game_id,team,player,player_id,position,starter,min,fgm,fga,2pm,2pa,3pm,3pa,ftm,fta,oreb,dreb,reb,ast,stl,blk,to,pf,pts
401424327,Southern Utah Thunderbirds,M. Fausett,4397379,,True,13.0,4,4,3,3,1,1,0,0,1,1,2,0,0,0,0,0,9
401424327,Southern Utah Thunderbirds,J. Spurgin,4702155,,True,40.0,3,9,3,8,0,1,2,2,5,11,16,1,1,0,6,4,8
401424327,Southern Utah Thunderbirds,H. Butler,4397380,,True,29.0,2,6,1,2,1,4,0,0,1,3,4,6,0,0,1,4,5
401424327,Southern Utah Thunderbirds,J. Knight III,4397421,,True,38.0,8,11,8,10,0,1,4,4,1,2,3,5,1,0,4,3,20
401424327,Southern Utah Thunderbirds,D. Marin,4278670,,True,32.0,3,6,1,2,2,4,0,0,0,2,2,1,1,0,2,3,8
401424327,Southern Utah Thunderbirds,N. Fleming,4702153,,False,12.0,1,3,0,0,1,3,0,0,0,1,1,1,0,0,2,4,3
401424327,Southern Utah Thunderbirds,D. Barnes,4397973,,False,0.0,0,0,0,0,0,0,0,0,0,0,0,0,0,0,0,0,0
401424327,Southern Utah Thunderbirds,M. Moore,4397733,,False,15.0,5,7,1,1,4,6,1,3,0,2,2,0,0,0,0,1,15
401424327,Southern Utah Thunderbirds,A. Moody,4278631,,False,21.0,3,8,2,2,1,6,2,2,0,3,3,1,0,0,0,4,9
401424327,Southern Utah Thunderbirds,TEAM,TOTAL,TOTAL,False,,29,54,19,28,10,26,9,11,8,27,35,15,3,0,15,23,77
401424327,Portland Pilots,C. Nduka,4897190,,True,36.0,4,9,2,6,2,3,0,1,1,3,4,3,0,0,3,3,10
401424327,Portland Pilots,M. Wood,4396657,,True,39.0,2,11,2,7,0,4,0,0,1,3,4,4,1,1,2,1,4
401424327,Portland Pilots,K. Sjolund,4395633,,True,37.0,0,6,0,1,0,5,1,2,0,3,3,1,1,1,0,2,1
401424327,Portland Pilots,T. Robertson,4592580,,True,40.0,8,16,6,13,2,3,9,10,3,7,10,3,2,0,4,3,27
401424327,Portland Pilots,C. Austin,4396811,,True,26.0,8,9,7,8,1,1,4,4,1,0,1,0,0,0,2,4,21
401424327,Portland Pilots,M. Svetozarevic,4897189,,False,16.0,1,2,0,0,1,2,0,0,1,1,2,1,0,0,0,0,3
401424327,Portland Pilots,M. Silveira,4398045,,False,1.0,0,1,0,1,0,0,0,0,0,0,0,0,0,0,0,0,0
401424327,Portland Pilots,Y. Harvey,4897184,,False,5.0,0,0,0,0,0,0,0,0,0,0,0,0,0,0,0,0,0
401424327,Portland Pilots,TEAM,TOTAL,TOTAL,False,,23,54,17,36,6,18,14,17,7,18,25,12,4,2,11,13,66
401424323,South Alabama Jaguars,M. Kearing,4897174,,True,15.0,3,6,3,6,0,0,0,0,0,2,2,0,0,1,1,0,6
401424323,South Alabama Jaguars,J. Franklin,4592747,,True,43.0,8,18,8,17,0,1,1,2,4,8,12,4,2,2,1,3,17
401424323,South Alabama Jaguars,L. Thomas,4277877,,True,12.0,1,4,0,3,1,1,0,0,1,4,5,0,0,1,0,0,3
401424323,South Alabama Jaguars,Al. Anderson,4897173,,True,28.0,4,8,4,8,0,0,2,5,4,2,6,2,3,0,1,3,10
401424323,South Alabama Jaguars,T. Jones,4432853,,True,38.0,1,7,1,3,0,4,2,2,1,5,6,7,1,0,4,1,4
401424323,South Alabama Jaguars,T. Shirley,4897175,,False,28.0,5,9,1,1,4,8,0,0,0,3,3,1,1,1,4,1,14
401424323,South Alabama Jaguars,D. Smith,4431819,,False,36.0,3,9,1,2,2,7,0,0,0,2,2,2,2,0,0,0,8
401424323,South Alabama Jaguars,K. Goncalves,4402692,,False,25.0,2,5,0,0,2,5,0,1,0,3,3,0,0,0,0,1,6
401424323,South Alabama Jaguars,TEAM,TOTAL,TOTAL,False,,27,66,18,40,9,26,5,10,10,29,39,16,9,5,14,9,68
401424323,Coastal Carolina Chanticleers,W. Likayi,4593814,,True,27.0,2,3,1,1,1,2,0,0,1,6,7,1,0,2,1,4,5
401424323,Coastal Carolina Chanticleers,V. Cole,4702008,,True,37.0,5,18,1,6,4,12,2,2,0,2,2,2,0,0,2,1,16
401424323,Coastal Carolina Chanticleers,R. Williams,4700534,,True,39.0,8,10,7,9,1,1,0,0,0,3,3,2,3,0,3,0,17
401424323,Coastal Carolina Chanticleers,G. Green,4593880,,True,27.0,2,6,1,3,1,3,0,0,0,2,2,1,0,0,3,1,5
401424323,Coastal Carolina Chanticleers,E. Dibba,4397504,,True,41.0,3,7,3,5,0,2,2,2,0,10,10,3,1,0,2,2,8
401424323,Coastal Carolina Chanticleers,E. Mostafa,4433052,,False,34.0,6,11,6,11,0,0,0,2,2,5,7,4,0,1,1,4,12
401424323,Coastal Carolina Chanticleers,I. Hippolyte,4397509,,False,2.0,0,0,0,0,0,0,0,0,0,0,0,1,0,0,1,0,0
401424323,Coastal Carolina Chanticleers,J. Uduje,4897224,,False,18.0,2,4,0,0,2,4,0,0,0,1,1,1,2,1,2,1,6
401424323,Coastal Carolina Chanticleers,TEAM,TOTAL,TOTAL,False,,28,59,19,35,9,24,4,6,3,30,33,15,6,4,15,13,69
401423832,UTEP Miners,A. Hollins,4278515,,True,16.0,2,3,2,2,0,1,0,0,0,1,1,0,1,0,0,0,4
401423832,UTEP Miners,T. Verhoeven,4278488,,True,26.0,0,4,0,4,0,0,2,2,1,4,5,2,2,1,3,0,2
401423832,UTEP Miners,K. Kennedy,4397137,,True,35.0,6,19,5,12,1,7,2,2,4,4,8,2,1,0,1,0,15
401423832,UTEP Miners,C. Agnew,4396762,,True,33.0,5,8,4,5,1,3,2,2,1,3,4,2,0,0,0,3,13
401423832,UTEP Miners,S. Boum,4280244,,True,36.0,8,19,3,8,5,11,4,5,1,0,1,3,3,1,0,2,25
401423832,UTEP Miners,Z. Onyema,4703082,,False,9.0,1,2,1,2,0,0,2,2,0,0,0,0,0,0,1,1,4
401423832,UTEP Miners,J. Sibley,4433168,,False,19.0,1,6,0,3,1,3,0,0,0,1,1,1,0,0,0,2,3
401423832,UTEP Miners,J. Saterfield,4897578,,False,20.0,0,2,0,0,0,2,0,0,0,1,1,0,0,0,0,1,0
401423832,UTEP Miners,K. Giffa,4897575,,False,1.0,1,1,0,0,1,1,0,0,0,0,0,0,0,0,0,0,3
401423832,UTEP Miners,C. Clardy,4703080,,False,4.0,0,0,0,0,0,0,0,0,0,1,1,0,0,0,0,0,0
401423832,UTEP Miners,E. White,4703079,,False,1.0,0,0,0,0,0,0,0,0,0,0,0,0,0,0,0,0,0
401423832,UTEP Miners,TEAM,TOTAL,TOTAL,False,,24,64,15,36,9,28,12,13,9,18,27,10,7,2,5,9,69
401423832,Southern Utah Thunderbirds,M. Fausett,4397379,,True,34.0,3,7,3,4,0,3,3,4,1,6,7,2,0,0,2,1,9
401423832,Southern Utah Thunderbirds,J. Spurgin,4702155,,True,33.0,6,8,5,7,1,1,0,0,0,7,7,3,0,2,2,1,13
401423832,Southern Utah Thunderbirds,H. Butler,4397380,,True,26.0,3,6,3,5,0,1,5,5,2,5,7,0,0,0,2,1,11
401423832,Southern Utah Thunderbirds,J. Knight III,4397421,,True,30.0,6,11,6,8,0,3,0,0,2,7,9,3,0,1,5,2,12
401423832,Southern Utah Thunderbirds,D. Marin,4278670,,True,38.0,6,9,1,2,5,7,0,0,0,2,2,4,0,0,1,2,17
401423832,Southern Utah Thunderbirds,N. Fleming,4702153,,False,27.0,7,11,3,4,4,7,0,0,0,2,2,4,1,0,2,3,18
401423832,Southern Utah Thunderbirds,A. Moody,4278631,,False,12.0,1,3,1,2,0,1,0,0,0,0,0,1,1,0,0,1,2
401423832,Southern Utah Thunderbirds,TEAM,TOTAL,TOTAL,False,,32,55,22,32,10,23,8,9,6,32,38,17,2,3,14,11,82
401423831,Youngstown State Penguins,W. Dunn,4702992,,True,28.0,4,7,3,4,1,3,0,0,1,4,5,0,0,0,1,5,9
401423831,Youngstown State Penguins,M. Akuchie,4279695,,True,26.0,5,9,4,5,1,4,5,6,1,5,6,0,1,1,5,5,16
401423831,Youngstown State Penguins,T. Olison,4898195,,True,36.0,3,11,0,4,3,7,0,0,1,6,7,1,2,1,1,4,9
401423831,Youngstown State Penguins,S. Rathan-Mayes,4702990,,True,29.0,1,5,0,0,1,5,0,0,0,1,1,0,1,0,1,2,3
401423831,Youngstown State Penguins,D. Cohill,4396791,,True,38.0,6,13,6,11,0,2,14,15,2,4,6,8,1,0,3,2,26
401423831,Youngstown State Penguins,J. Owens,4898198,,False,3.0,0,0,0,0,0,0,0,0,0,0,0,0,0,0,0,1,0
401423831,Youngstown State Penguins,J. Thomas,4593431,,False,16.0,4,5,4,5,0,0,0,0,0,1,1,1,1,0,1,2,8
401423831,Youngstown State Penguins,M. Hunter,4702989,,False,13.0,0,1,0,0,0,1,0,0,0,2,2,0,0,0,0,2,0
401423831,Youngstown State Penguins,O. Long,4606875,,False,5.0,0,0,0,0,0,0,0,0,0,0,0,0,0,0,0,0,0
401423831,Youngstown State Penguins,C. Shelton,4592667,,False,6.0,0,0,0,0,0,0,0,0,0,0,0,0,0,0,0,1,0
401423831,Youngstown State Penguins,TEAM,TOTAL,TOTAL,False,,23,51,17,29,6,22,19,21,5,25,30,10,6,2,14,24,71
401423831,Fresno State Bulldogs,O. Robinson,4593049,,True,35.0,4,11,3,8,1,3,7,11,2,11,13,3,1,2,1,3,16
401423831,Fresno State Bulldogs,L. Colimerio,4703241,,True,28.0,3,3,3,3,0,0,0,2,4,3,7,0,1,0,1,1,6
401423831,Fresno State Bulldogs,I. Hill,4593830,,True,34.0,4,8,3,3,1,5,2,4,0,1,1,5,3,0,2,3,11
401423831,Fresno State Bulldogs,D. Stroud,4397866,,True,9.0,1,5,1,1,0,4,0,0,0,0,0,0,0,0,0,1,2
401423831,Fresno State Bulldogs,J. Campbell,4397089,,True,22.0,1,4,0,1,1,3,1,2,0,2,2,5,0,0,1,2,4
401423831,Fresno State Bulldogs,B. Meah,4703242,,False,16.0,6,6,6,6,0,0,2,3,2,3,5,0,0,1,0,1,14
401423831,Fresno State Bulldogs,R. Vaihola,4897515,,False,1.0,0,0,0,0,0,0,0,0,0,0,0,0,0,0,1,0,0
401423831,Fresno State Bulldogs,D. Yap,4703386,,False,26.0,3,7,1,2,2,5,5,6,0,0,0,1,1,0,1,1,13
401423831,Fresno State Bulldogs,D. Whitaker,4703240,,False,27.0,5,9,1,2,4,7,0,0,0,0,0,0,1,0,1,2,14
401423831,Fresno State Bulldogs,K. Harding,4703239,,False,2.0,0,1,0,0,0,1,0,0,0,0,0,0,0,0,0,0,0
401423831,Fresno State Bulldogs,TEAM,TOTAL,TOTAL,False,,27,54,18,26,9,28,17,28,9,23,32,14,7,3,10,14,80
401423830,South Carolina Upstate Spartans,J. Aldrich,4397838,,True,29.0,5,9,4,7,1,2,4,4,6,0,6,2,0,1,1,4,15
401423830,South Carolina Upstate Spartans,B. Mozone,4397835,,True,40.0,6,16,2,7,4,9,13,14,0,6,6,0,2,0,2,2,29
401423830,South Carolina Upstate Spartans,J. Gainey,4897649,,True,37.0,5,9,2,3,3,6,3,4,2,4,6,3,2,0,6,3,16
401423830,South Carolina Upstate Spartans,M. Goodloe,4592766,,True,18.0,2,5,2,5,0,0,2,2,2,3,5,2,0,0,1,4,6
401423830,South Carolina Upstate Spartans,D. White,4397832,,True,30.0,2,7,1,3,1,4,0,0,0,2,2,3,1,0,2,1,5
401423830,South Carolina Upstate Spartans,K. Smith,4433079,,False,11.0,0,1,0,1,0,0,0,0,0,1,1,0,0,0,0,0,0
401423830,South Carolina Upstate Spartans,J. Breazeale,4897648,,False,12.0,0,1,0,1,0,0,0,0,0,2,2,2,0,0,2,1,0
401423830,South Carolina Upstate Spartans,F. Rideau Jr.,4704083,,False,23.0,3,7,3,5,0,2,2,3,2,0,2,0,1,1,0,4,8
401423830,South Carolina Upstate Spartans,TEAM,TOTAL,TOTAL,False,,23,55,14,32,9,23,24,27,13,19,32,12,6,2,14,19,79
401423830,South Alabama Jaguars,J. Franklin,4592747,,True,32.0,10,12,10,12,0,0,8,10,2,5,7,1,3,1,3,3,28
401423830,South Alabama Jaguars,L. Thomas,4277877,,True,5.0,1,2,0,0,1,2,0,0,1,2,3,0,0,0,1,3,3
401423830,South Alabama Jaguars,Al. Anderson,4897173,,True,29.0,2,4,2,4,0,0,0,0,0,0,0,2,1,0,0,3,4
401423830,South Alabama Jaguars,C. Manning Jr.,4593021,,True,8.0,1,3,1,3,0,0,0,0,0,3,3,3,1,1,0,0,2
401423830,South Alabama Jaguars,T. Jones,4432853,,True,39.0,4,10,3,7,1,3,4,7,1,2,3,6,2,0,5,1,13
401423830,South Alabama Jaguars,T. Shirley,4897175,,False,32.0,3,4,3,4,0,0,2,2,1,2,3,1,0,0,2,3,8
401423830,South Alabama Jaguars,M. Kearing,4897174,,False,12.0,4,6,4,6,0,0,2,4,0,2,2,1,1,0,0,0,10
401423830,South Alabama Jaguars,D. Smith,4431819,,False,20.0,2,4,1,2,1,2,0,0,1,2,3,1,0,0,0,5,5
401423830,South Alabama Jaguars,K. Goncalves,4402692,,False,23.0,3,6,0,0,3,6,1,2,0,3,3,0,1,0,0,2,10
401423830,South Alabama Jaguars,TEAM,TOTAL,TOTAL,False,,30,51,24,38,6,13,17,25,8,21,29,15,9,2,11,20,83
401423613,Florida Gulf Coast Eagles,K. Samuel,4277915,,True,26.0,3,4,3,4,0,0,0,2,2,4,6,0,1,1,2,5,6
401423613,Florida Gulf Coast Eagles,C. Largie,4592249,,True,27.0,2,5,1,2,1,3,0,0,1,2,3,1,3,0,1,3,5
401423613,Florida Gulf Coast Eagles,A. Richie,4397858,,True,28.0,2,6,2,2,0,4,0,0,0,2,2,1,0,0,0,1,4
401423613,Florida Gulf Coast Eagles,C. Catto,4396688,,True,32.0,3,10,1,1,2,9,3,3,1,3,4,3,1,0,2,2,11
401423613,Florida Gulf Coast Eagles,T. Dunn-Martin,4067358,,True,33.0,7,19,4,11,3,8,0,0,0,4,4,4,0,0,8,2,17
401423613,Florida Gulf Coast Eagles,Z. Anderson,4700870,,False,29.0,5,8,2,2,3,6,2,2,0,5,5,0,2,0,2,1,15
401423613,Florida Gulf Coast Eagles,D. Rivers,4592248,,False,13.0,2,4,0,0,2,4,1,3,0,1,1,0,0,0,2,3,7
401423613,Florida Gulf Coast Eagles,A. Weir,4741885,,False,12.0,1,2,1,2,0,0,1,4,0,4,4,0,0,1,0,1,3
401423613,Florida Gulf Coast Eagles,TEAM,TOTAL,TOTAL,False,,25,58,14,24,11,34,7,14,5,26,31,9,7,2,17,18,68
401423613,Coastal Carolina Chanticleers,W. Likayi,4593814,,True,35.0,4,10,4,7,0,3,2,3,3,9,12,2,3,1,1,1,10
401423613,Coastal Carolina Chanticleers,E. Mostafa,4433052,,True,32.0,11,18,11,18,0,0,1,3,5,9,14,0,1,1,3,3,23
401423613,Coastal Carolina Chanticleers,J. Uduje,4897224,,True,20.0,0,6,0,4,0,2,0,0,1,2,3,1,0,0,0,0,0
401423613,Coastal Carolina Chanticleers,V. Cole,4702008,,True,32.0,6,14,5,9,1,5,2,2,3,2,5,1,2,0,1,2,15
401423613,Coastal Carolina Chanticleers,R. Williams,4700534,,True,34.0,8,15,4,7,4,8,4,5,0,3,3,5,2,0,3,2,24
401423613,Coastal Carolina Chanticleers,I. Hippolyte,4397509,,False,5.0,0,0,0,0,0,0,0,0,0,0,0,0,0,0,0,0,0
401423613,Coastal Carolina Chanticleers,D. Thomas,4593022,,False,3.0,1,2,1,2,0,0,0,0,1,1,2,0,0,0,0,1,2
401423613,Coastal Carolina Chanticleers,G. Green,4593880,,False,5.0,0,0,0,0,0,0,0,0,0,0,0,0,0,0,0,1,0
401423613,Coastal Carolina Chanticleers,E. Dibba,4397504,,False,34.0,3,5,3,4,0,1,4,4,1,5,6,9,2,0,5,2,10
401423613,Coastal Carolina Chanticleers,TEAM,TOTAL,TOTAL,False,,33,70,28,51,5,19,13,17,14,32,46,18,10,2,14,12,84
401422751,Portland Pilots,C. Nduka,4897190,,True,38.0,3,6,3,5,0,1,0,2,4,5,9,4,2,1,2,3,6
401422751,Portland Pilots,M. Wood,4396657,,True,29.0,7,13,3,4,4,9,1,2,1,6,7,6,2,4,2,0,19
401422751,Portland Pilots,K. Sjolund,4395633,,True,30.0,6,10,0,0,6,10,3,4,1,3,4,4,0,0,2,2,21
401422751,Portland Pilots,T. Robertson,4592580,,True,31.0,5,10,2,4,3,6,1,1,1,5,6,7,3,0,1,0,14
401422751,Portland Pilots,C. Austin,4396811,,True,26.0,7,11,6,8,1,3,4,7,0,0,0,5,0,0,3,3,19
401422751,Portland Pilots,W. Watson,4397720,,False,9.0,1,2,0,0,1,2,3,4,0,1,1,0,0,1,1,1,6
401422751,Portland Pilots,M. Svetozarevic,4897189,,False,8.0,1,4,0,1,1,3,2,2,0,2,2,1,1,0,3,2,5
401422751,Portland Pilots,M. Silveira,4398045,,False,10.0,2,6,2,6,0,0,0,0,2,3,5,0,0,0,0,5,4
401422751,Portland Pilots,A. Bitrous,4931008,,False,1.0,0,1,0,1,0,0,0,0,0,0,0,0,0,0,0,0,0
401422751,Portland Pilots,N. Milosevic,4897187,,False,9.0,0,1,0,1,0,0,0,0,0,3,3,1,0,0,1,0,0
401422751,Portland Pilots,Y. Harvey,4897184,,False,9.0,0,0,0,0,0,0,0,0,0,1,1,0,0,0,2,2,0
401422751,Portland Pilots,TEAM,TOTAL,TOTAL,False,,32,64,16,30,16,34,14,22,9,30,39,28,8,6,18,18,94
401422751,New Orleans Privateers,S. Kirkland,4703132,,True,23.0,1,10,1,9,0,1,1,2,2,3,5,0,1,1,1,1,3
401422751,New Orleans Privateers,T. Jackson,4431818,,True,14.0,1,2,1,2,0,0,1,3,0,1,1,0,0,0,4,4,3
401422751,New Orleans Privateers,D. St. Hilaire,4398325,,True,29.0,4,18,1,11,3,7,3,4,0,3,3,1,2,0,2,3,14
401422751,New Orleans Privateers,D. Sackey,4397512,,True,18.0,0,3,0,1,0,2,0,0,2,3,5,1,1,0,1,1,0
401422751,New Orleans Privateers,T. Green,4279181,,True,30.0,6,9,6,9,0,0,5,5,3,1,4,1,0,0,4,5,17
401422751,New Orleans Privateers,D. Washington,4897329,,False,3.0,0,0,0,0,0,0,0,0,0,1,1,0,0,0,1,0,0
401422751,New Orleans Privateers,D. Bell,4703650,,False,16.0,2,2,2,2,0,0,0,2,3,2,5,0,2,0,1,1,4
401422751,New Orleans Privateers,J. Myers,4398093,,False,12.0,2,7,2,7,0,0,2,2,1,1,2,1,1,0,0,5,6
401422751,New Orleans Privateers,J. Vincent,4897328,,False,13.0,3,6,3,4,0,2,0,0,1,5,6,1,2,0,0,1,6
401422751,New Orleans Privateers,N. Williams,4703645,,False,1.0,0,1,0,0,0,1,1,1,0,0,0,0,0,0,0,0,1
401422751,New Orleans Privateers,R. Carson Jr.,4593813,,False,14.0,4,5,4,4,0,1,1,1,0,3,3,1,0,0,0,0,9
401422751,New Orleans Privateers,K. Doughty,4432969,,False,27.0,1,8,1,7,0,1,8,8,3,3,6,0,1,0,0,3,10
401422751,New Orleans Privateers,TEAM,TOTAL,TOTAL,False,,24,71,21,56,3,15,22,28,18,28,46,6,10,1,14,24,73
401422750,Fresno State Bulldogs,O. Robinson,4593049,,True,33.0,5,10,5,8,0,2,3,7,1,3,4,5,1,0,2,2,13
401422750,Fresno State Bulldogs,L. Colimerio,4703241,,True,33.0,6,10,6,9,0,1,5,5,2,7,9,1,3,1,0,3,17
401422750,Fresno State Bulldogs,I. Hill,4593830,,True,29.0,3,7,3,4,0,3,2,2,1,1,2,3,1,2,0,1,8
401422750,Fresno State Bulldogs,A. Holland,4593051,,True,33.0,6,12,2,4,4,8,2,2,2,6,8,0,1,0,0,3,18
401422750,Fresno State Bulldogs,J. Campbell,4397089,,True,11.0,1,3,0,1,1,2,0,0,0,2,2,2,1,0,2,1,3
401422750,Fresno State Bulldogs,B. Meah,4703242,,False,5.0,0,0,0,0,0,0,1,2,0,2,2,0,0,0,1,1,1
401422750,Fresno State Bulldogs,R. Vaihola,4897515,,False,3.0,0,0,0,0,0,0,2,4,1,1,2,0,0,0,0,1,2
401422750,Fresno State Bulldogs,D. Yap,4703386,,False,15.0,2,6,1,2,1,4,2,3,0,2,2,2,2,0,1,1,7
401422750,Fresno State Bulldogs,D. Whitaker,4703240,,False,10.0,0,2,0,0,0,2,0,0,0,0,0,0,0,0,0,0,0
401422750,Fresno State Bulldogs,D. Stroud,4397866,,False,28.0,5,9,4,5,1,4,3,3,2,1,3,2,2,0,3,2,14
401422750,Fresno State Bulldogs,TEAM,TOTAL,TOTAL,False,,28,59,21,33,7,26,20,28,11,25,36,15,11,3,9,15,83
401422750,Eastern Washington Eagles,E. Price,4897852,,True,32.0,3,8,3,4,0,4,1,1,2,4,6,3,1,0,3,4,7
401422750,Eastern Washington Eagles,L. Acliese,4609216,,True,29.0,9,15,6,8,3,7,4,4,2,2,4,1,1,0,3,5,25
401422750,Eastern Washington Eagles,A. Allegri,4398233,,True,33.0,3,5,1,2,2,3,0,1,1,5,6,0,1,1,1,1,8
401422750,Eastern Washington Eagles,S. Venters,4592579,,True,35.0,6,14,1,4,5,10,1,1,0,5,5,4,1,0,3,2,18
401422750,Eastern Washington Eagles,R. Bergersen,4280143,,True,27.0,3,7,3,6,0,1,2,4,1,1,2,4,1,0,3,3,8
401422750,Eastern Washington Eagles,C. Jones,4897857,,False,3.0,0,0,0,0,0,0,0,0,0,0,0,0,0,1,0,1,0
401422750,Eastern Washington Eagles,I. George,4897856,,False,13.0,1,1,0,0,1,1,0,0,1,4,5,0,2,0,1,2,3
401422750,Eastern Washington Eagles,V. Radocaj,4701569,,False,1.0,0,0,0,0,0,0,2,2,0,1,1,0,0,0,0,0,2
401422750,Eastern Washington Eagles,M. Landdeck,4897855,,False,13.0,1,4,0,1,1,3,0,0,0,0,0,1,0,0,1,3,3
401422750,Eastern Washington Eagles,E. Magnuson,4592585,,False,14.0,0,1,0,1,0,0,0,0,0,1,1,1,0,0,2,0,0
401422750,Eastern Washington Eagles,TEAM,TOTAL,TOTAL,False,,26,55,14,26,12,29,10,13,7,24,31,14,7,2,17,21,74
401422729,Southern Utah Thunderbirds,M. Fausett,4397379,,True,25.0,3,5,1,1,2,4,1,2,0,4,4,1,0,0,0,3,9
401422729,Southern Utah Thunderbirds,J. Spurgin,4702155,,True,36.0,5,7,4,5,1,2,2,4,2,5,7,2,0,2,3,4,13
401422729,Southern Utah Thunderbirds,H. Butler,4397380,,True,32.0,2,8,1,2,1,6,6,8,1,5,6,1,1,0,2,2,11
401422729,Southern Utah Thunderbirds,J. Knight III,4397421,,True,30.0,5,6,5,6,0,0,4,9,1,5,6,6,0,0,4,3,14
401422729,Southern Utah Thunderbirds,D. Marin,4278670,,True,33.0,10,16,3,6,7,10,0,0,0,3,3,5,3,0,0,0,27
401422729,Southern Utah Thunderbirds,N. Fleming,4702153,,False,22.0,2,5,1,1,1,4,2,2,0,0,0,3,0,0,1,1,7
401422729,Southern Utah Thunderbirds,D. Barnes,4397973,,False,2.0,0,0,0,0,0,0,0,0,0,1,1,0,0,0,0,0,0
401422729,Southern Utah Thunderbirds,M. Moore,4397733,,False,5.0,1,2,1,1,0,1,0,0,0,1,1,1,1,0,0,1,2
401422729,Southern Utah Thunderbirds,A. Moody,4278631,,False,15.0,0,3,0,1,0,2,0,0,0,2,2,1,1,0,0,1,0
401422729,Southern Utah Thunderbirds,TEAM,TOTAL,TOTAL,False,,28,52,16,23,12,29,15,25,6,28,34,20,6,2,12,15,83
401422729,Kent State Golden Flashes,V. Davis,4589474,,True,16.0,0,4,0,1,0,3,0,0,1,2,3,0,0,0,1,2,0
401422729,Kent State Golden Flashes,A. Odusipe,4432496,,True,10.0,0,0,0,0,0,0,1,2,1,1,2,2,0,0,1,2,1
401422729,Kent State Golden Flashes,M. Jacobs,4703551,,True,34.0,8,16,5,12,3,4,9,12,1,2,3,5,2,1,0,3,28
401422729,Kent State Golden Flashes,S. Carry,4396807,,True,36.0,3,9,2,5,1,4,3,4,1,4,5,2,1,1,3,2,10
401422729,Kent State Golden Flashes,A. Garcia,4066768,,True,27.0,6,12,5,10,1,2,0,0,3,2,5,1,2,0,1,3,13
401422729,Kent State Golden Flashes,J. Logan,4703553,,False,0.0,0,0,0,0,0,0,0,0,0,0,0,0,0,0,0,0,0
401422729,Kent State Golden Flashes,J. Hamilton,4278334,,False,29.0,2,6,2,6,0,0,2,3,0,4,4,1,0,0,1,2,6
401422729,Kent State Golden Flashes,C. Hornbeak,4898317,,False,6.0,0,0,0,0,0,0,0,0,0,4,4,0,0,0,0,0,0
401422729,Kent State Golden Flashes,J. Sullinger,4898316,,False,21.0,6,9,2,2,4,7,0,0,1,2,3,0,0,0,1,4,16
401422729,Kent State Golden Flashes,M. DiGiulio,4703554,,False,0.0,1,1,1,1,0,0,0,0,0,0,0,0,0,0,0,0,2
401422729,Kent State Golden Flashes,J. Hernandez,4433007,,False,21.0,1,4,0,1,1,3,0,0,0,0,0,2,1,0,0,1,3
401422729,Kent State Golden Flashes,TEAM,TOTAL,TOTAL,False,,27,61,17,38,10,23,15,21,9,22,31,13,6,2,8,19,79
401422727,Florida Gulf Coast Eagles,K. Samuel,4277915,,True,24.0,6,7,6,7,0,0,0,0,3,5,8,1,0,1,3,2,12
401422727,Florida Gulf Coast Eagles,C. Largie,4592249,,True,25.0,3,5,3,4,0,1,0,0,0,1,1,3,1,0,1,4,6
401422727,Florida Gulf Coast Eagles,A. Richie,4397858,,True,34.0,6,14,3,3,3,11,2,2,1,6,7,2,1,0,1,2,17
401422727,Florida Gulf Coast Eagles,C. Catto,4396688,,True,28.0,1,4,0,1,1,3,0,0,2,7,9,4,0,0,1,2,3
401422727,Florida Gulf Coast Eagles,T. Dunn-Martin,4067358,,True,35.0,12,19,7,10,5,9,4,5,0,3,3,6,3,1,3,0,33
401422727,Florida Gulf Coast Eagles,K. Riemenschneider,4897556,,False,1.0,0,0,0,0,0,0,0,0,0,0,0,0,0,0,0,0,0
401422727,Florida Gulf Coast Eagles,Z. Anderson,4700870,,False,23.0,2,4,0,0,2,4,4,4,4,2,6,3,0,0,1,2,10
401422727,Florida Gulf Coast Eagles,D. Rivers,4592248,,False,11.0,2,4,0,0,2,4,0,0,0,2,2,0,0,0,0,2,6
401422727,Florida Gulf Coast Eagles,C. Jackson,4592254,,False,1.0,0,0,0,0,0,0,0,0,0,0,0,0,0,0,0,0,0
401422727,Florida Gulf Coast Eagles,A. Weir,4741885,,False,16.0,4,9,4,8,0,1,0,2,2,1,3,0,1,0,1,2,8
401422727,Florida Gulf Coast Eagles,L. Ricca,4592256,,False,1.0,0,0,0,0,0,0,0,0,0,0,0,0,0,0,0,1,0
401422727,Florida Gulf Coast Eagles,V. Rosa,4432490,,False,1.0,0,0,0,0,0,0,0,0,0,1,1,0,0,0,0,0,0
401422727,Florida Gulf Coast Eagles,TEAM,TOTAL,TOTAL,False,,36,66,23,33,13,33,10,13,12,29,41,19,6,2,11,17,95
401422727,Detroit Mercy Titans,M. Akec,4396647,,True,36.0,7,17,5,12,2,5,1,1,3,6,9,1,0,1,0,4,17
401422727,Detroit Mercy Titans,B. Koka,4278375,,True,7.0,0,1,0,1,0,0,0,0,0,1,1,0,0,0,0,0,0
401422727,Detroit Mercy Titans,A. Davis,4397732,,True,38.0,10,20,7,12,3,8,1,1,0,3,3,3,1,0,3,1,24
401422727,Detroit Mercy Titans,K. McAdoo,4279331,,True,34.0,7,10,4,5,3,5,1,2,0,1,1,2,1,0,3,3,18
401422727,Detroit Mercy Titans,D.J. Harvey,4278010,,True,37.0,5,11,3,7,2,4,3,5,3,8,11,1,1,1,1,1,15
401422727,Detroit Mercy Titans,M. Sylla,4897722,,False,2.0,0,1,0,1,0,0,0,0,0,0,0,0,0,0,0,0,0
401422727,Detroit Mercy Titans,J. Shaw,4897721,,False,2.0,0,0,0,0,0,0,0,0,0,0,0,0,0,0,0,0,0
401422727,Detroit Mercy Titans,M. Johnson,4592487,,False,27.0,2,6,2,3,0,3,1,3,1,2,3,1,1,0,1,4,5
401422727,Detroit Mercy Titans,K. LeGreair,4567749,,False,17.0,0,0,0,0,0,0,0,0,1,0,1,2,1,0,1,2,0
401422727,Detroit Mercy Titans,TEAM,TOTAL,TOTAL,False,,31,66,21,41,10,25,7,12,10,21,31,10,5,2,9,15,79
401422726,South Alabama Jaguars,J. Franklin,4592747,,True,35.0,7,9,7,9,0,0,3,6,7,7,14,4,1,4,3,1,17
401422726,South Alabama Jaguars,L. Thomas,4277877,,True,4.0,0,2,0,0,0,2,0,0,1,0,1,0,0,0,0,0,0
401422726,South Alabama Jaguars,Al. Anderson,4897173,,True,30.0,3,4,3,4,0,0,1,4,1,2,3,2,0,0,0,0,7
401422726,South Alabama Jaguars,C. Manning Jr.,4593021,,True,34.0,5,16,5,13,0,3,0,0,2,1,3,6,1,3,4,5,10
401422726,South Alabama Jaguars,T. Jones,4432853,,True,36.0,6,10,3,4,3,6,2,2,0,1,1,3,2,0,5,2,17
401422726,South Alabama Jaguars,T. Shirley,4897175,,False,13.0,2,6,1,1,1,5,0,0,0,0,0,0,1,0,0,0,5
401422726,South Alabama Jaguars,M. Kearing,4897174,,False,5.0,1,2,1,2,0,0,0,0,0,0,0,0,0,0,0,2,2
401422726,South Alabama Jaguars,D. Smith,4431819,,False,16.0,1,3,0,0,1,3,0,0,0,4,4,2,0,0,0,1,3
401422726,South Alabama Jaguars,K. Goncalves,4402692,,False,27.0,3,9,0,0,3,9,0,2,0,4,4,0,1,1,1,3,9
401422726,South Alabama Jaguars,TEAM,TOTAL,TOTAL,False,,28,61,20,33,8,28,6,14,12,22,34,17,6,8,13,14,70
401422726,SE Louisiana Lions,J. Hinton,4897312,,True,39.0,5,10,5,10,0,0,3,6,4,7,11,2,4,3,2,2,13
401422726,SE Louisiana Lions,M. Brackmann,4594150,,True,6.0,0,0,0,0,0,0,0,0,1,1,2,0,0,0,0,1,0
401422726,SE Louisiana Lions,R. Eastmond,4593700,,True,17.0,1,5,1,3,0,2,0,0,2,0,2,1,0,0,2,2,2
401422726,SE Louisiana Lions,R. Burkhardt,4278456,,True,28.0,4,8,1,1,3,7,1,1,1,2,3,1,0,0,1,1,12
401422726,SE Louisiana Lions,K. Clergeot,4066460,,True,29.0,3,8,1,3,2,5,0,0,1,1,2,2,0,0,5,2,8
401422726,SE Louisiana Lions,R. McFarlane,4897313,,False,26.0,2,10,1,6,1,4,4,4,2,6,8,1,0,0,0,1,9
401422726,SE Louisiana Lions,N. Caldwell,4594148,,False,20.0,2,2,2,2,0,0,0,0,0,2,2,1,0,0,1,0,4
401422726,SE Louisiana Lions,J. Kasperzyk,4397945,,False,24.0,5,12,5,10,0,2,7,8,2,2,4,3,4,0,5,3,17
401422726,SE Louisiana Lions,M. Strange,4278330,,False,11.0,1,3,0,0,1,3,0,0,0,2,2,1,1,0,0,2,3
401422726,SE Louisiana Lions,TEAM,TOTAL,TOTAL,False,,23,58,16,35,7,23,15,19,14,25,39,12,9,3,16,14,68
401422725,Youngstown State Penguins,W. Dunn,4702992,,True,28.0,3,7,3,5,0,2,1,2,5,2,7,1,0,0,1,1,7
401422725,Youngstown State Penguins,M. Akuchie,4279695,,True,30.0,5,14,5,10,0,4,1,2,3,5,8,3,2,1,2,4,11
401422725,Youngstown State Penguins,T. Olison,4898195,,True,32.0,3,6,1,2,2,4,4,4,0,3,3,3,2,0,3,0,12
401422725,Youngstown State Penguins,S. Rathan-Mayes,4702990,,True,36.0,0,3,0,1,0,2,4,4,0,3,3,4,0,0,1,2,4
401422725,Youngstown State Penguins,D. Cohill,4396791,,True,37.0,8,18,5,14,3,4,9,10,0,4,4,0,1,1,4,1,28
401422725,Youngstown State Penguins,J. Owens,4898198,,False,1.0,0,0,0,0,0,0,0,0,0,0,0,0,0,0,0,1,0
401422725,Youngstown State Penguins,J. Thomas,4593431,,False,7.0,2,2,2,2,0,0,0,0,1,1,2,0,0,0,0,2,4
401422725,Youngstown State Penguins,L. Chicone,4898197,,False,3.0,0,1,0,1,0,0,0,0,0,0,0,0,1,0,1,0,0
401422725,Youngstown State Penguins,M. Hunter,4702989,,False,14.0,0,2,0,1,0,1,2,2,0,3,3,0,0,1,1,3,2
401422725,Youngstown State Penguins,O. Long,4606875,,False,8.0,0,2,0,1,0,1,0,1,0,0,0,0,0,0,0,2,0
401422725,Youngstown State Penguins,C. Shelton,4592667,,False,4.0,1,2,1,2,0,0,0,0,0,0,0,0,0,0,0,0,2
401422725,Youngstown State Penguins,TEAM,TOTAL,TOTAL,False,,22,57,17,39,5,18,21,25,11,25,36,11,6,3,14,16,70
401422725,Morgan State Bears,C. Venning,4711312,,True,28.0,6,10,6,10,0,0,1,2,4,1,5,0,0,1,2,0,13
401422725,Morgan State Bears,L. Grantsaan,4593392,,True,24.0,4,12,4,10,0,2,0,0,3,5,8,0,0,0,0,5,8
401422725,Morgan State Bears,M. Miller,4398197,,True,40.0,7,12,7,11,0,1,5,6,3,10,13,3,4,2,1,3,19
401422725,Morgan State Bears,T. Moore,4278218,,True,13.0,1,5,1,2,0,3,0,0,0,2,2,1,0,0,1,0,2
401422725,Morgan State Bears,S. Woods,4065676,,True,29.0,2,8,2,7,0,1,4,4,1,2,3,2,1,0,3,5,8
401422725,Morgan State Bears,Ty Horner,4900679,,False,2.0,0,0,0,0,0,0,0,0,0,0,0,0,0,0,0,1,0
401422725,Morgan State Bears,C. Nnamene,4397977,,False,7.0,0,0,0,0,0,0,0,0,0,1,1,0,0,0,0,0,0
401422725,Morgan State Bears,E. Bowens,4598777,,False,26.0,2,3,2,3,0,0,2,2,0,0,0,2,1,0,2,4,6
401422725,Morgan State Bears,K. McGee,4397356,,False,31.0,3,13,3,10,0,3,3,5,0,2,2,2,2,0,2,4,9
401422725,Morgan State Bears,TEAM,TOTAL,TOTAL,False,,25,63,25,53,0,10,15,19,11,24,35,10,8,3,12,22,65
401422724,Maryland Eastern Shore Hawks,N. Pollard Jr.,4704102,,True,18.0,1,3,1,3,0,0,0,1,0,4,4,2,0,0,4,3,2
401422724,Maryland Eastern Shore Hawks,Z. Styles,4704099,,True,29.0,4,17,4,12,0,5,2,4,2,5,7,2,2,0,2,4,10
401422724,Maryland Eastern Shore Hawks,D. London,4700872,,True,28.0,2,8,1,2,1,6,1,2,0,3,3,1,1,0,0,1,6
401422724,Maryland Eastern Shore Hawks,D. Phillip,4593381,,True,28.0,3,7,2,3,1,4,0,0,0,6,6,2,2,1,2,1,7
401422724,Maryland Eastern Shore Hawks,K. Voyles,4593380,,True,26.0,4,12,0,4,4,8,0,1,1,1,2,0,2,0,2,2,12
401422724,Maryland Eastern Shore Hawks,M. Milivojevic,4898272,,False,8.0,0,0,0,0,0,0,0,0,0,3,3,0,0,0,0,0,0
401422724,Maryland Eastern Shore Hawks,K. Thompson,4898271,,False,10.0,0,2,0,0,0,2,0,0,0,0,0,0,0,0,0,0,0
401422724,Maryland Eastern Shore Hawks,M. Akinsanya,4704101,,False,11.0,0,1,0,0,0,1,0,0,1,1,2,1,0,0,1,1,0
401422724,Maryland Eastern Shore Hawks,C. Davis,4898269,,False,13.0,0,2,0,1,0,1,0,0,0,0,0,1,0,0,2,0,0
401422724,Maryland Eastern Shore Hawks,D. Nugent,4704097,,False,20.0,1,5,1,1,0,4,0,0,1,0,1,1,1,1,3,2,2
401422724,Maryland Eastern Shore Hawks,M. Mensah,4704096,,False,5.0,1,3,0,0,1,3,0,0,0,2,2,0,0,0,0,1,3
401422724,Maryland Eastern Shore Hawks,G. Anderson,4593382,,False,4.0,0,0,0,0,0,0,0,0,0,0,0,0,0,0,0,0,0
401422724,Maryland Eastern Shore Hawks,TEAM,TOTAL,TOTAL,False,,16,60,9,26,7,34,3,8,9,29,38,10,8,2,17,15,42
401422724,Coastal Carolina Chanticleers,E. Mostafa,4433052,,True,22.0,1,5,1,5,0,0,1,2,1,6,7,1,0,1,2,4,3
401422724,Coastal Carolina Chanticleers,J. Uduje,4897224,,True,20.0,2,5,1,3,1,2,0,1,3,3,6,1,0,0,3,2,5
401422724,Coastal Carolina Chanticleers,V. Cole,4702008,,True,33.0,6,15,4,8,2,7,1,2,0,4,4,2,2,0,0,0,15
401422724,Coastal Carolina Chanticleers,G. Green,4593880,,True,12.0,0,2,0,0,0,2,0,0,0,1,1,0,0,0,2,0,0
401422724,Coastal Carolina Chanticleers,E. Dibba,4397504,,True,34.0,5,9,4,6,1,3,0,0,1,5,6,3,1,0,5,2,11
401422724,Coastal Carolina Chanticleers,A. Harvey,4593884,,False,3.0,0,0,0,0,0,0,0,0,0,1,1,0,0,0,1,0,0
401422724,Coastal Carolina Chanticleers,W. Likayi,4593814,,False,26.0,2,4,0,0,2,4,1,2,0,8,8,3,1,4,1,2,7
401422724,Coastal Carolina Chanticleers,I. Hippolyte,4397509,,False,14.0,3,5,3,3,0,2,1,2,2,1,3,1,0,1,0,0,7
401422724,Coastal Carolina Chanticleers,D. Thomas,4593022,,False,3.0,0,0,0,0,0,0,0,0,0,0,0,0,0,0,0,0,0
401422724,Coastal Carolina Chanticleers,K. Williamson,4702122,,False,3.0,0,0,0,0,0,0,0,0,0,0,0,0,0,0,0,0,0
401422724,Coastal Carolina Chanticleers,R. Williams,4700534,,False,30.0,6,12,3,6,3,6,3,4,0,4,4,4,2,0,2,1,18
401422724,Coastal Carolina Chanticleers,TEAM,TOTAL,TOTAL,False,,25,57,16,31,9,26,7,13,7,37,44,15,6,6,17,11,66
401422723,Western Illinois Leathernecks,W. Carius,4702623,,True,37.0,5,15,2,5,3,10,0,0,2,5,7,0,2,1,1,1,13
401422723,Western Illinois Leathernecks,L. Barisic,4593286,,True,19.0,1,6,1,2,0,4,6,6,0,3,3,1,1,0,2,4,8
401422723,Western Illinois Leathernecks,T. Pearson,4397727,,True,35.0,6,15,6,13,0,2,3,4,1,5,6,3,0,0,2,1,15
401422723,Western Illinois Leathernecks,K. Lee,4897229,,True,38.0,1,6,1,3,0,3,2,6,1,3,4,0,1,0,0,1,4
401422723,Western Illinois Leathernecks,T. Massner,4594126,,True,33.0,1,9,0,5,1,4,1,2,1,3,4,4,1,0,2,4,4
401422723,Western Illinois Leathernecks,C. Burrell,4702616,,False,30.0,5,10,5,9,0,1,0,0,1,2,3,1,0,0,1,2,10
401422723,Western Illinois Leathernecks,R. Jeter IV,4702621,,False,5.0,0,0,0,0,0,0,0,0,0,0,0,0,0,0,0,0,0
401422723,Western Illinois Leathernecks,M. Wade,4702625,,False,3.0,0,1,0,1,0,0,0,0,1,0,1,0,0,0,0,0,0
401422723,Western Illinois Leathernecks,TEAM,TOTAL,TOTAL,False,,19,62,15,38,4,24,12,18,8,22,30,9,5,1,8,13,54
401422723,UTEP Miners,J. Sibley,4433168,,True,27.0,5,9,4,5,1,4,0,0,1,5,6,2,0,1,1,3,11
401422723,UTEP Miners,T. Verhoeven,4278488,,True,24.0,4,7,4,7,0,0,2,4,0,1,1,0,0,1,0,2,10
401422723,UTEP Miners,K. Kennedy,4397137,,True,35.0,8,15,4,6,4,9,2,3,2,13,15,1,2,2,4,1,22
401422723,UTEP Miners,C. Agnew,4396762,,True,25.0,2,4,2,3,0,1,1,1,1,2,3,4,0,0,2,3,5
401422723,UTEP Miners,S. Boum,4280244,,True,39.0,7,13,5,8,2,5,4,4,0,12,12,10,1,1,3,1,20
401422723,UTEP Miners,K. Kalu,4897577,,False,4.0,1,1,1,1,0,0,0,0,1,1,2,1,0,0,0,1,2
401422723,UTEP Miners,Z. Onyema,4703082,,False,10.0,0,0,0,0,0,0,0,0,1,1,2,1,1,0,1,2,0
401422723,UTEP Miners,A. Hollins,4278515,,False,13.0,5,9,5,7,0,2,0,0,0,1,1,1,1,0,2,2,10
401422723,UTEP Miners,B. Maring,4897576,,False,3.0,0,0,0,0,0,0,0,0,0,0,0,0,0,0,0,0,0
401422723,UTEP Miners,J. Saterfield,4897578,,False,10.0,0,3,0,1,0,2,0,0,1,0,1,0,0,0,0,2,0
401422723,UTEP Miners,K. Giffa,4897575,,False,2.0,0,0,0,0,0,0,0,0,0,2,2,0,0,0,0,0,0
401422723,UTEP Miners,C. Clardy,4703080,,False,4.0,0,0,0,0,0,0,0,0,0,0,0,0,0,0,0,0,0
401422723,UTEP Miners,E. White,4703079,,False,4.0,0,0,0,0,0,0,0,0,0,0,0,0,0,0,0,0,0
401422723,UTEP Miners,TEAM,TOTAL,TOTAL,False,,32,61,25,38,7,23,9,12,8,39,47,20,5,5,13,17,80
401422722,South Carolina Upstate Spartans,J. Aldrich,4397838,,True,33.0,9,14,6,11,3,3,3,3,0,3,3,1,0,0,2,3,24
401422722,South Carolina Upstate Spartans,B. Mozone,4397835,,True,30.0,6,7,4,5,2,2,2,2,2,4,6,1,0,0,2,4,16
401422722,South Carolina Upstate Spartans,J. Gainey,4897649,,True,35.0,6,14,4,8,2,6,3,3,0,6,6,4,4,0,2,4,17
401422722,South Carolina Upstate Spartans,M. Goodloe,4592766,,True,35.0,3,10,3,7,0,3,1,1,3,3,6,3,3,0,0,3,7
401422722,South Carolina Upstate Spartans,D. White,4397832,,True,37.0,6,14,3,8,3,6,0,0,0,2,2,7,1,0,1,1,15
401422722,South Carolina Upstate Spartans,K. Smith,4433079,,False,7.0,0,1,0,1,0,0,1,2,0,2,2,0,0,0,1,0,1
401422722,South Carolina Upstate Spartans,J. Breazeale,4897648,,False,8.0,0,2,0,1,0,1,0,0,0,1,1,1,1,0,1,1,0
401422722,South Carolina Upstate Spartans,F. Rideau Jr.,4704083,,False,15.0,0,4,0,3,0,1,0,0,1,4,5,0,0,0,0,2,0
401422722,South Carolina Upstate Spartans,TEAM,TOTAL,TOTAL,False,,30,66,20,44,10,22,10,11,8,25,33,17,9,0,10,18,80
401422722,App State Mountaineers,J. Lewis Jr.,4280003,,True,16.0,2,3,2,3,0,0,0,0,1,3,4,0,0,1,0,0,4
401422722,App State Mountaineers,D. Gregory,4432904,,True,36.0,5,8,5,8,0,0,10,14,1,9,10,4,1,0,4,2,20
401422722,App State Mountaineers,A. Delph,4397415,,True,39.0,9,20,3,6,6,14,4,6,1,6,7,1,1,3,4,1,28
401422722,App State Mountaineers,J. Forrest,4280137,,True,22.0,1,4,0,1,1,3,1,2,0,1,1,2,0,1,1,1,4
401422722,App State Mountaineers,M. Almonacy,4066766,,True,34.0,3,8,1,3,2,5,0,0,0,2,2,4,1,0,4,3,8
401422722,App State Mountaineers,C. Mantis,4897226,,False,2.0,0,0,0,0,0,0,0,0,0,0,0,0,0,0,0,0,0
401422722,App State Mountaineers,CJ Huntley,4702602,,False,25.0,3,7,1,1,2,6,0,2,1,5,6,1,1,0,2,0,8
401422722,App State Mountaineers,RJ Duhart,4702600,,False,25.0,0,0,0,0,0,0,2,2,1,2,3,2,2,3,1,3,2
401422722,App State Mountaineers,T. Harcum,4897227,,False,1.0,0,0,0,0,0,0,0,0,0,0,0,0,0,0,0,0,0
401422722,App State Mountaineers,TEAM,TOTAL,TOTAL,False,,23,50,12,22,11,28,17,26,5,29,34,14,6,8,16,10,74
401421316,Southern Utah Thunderbirds,M. Fausett,4397379,,True,25.0,4,11,3,7,1,4,0,0,4,2,6,0,0,0,1,2,9
401421316,Southern Utah Thunderbirds,J. Spurgin,4702155,,True,35.0,3,8,3,7,0,1,2,2,2,0,2,1,0,1,4,3,8
401421316,Southern Utah Thunderbirds,H. Butler,4397380,,True,23.0,2,8,2,6,0,2,1,2,0,7,7,1,1,0,1,0,5
401421316,Southern Utah Thunderbirds,J. Knight III,4397421,,True,29.0,3,7,3,7,0,0,0,0,3,4,7,1,1,0,2,0,6
401421316,Southern Utah Thunderbirds,D. Marin,4278670,,True,35.0,3,12,1,6,2,6,0,0,0,1,1,0,1,0,0,0,8
401421316,Southern Utah Thunderbirds,M. Muhammad,4703561,,False,1.0,0,0,0,0,0,0,0,0,0,0,0,0,0,0,0,0,0
401421316,Southern Utah Thunderbirds,N. Fleming,4702153,,False,20.0,1,7,1,3,0,4,2,2,1,3,4,4,0,0,1,2,4
401421316,Southern Utah Thunderbirds,D. Barnes,4397973,,False,4.0,1,2,1,1,0,1,1,1,0,0,0,0,0,0,0,1,3
401421316,Southern Utah Thunderbirds,M. Moore,4397733,,False,9.0,2,3,1,2,1,1,0,1,0,2,2,1,0,0,0,0,5
401421316,Southern Utah Thunderbirds,A. Moody,4278631,,False,19.0,0,3,0,2,0,1,0,0,0,4,4,2,3,0,1,1,0
401421316,Southern Utah Thunderbirds,TEAM,TOTAL,TOTAL,False,,19,61,15,41,4,20,6,8,12,24,36,10,6,1,12,9,48
401421316,Fresno State Bulldogs,O. Robinson,4593049,,True,27.0,9,15,7,12,2,3,0,0,0,7,7,3,3,0,2,3,20
401421316,Fresno State Bulldogs,L. Colimerio,4703241,,True,29.0,2,5,1,1,1,4,1,2,0,5,5,2,0,1,3,2,6
401421316,Fresno State Bulldogs,D. Whitaker,4703240,,True,31.0,3,4,0,0,3,4,0,0,0,2,2,1,1,0,0,2,9
401421316,Fresno State Bulldogs,I. Hill,4593830,,True,33.0,3,7,1,3,2,4,0,0,0,1,1,7,1,0,1,1,8
401421316,Fresno State Bulldogs,J. Campbell,4397089,,True,30.0,4,8,1,3,3,5,0,0,0,5,5,3,0,1,1,2,11
401421316,Fresno State Bulldogs,B. Meah,4703242,,False,17.0,3,5,3,5,0,0,0,2,2,5,7,0,0,2,2,0,6
401421316,Fresno State Bulldogs,R. Vaihola,4897515,,False,2.0,0,0,0,0,0,0,1,2,0,0,0,0,0,0,0,0,1
401421316,Fresno State Bulldogs,S. Vasquez,4897516,,False,1.0,0,2,0,2,0,0,0,0,0,1,1,0,0,0,0,0,0
401421316,Fresno State Bulldogs,D. Yap,4703386,,False,16.0,1,4,1,3,0,1,0,0,0,1,1,1,3,0,0,3,2
401421316,Fresno State Bulldogs,K. Harding,4703239,,False,3.0,0,0,0,0,0,0,0,0,0,1,1,0,0,0,1,1,0
401421316,Fresno State Bulldogs,D. Stroud,4397866,,False,11.0,2,4,2,4,0,0,0,0,2,3,5,0,1,1,2,1,4
401421316,Fresno State Bulldogs,TEAM,TOTAL,TOTAL,False,,27,54,16,33,11,21,2,6,4,32,36,17,9,5,12,15,67
401415714,UMass Lowell River Hawks,M. Brooks,4700953,,True,32.0,12,16,12,16,0,0,5,6,5,12,17,3,0,2,2,2,29
401415714,UMass Lowell River Hawks,Al. Blunt,4396569,,True,38.0,5,13,4,10,1,3,2,2,4,3,7,2,2,0,0,1,13
401415714,UMass Lowell River Hawks,Q. Mincey,4567710,,True,7.0,1,3,1,3,0,0,1,2,1,1,2,1,0,0,0,0,3
401415714,UMass Lowell River Hawks,K. Thomas,4592912,,True,36.0,5,9,4,4,1,5,1,2,1,6,7,1,0,1,1,1,12
401415714,UMass Lowell River Hawks,A. Hikim,4431843,,True,36.0,5,10,4,7,1,3,3,5,0,0,0,7,1,1,4,2,14
401415714,UMass Lowell River Hawks,J. Hall,4066996,,False,8.0,1,2,1,2,0,0,0,0,1,1,2,0,0,0,1,3,2
401415714,UMass Lowell River Hawks,An. Blunt,4700954,,False,8.0,0,0,0,0,0,0,0,0,0,0,0,0,0,0,0,1,0
401415714,UMass Lowell River Hawks,E. Hammond,4397833,,False,35.0,3,9,3,7,0,2,4,4,0,6,6,0,1,0,2,4,10
401415714,UMass Lowell River Hawks,TEAM,TOTAL,TOTAL,False,,32,62,29,49,3,13,16,21,13,30,43,14,4,4,11,14,83
401415714,Hartford Hawks,J. Kimbrough,4397154,,True,26.0,1,3,1,2,0,1,0,1,2,3,5,2,0,1,2,2,2
401415714,Hartford Hawks,D. Shriver,4902627,,True,36.0,7,13,2,3,5,10,3,4,0,4,4,0,0,1,2,3,22
401415714,Hartford Hawks,B. McClain,4702189,,True,35.0,9,21,7,16,2,5,0,0,1,1,2,2,0,1,1,3,20
401415714,Hartford Hawks,D.J. Mitchell,4395893,,True,38.0,1,8,0,3,1,5,2,2,1,2,3,4,0,0,0,0,5
401415714,Hartford Hawks,T. Carter,3906520,,True,26.0,4,15,3,11,1,4,2,4,3,3,6,4,4,1,1,5,11
401415714,Hartford Hawks,T. Webley,4702191,,False,10.0,2,2,2,2,0,0,0,0,2,1,3,0,0,3,0,0,4
401415714,Hartford Hawks,P. Sow,4285641,,False,1.0,0,0,0,0,0,0,0,0,0,0,0,0,0,0,0,0,0
401415714,Hartford Hawks,C. Edmundo,4902632,,False,2.0,0,0,0,0,0,0,0,0,0,0,0,0,0,0,0,0,0
401415714,Hartford Hawks,K. Henderson,4902628,,False,5.0,0,2,0,0,0,2,2,2,0,0,0,0,0,0,0,1,2
401415714,Hartford Hawks,M. Hobbs,4395891,,False,21.0,3,5,2,2,1,3,0,1,2,1,3,0,1,0,0,3,7
401415714,Hartford Hawks,TEAM,TOTAL,TOTAL,False,,27,69,17,39,10,30,9,14,11,16,27,12,5,7,8,17,73
401415697,Texas A&M Aggies,H. Coleman III,4432186,,True,29.0,3,5,3,5,0,0,4,5,2,3,5,0,2,0,0,2,10
401415697,Texas A&M Aggies,W. Taylor IV,4683833,,True,14.0,3,5,2,2,1,3,3,4,0,3,3,2,0,0,1,3,10
401415697,Texas A&M Aggies,Q. Jackson,4592829,,True,34.0,6,11,5,10,1,1,4,6,1,2,3,2,1,1,5,0,17
401415697,Texas A&M Aggies,M. Obaseki,4433277,,True,23.0,4,12,4,10,0,2,3,3,4,3,7,2,1,0,2,2,11
401415697,Texas A&M Aggies,T. Radford,4395685,,True,32.0,4,11,4,10,0,1,0,0,7,4,11,3,3,0,0,0,8
401415697,Texas A&M Aggies,A. Janecek,4912943,,False,1.0,0,0,0,0,0,0,0,0,0,1,1,0,0,0,0,0,0
401415697,Texas A&M Aggies,E. Henderson,4395706,,False,5.0,1,2,1,2,0,0,0,0,1,0,1,0,1,0,0,1,2
401415697,Texas A&M Aggies,J. Brown,4702024,,False,8.0,1,1,1,1,0,0,0,1,0,2,2,0,0,0,0,1,2
401415697,Texas A&M Aggies,D. Watkins,4896468,,False,1.0,0,0,0,0,0,0,0,0,0,0,0,0,0,0,0,0,0
401415697,Texas A&M Aggies,A. Cash,4896467,,False,6.0,1,1,1,1,0,0,0,0,0,1,1,1,0,0,0,0,2
401415697,Texas A&M Aggies,H. Hefner,4433279,,False,20.0,2,5,1,1,1,4,1,1,0,2,2,2,0,0,1,1,6
401415697,Texas A&M Aggies,H. Diarra,4433160,,False,11.0,1,2,0,0,1,2,0,0,0,0,0,1,0,0,0,1,3
401415697,Texas A&M Aggies,A. Gordon,4431779,,False,15.0,2,3,2,2,0,1,0,0,0,0,0,1,1,0,0,1,4
401415697,Texas A&M Aggies,Z. Walker,4403533,,False,1.0,0,1,0,1,0,0,0,0,0,0,0,0,0,0,0,0,0
401415697,Texas A&M Aggies,TEAM,TOTAL,TOTAL,False,,28,59,24,45,4,14,15,20,16,22,38,14,9,1,10,12,75
401415697,Oregon Ducks,Q. Guerrier,4432996,,True,16.0,1,7,1,3,0,4,1,2,0,2,2,0,0,0,0,1,3
401415697,Oregon Ducks,F. Kepnang,4711400,,True,17.0,0,2,0,2,0,0,2,2,0,1,1,0,0,2,1,1,2
401415697,Oregon Ducks,R. Soares,4898116,,True,31.0,3,10,2,4,1,6,0,0,3,2,5,2,1,1,1,0,7
401415697,Oregon Ducks,D. Harmon,4431703,,True,30.0,5,12,3,7,2,5,0,0,1,1,2,1,1,0,0,2,12
401415697,Oregon Ducks,J. Young,4066326,,True,31.0,2,7,2,4,0,3,2,3,0,0,0,4,1,0,3,3,6
401415697,Oregon Ducks,L. Wur,4565434,,False,8.0,0,1,0,0,0,1,0,0,0,1,1,0,0,0,1,0,0
401415697,Oregon Ducks,N. Dante,4592401,,False,23.0,5,6,5,6,0,0,3,4,8,5,13,2,1,5,2,4,13
401415697,Oregon Ducks,N. Bittle,4432586,,False,12.0,1,2,1,2,0,0,2,2,2,2,4,1,1,0,1,2,4
401415697,Oregon Ducks,E. Williams Jr.,4278490,,False,31.0,4,10,1,5,3,5,2,2,0,2,2,2,1,1,1,4,13
401415697,Oregon Ducks,G. Reichle,4702388,,False,1.0,0,0,0,0,0,0,0,0,0,0,0,0,0,0,0,0,0
401415697,Oregon Ducks,TEAM,TOTAL,TOTAL,False,,21,57,15,33,6,24,12,15,15,19,34,12,6,9,11,17,60
401415696,Xavier Musketeers,J. Nunge,4277948,,True,19.0,4,5,3,4,1,1,3,4,1,7,8,4,1,0,0,1,12
401415696,Xavier Musketeers,C. Jones,4433378,,True,34.0,4,9,4,7,0,2,3,4,0,2,2,5,4,0,4,1,11
401415696,Xavier Musketeers,A. Kunkel,4398300,,True,34.0,2,6,2,3,0,3,1,2,0,4,4,1,1,0,3,3,5
401415696,Xavier Musketeers,P. Scruggs,4278591,,True,19.0,1,4,1,1,0,3,0,0,0,3,3,3,1,1,2,1,2
401415696,Xavier Musketeers,N. Johnson,4067338,,True,35.0,3,13,0,3,3,10,7,9,1,4,5,1,2,0,2,3,16
401415696,Xavier Musketeers,Z. Freemantle,4432869,,False,16.0,5,7,5,7,0,0,0,1,1,6,7,1,1,0,2,1,10
401415696,Xavier Musketeers,J. Hunter,4397011,,False,10.0,2,3,2,2,0,1,0,0,0,1,1,0,0,0,1,3,4
401415696,Xavier Musketeers,C. Edwards,4708074,,False,6.0,1,1,1,1,0,0,0,0,0,2,2,0,0,0,1,0,2
401415696,Xavier Musketeers,D. Odom,4432632,,False,27.0,4,5,4,5,0,0,2,2,2,5,7,3,0,1,3,0,10
401415696,Xavier Musketeers,TEAM,TOTAL,TOTAL,False,,26,53,22,33,4,20,16,22,7,36,43,18,10,2,18,13,72
401415696,Florida Gators,C. Castleton,4397204,,True,32.0,4,8,4,8,0,0,2,3,1,5,6,0,1,0,1,0,10
401415696,Florida Gators,K. Reeves,4683757,,True,25.0,5,11,2,3,3,8,1,2,0,1,1,2,3,0,1,4,14
401415696,Florida Gators,T. Appleby,4280299,,True,29.0,4,12,2,5,2,7,0,0,0,4,4,3,1,0,1,3,10
401415696,Florida Gators,B. McKissic,4280190,,True,25.0,0,4,0,2,0,2,2,2,0,1,1,2,1,0,2,2,2
401415696,Florida Gators,P. Fleming Jr.,4278688,,True,33.0,3,13,3,7,0,6,3,4,3,5,8,3,3,0,3,4,9
401415696,Florida Gators,T. Gatkek,4896453,,False,8.0,1,2,1,2,0,0,0,0,1,0,1,0,1,0,1,4,2
401415696,Florida Gators,E. Kennedy,4879743,,False,5.0,0,0,0,0,0,0,0,0,0,0,0,0,0,0,0,0,0
401415696,Florida Gators,N. Lane,4565449,,False,17.0,3,6,3,6,0,0,0,0,1,2,3,0,0,0,3,1,6
401415696,Florida Gators,A. Klatsky,4432023,,False,0.0,0,0,0,0,0,0,0,0,0,0,0,0,0,0,0,0,0
401415696,Florida Gators,M. Jones,4397238,,False,26.0,1,8,0,1,1,7,0,0,1,3,4,1,4,0,3,1,3
401415696,Florida Gators,TEAM,TOTAL,TOTAL,False,,21,64,15,34,6,30,8,11,9,23,32,11,14,0,15,19,56
401415695,St. Bonaventure Bonnies,O. Osunniyi,4397224,,True,34.0,7,10,7,10,0,0,0,3,5,5,10,1,2,0,2,2,14
401415695,St. Bonaventure Bonnies,J. Adaway,4279431,,True,40.0,4,11,3,7,1,4,2,2,0,3,3,1,2,0,2,1,11
401415695,St. Bonaventure Bonnies,J. Holmes,4701016,,True,40.0,8,12,4,8,4,4,3,4,0,4,4,3,1,1,3,2,23
401415695,St. Bonaventure Bonnies,D. Welch,4397221,,True,40.0,3,8,0,0,3,8,1,2,0,4,4,2,0,0,0,4,10
401415695,St. Bonaventure Bonnies,K. Lofton,4397220,,True,40.0,4,9,2,6,2,3,0,0,0,4,4,3,0,0,3,3,10
401415695,St. Bonaventure Bonnies,A. Coulibaly,4432889,,False,6.0,1,3,1,3,0,0,0,0,0,1,1,0,0,0,0,0,2
401415695,St. Bonaventure Bonnies,J. Ndjock-Tadjore,4897048,,False,0.0,0,0,0,0,0,0,0,0,0,0,0,0,0,0,0,0,0
401415695,St. Bonaventure Bonnies,TEAM,TOTAL,TOTAL,False,,27,53,17,34,10,19,6,11,5,22,27,10,5,1,10,12,70
401415695,Oklahoma Sooners,J. Hill,4592214,,True,38.0,5,9,5,7,0,2,3,3,1,4,5,1,0,0,2,2,13
401415695,Oklahoma Sooners,T. Groves,4278603,,True,22.0,3,9,2,5,1,4,0,0,2,6,8,2,0,0,2,2,7
401415695,Oklahoma Sooners,J. Groves,4592583,,True,21.0,1,4,0,1,1,3,0,0,0,3,3,0,0,0,0,0,3
401415695,Oklahoma Sooners,U. Gibson,4279087,,True,37.0,10,17,4,6,6,11,0,0,1,1,2,2,0,0,3,2,26
401415695,Oklahoma Sooners,J. Goldwire,4277845,,True,26.0,1,6,0,4,1,2,2,2,0,2,2,4,1,0,1,1,5
401415695,Oklahoma Sooners,E. Chargois,4278297,,False,17.0,3,5,3,4,0,1,0,0,1,2,3,6,1,0,2,5,6
401415695,Oklahoma Sooners,C.J. Noland,4694228,,False,17.0,1,1,0,0,1,1,0,1,1,0,1,2,1,0,0,0,3
401415695,Oklahoma Sooners,B. Cortes,4612129,,False,3.0,0,0,0,0,0,0,0,0,0,0,0,1,0,0,0,0,0
401415695,Oklahoma Sooners,M. Johnson,4593466,,False,19.0,2,4,1,2,1,2,0,0,0,4,4,1,1,0,2,0,5
401415695,Oklahoma Sooners,TEAM,TOTAL,TOTAL,False,,26,55,15,29,11,26,5,6,7,22,29,19,4,0,14,12,68
401415694,SMU Mustangs,Ma. Weathers,4067390,,True,34.0,7,13,7,10,0,3,2,2,1,10,11,2,0,0,3,3,16
401415694,SMU Mustangs,E. Bandoumel,4593107,,True,30.0,2,13,1,4,1,9,3,3,2,6,8,4,1,0,1,0,8
401415694,SMU Mustangs,Z. Nutall,4398281,,True,25.0,3,6,2,3,1,3,0,0,0,1,1,2,0,0,0,1,7
401415694,SMU Mustangs,K. Davis,4397066,,True,30.0,4,9,2,5,2,4,0,0,0,3,3,4,1,0,2,2,10
401415694,SMU Mustangs,Mi. Weathers,4067391,,True,38.0,4,6,4,4,0,2,8,8,1,11,12,0,2,3,4,3,16
401415694,SMU Mustangs,F. Agunanne,4397431,,False,14.0,1,3,1,3,0,0,1,2,3,1,4,0,1,1,0,0,3
401415694,SMU Mustangs,T. Clark,4277885,,False,10.0,1,1,1,1,0,0,2,2,0,3,3,2,1,1,1,1,4
401415694,SMU Mustangs,Z. Phelps,4699725,,False,14.0,1,6,1,5,0,1,2,4,2,2,4,2,2,0,2,0,4
401415694,SMU Mustangs,J. Smith,4690767,,False,5.0,0,1,0,0,0,1,0,0,0,0,0,0,0,0,0,0,0
401415694,SMU Mustangs,TEAM,TOTAL,TOTAL,False,,23,58,19,35,4,23,18,21,11,38,49,16,8,5,15,10,68
401415694,Nicholls Colonels,R. Lyons,4278303,,True,27.0,2,6,1,2,1,4,0,0,0,2,2,1,0,4,3,4,5
401415694,Nicholls Colonels,J. McGhee,4897324,,True,2.0,0,2,0,1,0,1,0,0,0,0,0,0,1,0,0,0,0
401415694,Nicholls Colonels,P. Spencer,4703670,,True,30.0,1,2,1,1,0,1,0,0,1,6,7,1,0,0,0,4,2
401415694,Nicholls Colonels,C. Huffman,4703557,,True,3.0,0,1,0,1,0,0,0,0,1,0,1,0,0,0,1,0,0
401415694,Nicholls Colonels,Ty Gordon,4599257,,True,35.0,2,15,0,4,2,11,0,0,0,1,1,3,0,0,3,3,6
401415694,Nicholls Colonels,M. Littles,4897327,,False,30.0,3,9,3,8,0,1,1,3,2,8,10,1,0,0,0,3,7
401415694,Nicholls Colonels,J. White,4703532,,False,3.0,0,1,0,0,0,1,0,0,0,1,1,0,0,0,0,1,0
401415694,Nicholls Colonels,L. Jones,4701200,,False,31.0,7,16,4,8,3,8,1,2,2,2,4,3,4,0,2,2,18
401415694,Nicholls Colonels,T. Terrell,4593810,,False,2.0,0,0,0,0,0,0,0,0,0,0,0,0,0,0,0,0,0
401415694,Nicholls Colonels,D. Carter,4593407,,False,37.0,9,16,8,13,1,3,1,4,1,4,5,7,2,0,2,1,20
401415694,Nicholls Colonels,TEAM,TOTAL,TOTAL,False,,24,68,17,38,7,30,3,9,9,26,35,16,7,4,11,18,58
401415693,Saint Louis Billikens,F. Okoro,4397105,,True,31.0,6,10,6,10,0,0,0,0,5,8,13,2,0,0,2,2,12
401415693,Saint Louis Billikens,J. Nesbitt,4714246,,True,24.0,1,5,0,2,1,3,5,8,1,3,4,0,0,0,1,0,8
401415693,Saint Louis Billikens,G. Jimerson,4432008,,True,40.0,7,17,3,8,4,9,2,2,1,3,4,1,2,0,1,0,20
401415693,Saint Louis Billikens,F. Thatch Jr.,4397199,,True,32.0,5,12,5,9,0,3,1,2,2,6,8,5,0,0,4,1,11
401415693,Saint Louis Billikens,D. Jones,4278267,,True,27.0,1,3,1,1,0,2,4,4,1,1,2,4,0,1,3,2,6
401415693,Saint Louis Billikens,T. Hargrove Jr.,4592484,,False,16.0,2,3,2,3,0,0,0,0,0,2,2,0,1,0,1,0,4
401415693,Saint Louis Billikens,M. Linssen,4279174,,False,9.0,1,3,1,3,0,0,0,0,1,1,2,0,0,0,1,2,2
401415693,Saint Louis Billikens,M. Strickland,4432494,,False,18.0,2,5,2,5,0,0,1,1,0,1,1,1,0,0,0,3,5
401415693,Saint Louis Billikens,R. Williams,4399106,,False,3.0,0,2,0,1,0,1,0,0,0,0,0,0,0,0,0,0,0
401415693,Saint Louis Billikens,TEAM,TOTAL,TOTAL,False,,25,60,20,42,5,18,13,17,12,27,39,13,3,1,13,10,68
401415693,Northern Iowa Panthers,N. Carter,4431923,,True,29.0,7,14,6,7,1,7,4,4,0,4,4,5,1,0,4,3,19
401415693,Northern Iowa Panthers,N. Heise,4703912,,True,27.0,3,5,2,2,1,3,0,2,0,2,2,1,3,0,0,1,7
401415693,Northern Iowa Panthers,AJ Green,4397475,,True,35.0,7,15,2,5,5,10,2,2,0,4,4,3,3,0,0,3,21
401415693,Northern Iowa Panthers,T. Berhow,4280203,,True,38.0,6,12,0,2,6,10,0,0,1,6,7,0,0,0,2,2,18
401415693,Northern Iowa Panthers,T. Pickford,4279167,,True,25.0,2,3,1,1,1,2,0,0,1,2,3,1,1,0,0,0,5
401415693,Northern Iowa Panthers,A. Phyfe,4279169,,False,11.0,0,1,0,1,0,0,2,2,1,2,3,1,0,1,2,2,2
401415693,Northern Iowa Panthers,T. Anderson,4703914,,False,7.0,0,2,0,2,0,0,0,0,1,1,2,0,0,0,0,0,0
401415693,Northern Iowa Panthers,B. Born,4703913,,False,26.0,3,6,1,1,2,5,0,0,0,2,2,3,2,0,0,4,8
401415693,Northern Iowa Panthers,A. Kimmons,4433020,,False,2.0,0,0,0,0,0,0,0,0,0,0,0,0,0,0,0,0,0
401415693,Northern Iowa Panthers,TEAM,TOTAL,TOTAL,False,,28,58,12,21,16,37,8,10,4,25,29,14,10,1,9,15,80
401415692,Wake Forest Demon Deacons,D. Walton,4066353,,True,26.0,5,11,5,9,0,2,7,7,1,6,7,1,0,2,1,3,17
401415692,Wake Forest Demon Deacons,I. Mucius,4395686,,True,28.0,5,7,4,5,1,2,1,2,1,0,1,2,1,2,3,5,12
401415692,Wake Forest Demon Deacons,J. LaRavia,4592691,,True,37.0,4,8,3,5,1,3,0,0,1,7,8,5,2,1,7,1,9
401415692,Wake Forest Demon Deacons,A. Williams,4592216,,True,32.0,2,5,2,4,0,1,2,2,0,6,6,5,0,0,0,0,6
401415692,Wake Forest Demon Deacons,D. Williamson,4398180,,True,34.0,1,5,0,1,1,4,4,6,0,6,6,1,0,0,0,0,7
401415692,Wake Forest Demon Deacons,K. Sy,4065740,,False,12.0,0,1,0,0,0,1,2,4,1,4,5,0,0,0,2,1,2
401415692,Wake Forest Demon Deacons,M. Marsh,4897407,,False,5.0,1,1,1,1,0,0,0,0,0,0,0,0,0,0,0,0,2
401415692,Wake Forest Demon Deacons,C. Hildreth,4696316,,False,13.0,1,1,1,1,0,0,3,5,0,3,3,0,1,1,3,2,5
401415692,Wake Forest Demon Deacons,D. Monsanto,4432916,,False,13.0,5,10,1,2,4,8,0,3,3,0,3,0,1,0,1,0,14
401415692,Wake Forest Demon Deacons,TEAM,TOTAL,TOTAL,False,,24,49,17,28,7,21,19,29,8,34,42,14,5,6,18,12,74
401415692,Towson Tigers,C. Thompson,4433103,,True,29.0,7,15,7,15,0,0,1,2,3,5,8,0,2,2,0,4,15
401415692,Towson Tigers,C. Holden,4703407,,True,30.0,3,7,3,5,0,2,3,6,1,2,3,5,4,0,4,4,9
401415692,Towson Tigers,J. Gibson,4592985,,True,29.0,4,4,0,0,4,4,0,0,0,2,2,0,0,0,2,2,12
401415692,Towson Tigers,N. Timberlake,4397595,,True,36.0,3,13,0,5,3,8,3,4,2,6,8,3,1,0,0,3,12
401415692,Towson Tigers,A. Rizzuto,4395873,,True,19.0,1,5,1,1,0,4,2,2,1,1,2,1,0,0,2,1,4
401415692,Towson Tigers,C. Biekeu,4702788,,False,1.0,0,0,0,0,0,0,0,0,0,0,0,0,0,0,0,0,0
401415692,Towson Tigers,C. Paar,4432076,,False,10.0,1,3,1,3,0,0,0,0,0,1,1,0,0,0,1,2,2
401415692,Towson Tigers,J. Gray,4066744,,False,14.0,1,4,1,2,0,2,0,0,0,1,1,0,0,0,0,2,2
401415692,Towson Tigers,T. Nolan Jr.,4278494,,False,31.0,3,15,2,7,1,8,1,2,2,3,5,4,4,1,3,3,8
401415692,Towson Tigers,TEAM,TOTAL,TOTAL,False,,23,66,15,38,8,28,10,16,12,22,34,13,11,3,12,21,64
401415691,VCU Rams,H. Ward,4592495,,True,22.0,4,6,4,6,0,0,0,0,1,3,4,1,0,1,0,1,8
401415691,VCU Rams,V. Williams Jr.,4397227,,True,37.0,6,9,3,3,3,6,2,2,1,10,11,6,2,0,1,2,17
401415691,VCU Rams,J. Nunn,4896614,,True,36.0,5,8,5,7,0,1,3,6,0,0,0,1,1,1,0,2,13
401415691,VCU Rams,A. Baldwin Jr.,4433182,,True,37.0,8,14,6,12,2,2,5,5,1,4,5,5,0,0,4,2,23
401415691,VCU Rams,K. Curry,4397228,,True,34.0,10,16,9,13,1,3,2,3,2,2,4,2,3,0,2,1,23
401415691,VCU Rams,M. Brown-Jones,4433224,,False,5.0,1,1,1,1,0,0,0,0,1,1,2,1,0,0,0,0,2
401415691,VCU Rams,J. DeLoach,4432483,,False,15.0,1,4,1,4,0,0,0,0,1,1,2,0,0,2,0,3,2
401415691,VCU Rams,L. Stockard III,4277897,,False,3.0,0,0,0,0,0,0,0,0,0,1,1,0,0,1,0,2,0
401415691,VCU Rams,N. Kern,4684145,,False,7.0,1,2,1,2,0,0,0,0,0,0,0,0,1,0,0,0,2
401415691,VCU Rams,M. Tsohonis,4592438,,False,4.0,0,2,0,2,0,0,0,0,0,1,1,0,0,0,0,0,0
401415691,VCU Rams,TEAM,TOTAL,TOTAL,False,,36,62,30,50,6,12,12,16,7,26,33,16,7,5,7,13,90
401415691,Princeton Tigers,T. Evbuomwan,4597865,,True,39.0,9,14,9,14,0,0,4,10,7,5,12,7,2,0,5,5,22
401415691,Princeton Tigers,D. Friberg,4398004,,True,39.0,2,5,1,1,1,4,0,1,0,5,5,2,0,0,1,1,5
401415691,Princeton Tigers,R. Langborg,4597863,,True,33.0,6,7,2,2,4,5,0,0,0,3,3,0,0,0,0,2,16
401415691,Princeton Tigers,E. Wright,4398005,,True,37.0,8,20,6,13,2,7,0,0,2,5,7,2,1,0,0,2,18
401415691,Princeton Tigers,J. Llewellyn,4398002,,True,40.0,6,17,5,10,1,7,0,0,1,3,4,1,1,0,2,1,13
401415691,Princeton Tigers,E. Barnes,4279567,,False,1.0,1,1,1,1,0,0,0,0,0,0,0,0,0,0,0,0,2
401415691,Princeton Tigers,B. Peters,4898233,,False,0.0,0,0,0,0,0,0,0,0,0,0,0,0,0,0,0,0,0
401415691,Princeton Tigers,M. Allocco,4898232,,False,11.0,1,2,0,0,1,2,0,0,1,0,1,1,0,0,2,2,3
401415691,Princeton Tigers,M. Johns,4398003,,False,0.0,0,1,0,1,0,0,0,0,0,0,0,0,0,0,0,0,0
401415691,Princeton Tigers,C. Bagin,4279564,,False,0.0,0,1,0,0,0,1,0,0,0,0,0,0,0,0,0,0,0
401415691,Princeton Tigers,TEAM,TOTAL,TOTAL,False,,33,68,24,42,9,26,4,11,13,22,35,13,4,0,10,13,79
401414990,Southern Utah Thunderbirds,M. Fausett,4397379,,True,22.0,2,6,2,4,0,2,3,3,2,5,7,1,0,0,2,3,7
401414990,Southern Utah Thunderbirds,J. Spurgin,4702155,,True,38.0,2,6,2,5,0,1,1,2,2,3,5,0,1,2,2,2,5
401414990,Southern Utah Thunderbirds,J. Knight III,4397421,,True,37.0,5,12,4,9,1,3,1,2,1,2,3,4,2,1,2,4,12
401414990,Southern Utah Thunderbirds,T. Jones,4397000,,True,15.0,0,2,0,0,0,2,0,0,0,2,2,0,0,0,0,1,0
401414990,Southern Utah Thunderbirds,D. Marin,4278670,,True,31.0,4,14,1,8,3,6,0,0,2,3,5,0,3,0,2,4,11
401414990,Southern Utah Thunderbirds,N. Fleming,4702153,,False,6.0,0,0,0,0,0,0,0,0,0,0,0,0,0,0,0,1,0
401414990,Southern Utah Thunderbirds,D. Barnes,4397973,,False,3.0,0,2,0,1,0,1,0,0,0,0,0,0,0,0,0,0,0
401414990,Southern Utah Thunderbirds,H. Butler,4397380,,False,19.0,2,6,1,5,1,1,3,4,0,3,3,0,1,0,1,3,8
401414990,Southern Utah Thunderbirds,A. Moody,4278631,,False,29.0,4,9,4,7,0,2,2,2,0,2,2,0,0,0,3,0,10
401414990,Southern Utah Thunderbirds,TEAM,TOTAL,TOTAL,False,,19,57,14,39,5,18,10,13,8,21,29,5,7,3,12,18,53
401414990,Montana State Bobcats,J. Belo,4592617,,True,32.0,4,9,4,9,0,0,3,3,2,7,9,2,1,3,3,1,11
401414990,Montana State Bobcats,A. Mohamed,4397559,,True,28.0,3,5,2,4,1,1,0,0,0,5,5,1,1,1,1,3,7
401414990,Montana State Bobcats,T. Patterson,4702074,,True,18.0,0,1,0,0,0,1,2,2,0,0,0,0,2,0,0,0,2
401414990,Montana State Bobcats,A. Adamu,4592615,,True,31.0,5,13,4,9,1,4,2,2,1,5,6,2,0,1,0,1,13
401414990,Montana State Bobcats,X. Bishop,4067581,,True,40.0,9,14,8,10,1,4,9,9,0,1,1,2,0,0,5,2,28
401414990,Montana State Bobcats,S. Lecholat,4897926,,False,4.0,0,0,0,0,0,0,0,0,0,1,1,0,0,1,0,0,0
401414990,Montana State Bobcats,G. Osobor,4897921,,False,15.0,1,1,1,1,0,0,1,2,1,7,8,1,0,0,4,0,3
401414990,Montana State Bobcats,K. Tynes,4702078,,False,1.0,0,0,0,0,0,0,1,2,0,1,1,0,0,0,0,0,1
401414990,Montana State Bobcats,N. Gazelas,4702072,,False,15.0,0,2,0,0,0,2,0,2,1,0,1,1,0,0,0,0,0
401414990,Montana State Bobcats,R. Battle,4431726,,False,16.0,1,4,1,3,0,1,2,2,0,0,0,0,0,1,1,4,4
401414990,Montana State Bobcats,TEAM,TOTAL,TOTAL,False,,23,49,20,36,3,13,20,24,6,32,38,9,4,7,14,11,69
401413556,Ohio State Buckeyes,E.J. Liddell,4432821,,True,39.0,7,17,5,11,2,6,11,13,5,9,14,1,1,6,2,3,27
401413556,Ohio State Buckeyes,K. Young,4277974,,True,8.0,1,3,1,2,0,1,0,0,1,1,2,0,0,1,1,2,2
401413556,Ohio State Buckeyes,E. Brown III,4433179,,True,26.0,2,5,2,4,0,1,2,2,3,1,4,3,0,0,0,1,6
401413556,Ohio State Buckeyes,M. Branham,4565201,,True,33.0,5,11,3,7,2,4,4,6,0,2,2,2,0,0,3,5,16
401413556,Ohio State Buckeyes,J. Wheeler,4277978,,True,31.0,3,5,3,3,0,2,0,0,1,3,4,0,0,0,2,2,6
401413556,Ohio State Buckeyes,H. Hookfin,4412299,,False,2.0,0,0,0,0,0,0,0,0,0,0,0,0,0,0,0,0,0
401413556,Ohio State Buckeyes,J. Brunk,4065763,,False,4.0,0,2,0,2,0,0,0,0,0,1,1,0,0,0,0,1,0
401413556,Ohio State Buckeyes,J. Ahrens,4397236,,False,22.0,1,4,0,1,1,3,0,0,1,2,3,2,0,0,0,2,3
401413556,Ohio State Buckeyes,M. Johnson Jr.,4710770,,False,2.0,0,2,0,0,0,2,0,0,0,0,0,0,0,0,0,0,0
401413556,Ohio State Buckeyes,C. Russell,4280257,,False,10.0,1,5,1,2,0,3,0,1,0,1,1,0,0,0,0,0,2
401413556,Ohio State Buckeyes,J. Sotos,4280044,,False,23.0,2,3,0,1,2,2,2,2,0,2,2,2,1,0,0,1,8
401413556,Ohio State Buckeyes,TEAM,TOTAL,TOTAL,False,,22,57,15,33,7,24,19,24,14,25,39,10,2,7,8,17,70
401413556,Nebraska Cornhuskers,D. Walker,4278113,,True,13.0,2,2,2,2,0,0,0,1,1,4,5,0,0,0,0,4,4
401413556,Nebraska Cornhuskers,L. Mayen,4277914,,True,26.0,1,4,0,0,1,4,3,4,0,2,2,0,0,1,0,3,6
401413556,Nebraska Cornhuskers,A. Verge Jr.,4592358,,True,35.0,5,14,4,12,1,2,2,2,0,5,5,11,0,0,1,1,13
401413556,Nebraska Cornhuskers,B. McGowens,4576086,,True,37.0,8,15,6,8,2,7,8,9,0,4,4,0,0,0,2,1,26
401413556,Nebraska Cornhuskers,T. McGowens,4395670,,True,32.0,3,5,2,3,1,2,0,0,1,5,6,0,4,0,0,5,7
401413556,Nebraska Cornhuskers,E. Andre,4702281,,False,9.0,1,1,1,1,0,0,0,0,1,2,3,0,0,0,0,3,2
401413556,Nebraska Cornhuskers,C.J. Wilcher,4432590,,False,33.0,6,11,3,6,3,5,0,0,1,1,2,0,1,0,1,2,15
401413556,Nebraska Cornhuskers,K. Webster,4279535,,False,15.0,1,3,0,0,1,3,2,2,0,1,1,1,0,0,0,1,5
401413556,Nebraska Cornhuskers,TEAM,TOTAL,TOTAL,False,,27,55,18,32,9,23,15,18,4,24,28,12,5,1,4,20,78
401413411,USC Trojans,I. Mobley,4432815,,True,34.0,3,12,2,9,1,3,2,2,3,8,11,1,1,1,1,4,9
401413411,USC Trojans,C. Goodwin,4067218,,True,19.0,4,5,4,5,0,0,2,3,2,0,2,0,0,1,3,4,10
401413411,USC Trojans,B. Ellis,4593106,,True,23.0,3,11,3,8,0,3,3,3,1,2,3,1,0,0,1,0,9
401413411,USC Trojans,E. Anderson,4431808,,True,21.0,0,2,0,2,0,0,0,0,0,0,0,2,2,1,0,1,0
401413411,USC Trojans,D. Peterson,4397689,,True,32.0,2,11,2,5,0,6,6,8,2,3,5,4,1,1,1,1,10
401413411,USC Trojans,H. Hornery,4433617,,False,5.0,1,2,1,1,0,1,0,0,1,0,1,0,0,0,0,0,2
401413411,USC Trojans,J. Morgan,4431830,,False,11.0,4,6,4,6,0,0,0,0,3,2,5,0,0,1,0,1,8
401413411,USC Trojans,M. Agbonkpolo,4431700,,False,22.0,6,10,4,8,2,2,0,0,1,2,3,1,1,1,2,2,14
401413411,USC Trojans,K. Johnson,4683857,,False,13.0,0,3,0,1,0,2,0,0,0,2,2,0,0,0,1,2,0
401413411,USC Trojans,R. Waters,4711593,,False,20.0,4,6,3,5,1,1,0,0,2,1,3,0,0,0,3,1,9
401413411,USC Trojans,TEAM,TOTAL,TOTAL,False,,27,68,23,50,4,18,13,16,19,21,40,9,5,6,12,16,71
401413411,Arizona Wildcats,A. Tubelis,4702372,,True,21.0,2,5,1,4,1,1,1,2,1,3,4,3,1,0,1,2,6
401413411,Arizona Wildcats,C. Koloko,4431778,,True,16.0,4,5,4,5,0,0,1,2,0,1,1,0,0,2,0,4,9
401413411,Arizona Wildcats,B. Mathurin,4683634,,True,33.0,7,13,4,7,3,6,2,2,1,4,5,6,3,0,1,2,19
401413411,Arizona Wildcats,K. Kriisa,4683633,,True,36.0,5,13,1,3,4,10,4,4,2,2,4,4,1,0,0,1,18
401413411,Arizona Wildcats,D. Terry,4433159,,True,33.0,5,8,4,5,1,3,0,0,1,4,5,4,1,0,4,3,11
401413411,Arizona Wildcats,O. Ballo,4594109,,False,24.0,5,7,5,7,0,0,1,3,1,4,5,0,0,1,0,1,11
401413411,Arizona Wildcats,P. Larsson,4601025,,False,13.0,2,4,1,3,1,1,0,0,0,0,0,2,1,0,1,3,5
401413411,Arizona Wildcats,J. Kier,4066863,,False,24.0,5,8,3,4,2,4,0,0,1,5,6,2,1,0,0,1,12
401413411,Arizona Wildcats,TEAM,TOTAL,TOTAL,False,,35,63,23,38,12,25,9,13,8,23,31,21,8,3,7,17,91
401412488,Michigan Wolverines,M. Diabate,4433249,,True,24.0,3,5,3,5,0,0,0,0,0,2,2,2,0,0,2,4,6
401412488,Michigan Wolverines,C. Houstan,4433623,,True,27.0,4,7,2,5,2,2,6,7,2,2,4,0,1,0,1,2,16
401412488,Michigan Wolverines,H. Dickinson,4432180,,True,32.0,13,19,13,18,0,1,7,9,3,6,9,1,0,4,1,3,33
401412488,Michigan Wolverines,D. Jones,4397506,,True,22.0,4,5,3,4,1,1,0,0,0,4,4,1,0,0,3,3,9
401412488,Michigan Wolverines,E. Brooks,4277960,,True,38.0,4,11,4,9,0,2,0,0,0,3,3,3,0,0,1,1,8
401412488,Michigan Wolverines,T. Williams II,4702236,,False,22.0,3,4,0,0,3,4,0,0,0,4,4,1,0,0,0,1,9
401412488,Michigan Wolverines,B. Johns Jr.,4397206,,False,6.0,1,1,0,0,1,1,2,2,1,0,1,0,0,0,0,0,5
401412488,Michigan Wolverines,J. Faulds,4279471,,False,2.0,0,0,0,0,0,0,1,2,0,0,0,0,1,0,0,2,1
401412488,Michigan Wolverines,K. Bufkin,4683736,,False,9.0,0,1,0,0,0,1,0,0,0,0,0,2,1,0,0,1,0
401412488,Michigan Wolverines,J. Howard,4611541,,False,2.0,0,0,0,0,0,0,0,0,0,0,0,0,0,0,1,1,0
401412488,Michigan Wolverines,F. Collins,4433616,,False,14.0,0,2,0,2,0,0,0,2,0,3,3,4,2,0,2,0,0
401412488,Michigan Wolverines,A. Nuñez,4397203,,False,2.0,0,0,0,0,0,0,0,0,0,0,0,0,0,0,0,0,0
401412488,Michigan Wolverines,TEAM,TOTAL,TOTAL,False,,32,55,25,43,7,12,16,22,7,26,33,14,5,4,11,18,87
401412488,Michigan State Spartans,M. Hall,4592693,,True,19.0,1,3,1,3,0,0,3,5,1,2,3,1,0,0,0,1,5
401412488,Michigan State Spartans,J. Marble II,4433031,,True,17.0,2,8,2,8,0,0,0,1,1,3,4,1,1,0,2,4,4
401412488,Michigan State Spartans,G. Brown,4397210,,True,24.0,5,9,3,4,2,5,0,0,0,3,3,3,0,0,0,3,12
401412488,Michigan State Spartans,M. Christie,4432582,,True,31.0,4,12,4,10,0,2,1,1,0,2,2,0,3,0,3,1,9
401412488,Michigan State Spartans,T. Walker,4432129,,True,29.0,4,9,4,7,0,2,3,4,0,1,1,4,1,0,0,1,11
401412488,Michigan State Spartans,K. Coleman,4635008,,False,2.0,0,1,0,0,0,1,0,0,0,0,0,0,1,0,1,0,0
401412488,Michigan State Spartans,M. Bingham Jr.,4397212,,False,9.0,1,3,1,2,0,1,0,0,0,2,2,0,0,2,0,2,2
401412488,Michigan State Spartans,J. Hauser,4295180,,False,22.0,3,4,2,2,1,2,1,2,2,2,4,1,0,0,1,4,8
401412488,Michigan State Spartans,P. Brooks,4683731,,False,7.0,1,2,1,1,0,1,0,0,0,0,0,0,0,0,0,0,2
401412488,Michigan State Spartans,M. Sissoko,4433154,,False,11.0,3,3,3,3,0,0,3,5,2,1,3,0,1,2,1,4,9
401412488,Michigan State Spartans,D. Smith,4702244,,False,2.0,0,0,0,0,0,0,0,1,0,0,0,0,0,0,0,0,0
401412488,Michigan State Spartans,J. Akins,4683730,,False,16.0,2,3,0,1,2,2,0,0,0,2,2,1,0,0,1,0,6
401412488,Michigan State Spartans,A. Hoggard,4432206,,False,11.0,1,2,1,2,0,0,0,0,1,0,1,0,0,0,1,1,2
401412488,Michigan State Spartans,TEAM,TOTAL,TOTAL,False,,27,59,22,43,5,16,11,19,9,19,28,11,7,4,10,21,70
401412470,TCU Horned Frogs,E. Miller,4432872,,True,34.0,9,14,9,13,0,1,0,0,1,5,6,0,1,0,1,0,18
401412470,TCU Horned Frogs,C. O'Bannon Jr.,4278533,,True,22.0,2,6,1,2,1,4,5,5,1,1,2,0,0,1,2,2,10
401412470,TCU Horned Frogs,E. Lampkin,4433191,,True,25.0,3,5,3,5,0,0,1,2,2,7,9,2,1,2,0,4,7
401412470,TCU Horned Frogs,M. Miles,4432550,,True,29.0,2,12,1,7,1,5,0,0,1,2,3,3,0,0,2,4,5
401412470,TCU Horned Frogs,D. Baugh,4431766,,True,35.0,6,11,6,9,0,2,2,2,2,3,5,4,3,0,4,3,14
401412470,TCU Horned Frogs,S. Doumbia,4897753,,False,1.0,0,0,0,0,0,0,0,0,0,0,0,0,0,0,0,0,0
401412470,TCU Horned Frogs,X. Cork,4593722,,False,13.0,2,3,2,3,0,0,0,0,0,2,2,1,0,1,2,3,4
401412470,TCU Horned Frogs,J. Coles,4432282,,False,4.0,1,1,0,0,1,1,0,0,0,0,0,0,1,0,1,3,3
401412470,TCU Horned Frogs,M. Peavy,4432185,,False,17.0,1,3,1,2,0,1,0,0,1,1,2,1,1,0,1,3,2
401412470,TCU Horned Frogs,F. Farabello,4431952,,False,20.0,1,2,0,0,1,2,2,2,0,2,2,3,0,0,2,0,5
401412470,TCU Horned Frogs,TEAM,TOTAL,TOTAL,False,,27,57,23,41,4,16,10,11,8,25,33,14,7,4,15,22,68
401412470,Kansas Jayhawks,J. Wilson,4431714,,True,34.0,2,4,2,3,0,1,5,7,1,9,10,3,2,1,0,2,9
401412470,Kansas Jayhawks,D. McCormack,4397019,,True,27.0,2,7,2,7,0,0,6,6,1,3,4,1,0,0,1,3,10
401412470,Kansas Jayhawks,D. Harris,4431983,,True,34.0,5,9,4,8,1,1,0,0,1,0,1,3,2,1,1,1,11
401412470,Kansas Jayhawks,C. Braun,4431767,,True,35.0,4,4,2,2,2,2,2,4,2,4,6,1,1,0,2,1,12
401412470,Kansas Jayhawks,O. Agbaji,4397018,,True,39.0,8,19,6,10,2,9,4,4,0,1,1,1,1,1,4,1,22
401412470,Kansas Jayhawks,Z. Clemence,4683146,,False,2.0,0,2,0,0,0,2,1,2,0,0,0,0,0,1,0,0,1
401412470,Kansas Jayhawks,K.J. Adams,4433259,,False,0.0,0,0,0,0,0,0,0,0,0,0,0,0,0,0,0,1,0
401412470,Kansas Jayhawks,M. Lightfoot,4066300,,False,10.0,2,2,2,2,0,0,0,0,0,3,3,0,2,0,1,3,4
401412470,Kansas Jayhawks,J. Yesufu,4431856,,False,12.0,1,5,0,3,1,2,0,0,0,0,0,1,0,0,1,0,3
401412470,Kansas Jayhawks,R. Martin,4278133,,False,4.0,0,2,0,1,0,1,0,0,0,0,0,0,1,0,0,0,0
401412470,Kansas Jayhawks,J. Coleman-Lands,3911842,,False,3.0,0,1,0,0,0,1,0,0,2,0,2,0,0,0,0,0,0
401412470,Kansas Jayhawks,TEAM,TOTAL,TOTAL,False,,24,55,18,36,6,19,18,23,9,21,30,10,9,4,11,12,72
401411742,Wagner Seahawks,R. Rogers,4289551,,True,24.0,6,8,6,7,0,1,0,0,3,2,5,0,1,0,4,2,12
401411742,Wagner Seahawks,Z. Williams,4897951,,True,26.0,1,8,0,2,1,6,0,0,1,2,3,1,2,0,0,4,3
401411742,Wagner Seahawks,D. Hunt,4703199,,True,37.0,1,6,1,2,0,4,0,1,1,2,3,4,2,0,2,1,2
401411742,Wagner Seahawks,W. Martinez,4593037,,True,31.0,3,8,3,7,0,1,1,2,1,4,5,2,2,0,3,1,7
401411742,Wagner Seahawks,A. Morales,4593034,,True,35.0,0,16,0,13,0,3,3,5,3,5,8,2,1,2,3,3,3
401411742,Wagner Seahawks,R. Taylor II,4897952,,False,2.0,1,1,1,1,0,0,0,0,1,0,1,0,0,0,0,0,2
401411742,Wagner Seahawks,J. Fletcher,4593038,,False,15.0,0,1,0,1,0,0,0,0,1,0,1,0,0,2,0,3,0
401411742,Wagner Seahawks,J. Price-Noel,4397675,,False,20.0,3,6,1,2,2,4,2,2,0,0,0,0,0,0,0,0,10
401411742,Wagner Seahawks,N. Jackson,4279882,,False,3.0,0,1,0,0,0,1,0,0,0,0,0,0,0,0,0,1,0
401411742,Wagner Seahawks,J. Ezquerra,4902635,,False,5.0,2,3,2,2,0,1,0,0,0,0,0,0,1,0,2,0,4
401411742,Wagner Seahawks,J. Mason,4593035,,False,2.0,0,0,0,0,0,0,0,0,0,0,0,0,0,0,0,0,0
401411742,Wagner Seahawks,TEAM,TOTAL,TOTAL,False,,17,58,14,37,3,21,6,10,13,16,29,9,9,4,14,15,43
401411742,Bryant Bulldogs,H. Elisias,4593267,,True,24.0,2,2,2,2,0,0,0,0,2,2,4,0,1,8,0,2,4
401411742,Bryant Bulldogs,A. Eleeda,4593304,,True,34.0,1,8,0,1,1,7,2,2,2,2,4,2,1,0,1,0,5
401411742,Bryant Bulldogs,C. Pride,4593263,,True,38.0,4,10,3,8,1,2,4,4,4,13,17,0,1,0,2,1,13
401411742,Bryant Bulldogs,L. Hurtado,4279105,,True,22.0,2,2,2,2,0,0,1,4,0,3,3,4,1,0,2,2,5
401411742,Bryant Bulldogs,P. Kiss,4070686,,True,38.0,13,23,9,18,4,5,4,5,2,4,6,3,5,0,4,1,34
401411742,Bryant Bulldogs,J. Ozabor,4898366,,False,2.0,0,0,0,0,0,0,0,0,0,0,0,0,0,0,0,0,0
401411742,Bryant Bulldogs,G. Calixte,4278362,,False,14.0,2,2,2,2,0,0,0,0,3,2,5,0,2,1,1,4,4
401411742,Bryant Bulldogs,M. Iuzzolino,4898365,,False,2.0,0,0,0,0,0,0,0,0,0,0,0,0,0,0,0,0,0
401411742,Bryant Bulldogs,E. Bans,4703138,,False,2.0,0,0,0,0,0,0,0,0,0,0,0,0,0,0,0,0,0
401411742,Bryant Bulldogs,T. Brelsford,4606833,,False,22.0,2,7,1,3,1,4,0,0,0,2,2,2,0,0,3,3,5
401411742,Bryant Bulldogs,T. Kiggins,4593264,,False,1.0,0,1,0,0,0,1,0,0,0,0,0,0,0,0,1,0,0
401411742,Bryant Bulldogs,TEAM,TOTAL,TOTAL,False,,26,55,19,36,7,19,11,15,14,31,45,11,11,9,18,13,70
401411741,Wagner Seahawks,R. Rogers,4289551,,True,28.0,3,6,3,6,0,0,2,2,3,8,11,2,2,2,2,3,8
401411741,Wagner Seahawks,J. Price-Noel,4397675,,True,11.0,2,3,1,1,1,2,0,0,0,1,1,0,0,0,0,4,5
401411741,Wagner Seahawks,D. Hunt,4703199,,True,35.0,6,10,3,5,3,5,2,3,0,1,1,3,4,0,1,2,17
401411741,Wagner Seahawks,W. Martinez,4593037,,True,32.0,3,9,3,7,0,2,2,2,0,5,5,3,0,0,2,3,8
401411741,Wagner Seahawks,A. Morales,4593034,,True,38.0,7,17,7,13,0,4,5,6,0,7,7,4,2,0,4,2,19
401411741,Wagner Seahawks,R. Taylor II,4897952,,False,2.0,1,1,1,1,0,0,2,2,0,2,2,0,0,0,0,0,4
401411741,Wagner Seahawks,J. Fletcher,4593038,,False,10.0,2,2,2,2,0,0,1,1,2,3,5,0,1,0,0,5,5
401411741,Wagner Seahawks,N. Jackson,4279882,,False,14.0,2,4,0,0,2,4,0,0,0,1,1,0,1,0,0,2,6
401411741,Wagner Seahawks,J. Ezquerra,4902635,,False,8.0,0,1,0,0,0,1,0,0,0,0,0,0,0,0,0,2,0
401411741,Wagner Seahawks,Z. Williams,4897951,,False,21.0,3,5,1,2,2,3,2,3,0,1,1,0,0,0,0,0,10
401411741,Wagner Seahawks,J. Mason,4593035,,False,1.0,0,1,0,0,0,1,0,0,0,0,0,0,0,0,0,1,0
401411741,Wagner Seahawks,TEAM,TOTAL,TOTAL,False,,29,59,21,37,8,22,16,19,8,31,39,12,10,2,9,24,82
401411741,Long Island University Sharks,T. Flowers,4703209,,True,39.0,10,20,7,13,3,7,1,1,2,6,8,1,1,1,3,1,24
401411741,Long Island University Sharks,E. Penn,4279628,,True,30.0,4,10,4,7,0,3,7,10,2,1,3,1,1,1,3,4,15
401411741,Long Island University Sharks,I. Kante,4278066,,True,30.0,6,9,6,9,0,0,2,6,3,5,8,1,0,0,1,3,14
401411741,Long Island University Sharks,K. Davis,4703205,,True,31.0,0,4,0,0,0,4,1,4,0,3,3,3,2,0,1,4,1
401411741,Long Island University Sharks,T. Wood,4397160,,True,39.0,1,5,1,3,0,2,4,7,0,4,4,2,1,1,1,3,6
401411741,Long Island University Sharks,N. Crawford,4703207,,False,1.0,0,0,0,0,0,0,0,0,0,0,0,0,0,0,0,0,0
401411741,Long Island University Sharks,Q. Burns,4897990,,False,4.0,0,2,0,1,0,1,0,0,1,1,2,0,0,0,0,1,0
401411741,Long Island University Sharks,A. Washington,4897987,,False,1.0,0,0,0,0,0,0,0,0,0,0,0,0,0,0,0,0,0
401411741,Long Island University Sharks,D. Nicholson,4595479,,False,1.0,0,0,0,0,0,0,0,0,0,0,0,0,0,0,0,0,0
401411741,Long Island University Sharks,T. Pickron,4398400,,False,1.0,0,0,0,0,0,0,0,0,0,0,0,0,0,0,0,0,0
401411741,Long Island University Sharks,A. Rivera,4396570,,False,23.0,1,3,1,1,0,2,0,0,1,3,4,3,0,0,2,2,2
401411741,Long Island University Sharks,TEAM,TOTAL,TOTAL,False,,22,53,19,34,3,19,15,28,9,25,34,11,5,3,11,18,62
401411740,Mount St. Mary's Mountaineers,M. Jefferson,4397980,,True,25.0,4,7,4,7,0,0,0,0,1,2,3,2,3,1,1,4,8
401411740,Mount St. Mary's Mountaineers,M. Offurum,4396837,,True,34.0,5,11,4,9,1,2,3,3,2,2,4,3,1,2,1,4,14
401411740,Mount St. Mary's Mountaineers,N. Opoku,4279871,,True,35.0,4,6,4,6,0,0,0,0,2,2,4,0,0,3,1,5,8
401411740,Mount St. Mary's Mountaineers,D. Thomas,4703168,,True,19.0,3,5,2,3,1,2,0,0,1,1,2,0,1,0,1,5,7
401411740,Mount St. Mary's Mountaineers,J. Benjamin,4431903,,True,28.0,5,15,4,13,1,2,5,6,0,2,2,2,1,0,1,2,16
401411740,Mount St. Mary's Mountaineers,F. Barton,4703170,,False,2.0,0,0,0,0,0,0,0,0,0,0,0,0,0,0,0,0,0
401411740,Mount St. Mary's Mountaineers,J. Gibson,4897975,,False,7.0,0,0,0,0,0,0,0,0,0,0,0,0,1,0,0,1,0
401411740,Mount St. Mary's Mountaineers,J. Reaves,4703169,,False,31.0,5,12,3,5,2,7,1,1,0,4,4,5,1,0,0,2,13
401411740,Mount St. Mary's Mountaineers,D. Leffew,4703167,,False,19.0,1,4,0,1,1,3,0,0,0,2,2,1,0,0,1,2,3
401411740,Mount St. Mary's Mountaineers,TEAM,TOTAL,TOTAL,False,,27,60,21,44,6,16,9,10,7,17,24,13,8,6,7,25,69
401411740,Bryant Bulldogs,H. Elisias,4593267,,True,27.0,2,5,2,5,0,0,9,10,3,3,6,0,0,3,0,2,13
401411740,Bryant Bulldogs,A. Eleeda,4593304,,True,37.0,1,4,0,0,1,4,0,0,1,8,9,0,1,0,2,2,3
401411740,Bryant Bulldogs,C. Pride,4593263,,True,39.0,5,16,4,9,1,7,13,15,4,6,10,1,2,0,1,0,24
401411740,Bryant Bulldogs,L. Hurtado,4279105,,True,35.0,5,6,3,4,2,2,2,2,2,4,6,1,0,1,4,3,14
401411740,Bryant Bulldogs,P. Kiss,4070686,,True,40.0,7,18,6,12,1,6,1,2,0,3,3,3,1,0,3,2,16
401411740,Bryant Bulldogs,G. Calixte,4278362,,False,13.0,0,0,0,0,0,0,0,0,1,0,1,0,0,1,1,3,0
401411740,Bryant Bulldogs,E. Bans,4703138,,False,1.0,0,1,0,1,0,0,0,0,0,0,0,0,0,0,0,1,0
401411740,Bryant Bulldogs,T. Brelsford,4606833,,False,8.0,0,2,0,0,0,2,0,0,0,0,0,0,0,0,0,1,0
401411740,Bryant Bulldogs,TEAM,TOTAL,TOTAL,False,,20,52,15,31,5,21,25,29,14,26,40,5,4,5,14,14,70
401411739,Central Connecticut Blue Devils,J. Brown,4896536,,True,26.0,3,11,3,10,0,1,2,2,2,2,4,2,0,1,3,5,8
401411739,Central Connecticut Blue Devils,A. Snoddy,4896537,,True,25.0,3,7,3,7,0,0,2,2,2,7,9,2,1,0,2,1,8
401411739,Central Connecticut Blue Devils,T. Mitchell,4703143,,True,34.0,5,12,1,5,4,7,0,0,1,3,4,2,2,1,1,4,14
401411739,Central Connecticut Blue Devils,N. Scantlebury,4703142,,True,37.0,7,17,4,9,3,8,0,0,2,2,4,2,1,0,0,2,17
401411739,Central Connecticut Blue Devils,I. Krishnan,4397951,,True,32.0,1,8,1,4,0,4,0,0,0,2,2,1,1,0,1,1,2
401411739,Central Connecticut Blue Devils,A. Dehnavi,4896533,,False,9.0,0,1,0,1,0,0,0,0,1,1,2,0,0,0,0,0,0
401411739,Central Connecticut Blue Devils,T. McLaughlin,4896538,,False,27.0,3,8,1,3,2,5,2,2,1,6,7,1,2,0,3,1,10
401411739,Central Connecticut Blue Devils,J. Ostrowsky,4896530,,False,10.0,0,2,0,2,0,0,0,0,1,0,1,0,0,0,0,1,0
401411739,Central Connecticut Blue Devils,TEAM,TOTAL,TOTAL,False,,22,66,13,41,9,25,6,6,14,23,37,10,7,2,12,15,59
401411739,Bryant Bulldogs,H. Elisias,4593267,,True,16.0,1,3,1,3,0,0,0,1,2,4,6,1,1,1,0,1,2
401411739,Bryant Bulldogs,A. Eleeda,4593304,,True,35.0,3,8,1,1,2,7,0,0,0,4,4,0,1,0,2,0,8
401411739,Bryant Bulldogs,C. Pride,4593263,,True,38.0,10,16,7,8,3,8,1,1,4,4,8,2,3,0,1,2,24
401411739,Bryant Bulldogs,L. Hurtado,4279105,,True,30.0,1,2,1,1,0,1,0,0,0,5,5,4,1,0,4,0,2
401411739,Bryant Bulldogs,P. Kiss,4070686,,True,39.0,8,21,6,14,2,7,6,7,1,5,6,5,0,1,5,3,24
401411739,Bryant Bulldogs,G. Calixte,4278362,,False,25.0,5,6,5,6,0,0,1,2,2,7,9,0,0,3,1,4,11
401411739,Bryant Bulldogs,E. Bans,4703138,,False,4.0,0,1,0,0,0,1,0,0,0,0,0,0,1,0,0,1,0
401411739,Bryant Bulldogs,T. Brelsford,4606833,,False,13.0,1,2,1,2,0,0,0,0,0,0,0,0,0,0,2,0,2
401411739,Bryant Bulldogs,TEAM,TOTAL,TOTAL,False,,29,59,22,35,7,24,8,11,10,30,40,12,7,5,15,11,73
401411738,Wagner Seahawks,R. Rogers,4289551,,True,24.0,8,12,7,11,1,1,0,2,3,6,9,2,0,2,2,3,17
401411738,Wagner Seahawks,Z. Williams,4897951,,True,31.0,5,9,2,3,3,6,2,2,0,3,3,1,2,0,2,2,15
401411738,Wagner Seahawks,D. Hunt,4703199,,True,28.0,9,10,5,5,4,5,2,3,3,1,4,3,3,0,1,1,24
401411738,Wagner Seahawks,W. Martinez,4593037,,True,24.0,2,7,1,5,1,2,1,2,0,1,1,3,2,0,2,2,6
401411738,Wagner Seahawks,A. Morales,4593034,,True,33.0,5,13,4,12,1,1,0,0,2,10,12,10,0,1,0,1,11
401411738,Wagner Seahawks,R. Taylor II,4897952,,False,3.0,0,0,0,0,0,0,0,1,2,0,2,0,0,0,0,1,0
401411738,Wagner Seahawks,J. Fletcher,4593038,,False,11.0,0,2,0,2,0,0,0,0,0,6,6,0,0,1,0,1,0
401411738,Wagner Seahawks,J. Price-Noel,4397675,,False,18.0,1,3,0,1,1,2,0,0,2,3,5,1,0,0,0,0,3
401411738,Wagner Seahawks,N. Jackson,4279882,,False,9.0,2,3,0,0,2,3,0,0,0,0,0,0,1,0,1,1,6
401411738,Wagner Seahawks,J. Ezquerra,4902635,,False,17.0,0,5,0,1,0,4,0,0,1,2,3,2,0,0,3,2,0
401411738,Wagner Seahawks,J. Mason,4593035,,False,2.0,0,0,0,0,0,0,0,0,0,0,0,0,0,0,0,1,0
401411738,Wagner Seahawks,TEAM,TOTAL,TOTAL,False,,32,64,19,40,13,24,5,10,14,32,46,22,8,4,11,15,82
401411738,St. Francis (PA) Red Flash,M. Flagg,4280256,,True,33.0,5,7,5,7,0,0,1,7,3,7,10,1,1,1,3,2,11
401411738,St. Francis (PA) Red Flash,Z. Harrison,4703193,,True,37.0,4,8,4,8,0,0,3,4,1,1,2,2,2,0,4,3,11
401411738,St. Francis (PA) Red Flash,M. Land,4433582,,True,35.0,1,11,1,5,0,6,0,0,0,3,3,0,1,1,1,2,2
401411738,St. Francis (PA) Red Flash,A.J. Labriola,4398019,,True,23.0,2,4,1,2,1,2,0,0,0,0,0,1,0,0,0,1,5
401411738,St. Francis (PA) Red Flash,R. Dixon-Conover,4398016,,True,29.0,3,10,3,5,0,5,2,4,1,4,5,2,3,0,0,1,8
401411738,St. Francis (PA) Red Flash,J. Coleman,4703196,,False,6.0,1,3,1,3,0,0,1,4,1,3,4,0,0,1,0,0,3
401411738,St. Francis (PA) Red Flash,C. Ikediashi,4703195,,False,4.0,0,0,0,0,0,0,0,0,0,0,0,0,0,0,0,1,0
401411738,St. Francis (PA) Red Flash,M. Hargis,4398054,,False,27.0,3,6,2,4,1,2,0,0,1,3,4,0,0,0,4,4,7
401411738,St. Francis (PA) Red Flash,M. Thompson,4398017,,False,6.0,2,3,0,0,2,3,0,0,0,0,0,1,0,0,0,0,6
401411738,St. Francis (PA) Red Flash,TEAM,TOTAL,TOTAL,False,,21,52,17,34,4,18,7,19,7,21,28,7,7,3,12,14,53
401411737,Sacred Heart Pioneers,B. Johnson,4703180,,True,24.0,1,5,1,4,0,1,0,2,1,6,7,3,0,0,1,2,2
401411737,Sacred Heart Pioneers,C. Dutreil,4396765,,True,30.0,3,3,3,3,0,0,2,3,3,5,8,0,1,1,1,4,8
401411737,Sacred Heart Pioneers,N. Galette,4703183,,True,29.0,9,16,5,8,4,8,4,6,6,4,10,0,1,0,3,2,26
401411737,Sacred Heart Pioneers,Ty. Thomas,4593126,,True,21.0,8,16,6,10,2,6,1,1,1,2,3,0,0,0,0,0,19
401411737,Sacred Heart Pioneers,A. Clarke,4397995,,True,34.0,3,12,1,6,2,6,2,2,0,1,1,6,1,0,3,2,10
401411737,Sacred Heart Pioneers,Ta. Thomas,4897974,,False,10.0,0,3,0,2,0,1,0,0,0,0,0,0,0,0,0,3,0
401411737,Sacred Heart Pioneers,M. Sixsmith,4703178,,False,24.0,3,7,1,2,2,5,0,0,0,3,3,3,4,0,1,5,8
401411737,Sacred Heart Pioneers,A. Watson,4279645,,False,28.0,1,8,1,4,0,4,0,0,1,0,1,2,1,0,1,1,2
401411737,Sacred Heart Pioneers,TEAM,TOTAL,TOTAL,False,,28,70,18,39,10,31,9,14,14,22,36,14,8,1,10,19,75
401411737,Long Island University Sharks,T. Flowers,4703209,,True,37.0,7,20,4,10,3,10,3,4,2,7,9,7,3,2,2,2,20
401411737,Long Island University Sharks,E. Penn,4279628,,True,35.0,2,10,2,5,0,5,5,6,2,6,8,4,2,3,3,2,9
401411737,Long Island University Sharks,I. Kante,4278066,,True,29.0,6,9,6,9,0,0,3,4,5,3,8,0,0,0,2,2,15
401411737,Long Island University Sharks,K. Davis,4703205,,True,29.0,2,5,0,1,2,4,5,6,2,2,4,2,1,1,1,1,11
401411737,Long Island University Sharks,T. Wood,4397160,,True,37.0,6,11,6,10,0,1,0,1,2,5,7,6,1,0,2,2,12
401411737,Long Island University Sharks,Q. Burns,4897990,,False,3.0,0,0,0,0,0,0,0,0,0,0,0,0,0,0,0,0,0
401411737,Long Island University Sharks,A. Washington,4897987,,False,3.0,0,0,0,0,0,0,0,0,0,0,0,0,0,0,0,0,0
401411737,Long Island University Sharks,A. Rivera,4396570,,False,27.0,5,6,1,1,4,5,1,2,0,3,3,0,0,0,1,3,15
401411737,Long Island University Sharks,TEAM,TOTAL,TOTAL,False,,28,61,19,36,9,25,17,23,13,29,42,19,7,6,11,12,82
401411736,St. Francis Brooklyn Terriers,P. Emilien,4397909,,True,24.0,3,8,3,8,0,0,1,1,2,2,4,0,1,0,4,3,7
401411736,St. Francis Brooklyn Terriers,J. Hemphill,4397633,,True,23.0,3,5,1,1,2,4,0,0,1,1,2,1,0,0,1,0,8
401411736,St. Francis Brooklyn Terriers,T. Wilcox Jr.,4897958,,True,29.0,2,7,2,3,0,4,0,0,0,2,2,0,1,0,0,1,4
401411736,St. Francis Brooklyn Terriers,R. Higgins,4593104,,True,38.0,5,14,3,9,2,5,0,2,1,2,3,4,0,0,2,3,12
401411736,St. Francis Brooklyn Terriers,M. Cubbage,4398412,,True,30.0,3,12,3,10,0,2,0,0,2,5,7,1,2,1,1,2,6
401411736,St. Francis Brooklyn Terriers,M. Egner,4897961,,False,2.0,0,0,0,0,0,0,0,0,0,0,0,0,0,0,0,0,0
401411736,St. Francis Brooklyn Terriers,E. Hardison,4703185,,False,2.0,0,0,0,0,0,0,0,0,0,0,0,0,0,0,2,0,0
401411736,St. Francis Brooklyn Terriers,V. Stevanic,4703184,,False,4.0,0,0,0,0,0,0,0,0,0,0,0,0,0,0,0,2,0
401411736,St. Francis Brooklyn Terriers,K. Suurorg,4897966,,False,2.0,0,0,0,0,0,0,0,0,0,0,0,1,0,0,1,0,0
401411736,St. Francis Brooklyn Terriers,M. Gonzalez,4897964,,False,2.0,0,0,0,0,0,0,0,0,0,0,0,0,0,0,0,0,0
401411736,St. Francis Brooklyn Terriers,N. Folk,4897960,,False,2.0,1,2,0,0,1,2,0,0,0,1,1,0,0,0,0,0,3
401411736,St. Francis Brooklyn Terriers,B. Haidara,4592440,,False,19.0,0,1,0,0,0,1,0,0,1,2,3,0,1,0,0,0,0
401411736,St. Francis Brooklyn Terriers,T. Quartlebaum,4433061,,False,4.0,0,0,0,0,0,0,0,0,0,0,0,0,0,0,0,0,0
401411736,St. Francis Brooklyn Terriers,L. Moreno,4398007,,False,19.0,3,8,1,1,2,7,0,0,2,1,3,1,0,0,0,2,8
401411736,St. Francis Brooklyn Terriers,TEAM,TOTAL,TOTAL,False,,20,57,13,32,7,25,1,3,11,17,28,8,5,1,13,13,48
401411736,Mount St. Mary's Mountaineers,M. Jefferson,4397980,,True,26.0,5,8,5,8,0,0,2,3,4,5,9,1,0,0,2,2,12
401411736,Mount St. Mary's Mountaineers,M. Offurum,4396837,,True,34.0,5,8,5,7,0,1,5,7,1,6,7,1,3,1,3,1,15
401411736,Mount St. Mary's Mountaineers,N. Opoku,4279871,,True,27.0,7,8,7,8,0,0,1,1,2,3,5,0,0,0,0,1,15
401411736,Mount St. Mary's Mountaineers,D. Thomas,4703168,,True,27.0,2,2,1,1,1,1,0,0,0,3,3,1,1,0,1,2,5
401411736,Mount St. Mary's Mountaineers,J. Benjamin,4431903,,True,35.0,6,15,4,11,2,4,2,3,0,2,2,4,1,1,2,1,16
401411736,Mount St. Mary's Mountaineers,J. Cordilia,4897979,,False,2.0,1,2,1,2,0,0,0,0,1,0,1,0,1,0,0,0,2
401411736,Mount St. Mary's Mountaineers,F. Barton,4703170,,False,6.0,0,1,0,1,0,0,0,0,0,1,1,0,0,0,0,0,0
401411736,Mount St. Mary's Mountaineers,B. Omari,4897980,,False,1.0,0,0,0,0,0,0,0,0,0,0,0,0,0,0,0,0,0
401411736,Mount St. Mary's Mountaineers,E. Elliott,4897978,,False,2.0,2,2,2,2,0,0,0,0,0,0,0,0,0,0,0,1,4
401411736,Mount St. Mary's Mountaineers,J. Gibson,4897975,,False,5.0,1,4,0,2,1,2,0,0,0,1,1,1,1,0,0,0,3
401411736,Mount St. Mary's Mountaineers,W. Moore,4703171,,False,1.0,0,1,0,1,0,0,0,0,1,0,1,0,0,0,0,0,0
401411736,Mount St. Mary's Mountaineers,J. Reaves,4703169,,False,21.0,2,4,0,0,2,4,0,0,0,3,3,1,0,0,0,0,6
401411736,Mount St. Mary's Mountaineers,D. Leffew,4703167,,False,13.0,0,1,0,0,0,1,0,0,0,2,2,2,0,0,0,0,0
401411736,Mount St. Mary's Mountaineers,TEAM,TOTAL,TOTAL,False,,31,56,25,43,6,13,10,14,11,26,37,11,7,2,9,8,78
401411734,UNC Wilmington Seahawks,J. Harvey,4702775,,True,27.0,2,7,2,5,0,2,2,2,0,4,4,1,0,0,0,2,6
401411734,UNC Wilmington Seahawks,S. Phillips,4592975,,True,35.0,1,3,1,3,0,0,2,2,2,3,5,3,1,0,2,5,4
401411734,UNC Wilmington Seahawks,J. Sims,4397570,,True,39.0,6,13,4,10,2,3,14,15,2,5,7,1,2,0,2,5,28
401411734,UNC Wilmington Seahawks,J. Baker,4279875,,True,23.0,1,3,0,1,1,2,0,0,0,1,1,1,0,1,0,5,3
401411734,UNC Wilmington Seahawks,M. Okauru,4278057,,True,49.0,8,20,6,12,2,8,10,12,0,5,5,2,1,1,1,4,28
401411734,UNC Wilmington Seahawks,A. Kelly,4396804,,False,18.0,1,2,1,1,0,1,0,0,1,1,2,1,0,0,0,5,2
401411734,UNC Wilmington Seahawks,K. Samb,4397286,,False,6.0,0,0,0,0,0,0,3,4,0,0,0,0,0,0,0,1,3
401411734,UNC Wilmington Seahawks,J. Thomas,4897713,,False,15.0,0,2,0,1,0,1,3,4,0,0,0,0,1,0,0,1,3
401411734,UNC Wilmington Seahawks,J. Fornes,4067294,,False,38.0,7,14,4,7,3,7,2,4,1,6,7,2,1,0,0,2,19
401411734,UNC Wilmington Seahawks,TEAM,TOTAL,TOTAL,False,,26,64,18,40,8,24,36,43,8,28,36,11,6,2,5,30,96
401411734,Middle Tennessee Blue Raiders,T. Millin,4592866,,True,30.0,1,3,1,1,0,2,4,8,2,4,6,1,0,0,0,3,6
401411734,Middle Tennessee Blue Raiders,D. Dishman,4067165,,True,34.0,7,10,7,10,0,0,3,4,0,2,2,1,0,0,3,5,17
401411734,Middle Tennessee Blue Raiders,T. Lenard,4897509,,True,38.0,4,10,3,5,1,5,2,2,1,5,6,2,2,4,0,4,11
401411734,Middle Tennessee Blue Raiders,E. Lawrence,4432029,,True,32.0,3,9,3,5,0,4,3,3,1,7,8,1,0,0,1,5,9
401411734,Middle Tennessee Blue Raiders,D. Sims,4279080,,True,48.0,5,17,2,8,3,9,14,16,3,5,8,3,0,0,1,2,27
401411734,Middle Tennessee Blue Raiders,C. Fussell,4590357,,False,7.0,1,3,0,0,1,3,1,2,1,2,3,0,0,1,0,0,4
401411734,Middle Tennessee Blue Raiders,C. Weston,4897511,,False,27.0,1,5,0,4,1,1,3,4,4,3,7,1,0,0,4,4,6
401411734,Middle Tennessee Blue Raiders,J. Bufford,4897508,,False,30.0,2,4,2,3,0,1,4,7,3,2,5,0,0,1,0,3,8
401411734,Middle Tennessee Blue Raiders,E. King,4431742,,False,4.0,1,4,1,1,0,3,0,0,1,1,2,0,0,0,0,0,2
401411734,Middle Tennessee Blue Raiders,TEAM,TOTAL,TOTAL,False,,25,65,19,37,6,28,34,46,18,34,52,9,2,6,10,26,90
401411733,Middle Tennessee Blue Raiders,T. Millin,4592866,,True,23.0,3,5,1,2,2,3,1,2,0,2,2,1,1,1,1,3,9
401411733,Middle Tennessee Blue Raiders,D. Dishman,4067165,,True,26.0,5,9,5,9,0,0,1,5,1,3,4,1,1,1,4,3,11
401411733,Middle Tennessee Blue Raiders,T. Lenard,4897509,,True,14.0,3,4,3,3,0,1,0,0,0,2,2,0,0,1,1,4,6
401411733,Middle Tennessee Blue Raiders,E. Lawrence,4432029,,True,35.0,5,9,3,3,2,6,5,6,1,3,4,1,0,0,1,3,17
401411733,Middle Tennessee Blue Raiders,D. Sims,4279080,,True,29.0,6,10,3,4,3,6,2,3,0,4,4,5,2,0,0,1,17
401411733,Middle Tennessee Blue Raiders,C. Fussell,4590357,,False,14.0,0,1,0,0,0,1,0,0,0,1,1,2,0,0,0,2,0
401411733,Middle Tennessee Blue Raiders,C. Weston,4897511,,False,28.0,2,5,2,5,0,0,5,6,1,2,3,9,5,1,2,4,9
401411733,Middle Tennessee Blue Raiders,J. Bufford,4897508,,False,17.0,2,3,1,2,1,1,1,1,0,1,1,0,2,0,0,2,6
401411733,Middle Tennessee Blue Raiders,E. King,4431742,,False,14.0,4,7,2,3,2,4,0,0,0,2,2,0,0,0,1,1,10
401411733,Middle Tennessee Blue Raiders,TEAM,TOTAL,TOTAL,False,,30,53,20,31,10,22,15,23,5,20,25,19,11,4,12,23,85
401411733,Abilene Christian Wildcats,A. Simmons,4433077,,True,16.0,3,7,2,4,1,3,2,4,1,3,4,1,2,0,2,5,9
401411733,Abilene Christian Wildcats,C. Mason,4593750,,True,31.0,3,8,3,8,0,0,9,9,1,2,3,2,0,1,4,4,15
401411733,Abilene Christian Wildcats,M. Morris,4593748,,True,33.0,5,13,3,9,2,4,2,2,0,6,6,2,0,0,2,0,14
401411733,Abilene Christian Wildcats,R. Miller,4593747,,True,30.0,0,3,0,1,0,2,5,8,2,1,3,3,0,1,3,1,5
401411733,Abilene Christian Wildcats,T. Cameron,4278255,,True,20.0,0,1,0,0,0,1,0,0,1,1,2,0,1,0,3,3,0
401411733,Abilene Christian Wildcats,C. Steele,4703600,,False,27.0,7,9,2,2,5,7,1,2,5,3,8,0,1,0,1,4,20
401411733,Abilene Christian Wildcats,Y. Gai,4896508,,False,1.0,0,0,0,0,0,0,0,0,0,0,0,0,0,0,0,0,0
401411733,Abilene Christian Wildcats,S. Smith,4896506,,False,1.0,0,1,0,0,0,1,0,0,0,0,0,0,0,0,0,0,0
401411733,Abilene Christian Wildcats,J. Jackson,4896504,,False,7.0,1,3,1,2,0,1,0,0,0,2,2,1,1,0,0,1,2
401411733,Abilene Christian Wildcats,I. Allen,4593749,,False,14.0,0,1,0,1,0,0,0,0,0,1,1,0,0,0,0,1,0
401411733,Abilene Christian Wildcats,D. Daniels,4397957,,False,20.0,1,3,1,3,0,0,2,2,0,1,1,1,0,0,1,1,4
401411733,Abilene Christian Wildcats,TEAM,TOTAL,TOTAL,False,,20,49,12,30,8,19,21,27,12,21,33,10,5,2,16,20,69
401411732,UNC Wilmington Seahawks,J. Harvey,4702775,,True,34.0,5,8,2,4,3,4,2,2,0,4,4,0,1,0,0,1,15
401411732,UNC Wilmington Seahawks,S. Phillips,4592975,,True,29.0,3,6,3,6,0,0,7,8,1,5,6,4,0,0,0,2,13
401411732,UNC Wilmington Seahawks,J. Sims,4397570,,True,34.0,7,12,7,11,0,1,3,4,1,4,5,2,2,1,1,2,17
401411732,UNC Wilmington Seahawks,J. Baker,4279875,,True,24.0,5,8,4,6,1,2,0,0,0,2,2,0,0,1,1,3,11
401411732,UNC Wilmington Seahawks,M. Okauru,4278057,,True,29.0,1,5,1,3,0,2,2,2,0,6,6,0,2,0,0,4,4
401411732,UNC Wilmington Seahawks,H. Carter,4912681,,False,2.0,0,0,0,0,0,0,0,1,0,0,0,0,0,0,0,0,0
401411732,UNC Wilmington Seahawks,A. Kelly,4396804,,False,17.0,4,6,4,6,0,0,0,0,3,1,4,0,0,0,1,3,8
401411732,UNC Wilmington Seahawks,K. Samb,4397286,,False,2.0,0,0,0,0,0,0,0,0,0,0,0,0,0,0,1,0,0
401411732,UNC Wilmington Seahawks,M. Surigao,4897716,,False,2.0,0,0,0,0,0,0,0,0,0,0,0,0,0,0,0,0,0
401411732,UNC Wilmington Seahawks,J. Thomas,4897713,,False,17.0,4,8,3,6,1,2,1,1,2,2,4,1,0,0,0,2,10
401411732,UNC Wilmington Seahawks,L. Morrissey,4710040,,False,2.0,0,0,0,0,0,0,0,0,0,0,0,0,0,0,0,0,0
401411732,UNC Wilmington Seahawks,J. Fornes,4067294,,False,8.0,1,3,1,2,0,1,0,0,0,1,1,1,0,0,0,3,2
401411732,UNC Wilmington Seahawks,TEAM,TOTAL,TOTAL,False,,30,56,25,44,5,12,15,18,7,28,35,8,5,2,4,20,80
401411732,Northern Colorado Bears,K. Jongkuch,4897945,,True,32.0,4,7,4,7,0,0,1,3,9,4,13,5,0,0,2,2,9
401411732,Northern Colorado Bears,M. Johnson II,4897941,,True,35.0,6,13,2,5,4,8,0,1,0,2,2,3,0,0,3,2,16
401411732,Northern Colorado Bears,D. Kuxhausen,4593774,,True,26.0,1,7,0,1,1,6,0,0,0,2,2,0,0,0,0,0,3
401411732,Northern Colorado Bears,B. Hume,4397311,,True,30.0,3,10,2,4,1,6,3,4,3,3,6,0,0,0,1,2,10
401411732,Northern Colorado Bears,D. Kountz,4397060,,True,34.0,5,13,4,11,1,2,3,4,0,6,6,1,0,1,2,4,14
401411732,Northern Colorado Bears,B. Kennedy,4702085,,False,6.0,0,0,0,0,0,0,0,0,0,0,0,0,0,0,0,2,0
401411732,Northern Colorado Bears,J. Melvin,4702083,,False,5.0,0,0,0,0,0,0,0,0,0,1,1,0,1,0,0,0,0
401411732,Northern Colorado Bears,T. Hughes,4702088,,False,4.0,0,1,0,1,0,0,0,0,0,1,1,0,0,0,0,0,0
401411732,Northern Colorado Bears,Z. Bloch,4897944,,False,6.0,0,0,0,0,0,0,0,0,0,2,2,0,0,0,0,0,0
401411732,Northern Colorado Bears,D. Knecht,4897943,,False,22.0,4,7,2,2,2,5,2,3,0,0,0,1,0,0,2,2,12
401411732,Northern Colorado Bears,TEAM,TOTAL,TOTAL,False,,23,58,14,31,9,27,9,15,12,21,33,10,1,1,10,14,64
401411731,Ohio Bobcats,B. Roderick,4593447,,True,25.0,2,7,2,3,0,4,1,1,1,1,2,2,0,1,1,5,5
401411731,Ohio Bobcats,B. Vander Plas,4279448,,True,40.0,6,14,4,8,2,6,7,11,2,9,11,4,2,1,5,5,21
401411731,Ohio Bobcats,J. Carter,4067398,,True,0.0,0,0,0,0,0,0,0,1,0,0,0,0,0,0,0,0,0
401411731,Ohio Bobcats,M. Sears,4703530,,True,40.0,10,19,9,15,1,4,14,19,4,3,7,3,1,0,3,1,35
401411731,Ohio Bobcats,M. Brown,4593449,,True,33.0,1,1,1,1,0,0,3,4,1,0,1,0,0,0,1,1,5
401411731,Ohio Bobcats,A. Clayton,4898339,,False,16.0,4,4,3,3,1,1,2,4,1,3,4,1,0,0,2,5,11
401411731,Ohio Bobcats,I. Ezuma,4898338,,False,4.0,0,0,0,0,0,0,0,0,0,1,1,0,0,0,0,0,0
401411731,Ohio Bobcats,S. Towns,4703531,,False,14.0,0,0,0,0,0,0,0,0,1,4,5,0,1,0,1,2,0
401411731,Ohio Bobcats,O. Adelodun,4898337,,False,0.0,0,0,0,0,0,0,0,0,0,0,0,0,0,0,0,0,0
401411731,Ohio Bobcats,T. Schmock,4407066,,False,28.0,3,8,0,0,3,8,0,0,0,2,2,0,1,0,1,4,9
401411731,Ohio Bobcats,TEAM,TOTAL,TOTAL,False,,26,53,19,30,7,23,27,40,11,23,34,10,5,2,14,23,86
401411731,Abilene Christian Wildcats,A. Simmons,4433077,,True,21.0,7,13,4,7,3,6,1,2,0,6,6,6,0,0,3,4,18
401411731,Abilene Christian Wildcats,C. Mason,4593750,,True,34.0,7,13,6,11,1,2,5,5,0,5,5,2,0,0,1,4,20
401411731,Abilene Christian Wildcats,M. Morris,4593748,,True,20.0,2,5,2,2,0,3,0,0,0,0,0,0,3,0,2,4,4
401411731,Abilene Christian Wildcats,R. Miller,4593747,,True,30.0,2,5,2,4,0,1,4,5,2,3,5,3,2,0,1,1,8
401411731,Abilene Christian Wildcats,T. Cameron,4278255,,True,18.0,2,5,1,3,1,2,3,4,2,4,6,3,0,0,1,5,8
401411731,Abilene Christian Wildcats,C. Steele,4703600,,False,17.0,4,4,2,2,2,2,2,2,0,2,2,0,0,2,0,4,12
401411731,Abilene Christian Wildcats,Y. Gai,4896508,,False,4.0,0,1,0,1,0,0,0,0,0,0,0,0,0,0,0,0,0
401411731,Abilene Christian Wildcats,J. Jackson,4896504,,False,11.0,0,0,0,0,0,0,0,0,0,0,0,1,0,0,1,3,0
401411731,Abilene Christian Wildcats,L. McLaughlin,4703599,,False,1.0,0,0,0,0,0,0,0,0,0,0,0,0,0,0,0,0,0
401411731,Abilene Christian Wildcats,I. Allen,4593749,,False,17.0,4,5,3,4,1,1,4,4,0,1,1,0,1,0,2,4,13
401411731,Abilene Christian Wildcats,D. Daniels,4397957,,False,27.0,1,3,1,2,0,1,6,7,0,1,1,3,4,0,0,3,8
401411731,Abilene Christian Wildcats,TEAM,TOTAL,TOTAL,False,,29,54,21,36,8,18,25,29,4,25,29,18,10,2,11,32,91
401411730,Middle Tennessee Blue Raiders,T. Millin,4592866,,True,28.0,3,3,2,2,1,1,0,0,0,2,2,1,0,0,1,1,7
401411730,Middle Tennessee Blue Raiders,D. Dishman,4067165,,True,22.0,6,11,6,11,0,0,0,1,1,5,6,0,2,0,0,2,12
401411730,Middle Tennessee Blue Raiders,T. Lenard,4897509,,True,29.0,4,6,1,1,3,5,3,4,0,2,2,0,2,4,0,2,14
401411730,Middle Tennessee Blue Raiders,E. Lawrence,4432029,,True,29.0,2,4,1,2,1,2,1,2,0,1,1,1,1,0,3,2,6
401411730,Middle Tennessee Blue Raiders,D. Sims,4279080,,True,30.0,6,12,6,9,0,3,1,1,1,5,6,6,3,0,1,2,13
401411730,Middle Tennessee Blue Raiders,C. Fussell,4590357,,False,18.0,1,3,1,2,0,1,0,0,1,4,5,1,0,0,1,3,2
401411730,Middle Tennessee Blue Raiders,C. Weston,4897511,,False,15.0,1,4,1,1,0,3,0,1,0,5,5,2,1,0,0,3,2
401411730,Middle Tennessee Blue Raiders,J. Bufford,4897508,,False,15.0,3,5,1,1,2,4,0,0,0,0,0,0,0,1,0,0,8
401411730,Middle Tennessee Blue Raiders,E. King,4431742,,False,14.0,4,6,1,1,3,5,1,1,0,0,0,1,0,0,1,1,12
401411730,Middle Tennessee Blue Raiders,TEAM,TOTAL,TOTAL,False,,30,54,20,30,10,24,6,10,4,25,29,12,9,5,7,16,76
401411730,Boston University Terriers,S. Mathon,4280042,,True,25.0,3,7,3,7,0,0,6,8,5,6,11,0,0,0,3,0,12
401411730,Boston University Terriers,E. Brittain-Watts,4431909,,True,21.0,2,6,1,1,1,5,0,0,0,0,0,1,0,0,3,2,5
401411730,Boston University Terriers,F. Tynen,4397634,,True,18.0,0,2,0,1,0,1,0,0,0,1,1,0,0,0,2,0,0
401411730,Boston University Terriers,J. Harper,4397631,,True,30.0,2,7,2,3,0,4,0,0,1,2,3,2,0,0,0,1,4
401411730,Boston University Terriers,J. McCoy,4280041,,True,34.0,5,13,4,7,1,6,0,0,0,2,2,1,0,0,3,1,11
401411730,Boston University Terriers,A. Patnode,4702489,,False,1.0,0,0,0,0,0,0,0,0,0,0,0,0,0,0,0,0,0
401411730,Boston University Terriers,M. Chimezie,4684448,,False,10.0,1,3,1,3,0,0,0,0,2,3,5,1,0,0,0,1,2
401411730,Boston University Terriers,T. Uzoegbu,4597894,,False,1.0,0,0,0,0,0,0,0,0,0,1,1,0,0,0,0,0,0
401411730,Boston University Terriers,M. Brewster,4702490,,False,11.0,0,1,0,1,0,0,1,2,0,2,2,0,1,1,0,0,1
401411730,Boston University Terriers,C. Jones,4702488,,False,6.0,0,0,0,0,0,0,0,0,0,0,0,0,0,0,0,2,0
401411730,Boston University Terriers,M. Quinn,4597893,,False,1.0,0,1,0,0,0,1,0,0,0,0,0,0,0,0,0,0,0
401411730,Boston University Terriers,T. Taboglu,4597892,,False,1.0,0,1,0,0,0,1,0,0,0,0,0,0,0,0,0,0,0
401411730,Boston University Terriers,D. Tate,4593079,,False,7.0,0,0,0,0,0,0,0,0,0,2,2,0,0,0,0,2,0
401411730,Boston University Terriers,G. Pascoe,4397630,,False,13.0,0,1,0,1,0,0,0,0,0,0,0,2,0,0,1,1,0
401411730,Boston University Terriers,W. Whyte,4280039,,False,21.0,4,11,1,4,3,7,0,0,0,2,2,0,0,0,0,0,11
401411730,Boston University Terriers,TEAM,TOTAL,TOTAL,False,,17,53,12,28,5,25,7,10,9,22,31,7,1,1,12,10,46
401411729,UNC Asheville Bulldogs,D. Pember,4431793,,True,33.0,9,17,8,14,1,3,5,6,0,10,10,0,0,2,1,3,24
401411729,UNC Asheville Bulldogs,C. Jude,4397803,,True,25.0,2,4,0,0,2,4,2,3,0,1,1,0,0,0,0,1,8
401411729,UNC Asheville Bulldogs,LJ Thorpe,4279050,,True,35.0,11,23,11,23,0,0,2,2,3,5,8,5,2,0,0,3,24
401411729,UNC Asheville Bulldogs,T. Stephney,4592753,,True,27.0,3,5,3,3,0,2,0,0,0,2,2,6,1,0,2,2,6
401411729,UNC Asheville Bulldogs,T. Jones,4279052,,True,31.0,5,10,2,4,3,6,0,0,0,3,3,0,2,0,0,2,13
401411729,UNC Asheville Bulldogs,S. Mason,4702142,,False,6.0,0,1,0,1,0,0,0,2,0,0,0,0,0,0,0,0,0
401411729,UNC Asheville Bulldogs,BJ Marable,4702141,,False,7.0,0,0,0,0,0,0,0,0,0,0,0,0,0,0,0,1,0
401411729,UNC Asheville Bulldogs,J. Battle,4592754,,False,27.0,3,8,3,8,0,0,0,0,4,3,7,0,0,1,0,2,6
401411729,UNC Asheville Bulldogs,Q. Kimble,4283783,,False,9.0,1,3,0,0,1,3,0,0,0,0,0,1,1,0,1,1,3
401411729,UNC Asheville Bulldogs,TEAM,TOTAL,TOTAL,False,,34,71,27,53,7,18,9,13,9,24,33,12,6,3,4,15,84
401411729,Northern Colorado Bears,K. Jongkuch,4897945,,True,25.0,5,7,5,7,0,0,1,4,3,6,9,2,0,1,0,3,11
401411729,Northern Colorado Bears,M. Johnson II,4897941,,True,32.0,2,7,1,3,1,4,0,1,1,4,5,4,0,0,2,1,5
401411729,Northern Colorado Bears,D. Kuxhausen,4593774,,True,37.0,6,11,1,2,5,9,1,1,0,3,3,3,0,0,1,1,18
401411729,Northern Colorado Bears,B. Hume,4397311,,True,29.0,6,10,3,3,3,7,0,0,0,7,7,0,0,2,2,3,15
401411729,Northern Colorado Bears,D. Kountz,4397060,,True,37.0,11,17,7,11,4,6,3,4,0,4,4,6,0,0,5,2,29
401411729,Northern Colorado Bears,B. Kennedy,4702085,,False,3.0,0,0,0,0,0,0,0,0,1,0,1,0,0,0,0,0,0
401411729,Northern Colorado Bears,J. Melvin,4702083,,False,5.0,1,1,1,1,0,0,0,0,2,0,2,0,0,0,0,2,2
401411729,Northern Colorado Bears,Z. Bloch,4897944,,False,5.0,0,2,0,0,0,2,0,0,0,0,0,0,0,0,1,0,0
401411729,Northern Colorado Bears,D. Knecht,4897943,,False,27.0,3,7,2,4,1,3,0,0,1,3,4,1,0,2,1,2,7
401411729,Northern Colorado Bears,TEAM,TOTAL,TOTAL,False,,34,62,20,31,14,31,5,10,9,28,37,16,0,5,12,14,87
401411728,UNC Wilmington Seahawks,J. Harvey,4702775,,True,28.0,0,6,0,2,0,4,1,2,0,0,0,1,0,0,0,2,1
401411728,UNC Wilmington Seahawks,S. Phillips,4592975,,True,36.0,10,14,10,14,0,0,4,5,1,1,2,2,1,0,1,3,24
401411728,UNC Wilmington Seahawks,J. Sims,4397570,,True,32.0,4,11,3,9,1,2,2,2,1,4,5,3,1,1,2,1,11
401411728,UNC Wilmington Seahawks,J. Baker,4279875,,True,29.0,4,9,3,6,1,3,0,0,3,5,8,3,2,1,0,0,9
401411728,UNC Wilmington Seahawks,M. Okauru,4278057,,True,27.0,4,8,3,5,1,3,4,4,0,2,2,1,1,0,2,2,13
401411728,UNC Wilmington Seahawks,A. Kelly,4396804,,False,11.0,1,3,1,3,0,0,0,0,0,1,1,0,1,1,0,0,2
401411728,UNC Wilmington Seahawks,J. Thomas,4897713,,False,14.0,1,2,1,2,0,0,3,3,1,1,2,1,0,0,1,4,5
401411728,UNC Wilmington Seahawks,L. Morrissey,4710040,,False,1.0,0,0,0,0,0,0,0,0,0,0,0,0,0,0,0,0,0
401411728,UNC Wilmington Seahawks,J. Fornes,4067294,,False,22.0,4,6,1,3,3,3,0,0,0,2,2,0,1,0,0,0,11
401411728,UNC Wilmington Seahawks,TEAM,TOTAL,TOTAL,False,,28,59,22,44,6,15,14,16,8,18,26,11,7,3,6,12,76
401411728,Drake Bulldogs,S. Hemphill,4397747,,True,35.0,7,11,7,11,0,0,1,2,2,5,7,2,2,1,4,1,15
401411728,Drake Bulldogs,T. Murphy,4397346,,True,32.0,5,7,2,2,3,5,1,1,1,2,3,0,1,0,2,3,14
401411728,Drake Bulldogs,T. Devries,4837238,,True,28.0,5,11,3,5,2,6,2,2,0,4,4,2,0,2,0,2,14
401411728,Drake Bulldogs,G. Sturtz,4397348,,True,35.0,5,10,4,9,1,1,0,0,1,2,3,2,0,0,1,2,11
401411728,Drake Bulldogs,R. Penn,4279754,,True,27.0,5,10,5,7,0,3,0,0,1,4,5,3,0,0,3,3,10
401411728,Drake Bulldogs,D. Brodie,4397121,,False,17.0,1,2,1,2,0,0,2,2,1,2,3,1,0,0,0,0,4
401411728,Drake Bulldogs,O. Djamgouz,4592679,,False,10.0,1,3,1,2,0,1,0,0,0,1,1,0,0,0,0,1,2
401411728,Drake Bulldogs,A. Akinwole,4279508,,False,16.0,2,3,1,1,1,2,0,0,0,3,3,1,0,0,1,1,5
401411728,Drake Bulldogs,TEAM,TOTAL,TOTAL,False,,31,57,24,39,7,18,6,7,6,24,30,11,3,3,11,13,75
401411727,Troy Trojans,N. Stampley,4593932,,True,16.0,2,4,1,2,1,2,0,0,0,1,1,0,1,0,1,0,5
401411727,Troy Trojans,K. Waters,4593931,,True,26.0,6,14,4,10,2,4,4,4,0,2,2,1,1,1,4,1,18
401411727,Troy Trojans,E. Odigie,4397868,,True,25.0,3,4,2,3,1,1,0,0,2,7,9,1,1,1,1,5,7
401411727,Troy Trojans,C. Eugene,4897147,,True,36.0,4,8,3,4,1,4,4,4,1,1,2,4,0,0,4,2,13
401411727,Troy Trojans,D. Williams,4593930,,True,29.0,6,13,4,4,2,9,0,0,0,1,1,4,1,1,1,1,14
401411727,Troy Trojans,N. Tshimanga,4709322,,False,10.0,0,0,0,0,0,0,2,2,0,0,0,1,0,0,2,5,2
401411727,Troy Trojans,R. Miguel,4703533,,False,6.0,0,0,0,0,0,0,3,4,0,0,0,0,0,1,0,3,3
401411727,Troy Trojans,L. Geffrard,4702053,,False,7.0,1,2,1,2,0,0,1,1,0,3,3,0,0,0,2,0,3
401411727,Troy Trojans,C. Turner,4702052,,False,9.0,0,2,0,1,0,1,0,0,0,4,4,1,1,0,1,1,0
401411727,Troy Trojans,Z. Williams,4397711,,False,17.0,1,3,0,1,1,2,0,0,0,6,6,1,2,0,1,1,3
401411727,Troy Trojans,T. Smith,4703552,,False,3.0,0,0,0,0,0,0,0,0,1,0,1,0,0,0,2,1,0
401411727,Troy Trojans,K. Punter,4702044,,False,16.0,0,0,0,0,0,0,2,2,0,0,0,1,1,0,1,2,2
401411727,Troy Trojans,TEAM,TOTAL,TOTAL,False,,23,50,15,27,8,23,16,17,6,26,32,14,8,4,20,22,70
401411727,Abilene Christian Wildcats,A. Simmons,4433077,,True,22.0,5,12,4,7,1,5,0,3,2,0,2,2,0,0,3,2,11
401411727,Abilene Christian Wildcats,C. Mason,4593750,,True,24.0,6,12,4,7,2,5,5,5,1,2,3,0,2,1,1,1,19
401411727,Abilene Christian Wildcats,M. Morris,4593748,,True,32.0,2,11,1,7,1,4,4,4,1,1,2,2,4,0,3,3,9
401411727,Abilene Christian Wildcats,R. Miller,4593747,,True,25.0,3,6,2,3,1,3,3,3,1,1,2,2,3,0,0,0,10
401411727,Abilene Christian Wildcats,T. Cameron,4278255,,True,26.0,1,5,1,3,0,2,1,2,3,4,7,4,1,0,1,2,3
401411727,Abilene Christian Wildcats,F. Cadeaux de Dieu,4896507,,False,2.0,0,0,0,0,0,0,0,0,0,1,1,0,0,0,0,0,0
401411727,Abilene Christian Wildcats,C. Steele,4703600,,False,19.0,6,8,2,3,4,5,2,2,0,7,7,1,1,1,1,1,18
401411727,Abilene Christian Wildcats,Y. Gai,4896508,,False,6.0,0,1,0,1,0,0,2,2,2,1,3,0,1,0,0,0,2
401411727,Abilene Christian Wildcats,S. Smith,4896506,,False,3.0,1,1,1,1,0,0,0,0,0,0,0,0,0,0,1,0,2
401411727,Abilene Christian Wildcats,J. Jackson,4896504,,False,15.0,1,2,1,2,0,0,0,2,0,1,1,1,0,0,1,2,2
401411727,Abilene Christian Wildcats,L. McLaughlin,4703599,,False,2.0,0,0,0,0,0,0,0,0,0,0,0,0,0,0,0,0,0
401411727,Abilene Christian Wildcats,I. Allen,4593749,,False,5.0,1,2,1,2,0,0,0,0,0,0,0,1,0,0,0,5,2
401411727,Abilene Christian Wildcats,D. Daniels,4397957,,False,19.0,2,3,2,2,0,1,0,0,0,2,2,5,1,0,2,1,4
401411727,Abilene Christian Wildcats,TEAM,TOTAL,TOTAL,False,,28,63,19,38,9,25,17,23,11,22,33,18,13,2,14,17,82
401411726,UNC Greensboro Spartans,B. Leyte,4593682,,True,32.0,6,8,6,8,0,0,5,6,6,2,8,2,0,0,0,3,17
401411726,UNC Greensboro Spartans,M. Abdulsalam,4398232,,True,26.0,1,5,1,5,0,0,3,7,2,4,6,0,0,0,1,3,5
401411726,UNC Greensboro Spartans,Ko. Langley,4433026,,True,30.0,3,9,1,1,2,8,0,0,0,5,5,3,1,0,1,3,8
401411726,UNC Greensboro Spartans,D. Treacy,4397989,,True,36.0,2,9,1,8,1,1,2,2,1,3,4,6,1,0,0,3,7
401411726,UNC Greensboro Spartans,D. Buckingham,4066833,,True,32.0,8,14,3,3,5,11,0,1,2,3,5,1,2,0,1,2,21
401411726,UNC Greensboro Spartans,M. Jones,4592762,,False,16.0,1,2,1,2,0,0,0,1,1,2,3,0,0,0,0,0,2
401411726,UNC Greensboro Spartans,J.C. Tharrington,4433098,,False,10.0,0,1,0,0,0,1,0,0,0,1,1,0,1,0,1,1,0
401411726,UNC Greensboro Spartans,Ke. Langley,4431864,,False,18.0,2,7,0,2,2,5,2,2,0,0,0,2,2,0,2,3,8
401411726,UNC Greensboro Spartans,TEAM,TOTAL,TOTAL,False,,23,55,13,29,10,26,12,19,12,20,32,14,7,0,8,18,68
401411726,Boston University Terriers,S. Mathon,4280042,,True,31.0,6,9,6,9,0,0,6,6,5,4,9,0,0,0,3,4,18
401411726,Boston University Terriers,E. Brittain-Watts,4431909,,True,32.0,0,5,0,2,0,3,2,2,0,4,4,1,1,0,1,2,2
401411726,Boston University Terriers,F. Tynen,4397634,,True,18.0,1,2,1,2,0,0,2,2,0,3,3,1,0,0,1,1,4
401411726,Boston University Terriers,J. Harper,4397631,,True,32.0,5,8,0,2,5,6,0,0,1,3,4,2,1,0,0,3,15
401411726,Boston University Terriers,J. McCoy,4280041,,True,34.0,5,16,5,14,0,2,3,4,1,1,2,3,3,0,4,3,13
401411726,Boston University Terriers,M. Chimezie,4684448,,False,9.0,2,3,2,3,0,0,0,0,2,1,3,0,0,0,0,3,4
401411726,Boston University Terriers,M. Brewster,4702490,,False,14.0,1,2,0,1,1,1,0,0,0,1,1,1,0,0,0,0,3
401411726,Boston University Terriers,C. Jones,4702488,,False,5.0,1,1,0,0,1,1,1,1,0,0,0,1,0,0,0,1,4
401411726,Boston University Terriers,G. Pascoe,4397630,,False,3.0,0,0,0,0,0,0,0,0,0,1,1,0,0,0,0,0,0
401411726,Boston University Terriers,W. Whyte,4280039,,False,22.0,2,8,1,2,1,6,3,3,1,5,6,1,0,0,0,1,8
401411726,Boston University Terriers,TEAM,TOTAL,TOTAL,False,,23,54,15,35,8,19,17,18,11,23,34,10,5,0,9,18,71
401411725,Northern Colorado Bears,K. Jongkuch,4897945,,True,33.0,7,9,7,9,0,0,2,3,4,8,12,0,0,2,3,2,16
401411725,Northern Colorado Bears,M. Johnson II,4897941,,True,33.0,2,5,1,2,1,3,0,1,0,2,2,3,1,0,1,1,5
401411725,Northern Colorado Bears,D. Kuxhausen,4593774,,True,26.0,3,7,0,0,3,7,1,2,0,0,0,1,1,0,2,0,10
401411725,Northern Colorado Bears,B. Hume,4397311,,True,32.0,4,11,1,3,3,8,0,2,1,10,11,2,0,3,2,2,11
401411725,Northern Colorado Bears,D. Kountz,4397060,,True,34.0,11,16,11,14,0,2,1,2,0,4,4,3,1,0,3,1,23
401411725,Northern Colorado Bears,B. Kennedy,4702085,,False,6.0,0,1,0,0,0,1,0,0,0,0,0,0,0,0,2,2,0
401411725,Northern Colorado Bears,J. Melvin,4702083,,False,9.0,0,2,0,2,0,0,0,0,3,1,4,0,0,0,2,1,0
401411725,Northern Colorado Bears,Z. Bloch,4897944,,False,7.0,0,1,0,0,0,1,0,0,0,1,1,0,0,0,1,0,0
401411725,Northern Colorado Bears,D. Knecht,4897943,,False,20.0,3,5,3,3,0,2,3,5,0,3,3,0,2,0,2,1,9
401411725,Northern Colorado Bears,TEAM,TOTAL,TOTAL,False,,30,57,23,33,7,24,7,15,8,30,38,9,5,5,18,10,74
401411725,Florida Atlantic Owls,G. Rosado,4585611,,True,24.0,7,16,7,16,0,0,1,2,3,2,5,0,1,0,0,3,15
401411725,Florida Atlantic Owls,V. Goldin,4700818,,True,13.0,1,7,1,7,0,0,0,0,1,3,4,0,0,1,2,2,2
401411725,Florida Atlantic Owls,J. Davis,4702655,,True,34.0,7,13,5,10,2,3,2,2,1,4,5,1,1,0,3,3,18
401411725,Florida Atlantic Owls,B. Greenlee,4592701,,True,34.0,4,6,1,2,3,4,0,0,0,3,3,4,4,0,2,1,11
401411725,Florida Atlantic Owls,M. Forrest,4397485,,True,33.0,5,15,3,9,2,6,0,0,0,4,4,2,1,0,1,2,12
401411725,Florida Atlantic Owls,D. Kapiti,4432013,,False,10.0,3,7,3,7,0,0,2,2,2,1,3,0,0,1,0,0,8
401411725,Florida Atlantic Owls,M. Niang,4397482,,False,4.0,0,1,0,0,0,1,0,0,1,1,2,0,0,0,0,0,0
401411725,Florida Atlantic Owls,B. Baruti,4066634,,False,5.0,0,0,0,0,0,0,0,0,0,0,0,0,0,0,0,1,0
401411725,Florida Atlantic Owls,B. Weatherspoon,4897476,,False,30.0,1,3,1,2,0,1,0,0,0,6,6,0,0,1,0,4,2
401411725,Florida Atlantic Owls,B. Zimonjic,4897475,,False,9.0,1,2,0,1,1,1,0,0,2,0,2,0,1,0,0,1,3
401411725,Florida Atlantic Owls,A. Ralat,4592847,,False,4.0,0,1,0,0,0,1,0,0,0,0,0,0,0,0,0,1,0
401411725,Florida Atlantic Owls,TEAM,TOTAL,TOTAL,False,,29,71,21,54,8,17,5,6,12,25,37,7,8,3,8,18,71
401411724,VMI Keydets,J. Stephens,4398257,,True,34.0,6,10,3,5,3,5,8,8,2,6,8,2,0,1,5,4,23
401411724,VMI Keydets,H. Huff,4897365,,True,31.0,1,5,0,1,1,4,0,0,1,2,3,1,0,0,5,4,3
401411724,VMI Keydets,T. Bonham,4703868,,True,31.0,7,15,6,10,1,5,11,13,1,3,4,2,2,0,3,2,26
401411724,VMI Keydets,S. Conway,4593716,,True,27.0,2,9,0,2,2,7,2,2,1,10,11,2,1,0,1,1,8
401411724,VMI Keydets,K. Curfman,4593713,,True,39.0,6,10,2,2,4,8,2,2,1,5,6,0,1,0,2,1,18
401411724,VMI Keydets,S. Wolfe,4593714,,False,2.0,0,0,0,0,0,0,0,0,1,0,1,0,0,0,1,0,0
401411724,VMI Keydets,DJ Nussbaum,4703872,,False,4.0,0,2,0,2,0,0,0,0,1,0,1,0,0,0,0,0,0
401411724,VMI Keydets,C. Sisco,4897367,,False,3.0,0,0,0,0,0,0,0,0,0,0,0,0,0,0,0,0,0
401411724,VMI Keydets,B. Watkins,4897364,,False,5.0,0,0,0,0,0,0,0,0,0,0,0,0,1,0,0,0,0
401411724,VMI Keydets,T. Mans,4703870,,False,20.0,0,4,0,0,0,4,0,0,0,0,0,3,1,0,1,5,0
401411724,VMI Keydets,L. Tang,4593711,,False,4.0,0,0,0,0,0,0,0,0,0,0,0,0,0,0,0,0,0
401411724,VMI Keydets,TEAM,TOTAL,TOTAL,False,,22,55,11,22,11,33,23,25,9,27,36,10,6,1,18,17,78
401411724,UNC Wilmington Seahawks,J. Harvey,4702775,,True,26.0,4,8,3,4,1,4,0,0,0,2,2,0,1,0,1,3,9
401411724,UNC Wilmington Seahawks,S. Phillips,4592975,,True,33.0,4,5,4,5,0,0,2,3,1,4,5,3,2,0,0,2,10
401411724,UNC Wilmington Seahawks,J. Sims,4397570,,True,30.0,4,11,2,5,2,6,8,9,2,6,8,7,5,0,3,3,18
401411724,UNC Wilmington Seahawks,J. Baker,4279875,,True,27.0,6,10,5,8,1,2,0,0,3,3,6,1,1,0,2,3,13
401411724,UNC Wilmington Seahawks,M. Okauru,4278057,,True,24.0,8,16,4,8,4,8,7,7,2,2,4,1,2,0,1,2,27
401411724,UNC Wilmington Seahawks,A. Kelly,4396804,,False,20.0,0,3,0,2,0,1,2,4,0,2,2,0,0,1,1,3,2
401411724,UNC Wilmington Seahawks,J. Thomas,4897713,,False,16.0,3,4,2,3,1,1,2,2,0,3,3,0,0,0,0,2,9
401411724,UNC Wilmington Seahawks,J. Fornes,4067294,,False,24.0,2,8,1,5,1,3,0,0,1,0,1,3,0,0,1,1,5
401411724,UNC Wilmington Seahawks,TEAM,TOTAL,TOTAL,False,,31,65,21,40,10,25,21,25,9,25,34,15,11,1,10,19,93
401411723,Rice Owls,M. Fiedler,4431964,,True,22.0,4,8,4,8,0,0,0,0,3,3,6,1,1,1,2,2,8
401411723,Rice Owls,T. Evee,4593712,,True,34.0,4,14,2,6,2,8,2,2,0,4,4,4,1,0,3,3,12
401411723,Rice Owls,C. Mullins,4397690,,True,38.0,5,10,5,10,0,0,1,1,0,1,1,5,2,1,2,1,11
401411723,Rice Owls,T. McBride,4279474,,True,18.0,1,3,1,3,0,0,0,0,0,1,1,0,0,1,4,1,2
401411723,Rice Owls,C. Pierre,4278368,,True,38.0,9,18,7,10,2,8,0,0,0,8,8,1,0,2,0,1,20
401411723,Rice Owls,M. Poteat,4590358,,False,18.0,5,7,5,7,0,0,0,0,5,6,11,1,0,0,2,3,10
401411723,Rice Owls,R. Abercrombie,4397265,,False,16.0,0,1,0,0,0,1,0,0,1,1,2,1,0,0,1,3,0
401411723,Rice Owls,C. Sheffield,4432321,,False,16.0,0,0,0,0,0,0,1,2,1,3,4,0,0,0,0,1,1
401411723,Rice Owls,TEAM,TOTAL,TOTAL,False,,28,61,24,44,4,17,4,5,13,28,41,13,4,5,14,15,64
401411723,Ohio Bobcats,B. Roderick,4593447,,True,25.0,3,10,1,4,2,6,0,0,0,0,0,1,1,0,0,2,8
401411723,Ohio Bobcats,B. Vander Plas,4279448,,True,36.0,4,11,3,5,1,6,4,5,0,6,6,3,2,0,2,1,13
401411723,Ohio Bobcats,J. Carter,4067398,,True,30.0,11,19,11,16,0,3,4,5,7,5,12,0,1,1,3,1,26
401411723,Ohio Bobcats,M. Sears,4703530,,True,38.0,4,15,4,12,0,3,0,2,2,4,6,3,4,0,1,1,8
401411723,Ohio Bobcats,M. Brown,4593449,,True,34.0,1,2,1,2,0,0,3,3,0,1,1,1,2,0,0,1,5
401411723,Ohio Bobcats,A. Clayton,4898339,,False,10.0,2,5,1,2,1,3,0,0,1,1,2,0,0,1,0,1,5
401411723,Ohio Bobcats,I. Ezuma,4898338,,False,4.0,0,1,0,1,0,0,0,0,0,1,1,0,0,1,0,0,0
401411723,Ohio Bobcats,T. Schmock,4407066,,False,23.0,0,1,0,0,0,1,0,0,1,2,3,1,0,0,1,1,0
401411723,Ohio Bobcats,TEAM,TOTAL,TOTAL,False,,25,64,21,42,4,22,11,15,12,20,32,9,10,3,8,8,65
401411722,Middle Tennessee Blue Raiders,T. Millin,4592866,,True,15.0,0,1,0,1,0,0,0,0,0,3,3,0,0,0,0,1,0
401411722,Middle Tennessee Blue Raiders,D. Dishman,4067165,,True,31.0,5,9,5,9,0,0,7,9,2,4,6,4,1,0,4,1,17
401411722,Middle Tennessee Blue Raiders,T. Lenard,4897509,,True,13.0,2,2,0,0,2,2,0,0,0,0,0,0,0,1,2,4,6
401411722,Middle Tennessee Blue Raiders,E. Lawrence,4432029,,True,25.0,1,7,1,4,0,3,0,0,0,4,4,0,0,0,3,4,2
401411722,Middle Tennessee Blue Raiders,D. Sims,4279080,,True,32.0,3,6,2,4,1,2,2,2,0,3,3,2,2,1,1,0,9
401411722,Middle Tennessee Blue Raiders,C. Fussell,4590357,,False,9.0,1,4,1,3,0,1,4,4,2,3,5,0,0,0,0,1,6
401411722,Middle Tennessee Blue Raiders,C. Weston,4897511,,False,32.0,3,4,3,4,0,0,3,4,1,2,3,3,3,0,2,0,9
401411722,Middle Tennessee Blue Raiders,J. Bufford,4897508,,False,24.0,2,4,2,3,0,1,2,2,0,3,3,0,2,1,0,3,6
401411722,Middle Tennessee Blue Raiders,E. King,4431742,,False,19.0,3,7,2,5,1,2,2,2,0,4,4,0,0,0,0,0,9
401411722,Middle Tennessee Blue Raiders,TEAM,TOTAL,TOTAL,False,,20,44,16,33,4,11,20,23,7,27,34,9,8,3,12,14,64
401411722,California Baptist Lancers,J. Stone,4702041,,True,26.0,6,8,6,8,0,0,0,0,6,0,6,1,0,1,1,2,12
401411722,California Baptist Lancers,E. Thomas,4066734,,True,22.0,3,5,3,5,0,0,4,6,1,1,2,0,1,0,1,1,10
401411722,California Baptist Lancers,Ta. Armstrong,4896850,,True,35.0,2,13,1,7,1,6,3,3,2,4,6,7,2,0,3,1,8
401411722,California Baptist Lancers,Tr. Armstrong,4593806,,True,35.0,1,10,0,6,1,4,3,3,2,5,7,2,1,0,0,3,6
401411722,California Baptist Lancers,Ty Rowell,4398423,,True,35.0,5,10,1,2,4,8,0,0,0,1,1,1,2,0,4,3,14
401411722,California Baptist Lancers,M. Wade,4702040,,False,11.0,0,3,0,3,0,0,0,0,1,1,2,0,0,0,1,4,0
401411722,California Baptist Lancers,D. Akin,4279163,,False,6.0,0,1,0,1,0,0,0,0,0,1,1,0,0,0,1,2,0
401411722,California Baptist Lancers,C. Hunter,4592943,,False,15.0,2,4,1,1,1,3,0,0,0,0,0,0,1,0,0,1,5
401411722,California Baptist Lancers,R. Nottage,4593807,,False,15.0,1,5,0,2,1,3,0,0,0,2,2,2,0,0,1,2,3
401411722,California Baptist Lancers,TEAM,TOTAL,TOTAL,False,,20,59,12,35,8,24,10,12,13,19,32,13,7,1,12,19,58
401411721,UNC Asheville Bulldogs,D. Pember,4431793,,True,31.0,5,8,2,3,3,5,4,4,3,5,8,3,3,6,4,2,17
401411721,UNC Asheville Bulldogs,C. Jude,4397803,,True,13.0,1,6,0,0,1,6,0,0,0,4,4,0,0,0,0,0,3
401411721,UNC Asheville Bulldogs,LJ Thorpe,4279050,,True,33.0,4,9,3,8,1,1,2,3,1,3,4,6,3,0,5,3,11
401411721,UNC Asheville Bulldogs,T. Stephney,4592753,,True,26.0,4,5,3,4,1,1,2,3,1,3,4,3,1,0,7,1,11
401411721,UNC Asheville Bulldogs,T. Jones,4279052,,True,34.0,6,12,2,5,4,7,0,0,1,3,4,2,0,0,1,1,16
401411721,UNC Asheville Bulldogs,S. Mason,4702142,,False,11.0,0,0,0,0,0,0,1,4,0,1,1,0,0,0,0,3,1
401411721,UNC Asheville Bulldogs,BJ Marable,4702141,,False,6.0,0,1,0,1,0,0,0,0,1,0,1,0,0,0,1,5,0
401411721,UNC Asheville Bulldogs,J. Battle,4592754,,False,30.0,5,9,5,9,0,0,5,5,3,2,5,2,1,0,1,1,15
401411721,UNC Asheville Bulldogs,Q. Kimble,4283783,,False,16.0,2,3,0,0,2,3,0,0,0,2,2,1,0,0,0,1,6
401411721,UNC Asheville Bulldogs,TEAM,TOTAL,TOTAL,False,,27,53,15,30,12,23,14,19,11,25,36,17,8,6,21,17,80
401411721,Stephen F. Austin Lumberjacks,C. Solomon,4594155,,True,15.0,3,8,3,8,0,0,0,0,2,1,3,0,1,0,1,2,6
401411721,Stephen F. Austin Lumberjacks,G. Kensmil,4279493,,True,38.0,5,12,5,12,0,0,3,6,3,4,7,3,1,0,9,4,13
401411721,Stephen F. Austin Lumberjacks,L. Jossell,4601284,,True,37.0,4,11,2,2,2,9,0,0,0,3,3,1,0,0,2,2,10
401411721,Stephen F. Austin Lumberjacks,N. Hawkins,4397862,,True,30.0,3,4,1,2,2,2,4,4,0,3,3,2,2,0,2,3,12
401411721,Stephen F. Austin Lumberjacks,D. Kachelries,4278450,,True,27.0,2,5,2,2,0,3,0,0,1,2,3,1,1,0,2,0,4
401411721,Stephen F. Austin Lumberjacks,S. Hall,4713935,,False,26.0,6,11,6,10,0,1,1,3,1,2,3,1,0,0,0,2,13
401411721,Stephen F. Austin Lumberjacks,N. Antwi-Boasiako,4703693,,False,2.0,0,0,0,0,0,0,0,0,1,0,1,0,0,0,0,0,0
401411721,Stephen F. Austin Lumberjacks,D. Tezeno,4896946,,False,5.0,1,2,1,2,0,0,0,0,0,0,0,0,0,0,0,0,2
401411721,Stephen F. Austin Lumberjacks,J. Jackson-Posey,4703691,,False,20.0,3,6,3,3,0,3,2,2,0,1,1,3,5,1,0,5,8
401411721,Stephen F. Austin Lumberjacks,TEAM,TOTAL,TOTAL,False,,27,59,23,41,4,18,10,15,10,17,27,11,10,1,16,18,68
401411720,Purdue Fort Wayne Mastodons,B. Planutis,4279863,,True,32.0,1,6,0,1,1,5,0,0,0,3,3,1,1,0,1,0,3
401411720,Purdue Fort Wayne Mastodons,R. Kpedi,4278247,,True,23.0,5,8,5,8,0,0,3,4,3,6,9,0,0,0,1,1,13
401411720,Purdue Fort Wayne Mastodons,J. Godfrey,4398080,,True,32.0,4,14,1,7,3,7,5,5,0,4,4,3,3,0,3,1,16
401411720,Purdue Fort Wayne Mastodons,D. Chong Qui,4397976,,True,34.0,5,10,4,7,1,3,0,3,0,2,2,2,0,1,4,2,11
401411720,Purdue Fort Wayne Mastodons,J. Pipkins,4278735,,True,29.0,4,10,4,9,0,1,3,4,0,1,1,3,1,0,2,2,11
401411720,Purdue Fort Wayne Mastodons,J. DeJurnett,4702942,,False,9.0,2,3,2,3,0,0,1,3,2,2,4,0,0,0,1,2,5
401411720,Purdue Fort Wayne Mastodons,C. Benford,4279505,,False,7.0,0,0,0,0,0,0,0,0,0,0,0,0,1,0,0,1,0
401411720,Purdue Fort Wayne Mastodons,J. Peterson,4898175,,False,27.0,0,0,0,0,0,0,1,2,1,0,1,0,0,1,1,1,1
401411720,Purdue Fort Wayne Mastodons,J. Walker,4702941,,False,7.0,1,2,1,2,0,0,3,4,0,1,1,0,0,0,0,0,5
401411720,Purdue Fort Wayne Mastodons,TEAM,TOTAL,TOTAL,False,,22,53,17,37,5,16,16,25,9,20,29,9,6,2,13,10,65
401411720,Drake Bulldogs,S. Hemphill,4397747,,True,25.0,5,6,5,6,0,0,1,1,0,1,1,2,1,0,1,0,11
401411720,Drake Bulldogs,D. Brodie,4397121,,True,21.0,1,1,1,1,0,0,0,0,1,6,7,1,4,1,3,2,2
401411720,Drake Bulldogs,T. Devries,4837238,,True,25.0,6,13,4,6,2,7,0,0,2,4,6,6,1,0,4,2,14
401411720,Drake Bulldogs,G. Sturtz,4397348,,True,19.0,6,7,6,7,0,0,2,2,1,3,4,2,1,1,0,3,14
401411720,Drake Bulldogs,R. Penn,4279754,,True,19.0,3,6,3,5,0,1,0,0,0,0,0,4,1,0,3,2,6
401411720,Drake Bulldogs,N. Ferguson,4432981,,False,18.0,1,2,1,2,0,0,1,2,1,2,3,1,1,0,0,3,3
401411720,Drake Bulldogs,T. Murphy,4397346,,False,19.0,4,7,2,4,2,3,0,0,0,5,5,1,0,0,0,3,10
401411720,Drake Bulldogs,D. Dahlke,4703095,,False,5.0,1,2,1,2,0,0,0,0,0,1,1,0,0,0,0,2,2
401411720,Drake Bulldogs,J. Jackson,4592680,,False,7.0,1,2,0,0,1,2,0,0,0,1,1,0,0,0,0,0,3
401411720,Drake Bulldogs,O. Djamgouz,4592679,,False,21.0,7,12,1,4,6,8,0,0,0,1,1,0,0,0,0,0,20
401411720,Drake Bulldogs,A. Akinwole,4279508,,False,21.0,1,3,1,2,0,1,0,0,1,1,2,5,0,0,0,5,2
401411720,Drake Bulldogs,TEAM,TOTAL,TOTAL,False,,36,61,25,39,11,22,4,5,6,26,32,22,9,2,12,22,87
401411719,Xavier Musketeers,J. Nunge,4277948,,True,33.0,6,11,6,9,0,2,3,5,6,5,11,4,2,1,0,2,15
401411719,Xavier Musketeers,C. Jones,4433378,,True,40.0,9,13,6,8,3,5,0,0,1,3,4,3,3,0,4,4,21
401411719,Xavier Musketeers,D. Odom,4432632,,True,34.0,8,12,8,12,0,0,2,3,0,3,3,2,0,1,3,4,18
401411719,Xavier Musketeers,A. Kunkel,4398300,,True,23.0,1,9,0,5,1,4,1,2,0,1,1,2,0,0,1,4,4
401411719,Xavier Musketeers,N. Johnson,4067338,,True,37.0,2,8,0,2,2,6,1,3,0,3,3,2,3,1,1,2,7
401411719,Xavier Musketeers,Z. Freemantle,4432869,,False,24.0,2,6,1,5,1,1,1,2,3,5,8,3,0,0,1,3,6
401411719,Xavier Musketeers,J. Hunter,4397011,,False,7.0,1,1,1,1,0,0,0,0,0,0,0,0,0,0,1,1,2
401411719,Xavier Musketeers,C. Edwards,4708074,,False,2.0,0,0,0,0,0,0,0,0,0,0,0,0,0,0,0,0,0
401411719,Xavier Musketeers,TEAM,TOTAL,TOTAL,False,,29,60,22,42,7,18,8,15,11,20,31,16,8,3,11,20,73
401411719,Texas A&M Aggies,H. Coleman III,4432186,,True,24.0,2,4,2,4,0,0,3,4,3,6,9,0,0,0,0,2,7
401411719,Texas A&M Aggies,W. Taylor IV,4683833,,True,17.0,1,4,1,2,0,2,2,2,0,0,0,1,1,0,2,3,4
401411719,Texas A&M Aggies,Q. Jackson,4592829,,True,33.0,5,10,4,7,1,3,12,14,0,6,6,0,1,1,2,4,23
401411719,Texas A&M Aggies,M. Obaseki,4433277,,True,20.0,2,3,2,3,0,0,2,2,0,0,0,0,1,1,0,1,6
401411719,Texas A&M Aggies,T. Radford,4395685,,True,37.0,6,17,5,13,1,4,2,3,4,3,7,1,0,0,3,0,15
401411719,Texas A&M Aggies,E. Henderson,4395706,,False,10.0,0,0,0,0,0,0,0,0,0,2,2,0,0,1,1,3,0
401411719,Texas A&M Aggies,A. Cash,4896467,,False,9.0,0,1,0,1,0,0,0,0,2,0,2,0,1,0,0,1,0
401411719,Texas A&M Aggies,H. Hefner,4433279,,False,15.0,1,4,0,1,1,3,0,0,0,0,0,1,1,0,1,0,3
401411719,Texas A&M Aggies,H. Diarra,4433160,,False,25.0,5,7,3,5,2,2,0,0,0,2,2,3,0,0,4,2,12
401411719,Texas A&M Aggies,A. Gordon,4431779,,False,10.0,1,1,1,1,0,0,0,0,0,3,3,0,0,0,0,1,2
401411719,Texas A&M Aggies,TEAM,TOTAL,TOTAL,False,,23,51,18,37,5,14,21,25,9,23,32,6,5,3,13,17,72
401411718,Washington State Cougars,M. Gueye,4712863,,True,11.0,1,2,1,2,0,0,0,2,1,3,4,0,0,0,0,2,2
401411718,Washington State Cougars,E. Abogidi,4702463,,True,21.0,2,2,2,2,0,0,5,8,4,6,10,2,0,1,2,1,9
401411718,Washington State Cougars,T. Roberts,4702609,,True,35.0,5,14,2,5,3,9,1,2,0,3,3,3,1,0,3,1,14
401411718,Washington State Cougars,TJ Bamba,4596365,,True,24.0,3,8,1,5,2,3,0,1,0,1,1,2,0,0,3,3,8
401411718,Washington State Cougars,M. Flowers,4279455,,True,30.0,2,12,2,7,0,5,1,2,1,1,2,2,2,0,3,2,5
401411718,Washington State Cougars,A. Jakimovski,4702466,,False,15.0,1,4,0,0,1,4,0,0,1,1,2,1,1,0,1,1,3
401411718,Washington State Cougars,DJ Rodman,4432103,,False,17.0,2,6,2,3,0,3,0,0,2,5,7,1,0,0,2,0,4
401411718,Washington State Cougars,M. DeWolf,4279464,,False,1.0,0,0,0,0,0,0,0,0,0,0,0,0,0,0,0,0,0
401411718,Washington State Cougars,D. Jackson,4432926,,False,16.0,2,2,2,2,0,0,1,2,1,1,2,0,0,0,1,2,5
401411718,Washington State Cougars,W. Burghardt,4898379,,False,1.0,0,0,0,0,0,0,0,0,0,0,0,0,0,0,0,0,0
401411718,Washington State Cougars,R. Rapp,4433062,,False,7.0,0,2,0,0,0,2,0,0,0,1,1,0,0,0,2,0,0
401411718,Washington State Cougars,N. Williams,4432850,,False,22.0,1,3,0,0,1,3,3,3,0,4,4,0,0,0,0,4,6
401411718,Washington State Cougars,TEAM,TOTAL,TOTAL,False,,19,55,12,26,7,29,11,20,13,28,41,11,4,1,17,16,56
401411718,Texas A&M Aggies,H. Coleman III,4432186,,True,23.0,8,12,8,12,0,0,0,0,1,5,6,0,0,1,1,3,16
401411718,Texas A&M Aggies,W. Taylor IV,4683833,,True,19.0,2,7,2,5,0,2,0,0,0,0,0,2,1,0,1,4,4
401411718,Texas A&M Aggies,Q. Jackson,4592829,,True,35.0,7,9,6,7,1,2,3,3,0,4,4,6,2,1,2,2,18
401411718,Texas A&M Aggies,M. Obaseki,4433277,,True,30.0,7,14,7,12,0,2,0,2,1,3,4,3,0,0,0,1,14
401411718,Texas A&M Aggies,T. Radford,4395685,,True,30.0,3,8,3,5,0,3,1,3,0,7,7,1,1,0,1,1,7
401411718,Texas A&M Aggies,E. Vaughn,4396916,,False,1.0,0,0,0,0,0,0,0,0,0,1,1,0,0,0,0,1,0
401411718,Texas A&M Aggies,E. Henderson,4395706,,False,9.0,0,1,0,1,0,0,0,0,0,1,1,0,0,1,0,1,0
401411718,Texas A&M Aggies,J. Brown,4702024,,False,3.0,1,2,1,2,0,0,0,1,2,0,2,0,0,0,0,1,2
401411718,Texas A&M Aggies,A. Cash,4896467,,False,6.0,1,3,1,3,0,0,0,0,2,0,2,1,0,0,1,0,2
401411718,Texas A&M Aggies,H. Hefner,4433279,,False,15.0,1,4,1,2,0,2,0,0,2,1,3,0,1,0,1,1,2
401411718,Texas A&M Aggies,H. Diarra,4433160,,False,15.0,2,5,1,3,1,2,2,3,0,2,2,2,0,0,0,4,7
401411718,Texas A&M Aggies,A. Gordon,4431779,,False,13.0,0,1,0,0,0,1,0,1,0,1,1,0,0,0,0,0,0
401411718,Texas A&M Aggies,Z. Walker,4403533,,False,1.0,0,0,0,0,0,0,0,0,0,1,1,0,0,0,0,0,0
401411718,Texas A&M Aggies,TEAM,TOTAL,TOTAL,False,,32,66,30,52,2,14,6,13,12,27,39,15,5,3,8,19,72
401411717,Xavier Musketeers,J. Nunge,4277948,,True,20.0,7,9,6,8,1,1,3,4,7,1,8,3,0,1,0,1,18
401411717,Xavier Musketeers,C. Jones,4433378,,True,38.0,7,15,6,12,1,3,1,2,1,7,8,4,1,0,1,1,16
401411717,Xavier Musketeers,D. Odom,4432632,,True,24.0,2,5,2,5,0,0,0,0,0,0,0,2,1,1,1,3,4
401411717,Xavier Musketeers,A. Kunkel,4398300,,True,40.0,7,16,4,5,3,11,1,2,0,4,4,3,0,0,4,0,18
401411717,Xavier Musketeers,N. Johnson,4067338,,True,39.0,3,8,1,2,2,6,2,2,0,4,4,5,1,0,2,3,10
401411717,Xavier Musketeers,Z. Freemantle,4432869,,False,22.0,8,10,7,8,1,2,1,2,1,5,6,1,0,0,1,1,18
401411717,Xavier Musketeers,J. Hunter,4397011,,False,10.0,0,1,0,1,0,0,0,0,1,1,2,0,1,0,1,1,0
401411717,Xavier Musketeers,B. Stanley,4279788,,False,2.0,0,0,0,0,0,0,0,0,0,0,0,0,0,0,0,0,0
401411717,Xavier Musketeers,C. Edwards,4708074,,False,5.0,0,0,0,0,0,0,0,0,1,0,1,0,0,0,0,0,0
401411717,Xavier Musketeers,TEAM,TOTAL,TOTAL,False,,34,64,26,41,8,23,8,12,14,24,38,18,4,2,10,10,84
401411717,St. Bonaventure Bonnies,O. Osunniyi,4397224,,True,36.0,5,7,5,7,0,0,2,3,0,3,3,2,0,4,1,2,12
401411717,St. Bonaventure Bonnies,J. Holmes,4701016,,True,40.0,5,11,4,8,1,3,4,6,2,3,5,4,3,0,3,0,15
401411717,St. Bonaventure Bonnies,D. Welch,4397221,,True,40.0,8,15,1,5,7,10,2,2,3,4,7,1,1,0,1,4,25
401411717,St. Bonaventure Bonnies,K. Lofton,4397220,,True,40.0,6,15,5,10,1,5,2,2,3,2,5,11,0,0,1,5,15
401411717,St. Bonaventure Bonnies,J. Adaway,4279431,,True,35.0,2,8,2,4,0,4,0,0,0,4,4,0,1,0,0,2,4
401411717,St. Bonaventure Bonnies,A. Coulibaly,4432889,,False,9.0,3,6,3,6,0,0,0,0,1,1,2,0,1,0,1,0,6
401411717,St. Bonaventure Bonnies,Q. Adams,4585591,,False,0.0,0,0,0,0,0,0,0,0,0,1,1,0,0,0,0,1,0
401411717,St. Bonaventure Bonnies,TEAM,TOTAL,TOTAL,False,,29,62,20,40,9,22,10,13,10,18,28,18,6,4,7,14,77
401411716,Washington State Cougars,M. Gueye,4712863,,True,30.0,2,4,1,2,1,2,1,3,3,1,4,1,1,2,0,3,6
401411716,Washington State Cougars,E. Abogidi,4702463,,True,18.0,3,8,3,7,0,1,0,0,3,0,3,1,2,2,0,3,6
401411716,Washington State Cougars,T. Roberts,4702609,,True,32.0,3,9,0,2,3,7,2,2,0,2,2,1,1,0,0,2,11
401411716,Washington State Cougars,TJ Bamba,4596365,,True,8.0,0,3,0,2,0,1,2,2,0,0,0,0,1,0,0,3,2
401411716,Washington State Cougars,M. Flowers,4279455,,True,35.0,11,20,7,10,4,10,1,1,0,2,2,5,3,0,2,1,27
401411716,Washington State Cougars,A. Jakimovski,4702466,,False,9.0,0,3,0,1,0,2,0,0,1,3,4,1,0,0,0,1,0
401411716,Washington State Cougars,DJ Rodman,4432103,,False,25.0,1,2,1,2,0,0,2,2,2,6,8,1,1,0,0,0,4
401411716,Washington State Cougars,M. DeWolf,4279464,,False,4.0,0,0,0,0,0,0,0,0,0,0,0,0,0,0,0,0,0
401411716,Washington State Cougars,D. Jackson,4432926,,False,21.0,7,9,7,9,0,0,0,2,1,6,7,1,0,0,1,3,14
401411716,Washington State Cougars,W. Burghardt,4898379,,False,1.0,0,0,0,0,0,0,0,0,0,0,0,0,0,0,1,0,0
401411716,Washington State Cougars,R. Rapp,4433062,,False,1.0,0,1,0,0,0,1,0,0,0,1,1,0,0,0,0,0,0
401411716,Washington State Cougars,N. Williams,4432850,,False,16.0,2,7,1,4,1,3,2,3,1,1,2,0,2,0,2,3,7
401411716,Washington State Cougars,TEAM,TOTAL,TOTAL,False,,29,66,20,39,9,27,10,15,13,26,39,11,11,4,6,19,77
401411716,BYU Cougars,G. George,4701218,,True,26.0,3,7,2,3,1,4,0,1,0,1,1,2,0,0,1,2,7
401411716,BYU Cougars,C. Lohner,4432208,,True,34.0,3,6,2,2,1,4,2,5,3,8,11,5,2,1,1,4,9
401411716,BYU Cougars,F. Traore,4712348,,True,30.0,7,10,7,10,0,0,2,3,2,6,8,1,0,1,2,2,16
401411716,BYU Cougars,A. Barcello,4278130,,True,35.0,5,14,4,9,1,5,1,2,0,3,3,2,0,0,3,1,12
401411716,BYU Cougars,T. Lucas,4066357,,True,31.0,3,9,3,8,0,1,0,0,0,1,1,1,0,0,5,1,6
401411716,BYU Cougars,A. Ally Atiki,4896973,,False,10.0,0,1,0,1,0,0,2,2,1,3,4,0,0,1,0,5,2
401411716,BYU Cougars,C. Brown,4896976,,False,1.0,1,1,1,1,0,0,0,0,1,1,2,0,0,0,0,0,2
401411716,BYU Cougars,N. Hansen,4896974,,False,2.0,0,2,0,0,0,2,0,0,0,0,0,0,0,0,0,0,0
401411716,BYU Cougars,T. Stewart,4896971,,False,3.0,1,1,1,1,0,0,0,0,0,0,0,0,1,0,0,0,2
401411716,BYU Cougars,S. Johnson,4701219,,False,13.0,0,2,0,1,0,1,2,2,0,2,2,1,0,0,0,1,2
401411716,BYU Cougars,H. Erickson,4701217,,False,3.0,0,0,0,0,0,0,0,0,0,0,0,0,0,0,1,0,0
401411716,BYU Cougars,T. Knell,4593744,,False,12.0,0,3,0,0,0,3,0,0,1,1,2,0,0,0,0,1,0
401411716,BYU Cougars,TEAM,TOTAL,TOTAL,False,,23,56,20,36,3,20,9,15,12,28,40,12,3,3,13,17,58
401411715,Wake Forest Demon Deacons,D. Walton,4066353,,True,33.0,2,5,1,2,1,3,5,8,4,7,11,2,1,1,4,4,10
401411715,Wake Forest Demon Deacons,I. Mucius,4395686,,True,31.0,5,13,2,4,3,9,2,2,0,5,5,0,0,0,0,3,15
401411715,Wake Forest Demon Deacons,J. LaRavia,4592691,,True,23.0,3,7,3,6,0,1,0,0,0,5,5,2,0,1,3,4,6
401411715,Wake Forest Demon Deacons,A. Williams,4592216,,True,40.0,3,11,3,7,0,4,3,5,0,5,5,4,2,1,2,1,9
401411715,Wake Forest Demon Deacons,D. Williamson,4398180,,True,20.0,0,6,0,2,0,4,0,0,0,0,0,1,0,0,3,1,0
401411715,Wake Forest Demon Deacons,K. Sy,4065740,,False,19.0,2,3,2,3,0,0,0,1,1,2,3,1,0,0,3,4,4
401411715,Wake Forest Demon Deacons,C. Whitt,4711679,,False,4.0,0,1,0,0,0,1,0,0,0,0,0,1,0,0,1,0,0
401411715,Wake Forest Demon Deacons,C. Hildreth,4696316,,False,20.0,1,2,0,1,1,1,0,0,1,3,4,2,2,0,2,1,3
401411715,Wake Forest Demon Deacons,D. Monsanto,4432916,,False,10.0,2,5,1,1,1,4,0,0,0,2,2,2,1,0,3,1,5
401411715,Wake Forest Demon Deacons,TEAM,TOTAL,TOTAL,False,,18,53,12,26,6,27,10,16,7,31,38,15,6,3,21,19,52
401411715,Texas A&M Aggies,H. Coleman III,4432186,,True,26.0,4,10,4,9,0,1,0,2,4,1,5,0,1,0,1,2,8
401411715,Texas A&M Aggies,W. Taylor IV,4683833,,True,26.0,5,9,3,4,2,5,0,0,0,3,3,3,3,0,0,4,12
401411715,Texas A&M Aggies,Q. Jackson,4592829,,True,29.0,3,10,3,4,0,6,6,8,0,6,6,2,4,1,3,2,12
401411715,Texas A&M Aggies,M. Obaseki,4433277,,True,28.0,2,8,2,6,0,2,4,7,1,4,5,0,2,0,3,0,8
401411715,Texas A&M Aggies,T. Radford,4395685,,True,31.0,4,6,3,4,1,2,1,2,1,7,8,0,2,0,2,2,10
401411715,Texas A&M Aggies,A. Janecek,4912943,,False,0.0,0,0,0,0,0,0,0,0,0,0,0,0,0,0,0,0,0
401411715,Texas A&M Aggies,E. Vaughn,4396916,,False,1.0,0,0,0,0,0,0,0,0,0,0,0,0,0,0,0,0,0
401411715,Texas A&M Aggies,E. Henderson,4395706,,False,5.0,0,0,0,0,0,0,1,2,0,1,1,0,0,0,0,2,1
401411715,Texas A&M Aggies,J. Brown,4702024,,False,8.0,2,2,2,2,0,0,1,1,0,1,1,0,0,0,0,2,5
401411715,Texas A&M Aggies,D. Watkins,4896468,,False,1.0,0,0,0,0,0,0,0,0,0,0,0,0,0,0,0,0,0
401411715,Texas A&M Aggies,A. Cash,4896467,,False,5.0,0,1,0,1,0,0,1,2,1,0,1,0,0,0,0,1,1
401411715,Texas A&M Aggies,H. Hefner,4433279,,False,14.0,1,4,1,2,0,2,0,0,1,2,3,1,1,0,1,1,2
401411715,Texas A&M Aggies,H. Diarra,4433160,,False,15.0,2,10,0,5,2,5,0,0,1,2,3,1,0,1,0,0,6
401411715,Texas A&M Aggies,A. Gordon,4431779,,False,11.0,1,1,1,1,0,0,0,0,0,1,1,1,1,0,0,0,2
401411715,Texas A&M Aggies,Z. Walker,4403533,,False,0.0,0,0,0,0,0,0,0,0,0,0,0,0,0,0,1,0,0
401411715,Texas A&M Aggies,TEAM,TOTAL,TOTAL,False,,24,61,19,38,5,23,14,24,10,31,41,8,14,2,12,16,67
401411714,Xavier Musketeers,J. Nunge,4277948,,True,28.0,4,8,2,4,2,4,0,1,1,3,4,1,1,3,2,1,10
401411714,Xavier Musketeers,C. Jones,4433378,,True,35.0,6,9,6,9,0,0,3,6,1,7,8,4,0,0,2,4,15
401411714,Xavier Musketeers,D. Odom,4432632,,True,29.0,2,4,2,4,0,0,0,1,0,4,4,4,1,1,2,1,4
401411714,Xavier Musketeers,A. Kunkel,4398300,,True,33.0,5,12,4,8,1,4,3,4,0,4,4,4,0,1,1,1,14
401411714,Xavier Musketeers,N. Johnson,4067338,,True,32.0,4,7,3,3,1,4,3,3,0,0,0,1,1,0,0,3,12
401411714,Xavier Musketeers,Z. Freemantle,4432869,,False,26.0,5,9,5,8,0,1,6,7,2,4,6,0,2,1,3,2,16
401411714,Xavier Musketeers,D. Miles,4431781,,False,5.0,0,0,0,0,0,0,0,0,1,0,1,0,0,0,0,1,0
401411714,Xavier Musketeers,J. Hunter,4397011,,False,8.0,0,1,0,1,0,0,1,2,0,3,3,0,0,0,0,0,1
401411714,Xavier Musketeers,C. Edwards,4708074,,False,4.0,1,1,0,0,1,1,0,0,0,0,0,0,0,0,0,1,3
401411714,Xavier Musketeers,TEAM,TOTAL,TOTAL,False,,27,51,22,37,5,14,16,24,5,26,31,14,5,6,10,14,75
401411714,Vanderbilt Commodores,L. Robbins,4397347,,True,24.0,4,7,4,7,0,0,1,3,1,6,7,3,0,1,1,3,9
401411714,Vanderbilt Commodores,M. Stute,4433340,,True,27.0,4,7,0,0,4,7,0,0,1,3,4,1,1,0,1,3,12
401411714,Vanderbilt Commodores,J. Wright,4432920,,True,33.0,4,9,3,5,1,4,2,3,1,2,3,1,0,0,2,5,11
401411714,Vanderbilt Commodores,S. Pippen Jr.,4431785,,True,38.0,8,21,5,14,3,7,9,10,2,7,9,7,2,0,5,0,28
401411714,Vanderbilt Commodores,R. Chatman,4067250,,True,30.0,0,6,0,2,0,4,0,0,0,0,0,2,1,1,1,1,0
401411714,Vanderbilt Commodores,Q. Millora-Brown,4397691,,False,19.0,1,1,1,1,0,0,0,0,1,1,2,0,0,0,0,3,2
401411714,Vanderbilt Commodores,T. Lawrence,4702530,,False,22.0,4,7,4,5,0,2,0,0,0,3,3,0,1,0,0,1,8
401411714,Vanderbilt Commodores,S. Dezonie,4683732,,False,0.0,0,0,0,0,0,0,0,0,0,0,0,0,0,0,0,0,0
401411714,Vanderbilt Commodores,J. Mann,4589479,,False,7.0,1,1,1,1,0,0,1,2,1,0,1,0,0,0,0,2,3
401411714,Vanderbilt Commodores,TEAM,TOTAL,TOTAL,False,,26,59,18,35,8,24,13,18,10,24,34,14,5,2,10,18,73
401411713,Virginia Cavaliers,K. Shedrick,4431710,,True,27.0,3,4,3,4,0,0,2,2,2,7,9,0,1,2,2,2,8
401411713,Virginia Cavaliers,J. Gardner,4396614,,True,38.0,7,15,7,15,0,0,0,1,3,2,5,0,0,0,0,0,14
401411713,Virginia Cavaliers,R. Beekman,4432187,,True,37.0,3,6,3,5,0,1,0,0,0,6,6,6,0,0,4,5,6
401411713,Virginia Cavaliers,A. Franklin,4431744,,True,28.0,5,11,0,0,5,11,2,3,0,6,6,0,0,0,1,4,17
401411713,Virginia Cavaliers,K. Clark,4395677,,True,40.0,0,7,0,3,0,4,2,2,0,1,1,6,0,0,2,0,2
401411713,Virginia Cavaliers,F. Caffaro,4395679,,False,13.0,2,3,2,3,0,0,0,0,1,3,4,0,0,0,0,0,4
401411713,Virginia Cavaliers,M. Poindexter,4701986,,False,2.0,0,0,0,0,0,0,0,0,0,0,0,0,0,0,0,0,0
401411713,Virginia Cavaliers,K. Stattmann,4395680,,False,15.0,0,7,0,4,0,3,0,0,1,1,2,1,1,0,0,0,0
401411713,Virginia Cavaliers,TEAM,TOTAL,TOTAL,False,,20,53,15,34,5,19,6,8,8,27,35,13,2,2,9,11,51
401411713,St. Bonaventure Bonnies,O. Osunniyi,4397224,,True,27.0,3,5,3,5,0,0,4,4,2,4,6,1,0,4,4,4,10
401411713,St. Bonaventure Bonnies,J. Holmes,4701016,,True,40.0,4,12,4,10,0,2,2,2,0,5,5,0,0,0,0,1,10
401411713,St. Bonaventure Bonnies,D. Welch,4397221,,True,40.0,4,12,2,5,2,7,0,0,1,9,10,2,1,0,1,1,10
401411713,St. Bonaventure Bonnies,K. Lofton,4397220,,True,40.0,3,10,3,7,0,3,3,3,0,5,5,5,3,0,2,3,9
401411713,St. Bonaventure Bonnies,J. Adaway,4279431,,True,40.0,4,11,3,8,1,3,0,0,1,1,2,1,0,0,0,2,9
401411713,St. Bonaventure Bonnies,A. Coulibaly,4432889,,False,13.0,2,4,2,4,0,0,0,0,2,3,5,0,1,1,0,1,4
401411713,St. Bonaventure Bonnies,TEAM,TOTAL,TOTAL,False,,20,54,17,39,3,15,9,9,7,27,34,9,5,5,7,12,52
401411712,Virginia Cavaliers,J. Gardner,4396614,,True,38.0,7,17,7,17,0,0,3,4,1,2,3,2,1,0,1,4,17
401411712,Virginia Cavaliers,F. Caffaro,4395679,,True,20.0,0,1,0,1,0,0,1,4,2,1,3,0,0,0,1,5,1
401411712,Virginia Cavaliers,R. Beekman,4432187,,True,45.0,6,9,5,8,1,1,0,1,2,5,7,9,3,0,1,1,13
401411712,Virginia Cavaliers,A. Franklin,4431744,,True,26.0,5,8,0,1,5,7,2,2,0,1,1,0,0,0,1,1,17
401411712,Virginia Cavaliers,K. Clark,4395677,,True,44.0,4,11,2,4,2,7,1,2,0,3,3,4,3,0,1,0,11
401411712,Virginia Cavaliers,K. Shedrick,4431710,,False,11.0,1,2,1,2,0,0,1,2,0,0,0,0,0,0,0,5,3
401411712,Virginia Cavaliers,M. Poindexter,4701986,,False,3.0,0,0,0,0,0,0,0,0,0,0,0,0,0,0,0,0,0
401411712,Virginia Cavaliers,T. Murray,4692906,,False,3.0,0,0,0,0,0,0,0,0,0,0,0,0,0,0,0,0,0
401411712,Virginia Cavaliers,K. Stattmann,4395680,,False,35.0,3,6,2,4,1,2,2,4,2,8,10,0,0,1,0,1,9
401411712,Virginia Cavaliers,TEAM,TOTAL,TOTAL,False,,26,54,17,37,9,17,10,19,9,22,31,15,7,1,6,17,71
401411712,North Texas Mean Green,A. Ousmane,4702773,,True,30.0,6,10,6,10,0,0,4,5,1,3,4,0,1,1,1,5,16
401411712,North Texas Mean Green,T. Bell,4592870,,True,45.0,5,13,5,11,0,2,2,3,4,8,12,6,0,0,3,4,12
401411712,North Texas Mean Green,T. Perry,4897518,,True,45.0,5,13,3,6,2,7,4,4,0,4,4,2,1,0,4,2,16
401411712,North Texas Mean Green,M. McBride,4702770,,True,45.0,7,15,1,4,6,11,1,2,0,0,0,0,0,2,1,0,21
401411712,North Texas Mean Green,JJ Murray,4397560,,True,41.0,0,3,0,1,0,2,0,0,1,3,4,5,0,0,1,3,0
401411712,North Texas Mean Green,M. Stone,4897523,,False,5.0,1,1,1,1,0,0,0,0,2,0,2,0,0,0,0,0,2
401411712,North Texas Mean Green,A. Scott,4897517,,False,14.0,1,1,1,1,0,0,0,0,1,3,4,0,0,0,1,3,2
401411712,North Texas Mean Green,TEAM,TOTAL,TOTAL,False,,25,56,17,34,8,22,11,14,12,23,35,13,2,3,11,17,69
401411711,Northern Iowa Panthers,N. Carter,4431923,,True,33.0,9,16,6,8,3,8,3,6,0,5,5,2,0,0,2,2,24
401411711,Northern Iowa Panthers,N. Heise,4703912,,True,21.0,0,5,0,1,0,4,0,0,0,5,5,2,0,0,1,2,0
401411711,Northern Iowa Panthers,AJ Green,4397475,,True,39.0,6,15,2,10,4,5,0,0,1,2,3,5,1,0,4,3,16
401411711,Northern Iowa Panthers,T. Berhow,4280203,,True,32.0,4,8,2,3,2,5,3,3,0,7,7,1,1,0,2,4,13
401411711,Northern Iowa Panthers,T. Pickford,4279167,,True,31.0,3,4,2,3,1,1,0,0,0,4,4,3,1,0,1,0,7
401411711,Northern Iowa Panthers,D. Krogmann,4592718,,False,2.0,0,0,0,0,0,0,0,0,0,1,1,0,0,0,0,0,0
401411711,Northern Iowa Panthers,C. Henry,4433004,,False,4.0,0,0,0,0,0,0,0,0,1,0,1,0,0,0,0,0,0
401411711,Northern Iowa Panthers,J. Betz,4431904,,False,1.0,0,0,0,0,0,0,0,0,0,0,0,0,0,0,0,0,0
401411711,Northern Iowa Panthers,A. Phyfe,4279169,,False,6.0,2,3,2,3,0,0,0,0,2,0,2,0,0,1,0,1,4
401411711,Northern Iowa Panthers,D. Daniel,4703915,,False,2.0,0,0,0,0,0,0,0,0,0,0,0,1,1,0,0,0,0
401411711,Northern Iowa Panthers,T. Anderson,4703914,,False,2.0,0,0,0,0,0,0,0,0,0,0,0,0,0,0,0,0,0
401411711,Northern Iowa Panthers,B. Born,4703913,,False,25.0,2,6,1,3,1,3,2,2,0,2,2,1,0,0,1,2,7
401411711,Northern Iowa Panthers,A. Kimmons,4433020,,False,2.0,0,1,0,0,0,1,0,0,0,0,0,0,0,0,0,0,0
401411711,Northern Iowa Panthers,TEAM,TOTAL,TOTAL,False,,26,58,15,31,11,27,8,11,5,29,34,15,4,1,12,14,71
401411711,BYU Cougars,G. George,4701218,,True,28.0,10,15,5,6,5,9,2,3,1,5,6,1,0,0,1,1,27
401411711,BYU Cougars,C. Lohner,4432208,,True,28.0,3,5,1,2,2,3,0,1,1,3,4,2,1,2,0,2,8
401411711,BYU Cougars,F. Traore,4712348,,True,17.0,2,5,2,5,0,0,0,0,2,5,7,1,0,0,1,1,4
401411711,BYU Cougars,A. Barcello,4278130,,True,32.0,5,13,4,5,1,8,0,1,0,5,5,7,2,0,2,2,11
401411711,BYU Cougars,T. Lucas,4066357,,True,31.0,7,12,7,9,0,3,0,0,1,2,3,8,1,0,1,0,14
401411711,BYU Cougars,A. Ally Atiki,4896973,,False,11.0,1,2,1,2,0,0,0,0,2,1,3,1,0,1,0,3,2
401411711,BYU Cougars,C. Brown,4896976,,False,2.0,0,0,0,0,0,0,0,0,0,0,0,0,0,0,0,0,0
401411711,BYU Cougars,N. Hansen,4896974,,False,2.0,1,1,0,0,1,1,0,0,0,0,0,0,0,0,0,0,3
401411711,BYU Cougars,T. Stewart,4896971,,False,2.0,0,1,0,1,0,0,0,0,0,2,2,0,0,0,0,0,0
401411711,BYU Cougars,S. Johnson,4701219,,False,21.0,2,6,0,1,2,5,0,0,0,1,1,1,1,0,0,1,6
401411711,BYU Cougars,H. Erickson,4701217,,False,2.0,0,0,0,0,0,0,0,0,0,0,0,1,0,0,1,0,0
401411711,BYU Cougars,T. Knell,4593744,,False,24.0,5,9,0,1,5,8,0,1,0,2,2,0,0,0,0,0,15
401411711,BYU Cougars,TEAM,TOTAL,TOTAL,False,,36,69,20,32,16,37,2,6,8,28,36,22,5,3,6,10,90
401411710,Washington State Cougars,M. Gueye,4712863,,True,13.0,1,6,1,6,0,0,0,0,3,2,5,0,2,0,0,2,2
401411710,Washington State Cougars,E. Abogidi,4702463,,True,25.0,4,8,3,6,1,2,3,5,4,4,8,2,1,3,1,0,12
401411710,Washington State Cougars,T. Roberts,4702609,,True,36.0,3,10,2,4,1,6,2,2,3,3,6,3,0,0,2,4,9
401411710,Washington State Cougars,TJ Bamba,4596365,,True,27.0,3,9,2,5,1,4,6,6,1,3,4,0,1,0,1,0,13
401411710,Washington State Cougars,M. Flowers,4279455,,True,28.0,6,13,3,5,3,8,7,7,0,2,2,3,0,0,2,3,22
401411710,Washington State Cougars,A. Jakimovski,4702466,,False,12.0,1,3,1,2,0,1,0,0,1,1,2,1,0,0,0,1,2
401411710,Washington State Cougars,DJ Rodman,4432103,,False,19.0,0,3,0,2,0,1,2,2,2,4,6,1,1,0,0,0,2
401411710,Washington State Cougars,D. Jackson,4432926,,False,21.0,4,7,4,7,0,0,0,0,2,7,9,1,0,0,0,2,8
401411710,Washington State Cougars,N. Williams,4432850,,False,19.0,1,6,1,4,0,2,3,4,0,1,1,1,1,0,2,0,5
401411710,Washington State Cougars,TEAM,TOTAL,TOTAL,False,,23,65,17,41,6,24,23,26,18,28,46,12,6,3,9,12,75
401411710,SMU Mustangs,Ma. Weathers,4067390,,True,33.0,2,9,1,5,1,4,3,4,0,5,5,1,0,0,2,3,8
401411710,SMU Mustangs,E. Bandoumel,4593107,,True,34.0,1,8,1,4,0,4,2,2,0,2,2,2,0,0,1,1,4
401411710,SMU Mustangs,Z. Nutall,4398281,,True,31.0,1,5,0,2,1,3,0,0,2,5,7,1,1,0,0,2,3
401411710,SMU Mustangs,K. Davis,4397066,,True,37.0,9,18,7,10,2,8,10,10,1,2,3,2,1,0,4,3,30
401411710,SMU Mustangs,Mi. Weathers,4067391,,True,35.0,8,15,8,15,0,0,0,0,2,6,8,2,2,1,1,4,16
401411710,SMU Mustangs,S. Todorovic,4897080,,False,0.0,0,0,0,0,0,0,0,0,0,0,0,0,0,0,0,0,0
401411710,SMU Mustangs,F. Agunanne,4397431,,False,11.0,0,0,0,0,0,0,0,0,1,3,4,0,0,1,3,3,0
401411710,SMU Mustangs,J. Young Jr.,4396640,,False,3.0,0,0,0,0,0,0,0,0,0,0,0,0,0,0,0,1,0
401411710,SMU Mustangs,T. Clark,4277885,,False,9.0,1,2,1,2,0,0,0,0,0,0,0,0,0,0,0,1,2
401411710,SMU Mustangs,Z. Phelps,4699725,,False,6.0,0,1,0,0,0,1,0,0,0,0,0,0,0,0,0,1,0
401411710,SMU Mustangs,J. Smith,4690767,,False,1.0,0,0,0,0,0,0,0,0,0,0,0,0,0,0,0,0,0
401411710,SMU Mustangs,TEAM,TOTAL,TOTAL,False,,22,58,18,38,4,20,15,16,7,25,32,8,4,2,11,19,63
401411709,Wake Forest Demon Deacons,D. Walton,4066353,,True,30.0,5,6,3,3,2,3,4,4,0,7,7,1,2,0,1,4,16
401411709,Wake Forest Demon Deacons,I. Mucius,4395686,,True,18.0,0,1,0,0,0,1,0,0,0,0,0,1,1,1,2,4,0
401411709,Wake Forest Demon Deacons,J. LaRavia,4592691,,True,31.0,5,11,4,7,1,4,4,4,2,4,6,3,2,0,1,4,15
401411709,Wake Forest Demon Deacons,A. Williams,4592216,,True,37.0,6,13,5,9,1,4,6,12,1,3,4,5,1,0,6,2,19
401411709,Wake Forest Demon Deacons,D. Williamson,4398180,,True,33.0,3,7,1,3,2,4,6,6,0,2,2,2,0,1,1,0,14
401411709,Wake Forest Demon Deacons,K. Sy,4065740,,False,10.0,0,2,0,1,0,1,0,0,0,0,0,0,1,1,1,2,0
401411709,Wake Forest Demon Deacons,C. Hildreth,4696316,,False,21.0,2,5,2,2,0,3,6,8,1,4,5,2,3,0,2,2,10
401411709,Wake Forest Demon Deacons,D. Monsanto,4432916,,False,20.0,1,6,0,1,1,5,3,3,2,2,4,0,2,0,0,4,6
401411709,Wake Forest Demon Deacons,TEAM,TOTAL,TOTAL,False,,22,51,15,26,7,25,29,37,8,23,31,14,12,3,15,23,80
401411709,VCU Rams,H. Ward,4592495,,True,18.0,2,3,2,3,0,0,4,4,2,2,4,2,2,2,0,4,8
401411709,VCU Rams,V. Williams Jr.,4397227,,True,37.0,7,15,4,6,3,9,10,11,2,6,8,0,1,1,5,3,27
401411709,VCU Rams,J. Nunn,4896614,,True,38.0,6,11,0,1,6,10,0,0,0,3,3,2,1,0,2,4,18
401411709,VCU Rams,A. Baldwin Jr.,4433182,,True,27.0,0,7,0,4,0,3,4,6,1,2,3,4,1,0,4,5,4
401411709,VCU Rams,K. Curry,4397228,,True,28.0,1,5,1,4,0,1,4,4,0,4,4,0,2,0,1,5,6
401411709,VCU Rams,M. Brown-Jones,4433224,,False,7.0,0,1,0,0,0,1,0,0,0,2,2,0,0,0,0,2,0
401411709,VCU Rams,J. DeLoach,4432483,,False,15.0,3,3,3,3,0,0,1,2,4,4,8,2,1,0,2,0,7
401411709,VCU Rams,L. Stockard III,4277897,,False,7.0,2,4,2,4,0,0,0,0,0,0,0,0,0,1,1,2,4
401411709,VCU Rams,N. Kern,4684145,,False,14.0,0,1,0,1,0,0,0,0,0,0,0,0,1,0,3,1,0
401411709,VCU Rams,M. Tsohonis,4592438,,False,2.0,0,0,0,0,0,0,0,0,0,0,0,0,0,0,0,0,0
401411709,VCU Rams,J. Banks,4432402,,False,7.0,0,2,0,1,0,1,0,0,0,0,0,1,0,0,1,0,0
401411709,VCU Rams,TEAM,TOTAL,TOTAL,False,,21,52,12,27,9,25,23,27,9,23,32,11,9,4,19,26,74
401411708,Vanderbilt Commodores,L. Robbins,4397347,,True,21.0,2,5,2,4,0,1,0,0,3,2,5,0,0,2,0,1,4
401411708,Vanderbilt Commodores,M. Stute,4433340,,True,32.0,2,6,0,1,2,5,0,0,0,5,5,0,0,0,0,4,6
401411708,Vanderbilt Commodores,J. Wright,4432920,,True,30.0,1,8,0,5,1,3,2,2,3,3,6,1,2,0,3,4,5
401411708,Vanderbilt Commodores,S. Pippen Jr.,4431785,,True,43.0,9,24,6,15,3,9,11,13,2,2,4,7,3,0,0,2,32
401411708,Vanderbilt Commodores,R. Chatman,4067250,,True,41.0,3,9,0,3,3,6,0,2,0,3,3,3,0,0,2,2,9
401411708,Vanderbilt Commodores,Q. Millora-Brown,4397691,,False,22.0,3,4,3,4,0,0,0,0,3,3,6,0,0,2,1,5,6
401411708,Vanderbilt Commodores,T. Lawrence,4702530,,False,13.0,2,4,1,2,1,2,0,0,0,1,1,0,0,0,0,0,5
401411708,Vanderbilt Commodores,S. Dezonie,4683732,,False,7.0,0,0,0,0,0,0,0,0,0,2,2,0,0,0,0,1,0
401411708,Vanderbilt Commodores,J. Mann,4589479,,False,16.0,1,2,1,2,0,0,1,3,0,3,3,1,1,0,1,1,3
401411708,Vanderbilt Commodores,TEAM,TOTAL,TOTAL,False,,23,62,13,36,10,26,14,20,11,26,37,12,6,4,9,20,70
401411708,Dayton Flyers,R.J. Blakney,4700864,,True,26.0,0,2,0,0,0,2,2,2,2,3,5,2,0,0,0,4,2
401411708,Dayton Flyers,T. Camara,4431736,,True,29.0,3,6,3,5,0,1,5,8,1,5,6,0,2,1,2,4,11
401411708,Dayton Flyers,D. Holmes II,4433607,,True,39.0,8,11,8,11,0,0,1,4,0,8,8,1,0,2,3,2,17
401411708,Dayton Flyers,K. Elvis,4683135,,True,41.0,8,21,6,14,2,7,2,2,1,2,3,5,0,0,5,2,20
401411708,Dayton Flyers,K. Brea,4591259,,True,45.0,3,9,1,5,2,4,0,0,0,4,4,1,0,0,2,1,8
401411708,Dayton Flyers,M. Sissoko,4431824,,False,6.0,4,4,4,4,0,0,0,0,0,0,0,0,0,0,0,1,8
401411708,Dayton Flyers,M. Amzil,4711607,,False,19.0,0,1,0,0,0,1,2,2,0,5,5,0,0,0,0,3,2
401411708,Dayton Flyers,K. Washington,4684293,,False,16.0,0,1,0,1,0,0,0,0,0,1,1,0,0,0,0,2,0
401411708,Dayton Flyers,C. Wilson,4403456,,False,4.0,0,1,0,0,0,1,0,0,0,0,0,0,0,0,0,0,0
401411708,Dayton Flyers,TEAM,TOTAL,TOTAL,False,,26,56,22,40,4,16,12,18,5,30,35,9,2,3,13,19,68
401411707,Toledo Rockets,J. Shumate,4703541,,True,33.0,0,11,0,4,0,7,0,0,2,5,7,4,1,2,1,3,0
401411707,Toledo Rockets,S. Millner Jr.,4703540,,True,37.0,8,14,7,11,1,3,1,1,3,4,7,1,3,0,0,0,18
401411707,Toledo Rockets,R. Moss,4703538,,True,36.0,3,9,2,6,1,3,1,2,3,4,7,2,0,1,4,2,8
401411707,Toledo Rockets,R. Rollins,4591725,,True,36.0,6,21,5,15,1,6,1,1,0,3,3,1,1,0,0,3,14
401411707,Toledo Rockets,R. Dennis,4431941,,True,34.0,6,11,5,8,1,3,0,0,1,1,2,4,1,0,1,2,13
401411707,Toledo Rockets,M. Carcoana,4898344,,False,7.0,0,1,0,0,0,1,0,0,0,3,3,0,0,1,0,1,0
401411707,Toledo Rockets,K. Jacobi,4898343,,False,3.0,0,0,0,0,0,0,0,0,1,0,1,0,0,0,0,0,0
401411707,Toledo Rockets,E. Wilson,4898341,,False,5.0,0,0,0,0,0,0,0,0,0,1,1,0,0,0,0,0,0
401411707,Toledo Rockets,E. Farmer,4683945,,False,4.0,0,1,0,1,0,0,0,0,0,0,0,0,0,0,0,0,0
401411707,Toledo Rockets,K. Saunders,4397880,,False,5.0,1,1,1,1,0,0,0,0,0,0,0,0,0,0,1,0,2
401411707,Toledo Rockets,TEAM,TOTAL,TOTAL,False,,24,69,20,46,4,23,3,4,12,22,34,12,6,4,7,11,55
401411707,Dayton Flyers,R.J. Blakney,4700864,,True,26.0,3,7,3,4,0,3,3,3,2,1,3,4,0,0,0,0,9
401411707,Dayton Flyers,T. Camara,4431736,,True,25.0,3,7,3,6,0,1,0,0,0,7,7,1,0,2,2,3,6
401411707,Dayton Flyers,D. Holmes II,4433607,,True,30.0,10,16,10,16,0,0,0,0,2,4,6,3,1,2,3,2,20
401411707,Dayton Flyers,K. Elvis,4683135,,True,35.0,5,11,4,7,1,4,0,0,1,6,7,8,1,0,1,0,11
401411707,Dayton Flyers,K. Brea,4591259,,True,33.0,5,11,2,5,3,6,0,0,0,10,10,2,1,0,1,1,13
401411707,Dayton Flyers,M. Sissoko,4431824,,False,10.0,4,5,4,5,0,0,0,0,2,0,2,0,0,0,0,0,8
401411707,Dayton Flyers,M. Amzil,4711607,,False,21.0,1,2,1,1,0,1,0,0,1,4,5,2,1,1,1,0,2
401411707,Dayton Flyers,K. Washington,4684293,,False,12.0,2,3,1,2,1,1,0,0,0,1,1,1,1,0,0,1,5
401411707,Dayton Flyers,Z. Nwokeji,4618121,,False,2.0,0,0,0,0,0,0,0,0,0,0,0,0,0,0,0,0,0
401411707,Dayton Flyers,C. Wilson,4403456,,False,5.0,0,0,0,0,0,0,0,0,0,1,1,0,0,0,0,1,0
401411707,Dayton Flyers,D. Swerlein,4600089,,False,1.0,0,1,0,0,0,1,0,0,0,0,0,0,0,0,0,0,0
401411707,Dayton Flyers,TEAM,TOTAL,TOTAL,False,,33,63,28,46,5,17,3,3,8,34,42,21,5,5,8,8,74
401411706,Long Beach State Beach,J. Roberts,4278751,,True,35.0,4,15,3,9,1,6,7,11,1,5,6,0,1,0,0,3,16
401411706,Long Beach State Beach,J. Murray,4897669,,True,36.0,9,17,9,15,0,2,6,6,0,0,0,2,2,0,1,1,24
401411706,Long Beach State Beach,J. Jones,4611534,,True,35.0,2,9,1,3,1,6,8,10,1,6,7,1,2,0,3,4,13
401411706,Long Beach State Beach,D. Cobb,4397496,,True,30.0,0,6,0,3,0,3,3,4,2,2,4,1,0,0,2,2,3
401411706,Long Beach State Beach,C. Slater,4066475,,True,28.0,4,7,3,4,1,3,6,6,1,1,2,0,2,0,2,5,15
401411706,Long Beach State Beach,T. Rotegaard,4703135,,False,11.0,0,1,0,0,0,1,0,0,0,2,2,0,0,0,0,1,0
401411706,Long Beach State Beach,R. Mansel,4431835,,False,1.0,0,0,0,0,0,0,0,0,0,0,0,0,0,0,0,0,0
401411706,Long Beach State Beach,J. Yan,4410862,,False,1.0,0,0,0,0,0,0,0,0,0,0,0,0,0,0,0,0,0
401411706,Long Beach State Beach,RJ Rhoden,4592940,,False,9.0,0,1,0,0,0,1,1,4,1,0,1,0,0,0,0,1,1
401411706,Long Beach State Beach,E. Scott,4279560,,False,14.0,0,1,0,1,0,0,0,0,0,3,3,0,0,0,0,0,0
401411706,Long Beach State Beach,TEAM,TOTAL,TOTAL,False,,19,57,16,35,3,22,31,41,9,21,30,4,7,0,8,17,72
401411706,BYU Cougars,G. George,4701218,,True,15.0,6,9,4,6,2,3,2,3,0,2,2,2,1,0,3,2,16
401411706,BYU Cougars,C. Lohner,4432208,,True,24.0,9,11,8,10,1,1,1,2,2,2,4,2,0,0,2,3,20
401411706,BYU Cougars,F. Traore,4712348,,True,24.0,5,6,5,6,0,0,1,2,1,6,7,3,0,3,1,3,11
401411706,BYU Cougars,A. Barcello,4278130,,True,35.0,5,13,1,4,4,9,0,0,0,5,5,5,0,0,3,2,14
401411706,BYU Cougars,T. Lucas,4066357,,True,30.0,3,5,3,3,0,2,0,0,0,3,3,7,0,0,1,2,6
401411706,BYU Cougars,A. Ally Atiki,4896973,,False,13.0,3,5,3,5,0,0,2,2,4,5,9,0,0,1,3,3,8
401411706,BYU Cougars,C. Brown,4896976,,False,1.0,0,1,0,0,0,1,0,0,0,0,0,0,0,0,0,0,0
401411706,BYU Cougars,N. Hansen,4896974,,False,2.0,0,0,0,0,0,0,0,0,0,0,0,0,0,0,0,0,0
401411706,BYU Cougars,T. Stewart,4896971,,False,5.0,0,2,0,0,0,2,0,0,0,1,1,1,0,0,0,2,0
401411706,BYU Cougars,S. Johnson,4701219,,False,18.0,2,7,1,2,1,5,1,2,2,2,4,3,1,0,0,3,6
401411706,BYU Cougars,H. Erickson,4701217,,False,9.0,1,1,1,1,0,0,0,0,1,3,4,1,1,0,0,3,2
401411706,BYU Cougars,T. Knell,4593744,,False,24.0,2,5,0,0,2,5,4,4,0,3,3,4,0,0,1,2,10
401411706,BYU Cougars,TEAM,TOTAL,TOTAL,False,,36,65,26,37,10,28,11,15,10,35,45,28,3,4,14,25,93
401411705,Iona Gaels,D. van Eyck,4593320,,True,28.0,5,9,2,5,3,4,2,6,2,2,4,4,0,0,1,3,15
401411705,Iona Gaels,N. Junior Joseph,4703015,,True,33.0,8,12,8,12,0,0,2,2,6,6,12,0,1,0,3,2,18
401411705,Iona Gaels,B. JeanLouis,4703008,,True,6.0,0,0,0,0,0,0,0,0,0,0,0,3,0,0,3,3,0
401411705,Iona Gaels,E. Joiner,4278407,,True,26.0,5,9,3,4,2,5,1,3,1,6,7,1,2,1,3,3,13
401411705,Iona Gaels,T. Jolly,4066291,,True,39.0,7,15,7,12,0,3,1,2,2,2,4,4,2,0,1,3,15
401411705,Iona Gaels,O. Shema,4703016,,False,7.0,2,2,2,2,0,0,1,1,0,1,1,0,0,0,0,1,5
401411705,Iona Gaels,Q. Slazinski,4431768,,False,12.0,0,1,0,0,0,1,0,0,0,0,0,2,0,0,2,1,0
401411705,Iona Gaels,J. Duach,4896373,,False,2.0,0,1,0,0,0,1,0,0,0,0,0,0,0,0,1,1,0
401411705,Iona Gaels,W. Clayton Jr.,4896372,,False,27.0,2,8,1,5,1,3,3,4,0,2,2,1,4,0,1,1,8
401411705,Iona Gaels,R. Myers,4703009,,False,18.0,0,6,0,3,0,3,0,0,0,1,1,1,0,0,1,2,0
401411705,Iona Gaels,P. Weiss,4593317,,False,2.0,0,0,0,0,0,0,0,0,0,1,1,0,0,0,0,0,0
401411705,Iona Gaels,TEAM,TOTAL,TOTAL,False,,29,63,23,43,6,20,10,18,15,22,37,16,9,1,16,20,74
401411705,Florida Gators,C. Castleton,4397204,,True,33.0,8,14,8,13,0,1,2,3,5,8,13,0,2,0,2,2,18
401411705,Florida Gators,K. Reeves,4683757,,True,30.0,5,10,2,2,3,8,1,3,2,4,6,0,1,0,1,1,14
401411705,Florida Gators,T. Appleby,4280299,,True,29.0,3,11,0,4,3,7,5,6,0,3,3,5,0,2,3,1,14
401411705,Florida Gators,B. McKissic,4280190,,True,19.0,0,3,0,3,0,0,0,0,0,1,1,3,1,0,2,1,0
401411705,Florida Gators,P. Fleming Jr.,4278688,,True,31.0,8,16,8,13,0,3,2,2,3,2,5,1,2,2,0,2,18
401411705,Florida Gators,T. Gatkek,4896453,,False,7.0,2,2,2,2,0,0,0,0,2,0,2,0,1,0,0,3,4
401411705,Florida Gators,E. Kennedy,4879743,,False,4.0,0,1,0,0,0,1,0,0,0,0,0,0,0,0,0,0,0
401411705,Florida Gators,N. Lane,4565449,,False,21.0,3,3,3,3,0,0,0,0,0,1,1,2,1,1,1,1,6
401411705,Florida Gators,M. Jones,4397238,,False,26.0,1,4,0,0,1,4,2,2,1,2,3,2,3,0,3,1,5
401411705,Florida Gators,TEAM,TOTAL,TOTAL,False,,30,64,23,40,7,24,12,16,15,24,39,13,11,5,13,12,79
401411704,Virginia Cavaliers,K. Shedrick,4431710,,True,14.0,1,3,1,3,0,0,0,0,0,3,3,0,0,0,1,2,2
401411704,Virginia Cavaliers,J. Gardner,4396614,,True,36.0,7,13,7,12,0,1,2,4,1,2,3,1,0,0,2,2,16
401411704,Virginia Cavaliers,R. Beekman,4432187,,True,37.0,5,7,5,6,0,1,4,5,0,3,3,6,4,0,1,1,14
401411704,Virginia Cavaliers,A. Franklin,4431744,,True,19.0,2,8,0,3,2,5,0,0,0,2,2,0,0,0,0,1,6
401411704,Virginia Cavaliers,K. Clark,4395677,,True,39.0,1,3,1,1,0,2,6,8,0,0,0,9,0,0,2,1,8
401411704,Virginia Cavaliers,F. Caffaro,4395679,,False,30.0,4,5,4,5,0,0,0,0,2,3,5,1,0,1,2,4,8
401411704,Virginia Cavaliers,T. Murray,4692906,,False,10.0,1,2,1,1,0,1,0,0,0,2,2,0,0,0,0,0,2
401411704,Virginia Cavaliers,K. Stattmann,4395680,,False,15.0,2,5,2,3,0,2,0,0,0,3,3,0,0,0,1,0,4
401411704,Virginia Cavaliers,TEAM,TOTAL,TOTAL,False,,23,46,21,34,2,12,12,17,4,20,24,17,4,1,9,11,60
401411704,Mississippi State Bulldogs,T. Smith,4397882,,True,35.0,6,9,6,9,0,0,4,8,2,9,11,2,1,0,2,1,16
401411704,Mississippi State Bulldogs,G. Brooks,4277908,,True,35.0,5,11,2,4,3,7,0,0,1,4,5,1,1,0,0,4,13
401411704,Mississippi State Bulldogs,A. Garcia,4702431,,True,19.0,1,1,0,0,1,1,2,2,0,1,1,2,0,0,2,4,5
401411704,Mississippi State Bulldogs,S. Moore,4602027,,True,33.0,3,9,3,5,0,4,0,0,1,3,4,3,0,0,1,3,6
401411704,Mississippi State Bulldogs,I. Molinar,4432885,,True,35.0,6,12,6,11,0,1,1,1,0,3,3,4,1,0,5,1,13
401411704,Mississippi State Bulldogs,D. Fountain,4702432,,False,3.0,1,1,1,1,0,0,0,0,0,0,0,0,0,0,0,0,2
401411704,Mississippi State Bulldogs,J. Davis,4592739,,False,5.0,0,0,0,0,0,0,0,0,0,0,0,0,0,0,1,2,0
401411704,Mississippi State Bulldogs,D.J. Jeffries,4431682,,False,24.0,0,2,0,2,0,0,0,0,0,1,1,0,0,0,2,1,0
401411704,Mississippi State Bulldogs,C. Matthews,4432394,,False,9.0,1,1,1,1,0,0,0,0,1,0,1,0,0,0,0,0,2
401411704,Mississippi State Bulldogs,C. Carter,4898380,,False,2.0,0,0,0,0,0,0,0,0,0,0,0,0,0,0,0,1,0
401411704,Mississippi State Bulldogs,TEAM,TOTAL,TOTAL,False,,23,46,19,33,4,13,7,11,5,22,27,12,3,0,14,17,57
401411703,Washington State Cougars,A. Jakimovski,4702466,,True,8.0,0,2,0,1,0,1,0,0,1,1,2,1,0,0,0,1,0
401411703,Washington State Cougars,E. Abogidi,4702463,,True,20.0,4,7,3,6,1,1,4,4,2,3,5,1,2,3,1,5,13
401411703,Washington State Cougars,T. Roberts,4702609,,True,35.0,8,21,1,5,7,16,0,0,1,6,7,1,1,0,1,0,23
401411703,Washington State Cougars,TJ Bamba,4596365,,True,27.0,1,6,1,6,0,0,1,2,0,4,4,3,0,0,0,2,3
401411703,Washington State Cougars,M. Flowers,4279455,,True,35.0,2,9,0,2,2,7,3,4,0,4,4,5,2,0,4,1,9
401411703,Washington State Cougars,M. Gueye,4712863,,False,9.0,0,2,0,1,0,1,0,0,0,1,1,0,0,3,0,2,0
401411703,Washington State Cougars,DJ Rodman,4432103,,False,26.0,1,3,1,1,0,2,1,2,2,4,6,1,0,0,0,1,3
401411703,Washington State Cougars,D. Jackson,4432926,,False,21.0,4,7,4,7,0,0,0,0,1,7,8,0,0,4,1,1,8
401411703,Washington State Cougars,N. Williams,4432850,,False,19.0,2,7,2,6,0,1,0,1,0,4,4,0,1,0,1,2,4
401411703,Washington State Cougars,TEAM,TOTAL,TOTAL,False,,22,64,12,35,10,29,9,13,9,35,44,12,6,10,8,15,63
401411703,Santa Clara Broncos,K. Justice,4397751,,True,32.0,0,6,0,1,0,5,0,0,0,4,4,2,0,0,2,4,0
401411703,Santa Clara Broncos,J. Vrankic,4280250,,True,37.0,7,13,7,11,0,2,5,8,1,9,10,0,0,0,4,2,19
401411703,Santa Clara Broncos,J. Bediako,4431889,,True,12.0,0,3,0,3,0,0,0,0,1,3,4,1,0,2,1,3,0
401411703,Santa Clara Broncos,J. Williams,4593803,,True,39.0,6,16,5,11,1,5,6,7,3,12,15,4,2,0,4,4,19
401411703,Santa Clara Broncos,PJ Pipes,4279237,,True,32.0,1,11,0,4,1,7,0,0,0,3,3,3,0,0,1,0,3
401411703,Santa Clara Broncos,J. Holt,4897210,,False,6.0,1,1,0,0,1,1,0,0,0,0,0,0,0,0,0,1,3
401411703,Santa Clara Broncos,P. Braun,4396957,,False,22.0,2,5,2,3,0,2,0,0,2,1,3,2,1,4,0,1,4
401411703,Santa Clara Broncos,C. Stewart,4683956,,False,17.0,1,2,1,2,0,0,0,0,1,0,1,1,0,0,0,1,2
401411703,Santa Clara Broncos,G. Williams,4432146,,False,3.0,0,3,0,2,0,1,0,0,0,0,0,0,0,0,0,0,0
401411703,Santa Clara Broncos,TEAM,TOTAL,TOTAL,False,,18,60,15,37,3,23,11,15,10,34,44,13,3,6,12,16,50
401411702,St. Bonaventure Bonnies,O. Osunniyi,4397224,,True,31.0,5,9,5,9,0,0,3,4,2,8,10,1,0,4,1,4,13
401411702,St. Bonaventure Bonnies,J. Adaway,4279431,,True,39.0,7,13,4,8,3,5,0,0,0,1,1,0,2,0,2,1,17
401411702,St. Bonaventure Bonnies,J. Holmes,4701016,,True,36.0,4,9,3,7,1,2,4,4,0,4,4,6,0,1,1,3,13
401411702,St. Bonaventure Bonnies,D. Welch,4397221,,True,40.0,4,9,0,1,4,8,0,0,0,8,8,1,2,1,2,3,12
401411702,St. Bonaventure Bonnies,K. Lofton,4397220,,True,40.0,6,12,4,7,2,5,1,1,0,1,1,8,1,0,2,3,15
401411702,St. Bonaventure Bonnies,A. Coulibaly,4432889,,False,9.0,2,2,2,2,0,0,0,0,0,0,0,0,0,0,0,0,4
401411702,St. Bonaventure Bonnies,J. Ndjock-Tadjore,4897048,,False,1.0,0,0,0,0,0,0,0,0,0,0,0,0,0,0,0,0,0
401411702,St. Bonaventure Bonnies,Q. Adams,4585591,,False,4.0,1,1,1,1,0,0,0,0,0,0,0,0,0,0,0,0,2
401411702,St. Bonaventure Bonnies,TEAM,TOTAL,TOTAL,False,,29,55,19,35,10,20,8,9,2,23,25,16,5,6,9,14,76
401411702,Colorado Buffaloes,T. da Silva,4702382,,True,30.0,5,10,5,5,0,5,3,3,0,5,5,4,0,0,2,2,13
401411702,Colorado Buffaloes,J. Walker,4432446,,True,30.0,2,10,2,7,0,3,2,2,4,4,8,3,0,0,0,2,6
401411702,Colorado Buffaloes,E. Battey,4278506,,True,33.0,5,9,4,5,1,4,3,3,2,3,5,0,1,0,2,2,14
401411702,Colorado Buffaloes,N. Clifford,4702384,,True,23.0,1,7,0,4,1,3,3,4,0,3,3,3,0,0,1,2,6
401411702,Colorado Buffaloes,J. Hammond III,4692907,,True,17.0,2,3,1,2,1,1,0,0,0,3,3,2,1,1,2,1,5
401411702,Colorado Buffaloes,L. O'Brien,4702380,,False,14.0,1,3,1,2,0,1,0,0,1,1,2,0,0,0,1,0,2
401411702,Colorado Buffaloes,KJ Simpson,4683834,,False,26.0,3,9,2,5,1,4,0,0,0,2,2,2,1,0,1,2,7
401411702,Colorado Buffaloes,K. Barthelemy,4581504,,False,27.0,6,7,3,3,3,4,0,0,0,1,1,2,0,1,0,0,15
401411702,Colorado Buffaloes,TEAM,TOTAL,TOTAL,False,,25,58,18,33,7,25,11,12,8,23,31,16,3,2,11,11,68
401411701,Xavier Musketeers,Z. Freemantle,4432869,,True,31.0,4,11,3,10,1,1,4,6,5,6,11,0,2,4,0,1,13
401411701,Xavier Musketeers,J. Nunge,4277948,,True,18.0,5,6,3,3,2,3,0,0,1,3,4,1,1,3,1,1,12
401411701,Xavier Musketeers,C. Jones,4433378,,True,32.0,4,8,4,7,0,1,3,5,3,5,8,6,2,0,4,3,11
401411701,Xavier Musketeers,P. Scruggs,4278591,,True,39.0,3,8,3,4,0,4,6,6,1,4,5,4,6,0,4,2,12
401411701,Xavier Musketeers,N. Johnson,4067338,,True,34.0,1,9,0,2,1,7,2,2,0,0,0,2,0,1,1,3,5
401411701,Xavier Musketeers,J. Hunter,4397011,,False,6.0,1,4,1,3,0,1,0,0,1,2,3,0,0,0,0,1,2
401411701,Xavier Musketeers,D. Odom,4432632,,False,13.0,1,5,1,5,0,0,1,2,0,1,1,1,1,0,0,2,3
401411701,Xavier Musketeers,A. Kunkel,4398300,,False,27.0,5,11,2,2,3,9,1,2,0,3,3,3,4,0,2,4,14
401411701,Xavier Musketeers,TEAM,TOTAL,TOTAL,False,,24,62,17,36,7,26,17,23,13,24,37,17,16,8,12,17,72
401411701,Cleveland State Vikings,D. Johnson,4399102,,True,26.0,5,6,5,6,0,0,1,2,3,4,7,1,1,2,2,2,11
401411701,Cleveland State Vikings,D. Hodge,4702702,,True,36.0,3,10,2,4,1,6,9,10,1,5,6,1,0,0,1,3,16
401411701,Cleveland State Vikings,T. Gomillion,4592883,,True,35.0,7,12,7,12,0,0,0,1,3,4,7,5,3,0,5,4,14
401411701,Cleveland State Vikings,D. Parker,4397548,,True,31.0,2,5,2,4,0,1,0,0,0,1,1,2,2,0,0,4,4
401411701,Cleveland State Vikings,T. Patton,4279311,,True,32.0,6,17,6,15,0,2,1,3,3,8,11,1,2,0,4,4,13
401411701,Cleveland State Vikings,A. Mirambeaux,4898221,,False,6.0,1,2,1,2,0,0,2,2,1,1,2,0,0,1,1,0,4
401411701,Cleveland State Vikings,M. Majak,4433216,,False,1.0,0,0,0,0,0,0,0,0,0,0,0,0,0,0,0,0,0
401411701,Cleveland State Vikings,J. Woodrich,4702699,,False,4.0,0,1,0,0,0,1,0,0,0,0,0,0,0,0,0,0,0
401411701,Cleveland State Vikings,Y. Hill,4702698,,False,7.0,1,3,1,2,0,1,0,0,0,0,0,1,0,0,1,2,2
401411701,Cleveland State Vikings,B. Finstuen,4593788,,False,21.0,2,4,2,3,0,1,0,1,1,4,5,2,1,0,3,4,4
401411701,Cleveland State Vikings,N. Jack,4592191,,False,1.0,0,0,0,0,0,0,0,0,0,1,1,0,0,0,0,0,0
401411701,Cleveland State Vikings,TEAM,TOTAL,TOTAL,False,,27,60,26,48,1,12,13,19,13,29,42,13,9,3,17,23,68
401411700,Texas A&M Aggies,H. Coleman III,4432186,,True,18.0,4,7,4,7,0,0,0,2,1,2,3,1,1,0,0,2,8
401411700,Texas A&M Aggies,W. Taylor IV,4683833,,True,24.0,4,9,2,3,2,6,2,2,0,3,3,3,0,0,3,3,12
401411700,Texas A&M Aggies,Q. Jackson,4592829,,True,28.0,4,7,3,5,1,2,1,1,0,3,3,3,2,2,4,1,10
401411700,Texas A&M Aggies,M. Obaseki,4433277,,True,21.0,1,5,1,4,0,1,0,0,0,1,1,2,1,1,0,1,2
401411700,Texas A&M Aggies,T. Radford,4395685,,True,33.0,4,8,3,5,1,3,5,5,7,7,14,2,3,0,0,1,14
401411700,Texas A&M Aggies,E. Henderson,4395706,,False,9.0,1,1,1,1,0,0,2,2,0,0,0,0,0,1,0,0,4
401411700,Texas A&M Aggies,J. Brown,4702024,,False,8.0,0,2,0,2,0,0,4,4,3,1,4,0,0,0,0,1,4
401411700,Texas A&M Aggies,A. Cash,4896467,,False,9.0,0,0,0,0,0,0,0,0,0,2,2,0,0,2,1,3,0
401411700,Texas A&M Aggies,H. Hefner,4433279,,False,15.0,2,8,2,4,0,4,2,2,1,0,1,0,2,0,2,1,6
401411700,Texas A&M Aggies,H. Diarra,4433160,,False,19.0,2,4,2,2,0,2,8,8,0,1,1,2,0,0,2,0,12
401411700,Texas A&M Aggies,A. Gordon,4431779,,False,16.0,0,2,0,0,0,2,2,2,0,2,2,1,0,0,0,0,2
401411700,Texas A&M Aggies,TEAM,TOTAL,TOTAL,False,,22,53,18,33,4,20,26,28,13,23,36,14,9,6,13,13,74
401411700,Alcorn State Braves,L. Henry,4278645,,True,33.0,7,13,7,12,0,1,2,3,6,4,10,2,1,0,0,1,16
401411700,Alcorn State Braves,D. Agnew,4593690,,True,18.0,3,4,3,4,0,0,0,1,1,2,3,1,0,0,2,1,6
401411700,Alcorn State Braves,D. Brewton,4594037,,True,35.0,8,18,5,13,3,5,1,1,1,5,6,4,1,0,4,3,20
401411700,Alcorn State Braves,O. Walker,4398293,,True,29.0,4,12,2,7,2,5,0,0,1,0,1,0,1,0,2,4,10
401411700,Alcorn State Braves,J. Thomas,4067394,,True,28.0,1,6,1,6,0,0,1,2,0,2,2,4,2,0,4,5,3
401411700,Alcorn State Braves,D. McQuarter,4705266,,False,27.0,1,4,1,4,0,0,1,2,2,0,2,1,0,1,1,3,3
401411700,Alcorn State Braves,L. Marshall,4397708,,False,7.0,1,3,1,3,0,0,0,0,3,1,4,0,0,1,0,2,2
401411700,Alcorn State Braves,D. Thorn,4594033,,False,23.0,1,7,1,5,0,2,0,0,0,3,3,4,1,0,2,1,2
401411700,Alcorn State Braves,TEAM,TOTAL,TOTAL,False,,26,67,21,54,5,13,5,9,19,19,38,16,6,2,16,20,62
401411699,Utah State Aggies,B. Horvath,4279162,,True,34.0,7,16,6,9,1,7,0,0,2,3,5,3,0,1,3,3,15
401411699,Utah State Aggies,J. Bean,4278720,,True,39.0,2,12,2,10,0,2,5,6,4,12,16,2,0,0,2,2,9
401411699,Utah State Aggies,S. Bairstow,4593102,,True,33.0,5,8,5,8,0,0,2,6,1,3,4,3,0,0,1,1,12
401411699,Utah State Aggies,R. Jones,4431751,,True,19.0,0,2,0,0,0,2,0,1,1,1,2,3,1,0,2,5,0
401411699,Utah State Aggies,RJ Eytle-Rock,4396591,,True,15.0,0,5,0,1,0,4,2,2,0,1,1,2,0,0,0,1,2
401411699,Utah State Aggies,N. Thelissen,4897547,,False,1.0,0,1,0,1,0,0,0,0,1,0,1,0,0,0,0,0,0
401411699,Utah State Aggies,S. Zapala,4701993,,False,1.0,0,1,0,1,0,0,0,2,1,0,1,0,0,0,0,0,0
401411699,Utah State Aggies,Z. Hamoda,4897548,,False,7.0,2,4,1,2,1,2,0,0,0,2,2,0,0,0,2,2,5
401411699,Utah State Aggies,M. Shulga,4701992,,False,22.0,2,3,1,2,1,1,2,2,2,3,5,2,1,1,2,1,7
401411699,Utah State Aggies,S. Ashworth,4701991,,False,29.0,6,12,0,2,6,10,2,2,0,2,2,5,1,0,0,2,20
401411699,Utah State Aggies,B. Miller,4278721,,False,0.0,1,1,1,1,0,0,0,0,0,0,0,0,0,0,0,1,2
401411699,Utah State Aggies,TEAM,TOTAL,TOTAL,False,,25,65,16,37,9,28,13,21,14,27,41,20,3,2,12,18,72
401411699,Oregon Ducks,Q. Guerrier,4432996,,True,28.0,3,10,1,5,2,5,1,1,1,4,5,1,0,0,3,5,9
401411699,Oregon Ducks,F. Kepnang,4711400,,True,24.0,4,7,4,7,0,0,1,1,3,6,9,0,0,2,1,2,9
401411699,Oregon Ducks,R. Soares,4898116,,True,29.0,5,8,4,6,1,2,2,2,1,3,4,1,0,0,1,1,13
401411699,Oregon Ducks,D. Harmon,4431703,,True,32.0,8,13,6,10,2,3,1,3,0,3,3,1,2,0,0,3,19
401411699,Oregon Ducks,J. Young,4066326,,True,27.0,6,13,5,10,1,3,4,7,0,4,4,4,0,0,2,2,17
401411699,Oregon Ducks,L. Wur,4565434,,False,12.0,1,4,1,2,0,2,0,0,0,1,1,1,1,1,0,0,2
401411699,Oregon Ducks,I. Johnson,4898118,,False,4.0,1,1,1,1,0,0,0,0,1,0,1,0,0,0,1,1,2
401411699,Oregon Ducks,N. Bittle,4432586,,False,14.0,1,3,0,1,1,2,0,0,0,4,4,0,0,3,0,1,3
401411699,Oregon Ducks,E. Williams Jr.,4278490,,False,30.0,4,6,3,4,1,2,0,0,1,3,4,5,2,0,0,1,9
401411699,Oregon Ducks,TEAM,TOTAL,TOTAL,False,,33,65,25,46,8,19,9,14,8,31,39,13,5,6,8,16,83
401411698,Texas State Bobcats,N. Martin,4702068,,True,18.0,2,2,2,2,0,0,2,4,1,3,4,1,0,0,1,1,6
401411698,Texas State Bobcats,I. Small,4593923,,True,38.0,2,6,2,5,0,1,1,2,3,5,8,1,0,1,1,2,5
401411698,Texas State Bobcats,C. Asberry,4593924,,True,35.0,2,8,0,0,2,8,4,5,0,6,6,3,1,0,2,4,10
401411698,Texas State Bobcats,M. Harrell,4397702,,True,40.0,4,13,3,8,1,5,0,1,0,3,3,3,0,0,0,3,9
401411698,Texas State Bobcats,S. Adams,4280276,,True,36.0,4,9,4,7,0,2,1,1,1,5,6,1,3,0,2,5,9
401411698,Texas State Bobcats,T. Morgan,4897157,,False,13.0,1,2,1,2,0,0,1,2,2,2,4,0,0,0,1,0,3
401411698,Texas State Bobcats,N. Ceaser,4702071,,False,25.0,5,9,5,9,0,0,4,7,2,2,4,0,0,0,1,3,14
401411698,Texas State Bobcats,D. Dawson,4702066,,False,6.0,0,2,0,1,0,1,0,0,0,0,0,0,0,0,0,2,0
401411698,Texas State Bobcats,D. Drinnon,4397358,,False,14.0,3,5,2,3,1,2,0,0,0,0,0,1,0,0,1,2,7
401411698,Texas State Bobcats,TEAM,TOTAL,TOTAL,False,,23,56,19,37,4,19,13,22,11,26,37,10,4,1,9,22,63
401411698,North Texas Mean Green,A. Ousmane,4702773,,True,34.0,3,8,3,8,0,0,0,0,3,7,10,1,1,2,1,4,6
401411698,North Texas Mean Green,T. Bell,4592870,,True,28.0,5,9,5,8,0,1,0,2,3,4,7,5,1,1,3,5,10
401411698,North Texas Mean Green,M. McBride,4702770,,True,43.0,8,18,2,5,6,13,2,2,1,2,3,0,2,0,1,0,24
401411698,North Texas Mean Green,R. Jones,4432430,,True,38.0,4,9,1,3,3,6,4,5,0,1,1,2,0,0,2,3,15
401411698,North Texas Mean Green,JJ Murray,4397560,,True,29.0,0,1,0,0,0,1,0,1,2,6,8,2,2,1,2,0,0
401411698,North Texas Mean Green,T. Perry,4897518,,False,34.0,2,10,0,3,2,7,4,8,0,2,2,4,0,0,1,5,10
401411698,North Texas Mean Green,A. Scott,4897517,,False,19.0,1,2,1,1,0,1,0,0,1,3,4,0,0,0,0,1,2
401411698,North Texas Mean Green,TEAM,TOTAL,TOTAL,False,,23,57,12,28,11,29,10,18,13,25,38,14,6,4,11,18,67
401411697,Vanderbilt Commodores,L. Robbins,4397347,,True,20.0,4,9,3,7,1,2,5,6,2,4,6,0,1,3,1,1,14
401411697,Vanderbilt Commodores,M. Stute,4433340,,True,28.0,2,6,2,2,0,4,1,1,0,4,4,0,0,0,1,1,5
401411697,Vanderbilt Commodores,J. Wright,4432920,,True,31.0,10,15,8,12,2,3,2,3,0,7,7,0,0,0,1,3,24
401411697,Vanderbilt Commodores,S. Pippen Jr.,4431785,,True,31.0,2,7,2,4,0,3,6,7,0,2,2,6,1,0,2,3,10
401411697,Vanderbilt Commodores,R. Chatman,4067250,,True,33.0,4,9,2,3,2,6,0,0,0,1,1,1,0,0,1,0,10
401411697,Vanderbilt Commodores,Q. Millora-Brown,4397691,,False,19.0,3,3,3,3,0,0,2,4,8,5,13,1,0,2,0,1,8
401411697,Vanderbilt Commodores,T. Lawrence,4702530,,False,14.0,3,5,2,3,1,2,2,2,0,0,0,0,0,0,1,1,9
401411697,Vanderbilt Commodores,S. Dezonie,4683732,,False,9.0,0,1,0,0,0,1,0,0,0,1,1,2,0,0,1,1,0
401411697,Vanderbilt Commodores,D. Weikert,4598779,,False,3.0,0,1,0,0,0,1,0,0,0,1,1,0,0,0,1,1,0
401411697,Vanderbilt Commodores,J. Mann,4589479,,False,12.0,1,6,1,4,0,2,0,0,2,2,4,0,0,0,0,1,2
401411697,Vanderbilt Commodores,TEAM,TOTAL,TOTAL,False,,29,62,23,38,6,24,18,23,13,29,42,10,2,5,10,13,82
401411697,Belmont Bruins,N. Muszynski,4279923,,True,31.0,6,16,5,12,1,4,0,0,1,4,5,5,0,1,0,2,13
401411697,Belmont Bruins,W. Richard,4897262,,True,35.0,7,13,4,7,3,6,5,5,2,6,8,0,1,3,0,1,22
401411697,Belmont Bruins,B. Sheppard,4433076,,True,37.0,4,13,3,7,1,6,2,2,1,5,6,2,0,0,1,4,11
401411697,Belmont Bruins,L. Smith,4402243,,True,27.0,2,5,1,1,1,4,2,2,0,2,2,1,0,0,2,3,7
401411697,Belmont Bruins,G. Murphy,4279920,,True,36.0,5,6,5,6,0,0,0,1,0,3,3,6,1,0,1,3,10
401411697,Belmont Bruins,F. Jakubicek,4703221,,False,8.0,1,3,0,1,1,2,0,0,0,0,0,0,2,1,1,2,3
401411697,Belmont Bruins,M. Shanks,4433075,,False,7.0,1,2,1,2,0,0,0,0,0,1,1,0,0,0,0,3,2
401411697,Belmont Bruins,J. Wood,4703220,,False,10.0,0,0,0,0,0,0,0,0,0,0,0,1,0,0,3,1,0
401411697,Belmont Bruins,T. Pierson,4279922,,False,9.0,1,2,0,0,1,2,0,0,0,1,1,0,1,0,1,1,3
401411697,Belmont Bruins,TEAM,TOTAL,TOTAL,False,,27,60,19,36,8,24,9,10,5,23,28,15,5,5,9,20,71
401411696,Oklahoma Sooners,J. Groves,4592583,,True,14.0,2,4,1,3,1,1,0,0,1,0,1,1,0,0,2,1,5
401411696,Oklahoma Sooners,J. Hill,4592214,,True,35.0,4,8,4,7,0,1,0,0,1,5,6,2,1,1,0,2,8
401411696,Oklahoma Sooners,T. Groves,4278603,,True,25.0,3,6,0,0,3,6,0,0,0,9,9,0,0,1,1,1,9
401411696,Oklahoma Sooners,U. Gibson,4279087,,True,36.0,8,17,3,7,5,10,7,7,0,3,3,1,3,0,1,1,28
401411696,Oklahoma Sooners,J. Goldwire,4277845,,True,27.0,7,11,7,10,0,1,1,2,0,1,1,8,0,3,2,2,15
401411696,Oklahoma Sooners,A. Mawein,4897745,,False,1.0,0,0,0,0,0,0,0,0,0,0,0,0,0,0,0,0,0
401411696,Oklahoma Sooners,E. Chargois,4278297,,False,14.0,3,6,2,4,1,2,2,2,3,2,5,1,0,1,1,2,9
401411696,Oklahoma Sooners,R. Issanza,4592217,,False,1.0,0,0,0,0,0,0,0,0,0,0,0,0,0,0,0,0,0
401411696,Oklahoma Sooners,J. Moser,4897746,,False,1.0,0,0,0,0,0,0,0,0,0,0,0,0,0,0,0,0,0
401411696,Oklahoma Sooners,A. Mason,4816113,,False,1.0,1,1,0,0,1,1,0,0,0,0,0,0,1,0,0,0,3
401411696,Oklahoma Sooners,C.J. Noland,4694228,,False,22.0,2,6,1,4,1,2,1,2,1,5,6,1,2,1,0,2,6
401411696,Oklahoma Sooners,B. Cortes,4612129,,False,2.0,0,0,0,0,0,0,0,0,0,1,1,0,0,0,2,0,0
401411696,Oklahoma Sooners,M. Johnson,4593466,,False,21.0,3,7,3,6,0,1,0,0,1,1,2,1,0,1,0,2,6
401411696,Oklahoma Sooners,TEAM,TOTAL,TOTAL,False,,33,66,21,41,12,25,11,13,10,28,38,15,7,8,9,13,89
401411696,Missouri State Bears,G. Prim,4592711,,True,32.0,4,10,4,10,0,0,6,6,3,5,8,4,1,0,4,1,14
401411696,Missouri State Bears,L. Patterson,4703979,,True,30.0,0,9,0,6,0,3,2,2,2,1,3,1,0,0,0,2,2
401411696,Missouri State Bears,D. Clay,4592730,,True,28.0,3,6,3,6,0,0,0,0,1,1,2,1,0,3,1,3,6
401411696,Missouri State Bears,J. Black,4592709,,True,28.0,3,6,0,0,3,6,0,0,2,1,3,0,0,0,0,0,9
401411696,Missouri State Bears,I. Mosley,4432879,,True,33.0,11,20,8,12,3,8,3,4,0,10,10,0,3,0,4,1,28
401411696,Missouri State Bears,D. Carper,4397464,,False,13.0,1,2,1,1,0,1,0,0,1,2,3,0,0,0,1,2,2
401411696,Missouri State Bears,I. Haney,4897477,,False,13.0,1,4,1,3,0,1,0,0,1,1,2,1,1,0,1,1,2
401411696,Missouri State Bears,J. Minnett,4279244,,False,23.0,3,7,0,2,3,5,0,0,0,2,2,1,0,1,0,1,9
401411696,Missouri State Bears,TEAM,TOTAL,TOTAL,False,,26,64,17,40,9,24,11,12,11,24,35,8,5,4,11,11,72
401410968,San Diego State Aztecs,K. Johnson,4431786,,True,42.0,3,5,3,5,0,0,3,4,1,1,2,0,0,1,2,0,9
401410968,San Diego State Aztecs,N. Mensah,4397371,,True,18.0,1,4,1,4,0,0,1,1,2,4,6,1,0,2,1,5,3
401410968,San Diego State Aztecs,T. Pulliam,4593083,,True,39.0,4,13,3,9,1,4,0,2,0,2,2,4,2,0,2,3,9
401410968,San Diego State Aztecs,L. Butler,4433183,,True,26.0,0,5,0,1,0,4,0,0,0,2,2,1,2,0,2,2,0
401410968,San Diego State Aztecs,M. Bradley,4397049,,True,39.0,8,18,6,11,2,7,8,10,1,9,10,2,1,1,2,3,26
401410968,San Diego State Aztecs,A. Arop,4397368,,False,7.0,2,3,2,3,0,0,1,2,1,1,2,0,1,0,1,0,5
401410968,San Diego State Aztecs,T. Diabate,4280209,,False,23.0,1,3,1,3,0,0,3,8,5,2,7,0,0,1,2,4,5
401410968,San Diego State Aztecs,J. Tomaic,4066375,,False,11.0,0,2,0,1,0,1,0,0,0,3,3,0,0,0,1,0,0
401410968,San Diego State Aztecs,C. Baker-Mazara,4897532,,False,12.0,1,4,1,4,0,0,0,0,0,2,2,1,0,0,0,1,2
401410968,San Diego State Aztecs,A. Seiko,4278704,,False,33.0,2,4,0,0,2,4,0,0,0,4,4,0,0,0,1,2,6
401410968,San Diego State Aztecs,TEAM,TOTAL,TOTAL,False,,22,61,17,41,5,20,16,27,10,34,44,9,6,5,14,20,65
401410968,Fresno State Bulldogs,O. Robinson,4593049,,True,48.0,4,13,4,10,0,3,9,12,2,9,11,1,2,0,4,2,17
401410968,Fresno State Bulldogs,L. Colimerio,4703241,,True,10.0,0,2,0,2,0,0,0,0,1,1,2,0,0,0,0,3,0
401410968,Fresno State Bulldogs,I. Hill,4593830,,True,44.0,1,10,1,7,0,3,2,2,0,4,4,4,0,0,4,4,4
401410968,Fresno State Bulldogs,A. Holland,4593051,,True,37.0,4,8,0,1,4,7,2,2,1,7,8,1,1,0,2,2,14
401410968,Fresno State Bulldogs,J. Campbell,4397089,,True,30.0,7,13,4,8,3,5,2,2,0,0,0,0,2,0,1,4,19
401410968,Fresno State Bulldogs,B. Meah,4703242,,False,28.0,1,1,1,1,0,0,2,2,0,8,8,0,0,2,3,4,4
401410968,Fresno State Bulldogs,R. Vaihola,4897515,,False,2.0,0,0,0,0,0,0,0,0,0,0,0,0,0,0,0,0,0
401410968,Fresno State Bulldogs,D. Yap,4703386,,False,4.0,0,0,0,0,0,0,1,2,0,1,1,0,2,0,1,1,1
401410968,Fresno State Bulldogs,D. Stroud,4397866,,False,22.0,1,6,1,4,0,2,0,2,0,1,1,3,0,0,0,3,2
401410968,Fresno State Bulldogs,J. Ballard,4397365,,False,25.0,1,3,0,1,1,2,0,2,0,1,1,1,1,0,0,2,3
401410968,Fresno State Bulldogs,TEAM,TOTAL,TOTAL,False,,19,56,11,34,8,22,18,26,6,33,39,10,8,2,16,25,64
401409398,UAB Blazers,KJ Buffen,4396968,,True,32.0,4,9,4,8,0,1,5,7,1,5,6,0,0,0,3,4,13
401409398,UAB Blazers,T. Jemison,4395623,,True,21.0,2,3,2,3,0,0,1,2,3,5,8,0,0,2,1,4,5
401409398,UAB Blazers,J. Walker,4396656,,True,37.0,6,11,2,4,4,7,11,11,0,6,6,4,1,0,5,1,27
401409398,UAB Blazers,M. Ertel,4280260,,True,35.0,6,12,3,5,3,7,0,0,0,0,0,0,0,0,2,1,15
401409398,UAB Blazers,Q. Jackson,4067781,,True,39.0,3,9,3,9,0,0,3,4,3,4,7,2,2,0,2,3,9
401409398,UAB Blazers,R. Gordon,4432400,,False,14.0,1,3,1,3,0,0,0,0,0,0,0,1,2,0,1,3,2
401409398,UAB Blazers,T. Toney,4703133,,False,2.0,0,0,0,0,0,0,0,0,0,0,0,0,0,0,0,0,0
401409398,UAB Blazers,T. Lovan,4397726,,False,20.0,3,4,3,4,0,0,5,7,1,6,7,1,3,1,0,1,11
401409398,UAB Blazers,TEAM,TOTAL,TOTAL,False,,25,51,18,36,7,15,25,31,11,27,38,8,8,3,16,17,82
401409398,Louisiana Tech Bulldogs,K. Lofton Jr.,4585610,,True,30.0,11,18,11,17,0,1,1,1,5,4,9,0,0,0,1,4,23
401409398,Louisiana Tech Bulldogs,K. Willis,4593756,,True,38.0,3,13,3,4,0,9,0,0,1,2,3,1,2,1,1,0,6
401409398,Louisiana Tech Bulldogs,C. Williams,4592858,,True,39.0,7,18,4,9,3,9,2,4,2,3,5,3,2,0,3,3,19
401409398,Louisiana Tech Bulldogs,E. Christon,4279006,,True,11.0,0,2,0,0,0,2,2,2,0,2,2,0,0,0,0,0,2
401409398,Louisiana Tech Bulldogs,A. Archibald,4279005,,True,33.0,4,7,3,4,1,3,3,4,2,3,5,0,1,0,2,4,12
401409398,Louisiana Tech Bulldogs,D. Green,4702763,,False,27.0,3,7,3,5,0,2,1,2,2,2,4,0,0,2,0,5,7
401409398,Louisiana Tech Bulldogs,K. Hunter,4432313,,False,10.0,0,1,0,1,0,0,0,0,1,0,1,0,0,0,0,2,0
401409398,Louisiana Tech Bulldogs,K. Stewart,4897498,,False,2.0,0,0,0,0,0,0,0,0,0,0,0,0,0,0,0,0,0
401409398,Louisiana Tech Bulldogs,L. Bradford,4433576,,False,10.0,1,3,1,1,0,2,2,4,2,1,3,1,1,0,2,3,4
401409398,Louisiana Tech Bulldogs,TEAM,TOTAL,TOTAL,False,,29,69,25,41,4,28,11,17,16,18,34,5,6,3,9,21,73
401409397,North Texas Mean Green,A. Ousmane,4702773,,True,33.0,3,11,3,11,0,0,0,0,4,6,10,0,1,1,3,2,6
401409397,North Texas Mean Green,T. Bell,4592870,,True,38.0,3,8,3,8,0,0,4,6,1,7,8,3,1,0,4,2,10
401409397,North Texas Mean Green,M. McBride,4702770,,True,38.0,3,10,2,4,1,6,2,2,1,0,1,0,0,0,0,0,9
401409397,North Texas Mean Green,R. Jones,4432430,,True,37.0,1,4,1,2,0,2,0,1,1,3,4,2,3,0,2,4,2
401409397,North Texas Mean Green,JJ Murray,4397560,,True,16.0,0,6,0,2,0,4,0,0,0,0,0,0,1,0,1,1,0
401409397,North Texas Mean Green,T. Perry,4897518,,False,33.0,3,14,0,3,3,11,0,0,0,5,5,0,2,1,1,4,9
401409397,North Texas Mean Green,A. Scott,4897517,,False,5.0,0,1,0,0,0,1,0,0,1,2,3,0,0,1,0,1,0
401409397,North Texas Mean Green,TEAM,TOTAL,TOTAL,False,,13,54,9,30,4,24,6,9,13,26,39,5,8,3,13,14,36
401409397,Louisiana Tech Bulldogs,K. Lofton Jr.,4585610,,True,29.0,2,8,1,6,1,2,4,4,2,10,12,0,2,1,5,2,9
401409397,Louisiana Tech Bulldogs,K. Willis,4593756,,True,35.0,4,11,0,3,4,8,0,0,0,4,4,0,1,0,1,1,12
401409397,Louisiana Tech Bulldogs,C. Williams,4592858,,True,30.0,5,12,5,10,0,2,2,3,0,3,3,1,2,1,3,2,12
401409397,Louisiana Tech Bulldogs,E. Christon,4279006,,True,22.0,0,1,0,1,0,0,0,0,0,3,3,0,1,0,0,1,0
401409397,Louisiana Tech Bulldogs,A. Archibald,4279005,,True,33.0,1,8,1,6,0,2,1,2,0,4,4,1,1,0,0,0,3
401409397,Louisiana Tech Bulldogs,D. Green,4702763,,False,18.0,2,4,2,2,0,2,0,0,1,0,1,0,0,0,1,5,4
401409397,Louisiana Tech Bulldogs,K. Hunter,4432313,,False,11.0,0,2,0,2,0,0,2,2,3,1,4,0,0,0,1,1,2
401409397,Louisiana Tech Bulldogs,K. Stewart,4897498,,False,3.0,0,0,0,0,0,0,0,0,0,0,0,0,0,0,0,0,0
401409397,Louisiana Tech Bulldogs,L. Bradford,4433576,,False,19.0,0,3,0,1,0,2,0,0,0,2,2,1,0,0,1,0,0
401409397,Louisiana Tech Bulldogs,TEAM,TOTAL,TOTAL,False,,14,49,9,31,5,18,9,11,11,31,42,3,7,2,14,12,42
401409396,UAB Blazers,KJ Buffen,4396968,,True,43.0,1,4,1,4,0,0,2,3,3,7,10,2,1,1,2,5,4
401409396,UAB Blazers,T. Jemison,4395623,,True,26.0,3,4,3,4,0,0,0,0,0,2,2,0,1,3,2,5,6
401409396,UAB Blazers,J. Walker,4396656,,True,46.0,11,29,6,13,5,16,13,13,0,6,6,3,0,0,5,4,40
401409396,UAB Blazers,M. Ertel,4280260,,True,54.0,8,16,2,4,6,12,4,4,3,1,4,2,1,0,1,2,26
401409396,UAB Blazers,Q. Jackson,4067781,,True,43.0,6,11,6,10,0,1,4,8,2,8,10,1,4,0,1,3,16
401409396,UAB Blazers,R. Gordon,4432400,,False,19.0,0,1,0,1,0,0,0,0,1,2,3,2,0,2,1,2,0
401409396,UAB Blazers,T. Toney,4703133,,False,4.0,0,0,0,0,0,0,0,0,0,0,0,0,0,0,0,1,0
401409396,UAB Blazers,T. Lovan,4397726,,False,35.0,2,5,2,4,0,1,4,6,0,5,5,1,1,0,0,2,8
401409396,UAB Blazers,J. Brown,4278307,,False,5.0,0,1,0,0,0,1,2,2,0,1,1,0,0,0,0,1,2
401409396,UAB Blazers,TEAM,TOTAL,TOTAL,False,,31,71,20,40,11,31,29,36,11,33,44,11,8,6,12,25,102
401409396,Middle Tennessee Blue Raiders,T. Millin,4592866,,True,17.0,0,2,0,1,0,1,0,0,1,1,2,1,1,0,0,2,0
401409396,Middle Tennessee Blue Raiders,D. Dishman,4067165,,True,47.0,11,21,11,21,0,0,3,5,5,4,9,4,0,0,1,4,25
401409396,Middle Tennessee Blue Raiders,T. Lenard,4897509,,True,32.0,5,11,5,7,0,4,3,4,3,1,4,0,1,4,2,3,13
401409396,Middle Tennessee Blue Raiders,E. Lawrence,4432029,,True,43.0,4,13,2,5,2,8,5,5,1,2,3,2,1,2,4,5,15
401409396,Middle Tennessee Blue Raiders,D. Sims,4279080,,True,49.0,5,15,2,6,3,9,8,10,3,6,9,3,2,0,1,1,21
401409396,Middle Tennessee Blue Raiders,C. Fussell,4590357,,False,8.0,0,2,0,1,0,1,0,0,0,0,0,0,0,0,0,1,0
401409396,Middle Tennessee Blue Raiders,C. Weston,4897511,,False,40.0,4,9,1,5,3,4,6,6,1,8,9,4,0,0,5,5,17
401409396,Middle Tennessee Blue Raiders,J. Bufford,4897508,,False,39.0,3,5,2,2,1,3,0,2,1,4,5,0,1,1,0,3,7
401409396,Middle Tennessee Blue Raiders,TEAM,TOTAL,TOTAL,False,,32,78,23,48,9,30,25,32,15,31,46,14,6,7,16,24,98
401409395,Rice Owls,M. Fiedler,4431964,,True,19.0,3,10,3,10,0,0,0,0,1,2,3,0,1,0,1,1,6
401409395,Rice Owls,T. Evee,4593712,,True,35.0,2,5,1,3,1,2,0,0,0,3,3,1,1,0,2,3,5
401409395,Rice Owls,C. Mullins,4397690,,True,27.0,0,5,0,2,0,3,0,0,0,1,1,0,1,0,0,2,0
401409395,Rice Owls,T. McBride,4279474,,True,30.0,4,8,4,8,0,0,2,2,0,1,1,0,2,0,1,2,10
401409395,Rice Owls,C. Pierre,4278368,,True,37.0,3,8,2,4,1,4,2,2,0,3,3,0,1,0,1,1,9
401409395,Rice Owls,M. Poteat,4590358,,False,17.0,4,5,4,5,0,0,2,3,2,2,4,0,0,1,0,1,10
401409395,Rice Owls,R. Abercrombie,4397265,,False,16.0,1,4,1,1,0,3,2,2,0,1,1,0,0,0,1,1,4
401409395,Rice Owls,J. Geron,4897553,,False,3.0,0,1,0,1,0,0,0,0,1,0,1,0,0,0,0,1,0
401409395,Rice Owls,C. Sheffield,4432321,,False,16.0,1,1,1,1,0,0,4,6,1,4,5,0,0,0,0,1,6
401409395,Rice Owls,TEAM,TOTAL,TOTAL,False,,18,47,16,35,2,12,12,15,8,18,26,1,6,1,7,13,50
401409395,North Texas Mean Green,A. Ousmane,4702773,,True,19.0,8,10,8,10,0,0,0,2,4,4,8,0,1,3,1,4,16
401409395,North Texas Mean Green,T. Bell,4592870,,True,31.0,6,8,6,7,0,1,3,5,4,3,7,5,1,0,3,3,15
401409395,North Texas Mean Green,M. McBride,4702770,,True,34.0,6,13,5,6,1,7,0,0,1,3,4,0,0,0,0,2,13
401409395,North Texas Mean Green,R. Jones,4432430,,True,31.0,2,7,0,1,2,6,0,0,0,3,3,1,1,0,0,0,6
401409395,North Texas Mean Green,JJ Murray,4397560,,True,23.0,0,2,0,0,0,2,0,0,0,3,3,0,0,0,2,0,0
401409395,North Texas Mean Green,H. Wright,4278544,,False,5.0,0,0,0,0,0,0,1,2,1,0,1,0,0,0,0,0,1
401409395,North Texas Mean Green,M. Stone,4897523,,False,5.0,0,1,0,0,0,1,1,2,0,1,1,0,0,0,0,1,1
401409395,North Texas Mean Green,B. Zephir,4897519,,False,3.0,0,0,0,0,0,0,0,0,0,0,0,0,0,0,0,0,0
401409395,North Texas Mean Green,T. Perry,4897518,,False,28.0,5,12,1,5,4,7,0,0,2,2,4,0,2,0,1,2,14
401409395,North Texas Mean Green,A. Scott,4897517,,False,18.0,0,1,0,1,0,0,0,0,2,4,6,0,0,0,0,3,0
401409395,North Texas Mean Green,R. Browne,4703700,,False,3.0,0,0,0,0,0,0,2,3,0,0,0,0,1,0,1,0,2
401409395,North Texas Mean Green,TEAM,TOTAL,TOTAL,False,,27,54,20,30,7,24,7,14,15,23,38,6,6,3,8,15,68
401409394,Western Kentucky Hilltoppers,J. Sharp,4897696,,True,36.0,2,3,2,3,0,0,0,3,6,4,10,0,1,6,2,4,4
401409394,Western Kentucky Hilltoppers,D. McKnight,4574710,,True,40.0,7,16,7,14,0,2,6,10,1,6,7,0,2,0,4,2,20
401409394,Western Kentucky Hilltoppers,J. Anderson,4279119,,True,36.0,5,13,4,9,1,4,5,5,1,4,5,0,4,1,1,3,16
401409394,Western Kentucky Hilltoppers,L. Frampton,4278350,,True,37.0,0,5,0,0,0,5,0,0,0,1,1,1,0,0,1,0,0
401409394,Western Kentucky Hilltoppers,C. Justice,3911625,,True,32.0,6,16,4,8,2,8,1,1,1,2,3,1,2,0,2,2,15
401409394,Western Kentucky Hilltoppers,I. Cozart,4431931,,False,4.0,0,1,0,1,0,0,0,0,1,1,2,0,0,0,0,0,0
401409394,Western Kentucky Hilltoppers,J. Hamilton,4395617,,False,15.0,1,5,1,3,0,2,0,0,1,1,2,0,0,0,1,1,2
401409394,Western Kentucky Hilltoppers,TEAM,TOTAL,TOTAL,False,,21,59,18,38,3,21,12,19,12,19,31,2,9,7,11,12,57
401409394,Louisiana Tech Bulldogs,K. Lofton Jr.,4585610,,True,30.0,5,11,5,11,0,0,5,6,3,9,12,5,0,0,4,1,15
401409394,Louisiana Tech Bulldogs,K. Willis,4593756,,True,36.0,6,12,1,2,5,10,0,0,0,3,3,0,0,0,0,1,17
401409394,Louisiana Tech Bulldogs,C. Williams,4592858,,True,34.0,1,7,0,3,1,4,1,2,1,4,5,0,2,0,4,3,4
401409394,Louisiana Tech Bulldogs,E. Christon,4279006,,True,17.0,0,2,0,2,0,0,0,0,0,1,1,0,0,0,1,3,0
401409394,Louisiana Tech Bulldogs,A. Archibald,4279005,,True,25.0,2,5,1,2,1,3,0,2,1,1,2,1,2,0,2,3,5
401409394,Louisiana Tech Bulldogs,D. Green,4702763,,False,23.0,4,6,2,2,2,4,0,0,0,2,2,1,2,1,2,4,10
401409394,Louisiana Tech Bulldogs,K. Hunter,4432313,,False,10.0,3,3,3,3,0,0,0,0,0,3,3,0,0,1,0,0,6
401409394,Louisiana Tech Bulldogs,K. Stewart,4897498,,False,12.0,0,1,0,0,0,1,0,0,0,0,0,0,1,0,1,1,0
401409394,Louisiana Tech Bulldogs,L. Bradford,4433576,,False,13.0,1,1,1,1,0,0,0,0,0,3,3,2,0,0,1,1,2
401409394,Louisiana Tech Bulldogs,TEAM,TOTAL,TOTAL,False,,22,48,13,26,9,22,6,10,9,29,38,9,7,2,20,17,59
401409393,UTEP Miners,J. Sibley,4433168,,True,31.0,2,3,1,2,1,1,0,0,0,1,1,0,0,3,0,0,5
401409393,UTEP Miners,T. Verhoeven,4278488,,True,27.0,2,4,2,4,0,0,1,2,2,6,8,1,0,1,3,5,5
401409393,UTEP Miners,K. Kennedy,4397137,,True,31.0,4,16,4,11,0,5,3,4,4,6,10,2,1,0,1,3,11
401409393,UTEP Miners,J. Bieniemy,4397027,,True,43.0,6,17,5,11,1,6,0,0,0,2,2,3,1,0,4,4,13
401409393,UTEP Miners,S. Boum,4280244,,True,45.0,5,17,4,11,1,6,1,2,1,8,9,1,7,1,2,3,12
401409393,UTEP Miners,Z. Onyema,4703082,,False,17.0,0,0,0,0,0,0,0,0,1,1,2,0,0,1,1,4,0
401409393,UTEP Miners,A. Hollins,4278515,,False,14.0,3,4,3,4,0,0,1,1,0,1,1,0,0,0,0,0,7
401409393,UTEP Miners,J. Saterfield,4897578,,False,2.0,0,0,0,0,0,0,0,0,0,0,0,0,0,0,0,0,0
401409393,UTEP Miners,C. Agnew,4396762,,False,15.0,2,3,1,2,1,1,1,1,0,1,1,0,1,0,1,4,6
401409393,UTEP Miners,TEAM,TOTAL,TOTAL,False,,24,64,20,45,4,19,7,10,9,29,38,7,10,6,15,23,59
401409393,Middle Tennessee Blue Raiders,T. Millin,4592866,,True,24.0,0,1,0,0,0,1,1,2,1,4,5,0,0,0,1,1,1
401409393,Middle Tennessee Blue Raiders,D. Dishman,4067165,,True,37.0,7,13,7,13,0,0,4,6,2,5,7,2,0,0,4,0,18
401409393,Middle Tennessee Blue Raiders,T. Lenard,4897509,,True,29.0,2,5,2,3,0,2,0,0,0,3,3,0,2,2,2,4,4
401409393,Middle Tennessee Blue Raiders,E. Lawrence,4432029,,True,35.0,6,12,3,7,3,5,4,5,1,6,7,2,3,0,2,1,19
401409393,Middle Tennessee Blue Raiders,D. Sims,4279080,,True,37.0,2,11,2,8,0,3,3,3,1,7,8,0,1,0,1,0,7
401409393,Middle Tennessee Blue Raiders,C. Fussell,4590357,,False,8.0,1,2,1,2,0,0,0,0,0,0,0,0,0,0,1,1,2
401409393,Middle Tennessee Blue Raiders,C. Weston,4897511,,False,28.0,2,8,2,7,0,1,5,6,1,4,5,3,0,0,1,4,9
401409393,Middle Tennessee Blue Raiders,J. Bufford,4897508,,False,21.0,1,4,1,4,0,0,0,1,3,2,5,1,2,0,1,1,2
401409393,Middle Tennessee Blue Raiders,E. King,4431742,,False,6.0,2,3,2,2,0,1,0,1,0,0,0,0,0,0,0,0,4
401409393,Middle Tennessee Blue Raiders,TEAM,TOTAL,TOTAL,False,,23,59,20,46,3,13,17,24,10,31,41,8,8,2,13,12,66
401409392,UAB Blazers,KJ Buffen,4396968,,True,16.0,1,3,1,3,0,0,3,5,1,3,4,1,1,0,3,3,5
401409392,UAB Blazers,T. Jemison,4395623,,True,19.0,1,1,1,1,0,0,0,0,2,1,3,0,0,2,4,4,2
401409392,UAB Blazers,J. Walker,4396656,,True,35.0,7,20,2,8,5,12,7,10,1,2,3,3,5,0,6,1,26
401409392,UAB Blazers,M. Ertel,4280260,,True,36.0,6,10,2,2,4,8,0,0,0,6,6,2,2,0,1,2,16
401409392,UAB Blazers,Q. Jackson,4067781,,True,35.0,7,13,5,9,2,4,4,4,6,8,14,3,0,0,5,0,20
401409392,UAB Blazers,R. Gordon,4432400,,False,21.0,0,1,0,1,0,0,0,0,1,0,1,0,0,0,0,4,0
401409392,UAB Blazers,T. Toney,4703133,,False,7.0,0,0,0,0,0,0,0,0,0,0,0,0,0,1,0,1,0
401409392,UAB Blazers,T. Lovan,4397726,,False,18.0,3,5,3,5,0,0,0,0,0,4,4,0,2,0,1,0,6
401409392,UAB Blazers,J. Brown,4278307,,False,13.0,2,3,1,1,1,2,0,0,0,3,3,0,0,0,0,0,5
401409392,UAB Blazers,TEAM,TOTAL,TOTAL,False,,27,56,15,30,12,26,14,19,14,29,43,9,10,3,20,15,80
401409392,Florida Atlantic Owls,V. Goldin,4700818,,True,15.0,3,6,3,6,0,0,1,1,0,3,3,0,0,2,0,1,7
401409392,Florida Atlantic Owls,A. Martin,4702656,,True,37.0,4,15,2,4,2,11,1,1,2,6,8,4,2,1,3,4,11
401409392,Florida Atlantic Owls,B. Greenlee,4592701,,True,24.0,0,6,0,3,0,3,1,2,1,0,1,1,1,0,2,3,1
401409392,Florida Atlantic Owls,M. Forrest,4397485,,True,35.0,5,10,2,2,3,8,3,3,0,2,2,3,0,0,4,2,16
401409392,Florida Atlantic Owls,E. Winchester,4067456,,True,28.0,5,10,5,10,0,0,0,0,0,1,1,2,2,1,1,2,10
401409392,Florida Atlantic Owls,G. Rosado,4585611,,False,25.0,1,3,1,3,0,0,7,9,3,1,4,3,2,1,2,0,9
401409392,Florida Atlantic Owls,B. Baruti,4066634,,False,3.0,0,1,0,0,0,1,0,0,0,0,0,0,0,0,0,0,0
401409392,Florida Atlantic Owls,B. Weatherspoon,4897476,,False,11.0,0,2,0,0,0,2,0,2,1,0,1,0,2,0,0,0,0
401409392,Florida Atlantic Owls,J. Davis,4702655,,False,22.0,5,7,3,4,2,3,0,0,1,3,4,0,2,0,3,4,12
401409392,Florida Atlantic Owls,TEAM,TOTAL,TOTAL,False,,23,60,16,32,7,28,13,18,9,18,27,13,11,5,16,16,66
401409391,Southern Miss Golden Eagles,D. Pinckney,4703112,,True,32.0,3,10,2,5,1,5,6,7,2,5,7,0,1,0,0,3,13
401409391,Southern Miss Golden Eagles,D. Harris,4593268,,True,17.0,1,4,1,4,0,0,1,1,3,3,6,0,1,0,2,1,3
401409391,Southern Miss Golden Eagles,R. Bolden,4897558,,True,27.0,3,8,2,5,1,3,1,1,0,3,3,0,0,0,1,1,8
401409391,Southern Miss Golden Eagles,W. Napper,4897557,,True,37.0,6,11,5,8,1,3,4,4,1,5,6,1,1,0,5,1,17
401409391,Southern Miss Golden Eagles,J. Armstrong,4593269,,True,31.0,1,1,0,0,1,1,0,0,0,0,0,2,0,0,0,2,3
401409391,Southern Miss Golden Eagles,T. Stevenson,4397707,,False,29.0,5,15,5,15,0,0,0,0,2,1,3,1,0,1,1,2,10
401409391,Southern Miss Golden Eagles,T. Ryder,4897560,,False,1.0,0,0,0,0,0,0,0,0,0,0,0,0,0,0,0,0,0
401409391,Southern Miss Golden Eagles,T. Alfonso,4897559,,False,1.0,0,0,0,0,0,0,0,0,1,0,1,0,0,0,0,0,0
401409391,Southern Miss Golden Eagles,J. Pierre Jr.,4703115,,False,23.0,2,8,2,5,0,3,1,1,0,2,2,1,0,0,3,3,5
401409391,Southern Miss Golden Eagles,M. Jaakson,4703114,,False,1.0,0,1,0,1,0,0,0,0,0,0,0,0,0,0,0,0,0
401409391,Southern Miss Golden Eagles,B. Roberts,4703111,,False,1.0,0,1,0,1,0,0,0,0,0,0,0,0,0,0,0,0,0
401409391,Southern Miss Golden Eagles,TEAM,TOTAL,TOTAL,False,,21,59,17,44,4,15,13,14,10,19,29,5,3,1,12,13,59
401409391,Florida Atlantic Owls,V. Goldin,4700818,,True,15.0,5,7,5,7,0,0,2,3,2,1,3,1,2,0,1,2,12
401409391,Florida Atlantic Owls,A. Martin,4702656,,True,20.0,4,8,2,4,2,4,0,0,0,3,3,0,2,1,2,2,10
401409391,Florida Atlantic Owls,B. Greenlee,4592701,,True,28.0,5,6,0,0,5,6,0,0,0,1,1,6,0,0,2,0,15
401409391,Florida Atlantic Owls,M. Forrest,4397485,,True,29.0,2,5,1,1,1,4,0,0,1,1,2,4,2,0,2,3,5
401409391,Florida Atlantic Owls,E. Winchester,4067456,,True,22.0,3,5,3,4,0,1,0,0,1,5,6,3,1,1,1,2,6
401409391,Florida Atlantic Owls,B. Ulmer,4592848,,False,1.0,0,0,0,0,0,0,0,0,0,0,0,0,0,0,0,0,0
401409391,Florida Atlantic Owls,G. Rosado,4585611,,False,19.0,5,5,5,5,0,0,1,2,0,5,5,2,0,0,1,0,11
401409391,Florida Atlantic Owls,D. Kapiti,4432013,,False,5.0,2,3,2,3,0,0,0,0,0,0,0,0,0,1,1,1,4
401409391,Florida Atlantic Owls,M. Niang,4397482,,False,5.0,1,2,1,2,0,0,0,0,0,2,2,0,0,0,0,0,2
401409391,Florida Atlantic Owls,B. Baruti,4066634,,False,8.0,0,1,0,1,0,0,0,0,0,0,0,0,0,1,1,0,0
401409391,Florida Atlantic Owls,B. Weatherspoon,4897476,,False,20.0,4,8,3,3,1,5,1,1,1,3,4,3,1,0,0,1,10
401409391,Florida Atlantic Owls,B. Zimonjic,4897475,,False,3.0,1,2,0,0,1,2,0,0,0,1,1,0,0,0,0,0,3
401409391,Florida Atlantic Owls,J. Davis,4702655,,False,17.0,2,5,1,2,1,3,3,4,0,7,7,3,1,0,0,2,8
401409391,Florida Atlantic Owls,A. Ralat,4592847,,False,6.0,0,1,0,1,0,0,0,0,2,0,2,0,0,0,0,4,0
401409391,Florida Atlantic Owls,TEAM,TOTAL,TOTAL,False,,34,58,23,33,11,25,7,10,8,29,37,22,9,4,12,17,86
401409390,UTEP Miners,Z. Onyema,4703082,,True,17.0,2,3,2,3,0,0,0,0,2,2,4,0,1,0,1,2,4
401409390,UTEP Miners,T. Verhoeven,4278488,,True,29.0,6,8,6,8,0,0,0,0,4,5,9,2,1,2,4,3,12
401409390,UTEP Miners,K. Kennedy,4397137,,True,32.0,6,15,3,8,3,7,2,2,0,1,1,0,0,0,1,1,17
401409390,UTEP Miners,J. Bieniemy,4397027,,True,35.0,4,11,2,5,2,6,3,4,0,5,5,7,0,1,0,0,13
401409390,UTEP Miners,S. Boum,4280244,,True,35.0,7,11,4,6,3,5,4,7,1,5,6,2,0,0,2,2,21
401409390,UTEP Miners,K. Kalu,4897577,,False,1.0,0,0,0,0,0,0,0,0,0,0,0,0,0,0,0,0,0
401409390,UTEP Miners,J. Sibley,4433168,,False,24.0,3,5,2,3,1,2,0,0,1,3,4,1,1,2,1,2,7
401409390,UTEP Miners,A. Hollins,4278515,,False,9.0,0,1,0,1,0,0,0,0,0,0,0,0,0,0,2,2,0
401409390,UTEP Miners,J. Saterfield,4897578,,False,11.0,0,2,0,0,0,2,0,0,0,2,2,0,0,0,0,1,0
401409390,UTEP Miners,E. White,4703079,,False,2.0,0,1,0,0,0,1,0,0,0,0,0,0,0,0,0,0,0
401409390,UTEP Miners,C. Agnew,4396762,,False,5.0,0,0,0,0,0,0,0,0,0,0,0,0,0,0,0,0,0
401409390,UTEP Miners,TEAM,TOTAL,TOTAL,False,,28,57,19,34,9,23,9,13,9,27,36,12,3,5,12,13,74
401409390,Old Dominion Monarchs,K. Ezikpe,4397564,,True,34.0,4,9,4,9,0,0,1,1,1,9,10,1,1,1,2,1,9
401409390,Old Dominion Monarchs,A. Trice,4397007,,True,30.0,5,10,5,10,0,0,2,5,3,5,8,0,1,1,2,1,12
401409390,Old Dominion Monarchs,M. Long,4431804,,True,33.0,3,8,3,7,0,1,3,5,8,4,12,0,1,0,0,0,9
401409390,Old Dominion Monarchs,J. Hunter,4592875,,True,35.0,3,13,3,7,0,6,0,0,1,1,2,2,5,0,4,4,6
401409390,Old Dominion Monarchs,C.J. Keyser,4066455,,True,33.0,8,17,8,15,0,2,4,4,2,2,4,3,1,0,3,3,20
401409390,Old Dominion Monarchs,D. Stines,4897542,,False,1.0,0,0,0,0,0,0,0,0,0,1,1,0,0,0,0,0,0
401409390,Old Dominion Monarchs,I. Essien,4897541,,False,8.0,2,3,1,2,1,1,0,0,0,0,0,0,0,0,0,1,5
401409390,Old Dominion Monarchs,A.J. Oliver II,4592878,,False,12.0,0,2,0,0,0,2,0,0,1,0,1,0,0,0,0,0,0
401409390,Old Dominion Monarchs,C. Smith IV,4431798,,False,14.0,1,3,0,0,1,3,0,0,0,1,1,0,0,0,0,2,3
401409390,Old Dominion Monarchs,TEAM,TOTAL,TOTAL,False,,26,65,24,50,2,15,10,15,17,24,41,6,9,2,11,12,64
401409389,Marshall Thundering Herd,O. Anochili-Killen,4432441,,True,30.0,1,9,1,4,0,5,0,0,2,5,7,1,0,3,1,2,2
401409389,Marshall Thundering Herd,M. Beyers,4397545,,True,35.0,8,18,5,9,3,9,2,3,3,9,12,2,0,1,1,4,21
401409389,Marshall Thundering Herd,G. Miladinovic,4592865,,True,17.0,1,2,0,1,1,1,0,0,0,2,2,1,0,1,0,2,3
401409389,Marshall Thundering Herd,A. Taylor,4592859,,True,35.0,3,10,1,3,2,7,0,0,0,2,2,4,1,0,4,1,8
401409389,Marshall Thundering Herd,T. Kinsey,4397537,,True,35.0,9,19,6,14,3,5,3,6,2,3,5,1,2,0,3,2,24
401409389,Marshall Thundering Herd,D. George,4279078,,False,13.0,1,2,0,0,1,2,0,0,0,0,0,0,1,1,1,1,3
401409389,Marshall Thundering Herd,A. Toussaint,4897505,,False,2.0,0,1,0,1,0,0,0,0,1,0,1,0,0,0,0,0,0
401409389,Marshall Thundering Herd,M. Sarenac,4592862,,False,14.0,0,1,0,0,0,1,0,0,0,1,1,0,0,0,1,1,0
401409389,Marshall Thundering Herd,D. Early,4702695,,False,19.0,2,4,0,0,2,4,0,0,1,2,3,1,0,0,1,2,6
401409389,Marshall Thundering Herd,TEAM,TOTAL,TOTAL,False,,25,66,13,32,12,34,5,9,10,24,34,10,4,6,13,15,67
401409389,Louisiana Tech Bulldogs,K. Lofton Jr.,4585610,,True,22.0,9,14,9,14,0,0,3,5,2,7,9,2,1,0,6,4,21
401409389,Louisiana Tech Bulldogs,K. Willis,4593756,,True,33.0,6,12,4,6,2,6,4,4,0,4,4,0,0,0,1,1,18
401409389,Louisiana Tech Bulldogs,C. Williams,4592858,,True,30.0,4,9,3,5,1,4,1,2,0,7,7,2,1,0,1,0,10
401409389,Louisiana Tech Bulldogs,E. Christon,4279006,,True,25.0,0,1,0,0,0,1,2,2,0,0,0,0,0,1,0,0,2
401409389,Louisiana Tech Bulldogs,A. Archibald,4279005,,True,33.0,3,8,2,6,1,2,2,2,0,3,3,2,0,0,1,2,9
401409389,Louisiana Tech Bulldogs,D. Green,4702763,,False,13.0,2,5,1,3,1,2,0,0,0,1,1,0,1,0,1,2,5
401409389,Louisiana Tech Bulldogs,K. Hunter,4432313,,False,14.0,2,2,2,2,0,0,3,3,2,3,5,0,0,1,2,3,7
401409389,Louisiana Tech Bulldogs,S. Thomas,4397515,,False,1.0,0,0,0,0,0,0,0,0,0,0,0,0,0,0,0,0,0
401409389,Louisiana Tech Bulldogs,K. Stewart,4897498,,False,7.0,2,3,1,1,1,2,0,0,0,2,2,0,0,0,0,0,5
401409389,Louisiana Tech Bulldogs,L. Bradford,4433576,,False,22.0,0,1,0,1,0,0,0,0,0,5,5,1,0,0,1,1,0
401409389,Louisiana Tech Bulldogs,TEAM,TOTAL,TOTAL,False,,28,55,22,38,6,17,15,18,4,33,37,7,3,2,13,13,77
401409388,Rice Owls,M. Fiedler,4431964,,True,29.0,5,7,5,7,0,0,2,2,4,4,8,6,1,1,1,2,12
401409388,Rice Owls,T. Evee,4593712,,True,39.0,0,6,0,2,0,4,8,11,0,2,2,0,2,0,2,2,8
401409388,Rice Owls,C. Mullins,4397690,,True,37.0,5,11,5,9,0,2,3,6,2,4,6,3,2,0,0,0,13
401409388,Rice Owls,T. McBride,4279474,,True,37.0,3,4,3,4,0,0,0,0,0,4,4,3,1,0,3,0,6
401409388,Rice Owls,C. Pierre,4278368,,True,36.0,7,14,6,7,1,7,1,1,0,8,8,0,0,0,2,2,16
401409388,Rice Owls,M. Poteat,4590358,,False,11.0,4,5,4,5,0,0,1,4,1,4,5,0,0,0,0,4,9
401409388,Rice Owls,R. Abercrombie,4397265,,False,9.0,3,6,0,1,3,5,0,0,0,1,1,0,0,0,1,1,9
401409388,Rice Owls,C. Sheffield,4432321,,False,2.0,0,0,0,0,0,0,0,0,0,0,0,0,0,0,0,0,0
401409388,Rice Owls,TEAM,TOTAL,TOTAL,False,,27,53,23,35,4,18,15,24,7,28,35,12,6,1,10,11,73
401409388,Charlotte 49ers,A. Khalifa,4702739,,True,17.0,4,6,3,4,1,2,0,0,6,0,6,1,1,0,3,5,9
401409388,Charlotte 49ers,J. Threadgill,4702738,,True,23.0,1,3,0,0,1,3,0,0,0,2,2,0,0,0,1,1,3
401409388,Charlotte 49ers,J. Young,4433133,,True,37.0,6,21,5,13,1,8,1,1,1,3,4,3,1,0,2,1,14
401409388,Charlotte 49ers,A. Butler,4280070,,True,36.0,6,16,4,11,2,5,2,4,6,6,12,2,0,1,3,4,16
401409388,Charlotte 49ers,C. Trapp Jr.,4277833,,True,33.0,4,9,3,6,1,3,3,3,0,12,12,1,2,2,3,4,12
401409388,Charlotte 49ers,J. Garcia,4702740,,False,3.0,1,2,1,2,0,0,0,0,0,0,0,0,0,0,0,1,2
401409388,Charlotte 49ers,R. Braswell,4395675,,False,23.0,2,4,1,1,1,3,0,0,1,0,1,1,0,1,0,0,5
401409388,Charlotte 49ers,P. Francois,4067864,,False,3.0,0,1,0,1,0,0,0,0,0,1,1,0,0,0,0,0,0
401409388,Charlotte 49ers,L. Vasic,4278934,,False,17.0,0,5,0,3,0,2,0,0,1,1,2,0,1,0,0,1,0
401409388,Charlotte 49ers,M. Cannon,4397168,,False,8.0,0,2,0,0,0,2,0,0,0,0,0,0,0,0,0,2,0
401409388,Charlotte 49ers,TEAM,TOTAL,TOTAL,False,,24,69,17,41,7,28,6,8,17,26,43,8,5,4,13,19,61
401409387,UTSA Roadrunners,J. Germany,4432877,,True,36.0,12,20,12,19,0,1,4,6,7,5,12,0,1,0,7,2,28
401409387,UTSA Roadrunners,L. Bofinger,4703124,,True,22.0,5,9,5,9,0,0,0,2,1,5,6,1,1,0,1,1,10
401409387,UTSA Roadrunners,I. Addo-Ankrah,4703125,,True,35.0,4,9,0,1,4,8,2,2,2,3,5,1,2,0,0,3,14
401409387,UTSA Roadrunners,E. Czumbel,4593285,,True,37.0,4,8,3,4,1,4,1,1,0,3,3,7,0,0,1,1,10
401409387,UTSA Roadrunners,D. McNeill,4278139,,True,26.0,1,3,1,3,0,0,0,0,1,3,4,2,0,0,2,1,2
401409387,UTSA Roadrunners,P. Ford,4278381,,False,14.0,0,0,0,0,0,0,0,0,0,5,5,0,0,0,2,5,0
401409387,UTSA Roadrunners,C. Tucker,4897692,,False,3.0,0,0,0,0,0,0,0,0,0,1,1,0,0,0,1,1,0
401409387,UTSA Roadrunners,D. Deing,4897688,,False,26.0,0,9,0,1,0,8,0,0,0,3,3,2,0,0,4,2,0
401409387,UTSA Roadrunners,TEAM,TOTAL,TOTAL,False,,26,58,21,37,5,21,7,11,11,29,40,13,4,0,18,16,64
401409387,Southern Miss Golden Eagles,D. Pinckney,4703112,,True,24.0,2,6,1,4,1,2,2,2,0,3,3,0,1,1,2,5,7
401409387,Southern Miss Golden Eagles,D. Harris,4593268,,True,29.0,2,5,2,5,0,0,0,1,2,3,5,1,2,0,1,2,4
401409387,Southern Miss Golden Eagles,R. Bolden,4897558,,True,22.0,1,6,0,3,1,3,0,0,1,2,3,0,0,0,0,0,3
401409387,Southern Miss Golden Eagles,W. Napper,4897557,,True,40.0,8,14,5,7,3,7,0,1,0,3,3,6,2,0,2,2,19
401409387,Southern Miss Golden Eagles,J. Armstrong,4593269,,True,29.0,0,3,0,0,0,3,0,0,0,0,0,5,2,0,0,2,0
401409387,Southern Miss Golden Eagles,T. Stevenson,4397707,,False,27.0,9,12,9,12,0,0,4,7,3,4,7,0,1,2,0,1,22
401409387,Southern Miss Golden Eagles,J. Pierre Jr.,4703115,,False,29.0,3,11,1,3,2,8,4,4,0,2,2,3,1,0,3,3,12
401409387,Southern Miss Golden Eagles,TEAM,TOTAL,TOTAL,False,,25,57,18,34,7,23,10,15,6,22,28,15,9,3,9,15,67
401409386,Marshall Thundering Herd,O. Anochili-Killen,4432441,,True,33.0,5,13,3,7,2,6,3,4,4,8,12,1,1,1,0,0,15
401409386,Marshall Thundering Herd,M. Beyers,4397545,,True,37.0,3,13,3,9,0,4,8,9,1,5,6,1,1,1,4,2,14
401409386,Marshall Thundering Herd,G. Miladinovic,4592865,,True,9.0,1,2,1,2,0,0,0,0,1,5,6,0,0,1,0,2,2
401409386,Marshall Thundering Herd,A. Taylor,4592859,,True,34.0,4,11,3,8,1,3,1,2,2,5,7,4,1,0,2,1,10
401409386,Marshall Thundering Herd,T. Kinsey,4397537,,True,34.0,9,16,8,12,1,4,4,5,2,2,4,0,1,0,1,0,23
401409386,Marshall Thundering Herd,D. George,4279078,,False,15.0,2,2,1,1,1,1,0,0,0,0,0,0,2,0,0,1,5
401409386,Marshall Thundering Herd,A. Toussaint,4897505,,False,7.0,1,1,1,1,0,0,0,0,0,1,1,0,0,0,0,0,2
401409386,Marshall Thundering Herd,M. Sarenac,4592862,,False,13.0,0,2,0,0,0,2,2,3,0,0,0,2,1,0,0,2,2
401409386,Marshall Thundering Herd,D. Early,4702695,,False,18.0,0,1,0,0,0,1,1,2,0,1,1,1,0,0,1,0,1
401409386,Marshall Thundering Herd,TEAM,TOTAL,TOTAL,False,,25,61,20,40,5,21,19,25,11,31,42,9,7,3,8,8,74
401409386,Florida International Panthers,C. Brown,4066229,,True,18.0,1,9,1,8,0,1,0,0,3,2,5,0,0,1,2,1,2
401409386,Florida International Panthers,S. Pinkney,4593362,,True,10.0,0,0,0,0,0,0,0,0,0,3,3,0,0,0,0,3,0
401409386,Florida International Panthers,T. Brewer,4592852,,True,33.0,8,17,3,8,5,9,2,2,0,3,3,4,0,0,3,1,23
401409386,Florida International Panthers,E. Lovett,4592851,,True,25.0,2,6,2,3,0,3,0,0,0,7,7,0,0,0,0,3,4
401409386,Florida International Panthers,I. Banks,4278975,,True,31.0,3,6,3,3,0,3,1,1,1,3,4,1,0,0,1,4,7
401409386,Florida International Panthers,M. Sanogo,4897497,,False,5.0,0,1,0,1,0,0,0,0,0,0,0,0,0,0,0,0,0
401409386,Florida International Panthers,D. Wilcox,4432143,,False,12.0,2,2,2,2,0,0,1,1,0,1,1,2,1,0,1,3,5
401409386,Florida International Panthers,D. Jones,4897493,,False,29.0,4,11,2,7,2,4,2,2,1,4,5,1,0,0,4,1,12
401409386,Florida International Panthers,P. Krivokapic,4702675,,False,11.0,1,2,0,0,1,2,0,0,0,2,2,0,0,0,2,1,3
401409386,Florida International Panthers,J. Hawkins,4702674,,False,19.0,2,5,0,0,2,5,0,0,0,0,0,1,0,0,0,1,6
401409386,Florida International Panthers,A. Smart,4590400,,False,7.0,0,2,0,1,0,1,0,0,0,0,0,1,1,0,1,1,0
401409386,Florida International Panthers,TEAM,TOTAL,TOTAL,False,,23,61,13,33,10,28,6,6,7,27,34,10,2,1,14,19,62
401409384,UCLA Bruins,M. Johnson,4277987,,True,18.0,0,1,0,1,0,0,0,0,4,1,5,0,1,1,1,4,0
401409384,UCLA Bruins,J. Jaquez Jr.,4432848,,True,37.0,6,17,6,12,0,5,6,7,2,8,10,1,2,1,3,2,18
401409384,UCLA Bruins,J. Juzang,4432817,,True,39.0,7,15,5,11,2,4,0,1,0,3,3,2,2,0,1,0,16
401409384,UCLA Bruins,T. Campbell,4397128,,True,32.0,6,15,5,11,1,4,1,1,0,2,2,4,1,0,1,3,14
401409384,UCLA Bruins,J. Bernard,4397127,,True,34.0,6,13,4,6,2,7,5,6,0,3,3,2,1,0,1,3,19
401409384,UCLA Bruins,K. Nwuba,4397129,,False,6.0,0,0,0,0,0,0,1,2,0,0,0,0,0,0,0,2,1
401409384,UCLA Bruins,C. Riley,4278525,,False,15.0,2,4,2,3,0,1,0,0,1,0,1,0,0,0,0,4,4
401409384,UCLA Bruins,P. Watson,4576087,,False,5.0,0,1,0,0,0,1,0,0,0,1,1,0,0,1,0,0,0
401409384,UCLA Bruins,J. Clark,4432247,,False,10.0,2,3,2,3,0,0,0,0,3,0,3,0,1,0,0,2,4
401409384,UCLA Bruins,D. Singleton,4397131,,False,4.0,0,0,0,0,0,0,0,0,0,0,0,0,0,0,0,1,0
401409384,UCLA Bruins,TEAM,TOTAL,TOTAL,False,,29,69,24,47,5,22,13,17,14,18,32,9,8,3,7,21,76
401409384,Arizona Wildcats,A. Tubelis,4702372,,True,28.0,4,7,4,7,0,0,1,2,1,2,3,1,0,0,1,2,9
401409384,Arizona Wildcats,C. Koloko,4431778,,True,32.0,5,9,5,9,0,0,3,3,4,6,10,0,1,4,4,2,13
401409384,Arizona Wildcats,B. Mathurin,4683634,,True,39.0,6,14,4,8,2,6,13,15,1,3,4,7,1,1,2,1,27
401409384,Arizona Wildcats,D. Terry,4433159,,True,36.0,5,9,3,5,2,4,3,4,1,6,7,7,0,0,0,3,15
401409384,Arizona Wildcats,J. Kier,4066863,,True,13.0,2,3,2,3,0,0,0,0,0,2,2,2,1,0,1,4,4
401409384,Arizona Wildcats,O. Ballo,4594109,,False,20.0,0,3,0,3,0,0,2,2,1,4,5,0,0,6,0,2,2
401409384,Arizona Wildcats,A. Bal,4896365,,False,9.0,2,2,0,0,2,2,0,0,0,0,0,0,0,0,2,1,6
401409384,Arizona Wildcats,P. Larsson,4601025,,False,23.0,3,5,2,3,1,2,1,2,1,5,6,3,1,0,2,4,8
401409384,Arizona Wildcats,TEAM,TOTAL,TOTAL,False,,27,52,20,38,7,14,23,28,10,29,39,20,4,11,13,19,84
401409383,USC Trojans,I. Mobley,4432815,,True,38.0,4,11,4,7,0,4,1,2,1,6,7,1,1,0,3,2,9
401409383,USC Trojans,M. Agbonkpolo,4431700,,True,25.0,0,3,0,2,0,1,0,0,0,1,1,1,0,0,0,3,0
401409383,USC Trojans,C. Goodwin,4067218,,True,19.0,2,7,2,7,0,0,1,4,3,4,7,0,1,0,0,0,5
401409383,USC Trojans,B. Ellis,4593106,,True,36.0,9,17,4,8,5,9,4,4,0,5,5,1,0,0,3,4,27
401409383,USC Trojans,D. Peterson,4397689,,True,37.0,4,6,3,4,1,2,2,2,0,1,1,1,0,0,2,1,11
401409383,USC Trojans,J. Morgan,4431830,,False,9.0,0,0,0,0,0,0,0,0,0,0,0,0,0,0,0,0,0
401409383,USC Trojans,K. Johnson,4683857,,False,19.0,2,4,1,3,1,1,2,2,0,1,1,1,1,0,0,4,7
401409383,USC Trojans,E. Anderson,4431808,,False,15.0,0,3,0,2,0,1,0,2,0,2,2,1,0,0,0,1,0
401409383,USC Trojans,I. White,4395988,,False,2.0,0,2,0,2,0,0,0,0,2,1,3,0,0,0,0,0,0
401409383,USC Trojans,TEAM,TOTAL,TOTAL,False,,21,53,14,35,7,18,10,16,9,22,31,6,3,0,9,15,59
401409383,UCLA Bruins,M. Johnson,4277987,,True,26.0,2,2,2,2,0,0,0,1,1,4,5,1,0,1,1,1,4
401409383,UCLA Bruins,J. Jaquez Jr.,4432848,,True,36.0,6,9,6,8,0,1,7,8,0,5,5,2,1,1,1,0,19
401409383,UCLA Bruins,J. Juzang,4432817,,True,31.0,4,11,4,10,0,1,2,3,0,5,5,2,1,0,1,0,10
401409383,UCLA Bruins,T. Campbell,4397128,,True,35.0,5,9,2,4,3,5,1,2,0,2,2,2,0,0,2,3,14
401409383,UCLA Bruins,J. Bernard,4397127,,True,29.0,3,7,1,3,2,4,7,7,1,7,8,1,1,0,1,3,15
401409383,UCLA Bruins,C. Riley,4278525,,False,14.0,1,4,1,4,0,0,0,0,0,1,1,0,0,0,0,3,2
401409383,UCLA Bruins,P. Watson,4576087,,False,9.0,2,2,1,1,1,1,0,0,1,0,1,1,1,1,2,3,5
401409383,UCLA Bruins,J. Clark,4432247,,False,12.0,0,3,0,3,0,0,0,0,2,1,3,2,0,0,0,3,0
401409383,UCLA Bruins,D. Singleton,4397131,,False,8.0,0,0,0,0,0,0,0,0,0,0,0,0,1,0,0,0,0
401409383,UCLA Bruins,TEAM,TOTAL,TOTAL,False,,23,47,17,35,6,12,17,21,5,26,31,11,5,3,9,16,69
401409382,Colorado Buffaloes,T. da Silva,4702382,,True,33.0,3,8,2,6,1,2,0,0,1,3,4,3,0,1,1,3,7
401409382,Colorado Buffaloes,J. Walker,4432446,,True,32.0,6,10,1,4,5,6,2,2,0,5,5,2,2,3,3,4,19
401409382,Colorado Buffaloes,E. Battey,4278506,,True,26.0,4,9,2,4,2,5,0,0,0,1,1,1,0,0,2,4,10
401409382,Colorado Buffaloes,N. Clifford,4702384,,True,31.0,2,7,1,4,1,3,1,2,3,1,4,2,1,0,1,2,6
401409382,Colorado Buffaloes,J. Hammond III,4692907,,True,16.0,3,6,0,1,3,5,0,0,0,3,3,5,1,0,1,0,9
401409382,Colorado Buffaloes,L. O'Brien,4702380,,False,19.0,1,5,1,4,0,1,0,0,1,1,2,1,0,0,0,2,2
401409382,Colorado Buffaloes,KJ Simpson,4683834,,False,26.0,1,10,1,5,0,5,5,6,0,2,2,5,4,0,5,4,7
401409382,Colorado Buffaloes,K. Barthelemy,4581504,,False,17.0,4,7,0,2,4,5,0,0,0,2,2,1,1,0,1,2,12
401409382,Colorado Buffaloes,TEAM,TOTAL,TOTAL,False,,24,62,8,30,16,32,8,10,8,19,27,20,9,4,14,21,72
401409382,Arizona Wildcats,A. Tubelis,4702372,,True,34.0,9,14,8,13,1,1,1,1,2,9,11,2,3,0,2,0,20
401409382,Arizona Wildcats,C. Koloko,4431778,,True,30.0,3,4,3,4,0,0,2,2,1,3,4,0,2,1,4,3,8
401409382,Arizona Wildcats,B. Mathurin,4683634,,True,34.0,3,11,1,3,2,8,2,2,1,3,4,3,1,0,3,4,10
401409382,Arizona Wildcats,D. Terry,4433159,,True,28.0,3,4,1,1,2,3,4,4,0,4,4,3,3,0,2,2,12
401409382,Arizona Wildcats,J. Kier,4066863,,True,33.0,3,8,2,7,1,1,6,6,0,5,5,3,1,0,2,3,13
401409382,Arizona Wildcats,O. Ballo,4594109,,False,14.0,2,4,2,4,0,0,6,6,0,1,1,0,0,1,1,1,10
401409382,Arizona Wildcats,A. Bal,4896365,,False,1.0,0,0,0,0,0,0,0,0,0,0,0,0,0,0,0,0,0
401409382,Arizona Wildcats,P. Larsson,4601025,,False,26.0,3,5,3,3,0,2,3,4,1,3,4,3,0,2,3,1,9
401409382,Arizona Wildcats,TEAM,TOTAL,TOTAL,False,,26,50,20,35,6,15,24,25,6,30,36,14,10,4,18,14,82
401409381,Washington Huskies,N. Roberts,4397158,,True,22.0,1,3,1,3,0,0,1,2,3,3,6,1,0,0,0,5,3
401409381,Washington Huskies,E. Matthews Jr.,4397099,,True,34.0,3,10,3,6,0,4,6,6,1,2,3,0,2,1,2,1,12
401409381,Washington Huskies,J. Bey,4397155,,True,31.0,3,10,1,5,2,5,2,4,2,3,5,1,2,0,1,0,10
401409381,Washington Huskies,T. Brown Jr.,4395997,,True,37.0,9,25,7,20,2,5,3,3,1,5,6,5,4,0,2,0,23
401409381,Washington Huskies,D. Davis,4278522,,True,24.0,0,6,0,3,0,3,0,0,0,1,1,2,2,0,1,5,0
401409381,Washington Huskies,L. Wilson,4898376,,False,14.0,1,2,0,0,1,2,0,0,0,2,2,0,0,1,0,2,3
401409381,Washington Huskies,C. Bajema,4431757,,False,13.0,1,3,0,2,1,1,1,1,0,3,3,0,0,0,1,1,4
401409381,Washington Huskies,PJ Fuller,4431717,,False,25.0,2,6,2,4,0,2,2,2,0,1,1,0,3,0,0,2,6
401409381,Washington Huskies,TEAM,TOTAL,TOTAL,False,,20,65,14,43,6,22,15,18,12,20,32,9,13,2,8,16,61
401409381,USC Trojans,I. Mobley,4432815,,True,36.0,4,9,4,6,0,3,1,3,5,4,9,6,0,2,5,3,9
401409381,USC Trojans,M. Agbonkpolo,4431700,,True,25.0,3,5,2,2,1,3,1,1,1,3,4,1,0,0,3,2,8
401409381,USC Trojans,C. Goodwin,4067218,,True,27.0,3,5,3,5,0,0,1,4,3,5,8,1,1,0,3,2,7
401409381,USC Trojans,B. Ellis,4593106,,True,29.0,6,10,3,5,3,5,2,3,1,3,4,1,0,1,3,2,17
401409381,USC Trojans,D. Peterson,4397689,,True,35.0,3,7,2,3,1,4,2,2,0,6,6,3,0,1,4,2,9
401409381,USC Trojans,J. Morgan,4431830,,False,10.0,1,2,1,2,0,0,0,0,0,3,3,0,0,1,0,2,2
401409381,USC Trojans,K. Johnson,4683857,,False,1.0,0,1,0,1,0,0,0,0,0,0,0,0,0,0,0,2,0
401409381,USC Trojans,R. Waters,4711593,,False,22.0,3,7,2,5,1,2,2,2,0,4,4,0,0,1,2,3,9
401409381,USC Trojans,E. Anderson,4431808,,False,15.0,2,5,2,3,0,2,0,0,0,1,1,3,0,1,2,0,4
401409381,USC Trojans,TEAM,TOTAL,TOTAL,False,,25,51,19,32,6,19,9,15,11,33,44,15,1,7,23,18,65
401409380,Washington State Cougars,A. Jakimovski,4702466,,True,27.0,5,8,2,3,3,5,2,2,1,3,4,0,0,0,1,3,15
401409380,Washington State Cougars,E. Abogidi,4702463,,True,27.0,3,6,3,5,0,1,1,1,3,5,8,0,0,3,0,0,7
401409380,Washington State Cougars,T. Roberts,4702609,,True,31.0,5,13,2,5,3,8,1,1,0,1,1,3,0,0,3,2,14
401409380,Washington State Cougars,N. Williams,4432850,,True,29.0,2,6,2,3,0,3,1,2,0,2,2,0,0,0,0,0,5
401409380,Washington State Cougars,M. Flowers,4279455,,True,33.0,3,12,3,4,0,8,2,3,0,1,1,3,2,1,3,3,8
401409380,Washington State Cougars,DJ Rodman,4432103,,False,7.0,0,0,0,0,0,0,0,0,0,4,4,2,0,0,1,1,0
401409380,Washington State Cougars,M. DeWolf,4279464,,False,1.0,0,0,0,0,0,0,0,0,0,0,0,0,0,1,0,0,0
401409380,Washington State Cougars,D. Jackson,4432926,,False,21.0,1,3,1,3,0,0,3,3,0,2,2,0,0,1,0,1,5
401409380,Washington State Cougars,TJ Bamba,4596365,,False,23.0,3,5,1,1,2,4,3,4,0,2,2,0,0,0,1,3,11
401409380,Washington State Cougars,R. Rapp,4433062,,False,1.0,0,0,0,0,0,0,0,0,0,0,0,0,0,0,0,0,0
401409380,Washington State Cougars,TEAM,TOTAL,TOTAL,False,,22,53,14,24,8,29,13,16,5,20,25,8,2,6,11,13,65
401409380,UCLA Bruins,C. Riley,4278525,,True,21.0,3,5,3,5,0,0,0,0,1,2,3,0,0,0,1,2,6
401409380,UCLA Bruins,J. Jaquez Jr.,4432848,,True,33.0,9,15,7,12,2,3,3,3,3,8,11,4,2,0,2,1,23
401409380,UCLA Bruins,J. Juzang,4432817,,True,27.0,3,8,3,7,0,1,0,0,2,3,5,1,0,0,3,4,6
401409380,UCLA Bruins,T. Campbell,4397128,,True,27.0,1,3,1,2,0,1,0,0,0,1,1,4,0,0,2,3,2
401409380,UCLA Bruins,J. Bernard,4397127,,True,31.0,7,12,3,4,4,8,1,1,0,5,5,1,1,0,1,1,19
401409380,UCLA Bruins,K. Nwuba,4397129,,False,1.0,0,0,0,0,0,0,0,0,0,0,0,0,0,0,0,0,0
401409380,UCLA Bruins,M. Johnson,4277987,,False,19.0,2,3,2,3,0,0,5,5,3,1,4,1,0,1,2,3,9
401409380,UCLA Bruins,P. Watson,4576087,,False,12.0,2,6,2,5,0,1,2,2,2,2,4,2,0,0,0,2,6
401409380,UCLA Bruins,J. Kyman,4432876,,False,3.0,0,0,0,0,0,0,0,0,0,0,0,0,0,0,0,0,0
401409380,UCLA Bruins,J. Clark,4432247,,False,19.0,2,7,2,7,0,0,0,0,0,2,2,1,2,1,0,3,4
401409380,UCLA Bruins,R. Stong,4405598,,False,1.0,0,1,0,0,0,1,0,0,0,0,0,0,0,0,1,0,0
401409380,UCLA Bruins,D. Singleton,4397131,,False,6.0,0,1,0,0,0,1,0,0,0,0,0,1,0,0,0,1,0
401409380,UCLA Bruins,TEAM,TOTAL,TOTAL,False,,29,61,23,45,6,16,11,11,12,28,40,15,5,2,12,20,75
401409379,Oregon Ducks,Q. Guerrier,4432996,,True,35.0,8,18,4,8,4,10,5,8,3,10,13,1,0,2,3,3,25
401409379,Oregon Ducks,N. Dante,4592401,,True,20.0,2,4,2,4,0,0,0,0,3,8,11,0,0,0,1,4,4
401409379,Oregon Ducks,E. Williams Jr.,4278490,,True,34.0,3,14,2,8,1,6,3,4,0,4,4,3,1,0,2,4,10
401409379,Oregon Ducks,D. Harmon,4431703,,True,29.0,1,6,1,4,0,2,0,0,1,2,3,2,1,0,0,2,2
401409379,Oregon Ducks,J. Young,4066326,,True,38.0,7,19,6,14,1,5,3,4,0,4,4,7,2,0,3,1,18
401409379,Oregon Ducks,F. Kepnang,4711400,,False,17.0,1,4,1,4,0,0,0,0,1,1,2,0,0,4,0,0,2
401409379,Oregon Ducks,R. Soares,4898116,,False,27.0,2,5,0,1,2,4,2,2,2,0,2,0,1,1,0,4,8
401409379,Oregon Ducks,TEAM,TOTAL,TOTAL,False,,24,70,16,43,8,27,13,18,12,30,42,13,5,7,9,18,69
401409379,Colorado Buffaloes,T. da Silva,4702382,,True,27.0,5,9,4,7,1,2,1,2,1,2,3,1,2,2,2,4,12
401409379,Colorado Buffaloes,J. Walker,4432446,,True,31.0,6,16,4,11,2,5,4,7,4,12,16,1,0,0,0,3,18
401409379,Colorado Buffaloes,E. Battey,4278506,,True,34.0,6,15,4,9,2,6,5,6,3,9,12,1,0,2,0,3,19
401409379,Colorado Buffaloes,N. Clifford,4702384,,True,19.0,3,6,3,6,0,0,0,0,0,3,3,1,1,0,0,4,6
401409379,Colorado Buffaloes,J. Hammond III,4692907,,True,20.0,0,2,0,0,0,2,0,0,1,1,2,4,0,0,2,0,0
401409379,Colorado Buffaloes,L. O'Brien,4702380,,False,16.0,1,3,0,2,1,1,0,0,1,2,3,2,1,0,0,2,3
401409379,Colorado Buffaloes,KJ Simpson,4683834,,False,27.0,5,11,4,8,1,3,2,3,0,7,7,6,2,0,3,0,13
401409379,Colorado Buffaloes,K. Barthelemy,4581504,,False,26.0,4,12,4,7,0,5,1,1,3,1,4,1,1,0,1,0,9
401409379,Colorado Buffaloes,TEAM,TOTAL,TOTAL,False,,30,74,23,50,7,24,13,19,17,38,55,17,7,4,8,16,80
401409378,Stanford Cardinal,S. Jones,4592427,,True,28.0,12,18,8,11,4,7,0,0,3,5,8,0,0,2,1,2,28
401409378,Stanford Cardinal,M. Murrell,4585601,,True,12.0,0,2,0,0,0,2,0,0,0,0,0,3,2,1,1,1,0
401409378,Stanford Cardinal,H. Ingram,4433618,,True,35.0,7,13,5,10,2,3,0,0,0,6,6,4,1,0,4,1,16
401409378,Stanford Cardinal,J. Keefe,4433018,,True,28.0,3,7,3,6,0,1,2,2,0,3,3,1,0,1,0,1,8
401409378,Stanford Cardinal,M. O'Connell,4683635,,True,24.0,4,7,1,3,3,4,0,0,1,2,3,4,1,0,1,3,11
401409378,Stanford Cardinal,M. Raynaud,4898371,,False,13.0,0,1,0,1,0,0,0,0,1,2,3,1,0,0,1,2,0
401409378,Stanford Cardinal,B. Angel,4590354,,False,22.0,2,5,1,3,1,2,0,0,0,1,1,3,0,0,0,4,5
401409378,Stanford Cardinal,L. Kisunas,4397116,,False,3.0,0,1,0,1,0,0,0,2,1,0,1,0,0,0,1,1,0
401409378,Stanford Cardinal,J. Delaire,4397112,,False,14.0,2,2,2,2,0,0,1,2,0,2,2,0,0,1,2,4,5
401409378,Stanford Cardinal,I. Silva,4433614,,False,17.0,2,3,1,2,1,1,2,2,0,1,1,2,1,0,1,0,7
401409378,Stanford Cardinal,S. Beskind,4397115,,False,4.0,0,0,0,0,0,0,0,0,0,1,1,0,0,0,0,1,0
401409378,Stanford Cardinal,TEAM,TOTAL,TOTAL,False,,32,59,21,39,11,20,5,8,8,23,31,18,5,5,12,20,80
401409378,Arizona Wildcats,A. Tubelis,4702372,,True,22.0,4,8,3,6,1,2,0,2,4,3,7,5,2,1,2,2,9
401409378,Arizona Wildcats,C. Koloko,4431778,,True,32.0,10,12,10,12,0,0,4,4,6,3,9,4,1,1,2,1,24
401409378,Arizona Wildcats,B. Mathurin,4683634,,True,34.0,7,17,3,8,4,9,2,3,1,6,7,0,0,0,1,1,20
401409378,Arizona Wildcats,K. Kriisa,4683633,,True,33.0,3,11,0,2,3,9,1,2,0,1,1,5,2,0,0,1,10
401409378,Arizona Wildcats,D. Terry,4433159,,True,31.0,3,6,3,5,0,1,1,2,2,1,3,2,2,0,2,3,7
401409378,Arizona Wildcats,O. Ballo,4594109,,False,12.0,1,2,1,2,0,0,3,4,1,2,3,1,1,0,0,2,5
401409378,Arizona Wildcats,A. Bal,4896365,,False,2.0,0,0,0,0,0,0,0,0,0,1,1,0,0,0,0,0,0
401409378,Arizona Wildcats,P. Larsson,4601025,,False,18.0,1,3,0,1,1,2,2,2,0,1,1,2,0,0,1,3,5
401409378,Arizona Wildcats,J. Kier,4066863,,False,16.0,2,6,2,5,0,1,0,0,1,1,2,2,0,0,1,1,4
401409378,Arizona Wildcats,TEAM,TOTAL,TOTAL,False,,31,65,22,41,9,24,13,19,16,21,37,21,8,2,10,14,84
401409377,Washington Huskies,N. Roberts,4397158,,True,32.0,2,8,2,8,0,0,1,2,6,5,11,1,1,0,0,2,5
401409377,Washington Huskies,E. Matthews Jr.,4397099,,True,35.0,4,8,2,3,2,5,0,0,0,4,4,0,2,0,0,1,10
401409377,Washington Huskies,J. Bey,4397155,,True,36.0,5,12,2,6,3,6,6,7,2,2,4,2,0,0,1,3,19
401409377,Washington Huskies,T. Brown Jr.,4395997,,True,38.0,9,19,9,16,0,3,4,4,2,2,4,5,1,0,0,1,22
401409377,Washington Huskies,D. Davis,4278522,,True,28.0,4,6,4,6,0,0,0,0,0,1,1,3,2,1,3,4,8
401409377,Washington Huskies,C. Bajema,4431757,,False,25.0,5,9,2,5,3,4,3,3,0,1,1,1,1,0,0,3,16
401409377,Washington Huskies,PJ Fuller,4431717,,False,6.0,1,1,1,1,0,0,0,0,0,1,1,0,1,0,1,0,2
401409377,Washington Huskies,TEAM,TOTAL,TOTAL,False,,30,63,22,45,8,18,14,16,13,17,30,12,8,1,5,14,82
401409377,Utah Utes,B. Carlson,4592435,,True,30.0,7,10,7,9,0,1,0,0,3,3,6,3,1,2,0,2,14
401409377,Utah Utes,L. Stefanovic,4708167,,True,24.0,3,5,2,3,1,2,0,0,0,5,5,1,0,0,2,5,7
401409377,Utah Utes,R. Worster,4701995,,True,32.0,1,6,1,5,0,1,0,0,1,7,8,6,0,0,3,1,2
401409377,Utah Utes,G. Madsen,4432753,,True,19.0,4,10,0,1,4,9,0,0,1,1,2,1,0,0,2,2,12
401409377,Utah Utes,M. Anthony,4278034,,True,37.0,7,15,7,15,0,0,4,4,2,1,3,2,0,0,2,1,18
401409377,Utah Utes,L. Thioune,4397151,,False,8.0,1,1,1,1,0,0,0,0,1,1,2,0,0,0,0,0,2
401409377,Utah Utes,R. Battin,4397149,,False,6.0,1,1,1,1,0,0,0,0,1,1,2,0,1,0,0,0,2
401409377,Utah Utes,E. Ballstaedt,4592433,,False,1.0,0,0,0,0,0,0,0,0,0,0,0,1,0,0,0,0,0
401409377,Utah Utes,J. Brenchley,4592431,,False,21.0,2,4,2,4,0,0,4,5,3,1,4,2,0,0,2,2,8
401409377,Utah Utes,B. Gach,4397145,,False,9.0,0,2,0,0,0,2,0,0,0,0,0,0,0,0,2,2,0
401409377,Utah Utes,D. Jenkins Jr.,4279527,,False,13.0,1,2,0,0,1,2,2,2,0,0,0,0,1,0,2,1,5
401409377,Utah Utes,TEAM,TOTAL,TOTAL,False,,27,56,21,39,6,17,10,11,13,21,34,16,3,2,16,16,70
401409376,Washington State Cougars,A. Jakimovski,4702466,,True,32.0,0,6,0,2,0,4,2,4,2,8,10,1,1,0,0,1,2
401409376,Washington State Cougars,E. Abogidi,4702463,,True,29.0,7,17,6,13,1,4,4,4,2,3,5,0,2,1,1,3,19
401409376,Washington State Cougars,T. Roberts,4702609,,True,34.0,5,9,3,6,2,3,2,2,0,0,0,1,0,0,2,4,14
401409376,Washington State Cougars,N. Williams,4432850,,True,12.0,0,3,0,1,0,2,1,2,1,0,1,1,1,0,2,3,1
401409376,Washington State Cougars,M. Flowers,4279455,,True,35.0,3,5,1,1,2,4,4,4,0,4,4,2,0,0,4,2,12
401409376,Washington State Cougars,DJ Rodman,4432103,,False,20.0,0,1,0,0,0,1,2,2,2,6,8,0,0,0,1,0,2
401409376,Washington State Cougars,D. Jackson,4432926,,False,13.0,1,5,1,5,0,0,2,2,1,2,3,2,1,5,1,4,4
401409376,Washington State Cougars,TJ Bamba,4596365,,False,21.0,4,9,3,6,1,3,3,3,1,2,3,0,1,0,1,2,12
401409376,Washington State Cougars,R. Rapp,4433062,,False,4.0,0,0,0,0,0,0,0,0,0,0,0,0,0,0,0,0,0
401409376,Washington State Cougars,TEAM,TOTAL,TOTAL,False,,20,55,14,34,6,21,20,23,9,26,35,7,6,6,12,19,66
401409376,California Golden Bears,G. Anticevich,4278145,,True,26.0,2,12,1,7,1,5,1,2,1,7,8,2,0,0,1,3,6
401409376,California Golden Bears,L. Thiemann,4433099,,True,30.0,2,5,2,5,0,0,2,2,3,7,10,0,2,1,5,2,6
401409376,California Golden Bears,J. Celestine,4598611,,True,28.0,5,9,5,7,0,2,1,3,3,1,4,0,1,0,1,5,11
401409376,California Golden Bears,J. Brown,4431787,,True,9.0,0,2,0,2,0,0,0,0,0,0,0,1,0,0,1,1,0
401409376,California Golden Bears,J. Shepherd,4066308,,True,39.0,6,17,5,12,1,5,6,8,1,3,4,2,4,0,4,4,19
401409376,California Golden Bears,S. Alajiki,4708166,,False,18.0,1,4,1,2,0,2,3,4,1,0,1,0,0,0,0,1,5
401409376,California Golden Bears,O. Anyanwu,4433276,,False,3.0,0,1,0,1,0,0,0,0,2,1,3,0,0,0,0,0,0
401409376,California Golden Bears,K. Kuany,4432021,,False,17.0,2,6,1,4,1,2,0,0,2,4,6,0,0,0,1,2,5
401409376,California Golden Bears,M. Roberson,4698720,,False,3.0,0,0,0,0,0,0,0,0,1,0,1,0,0,0,0,2,0
401409376,California Golden Bears,M. Foreman,4067252,,False,27.0,2,8,2,5,0,3,3,3,3,2,5,3,1,0,0,3,7
401409376,California Golden Bears,TEAM,TOTAL,TOTAL,False,,20,64,17,45,3,19,16,22,21,27,48,8,8,1,14,23,59
401409375,Oregon State Beavers,G. Taylor Jr.,4833075,,True,31.0,6,8,5,7,1,1,3,3,1,2,3,3,1,0,2,3,16
401409375,Oregon State Beavers,M. Calloo,4397043,,True,31.0,2,9,1,6,1,3,4,4,1,4,5,0,1,0,2,3,9
401409375,Oregon State Beavers,R. Silva,4592414,,True,18.0,3,6,3,6,0,0,3,4,0,1,1,0,1,0,1,5,9
401409375,Oregon State Beavers,D. Davis,4898119,,True,34.0,4,9,4,7,0,2,0,0,1,2,3,5,1,1,4,0,8
401409375,Oregon State Beavers,J. Lucas,4431765,,True,39.0,6,10,3,4,3,6,7,8,0,2,2,1,0,0,0,2,22
401409375,Oregon State Beavers,I. Johnson,4702389,,False,5.0,0,1,0,1,0,0,0,0,0,0,0,0,0,0,0,1,0
401409375,Oregon State Beavers,A. Rand,4701206,,False,13.0,2,5,2,4,0,1,2,2,0,4,4,0,0,2,1,3,6
401409375,Oregon State Beavers,W. Alatishe,4398127,,False,7.0,0,1,0,1,0,0,0,0,0,2,2,1,0,1,2,0,0
401409375,Oregon State Beavers,D. Akanno,4431877,,False,22.0,1,5,1,3,0,2,0,0,0,5,5,0,1,1,1,2,2
401409375,Oregon State Beavers,TEAM,TOTAL,TOTAL,False,,24,54,19,39,5,15,19,21,5,25,30,10,5,5,13,19,72
401409375,Oregon Ducks,Q. Guerrier,4432996,,True,36.0,7,11,4,4,3,7,3,6,0,4,4,2,1,0,1,0,20
401409375,Oregon Ducks,N. Dante,4592401,,True,28.0,7,8,7,8,0,0,1,3,3,4,7,2,1,5,1,3,15
401409375,Oregon Ducks,E. Williams Jr.,4278490,,True,33.0,6,12,4,6,2,6,0,0,1,7,8,2,0,0,3,4,14
401409375,Oregon Ducks,D. Harmon,4431703,,True,34.0,2,7,1,4,1,3,0,1,2,3,5,2,2,0,1,2,5
401409375,Oregon Ducks,J. Young,4066326,,True,38.0,10,19,10,17,0,2,3,3,1,5,6,11,3,0,3,2,23
401409375,Oregon Ducks,F. Kepnang,4711400,,False,11.0,0,1,0,1,0,0,1,4,0,1,1,0,1,1,0,3,1
401409375,Oregon Ducks,N. Bittle,4432586,,False,2.0,0,0,0,0,0,0,0,0,0,0,0,0,0,0,0,1,0
401409375,Oregon Ducks,R. Soares,4898116,,False,18.0,3,5,2,3,1,2,1,1,0,2,2,0,0,0,0,4,8
401409375,Oregon Ducks,TEAM,TOTAL,TOTAL,False,,35,63,28,43,7,20,9,18,10,26,36,19,8,6,9,19,86
401409374,Stanford Cardinal,S. Jones,4592427,,True,33.0,8,17,2,5,6,12,4,4,2,4,6,1,1,0,1,1,26
401409374,Stanford Cardinal,M. Murrell,4585601,,True,8.0,0,2,0,0,0,2,0,0,0,0,0,0,0,0,2,0,0
401409374,Stanford Cardinal,H. Ingram,4433618,,True,33.0,2,7,2,6,0,1,2,4,1,9,10,3,2,1,2,0,6
401409374,Stanford Cardinal,J. Keefe,4433018,,True,25.0,7,8,7,8,0,0,2,2,2,8,10,1,0,2,0,4,16
401409374,Stanford Cardinal,M. O'Connell,4683635,,True,31.0,1,6,1,3,0,3,0,0,0,2,2,7,0,0,0,0,2
401409374,Stanford Cardinal,M. Raynaud,4898371,,False,9.0,1,2,1,1,0,1,0,0,0,2,2,1,0,0,1,0,2
401409374,Stanford Cardinal,B. Angel,4590354,,False,26.0,5,11,4,9,1,2,4,4,3,2,5,3,0,0,2,3,15
401409374,Stanford Cardinal,L. Kisunas,4397116,,False,6.0,1,1,1,1,0,0,0,0,0,0,0,0,0,0,0,0,2
401409374,Stanford Cardinal,J. Delaire,4397112,,False,16.0,1,5,1,3,0,2,0,0,1,1,2,1,0,1,0,0,2
401409374,Stanford Cardinal,I. Silva,4433614,,False,10.0,0,2,0,1,0,1,0,0,0,0,0,1,2,0,1,3,0
401409374,Stanford Cardinal,S. Beskind,4397115,,False,3.0,0,0,0,0,0,0,0,0,0,0,0,0,1,0,1,3,0
401409374,Stanford Cardinal,TEAM,TOTAL,TOTAL,False,,26,61,19,37,7,24,12,14,11,32,43,18,6,4,10,14,71
401409374,Arizona State Sun Devils,J. Graham,4432855,,True,23.0,2,10,2,10,0,0,0,1,0,6,6,1,1,1,0,4,4
401409374,Arizona State Sun Devils,A. Gaffney,4431694,,True,25.0,3,5,1,2,2,3,0,0,3,2,5,1,1,1,0,2,8
401409374,Arizona State Sun Devils,K. Lawrence,4278134,,True,27.0,3,9,3,9,0,0,0,2,2,3,5,2,0,2,1,2,6
401409374,Arizona State Sun Devils,J. Heath,4592181,,True,32.0,4,6,0,1,4,5,0,0,0,2,2,3,0,0,1,1,12
401409374,Arizona State Sun Devils,DJ Horne,4431993,,True,31.0,8,17,3,5,5,12,0,0,0,2,2,1,1,0,1,1,21
401409374,Arizona State Sun Devils,E. Boakye,4898110,,False,9.0,0,1,0,1,0,0,0,0,0,5,5,1,0,3,1,2,0
401409374,Arizona State Sun Devils,J. Neal,4837237,,False,6.0,0,1,0,0,0,1,0,0,0,1,1,1,0,0,1,0,0
401409374,Arizona State Sun Devils,L. Muhammad,4397234,,False,17.0,2,5,1,4,1,1,0,0,0,0,0,0,0,0,0,0,5
401409374,Arizona State Sun Devils,M. Jackson,4279451,,False,30.0,4,7,1,1,3,6,3,4,0,3,3,4,2,0,3,2,14
401409374,Arizona State Sun Devils,TEAM,TOTAL,TOTAL,False,,26,61,11,33,15,28,3,7,7,26,33,14,5,7,9,14,70
401409373,San Diego State Aztecs,K. Johnson,4431786,,True,13.0,0,2,0,1,0,1,0,2,0,1,1,1,0,0,0,0,0
401409373,San Diego State Aztecs,N. Mensah,4397371,,True,32.0,2,6,2,6,0,0,0,2,7,3,10,1,1,4,0,2,4
401409373,San Diego State Aztecs,T. Pulliam,4593083,,True,33.0,3,10,3,9,0,1,0,0,0,3,3,3,2,1,4,4,6
401409373,San Diego State Aztecs,L. Butler,4433183,,True,28.0,5,6,2,3,3,3,3,3,0,0,0,1,1,0,1,3,16
401409373,San Diego State Aztecs,M. Bradley,4397049,,True,35.0,6,17,4,13,2,4,3,4,3,4,7,2,1,0,3,3,17
401409373,San Diego State Aztecs,A. Arop,4397368,,False,21.0,3,5,3,5,0,0,0,0,1,3,4,0,0,0,2,3,6
401409373,San Diego State Aztecs,T. Diabate,4280209,,False,4.0,0,1,0,1,0,0,0,0,0,0,0,0,0,0,0,0,0
401409373,San Diego State Aztecs,J. Tomaic,4066375,,False,10.0,1,4,0,3,1,1,0,0,0,1,1,0,0,0,0,1,3
401409373,San Diego State Aztecs,C. Baker-Mazara,4897532,,False,12.0,0,4,0,4,0,0,0,0,0,2,2,0,0,0,0,3,0
401409373,San Diego State Aztecs,A. Seiko,4278704,,False,12.0,0,2,0,0,0,2,0,0,1,1,2,1,0,0,0,4,0
401409373,San Diego State Aztecs,TEAM,TOTAL,TOTAL,False,,20,57,14,45,6,12,6,11,13,21,34,9,5,5,10,23,52
401409373,Boise State Broncos,T. Degenhart,4898260,,True,33.0,5,11,2,6,3,5,0,1,1,3,4,2,0,0,0,3,13
401409373,Boise State Broncos,M. Armus,4280022,,True,22.0,3,5,3,5,0,0,1,1,2,4,6,0,1,0,1,3,7
401409373,Boise State Broncos,A. Kigab,4278513,,True,36.0,4,7,4,5,0,2,3,6,0,3,3,3,1,0,3,2,11
401409373,Boise State Broncos,M. Shaver Jr.,4280208,,True,31.0,2,10,1,5,1,5,3,4,0,3,3,3,0,0,2,4,8
401409373,Boise State Broncos,E. Akot,4278131,,True,29.0,3,8,2,4,1,4,3,5,0,6,6,1,1,0,3,1,10
401409373,Boise State Broncos,N. Smith,4702873,,False,10.0,0,1,0,1,0,0,0,0,0,0,0,0,0,1,0,0,0
401409373,Boise State Broncos,L. Milner,4702874,,False,12.0,0,0,0,0,0,0,0,0,1,1,2,0,0,2,0,1,0
401409373,Boise State Broncos,P. Kuzmanovic,4702872,,False,3.0,0,0,0,0,0,0,0,0,0,0,0,0,0,0,0,0,0
401409373,Boise State Broncos,M. Rice,4397263,,False,24.0,1,5,1,3,0,2,2,4,2,7,9,0,0,0,1,1,4
401409373,Boise State Broncos,TEAM,TOTAL,TOTAL,False,,18,47,13,29,5,18,12,21,9,28,37,9,3,3,13,15,53
401409372,San Diego State Aztecs,K. Johnson,4431786,,True,21.0,1,2,1,2,0,0,1,2,3,2,5,1,1,0,0,0,3
401409372,San Diego State Aztecs,N. Mensah,4397371,,True,23.0,4,5,4,5,0,0,1,2,3,3,6,0,0,1,1,5,9
401409372,San Diego State Aztecs,T. Pulliam,4593083,,True,34.0,4,8,3,4,1,4,2,2,0,0,0,6,0,0,2,1,11
401409372,San Diego State Aztecs,L. Butler,4433183,,True,22.0,2,4,2,2,0,2,4,4,1,0,1,2,2,0,3,1,8
401409372,San Diego State Aztecs,M. Bradley,4397049,,True,24.0,2,7,1,5,1,2,0,0,1,5,6,3,1,0,3,4,5
401409372,San Diego State Aztecs,A. Arop,4397368,,False,18.0,4,7,3,6,1,1,0,0,0,0,0,0,0,0,1,2,9
401409372,San Diego State Aztecs,J. Tomaic,4066375,,False,17.0,2,2,0,0,2,2,0,0,1,1,2,1,1,0,2,3,6
401409372,San Diego State Aztecs,C. Baker-Mazara,4897532,,False,14.0,1,6,1,5,0,1,0,0,1,1,2,0,1,1,0,1,2
401409372,San Diego State Aztecs,A. Seiko,4278704,,False,27.0,2,7,1,1,1,6,5,8,1,5,6,3,0,0,1,0,10
401409372,San Diego State Aztecs,TEAM,TOTAL,TOTAL,False,,22,48,16,30,6,18,13,18,13,19,32,16,6,2,14,17,63
401409372,Colorado State Rams,D. Thomas,4593040,,True,12.0,1,2,0,0,1,2,0,0,0,1,1,1,0,0,0,1,3
401409372,Colorado State Rams,D. Roddy,4593041,,True,38.0,7,14,5,9,2,5,6,10,4,5,9,4,3,1,4,4,22
401409372,Colorado State Rams,J. Tonje,4593043,,True,27.0,1,5,1,2,0,3,0,0,2,3,5,2,1,0,1,3,2
401409372,Colorado State Rams,I. Stevens,4432117,,True,39.0,9,13,6,8,3,5,0,0,1,1,2,0,1,0,4,2,21
401409372,Colorado State Rams,K. Moore,4397269,,True,26.0,0,5,0,1,0,4,0,0,0,1,1,2,0,0,0,3,0
401409372,Colorado State Rams,J. Moors,4593039,,False,20.0,0,0,0,0,0,0,0,0,1,0,1,1,0,0,2,3,0
401409372,Colorado State Rams,J. Lake,4897514,,False,2.0,0,0,0,0,0,0,0,0,0,0,0,0,0,0,0,0,0
401409372,Colorado State Rams,C. Jacobs,4897513,,False,23.0,4,5,4,4,0,1,1,2,0,5,5,0,0,0,0,2,9
401409372,Colorado State Rams,I. Rivera,4703224,,False,13.0,0,2,0,1,0,1,1,4,0,0,0,2,3,0,2,1,1
401409372,Colorado State Rams,TEAM,TOTAL,TOTAL,False,,22,46,16,25,6,21,8,16,8,16,24,12,8,1,14,19,58
401409371,Wyoming Cowboys,J. Oden,4703399,,True,30.0,3,8,3,5,0,3,0,2,2,4,6,1,1,1,3,4,6
401409371,Wyoming Cowboys,G. Ike,4703396,,True,38.0,8,15,8,15,0,0,2,2,2,4,6,2,1,0,1,3,18
401409371,Wyoming Cowboys,D. Jeffries,4703397,,True,38.0,5,8,0,0,5,8,2,3,1,3,4,3,1,0,4,1,17
401409371,Wyoming Cowboys,X. DuSell,4703394,,True,34.0,0,5,0,1,0,4,0,1,1,3,4,1,0,0,1,2,0
401409371,Wyoming Cowboys,H. Maldonado,4280267,,True,40.0,6,14,5,7,1,7,4,5,2,7,9,5,4,0,4,5,17
401409371,Wyoming Cowboys,H. Thompson,4280268,,False,3.0,0,0,0,0,0,0,0,0,0,1,1,0,0,0,0,0,0
401409371,Wyoming Cowboys,N. Reynolds,4897551,,False,7.0,0,2,0,1,0,1,0,0,0,0,0,0,0,0,1,2,0
401409371,Wyoming Cowboys,B. Wenzel,4433110,,False,10.0,1,2,0,0,1,2,0,0,0,1,1,0,0,0,1,1,3
401409371,Wyoming Cowboys,TEAM,TOTAL,TOTAL,False,,23,54,16,29,7,25,8,13,8,25,33,12,7,1,16,18,61
401409371,Boise State Broncos,T. Degenhart,4898260,,True,18.0,0,2,0,0,0,2,0,0,0,1,1,0,0,0,0,2,0
401409371,Boise State Broncos,M. Armus,4280022,,True,36.0,6,6,6,6,0,0,4,5,3,10,13,0,4,1,5,3,16
401409371,Boise State Broncos,A. Kigab,4278513,,True,37.0,7,15,3,7,4,8,4,4,1,5,6,4,3,0,1,3,22
401409371,Boise State Broncos,M. Shaver Jr.,4280208,,True,24.0,1,6,1,4,0,2,5,8,0,1,1,2,0,0,3,1,7
401409371,Boise State Broncos,E. Akot,4278131,,True,38.0,4,9,4,8,0,1,3,4,0,3,3,6,0,0,3,2,11
401409371,Boise State Broncos,N. Smith,4702873,,False,22.0,4,6,2,2,2,4,0,0,0,3,3,0,1,1,0,3,10
401409371,Boise State Broncos,L. Milner,4702874,,False,2.0,0,0,0,0,0,0,0,0,0,0,0,0,0,1,1,1,0
401409371,Boise State Broncos,M. Rice,4397263,,False,23.0,1,5,1,3,0,2,0,0,1,1,2,0,1,0,0,1,2
401409371,Boise State Broncos,TEAM,TOTAL,TOTAL,False,,23,49,17,30,6,19,16,21,5,25,30,12,9,3,13,16,68
401409370,San Diego State Aztecs,K. Johnson,4431786,,True,19.0,1,3,1,1,0,2,1,1,0,3,3,1,0,1,1,0,3
401409370,San Diego State Aztecs,N. Mensah,4397371,,True,26.0,3,6,3,6,0,0,0,0,3,3,6,1,1,5,2,2,6
401409370,San Diego State Aztecs,T. Pulliam,4593083,,True,32.0,5,9,5,8,0,1,0,1,0,2,2,2,1,0,1,1,10
401409370,San Diego State Aztecs,L. Butler,4433183,,True,25.0,2,7,2,3,0,4,1,2,0,0,0,4,0,0,1,1,5
401409370,San Diego State Aztecs,M. Bradley,4397049,,True,29.0,2,7,1,3,1,4,2,3,0,6,6,2,0,0,6,3,7
401409370,San Diego State Aztecs,A. Arop,4397368,,False,19.0,0,3,0,3,0,0,0,0,3,2,5,0,1,0,2,1,0
401409370,San Diego State Aztecs,T. Diabate,4280209,,False,3.0,0,1,0,1,0,0,0,0,0,1,1,0,0,0,0,0,0
401409370,San Diego State Aztecs,J. Tomaic,4066375,,False,9.0,0,1,0,0,0,1,0,0,0,0,0,0,0,0,0,1,0
401409370,San Diego State Aztecs,C. Baker-Mazara,4897532,,False,15.0,4,6,3,5,1,1,2,2,2,3,5,0,1,0,3,2,11
401409370,San Diego State Aztecs,A. Seiko,4278704,,False,23.0,3,5,0,2,3,3,2,2,0,0,0,1,0,0,0,0,11
401409370,San Diego State Aztecs,TEAM,TOTAL,TOTAL,False,,20,48,15,32,5,16,8,11,10,24,34,11,4,6,17,11,53
401409370,Fresno State Bulldogs,O. Robinson,4593049,,True,38.0,10,20,7,17,3,3,2,5,5,6,11,3,0,1,5,4,25
401409370,Fresno State Bulldogs,L. Colimerio,4703241,,True,25.0,1,1,1,1,0,0,0,0,0,3,3,3,1,0,0,0,2
401409370,Fresno State Bulldogs,I. Hill,4593830,,True,37.0,2,7,1,3,1,4,0,0,0,0,0,2,1,1,2,4,5
401409370,Fresno State Bulldogs,A. Holland,4593051,,True,35.0,2,7,2,4,0,3,0,0,0,3,3,0,1,1,1,4,4
401409370,Fresno State Bulldogs,J. Campbell,4397089,,True,30.0,3,7,3,4,0,3,0,0,0,2,2,1,1,0,3,1,6
401409370,Fresno State Bulldogs,B. Meah,4703242,,False,6.0,0,0,0,0,0,0,0,0,1,2,3,0,0,1,0,0,0
401409370,Fresno State Bulldogs,D. Yap,4703386,,False,3.0,0,2,0,1,0,1,0,0,0,0,0,0,0,0,0,1,0
401409370,Fresno State Bulldogs,D. Stroud,4397866,,False,7.0,1,4,0,1,1,3,0,0,0,0,0,0,2,0,0,0,3
401409370,Fresno State Bulldogs,J. Ballard,4397365,,False,19.0,0,1,0,0,0,1,1,2,0,2,2,1,2,0,0,1,1
401409370,Fresno State Bulldogs,TEAM,TOTAL,TOTAL,False,,19,49,14,31,5,18,3,7,8,21,29,10,8,4,15,15,46
401409369,Utah State Aggies,B. Horvath,4279162,,True,37.0,8,13,8,12,0,1,1,3,2,6,8,2,0,0,3,2,17
401409369,Utah State Aggies,J. Bean,4278720,,True,40.0,5,15,4,11,1,4,4,4,4,9,13,3,2,1,3,3,15
401409369,Utah State Aggies,S. Bairstow,4593102,,True,37.0,4,12,4,10,0,2,1,2,2,2,4,2,0,0,1,4,9
401409369,Utah State Aggies,R. Jones,4431751,,True,28.0,3,4,3,3,0,1,0,0,0,2,2,5,1,0,2,3,6
401409369,Utah State Aggies,RJ Eytle-Rock,4396591,,True,19.0,0,2,0,1,0,1,0,0,0,2,2,0,0,0,0,2,0
401409369,Utah State Aggies,M. Shulga,4701992,,False,10.0,1,1,1,1,0,0,0,0,1,1,2,0,0,0,1,2,2
401409369,Utah State Aggies,S. Ashworth,4701991,,False,23.0,1,5,1,1,0,4,0,0,0,2,2,3,1,0,1,0,2
401409369,Utah State Aggies,B. Miller,4278721,,False,6.0,0,2,0,0,0,2,0,0,0,0,0,0,0,0,0,0,0
401409369,Utah State Aggies,TEAM,TOTAL,TOTAL,False,,22,54,21,39,1,15,6,9,11,26,37,15,4,1,12,16,51
401409369,Colorado State Rams,D. Thomas,4593040,,True,14.0,0,3,0,1,0,2,2,2,1,2,3,0,0,0,1,0,2
401409369,Colorado State Rams,J. Tonje,4593043,,True,31.0,3,4,3,3,0,1,2,2,0,2,2,1,2,0,1,0,8
401409369,Colorado State Rams,D. Roddy,4593041,,True,37.0,6,9,6,8,0,1,1,3,1,5,6,2,0,2,3,3,13
401409369,Colorado State Rams,I. Stevens,4432117,,True,37.0,5,11,3,7,2,4,2,2,1,6,7,5,2,0,2,2,14
401409369,Colorado State Rams,K. Moore,4397269,,True,29.0,2,6,1,2,1,4,0,1,0,1,1,0,2,0,3,0,5
401409369,Colorado State Rams,J. Moors,4593039,,False,9.0,1,2,1,2,0,0,2,4,1,2,3,1,0,1,0,3,4
401409369,Colorado State Rams,A. Thistlewood,4397271,,False,3.0,0,0,0,0,0,0,0,0,0,0,0,0,0,0,0,0,0
401409369,Colorado State Rams,J. Lake,4897514,,False,7.0,1,3,1,2,0,1,0,0,0,1,1,0,1,0,0,0,2
401409369,Colorado State Rams,C. Jacobs,4897513,,False,15.0,1,4,1,2,0,2,0,0,1,0,1,0,0,0,0,3,2
401409369,Colorado State Rams,I. Rivera,4703224,,False,18.0,1,5,1,2,0,3,1,2,0,4,4,0,0,0,0,1,3
401409369,Colorado State Rams,TEAM,TOTAL,TOTAL,False,,20,47,17,29,3,18,10,16,6,24,30,9,7,3,10,12,53
401409368,Wyoming Cowboys,J. Oden,4703399,,True,23.0,1,4,1,2,0,2,0,0,1,5,6,1,0,0,2,1,2
401409368,Wyoming Cowboys,G. Ike,4703396,,True,30.0,4,14,4,14,0,0,3,3,5,8,13,1,0,0,6,3,11
401409368,Wyoming Cowboys,D. Jeffries,4703397,,True,40.0,2,7,0,0,2,7,2,2,0,7,7,0,1,0,0,0,8
401409368,Wyoming Cowboys,X. DuSell,4703394,,True,20.0,2,7,0,0,2,7,2,2,0,2,2,0,0,0,0,4,8
401409368,Wyoming Cowboys,H. Maldonado,4280267,,True,33.0,5,13,5,11,0,2,1,2,2,2,4,5,0,0,5,4,11
401409368,Wyoming Cowboys,H. Thompson,4280268,,False,10.0,0,0,0,0,0,0,0,0,0,3,3,1,0,0,2,3,0
401409368,Wyoming Cowboys,N. Reynolds,4897551,,False,15.0,2,3,2,3,0,0,3,4,0,0,0,1,0,0,1,0,7
401409368,Wyoming Cowboys,B. Wenzel,4433110,,False,29.0,3,4,1,1,2,3,4,4,3,4,7,1,0,0,1,3,12
401409368,Wyoming Cowboys,TEAM,TOTAL,TOTAL,False,,19,52,13,31,6,21,15,17,12,33,45,10,1,0,17,18,59
401409368,UNLV Rebels,R. Hamm Jr.,4277920,,True,24.0,2,5,1,2,1,3,0,0,0,7,7,0,0,0,3,4,5
401409368,UNLV Rebels,D. Muoka,4593762,,True,19.0,1,1,1,1,0,0,0,0,0,3,3,0,0,2,1,4,2
401409368,UNLV Rebels,B. Hamilton,4397433,,True,39.0,10,23,10,18,0,5,2,3,2,5,7,3,1,0,2,4,22
401409368,UNLV Rebels,M. Nuga,4397315,,True,15.0,0,2,0,0,0,2,0,0,0,1,1,0,1,0,0,0,0
401409368,UNLV Rebels,J. McCabe,4397100,,True,20.0,1,5,1,3,0,2,0,0,0,0,0,2,2,0,0,2,2
401409368,UNLV Rebels,R. Brown,4703390,,False,1.0,0,0,0,0,0,0,0,0,0,0,0,0,0,0,0,0,0
401409368,UNLV Rebels,D. Williams,4592304,,False,31.0,7,13,5,10,2,3,4,4,0,1,1,2,2,1,0,3,20
401409368,UNLV Rebels,K. Gilbert,4585618,,False,24.0,0,5,0,2,0,3,3,4,3,4,7,2,2,0,2,1,3
401409368,UNLV Rebels,J. Webster,4432918,,False,27.0,0,6,0,3,0,3,2,2,1,0,1,1,2,0,0,1,2
401409368,UNLV Rebels,TEAM,TOTAL,TOTAL,False,,21,60,18,39,3,21,11,13,7,22,29,10,10,3,8,19,56
401409367,Nevada Wolf Pack,T. Coleman,4433217,,True,34.0,1,2,0,1,1,1,2,2,1,1,2,0,3,1,0,2,5
401409367,Nevada Wolf Pack,W. Washington,4397093,,True,25.0,5,9,5,9,0,0,3,4,2,3,5,2,0,0,1,2,13
401409367,Nevada Wolf Pack,K. Blackshear,4592846,,True,25.0,1,8,0,2,1,6,0,2,0,5,5,2,2,1,1,4,3
401409367,Nevada Wolf Pack,G. Sherfield,4431794,,True,39.0,10,20,10,17,0,3,5,5,0,3,3,6,1,0,4,4,25
401409367,Nevada Wolf Pack,D. Cambridge Jr.,4279462,,True,35.0,6,14,3,5,3,9,1,3,2,4,6,3,3,0,3,0,16
401409367,Nevada Wolf Pack,W. Baker,4431691,,False,15.0,3,4,2,2,1,2,0,0,0,1,1,0,1,0,1,3,7
401409367,Nevada Wolf Pack,K.J. Hymes,4397343,,False,6.0,0,0,0,0,0,0,0,0,0,1,1,0,0,0,0,3,0
401409367,Nevada Wolf Pack,D. Foster,4702876,,False,21.0,0,1,0,1,0,0,0,0,2,1,3,1,1,0,0,0,0
401409367,Nevada Wolf Pack,TEAM,TOTAL,TOTAL,False,,26,58,20,37,6,21,11,16,7,20,27,14,11,2,10,18,69
401409367,Boise State Broncos,T. Degenhart,4898260,,True,32.0,4,6,4,6,0,0,1,1,2,4,6,3,0,0,2,2,9
401409367,Boise State Broncos,M. Armus,4280022,,True,30.0,3,4,3,4,0,0,0,0,3,4,7,0,0,0,2,4,6
401409367,Boise State Broncos,A. Kigab,4278513,,True,34.0,5,11,4,9,1,2,0,0,1,3,4,6,1,1,3,3,11
401409367,Boise State Broncos,M. Shaver Jr.,4280208,,True,33.0,3,13,3,10,0,3,9,10,1,7,8,4,2,0,4,3,15
401409367,Boise State Broncos,E. Akot,4278131,,True,36.0,8,15,4,7,4,8,2,4,0,4,4,4,1,1,3,2,22
401409367,Boise State Broncos,N. Smith,4702873,,False,11.0,0,0,0,0,0,0,0,0,0,2,2,0,1,1,0,0,0
401409367,Boise State Broncos,L. Milner,4702874,,False,7.0,1,1,1,1,0,0,1,2,0,0,0,0,0,0,0,0,3
401409367,Boise State Broncos,P. Kuzmanovic,4702872,,False,1.0,0,0,0,0,0,0,0,0,0,1,1,0,0,0,1,0,0
401409367,Boise State Broncos,M. Rice,4397263,,False,16.0,2,2,1,1,1,1,0,0,0,2,2,0,0,0,0,2,5
401409367,Boise State Broncos,TEAM,TOTAL,TOTAL,False,,26,52,20,38,6,14,13,17,9,27,36,17,5,3,16,16,71
401409366,San José State Spartans,I. Diallo,4592720,,True,9.0,1,3,1,3,0,0,0,4,0,2,2,0,0,0,1,5,2
401409366,San José State Spartans,T. Gorener,4702371,,True,21.0,3,5,1,1,2,4,0,0,0,3,3,0,0,0,0,1,8
401409366,San José State Spartans,T. Anderson,4593007,,True,41.0,4,7,2,3,2,4,0,0,0,2,2,1,1,0,3,4,10
401409366,San José State Spartans,A. Cardenas Torre,4897535,,True,42.0,5,9,3,5,2,4,1,2,1,3,4,3,1,0,0,4,13
401409366,San José State Spartans,O. Moore,4593095,,True,43.0,7,14,5,10,2,4,3,6,3,10,13,8,1,0,4,4,19
401409366,San José State Spartans,S. Robinson,4593017,,False,28.0,1,3,0,1,1,2,1,2,0,4,4,5,1,0,1,5,4
401409366,San José State Spartans,M. Amey Jr.,4897534,,False,39.0,5,12,4,8,1,4,0,0,2,2,4,0,2,0,3,3,11
401409366,San José State Spartans,C. Simmons,4278716,,False,2.0,0,0,0,0,0,0,0,0,0,0,0,0,0,0,1,0,0
401409366,San José State Spartans,TEAM,TOTAL,TOTAL,False,,26,53,16,31,10,22,5,14,7,27,34,17,6,0,14,26,67
401409366,Fresno State Bulldogs,O. Robinson,4593049,,True,40.0,11,21,10,16,1,5,8,15,4,2,6,2,1,1,4,4,31
401409366,Fresno State Bulldogs,L. Colimerio,4703241,,True,39.0,0,1,0,1,0,0,1,2,2,3,5,0,1,0,2,0,1
401409366,Fresno State Bulldogs,I. Hill,4593830,,True,33.0,5,9,2,5,3,4,1,2,0,4,4,3,1,0,4,3,14
401409366,Fresno State Bulldogs,A. Holland,4593051,,True,45.0,1,9,1,3,0,6,5,8,3,9,12,3,3,0,0,1,7
401409366,Fresno State Bulldogs,J. Campbell,4397089,,True,30.0,4,8,4,5,0,3,0,0,2,3,5,2,2,0,1,2,8
401409366,Fresno State Bulldogs,B. Meah,4703242,,False,2.0,0,0,0,0,0,0,0,0,0,0,0,0,0,0,0,1,0
401409366,Fresno State Bulldogs,R. Vaihola,4897515,,False,3.0,1,1,1,1,0,0,0,0,1,0,1,0,0,0,0,0,2
401409366,Fresno State Bulldogs,D. Yap,4703386,,False,12.0,0,2,0,1,0,1,3,4,0,1,1,0,0,0,0,0,3
401409366,Fresno State Bulldogs,J. Ballard,4397365,,False,21.0,1,5,1,1,0,4,1,1,0,0,0,0,0,0,0,1,3
401409366,Fresno State Bulldogs,TEAM,TOTAL,TOTAL,False,,23,56,19,33,4,23,19,32,14,24,38,10,8,1,11,12,69
401409365,Utah State Aggies,B. Horvath,4279162,,True,30.0,8,12,8,12,0,0,2,4,2,10,12,2,1,1,2,1,18
401409365,Utah State Aggies,J. Bean,4278720,,True,27.0,6,8,4,5,2,3,2,2,0,4,4,2,1,0,1,2,16
401409365,Utah State Aggies,S. Bairstow,4593102,,True,30.0,3,6,3,5,0,1,5,6,2,2,4,1,0,0,2,1,11
401409365,Utah State Aggies,R. Jones,4431751,,True,18.0,1,3,0,0,1,3,0,0,0,0,0,3,1,0,0,2,3
401409365,Utah State Aggies,RJ Eytle-Rock,4396591,,True,19.0,1,3,1,1,0,2,0,0,0,1,1,2,1,0,0,1,2
401409365,Utah State Aggies,N. Thelissen,4897547,,False,2.0,1,1,1,1,0,0,0,0,0,0,0,0,1,0,0,0,2
401409365,Utah State Aggies,T. Wagstaff,4593977,,False,2.0,0,0,0,0,0,0,0,0,0,0,0,0,0,0,0,0,0
401409365,Utah State Aggies,S. Zapala,4701993,,False,4.0,1,1,1,1,0,0,0,0,0,0,0,0,0,0,1,0,2
401409365,Utah State Aggies,T. Dorius,4066764,,False,1.0,0,0,0,0,0,0,0,0,0,0,0,0,0,0,0,1,0
401409365,Utah State Aggies,Z. Hamoda,4897548,,False,6.0,1,2,1,2,0,0,2,4,1,1,2,0,0,0,3,1,4
401409365,Utah State Aggies,C. Odom,4702227,,False,2.0,1,1,0,0,1,1,0,0,0,1,1,0,0,0,0,0,3
401409365,Utah State Aggies,M. Shulga,4701992,,False,17.0,3,5,0,1,3,4,2,2,1,3,4,1,1,0,0,4,11
401409365,Utah State Aggies,S. Ashworth,4701991,,False,26.0,3,7,1,3,2,4,3,3,0,0,0,6,2,0,0,1,11
401409365,Utah State Aggies,B. Miller,4278721,,False,16.0,0,5,0,2,0,3,0,0,0,1,1,2,0,0,0,2,0
401409365,Utah State Aggies,TEAM,TOTAL,TOTAL,False,,29,54,20,33,9,21,16,21,7,24,31,19,8,1,9,16,83
401409365,Air Force Falcons,L. Moerman,4903271,,True,24.0,0,4,0,2,0,2,0,0,0,3,3,1,0,1,0,2,0
401409365,Air Force Falcons,E. Taylor,4903265,,True,28.0,1,5,1,3,0,2,0,0,1,2,3,4,0,0,4,3,2
401409365,Air Force Falcons,J. Heidbreder,4903264,,True,27.0,5,8,3,4,2,4,1,1,0,1,1,1,0,0,2,3,13
401409365,Air Force Falcons,J. Octave,4708045,,True,34.0,8,13,8,13,0,0,5,6,1,9,10,1,1,0,0,2,21
401409365,Air Force Falcons,A. Walker,4397255,,True,26.0,2,10,2,8,0,2,0,0,1,3,4,1,0,0,3,2,4
401409365,Air Force Falcons,N. Jackson,4593025,,False,11.0,0,1,0,0,0,1,0,2,0,1,1,1,0,0,0,2,0
401409365,Air Force Falcons,A. Kinrade,4397257,,False,3.0,0,1,0,1,0,0,0,0,0,0,0,0,0,0,1,0,0
401409365,Air Force Falcons,R. Corner,4905396,,False,1.0,0,0,0,0,0,0,0,0,0,0,0,0,0,0,0,0,0
401409365,Air Force Falcons,B. Brown,4905394,,False,2.0,1,1,1,1,0,0,1,1,0,0,0,0,0,0,0,0,3
401409365,Air Force Falcons,J. Mills,4903269,,False,22.0,4,4,3,3,1,1,0,1,1,1,2,3,1,0,2,2,9
401409365,Air Force Falcons,J. Murphy,4903268,,False,2.0,0,0,0,0,0,0,0,0,0,0,0,0,0,0,0,0,0
401409365,Air Force Falcons,K. Brown,4710043,,False,2.0,0,0,0,0,0,0,0,0,0,0,0,0,1,0,1,0,0
401409365,Air Force Falcons,C. Vander Zwaag,4593028,,False,7.0,0,0,0,0,0,0,0,0,0,0,0,0,0,0,0,0,0
401409365,Air Force Falcons,C. Murphy,4432057,,False,11.0,2,4,2,2,0,2,0,0,0,1,1,2,1,0,1,0,4
401409365,Air Force Falcons,TEAM,TOTAL,TOTAL,False,,23,51,20,37,3,14,7,11,6,21,27,14,4,1,17,16,56
401409364,New Mexico Lobos,J. Allen-Tovar,4897529,,True,11.0,0,2,0,1,0,1,0,0,0,1,1,0,0,1,0,5,0
401409364,New Mexico Lobos,S. Singleton,4703252,,True,29.0,1,3,1,3,0,0,1,2,2,5,7,0,0,0,1,3,3
401409364,New Mexico Lobos,J. Johnson,4683803,,True,39.0,5,8,2,2,3,6,1,2,2,4,6,2,0,0,2,2,14
401409364,New Mexico Lobos,J. Mashburn Jr.,4432408,,True,31.0,5,15,2,10,3,5,2,2,0,2,2,2,1,0,2,2,15
401409364,New Mexico Lobos,J. House,4431763,,True,29.0,4,10,3,6,1,4,10,11,0,5,5,7,2,0,4,4,19
401409364,New Mexico Lobos,J. Arroyo,4397360,,False,6.0,2,2,2,2,0,0,0,2,2,0,2,0,0,0,0,0,4
401409364,New Mexico Lobos,S. Forsling,4897528,,False,21.0,2,3,1,2,1,1,1,2,1,0,1,0,1,0,1,5,6
401409364,New Mexico Lobos,KJ Jenkins,4897526,,False,25.0,4,13,2,3,2,10,1,1,0,3,3,1,1,0,4,5,11
401409364,New Mexico Lobos,T. Todd,4592288,,False,7.0,0,1,0,1,0,0,0,0,1,0,1,0,0,0,1,0,0
401409364,New Mexico Lobos,J. Francis III,4431797,,False,2.0,0,1,0,1,0,0,0,0,0,0,0,0,0,0,0,0,0
401409364,New Mexico Lobos,TEAM,TOTAL,TOTAL,False,,23,58,13,31,10,27,16,22,9,21,30,12,5,1,16,26,72
401409364,Nevada Wolf Pack,W. Baker,4431691,,True,15.0,4,7,4,6,0,1,2,3,1,1,2,0,0,0,2,3,10
401409364,Nevada Wolf Pack,T. Coleman,4433217,,True,35.0,0,2,0,2,0,0,4,6,2,4,6,2,1,0,2,3,4
401409364,Nevada Wolf Pack,K. Blackshear,4592846,,True,37.0,4,7,3,5,1,2,0,1,2,5,7,1,1,1,6,2,9
401409364,Nevada Wolf Pack,G. Sherfield,4431794,,True,38.0,9,17,8,14,1,3,8,9,0,10,10,5,1,0,2,1,27
401409364,Nevada Wolf Pack,D. Cambridge Jr.,4279462,,True,18.0,5,8,2,2,3,6,1,2,0,1,1,0,0,0,2,5,14
401409364,Nevada Wolf Pack,K.J. Hymes,4397343,,False,6.0,0,0,0,0,0,0,1,2,0,0,0,0,0,0,1,2,1
401409364,Nevada Wolf Pack,W. Washington,4397093,,False,25.0,4,9,4,9,0,0,3,3,3,5,8,2,0,1,2,2,11
401409364,Nevada Wolf Pack,D. Foster,4702876,,False,25.0,0,1,0,0,0,1,3,4,2,2,4,2,1,1,1,5,3
401409364,Nevada Wolf Pack,A. Huseinovic,4702875,,False,1.0,0,0,0,0,0,0,0,0,0,0,0,0,1,0,0,0,0
401409364,Nevada Wolf Pack,TEAM,TOTAL,TOTAL,False,,26,51,21,38,5,13,22,30,10,30,40,12,5,3,18,23,79
401408633,Saint Peter's Peacocks,C. Rupert,4898258,,True,11.0,1,3,1,2,0,1,0,0,1,2,3,0,0,1,0,1,2
401408633,Saint Peter's Peacocks,H. Drame,4593387,,True,19.0,3,7,2,4,1,3,0,0,0,0,0,1,0,0,1,3,7
401408633,Saint Peter's Peacocks,K. Ndefo,4398386,,True,33.0,5,13,5,13,0,0,0,0,0,7,7,3,3,6,2,4,10
401408633,Saint Peter's Peacocks,M. Lee,4593388,,True,27.0,0,6,0,4,0,2,2,2,0,2,2,1,0,0,2,1,2
401408633,Saint Peter's Peacocks,D. Banks III,4593386,,True,32.0,2,8,1,5,1,3,2,2,0,2,2,2,1,0,0,1,7
401408633,Saint Peter's Peacocks,O. Diahame,4703529,,False,1.0,0,1,0,1,0,0,0,0,0,0,0,0,0,0,0,0,0
401408633,Saint Peter's Peacocks,F. Drame,4432970,,False,23.0,4,8,3,6,1,2,3,4,3,4,7,0,0,0,1,3,12
401408633,Saint Peter's Peacocks,L. Reid,4898255,,False,1.0,0,0,0,0,0,0,0,0,0,1,1,1,0,0,0,0,0
401408633,Saint Peter's Peacocks,M. Silvera,4703527,,False,1.0,0,0,0,0,0,0,0,0,0,0,0,0,0,0,0,0,0
401408633,Saint Peter's Peacocks,I. Dasher,4701199,,False,18.0,2,5,2,4,0,1,0,0,0,3,3,1,0,0,1,2,4
401408633,Saint Peter's Peacocks,J. Murray,4683865,,False,13.0,1,4,0,3,1,1,0,0,0,0,0,2,0,0,0,2,3
401408633,Saint Peter's Peacocks,D. Edert,4432977,,False,21.0,0,5,0,2,0,3,2,2,0,4,4,0,0,0,0,1,2
401408633,Saint Peter's Peacocks,TEAM,TOTAL,TOTAL,False,,18,60,14,44,4,16,9,10,7,26,33,11,4,7,7,18,49
401408633,North Carolina Tar Heels,A. Bacot,4431674,,True,35.0,8,15,8,15,0,0,4,9,8,14,22,1,0,2,2,3,20
401408633,North Carolina Tar Heels,B. Manek,4277902,,True,39.0,7,11,3,5,4,6,1,2,0,8,8,1,0,0,0,1,19
401408633,North Carolina Tar Heels,L. Black,4395650,,True,33.0,1,2,1,2,0,0,3,4,2,2,4,5,2,3,0,2,5
401408633,North Carolina Tar Heels,R.J. Davis,4433176,,True,39.0,2,11,2,7,0,4,5,5,0,4,4,3,4,0,2,4,9
401408633,North Carolina Tar Heels,C. Love,4433144,,True,39.0,6,17,4,7,2,10,0,1,0,4,4,4,0,0,2,2,14
401408633,North Carolina Tar Heels,J. McKoy,4432058,,False,1.0,0,2,0,1,0,1,0,0,1,0,1,0,0,0,0,0,0
401408633,North Carolina Tar Heels,D. Styles,4611413,,False,1.0,0,1,0,0,0,1,0,0,0,0,0,0,0,0,0,0,0
401408633,North Carolina Tar Heels,P. Johnson,4701846,,False,11.0,1,2,1,2,0,0,0,0,0,0,0,1,0,0,0,0,2
401408633,North Carolina Tar Heels,D. Dunn,4683638,,False,1.0,0,0,0,0,0,0,0,0,0,1,1,0,0,0,0,0,0
401408633,North Carolina Tar Heels,K. Walton,4567079,,False,1.0,0,0,0,0,0,0,0,0,1,0,1,0,0,0,0,0,0
401408633,North Carolina Tar Heels,TEAM,TOTAL,TOTAL,False,,25,61,19,39,6,22,13,21,14,35,49,15,6,5,8,12,69
401408632,Miami Hurricanes,S. Waardenburg,4079701,,True,28.0,1,3,0,0,1,3,2,2,0,2,2,0,1,2,1,5,5
401408632,Miami Hurricanes,I. Wong,4431727,,True,34.0,6,14,4,8,2,6,1,1,1,2,3,3,2,0,3,1,15
401408632,Miami Hurricanes,J. Miller,4396818,,True,23.0,1,3,1,3,0,0,0,0,1,3,4,0,0,0,2,5,2
401408632,Miami Hurricanes,C. Moore,4066345,,True,26.0,2,9,2,6,0,3,1,2,0,1,1,2,2,0,3,2,5
401408632,Miami Hurricanes,K. McGusty,4066310,,True,36.0,7,17,7,13,0,4,4,4,0,4,4,1,1,1,1,1,18
401408632,Miami Hurricanes,T. Oosterbroek,4897396,,False,1.0,0,0,0,0,0,0,0,0,0,0,0,0,0,0,0,0,0
401408632,Miami Hurricanes,A. Walker,4592205,,False,15.0,1,4,1,2,0,2,1,2,1,4,5,0,1,1,1,1,3
401408632,Miami Hurricanes,D. Gak,4277891,,False,3.0,0,1,0,1,0,0,0,0,1,1,2,0,0,0,0,0,0
401408632,Miami Hurricanes,R. Miller Jr.,4065671,,False,2.0,0,0,0,0,0,0,0,0,0,0,0,0,0,0,0,0,0
401408632,Miami Hurricanes,W. Poplar,4897397,,False,13.0,0,2,0,0,0,2,0,2,1,3,4,0,0,0,1,1,0
401408632,Miami Hurricanes,B. Joseph,4683753,,False,17.0,1,2,1,1,0,1,0,0,0,1,1,1,0,0,2,4,2
401408632,Miami Hurricanes,F. Gkogkos,4592206,,False,2.0,0,0,0,0,0,0,0,0,0,0,0,0,0,0,0,0,0
401408632,Miami Hurricanes,TEAM,TOTAL,TOTAL,False,,19,55,16,34,3,21,9,13,5,23,28,7,7,4,14,20,50
401408632,Kansas Jayhawks,J. Wilson,4431714,,True,31.0,1,8,1,4,0,4,3,6,1,10,11,3,1,0,2,3,5
401408632,Kansas Jayhawks,D. McCormack,4397019,,True,18.0,6,7,6,7,0,0,3,4,1,3,4,0,0,0,2,1,15
401408632,Kansas Jayhawks,D. Harris,4431983,,True,26.0,2,3,2,3,0,0,1,2,0,3,3,4,1,0,3,4,5
401408632,Kansas Jayhawks,C. Braun,4431767,,True,35.0,4,9,3,7,1,2,3,5,0,6,6,4,0,1,0,1,12
401408632,Kansas Jayhawks,O. Agbaji,4397018,,True,34.0,8,12,6,10,2,2,0,1,2,3,5,4,4,0,2,2,18
401408632,Kansas Jayhawks,Z. Clemence,4683146,,False,2.0,0,0,0,0,0,0,0,0,0,1,1,0,0,0,0,1,0
401408632,Kansas Jayhawks,K.J. Adams,4433259,,False,2.0,0,0,0,0,0,0,0,0,0,0,0,0,0,1,0,0,0
401408632,Kansas Jayhawks,M. Lightfoot,4066300,,False,17.0,3,4,3,4,0,0,3,8,2,1,3,1,1,1,0,2,9
401408632,Kansas Jayhawks,J. Yesufu,4431856,,False,2.0,0,0,0,0,0,0,0,0,0,0,0,0,0,0,0,0,0
401408632,Kansas Jayhawks,R. Martin,4278133,,False,24.0,4,9,3,7,1,2,0,0,0,6,6,2,0,0,1,2,9
401408632,Kansas Jayhawks,C. Teahan,4277893,,False,2.0,0,1,0,0,0,1,0,0,0,0,0,0,0,0,0,0,0
401408632,Kansas Jayhawks,J. Coleman-Lands,3911842,,False,7.0,1,5,0,2,1,3,0,0,0,0,0,0,0,0,0,0,3
401408632,Kansas Jayhawks,TEAM,TOTAL,TOTAL,False,,29,58,24,44,5,14,13,26,8,33,41,18,7,3,11,16,76
401408631,Duke Blue Devils,P. Banchero,4432573,,True,38.0,4,11,3,9,1,2,7,8,0,7,7,3,1,1,1,4,16
401408631,Duke Blue Devils,W. Moore Jr.,4592187,,True,36.0,5,10,5,10,0,0,4,4,2,0,2,2,2,0,2,1,14
401408631,Duke Blue Devils,M. Williams,4701232,,True,35.0,6,6,6,6,0,0,0,1,3,9,12,0,0,3,2,3,12
401408631,Duke Blue Devils,AJ Griffin,4432585,,True,26.0,7,9,5,6,2,3,2,2,0,3,3,0,1,1,2,2,18
401408631,Duke Blue Devils,J. Roach,4433135,,True,35.0,3,8,3,7,0,1,3,3,1,0,1,2,2,0,5,3,9
401408631,Duke Blue Devils,T. John,4278569,,False,5.0,0,0,0,0,0,0,0,0,0,2,2,0,0,0,0,0,0
401408631,Duke Blue Devils,T. Keels,4432645,,False,25.0,4,9,3,5,1,4,0,0,0,0,0,1,1,0,2,2,9
401408631,Duke Blue Devils,TEAM,TOTAL,TOTAL,False,,29,53,25,43,4,10,16,18,7,27,34,8,7,5,15,15,78
401408631,Arkansas Razorbacks,J. Williams,4432823,,True,34.0,8,17,8,15,0,2,3,3,1,9,10,3,2,0,3,2,19
401408631,Arkansas Razorbacks,T. Wade,4279111,,True,29.0,3,7,2,4,1,3,0,0,3,0,3,0,1,0,1,0,7
401408631,Arkansas Razorbacks,A. Toney,4395671,,True,30.0,2,7,2,6,0,1,0,0,1,2,3,1,1,1,1,4,4
401408631,Arkansas Razorbacks,S. Umude,4279532,,True,35.0,4,8,2,2,2,6,4,4,0,1,1,2,1,2,2,1,14
401408631,Arkansas Razorbacks,JD Notae,4278435,,True,35.0,5,14,3,9,2,5,2,2,1,3,4,4,1,2,2,5,14
401408631,Arkansas Razorbacks,K. Johnson,4397556,,False,1.0,0,0,0,0,0,0,0,0,0,0,0,0,0,0,0,1,0
401408631,Arkansas Razorbacks,D. Davis,4432197,,False,28.0,4,7,3,5,1,2,0,0,2,1,3,1,0,0,2,1,9
401408631,Arkansas Razorbacks,C. Lykes,4277889,,False,8.0,0,2,0,1,0,1,2,2,0,1,1,1,0,0,0,1,2
401408631,Arkansas Razorbacks,TEAM,TOTAL,TOTAL,False,,26,62,20,42,6,20,11,11,8,17,25,12,6,5,11,15,69
401408630,Villanova Wildcats,E. Dixon,4431718,,True,25.0,2,6,2,6,0,0,2,2,5,4,9,0,0,1,1,3,6
401408630,Villanova Wildcats,B. Slater,4397133,,True,32.0,0,4,0,0,0,4,2,2,0,3,3,2,1,0,0,0,2
401408630,Villanova Wildcats,J. Samuels,4278588,,True,33.0,6,10,5,8,1,2,3,3,3,7,10,0,0,0,3,1,16
401408630,Villanova Wildcats,J. Moore,4592491,,True,37.0,2,10,0,6,2,4,2,2,0,2,2,0,1,1,2,1,8
401408630,Villanova Wildcats,C. Gillespie,4278585,,True,36.0,1,6,1,2,0,4,4,4,1,4,5,1,0,0,1,3,6
401408630,Villanova Wildcats,C. Arcidiacono,4592490,,False,2.0,0,0,0,0,0,0,0,0,0,0,0,1,0,0,0,1,0
401408630,Villanova Wildcats,C. Daniels,4278373,,False,35.0,4,16,2,9,2,7,2,2,1,5,6,2,1,0,2,3,12
401408630,Villanova Wildcats,TEAM,TOTAL,TOTAL,False,,15,52,10,31,5,21,15,15,12,26,38,6,3,2,10,12,50
401408630,Houston Cougars,F. White Jr.,4278263,,True,27.0,1,5,1,3,0,2,0,0,1,3,4,0,0,0,0,4,2
401408630,Houston Cougars,J. Carlton,4278229,,True,14.0,2,3,2,3,0,0,0,0,1,4,5,0,0,2,4,3,4
401408630,Houston Cougars,J. Shead,4432241,,True,38.0,4,13,4,8,0,5,1,2,1,1,2,2,0,0,1,1,9
401408630,Houston Cougars,K. Edwards,4397081,,True,39.0,1,12,1,4,0,8,2,4,0,4,4,4,0,0,1,2,4
401408630,Houston Cougars,T. Moore,4066808,,True,35.0,6,21,5,16,1,5,2,2,5,5,10,1,3,0,2,1,15
401408630,Houston Cougars,J. Roberts,4433068,,False,26.0,2,2,2,2,0,0,3,4,4,4,8,0,3,2,0,2,7
401408630,Houston Cougars,R. Chaney,4395708,,False,12.0,1,1,1,1,0,0,1,2,1,1,2,0,0,0,1,0,3
401408630,Houston Cougars,R. Walker,4708176,,False,9.0,0,0,0,0,0,0,0,0,0,0,0,0,0,0,0,1,0
401408630,Houston Cougars,TEAM,TOTAL,TOTAL,False,,17,57,16,37,1,20,9,14,15,24,39,7,6,4,10,14,44
401408629,UCLA Bruins,C. Riley,4278525,,True,25.0,2,6,2,6,0,0,0,0,1,3,4,0,1,2,1,2,4
401408629,UCLA Bruins,J. Jaquez Jr.,4432848,,True,38.0,5,18,5,15,0,3,0,2,0,5,5,2,1,0,0,0,10
401408629,UCLA Bruins,J. Juzang,4432817,,True,39.0,5,13,3,9,2,4,2,2,0,4,4,2,0,0,1,2,14
401408629,UCLA Bruins,T. Campbell,4397128,,True,39.0,6,9,6,8,0,1,3,4,0,2,2,6,1,1,3,2,15
401408629,UCLA Bruins,J. Bernard,4397127,,True,38.0,7,11,5,6,2,5,0,0,1,4,5,1,2,0,0,0,16
401408629,UCLA Bruins,M. Johnson,4277987,,False,12.0,2,2,2,2,0,0,0,0,2,2,4,0,1,1,0,2,4
401408629,UCLA Bruins,P. Watson,4576087,,False,3.0,0,0,0,0,0,0,0,0,0,1,1,0,0,0,0,1,0
401408629,UCLA Bruins,J. Kyman,4432876,,False,1.0,0,0,0,0,0,0,0,0,0,0,0,0,0,0,0,1,0
401408629,UCLA Bruins,J. Clark,4432247,,False,5.0,1,3,0,2,1,1,0,0,1,1,2,0,1,0,1,1,3
401408629,UCLA Bruins,TEAM,TOTAL,TOTAL,False,,28,62,23,48,5,14,5,8,8,26,34,11,7,4,6,11,66
401408629,North Carolina Tar Heels,A. Bacot,4431674,,True,31.0,6,10,6,10,0,0,2,4,8,7,15,2,0,1,2,3,14
401408629,North Carolina Tar Heels,B. Manek,4277902,,True,38.0,5,13,2,3,3,10,0,0,2,6,8,2,1,0,2,1,13
401408629,North Carolina Tar Heels,L. Black,4395650,,True,39.0,1,5,1,3,0,2,0,0,0,2,2,0,1,0,1,0,2
401408629,North Carolina Tar Heels,R.J. Davis,4433176,,True,37.0,3,11,2,7,1,4,5,5,1,6,7,3,0,0,2,2,12
401408629,North Carolina Tar Heels,C. Love,4433144,,True,40.0,11,24,5,11,6,13,2,2,1,2,3,4,0,0,1,2,30
401408629,North Carolina Tar Heels,P. Johnson,4701846,,False,10.0,1,2,1,1,0,1,0,1,1,1,2,0,0,0,0,1,2
401408629,North Carolina Tar Heels,D. Styles,4611413,,False,5.0,0,1,0,0,0,1,0,0,0,2,2,0,0,0,0,0,0
401408629,North Carolina Tar Heels,TEAM,TOTAL,TOTAL,False,,27,66,17,35,10,31,9,12,15,28,43,11,2,1,8,9,73
401408628,Saint Peter's Peacocks,C. Rupert,4898258,,True,22.0,5,8,4,6,1,2,0,1,1,2,3,0,3,2,1,4,11
401408628,Saint Peter's Peacocks,H. Drame,4593387,,True,24.0,1,3,0,1,1,2,4,4,1,1,2,0,1,0,0,3,7
401408628,Saint Peter's Peacocks,K. Ndefo,4398386,,True,19.0,2,6,2,5,0,1,0,0,0,3,3,4,1,0,3,5,4
401408628,Saint Peter's Peacocks,M. Lee,4593388,,True,30.0,2,8,1,4,1,4,2,2,1,0,1,3,0,0,0,1,7
401408628,Saint Peter's Peacocks,D. Banks III,4593386,,True,28.0,6,14,6,10,0,4,2,2,0,3,3,0,0,1,0,1,14
401408628,Saint Peter's Peacocks,O. Diahame,4703529,,False,8.0,0,0,0,0,0,0,0,0,0,1,1,0,2,1,0,2,0
401408628,Saint Peter's Peacocks,F. Drame,4432970,,False,22.0,1,3,0,1,1,2,2,2,1,0,1,0,1,0,0,2,5
401408628,Saint Peter's Peacocks,I. Dasher,4701199,,False,17.0,1,1,0,0,1,1,0,0,0,1,1,0,0,0,1,1,3
401408628,Saint Peter's Peacocks,J. Murray,4683865,,False,10.0,2,5,2,3,0,2,2,2,1,1,2,1,1,0,2,0,6
401408628,Saint Peter's Peacocks,D. Edert,4432977,,False,20.0,1,6,0,3,1,3,7,8,1,2,3,1,0,0,1,0,10
401408628,Saint Peter's Peacocks,TEAM,TOTAL,TOTAL,False,,21,54,15,33,6,21,19,21,8,18,26,9,9,4,8,19,67
401408628,Purdue Boilermakers,M. Gillis,4431753,,True,28.0,2,6,2,3,0,3,6,6,3,3,6,4,1,0,1,4,10
401408628,Purdue Boilermakers,Z. Edey,4600663,,True,17.0,5,7,5,7,0,0,1,2,2,0,2,0,0,1,5,0,11
401408628,Purdue Boilermakers,J. Ivey,4433218,,True,36.0,4,12,3,6,1,6,0,0,1,7,8,2,0,0,6,2,9
401408628,Purdue Boilermakers,E. Hunter Jr.,4397243,,True,31.0,0,4,0,1,0,3,0,0,1,4,5,3,0,0,0,3,0
401408628,Purdue Boilermakers,S. Stefanovic,4277985,,True,36.0,4,8,1,1,3,7,0,0,0,4,4,0,0,0,0,4,11
401408628,Purdue Boilermakers,C. Furst,4433598,,False,12.0,0,0,0,0,0,0,2,2,1,1,2,0,0,0,0,1,2
401408628,Purdue Boilermakers,T. Williams,4397246,,False,23.0,7,15,7,15,0,0,2,3,1,7,8,2,0,1,1,3,16
401408628,Purdue Boilermakers,E. Morton,4433151,,False,4.0,0,1,0,0,0,1,0,0,0,0,0,0,1,0,0,0,0
401408628,Purdue Boilermakers,I. Thompson,4431749,,False,13.0,1,1,0,0,1,1,2,2,1,0,1,0,0,0,1,1,5
401408628,Purdue Boilermakers,TEAM,TOTAL,TOTAL,False,,23,54,18,33,5,21,13,15,11,26,37,11,2,2,15,18,64
401408627,Providence Friars,N. Horchler,4278453,,True,38.0,4,14,2,6,2,8,0,0,1,7,8,0,1,1,1,2,10
401408627,Providence Friars,J. Minaya,4278111,,True,37.0,1,4,1,2,0,2,0,0,2,3,5,4,1,1,0,4,2
401408627,Providence Friars,N. Watson,4278573,,True,22.0,4,11,4,11,0,0,0,2,1,1,2,0,0,1,0,4,8
401408627,Providence Friars,A.J. Reeves,4397109,,True,27.0,2,10,1,3,1,7,4,4,1,2,3,1,1,1,1,1,9
401408627,Providence Friars,Al Durham,4277942,,True,39.0,8,18,7,13,1,5,4,7,1,6,7,4,1,0,3,4,21
401408627,Providence Friars,Ed Croswell,4397153,,False,18.0,3,6,3,6,0,0,3,3,3,3,6,0,0,0,0,4,9
401408627,Providence Friars,A. Breed,4585590,,False,2.0,0,0,0,0,0,0,0,0,0,0,0,0,0,0,0,1,0
401408627,Providence Friars,B. Goodine,4431716,,False,0.0,0,0,0,0,0,0,0,0,0,0,0,0,0,0,0,0,0
401408627,Providence Friars,J. Bynum,4397194,,False,17.0,1,5,1,4,0,1,0,0,0,1,1,1,0,0,2,1,2
401408627,Providence Friars,A. Fonts,4278575,,False,0.0,0,0,0,0,0,0,0,0,0,0,0,0,0,0,0,0,0
401408627,Providence Friars,TEAM,TOTAL,TOTAL,False,,23,68,19,45,4,23,11,16,13,25,38,10,4,4,7,21,61
401408627,Kansas Jayhawks,J. Wilson,4431714,,True,38.0,5,16,4,13,1,3,5,5,4,7,11,0,1,1,1,2,16
401408627,Kansas Jayhawks,D. McCormack,4397019,,True,23.0,2,5,2,5,0,0,4,6,1,1,2,0,0,1,3,4,8
401408627,Kansas Jayhawks,D. Harris,4431983,,True,20.0,3,5,3,4,0,1,0,0,0,0,0,2,0,0,1,0,6
401408627,Kansas Jayhawks,C. Braun,4431767,,True,36.0,2,6,2,4,0,2,2,2,1,9,10,2,0,0,1,3,6
401408627,Kansas Jayhawks,O. Agbaji,4397018,,True,36.0,2,8,2,4,0,4,1,2,0,4,4,0,2,4,1,1,5
401408627,Kansas Jayhawks,M. Lightfoot,4066300,,False,16.0,1,3,1,3,0,0,0,0,1,1,2,0,0,4,0,2,2
401408627,Kansas Jayhawks,R. Martin,4278133,,False,27.0,7,13,6,9,1,4,8,13,0,7,7,3,0,1,3,3,23
401408627,Kansas Jayhawks,J. Coleman-Lands,3911842,,False,4.0,0,0,0,0,0,0,0,0,0,0,0,0,0,0,0,0,0
401408627,Kansas Jayhawks,TEAM,TOTAL,TOTAL,False,,22,56,20,42,2,14,20,28,10,33,43,7,3,11,10,15,66
401408626,Miami Hurricanes,S. Waardenburg,4079701,,True,35.0,5,9,2,2,3,7,0,0,0,8,8,5,1,3,2,2,13
401408626,Miami Hurricanes,I. Wong,4431727,,True,39.0,3,11,2,6,1,5,0,2,2,2,4,3,1,0,1,3,7
401408626,Miami Hurricanes,J. Miller,4396818,,True,34.0,6,6,6,6,0,0,4,6,3,4,7,2,1,2,1,1,16
401408626,Miami Hurricanes,C. Moore,4066345,,True,38.0,2,8,1,3,1,5,2,2,1,1,2,9,1,0,3,3,7
401408626,Miami Hurricanes,K. McGusty,4066310,,True,37.0,10,18,6,11,4,7,3,4,0,6,6,1,4,0,4,0,27
401408626,Miami Hurricanes,A. Walker,4592205,,False,10.0,0,2,0,1,0,1,0,0,0,3,3,0,2,1,1,0,0
401408626,Miami Hurricanes,W. Poplar,4897397,,False,2.0,0,1,0,1,0,0,0,0,0,0,0,0,0,0,0,1,0
401408626,Miami Hurricanes,B. Joseph,4683753,,False,5.0,0,1,0,0,0,1,0,0,0,0,0,1,1,1,1,2,0
401408626,Miami Hurricanes,TEAM,TOTAL,TOTAL,False,,26,56,17,30,9,26,9,14,7,27,34,21,11,7,14,12,70
401408626,Iowa State Cyclones,R. Jones,4593702,,True,18.0,3,7,3,7,0,0,0,2,4,3,7,1,0,0,0,3,6
401408626,Iowa State Cyclones,A. Kunc,4397167,,True,29.0,1,5,1,4,0,1,0,0,2,7,9,2,0,2,1,5,2
401408626,Iowa State Cyclones,T. Enaruna,4431734,,True,3.0,0,0,0,0,0,0,0,0,0,0,0,0,0,0,1,0,0
401408626,Iowa State Cyclones,T. Hunter,4683751,,True,31.0,6,14,5,10,1,4,0,0,0,4,4,7,3,1,2,2,13
401408626,Iowa State Cyclones,I. Brockington,4278412,,True,36.0,5,15,4,11,1,4,0,0,1,6,7,2,1,0,4,2,11
401408626,Iowa State Cyclones,G. Conditt IV,4396989,,False,17.0,3,4,3,4,0,0,2,2,4,0,4,1,0,1,2,2,8
401408626,Iowa State Cyclones,T. Jackson,4431999,,False,5.0,0,1,0,0,0,1,0,0,0,1,1,0,0,0,0,1,0
401408626,Iowa State Cyclones,C. Grill,4431973,,False,24.0,1,6,0,0,1,6,0,0,1,0,1,2,1,0,0,1,3
401408626,Iowa State Cyclones,G. Kalscheur,4397214,,False,37.0,6,16,5,10,1,6,0,0,2,2,4,1,1,0,6,2,13
401408626,Iowa State Cyclones,TEAM,TOTAL,TOTAL,False,,25,68,21,46,4,22,2,4,16,26,42,16,6,4,18,18,56
401408625,Gonzaga Bulldogs,D. Timme,4431695,,True,37.0,9,19,9,18,0,1,7,8,3,4,7,3,0,0,5,2,25
401408625,Gonzaga Bulldogs,C. Holmgren,4433255,,True,23.0,5,9,4,6,1,3,0,2,3,11,14,1,0,2,1,5,11
401408625,Gonzaga Bulldogs,J. Strawther,4432181,,True,33.0,3,9,2,4,1,5,5,6,1,2,3,0,0,0,0,1,12
401408625,Gonzaga Bulldogs,R. Bolton,4397242,,True,29.0,3,10,1,3,2,7,0,0,0,2,2,1,0,0,1,4,8
401408625,Gonzaga Bulldogs,A. Nembhard,4395712,,True,40.0,2,11,1,8,1,3,2,2,0,7,7,3,3,0,5,1,7
401408625,Gonzaga Bulldogs,A. Watson,4431705,,False,17.0,0,2,0,2,0,0,1,2,1,7,8,0,0,1,1,1,1
401408625,Gonzaga Bulldogs,N. Hickman,4683737,,False,13.0,1,3,1,1,0,2,0,0,1,0,1,1,1,0,1,3,2
401408625,Gonzaga Bulldogs,H. Sallis,4433281,,False,8.0,1,1,1,1,0,0,0,0,0,0,0,0,1,0,0,0,2
401408625,Gonzaga Bulldogs,TEAM,TOTAL,TOTAL,False,,24,64,19,43,5,21,15,20,11,34,45,9,5,3,15,17,68
401408625,Arkansas Razorbacks,J. Williams,4432823,,True,36.0,5,12,3,7,2,5,3,5,1,11,12,3,0,1,0,4,15
401408625,Arkansas Razorbacks,T. Wade,4279111,,True,34.0,6,10,3,6,3,4,0,0,0,7,7,1,1,1,0,3,15
401408625,Arkansas Razorbacks,A. Toney,4395671,,True,39.0,4,8,4,7,0,1,1,3,4,3,7,0,1,2,0,2,9
401408625,Arkansas Razorbacks,S. Umude,4279532,,True,20.0,3,5,3,4,0,1,0,0,0,2,2,1,0,0,2,4,6
401408625,Arkansas Razorbacks,JD Notae,4278435,,True,38.0,9,29,7,17,2,12,1,2,2,4,6,6,3,2,5,2,21
401408625,Arkansas Razorbacks,K. Johnson,4397556,,False,4.0,0,1,0,1,0,0,0,0,0,0,0,0,0,0,0,2,0
401408625,Arkansas Razorbacks,D. Davis,4432197,,False,25.0,2,7,2,5,0,2,2,2,0,3,3,2,1,0,1,2,6
401408625,Arkansas Razorbacks,C. Lykes,4277889,,False,4.0,0,0,0,0,0,0,2,2,0,0,0,0,0,0,0,1,2
401408625,Arkansas Razorbacks,TEAM,TOTAL,TOTAL,False,,29,72,22,47,7,25,9,14,10,32,42,13,6,6,8,20,74
401408624,Texas Tech Red Raiders,K. Obanor,4398304,,True,38.0,4,10,2,6,2,4,0,0,2,8,10,1,0,1,0,3,10
401408624,Texas Tech Red Raiders,B. Williams,4066678,,True,34.0,8,16,6,13,2,3,3,4,4,1,5,2,0,1,1,2,21
401408624,Texas Tech Red Raiders,K. McCullar,4411057,,True,36.0,7,13,6,9,1,4,2,3,0,3,3,1,1,0,2,3,17
401408624,Texas Tech Red Raiders,T. Shannon Jr.,4432847,,True,35.0,4,9,4,8,0,1,0,0,0,2,2,0,1,0,1,1,8
401408624,Texas Tech Red Raiders,A. Arms,4406489,,True,36.0,6,12,5,6,1,6,0,0,2,5,7,7,2,0,2,1,13
401408624,Texas Tech Red Raiders,D. Batcho,4683631,,False,0.0,0,0,0,0,0,0,0,2,0,0,0,0,0,0,0,0,0
401408624,Texas Tech Red Raiders,M. Santos-Silva,4278420,,False,8.0,2,4,2,4,0,0,0,0,0,0,0,0,0,1,0,0,4
401408624,Texas Tech Red Raiders,D. Warren,4592666,,False,10.0,0,2,0,1,0,1,0,0,1,1,2,1,0,0,2,2,0
401408624,Texas Tech Red Raiders,M. Wilson,4432902,,False,0.0,0,0,0,0,0,0,0,0,0,0,0,0,0,0,0,0,0
401408624,Texas Tech Red Raiders,C. Nadolny,4431841,,False,3.0,0,0,0,0,0,0,0,0,0,0,0,0,0,0,0,2,0
401408624,Texas Tech Red Raiders,TEAM,TOTAL,TOTAL,False,,31,66,25,47,6,19,5,9,12,21,33,12,4,3,8,14,73
401408624,Duke Blue Devils,P. Banchero,4432573,,True,37.0,7,12,4,8,3,4,5,6,0,4,4,4,3,0,1,0,22
401408624,Duke Blue Devils,W. Moore Jr.,4592187,,True,34.0,4,7,3,4,1,3,3,3,1,3,4,2,0,0,2,1,12
401408624,Duke Blue Devils,M. Williams,4701232,,True,30.0,6,9,6,9,0,0,4,4,2,6,8,0,0,3,2,2,16
401408624,Duke Blue Devils,AJ Griffin,4432585,,True,37.0,3,9,0,2,3,7,2,2,0,7,7,1,0,1,0,3,11
401408624,Duke Blue Devils,J. Roach,4433135,,True,35.0,7,11,7,10,0,1,1,2,0,4,4,5,1,0,4,3,15
401408624,Duke Blue Devils,T. John,4278569,,False,10.0,1,1,1,1,0,0,0,0,1,0,1,0,0,2,0,1,2
401408624,Duke Blue Devils,B. Jones,4278348,,False,3.0,0,2,0,0,0,2,0,0,0,0,0,0,0,0,0,1,0
401408624,Duke Blue Devils,T. Keels,4432645,,False,14.0,0,3,0,1,0,2,0,0,0,0,0,0,0,0,0,1,0
401408624,Duke Blue Devils,TEAM,TOTAL,TOTAL,False,,28,54,21,35,7,19,15,17,5,24,29,12,4,6,10,12,78
401408623,Villanova Wildcats,E. Dixon,4431718,,True,21.0,2,5,1,3,1,2,1,2,3,4,7,0,0,1,0,4,6
401408623,Villanova Wildcats,B. Slater,4397133,,True,27.0,0,4,0,2,0,2,0,0,0,3,3,0,1,0,1,3,0
401408623,Villanova Wildcats,J. Samuels,4278588,,True,35.0,8,13,7,10,1,3,5,5,3,4,7,1,2,2,2,2,22
401408623,Villanova Wildcats,J. Moore,4592491,,True,39.0,5,13,2,5,3,8,2,2,0,4,4,4,0,0,1,1,15
401408623,Villanova Wildcats,C. Gillespie,4278585,,True,39.0,4,14,0,4,4,10,0,0,0,6,6,2,1,0,1,1,12
401408623,Villanova Wildcats,C. Arcidiacono,4592490,,False,1.0,0,0,0,0,0,0,0,0,0,0,0,0,0,0,0,0,0
401408623,Villanova Wildcats,B. Antoine,4432814,,False,3.0,0,0,0,0,0,0,0,0,0,0,0,0,0,0,0,0,0
401408623,Villanova Wildcats,C. Daniels,4278373,,False,35.0,3,10,3,5,0,5,2,3,2,7,9,3,1,1,1,1,8
401408623,Villanova Wildcats,TEAM,TOTAL,TOTAL,False,,22,59,13,29,9,30,10,12,10,28,38,10,5,4,7,12,63
401408623,Michigan Wolverines,C. Houstan,4433623,,True,28.0,2,6,1,1,1,5,0,0,0,2,2,0,1,0,1,2,5
401408623,Michigan Wolverines,M. Diabate,4433249,,True,21.0,3,7,3,7,0,0,1,2,3,3,6,0,0,2,2,1,7
401408623,Michigan Wolverines,H. Dickinson,4432180,,True,31.0,6,16,6,15,0,1,3,4,5,10,15,3,0,2,0,4,15
401408623,Michigan Wolverines,D. Jones,4397506,,True,31.0,3,6,2,4,1,2,0,0,0,4,4,4,0,0,3,1,7
401408623,Michigan Wolverines,E. Brooks,4277960,,True,39.0,5,14,2,9,3,5,1,2,2,3,5,2,1,0,1,1,14
401408623,Michigan Wolverines,T. Williams II,4702236,,False,23.0,1,4,0,1,1,3,2,2,1,2,3,1,0,0,0,1,5
401408623,Michigan Wolverines,B. Johns Jr.,4397206,,False,17.0,0,5,0,3,0,2,0,2,0,2,2,1,1,2,0,0,0
401408623,Michigan Wolverines,F. Collins,4433616,,False,10.0,1,3,1,3,0,0,0,2,0,1,1,0,0,0,0,1,2
401408623,Michigan Wolverines,TEAM,TOTAL,TOTAL,False,,21,61,15,43,6,18,7,14,14,27,41,11,3,6,8,11,55
401408622,Houston Cougars,F. White Jr.,4278263,,True,26.0,2,6,2,3,0,3,0,1,1,4,5,1,0,2,1,4,4
401408622,Houston Cougars,J. Carlton,4278229,,True,28.0,5,6,5,6,0,0,0,2,5,2,7,0,1,1,1,3,10
401408622,Houston Cougars,J. Shead,4432241,,True,38.0,5,16,3,11,2,5,9,10,1,3,4,6,2,0,5,2,21
401408622,Houston Cougars,K. Edwards,4397081,,True,38.0,6,13,1,4,5,9,2,4,0,5,5,3,1,0,2,2,19
401408622,Houston Cougars,T. Moore,4066808,,True,17.0,1,3,0,2,1,1,0,0,0,4,4,2,0,2,2,4,3
401408622,Houston Cougars,J. Roberts,4433068,,False,14.0,1,1,1,1,0,0,2,2,0,2,2,0,0,0,0,0,4
401408622,Houston Cougars,R. Chaney,4395708,,False,12.0,1,2,1,2,0,0,4,6,3,0,3,0,0,0,0,2,6
401408622,Houston Cougars,R. Walker,4708176,,False,27.0,2,3,1,1,1,2,0,0,0,3,3,0,1,1,0,2,5
401408622,Houston Cougars,TEAM,TOTAL,TOTAL,False,,23,50,14,30,9,20,17,25,12,25,37,12,5,6,12,19,72
401408622,Arizona Wildcats,A. Tubelis,4702372,,True,23.0,0,8,0,7,0,1,2,2,2,3,5,1,2,0,4,1,2
401408622,Arizona Wildcats,C. Koloko,4431778,,True,32.0,2,6,2,6,0,0,6,8,0,4,4,2,2,2,1,2,10
401408622,Arizona Wildcats,B. Mathurin,4683634,,True,37.0,4,14,2,7,2,7,5,8,2,2,4,3,0,0,1,4,15
401408622,Arizona Wildcats,K. Kriisa,4683633,,True,19.0,1,7,0,0,1,7,0,0,2,2,4,1,0,0,2,4,3
401408622,Arizona Wildcats,D. Terry,4433159,,True,38.0,6,9,4,6,2,3,3,4,4,2,6,3,0,1,3,2,17
401408622,Arizona Wildcats,O. Ballo,4594109,,False,10.0,1,3,1,3,0,0,0,0,0,0,0,0,1,0,1,3,2
401408622,Arizona Wildcats,P. Larsson,4601025,,False,22.0,3,4,2,2,1,2,1,1,2,4,6,1,1,0,1,4,8
401408622,Arizona Wildcats,J. Kier,4066863,,False,19.0,1,3,0,1,1,2,0,0,1,1,2,1,1,0,1,1,3
401408622,Arizona Wildcats,TEAM,TOTAL,TOTAL,False,,18,54,11,32,7,22,17,23,16,19,35,12,7,3,14,21,60
401408621,TCU Horned Frogs,E. Miller,4432872,,True,21.0,3,7,3,6,0,1,4,4,3,4,7,1,0,0,1,5,10
401408621,TCU Horned Frogs,C. O'Bannon Jr.,4278533,,True,39.0,7,18,2,5,5,13,4,5,3,2,5,1,4,0,0,2,23
401408621,TCU Horned Frogs,E. Lampkin,4433191,,True,36.0,8,9,8,9,0,0,4,10,10,4,14,0,0,2,1,4,20
401408621,TCU Horned Frogs,M. Miles,4432550,,True,37.0,5,20,4,14,1,6,9,9,0,2,2,3,1,1,6,4,20
401408621,TCU Horned Frogs,D. Baugh,4431766,,True,41.0,3,17,3,13,0,4,0,0,1,8,9,6,2,0,2,1,6
401408621,TCU Horned Frogs,X. Cork,4593722,,False,10.0,0,0,0,0,0,0,0,0,0,1,1,1,1,0,1,0,0
401408621,TCU Horned Frogs,J. Coles,4432282,,False,3.0,0,0,0,0,0,0,0,0,0,0,0,1,2,0,0,0,0
401408621,TCU Horned Frogs,M. Peavy,4432185,,False,24.0,0,1,0,1,0,0,1,2,1,2,3,0,1,0,2,5,1
401408621,TCU Horned Frogs,F. Farabello,4431952,,False,14.0,0,2,0,0,0,2,0,0,0,2,2,0,0,0,1,1,0
401408621,TCU Horned Frogs,TEAM,TOTAL,TOTAL,False,,26,74,20,48,6,26,22,30,20,28,48,13,11,3,14,22,80
401408621,Arizona Wildcats,A. Tubelis,4702372,,True,16.0,2,7,2,7,0,0,1,1,2,2,4,1,0,0,3,1,5
401408621,Arizona Wildcats,C. Koloko,4431778,,True,40.0,12,13,12,13,0,0,4,7,7,5,12,2,1,3,2,2,28
401408621,Arizona Wildcats,B. Mathurin,4683634,,True,41.0,8,19,5,8,3,11,11,13,3,5,8,4,2,0,3,2,30
401408621,Arizona Wildcats,D. Terry,4433159,,True,42.0,2,8,1,6,1,2,0,0,0,4,4,5,5,0,0,4,5
401408621,Arizona Wildcats,J. Kier,4066863,,True,14.0,3,5,3,4,0,1,0,1,0,2,2,0,0,0,3,2,6
401408621,Arizona Wildcats,O. Ballo,4594109,,False,15.0,1,1,1,1,0,0,0,1,0,4,4,2,0,1,1,4,2
401408621,Arizona Wildcats,K. Kriisa,4683633,,False,27.0,1,10,0,0,1,10,0,0,1,1,2,1,0,0,2,3,3
401408621,Arizona Wildcats,P. Larsson,4601025,,False,30.0,2,5,2,2,0,3,2,2,1,5,6,1,2,0,2,3,6
401408621,Arizona Wildcats,TEAM,TOTAL,TOTAL,False,,31,68,26,41,5,27,18,25,14,30,44,16,10,4,16,21,85
401408620,Texas Tech Red Raiders,K. Obanor,4398304,,True,32.0,6,13,5,9,1,4,2,3,7,8,15,1,0,1,2,2,15
401408620,Texas Tech Red Raiders,B. Williams,4066678,,True,23.0,6,14,6,10,0,4,2,2,0,3,3,1,2,0,1,4,14
401408620,Texas Tech Red Raiders,K. McCullar,4411057,,True,33.0,4,9,3,7,1,2,5,6,1,1,2,1,2,0,2,5,14
401408620,Texas Tech Red Raiders,T. Shannon Jr.,4432847,,True,18.0,1,4,0,1,1,3,0,2,0,1,1,0,1,0,1,1,3
401408620,Texas Tech Red Raiders,A. Arms,4406489,,True,28.0,1,5,0,4,1,1,2,2,1,6,7,4,0,1,1,0,5
401408620,Texas Tech Red Raiders,D. Batcho,4683631,,False,4.0,0,0,0,0,0,0,0,0,0,1,1,0,0,0,0,0,0
401408620,Texas Tech Red Raiders,M. Santos-Silva,4278420,,False,17.0,1,4,1,4,0,0,2,2,1,4,5,1,0,2,1,1,4
401408620,Texas Tech Red Raiders,D. Warren,4592666,,False,26.0,1,8,1,7,0,1,0,0,0,3,3,2,1,0,0,3,2
401408620,Texas Tech Red Raiders,M. Wilson,4432902,,False,10.0,0,1,0,1,0,0,0,0,0,0,0,0,1,0,0,0,0
401408620,Texas Tech Red Raiders,C. Nadolny,4431841,,False,9.0,1,1,1,1,0,0,0,0,0,0,0,0,1,0,0,0,2
401408620,Texas Tech Red Raiders,TEAM,TOTAL,TOTAL,False,,21,59,17,44,4,15,13,17,12,30,42,10,8,4,8,16,59
401408620,Notre Dame Fighting Irish,P. Atkinson Jr.,4279699,,True,22.0,1,4,1,4,0,0,3,4,1,3,4,1,0,2,1,2,5
401408620,Notre Dame Fighting Irish,B. Wesley,4683935,,True,32.0,3,14,3,10,0,4,5,6,2,6,8,3,1,0,3,0,11
401408620,Notre Dame Fighting Irish,C. Ryan,4397114,,True,34.0,3,8,1,2,2,6,1,3,1,3,4,0,0,0,2,4,9
401408620,Notre Dame Fighting Irish,D. Goodwin,4395667,,True,32.0,5,8,2,3,3,5,1,2,2,6,8,0,0,0,2,3,14
401408620,Notre Dame Fighting Irish,P. Hubb,4395664,,True,35.0,2,7,1,3,1,4,0,0,1,3,4,3,1,0,2,2,5
401408620,Notre Dame Fighting Irish,N. Laszewski,4395665,,False,25.0,1,6,0,1,1,5,0,0,0,5,5,0,0,0,0,1,3
401408620,Notre Dame Fighting Irish,T. Wertz,4397753,,False,20.0,2,5,0,1,2,4,0,0,0,1,1,1,1,0,1,1,6
401408620,Notre Dame Fighting Irish,TEAM,TOTAL,TOTAL,False,,17,52,8,24,9,28,10,15,8,28,36,8,3,2,11,13,53
401408619,Villanova Wildcats,E. Dixon,4431718,,True,32.0,5,9,3,7,2,2,1,2,5,3,8,1,1,1,2,3,13
401408619,Villanova Wildcats,B. Slater,4397133,,True,21.0,0,2,0,2,0,0,0,0,0,0,0,1,2,0,2,4,0
401408619,Villanova Wildcats,J. Samuels,4278588,,True,38.0,7,9,6,7,1,2,2,3,2,6,8,0,2,0,2,0,17
401408619,Villanova Wildcats,J. Moore,4592491,,True,29.0,3,9,1,3,2,6,0,0,0,1,1,2,0,0,2,2,8
401408619,Villanova Wildcats,C. Gillespie,4278585,,True,38.0,5,14,3,5,2,9,8,8,0,1,1,4,1,0,1,1,20
401408619,Villanova Wildcats,C. Arcidiacono,4592490,,False,3.0,0,0,0,0,0,0,2,2,0,0,0,0,1,0,0,0,2
401408619,Villanova Wildcats,B. Antoine,4432814,,False,5.0,0,0,0,0,0,0,0,0,0,0,0,0,0,0,0,0,0
401408619,Villanova Wildcats,C. Daniels,4278373,,False,34.0,3,9,2,5,1,4,4,5,2,6,8,1,0,0,0,4,11
401408619,Villanova Wildcats,TEAM,TOTAL,TOTAL,False,,23,52,15,29,8,23,17,20,11,20,31,9,7,1,9,14,71
401408619,Ohio State Buckeyes,E.J. Liddell,4432821,,True,35.0,6,13,4,9,2,4,3,5,1,5,6,3,3,2,3,4,17
401408619,Ohio State Buckeyes,K. Young,4277974,,True,28.0,3,9,3,6,0,3,0,0,3,3,6,0,0,1,2,0,6
401408619,Ohio State Buckeyes,E. Brown III,4433179,,True,25.0,2,4,2,3,0,1,1,2,0,1,1,0,0,0,1,4,5
401408619,Ohio State Buckeyes,M. Branham,4565201,,True,39.0,10,19,7,11,3,8,0,0,0,2,2,4,0,0,4,2,23
401408619,Ohio State Buckeyes,J. Wheeler,4277978,,True,32.0,1,4,0,1,1,3,0,0,1,4,5,3,1,0,0,2,3
401408619,Ohio State Buckeyes,Z. Key,4432401,,False,17.0,1,5,1,5,0,0,2,4,7,4,11,0,0,0,2,3,4
401408619,Ohio State Buckeyes,J. Ahrens,4397236,,False,4.0,0,0,0,0,0,0,0,0,0,0,0,0,0,0,0,0,0
401408619,Ohio State Buckeyes,M. Johnson Jr.,4710770,,False,16.0,1,2,0,0,1,2,0,0,1,1,2,1,0,0,0,3,3
401408619,Ohio State Buckeyes,C. Russell,4280257,,False,4.0,0,1,0,0,0,1,0,0,0,0,0,0,0,0,0,0,0
401408619,Ohio State Buckeyes,TEAM,TOTAL,TOTAL,False,,24,57,17,35,7,22,6,11,15,20,35,11,4,3,12,18,61
401408618,Illinois Fighting Illini,K. Cockburn,4432828,,True,38.0,6,11,6,11,0,0,7,7,3,5,8,0,2,1,3,2,19
401408618,Illinois Fighting Illini,C. Hawkins,4432976,,True,19.0,1,5,0,1,1,4,0,0,0,4,4,1,0,0,1,3,3
401408618,Illinois Fighting Illini,A. Plummer,4592434,,True,31.0,2,10,0,3,2,7,2,3,0,2,2,1,2,0,1,2,8
401408618,Illinois Fighting Illini,D. Williams,4277940,,True,20.0,0,1,0,0,0,1,0,0,1,2,3,1,1,0,3,3,0
401408618,Illinois Fighting Illini,T. Frazier,4277936,,True,37.0,2,7,1,1,1,6,3,5,0,3,3,4,1,0,2,2,8
401408618,Illinois Fighting Illini,B. Bosmans-Verdonk,4592607,,False,2.0,0,0,0,0,0,0,0,0,0,0,0,0,0,0,0,0,0
401408618,Illinois Fighting Illini,L. Goode,4683743,,False,19.0,2,7,0,2,2,5,0,0,2,3,5,0,0,1,2,2,6
401408618,Illinois Fighting Illini,R. Melendez,4683738,,False,20.0,4,5,4,5,0,0,1,1,0,2,2,3,0,0,0,0,9
401408618,Illinois Fighting Illini,A. Curbelo,4432195,,False,10.0,0,4,0,2,0,2,0,0,0,0,0,1,0,0,2,1,0
401408618,Illinois Fighting Illini,J. Grandison,4280073,,False,4.0,0,0,0,0,0,0,0,0,0,0,0,0,0,0,1,0,0
401408618,Illinois Fighting Illini,TEAM,TOTAL,TOTAL,False,,17,50,11,25,6,25,13,16,11,22,33,11,6,2,17,15,53
401408618,Houston Cougars,F. White Jr.,4278263,,True,27.0,1,8,0,3,1,5,3,4,3,4,7,2,0,0,1,1,6
401408618,Houston Cougars,J. Carlton,4278229,,True,20.0,3,5,3,5,0,0,1,1,3,3,6,0,0,1,1,4,7
401408618,Houston Cougars,J. Shead,4432241,,True,37.0,7,13,6,11,1,2,3,3,1,0,1,3,3,0,3,3,18
401408618,Houston Cougars,K. Edwards,4397081,,True,38.0,5,16,1,4,4,12,1,2,0,6,6,4,2,0,1,2,15
401408618,Houston Cougars,T. Moore,4066808,,True,33.0,9,16,9,13,0,3,3,5,3,4,7,1,2,1,2,0,21
401408618,Houston Cougars,J. Roberts,4433068,,False,13.0,0,1,0,1,0,0,0,0,2,3,5,0,0,2,0,1,0
401408618,Houston Cougars,R. Chaney,4395708,,False,20.0,0,0,0,0,0,0,1,2,3,3,6,0,1,2,0,4,1
401408618,Houston Cougars,R. Walker,4708176,,False,12.0,0,0,0,0,0,0,0,0,0,0,0,0,0,0,0,1,0
401408618,Houston Cougars,TEAM,TOTAL,TOTAL,False,,25,59,19,37,6,22,12,17,15,24,39,10,8,6,9,16,68
401408617,Wisconsin Badgers,S. Crowl,4588201,,True,25.0,1,4,1,1,0,3,0,0,0,1,1,1,0,0,2,3,2
401408617,Wisconsin Badgers,T. Wahl,4433105,,True,24.0,3,6,3,6,0,0,2,3,2,6,8,0,0,0,3,4,8
401408617,Wisconsin Badgers,C. Hepburn,4590360,,True,14.0,0,3,0,1,0,2,0,0,0,2,2,0,0,0,2,0,0
401408617,Wisconsin Badgers,Joh. Davis,4432356,,True,38.0,4,16,4,9,0,7,9,11,1,8,9,1,2,4,4,3,17
401408617,Wisconsin Badgers,B. Davison,4277993,,True,37.0,3,7,2,4,1,3,5,7,0,4,4,4,4,0,2,4,12
401408617,Wisconsin Badgers,C. Gilmore,4702534,,False,1.0,0,0,0,0,0,0,0,0,0,0,0,0,0,0,0,0,0
401408617,Wisconsin Badgers,B. Carlson,4433166,,False,12.0,0,1,0,0,0,1,2,2,0,0,0,0,0,0,0,0,2
401408617,Wisconsin Badgers,C. Vogt,4279252,,False,14.0,2,2,2,2,0,0,0,0,1,2,3,0,0,2,2,0,4
401408617,Wisconsin Badgers,I. Lindsey,4703389,,False,2.0,0,1,0,0,0,1,0,0,0,0,0,0,0,0,0,0,0
401408617,Wisconsin Badgers,Jor. Davis,4433242,,False,11.0,1,4,0,1,1,3,0,0,2,0,2,0,0,1,0,4,3
401408617,Wisconsin Badgers,J. Neath,4432066,,False,22.0,0,3,0,1,0,2,1,2,0,4,4,1,0,0,1,0,1
401408617,Wisconsin Badgers,TEAM,TOTAL,TOTAL,False,,14,47,12,25,2,22,19,25,7,29,36,7,6,7,17,18,49
401408617,Iowa State Cyclones,R. Jones,4593702,,True,16.0,1,2,1,2,0,0,0,2,1,1,2,1,0,0,1,3,2
401408617,Iowa State Cyclones,A. Kunc,4397167,,True,29.0,1,4,0,1,1,3,4,5,0,6,6,1,1,2,0,4,7
401408617,Iowa State Cyclones,T. Hunter,4683751,,True,34.0,1,10,1,7,0,3,2,2,0,6,6,5,3,0,3,1,4
401408617,Iowa State Cyclones,G. Kalscheur,4397214,,True,34.0,10,19,9,15,1,4,1,3,3,1,4,1,2,0,1,4,22
401408617,Iowa State Cyclones,I. Brockington,4278412,,True,31.0,4,15,4,14,0,1,2,2,0,2,2,0,2,1,4,3,10
401408617,Iowa State Cyclones,G. Conditt IV,4396989,,False,22.0,1,4,1,4,0,0,2,2,3,3,6,3,0,0,3,4,4
401408617,Iowa State Cyclones,T. Enaruna,4431734,,False,8.0,0,0,0,0,0,0,0,0,0,4,4,0,0,0,0,1,0
401408617,Iowa State Cyclones,T. Jackson,4431999,,False,6.0,0,0,0,0,0,0,0,0,0,0,0,0,0,0,1,2,0
401408617,Iowa State Cyclones,C. Grill,4431973,,False,20.0,2,4,1,1,1,3,0,0,0,2,2,1,1,0,0,3,5
401408617,Iowa State Cyclones,TEAM,TOTAL,TOTAL,False,,20,58,17,44,3,14,11,16,11,28,39,12,9,3,14,25,54
401408616,Texas Longhorns,T. Allen,4397148,,True,18.0,1,6,1,6,0,0,0,0,1,1,2,1,0,0,0,5,2
401408616,Texas Longhorns,C. Bishop,4397037,,True,23.0,5,8,5,8,0,0,0,0,2,5,7,0,0,1,1,5,10
401408616,Texas Longhorns,C. Ramey,4334018,,True,32.0,3,11,2,7,1,4,0,0,1,3,4,3,3,0,1,3,7
401408616,Texas Longhorns,M. Carr,4278014,,True,37.0,8,18,4,10,4,8,3,5,0,0,0,7,0,0,2,3,23
401408616,Texas Longhorns,A. Jones,4066325,,True,35.0,6,13,4,6,2,7,3,4,0,2,2,1,2,0,2,4,17
401408616,Texas Longhorns,B. Cunningham,4397079,,False,16.0,1,3,0,0,1,3,0,0,3,2,5,2,0,0,0,2,3
401408616,Texas Longhorns,D. Disu,4432866,,False,9.0,1,3,1,3,0,0,0,1,3,1,4,1,0,2,0,3,2
401408616,Texas Longhorns,D. Askew,4702467,,False,8.0,0,0,0,0,0,0,0,0,0,0,0,1,0,0,1,1,0
401408616,Texas Longhorns,J. Febres,4277921,,False,22.0,2,6,0,0,2,6,1,2,1,2,3,0,0,0,0,3,7
401408616,Texas Longhorns,TEAM,TOTAL,TOTAL,False,,27,68,17,40,10,28,7,12,11,17,28,16,5,3,7,29,71
401408616,Purdue Boilermakers,M. Gillis,4431753,,True,20.0,1,2,1,1,0,1,0,0,1,6,7,2,0,0,1,0,2
401408616,Purdue Boilermakers,Z. Edey,4600663,,True,15.0,2,6,2,6,0,0,7,12,5,5,10,0,0,0,1,3,11
401408616,Purdue Boilermakers,J. Ivey,4433218,,True,38.0,4,7,2,3,2,4,8,9,0,3,3,3,0,1,3,1,18
401408616,Purdue Boilermakers,E. Hunter Jr.,4397243,,True,36.0,1,7,0,2,1,5,8,9,1,2,3,3,1,0,2,3,11
401408616,Purdue Boilermakers,S. Stefanovic,4277985,,True,28.0,0,4,0,0,0,4,4,5,0,5,5,0,0,1,0,0,4
401408616,Purdue Boilermakers,C. Furst,4433598,,False,9.0,1,2,0,1,1,1,1,2,0,0,0,0,0,0,0,1,4
401408616,Purdue Boilermakers,T. Williams,4397246,,False,24.0,10,13,10,13,0,0,2,4,1,6,7,2,0,0,4,3,22
401408616,Purdue Boilermakers,B. Newman,4592726,,False,4.0,0,0,0,0,0,0,0,0,0,0,0,0,1,0,0,1,0
401408616,Purdue Boilermakers,E. Morton,4433151,,False,22.0,2,2,0,0,2,2,2,3,0,2,2,0,0,2,1,2,8
401408616,Purdue Boilermakers,I. Thompson,4431749,,False,4.0,0,0,0,0,0,0,1,2,0,2,2,0,1,0,0,2,1
401408616,Purdue Boilermakers,TEAM,TOTAL,TOTAL,False,,21,43,15,26,6,17,33,46,9,32,41,10,3,4,12,16,81
401408615,Miami Hurricanes,S. Waardenburg,4079701,,True,35.0,3,4,2,2,1,2,0,0,0,5,5,1,0,2,0,1,7
401408615,Miami Hurricanes,I. Wong,4431727,,True,36.0,8,18,8,17,0,1,5,5,0,6,6,2,1,0,0,0,21
401408615,Miami Hurricanes,J. Miller,4396818,,True,34.0,5,13,5,10,0,3,2,2,1,2,3,2,2,2,1,2,12
401408615,Miami Hurricanes,C. Moore,4066345,,True,36.0,4,8,2,5,2,3,5,7,1,8,9,8,3,0,2,2,15
401408615,Miami Hurricanes,K. McGusty,4066310,,True,38.0,10,18,10,13,0,5,0,1,2,4,6,4,4,1,1,1,20
401408615,Miami Hurricanes,A. Walker,4592205,,False,10.0,2,4,2,3,0,1,0,0,0,1,1,0,0,0,0,2,4
401408615,Miami Hurricanes,D. Gak,4277891,,False,0.0,0,0,0,0,0,0,0,0,0,0,0,0,0,1,0,0,0
401408615,Miami Hurricanes,R. Miller Jr.,4065671,,False,0.0,0,0,0,0,0,0,0,0,0,0,0,0,0,0,0,0,0
401408615,Miami Hurricanes,W. Poplar,4897397,,False,7.0,0,1,0,1,0,0,0,0,0,2,2,2,0,0,0,3,0
401408615,Miami Hurricanes,B. Joseph,4683753,,False,4.0,0,0,0,0,0,0,0,0,0,2,2,0,0,0,0,0,0
401408615,Miami Hurricanes,F. Gkogkos,4592206,,False,0.0,0,0,0,0,0,0,0,0,0,0,0,0,0,0,0,0,0
401408615,Miami Hurricanes,TEAM,TOTAL,TOTAL,False,,32,66,29,51,3,15,12,15,6,33,39,19,10,6,4,11,79
401408615,Auburn Tigers,J. Smith,4432639,,True,35.0,3,16,2,8,1,8,3,6,4,11,15,4,0,3,2,4,10
401408615,Auburn Tigers,W. Kessler,4433136,,True,13.0,0,6,0,6,0,0,2,2,2,0,2,0,0,2,1,2,2
401408615,Auburn Tigers,A. Flanigan,4432874,,True,28.0,2,7,2,7,0,0,1,1,3,5,8,1,0,0,2,2,5
401408615,Auburn Tigers,K. Johnson,4432363,,True,34.0,4,10,3,4,1,6,3,4,0,3,3,1,1,1,4,2,12
401408615,Auburn Tigers,Z. Jasper,4311618,,True,17.0,1,4,1,2,0,2,2,2,1,0,1,0,0,0,1,0,4
401408615,Auburn Tigers,C. Moore,4433200,,False,0.0,0,0,0,0,0,0,0,0,0,0,0,0,0,0,0,0,0
401408615,Auburn Tigers,J. Williams,4431776,,False,18.0,5,8,3,5,2,3,0,0,2,2,4,0,0,0,0,5,12
401408615,Auburn Tigers,D. Cambridge,4567588,,False,14.0,2,3,2,2,0,1,1,2,1,3,4,0,0,0,0,1,5
401408615,Auburn Tigers,D. Cardwell,4433174,,False,12.0,0,0,0,0,0,0,0,0,0,1,1,0,0,2,0,0,0
401408615,Auburn Tigers,L. Berman,4592748,,False,0.0,0,0,0,0,0,0,0,0,0,0,0,0,0,0,0,0,0
401408615,Auburn Tigers,W. Green Jr.,4433198,,False,29.0,4,14,3,8,1,6,2,2,1,4,5,5,0,0,3,3,11
401408615,Auburn Tigers,P. Cook,4403230,,False,0.0,0,1,0,1,0,0,0,0,0,0,0,0,0,0,0,0,0
401408615,Auburn Tigers,TEAM,TOTAL,TOTAL,False,,21,69,16,43,5,26,14,19,17,30,47,11,1,8,13,19,61
401408614,Michigan State Spartans,M. Bingham Jr.,4397212,,True,27.0,5,12,3,9,2,3,4,4,6,4,10,0,2,3,0,4,16
401408614,Michigan State Spartans,G. Brown,4397210,,True,36.0,7,11,3,5,4,6,0,0,1,1,2,0,0,1,0,2,18
401408614,Michigan State Spartans,J. Hauser,4295180,,True,25.0,1,5,0,1,1,4,2,2,1,5,6,3,0,0,1,2,5
401408614,Michigan State Spartans,M. Christie,4432582,,True,24.0,4,8,3,6,1,2,0,0,2,1,3,2,0,0,2,3,9
401408614,Michigan State Spartans,A. Hoggard,4432206,,True,19.0,3,8,3,8,0,0,2,2,0,3,3,4,0,1,2,4,8
401408614,Michigan State Spartans,M. Hall,4592693,,False,15.0,0,3,0,2,0,1,0,0,0,3,3,1,0,0,1,1,0
401408614,Michigan State Spartans,J. Marble II,4433031,,False,13.0,2,9,2,9,0,0,0,0,2,0,2,0,0,0,0,2,4
401408614,Michigan State Spartans,P. Brooks,4683731,,False,1.0,0,0,0,0,0,0,0,0,0,0,0,0,0,0,0,0,0
401408614,Michigan State Spartans,J. Akins,4683730,,False,15.0,1,1,0,0,1,1,0,0,0,1,1,0,0,0,0,1,3
401408614,Michigan State Spartans,T. Walker,4432129,,False,25.0,4,8,2,3,2,5,3,4,0,1,1,5,1,0,1,0,13
401408614,Michigan State Spartans,TEAM,TOTAL,TOTAL,False,,27,65,16,43,11,22,11,12,12,19,31,15,3,5,7,19,76
401408614,Duke Blue Devils,P. Banchero,4432573,,True,38.0,8,14,6,9,2,5,1,3,1,6,7,4,0,1,5,3,19
401408614,Duke Blue Devils,W. Moore Jr.,4592187,,True,36.0,3,6,3,6,0,0,9,10,0,2,2,4,2,0,1,2,15
401408614,Duke Blue Devils,M. Williams,4701232,,True,30.0,7,9,7,9,0,0,1,2,2,6,8,0,2,5,1,2,15
401408614,Duke Blue Devils,AJ Griffin,4432585,,True,23.0,3,7,2,4,1,3,0,0,1,2,3,2,0,0,0,0,7
401408614,Duke Blue Devils,J. Roach,4433135,,True,37.0,6,10,5,7,1,3,2,2,0,2,2,3,1,0,2,2,15
401408614,Duke Blue Devils,T. John,4278569,,False,10.0,1,2,1,2,0,0,0,0,1,1,2,0,0,0,0,2,2
401408614,Duke Blue Devils,B. Jones,4278348,,False,1.0,0,0,0,0,0,0,0,0,0,0,0,0,0,0,0,0,0
401408614,Duke Blue Devils,T. Keels,4432645,,False,25.0,4,8,3,6,1,2,3,4,2,2,4,1,0,0,1,1,12
401408614,Duke Blue Devils,TEAM,TOTAL,TOTAL,False,,32,56,27,43,5,13,16,21,10,25,35,14,5,6,10,12,85
401408613,Memphis Tigers,D. Williams,4397355,,True,29.0,7,13,7,10,0,3,0,0,2,5,7,1,1,0,0,4,14
401408613,Memphis Tigers,J. Duren,4433621,,True,19.0,3,11,3,11,0,0,1,2,4,3,7,2,0,1,1,4,7
401408613,Memphis Tigers,L. Quinones,4431720,,True,28.0,4,8,2,3,2,5,0,1,1,4,5,0,0,0,0,3,10
401408613,Memphis Tigers,A. Lomax,4396633,,True,27.0,4,7,4,7,0,0,1,2,1,2,3,5,0,0,1,2,9
401408613,Memphis Tigers,L. Nolley II,4395684,,True,23.0,1,6,1,5,0,1,5,6,1,3,4,1,1,0,2,4,7
401408613,Memphis Tigers,M. Dandridge,4431738,,False,24.0,4,5,4,5,0,0,0,1,0,5,5,0,0,0,0,3,8
401408613,Memphis Tigers,J. Minott,4687718,,False,8.0,2,2,2,2,0,0,0,0,2,2,4,0,0,0,0,2,4
401408613,Memphis Tigers,E. Bates,4433620,,False,12.0,2,7,1,2,1,5,0,0,0,1,1,0,0,0,0,0,5
401408613,Memphis Tigers,E. Timberlake,4432193,,False,7.0,0,1,0,1,0,0,1,2,0,0,0,0,0,1,0,0,1
401408613,Memphis Tigers,T. Harris,4396632,,False,23.0,3,10,2,5,1,5,6,6,1,0,1,3,0,0,1,1,13
401408613,Memphis Tigers,TEAM,TOTAL,TOTAL,False,,30,70,26,51,4,19,14,20,14,26,40,12,2,2,5,23,78
401408613,Gonzaga Bulldogs,D. Timme,4431695,,True,36.0,10,16,9,15,1,1,4,8,3,11,14,4,0,0,0,2,25
401408613,Gonzaga Bulldogs,C. Holmgren,4433255,,True,30.0,4,7,4,4,0,3,1,3,3,6,9,2,0,4,2,5,9
401408613,Gonzaga Bulldogs,J. Strawther,4432181,,True,33.0,3,11,3,5,0,6,0,2,3,4,7,2,0,0,0,2,6
401408613,Gonzaga Bulldogs,R. Bolton,4397242,,True,33.0,6,9,3,3,3,6,2,2,0,2,2,2,0,0,0,2,17
401408613,Gonzaga Bulldogs,A. Nembhard,4395712,,True,40.0,6,12,1,2,5,10,6,7,0,1,1,5,0,0,3,2,23
401408613,Gonzaga Bulldogs,A. Watson,4431705,,False,14.0,0,2,0,1,0,1,0,2,1,3,4,3,1,0,0,0,0
401408613,Gonzaga Bulldogs,N. Hickman,4683737,,False,11.0,1,1,1,1,0,0,0,0,0,0,0,0,1,0,0,1,2
401408613,Gonzaga Bulldogs,H. Sallis,4433281,,False,3.0,0,0,0,0,0,0,0,0,0,0,0,0,0,0,0,1,0
401408613,Gonzaga Bulldogs,TEAM,TOTAL,TOTAL,False,,30,58,21,31,9,27,13,24,10,28,38,18,2,4,7,16,82
401408612,UCLA Bruins,C. Riley,4278525,,True,28.0,3,4,2,3,1,1,2,3,1,4,5,1,1,0,0,2,9
401408612,UCLA Bruins,J. Jaquez Jr.,4432848,,True,30.0,6,11,6,11,0,0,3,4,0,1,1,2,0,0,3,2,15
401408612,UCLA Bruins,J. Juzang,4432817,,True,38.0,6,11,6,10,0,1,2,2,0,8,8,2,0,0,1,2,14
401408612,UCLA Bruins,T. Campbell,4397128,,True,32.0,4,8,4,7,0,1,8,8,1,2,3,4,0,0,1,3,16
401408612,UCLA Bruins,J. Bernard,4397127,,True,31.0,5,9,2,4,3,5,1,2,1,4,5,4,1,0,0,1,14
401408612,UCLA Bruins,M. Johnson,4277987,,False,12.0,0,0,0,0,0,0,0,0,0,0,0,0,0,0,0,1,0
401408612,UCLA Bruins,P. Watson,4576087,,False,10.0,1,1,1,1,0,0,0,0,0,1,1,0,1,0,0,1,2
401408612,UCLA Bruins,J. Clark,4432247,,False,11.0,1,1,1,1,0,0,0,0,1,0,1,0,0,0,0,0,2
401408612,UCLA Bruins,R. Stong,4405598,,False,0.0,0,0,0,0,0,0,0,0,0,0,0,0,0,0,0,0,0
401408612,UCLA Bruins,D. Singleton,4397131,,False,8.0,0,1,0,0,0,1,0,0,0,0,0,1,0,0,0,0,0
401408612,UCLA Bruins,TEAM,TOTAL,TOTAL,False,,26,46,22,37,4,9,16,19,4,23,27,14,3,0,6,12,72
401408612,Saint Mary's Gaels,K. Bowen,4431902,,True,33.0,1,2,1,2,0,0,0,0,0,0,0,0,1,1,0,3,2
401408612,Saint Mary's Gaels,M. Tass,4397724,,True,35.0,4,5,4,5,0,0,6,7,2,5,7,3,0,0,3,2,14
401408612,Saint Mary's Gaels,A. Ducas,4432971,,True,37.0,4,12,1,3,3,9,0,0,1,4,5,0,1,0,1,2,11
401408612,Saint Mary's Gaels,L. Johnson,4396608,,True,39.0,6,14,3,9,3,5,3,4,0,5,5,3,0,0,1,4,18
401408612,Saint Mary's Gaels,T. Kuhse,4066735,,True,38.0,5,13,4,6,1,7,0,0,1,1,2,6,1,0,1,1,11
401408612,Saint Mary's Gaels,J. Brown,4433193,,False,0.0,0,0,0,0,0,0,0,0,0,0,0,0,0,0,0,0,0
401408612,Saint Mary's Gaels,D. Fotu,4397722,,False,7.0,0,0,0,0,0,0,0,0,0,1,1,0,0,0,2,3,0
401408612,Saint Mary's Gaels,M. Saxen,4701182,,False,4.0,0,3,0,3,0,0,0,0,4,0,4,0,0,0,0,0,0
401408612,Saint Mary's Gaels,A. Marciulionis,4897197,,False,3.0,0,0,0,0,0,0,0,0,0,0,0,0,0,0,0,1,0
401408612,Saint Mary's Gaels,L. Bockler,4701183,,False,1.0,0,0,0,0,0,0,0,0,0,0,0,0,0,0,0,0,0
401408612,Saint Mary's Gaels,J. Mullins,4701181,,False,3.0,0,0,0,0,0,0,0,1,0,0,0,0,0,0,0,0,0
401408612,Saint Mary's Gaels,TEAM,TOTAL,TOTAL,False,,20,49,13,28,7,21,9,12,8,17,25,12,3,1,9,16,56
401408611,Kansas Jayhawks,J. Wilson,4431714,,True,32.0,5,14,5,11,0,3,4,4,4,10,14,0,0,1,0,4,14
401408611,Kansas Jayhawks,D. McCormack,4397019,,True,25.0,2,8,2,8,0,0,3,3,3,3,6,1,2,2,1,2,7
401408611,Kansas Jayhawks,D. Harris,4431983,,True,18.0,1,4,0,2,1,2,2,2,1,0,1,2,0,0,0,2,5
401408611,Kansas Jayhawks,C. Braun,4431767,,True,38.0,5,9,4,7,1,2,2,2,1,7,8,4,1,1,2,1,13
401408611,Kansas Jayhawks,O. Agbaji,4397018,,True,34.0,5,14,4,11,1,3,4,5,2,6,8,3,2,1,1,4,15
401408611,Kansas Jayhawks,K.J. Adams,4433259,,False,4.0,0,1,0,1,0,0,0,0,0,0,0,0,0,0,0,0,0
401408611,Kansas Jayhawks,M. Lightfoot,4066300,,False,8.0,0,0,0,0,0,0,0,0,0,1,1,0,0,1,0,1,0
401408611,Kansas Jayhawks,J. Yesufu,4431856,,False,3.0,0,0,0,0,0,0,0,0,0,0,0,0,0,0,2,1,0
401408611,Kansas Jayhawks,R. Martin,4278133,,False,29.0,7,14,5,9,2,5,4,4,1,6,7,4,0,1,1,3,20
401408611,Kansas Jayhawks,J. Coleman-Lands,3911842,,False,9.0,2,2,1,1,1,1,0,0,1,0,1,0,0,0,0,3,5
401408611,Kansas Jayhawks,TEAM,TOTAL,TOTAL,False,,27,66,21,50,6,16,19,20,13,34,47,14,5,7,7,21,79
401408611,Creighton Bluejays,R. Hawkins,4897413,,True,40.0,5,13,2,7,3,6,1,1,1,5,6,2,0,1,1,4,14
401408611,Creighton Bluejays,A. Kaluma,4433599,,True,40.0,8,19,4,9,4,10,4,6,4,8,12,3,1,1,1,4,24
401408611,Creighton Bluejays,K. Feazell,4278099,,True,19.0,2,5,2,4,0,1,0,0,0,4,4,1,1,0,1,3,4
401408611,Creighton Bluejays,T. Alexander,4433268,,True,40.0,3,11,1,8,2,3,6,6,0,3,3,9,1,0,3,2,14
401408611,Creighton Bluejays,A. O'Connell,4277846,,True,38.0,3,9,0,1,3,8,7,8,1,1,2,3,2,1,2,0,16
401408611,Creighton Bluejays,M. Kancleris,4701556,,False,0.0,0,0,0,0,0,0,0,0,0,0,0,0,0,0,0,0,0
401408611,Creighton Bluejays,R. Andronikashvili,4701555,,False,23.0,0,2,0,2,0,0,0,0,0,1,1,0,1,0,0,3,0
401408611,Creighton Bluejays,D. Davis,4701554,,False,0.0,0,0,0,0,0,0,0,0,0,0,0,0,0,0,0,0,0
401408611,Creighton Bluejays,S. Osmani,4701553,,False,0.0,0,0,0,0,0,0,0,0,0,0,0,0,0,0,0,0,0
401408611,Creighton Bluejays,TEAM,TOTAL,TOTAL,False,,21,59,9,31,12,28,18,21,6,25,31,18,6,3,8,16,72
401408610,North Carolina Tar Heels,A. Bacot,4431674,,True,39.0,4,10,4,10,0,0,7,15,4,12,16,4,1,3,2,4,15
401408610,North Carolina Tar Heels,B. Manek,4277902,,True,28.0,8,13,4,5,4,8,6,8,2,3,5,2,0,0,0,3,26
401408610,North Carolina Tar Heels,L. Black,4395650,,True,40.0,2,3,2,3,0,0,0,0,1,4,5,6,1,1,2,3,4
401408610,North Carolina Tar Heels,R.J. Davis,4433176,,True,45.0,8,17,3,7,5,10,9,10,0,5,5,6,1,0,3,4,30
401408610,North Carolina Tar Heels,C. Love,4433144,,True,32.0,1,6,0,2,1,4,2,2,0,3,3,2,1,1,6,5,5
401408610,North Carolina Tar Heels,J. McKoy,4432058,,False,10.0,0,0,0,0,0,0,2,2,0,3,3,1,1,0,3,2,2
401408610,North Carolina Tar Heels,P. Johnson,4701846,,False,6.0,1,1,1,1,0,0,0,0,0,1,1,0,0,0,0,1,2
401408610,North Carolina Tar Heels,D. Styles,4611413,,False,25.0,4,7,3,4,1,3,0,0,0,3,3,1,2,0,2,4,9
401408610,North Carolina Tar Heels,TEAM,TOTAL,TOTAL,False,,28,57,17,32,11,25,26,37,10,37,47,22,7,5,21,26,93
401408610,Baylor Bears,F. Thamba,4395692,,True,24.0,0,1,0,1,0,0,0,0,3,2,5,0,1,1,1,5,0
401408610,Baylor Bears,M. Mayer,4395697,,True,27.0,3,8,1,3,2,5,2,2,2,1,3,0,1,0,2,5,10
401408610,Baylor Bears,K. Brown,4433254,,True,28.0,2,7,2,3,0,4,2,4,2,3,5,1,3,0,0,3,6
401408610,Baylor Bears,A. Flagler,4397654,,True,41.0,10,25,7,14,3,11,4,5,1,2,3,2,0,1,2,3,27
401408610,Baylor Bears,J. Akinjo,4397072,,True,39.0,6,20,5,13,1,7,7,8,0,4,4,5,3,1,2,5,20
401408610,Baylor Bears,J. Sochan,4610139,,False,34.0,4,14,3,9,1,5,6,8,4,7,11,3,1,1,4,3,15
401408610,Baylor Bears,J. Turner,4592207,,False,0.0,0,0,0,0,0,0,0,0,0,0,0,0,0,0,0,0,0
401408610,Baylor Bears,D. Bonner,4601289,,False,32.0,3,6,1,1,2,5,0,0,3,2,5,0,1,1,0,3,8
401408610,Baylor Bears,TEAM,TOTAL,TOTAL,False,,28,81,19,44,9,37,21,27,16,22,38,11,10,5,11,27,86
401408609,Saint Peter's Peacocks,C. Rupert,4898258,,True,16.0,3,6,3,6,0,0,1,2,1,0,1,1,1,0,0,2,7
401408609,Saint Peter's Peacocks,H. Drame,4593387,,True,24.0,3,5,3,4,0,1,2,2,3,5,8,0,1,0,1,4,8
401408609,Saint Peter's Peacocks,K. Ndefo,4398386,,True,33.0,5,10,5,9,0,1,7,9,4,6,10,3,1,6,3,1,17
401408609,Saint Peter's Peacocks,M. Lee,4593388,,True,28.0,3,8,2,5,1,3,2,2,0,3,3,4,0,0,1,2,9
401408609,Saint Peter's Peacocks,D. Banks III,4593386,,True,27.0,1,7,0,4,1,3,3,4,0,1,1,1,1,0,2,4,6
401408609,Saint Peter's Peacocks,O. Diahame,4703529,,False,1.0,0,0,0,0,0,0,0,0,0,0,0,0,0,1,0,1,0
401408609,Saint Peter's Peacocks,F. Drame,4432970,,False,20.0,0,2,0,0,0,2,2,4,1,5,6,1,1,0,0,5,2
401408609,Saint Peter's Peacocks,I. Dasher,4701199,,False,16.0,1,3,1,3,0,0,0,0,0,1,1,1,0,0,0,1,2
401408609,Saint Peter's Peacocks,J. Murray,4683865,,False,11.0,2,6,2,5,0,1,2,2,1,1,2,1,0,0,0,0,6
401408609,Saint Peter's Peacocks,D. Edert,4432977,,False,24.0,4,6,3,4,1,2,4,6,0,3,3,2,0,0,2,2,13
401408609,Saint Peter's Peacocks,TEAM,TOTAL,TOTAL,False,,22,53,19,40,3,13,23,31,13,25,38,14,5,7,10,22,70
401408609,Murray State Racers,D. Burns,4594111,,True,16.0,1,2,1,2,0,0,0,0,3,0,3,0,0,1,0,4,2
401408609,Murray State Racers,K. Williams,4398348,,True,33.0,2,9,2,6,0,3,8,10,1,2,3,1,0,0,1,4,12
401408609,Murray State Racers,J. Hill,4703264,,True,37.0,7,15,2,6,5,9,0,0,0,2,2,4,3,2,3,2,19
401408609,Murray State Racers,T. Hannibal,4593008,,True,28.0,2,4,2,4,0,0,6,7,2,6,8,1,4,0,3,3,10
401408609,Murray State Racers,T. Brown,4279886,,True,40.0,5,17,2,7,3,10,1,4,1,4,5,4,0,1,2,1,14
401408609,Murray State Racers,N. McMullen,4703266,,False,4.0,0,0,0,0,0,0,0,0,0,0,0,0,0,0,1,3,0
401408609,Murray State Racers,J. Skipper-Brown,4593465,,False,22.0,1,1,1,1,0,0,1,4,4,1,5,3,1,2,1,5,3
401408609,Murray State Racers,D. Smith,4398347,,False,20.0,0,4,0,2,0,2,0,0,0,1,1,0,0,1,0,2,0
401408609,Murray State Racers,TEAM,TOTAL,TOTAL,False,,18,52,10,28,8,24,16,25,13,18,31,13,8,7,12,24,60
401408608,Tennessee Volunteers,B. Huntley-Hatfield,4432680,,True,12.0,2,4,2,4,0,0,0,0,1,1,2,0,0,0,0,0,4
401408608,Tennessee Volunteers,U. Plavsic,4397023,,True,25.0,3,7,3,7,0,0,3,3,2,7,9,0,2,1,0,2,9
401408608,Tennessee Volunteers,S. Vescovi,4609299,,True,38.0,2,7,1,2,1,5,0,0,1,3,4,2,0,0,1,3,5
401408608,Tennessee Volunteers,K. Chandler,4432646,,True,37.0,9,19,8,16,1,3,0,0,1,3,4,9,2,0,3,3,19
401408608,Tennessee Volunteers,J. James,4431685,,True,37.0,5,13,5,7,0,6,3,4,2,4,6,3,2,1,0,3,13
401408608,Tennessee Volunteers,J. Aidoo,4684682,,False,5.0,1,4,1,4,0,0,2,2,0,1,1,0,0,0,0,1,4
401408608,Tennessee Volunteers,J. Fulkerson,4066215,,False,18.0,2,4,2,4,0,0,2,3,2,0,2,0,0,2,2,3,6
401408608,Tennessee Volunteers,Z. Zeigler,4883573,,False,23.0,4,9,4,5,0,4,0,0,0,2,2,1,1,0,0,3,8
401408608,Tennessee Volunteers,J. Mashack,4683934,,False,0.0,0,0,0,0,0,0,0,0,0,0,0,0,0,0,0,0,0
401408608,Tennessee Volunteers,V. Bailey Jr.,4278512,,False,5.0,0,0,0,0,0,0,0,0,1,0,1,0,0,0,0,0,0
401408608,Tennessee Volunteers,TEAM,TOTAL,TOTAL,False,,28,67,26,49,2,18,10,12,11,22,33,15,7,4,7,18,68
401408608,Michigan Wolverines,C. Houstan,4433623,,True,32.0,0,4,0,1,0,3,0,0,0,3,3,0,1,0,2,2,0
401408608,Michigan Wolverines,M. Diabate,4433249,,True,28.0,5,10,5,10,0,0,3,5,2,4,6,1,0,3,1,1,13
401408608,Michigan Wolverines,H. Dickinson,4432180,,True,38.0,8,13,5,8,3,5,8,10,1,10,11,4,1,1,2,2,27
401408608,Michigan Wolverines,D. Jones,4397506,,True,11.0,1,3,1,3,0,0,0,0,0,3,3,3,0,1,2,1,2
401408608,Michigan Wolverines,E. Brooks,4277960,,True,39.0,9,14,7,9,2,5,3,3,1,2,3,5,1,1,4,1,23
401408608,Michigan Wolverines,T. Williams II,4702236,,False,14.0,3,5,2,3,1,2,2,2,2,1,3,0,0,0,1,1,9
401408608,Michigan Wolverines,B. Johns Jr.,4397206,,False,8.0,0,1,0,1,0,0,0,0,0,0,0,0,1,0,0,1,0
401408608,Michigan Wolverines,F. Collins,4433616,,False,30.0,1,4,1,3,0,1,0,0,0,4,4,2,0,0,2,3,2
401408608,Michigan Wolverines,TEAM,TOTAL,TOTAL,False,,27,54,21,38,6,16,16,20,7,29,36,15,4,6,15,12,76
401408607,Richmond Spiders,T. Burton,4431914,,True,34.0,1,8,0,3,1,5,2,6,1,5,6,0,2,1,1,2,5
401408607,Richmond Spiders,N. Cayo,4278380,,True,32.0,9,11,9,11,0,0,0,4,2,3,5,1,0,1,2,4,18
401408607,Richmond Spiders,G. Golden,4066836,,True,27.0,4,8,4,7,0,1,2,3,0,5,5,5,0,1,1,1,10
401408607,Richmond Spiders,A. Gustavson,4397193,,True,30.0,2,3,2,2,0,1,1,2,1,1,2,0,0,0,0,0,5
401408607,Richmond Spiders,J. Gilyard,4278378,,True,39.0,2,10,2,3,0,7,0,0,0,3,3,3,0,1,0,3,4
401408607,Richmond Spiders,M. Grace,4397192,,False,15.0,1,6,1,2,0,4,2,2,1,0,1,0,0,0,0,1,4
401408607,Richmond Spiders,S. Koureissi,4397190,,False,1.0,0,0,0,0,0,0,0,2,0,0,0,0,0,0,0,0,0
401408607,Richmond Spiders,S. Kulju,4278383,,False,0.0,0,0,0,0,0,0,0,0,0,0,0,0,0,0,0,0,0
401408607,Richmond Spiders,M. Randolph,4710356,,False,1.0,0,1,0,0,0,1,0,0,0,0,0,0,0,0,0,0,0
401408607,Richmond Spiders,D. Bailey,4700974,,False,1.0,0,0,0,0,0,0,0,0,0,0,0,0,0,0,1,0,0
401408607,Richmond Spiders,I. Wilson,4700973,,False,7.0,0,0,0,0,0,0,0,0,0,0,0,0,0,0,0,1,0
401408607,Richmond Spiders,C. Crabtree,4396658,,False,4.0,0,0,0,0,0,0,0,0,0,0,0,0,0,0,0,1,0
401408607,Richmond Spiders,J. Gaitley,4278384,,False,0.0,0,0,0,0,0,0,0,0,0,0,0,0,0,0,0,0,0
401408607,Richmond Spiders,N. Sherod,4066832,,False,9.0,2,6,2,3,0,3,1,2,0,2,2,0,0,0,1,0,5
401408607,Richmond Spiders,TEAM,TOTAL,TOTAL,False,,21,53,20,31,1,22,8,21,8,19,27,9,2,4,6,13,51
401408607,Providence Friars,N. Horchler,4278453,,True,32.0,6,10,2,4,4,6,0,0,1,13,14,1,1,1,0,4,16
401408607,Providence Friars,J. Minaya,4278111,,True,34.0,3,4,1,1,2,3,1,2,1,2,3,2,0,0,0,4,9
401408607,Providence Friars,N. Watson,4278573,,True,19.0,5,9,5,9,0,0,0,0,1,3,4,1,0,0,1,4,10
401408607,Providence Friars,A.J. Reeves,4397109,,True,24.0,3,10,1,4,2,6,4,4,0,2,2,5,0,0,1,0,12
401408607,Providence Friars,Al Durham,4277942,,True,24.0,5,7,2,3,3,4,0,0,0,4,4,3,1,0,2,1,13
401408607,Providence Friars,K. O'Haire,4897416,,False,0.0,0,0,0,0,0,0,0,0,0,0,0,0,0,0,0,0,0
401408607,Providence Friars,Ed Croswell,4397153,,False,23.0,3,5,3,5,0,0,0,0,2,3,5,0,1,2,1,1,6
401408607,Providence Friars,L. Fonts,4897415,,False,0.0,0,0,0,0,0,0,0,0,0,0,0,0,0,0,0,0,0
401408607,Providence Friars,M. Case,4702958,,False,1.0,0,0,0,0,0,0,0,0,0,1,1,0,0,0,1,0,0
401408607,Providence Friars,A. Breed,4585590,,False,13.0,1,2,1,1,0,1,1,2,0,0,0,0,1,0,0,0,3
401408607,Providence Friars,B. Goodine,4431716,,False,1.0,0,0,0,0,0,0,0,0,0,0,0,0,0,0,0,0,0
401408607,Providence Friars,J. Bynum,4397194,,False,28.0,2,7,1,5,1,2,5,6,0,2,2,6,0,0,0,1,10
401408607,Providence Friars,A. Fonts,4278575,,False,1.0,0,0,0,0,0,0,0,0,0,0,0,0,0,0,0,0,0
401408607,Providence Friars,TEAM,TOTAL,TOTAL,False,,28,54,16,32,12,22,11,14,8,30,38,18,4,3,10,15,79
401408606,New Mexico State Aggies,W. McNair Jr.,4396012,,True,24.0,3,4,3,3,0,1,0,0,2,5,7,0,0,0,1,3,6
401408606,New Mexico State Aggies,J. McCants,4067472,,True,39.0,6,13,4,6,2,7,2,3,2,10,12,2,2,2,5,4,16
401408606,New Mexico State Aggies,C. Henry,4396010,,True,35.0,1,5,0,0,1,5,3,3,0,6,6,1,1,1,0,1,6
401408606,New Mexico State Aggies,J. Rice,4280181,,True,24.0,2,10,1,5,1,5,0,0,0,0,0,0,0,1,4,2,5
401408606,New Mexico State Aggies,T. Allen,4277932,,True,39.0,5,16,3,10,2,6,0,0,0,4,4,0,1,0,3,2,12
401408606,New Mexico State Aggies,M. Peake,4572450,,False,6.0,0,1,0,0,0,1,0,0,0,1,1,0,0,0,0,0,0
401408606,New Mexico State Aggies,Y. Alok,4397070,,False,6.0,0,1,0,0,0,1,1,2,0,1,1,0,0,0,0,0,1
401408606,New Mexico State Aggies,L. Williams,4896931,,False,0.0,0,0,0,0,0,0,0,0,0,0,0,0,0,0,0,0,0
401408606,New Mexico State Aggies,C. Crawford,4896930,,False,0.0,0,0,0,0,0,0,0,0,0,0,0,0,0,0,0,0,0
401408606,New Mexico State Aggies,M. McKinney Jr.,4896928,,False,12.0,0,1,0,1,0,0,0,0,0,3,3,1,0,0,3,3,0
401408606,New Mexico State Aggies,N. Pryor,4702460,,False,15.0,1,2,1,2,0,0,0,2,0,2,2,4,0,0,1,0,2
401408606,New Mexico State Aggies,V. Cotton,4279307,,False,0.0,0,0,0,0,0,0,0,0,0,0,0,0,0,0,0,0,0
401408606,New Mexico State Aggies,TEAM,TOTAL,TOTAL,False,,18,53,12,27,6,26,6,10,5,36,41,8,4,4,19,15,48
401408606,Arkansas Razorbacks,J. Williams,4432823,,True,40.0,3,10,3,9,0,1,4,4,2,13,15,3,1,0,0,1,10
401408606,Arkansas Razorbacks,T. Wade,4279111,,True,6.0,0,1,0,0,0,1,0,0,0,1,1,0,1,0,0,0,0
401408606,Arkansas Razorbacks,A. Toney,4395671,,True,40.0,3,5,3,3,0,2,1,3,0,2,2,0,0,1,2,3,7
401408606,Arkansas Razorbacks,S. Umude,4279532,,True,40.0,3,10,1,2,2,8,1,1,0,8,8,3,1,0,1,4,9
401408606,Arkansas Razorbacks,JD Notae,4278435,,True,31.0,5,18,4,15,1,3,7,8,0,4,4,3,8,0,6,5,18
401408606,Arkansas Razorbacks,L. Blake,4896388,,False,0.0,0,0,0,0,0,0,0,0,0,0,0,0,0,0,0,0,0
401408606,Arkansas Razorbacks,C. Arbogast,4896387,,False,0.0,0,0,0,0,0,0,0,0,0,0,0,0,0,0,0,0,0
401408606,Arkansas Razorbacks,C. Moore,4433596,,False,0.0,0,0,0,0,0,0,0,0,0,0,0,0,0,0,0,0,0
401408606,Arkansas Razorbacks,D. Davis,4432197,,False,34.0,0,6,0,5,0,1,2,2,1,2,3,1,1,0,1,1,2
401408606,Arkansas Razorbacks,C. Lykes,4277889,,False,9.0,0,1,0,1,0,0,7,7,0,0,0,0,0,0,1,0,7
401408606,Arkansas Razorbacks,TEAM,TOTAL,TOTAL,False,,14,51,11,35,3,16,22,25,3,31,34,10,12,1,12,14,53
401408605,Notre Dame Fighting Irish,P. Atkinson Jr.,4279699,,True,35.0,6,11,6,11,0,0,1,1,4,4,8,3,4,1,5,2,13
401408605,Notre Dame Fighting Irish,B. Wesley,4683935,,True,27.0,8,14,8,13,0,1,2,2,0,1,1,1,3,0,3,3,18
401408605,Notre Dame Fighting Irish,C. Ryan,4397114,,True,36.0,10,13,3,4,7,9,2,2,0,6,6,1,0,0,2,3,29
401408605,Notre Dame Fighting Irish,D. Goodwin,4395667,,True,21.0,1,3,1,2,0,1,1,2,0,1,1,0,0,0,1,1,3
401408605,Notre Dame Fighting Irish,P. Hubb,4395664,,True,35.0,1,8,0,6,1,2,2,2,0,5,5,3,2,0,1,2,5
401408605,Notre Dame Fighting Irish,N. Laszewski,4395665,,False,30.0,3,4,1,1,2,3,2,2,0,6,6,3,0,0,4,1,10
401408605,Notre Dame Fighting Irish,T. Wertz,4397753,,False,16.0,0,1,0,1,0,0,0,0,0,0,0,2,1,0,2,1,0
401408605,Notre Dame Fighting Irish,TEAM,TOTAL,TOTAL,False,,29,54,19,38,10,16,10,11,5,27,32,13,10,1,18,13,78
401408605,Alabama Crimson Tide,N. Gurley,4280015,,True,15.0,2,4,2,3,0,1,0,0,2,3,5,2,0,0,1,1,4
401408605,Alabama Crimson Tide,C. Bediako,4565203,,True,17.0,2,4,2,4,0,0,0,0,0,0,0,0,0,0,2,5,4
401408605,Alabama Crimson Tide,K. Ellis,4702177,,True,39.0,6,11,2,5,4,6,0,0,4,5,9,0,2,0,3,1,16
401408605,Alabama Crimson Tide,J. Shackelford,4432846,,True,38.0,4,17,2,7,2,10,3,4,1,6,7,2,2,1,2,1,13
401408605,Alabama Crimson Tide,Jah. Quinerly,4397132,,True,3.0,0,2,0,0,0,2,0,0,0,0,0,1,0,0,0,0,0
401408605,Alabama Crimson Tide,J. Rojas,4592740,,False,8.0,1,1,1,1,0,0,0,0,0,0,0,0,0,0,0,2,2
401408605,Alabama Crimson Tide,D. Miles,4433561,,False,20.0,2,7,2,5,0,2,0,0,0,0,0,1,0,0,0,1,4
401408605,Alabama Crimson Tide,J. Gary,4431707,,False,23.0,4,9,3,7,1,2,1,3,3,1,4,1,2,3,0,2,10
401408605,Alabama Crimson Tide,J. Holt,4684152,,False,1.0,0,0,0,0,0,0,0,0,0,0,0,0,0,0,0,0,0
401408605,Alabama Crimson Tide,JD Davison,4576085,,False,36.0,5,9,4,8,1,1,0,0,0,3,3,9,3,0,6,1,11
401408605,Alabama Crimson Tide,TEAM,TOTAL,TOTAL,False,,26,64,18,40,8,24,4,7,10,18,28,16,9,4,14,14,64
401408604,Wright State Raiders,A. Braun,4709318,,True,5.0,0,1,0,1,0,0,0,2,0,0,0,0,0,0,0,1,0
401408604,Wright State Raiders,G. Basile,4397787,,True,38.0,8,20,5,11,3,9,2,3,1,4,5,1,2,3,3,3,21
401408604,Wright State Raiders,T. Holden,4431990,,True,31.0,3,11,3,10,0,1,6,7,2,1,3,3,1,0,1,4,12
401408604,Wright State Raiders,T. Calvin,4431915,,True,39.0,6,19,4,15,2,4,2,3,0,1,1,4,2,0,2,3,16
401408604,Wright State Raiders,T. Finke,4396017,,True,38.0,6,14,3,6,3,8,0,0,1,5,6,3,4,0,0,2,15
401408604,Wright State Raiders,C. Wilbourn,4432141,,False,2.0,0,0,0,0,0,0,0,0,0,0,0,0,0,0,0,0,0
401408604,Wright State Raiders,A. Neff,4397786,,False,1.0,0,0,0,0,0,0,2,2,0,0,0,0,0,0,0,0,2
401408604,Wright State Raiders,R. Voss,4279475,,False,1.0,0,0,0,0,0,0,0,0,0,1,1,0,0,0,0,0,0
401408604,Wright State Raiders,K. Norris,4898194,,False,35.0,1,3,0,1,1,2,0,0,0,5,5,2,1,0,0,1,3
401408604,Wright State Raiders,A. Welage,4702995,,False,9.0,0,1,0,0,0,1,0,0,0,0,0,0,0,0,0,0,0
401408604,Wright State Raiders,T. Nagy,4593400,,False,1.0,0,0,0,0,0,0,1,2,0,1,1,0,0,0,0,0,1
401408604,Wright State Raiders,TEAM,TOTAL,TOTAL,False,,24,69,15,44,9,25,13,19,7,18,25,13,10,3,6,14,70
401408604,Arizona Wildcats,A. Tubelis,4702372,,True,20.0,6,8,6,7,0,1,1,2,0,5,5,0,2,0,3,3,13
401408604,Arizona Wildcats,C. Koloko,4431778,,True,31.0,7,10,7,10,0,0,3,4,5,8,13,6,0,5,2,2,17
401408604,Arizona Wildcats,B. Mathurin,4683634,,True,33.0,7,18,3,8,4,10,0,0,0,5,5,0,0,0,4,1,18
401408604,Arizona Wildcats,D. Terry,4433159,,True,36.0,6,8,4,6,2,2,2,2,2,5,7,4,1,1,2,2,16
401408604,Arizona Wildcats,J. Kier,4066863,,True,29.0,2,3,0,1,2,2,2,2,0,4,4,6,1,0,3,2,8
401408604,Arizona Wildcats,T. Tubelis,4683637,,False,1.0,0,0,0,0,0,0,0,0,0,0,0,0,0,0,0,0,0
401408604,Arizona Wildcats,J. Mains,4609978,,False,1.0,0,0,0,0,0,0,0,0,0,0,0,0,0,0,0,0,0
401408604,Arizona Wildcats,O. Ballo,4594109,,False,18.0,0,1,0,1,0,0,0,0,1,2,3,2,0,3,2,1,0
401408604,Arizona Wildcats,A. Bal,4896365,,False,9.0,2,4,2,3,0,1,0,0,0,0,0,0,0,0,0,0,4
401408604,Arizona Wildcats,G. Weitman,4702373,,False,1.0,0,0,0,0,0,0,0,0,0,0,0,0,0,0,0,1,0
401408604,Arizona Wildcats,P. Larsson,4601025,,False,20.0,3,7,0,3,3,4,2,2,1,4,5,3,0,0,3,4,11
401408604,Arizona Wildcats,S. Nowell,4433263,,False,1.0,0,1,0,1,0,0,0,0,0,0,0,0,0,0,0,1,0
401408604,Arizona Wildcats,TEAM,TOTAL,TOTAL,False,,33,60,22,40,11,20,10,12,10,36,46,21,4,9,19,17,87
401408603,TCU Horned Frogs,E. Miller,4432872,,True,24.0,4,6,4,5,0,1,2,2,0,2,2,0,3,1,1,1,10
401408603,TCU Horned Frogs,C. O'Bannon Jr.,4278533,,True,21.0,0,2,0,2,0,0,4,5,0,6,6,3,1,0,2,1,4
401408603,TCU Horned Frogs,E. Lampkin,4433191,,True,22.0,1,4,1,4,0,0,0,1,3,2,5,2,1,0,2,2,2
401408603,TCU Horned Frogs,M. Miles,4432550,,True,28.0,9,18,8,16,1,2,2,2,0,4,4,2,0,0,2,3,21
401408603,TCU Horned Frogs,D. Baugh,4431766,,True,31.0,5,9,3,7,2,2,2,2,0,5,5,6,0,0,3,1,14
401408603,TCU Horned Frogs,S. Doumbia,4897753,,False,1.0,0,1,0,1,0,0,0,0,0,0,0,0,0,0,0,1,0
401408603,TCU Horned Frogs,X. Cork,4593722,,False,17.0,3,4,3,4,0,0,0,0,1,2,3,0,0,1,1,2,6
401408603,TCU Horned Frogs,J. Coles,4432282,,False,10.0,1,3,1,1,0,2,1,2,0,2,2,0,0,0,0,2,3
401408603,TCU Horned Frogs,C. Despie,4897754,,False,1.0,0,0,0,0,0,0,0,0,0,0,0,0,0,0,0,0,0
401408603,TCU Horned Frogs,D. Ford,4897751,,False,1.0,0,0,0,0,0,0,0,0,0,0,0,0,0,0,0,0,0
401408603,TCU Horned Frogs,H. Young,4592292,,False,1.0,0,0,0,0,0,0,0,0,0,0,0,0,0,0,0,0,0
401408603,TCU Horned Frogs,M. Peavy,4432185,,False,23.0,3,3,3,3,0,0,0,0,1,2,3,1,1,1,0,2,6
401408603,TCU Horned Frogs,F. Farabello,4431952,,False,20.0,1,3,0,0,1,3,0,0,1,4,5,1,1,0,2,0,3
401408603,TCU Horned Frogs,TEAM,TOTAL,TOTAL,False,,27,53,23,43,4,10,11,14,8,31,39,15,7,3,13,15,69
401408603,Seton Hall Pirates,T. Jackson,4593010,,True,23.0,1,6,0,2,1,4,0,0,0,1,1,0,2,1,1,1,3
401408603,Seton Hall Pirates,I. Obiagu,4277851,,True,21.0,1,2,1,2,0,0,1,4,2,3,5,0,0,2,3,4,3
401408603,Seton Hall Pirates,K. Richmond,4701845,,True,27.0,2,4,2,4,0,0,0,1,1,1,2,4,3,0,6,2,4
401408603,Seton Hall Pirates,J. Rhoden,4397119,,True,18.0,2,7,2,6,0,1,1,2,0,4,4,0,0,0,2,5,5
401408603,Seton Hall Pirates,M. Cale,4278579,,True,35.0,4,15,1,9,3,6,0,0,1,1,2,1,1,0,1,3,11
401408603,Seton Hall Pirates,T. Samuel,4432105,,False,19.0,2,4,2,3,0,1,1,1,0,2,2,1,1,1,1,2,5
401408603,Seton Hall Pirates,A. Yetna,4278308,,False,17.0,0,2,0,1,0,1,0,0,0,3,3,1,1,0,0,0,0
401408603,Seton Hall Pirates,T. Powell,4684146,,False,8.0,0,1,0,0,0,1,0,0,0,2,2,0,0,0,0,0,0
401408603,Seton Hall Pirates,J. Harris,4277966,,False,32.0,3,11,1,4,2,7,3,3,0,0,0,2,0,0,0,0,11
401408603,Seton Hall Pirates,TEAM,TOTAL,TOTAL,False,,15,52,9,31,6,21,6,11,8,18,26,9,8,4,16,17,42
401408602,Texas Tech Red Raiders,K. Obanor,4398304,,True,27.0,5,7,5,5,0,2,0,1,2,9,11,1,0,0,0,3,10
401408602,Texas Tech Red Raiders,B. Williams,4066678,,True,17.0,8,10,4,5,4,5,0,1,0,2,2,3,0,0,4,3,20
401408602,Texas Tech Red Raiders,K. McCullar,4411057,,True,18.0,5,6,5,5,0,1,0,1,0,1,1,4,2,0,2,2,10
401408602,Texas Tech Red Raiders,T. Shannon Jr.,4432847,,True,26.0,5,7,2,3,3,4,7,8,0,1,1,6,0,2,1,0,20
401408602,Texas Tech Red Raiders,A. Arms,4406489,,True,25.0,4,7,2,4,2,3,5,6,1,4,5,3,1,1,1,0,15
401408602,Texas Tech Red Raiders,KJ Allen,4897776,,False,4.0,0,1,0,1,0,0,0,0,0,0,0,0,0,0,0,0,0
401408602,Texas Tech Red Raiders,D. Batcho,4683631,,False,15.0,0,0,0,0,0,0,0,1,2,2,4,1,0,0,0,3,0
401408602,Texas Tech Red Raiders,M. Santos-Silva,4278420,,False,17.0,1,1,1,1,0,0,0,0,0,1,1,1,0,2,1,4,2
401408602,Texas Tech Red Raiders,D. Warren,4592666,,False,29.0,4,9,3,6,1,3,1,1,1,3,4,2,2,0,2,3,10
401408602,Texas Tech Red Raiders,C. Agbo,4433197,,False,6.0,3,3,1,1,2,2,0,0,0,1,1,0,0,0,0,0,8
401408602,Texas Tech Red Raiders,M. Wilson,4432902,,False,16.0,1,3,1,3,0,0,0,0,0,0,0,2,1,0,1,0,2
401408602,Texas Tech Red Raiders,TEAM,TOTAL,TOTAL,False,,36,54,24,34,12,20,13,19,7,26,33,23,6,5,12,18,97
401408602,Montana State Bobcats,J. Belo,4592617,,True,25.0,2,8,2,8,0,0,1,3,3,0,3,4,1,0,2,2,5
401408602,Montana State Bobcats,A. Mohamed,4397559,,True,23.0,1,2,1,2,0,0,1,2,1,2,3,1,1,0,2,3,3
401408602,Montana State Bobcats,T. Patterson,4702074,,True,19.0,1,8,0,1,1,7,0,0,1,2,3,0,1,0,0,1,3
401408602,Montana State Bobcats,A. Adamu,4592615,,True,22.0,2,6,2,6,0,0,0,0,0,3,3,2,1,0,2,0,4
401408602,Montana State Bobcats,X. Bishop,4067581,,True,27.0,3,8,1,4,2,4,4,4,1,0,1,2,1,0,3,3,12
401408602,Montana State Bobcats,S. Lecholat,4897926,,False,12.0,0,0,0,0,0,0,2,2,0,2,2,1,0,0,1,2,2
401408602,Montana State Bobcats,G. Osobor,4897921,,False,19.0,1,2,1,2,0,0,2,2,1,3,4,1,0,0,1,3,4
401408602,Montana State Bobcats,B. Fernandez,4592619,,False,1.0,0,0,0,0,0,0,0,0,0,0,0,0,0,0,0,0,0
401408602,Montana State Bobcats,I. Spears,4897925,,False,4.0,1,3,1,2,0,1,0,0,0,0,0,0,0,0,0,0,2
401408602,Montana State Bobcats,P. McMahon,4897923,,False,8.0,2,2,1,1,1,1,2,2,0,1,1,0,0,1,2,3,7
401408602,Montana State Bobcats,K. Tynes,4702078,,False,9.0,1,1,1,1,0,0,0,0,0,0,0,1,0,0,0,1,2
401408602,Montana State Bobcats,C. Ash,4702076,,False,1.0,0,0,0,0,0,0,0,0,0,0,0,0,0,0,0,0,0
401408602,Montana State Bobcats,N. Gazelas,4702072,,False,17.0,3,7,0,1,3,6,0,0,0,0,0,1,0,0,1,2,9
401408602,Montana State Bobcats,R. Battle,4431726,,False,13.0,4,8,3,3,1,5,0,0,0,0,0,1,0,0,1,2,9
401408602,Montana State Bobcats,TEAM,TOTAL,TOTAL,False,,21,55,13,31,8,24,12,15,10,14,24,14,5,1,16,22,62
401408601,UAB Blazers,KJ Buffen,4396968,,True,35.0,4,7,4,6,0,1,2,2,2,9,11,1,3,1,1,2,10
401408601,UAB Blazers,T. Jemison,4395623,,True,32.0,3,4,3,4,0,0,1,1,2,7,9,2,0,0,2,2,7
401408601,UAB Blazers,J. Walker,4396656,,True,37.0,6,18,5,8,1,10,4,5,0,1,1,5,0,0,5,1,17
401408601,UAB Blazers,M. Ertel,4280260,,True,35.0,5,10,2,4,3,6,0,0,0,0,0,1,1,0,0,3,13
401408601,UAB Blazers,Q. Jackson,4067781,,True,28.0,3,8,2,6,1,2,0,0,0,3,3,2,0,0,2,2,7
401408601,UAB Blazers,R. Gordon,4432400,,False,5.0,0,0,0,0,0,0,0,0,0,1,1,0,0,0,1,2,0
401408601,UAB Blazers,E. Tate,4897574,,False,1.0,0,0,0,0,0,0,0,0,0,0,0,0,0,0,0,0,0
401408601,UAB Blazers,T. Toney,4703133,,False,2.0,0,2,0,2,0,0,0,0,0,0,0,0,1,0,0,0,0
401408601,UAB Blazers,J. Coleman,4593281,,False,1.0,0,0,0,0,0,0,0,0,0,0,0,0,0,0,0,0,0
401408601,UAB Blazers,T. Lovan,4397726,,False,23.0,5,7,5,7,0,0,4,6,3,2,5,1,1,0,1,2,14
401408601,UAB Blazers,J. Brown,4278307,,False,1.0,0,0,0,0,0,0,0,0,0,0,0,0,0,0,0,0,0
401408601,UAB Blazers,TEAM,TOTAL,TOTAL,False,,26,56,21,37,5,19,11,14,9,23,32,12,6,1,12,14,68
401408601,Houston Cougars,F. White Jr.,4278263,,True,29.0,5,11,4,7,1,4,3,5,3,3,6,0,0,1,0,3,14
401408601,Houston Cougars,J. Carlton,4278229,,True,22.0,6,11,6,11,0,0,0,2,2,0,2,0,0,0,3,1,12
401408601,Houston Cougars,J. Shead,4432241,,True,34.0,4,8,2,4,2,4,2,2,0,3,3,7,1,0,1,2,12
401408601,Houston Cougars,K. Edwards,4397081,,True,37.0,9,15,3,7,6,8,1,2,1,6,7,3,1,1,2,0,25
401408601,Houston Cougars,T. Moore,4066808,,True,36.0,4,10,3,6,1,4,0,0,0,4,4,6,1,0,0,2,9
401408601,Houston Cougars,J. Francis,4684301,,False,1.0,0,0,0,0,0,0,0,0,0,0,0,0,0,0,0,0,0
401408601,Houston Cougars,J. Roberts,4433068,,False,14.0,3,3,3,3,0,0,0,2,1,1,2,0,1,1,0,1,6
401408601,Houston Cougars,R. Chaney,4395708,,False,9.0,1,1,1,1,0,0,0,0,1,1,2,1,1,0,1,0,2
401408601,Houston Cougars,R. Armbrester,4684151,,False,1.0,0,0,0,0,0,0,0,0,0,0,0,0,0,0,0,0,0
401408601,Houston Cougars,R. Walker,4708176,,False,16.0,0,1,0,0,0,1,2,2,2,4,6,2,1,0,0,3,2
401408601,Houston Cougars,R. Elvin,4701204,,False,1.0,0,0,0,0,0,0,0,0,0,0,0,0,0,0,0,0,0
401408601,Houston Cougars,TEAM,TOTAL,TOTAL,False,,32,60,22,39,10,21,8,15,10,23,33,19,6,3,7,12,82
401408600,Illinois Fighting Illini,K. Cockburn,4432828,,True,35.0,6,12,6,12,0,0,5,10,5,8,13,1,1,3,4,4,17
401408600,Illinois Fighting Illini,C. Hawkins,4432976,,True,32.0,5,8,5,7,0,1,0,1,2,6,8,2,0,1,0,3,10
401408600,Illinois Fighting Illini,A. Plummer,4592434,,True,29.0,5,12,2,4,3,8,2,2,0,2,2,0,0,0,3,2,15
401408600,Illinois Fighting Illini,D. Williams,4277940,,True,28.0,1,3,1,1,0,2,0,0,0,6,6,0,1,0,0,1,2
401408600,Illinois Fighting Illini,T. Frazier,4277936,,True,32.0,0,6,0,1,0,5,2,2,1,2,3,4,2,0,1,2,2
401408600,Illinois Fighting Illini,B. Bosmans-Verdonk,4592607,,False,1.0,0,0,0,0,0,0,0,0,0,0,0,0,0,0,0,0,0
401408600,Illinois Fighting Illini,O. Payne,4432825,,False,4.0,1,1,1,1,0,0,1,3,0,0,0,0,0,0,0,1,3
401408600,Illinois Fighting Illini,A. Curbelo,4432195,,False,30.0,1,7,1,6,0,1,3,4,0,3,3,4,1,0,6,2,5
401408600,Illinois Fighting Illini,J. Grandison,4280073,,False,9.0,0,0,0,0,0,0,0,0,1,2,3,2,0,0,0,1,0
401408600,Illinois Fighting Illini,TEAM,TOTAL,TOTAL,False,,19,49,16,32,3,17,13,22,9,32,41,13,5,4,14,16,54
401408600,Chattanooga Mocs,KC Hankton,4397200,,True,22.0,2,4,0,0,2,4,0,0,0,2,2,0,0,0,1,3,6
401408600,Chattanooga Mocs,S. De Sousa,4292484,,True,18.0,4,7,4,7,0,0,0,2,2,2,4,3,0,0,1,4,8
401408600,Chattanooga Mocs,D. Banks,4279210,,True,38.0,3,9,3,9,0,0,2,4,4,9,13,1,2,0,1,3,8
401408600,Chattanooga Mocs,M. Smith,4397784,,True,34.0,4,20,4,17,0,3,4,6,3,5,8,1,3,0,2,1,12
401408600,Chattanooga Mocs,D. Jean-Baptiste,4067255,,True,33.0,2,11,2,7,0,4,0,0,1,2,3,1,2,0,2,0,4
401408600,Chattanooga Mocs,J. Ayeni,4066518,,False,5.0,2,3,1,2,1,1,0,0,0,0,0,0,0,0,0,5,5
401408600,Chattanooga Mocs,A. Diggs,4278461,,False,13.0,2,3,2,3,0,0,0,0,2,1,3,0,1,0,1,2,4
401408600,Chattanooga Mocs,G. Ledford,4433029,,False,19.0,2,7,1,4,1,3,0,0,2,1,3,0,0,0,1,1,5
401408600,Chattanooga Mocs,A.J. Caldwell,4280264,,False,18.0,0,1,0,1,0,0,1,2,1,2,3,0,0,0,1,2,1
401408600,Chattanooga Mocs,TEAM,TOTAL,TOTAL,False,,21,65,17,50,4,15,7,14,16,27,43,6,8,0,10,21,53
401408599,Ohio State Buckeyes,E.J. Liddell,4432821,,True,34.0,4,9,4,7,0,2,8,10,1,9,10,1,0,3,3,1,16
401408599,Ohio State Buckeyes,K. Young,4277974,,True,35.0,4,10,4,8,0,2,1,2,0,7,7,1,1,1,2,4,9
401408599,Ohio State Buckeyes,E. Brown III,4433179,,True,21.0,2,5,2,2,0,3,0,0,0,1,1,1,0,1,1,2,4
401408599,Ohio State Buckeyes,M. Branham,4565201,,True,27.0,5,7,5,6,0,1,4,4,1,4,5,2,4,0,3,4,14
401408599,Ohio State Buckeyes,J. Wheeler,4277978,,True,30.0,1,4,1,2,0,2,2,3,1,3,4,1,1,0,2,2,4
401408599,Ohio State Buckeyes,Z. Key,4432401,,False,12.0,1,1,1,1,0,0,0,0,1,6,7,0,0,0,4,2,2
401408599,Ohio State Buckeyes,H. Hookfin,4412299,,False,1.0,0,1,0,1,0,0,0,0,1,0,1,0,0,0,0,0,0
401408599,Ohio State Buckeyes,J. Brunk,4065763,,False,1.0,0,1,0,1,0,0,0,0,0,1,1,0,0,0,0,0,0
401408599,Ohio State Buckeyes,J. Ahrens,4397236,,False,12.0,0,2,0,0,0,2,0,0,0,1,1,0,1,0,0,0,0
401408599,Ohio State Buckeyes,M. Johnson Jr.,4710770,,False,15.0,1,3,0,0,1,3,0,0,1,0,1,0,0,0,1,1,3
401408599,Ohio State Buckeyes,C. Russell,4280257,,False,11.0,0,0,0,0,0,0,2,2,0,0,0,0,0,0,1,0,2
401408599,Ohio State Buckeyes,J. Sotos,4280044,,False,1.0,0,0,0,0,0,0,0,0,0,0,0,0,0,0,0,0,0
401408599,Ohio State Buckeyes,TEAM,TOTAL,TOTAL,False,,18,43,17,28,1,15,17,21,8,33,41,6,7,5,17,16,54
401408599,Loyola Chicago Ramblers,C. Knight,4279553,,True,19.0,3,6,3,6,0,0,0,0,1,2,3,0,1,2,2,2,6
401408599,Loyola Chicago Ramblers,A. Uguak,4066717,,True,33.0,1,6,1,3,0,3,0,0,0,0,0,1,1,0,2,1,2
401408599,Loyola Chicago Ramblers,B. Norris,4397778,,True,33.0,5,13,1,2,4,11,0,0,2,1,3,2,1,0,1,2,14
401408599,Loyola Chicago Ramblers,T. Hall,4289536,,True,19.0,1,4,0,1,1,3,0,0,0,2,2,0,0,0,1,4,3
401408599,Loyola Chicago Ramblers,L. Williamson,4279147,,True,34.0,1,10,0,5,1,5,1,6,1,4,5,6,3,0,3,2,4
401408599,Loyola Chicago Ramblers,S. Thomas,4897471,,False,1.0,0,0,0,0,0,0,0,0,0,0,0,0,0,0,0,0,0
401408599,Loyola Chicago Ramblers,T. Welch,4432136,,False,8.0,0,1,0,1,0,0,0,2,1,0,1,0,1,0,0,2,0
401408599,Loyola Chicago Ramblers,W. Alcock,4397432,,False,1.0,0,1,0,1,0,0,0,0,0,1,1,0,0,0,0,0,0
401408599,Loyola Chicago Ramblers,R. Schwieger,4279565,,False,22.0,3,6,1,2,2,4,0,0,2,4,6,0,0,0,4,3,8
401408599,Loyola Chicago Ramblers,J. Hutson,4590402,,False,3.0,0,1,0,1,0,0,0,0,0,0,0,0,0,0,0,0,0
401408599,Loyola Chicago Ramblers,K. Clemons,4592695,,False,3.0,0,0,0,0,0,0,0,0,0,0,0,0,1,0,0,0,0
401408599,Loyola Chicago Ramblers,M. Kennedy,4433019,,False,24.0,1,8,1,6,0,2,2,2,1,4,5,3,1,0,0,3,4
401408599,Loyola Chicago Ramblers,TEAM,TOTAL,TOTAL,False,,15,56,7,28,8,28,3,10,11,20,31,12,9,2,14,19,41
401408598,Villanova Wildcats,E. Dixon,4431718,,True,26.0,5,6,4,4,1,2,1,1,1,5,6,0,1,0,0,0,12
401408598,Villanova Wildcats,B. Slater,4397133,,True,24.0,1,1,1,1,0,0,1,1,0,5,5,1,0,1,2,4,3
401408598,Villanova Wildcats,J. Samuels,4278588,,True,31.0,5,9,3,6,2,3,3,4,7,2,9,3,1,1,3,3,15
401408598,Villanova Wildcats,J. Moore,4592491,,True,33.0,7,13,4,8,3,5,4,4,0,3,3,6,1,0,3,1,21
401408598,Villanova Wildcats,C. Gillespie,4278585,,True,32.0,5,11,1,2,4,9,0,0,0,4,4,4,0,0,1,0,14
401408598,Villanova Wildcats,T. Patterson,4713885,,False,2.0,0,0,0,0,0,0,0,0,0,1,1,0,0,0,0,3,0
401408598,Villanova Wildcats,N. Njoku,4433274,,False,2.0,0,0,0,0,0,0,0,0,0,0,0,0,1,0,0,0,0
401408598,Villanova Wildcats,K. Voigt,4702030,,False,0.0,0,0,0,0,0,0,0,0,0,0,0,0,0,0,0,0,0
401408598,Villanova Wildcats,C. Arcidiacono,4592490,,False,9.0,0,2,0,1,0,1,0,0,0,0,0,0,0,0,0,0,0
401408598,Villanova Wildcats,B. Antoine,4432814,,False,11.0,1,5,1,2,0,3,0,0,0,1,1,1,0,0,0,1,2
401408598,Villanova Wildcats,C. Daniels,4278373,,False,30.0,4,8,1,3,3,5,2,2,1,1,2,1,1,0,1,2,13
401408598,Villanova Wildcats,TEAM,TOTAL,TOTAL,False,,28,55,15,27,13,28,11,12,10,23,33,16,5,2,11,14,80
401408598,Delaware Blue Hens,A. Carr,4702743,,True,20.0,5,5,4,4,1,1,2,2,0,3,3,1,0,0,3,2,13
401408598,Delaware Blue Hens,J. Davis,4701989,,True,31.0,7,10,7,10,0,0,3,4,3,3,6,1,0,1,1,2,17
401408598,Delaware Blue Hens,E. Asamoah,4597790,,True,22.0,0,4,0,0,0,4,0,0,0,1,1,0,3,0,1,2,0
401408598,Delaware Blue Hens,J. Nelson Jr.,4592444,,True,35.0,3,13,2,8,1,5,1,1,0,1,1,3,1,0,2,4,8
401408598,Delaware Blue Hens,K. Anderson,4279189,,True,35.0,3,8,2,3,1,5,2,2,1,2,3,2,1,1,1,0,9
401408598,Delaware Blue Hens,A. Ochefu,4278243,,False,2.0,0,0,0,0,0,0,0,1,1,0,1,0,0,0,0,0,0
401408598,Delaware Blue Hens,D. Painter,4065840,,False,16.0,2,4,2,3,0,1,2,2,0,2,2,1,2,0,0,1,6
401408598,Delaware Blue Hens,W. Peterson,4897008,,False,2.0,0,0,0,0,0,0,2,2,0,0,0,0,0,0,0,0,2
401408598,Delaware Blue Hens,G. Arletti,4702742,,False,2.0,0,0,0,0,0,0,1,2,0,1,1,0,0,0,0,1,1
401408598,Delaware Blue Hens,F. Rullo IV,4597789,,False,0.0,0,0,0,0,0,0,0,0,0,0,0,0,0,0,0,0,0
401408598,Delaware Blue Hens,R. Gardner Jr.,4398238,,False,3.0,0,0,0,0,0,0,0,0,0,1,1,0,0,0,0,1,0
401408598,Delaware Blue Hens,D. Long,4397403,,False,1.0,0,0,0,0,0,0,0,0,0,0,0,0,0,0,1,0,0
401408598,Delaware Blue Hens,R. Allen,4279190,,False,31.0,2,6,2,2,0,4,0,0,0,2,2,1,1,0,1,2,4
401408598,Delaware Blue Hens,TEAM,TOTAL,TOTAL,False,,22,50,19,30,3,20,13,16,7,17,24,9,8,2,10,15,60
401408597,LSU Tigers,E. Reid,4433594,,True,17.0,1,1,1,1,0,0,2,2,1,2,3,0,0,0,2,2,4
401408597,LSU Tigers,D. Days,4396978,,True,37.0,4,9,2,3,2,6,4,8,3,9,12,0,2,0,2,2,14
401408597,LSU Tigers,M. Wilkinson,4567590,,True,30.0,3,9,3,4,0,5,2,2,2,1,3,1,1,0,1,1,8
401408597,LSU Tigers,B. Murray,4684166,,True,35.0,3,8,2,4,1,4,1,3,0,3,3,1,2,0,2,1,8
401408597,LSU Tigers,X. Pinson,4396953,,True,32.0,1,5,1,4,0,1,0,1,1,1,2,7,1,0,5,1,2
401408597,LSU Tigers,A. Fudge,4896481,,False,2.0,0,0,0,0,0,0,0,0,0,0,0,0,0,0,0,0,0
401408597,LSU Tigers,T. Eason,4433192,,False,19.0,5,9,4,7,1,2,7,7,1,3,4,0,0,0,4,4,18
401408597,LSU Tigers,S. O'Neal,4397130,,False,5.0,0,1,0,1,0,0,0,0,0,1,1,0,0,0,1,0,0
401408597,LSU Tigers,J. Williams,4683676,,False,5.0,0,1,0,1,0,0,0,0,0,0,0,0,1,0,0,0,0
401408597,LSU Tigers,E. Gaines,4682883,,False,18.0,0,3,0,2,0,1,0,0,0,2,2,2,0,1,2,2,0
401408597,LSU Tigers,TEAM,TOTAL,TOTAL,False,,17,46,13,27,4,19,16,23,12,26,38,11,7,1,19,13,54
401408597,Iowa State Cyclones,R. Jones,4593702,,True,17.0,0,0,0,0,0,0,0,0,0,4,4,2,0,0,1,2,0
401408597,Iowa State Cyclones,T. Enaruna,4431734,,True,11.0,1,1,1,1,0,0,0,0,1,1,2,2,0,0,0,1,2
401408597,Iowa State Cyclones,T. Hunter,4683751,,True,34.0,8,13,1,2,7,11,0,0,0,3,3,3,5,0,3,2,23
401408597,Iowa State Cyclones,G. Kalscheur,4397214,,True,30.0,1,7,0,1,1,6,1,2,2,2,4,3,3,0,4,4,4
401408597,Iowa State Cyclones,I. Brockington,4278412,,True,38.0,6,16,5,12,1,4,6,8,2,2,4,1,3,0,2,3,19
401408597,Iowa State Cyclones,A. Kunc,4397167,,False,26.0,1,3,0,0,1,3,0,0,0,4,4,1,2,2,0,2,3
401408597,Iowa State Cyclones,G. Conditt IV,4396989,,False,10.0,0,0,0,0,0,0,0,0,1,0,1,1,0,2,0,1,0
401408597,Iowa State Cyclones,T. Jackson,4431999,,False,6.0,0,2,0,0,0,2,0,0,0,1,1,0,0,0,0,0,0
401408597,Iowa State Cyclones,C. Grill,4431973,,False,28.0,3,14,1,3,2,11,0,0,1,3,4,1,2,0,0,4,8
401408597,Iowa State Cyclones,TEAM,TOTAL,TOTAL,False,,20,56,8,19,12,37,7,10,8,21,29,14,15,4,10,19,59
401408596,Virginia Tech Hokies,K. Aluma,4280120,,True,30.0,7,10,7,10,0,0,1,1,0,6,6,1,1,1,3,3,15
401408596,Virginia Tech Hokies,J. Mutts,4278693,,True,34.0,3,5,3,4,0,1,3,4,2,3,5,5,1,0,4,3,9
401408596,Virginia Tech Hokies,H. Cattoor,4432954,,True,27.0,4,7,3,4,1,3,3,4,0,1,1,1,1,0,3,3,12
401408596,Virginia Tech Hokies,N. Alleyne,4432934,,True,31.0,1,3,1,3,0,0,2,2,0,2,2,0,0,0,0,3,4
401408596,Virginia Tech Hokies,S. Murphy,4280118,,True,25.0,2,5,2,5,0,0,2,2,1,4,5,4,1,0,3,2,6
401408596,Virginia Tech Hokies,D. N'Guessan,4701984,,False,9.0,1,2,1,2,0,0,1,1,0,0,0,0,0,1,0,2,3
401408596,Virginia Tech Hokies,S. Pedulla,4709131,,False,19.0,3,9,0,3,3,6,10,10,0,2,2,0,0,0,0,2,19
401408596,Virginia Tech Hokies,D. Maddox,4432257,,False,25.0,2,6,2,4,0,2,1,2,1,3,4,0,0,0,0,1,5
401408596,Virginia Tech Hokies,TEAM,TOTAL,TOTAL,False,,23,47,19,35,4,12,23,26,4,21,25,11,4,2,13,19,73
401408596,Texas Longhorns,T. Allen,4397148,,True,34.0,4,11,4,11,0,0,6,8,2,4,6,3,2,0,1,5,14
401408596,Texas Longhorns,C. Bishop,4397037,,True,14.0,5,7,5,7,0,0,1,2,2,1,3,0,1,1,1,4,11
401408596,Texas Longhorns,C. Ramey,4334018,,True,28.0,2,8,1,4,1,4,5,6,0,3,3,0,2,0,1,1,10
401408596,Texas Longhorns,M. Carr,4278014,,True,34.0,6,11,3,6,3,5,0,0,0,1,1,9,2,0,1,3,15
401408596,Texas Longhorns,A. Jones,4066325,,True,30.0,7,11,2,4,5,7,2,2,0,5,5,1,1,1,2,1,21
401408596,Texas Longhorns,B. Cunningham,4397079,,False,15.0,0,0,0,0,0,0,0,0,2,0,2,2,1,0,0,5,0
401408596,Texas Longhorns,D. Disu,4432866,,False,12.0,1,4,1,4,0,0,2,2,2,0,2,1,0,1,0,0,4
401408596,Texas Longhorns,D. Askew,4702467,,False,16.0,1,1,1,1,0,0,1,2,0,1,1,0,0,0,1,1,3
401408596,Texas Longhorns,J. Febres,4277921,,False,17.0,1,4,0,1,1,3,0,0,0,2,2,1,0,0,0,2,3
401408596,Texas Longhorns,TEAM,TOTAL,TOTAL,False,,27,57,17,38,10,19,17,22,9,20,29,17,9,3,9,22,81
401408595,Yale Bulldogs,M. Knowling,4898246,,True,32.0,4,11,4,11,0,0,0,0,3,3,6,2,1,0,1,1,8
401408595,Yale Bulldogs,EJ Jarvis,4431872,,True,21.0,4,10,4,8,0,2,0,1,0,2,2,2,0,2,1,4,8
401408595,Yale Bulldogs,B. Mbeng,4898237,,True,20.0,1,2,1,1,0,1,0,0,0,3,3,3,0,0,4,3,2
401408595,Yale Bulldogs,A. Swain,4279697,,True,33.0,8,19,6,13,2,6,0,0,0,3,3,2,1,0,1,0,18
401408595,Yale Bulldogs,J. Gabbidon,4279696,,True,21.0,1,6,1,3,0,3,0,0,1,3,4,3,1,0,3,4,2
401408595,Yale Bulldogs,Y. Basa-Ama,4898247,,False,2.0,0,0,0,0,0,0,0,0,0,0,0,0,0,1,0,0,0
401408595,Yale Bulldogs,I. Kelly,4398015,,False,19.0,1,4,1,4,0,0,2,2,3,3,6,0,0,0,0,4,4
401408595,Yale Bulldogs,J. Lanford,4398014,,False,2.0,0,0,0,0,0,0,0,0,0,0,0,0,0,0,0,3,0
401408595,Yale Bulldogs,Y. Gharram,4898248,,False,1.0,0,0,0,0,0,0,1,2,0,0,0,0,1,0,0,0,1
401408595,Yale Bulldogs,E. Buyukhanli,4898240,,False,1.0,0,0,0,0,0,0,0,0,0,0,0,0,0,0,0,0,0
401408595,Yale Bulldogs,J. Poulakidas,4898238,,False,4.0,0,1,0,1,0,0,0,0,0,0,0,1,0,0,0,0,0
401408595,Yale Bulldogs,A. Mahoney,4593361,,False,14.0,3,4,2,2,1,2,1,2,0,2,2,1,0,0,1,2,8
401408595,Yale Bulldogs,M. Feinberg,4398013,,False,2.0,0,0,0,0,0,0,0,2,0,0,0,0,0,0,0,0,0
401408595,Yale Bulldogs,M. Cotton,4398012,,False,24.0,1,6,0,3,1,3,0,0,0,2,2,0,1,0,1,0,3
401408595,Yale Bulldogs,E. Dike,4398011,,False,4.0,0,0,0,0,0,0,2,2,0,0,0,0,1,0,0,0,2
401408595,Yale Bulldogs,TEAM,TOTAL,TOTAL,False,,23,63,19,46,4,17,6,11,11,22,33,14,6,3,12,21,56
401408595,Purdue Boilermakers,M. Gillis,4431753,,True,19.0,2,5,2,4,0,1,0,0,3,0,3,2,2,0,0,0,4
401408595,Purdue Boilermakers,Z. Edey,4600663,,True,20.0,4,7,4,7,0,0,8,10,5,4,9,1,0,3,1,2,16
401408595,Purdue Boilermakers,J. Ivey,4433218,,True,28.0,6,13,3,7,3,6,7,9,0,4,4,1,2,0,3,0,22
401408595,Purdue Boilermakers,E. Hunter Jr.,4397243,,True,24.0,1,2,0,0,1,2,1,2,0,5,5,2,1,0,0,1,4
401408595,Purdue Boilermakers,S. Stefanovic,4277985,,True,22.0,2,8,0,0,2,8,0,0,0,0,0,4,0,0,0,0,6
401408595,Purdue Boilermakers,M. Frost,4592727,,False,2.0,0,0,0,0,0,0,0,0,0,0,0,0,0,0,0,0,0
401408595,Purdue Boilermakers,C. Furst,4433598,,False,21.0,2,2,1,1,1,1,5,6,1,3,4,0,2,0,0,3,10
401408595,Purdue Boilermakers,T. Williams,4397246,,False,18.0,2,5,2,4,0,1,4,4,1,9,10,4,1,0,3,2,8
401408595,Purdue Boilermakers,C. Barrett,4702333,,False,2.0,0,2,0,1,0,1,0,0,1,0,1,0,0,0,0,0,0
401408595,Purdue Boilermakers,B. Newman,4592726,,False,9.0,1,3,1,2,0,1,0,0,0,2,2,0,0,0,2,1,2
401408595,Purdue Boilermakers,E. Morton,4433151,,False,20.0,0,1,0,0,0,1,0,0,0,1,1,1,2,0,0,2,0
401408595,Purdue Boilermakers,I. Thompson,4431749,,False,13.0,2,3,2,3,0,0,2,2,0,1,1,0,0,0,0,2,6
401408595,Purdue Boilermakers,J. Wulbrun,4405098,,False,2.0,0,0,0,0,0,0,0,0,0,0,0,0,0,0,2,0,0
401408595,Purdue Boilermakers,TEAM,TOTAL,TOTAL,False,,22,51,15,29,7,22,27,33,11,31,42,15,10,3,12,13,78
401408594,Wisconsin Badgers,S. Crowl,4588201,,True,25.0,2,6,1,3,1,3,0,0,2,3,5,1,0,1,0,2,5
401408594,Wisconsin Badgers,T. Wahl,4433105,,True,37.0,7,18,7,18,0,0,1,1,3,6,9,4,2,1,2,2,15
401408594,Wisconsin Badgers,C. Hepburn,4590360,,True,33.0,3,6,2,3,1,3,1,2,1,5,6,5,1,0,0,1,8
401408594,Wisconsin Badgers,Joh. Davis,4432356,,True,37.0,8,20,4,10,4,10,5,5,1,7,8,1,2,1,1,2,25
401408594,Wisconsin Badgers,B. Davison,4277993,,True,37.0,1,5,1,4,0,1,2,2,0,2,2,4,0,0,1,2,4
401408594,Wisconsin Badgers,B. Carlson,4433166,,False,11.0,2,3,2,3,0,0,0,0,3,0,3,0,0,0,0,0,4
401408594,Wisconsin Badgers,C. Vogt,4279252,,False,15.0,3,4,3,4,0,0,0,2,1,1,2,0,0,0,1,1,6
401408594,Wisconsin Badgers,J. Neath,4432066,,False,5.0,0,0,0,0,0,0,0,0,0,0,0,0,0,0,0,0,0
401408594,Wisconsin Badgers,TEAM,TOTAL,TOTAL,False,,26,62,20,45,6,17,9,12,13,24,37,15,5,3,5,10,67
401408594,Colgate Raiders,K. Records,4593089,,True,24.0,3,6,3,6,0,0,1,2,3,4,7,0,0,0,1,1,7
401408594,Colgate Raiders,R. Moffatt,4593087,,True,31.0,1,4,0,3,1,1,0,0,1,2,3,2,0,0,0,0,3
401408594,Colgate Raiders,T. Richardson,4398040,,True,36.0,5,13,0,3,5,10,0,0,0,7,7,1,1,0,2,0,15
401408594,Colgate Raiders,J. Ferguson,4280048,,True,31.0,1,6,0,2,1,4,0,0,0,2,2,3,1,0,1,3,3
401408594,Colgate Raiders,N. Cummings,4279317,,True,34.0,8,20,6,14,2,6,2,2,2,4,6,6,0,0,2,3,20
401408594,Colgate Raiders,J. Woodward,4702503,,False,15.0,1,3,1,3,0,0,3,3,1,3,4,2,0,1,1,2,5
401408594,Colgate Raiders,S. Thomson,4702501,,False,9.0,1,1,1,1,0,0,0,0,1,2,3,0,0,0,0,1,2
401408594,Colgate Raiders,O. Lynch-Daniels,4278275,,False,20.0,2,4,1,3,1,1,0,0,1,0,1,0,0,0,3,3,5
401408594,Colgate Raiders,TEAM,TOTAL,TOTAL,False,,22,57,12,35,10,22,6,7,11,25,36,14,2,1,12,13,60
401408593,Michigan State Spartans,M. Bingham Jr.,4397212,,True,17.0,3,6,3,5,0,1,0,0,3,5,8,0,2,2,1,3,6
401408593,Michigan State Spartans,G. Brown,4397210,,True,31.0,4,10,1,2,3,8,1,2,0,1,1,3,0,0,1,0,12
401408593,Michigan State Spartans,J. Hauser,4295180,,True,34.0,9,12,5,6,4,6,5,6,2,6,8,2,1,0,0,3,27
401408593,Michigan State Spartans,M. Christie,4432582,,True,27.0,1,6,1,2,0,4,0,0,1,1,2,1,1,1,0,0,2
401408593,Michigan State Spartans,A. Hoggard,4432206,,True,22.0,6,9,6,7,0,2,2,4,0,3,3,2,0,0,2,1,14
401408593,Michigan State Spartans,M. Hall,4592693,,False,17.0,1,5,1,3,0,2,0,0,2,3,5,1,0,0,3,2,2
401408593,Michigan State Spartans,J. Marble II,4433031,,False,11.0,2,3,2,3,0,0,1,1,0,1,1,1,0,1,0,3,5
401408593,Michigan State Spartans,P. Brooks,4683731,,False,3.0,0,1,0,1,0,0,0,0,1,1,2,0,0,0,0,0,0
401408593,Michigan State Spartans,J. Akins,4683730,,False,13.0,0,2,0,1,0,1,0,0,0,1,1,0,0,0,0,0,0
401408593,Michigan State Spartans,T. Walker,4432129,,False,25.0,2,5,2,3,0,2,2,2,0,2,2,3,0,0,0,2,6
401408593,Michigan State Spartans,TEAM,TOTAL,TOTAL,False,,28,59,21,33,7,26,11,15,10,25,35,13,4,4,7,14,74
401408593,Davidson Wildcats,S. Mennenga,4700862,,True,30.0,6,12,3,7,3,5,0,2,0,5,5,1,0,1,0,1,15
401408593,Davidson Wildcats,L. Brajkovic,4396787,,True,22.0,8,10,7,8,1,2,1,3,1,3,4,2,0,0,0,4,18
401408593,Davidson Wildcats,H. Lee,4592308,,True,35.0,4,11,1,4,3,7,0,0,1,3,4,1,0,0,2,4,11
401408593,Davidson Wildcats,F. Loyer,4397208,,True,28.0,3,9,2,4,1,5,5,5,1,5,6,4,0,0,1,3,12
401408593,Davidson Wildcats,M. Jones,4396784,,True,36.0,3,6,2,2,1,4,1,2,1,5,6,3,1,0,2,2,8
401408593,Davidson Wildcats,N. Boachie-Yiadom,4396786,,False,18.0,1,3,1,3,0,0,0,0,1,0,1,0,0,1,1,1,2
401408593,Davidson Wildcats,D. Watson,4897098,,False,9.0,1,2,0,1,1,1,0,0,0,0,0,0,0,0,0,0,3
401408593,Davidson Wildcats,G. Huffman,4432522,,False,22.0,2,6,2,5,0,1,0,0,1,2,3,3,2,1,1,3,4
401408593,Davidson Wildcats,TEAM,TOTAL,TOTAL,False,,28,59,18,34,10,25,7,12,8,24,32,14,3,3,8,18,73
401408592,Duke Blue Devils,P. Banchero,4432573,,True,33.0,7,14,5,10,2,4,1,1,3,7,10,4,1,2,2,3,17
401408592,Duke Blue Devils,W. Moore Jr.,4592187,,True,29.0,5,8,2,4,3,4,0,0,1,5,6,6,1,0,2,2,13
401408592,Duke Blue Devils,M. Williams,4701232,,True,32.0,6,7,6,7,0,0,3,3,3,4,7,5,1,5,2,0,15
401408592,Duke Blue Devils,AJ Griffin,4432585,,True,33.0,4,9,2,2,2,7,0,0,0,6,6,0,0,0,1,0,10
401408592,Duke Blue Devils,J. Roach,4433135,,True,35.0,3,8,2,5,1,3,5,5,0,1,1,5,1,1,2,2,12
401408592,Duke Blue Devils,T. John,4278569,,False,8.0,1,1,1,1,0,0,0,0,1,3,4,0,1,2,0,3,2
401408592,Duke Blue Devils,B. Jones,4278348,,False,2.0,0,0,0,0,0,0,0,0,0,0,0,0,0,0,0,0,0
401408592,Duke Blue Devils,J. Baker,4395624,,False,5.0,1,3,0,1,1,2,0,0,0,0,0,0,0,0,0,1,3
401408592,Duke Blue Devils,J. Blakes,4683735,,False,2.0,0,1,0,1,0,0,0,0,0,0,0,0,0,0,0,0,0
401408592,Duke Blue Devils,T. Keels,4432645,,False,21.0,3,7,3,5,0,2,0,0,1,1,2,1,1,0,4,0,6
401408592,Duke Blue Devils,TEAM,TOTAL,TOTAL,False,,30,58,21,36,9,22,9,9,10,28,38,21,6,10,13,11,78
401408592,Cal State Fullerton Titans,V. Lee,4397342,,True,31.0,4,12,4,12,0,0,2,2,3,1,4,2,2,1,0,1,10
401408592,Cal State Fullerton Titans,E.J. Anosike,4279647,,True,36.0,4,9,4,9,0,0,2,2,5,5,10,0,0,0,1,2,10
401408592,Cal State Fullerton Titans,L. Wrightsell Jr.,4702484,,True,30.0,3,9,3,6,0,3,0,0,0,2,2,2,1,0,1,0,6
401408592,Cal State Fullerton Titans,T. San Antonio,4432108,,True,20.0,0,4,0,3,0,1,0,0,0,2,2,0,0,0,0,2,0
401408592,Cal State Fullerton Titans,D. Milstead,4280171,,True,30.0,5,9,3,6,2,3,0,0,1,4,5,3,3,0,4,1,12
401408592,Cal State Fullerton Titans,L. Laku,4703699,,False,2.0,0,1,0,1,0,0,2,2,1,0,1,0,0,0,0,0,2
401408592,Cal State Fullerton Titans,I. Doumbia,4278109,,False,3.0,0,0,0,0,0,0,0,0,0,0,0,0,0,0,0,0,0
401408592,Cal State Fullerton Titans,G. Carper,4897658,,False,2.0,1,1,1,1,0,0,0,0,0,0,0,0,0,0,0,0,2
401408592,Cal State Fullerton Titans,D. Maddox Jr.,4702487,,False,4.0,1,2,1,1,0,1,0,0,0,1,1,0,0,0,1,0,2
401408592,Cal State Fullerton Titans,J. Harris,4702482,,False,20.0,3,10,1,6,2,4,2,2,1,0,1,0,1,0,0,2,10
401408592,Cal State Fullerton Titans,T. Maddox Jr.,4397779,,False,22.0,3,7,2,2,1,5,0,0,1,1,2,3,1,0,1,2,7
401408592,Cal State Fullerton Titans,TEAM,TOTAL,TOTAL,False,,24,64,19,47,5,17,8,8,12,18,30,10,8,1,8,10,61
401408591,Jacksonville State Gamecocks,K. Henry,4593671,,True,21.0,0,9,0,6,0,3,0,0,1,3,4,0,2,0,2,2,0
401408591,Jacksonville State Gamecocks,B. Huffman,4277912,,True,26.0,3,7,3,7,0,0,3,5,5,2,7,0,0,1,0,4,9
401408591,Jacksonville State Gamecocks,J. Finch,4703243,,True,32.0,6,10,4,7,2,3,3,3,0,1,1,0,2,0,1,4,17
401408591,Jacksonville State Gamecocks,J. Gibbs,4278993,,True,36.0,5,14,1,5,4,9,6,6,2,4,6,0,0,0,0,2,20
401408591,Jacksonville State Gamecocks,D. Adams,4067814,,True,36.0,3,14,2,9,1,5,1,2,2,3,5,4,2,0,2,3,8
401408591,Jacksonville State Gamecocks,J. Pal,4703247,,False,8.0,0,0,0,0,0,0,0,0,0,0,0,0,0,0,0,1,0
401408591,Jacksonville State Gamecocks,M. Brigham Jr.,4703246,,False,1.0,0,0,0,0,0,0,0,0,0,0,0,0,0,0,1,0,0
401408591,Jacksonville State Gamecocks,J. Perdue,4433059,,False,7.0,0,0,0,0,0,0,0,0,0,2,2,0,0,0,1,1,0
401408591,Jacksonville State Gamecocks,M. Zeliznak,4398323,,False,9.0,0,0,0,0,0,0,0,0,0,2,2,0,0,0,1,4,0
401408591,Jacksonville State Gamecocks,S. Henderson,4703245,,False,1.0,1,1,0,0,1,1,0,0,0,0,0,0,0,0,0,0,3
401408591,Jacksonville State Gamecocks,D. King,4703244,,False,22.0,1,6,1,2,0,4,2,2,0,3,3,5,1,0,0,0,4
401408591,Jacksonville State Gamecocks,C. Byrd,4702737,,False,1.0,0,0,0,0,0,0,0,0,0,1,1,0,0,0,0,0,0
401408591,Jacksonville State Gamecocks,TEAM,TOTAL,TOTAL,False,,19,61,11,36,8,25,15,18,11,21,32,9,7,1,8,21,61
401408591,Auburn Tigers,J. Smith,4432639,,True,33.0,6,13,2,6,4,7,4,6,4,10,14,4,0,0,4,3,20
401408591,Auburn Tigers,W. Kessler,4433136,,True,31.0,6,11,6,10,0,1,1,4,5,5,10,1,1,9,1,2,13
401408591,Auburn Tigers,A. Flanigan,4432874,,True,24.0,3,9,3,8,0,1,4,6,1,4,5,1,1,0,2,2,10
401408591,Auburn Tigers,K. Johnson,4432363,,True,30.0,3,8,1,2,2,6,2,2,1,4,5,7,0,0,1,1,10
401408591,Auburn Tigers,Z. Jasper,4311618,,True,25.0,2,4,2,3,0,1,2,2,0,0,0,4,0,0,1,0,6
401408591,Auburn Tigers,C. Moore,4433200,,False,1.0,0,1,0,1,0,0,0,0,1,0,1,0,0,0,0,0,0
401408591,Auburn Tigers,J. Williams,4431776,,False,6.0,3,3,1,1,2,2,0,0,0,1,1,0,0,0,0,1,8
401408591,Auburn Tigers,D. Cambridge,4567588,,False,15.0,1,5,1,2,0,3,0,0,2,3,5,0,0,1,0,4,2
401408591,Auburn Tigers,D. Cardwell,4433174,,False,8.0,1,2,1,2,0,0,0,0,3,1,4,0,0,0,0,1,2
401408591,Auburn Tigers,B. Akingbola,4431873,,False,1.0,0,0,0,0,0,0,0,0,0,0,0,0,0,0,0,0,0
401408591,Auburn Tigers,L. Berman,4592748,,False,1.0,0,1,0,1,0,0,0,0,0,0,0,0,0,0,0,0,0
401408591,Auburn Tigers,W. Green Jr.,4433198,,False,24.0,3,5,2,3,1,2,2,2,0,1,1,6,0,0,1,3,9
401408591,Auburn Tigers,P. Cook,4403230,,False,1.0,0,1,0,0,0,1,0,0,0,0,0,0,0,0,0,0,0
401408591,Auburn Tigers,TEAM,TOTAL,TOTAL,False,,28,63,19,39,9,24,15,22,19,31,50,23,2,10,11,17,80
401408590,USC Trojans,I. Mobley,4432815,,True,37.0,3,11,1,5,2,6,3,6,2,3,5,8,0,0,2,2,11
401408590,USC Trojans,M. Agbonkpolo,4431700,,True,12.0,1,2,0,1,1,1,0,0,1,4,5,0,0,0,4,0,3
401408590,USC Trojans,C. Goodwin,4067218,,True,27.0,4,7,4,7,0,0,2,4,1,5,6,0,0,2,4,4,10
401408590,USC Trojans,B. Ellis,4593106,,True,14.0,1,6,0,2,1,4,0,0,1,2,3,1,1,0,3,0,3
401408590,USC Trojans,D. Peterson,4397689,,True,35.0,7,15,4,8,3,7,0,0,0,5,5,3,0,0,1,4,17
401408590,USC Trojans,J. Morgan,4431830,,False,12.0,1,1,1,1,0,0,0,0,1,3,4,0,0,0,1,0,2
401408590,USC Trojans,K. Johnson,4683857,,False,4.0,0,0,0,0,0,0,0,0,0,0,0,0,0,0,1,0,0
401408590,USC Trojans,R. Waters,4711593,,False,28.0,5,6,3,4,2,2,4,5,0,2,2,1,0,1,2,2,16
401408590,USC Trojans,E. Anderson,4431808,,False,31.0,2,2,2,2,0,0,0,0,0,5,5,4,0,0,0,4,4
401408590,USC Trojans,TEAM,TOTAL,TOTAL,False,,24,50,15,30,9,20,9,15,6,32,38,17,1,3,18,16,66
401408590,Miami Hurricanes,S. Waardenburg,4079701,,True,34.0,2,5,2,3,0,2,1,2,0,3,3,3,0,4,0,1,5
401408590,Miami Hurricanes,I. Wong,4431727,,True,24.0,7,12,7,10,0,2,8,9,0,4,4,1,1,0,1,5,22
401408590,Miami Hurricanes,J. Miller,4396818,,True,35.0,3,4,3,4,0,0,0,2,1,3,4,1,4,0,0,1,6
401408590,Miami Hurricanes,C. Moore,4066345,,True,36.0,5,11,4,7,1,4,5,6,0,3,3,4,4,0,2,3,16
401408590,Miami Hurricanes,K. McGusty,4066310,,True,37.0,5,18,5,15,0,3,2,2,1,5,6,2,1,0,0,2,12
401408590,Miami Hurricanes,A. Walker,4592205,,False,11.0,1,3,1,2,0,1,1,2,0,2,2,1,0,0,0,2,3
401408590,Miami Hurricanes,W. Poplar,4897397,,False,8.0,1,2,1,1,0,1,0,0,1,1,2,0,1,0,0,0,2
401408590,Miami Hurricanes,B. Joseph,4683753,,False,15.0,0,1,0,0,0,1,2,2,0,1,1,1,1,0,0,0,2
401408590,Miami Hurricanes,TEAM,TOTAL,TOTAL,False,,24,56,23,42,1,14,19,25,3,23,26,13,12,4,3,14,68
401408589,Saint Mary's Gaels,K. Bowen,4431902,,True,20.0,0,0,0,0,0,0,0,0,1,1,2,0,0,0,0,1,0
401408589,Saint Mary's Gaels,M. Tass,4397724,,True,25.0,6,10,6,10,0,0,0,0,5,2,7,4,0,1,1,3,12
401408589,Saint Mary's Gaels,A. Ducas,4432971,,True,30.0,5,10,2,4,3,6,0,0,0,4,4,1,2,0,1,0,13
401408589,Saint Mary's Gaels,L. Johnson,4396608,,True,34.0,8,13,7,12,1,1,3,4,0,6,6,1,3,0,1,2,20
401408589,Saint Mary's Gaels,T. Kuhse,4066735,,True,32.0,6,15,3,9,3,6,4,4,0,2,2,6,1,0,3,0,19
401408589,Saint Mary's Gaels,J. Brown,4433193,,False,5.0,0,0,0,0,0,0,0,0,0,0,0,0,0,0,0,0,0
401408589,Saint Mary's Gaels,D. Fotu,4397722,,False,16.0,2,3,1,1,1,2,2,2,0,5,5,0,0,1,0,1,7
401408589,Saint Mary's Gaels,L. Barrett,4701184,,False,3.0,0,1,0,0,0,1,0,2,1,1,2,0,0,0,0,0,0
401408589,Saint Mary's Gaels,M. Saxen,4701182,,False,15.0,2,3,2,3,0,0,1,2,2,3,5,0,0,1,0,3,5
401408589,Saint Mary's Gaels,A. Marciulionis,4897197,,False,8.0,0,1,0,0,0,1,0,1,0,2,2,3,1,0,2,1,0
401408589,Saint Mary's Gaels,L. Bockler,4701183,,False,4.0,1,2,0,0,1,2,0,0,0,1,1,1,1,0,0,1,3
401408589,Saint Mary's Gaels,J. Mullins,4701181,,False,8.0,1,2,0,0,1,2,0,0,0,0,0,0,0,0,1,2,3
401408589,Saint Mary's Gaels,TEAM,TOTAL,TOTAL,False,,31,60,21,39,10,21,10,15,10,29,39,16,8,3,10,14,82
401408589,Indiana Hoosiers,T. Jackson-Davis,4431684,,True,31.0,5,10,5,10,0,0,2,2,0,5,5,2,0,1,1,0,12
401408589,Indiana Hoosiers,M. Kopp,4397231,,True,22.0,0,4,0,3,0,1,0,0,0,1,1,0,0,0,0,1,0
401408589,Indiana Hoosiers,R. Thompson,4277947,,True,21.0,1,6,1,5,0,1,1,2,2,2,4,0,1,1,2,4,3
401408589,Indiana Hoosiers,X. Johnson,4395669,,True,26.0,3,8,3,8,0,0,5,6,0,2,2,5,2,0,5,4,11
401408589,Indiana Hoosiers,P. Stewart,4278013,,True,19.0,1,4,0,2,1,2,0,0,0,2,2,0,0,0,0,0,3
401408589,Indiana Hoosiers,M. Durr,4396642,,False,5.0,1,1,1,1,0,0,0,0,0,0,0,0,0,0,0,0,2
401408589,Indiana Hoosiers,J. Geronimo,4432512,,False,21.0,3,6,2,5,1,1,2,2,3,3,6,1,0,0,1,3,9
401408589,Indiana Hoosiers,L. Duncomb,4682856,,False,3.0,0,0,0,0,0,0,0,0,0,1,1,0,1,0,1,1,0
401408589,Indiana Hoosiers,K. Lander,4702150,,False,6.0,1,3,1,2,0,1,0,0,0,0,0,0,1,0,0,1,2
401408589,Indiana Hoosiers,T. Bates,4683933,,False,17.0,2,5,2,5,0,0,3,4,0,1,1,0,0,0,1,2,7
401408589,Indiana Hoosiers,A. Leal,4574701,,False,5.0,0,0,0,0,0,0,2,2,0,1,1,0,0,0,0,0,2
401408589,Indiana Hoosiers,T. Galloway,4432315,,False,8.0,1,1,1,1,0,0,0,0,0,1,1,0,0,0,2,1,2
401408589,Indiana Hoosiers,R. Phinisee,4397010,,False,16.0,0,5,0,1,0,4,0,0,0,1,1,0,0,0,0,1,0
401408589,Indiana Hoosiers,TEAM,TOTAL,TOTAL,False,,18,53,16,43,2,10,15,18,6,22,28,8,5,2,13,18,53
401408588,Memphis Tigers,D. Williams,4397355,,True,32.0,7,8,7,7,0,1,0,0,1,4,5,0,0,0,4,3,14
401408588,Memphis Tigers,J. Duren,4433621,,True,30.0,4,11,4,11,0,0,2,2,5,6,11,1,1,1,2,3,10
401408588,Memphis Tigers,L. Quinones,4431720,,True,28.0,3,6,2,5,1,1,1,2,2,0,2,1,0,0,2,1,8
401408588,Memphis Tigers,A. Lomax,4396633,,True,30.0,2,5,1,3,1,2,4,5,0,5,5,5,1,0,2,2,9
401408588,Memphis Tigers,L. Nolley II,4395684,,True,32.0,4,9,2,4,2,5,2,2,1,4,5,1,2,0,1,3,12
401408588,Memphis Tigers,M. Dandridge,4431738,,False,10.0,1,3,1,3,0,0,0,1,2,3,5,1,0,1,1,0,2
401408588,Memphis Tigers,J. Minott,4687718,,False,4.0,1,2,1,1,0,1,0,0,0,1,1,0,0,0,1,0,2
401408588,Memphis Tigers,E. Bates,4433620,,False,3.0,1,1,0,0,1,1,0,0,0,0,0,0,0,0,0,1,3
401408588,Memphis Tigers,C. Lawson,4431721,,False,4.0,0,1,0,1,0,0,0,0,0,0,0,1,0,0,0,0,0
401408588,Memphis Tigers,E. Timberlake,4432193,,False,12.0,0,1,0,1,0,0,2,2,0,2,2,2,0,0,0,3,2
401408588,Memphis Tigers,J. Hardaway,4396635,,False,4.0,0,0,0,0,0,0,0,0,0,0,0,0,0,0,1,0,0
401408588,Memphis Tigers,T. Harris,4396632,,False,11.0,1,4,1,3,0,1,0,0,0,0,0,0,1,0,1,2,2
401408588,Memphis Tigers,TEAM,TOTAL,TOTAL,False,,24,51,19,39,5,12,11,14,12,27,39,12,5,2,15,18,64
401408588,Boise State Broncos,T. Degenhart,4898260,,True,30.0,3,5,1,2,2,3,0,0,2,2,4,1,0,0,2,0,8
401408588,Boise State Broncos,M. Armus,4280022,,True,28.0,1,2,1,2,0,0,1,5,4,7,11,0,1,0,3,1,3
401408588,Boise State Broncos,A. Kigab,4278513,,True,34.0,6,16,4,11,2,5,6,7,0,3,3,2,2,0,0,4,20
401408588,Boise State Broncos,M. Shaver Jr.,4280208,,True,31.0,1,10,1,6,0,4,2,2,1,1,2,1,1,0,0,2,4
401408588,Boise State Broncos,E. Akot,4278131,,True,32.0,3,12,2,6,1,6,0,1,0,0,0,0,0,0,1,3,7
401408588,Boise State Broncos,N. Smith,4702873,,False,13.0,1,3,1,2,0,1,4,4,2,2,4,1,2,0,2,2,6
401408588,Boise State Broncos,L. Milner,4702874,,False,9.0,1,3,1,3,0,0,0,0,3,1,4,0,0,1,0,1,2
401408588,Boise State Broncos,M. Rice,4397263,,False,23.0,1,3,0,1,1,2,0,0,0,2,2,2,3,0,0,1,3
401408588,Boise State Broncos,TEAM,TOTAL,TOTAL,False,,17,54,11,33,6,21,13,19,12,18,30,7,9,1,10,14,53
401408587,UCLA Bruins,C. Riley,4278525,,True,23.0,1,4,1,4,0,0,0,0,2,6,8,0,1,1,0,3,2
401408587,UCLA Bruins,J. Jaquez Jr.,4432848,,True,37.0,3,10,2,6,1,4,8,9,3,6,9,6,2,1,1,1,15
401408587,UCLA Bruins,J. Juzang,4432817,,True,29.0,3,11,2,7,1,4,2,2,0,5,5,2,3,1,1,0,9
401408587,UCLA Bruins,T. Campbell,4397128,,True,38.0,6,12,3,6,3,6,1,1,0,1,1,5,0,0,2,1,16
401408587,UCLA Bruins,J. Bernard,4397127,,True,36.0,4,11,2,5,2,6,0,0,2,2,4,1,2,1,2,0,10
401408587,UCLA Bruins,M. Johnson,4277987,,False,9.0,0,0,0,0,0,0,0,0,0,1,1,0,0,1,1,3,0
401408587,UCLA Bruins,P. Watson,4576087,,False,6.0,2,3,1,2,1,1,0,0,0,0,0,0,0,0,0,1,5
401408587,UCLA Bruins,J. Clark,4432247,,False,16.0,0,1,0,1,0,0,0,1,0,0,0,0,1,1,0,2,0
401408587,UCLA Bruins,D. Singleton,4397131,,False,6.0,0,2,0,1,0,1,0,0,0,0,0,0,0,0,0,0,0
401408587,UCLA Bruins,TEAM,TOTAL,TOTAL,False,,19,54,11,32,8,22,11,13,11,23,34,14,9,6,8,11,57
401408587,Akron Zips,E. Freeman,4592699,,True,24.0,5,6,5,6,0,0,4,4,2,8,10,1,1,0,3,5,14
401408587,Akron Zips,M. Dawson,4609661,,True,31.0,1,4,1,2,0,2,0,0,3,2,5,1,1,0,1,1,2
401408587,Akron Zips,A. Ali,4592700,,True,36.0,2,10,1,6,1,4,0,0,0,1,1,1,1,1,1,1,5
401408587,Akron Zips,G. Tribble,4592697,,True,27.0,2,7,2,6,0,1,1,1,0,4,4,0,0,0,3,1,5
401408587,Akron Zips,X. Castaneda,4396641,,True,33.0,8,17,6,10,2,7,0,0,0,6,6,1,1,0,1,3,18
401408587,Akron Zips,A. Bandaogo,4703576,,False,13.0,1,2,1,2,0,0,0,1,1,2,3,0,0,0,0,1,2
401408587,Akron Zips,M. Wynn,4395689,,False,16.0,0,3,0,2,0,1,0,0,0,1,1,0,0,1,1,2,0
401408587,Akron Zips,G. Clarke,4433221,,False,20.0,2,4,1,2,1,2,2,2,2,2,4,0,2,0,0,1,7
401408587,Akron Zips,TEAM,TOTAL,TOTAL,False,,21,53,17,36,4,17,7,8,8,26,34,4,6,2,10,15,53
401408586,Gonzaga Bulldogs,D. Timme,4431695,,True,27.0,13,21,13,20,0,1,6,13,5,8,13,2,1,0,2,2,32
401408586,Gonzaga Bulldogs,C. Holmgren,4433255,,True,29.0,8,13,8,11,0,2,3,5,4,13,17,5,2,7,0,3,19
401408586,Gonzaga Bulldogs,J. Strawther,4432181,,True,19.0,1,5,1,2,0,3,1,2,1,2,3,1,0,0,0,2,3
401408586,Gonzaga Bulldogs,R. Bolton,4397242,,True,30.0,3,5,1,1,2,4,2,2,0,0,0,2,0,0,2,1,10
401408586,Gonzaga Bulldogs,A. Nembhard,4395712,,True,37.0,3,7,0,2,3,5,0,0,1,5,6,11,1,0,3,1,9
401408586,Gonzaga Bulldogs,B. Gregg,4711313,,False,3.0,0,0,0,0,0,0,0,0,0,0,0,0,0,0,0,0,0
401408586,Gonzaga Bulldogs,A. Watson,4431705,,False,20.0,4,9,4,9,0,0,2,4,3,3,6,1,1,0,0,1,10
401408586,Gonzaga Bulldogs,J. Few,4898367,,False,1.0,0,1,0,1,0,0,0,0,1,0,1,0,0,0,0,0,0
401408586,Gonzaga Bulldogs,N. Hickman,4683737,,False,14.0,1,4,1,2,0,2,0,0,0,3,3,0,0,1,0,3,2
401408586,Gonzaga Bulldogs,W. Graves,4597889,,False,1.0,0,0,0,0,0,0,0,0,0,0,0,0,0,0,0,0,0
401408586,Gonzaga Bulldogs,H. Sallis,4433281,,False,15.0,2,3,2,3,0,0,1,2,0,2,2,1,0,1,0,3,5
401408586,Gonzaga Bulldogs,M. Arlauskas,4431887,,False,3.0,1,2,1,2,0,0,1,2,1,1,2,0,0,0,0,1,3
401408586,Gonzaga Bulldogs,M. Lang,4397665,,False,1.0,0,1,0,0,0,1,0,0,0,0,0,0,0,0,0,1,0
401408586,Gonzaga Bulldogs,TEAM,TOTAL,TOTAL,False,,36,71,31,53,5,18,16,30,16,38,54,23,5,9,7,18,93
401408586,Georgia State Panthers,J. Thomas,4593903,,True,26.0,4,11,4,11,0,0,4,4,4,5,9,1,1,2,0,5,12
401408586,Georgia State Panthers,E. Nsoseme,4278220,,True,8.0,1,1,1,1,0,0,0,0,1,4,5,0,0,0,1,2,2
401408586,Georgia State Panthers,J. Roberts,4397535,,True,33.0,4,13,4,11,0,2,3,4,3,3,6,5,1,0,1,3,11
401408586,Georgia State Panthers,K. Williams,4280167,,True,32.0,3,10,3,10,0,0,6,8,1,2,3,3,2,0,1,2,12
401408586,Georgia State Panthers,C. Allen,4067418,,True,33.0,5,19,1,9,4,10,2,2,0,1,1,2,0,0,0,1,16
401408586,Georgia State Panthers,J. Hudson,4897218,,False,18.0,2,4,1,3,1,1,0,0,2,3,5,0,0,1,3,5,5
401408586,Georgia State Panthers,C. Ma,4897217,,False,6.0,0,1,0,1,0,0,0,0,0,0,0,0,0,0,0,1,0
401408586,Georgia State Panthers,K. Scott,4702111,,False,10.0,2,5,2,5,0,0,1,1,1,2,3,1,0,1,0,5,5
401408586,Georgia State Panthers,C. Moore,4702110,,False,15.0,0,1,0,1,0,0,2,3,0,0,0,0,0,0,1,1,2
401408586,Georgia State Panthers,E. Johnson,4702109,,False,14.0,2,4,1,1,1,3,2,3,0,4,4,0,1,0,0,0,7
401408586,Georgia State Panthers,D. Stubbs,4683628,,False,3.0,0,0,0,0,0,0,0,0,0,0,0,0,0,1,0,0,0
401408586,Georgia State Panthers,K. Brooks,4593901,,False,2.0,0,1,0,1,0,0,0,0,0,0,0,0,0,0,0,0,0
401408586,Georgia State Panthers,TEAM,TOTAL,TOTAL,False,,23,70,17,54,6,16,20,25,13,28,41,12,5,5,7,25,72
401408585,Norfolk State Spartans,D. Tate,4397180,,True,18.0,0,5,0,2,0,3,0,0,1,0,1,0,1,0,1,1,0
401408585,Norfolk State Spartans,K. Bankston,4280289,,True,18.0,1,2,1,2,0,0,1,2,3,0,3,3,0,0,0,4,3
401408585,Norfolk State Spartans,T. Jenkins,4595430,,True,29.0,3,7,2,4,1,3,0,0,1,0,1,1,1,0,1,0,7
401408585,Norfolk State Spartans,C. Ings,4431996,,True,28.0,2,8,1,3,1,5,0,0,1,2,3,2,2,0,2,2,5
401408585,Norfolk State Spartans,J. Bryant Jr.,4398206,,True,35.0,5,15,3,11,2,4,3,4,1,4,5,0,0,0,4,2,15
401408585,Norfolk State Spartans,N. Chambers,4593404,,False,15.0,0,0,0,0,0,0,4,4,1,3,4,0,0,0,0,3,4
401408585,Norfolk State Spartans,C. Ford,4398209,,False,15.0,3,4,3,4,0,0,0,0,4,1,5,0,0,1,1,1,6
401408585,Norfolk State Spartans,J. Hawkins,4593134,,False,2.0,0,1,0,0,0,1,0,0,0,1,1,0,0,0,0,0,0
401408585,Norfolk State Spartans,T. Jones,4898280,,False,23.0,4,10,3,7,1,3,0,0,1,0,1,0,2,0,3,2,9
401408585,Norfolk State Spartans,A. Bottoms,4704103,,False,2.0,0,0,0,0,0,0,0,0,0,0,0,1,0,0,0,0,0
401408585,Norfolk State Spartans,Y. Sidibe,4595433,,False,2.0,0,0,0,0,0,0,0,0,0,0,0,0,0,0,0,1,0
401408585,Norfolk State Spartans,D. Anderson,4593406,,False,13.0,0,5,0,2,0,3,0,0,0,0,0,0,0,0,0,1,0
401408585,Norfolk State Spartans,TEAM,TOTAL,TOTAL,False,,18,57,13,35,5,22,8,10,15,14,29,7,6,1,15,17,49
401408585,Baylor Bears,F. Thamba,4395692,,True,25.0,7,9,7,9,0,0,0,3,3,3,6,1,2,1,1,2,14
401408585,Baylor Bears,M. Mayer,4395697,,True,27.0,8,12,4,5,4,7,2,2,2,4,6,1,2,1,4,2,22
401408585,Baylor Bears,K. Brown,4433254,,True,20.0,2,4,2,3,0,1,0,0,3,0,3,1,0,0,1,2,4
401408585,Baylor Bears,A. Flagler,4397654,,True,22.0,4,7,2,2,2,5,1,2,0,0,0,3,1,0,0,2,11
401408585,Baylor Bears,J. Akinjo,4397072,,True,35.0,2,6,0,1,2,5,4,4,0,4,4,10,0,0,3,2,10
401408585,Baylor Bears,A. Sacks,4701188,,False,2.0,0,1,0,0,0,1,0,0,0,0,0,0,0,0,0,0,0
401408585,Baylor Bears,J. Sochan,4610139,,False,27.0,6,9,4,5,2,4,1,2,1,6,7,3,1,1,1,3,15
401408585,Baylor Bears,J. Turner,4592207,,False,10.0,2,3,1,1,1,2,1,2,1,5,6,0,0,0,0,0,6
401408585,Baylor Bears,Z. Loveday,4432284,,False,6.0,0,0,0,0,0,0,1,4,0,0,0,0,0,0,0,1,1
401408585,Baylor Bears,D. Bonner,4601289,,False,26.0,0,3,0,1,0,2,2,2,1,0,1,5,0,0,0,0,2
401408585,Baylor Bears,TEAM,TOTAL,TOTAL,False,,31,54,20,27,11,27,12,21,13,25,38,24,6,3,10,14,85
401408584,San Diego State Aztecs,K. Johnson,4431786,,True,26.0,3,5,3,3,0,2,0,0,2,0,2,2,1,1,1,1,6
401408584,San Diego State Aztecs,N. Mensah,4397371,,True,13.0,0,1,0,1,0,0,0,0,0,2,2,0,0,2,0,5,0
401408584,San Diego State Aztecs,T. Pulliam,4593083,,True,37.0,6,14,4,12,2,2,0,2,1,2,3,3,2,0,5,1,14
401408584,San Diego State Aztecs,L. Butler,4433183,,True,17.0,1,2,0,0,1,2,0,0,1,5,6,2,0,0,2,4,3
401408584,San Diego State Aztecs,M. Bradley,4397049,,True,35.0,6,19,6,14,0,5,4,7,4,4,8,3,0,1,4,4,16
401408584,San Diego State Aztecs,A. Arop,4397368,,False,31.0,3,7,3,6,0,1,0,1,2,0,2,2,3,1,0,1,6
401408584,San Diego State Aztecs,T. Diabate,4280209,,False,11.0,1,2,1,2,0,0,0,0,0,1,1,1,0,1,0,2,2
401408584,San Diego State Aztecs,J. Tomaic,4066375,,False,10.0,0,1,0,0,0,1,0,0,1,0,1,0,0,0,0,1,0
401408584,San Diego State Aztecs,C. Baker-Mazara,4897532,,False,17.0,5,8,4,6,1,2,6,7,0,3,3,1,0,0,1,1,17
401408584,San Diego State Aztecs,A. Seiko,4278704,,False,28.0,2,5,1,1,1,4,0,0,0,2,2,0,1,0,2,0,5
401408584,San Diego State Aztecs,TEAM,TOTAL,TOTAL,False,,27,64,22,45,5,19,10,17,11,21,32,14,7,6,16,20,69
401408584,Creighton Bluejays,R. Hawkins,4897413,,True,45.0,4,11,4,8,0,3,2,3,2,6,8,1,3,0,6,2,10
401408584,Creighton Bluejays,A. Kaluma,4433599,,True,44.0,3,10,2,4,1,6,5,6,1,5,6,1,1,0,5,4,12
401408584,Creighton Bluejays,R. Kalkbrenner,4576060,,True,40.0,5,8,5,8,0,0,6,6,6,4,10,3,1,0,0,1,16
401408584,Creighton Bluejays,T. Alexander,4433268,,True,29.0,7,15,7,13,0,2,4,5,0,4,4,5,2,0,4,4,18
401408584,Creighton Bluejays,A. O'Connell,4277846,,True,41.0,6,11,5,8,1,3,2,2,2,6,8,2,1,0,3,5,15
401408584,Creighton Bluejays,K. Feazell,4278099,,False,6.0,0,0,0,0,0,0,1,2,0,0,0,1,1,0,0,0,1
401408584,Creighton Bluejays,R. Andronikashvili,4701555,,False,20.0,0,1,0,1,0,0,0,0,0,3,3,1,0,0,2,1,0
401408584,Creighton Bluejays,TEAM,TOTAL,TOTAL,False,,25,56,23,42,2,14,20,24,12,29,41,14,9,0,20,17,72
401408583,North Carolina Tar Heels,A. Bacot,4431674,,True,28.0,6,13,6,13,0,0,5,5,4,6,10,3,1,1,1,0,17
401408583,North Carolina Tar Heels,B. Manek,4277902,,True,33.0,10,15,5,5,5,10,3,3,3,8,11,3,0,2,2,2,28
401408583,North Carolina Tar Heels,L. Black,4395650,,True,34.0,2,4,2,3,0,1,0,0,2,5,7,8,2,0,2,1,4
401408583,North Carolina Tar Heels,R.J. Davis,4433176,,True,30.0,1,10,0,5,1,5,1,2,1,3,4,12,0,0,1,0,4
401408583,North Carolina Tar Heels,C. Love,4433144,,True,34.0,6,15,0,2,6,13,5,7,0,3,3,1,0,0,2,1,23
401408583,North Carolina Tar Heels,D. Farris,4701848,,False,1.0,0,0,0,0,0,0,0,0,0,0,0,0,0,0,0,0,0
401408583,North Carolina Tar Heels,J. McKoy,4432058,,False,4.0,0,2,0,1,0,1,0,0,0,0,0,0,0,0,0,0,0
401408583,North Carolina Tar Heels,R. McAdoo,4278388,,False,1.0,0,1,0,0,0,1,0,0,0,1,1,0,0,0,0,0,0
401408583,North Carolina Tar Heels,C. Lebo,4701847,,False,1.0,0,1,0,0,0,1,0,0,0,0,0,0,1,0,0,0,0
401408583,North Carolina Tar Heels,P. Johnson,4701846,,False,13.0,5,7,4,5,1,2,0,0,0,3,3,0,0,1,0,3,11
401408583,North Carolina Tar Heels,D. Dunn,4683638,,False,3.0,0,1,0,1,0,0,0,0,0,0,0,1,0,0,0,1,0
401408583,North Carolina Tar Heels,D. Styles,4611413,,False,15.0,3,3,3,3,0,0,0,0,1,5,6,1,0,0,2,2,6
401408583,North Carolina Tar Heels,K. Walton,4567079,,False,3.0,1,2,1,1,0,1,0,0,1,0,1,0,0,0,0,1,2
401408583,North Carolina Tar Heels,TEAM,TOTAL,TOTAL,False,,34,74,21,39,13,35,14,17,15,37,52,29,4,4,10,11,95
401408583,Marquette Golden Eagles,O. Prosper,4595400,,True,27.0,6,10,2,2,4,8,0,0,0,3,3,0,1,0,1,1,16
401408583,Marquette Golden Eagles,J. Lewis,4432239,,True,26.0,2,15,0,8,2,7,0,0,3,5,8,1,1,1,1,1,6
401408583,Marquette Golden Eagles,K. Kuath,4397028,,True,17.0,3,5,3,5,0,0,0,0,2,3,5,0,0,5,0,2,6
401408583,Marquette Golden Eagles,T. Kolek,4433225,,True,28.0,1,5,0,1,1,4,0,0,0,1,1,10,0,0,0,0,3
401408583,Marquette Golden Eagles,D. Morsell,4277954,,True,26.0,5,12,5,9,0,3,1,4,1,6,7,1,0,0,2,4,11
401408583,Marquette Golden Eagles,D. Joplin,4684306,,False,14.0,2,4,2,3,0,1,0,1,1,3,4,1,0,0,0,2,4
401408583,Marquette Golden Eagles,M. Kennedy,4592467,,False,1.0,0,1,0,0,0,1,0,0,0,0,0,0,0,0,0,0,0
401408583,Marquette Golden Eagles,O. Ighodaro,4601023,,False,19.0,3,8,3,8,0,0,2,2,2,0,2,1,2,1,3,3,8
401408583,Marquette Golden Eagles,C. Brown,4897414,,False,1.0,0,0,0,0,0,0,0,0,0,0,0,0,0,0,0,0,0
401408583,Marquette Golden Eagles,E. Ellis,4698721,,False,5.0,0,2,0,1,0,1,0,1,0,1,1,0,0,0,0,0,0
401408583,Marquette Golden Eagles,K. Jones,4697268,,False,13.0,1,4,0,0,1,4,0,0,0,0,0,0,0,0,0,1,3
401408583,Marquette Golden Eagles,S. Mitchell,4683840,,False,11.0,3,3,3,3,0,0,0,0,0,1,1,1,1,0,2,1,6
401408583,Marquette Golden Eagles,B. Carney,4592466,,False,1.0,0,1,0,0,0,1,0,0,0,0,0,0,0,0,0,0,0
401408583,Marquette Golden Eagles,G. Elliott,4278570,,False,11.0,0,3,0,2,0,1,0,0,1,0,1,0,0,0,0,0,0
401408583,Marquette Golden Eagles,TEAM,TOTAL,TOTAL,False,,26,73,18,42,8,31,3,8,13,24,37,15,5,7,10,15,63
401408582,Texas Southern Tigers,J. Nicholas,4278623,,True,22.0,3,9,3,9,0,0,1,2,3,6,9,2,0,1,2,3,7
401408582,Texas Southern Tigers,B. Gresham,4066799,,True,25.0,4,7,4,6,0,1,1,2,0,4,4,0,1,0,2,2,9
401408582,Texas Southern Tigers,A. Lawson,4897771,,True,30.0,1,6,1,3,0,3,0,0,1,5,6,3,0,0,0,2,2
401408582,Texas Southern Tigers,B. Etienne,4594120,,True,17.0,2,7,1,5,1,2,0,0,0,1,1,0,2,0,1,0,5
401408582,Texas Southern Tigers,P. Henry,4431987,,True,24.0,2,5,2,3,0,2,2,2,0,1,1,2,2,0,5,1,6
401408582,Texas Southern Tigers,Y. Rasas,4594119,,False,9.0,0,3,0,3,0,0,2,2,0,0,0,0,0,1,1,2,2
401408582,Texas Southern Tigers,J. Walker III,4278121,,False,22.0,5,11,4,9,1,2,2,2,1,2,3,0,1,4,2,2,13
401408582,Texas Southern Tigers,J. Hopkins,4067629,,False,13.0,0,1,0,0,0,1,1,2,1,0,1,1,0,0,1,1,1
401408582,Texas Southern Tigers,J. Gilliam,4397615,,False,20.0,1,6,1,5,0,1,1,1,1,2,3,4,0,0,0,0,3
401408582,Texas Southern Tigers,J. Jones,4278696,,False,18.0,1,3,0,1,1,2,5,6,0,1,1,0,0,0,0,1,8
401408582,Texas Southern Tigers,TEAM,TOTAL,TOTAL,False,,19,58,16,44,3,14,15,19,8,24,32,12,6,6,16,14,56
401408582,Kansas Jayhawks,J. Wilson,4431714,,True,20.0,5,9,4,5,1,4,0,0,2,4,6,3,1,0,2,4,11
401408582,Kansas Jayhawks,D. McCormack,4397019,,True,23.0,4,6,4,6,0,0,1,2,0,7,7,1,1,0,2,3,9
401408582,Kansas Jayhawks,D. Harris,4431983,,True,29.0,5,6,3,4,2,2,0,0,0,2,2,3,2,0,1,1,12
401408582,Kansas Jayhawks,C. Braun,4431767,,True,31.0,5,12,1,7,4,5,0,2,2,3,5,4,1,0,2,2,14
401408582,Kansas Jayhawks,O. Agbaji,4397018,,True,33.0,5,14,4,9,1,5,0,0,0,6,6,0,0,1,5,2,11
401408582,Kansas Jayhawks,Z. Clemence,4683146,,False,9.0,1,7,1,4,0,3,0,1,2,1,3,3,1,0,0,1,2
401408582,Kansas Jayhawks,K.J. Adams,4433259,,False,7.0,0,0,0,0,0,0,0,0,1,1,2,0,0,0,1,1,0
401408582,Kansas Jayhawks,M. Lightfoot,4066300,,False,7.0,1,1,1,1,0,0,1,1,1,3,4,1,0,0,0,1,3
401408582,Kansas Jayhawks,J. Yesufu,4431856,,False,10.0,0,0,0,0,0,0,0,0,0,1,1,1,0,0,0,3,0
401408582,Kansas Jayhawks,R. Martin,4278133,,False,21.0,6,8,5,7,1,1,2,3,1,0,1,4,2,0,0,1,15
401408582,Kansas Jayhawks,C. Teahan,4277893,,False,3.0,0,1,0,1,0,0,0,0,0,0,0,0,0,0,0,0,0
401408582,Kansas Jayhawks,J. Coleman-Lands,3911842,,False,7.0,2,4,0,1,2,3,0,0,2,0,2,0,0,0,2,2,6
401408582,Kansas Jayhawks,TEAM,TOTAL,TOTAL,False,,34,68,23,45,11,23,4,9,13,31,44,20,8,1,15,21,83
401408581,Michigan Wolverines,C. Houstan,4433623,,True,36.0,5,11,2,3,3,8,0,0,1,4,5,2,0,0,1,0,13
401408581,Michigan Wolverines,M. Diabate,4433249,,True,27.0,2,4,2,4,0,0,3,4,2,7,9,2,0,0,2,4,7
401408581,Michigan Wolverines,H. Dickinson,4432180,,True,35.0,8,10,8,9,0,1,5,5,1,5,6,1,1,4,4,1,21
401408581,Michigan Wolverines,F. Collins,4433616,,True,31.0,6,7,5,5,1,2,1,1,0,6,6,2,1,0,1,4,14
401408581,Michigan Wolverines,E. Brooks,4277960,,True,40.0,5,13,5,12,0,1,6,8,1,6,7,6,2,0,3,1,16
401408581,Michigan Wolverines,T. Williams II,4702236,,False,9.0,0,1,0,0,0,1,2,2,0,1,1,1,0,0,1,0,2
401408581,Michigan Wolverines,B. Johns Jr.,4397206,,False,13.0,0,0,0,0,0,0,0,0,0,1,1,1,1,0,1,1,0
401408581,Michigan Wolverines,K. Bufkin,4683736,,False,9.0,0,2,0,1,0,1,2,2,0,0,0,0,0,0,2,0,2
401408581,Michigan Wolverines,TEAM,TOTAL,TOTAL,False,,26,48,22,34,4,14,19,22,6,30,36,15,5,4,15,11,75
401408581,Colorado State Rams,D. Thomas,4593040,,True,24.0,5,9,0,2,5,7,0,0,0,1,1,1,2,0,1,2,15
401408581,Colorado State Rams,J. Tonje,4593043,,True,21.0,1,9,1,5,0,4,0,0,1,2,3,1,0,0,0,1,2
401408581,Colorado State Rams,D. Roddy,4593041,,True,38.0,5,11,4,5,1,6,2,4,2,4,6,4,1,0,2,5,13
401408581,Colorado State Rams,I. Stevens,4432117,,True,29.0,3,11,1,7,2,4,0,0,0,5,5,4,1,0,0,5,8
401408581,Colorado State Rams,K. Moore,4397269,,True,29.0,3,7,1,2,2,5,2,2,1,1,2,3,3,0,2,2,10
401408581,Colorado State Rams,J. Moors,4593039,,False,11.0,1,4,1,4,0,0,0,0,3,1,4,0,0,0,2,1,2
401408581,Colorado State Rams,A. Thistlewood,4397271,,False,1.0,0,0,0,0,0,0,0,0,0,0,0,0,0,0,0,0,0
401408581,Colorado State Rams,J. Lake,4897514,,False,16.0,2,6,0,1,2,5,0,0,0,0,0,2,1,0,0,0,6
401408581,Colorado State Rams,C. Jacobs,4897513,,False,22.0,3,7,3,4,0,3,1,1,1,1,2,1,2,0,2,2,7
401408581,Colorado State Rams,I. Rivera,4703224,,False,9.0,0,1,0,0,0,1,0,0,1,0,1,0,0,0,0,1,0
401408581,Colorado State Rams,TEAM,TOTAL,TOTAL,False,,23,65,11,30,12,35,5,7,9,16,25,16,10,0,11,19,63
401408580,Tennessee Volunteers,B. Huntley-Hatfield,4432680,,True,19.0,3,5,3,5,0,0,1,1,1,3,4,0,1,0,1,1,7
401408580,Tennessee Volunteers,U. Plavsic,4397023,,True,14.0,2,3,2,3,0,0,0,0,0,2,2,1,2,0,1,1,4
401408580,Tennessee Volunteers,S. Vescovi,4609299,,True,29.0,6,10,0,2,6,8,0,0,0,0,0,7,4,0,1,2,18
401408580,Tennessee Volunteers,K. Chandler,4432646,,True,27.0,4,8,1,4,3,4,2,4,1,4,5,5,4,0,3,2,13
401408580,Tennessee Volunteers,J. James,4431685,,True,31.0,6,9,3,3,3,6,2,2,0,9,9,2,0,1,0,0,17
401408580,Tennessee Volunteers,J. Aidoo,4684682,,False,4.0,0,2,0,2,0,0,0,0,0,3,3,1,1,0,0,0,0
401408580,Tennessee Volunteers,J. Fulkerson,4066215,,False,16.0,7,8,7,8,0,0,1,2,1,1,2,2,1,0,0,3,15
401408580,Tennessee Volunteers,Q. Diboundje,4896479,,False,3.0,0,1,0,1,0,0,0,0,0,0,0,1,0,0,1,0,0
401408580,Tennessee Volunteers,Z. Zeigler,4883573,,False,24.0,3,5,1,1,2,4,2,2,0,0,0,6,0,0,3,2,10
401408580,Tennessee Volunteers,J. Mashack,4683934,,False,9.0,1,1,1,1,0,0,0,0,0,1,1,0,0,0,1,1,2
401408580,Tennessee Volunteers,J. Powell,4432250,,False,4.0,0,0,0,0,0,0,0,0,0,0,0,0,0,0,0,1,0
401408580,Tennessee Volunteers,V. Bailey Jr.,4278512,,False,20.0,1,3,1,1,0,2,0,0,2,0,2,4,0,0,1,1,2
401408580,Tennessee Volunteers,TEAM,TOTAL,TOTAL,False,,33,55,19,31,14,24,8,11,5,27,32,29,13,1,12,14,88
401408580,Longwood Lancers,J. Granlund,4702126,,True,22.0,1,2,1,1,0,1,0,0,1,2,3,1,0,0,0,1,2
401408580,Longwood Lancers,Z. Watson,4397617,,True,21.0,3,9,3,9,0,0,1,1,2,1,3,2,1,1,2,0,7
401408580,Longwood Lancers,J. Hill,4702127,,True,27.0,4,12,1,6,3,6,2,2,0,2,2,2,4,0,5,0,13
401408580,Longwood Lancers,D. Wade,4396618,,True,27.0,4,8,2,4,2,4,0,0,1,2,3,2,0,0,1,1,10
401408580,Longwood Lancers,I. Wilkins,4395681,,True,26.0,3,10,2,3,1,7,2,2,0,2,2,2,1,0,1,0,9
401408580,Longwood Lancers,T. Hicks,4897637,,False,1.0,1,1,1,1,0,0,0,0,0,0,0,0,0,0,0,0,2
401408580,Longwood Lancers,L. Nkereuwem,4432064,,False,18.0,2,3,2,3,0,0,0,0,1,0,1,1,1,0,0,4,4
401408580,Longwood Lancers,G. LaCount,4897638,,False,1.0,0,0,0,0,0,0,0,0,0,0,0,0,0,0,0,0,0
401408580,Longwood Lancers,J. Darden,4897636,,False,4.0,0,0,0,0,0,0,0,0,0,0,0,0,0,0,0,0,0
401408580,Longwood Lancers,C. Williams,4702129,,False,2.0,0,0,0,0,0,0,0,0,0,0,0,0,0,0,1,0,0
401408580,Longwood Lancers,C. O'Conner,4592752,,False,1.0,0,1,0,1,0,0,0,0,0,0,0,1,1,0,0,0,0
401408580,Longwood Lancers,D. Houston,4585602,,False,15.0,0,0,0,0,0,0,1,2,0,1,1,1,1,0,2,5,1
401408580,Longwood Lancers,N. Lliteras,4432036,,False,13.0,1,3,0,0,1,3,0,0,0,3,3,0,0,0,0,0,3
401408580,Longwood Lancers,J. Perkins,4284169,,False,22.0,1,3,1,2,0,1,3,4,1,3,4,3,0,0,3,2,5
401408580,Longwood Lancers,TEAM,TOTAL,TOTAL,False,,20,52,13,30,7,22,9,11,7,17,24,15,9,1,16,13,56
401408579,San Francisco Dons,J. Kunen,4432026,,True,27.0,3,7,3,3,0,4,2,2,1,6,7,2,0,0,1,1,8
401408579,San Francisco Dons,P. Tapé,4066805,,True,33.0,5,5,5,5,0,0,0,1,3,3,6,0,3,3,2,5,10
401408579,San Francisco Dons,K. Shabazz,4397745,,True,43.0,1,10,0,4,1,6,0,0,0,4,4,1,1,0,0,1,3
401408579,San Francisco Dons,J. Bouyea,4280245,,True,45.0,13,26,9,14,4,12,6,8,1,2,3,3,1,1,1,3,36
401408579,San Francisco Dons,G. Stefanini,4279467,,True,22.0,2,4,1,1,1,3,2,4,0,0,0,3,0,0,1,3,7
401408579,San Francisco Dons,Z. Meeks,4593064,,False,22.0,5,7,3,3,2,4,1,3,2,3,5,1,0,1,2,3,13
401408579,San Francisco Dons,V. Markovetskyy,4592672,,False,8.0,1,1,1,1,0,0,0,0,0,3,3,0,0,1,0,3,2
401408579,San Francisco Dons,J. Rishwain,4431875,,False,25.0,2,8,1,2,1,6,3,4,1,3,4,0,2,0,1,5,8
401408579,San Francisco Dons,TEAM,TOTAL,TOTAL,False,,32,68,23,33,9,35,14,22,9,26,35,10,7,6,9,24,87
401408579,Murray State Racers,D. Burns,4594111,,True,27.0,2,5,2,5,0,0,2,2,2,0,2,2,2,0,0,5,6
401408579,Murray State Racers,K. Williams,4398348,,True,39.0,8,14,6,8,2,6,0,1,2,5,7,1,0,1,3,0,18
401408579,Murray State Racers,J. Hill,4703264,,True,45.0,6,13,6,9,0,4,3,4,1,4,5,9,0,0,5,1,15
401408579,Murray State Racers,T. Brown,4279886,,True,36.0,5,13,2,4,3,9,4,5,1,7,8,3,2,0,1,3,17
401408579,Murray State Racers,C. Collins,4278347,,True,2.0,0,0,0,0,0,0,0,0,0,1,1,0,0,0,0,0,0
401408579,Murray State Racers,N. McMullen,4703266,,False,6.0,0,1,0,1,0,0,1,2,1,0,1,0,0,0,0,1,1
401408579,Murray State Racers,J. Skipper-Brown,4593465,,False,18.0,2,3,2,3,0,0,8,12,2,8,10,1,1,0,0,2,12
401408579,Murray State Racers,D. Bostick,4703262,,False,8.0,0,0,0,0,0,0,0,2,0,2,2,1,0,0,0,1,0
401408579,Murray State Racers,T. Hannibal,4593008,,False,27.0,6,12,6,12,0,0,6,7,1,5,6,0,0,0,1,5,18
401408579,Murray State Racers,D. Smith,4398347,,False,17.0,2,3,1,1,1,2,0,0,0,0,0,0,0,0,1,3,5
401408579,Murray State Racers,TEAM,TOTAL,TOTAL,False,,31,64,25,43,6,21,24,35,11,32,43,17,5,1,12,21,92
401408578,Saint Peter's Peacocks,C. Rupert,4898258,,True,19.0,3,5,3,4,0,1,0,0,1,3,4,1,0,0,2,3,6
401408578,Saint Peter's Peacocks,H. Drame,4593387,,True,34.0,3,4,3,4,0,0,1,2,2,6,8,4,1,1,0,4,7
401408578,Saint Peter's Peacocks,K. Ndefo,4398386,,True,25.0,2,4,2,3,0,1,3,5,0,3,3,2,0,2,5,3,7
401408578,Saint Peter's Peacocks,M. Lee,4593388,,True,26.0,1,5,1,4,0,1,2,2,0,1,1,4,1,1,1,2,4
401408578,Saint Peter's Peacocks,D. Banks III,4593386,,True,37.0,9,19,4,11,5,8,4,4,0,4,4,2,1,0,3,2,27
401408578,Saint Peter's Peacocks,O. Diahame,4703529,,False,8.0,0,0,0,0,0,0,0,0,0,1,1,0,0,0,1,0,0
401408578,Saint Peter's Peacocks,F. Drame,4432970,,False,14.0,2,2,2,2,0,0,0,0,1,1,2,0,0,0,0,3,4
401408578,Saint Peter's Peacocks,I. Dasher,4701199,,False,18.0,1,4,1,2,0,2,0,0,0,1,1,1,0,0,1,4,2
401408578,Saint Peter's Peacocks,J. Murray,4683865,,False,19.0,3,7,1,5,2,2,0,0,0,3,3,2,1,0,1,2,8
401408578,Saint Peter's Peacocks,D. Edert,4432977,,False,25.0,5,7,3,5,2,2,8,8,1,3,4,2,0,0,1,2,20
401408578,Saint Peter's Peacocks,TEAM,TOTAL,TOTAL,False,,29,57,20,40,9,17,18,21,8,27,35,18,4,4,15,25,85
401408578,Kentucky Wildcats,T. Washington Jr.,4683749,,True,32.0,2,10,1,8,1,2,0,0,1,1,2,1,0,0,2,3,5
401408578,Kentucky Wildcats,K. Brooks Jr.,4431689,,True,29.0,2,7,2,6,0,1,4,5,2,1,3,2,2,2,0,2,8
401408578,Kentucky Wildcats,O. Tshiebwe,4432827,,True,43.0,11,16,11,16,0,0,8,12,6,10,16,2,2,2,3,3,30
401408578,Kentucky Wildcats,S. Wheeler,4431725,,True,39.0,4,8,3,6,1,2,2,5,0,4,4,6,0,0,6,4,11
401408578,Kentucky Wildcats,K. Grady,4278349,,True,40.0,1,9,0,2,1,7,5,6,1,4,5,4,1,0,0,0,8
401408578,Kentucky Wildcats,J. Toppin,4592461,,False,16.0,3,3,3,3,0,0,3,4,0,1,1,1,0,1,1,0,9
401408578,Kentucky Wildcats,L. Ware,4433152,,False,2.0,0,1,0,1,0,0,0,0,0,0,0,0,0,1,0,0,0
401408578,Kentucky Wildcats,D. Mintz,4065766,,False,24.0,3,7,2,4,1,3,1,3,2,1,3,2,1,0,0,5,8
401408578,Kentucky Wildcats,TEAM,TOTAL,TOTAL,False,,26,61,22,46,4,15,23,35,14,22,36,18,6,6,13,17,79
401408577,Richmond Spiders,T. Burton,4431914,,True,40.0,4,11,3,6,1,5,9,10,2,9,11,1,3,0,5,1,18
401408577,Richmond Spiders,N. Cayo,4278380,,True,31.0,7,11,7,11,0,0,1,2,1,1,2,1,0,1,0,4,15
401408577,Richmond Spiders,G. Golden,4066836,,True,25.0,2,11,2,10,0,1,0,0,1,4,5,5,0,1,2,0,4
401408577,Richmond Spiders,A. Gustavson,4397193,,True,20.0,1,4,1,2,0,2,0,0,2,3,5,1,0,0,0,3,2
401408577,Richmond Spiders,J. Gilyard,4278378,,True,40.0,8,15,4,8,4,7,4,4,0,6,6,6,0,0,3,2,24
401408577,Richmond Spiders,M. Grace,4397192,,False,21.0,2,2,2,2,0,0,0,0,0,1,1,0,1,1,1,1,4
401408577,Richmond Spiders,I. Wilson,4700973,,False,0.0,0,0,0,0,0,0,0,0,0,0,0,0,0,0,0,0,0
401408577,Richmond Spiders,C. Crabtree,4396658,,False,13.0,0,1,0,0,0,1,0,0,0,1,1,0,0,0,0,3,0
401408577,Richmond Spiders,N. Sherod,4066832,,False,10.0,0,2,0,1,0,1,0,0,0,0,0,0,0,0,0,0,0
401408577,Richmond Spiders,TEAM,TOTAL,TOTAL,False,,24,57,19,40,5,17,14,16,8,28,36,14,4,3,12,14,67
401408577,Iowa Hawkeyes,Ke. Murray,4594327,,True,38.0,8,15,8,12,0,3,5,5,2,7,9,2,1,1,2,3,21
401408577,Iowa Hawkeyes,P. McCaffery,4432836,,True,25.0,7,17,3,10,4,7,0,0,1,1,2,1,0,0,0,1,18
401408577,Iowa Hawkeyes,F. Rebraca,4398190,,True,25.0,2,5,2,5,0,0,1,2,2,7,9,1,1,2,0,3,5
401408577,Iowa Hawkeyes,T. Perkins,4433130,,True,19.0,2,5,2,3,0,2,2,3,0,1,1,1,0,0,3,5,6
401408577,Iowa Hawkeyes,J. Bohannon,4066366,,True,33.0,2,8,0,1,2,7,0,0,0,2,2,3,1,0,1,1,6
401408577,Iowa Hawkeyes,Kr. Murray,4594326,,False,16.0,1,6,1,1,0,5,1,2,1,4,5,2,2,0,0,2,3
401408577,Iowa Hawkeyes,P. Sandfort,4697270,,False,8.0,1,5,1,2,0,3,0,0,2,1,3,0,0,0,0,1,2
401408577,Iowa Hawkeyes,J. Toussaint,4432880,,False,13.0,1,3,1,3,0,0,0,0,1,0,1,1,0,0,1,2,2
401408577,Iowa Hawkeyes,A. Ulis,4432454,,False,0.0,0,0,0,0,0,0,0,0,0,0,0,0,0,0,0,0,0
401408577,Iowa Hawkeyes,C. McCaffery,4277950,,False,23.0,0,2,0,0,0,2,0,0,1,2,3,3,0,0,2,0,0
401408577,Iowa Hawkeyes,TEAM,TOTAL,TOTAL,False,,24,66,18,37,6,29,9,12,14,26,40,14,5,3,11,18,63
401408576,South Dakota State Jackrabbits,D. Wilson,4593842,,True,34.0,6,14,6,13,0,1,1,2,2,2,4,3,4,2,2,3,13
401408576,South Dakota State Jackrabbits,B. Scheierman,4593841,,True,40.0,7,17,4,9,3,8,1,2,0,10,10,3,0,0,2,1,18
401408576,South Dakota State Jackrabbits,Z. Mayo,4897251,,True,36.0,3,9,0,1,3,8,2,2,0,4,4,1,3,0,2,1,11
401408576,South Dakota State Jackrabbits,C. Easley,4592707,,True,29.0,1,4,1,3,0,1,0,0,0,1,1,2,0,0,0,3,2
401408576,South Dakota State Jackrabbits,A. Arians,4279531,,True,38.0,5,9,4,6,1,3,2,3,0,7,7,2,0,0,1,0,13
401408576,South Dakota State Jackrabbits,L. Appel,4702644,,False,5.0,0,2,0,2,0,0,0,0,1,0,1,0,0,1,1,2,0
401408576,South Dakota State Jackrabbits,M. Dentlinger,4279530,,False,5.0,0,0,0,0,0,0,0,0,0,0,0,0,0,1,0,0,0
401408576,South Dakota State Jackrabbits,M. Mims,4398338,,False,13.0,0,2,0,0,0,2,0,0,1,1,2,1,0,0,2,1,0
401408576,South Dakota State Jackrabbits,TEAM,TOTAL,TOTAL,False,,22,57,15,34,7,23,6,9,5,27,32,12,7,4,10,11,57
401408576,Providence Friars,N. Horchler,4278453,,True,33.0,5,12,4,9,1,3,2,2,0,9,9,0,2,1,1,3,13
401408576,Providence Friars,J. Minaya,4278111,,True,33.0,3,8,2,3,1,5,2,2,2,0,2,3,0,0,1,2,9
401408576,Providence Friars,N. Watson,4278573,,True,25.0,3,7,3,7,0,0,0,0,0,3,3,0,0,0,1,2,6
401408576,Providence Friars,A.J. Reeves,4397109,,True,26.0,2,6,0,4,2,2,0,0,0,3,3,3,0,0,1,2,6
401408576,Providence Friars,Al Durham,4277942,,True,29.0,5,12,4,7,1,5,2,3,1,7,8,6,0,0,2,1,13
401408576,Providence Friars,Ed Croswell,4397153,,False,15.0,1,3,1,3,0,0,0,0,6,3,9,0,4,0,0,1,2
401408576,Providence Friars,A. Breed,4585590,,False,14.0,2,4,1,2,1,2,0,0,0,2,2,1,1,0,1,0,5
401408576,Providence Friars,J. Bynum,4397194,,False,25.0,3,9,1,4,2,5,4,5,1,0,1,0,0,0,2,1,12
401408576,Providence Friars,TEAM,TOTAL,TOTAL,False,,24,61,16,39,8,22,10,12,11,30,41,13,7,1,10,12,66
401408575,Vermont Catamounts,I. Powell,4592945,,True,32.0,0,1,0,1,0,0,2,2,0,7,7,1,0,0,0,3,2
401408575,Vermont Catamounts,R. Davis,4396597,,True,33.0,7,10,3,5,4,5,2,4,0,3,3,0,0,0,1,2,20
401408575,Vermont Catamounts,F. Sullivan,4397759,,True,30.0,2,7,1,2,1,5,1,2,1,3,4,4,0,0,1,4,6
401408575,Vermont Catamounts,J. Mazzulla,4278493,,True,29.0,5,11,4,7,1,4,2,3,2,7,9,4,0,1,0,3,13
401408575,Vermont Catamounts,B. Shungu,4066789,,True,32.0,8,17,6,12,2,5,2,3,1,5,6,1,0,0,3,3,20
401408575,Vermont Catamounts,N. Fiorillo,4592946,,False,7.0,0,1,0,0,0,1,0,0,0,0,0,1,1,0,0,1,0
401408575,Vermont Catamounts,A. Deloney,4431940,,False,18.0,2,8,2,5,0,3,0,0,1,1,2,0,0,0,1,2,4
401408575,Vermont Catamounts,R. Duncan,4396594,,False,19.0,2,3,1,2,1,1,1,3,0,0,0,2,0,0,0,3,6
401408575,Vermont Catamounts,TEAM,TOTAL,TOTAL,False,,26,58,17,34,9,24,10,17,6,26,32,13,1,1,6,21,71
401408575,Arkansas Razorbacks,J. Williams,4432823,,True,33.0,4,10,3,6,1,4,4,6,2,8,10,1,0,0,2,2,13
401408575,Arkansas Razorbacks,T. Wade,4279111,,True,18.0,1,2,1,1,0,1,0,0,1,0,1,1,0,0,0,0,2
401408575,Arkansas Razorbacks,A. Toney,4395671,,True,40.0,2,4,1,3,1,1,1,2,2,3,5,0,0,1,0,4,6
401408575,Arkansas Razorbacks,S. Umude,4279532,,True,40.0,6,11,3,7,3,4,6,6,0,9,9,3,0,2,0,4,21
401408575,Arkansas Razorbacks,JD Notae,4278435,,True,27.0,5,16,4,9,1,7,6,8,0,7,7,4,0,0,2,4,17
401408575,Arkansas Razorbacks,K. Robinson,4565207,,False,0.0,0,0,0,0,0,0,0,0,0,0,0,0,0,0,0,0,0
401408575,Arkansas Razorbacks,D. Davis,4432197,,False,36.0,6,10,5,8,1,2,1,1,0,3,3,3,2,0,1,4,14
401408575,Arkansas Razorbacks,C. Lykes,4277889,,False,6.0,0,3,0,1,0,2,2,2,0,0,0,0,0,0,0,1,2
401408575,Arkansas Razorbacks,TEAM,TOTAL,TOTAL,False,,24,56,17,35,7,21,20,25,8,31,39,12,2,3,5,19,75
401408574,UConn Huskies,I. Whaley,4278231,,True,34.0,4,7,3,3,1,4,0,0,0,3,3,0,0,4,3,3,9
401408574,UConn Huskies,A. Sanogo,4702023,,True,35.0,4,9,4,9,0,0,2,2,2,6,8,3,3,0,1,2,10
401408574,UConn Huskies,A. Jackson,4432190,,True,28.0,2,3,2,2,0,1,2,2,0,2,2,4,1,0,0,5,6
401408574,UConn Huskies,T. Martin,4397179,,True,39.0,2,7,0,3,2,4,3,4,2,3,5,3,0,0,2,2,9
401408574,UConn Huskies,R.J. Cole,4279789,,True,36.0,7,15,5,9,2,6,4,4,0,1,1,4,0,0,2,1,20
401408574,UConn Huskies,A. Akok,4431706,,False,2.0,1,1,1,1,0,0,0,0,0,0,0,0,0,0,0,1,2
401408574,UConn Huskies,T. Polley,4278230,,False,20.0,2,7,0,0,2,7,1,1,0,0,0,0,0,0,0,2,7
401408574,UConn Huskies,J. Gaffney,4431732,,False,6.0,0,2,0,1,0,1,0,0,0,0,0,1,1,0,0,1,0
401408574,UConn Huskies,TEAM,TOTAL,TOTAL,False,,22,51,15,28,7,23,12,13,8,17,25,15,5,4,8,17,63
401408574,New Mexico State Aggies,W. McNair Jr.,4396012,,True,33.0,2,6,2,6,0,0,0,0,0,3,3,0,0,1,0,2,4
401408574,New Mexico State Aggies,J. McCants,4067472,,True,34.0,2,2,1,1,1,1,0,0,0,2,2,2,2,0,1,3,5
401408574,New Mexico State Aggies,C. Henry,4396010,,True,29.0,3,4,1,2,2,2,0,0,2,2,4,2,0,0,1,3,8
401408574,New Mexico State Aggies,J. Rice,4280181,,True,35.0,3,8,0,2,3,6,0,0,0,2,2,4,0,0,2,1,9
401408574,New Mexico State Aggies,T. Allen,4277932,,True,39.0,10,24,6,17,4,7,13,13,3,3,6,3,2,0,2,1,37
401408574,New Mexico State Aggies,M. Peake,4572450,,False,9.0,1,1,0,0,1,1,0,0,1,0,1,0,0,0,0,1,3
401408574,New Mexico State Aggies,Y. Alok,4397070,,False,4.0,1,2,1,2,0,0,0,0,0,0,0,0,0,0,0,2,2
401408574,New Mexico State Aggies,M. McKinney Jr.,4896928,,False,17.0,1,3,1,3,0,0,0,0,1,2,3,1,0,0,1,3,2
401408574,New Mexico State Aggies,TEAM,TOTAL,TOTAL,False,,23,50,12,33,11,17,13,13,8,18,26,12,4,1,11,16,70
401408573,Wright State Raiders,A. Braun,4709318,,True,13.0,0,2,0,2,0,0,4,6,3,1,4,1,0,0,1,2,4
401408573,Wright State Raiders,G. Basile,4397787,,True,30.0,6,19,4,15,2,4,0,0,2,6,8,1,1,3,7,4,14
401408573,Wright State Raiders,T. Holden,4431990,,True,39.0,11,15,10,14,1,1,14,16,3,8,11,1,2,0,1,2,37
401408573,Wright State Raiders,T. Calvin,4431915,,True,33.0,7,14,5,8,2,6,5,6,0,5,5,4,2,0,1,3,21
401408573,Wright State Raiders,T. Finke,4396017,,True,40.0,2,6,0,0,2,6,2,3,3,4,7,6,0,1,1,2,8
401408573,Wright State Raiders,C. Wilbourn,4432141,,False,1.0,0,0,0,0,0,0,0,0,0,0,0,0,0,0,0,0,0
401408573,Wright State Raiders,A. Neff,4397786,,False,0.0,0,0,0,0,0,0,0,0,0,0,0,0,0,0,0,0,0
401408573,Wright State Raiders,R. Voss,4279475,,False,0.0,0,0,0,0,0,0,0,0,0,0,0,0,0,0,0,0,0
401408573,Wright State Raiders,K. Norris,4898194,,False,30.0,1,2,0,0,1,2,0,0,1,2,3,3,1,0,2,4,3
401408573,Wright State Raiders,A. Welage,4702995,,False,14.0,2,3,1,1,1,2,1,1,0,3,3,3,0,0,2,3,6
401408573,Wright State Raiders,T. Nagy,4593400,,False,0.0,0,0,0,0,0,0,0,0,0,0,0,0,0,0,0,0,0
401408573,Wright State Raiders,TEAM,TOTAL,TOTAL,False,,29,61,20,40,9,21,26,32,13,31,44,19,6,4,16,20,93
401408573,Bryant Bulldogs,H. Elisias,4593267,,True,28.0,4,11,4,9,0,2,0,0,3,3,6,0,2,2,0,5,8
401408573,Bryant Bulldogs,A. Eleeda,4593304,,True,26.0,2,8,0,0,2,8,3,3,0,7,7,0,1,0,1,5,9
401408573,Bryant Bulldogs,C. Pride,4593263,,True,32.0,4,14,4,9,0,5,0,1,7,1,8,0,2,0,3,4,8
401408573,Bryant Bulldogs,L. Hurtado,4279105,,True,33.0,6,8,6,6,0,2,1,2,0,6,6,3,3,0,2,2,13
401408573,Bryant Bulldogs,P. Kiss,4070686,,True,39.0,11,25,9,19,2,6,4,6,0,4,4,2,3,0,4,0,28
401408573,Bryant Bulldogs,J. Ozabor,4898366,,False,1.0,0,0,0,0,0,0,0,0,0,0,0,0,0,0,0,0,0
401408573,Bryant Bulldogs,G. Calixte,4278362,,False,11.0,1,1,1,1,0,0,0,2,0,0,0,0,0,3,2,3,2
401408573,Bryant Bulldogs,M. Iuzzolino,4898365,,False,0.0,0,0,0,0,0,0,0,0,0,0,0,0,0,0,0,0,0
401408573,Bryant Bulldogs,E. Bans,4703138,,False,9.0,1,1,1,1,0,0,0,0,0,0,0,0,0,0,0,2,2
401408573,Bryant Bulldogs,T. Brelsford,4606833,,False,21.0,2,3,2,2,0,1,8,9,0,1,1,2,0,0,1,3,12
401408573,Bryant Bulldogs,TEAM,TOTAL,TOTAL,False,,31,71,27,47,4,24,16,23,12,22,34,7,11,5,13,24,82
401408572,Texas Southern Tigers,J. Nicholas,4278623,,True,19.0,3,7,3,7,0,0,1,4,1,4,5,0,1,1,3,3,7
401408572,Texas Southern Tigers,J. Hopkins,4067629,,True,4.0,0,1,0,0,0,1,0,0,0,0,0,0,0,0,0,0,0
401408572,Texas Southern Tigers,B. Gresham,4066799,,True,27.0,3,6,3,6,0,0,0,0,5,8,13,1,0,6,1,4,6
401408572,Texas Southern Tigers,A. Lawson,4897771,,True,32.0,3,10,3,9,0,1,0,1,1,4,5,2,0,2,2,2,6
401408572,Texas Southern Tigers,J. Jones,4278696,,True,9.0,1,4,1,2,0,2,0,1,0,0,0,1,0,0,0,1,2
401408572,Texas Southern Tigers,Y. Rasas,4594119,,False,9.0,2,2,2,2,0,0,0,0,0,3,3,1,0,0,2,1,4
401408572,Texas Southern Tigers,J. Walker III,4278121,,False,25.0,4,11,2,7,2,4,6,7,0,6,6,0,1,0,3,2,16
401408572,Texas Southern Tigers,B. Etienne,4594120,,False,31.0,5,9,3,4,2,5,9,9,1,4,5,1,1,0,2,2,21
401408572,Texas Southern Tigers,P. Henry,4431987,,False,32.0,2,4,2,4,0,0,10,13,0,5,5,2,0,0,2,2,14
401408572,Texas Southern Tigers,J. Gilliam,4397615,,False,12.0,0,1,0,1,0,0,0,0,0,0,0,1,1,0,0,1,0
401408572,Texas Southern Tigers,TEAM,TOTAL,TOTAL,False,,23,55,19,42,4,13,26,35,9,36,45,9,4,9,15,18,76
401408572,Texas A&M-Corpus Christi Islanders,I. Mushila,4897300,,True,19.0,2,7,1,6,1,1,0,0,2,6,8,2,1,0,2,3,5
401408572,Texas A&M-Corpus Christi Islanders,D. Keys,4703701,,True,21.0,3,9,3,9,0,0,1,2,0,0,0,1,0,0,1,1,7
401408572,Texas A&M-Corpus Christi Islanders,T. Murdix,4897301,,True,29.0,4,13,3,10,1,3,1,2,0,3,3,6,1,0,1,5,10
401408572,Texas A&M-Corpus Christi Islanders,S. Fryer,4703703,,True,32.0,5,9,3,4,2,5,0,0,2,7,9,1,1,0,0,3,12
401408572,Texas A&M-Corpus Christi Islanders,J. Jackson,4592869,,True,28.0,1,7,1,6,0,1,3,4,1,1,2,3,1,1,1,2,5
401408572,Texas A&M-Corpus Christi Islanders,S. Brinson,4278448,,False,12.0,0,1,0,1,0,0,0,2,1,2,3,0,0,0,0,1,0
401408572,Texas A&M-Corpus Christi Islanders,S. Faramade,4897304,,False,19.0,2,3,2,3,0,0,2,4,0,3,3,1,1,1,0,4,6
401408572,Texas A&M-Corpus Christi Islanders,J. Roberts,4897299,,False,0.0,0,1,0,0,0,1,0,0,0,0,0,0,0,0,0,0,0
401408572,Texas A&M-Corpus Christi Islanders,T. Nickelson,4897298,,False,0.0,0,0,0,0,0,0,0,0,0,0,0,0,0,0,0,0,0
401408572,Texas A&M-Corpus Christi Islanders,T. Tennyson,4897296,,False,23.0,7,13,4,6,3,7,1,3,0,4,4,0,1,1,1,1,18
401408572,Texas A&M-Corpus Christi Islanders,E. White,4403714,,False,0.0,0,0,0,0,0,0,0,0,0,0,0,0,0,0,0,0,0
401408572,Texas A&M-Corpus Christi Islanders,M. Smith,4278341,,False,17.0,1,4,0,1,1,3,1,2,1,3,4,3,3,0,2,2,4
401408572,Texas A&M-Corpus Christi Islanders,TEAM,TOTAL,TOTAL,False,,25,67,17,46,8,21,9,19,7,30,37,17,9,3,9,22,67
401408571,Wyoming Cowboys,G. Ike,4703396,,True,30.0,7,14,7,14,0,0,3,4,4,5,9,1,0,0,5,4,17
401408571,Wyoming Cowboys,H. Thompson,4280268,,True,23.0,2,2,0,0,2,2,0,0,0,3,3,0,0,0,1,3,6
401408571,Wyoming Cowboys,D. Jeffries,4703397,,True,37.0,1,7,1,1,0,6,2,3,2,8,10,0,0,0,0,2,4
401408571,Wyoming Cowboys,B. Wenzel,4433110,,True,37.0,1,5,0,0,1,5,2,3,0,4,4,0,1,0,1,1,5
401408571,Wyoming Cowboys,H. Maldonado,4280267,,True,40.0,8,16,6,12,2,4,3,6,1,2,3,5,1,0,10,2,21
401408571,Wyoming Cowboys,J. Oden,4703399,,False,19.0,1,1,0,0,1,1,2,2,0,1,1,0,0,1,0,1,5
401408571,Wyoming Cowboys,X. DuSell,4703394,,False,14.0,0,1,0,0,0,1,0,0,0,0,0,0,0,0,1,4,0
401408571,Wyoming Cowboys,TEAM,TOTAL,TOTAL,False,,20,46,14,27,6,19,12,18,7,23,30,6,2,1,19,17,58
401408571,Indiana Hoosiers,T. Jackson-Davis,4431684,,True,36.0,10,16,10,16,0,0,9,11,1,8,9,0,0,1,1,1,29
401408571,Indiana Hoosiers,M. Kopp,4397231,,True,21.0,0,2,0,1,0,1,0,0,1,1,2,0,1,0,0,3,0
401408571,Indiana Hoosiers,R. Thompson,4277947,,True,20.0,2,9,2,7,0,2,0,2,4,3,7,0,2,0,1,4,4
401408571,Indiana Hoosiers,X. Johnson,4395669,,True,32.0,3,12,2,10,1,2,3,5,0,4,4,7,0,0,2,2,10
401408571,Indiana Hoosiers,P. Stewart,4278013,,True,37.0,2,6,2,4,0,2,0,0,1,1,2,1,0,0,0,3,4
401408571,Indiana Hoosiers,M. Durr,4396642,,False,4.0,0,0,0,0,0,0,0,0,0,0,0,0,0,0,0,2,0
401408571,Indiana Hoosiers,J. Geronimo,4432512,,False,19.0,7,11,6,7,1,4,0,2,3,4,7,1,0,1,0,2,15
401408571,Indiana Hoosiers,T. Bates,4683933,,False,11.0,1,2,1,2,0,0,0,0,1,0,1,1,0,0,0,0,2
401408571,Indiana Hoosiers,T. Galloway,4432315,,False,12.0,1,4,1,2,0,2,0,0,1,0,1,0,0,1,2,5,2
401408571,Indiana Hoosiers,R. Phinisee,4397010,,False,8.0,0,0,0,0,0,0,0,0,0,1,1,0,0,0,1,0,0
401408571,Indiana Hoosiers,TEAM,TOTAL,TOTAL,False,,26,62,24,49,2,13,12,20,15,24,39,10,3,3,8,22,66
401408570,Rutgers Scarlet Knights,R. Harper Jr.,4397251,,True,46.0,9,14,5,7,4,7,0,0,1,3,4,4,0,1,2,3,22
401408570,Rutgers Scarlet Knights,C. Omoruyi,4433155,,True,35.0,7,9,7,9,0,0,1,2,1,5,6,3,0,1,1,3,15
401408570,Rutgers Scarlet Knights,P. Mulcahy,4432849,,True,46.0,3,11,1,6,2,5,0,0,2,4,6,5,0,0,3,2,8
401408570,Rutgers Scarlet Knights,C. McConnell,4397249,,True,48.0,10,12,8,9,2,3,1,1,5,6,11,2,1,1,1,3,23
401408570,Rutgers Scarlet Knights,G. Baker,4277986,,True,44.0,7,19,4,11,3,8,2,3,2,4,6,5,0,1,3,2,19
401408570,Rutgers Scarlet Knights,M. Mag,4602948,,False,9.0,0,2,0,0,0,2,0,0,0,1,1,0,0,1,1,0,0
401408570,Rutgers Scarlet Knights,D. Reiber,4581507,,False,6.0,0,0,0,0,0,0,0,0,0,3,3,1,0,0,2,1,0
401408570,Rutgers Scarlet Knights,A. Hyatt,4396975,,False,14.0,0,4,0,2,0,2,0,0,2,2,4,2,0,1,0,1,0
401408570,Rutgers Scarlet Knights,J. Miller,4708076,,False,2.0,0,0,0,0,0,0,0,0,0,0,0,0,0,0,0,0,0
401408570,Rutgers Scarlet Knights,TEAM,TOTAL,TOTAL,False,,36,71,25,44,11,27,4,6,13,31,44,22,1,6,13,15,87
401408570,Notre Dame Fighting Irish,P. Atkinson Jr.,4279699,,True,33.0,13,15,13,15,0,0,0,2,4,2,6,1,0,2,2,1,26
401408570,Notre Dame Fighting Irish,B. Wesley,4683935,,True,42.0,4,17,4,14,0,3,0,2,1,5,6,1,1,0,1,1,8
401408570,Notre Dame Fighting Irish,C. Ryan,4397114,,True,46.0,7,12,5,6,2,6,0,0,0,1,1,2,3,0,1,2,16
401408570,Notre Dame Fighting Irish,D. Goodwin,4395667,,True,34.0,4,7,2,5,2,2,2,3,0,4,4,1,0,0,1,1,12
401408570,Notre Dame Fighting Irish,P. Hubb,4395664,,True,44.0,3,12,3,8,0,4,3,4,1,4,5,7,0,0,0,0,9
401408570,Notre Dame Fighting Irish,N. Laszewski,4395665,,False,37.0,6,8,4,4,2,4,4,5,1,5,6,1,1,0,0,2,18
401408570,Notre Dame Fighting Irish,T. Wertz,4397753,,False,14.0,0,1,0,1,0,0,0,0,0,1,1,4,1,0,0,1,0
401408570,Notre Dame Fighting Irish,TEAM,TOTAL,TOTAL,False,,37,72,31,53,6,19,9,16,9,23,32,17,6,2,5,8,89
401408177,UNC Wilmington Seahawks,T. White,4897714,,True,17.0,0,2,0,1,0,1,3,6,3,3,6,0,1,0,1,3,3
401408177,UNC Wilmington Seahawks,S. Phillips,4592975,,True,36.0,4,15,4,13,0,2,0,0,1,4,5,1,2,0,1,1,8
401408177,UNC Wilmington Seahawks,J. Sims,4397570,,True,30.0,4,15,2,8,2,7,8,9,0,4,4,1,1,1,0,2,18
401408177,UNC Wilmington Seahawks,J. Baker,4279875,,True,33.0,2,3,2,3,0,0,0,0,2,2,4,1,1,2,2,3,4
401408177,UNC Wilmington Seahawks,M. Okauru,4278057,,True,31.0,5,10,5,8,0,2,0,0,1,3,4,1,0,0,4,3,10
401408177,UNC Wilmington Seahawks,A. Kelly,4396804,,False,8.0,1,2,1,2,0,0,0,0,1,0,1,0,0,1,0,3,2
401408177,UNC Wilmington Seahawks,J. Harvey,4702775,,False,12.0,1,1,0,0,1,1,0,0,0,1,1,1,0,0,0,0,3
401408177,UNC Wilmington Seahawks,J. Fornes,4067294,,False,33.0,3,6,2,4,1,2,0,0,1,4,5,0,1,0,3,1,7
401408177,UNC Wilmington Seahawks,TEAM,TOTAL,TOTAL,False,,20,54,16,39,4,15,11,15,10,22,32,5,6,4,11,16,55
401408177,Delaware Blue Hens,A. Carr,4702743,,True,32.0,6,7,6,7,0,0,5,6,6,6,12,0,3,3,1,4,17
401408177,Delaware Blue Hens,J. Davis,4701989,,True,36.0,8,15,8,15,0,0,2,4,1,4,5,1,0,0,1,0,18
401408177,Delaware Blue Hens,E. Asamoah,4597790,,True,24.0,0,3,0,2,0,1,2,2,1,2,3,0,1,0,0,2,2
401408177,Delaware Blue Hens,J. Nelson Jr.,4592444,,True,33.0,3,10,1,4,2,6,2,4,1,5,6,2,1,1,2,1,10
401408177,Delaware Blue Hens,K. Anderson,4279189,,True,38.0,1,9,1,5,0,4,0,0,1,4,5,3,3,0,4,3,2
401408177,Delaware Blue Hens,D. Painter,4065840,,False,10.0,0,1,0,1,0,0,0,0,2,1,3,0,0,0,3,3,0
401408177,Delaware Blue Hens,R. Gardner Jr.,4398238,,False,0.0,0,0,0,0,0,0,0,0,0,0,0,0,0,0,0,0,0
401408177,Delaware Blue Hens,R. Allen,4279190,,False,27.0,4,11,4,9,0,2,2,4,0,2,2,2,1,0,0,0,10
401408177,Delaware Blue Hens,TEAM,TOTAL,TOTAL,False,,22,56,20,43,2,13,13,20,15,27,42,8,9,4,11,13,59
401408176,UNC Wilmington Seahawks,T. White,4897714,,True,31.0,2,4,2,4,0,0,4,6,2,3,5,1,1,0,4,5,8
401408176,UNC Wilmington Seahawks,S. Phillips,4592975,,True,25.0,3,6,3,6,0,0,1,1,1,2,3,2,3,1,4,4,7
401408176,UNC Wilmington Seahawks,J. Sims,4397570,,True,37.0,8,19,3,12,5,7,5,6,0,11,11,1,2,0,3,1,26
401408176,UNC Wilmington Seahawks,J. Baker,4279875,,True,21.0,0,2,0,1,0,1,0,0,1,0,1,0,1,0,0,0,0
401408176,UNC Wilmington Seahawks,M. Okauru,4278057,,True,37.0,5,12,4,8,1,4,0,2,1,1,2,2,4,1,1,1,11
401408176,UNC Wilmington Seahawks,A. Kelly,4396804,,False,19.0,3,4,3,4,0,0,2,2,2,1,3,0,0,1,1,2,8
401408176,UNC Wilmington Seahawks,J. Harvey,4702775,,False,9.0,0,3,0,1,0,2,0,0,0,1,1,1,0,0,0,1,0
401408176,UNC Wilmington Seahawks,J. Fornes,4067294,,False,21.0,0,3,0,1,0,2,0,0,0,1,1,1,0,0,0,1,0
401408176,UNC Wilmington Seahawks,TEAM,TOTAL,TOTAL,False,,21,53,15,37,6,16,12,17,9,22,31,8,11,3,13,15,60
401408176,Charleston Cougars,B. Burnham,4896997,,True,23.0,2,4,2,3,0,1,0,0,1,4,5,0,1,1,3,2,4
401408176,Charleston Cougars,J. Meeks,4280046,,True,31.0,3,12,2,10,1,2,1,2,3,2,5,1,0,0,5,3,8
401408176,Charleston Cougars,R. Horton,4896996,,True,31.0,4,8,2,5,2,3,1,2,6,4,10,0,0,1,1,2,11
401408176,Charleston Cougars,B. Tucker,4597990,,True,23.0,2,7,2,5,0,2,1,2,0,1,1,1,1,0,2,0,5
401408176,Charleston Cougars,D. Underwood,4077059,,True,33.0,10,20,10,19,0,1,1,4,2,6,8,1,2,0,2,3,21
401408176,Charleston Cougars,B. Faye,4897000,,False,11.0,0,2,0,1,0,1,0,0,0,3,3,0,0,1,1,1,0
401408176,Charleston Cougars,C. Lampten,4896999,,False,2.0,0,0,0,0,0,0,0,0,0,0,0,0,0,0,0,1,0
401408176,Charleston Cougars,O. Smart,4067221,,False,8.0,0,1,0,1,0,0,0,0,1,2,3,0,0,0,0,0,0
401408176,Charleston Cougars,N. Farrar,4573135,,False,9.0,2,3,1,2,1,1,0,0,1,0,1,0,0,0,2,1,5
401408176,Charleston Cougars,N. Evdokimov,4912479,,False,2.0,0,1,0,1,0,0,0,0,0,0,0,0,0,0,0,1,0
401408176,Charleston Cougars,R. Smith,4896994,,False,27.0,0,2,0,0,0,2,3,3,0,1,1,0,0,0,0,1,3
401408176,Charleston Cougars,TEAM,TOTAL,TOTAL,False,,23,60,19,47,4,13,7,13,17,24,41,3,4,3,16,15,57
401408175,Towson Tigers,C. Thompson,4433103,,True,28.0,5,12,5,12,0,0,3,3,4,2,6,2,1,0,1,2,13
401408175,Towson Tigers,C. Holden,4703407,,True,32.0,2,9,2,7,0,2,7,8,4,3,7,2,1,1,2,4,11
401408175,Towson Tigers,J. Gibson,4592985,,True,32.0,3,11,1,3,2,8,4,4,2,3,5,1,1,0,1,2,12
401408175,Towson Tigers,N. Timberlake,4397595,,True,38.0,4,13,2,5,2,8,0,0,2,1,3,1,2,1,2,3,10
401408175,Towson Tigers,A. Rizzuto,4395873,,True,16.0,0,2,0,1,0,1,0,0,0,0,0,0,1,1,0,2,0
401408175,Towson Tigers,C. Biekeu,4702788,,False,0.0,0,0,0,0,0,0,0,0,0,0,0,0,0,0,0,0,0
401408175,Towson Tigers,C. Paar,4432076,,False,10.0,2,2,2,2,0,0,0,4,3,2,5,0,0,0,2,3,4
401408175,Towson Tigers,J. Gray,4066744,,False,16.0,2,3,2,3,0,0,0,1,1,3,4,0,0,0,1,2,4
401408175,Towson Tigers,R. Hicks,4897712,,False,3.0,0,0,0,0,0,0,0,0,0,0,0,0,0,0,0,1,0
401408175,Towson Tigers,T. Gill,4897710,,False,0.0,0,0,0,0,0,0,0,0,0,0,0,0,0,0,0,0,0
401408175,Towson Tigers,D. Jones Jr.,4702786,,False,0.0,0,0,0,0,0,0,0,0,0,0,0,0,0,0,0,0,0
401408175,Towson Tigers,T. Nolan Jr.,4278494,,False,25.0,0,6,0,2,0,4,2,2,0,3,3,1,0,0,4,3,2
401408175,Towson Tigers,TEAM,TOTAL,TOTAL,False,,18,58,14,35,4,23,16,22,17,20,37,7,6,3,13,22,56
401408175,Delaware Blue Hens,A. Carr,4702743,,True,27.0,1,2,1,1,0,1,4,7,3,8,11,2,0,1,1,3,6
401408175,Delaware Blue Hens,J. Davis,4701989,,True,23.0,7,11,7,11,0,0,0,0,1,7,8,0,0,1,2,4,14
401408175,Delaware Blue Hens,E. Asamoah,4597790,,True,33.0,1,6,0,1,1,5,0,0,1,3,4,0,2,0,0,4,3
401408175,Delaware Blue Hens,J. Nelson Jr.,4592444,,True,24.0,3,6,2,3,1,3,4,4,1,1,2,2,0,0,4,4,11
401408175,Delaware Blue Hens,K. Anderson,4279189,,True,36.0,4,10,0,4,4,6,5,6,0,2,2,4,3,1,1,0,17
401408175,Delaware Blue Hens,D. Painter,4065840,,False,23.0,4,5,4,5,0,0,4,5,2,3,5,1,0,1,2,2,12
401408175,Delaware Blue Hens,G. Arletti,4702742,,False,3.0,0,0,0,0,0,0,0,0,0,1,1,0,0,0,0,1,0
401408175,Delaware Blue Hens,R. Allen,4279190,,False,31.0,2,9,2,5,0,4,2,3,0,1,1,4,0,0,0,2,6
401408175,Delaware Blue Hens,TEAM,TOTAL,TOTAL,False,,22,49,16,30,6,19,19,25,9,28,37,13,5,4,11,20,69
401408174,Hofstra Pride,A. Iyiola,4278475,,True,18.0,5,8,5,8,0,0,1,1,2,3,5,1,1,1,0,2,11
401408174,Hofstra Pride,D. Dubar,4598640,,True,27.0,2,4,1,2,1,2,0,0,2,1,3,3,1,0,1,1,5
401408174,Hofstra Pride,A. Estrada,4593385,,True,38.0,7,17,5,10,2,7,3,3,0,3,3,6,2,0,2,1,19
401408174,Hofstra Pride,C. Burgess,4592954,,True,11.0,0,2,0,2,0,0,0,0,0,0,0,2,0,0,1,1,0
401408174,Hofstra Pride,J. Ray,4279206,,True,35.0,7,18,2,3,5,15,2,3,1,4,5,3,1,0,1,2,21
401408174,Hofstra Pride,K. Cramer,4592957,,False,13.0,1,1,1,1,0,0,3,4,0,1,1,0,0,1,0,3,5
401408174,Hofstra Pride,J. Simmons,4279562,,False,9.0,0,0,0,0,0,0,0,0,0,0,0,0,0,0,1,3,0
401408174,Hofstra Pride,O. Silverio,4397181,,False,32.0,3,10,2,6,1,4,0,0,0,1,1,1,2,0,3,2,7
401408174,Hofstra Pride,Z. Cooks,4278449,,False,17.0,3,6,2,3,1,3,1,1,1,0,1,1,1,0,1,2,8
401408174,Hofstra Pride,TEAM,TOTAL,TOTAL,False,,28,66,18,35,10,31,10,12,9,17,26,17,8,2,10,17,76
401408174,Charleston Cougars,B. Burnham,4896997,,True,24.0,1,4,1,3,0,1,1,2,1,4,5,0,2,0,0,1,3
401408174,Charleston Cougars,J. Meeks,4280046,,True,35.0,11,16,7,11,4,5,5,5,1,6,7,3,2,1,2,1,31
401408174,Charleston Cougars,R. Horton,4896996,,True,26.0,5,7,4,4,1,3,2,2,2,6,8,0,0,0,3,3,13
401408174,Charleston Cougars,B. Tucker,4597990,,True,24.0,4,11,4,9,0,2,4,5,1,3,4,4,0,1,3,2,12
401408174,Charleston Cougars,D. Underwood,4077059,,True,14.0,3,6,3,4,0,2,0,0,1,1,2,2,0,0,1,2,6
401408174,Charleston Cougars,B. Faye,4897000,,False,18.0,1,1,1,1,0,0,0,0,1,0,1,1,0,1,2,2,2
401408174,Charleston Cougars,C. Lampten,4896999,,False,1.0,0,0,0,0,0,0,0,0,0,0,0,0,0,0,0,0,0
401408174,Charleston Cougars,O. Smart,4067221,,False,22.0,4,5,4,5,0,0,0,2,3,2,5,0,1,2,1,2,8
401408174,Charleston Cougars,N. Farrar,4573135,,False,4.0,2,3,1,2,1,1,1,1,0,1,1,0,0,0,1,0,6
401408174,Charleston Cougars,N. Evdokimov,4912479,,False,6.0,0,2,0,2,0,0,0,0,1,2,3,4,0,0,0,0,0
401408174,Charleston Cougars,R. Smith,4896994,,False,26.0,3,7,0,0,3,7,2,2,0,2,2,0,1,0,0,4,11
401408174,Charleston Cougars,TEAM,TOTAL,TOTAL,False,,34,62,25,41,9,21,15,19,11,29,40,14,6,5,13,17,92
401408173,UNC Wilmington Seahawks,T. White,4897714,,True,34.0,5,9,4,7,1,2,4,5,4,7,11,2,0,0,0,1,15
401408173,UNC Wilmington Seahawks,S. Phillips,4592975,,True,17.0,5,8,5,8,0,0,2,2,1,2,3,1,1,1,1,4,12
401408173,UNC Wilmington Seahawks,J. Sims,4397570,,True,39.0,6,14,4,8,2,6,2,2,0,6,6,4,0,0,1,2,16
401408173,UNC Wilmington Seahawks,J. Baker,4279875,,True,33.0,2,6,2,5,0,1,1,2,2,4,6,0,0,4,0,1,5
401408173,UNC Wilmington Seahawks,M. Okauru,4278057,,True,32.0,5,10,3,6,2,4,0,0,0,3,3,1,2,1,2,3,12
401408173,UNC Wilmington Seahawks,A. Kelly,4396804,,False,7.0,0,1,0,1,0,0,0,0,0,0,0,0,2,0,0,3,0
401408173,UNC Wilmington Seahawks,K. Samb,4397286,,False,1.0,0,0,0,0,0,0,0,0,0,0,0,0,0,0,0,0,0
401408173,UNC Wilmington Seahawks,M. Surigao,4897716,,False,1.0,0,0,0,0,0,0,0,0,0,1,1,0,0,0,0,0,0
401408173,UNC Wilmington Seahawks,J. Thomas,4897713,,False,1.0,0,1,0,1,0,0,1,2,1,0,1,0,0,0,0,0,1
401408173,UNC Wilmington Seahawks,L. Morrissey,4710040,,False,1.0,0,0,0,0,0,0,0,0,0,0,0,0,0,0,0,0,0
401408173,UNC Wilmington Seahawks,J. Harvey,4702775,,False,7.0,2,2,0,0,2,2,0,0,0,0,0,0,0,0,0,0,6
401408173,UNC Wilmington Seahawks,J. Fornes,4067294,,False,27.0,3,7,2,4,1,3,1,1,1,1,2,2,1,0,1,2,8
401408173,UNC Wilmington Seahawks,TEAM,TOTAL,TOTAL,False,,28,58,20,40,8,18,11,14,10,26,36,10,6,6,5,16,75
401408173,Elon Phoenix,M. Graham,4702761,,True,22.0,2,4,2,4,0,0,5,6,2,3,5,0,0,2,1,0,9
401408173,Elon Phoenix,C. Hannah,4397456,,True,25.0,4,6,3,3,1,3,0,0,2,3,5,0,0,0,0,3,9
401408173,Elon Phoenix,Z. Ervin,4431950,,True,24.0,2,6,0,1,2,5,1,2,0,0,0,0,0,0,0,2,7
401408173,Elon Phoenix,D. Burford,4702759,,True,34.0,2,11,2,9,0,2,0,0,0,3,3,4,1,0,1,1,4
401408173,Elon Phoenix,H. McIntosh,4592948,,True,37.0,5,10,3,4,2,6,3,6,0,3,3,4,0,0,3,3,15
401408173,Elon Phoenix,S. Sherry,4897697,,False,2.0,0,1,0,0,0,1,0,0,0,0,0,0,0,0,0,0,0
401408173,Elon Phoenix,H. Woods,4592950,,False,17.0,2,3,0,0,2,3,0,0,0,3,3,1,0,0,3,3,6
401408173,Elon Phoenix,A. Junkin,4396962,,False,9.0,1,2,1,2,0,0,0,0,1,0,1,1,0,0,0,3,2
401408173,Elon Phoenix,C. Mendys,4702757,,False,1.0,0,1,0,0,0,1,0,0,0,1,1,0,0,0,0,0,0
401408173,Elon Phoenix,B. Daugherty,4592949,,False,1.0,0,0,0,0,0,0,0,0,0,0,0,0,0,0,0,1,0
401408173,Elon Phoenix,K. Wooten,4397455,,False,27.0,2,7,0,1,2,6,0,0,0,3,3,2,0,0,1,1,6
401408173,Elon Phoenix,TEAM,TOTAL,TOTAL,False,,20,51,11,24,9,27,9,14,8,21,29,12,1,2,9,17,58
401408172,Drexel Dragons,A. Williams,4702745,,True,15.0,1,4,1,3,0,1,2,2,0,6,6,0,0,1,2,5,4
401408172,Drexel Dragons,M. Martin,4279733,,True,28.0,0,8,0,5,0,3,0,0,1,9,10,0,1,0,0,4,0
401408172,Drexel Dragons,X. Bell,4612161,,True,28.0,3,8,2,5,1,3,0,0,0,0,0,0,0,0,1,1,7
401408172,Drexel Dragons,C. Wynter,4397427,,True,38.0,12,20,11,15,1,5,3,3,2,2,4,1,1,0,3,2,28
401408172,Drexel Dragons,C. Washington,4397425,,True,33.0,3,6,2,2,1,4,2,2,1,0,1,0,0,0,2,3,9
401408172,Drexel Dragons,M. Okros,4592777,,False,14.0,1,3,0,0,1,3,0,0,0,1,1,0,0,0,0,1,3
401408172,Drexel Dragons,J. Butler,4067138,,False,25.0,2,3,2,3,0,0,1,4,2,6,8,2,0,0,0,2,5
401408172,Drexel Dragons,T. Brown,4709927,,False,2.0,0,1,0,0,0,1,0,0,0,0,0,0,0,0,0,0,0
401408172,Drexel Dragons,L. House,4702744,,False,1.0,0,0,0,0,0,0,0,0,0,0,0,0,0,0,0,0,0
401408172,Drexel Dragons,L. Oden Jr.,4585866,,False,11.0,0,4,0,2,0,2,0,0,0,0,0,0,0,0,0,0,0
401408172,Drexel Dragons,M. Juric,4397428,,False,5.0,0,1,0,0,0,1,0,0,0,1,1,0,0,0,1,0,0
401408172,Drexel Dragons,TEAM,TOTAL,TOTAL,False,,22,58,18,35,4,23,8,11,6,26,32,3,2,1,9,18,56
401408172,Delaware Blue Hens,A. Carr,4702743,,True,30.0,4,10,3,7,1,3,4,7,2,5,7,0,1,1,2,2,13
401408172,Delaware Blue Hens,J. Davis,4701989,,True,29.0,7,13,7,13,0,0,3,5,1,9,10,0,0,1,1,1,17
401408172,Delaware Blue Hens,E. Asamoah,4597790,,True,25.0,1,2,1,2,0,0,1,2,1,4,5,0,1,0,0,3,3
401408172,Delaware Blue Hens,J. Nelson Jr.,4592444,,True,34.0,4,9,4,6,0,3,3,3,0,4,4,1,0,1,3,2,11
401408172,Delaware Blue Hens,K. Anderson,4279189,,True,38.0,4,8,3,4,1,4,0,1,0,1,1,5,1,0,1,1,9
401408172,Delaware Blue Hens,D. Painter,4065840,,False,16.0,2,6,2,5,0,1,0,0,0,2,2,1,0,0,1,0,4
401408172,Delaware Blue Hens,G. Arletti,4702742,,False,6.0,0,0,0,0,0,0,0,0,0,1,1,0,0,0,0,1,0
401408172,Delaware Blue Hens,R. Allen,4279190,,False,22.0,4,7,3,5,1,2,0,0,1,2,3,2,1,0,2,0,9
401408172,Delaware Blue Hens,TEAM,TOTAL,TOTAL,False,,26,55,23,42,3,13,11,18,6,31,37,9,4,3,11,10,66
401408171,Towson Tigers,C. Thompson,4433103,,True,15.0,1,3,1,3,0,0,0,0,2,3,5,0,0,1,2,1,2
401408171,Towson Tigers,C. Holden,4703407,,True,39.0,5,10,5,8,0,2,8,9,2,4,6,6,1,0,3,3,18
401408171,Towson Tigers,J. Gibson,4592985,,True,27.0,1,7,1,3,0,4,2,2,0,1,1,2,2,0,0,1,4
401408171,Towson Tigers,N. Timberlake,4397595,,True,35.0,7,10,2,3,5,7,6,7,0,2,2,1,2,0,4,3,25
401408171,Towson Tigers,A. Rizzuto,4395873,,True,22.0,0,4,0,1,0,3,0,0,0,2,2,0,1,0,0,2,0
401408171,Towson Tigers,C. Biekeu,4702788,,False,8.0,0,0,0,0,0,0,0,0,0,1,1,0,0,0,0,1,0
401408171,Towson Tigers,C. Paar,4432076,,False,12.0,1,1,1,1,0,0,0,2,1,1,2,0,0,0,0,4,2
401408171,Towson Tigers,J. Gray,4066744,,False,13.0,2,4,1,2,1,2,1,1,1,5,6,0,0,0,1,1,6
401408171,Towson Tigers,T. Nolan Jr.,4278494,,False,29.0,4,11,1,6,3,5,0,2,0,2,2,1,2,1,1,3,11
401408171,Towson Tigers,TEAM,TOTAL,TOTAL,False,,21,50,12,27,9,23,17,23,8,21,29,10,8,2,12,19,68
401408171,Northeastern Huskies,C. Doherty,4395666,,True,32.0,5,11,5,11,0,0,3,5,3,5,8,1,0,0,3,5,13
401408171,Northeastern Huskies,J. Telfort,4702785,,True,36.0,4,11,4,7,0,4,3,4,0,2,2,1,1,0,3,0,11
401408171,Northeastern Huskies,Q. Emanga,4592982,,True,38.0,3,5,3,4,0,1,1,2,2,4,6,2,0,0,3,3,7
401408171,Northeastern Huskies,S. Walters,4280251,,True,33.0,3,9,3,5,0,4,4,4,0,6,6,4,0,0,4,5,10
401408171,Northeastern Huskies,N. Djogo,4065704,,True,34.0,3,6,2,4,1,2,4,4,1,7,8,1,0,0,1,2,11
401408171,Northeastern Huskies,C. Braun,4592983,,False,2.0,0,0,0,0,0,0,0,0,0,0,0,0,0,0,0,0,0
401408171,Northeastern Huskies,J. Strong,4279220,,False,16.0,3,6,2,3,1,3,2,2,0,1,1,0,1,0,0,3,9
401408171,Northeastern Huskies,G. McClintock,4432051,,False,9.0,0,1,0,1,0,0,0,0,0,0,0,0,1,0,0,1,0
401408171,Northeastern Huskies,TEAM,TOTAL,TOTAL,False,,21,49,19,35,2,14,17,21,7,25,32,9,3,0,14,19,61
401408170,William & Mary Tribe,B. Wight,4433119,,True,24.0,5,7,5,7,0,0,4,5,2,1,3,0,0,0,2,5,14
401408170,William & Mary Tribe,B. Carroll,4067526,,True,38.0,3,10,3,5,0,5,4,4,3,9,12,0,1,2,3,5,10
401408170,William & Mary Tribe,T. Rice,4897718,,True,33.0,6,13,3,8,3,5,0,0,0,1,1,4,0,0,0,4,15
401408170,William & Mary Tribe,J. Lewis,4897717,,True,38.0,1,12,1,7,0,5,2,3,2,7,9,4,1,0,2,4,4
401408170,William & Mary Tribe,C. Kochera,4585606,,True,37.0,4,14,3,8,1,6,1,1,1,6,7,1,1,0,1,2,10
401408170,William & Mary Tribe,M. Harvey,4397606,,False,20.0,1,2,1,2,0,0,1,3,0,2,2,1,1,2,2,4,3
401408170,William & Mary Tribe,Y. Covington,4702871,,False,24.0,2,7,1,4,1,3,2,2,0,3,3,0,1,0,1,1,7
401408170,William & Mary Tribe,J. Milkereit,4702870,,False,11.0,0,1,0,1,0,0,0,0,1,1,2,0,0,0,0,1,0
401408170,William & Mary Tribe,A. Washburn,4397605,,False,0.0,0,0,0,0,0,0,0,0,0,0,0,0,0,0,0,0,0
401408170,William & Mary Tribe,TEAM,TOTAL,TOTAL,False,,22,66,17,42,5,24,14,18,14,31,45,10,5,4,11,26,63
401408170,Northeastern Huskies,C. Doherty,4395666,,True,31.0,10,10,10,10,0,0,6,7,1,5,6,0,0,4,2,3,26
401408170,Northeastern Huskies,J. Telfort,4702785,,True,44.0,3,8,3,7,0,1,1,5,0,7,7,2,1,3,2,2,7
401408170,Northeastern Huskies,Q. Emanga,4592982,,True,43.0,0,2,0,2,0,0,3,6,3,7,10,3,2,1,1,3,3
401408170,Northeastern Huskies,S. Walters,4280251,,True,36.0,6,16,3,8,3,8,2,3,1,2,3,2,0,0,2,4,17
401408170,Northeastern Huskies,N. Djogo,4065704,,True,34.0,1,11,0,2,1,9,3,4,1,8,9,2,2,0,1,3,6
401408170,Northeastern Huskies,C. Braun,4592983,,False,2.0,0,0,0,0,0,0,0,0,0,1,1,0,0,0,0,0,0
401408170,Northeastern Huskies,J. Strong,4279220,,False,24.0,3,7,1,2,2,5,1,2,0,0,0,0,0,0,3,3,9
401408170,Northeastern Huskies,G. McClintock,4432051,,False,11.0,0,2,0,2,0,0,0,0,0,2,2,1,0,0,0,1,0
401408170,Northeastern Huskies,TEAM,TOTAL,TOTAL,False,,23,56,17,33,6,23,16,27,6,34,40,10,5,8,12,19,68
401408169,South Dakota State Jackrabbits,D. Wilson,4593842,,True,34.0,9,18,9,18,0,0,3,5,5,6,11,4,1,0,1,3,21
401408169,South Dakota State Jackrabbits,B. Scheierman,4593841,,True,38.0,4,15,2,10,2,5,1,1,1,2,3,4,3,0,1,3,11
401408169,South Dakota State Jackrabbits,Z. Mayo,4897251,,True,37.0,4,10,4,6,0,4,4,4,0,4,4,1,1,0,3,0,12
401408169,South Dakota State Jackrabbits,C. Easley,4592707,,True,35.0,5,6,2,2,3,4,2,2,0,6,6,0,0,0,0,3,15
401408169,South Dakota State Jackrabbits,A. Arians,4279531,,True,31.0,3,8,2,6,1,2,3,4,1,5,6,0,1,0,0,1,10
401408169,South Dakota State Jackrabbits,L. Appel,4702644,,False,10.0,2,3,2,3,0,0,0,0,0,3,3,0,0,0,0,3,4
401408169,South Dakota State Jackrabbits,M. Dentlinger,4279530,,False,9.0,1,4,1,4,0,0,0,0,1,1,2,0,0,0,0,0,2
401408169,South Dakota State Jackrabbits,M. Mims,4398338,,False,6.0,0,0,0,0,0,0,0,0,0,0,0,0,0,0,0,2,0
401408169,South Dakota State Jackrabbits,TEAM,TOTAL,TOTAL,False,,28,64,22,49,6,15,13,16,9,27,36,9,6,0,5,15,75
401408169,North Dakota State Bison,G. Nelson,4702670,,True,34.0,5,11,5,8,0,3,1,3,2,6,8,1,0,1,2,2,11
401408169,North Dakota State Bison,R. Kreuser,4279518,,True,33.0,1,9,1,5,0,4,2,2,0,6,6,0,0,0,1,3,4
401408169,North Dakota State Bison,J. Cook,4398214,,True,26.0,5,7,2,4,3,3,0,0,1,0,1,1,0,1,0,0,13
401408169,North Dakota State Bison,S. Griesel,4398213,,True,38.0,10,16,8,12,2,4,2,4,1,7,8,5,0,1,5,4,24
401408169,North Dakota State Bison,T. Eady,4279514,,True,31.0,2,4,1,1,1,3,2,2,0,4,4,3,1,0,2,4,7
401408169,North Dakota State Bison,A. Morgan,4897275,,False,7.0,1,1,1,1,0,0,0,0,0,1,1,0,0,0,0,2,2
401408169,North Dakota State Bison,W. Guy,4897272,,False,1.0,0,0,0,0,0,0,0,0,0,0,0,0,0,0,0,0,0
401408169,North Dakota State Bison,B. Skunberg,4702671,,False,21.0,0,6,0,2,0,4,0,0,0,4,4,0,0,0,0,3,0
401408169,North Dakota State Bison,M. Harden-Hayes,4431974,,False,9.0,3,4,1,2,2,2,0,0,0,0,0,0,0,0,0,1,8
401408169,North Dakota State Bison,TEAM,TOTAL,TOTAL,False,,27,58,19,35,8,23,7,11,4,30,34,10,1,3,10,19,69
401408168,Oral Roberts Golden Eagles,E. Lufile,4593822,,True,17.0,0,3,0,3,0,0,0,0,5,3,8,0,0,1,0,1,0
401408168,Oral Roberts Golden Eagles,F. Lacis,4398309,,True,31.0,1,6,0,1,1,5,0,1,1,9,10,0,0,0,0,3,3
401408168,Oral Roberts Golden Eagles,K. Thompson,4702657,,True,17.0,0,2,0,1,0,1,0,0,0,2,2,0,0,0,1,2,0
401408168,Oral Roberts Golden Eagles,M. Abmas,4432932,,True,35.0,11,23,7,13,4,10,2,3,2,1,3,1,0,0,0,3,28
401408168,Oral Roberts Golden Eagles,I. McBride,4431769,,True,32.0,7,18,4,12,3,6,2,2,1,2,3,1,0,0,2,1,19
401408168,Oral Roberts Golden Eagles,L. Tekavcic,4897260,,False,2.0,1,1,0,0,1,1,0,0,0,0,0,0,0,0,0,0,3
401408168,Oral Roberts Golden Eagles,S. Herron,4897258,,False,3.0,0,0,0,0,0,0,0,0,0,0,0,0,0,0,0,0,0
401408168,Oral Roberts Golden Eagles,I. Plet,4702662,,False,2.0,0,0,0,0,0,0,0,0,0,0,0,0,0,0,0,0,0
401408168,Oral Roberts Golden Eagles,D. Weaver,4593825,,False,19.0,1,5,0,1,1,4,0,0,1,1,2,0,0,2,0,1,3
401408168,Oral Roberts Golden Eagles,N. Clover III,4702659,,False,2.0,0,0,0,0,0,0,0,0,0,1,1,0,0,0,0,0,0
401408168,Oral Roberts Golden Eagles,E. Lawrence,4897259,,False,2.0,0,0,0,0,0,0,0,0,0,0,0,1,0,0,0,0,0
401408168,Oral Roberts Golden Eagles,J. Bergens,4702658,,False,2.0,2,2,1,1,1,1,0,0,0,0,0,0,0,0,0,0,5
401408168,Oral Roberts Golden Eagles,T. Phipps,4601286,,False,10.0,1,6,1,4,0,2,3,4,0,1,1,0,1,0,0,2,5
401408168,Oral Roberts Golden Eagles,C. Jürgens,4398306,,False,26.0,2,7,2,6,0,1,2,4,1,3,4,1,1,0,0,1,6
401408168,Oral Roberts Golden Eagles,TEAM,TOTAL,TOTAL,False,,26,73,15,42,11,31,9,14,12,23,35,4,2,3,3,14,72
401408168,North Dakota State Bison,G. Nelson,4702670,,True,31.0,9,11,9,10,0,1,2,2,2,6,8,1,1,2,1,2,20
401408168,North Dakota State Bison,R. Kreuser,4279518,,True,29.0,5,11,4,9,1,2,5,7,0,5,5,0,0,1,1,3,16
401408168,North Dakota State Bison,J. Cook,4398214,,True,23.0,3,7,2,5,1,2,1,2,0,3,3,1,0,1,0,2,8
401408168,North Dakota State Bison,S. Griesel,4398213,,True,34.0,12,18,11,16,1,2,1,4,1,8,9,8,0,1,1,1,26
401408168,North Dakota State Bison,T. Eady,4279514,,True,28.0,3,5,3,4,0,1,2,3,3,3,6,2,0,2,1,3,8
401408168,North Dakota State Bison,A. Morgan,4897275,,False,7.0,2,3,2,3,0,0,0,0,0,3,3,0,0,0,2,0,4
401408168,North Dakota State Bison,J. Streit,4897274,,False,2.0,0,0,0,0,0,0,0,0,0,0,0,0,0,0,0,0,0
401408168,North Dakota State Bison,K. Rada,4897276,,False,1.0,1,1,1,1,0,0,0,0,0,0,0,0,0,0,0,0,2
401408168,North Dakota State Bison,A. Kallman,4897273,,False,2.0,0,0,0,0,0,0,0,0,0,0,0,0,0,0,0,0,0
401408168,North Dakota State Bison,W. Guy,4897272,,False,2.0,0,1,0,0,0,1,0,0,0,0,0,1,0,0,0,0,0
401408168,North Dakota State Bison,B. Skunberg,4702671,,False,24.0,2,3,0,1,2,2,0,0,0,2,2,1,1,0,0,1,6
401408168,North Dakota State Bison,G. Haman,4585599,,False,1.0,0,0,0,0,0,0,0,0,0,0,0,0,0,0,0,0,0
401408168,North Dakota State Bison,M. Harden-Hayes,4431974,,False,16.0,1,3,1,2,0,1,0,0,1,3,4,1,0,0,1,1,2
401408168,North Dakota State Bison,TEAM,TOTAL,TOTAL,False,,38,63,33,51,5,12,11,18,8,37,45,15,2,7,8,13,92
401408167,South Dakota State Jackrabbits,D. Wilson,4593842,,True,24.0,8,11,8,11,0,0,5,9,0,8,8,1,1,0,4,1,21
401408167,South Dakota State Jackrabbits,B. Scheierman,4593841,,True,27.0,6,9,4,5,2,4,4,4,0,5,5,3,0,0,2,4,18
401408167,South Dakota State Jackrabbits,Z. Mayo,4897251,,True,29.0,5,9,2,5,3,4,0,0,1,1,2,3,0,0,0,0,13
401408167,South Dakota State Jackrabbits,C. Easley,4592707,,True,29.0,2,5,0,1,2,4,2,2,2,2,4,3,0,0,0,1,8
401408167,South Dakota State Jackrabbits,A. Arians,4279531,,True,14.0,2,3,2,2,0,1,0,0,0,1,1,1,0,0,2,4,4
401408167,South Dakota State Jackrabbits,L. Appel,4702644,,False,29.0,4,4,4,4,0,0,0,0,0,8,8,0,0,0,0,2,8
401408167,South Dakota State Jackrabbits,A. Fiegen,4398339,,False,2.0,0,0,0,0,0,0,0,0,1,0,1,0,0,0,0,0,0
401408167,South Dakota State Jackrabbits,M. Dentlinger,4279530,,False,19.0,2,4,2,4,0,0,2,2,0,1,1,1,1,1,0,0,6
401408167,South Dakota State Jackrabbits,D. Wingett,4396637,,False,2.0,0,1,0,0,0,1,0,0,0,0,0,0,0,0,0,0,0
401408167,South Dakota State Jackrabbits,J. Gentry,4897250,,False,2.0,0,1,0,0,0,1,0,0,0,0,0,0,1,0,0,0,0
401408167,South Dakota State Jackrabbits,N. Freidel,4431956,,False,2.0,0,1,0,0,0,1,0,0,0,0,0,0,0,0,0,0,0
401408167,South Dakota State Jackrabbits,M. Mims,4398338,,False,21.0,2,4,1,1,1,3,0,0,0,1,1,2,1,0,0,3,5
401408167,South Dakota State Jackrabbits,TEAM,TOTAL,TOTAL,False,,31,52,23,33,8,19,13,17,7,27,34,14,4,1,8,15,83
401408167,South Dakota Coyotes,T. Kamateros,4593838,,True,29.0,2,6,2,3,0,3,0,1,0,1,1,4,0,1,1,2,4
401408167,South Dakota Coyotes,H. Goodrick,4593836,,True,25.0,3,6,2,3,1,3,0,0,2,6,8,0,0,1,1,2,7
401408167,South Dakota Coyotes,M. Archambault,4702648,,True,38.0,3,9,1,6,2,3,2,2,0,2,2,1,1,0,0,2,10
401408167,South Dakota Coyotes,B. Anderson,4702646,,True,25.0,4,7,4,7,0,0,0,2,1,0,1,1,2,0,1,2,8
401408167,South Dakota Coyotes,K. Perrott-Hunt,4394666,,True,34.0,7,13,5,7,2,6,3,3,0,0,0,2,0,0,1,1,19
401408167,South Dakota Coyotes,N. Zizic,4702652,,False,2.0,0,0,0,0,0,0,0,0,0,0,0,0,0,0,0,0,0
401408167,South Dakota Coyotes,E. Oliver,4897256,,False,11.0,0,5,0,2,0,3,0,0,1,2,3,1,0,0,1,0,0
401408167,South Dakota Coyotes,K. Kutcher,4897255,,False,7.0,1,3,1,1,0,2,0,1,0,0,0,0,0,0,0,0,2
401408167,South Dakota Coyotes,D. Hayes,4702651,,False,14.0,0,0,0,0,0,0,0,0,0,0,0,0,0,0,0,1,0
401408167,South Dakota Coyotes,X. Fuller,4702647,,False,13.0,4,6,4,6,0,0,0,0,0,1,1,0,0,0,0,2,8
401408167,South Dakota Coyotes,K. Koster,4593837,,False,2.0,1,1,1,1,0,0,0,0,0,0,0,0,0,0,0,0,2
401408167,South Dakota Coyotes,TEAM,TOTAL,TOTAL,False,,25,56,20,36,5,20,5,9,5,14,19,9,3,2,6,12,60
401408166,Western Illinois Leathernecks,W. Carius,4702623,,True,37.0,2,9,2,4,0,5,0,1,1,2,3,3,1,0,1,1,4
401408166,Western Illinois Leathernecks,L. Barisic,4593286,,True,35.0,2,7,0,2,2,5,0,0,0,7,7,0,0,1,2,1,6
401408166,Western Illinois Leathernecks,T. Pearson,4397727,,True,23.0,7,11,7,11,0,0,0,0,2,2,4,0,0,0,0,1,14
401408166,Western Illinois Leathernecks,C. Sandage,4702620,,True,31.0,3,8,0,0,3,8,2,3,0,6,6,2,2,1,0,5,11
401408166,Western Illinois Leathernecks,T. Massner,4594126,,True,40.0,10,23,6,13,4,10,4,4,1,3,4,3,2,1,4,3,28
401408166,Western Illinois Leathernecks,C. Burrell,4702616,,False,17.0,2,3,2,3,0,0,0,2,2,3,5,0,0,0,1,0,4
401408166,Western Illinois Leathernecks,K. Lee,4897229,,False,3.0,0,0,0,0,0,0,0,0,1,0,1,0,0,0,0,0,0
401408166,Western Illinois Leathernecks,G. Dixon,4593468,,False,14.0,0,0,0,0,0,0,1,2,0,1,1,1,0,0,0,3,1
401408166,Western Illinois Leathernecks,TEAM,TOTAL,TOTAL,False,,26,61,17,33,9,28,7,12,7,25,32,9,5,3,8,14,68
401408166,Oral Roberts Golden Eagles,E. Lufile,4593822,,True,28.0,9,13,9,13,0,0,0,0,6,8,14,0,1,0,0,3,18
401408166,Oral Roberts Golden Eagles,F. Lacis,4398309,,True,33.0,3,6,1,1,2,5,0,0,1,7,8,1,3,0,1,3,8
401408166,Oral Roberts Golden Eagles,K. Thompson,4702657,,True,26.0,3,7,3,5,0,2,2,2,1,1,2,1,0,0,2,3,8
401408166,Oral Roberts Golden Eagles,M. Abmas,4432932,,True,38.0,6,15,5,10,1,5,9,10,0,4,4,5,1,0,2,0,22
401408166,Oral Roberts Golden Eagles,I. McBride,4431769,,True,28.0,4,10,3,8,1,2,2,2,0,2,2,4,0,0,3,2,11
401408166,Oral Roberts Golden Eagles,I. Plet,4702662,,False,0.0,0,0,0,0,0,0,0,0,0,0,0,0,0,0,0,0,0
401408166,Oral Roberts Golden Eagles,D. Weaver,4593825,,False,18.0,4,8,1,2,3,6,0,0,1,5,6,0,0,2,0,1,11
401408166,Oral Roberts Golden Eagles,T. Phipps,4601286,,False,8.0,0,4,0,1,0,3,0,0,0,0,0,1,0,0,0,0,0
401408166,Oral Roberts Golden Eagles,C. Jürgens,4398306,,False,21.0,1,3,1,2,0,1,0,0,0,2,2,1,0,0,0,1,2
401408166,Oral Roberts Golden Eagles,TEAM,TOTAL,TOTAL,False,,30,66,23,42,7,24,13,14,11,31,42,13,5,2,8,13,80
401408165,South Dakota Coyotes,T. Kamateros,4593838,,True,35.0,6,12,5,8,1,4,2,2,0,11,11,2,0,0,2,3,15
401408165,South Dakota Coyotes,H. Goodrick,4593836,,True,30.0,5,7,4,6,1,1,3,4,2,6,8,2,0,3,1,0,14
401408165,South Dakota Coyotes,M. Archambault,4702648,,True,37.0,3,10,1,5,2,5,6,6,0,3,3,6,0,2,3,3,14
401408165,South Dakota Coyotes,B. Anderson,4702646,,True,26.0,6,8,6,8,0,0,0,0,1,2,3,0,3,0,0,2,12
401408165,South Dakota Coyotes,K. Perrott-Hunt,4394666,,True,30.0,3,9,3,7,0,2,7,8,2,3,5,2,0,0,1,3,13
401408165,South Dakota Coyotes,E. Oliver,4897256,,False,16.0,1,1,0,0,1,1,0,0,0,2,2,1,0,0,1,0,3
401408165,South Dakota Coyotes,D. Hayes,4702651,,False,15.0,1,2,1,2,0,0,1,1,1,3,4,0,0,0,1,4,3
401408165,South Dakota Coyotes,X. Fuller,4702647,,False,11.0,0,3,0,2,0,1,0,0,0,2,2,0,0,1,0,1,0
401408165,South Dakota Coyotes,TEAM,TOTAL,TOTAL,False,,25,52,20,38,5,14,19,21,6,33,39,13,3,6,10,16,74
401408165,Kansas City Roos,J. Allick,4593968,,True,40.0,4,10,2,6,2,4,0,2,1,3,4,0,0,0,2,2,10
401408165,Kansas City Roos,A. Lamar,4066775,,True,35.0,4,12,3,8,1,4,2,2,1,8,9,2,1,0,1,3,11
401408165,Kansas City Roos,S. Martin,4593971,,True,4.0,1,1,1,1,0,0,0,0,0,0,0,1,1,0,1,3,2
401408165,Kansas City Roos,M. Nesbitt Jr.,4280195,,True,37.0,8,17,8,14,0,3,3,5,1,3,4,4,2,0,0,2,19
401408165,Kansas City Roos,E. Gilyard II,4279109,,True,40.0,3,13,2,6,1,7,4,4,1,0,1,1,0,0,0,2,11
401408165,Kansas City Roos,C. Boser,4702638,,False,3.0,0,0,0,0,0,0,0,0,0,0,0,0,0,1,0,3,0
401408165,Kansas City Roos,S. Allen,4897232,,False,26.0,2,3,2,3,0,0,1,2,1,3,4,2,0,0,1,4,5
401408165,Kansas City Roos,T. Barnes,4897230,,False,1.0,0,0,0,0,0,0,0,0,0,0,0,0,0,0,0,0,0
401408165,Kansas City Roos,A. Kopp,4593765,,False,14.0,1,3,0,0,1,3,0,0,0,2,2,0,0,0,0,1,3
401408165,Kansas City Roos,TEAM,TOTAL,TOTAL,False,,23,59,18,38,5,21,10,15,5,19,24,10,4,1,5,20,61
401408164,North Dakota State Bison,G. Nelson,4702670,,True,33.0,5,13,3,5,2,8,2,2,1,3,4,2,0,1,1,2,14
401408164,North Dakota State Bison,R. Kreuser,4279518,,True,27.0,7,13,5,8,2,5,6,6,2,4,6,0,1,1,3,5,22
401408164,North Dakota State Bison,J. Cook,4398214,,True,12.0,1,4,1,3,0,1,1,2,1,0,1,0,0,0,0,2,3
401408164,North Dakota State Bison,S. Griesel,4398213,,True,39.0,3,7,3,6,0,1,5,6,0,6,6,8,2,0,2,2,11
401408164,North Dakota State Bison,T. Eady,4279514,,True,32.0,6,8,4,5,2,3,1,2,0,8,8,1,1,1,2,2,15
401408164,North Dakota State Bison,A. Morgan,4897275,,False,10.0,1,1,1,1,0,0,1,2,0,2,2,1,0,0,2,0,3
401408164,North Dakota State Bison,J. Streit,4897274,,False,2.0,0,0,0,0,0,0,0,0,0,1,1,0,0,0,0,0,0
401408164,North Dakota State Bison,K. Rada,4897276,,False,1.0,0,0,0,0,0,0,0,0,0,0,0,0,0,0,0,0,0
401408164,North Dakota State Bison,A. Kallman,4897273,,False,2.0,0,0,0,0,0,0,0,0,0,0,0,1,0,0,0,0,0
401408164,North Dakota State Bison,W. Guy,4897272,,False,2.0,1,1,1,1,0,0,0,0,0,0,0,0,0,0,0,0,2
401408164,North Dakota State Bison,B. Skunberg,4702671,,False,27.0,2,4,1,1,1,3,2,2,0,1,1,0,0,0,1,2,7
401408164,North Dakota State Bison,G. Haman,4585599,,False,1.0,1,1,0,0,1,1,0,0,0,0,0,0,0,0,0,0,3
401408164,North Dakota State Bison,M. Harden-Hayes,4431974,,False,12.0,0,1,0,1,0,0,2,2,0,2,2,0,0,0,0,0,2
401408164,North Dakota State Bison,TEAM,TOTAL,TOTAL,False,,27,53,19,31,8,22,20,24,4,28,32,13,4,3,11,15,82
401408164,Denver Pioneers,T. Tainamo,4897292,,True,18.0,3,3,3,3,0,0,0,0,0,2,2,0,0,0,0,4,6
401408164,Denver Pioneers,M. Henn,4066923,,True,23.0,2,3,2,3,0,0,0,3,2,4,6,3,0,0,2,3,4
401408164,Denver Pioneers,C. Porter,4897288,,True,26.0,3,12,0,2,3,10,0,4,1,1,2,1,0,0,2,1,9
401408164,Denver Pioneers,T. Smith,4897287,,True,24.0,5,9,5,9,0,0,0,0,0,3,3,2,0,0,1,5,10
401408164,Denver Pioneers,K. Hunt,4593678,,True,27.0,6,14,4,10,2,4,2,2,0,5,5,3,2,0,6,1,16
401408164,Denver Pioneers,P. Lopez-Sanvicente,4897291,,False,7.0,1,1,1,1,0,0,0,0,0,1,1,0,1,0,0,0,2
401408164,Denver Pioneers,J. Bickham,4593704,,False,2.0,1,1,1,1,0,0,0,0,0,0,0,0,0,0,0,0,2
401408164,Denver Pioneers,T. Green,4593703,,False,27.0,2,2,2,2,0,0,1,1,1,2,3,1,1,0,1,3,5
401408164,Denver Pioneers,J. Johnson,4897289,,False,22.0,2,6,1,2,1,4,1,2,1,4,5,2,0,0,1,1,6
401408164,Denver Pioneers,K. Hess,4702683,,False,2.0,0,0,0,0,0,0,0,0,0,0,0,0,0,0,0,0,0
401408164,Denver Pioneers,T. Gatlin,4398061,,False,15.0,1,3,1,2,0,1,0,0,0,1,1,0,0,0,1,2,2
401408164,Denver Pioneers,P. Moore,4397687,,False,7.0,0,0,0,0,0,0,0,0,0,0,0,2,0,0,0,0,0
401408164,Denver Pioneers,TEAM,TOTAL,TOTAL,False,,26,54,20,35,6,19,4,12,5,23,28,14,4,0,14,20,62
401408163,South Dakota State Jackrabbits,D. Wilson,4593842,,True,31.0,7,14,7,14,0,0,8,10,4,3,7,0,0,1,3,3,22
401408163,South Dakota State Jackrabbits,B. Scheierman,4593841,,True,34.0,6,12,2,6,4,6,4,6,1,2,3,5,2,0,0,3,20
401408163,South Dakota State Jackrabbits,Z. Mayo,4897251,,True,28.0,2,7,0,2,2,5,1,2,1,1,2,1,1,0,1,1,7
401408163,South Dakota State Jackrabbits,C. Easley,4592707,,True,31.0,2,5,1,2,1,3,2,2,0,1,1,2,3,0,1,2,7
401408163,South Dakota State Jackrabbits,A. Arians,4279531,,True,28.0,2,6,2,5,0,1,2,2,1,7,8,3,1,0,0,2,6
401408163,South Dakota State Jackrabbits,L. Appel,4702644,,False,13.0,3,5,3,5,0,0,3,4,2,0,2,1,0,0,2,2,9
401408163,South Dakota State Jackrabbits,M. Dentlinger,4279530,,False,15.0,3,5,3,5,0,0,3,5,4,3,7,1,0,1,0,1,9
401408163,South Dakota State Jackrabbits,M. Mims,4398338,,False,20.0,2,3,1,1,1,2,2,2,0,1,1,0,0,0,0,1,7
401408163,South Dakota State Jackrabbits,TEAM,TOTAL,TOTAL,False,,27,57,19,40,8,17,25,33,13,19,32,13,7,2,7,15,87
401408163,Omaha Mavericks,F. Fidler,4897263,,True,38.0,11,18,8,15,3,3,9,10,1,2,3,0,1,0,6,2,34
401408163,Omaha Mavericks,A. Arop,4431820,,True,30.0,5,9,5,8,0,1,0,1,3,4,7,1,0,0,2,2,10
401408163,Omaha Mavericks,D. Brougham,4702679,,True,21.0,3,5,3,5,0,0,2,2,2,2,4,2,2,0,0,2,8
401408163,Omaha Mavericks,F. Lemetti,4398076,,True,36.0,5,11,2,4,3,7,0,0,0,3,3,5,0,0,4,4,13
401408163,Omaha Mavericks,M. Smith,4280189,,True,23.0,3,5,1,2,2,3,0,0,0,3,3,3,0,0,2,4,8
401408163,Omaha Mavericks,D. Evans,4702681,,False,4.0,0,0,0,0,0,0,0,0,0,0,0,0,0,0,0,2,0
401408163,Omaha Mavericks,D. Hughes,4593782,,False,15.0,1,2,1,2,0,0,0,0,1,1,2,0,0,0,1,5,2
401408163,Omaha Mavericks,S. Roe,4702677,,False,20.0,2,5,2,5,0,0,0,0,1,2,3,0,0,1,0,2,4
401408163,Omaha Mavericks,K. Luedtke,4398237,,False,13.0,0,2,0,1,0,1,0,0,0,2,2,1,1,0,0,3,0
401408163,Omaha Mavericks,TEAM,TOTAL,TOTAL,False,,30,57,22,42,8,15,11,13,10,21,31,12,4,1,15,26,79
401408162,Texas A&M Aggies,H. Coleman III,4432186,,True,24.0,5,7,5,7,0,0,2,3,3,4,7,0,0,0,1,1,12
401408162,Texas A&M Aggies,W. Taylor IV,4683833,,True,20.0,3,9,2,5,1,4,0,0,2,1,3,2,1,0,1,4,7
401408162,Texas A&M Aggies,Q. Jackson,4592829,,True,35.0,3,9,3,7,0,2,3,4,0,2,2,3,1,0,3,2,9
401408162,Texas A&M Aggies,M. Obaseki,4433277,,True,19.0,0,2,0,2,0,0,2,2,0,2,2,1,0,0,0,1,2
401408162,Texas A&M Aggies,T. Radford,4395685,,True,32.0,4,14,1,6,3,8,2,2,0,6,6,0,3,0,1,1,13
401408162,Texas A&M Aggies,E. Henderson,4395706,,False,14.0,0,0,0,0,0,0,0,1,0,1,1,0,0,0,0,1,0
401408162,Texas A&M Aggies,A. Cash,4896467,,False,14.0,1,3,1,3,0,0,0,0,4,2,6,0,0,0,0,0,2
401408162,Texas A&M Aggies,H. Hefner,4433279,,False,12.0,0,2,0,0,0,2,1,2,0,0,0,0,1,0,3,2,1
401408162,Texas A&M Aggies,H. Diarra,4433160,,False,18.0,0,3,0,2,0,1,4,4,0,3,3,0,0,0,1,1,4
401408162,Texas A&M Aggies,A. Gordon,4431779,,False,10.0,0,2,0,0,0,2,0,0,0,1,1,0,0,0,1,1,0
401408162,Texas A&M Aggies,TEAM,TOTAL,TOTAL,False,,16,51,12,32,4,19,14,18,10,24,34,6,6,0,12,14,50
401408162,Tennessee Volunteers,B. Huntley-Hatfield,4432680,,True,14.0,1,5,1,5,0,0,0,2,1,1,2,2,1,0,0,1,2
401408162,Tennessee Volunteers,U. Plavsic,4397023,,True,13.0,1,1,1,1,0,0,1,2,4,0,4,1,1,1,1,3,3
401408162,Tennessee Volunteers,S. Vescovi,4609299,,True,35.0,4,9,0,0,4,9,5,5,0,3,3,5,2,0,1,2,17
401408162,Tennessee Volunteers,K. Chandler,4432646,,True,37.0,5,9,1,2,4,7,0,1,0,4,4,7,1,0,0,2,14
401408162,Tennessee Volunteers,J. James,4431685,,True,38.0,6,16,3,9,3,7,1,1,2,8,10,2,1,3,1,2,16
401408162,Tennessee Volunteers,J. Aidoo,4684682,,False,3.0,1,1,1,1,0,0,0,0,0,0,0,0,0,0,0,0,2
401408162,Tennessee Volunteers,J. Fulkerson,4066215,,False,28.0,3,9,3,9,0,0,2,3,2,10,12,1,0,0,3,3,8
401408162,Tennessee Volunteers,Z. Zeigler,4883573,,False,31.0,1,5,0,1,1,4,0,0,0,2,2,1,2,0,6,1,3
401408162,Tennessee Volunteers,V. Bailey Jr.,4278512,,False,1.0,0,1,0,0,0,1,0,0,0,0,0,0,0,0,0,0,0
401408162,Tennessee Volunteers,TEAM,TOTAL,TOTAL,False,,22,56,10,28,12,28,9,14,12,29,41,19,8,4,13,14,65
401408161,Tennessee Volunteers,B. Huntley-Hatfield,4432680,,True,22.0,4,7,4,7,0,0,0,2,1,5,6,1,0,0,2,2,8
401408161,Tennessee Volunteers,U. Plavsic,4397023,,True,19.0,3,4,3,4,0,0,0,0,3,5,8,0,0,0,1,2,6
401408161,Tennessee Volunteers,S. Vescovi,4609299,,True,37.0,2,8,0,1,2,7,3,4,0,5,5,3,1,0,1,3,9
401408161,Tennessee Volunteers,K. Chandler,4432646,,True,34.0,8,16,7,13,1,3,2,3,1,2,3,2,1,0,3,2,19
401408161,Tennessee Volunteers,J. James,4431685,,True,30.0,3,8,1,4,2,4,2,2,1,3,4,3,0,1,4,4,10
401408161,Tennessee Volunteers,J. Aidoo,4684682,,False,9.0,0,1,0,1,0,0,1,2,0,1,1,0,0,1,0,2,1
401408161,Tennessee Volunteers,J. Fulkerson,4066215,,False,22.0,0,2,0,2,0,0,3,4,0,3,3,1,1,0,0,1,3
401408161,Tennessee Volunteers,Z. Zeigler,4883573,,False,21.0,2,5,1,4,1,1,6,8,0,2,2,1,1,0,2,4,11
401408161,Tennessee Volunteers,J. Mashack,4683934,,False,2.0,0,0,0,0,0,0,0,0,0,1,1,0,0,0,0,0,0
401408161,Tennessee Volunteers,V. Bailey Jr.,4278512,,False,4.0,1,1,1,1,0,0,0,0,0,0,0,0,1,0,0,1,2
401408161,Tennessee Volunteers,TEAM,TOTAL,TOTAL,False,,23,52,17,37,6,15,17,25,8,30,38,11,5,2,13,21,69
401408161,Kentucky Wildcats,T. Washington Jr.,4683749,,True,37.0,6,16,5,9,1,7,4,5,0,6,6,4,3,1,2,2,17
401408161,Kentucky Wildcats,K. Brooks Jr.,4431689,,True,28.0,7,11,6,8,1,3,4,4,3,2,5,0,1,0,3,4,19
401408161,Kentucky Wildcats,O. Tshiebwe,4432827,,True,24.0,5,10,5,10,0,0,3,7,4,7,11,0,0,2,2,5,13
401408161,Kentucky Wildcats,S. Wheeler,4431725,,True,35.0,3,11,3,9,0,2,4,4,1,5,6,3,1,1,1,1,10
401408161,Kentucky Wildcats,K. Grady,4278349,,True,27.0,1,8,1,3,0,5,0,0,0,2,2,0,1,0,0,2,2
401408161,Kentucky Wildcats,J. Toppin,4592461,,False,12.0,0,2,0,2,0,0,0,0,1,1,2,0,0,0,1,1,0
401408161,Kentucky Wildcats,L. Ware,4433152,,False,16.0,0,0,0,0,0,0,0,0,3,3,6,0,0,0,0,2,0
401408161,Kentucky Wildcats,D. Allen,4431741,,False,1.0,0,0,0,0,0,0,0,0,0,0,0,0,0,0,0,0,0
401408161,Kentucky Wildcats,D. Mintz,4065766,,False,20.0,0,6,0,3,0,3,1,2,1,0,1,1,0,1,0,1,1
401408161,Kentucky Wildcats,TEAM,TOTAL,TOTAL,False,,22,64,20,44,2,20,16,22,16,27,43,8,6,5,10,18,62
401408160,Texas A&M Aggies,H. Coleman III,4432186,,True,24.0,4,8,4,8,0,0,2,2,3,1,4,2,0,0,1,1,10
401408160,Texas A&M Aggies,W. Taylor IV,4683833,,True,21.0,3,9,2,6,1,3,2,2,0,1,1,1,1,0,1,1,9
401408160,Texas A&M Aggies,Q. Jackson,4592829,,True,33.0,7,16,6,13,1,3,5,8,1,4,5,6,4,0,4,2,20
401408160,Texas A&M Aggies,M. Obaseki,4433277,,True,17.0,1,4,0,3,1,1,0,0,0,0,0,1,1,0,1,2,3
401408160,Texas A&M Aggies,T. Radford,4395685,,True,34.0,4,5,2,3,2,2,1,1,0,5,5,3,1,0,1,1,11
401408160,Texas A&M Aggies,A. Smith,4701266,,False,1.0,0,0,0,0,0,0,0,0,0,0,0,0,0,0,0,0,0
401408160,Texas A&M Aggies,E. Henderson,4395706,,False,7.0,0,0,0,0,0,0,0,0,1,3,4,1,1,0,0,1,0
401408160,Texas A&M Aggies,J. Brown,4702024,,False,1.0,0,0,0,0,0,0,0,0,0,0,0,0,0,0,0,0,0
401408160,Texas A&M Aggies,A. Cash,4896467,,False,13.0,4,4,4,4,0,0,0,0,1,2,3,1,0,0,0,4,8
401408160,Texas A&M Aggies,H. Hefner,4433279,,False,17.0,4,8,3,5,1,3,0,0,0,3,3,2,1,0,0,1,9
401408160,Texas A&M Aggies,H. Diarra,4433160,,False,18.0,4,6,2,4,2,2,2,2,0,1,1,0,0,0,1,2,12
401408160,Texas A&M Aggies,A. Gordon,4431779,,False,13.0,0,1,0,0,0,1,0,0,0,3,3,1,0,1,2,1,0
401408160,Texas A&M Aggies,Z. Walker,4403533,,False,1.0,0,0,0,0,0,0,0,0,0,1,1,0,0,0,2,0,0
401408160,Texas A&M Aggies,TEAM,TOTAL,TOTAL,False,,31,61,23,46,8,15,12,15,9,29,38,18,9,1,13,16,82
401408160,Arkansas Razorbacks,J. Williams,4432823,,True,26.0,2,5,2,4,0,1,0,1,1,8,9,2,1,0,5,3,4
401408160,Arkansas Razorbacks,T. Wade,4279111,,True,11.0,0,1,0,1,0,0,0,0,1,2,3,0,0,0,0,1,0
401408160,Arkansas Razorbacks,A. Toney,4395671,,True,39.0,6,9,6,8,0,1,6,6,1,2,3,1,1,2,2,4,18
401408160,Arkansas Razorbacks,S. Umude,4279532,,True,35.0,7,13,4,8,3,5,3,3,0,3,3,0,1,2,2,0,20
401408160,Arkansas Razorbacks,JD Notae,4278435,,True,27.0,2,8,2,3,0,5,1,1,0,4,4,5,0,1,3,3,5
401408160,Arkansas Razorbacks,K. Johnson,4397556,,False,7.0,0,0,0,0,0,0,0,0,0,0,0,0,0,0,0,0,0
401408160,Arkansas Razorbacks,J. Robinson,4702528,,False,2.0,0,0,0,0,0,0,0,0,0,0,0,0,0,0,0,0,0
401408160,Arkansas Razorbacks,K. Robinson,4565207,,False,4.0,1,1,1,1,0,0,3,4,0,0,0,0,1,0,0,0,5
401408160,Arkansas Razorbacks,D. Davis,4432197,,False,31.0,5,12,5,8,0,4,1,1,1,1,2,4,1,0,1,1,11
401408160,Arkansas Razorbacks,C. Lykes,4277889,,False,18.0,0,4,0,2,0,2,1,2,0,0,0,1,1,0,2,2,1
401408160,Arkansas Razorbacks,TEAM,TOTAL,TOTAL,False,,23,53,20,35,3,18,15,18,4,21,25,13,6,5,15,14,64
401408159,Vanderbilt Commodores,L. Robbins,4397347,,True,23.0,4,8,3,4,1,4,0,0,2,2,4,1,1,4,1,1,9
401408159,Vanderbilt Commodores,M. Stute,4433340,,True,32.0,4,7,1,1,3,6,0,0,1,5,6,0,2,0,0,1,11
401408159,Vanderbilt Commodores,J. Wright,4432920,,True,32.0,10,12,5,6,5,6,2,2,1,5,6,0,0,0,1,3,27
401408159,Vanderbilt Commodores,S. Pippen Jr.,4431785,,True,36.0,2,17,1,10,1,7,5,5,0,1,1,7,0,0,3,2,10
401408159,Vanderbilt Commodores,R. Chatman,4067250,,True,32.0,3,9,2,4,1,5,0,0,0,3,3,2,2,0,3,3,7
401408159,Vanderbilt Commodores,Q. Millora-Brown,4397691,,False,19.0,1,2,1,2,0,0,1,2,1,0,1,0,0,1,2,3,3
401408159,Vanderbilt Commodores,T. Lawrence,4702530,,False,12.0,2,6,2,6,0,0,0,1,2,0,2,0,2,0,1,0,4
401408159,Vanderbilt Commodores,S. Dezonie,4683732,,False,9.0,0,1,0,1,0,0,0,0,0,0,0,0,0,0,0,1,0
401408159,Vanderbilt Commodores,J. Mann,4589479,,False,5.0,0,0,0,0,0,0,0,0,1,0,1,1,0,0,0,1,0
401408159,Vanderbilt Commodores,TEAM,TOTAL,TOTAL,False,,26,62,15,34,11,28,8,10,10,17,27,11,7,5,11,15,71
401408159,Kentucky Wildcats,T. Washington Jr.,4683749,,True,32.0,8,17,4,12,4,5,5,6,0,3,3,1,1,0,2,2,25
401408159,Kentucky Wildcats,K. Brooks Jr.,4431689,,True,14.0,2,6,2,5,0,1,0,0,2,1,3,0,0,0,0,3,4
401408159,Kentucky Wildcats,O. Tshiebwe,4432827,,True,38.0,5,9,5,9,0,0,2,2,5,9,14,1,0,5,2,0,12
401408159,Kentucky Wildcats,S. Wheeler,4431725,,True,37.0,4,13,4,11,0,2,0,0,1,5,6,11,0,0,4,2,8
401408159,Kentucky Wildcats,K. Grady,4278349,,True,23.0,3,5,1,2,2,3,0,0,0,0,0,1,0,0,2,3,8
401408159,Kentucky Wildcats,D. Collins,4611412,,False,3.0,0,0,0,0,0,0,0,0,0,2,2,0,0,0,0,0,0
401408159,Kentucky Wildcats,J. Toppin,4592461,,False,20.0,5,6,5,5,0,1,0,0,0,2,2,1,0,3,1,1,10
401408159,Kentucky Wildcats,B. Hopkins,4565698,,False,1.0,0,0,0,0,0,0,0,0,0,0,0,0,0,0,0,0,0
401408159,Kentucky Wildcats,L. Ware,4433152,,False,4.0,0,0,0,0,0,0,0,0,0,3,3,1,2,0,0,1,0
401408159,Kentucky Wildcats,D. Mintz,4065766,,False,28.0,3,5,2,2,1,3,3,5,0,0,0,5,1,1,1,3,10
401408159,Kentucky Wildcats,TEAM,TOTAL,TOTAL,False,,30,61,23,46,7,15,10,13,10,27,37,21,4,9,12,15,77
401408158,Tennessee Volunteers,B. Huntley-Hatfield,4432680,,True,22.0,5,9,5,8,0,1,0,0,0,3,3,0,0,0,3,1,10
401408158,Tennessee Volunteers,U. Plavsic,4397023,,True,20.0,2,4,2,4,0,0,0,1,1,3,4,0,0,0,1,4,4
401408158,Tennessee Volunteers,S. Vescovi,4609299,,True,34.0,3,7,1,1,2,6,2,2,0,2,2,1,2,0,0,1,10
401408158,Tennessee Volunteers,K. Chandler,4432646,,True,27.0,4,7,3,5,1,2,2,2,1,0,1,6,2,0,0,0,11
401408158,Tennessee Volunteers,J. James,4431685,,True,30.0,6,11,2,5,4,6,0,1,2,3,5,4,1,0,0,2,16
401408158,Tennessee Volunteers,J. Aidoo,4684682,,False,2.0,1,1,1,1,0,0,0,0,1,0,1,0,0,0,0,2,2
401408158,Tennessee Volunteers,J. Fulkerson,4066215,,False,29.0,3,7,3,7,0,0,2,4,1,5,6,2,0,0,1,3,8
401408158,Tennessee Volunteers,Z. Zeigler,4883573,,False,29.0,5,10,4,7,1,3,0,0,0,1,1,8,3,0,1,2,11
401408158,Tennessee Volunteers,J. Powell,4432250,,False,5.0,0,1,0,0,0,1,0,0,0,1,1,0,0,0,0,0,0
401408158,Tennessee Volunteers,V. Bailey Jr.,4278512,,False,2.0,0,1,0,1,0,0,0,0,0,1,1,0,0,0,0,1,0
401408158,Tennessee Volunteers,TEAM,TOTAL,TOTAL,False,,29,58,21,39,8,19,6,10,8,21,29,21,8,0,6,16,72
401408158,Mississippi State Bulldogs,T. Smith,4397882,,True,35.0,4,9,4,9,0,0,6,7,2,0,2,2,0,0,2,2,14
401408158,Mississippi State Bulldogs,G. Brooks,4277908,,True,31.0,2,7,0,3,2,4,0,0,1,4,5,0,0,0,1,3,6
401408158,Mississippi State Bulldogs,A. Garcia,4702431,,True,21.0,1,2,1,2,0,0,0,2,2,4,6,2,2,0,3,0,2
401408158,Mississippi State Bulldogs,S. Moore,4602027,,True,33.0,4,11,2,5,2,6,5,5,0,6,6,3,1,0,2,2,15
401408158,Mississippi State Bulldogs,I. Molinar,4432885,,True,36.0,3,9,3,7,0,2,4,5,1,3,4,3,0,0,2,2,10
401408158,Mississippi State Bulldogs,D. Fountain,4702432,,False,10.0,0,2,0,1,0,1,0,0,1,0,1,0,0,0,2,1,0
401408158,Mississippi State Bulldogs,J. Davis,4592739,,False,4.0,0,1,0,1,0,0,0,0,1,0,1,0,0,0,0,0,0
401408158,Mississippi State Bulldogs,D.J. Jeffries,4431682,,False,26.0,5,7,3,3,2,4,0,0,0,6,6,1,0,0,1,1,12
401408158,Mississippi State Bulldogs,C. Matthews,4432394,,False,3.0,0,0,0,0,0,0,0,0,0,1,1,1,0,0,0,3,0
401408158,Mississippi State Bulldogs,C. Carter,4898380,,False,1.0,0,0,0,0,0,0,0,0,0,0,0,0,0,0,0,1,0
401408158,Mississippi State Bulldogs,TEAM,TOTAL,TOTAL,False,,19,48,13,31,6,17,15,19,9,24,33,12,3,0,13,15,59
401408157,LSU Tigers,E. Reid,4433594,,True,20.0,2,6,2,6,0,0,0,0,0,2,2,0,2,0,0,4,4
401408157,LSU Tigers,D. Days,4396978,,True,29.0,3,7,3,4,0,3,8,10,3,7,10,0,1,1,1,4,14
401408157,LSU Tigers,M. Wilkinson,4567590,,True,28.0,3,6,1,1,2,5,0,0,0,2,2,0,1,1,1,1,8
401408157,LSU Tigers,B. Murray,4684166,,True,32.0,4,9,2,5,2,4,3,4,0,3,3,4,0,0,0,3,13
401408157,LSU Tigers,X. Pinson,4396953,,True,28.0,1,6,1,2,0,4,2,2,0,1,1,3,1,0,3,2,4
401408157,LSU Tigers,A. Fudge,4896481,,False,4.0,0,0,0,0,0,0,0,0,0,1,1,0,0,1,1,0,0
401408157,LSU Tigers,T. Eason,4433192,,False,29.0,4,10,4,8,0,2,7,7,0,1,1,3,3,1,2,3,15
401408157,LSU Tigers,E. Gaines,4682883,,False,30.0,1,7,1,6,0,1,7,8,1,4,5,2,3,1,3,3,9
401408157,LSU Tigers,TEAM,TOTAL,TOTAL,False,,18,51,14,32,4,19,27,31,6,22,28,12,11,5,12,21,67
401408157,Arkansas Razorbacks,J. Williams,4432823,,True,37.0,3,10,3,9,0,1,0,0,2,9,11,2,1,4,1,2,6
401408157,Arkansas Razorbacks,T. Wade,4279111,,True,37.0,3,6,2,3,1,3,0,0,3,4,7,1,0,1,2,3,7
401408157,Arkansas Razorbacks,A. Toney,4395671,,True,38.0,6,11,4,8,2,3,8,10,3,7,10,2,0,0,1,4,22
401408157,Arkansas Razorbacks,S. Umude,4279532,,True,20.0,3,7,2,4,1,3,0,0,2,3,5,2,0,0,2,4,7
401408157,Arkansas Razorbacks,JD Notae,4278435,,True,32.0,4,14,3,7,1,7,10,13,2,4,6,3,4,0,4,2,19
401408157,Arkansas Razorbacks,K. Johnson,4397556,,False,2.0,0,0,0,0,0,0,0,0,2,0,2,0,1,0,0,1,0
401408157,Arkansas Razorbacks,D. Davis,4432197,,False,5.0,0,0,0,0,0,0,0,0,0,0,0,0,0,0,2,1,0
401408157,Arkansas Razorbacks,C. Lykes,4277889,,False,29.0,5,9,4,5,1,4,7,8,0,1,1,2,3,0,1,4,18
401408157,Arkansas Razorbacks,TEAM,TOTAL,TOTAL,False,,24,57,18,36,6,21,25,31,14,28,42,12,9,5,15,21,79
401408156,Texas A&M Aggies,H. Coleman III,4432186,,True,38.0,8,15,8,15,0,0,0,0,2,8,10,3,1,0,1,0,16
401408156,Texas A&M Aggies,W. Taylor IV,4683833,,True,33.0,3,10,2,6,1,4,2,2,1,6,7,1,2,0,1,1,9
401408156,Texas A&M Aggies,Q. Jackson,4592829,,True,22.0,5,6,5,6,0,0,7,9,0,2,2,2,1,2,1,4,17
401408156,Texas A&M Aggies,M. Obaseki,4433277,,True,17.0,0,6,0,4,0,2,0,0,2,2,4,1,0,2,3,5,0
401408156,Texas A&M Aggies,T. Radford,4395685,,True,33.0,7,11,2,5,5,6,0,1,2,6,8,1,0,0,3,2,19
401408156,Texas A&M Aggies,E. Henderson,4395706,,False,1.0,0,0,0,0,0,0,0,0,0,1,1,0,0,0,1,1,0
401408156,Texas A&M Aggies,J. Brown,4702024,,False,1.0,0,0,0,0,0,0,0,0,0,0,0,0,0,0,1,0,0
401408156,Texas A&M Aggies,A. Cash,4896467,,False,10.0,0,0,0,0,0,0,0,0,0,0,0,0,0,1,0,1,0
401408156,Texas A&M Aggies,H. Hefner,4433279,,False,5.0,0,1,0,0,0,1,0,0,0,1,1,0,0,0,0,1,0
401408156,Texas A&M Aggies,H. Diarra,4433160,,False,23.0,1,7,0,5,1,2,0,1,0,2,2,2,2,0,2,1,3
401408156,Texas A&M Aggies,A. Gordon,4431779,,False,17.0,1,1,0,0,1,1,0,0,0,1,1,1,0,0,2,1,3
401408156,Texas A&M Aggies,TEAM,TOTAL,TOTAL,False,,25,57,17,41,8,16,9,13,10,32,42,11,6,5,16,17,67
401408156,Auburn Tigers,J. Smith,4432639,,True,31.0,5,16,2,6,3,10,4,6,1,8,9,4,2,2,1,2,17
401408156,Auburn Tigers,W. Kessler,4433136,,True,31.0,6,8,6,6,0,2,4,6,3,6,9,2,3,4,0,2,16
401408156,Auburn Tigers,A. Flanigan,4432874,,True,26.0,2,5,2,3,0,2,1,4,1,2,3,0,0,0,1,2,5
401408156,Auburn Tigers,K. Johnson,4432363,,True,26.0,0,14,0,8,0,6,0,0,3,3,6,0,1,1,3,2,0
401408156,Auburn Tigers,Z. Jasper,4311618,,True,24.0,2,8,1,4,1,4,2,2,2,0,2,1,2,0,1,2,7
401408156,Auburn Tigers,C. Moore,4433200,,False,2.0,0,0,0,0,0,0,0,0,0,0,0,0,0,0,0,0,0
401408156,Auburn Tigers,J. Williams,4431776,,False,9.0,1,2,1,1,0,1,0,0,1,0,1,1,0,0,1,0,2
401408156,Auburn Tigers,D. Cambridge,4567588,,False,12.0,0,3,0,1,0,2,0,0,2,0,2,0,0,0,0,2,0
401408156,Auburn Tigers,D. Cardwell,4433174,,False,9.0,0,1,0,1,0,0,0,0,1,2,3,0,1,1,0,0,0
401408156,Auburn Tigers,W. Green Jr.,4433198,,False,30.0,5,12,0,3,5,9,0,0,0,4,4,3,0,0,2,5,15
401408156,Auburn Tigers,TEAM,TOTAL,TOTAL,False,,21,69,12,33,9,36,11,18,18,25,43,11,9,8,9,17,62
401408155,Vanderbilt Commodores,L. Robbins,4397347,,True,10.0,0,3,0,1,0,2,0,0,0,2,2,0,0,1,3,5,0
401408155,Vanderbilt Commodores,M. Stute,4433340,,True,28.0,6,10,0,0,6,10,0,2,0,4,4,0,1,0,0,2,18
401408155,Vanderbilt Commodores,J. Wright,4432920,,True,36.0,3,9,3,6,0,3,7,8,1,10,11,2,3,2,1,3,13
401408155,Vanderbilt Commodores,S. Pippen Jr.,4431785,,True,37.0,5,19,4,15,1,4,15,21,2,0,2,7,1,0,1,3,26
401408155,Vanderbilt Commodores,R. Chatman,4067250,,True,20.0,3,5,1,1,2,4,4,7,0,2,2,1,1,0,2,5,12
401408155,Vanderbilt Commodores,Q. Millora-Brown,4397691,,False,30.0,2,2,2,2,0,0,1,2,1,6,7,1,0,0,2,3,5
401408155,Vanderbilt Commodores,T. Thomas,4702531,,False,19.0,1,4,1,1,0,3,2,2,0,2,2,2,2,0,1,1,4
401408155,Vanderbilt Commodores,T. Lawrence,4702530,,False,6.0,0,0,0,0,0,0,0,0,0,0,0,0,0,0,0,1,0
401408155,Vanderbilt Commodores,S. Dezonie,4683732,,False,11.0,1,1,1,1,0,0,1,1,0,1,1,0,2,0,0,1,3
401408155,Vanderbilt Commodores,J. Mann,4589479,,False,3.0,0,0,0,0,0,0,1,2,1,0,1,0,0,0,0,0,1
401408155,Vanderbilt Commodores,TEAM,TOTAL,TOTAL,False,,21,53,12,27,9,26,31,45,5,29,34,13,10,3,11,24,82
401408155,Alabama Crimson Tide,N. Gurley,4280015,,True,12.0,0,2,0,1,0,1,2,6,1,1,2,0,0,0,3,1,2
401408155,Alabama Crimson Tide,C. Bediako,4565203,,True,18.0,3,3,3,3,0,0,0,1,3,4,7,0,0,0,2,3,6
401408155,Alabama Crimson Tide,K. Ellis,4702177,,True,30.0,2,6,2,2,0,4,4,5,2,5,7,3,3,0,1,4,8
401408155,Alabama Crimson Tide,J. Shackelford,4432846,,True,34.0,6,18,0,2,6,16,3,4,0,3,3,0,1,0,1,5,21
401408155,Alabama Crimson Tide,Jah. Quinerly,4397132,,True,19.0,4,10,3,7,1,3,4,7,0,5,5,4,0,0,5,5,13
401408155,Alabama Crimson Tide,J. Rojas,4592740,,False,16.0,3,7,3,5,0,2,1,2,2,2,4,0,0,0,2,3,7
401408155,Alabama Crimson Tide,D. Miles,4433561,,False,17.0,2,7,1,2,1,5,1,2,1,2,3,0,0,0,3,3,6
401408155,Alabama Crimson Tide,J. Gary,4431707,,False,7.0,1,2,1,2,0,0,0,0,0,2,2,1,0,0,0,2,2
401408155,Alabama Crimson Tide,J. Holt,4684152,,False,15.0,2,4,2,2,0,2,3,5,2,2,4,0,1,0,0,2,7
401408155,Alabama Crimson Tide,JD Davison,4576085,,False,32.0,1,8,1,7,0,1,2,2,1,6,7,8,0,0,1,2,4
401408155,Alabama Crimson Tide,TEAM,TOTAL,TOTAL,False,,24,67,16,33,8,34,20,34,18,34,52,16,5,0,18,30,76
401408154,South Carolina Gamecocks,W. Leveque,4431805,,True,23.0,1,4,1,4,0,0,0,0,3,3,6,0,2,2,2,4,2
401408154,South Carolina Gamecocks,K. Bryant,4396951,,True,27.0,3,13,3,10,0,3,2,6,1,2,3,1,0,3,1,3,8
401408154,South Carolina Gamecocks,J. Couisnard,4396948,,True,31.0,3,14,1,9,2,5,1,2,1,4,5,4,1,0,3,2,9
401408154,South Carolina Gamecocks,E. Stevenson,4396679,,True,33.0,5,14,1,3,4,11,4,4,0,5,5,5,2,0,2,3,18
401408154,South Carolina Gamecocks,J. Reese V,4279322,,True,28.0,0,4,0,2,0,2,2,2,1,0,1,0,0,0,1,3,2
401408154,South Carolina Gamecocks,T. Woodley,4684446,,False,15.0,0,1,0,1,0,0,0,0,1,4,5,0,1,0,4,2,0
401408154,South Carolina Gamecocks,B. Martin,4397834,,False,12.0,1,2,1,2,0,0,0,0,1,1,2,0,0,0,0,0,2
401408154,South Carolina Gamecocks,T. Minott,4712656,,False,1.0,0,0,0,0,0,0,0,0,0,0,0,0,0,0,0,0,0
401408154,South Carolina Gamecocks,J. Gray,4706679,,False,2.0,0,0,0,0,0,0,0,0,0,0,0,0,0,0,0,0,0
401408154,South Carolina Gamecocks,J. Wright,4683836,,False,5.0,0,1,0,1,0,0,0,0,0,0,0,0,0,0,0,0,0
401408154,South Carolina Gamecocks,C. Carter Jr.,4593683,,False,2.0,0,0,0,0,0,0,0,0,0,0,0,0,0,0,1,1,0
401408154,South Carolina Gamecocks,D. Carter,4433188,,False,21.0,4,7,4,5,0,2,2,5,1,4,5,0,1,0,4,1,10
401408154,South Carolina Gamecocks,TEAM,TOTAL,TOTAL,False,,17,60,11,37,6,23,11,19,12,27,39,10,7,5,18,19,51
401408154,Mississippi State Bulldogs,T. Smith,4397882,,True,30.0,8,14,8,14,0,0,4,7,5,7,12,0,2,0,4,2,20
401408154,Mississippi State Bulldogs,G. Brooks,4277908,,True,31.0,4,8,4,7,0,1,1,1,1,4,5,0,2,1,0,2,9
401408154,Mississippi State Bulldogs,A. Garcia,4702431,,True,24.0,1,3,1,3,0,0,5,6,6,8,14,4,1,2,1,5,7
401408154,Mississippi State Bulldogs,S. Moore,4602027,,True,32.0,4,10,2,5,2,5,0,0,1,4,5,5,0,0,1,0,10
401408154,Mississippi State Bulldogs,I. Molinar,4432885,,True,32.0,6,20,5,17,1,3,6,7,0,2,2,2,2,0,4,1,19
401408154,Mississippi State Bulldogs,D. Fountain,4702432,,False,12.0,1,2,1,2,0,0,4,4,0,2,2,1,2,2,2,0,6
401408154,Mississippi State Bulldogs,J. Davis,4592739,,False,1.0,0,0,0,0,0,0,0,0,0,0,0,0,0,0,0,0,0
401408154,Mississippi State Bulldogs,D.J. Jeffries,4431682,,False,17.0,0,3,0,1,0,2,0,0,0,2,2,1,0,0,0,2,0
401408154,Mississippi State Bulldogs,C. Matthews,4432394,,False,6.0,0,1,0,1,0,0,0,0,0,1,1,1,2,0,1,0,0
401408154,Mississippi State Bulldogs,T. Brumfield,4898381,,False,1.0,0,0,0,0,0,0,0,2,0,0,0,0,0,0,0,0,0
401408154,Mississippi State Bulldogs,C. Carter,4898380,,False,12.0,1,2,1,2,0,0,0,0,0,1,1,1,0,0,1,3,2
401408154,Mississippi State Bulldogs,I. Stansbury,4593015,,False,1.0,0,0,0,0,0,0,0,0,0,0,0,0,0,0,0,0,0
401408154,Mississippi State Bulldogs,J. Rumph,4593014,,False,1.0,0,0,0,0,0,0,0,0,0,1,1,0,0,0,0,0,0
401408154,Mississippi State Bulldogs,TEAM,TOTAL,TOTAL,False,,25,63,22,52,3,11,20,27,15,34,49,15,11,5,15,15,73
401408153,Missouri Tigers,T. Brazile,4698719,,True,30.0,5,11,4,9,1,2,4,4,5,3,8,1,2,2,2,2,15
401408153,Missouri Tigers,Ko. Brown,4431752,,True,30.0,3,7,3,5,0,2,1,1,2,1,3,3,2,0,5,3,7
401408153,Missouri Tigers,D. Gordon,4432891,,True,28.0,7,9,3,4,4,5,1,2,2,4,6,0,0,0,2,4,19
401408153,Missouri Tigers,J. Coleman,4397811,,True,15.0,0,5,0,1,0,4,1,2,0,0,0,0,0,0,2,3,1
401408153,Missouri Tigers,J. Pickett,4396954,,True,25.0,4,9,3,6,1,3,5,5,0,3,3,3,2,0,1,2,14
401408153,Missouri Tigers,R. DeGray III,4701128,,False,24.0,2,7,1,4,1,3,1,1,1,2,3,3,2,0,1,1,6
401408153,Missouri Tigers,Ka. Brown,4690766,,False,26.0,1,1,1,1,0,0,0,0,0,4,4,5,1,1,5,1,2
401408153,Missouri Tigers,A. Davis,4431937,,False,22.0,1,6,1,6,0,0,2,2,2,1,3,1,2,0,2,1,4
401408153,Missouri Tigers,TEAM,TOTAL,TOTAL,False,,23,55,16,36,7,19,15,17,13,19,32,16,11,3,24,17,68
401408153,LSU Tigers,E. Reid,4433594,,True,22.0,6,6,6,6,0,0,0,0,1,0,1,1,1,2,2,3,12
401408153,LSU Tigers,D. Days,4396978,,True,29.0,6,11,4,7,2,4,2,2,3,4,7,0,3,1,2,3,16
401408153,LSU Tigers,M. Wilkinson,4567590,,True,24.0,0,2,0,0,0,2,0,0,0,3,3,1,0,0,1,3,0
401408153,LSU Tigers,B. Murray,4684166,,True,35.0,2,8,2,5,0,3,3,5,0,5,5,9,0,0,2,2,7
401408153,LSU Tigers,X. Pinson,4396953,,True,32.0,3,6,2,3,1,3,4,4,0,0,0,5,3,0,4,1,11
401408153,LSU Tigers,A. Fudge,4896481,,False,3.0,0,0,0,0,0,0,0,0,0,0,0,0,0,0,0,1,0
401408153,LSU Tigers,T. Eason,4433192,,False,28.0,7,11,6,7,1,4,4,5,0,5,5,0,1,2,6,2,19
401408153,LSU Tigers,E. Gaines,4682883,,False,27.0,4,6,3,3,1,3,2,2,1,1,2,2,1,2,2,0,11
401408153,LSU Tigers,TEAM,TOTAL,TOTAL,False,,28,50,23,31,5,19,15,18,5,19,24,18,9,7,19,15,76
401408152,Texas A&M Aggies,H. Coleman III,4432186,,True,41.0,7,10,7,10,0,0,8,11,4,4,8,1,5,0,2,1,22
401408152,Texas A&M Aggies,W. Taylor IV,4683833,,True,20.0,1,7,1,4,0,3,8,9,0,1,1,0,0,0,1,2,10
401408152,Texas A&M Aggies,Q. Jackson,4592829,,True,30.0,5,10,4,9,1,1,3,4,1,3,4,3,3,0,3,5,14
401408152,Texas A&M Aggies,M. Obaseki,4433277,,True,24.0,1,2,0,1,1,1,2,6,1,4,5,2,1,0,0,2,5
401408152,Texas A&M Aggies,T. Radford,4395685,,True,30.0,4,8,1,4,3,4,2,2,1,4,5,4,0,0,3,3,13
401408152,Texas A&M Aggies,E. Henderson,4395706,,False,13.0,0,1,0,1,0,0,0,1,0,1,1,1,2,0,0,3,0
401408152,Texas A&M Aggies,J. Brown,4702024,,False,2.0,0,0,0,0,0,0,0,0,0,0,0,0,0,0,0,0,0
401408152,Texas A&M Aggies,A. Cash,4896467,,False,5.0,0,0,0,0,0,0,0,0,0,1,1,0,0,0,0,1,0
401408152,Texas A&M Aggies,H. Hefner,4433279,,False,12.0,1,3,1,2,0,1,0,0,1,1,2,0,1,0,0,5,2
401408152,Texas A&M Aggies,H. Diarra,4433160,,False,28.0,4,7,1,3,3,4,3,3,1,1,2,3,3,1,4,3,14
401408152,Texas A&M Aggies,A. Gordon,4431779,,False,20.0,1,5,0,2,1,3,0,0,0,2,2,1,0,0,0,0,3
401408152,Texas A&M Aggies,TEAM,TOTAL,TOTAL,False,,24,53,15,36,9,17,26,36,10,24,34,15,15,1,15,25,83
401408152,Florida Gators,A. Duruji,4279008,,True,16.0,1,5,1,3,0,2,0,0,0,0,0,1,0,0,1,3,2
401408152,Florida Gators,C. Castleton,4397204,,True,41.0,7,11,7,11,0,0,1,2,2,4,6,3,1,1,2,3,15
401408152,Florida Gators,M. Jones,4397238,,True,27.0,1,6,1,2,0,4,0,0,0,3,3,2,0,0,1,0,2
401408152,Florida Gators,T. Appleby,4280299,,True,20.0,0,4,0,1,0,3,0,0,0,4,4,3,0,0,3,2,0
401408152,Florida Gators,P. Fleming Jr.,4278688,,True,34.0,5,11,4,7,1,4,6,7,2,1,3,4,3,1,6,2,17
401408152,Florida Gators,T. Gatkek,4896453,,False,3.0,0,1,0,1,0,0,0,0,1,1,2,0,1,1,1,4,0
401408152,Florida Gators,K. Reeves,4683757,,False,29.0,6,11,3,4,3,7,6,8,3,3,6,1,1,0,1,1,21
401408152,Florida Gators,N. Lane,4565449,,False,22.0,6,8,5,7,1,1,3,5,4,5,9,0,1,1,0,1,16
401408152,Florida Gators,B. McKissic,4280190,,False,33.0,2,7,2,4,0,3,3,3,0,2,2,3,2,0,2,5,7
401408152,Florida Gators,TEAM,TOTAL,TOTAL,False,,28,64,23,40,5,24,19,25,15,24,39,17,9,4,18,21,80
401408151,Vanderbilt Commodores,L. Robbins,4397347,,True,13.0,2,6,2,5,0,1,0,0,0,3,3,1,0,2,3,1,4
401408151,Vanderbilt Commodores,M. Stute,4433340,,True,24.0,3,7,0,0,3,7,2,3,1,4,5,1,0,1,0,2,11
401408151,Vanderbilt Commodores,J. Wright,4432920,,True,22.0,4,6,1,2,3,4,0,0,2,5,7,2,1,1,2,3,11
401408151,Vanderbilt Commodores,S. Pippen Jr.,4431785,,True,23.0,6,12,5,9,1,3,1,2,1,1,2,1,2,1,1,3,14
401408151,Vanderbilt Commodores,R. Chatman,4067250,,True,10.0,3,7,2,3,1,4,1,1,0,1,1,2,0,0,1,3,8
401408151,Vanderbilt Commodores,M. Adelman,4702532,,False,4.0,0,1,0,0,0,1,0,0,0,1,1,1,0,0,0,0,0
401408151,Vanderbilt Commodores,T. Frank,4433146,,False,11.0,2,3,1,1,1,2,0,0,2,1,3,0,0,0,0,1,5
401408151,Vanderbilt Commodores,Q. Millora-Brown,4397691,,False,19.0,1,1,1,1,0,0,0,0,1,3,4,0,0,1,0,0,2
401408151,Vanderbilt Commodores,G. Calton,4896466,,False,2.0,1,1,0,0,1,1,0,0,0,0,0,0,0,0,0,0,3
401408151,Vanderbilt Commodores,T. Thomas,4702531,,False,20.0,2,7,0,1,2,6,0,0,1,1,2,3,0,0,0,2,6
401408151,Vanderbilt Commodores,T. Lawrence,4702530,,False,13.0,2,4,1,1,1,3,2,2,0,2,2,0,0,0,0,2,7
401408151,Vanderbilt Commodores,S. Dezonie,4683732,,False,17.0,4,5,2,2,2,3,0,0,1,3,4,1,0,0,0,0,10
401408151,Vanderbilt Commodores,G. Dorsey,4683639,,False,7.0,1,4,1,1,0,3,0,0,0,0,0,1,0,0,1,0,2
401408151,Vanderbilt Commodores,D. Weikert,4598779,,False,7.0,1,2,0,0,1,2,0,0,0,0,0,2,1,0,0,1,3
401408151,Vanderbilt Commodores,J. Mann,4589479,,False,8.0,0,2,0,1,0,1,0,1,1,3,4,1,0,0,0,4,0
401408151,Vanderbilt Commodores,TEAM,TOTAL,TOTAL,False,,32,68,16,27,16,41,6,9,12,31,43,16,4,6,9,22,86
401408151,Georgia Bulldogs,B. Bridges,4593259,,True,35.0,5,11,5,11,0,0,5,6,1,10,11,2,1,0,0,0,15
401408151,Georgia Bulldogs,J. Etter,4594269,,True,22.0,0,0,0,0,0,0,2,4,0,0,0,2,0,0,0,1,2
401408151,Georgia Bulldogs,C. Wright,4896464,,True,25.0,2,4,2,4,0,0,0,0,0,0,0,0,0,0,2,3,4
401408151,Georgia Bulldogs,K. Oquendo,4896463,,True,32.0,3,10,3,6,0,4,5,7,0,3,3,0,0,0,2,0,11
401408151,Georgia Bulldogs,A. Cook,4067063,,True,33.0,2,11,1,6,1,5,2,2,1,6,7,5,3,0,8,2,7
401408151,Georgia Bulldogs,D. Ridgnal,4896465,,False,10.0,0,3,0,1,0,2,0,1,1,2,3,1,0,1,0,1,0
401408151,Georgia Bulldogs,T. McMillan,4702886,,False,1.0,0,0,0,0,0,0,0,0,0,0,0,0,0,0,1,0,0
401408151,Georgia Bulldogs,N. Baumann,4278713,,False,16.0,2,3,1,1,1,2,5,5,0,2,2,0,0,0,0,1,10
401408151,Georgia Bulldogs,C. McDowell,4896462,,False,3.0,0,2,0,0,0,2,0,0,0,0,0,0,0,0,0,0,0
401408151,Georgia Bulldogs,J. Abdur-Rahim,4432191,,False,23.0,0,3,0,1,0,2,2,2,1,1,2,0,1,0,2,4,2
401408151,Georgia Bulldogs,TEAM,TOTAL,TOTAL,False,,14,47,12,30,2,17,21,27,6,25,31,10,5,1,15,12,51
401408150,Ole Miss Rebels,J. Brakefield,4432169,,True,21.0,1,1,1,1,0,0,1,2,0,5,5,0,0,0,1,2,3
401408150,Ole Miss Rebels,N. Brooks,4066485,,True,23.0,2,5,2,5,0,0,2,2,1,0,1,0,1,0,1,2,6
401408150,Ole Miss Rebels,M. Murrell,4702442,,True,36.0,6,14,4,8,2,6,2,4,0,4,4,2,2,0,2,4,16
401408150,Ole Miss Rebels,L. Rodriguez,4396969,,True,26.0,2,7,1,4,1,3,0,0,1,3,4,2,1,1,1,5,5
401408150,Ole Miss Rebels,J. Joiner,4278729,,True,36.0,5,15,4,13,1,2,2,2,0,4,4,2,3,0,1,3,13
401408150,Ole Miss Rebels,S. Hunter,4433011,,False,19.0,2,5,2,5,0,0,2,4,2,1,3,1,1,1,0,3,6
401408150,Ole Miss Rebels,A. Crowley,4431758,,False,17.0,3,6,3,4,0,2,1,1,0,0,0,2,0,0,0,0,7
401408150,Ole Miss Rebels,J. McBride,4396970,,False,1.0,0,0,0,0,0,0,0,0,0,0,0,0,0,0,0,0,0
401408150,Ole Miss Rebels,T. Fagan,4395719,,False,21.0,2,3,2,2,0,1,0,0,0,1,1,1,1,0,1,1,4
401408150,Ole Miss Rebels,TEAM,TOTAL,TOTAL,False,,23,56,19,42,4,14,10,15,6,19,25,10,9,2,7,20,60
401408150,Missouri Tigers,T. Brazile,4698719,,True,25.0,2,3,2,3,0,0,5,7,2,7,9,1,0,3,1,0,9
401408150,Missouri Tigers,Ko. Brown,4431752,,True,31.0,6,10,6,9,0,1,4,6,1,6,7,4,1,1,2,3,16
401408150,Missouri Tigers,D. Gordon,4432891,,True,21.0,3,7,3,5,0,2,0,0,1,4,5,0,0,0,1,4,6
401408150,Missouri Tigers,J. Coleman,4397811,,True,35.0,3,7,2,3,1,4,2,2,0,3,3,3,3,0,4,2,9
401408150,Missouri Tigers,J. Pickett,4396954,,True,34.0,4,8,4,6,0,2,1,2,1,2,3,0,0,0,1,3,9
401408150,Missouri Tigers,R. DeGray III,4701128,,False,23.0,5,9,2,4,3,5,1,2,0,2,2,0,1,0,0,2,14
401408150,Missouri Tigers,Ka. Brown,4690766,,False,4.0,0,0,0,0,0,0,0,0,0,2,2,2,0,0,0,1,0
401408150,Missouri Tigers,A. Davis,4431937,,False,27.0,4,6,4,6,0,0,1,2,1,1,2,3,0,0,2,0,9
401408150,Missouri Tigers,TEAM,TOTAL,TOTAL,False,,27,50,23,36,4,14,14,21,7,30,37,13,5,4,12,15,72
401408143,Chicago State Cougars,N. Bigirumwami,4396020,,True,22.0,0,3,0,3,0,0,0,1,2,4,6,0,1,0,2,4,0
401408143,Chicago State Cougars,T. Bayi Ba Mandeng,4896865,,True,26.0,2,4,2,4,0,0,0,2,2,2,4,0,1,0,1,3,4
401408143,Chicago State Cougars,F. Chukwukelu,4896867,,True,16.0,0,3,0,1,0,2,0,0,1,1,2,1,0,0,1,0,0
401408143,Chicago State Cougars,B. Betson,4896861,,True,39.0,10,17,8,11,2,6,2,2,0,4,4,1,1,0,4,2,24
401408143,Chicago State Cougars,J. Corbett,4896860,,True,37.0,5,11,5,7,0,4,3,5,3,5,8,0,1,0,5,4,13
401408143,Chicago State Cougars,J. Rivera,4896866,,False,4.0,0,1,0,0,0,1,0,0,0,0,0,1,0,0,0,0,0
401408143,Chicago State Cougars,K. Green,4896864,,False,3.0,0,1,0,0,0,1,0,0,0,0,0,0,0,0,0,0,0
401408143,Chicago State Cougars,B. Johnson,4896859,,False,30.0,3,5,2,3,1,2,0,0,2,3,5,0,0,0,0,3,7
401408143,Chicago State Cougars,J. Harris,4896857,,False,23.0,2,8,1,3,1,5,0,0,0,3,3,0,3,0,0,2,5
401408143,Chicago State Cougars,TEAM,TOTAL,TOTAL,False,,22,53,18,32,4,21,5,10,12,22,34,3,7,0,14,18,53
401408143,California Baptist Lancers,D. Akin,4279163,,True,32.0,2,5,2,5,0,0,2,2,4,4,8,1,1,1,3,3,6
401408143,California Baptist Lancers,E. Thomas,4066734,,True,17.0,3,4,2,2,1,2,2,4,2,2,4,0,1,1,2,0,9
401408143,California Baptist Lancers,Ta. Armstrong,4896850,,True,34.0,3,10,2,6,1,4,4,6,0,4,4,8,0,0,5,4,11
401408143,California Baptist Lancers,Tr. Armstrong,4593806,,True,38.0,4,9,0,0,4,9,0,0,2,4,6,1,1,0,0,2,12
401408143,California Baptist Lancers,Ty Rowell,4398423,,True,38.0,5,10,1,2,4,8,1,4,0,3,3,0,1,0,2,1,15
401408143,California Baptist Lancers,J. Stone,4702041,,False,8.0,1,4,1,4,0,0,0,2,1,0,1,0,0,0,1,1,2
401408143,California Baptist Lancers,T. Kund,4702038,,False,0.0,0,1,0,0,0,1,0,0,0,0,0,0,0,0,0,0,0
401408143,California Baptist Lancers,T. Campbell,4702036,,False,3.0,0,0,0,0,0,0,0,0,0,0,0,0,0,0,0,0,0
401408143,California Baptist Lancers,R. Nottage,4593807,,False,30.0,2,5,1,1,1,4,2,3,2,1,3,3,0,0,0,2,7
401408143,California Baptist Lancers,TEAM,TOTAL,TOTAL,False,,20,48,9,20,11,28,11,21,12,22,34,13,4,2,14,13,62
401407948,Houston Cougars,F. White Jr.,4278263,,True,36.0,10,21,8,15,2,6,6,8,5,5,10,1,2,2,2,0,28
401407948,Houston Cougars,J. Carlton,4278229,,True,28.0,3,8,3,8,0,0,9,11,6,3,9,2,0,0,2,3,15
401407948,Houston Cougars,J. Shead,4432241,,True,29.0,1,3,1,2,0,1,2,2,0,4,4,2,0,0,4,2,4
401407948,Houston Cougars,K. Edwards,4397081,,True,37.0,4,8,3,5,1,3,3,3,1,3,4,4,2,0,1,0,12
401407948,Houston Cougars,T. Moore,4066808,,True,34.0,5,10,3,6,2,4,0,0,0,6,6,2,1,0,0,4,12
401407948,Houston Cougars,J. Roberts,4433068,,False,13.0,0,1,0,1,0,0,0,0,1,4,5,0,0,0,0,2,0
401407948,Houston Cougars,R. Chaney,4395708,,False,3.0,0,0,0,0,0,0,0,0,0,0,0,0,0,0,1,0,0
401407948,Houston Cougars,R. Armbrester,4684151,,False,1.0,0,0,0,0,0,0,0,0,0,1,1,0,1,0,0,0,0
401407948,Houston Cougars,R. Walker,4708176,,False,19.0,0,3,0,1,0,2,0,0,0,1,1,0,0,1,2,3,0
401407948,Houston Cougars,TEAM,TOTAL,TOTAL,False,,23,54,18,38,5,16,20,24,13,28,41,11,6,3,12,14,71
401407948,Cincinnati Bearcats,A. Ado,4066288,,True,11.0,0,0,0,0,0,0,0,0,0,0,0,0,1,0,0,3,0
401407948,Cincinnati Bearcats,J. Newman III,4395622,,True,30.0,4,8,2,4,2,4,1,3,2,5,7,2,1,0,1,3,11
401407948,Cincinnati Bearcats,J. Davenport,4592898,,True,30.0,2,10,0,2,2,8,1,2,1,2,3,1,1,0,1,3,7
401407948,Cincinnati Bearcats,M. Adams-Woods,4431831,,True,21.0,1,7,1,4,0,3,0,0,0,0,0,1,1,0,1,2,2
401407948,Cincinnati Bearcats,D. DeJulius,4397202,,True,29.0,4,10,3,4,1,6,0,0,0,1,1,4,1,0,6,0,9
401407948,Cincinnati Bearcats,J. Hensley,4703828,,False,14.0,0,1,0,0,0,1,0,2,2,2,4,0,1,1,2,3,0
401407948,Cincinnati Bearcats,O. Oguama,4432075,,False,17.0,1,2,1,2,0,0,1,7,1,3,4,0,0,1,0,1,3
401407948,Cincinnati Bearcats,H. Koval,4278265,,False,4.0,0,0,0,0,0,0,0,0,0,0,0,0,0,0,0,2,0
401407948,Cincinnati Bearcats,V. Lakhin,4701192,,False,12.0,2,3,2,3,0,0,0,0,2,1,3,1,0,0,0,2,4
401407948,Cincinnati Bearcats,M. Madsen,4581506,,False,10.0,1,2,0,0,1,2,0,0,0,1,1,0,0,0,0,1,3
401407948,Cincinnati Bearcats,M. Saunders,4432403,,False,22.0,5,7,3,4,2,3,2,2,0,3,3,0,1,0,3,0,14
401407948,Cincinnati Bearcats,TEAM,TOTAL,TOTAL,False,,20,50,12,23,8,27,5,16,9,19,28,9,7,2,15,20,53
401405907,Memphis Tigers,D. Williams,4397355,,True,28.0,4,9,4,9,0,0,2,4,1,4,5,3,1,0,3,3,10
401405907,Memphis Tigers,J. Duren,4433621,,True,33.0,6,8,6,8,0,0,2,3,3,7,10,4,0,2,2,4,14
401405907,Memphis Tigers,L. Quinones,4431720,,True,31.0,3,7,2,2,1,5,0,0,0,2,2,1,1,0,1,1,7
401405907,Memphis Tigers,A. Lomax,4396633,,True,36.0,2,4,2,4,0,0,0,0,1,2,3,4,1,0,4,2,4
401405907,Memphis Tigers,L. Nolley II,4395684,,True,26.0,1,6,1,4,0,2,0,0,0,4,4,1,0,0,3,3,2
401405907,Memphis Tigers,M. Dandridge,4431738,,False,11.0,1,1,1,1,0,0,1,2,0,0,0,0,1,0,1,4,3
401405907,Memphis Tigers,J. Minott,4687718,,False,5.0,2,3,2,3,0,0,1,2,1,0,1,0,0,0,0,1,5
401405907,Memphis Tigers,C. Lawson,4431721,,False,4.0,1,1,1,1,0,0,0,0,0,1,1,0,0,0,0,0,2
401405907,Memphis Tigers,E. Timberlake,4432193,,False,15.0,2,6,2,6,0,0,2,3,1,3,4,1,1,2,0,0,6
401405907,Memphis Tigers,T. Harris,4396632,,False,11.0,0,6,0,3,0,3,0,0,0,1,1,1,0,0,0,1,0
401405907,Memphis Tigers,TEAM,TOTAL,TOTAL,False,,22,51,21,41,1,10,8,14,9,25,34,15,5,4,15,19,53
401405907,Houston Cougars,F. White Jr.,4278263,,True,29.0,8,13,6,9,2,4,2,3,3,0,3,0,2,1,1,1,20
401405907,Houston Cougars,J. Carlton,4278229,,True,28.0,5,8,5,8,0,0,8,11,2,2,4,0,2,1,1,4,18
401405907,Houston Cougars,J. Shead,4432241,,True,31.0,3,9,1,4,2,5,2,2,0,4,4,6,1,0,0,4,10
401405907,Houston Cougars,K. Edwards,4397081,,True,37.0,3,12,1,3,2,9,0,0,1,10,11,5,3,0,2,1,8
401405907,Houston Cougars,T. Moore,4066808,,True,32.0,4,10,2,6,2,4,1,2,3,1,4,8,1,0,1,4,11
401405907,Houston Cougars,J. Roberts,4433068,,False,15.0,1,2,1,2,0,0,0,1,3,2,5,1,1,1,1,0,2
401405907,Houston Cougars,R. Chaney,4395708,,False,8.0,1,2,1,2,0,0,0,0,0,0,0,0,0,0,0,2,2
401405907,Houston Cougars,R. Walker,4708176,,False,20.0,0,2,0,0,0,2,0,0,1,0,1,0,0,0,1,0,0
401405907,Houston Cougars,TEAM,TOTAL,TOTAL,False,,25,58,17,34,8,24,13,19,13,21,34,20,10,3,9,16,71
401405906,SMU Mustangs,Ma. Weathers,4067390,,True,37.0,4,9,4,6,0,3,8,10,2,4,6,2,1,2,1,3,16
401405906,SMU Mustangs,E. Bandoumel,4593107,,True,38.0,4,10,4,5,0,5,0,0,0,2,2,1,1,0,1,3,8
401405906,SMU Mustangs,Z. Nutall,4398281,,True,26.0,3,6,1,2,2,4,0,0,0,4,4,1,1,0,0,4,8
401405906,SMU Mustangs,K. Davis,4397066,,True,40.0,3,13,2,10,1,3,5,6,0,4,4,2,2,0,4,4,12
401405906,SMU Mustangs,Mi. Weathers,4067391,,True,36.0,3,9,2,7,1,2,5,6,1,3,4,2,3,0,6,4,12
401405906,SMU Mustangs,J. Young Jr.,4396640,,False,0.0,0,0,0,0,0,0,0,0,0,0,0,0,0,0,0,0,0
401405906,SMU Mustangs,T. Clark,4277885,,False,7.0,1,1,1,1,0,0,0,0,1,1,2,0,0,0,0,2,2
401405906,SMU Mustangs,Z. Phelps,4699725,,False,9.0,1,2,1,1,0,1,0,2,0,0,0,0,2,0,0,0,2
401405906,SMU Mustangs,J. Smith,4690767,,False,7.0,1,2,0,0,1,2,0,0,0,0,0,0,0,0,0,0,3
401405906,SMU Mustangs,TEAM,TOTAL,TOTAL,False,,20,52,15,32,5,20,18,24,5,20,25,8,10,2,12,20,63
401405906,Memphis Tigers,D. Williams,4397355,,True,20.0,2,6,2,6,0,0,3,5,4,6,10,2,0,0,0,5,7
401405906,Memphis Tigers,J. Duren,4433621,,True,17.0,3,4,3,4,0,0,3,4,3,4,7,1,1,2,2,2,9
401405906,Memphis Tigers,L. Quinones,4431720,,True,35.0,3,7,1,4,2,3,2,3,1,7,8,1,3,0,1,0,10
401405906,Memphis Tigers,A. Lomax,4396633,,True,39.0,5,8,5,8,0,0,2,2,0,4,4,3,4,2,7,1,12
401405906,Memphis Tigers,L. Nolley II,4395684,,True,31.0,4,18,4,15,0,3,4,5,1,5,6,3,1,0,1,1,12
401405906,Memphis Tigers,M. Dandridge,4431738,,False,13.0,1,2,1,2,0,0,0,0,2,3,5,2,0,2,3,4,2
401405906,Memphis Tigers,J. Minott,4687718,,False,9.0,0,2,0,2,0,0,1,2,0,0,0,0,0,0,1,1,1
401405906,Memphis Tigers,E. Timberlake,4432193,,False,18.0,4,5,4,5,0,0,1,3,4,1,5,0,0,1,1,3,9
401405906,Memphis Tigers,T. Harris,4396632,,False,18.0,2,6,0,3,2,3,2,2,0,1,1,0,0,0,1,2,8
401405906,Memphis Tigers,TEAM,TOTAL,TOTAL,False,,24,58,20,49,4,9,18,26,16,32,48,12,9,7,19,19,70
401405905,Tulane Green Wave,K. Cross,4592703,,True,30.0,5,7,5,6,0,1,3,6,0,5,5,7,0,0,3,0,13
401405905,Tulane Green Wave,S. James,4602025,,True,35.0,1,5,1,5,0,0,0,2,0,1,1,5,1,0,0,2,2
401405905,Tulane Green Wave,J. Coleman,4602024,,True,22.0,2,4,1,1,1,3,2,3,0,0,0,3,2,0,3,2,7
401405905,Tulane Green Wave,J. Forbes,4431722,,True,36.0,7,14,6,8,1,6,4,4,0,7,7,2,2,1,1,3,19
401405905,Tulane Green Wave,D. Baker,4397802,,True,30.0,5,12,3,6,2,6,0,0,0,0,0,0,1,0,1,0,12
401405905,Tulane Green Wave,T. Pope,4593827,,False,26.0,3,6,1,4,2,2,2,2,2,2,4,1,0,0,1,2,10
401405905,Tulane Green Wave,O. Jankovic,4592828,,False,2.0,0,0,0,0,0,0,0,0,0,1,1,0,0,0,0,1,0
401405905,Tulane Green Wave,N. Days,4432886,,False,7.0,0,0,0,0,0,0,0,0,0,1,1,1,0,0,0,1,0
401405905,Tulane Green Wave,Q. Scott,4280277,,False,3.0,0,0,0,0,0,0,3,4,0,0,0,0,0,0,0,1,3
401405905,Tulane Green Wave,R.J. McGee,4593828,,False,5.0,0,0,0,0,0,0,0,0,0,0,0,0,0,0,0,0,0
401405905,Tulane Green Wave,S. Spencer,4065646,,False,4.0,0,2,0,0,0,2,0,0,0,0,0,0,0,0,0,0,0
401405905,Tulane Green Wave,TEAM,TOTAL,TOTAL,False,,23,50,17,30,6,20,14,21,3,18,21,19,6,1,10,12,66
401405905,Houston Cougars,F. White Jr.,4278263,,True,3.0,0,1,0,1,0,0,0,0,0,0,0,0,0,0,0,0,0
401405905,Houston Cougars,J. Carlton,4278229,,True,25.0,7,11,7,11,0,0,2,2,5,1,6,0,1,1,0,0,16
401405905,Houston Cougars,J. Shead,4432241,,True,30.0,2,8,1,3,1,5,0,0,0,3,3,6,1,0,2,1,5
401405905,Houston Cougars,K. Edwards,4397081,,True,34.0,6,13,0,1,6,12,2,2,0,7,7,8,0,0,1,0,20
401405905,Houston Cougars,T. Moore,4066808,,True,31.0,6,16,5,9,1,7,4,4,2,0,2,7,2,1,3,1,17
401405905,Houston Cougars,J. Francis,4684301,,False,5.0,0,0,0,0,0,0,1,2,0,0,0,0,0,0,0,0,1
401405905,Houston Cougars,J. Roberts,4433068,,False,34.0,5,6,5,6,0,0,0,0,5,8,13,1,1,0,2,4,10
401405905,Houston Cougars,R. Chaney,4395708,,False,10.0,2,2,2,2,0,0,1,2,1,1,2,1,0,0,1,5,5
401405905,Houston Cougars,R. Armbrester,4684151,,False,3.0,0,0,0,0,0,0,1,2,0,0,0,0,0,0,0,1,1
401405905,Houston Cougars,R. Walker,4708176,,False,23.0,4,7,1,3,3,4,0,0,1,5,6,1,1,0,1,1,11
401405905,Houston Cougars,R. Elvin,4701204,,False,2.0,0,1,0,0,0,1,0,0,1,0,1,0,0,0,0,1,0
401405905,Houston Cougars,TEAM,TOTAL,TOTAL,False,,32,65,21,36,11,29,11,14,17,26,43,24,6,2,11,14,86
401405904,UCF Knights,C.J. Walker,4592403,,True,10.0,1,6,1,4,0,2,0,0,0,0,0,1,0,0,0,0,2
401405904,UCF Knights,C. Diong,4278951,,True,18.0,3,3,3,3,0,0,1,2,0,1,1,0,2,1,0,4,7
401405904,UCF Knights,D. Johnson,4684809,,True,34.0,2,7,0,3,2,4,0,0,1,4,5,7,1,0,4,4,6
401405904,UCF Knights,D. Green Jr.,4593839,,True,38.0,2,14,1,3,1,11,2,2,0,1,1,2,2,1,1,1,7
401405904,UCF Knights,D. Perry,4277878,,True,37.0,8,15,4,7,4,8,3,3,2,3,5,7,1,1,2,4,23
401405904,UCF Knights,J. Reynolds,4432407,,False,21.0,2,2,2,2,0,0,2,4,3,2,5,0,1,1,1,0,6
401405904,UCF Knights,T. Freeman,4897194,,False,13.0,1,2,1,1,0,1,2,2,1,1,2,2,0,0,0,3,4
401405904,UCF Knights,B. Mahan,4396917,,False,5.0,0,2,0,0,0,2,0,0,1,0,1,0,0,0,2,0,0
401405904,UCF Knights,D. Fuller Jr.,4396670,,False,24.0,5,10,1,5,4,5,0,0,1,0,1,0,1,0,1,0,14
401405904,UCF Knights,TEAM,TOTAL,TOTAL,False,,24,61,13,28,11,33,10,13,10,14,24,19,8,4,11,16,69
401405904,Memphis Tigers,D. Williams,4397355,,True,28.0,6,13,6,13,0,0,2,2,4,2,6,3,2,1,0,1,14
401405904,Memphis Tigers,J. Duren,4433621,,True,27.0,8,14,8,14,0,0,5,7,6,14,20,2,2,2,3,1,21
401405904,Memphis Tigers,L. Nolley II,4395684,,True,30.0,2,7,2,3,0,4,4,4,2,2,4,3,0,0,3,1,8
401405904,Memphis Tigers,L. Quinones,4431720,,True,28.0,8,12,3,4,5,8,1,2,0,2,2,0,1,0,0,4,22
401405904,Memphis Tigers,A. Lomax,4396633,,True,31.0,1,2,0,1,1,1,0,0,0,1,1,7,3,0,3,3,3
401405904,Memphis Tigers,M. Dandridge,4431738,,False,6.0,0,0,0,0,0,0,0,0,0,0,0,0,0,0,1,1,0
401405904,Memphis Tigers,J. Minott,4687718,,False,17.0,3,5,3,5,0,0,6,7,3,4,7,2,1,1,0,0,12
401405904,Memphis Tigers,C. Lawson,4431721,,False,5.0,0,0,0,0,0,0,0,0,0,2,2,0,0,0,0,0,0
401405904,Memphis Tigers,E. Timberlake,4432193,,False,6.0,2,2,2,2,0,0,1,1,0,1,1,1,0,0,1,0,5
401405904,Memphis Tigers,J. Hardaway,4396635,,False,4.0,0,1,0,0,0,1,0,0,0,0,0,0,0,0,0,1,0
401405904,Memphis Tigers,T. Harris,4396632,,False,18.0,0,5,0,2,0,3,0,0,1,1,2,3,0,0,2,1,0
401405904,Memphis Tigers,TEAM,TOTAL,TOTAL,False,,30,61,24,44,6,17,19,23,17,30,47,21,9,4,14,13,85
401405903,Tulsa Golden Hurricane,R. Idowu,4397373,,True,22.0,2,5,2,5,0,0,1,2,2,6,8,1,0,0,1,3,5
401405903,Tulsa Golden Hurricane,J. Horne,4066390,,True,39.0,4,15,4,12,0,3,4,6,2,5,7,4,1,1,1,3,12
401405903,Tulsa Golden Hurricane,C. Haywood II,4593833,,True,34.0,2,7,1,4,1,3,1,2,1,5,6,7,0,1,5,2,6
401405903,Tulsa Golden Hurricane,S. Griffin,4432994,,True,31.0,6,21,3,10,3,11,1,1,0,1,1,1,0,1,2,1,16
401405903,Tulsa Golden Hurricane,D. Jackson,4278408,,True,32.0,4,8,2,6,2,2,1,1,3,3,6,0,1,1,2,3,11
401405903,Tulsa Golden Hurricane,N. Konstantynovskyi,4897154,,False,7.0,0,0,0,0,0,0,0,0,1,3,4,0,0,0,0,0,0
401405903,Tulsa Golden Hurricane,S. Gaston-Chapman,4708216,,False,11.0,1,2,1,2,0,0,1,4,1,0,1,0,0,0,0,5,3
401405903,Tulsa Golden Hurricane,L. Draine,4279101,,False,24.0,2,5,1,2,1,3,0,0,1,4,5,1,0,1,1,0,5
401405903,Tulsa Golden Hurricane,TEAM,TOTAL,TOTAL,False,,21,63,14,41,7,22,9,16,15,29,44,14,2,5,12,17,58
401405903,SMU Mustangs,Ma. Weathers,4067390,,True,30.0,7,11,7,10,0,1,4,8,3,6,9,0,0,0,0,3,18
401405903,SMU Mustangs,E. Bandoumel,4593107,,True,36.0,5,13,1,4,4,9,2,2,0,6,6,4,0,0,0,3,16
401405903,SMU Mustangs,Z. Nutall,4398281,,True,33.0,3,8,1,1,2,7,0,0,0,4,4,4,1,1,1,1,8
401405903,SMU Mustangs,K. Davis,4397066,,True,38.0,7,23,1,8,6,15,4,4,1,4,5,5,4,0,1,2,24
401405903,SMU Mustangs,Mi. Weathers,4067391,,True,30.0,4,7,3,5,1,2,3,5,0,5,5,2,0,7,0,1,12
401405903,SMU Mustangs,F. Agunanne,4397431,,False,5.0,0,0,0,0,0,0,0,0,1,0,1,0,1,0,0,1,0
401405903,SMU Mustangs,J. Young Jr.,4396640,,False,1.0,0,0,0,0,0,0,0,0,0,0,0,0,0,0,0,0,0
401405903,SMU Mustangs,T. Clark,4277885,,False,11.0,0,1,0,1,0,0,0,0,1,3,4,0,0,2,0,0,0
401405903,SMU Mustangs,Z. Phelps,4699725,,False,12.0,2,2,2,2,0,0,1,2,1,0,1,2,2,0,1,2,5
401405903,SMU Mustangs,J. Smith,4690767,,False,3.0,0,0,0,0,0,0,0,0,0,0,0,1,0,0,0,0,0
401405903,SMU Mustangs,D. McBride,4433034,,False,1.0,0,0,0,0,0,0,0,0,0,0,0,0,0,0,0,0,0
401405903,SMU Mustangs,TEAM,TOTAL,TOTAL,False,,28,65,15,31,13,34,14,21,11,30,41,18,8,10,3,13,83
401405902,Tulane Green Wave,K. Cross,4592703,,True,29.0,8,10,7,8,1,2,1,2,1,8,9,4,1,0,5,3,18
401405902,Tulane Green Wave,S. James,4602025,,True,38.0,4,4,3,3,1,1,0,0,0,3,3,9,1,5,1,1,9
401405902,Tulane Green Wave,J. Coleman,4602024,,True,29.0,2,10,1,5,1,5,0,0,0,0,0,3,1,1,4,0,5
401405902,Tulane Green Wave,J. Forbes,4431722,,True,37.0,2,8,1,4,1,4,7,8,1,8,9,2,2,0,4,3,12
401405902,Tulane Green Wave,D. Baker,4397802,,True,35.0,5,11,4,8,1,3,4,4,0,2,2,0,4,1,2,3,15
401405902,Tulane Green Wave,T. Pope,4593827,,False,18.0,4,5,4,5,0,0,0,0,1,3,4,0,0,1,0,4,8
401405902,Tulane Green Wave,N. Days,4432886,,False,11.0,1,2,1,2,0,0,0,0,3,2,5,1,0,1,0,0,2
401405902,Tulane Green Wave,R.J. McGee,4593828,,False,2.0,0,0,0,0,0,0,0,0,0,0,0,0,0,0,0,0,0
401405902,Tulane Green Wave,S. Spencer,4065646,,False,1.0,0,0,0,0,0,0,0,0,0,0,0,0,0,0,0,0,0
401405902,Tulane Green Wave,TEAM,TOTAL,TOTAL,False,,26,50,21,35,5,15,12,14,6,28,34,19,9,9,17,14,69
401405902,Temple Owls,N. Jourdain,4701221,,True,12.0,1,5,1,5,0,0,0,0,2,1,3,0,0,0,1,1,2
401405902,Temple Owls,H. Miller,4708218,,True,34.0,5,11,2,3,3,8,8,9,0,2,2,4,2,0,1,0,21
401405902,Temple Owls,J. White,4432514,,True,36.0,2,13,1,9,1,4,0,0,6,4,10,0,1,0,4,4,5
401405902,Temple Owls,D. Dunn,4431946,,True,19.0,3,8,2,5,1,3,0,0,0,0,0,1,1,0,4,1,7
401405902,Temple Owls,T. Strickland,4397253,,True,34.0,1,12,1,11,0,1,2,2,6,3,9,4,3,0,2,3,4
401405902,Temple Owls,Z. Hicks,4708214,,False,30.0,4,12,2,4,2,8,2,3,0,2,2,1,1,1,1,2,12
401405902,Temple Owls,S. Tolbert III,4398355,,False,13.0,1,2,0,0,1,2,2,3,2,4,6,0,3,0,0,2,5
401405902,Temple Owls,J. Forrester,4397009,,False,14.0,2,4,2,4,0,0,0,0,2,2,4,1,0,1,0,2,4
401405902,Temple Owls,C. Daly,4711160,,False,8.0,0,0,0,0,0,0,0,0,0,1,1,1,1,0,1,0,0
401405902,Temple Owls,TEAM,TOTAL,TOTAL,False,,19,67,11,41,8,26,14,17,19,19,38,12,12,2,14,15,60
401405901,Houston Cougars,F. White Jr.,4278263,,True,34.0,7,13,5,10,2,3,2,2,3,5,8,1,0,0,1,2,18
401405901,Houston Cougars,J. Carlton,4278229,,True,15.0,4,4,4,4,0,0,0,0,2,1,3,0,0,1,2,5,8
401405901,Houston Cougars,J. Shead,4432241,,True,37.0,6,10,6,8,0,2,3,4,1,4,5,7,0,1,1,3,15
401405901,Houston Cougars,K. Edwards,4397081,,True,36.0,4,11,4,5,0,6,4,6,1,3,4,1,1,0,3,1,12
401405901,Houston Cougars,T. Moore,4066808,,True,34.0,2,5,1,3,1,2,4,4,0,6,6,4,2,0,3,3,9
401405901,Houston Cougars,J. Francis,4684301,,False,1.0,0,0,0,0,0,0,0,0,0,1,1,0,0,0,0,0,0
401405901,Houston Cougars,J. Roberts,4433068,,False,17.0,2,3,2,3,0,0,0,3,1,4,5,0,1,0,1,2,4
401405901,Houston Cougars,R. Chaney,4395708,,False,11.0,0,0,0,0,0,0,0,0,0,1,1,0,1,2,0,3,0
401405901,Houston Cougars,R. Armbrester,4684151,,False,1.0,0,0,0,0,0,0,0,0,0,0,0,0,0,0,0,0,0
401405901,Houston Cougars,R. Walker,4708176,,False,13.0,0,0,0,0,0,0,3,3,0,1,1,1,0,0,0,2,3
401405901,Houston Cougars,R. Elvin,4701204,,False,1.0,0,0,0,0,0,0,0,0,0,0,0,0,0,0,0,0,0
401405901,Houston Cougars,TEAM,TOTAL,TOTAL,False,,25,46,22,33,3,13,16,22,9,29,38,14,5,4,11,21,69
401405901,Cincinnati Bearcats,A. Ado,4066288,,True,24.0,0,1,0,1,0,0,1,2,4,1,5,0,2,0,2,1,1
401405901,Cincinnati Bearcats,J. Newman III,4395622,,True,31.0,6,9,5,6,1,3,0,1,3,1,4,4,0,0,0,2,13
401405901,Cincinnati Bearcats,J. Davenport,4592898,,True,31.0,4,14,1,3,3,11,2,2,2,3,5,1,1,0,2,3,13
401405901,Cincinnati Bearcats,M. Adams-Woods,4431831,,True,28.0,2,8,0,3,2,5,4,4,0,2,2,4,1,0,0,1,10
401405901,Cincinnati Bearcats,D. DeJulius,4397202,,True,31.0,3,16,2,7,1,9,2,3,1,2,3,2,0,0,1,2,9
401405901,Cincinnati Bearcats,J. Hensley,4703828,,False,11.0,0,0,0,0,0,0,3,4,0,3,3,0,0,0,0,1,3
401405901,Cincinnati Bearcats,O. Oguama,4432075,,False,13.0,1,3,1,3,0,0,0,1,4,1,5,0,0,0,1,2,2
401405901,Cincinnati Bearcats,H. Koval,4278265,,False,3.0,0,1,0,0,0,1,0,0,0,0,0,0,0,0,0,0,0
401405901,Cincinnati Bearcats,V. Lakhin,4701192,,False,7.0,0,0,0,0,0,0,0,0,1,0,1,0,0,0,1,2,0
401405901,Cincinnati Bearcats,C. Anthony,4897054,,False,1.0,0,1,0,0,0,1,0,0,0,0,0,0,0,0,0,0,0
401405901,Cincinnati Bearcats,M. Madsen,4581506,,False,4.0,0,1,0,1,0,0,0,0,0,0,0,0,0,0,0,0,0
401405901,Cincinnati Bearcats,M. Saunders,4432403,,False,15.0,1,5,1,3,0,2,3,4,0,0,0,1,3,0,0,2,5
401405901,Cincinnati Bearcats,S. Martin,4278221,,False,1.0,0,0,0,0,0,0,0,0,0,0,0,0,0,0,0,0,0
401405901,Cincinnati Bearcats,TEAM,TOTAL,TOTAL,False,,17,59,10,27,7,32,15,21,15,14,29,12,7,0,7,16,56
401405900,UCF Knights,C.J. Walker,4592403,,True,34.0,2,11,1,7,1,4,1,1,1,6,7,0,0,3,0,1,6
401405900,UCF Knights,C. Diong,4278951,,True,32.0,4,7,4,7,0,0,0,0,0,8,8,2,0,5,2,2,8
401405900,UCF Knights,D. Johnson,4684809,,True,31.0,3,12,0,6,3,6,1,2,1,4,5,4,4,0,1,3,10
401405900,UCF Knights,D. Green Jr.,4593839,,True,38.0,4,9,1,3,3,6,0,0,0,3,3,1,0,1,1,1,11
401405900,UCF Knights,D. Perry,4277878,,True,29.0,5,11,2,6,3,5,0,2,0,2,2,4,1,1,4,3,13
401405900,UCF Knights,J. Reynolds,4432407,,False,8.0,0,2,0,2,0,0,2,4,0,0,0,0,0,2,0,1,2
401405900,UCF Knights,T. Freeman,4897194,,False,17.0,3,4,3,3,0,1,4,4,2,3,5,0,1,0,1,0,10
401405900,UCF Knights,D. Fuller Jr.,4396670,,False,11.0,0,2,0,2,0,0,0,0,1,2,3,3,0,1,1,1,0
401405900,UCF Knights,TEAM,TOTAL,TOTAL,False,,21,58,11,36,10,22,8,13,7,29,36,14,6,13,10,12,60
401405900,South Florida Bulls,C. Walker Jr.,4290822,,True,15.0,3,6,3,5,0,1,0,0,2,3,5,2,1,1,2,4,6
401405900,South Florida Bulls,R. Tchewa,4432888,,True,33.0,5,13,5,13,0,0,1,2,3,7,10,0,0,0,1,2,11
401405900,South Florida Bulls,C. Murphy,4567587,,True,37.0,6,18,3,12,3,6,0,0,0,2,2,8,0,1,2,1,15
401405900,South Florida Bulls,J. Chaplin,4431925,,True,29.0,5,12,5,9,0,3,1,2,6,2,8,1,2,2,1,1,11
401405900,South Florida Bulls,J. Greene,4278360,,True,35.0,1,8,0,5,1,3,2,2,0,5,5,3,4,1,3,2,5
401405900,South Florida Bulls,B. Matos,4612507,,False,7.0,0,1,0,1,0,0,0,0,0,4,4,0,0,0,1,1,0
401405900,South Florida Bulls,J. Boggs,4431899,,False,5.0,0,0,0,0,0,0,0,0,0,0,0,0,0,0,0,0,0
401405900,South Florida Bulls,D. Patrick,4897129,,False,13.0,3,5,1,1,2,4,0,0,1,3,4,0,0,0,0,0,8
401405900,South Florida Bulls,S. Hines Jr.,4702687,,False,19.0,1,5,1,5,0,0,0,0,2,2,4,1,2,1,1,2,2
401405900,South Florida Bulls,T. Moss,4708220,,False,3.0,0,0,0,0,0,0,0,0,0,1,1,1,0,0,1,0,0
401405900,South Florida Bulls,S. Smith Jr.,4397185,,False,4.0,0,1,0,1,0,0,0,0,0,2,2,0,0,0,0,0,0
401405900,South Florida Bulls,TEAM,TOTAL,TOTAL,False,,24,69,18,52,6,17,4,6,17,32,49,16,9,6,12,13,58
401405899,Wichita State Shockers,J. Pleasant,4397958,,True,14.0,0,0,0,0,0,0,0,0,0,3,3,0,0,1,0,0,0
401405899,Wichita State Shockers,M. Udeze,4396681,,True,26.0,1,4,1,4,0,0,2,2,4,2,6,0,1,0,1,3,4
401405899,Wichita State Shockers,R. Council IV,4701234,,True,22.0,5,12,3,7,2,5,7,7,1,4,5,0,0,0,3,2,19
401405899,Wichita State Shockers,T. Etienne,4432887,,True,39.0,5,16,3,8,2,8,2,2,2,3,5,5,1,0,2,5,14
401405899,Wichita State Shockers,D. Dennis,4396676,,True,36.0,3,8,2,3,1,5,3,5,2,4,6,1,1,0,0,2,10
401405899,Wichita State Shockers,C. Jackson,4701238,,False,15.0,1,3,1,1,0,2,0,0,0,4,4,0,1,0,2,0,2
401405899,Wichita State Shockers,K. Pohto,4684445,,False,14.0,1,3,1,3,0,0,1,2,3,0,3,1,0,1,0,2,3
401405899,Wichita State Shockers,Q. Grant,4897201,,False,29.0,5,12,3,6,2,6,1,1,0,2,2,3,0,0,1,4,13
401405899,Wichita State Shockers,C. Jenkins,4701236,,False,5.0,1,2,1,2,0,0,0,0,0,0,0,0,0,0,0,2,2
401405899,Wichita State Shockers,TEAM,TOTAL,TOTAL,False,,22,60,15,34,7,26,16,19,13,23,36,10,4,2,10,20,67
401405899,Tulsa Golden Hurricane,R. Idowu,4397373,,True,27.0,4,7,4,7,0,0,2,7,4,5,9,2,1,2,1,5,10
401405899,Tulsa Golden Hurricane,J. Horne,4066390,,True,37.0,6,11,3,7,3,4,2,4,1,9,10,2,1,0,0,1,17
401405899,Tulsa Golden Hurricane,C. Haywood II,4593833,,True,39.0,1,4,1,3,0,1,0,0,1,2,3,2,2,2,4,4,2
401405899,Tulsa Golden Hurricane,S. Griffin,4432994,,True,37.0,5,15,2,5,3,10,8,9,0,2,2,1,1,0,1,1,21
401405899,Tulsa Golden Hurricane,D. Jackson,4278408,,True,38.0,8,14,7,10,1,4,3,4,2,7,9,2,1,2,1,2,20
401405899,Tulsa Golden Hurricane,N. Konstantynovskyi,4897154,,False,10.0,0,1,0,1,0,0,1,2,2,1,3,1,0,2,1,2,1
401405899,Tulsa Golden Hurricane,T. Dalger,4897153,,False,2.0,0,0,0,0,0,0,0,0,0,0,0,0,0,0,0,0,0
401405899,Tulsa Golden Hurricane,S. Gaston-Chapman,4708216,,False,4.0,0,1,0,0,0,1,0,0,0,0,0,0,0,0,0,0,0
401405899,Tulsa Golden Hurricane,L. Draine,4279101,,False,6.0,0,0,0,0,0,0,2,2,0,0,0,0,0,0,1,1,2
401405899,Tulsa Golden Hurricane,TEAM,TOTAL,TOTAL,False,,24,53,17,33,7,20,18,28,11,27,38,10,6,8,9,16,73
401405898,East Carolina Pirates,V. Jackson,4066442,,True,37.0,6,18,4,8,2,10,2,2,0,10,10,0,0,0,1,1,16
401405898,East Carolina Pirates,L. Debaut,4592970,,True,32.0,2,3,2,3,0,0,0,0,2,2,4,1,0,4,2,1,4
401405898,East Carolina Pirates,T. Robinson-White,4592968,,True,26.0,3,3,2,2,1,1,0,0,0,1,1,2,1,0,3,2,7
401405898,East Carolina Pirates,J.J. Miles,4592967,,True,35.0,2,7,2,4,0,3,0,0,0,2,2,0,0,0,0,2,4
401405898,East Carolina Pirates,T. Newton,4592965,,True,37.0,9,17,7,12,2,5,6,6,1,8,9,6,0,0,5,4,26
401405898,East Carolina Pirates,B. Johnson,4897055,,False,3.0,0,0,0,0,0,0,0,0,0,0,0,1,0,0,0,1,0
401405898,East Carolina Pirates,A. Frink,4396950,,False,8.0,0,1,0,0,0,1,0,0,0,1,1,0,0,2,1,2,0
401405898,East Carolina Pirates,B. Suggs,4592966,,False,22.0,1,4,1,4,0,0,4,4,0,1,1,2,0,2,0,3,6
401405898,East Carolina Pirates,TEAM,TOTAL,TOTAL,False,,23,53,18,33,5,20,12,12,4,28,32,12,1,8,12,16,63
401405898,Cincinnati Bearcats,J. Newman III,4395622,,True,29.0,2,6,1,2,1,4,2,4,2,6,8,5,2,0,0,2,7
401405898,Cincinnati Bearcats,A. Ado,4066288,,True,22.0,1,1,1,1,0,0,0,0,1,4,5,0,1,3,0,1,2
401405898,Cincinnati Bearcats,J. Davenport,4592898,,True,28.0,4,12,1,5,3,7,0,0,0,6,6,0,0,1,0,3,11
401405898,Cincinnati Bearcats,M. Adams-Woods,4431831,,True,25.0,0,6,0,4,0,2,6,6,3,2,5,1,0,0,1,0,6
401405898,Cincinnati Bearcats,D. DeJulius,4397202,,True,30.0,8,16,6,9,2,7,4,4,0,4,4,3,1,0,3,0,22
401405898,Cincinnati Bearcats,J. Hensley,4703828,,False,13.0,2,3,1,2,1,1,2,2,1,1,2,3,0,0,1,2,7
401405898,Cincinnati Bearcats,O. Oguama,4432075,,False,6.0,0,1,0,1,0,0,0,0,0,1,1,0,0,0,0,0,0
401405898,Cincinnati Bearcats,H. Koval,4278265,,False,12.0,2,4,2,3,0,1,0,0,0,1,1,0,1,0,0,0,4
401405898,Cincinnati Bearcats,V. Lakhin,4701192,,False,8.0,1,3,1,3,0,0,0,0,1,0,1,0,0,0,1,2,2
401405898,Cincinnati Bearcats,M. Madsen,4581506,,False,6.0,1,1,0,0,1,1,0,0,0,0,0,0,0,0,1,2,3
401405898,Cincinnati Bearcats,M. Saunders,4432403,,False,18.0,4,7,2,4,2,3,0,3,0,1,1,2,0,0,0,1,10
401405898,Cincinnati Bearcats,TEAM,TOTAL,TOTAL,False,,25,60,15,34,10,26,14,19,9,26,35,14,5,4,7,13,74
401405897,Texas Southern Tigers,J. Nicholas,4278623,,True,25.0,1,7,1,7,0,0,4,4,4,2,6,1,1,0,2,1,6
401405897,Texas Southern Tigers,B. Gresham,4066799,,True,15.0,1,3,1,3,0,0,0,0,3,4,7,0,0,1,3,4,2
401405897,Texas Southern Tigers,A. Lawson,4897771,,True,35.0,2,10,2,8,0,2,0,0,1,2,3,1,0,1,1,0,4
401405897,Texas Southern Tigers,B. Etienne,4594120,,True,33.0,3,10,2,7,1,3,2,2,1,1,2,2,2,0,1,1,9
401405897,Texas Southern Tigers,P. Henry,4431987,,True,29.0,2,10,1,6,1,4,4,6,0,2,2,1,3,0,3,4,9
401405897,Texas Southern Tigers,Y. Rasas,4594119,,False,13.0,5,7,5,6,0,1,0,0,2,1,3,0,0,0,0,1,10
401405897,Texas Southern Tigers,J. Walker III,4278121,,False,27.0,4,6,2,3,2,3,4,8,3,3,6,0,0,1,2,2,14
401405897,Texas Southern Tigers,J. Hopkins,4067629,,False,5.0,0,1,0,1,0,0,0,0,0,0,0,0,1,0,0,0,0
401405897,Texas Southern Tigers,J. Gilliam,4397615,,False,11.0,0,1,0,1,0,0,0,0,0,2,2,2,0,0,0,1,0
401405897,Texas Southern Tigers,J. Jones,4278696,,False,7.0,0,0,0,0,0,0,0,0,0,0,0,0,0,0,0,0,0
401405897,Texas Southern Tigers,TEAM,TOTAL,TOTAL,False,,18,55,14,42,4,13,14,20,16,19,35,7,7,3,13,14,54
401405897,Jackson State Tigers,T. Lewis II,4702774,,True,30.0,4,10,4,10,0,0,0,0,1,4,5,0,2,0,0,1,8
401405897,Jackson State Tigers,J. McKinnis,4403417,,True,37.0,6,9,6,9,0,0,3,5,3,10,13,0,0,3,2,2,15
401405897,Jackson State Tigers,K. Evans,4594079,,True,37.0,4,14,3,11,1,3,1,1,0,3,3,2,0,0,5,0,10
401405897,Jackson State Tigers,J. James,4594075,,True,25.0,2,6,2,4,0,2,2,2,0,1,1,1,2,0,2,3,6
401405897,Jackson State Tigers,D. Wilson,4406975,,True,31.0,0,1,0,0,0,1,0,0,0,1,1,1,0,0,0,2,0
401405897,Jackson State Tigers,J. Jones,4703203,,False,8.0,2,3,2,3,0,0,0,0,0,0,0,0,0,0,0,3,4
401405897,Jackson State Tigers,D. Hicks,4065698,,False,6.0,1,1,1,1,0,0,0,0,0,0,0,1,0,0,0,0,2
401405897,Jackson State Tigers,M. Wideman,4899538,,False,0.0,0,0,0,0,0,0,0,0,0,0,0,0,0,0,0,0,0
401405897,Jackson State Tigers,C. Young,4899535,,False,0.0,0,0,0,0,0,0,0,0,0,0,0,0,0,0,0,0,0
401405897,Jackson State Tigers,D. Taylor,4288220,,False,26.0,1,2,1,1,0,1,3,4,0,3,3,3,2,0,5,5,5
401405897,Jackson State Tigers,TEAM,TOTAL,TOTAL,False,,20,46,19,39,1,7,9,12,8,24,32,8,6,3,16,16,50
401405896,Prairie View A&M Panthers,M. Bell,4594055,,True,41.0,3,7,3,7,0,0,0,0,3,3,6,1,1,4,4,5,6
401405896,Prairie View A&M Panthers,J. Kendall,4897812,,True,21.0,1,7,1,7,0,0,5,5,2,4,6,0,0,3,1,5,7
401405896,Prairie View A&M Panthers,J. Gambrell,4397884,,True,41.0,6,16,0,2,6,14,2,4,0,3,3,1,2,2,7,1,20
401405896,Prairie View A&M Panthers,J. Daniels,4594103,,True,45.0,4,15,2,10,2,5,2,3,4,12,16,5,1,0,8,4,12
401405896,Prairie View A&M Panthers,D. Cox,4594100,,True,45.0,7,14,6,10,1,4,1,2,0,3,3,1,6,0,2,2,16
401405896,Prairie View A&M Panthers,B. Myles,4897813,,False,26.0,1,1,1,1,0,0,0,1,1,6,7,0,0,2,5,4,2
401405896,Prairie View A&M Panthers,Ty Chisom,4593834,,False,2.0,0,0,0,0,0,0,0,0,0,0,0,0,0,0,0,0,0
401405896,Prairie View A&M Panthers,C. Guess,4396958,,False,2.0,0,1,0,1,0,0,0,0,0,1,1,0,0,0,0,0,0
401405896,Prairie View A&M Panthers,D. Ware,4897811,,False,2.0,0,0,0,0,0,0,0,0,0,0,0,0,0,0,0,0,0
401405896,Prairie View A&M Panthers,TEAM,TOTAL,TOTAL,False,,22,61,13,38,9,23,10,15,15,36,51,8,10,11,27,21,63
401405896,Alcorn State Braves,L. Henry,4278645,,True,20.0,2,6,2,5,0,1,2,4,3,1,4,0,0,0,2,3,6
401405896,Alcorn State Braves,D. Agnew,4593690,,True,34.0,5,11,5,10,0,1,3,4,4,6,10,1,2,0,3,2,13
401405896,Alcorn State Braves,B. Joshua,4703131,,True,36.0,3,14,1,6,2,8,5,9,1,1,2,1,3,0,4,3,13
401405896,Alcorn State Braves,O. Walker,4398293,,True,25.0,3,8,1,3,2,5,1,4,1,1,2,1,2,0,0,1,9
401405896,Alcorn State Braves,J. Thomas,4067394,,True,35.0,2,10,2,9,0,1,3,6,1,4,5,3,4,0,2,2,7
401405896,Alcorn State Braves,D. McQuarter,4705266,,False,30.0,4,7,3,6,1,1,0,0,7,2,9,0,3,4,3,4,9
401405896,Alcorn State Braves,K. Montgomery,4432410,,False,16.0,0,9,0,1,0,8,0,0,0,4,4,0,1,0,2,1,0
401405896,Alcorn State Braves,L. Marshall,4397708,,False,1.0,0,0,0,0,0,0,0,0,0,0,0,0,0,0,0,0,0
401405896,Alcorn State Braves,D. Brewton,4594037,,False,24.0,3,9,2,7,1,2,0,1,2,3,5,1,0,0,0,2,7
401405896,Alcorn State Braves,D. Thorn,4594033,,False,4.0,0,0,0,0,0,0,0,0,0,0,0,0,0,0,0,0,0
401405896,Alcorn State Braves,TEAM,TOTAL,TOTAL,False,,22,74,16,47,6,27,14,28,24,27,51,7,15,4,17,18,64
401405895,Southern Jaguars,T. Williams Jr.,4594110,,True,25.0,3,7,1,3,2,4,2,2,0,5,5,0,0,0,1,2,10
401405895,Southern Jaguars,K. Parker,4594117,,True,8.0,1,2,1,2,0,0,0,0,2,3,5,0,0,0,0,1,2
401405895,Southern Jaguars,J. Saddler,4402919,,True,33.0,2,10,2,9,0,1,3,4,1,1,2,7,2,1,2,2,7
401405895,Southern Jaguars,T. Lyons,4398221,,True,26.0,5,9,5,8,0,1,3,11,4,4,8,0,0,0,1,3,13
401405895,Southern Jaguars,P. Byrd,4397229,,True,23.0,3,7,1,1,2,6,0,0,0,1,1,2,1,0,1,3,8
401405895,Southern Jaguars,J. Ewing,4897807,,False,10.0,0,1,0,1,0,0,0,0,0,2,2,0,0,0,0,2,0
401405895,Southern Jaguars,D. Sears,4067150,,False,21.0,2,3,2,3,0,0,0,0,1,5,6,0,1,1,1,0,4
401405895,Southern Jaguars,J. Holliday,4593685,,False,9.0,0,3,0,2,0,1,0,0,1,0,1,0,1,0,1,2,0
401405895,Southern Jaguars,B. Brooks,4402918,,False,11.0,0,0,0,0,0,0,0,1,1,0,1,1,1,0,0,1,0
401405895,Southern Jaguars,I. Rollins,4398430,,False,7.0,0,2,0,1,0,1,1,2,0,1,1,1,0,0,0,0,1
401405895,Southern Jaguars,B. Whitley,4279890,,False,26.0,4,11,2,4,2,7,3,4,1,1,2,2,0,0,1,0,13
401405895,Southern Jaguars,A. Shivers,4067352,,False,1.0,0,0,0,0,0,0,0,0,0,0,0,0,0,0,1,0,0
401405895,Southern Jaguars,TEAM,TOTAL,TOTAL,False,,20,55,14,34,6,21,12,24,13,25,38,13,6,2,11,16,58
401405895,Grambling Tigers,A. McCray,4397673,,True,18.0,3,5,3,5,0,0,2,2,1,1,2,1,0,0,2,1,8
401405895,Grambling Tigers,S. Cowart,4702762,,True,36.0,3,5,2,3,1,2,0,1,1,3,4,2,1,0,1,4,7
401405895,Grambling Tigers,T. Moton,4594071,,True,39.0,4,10,4,8,0,2,4,5,3,8,11,9,3,0,1,1,12
401405895,Grambling Tigers,P. Moss,4280109,,True,33.0,4,12,3,7,1,5,2,2,0,8,8,0,0,0,2,4,11
401405895,Grambling Tigers,C. Christon,4278638,,True,22.0,4,10,4,7,0,3,0,1,0,6,6,0,0,1,1,3,8
401405895,Grambling Tigers,T. Randolph,4594073,,False,6.0,0,2,0,2,0,0,0,0,0,1,1,0,0,0,2,1,0
401405895,Grambling Tigers,M. Lamin,4897848,,False,22.0,2,2,2,2,0,0,0,0,1,1,2,0,0,1,1,3,4
401405895,Grambling Tigers,Z. Munford,4594070,,False,15.0,3,6,2,3,1,3,0,0,0,0,0,1,1,0,2,0,7
401405895,Grambling Tigers,C. Robinson,4433101,,False,9.0,0,1,0,1,0,0,3,5,0,2,2,0,0,0,0,1,3
401405895,Grambling Tigers,TEAM,TOTAL,TOTAL,False,,23,53,20,38,3,15,11,16,8,30,38,13,5,2,12,18,60
401405894,Florida A&M Rattlers,DJ Jones,4066476,,True,28.0,3,9,3,9,0,0,0,0,2,6,8,1,0,1,0,3,6
401405894,Florida A&M Rattlers,B. Moragne,4279780,,True,37.0,3,8,3,8,0,0,0,0,3,2,5,3,0,2,0,4,6
401405894,Florida A&M Rattlers,J. Speer,4704015,,True,31.0,2,10,1,4,1,6,1,1,0,1,1,2,0,0,3,4,6
401405894,Florida A&M Rattlers,MJ Randolph,4398142,,True,40.0,7,20,7,18,0,2,5,7,2,3,5,0,3,0,3,3,19
401405894,Florida A&M Rattlers,K. Reaves,4279781,,True,34.0,5,10,2,4,3,6,0,1,0,6,6,2,1,0,0,1,13
401405894,Florida A&M Rattlers,J. Brown,4704021,,False,12.0,0,5,0,2,0,3,0,0,0,3,3,1,0,1,0,1,0
401405894,Florida A&M Rattlers,C. Barrs,4432939,,False,3.0,1,1,1,1,0,0,0,0,0,1,1,0,0,0,0,1,2
401405894,Florida A&M Rattlers,K. Littles,4704017,,False,15.0,2,4,2,3,0,1,0,0,0,1,1,1,0,0,0,2,4
401405894,Florida A&M Rattlers,TEAM,TOTAL,TOTAL,False,,23,67,19,49,4,18,6,9,9,27,36,10,4,4,6,19,56
401405894,Alabama A&M Bulldogs,M. Parker,4703104,,True,23.0,2,4,2,3,0,1,5,6,0,6,6,0,0,0,0,0,9
401405894,Alabama A&M Bulldogs,J. Johnson,4594013,,True,35.0,6,12,6,12,0,0,3,4,1,8,9,0,1,1,1,3,15
401405894,Alabama A&M Bulldogs,D. Smith,4703106,,True,37.0,2,12,0,7,2,5,6,6,1,8,9,2,0,1,3,2,12
401405894,Alabama A&M Bulldogs,G. Hicks,4594014,,True,37.0,4,12,3,7,1,5,3,5,2,7,9,1,1,0,1,1,12
401405894,Alabama A&M Bulldogs,C. Tucker,4594012,,True,38.0,2,7,2,6,0,1,3,4,1,4,5,5,1,2,2,2,7
401405894,Alabama A&M Bulldogs,A. Cortez,4703108,,False,10.0,1,4,1,2,0,2,0,0,3,1,4,0,0,0,0,0,2
401405894,Alabama A&M Bulldogs,E. Williams,4594016,,False,13.0,2,3,2,3,0,0,0,2,3,0,3,1,0,1,0,1,4
401405894,Alabama A&M Bulldogs,E. Lee,4703109,,False,7.0,0,0,0,0,0,0,0,0,0,0,0,0,0,0,1,1,0
401405894,Alabama A&M Bulldogs,TEAM,TOTAL,TOTAL,False,,19,54,16,40,3,14,20,27,12,38,50,9,3,5,9,10,61
401405893,Texas Southern Tigers,J. Nicholas,4278623,,True,20.0,1,4,1,4,0,0,0,0,1,6,7,4,1,1,1,1,2
401405893,Texas Southern Tigers,B. Gresham,4066799,,True,20.0,5,6,5,6,0,0,1,1,2,0,2,0,1,2,1,1,11
401405893,Texas Southern Tigers,A. Lawson,4897771,,True,19.0,3,5,1,2,2,3,0,0,0,3,3,2,1,0,2,2,8
401405893,Texas Southern Tigers,B. Etienne,4594120,,True,28.0,4,11,2,4,2,7,1,1,0,3,3,3,1,0,1,0,11
401405893,Texas Southern Tigers,P. Henry,4431987,,True,27.0,7,16,4,9,3,7,1,1,1,6,7,0,0,0,3,2,18
401405893,Texas Southern Tigers,Y. Rasas,4594119,,False,20.0,1,1,1,1,0,0,0,0,0,5,5,1,1,0,2,1,2
401405893,Texas Southern Tigers,J. Walker III,4278121,,False,16.0,2,6,1,3,1,3,4,4,1,3,4,2,1,1,1,2,9
401405893,Texas Southern Tigers,J. Hopkins,4067629,,False,15.0,1,3,1,2,0,1,0,0,2,0,2,1,0,0,3,1,2
401405893,Texas Southern Tigers,D. Barnes,4897774,,False,10.0,0,1,0,1,0,0,0,0,2,1,3,0,0,0,2,2,0
401405893,Texas Southern Tigers,J. Gilliam,4397615,,False,13.0,0,3,0,1,0,2,0,0,0,0,0,1,0,0,0,1,0
401405893,Texas Southern Tigers,J. Jones,4278696,,False,12.0,4,7,2,3,2,4,0,0,0,4,4,0,0,0,0,1,10
401405893,Texas Southern Tigers,TEAM,TOTAL,TOTAL,False,,28,63,18,36,10,27,7,7,11,33,44,14,6,4,17,14,73
401405893,Grambling Tigers,A. McCray,4397673,,True,21.0,3,6,3,5,0,1,4,6,3,4,7,0,2,2,1,2,10
401405893,Grambling Tigers,S. Cowart,4702762,,True,37.0,8,15,8,13,0,2,4,4,2,5,7,1,3,0,3,3,20
401405893,Grambling Tigers,T. Moton,4594071,,True,32.0,3,11,2,8,1,3,2,3,0,1,1,2,2,0,2,1,9
401405893,Grambling Tigers,P. Moss,4280109,,True,18.0,0,6,0,2,0,4,0,0,0,1,1,0,2,1,4,0,0
401405893,Grambling Tigers,C. Christon,4278638,,True,26.0,2,6,0,0,2,6,2,3,1,5,6,0,1,0,1,0,8
401405893,Grambling Tigers,T. Randolph,4594073,,False,17.0,2,3,2,3,0,0,0,0,1,3,4,0,0,0,0,1,4
401405893,Grambling Tigers,M. Lamin,4897848,,False,17.0,0,1,0,1,0,0,0,0,1,0,1,0,0,1,1,1,0
401405893,Grambling Tigers,T. Duncan,4897849,,False,4.0,0,0,0,0,0,0,0,0,0,0,0,0,1,0,1,0,0
401405893,Grambling Tigers,Q. Murrell,4897846,,False,6.0,0,2,0,2,0,0,0,0,1,0,1,0,0,0,0,0,0
401405893,Grambling Tigers,Z. Munford,4594070,,False,17.0,1,5,1,3,0,2,0,0,0,3,3,1,0,0,0,0,2
401405893,Grambling Tigers,C. Robinson,4433101,,False,5.0,0,3,0,2,0,1,1,2,0,0,0,0,0,0,0,0,1
401405893,Grambling Tigers,TEAM,TOTAL,TOTAL,False,,19,58,16,39,3,19,13,18,9,24,33,4,11,4,13,8,54
401405892,Alcorn State Braves,L. Henry,4278645,,True,25.0,2,4,2,4,0,0,4,4,1,3,4,2,2,0,1,3,8
401405892,Alcorn State Braves,D. Agnew,4593690,,True,26.0,4,11,4,11,0,0,1,3,1,2,3,1,1,0,0,2,9
401405892,Alcorn State Braves,B. Joshua,4703131,,True,8.0,0,1,0,0,0,1,0,0,0,0,0,1,0,0,0,2,0
401405892,Alcorn State Braves,O. Walker,4398293,,True,25.0,1,3,1,1,0,2,0,0,0,4,4,0,2,0,2,1,2
401405892,Alcorn State Braves,J. Thomas,4067394,,True,33.0,8,13,8,11,0,2,3,5,0,4,4,2,0,2,4,1,19
401405892,Alcorn State Braves,D. McQuarter,4705266,,False,22.0,1,5,1,5,0,0,0,0,1,2,3,1,0,1,0,4,2
401405892,Alcorn State Braves,K. Montgomery,4432410,,False,17.0,5,8,4,7,1,1,3,3,1,0,1,1,1,0,1,0,14
401405892,Alcorn State Braves,L. Marshall,4397708,,False,4.0,0,1,0,1,0,0,0,0,0,0,0,0,1,0,1,0,0
401405892,Alcorn State Braves,P. King,4899680,,False,8.0,0,1,0,0,0,1,0,0,0,0,0,0,0,0,1,2,0
401405892,Alcorn State Braves,D. Brewton,4594037,,False,32.0,6,9,5,6,1,3,2,3,1,10,11,1,1,1,1,3,15
401405892,Alcorn State Braves,TEAM,TOTAL,TOTAL,False,,27,56,25,46,2,10,13,18,7,29,36,9,8,4,14,18,69
401405892,Alabama A&M Bulldogs,M. Parker,4703104,,True,18.0,0,1,0,0,0,1,4,4,0,1,1,0,0,0,2,4,4
401405892,Alabama A&M Bulldogs,J. Johnson,4594013,,True,36.0,7,13,7,13,0,0,6,8,5,6,11,0,1,2,4,3,20
401405892,Alabama A&M Bulldogs,D. Smith,4703106,,True,35.0,1,10,1,6,0,4,4,4,2,5,7,1,3,0,3,0,6
401405892,Alabama A&M Bulldogs,G. Hicks,4594014,,True,36.0,6,17,0,6,6,11,2,3,0,3,3,1,0,0,0,3,20
401405892,Alabama A&M Bulldogs,C. Tucker,4594012,,True,40.0,4,10,4,9,0,1,0,0,2,1,3,3,1,1,1,4,8
401405892,Alabama A&M Bulldogs,A. Cortez,4703108,,False,12.0,2,4,2,4,0,0,0,0,1,2,3,1,0,0,2,2,4
401405892,Alabama A&M Bulldogs,E. Williams,4594016,,False,12.0,1,4,1,4,0,0,0,0,1,0,1,0,1,0,2,1,2
401405892,Alabama A&M Bulldogs,E. Lee,4703109,,False,11.0,0,2,0,2,0,0,0,0,0,1,1,1,0,0,0,1,0
401405892,Alabama A&M Bulldogs,TEAM,TOTAL,TOTAL,False,,21,61,15,44,6,17,16,19,13,25,38,7,6,3,14,18,64
401405891,Texas Southern Tigers,J. Nicholas,4278623,,True,21.0,4,7,4,7,0,0,3,5,3,5,8,2,0,1,1,4,11
401405891,Texas Southern Tigers,B. Gresham,4066799,,True,27.0,5,6,5,6,0,0,0,0,2,5,7,0,0,5,1,2,10
401405891,Texas Southern Tigers,A. Lawson,4897771,,True,32.0,5,7,4,5,1,2,3,4,0,0,0,4,3,1,2,1,14
401405891,Texas Southern Tigers,B. Etienne,4594120,,True,32.0,4,15,4,12,0,3,0,0,1,7,8,4,1,0,3,1,8
401405891,Texas Southern Tigers,P. Henry,4431987,,True,24.0,6,11,5,10,1,1,2,2,0,5,5,0,0,0,1,3,15
401405891,Texas Southern Tigers,Y. Rasas,4594119,,False,9.0,0,1,0,1,0,0,1,2,0,1,1,0,0,0,0,4,1
401405891,Texas Southern Tigers,J. Walker III,4278121,,False,20.0,6,8,5,7,1,1,4,4,1,5,6,0,0,2,0,3,17
401405891,Texas Southern Tigers,J. Hopkins,4067629,,False,5.0,0,0,0,0,0,0,0,0,0,1,1,0,0,0,1,0,0
401405891,Texas Southern Tigers,D. Barnes,4897774,,False,6.0,1,2,1,2,0,0,1,2,0,1,1,1,0,0,0,0,3
401405891,Texas Southern Tigers,A. Malveaux III,4705525,,False,2.0,0,0,0,0,0,0,0,0,0,0,0,0,0,0,0,0,0
401405891,Texas Southern Tigers,J. Gilliam,4397615,,False,14.0,1,2,1,1,0,1,1,2,0,3,3,2,0,0,1,3,3
401405891,Texas Southern Tigers,J. Jones,4278696,,False,8.0,2,2,1,1,1,1,0,0,0,0,0,0,0,0,1,0,5
401405891,Texas Southern Tigers,TEAM,TOTAL,TOTAL,False,,34,61,30,52,4,9,15,21,8,36,44,13,4,9,12,21,87
401405891,Alcorn State Braves,L. Henry,4278645,,True,30.0,3,10,2,6,1,4,2,4,4,3,7,0,1,1,1,3,9
401405891,Alcorn State Braves,D. Agnew,4593690,,True,13.0,1,6,1,6,0,0,2,2,0,2,2,0,0,0,2,1,4
401405891,Alcorn State Braves,B. Joshua,4703131,,True,34.0,4,13,3,10,1,3,4,5,1,1,2,1,1,1,1,3,13
401405891,Alcorn State Braves,O. Walker,4398293,,True,26.0,3,8,1,4,2,4,0,0,0,3,3,0,0,0,0,2,8
401405891,Alcorn State Braves,J. Thomas,4067394,,True,31.0,4,8,3,7,1,1,9,12,0,5,5,0,3,0,1,1,18
401405891,Alcorn State Braves,D. McQuarter,4705266,,False,23.0,0,4,0,3,0,1,0,1,1,2,3,1,1,1,0,4,0
401405891,Alcorn State Braves,K. Montgomery,4432410,,False,17.0,1,4,0,2,1,2,4,6,1,2,3,0,0,0,1,2,7
401405891,Alcorn State Braves,L. Marshall,4397708,,False,1.0,0,0,0,0,0,0,0,0,0,1,1,0,0,0,0,1,0
401405891,Alcorn State Braves,D. Brewton,4594037,,False,17.0,1,6,1,4,0,2,1,2,2,2,4,0,0,0,1,4,3
401405891,Alcorn State Braves,D. Thorn,4594033,,False,8.0,0,1,0,0,0,1,0,0,0,1,1,0,0,0,0,0,0
401405891,Alcorn State Braves,TEAM,TOTAL,TOTAL,False,,17,60,11,42,6,18,22,32,12,23,35,2,6,3,10,21,62
401405890,Texas A&M-Corpus Christi Islanders,I. Mushila,4897300,,True,27.0,2,7,2,6,0,1,4,4,5,7,12,1,1,0,1,1,8
401405890,Texas A&M-Corpus Christi Islanders,D. Keys,4703701,,True,29.0,5,7,5,7,0,0,2,2,1,2,3,2,1,0,0,1,12
401405890,Texas A&M-Corpus Christi Islanders,T. Murdix,4897301,,True,33.0,5,13,5,11,0,2,3,4,1,1,2,5,1,0,3,4,13
401405890,Texas A&M-Corpus Christi Islanders,S. Fryer,4703703,,True,33.0,3,8,2,5,1,3,0,0,0,6,6,0,1,1,0,4,7
401405890,Texas A&M-Corpus Christi Islanders,J. Jackson,4592869,,True,32.0,5,8,4,4,1,4,2,2,0,6,6,5,1,0,6,3,13
401405890,Texas A&M-Corpus Christi Islanders,S. Brinson,4278448,,False,11.0,4,7,2,3,2,4,0,0,0,1,1,1,1,1,0,0,10
401405890,Texas A&M-Corpus Christi Islanders,S. Faramade,4897304,,False,8.0,2,3,2,3,0,0,0,0,1,1,2,0,0,0,1,2,4
401405890,Texas A&M-Corpus Christi Islanders,J. Roberts,4897299,,False,1.0,0,0,0,0,0,0,0,0,0,0,0,0,0,0,0,1,0
401405890,Texas A&M-Corpus Christi Islanders,T. Nickelson,4897298,,False,3.0,0,1,0,1,0,0,0,0,0,0,0,0,0,0,0,0,0
401405890,Texas A&M-Corpus Christi Islanders,T. Tennyson,4897296,,False,8.0,0,3,0,2,0,1,0,0,0,0,0,1,0,0,0,0,0
401405890,Texas A&M-Corpus Christi Islanders,E. White,4403714,,False,1.0,0,0,0,0,0,0,0,0,0,0,0,0,0,0,0,0,0
401405890,Texas A&M-Corpus Christi Islanders,M. Smith,4278341,,False,14.0,2,3,0,1,2,2,0,0,1,1,2,2,0,0,0,2,6
401405890,Texas A&M-Corpus Christi Islanders,TEAM,TOTAL,TOTAL,False,,28,60,22,43,6,17,11,12,11,26,37,17,6,2,13,18,73
401405890,SE Louisiana Lions,J. Hinton,4897312,,True,39.0,2,5,2,5,0,0,2,2,1,6,7,2,1,6,1,0,6
401405890,SE Louisiana Lions,G. Okafor,4397641,,True,37.0,2,12,1,5,1,7,0,0,0,5,5,4,0,0,1,3,5
401405890,SE Louisiana Lions,R. Eastmond,4593700,,True,16.0,2,5,1,4,1,1,0,2,0,2,2,3,1,0,2,0,5
401405890,SE Louisiana Lions,R. Burkhardt,4278456,,True,31.0,4,5,1,1,3,4,3,3,0,1,1,1,1,0,2,3,14
401405890,SE Louisiana Lions,K. Clergeot,4066460,,True,34.0,5,9,2,3,3,6,5,6,1,3,4,2,2,0,4,2,18
401405890,SE Louisiana Lions,M. Brackmann,4594150,,False,1.0,0,0,0,0,0,0,0,0,0,0,0,0,0,0,0,0,0
401405890,SE Louisiana Lions,R. McFarlane,4897313,,False,13.0,1,5,1,4,0,1,0,0,1,1,2,1,1,0,0,2,2
401405890,SE Louisiana Lions,J. Warren,4703694,,False,1.0,0,0,0,0,0,0,3,3,0,0,0,0,0,0,0,0,3
401405890,SE Louisiana Lions,N. Caldwell,4594148,,False,1.0,0,0,0,0,0,0,0,0,0,0,0,0,0,0,0,0,0
401405890,SE Louisiana Lions,J. Kasperzyk,4397945,,False,24.0,2,7,0,4,2,3,4,4,2,0,2,1,0,0,2,3,10
401405890,SE Louisiana Lions,M. Strange,4278330,,False,3.0,0,0,0,0,0,0,2,2,0,0,0,0,0,0,0,0,2
401405890,SE Louisiana Lions,TEAM,TOTAL,TOTAL,False,,18,48,8,26,10,22,19,22,6,19,25,14,6,6,15,13,65
401405889,SE Louisiana Lions,J. Hinton,4897312,,True,40.0,5,8,5,8,0,0,6,8,3,10,13,5,1,7,2,0,16
401405889,SE Louisiana Lions,G. Okafor,4397641,,True,38.0,3,9,3,3,0,6,0,0,1,5,6,4,1,2,3,4,6
401405889,SE Louisiana Lions,R. Eastmond,4593700,,True,13.0,1,4,1,3,0,1,0,0,0,1,1,0,0,0,2,2,2
401405889,SE Louisiana Lions,R. Burkhardt,4278456,,True,33.0,2,5,0,0,2,5,4,4,1,2,3,0,0,0,0,1,10
401405889,SE Louisiana Lions,K. Clergeot,4066460,,True,14.0,2,7,1,3,1,4,0,0,0,1,1,1,4,0,2,4,5
401405889,SE Louisiana Lions,M. Brackmann,4594150,,False,2.0,0,0,0,0,0,0,0,0,0,0,0,0,0,0,0,0,0
401405889,SE Louisiana Lions,R. McFarlane,4897313,,False,27.0,5,9,3,5,2,4,1,2,1,8,9,2,1,0,0,1,13
401405889,SE Louisiana Lions,N. Caldwell,4594148,,False,5.0,1,2,0,0,1,2,0,0,0,0,0,0,0,0,0,1,3
401405889,SE Louisiana Lions,J. Kasperzyk,4397945,,False,28.0,7,11,6,8,1,3,4,4,0,1,1,7,2,0,4,3,19
401405889,SE Louisiana Lions,TEAM,TOTAL,TOTAL,False,,26,55,19,30,7,25,15,18,8,30,38,19,9,9,14,16,74
401405889,New Orleans Privateers,S. Kirkland,4703132,,True,28.0,1,4,1,4,0,0,0,0,3,2,5,2,0,2,2,2,2
401405889,New Orleans Privateers,T. Jackson,4431818,,True,28.0,4,7,4,7,0,0,2,2,1,3,4,0,0,0,1,4,10
401405889,New Orleans Privateers,D. St. Hilaire,4398325,,True,31.0,4,20,3,13,1,7,3,5,0,3,3,1,3,0,1,2,12
401405889,New Orleans Privateers,D. Sackey,4397512,,True,29.0,4,8,2,4,2,4,0,0,0,1,1,2,1,1,2,0,10
401405889,New Orleans Privateers,T. Green,4279181,,True,38.0,10,19,9,16,1,3,3,4,2,10,12,3,4,0,2,3,24
401405889,New Orleans Privateers,D. Bell,4703650,,False,15.0,0,0,0,0,0,0,0,0,0,2,2,0,0,1,1,3,0
401405889,New Orleans Privateers,J. Myers,4398093,,False,9.0,1,1,1,1,0,0,0,0,0,0,0,0,0,0,1,3,2
401405889,New Orleans Privateers,R. Carson Jr.,4593813,,False,12.0,0,1,0,1,0,0,2,2,0,1,1,0,0,0,1,0,2
401405889,New Orleans Privateers,K. Doughty,4432969,,False,10.0,1,2,0,1,1,1,0,0,0,0,0,1,0,0,0,1,3
401405889,New Orleans Privateers,TEAM,TOTAL,TOTAL,False,,25,62,20,47,5,15,10,13,9,23,32,9,8,4,11,18,65
401405888,Texas A&M-Corpus Christi Islanders,I. Mushila,4897300,,True,23.0,4,4,4,4,0,0,4,6,7,3,10,0,1,0,2,3,12
401405888,Texas A&M-Corpus Christi Islanders,D. Keys,4703701,,True,19.0,0,5,0,5,0,0,0,0,0,1,1,0,0,0,1,2,0
401405888,Texas A&M-Corpus Christi Islanders,T. Murdix,4897301,,True,31.0,4,10,3,7,1,3,4,5,2,7,9,8,1,0,5,3,13
401405888,Texas A&M-Corpus Christi Islanders,S. Fryer,4703703,,True,34.0,6,15,1,4,5,11,3,4,0,3,3,1,1,0,0,1,20
401405888,Texas A&M-Corpus Christi Islanders,J. Jackson,4592869,,True,28.0,2,6,2,5,0,1,1,2,0,4,4,3,0,0,0,3,5
401405888,Texas A&M-Corpus Christi Islanders,S. Brinson,4278448,,False,9.0,1,1,1,1,0,0,0,0,0,3,3,0,0,0,2,0,2
401405888,Texas A&M-Corpus Christi Islanders,S. Faramade,4897304,,False,20.0,6,9,6,9,0,0,0,0,2,4,6,1,0,0,0,3,12
401405888,Texas A&M-Corpus Christi Islanders,T. Nickelson,4897298,,False,3.0,0,0,0,0,0,0,0,0,0,0,0,0,0,0,0,0,0
401405888,Texas A&M-Corpus Christi Islanders,T. Tennyson,4897296,,False,14.0,1,6,0,2,1,4,2,2,0,1,1,1,0,0,1,1,5
401405888,Texas A&M-Corpus Christi Islanders,M. Smith,4278341,,False,19.0,1,3,1,2,0,1,0,0,1,2,3,3,0,0,1,1,2
401405888,Texas A&M-Corpus Christi Islanders,TEAM,TOTAL,TOTAL,False,,25,59,18,39,7,20,14,19,14,32,46,17,3,0,14,17,71
401405888,Nicholls Colonels,M. Littles,4897327,,True,25.0,3,7,3,5,0,2,0,0,1,4,5,1,2,0,2,2,6
401405888,Nicholls Colonels,R. Lyons,4278303,,True,31.0,1,6,1,4,0,2,2,4,1,1,2,1,2,2,1,4,4
401405888,Nicholls Colonels,L. Jones,4701200,,True,34.0,8,17,6,9,2,8,2,3,1,4,5,0,1,0,0,0,20
401405888,Nicholls Colonels,Ty Gordon,4599257,,True,40.0,5,16,3,6,2,10,2,3,1,3,4,2,1,0,3,3,14
401405888,Nicholls Colonels,D. Carter,4593407,,True,38.0,5,11,4,9,1,2,6,6,3,6,9,4,2,1,0,2,17
401405888,Nicholls Colonels,R. Maxwell,4897325,,False,4.0,0,0,0,0,0,0,0,0,0,1,1,0,0,0,0,0,0
401405888,Nicholls Colonels,P. Spencer,4703670,,False,28.0,1,7,0,1,1,6,0,1,1,4,5,2,1,0,2,4,3
401405888,Nicholls Colonels,T. Terrell,4593810,,False,0.0,0,0,0,0,0,0,0,0,0,0,0,0,0,0,0,0,0
401405888,Nicholls Colonels,TEAM,TOTAL,TOTAL,False,,23,64,17,34,6,30,12,17,11,23,34,10,9,3,8,15,64
401405887,New Orleans Privateers,S. Kirkland,4703132,,True,15.0,3,4,3,4,0,0,0,0,0,1,1,0,0,2,2,4,6
401405887,New Orleans Privateers,T. Jackson,4431818,,True,23.0,3,5,3,5,0,0,0,0,1,2,3,1,1,0,1,2,6
401405887,New Orleans Privateers,D. St. Hilaire,4398325,,True,39.0,4,14,3,7,1,7,7,8,1,3,4,2,1,0,2,4,16
401405887,New Orleans Privateers,D. Sackey,4397512,,True,29.0,3,6,3,3,0,3,4,6,2,2,4,6,0,0,2,2,10
401405887,New Orleans Privateers,T. Green,4279181,,True,39.0,6,12,6,12,0,0,9,11,1,6,7,2,4,0,3,2,21
401405887,New Orleans Privateers,D. Bell,4703650,,False,14.0,2,3,2,3,0,0,1,4,0,1,1,1,0,1,1,2,5
401405887,New Orleans Privateers,J. Myers,4398093,,False,25.0,5,7,5,7,0,0,0,0,0,1,1,2,1,1,1,4,10
401405887,New Orleans Privateers,J. Vincent,4897328,,False,0.0,0,0,0,0,0,0,0,0,0,1,1,0,0,0,0,0,0
401405887,New Orleans Privateers,R. Carson Jr.,4593813,,False,8.0,2,4,2,4,0,0,0,0,3,0,3,0,0,0,0,1,4
401405887,New Orleans Privateers,K. Doughty,4432969,,False,8.0,0,0,0,0,0,0,4,4,0,2,2,0,0,1,1,5,4
401405887,New Orleans Privateers,TEAM,TOTAL,TOTAL,False,,28,55,27,45,1,10,25,33,10,19,29,14,7,5,13,26,82
401405887,McNeese Cowboys,K. Taylor,4066493,,True,34.0,4,9,4,8,0,1,4,6,5,5,10,4,0,1,2,4,12
401405887,McNeese Cowboys,M. Lewis,4280102,,True,25.0,3,5,3,4,0,1,0,3,1,2,3,1,1,2,1,3,6
401405887,McNeese Cowboys,B. Medley-Bacon,4398113,,True,19.0,2,6,2,6,0,0,2,3,4,3,7,0,0,0,2,4,6
401405887,McNeese Cowboys,J. Massie,4897338,,True,17.0,4,7,3,4,1,3,0,1,3,3,6,2,0,1,4,3,9
401405887,McNeese Cowboys,Z. Scott,4396689,,True,32.0,5,10,2,4,3,6,6,6,2,3,5,2,0,0,1,2,19
401405887,McNeese Cowboys,C. Shumate,4701228,,False,15.0,2,3,2,2,0,1,1,2,1,2,3,0,0,0,3,3,5
401405887,McNeese Cowboys,T. English,4897337,,False,25.0,4,6,3,3,1,3,10,15,0,1,1,4,1,0,1,2,19
401405887,McNeese Cowboys,C. Warren,4593781,,False,15.0,0,5,0,2,0,3,0,0,0,0,0,0,1,0,2,2,0
401405887,McNeese Cowboys,H. Francois,4592723,,False,17.0,1,5,1,1,0,4,0,0,0,3,3,1,0,0,1,4,2
401405887,McNeese Cowboys,TEAM,TOTAL,TOTAL,False,,25,56,20,34,5,22,23,36,21,23,44,14,3,4,18,27,78
401405886,Texas A&M-Corpus Christi Islanders,I. Mushila,4897300,,True,20.0,0,2,0,2,0,0,0,0,1,4,5,1,3,0,2,2,0
401405886,Texas A&M-Corpus Christi Islanders,D. Keys,4703701,,True,21.0,2,5,2,5,0,0,2,2,1,3,4,3,0,0,0,1,6
401405886,Texas A&M-Corpus Christi Islanders,T. Murdix,4897301,,True,21.0,5,8,5,8,0,0,2,2,0,4,4,1,0,0,0,1,12
401405886,Texas A&M-Corpus Christi Islanders,S. Fryer,4703703,,True,23.0,6,9,2,4,4,5,0,0,1,4,5,1,0,0,2,1,16
401405886,Texas A&M-Corpus Christi Islanders,J. Jackson,4592869,,True,23.0,2,4,2,4,0,0,1,2,1,1,2,3,1,0,1,2,5
401405886,Texas A&M-Corpus Christi Islanders,S. Brinson,4278448,,False,20.0,1,1,1,1,0,0,4,4,1,4,5,2,0,1,1,4,6
401405886,Texas A&M-Corpus Christi Islanders,S. Faramade,4897304,,False,14.0,3,3,3,3,0,0,0,4,0,6,6,1,0,1,2,3,6
401405886,Texas A&M-Corpus Christi Islanders,J. Roberts,4897299,,False,5.0,1,2,1,1,0,1,0,1,1,1,2,0,0,0,1,0,2
401405886,Texas A&M-Corpus Christi Islanders,T. Nickelson,4897298,,False,20.0,3,7,3,5,0,2,2,2,0,1,1,1,0,0,2,2,8
401405886,Texas A&M-Corpus Christi Islanders,T. Tennyson,4897296,,False,20.0,4,10,4,9,0,1,2,2,2,2,4,1,0,0,1,1,10
401405886,Texas A&M-Corpus Christi Islanders,E. White,4403714,,False,5.0,1,3,1,2,0,1,0,0,0,0,0,0,0,0,0,0,2
401405886,Texas A&M-Corpus Christi Islanders,M. Smith,4278341,,False,8.0,0,2,0,0,0,2,2,2,0,1,1,1,0,0,0,5,2
401405886,Texas A&M-Corpus Christi Islanders,TEAM,TOTAL,TOTAL,False,,28,56,24,44,4,12,15,21,8,33,41,15,4,2,14,22,75
401405886,Houston Christian Huskies,Z. Tordoff,4593335,,True,31.0,3,5,3,5,0,0,2,2,4,3,7,0,1,1,1,4,8
401405886,Houston Christian Huskies,S. Hofman,4592901,,True,21.0,3,11,0,2,3,9,2,2,0,3,3,0,0,0,2,3,11
401405886,Houston Christian Huskies,D. Lee,4703615,,True,33.0,4,12,2,9,2,3,8,12,1,5,6,4,3,0,1,2,18
401405886,Houston Christian Huskies,K. Courseault,4593063,,True,32.0,3,11,1,4,2,7,2,2,1,3,4,1,1,1,2,4,10
401405886,Houston Christian Huskies,B. Long,4586322,,True,31.0,0,6,0,0,0,6,1,3,0,3,3,4,1,0,1,1,1
401405886,Houston Christian Huskies,Z. Iyeyemi,4593753,,False,4.0,0,0,0,0,0,0,0,0,0,1,1,0,0,0,1,2,0
401405886,Houston Christian Huskies,T. Moore,4897352,,False,2.0,0,1,0,1,0,0,0,0,0,0,0,0,0,0,0,0,0
401405886,Houston Christian Huskies,D. Proctor,4897351,,False,2.0,1,2,1,1,0,1,0,0,1,0,1,0,0,0,0,0,2
401405886,Houston Christian Huskies,J. Thompson,4593751,,False,18.0,1,4,1,2,0,2,0,1,1,3,4,0,1,0,1,2,2
401405886,Houston Christian Huskies,C. Plummer,4703617,,False,2.0,1,3,1,3,0,0,0,0,2,1,3,0,0,0,0,0,2
401405886,Houston Christian Huskies,J. Tse,4703613,,False,22.0,2,4,1,2,1,2,1,3,0,2,2,0,0,0,1,1,6
401405886,Houston Christian Huskies,A. Charles Jr.,4398023,,False,2.0,0,0,0,0,0,0,0,0,0,0,0,0,0,0,0,0,0
401405886,Houston Christian Huskies,TEAM,TOTAL,TOTAL,False,,18,59,10,29,8,30,16,25,11,24,35,9,7,2,12,20,60
401405885,Northwestern State Demons,K. Coleman,4703671,,True,35.0,5,12,5,12,0,0,4,10,2,10,12,0,0,2,0,3,14
401405885,Northwestern State Demons,L. Owens,4278317,,True,10.0,1,5,1,5,0,0,1,2,2,0,2,0,0,0,1,1,3
401405885,Northwestern State Demons,C. Garrett,4897318,,True,30.0,6,11,6,8,0,3,0,0,1,4,5,0,2,3,1,2,12
401405885,Northwestern State Demons,C. Teasett,4703672,,True,35.0,7,17,4,8,3,9,3,3,1,1,2,5,3,0,3,1,20
401405885,Northwestern State Demons,B. White,4398266,,True,14.0,0,1,0,1,0,0,0,0,0,1,1,3,0,0,0,1,0
401405885,Northwestern State Demons,S. Riley II,4897317,,False,4.0,0,0,0,0,0,0,0,0,1,0,1,0,0,0,1,0,0
401405885,Northwestern State Demons,R. Chougkaz,4594128,,False,6.0,1,1,1,1,0,0,0,0,0,0,0,0,0,0,0,1,2
401405885,Northwestern State Demons,J. King,4897316,,False,15.0,2,4,2,3,0,1,0,0,0,0,0,1,2,0,0,0,4
401405885,Northwestern State Demons,E. McDonald,4897315,,False,8.0,1,3,0,0,1,3,0,0,0,0,0,1,0,0,0,0,3
401405885,Northwestern State Demons,J. Zelenbaba,4594125,,False,17.0,0,1,0,1,0,0,0,0,0,1,1,0,0,0,1,3,0
401405885,Northwestern State Demons,L. Reed,4398265,,False,26.0,4,6,3,5,1,1,0,0,1,2,3,1,0,0,3,2,9
401405885,Northwestern State Demons,TEAM,TOTAL,TOTAL,False,,27,61,22,44,5,17,8,15,8,20,28,11,7,5,10,14,67
401405885,McNeese Cowboys,K. Taylor,4066493,,True,31.0,7,8,7,8,0,0,8,8,4,2,6,2,0,0,3,3,22
401405885,McNeese Cowboys,M. Lewis,4280102,,True,18.0,1,4,1,3,0,1,0,0,1,5,6,1,0,0,2,1,2
401405885,McNeese Cowboys,B. Medley-Bacon,4398113,,True,22.0,3,4,3,4,0,0,0,0,0,3,3,1,0,2,1,3,6
401405885,McNeese Cowboys,J. Massie,4897338,,True,20.0,1,4,1,3,0,1,3,4,0,1,1,3,2,0,0,0,5
401405885,McNeese Cowboys,Z. Scott,4396689,,True,27.0,4,8,1,2,3,6,0,0,0,3,3,1,0,0,1,2,11
401405885,McNeese Cowboys,C. Shumate,4701228,,False,18.0,4,9,4,8,0,1,1,1,5,5,10,1,1,1,3,2,9
401405885,McNeese Cowboys,C. Rawls,4897340,,False,1.0,0,0,0,0,0,0,0,0,0,0,0,0,0,0,0,0,0
401405885,McNeese Cowboys,T. Passmore,4897339,,False,1.0,0,1,0,0,0,1,0,0,0,0,0,0,0,0,1,1,0
401405885,McNeese Cowboys,T. English,4897337,,False,24.0,4,7,3,6,1,1,3,5,0,3,3,3,2,0,0,2,12
401405885,McNeese Cowboys,C. Warren,4593781,,False,17.0,2,7,2,5,0,2,0,0,1,2,3,0,0,0,2,1,4
401405885,McNeese Cowboys,H. Francois,4592723,,False,21.0,3,6,0,0,3,6,0,0,0,3,3,1,0,0,2,1,9
401405885,McNeese Cowboys,TEAM,TOTAL,TOTAL,False,,29,58,22,39,7,19,15,18,11,30,41,13,5,3,15,16,80
401405884,Incarnate Word Cardinals,D. Hayman,4897346,,True,20.0,0,4,0,2,0,2,0,0,1,1,2,1,0,2,1,3,0
401405884,Incarnate Word Cardinals,J. Morgan,4703621,,True,37.0,6,12,4,7,2,5,3,3,0,2,2,1,1,0,2,1,17
401405884,Incarnate Word Cardinals,D. Lutz,4593757,,True,35.0,6,9,4,6,2,3,4,4,0,2,2,3,4,0,2,3,18
401405884,Incarnate Word Cardinals,B. Swaby,4398037,,True,40.0,1,6,0,3,1,3,7,8,1,4,5,5,2,0,0,3,10
401405884,Incarnate Word Cardinals,RJ Glasper,4066245,,True,28.0,5,14,3,9,2,5,0,0,0,1,1,2,1,0,0,0,12
401405884,Incarnate Word Cardinals,G. Ezedinma,4703624,,False,5.0,0,1,0,0,0,1,0,0,0,2,2,0,0,0,0,2,0
401405884,Incarnate Word Cardinals,B. Griscti,4897348,,False,15.0,2,4,1,1,1,3,0,0,0,0,0,0,0,0,0,1,5
401405884,Incarnate Word Cardinals,S. Hassan Mobutu,4897344,,False,20.0,1,1,1,1,0,0,0,0,0,2,2,0,0,0,2,1,2
401405884,Incarnate Word Cardinals,TEAM,TOTAL,TOTAL,False,,21,51,13,29,8,22,14,15,2,17,19,12,8,2,8,14,64
401405884,Houston Christian Huskies,Z. Tordoff,4593335,,True,22.0,4,6,4,6,0,0,0,2,4,3,7,1,0,0,1,3,8
401405884,Houston Christian Huskies,S. Hofman,4592901,,True,32.0,4,10,2,5,2,5,1,3,1,9,10,1,1,0,1,3,11
401405884,Houston Christian Huskies,D. Lee,4703615,,True,38.0,8,10,8,8,0,2,1,2,1,9,10,2,2,0,1,1,17
401405884,Houston Christian Huskies,K. Courseault,4593063,,True,37.0,8,12,7,9,1,3,2,2,0,3,3,1,1,2,3,0,19
401405884,Houston Christian Huskies,B. Long,4586322,,True,37.0,4,9,3,3,1,6,2,2,0,0,0,5,1,0,2,1,11
401405884,Houston Christian Huskies,Z. Iyeyemi,4593753,,False,3.0,0,0,0,0,0,0,0,0,0,0,0,0,0,0,1,2,0
401405884,Houston Christian Huskies,J. Thompson,4593751,,False,13.0,2,2,2,2,0,0,0,0,0,2,2,1,0,0,1,3,4
401405884,Houston Christian Huskies,J. Tse,4703613,,False,18.0,1,3,1,1,0,2,2,2,0,2,2,5,0,0,0,0,4
401405884,Houston Christian Huskies,TEAM,TOTAL,TOTAL,False,,31,52,27,34,4,18,8,13,6,28,34,16,5,2,10,13,74
401405882,Murray State Racers,D. Burns,4594111,,True,19.0,1,3,1,3,0,0,0,0,4,5,9,1,1,0,1,4,2
401405882,Murray State Racers,K. Williams,4398348,,True,35.0,2,6,1,4,1,2,3,6,3,7,10,0,1,0,2,3,8
401405882,Murray State Racers,J. Hill,4703264,,True,37.0,8,19,5,13,3,6,2,3,0,2,2,3,1,1,4,2,21
401405882,Murray State Racers,T. Brown,4279886,,True,40.0,7,18,4,7,3,11,6,8,1,5,6,3,1,1,1,1,23
401405882,Murray State Racers,C. Collins,4278347,,True,14.0,1,2,0,1,1,1,0,0,1,2,3,2,0,0,0,0,3
401405882,Murray State Racers,N. McMullen,4703266,,False,4.0,0,3,0,3,0,0,0,0,4,0,4,0,0,1,1,0,0
401405882,Murray State Racers,J. Skipper-Brown,4593465,,False,9.0,0,2,0,2,0,0,0,0,2,2,4,0,0,2,0,4,0
401405882,Murray State Racers,T. Hannibal,4593008,,False,24.0,3,8,3,8,0,0,2,2,0,6,6,1,0,0,2,1,8
401405882,Murray State Racers,D. Smith,4398347,,False,18.0,2,2,0,0,2,2,0,0,0,0,0,0,0,0,0,2,6
401405882,Murray State Racers,TEAM,TOTAL,TOTAL,False,,24,63,14,41,10,22,13,19,18,29,47,10,4,5,11,17,71
401405882,Morehead State Eagles,J. Broome,4433569,,True,34.0,13,20,13,19,0,1,6,11,1,7,8,1,2,2,1,4,32
401405882,Morehead State Eagles,J. Hall,4279497,,True,34.0,3,7,1,3,2,4,0,0,0,3,3,1,1,0,2,3,8
401405882,Morehead State Eagles,T. Cooper,4432959,,True,37.0,5,10,4,8,1,2,1,4,4,1,5,5,0,4,1,3,12
401405882,Morehead State Eagles,S. Potter,4397783,,True,21.0,0,3,0,1,0,2,0,0,1,4,5,2,0,0,0,3,0
401405882,Morehead State Eagles,J. Wolfe,4396750,,True,31.0,1,4,1,4,0,0,1,3,0,2,2,1,0,1,2,2,3
401405882,Morehead State Eagles,L. Bryan,4593680,,False,6.0,0,1,0,1,0,0,0,0,0,1,1,0,0,1,0,1,0
401405882,Morehead State Eagles,J. Sebree,4397481,,False,9.0,0,2,0,1,0,1,0,0,0,3,3,0,0,0,1,0,0
401405882,Morehead State Eagles,D. Thelwell,4703260,,False,3.0,0,0,0,0,0,0,0,0,0,0,0,0,1,0,0,0,0
401405882,Morehead State Eagles,T. Hollowell,4280119,,False,25.0,4,7,0,0,4,7,0,0,0,2,2,2,2,1,1,2,12
401405882,Morehead State Eagles,TEAM,TOTAL,TOTAL,False,,26,54,19,37,7,17,8,18,6,25,31,12,6,9,9,18,67
401405881,Morehead State Eagles,J. Broome,4433569,,True,29.0,6,14,6,14,0,0,1,2,4,7,11,0,1,3,5,4,13
401405881,Morehead State Eagles,J. Hall,4279497,,True,24.0,2,5,2,3,0,2,2,4,0,0,0,0,4,0,1,2,6
401405881,Morehead State Eagles,T. Cooper,4432959,,True,36.0,2,6,2,6,0,0,0,0,2,0,2,5,2,1,2,1,4
401405881,Morehead State Eagles,S. Potter,4397783,,True,29.0,3,7,1,3,2,4,4,4,1,4,5,0,2,0,1,2,12
401405881,Morehead State Eagles,J. Wolfe,4396750,,True,29.0,2,6,1,4,1,2,0,0,2,2,4,1,0,0,0,1,5
401405881,Morehead State Eagles,L. Bryan,4593680,,False,11.0,0,1,0,1,0,0,0,0,0,4,4,0,0,0,1,3,0
401405881,Morehead State Eagles,J. Sebree,4397481,,False,11.0,0,1,0,1,0,0,0,0,0,0,0,0,0,0,0,1,0
401405881,Morehead State Eagles,D. Thelwell,4703260,,False,5.0,1,1,0,0,1,1,0,0,0,0,0,0,0,0,2,1,3
401405881,Morehead State Eagles,T. Hollowell,4280119,,False,26.0,4,11,2,4,2,7,0,0,0,2,2,0,2,0,3,3,10
401405881,Morehead State Eagles,TEAM,TOTAL,TOTAL,False,,20,52,14,36,6,16,7,10,9,22,31,6,11,4,16,18,53
401405881,Belmont Bruins,N. Muszynski,4279923,,True,32.0,6,13,6,11,0,2,2,4,1,3,4,0,0,1,2,0,14
401405881,Belmont Bruins,W. Richard,4897262,,True,30.0,3,7,2,5,1,2,4,4,2,6,8,0,1,2,3,4,11
401405881,Belmont Bruins,B. Sheppard,4433076,,True,37.0,5,10,4,7,1,3,8,11,0,2,2,0,5,0,4,3,19
401405881,Belmont Bruins,L. Smith,4402243,,True,23.0,0,3,0,2,0,1,0,0,0,1,1,5,1,0,1,2,0
401405881,Belmont Bruins,G. Murphy,4279920,,True,36.0,3,5,3,4,0,1,0,0,0,8,8,0,1,0,5,1,6
401405881,Belmont Bruins,E. Brauns,4703219,,False,2.0,0,0,0,0,0,0,0,0,0,0,0,0,0,0,0,1,0
401405881,Belmont Bruins,F. Jakubicek,4703221,,False,6.0,0,0,0,0,0,0,0,0,1,0,1,0,0,1,0,1,0
401405881,Belmont Bruins,M. Shanks,4433075,,False,7.0,0,2,0,1,0,1,1,2,1,1,2,0,0,1,1,0,1
401405881,Belmont Bruins,J. Wood,4703220,,False,18.0,0,2,0,1,0,1,0,0,0,0,0,1,2,0,1,0,0
401405881,Belmont Bruins,T. Pierson,4279922,,False,9.0,0,1,0,0,0,1,0,0,0,0,0,0,0,0,0,0,0
401405881,Belmont Bruins,TEAM,TOTAL,TOTAL,False,,17,43,15,31,2,12,15,21,7,24,31,6,10,5,18,12,51
401405880,Southeast Missouri State Redhawks,M. Patterson,4279241,,True,16.0,3,3,3,3,0,0,3,5,1,3,4,1,0,1,1,5,9
401405880,Southeast Missouri State Redhawks,D. Branson,4703379,,True,13.0,1,2,1,1,0,1,0,0,0,1,1,0,0,0,0,2,2
401405880,Southeast Missouri State Redhawks,E. Reed Jr.,4703377,,True,33.0,4,11,2,4,2,7,2,3,0,1,1,1,1,0,1,3,12
401405880,Southeast Missouri State Redhawks,P. Russell,4701120,,True,26.0,1,6,1,3,0,3,1,2,1,2,3,4,2,0,2,3,3
401405880,Southeast Missouri State Redhawks,N. Russell,4398354,,True,20.0,2,4,2,3,0,1,0,0,2,3,5,0,1,0,3,1,4
401405880,Southeast Missouri State Redhawks,S. Thompson,4897307,,False,8.0,0,0,0,0,0,0,0,0,0,1,1,0,0,2,0,3,0
401405880,Southeast Missouri State Redhawks,N. Akenten,4277969,,False,16.0,3,8,1,3,2,5,3,4,1,1,2,0,2,0,1,2,11
401405880,Southeast Missouri State Redhawks,C. Thompson,4897305,,False,13.0,3,3,2,2,1,1,2,3,0,0,0,0,0,0,0,2,9
401405880,Southeast Missouri State Redhawks,D. Nicholas,4593687,,False,29.0,5,9,3,5,2,4,8,10,0,5,5,4,1,0,1,0,20
401405880,Southeast Missouri State Redhawks,C. Harris,4593686,,False,26.0,1,9,0,5,1,4,1,2,0,3,3,2,0,0,0,1,4
401405880,Southeast Missouri State Redhawks,TEAM,TOTAL,TOTAL,False,,23,55,15,29,8,26,20,29,7,20,27,12,7,3,9,22,74
401405880,Murray State Racers,D. Burns,4594111,,True,25.0,3,3,3,3,0,0,2,2,4,3,7,0,3,0,0,4,8
401405880,Murray State Racers,K. Williams,4398348,,True,31.0,10,16,6,10,4,6,5,7,0,10,10,0,1,0,4,3,29
401405880,Murray State Racers,J. Hill,4703264,,True,35.0,4,7,3,3,1,4,1,2,0,1,1,5,2,0,2,2,10
401405880,Murray State Racers,T. Brown,4279886,,True,36.0,9,17,6,10,3,7,5,8,1,5,6,3,2,2,1,3,26
401405880,Murray State Racers,C. Collins,4278347,,True,18.0,0,1,0,1,0,0,0,0,0,0,0,1,0,0,0,3,0
401405880,Murray State Racers,N. McMullen,4703266,,False,9.0,1,2,1,2,0,0,2,4,6,2,8,0,0,0,1,4,4
401405880,Murray State Racers,J. Skipper-Brown,4593465,,False,9.0,1,2,1,2,0,0,1,1,0,1,1,0,0,0,2,2,3
401405880,Murray State Racers,D. Bostick,4703262,,False,1.0,0,0,0,0,0,0,0,0,0,0,0,0,0,0,0,0,0
401405880,Murray State Racers,R. Thomas,4593684,,False,1.0,0,2,0,0,0,2,0,0,0,0,0,0,0,0,0,0,0
401405880,Murray State Racers,T. Hannibal,4593008,,False,25.0,2,4,2,4,0,0,4,6,0,5,5,0,0,0,2,0,8
401405880,Murray State Racers,J. Sivills,4590401,,False,1.0,0,0,0,0,0,0,0,0,1,0,1,0,0,0,0,0,0
401405880,Murray State Racers,D. Smith,4398347,,False,9.0,0,2,0,1,0,1,0,0,1,1,2,0,0,0,1,3,0
401405880,Murray State Racers,TEAM,TOTAL,TOTAL,False,,30,56,22,36,8,20,20,30,13,31,44,9,8,2,13,24,88
401405879,Tennessee Tech Golden Eagles,K. White Jr.,4703423,,True,34.0,6,10,4,7,2,3,0,0,0,4,4,0,0,0,2,1,14
401405879,Tennessee Tech Golden Eagles,S. Goldman,4067820,,True,31.0,1,6,0,0,1,6,0,0,0,4,4,0,0,1,1,3,3
401405879,Tennessee Tech Golden Eagles,K. Davidson,4593730,,True,35.0,3,7,2,5,1,2,0,0,1,4,5,3,1,0,1,2,7
401405879,Tennessee Tech Golden Eagles,D. Wood,4395700,,True,24.0,4,9,4,8,0,1,0,0,1,4,5,3,0,0,1,1,8
401405879,Tennessee Tech Golden Eagles,J. Pettway,4067800,,True,21.0,3,6,3,6,0,0,5,6,0,3,3,1,1,2,3,2,11
401405879,Tennessee Tech Golden Eagles,A. Sylla,4593732,,False,19.0,1,3,1,3,0,0,0,0,1,4,5,1,0,2,1,0,2
401405879,Tennessee Tech Golden Eagles,D. Quest,4593731,,False,2.0,0,0,0,0,0,0,0,0,0,0,0,0,0,0,0,0,0
401405879,Tennessee Tech Golden Eagles,B. Gilliam,4897322,,False,2.0,1,1,1,1,0,0,0,0,0,0,0,0,0,0,0,0,2
401405879,Tennessee Tech Golden Eagles,C. Gettelfinger,4593346,,False,2.0,0,1,0,0,0,1,2,3,0,1,1,0,0,0,0,1,2
401405879,Tennessee Tech Golden Eagles,Jr. Clay,4398376,,False,30.0,3,12,2,9,1,3,0,0,0,2,2,4,1,0,0,2,7
401405879,Tennessee Tech Golden Eagles,TEAM,TOTAL,TOTAL,False,,22,55,17,39,5,16,7,9,3,30,33,12,3,5,10,13,56
401405879,Morehead State Eagles,J. Broome,4433569,,True,25.0,7,15,7,15,0,0,1,3,3,6,9,3,0,3,1,2,15
401405879,Morehead State Eagles,J. Hall,4279497,,True,24.0,4,9,2,4,2,5,4,4,1,3,4,1,1,0,0,0,14
401405879,Morehead State Eagles,T. Cooper,4432959,,True,32.0,4,8,2,3,2,5,4,4,1,2,3,7,1,0,0,0,14
401405879,Morehead State Eagles,S. Potter,4397783,,True,27.0,5,9,1,3,4,6,0,0,1,5,6,3,0,0,1,2,14
401405879,Morehead State Eagles,J. Wolfe,4396750,,True,20.0,1,4,1,2,0,2,0,0,2,1,3,0,0,0,2,3,2
401405879,Morehead State Eagles,L. Bryan,4593680,,False,15.0,0,2,0,2,0,0,0,0,2,3,5,1,0,1,0,0,0
401405879,Morehead State Eagles,J. Sebree,4397481,,False,20.0,0,4,0,2,0,2,2,2,0,3,3,1,0,1,1,2,2
401405879,Morehead State Eagles,B. May,4897271,,False,2.0,0,1,0,0,0,1,0,0,0,0,0,0,0,0,0,0,0
401405879,Morehead State Eagles,T. Redding,4897269,,False,2.0,0,1,0,0,0,1,0,0,0,0,0,0,0,0,0,1,0
401405879,Morehead State Eagles,D. Thelwell,4703260,,False,15.0,1,3,1,2,0,1,1,2,1,1,2,1,1,0,1,0,3
401405879,Morehead State Eagles,T. Hollowell,4280119,,False,18.0,3,8,0,1,3,7,0,0,0,3,3,0,0,0,0,0,9
401405879,Morehead State Eagles,TEAM,TOTAL,TOTAL,False,,25,64,14,34,11,30,12,15,11,30,41,17,3,5,7,10,73
401405878,Tennessee State Tigers,S. Johnson,4593726,,True,26.0,3,4,3,4,0,0,1,2,1,2,3,0,1,0,3,2,7
401405878,Tennessee State Tigers,K. Nicholson,4593280,,True,29.0,2,7,2,7,0,0,0,2,2,5,7,0,1,0,2,2,4
401405878,Tennessee State Tigers,J. Dupree,4067190,,True,13.0,1,3,1,1,0,2,0,0,0,3,3,0,0,0,2,2,2
401405878,Tennessee State Tigers,M. Fitzgerald Jr.,4703415,,True,36.0,9,16,9,12,0,4,5,6,0,5,5,3,4,0,4,3,23
401405878,Tennessee State Tigers,K. Cooper,4067179,,True,33.0,2,9,2,8,0,1,3,3,1,3,4,0,0,1,3,2,7
401405878,Tennessee State Tigers,D. Acosta,4897310,,False,7.0,0,1,0,1,0,0,1,2,1,1,2,0,3,0,0,3,1
401405878,Tennessee State Tigers,T. Bartholomew,4897308,,False,4.0,0,1,0,1,0,0,2,2,0,0,0,0,0,0,0,0,2
401405878,Tennessee State Tigers,C. Marshall Jr.,4593725,,False,17.0,3,10,2,8,1,2,0,0,0,2,2,0,2,0,5,5,7
401405878,Tennessee State Tigers,M. Johal,4398373,,False,11.0,0,2,0,1,0,1,0,0,0,0,0,1,1,0,0,2,0
401405878,Tennessee State Tigers,D. Boyd,4279854,,False,24.0,1,6,1,4,0,2,0,0,0,3,3,0,0,0,0,1,2
401405878,Tennessee State Tigers,TEAM,TOTAL,TOTAL,False,,21,59,20,47,1,12,12,17,7,25,32,4,12,1,19,23,55
401405878,Southeast Missouri State Redhawks,M. Patterson,4279241,,True,20.0,6,8,6,8,0,0,7,10,4,6,10,3,2,2,4,1,19
401405878,Southeast Missouri State Redhawks,D. Branson,4703379,,True,19.0,3,6,2,4,1,2,0,0,2,4,6,1,1,0,7,0,7
401405878,Southeast Missouri State Redhawks,E. Reed Jr.,4703377,,True,30.0,6,13,1,3,5,10,5,6,0,4,4,1,1,0,0,1,22
401405878,Southeast Missouri State Redhawks,P. Russell,4701120,,True,16.0,1,4,0,0,1,4,0,1,2,1,3,3,0,0,1,4,3
401405878,Southeast Missouri State Redhawks,N. Russell,4398354,,True,21.0,3,6,0,0,3,6,0,0,0,9,9,3,2,2,3,4,9
401405878,Southeast Missouri State Redhawks,S. Thompson,4897307,,False,13.0,2,5,2,5,0,0,1,2,2,2,4,0,0,0,1,4,5
401405878,Southeast Missouri State Redhawks,N. Akenten,4277969,,False,22.0,1,6,1,5,0,1,0,1,2,1,3,0,2,0,0,0,2
401405878,Southeast Missouri State Redhawks,C. Thompson,4897305,,False,4.0,0,0,0,0,0,0,0,0,1,0,1,0,0,0,0,0,0
401405878,Southeast Missouri State Redhawks,P. Long,4606870,,False,2.0,0,0,0,0,0,0,0,0,0,0,0,0,0,0,0,0,0
401405878,Southeast Missouri State Redhawks,D. Nicholas,4593687,,False,32.0,4,10,3,6,1,4,1,2,0,3,3,5,2,0,1,3,10
401405878,Southeast Missouri State Redhawks,C. Harris,4593686,,False,21.0,0,3,0,0,0,3,2,2,0,3,3,2,1,0,2,1,2
401405878,Southeast Missouri State Redhawks,TEAM,TOTAL,TOTAL,False,,26,61,15,31,11,30,16,24,14,33,47,18,11,4,19,18,79
401405877,Tennessee Tech Golden Eagles,K. White Jr.,4703423,,True,33.0,4,7,2,5,2,2,0,2,3,5,8,0,0,2,1,1,10
401405877,Tennessee Tech Golden Eagles,S. Goldman,4067820,,True,32.0,5,12,0,0,5,12,0,0,1,6,7,2,1,2,2,3,15
401405877,Tennessee Tech Golden Eagles,K. Davidson,4593730,,True,34.0,9,14,8,11,1,3,1,1,0,3,3,7,2,0,4,0,20
401405877,Tennessee Tech Golden Eagles,D. Wood,4395700,,True,26.0,4,6,4,6,0,0,1,1,0,3,3,1,0,0,0,1,9
401405877,Tennessee Tech Golden Eagles,J. Pettway,4067800,,True,25.0,6,8,6,8,0,0,1,3,1,5,6,1,1,0,4,2,13
401405877,Tennessee Tech Golden Eagles,A. Sylla,4593732,,False,15.0,0,1,0,1,0,0,0,2,2,3,5,0,0,2,1,1,0
401405877,Tennessee Tech Golden Eagles,D. Quest,4593731,,False,1.0,0,0,0,0,0,0,0,0,0,0,0,0,1,0,0,0,0
401405877,Tennessee Tech Golden Eagles,B. Gilliam,4897322,,False,1.0,0,0,0,0,0,0,0,0,0,0,0,0,0,0,0,0,0
401405877,Tennessee Tech Golden Eagles,C. Gettelfinger,4593346,,False,1.0,1,1,1,1,0,0,0,0,0,1,1,0,0,0,0,0,2
401405877,Tennessee Tech Golden Eagles,Jr. Clay,4398376,,False,32.0,3,11,2,7,1,4,2,4,2,6,8,3,1,0,3,2,9
401405877,Tennessee Tech Golden Eagles,TEAM,TOTAL,TOTAL,False,,32,60,23,39,9,21,5,13,10,33,43,14,6,6,15,10,78
401405877,Austin Peay Governors,C. Stone-Carrawell,4592841,,True,26.0,3,11,2,7,1,4,0,0,1,4,5,2,3,0,1,1,7
401405877,Austin Peay Governors,E. Hutchins-Everett,4433161,,True,28.0,4,11,4,10,0,1,0,0,1,4,5,0,0,0,0,1,8
401405877,Austin Peay Governors,C. Paez,4433055,,True,24.0,1,6,1,3,0,3,0,0,2,3,5,0,0,0,0,3,2
401405877,Austin Peay Governors,C. Copeland,4396777,,True,21.0,4,10,4,8,0,2,2,2,5,4,9,1,0,0,1,2,10
401405877,Austin Peay Governors,T. Silver,4279332,,True,22.0,1,8,1,3,0,5,0,0,0,2,2,1,0,0,2,2,2
401405877,Austin Peay Governors,J. Ware,4897238,,False,4.0,0,1,0,0,0,1,0,2,2,0,2,0,0,0,0,0,0
401405877,Austin Peay Governors,C. Clements,4710472,,False,1.0,0,0,0,0,0,0,0,0,0,0,0,0,0,0,0,0,0
401405877,Austin Peay Governors,E. Walker,4703214,,False,28.0,7,10,7,10,0,0,2,3,4,2,6,0,2,1,1,2,16
401405877,Austin Peay Governors,J. Roberts,4913969,,False,1.0,0,1,0,1,0,0,0,0,1,0,1,0,0,0,1,0,0
401405877,Austin Peay Governors,D. Calderon,4897237,,False,11.0,0,4,0,1,0,3,0,0,1,1,2,0,0,0,1,2,0
401405877,Austin Peay Governors,C. Bates,4598340,,False,1.0,0,2,0,1,0,1,0,0,1,0,1,0,0,0,0,0,0
401405877,Austin Peay Governors,A. Woodard,4432150,,False,18.0,2,6,0,1,2,5,0,0,0,1,1,6,2,0,1,1,6
401405877,Austin Peay Governors,D. Peavy,4398224,,False,15.0,0,3,0,1,0,2,0,0,1,1,2,2,2,0,3,0,0
401405877,Austin Peay Governors,TEAM,TOTAL,TOTAL,False,,22,73,19,46,3,27,4,7,19,23,42,12,9,1,12,14,51
401405876,Tennessee State Tigers,S. Johnson,4593726,,True,34.0,10,12,10,12,0,0,2,3,3,8,11,3,0,1,5,2,22
401405876,Tennessee State Tigers,K. Nicholson,4593280,,True,34.0,2,8,2,7,0,1,0,1,0,7,7,2,2,2,0,3,4
401405876,Tennessee State Tigers,J. Dupree,4067190,,True,18.0,1,2,1,1,0,1,4,6,2,2,4,1,1,6,1,5,6
401405876,Tennessee State Tigers,M. Fitzgerald Jr.,4703415,,True,23.0,3,10,2,7,1,3,3,6,0,4,4,1,3,0,4,4,10
401405876,Tennessee State Tigers,K. Cooper,4067179,,True,35.0,3,9,1,4,2,5,2,3,2,1,3,4,2,0,2,2,10
401405876,Tennessee State Tigers,D. Acosta,4897310,,False,3.0,0,0,0,0,0,0,2,2,0,0,0,0,0,0,0,1,2
401405876,Tennessee State Tigers,T. Bartholomew,4897308,,False,3.0,0,0,0,0,0,0,0,0,0,0,0,0,0,0,1,2,0
401405876,Tennessee State Tigers,C. Marshall Jr.,4593725,,False,25.0,4,9,3,6,1,3,5,7,2,3,5,3,1,0,1,1,14
401405876,Tennessee State Tigers,M. Johal,4398373,,False,5.0,0,0,0,0,0,0,0,0,0,2,2,0,0,0,0,1,0
401405876,Tennessee State Tigers,D. Boyd,4279854,,False,20.0,3,9,1,3,2,6,1,2,0,1,1,0,0,0,0,1,9
401405876,Tennessee State Tigers,TEAM,TOTAL,TOTAL,False,,26,59,20,40,6,19,19,30,14,30,44,14,9,9,15,22,77
401405876,SIU Edwardsville Cougars,D. Pruitt,4897293,,True,33.0,1,10,0,7,1,3,8,8,2,4,6,1,1,1,3,3,11
401405876,SIU Edwardsville Cougars,L. Wright,4593691,,True,20.0,3,4,3,4,0,0,3,5,3,2,5,1,1,2,2,4,9
401405876,SIU Edwardsville Cougars,C. Carter,4703382,,True,38.0,2,7,1,2,1,5,4,4,0,2,2,2,3,0,2,2,9
401405876,SIU Edwardsville Cougars,S. Wright,4433129,,True,32.0,3,10,3,7,0,3,6,7,0,4,4,0,2,2,3,4,12
401405876,SIU Edwardsville Cougars,S. Doss Jr.,4403367,,True,40.0,5,13,3,9,2,4,4,5,2,8,10,4,2,2,3,4,16
401405876,SIU Edwardsville Cougars,J. Kurtas,4897294,,False,10.0,0,1,0,1,0,0,0,0,0,0,0,0,0,1,1,1,0
401405876,SIU Edwardsville Cougars,E. Eze,4398361,,False,0.0,0,0,0,0,0,0,0,0,0,0,0,0,0,0,0,0,0
401405876,SIU Edwardsville Cougars,Z. Butler,4711058,,False,1.0,0,0,0,0,0,0,0,0,0,0,0,0,0,0,1,0,0
401405876,SIU Edwardsville Cougars,C. Williams,4703385,,False,14.0,1,5,1,3,0,2,1,3,1,1,2,0,0,1,0,3,3
401405876,SIU Edwardsville Cougars,D. Polk,4432527,,False,12.0,1,4,1,3,0,1,0,0,1,1,2,1,0,0,2,1,2
401405876,SIU Edwardsville Cougars,TEAM,TOTAL,TOTAL,False,,16,54,12,36,4,18,26,32,11,25,36,9,9,9,17,22,62
401405875,Kent State Golden Flashes,V. Davis,4589474,,True,25.0,2,3,0,0,2,3,0,0,0,1,1,0,0,0,1,5,6
401405875,Kent State Golden Flashes,A. Odusipe,4432496,,True,5.0,0,0,0,0,0,0,0,0,1,1,2,0,0,0,0,0,0
401405875,Kent State Golden Flashes,G. Santiago,4593436,,True,32.0,3,8,1,2,2,6,0,0,1,0,1,2,0,0,2,0,8
401405875,Kent State Golden Flashes,S. Carry,4396807,,True,40.0,2,11,0,6,2,5,0,0,0,2,2,3,0,0,9,1,6
401405875,Kent State Golden Flashes,A. Garcia,4066768,,True,22.0,2,5,2,5,0,0,1,1,3,1,4,1,2,0,1,5,5
401405875,Kent State Golden Flashes,T. Beck,4278950,,False,14.0,2,4,2,2,0,2,0,0,0,1,1,0,0,0,1,0,4
401405875,Kent State Golden Flashes,J. Hamilton,4278334,,False,35.0,8,10,7,9,1,1,2,2,3,5,8,0,2,0,0,3,19
401405875,Kent State Golden Flashes,J. Sullinger,4898316,,False,0.0,0,1,0,1,0,0,0,0,0,0,0,0,0,0,0,0,0
401405875,Kent State Golden Flashes,M. Jacobs,4703551,,False,20.0,3,5,3,5,0,0,1,2,0,3,3,4,0,1,3,3,7
401405875,Kent State Golden Flashes,J. Hernandez,4433007,,False,7.0,0,0,0,0,0,0,0,0,0,0,0,0,0,0,1,1,0
401405875,Kent State Golden Flashes,TEAM,TOTAL,TOTAL,False,,22,47,15,30,7,17,4,5,9,20,29,10,4,1,19,18,55
401405875,Akron Zips,E. Freeman,4592699,,True,38.0,8,10,8,10,0,0,7,8,4,4,8,2,2,0,3,0,23
401405875,Akron Zips,A. Ali,4592700,,True,38.0,5,9,1,4,4,5,1,2,1,2,3,4,0,1,2,0,15
401405875,Akron Zips,M. Dawson,4609661,,True,29.0,1,2,0,1,1,1,0,0,2,3,5,1,3,0,0,0,3
401405875,Akron Zips,G. Tribble,4592697,,True,23.0,2,7,1,4,1,3,1,2,0,1,1,5,0,0,2,1,6
401405875,Akron Zips,X. Castaneda,4396641,,True,38.0,5,12,4,8,1,4,4,6,0,2,2,2,5,0,1,2,15
401405875,Akron Zips,A. Bandaogo,4703576,,False,2.0,0,0,0,0,0,0,0,0,0,0,0,0,0,0,0,0,0
401405875,Akron Zips,M. Wynn,4395689,,False,11.0,1,2,1,1,0,1,0,0,1,0,1,0,1,0,1,3,2
401405875,Akron Zips,G. Clarke,4433221,,False,21.0,3,6,0,1,3,5,2,3,0,2,2,2,1,0,2,1,11
401405875,Akron Zips,TEAM,TOTAL,TOTAL,False,,25,48,15,29,10,19,15,21,8,16,24,16,12,1,11,7,75
401405874,Toledo Rockets,J. Shumate,4703541,,True,37.0,5,8,3,5,2,3,0,2,2,3,5,0,1,0,2,3,12
401405874,Toledo Rockets,S. Millner Jr.,4703540,,True,37.0,2,8,2,5,0,3,3,7,1,3,4,1,1,0,0,1,7
401405874,Toledo Rockets,R. Moss,4703538,,True,35.0,6,9,5,8,1,1,0,2,2,5,7,2,2,0,3,3,13
401405874,Toledo Rockets,R. Rollins,4591725,,True,37.0,7,19,6,13,1,6,3,5,0,6,6,3,0,0,0,4,18
401405874,Toledo Rockets,R. Dennis,4431941,,True,37.0,4,10,4,8,0,2,3,4,3,1,4,1,1,0,3,4,11
401405874,Toledo Rockets,M. Carcoana,4898344,,False,3.0,0,0,0,0,0,0,1,2,1,0,1,0,0,0,0,1,1
401405874,Toledo Rockets,K. Jacobi,4898343,,False,3.0,0,0,0,0,0,0,0,0,0,1,1,0,0,0,0,0,0
401405874,Toledo Rockets,K. Saunders,4397880,,False,11.0,0,0,0,0,0,0,0,0,0,2,2,0,0,0,0,0,0
401405874,Toledo Rockets,TEAM,TOTAL,TOTAL,False,,24,54,20,39,4,15,10,22,12,21,33,7,5,0,8,16,62
401405874,Akron Zips,E. Freeman,4592699,,True,29.0,6,6,6,6,0,0,0,0,2,8,10,1,2,0,2,5,12
401405874,Akron Zips,A. Ali,4592700,,True,38.0,5,11,5,9,0,2,3,3,3,2,5,2,1,0,3,2,13
401405874,Akron Zips,M. Dawson,4609661,,True,28.0,3,6,0,0,3,6,0,0,0,5,5,0,0,1,0,3,9
401405874,Akron Zips,G. Tribble,4592697,,True,33.0,4,9,4,8,0,1,2,2,0,0,0,4,1,1,1,2,10
401405874,Akron Zips,X. Castaneda,4396641,,True,35.0,7,15,2,4,5,11,7,7,0,4,4,1,1,1,2,1,26
401405874,Akron Zips,M. Wynn,4395689,,False,18.0,0,2,0,2,0,0,0,0,1,6,7,0,0,2,0,5,0
401405874,Akron Zips,G. Clarke,4433221,,False,19.0,0,4,0,1,0,3,0,3,2,1,3,1,0,0,0,1,0
401405874,Akron Zips,TEAM,TOTAL,TOTAL,False,,25,53,17,30,8,23,12,15,9,27,36,9,5,5,9,19,70
401405873,Ohio Bobcats,B. Roderick,4593447,,True,19.0,1,4,1,2,0,2,0,2,0,2,2,0,0,0,1,1,2
401405873,Ohio Bobcats,B. Vander Plas,4279448,,True,38.0,6,9,5,5,1,4,7,10,1,5,6,2,1,0,1,4,20
401405873,Ohio Bobcats,J. Carter,4067398,,True,33.0,3,11,3,11,0,0,4,8,1,6,7,0,1,2,2,3,10
401405873,Ohio Bobcats,M. Sears,4703530,,True,40.0,5,13,1,4,4,9,4,4,2,4,6,1,0,0,3,4,18
401405873,Ohio Bobcats,M. Brown,4593449,,True,34.0,2,5,1,1,1,4,0,0,0,2,2,0,0,0,0,1,5
401405873,Ohio Bobcats,A. Clayton,4898339,,False,4.0,0,0,0,0,0,0,0,0,1,1,2,0,0,0,0,0,0
401405873,Ohio Bobcats,I. Ezuma,4898338,,False,5.0,0,0,0,0,0,0,0,0,0,0,0,0,0,0,0,0,0
401405873,Ohio Bobcats,T. Schmock,4407066,,False,27.0,2,5,0,0,2,5,0,0,0,2,2,1,1,0,0,0,6
401405873,Ohio Bobcats,TEAM,TOTAL,TOTAL,False,,19,47,11,23,8,24,15,24,5,22,27,4,3,2,8,13,61
401405873,Kent State Golden Flashes,V. Davis,4589474,,True,12.0,2,4,1,2,1,2,0,0,1,2,3,0,0,0,0,0,5
401405873,Kent State Golden Flashes,A. Odusipe,4432496,,True,5.0,0,0,0,0,0,0,0,0,0,0,0,0,0,0,0,2,0
401405873,Kent State Golden Flashes,M. Jacobs,4703551,,True,38.0,9,13,8,12,1,1,0,0,0,10,10,5,2,1,2,3,19
401405873,Kent State Golden Flashes,S. Carry,4396807,,True,40.0,6,18,5,13,1,5,3,5,3,5,8,4,0,0,2,1,16
401405873,Kent State Golden Flashes,A. Garcia,4066768,,True,27.0,2,7,1,4,1,3,3,4,3,2,5,0,0,0,2,4,8
401405873,Kent State Golden Flashes,T. Beck,4278950,,False,14.0,3,7,2,4,1,3,3,4,0,1,1,0,0,0,0,3,10
401405873,Kent State Golden Flashes,J. Hamilton,4278334,,False,31.0,3,5,3,5,0,0,0,0,3,4,7,1,0,3,0,3,6
401405873,Kent State Golden Flashes,G. Santiago,4593436,,False,27.0,1,3,0,0,1,3,0,0,0,1,1,1,1,0,0,2,3
401405873,Kent State Golden Flashes,J. Hernandez,4433007,,False,6.0,0,0,0,0,0,0,0,0,0,2,2,0,0,0,0,0,0
401405873,Kent State Golden Flashes,TEAM,TOTAL,TOTAL,False,,26,57,20,40,6,17,9,13,12,28,40,11,3,4,9,18,67
401405872,Toledo Rockets,J. Shumate,4703541,,True,37.0,5,10,3,4,2,6,0,0,2,3,5,1,0,1,2,3,12
401405872,Toledo Rockets,S. Millner Jr.,4703540,,True,36.0,10,17,8,12,2,5,0,0,3,2,5,1,1,0,2,1,22
401405872,Toledo Rockets,R. Moss,4703538,,True,38.0,1,4,0,3,1,1,4,6,1,5,6,4,1,1,1,3,7
401405872,Toledo Rockets,R. Rollins,4591725,,True,35.0,4,10,3,6,1,4,5,6,1,5,6,3,2,0,2,3,14
401405872,Toledo Rockets,R. Dennis,4431941,,True,39.0,6,14,6,10,0,4,1,4,1,3,4,3,3,1,1,2,13
401405872,Toledo Rockets,M. Carcoana,4898344,,False,3.0,0,0,0,0,0,0,0,0,0,0,0,0,0,0,0,0,0
401405872,Toledo Rockets,K. Jacobi,4898343,,False,4.0,1,2,1,2,0,0,0,0,1,1,2,0,0,0,0,0,2
401405872,Toledo Rockets,E. Farmer,4683945,,False,1.0,0,0,0,0,0,0,2,2,0,0,0,0,0,0,0,0,2
401405872,Toledo Rockets,K. Saunders,4397880,,False,7.0,0,1,0,0,0,1,0,0,0,0,0,1,0,0,0,1,0
401405872,Toledo Rockets,TEAM,TOTAL,TOTAL,False,,27,58,21,37,6,21,12,18,9,22,31,13,7,3,8,13,72
401405872,Central Michigan Chippewas,R. Bissainthe,4279247,,True,29.0,2,5,2,2,0,3,1,2,2,5,7,2,0,0,0,3,5
401405872,Central Michigan Chippewas,H. Henderson,4066434,,True,34.0,8,15,7,10,1,5,4,6,4,6,10,0,0,0,2,3,21
401405872,Central Michigan Chippewas,K. Miller,4898283,,True,40.0,6,16,5,12,1,4,0,0,2,2,4,8,0,0,3,3,13
401405872,Central Michigan Chippewas,B. Taylor,4593256,,True,40.0,5,9,2,4,3,5,2,2,2,6,8,1,1,2,4,1,15
401405872,Central Michigan Chippewas,C. Healy,4278203,,True,40.0,3,12,1,2,2,10,3,3,0,3,3,2,2,0,1,1,11
401405872,Central Michigan Chippewas,N. Pavrette,4898285,,False,9.0,2,3,2,3,0,0,0,0,1,0,1,0,0,1,1,4,4
401405872,Central Michigan Chippewas,M. Stafl,4592903,,False,5.0,1,2,1,2,0,0,0,0,1,2,3,1,0,0,2,3,2
401405872,Central Michigan Chippewas,J. Webb,4898284,,False,3.0,0,0,0,0,0,0,0,0,0,1,1,0,0,0,0,0,0
401405872,Central Michigan Chippewas,TEAM,TOTAL,TOTAL,False,,27,62,20,35,7,27,10,13,14,26,40,14,3,3,14,18,71
401405871,Buffalo Bulls,D. Skogman,4593409,,True,23.0,4,6,3,4,1,2,0,0,4,4,8,0,0,1,1,2,9
401405871,Buffalo Bulls,J. Williams,4397821,,True,39.0,7,16,5,12,2,4,1,2,4,3,7,4,3,2,6,0,17
401405871,Buffalo Bulls,J. Mballa,4397084,,True,26.0,1,7,1,6,0,1,1,2,0,2,2,0,2,0,1,2,3
401405871,Buffalo Bulls,R. Segu,4397820,,True,31.0,1,9,1,6,0,3,4,4,0,2,2,1,1,0,3,1,6
401405871,Buffalo Bulls,M. Jack,4278495,,True,27.0,3,7,3,3,0,4,5,6,2,3,5,1,1,0,1,2,11
401405871,Buffalo Bulls,T. Fagan,4397823,,False,18.0,4,7,3,4,1,3,3,3,1,4,5,0,2,1,0,4,12
401405871,Buffalo Bulls,L. Hardnett,4396610,,False,13.0,1,1,1,1,0,0,0,0,1,1,2,1,0,1,1,5,2
401405871,Buffalo Bulls,C. Jones,4898369,,False,11.0,0,0,0,0,0,0,1,2,0,1,1,2,1,0,1,1,1
401405871,Buffalo Bulls,K. Brewton,4593881,,False,12.0,2,4,0,1,2,3,1,1,0,1,1,0,0,0,0,0,7
401405871,Buffalo Bulls,TEAM,TOTAL,TOTAL,False,,23,57,17,37,6,20,16,20,12,23,35,9,10,5,14,17,68
401405871,Akron Zips,E. Freeman,4592699,,True,29.0,5,7,5,7,0,0,0,1,3,6,9,1,1,2,1,4,10
401405871,Akron Zips,A. Ali,4592700,,True,36.0,7,15,4,12,3,3,2,2,1,2,3,1,3,1,6,3,19
401405871,Akron Zips,M. Dawson,4609661,,True,34.0,5,9,2,5,3,4,1,2,2,2,4,1,1,0,1,1,14
401405871,Akron Zips,G. Tribble,4592697,,True,27.0,0,2,0,2,0,0,6,6,0,4,4,1,1,0,4,4,6
401405871,Akron Zips,X. Castaneda,4396641,,True,35.0,5,15,3,9,2,6,3,3,1,5,6,4,1,1,2,1,15
401405871,Akron Zips,A. Bandaogo,4703576,,False,3.0,0,0,0,0,0,0,0,0,0,2,2,0,0,0,0,1,0
401405871,Akron Zips,M. Wynn,4395689,,False,16.0,1,3,1,1,0,2,1,2,1,1,2,0,1,1,0,2,3
401405871,Akron Zips,G. Clarke,4433221,,False,20.0,1,4,0,2,1,2,0,0,0,2,2,0,0,0,0,2,3
401405871,Akron Zips,TEAM,TOTAL,TOTAL,False,,24,55,15,38,9,17,13,16,10,24,34,8,8,5,15,18,70
401405870,Miami (OH) RedHawks,K. Williams,4592182,,True,34.0,2,7,1,2,1,5,4,5,3,5,8,0,0,0,2,5,9
401405870,Miami (OH) RedHawks,D. Brown,4279435,,True,7.0,0,1,0,0,0,1,0,0,0,1,1,1,1,0,0,0,0
401405870,Miami (OH) RedHawks,P. Ayah,4067388,,True,31.0,7,8,7,8,0,0,2,2,2,4,6,1,1,0,1,3,16
401405870,Miami (OH) RedHawks,D. Grant,4593444,,True,39.0,6,19,5,12,1,7,2,2,1,5,6,5,2,0,2,4,15
401405870,Miami (OH) RedHawks,M. Lairy,4397850,,True,19.0,4,9,3,6,1,3,5,5,0,1,1,2,0,0,5,4,14
401405870,Miami (OH) RedHawks,J. Etzler,4593443,,False,11.0,0,1,0,0,0,1,0,0,0,1,1,1,0,1,0,2,0
401405870,Miami (OH) RedHawks,E. McNamara,4397853,,False,19.0,5,7,5,7,0,0,3,6,1,0,1,0,1,0,1,2,13
401405870,Miami (OH) RedHawks,J. Beck,4279495,,False,4.0,0,0,0,0,0,0,0,0,0,0,0,0,0,0,0,0,0
401405870,Miami (OH) RedHawks,M. White,4397851,,False,12.0,2,2,0,0,2,2,0,0,0,1,1,0,0,0,0,0,6
401405870,Miami (OH) RedHawks,I. Coleman-Lands,4279432,,False,24.0,1,7,1,1,0,6,0,1,0,0,0,1,1,0,0,2,2
401405870,Miami (OH) RedHawks,TEAM,TOTAL,TOTAL,False,,27,61,22,36,5,25,16,21,9,19,28,11,6,1,11,22,75
401405870,Kent State Golden Flashes,V. Davis,4589474,,True,12.0,1,3,1,1,0,2,2,2,1,1,2,0,0,0,0,1,4
401405870,Kent State Golden Flashes,A. Odusipe,4432496,,True,7.0,0,0,0,0,0,0,0,0,0,0,0,0,0,0,1,1,0
401405870,Kent State Golden Flashes,M. Jacobs,4703551,,True,36.0,4,9,3,6,1,3,12,15,3,8,11,2,3,0,2,2,21
401405870,Kent State Golden Flashes,S. Carry,4396807,,True,38.0,5,15,3,7,2,8,3,4,0,4,4,8,2,0,2,2,15
401405870,Kent State Golden Flashes,A. Garcia,4066768,,True,21.0,4,7,2,2,2,5,2,2,0,2,2,0,0,0,0,3,12
401405870,Kent State Golden Flashes,T. Beck,4278950,,False,20.0,2,4,1,1,1,3,3,4,2,4,6,0,0,0,1,4,8
401405870,Kent State Golden Flashes,J. Hamilton,4278334,,False,28.0,7,10,7,10,0,0,1,1,3,6,9,1,1,1,3,2,15
401405870,Kent State Golden Flashes,G. Santiago,4593436,,False,30.0,1,4,0,0,1,4,5,5,1,1,2,3,2,0,2,0,8
401405870,Kent State Golden Flashes,J. Hernandez,4433007,,False,8.0,1,2,1,1,0,1,0,0,0,0,0,0,0,0,0,1,2
401405870,Kent State Golden Flashes,TEAM,TOTAL,TOTAL,False,,25,54,18,28,7,26,28,33,11,28,39,14,8,1,12,16,85
401405869,Ohio Bobcats,B. Roderick,4593447,,True,25.0,1,5,0,0,1,5,0,0,0,2,2,0,0,0,3,5,3
401405869,Ohio Bobcats,B. Vander Plas,4279448,,True,35.0,5,10,2,4,3,6,1,2,0,6,6,3,0,0,3,3,14
401405869,Ohio Bobcats,J. Carter,4067398,,True,26.0,9,14,9,13,0,1,2,2,6,12,18,1,1,0,1,0,20
401405869,Ohio Bobcats,M. Sears,4703530,,True,38.0,7,15,4,9,3,6,7,9,5,5,10,5,1,0,2,2,24
401405869,Ohio Bobcats,M. Brown,4593449,,True,28.0,4,10,1,4,3,6,2,2,1,4,5,0,1,1,1,3,13
401405869,Ohio Bobcats,A. Clayton,4898339,,False,6.0,0,0,0,0,0,0,0,0,0,1,1,0,0,0,0,1,0
401405869,Ohio Bobcats,I. Ezuma,4898338,,False,12.0,0,3,0,3,0,0,0,1,1,2,3,0,0,1,0,5,0
401405869,Ohio Bobcats,S. Towns,4703531,,False,2.0,0,0,0,0,0,0,0,0,0,0,0,0,0,0,0,0,0
401405869,Ohio Bobcats,O. Adelodun,4898337,,False,2.0,0,1,0,1,0,0,0,0,0,0,0,0,0,0,1,0,0
401405869,Ohio Bobcats,L. Frazier,4606834,,False,0.0,0,0,0,0,0,0,0,0,0,0,0,0,0,0,0,0,0
401405869,Ohio Bobcats,T. Schmock,4407066,,False,26.0,1,4,0,0,1,4,0,0,0,2,2,2,0,0,0,0,3
401405869,Ohio Bobcats,TEAM,TOTAL,TOTAL,False,,27,62,16,34,11,28,12,16,13,35,48,11,3,2,11,19,77
401405869,Ball State Cardinals,M. Thomas,4279796,,True,27.0,3,7,1,2,2,5,0,0,0,3,3,0,0,1,1,3,8
401405869,Ball State Cardinals,P. Sparks,4898008,,True,32.0,6,12,6,11,0,1,8,10,5,9,14,0,0,0,2,2,20
401405869,Ball State Cardinals,L. Bumbalough,4593397,,True,35.0,2,9,1,3,1,6,0,0,0,2,2,2,1,1,0,0,5
401405869,Ball State Cardinals,T. Cochran,4431930,,True,27.0,6,15,2,10,4,5,0,2,0,3,3,3,4,0,2,3,16
401405869,Ball State Cardinals,D. Jacobs,4397198,,True,31.0,4,9,3,7,1,2,0,0,3,3,6,3,1,1,1,2,9
401405869,Ball State Cardinals,B. Jihad,4898009,,False,6.0,1,1,1,1,0,0,0,0,1,1,2,0,0,0,0,3,2
401405869,Ball State Cardinals,M. Pearson,4431796,,False,7.0,0,1,0,0,0,1,0,0,0,0,0,0,0,0,0,1,0
401405869,Ball State Cardinals,L. Brown,4912654,,False,13.0,0,4,0,2,0,2,0,0,0,1,1,0,0,0,0,0,0
401405869,Ball State Cardinals,J. Sellers,4898010,,False,22.0,2,10,1,5,1,5,2,5,0,2,2,0,1,1,0,4,7
401405869,Ball State Cardinals,TEAM,TOTAL,TOTAL,False,,24,68,15,41,9,27,10,17,13,25,38,8,7,4,6,18,67
401405868,Wright State Raiders,A. Braun,4709318,,True,13.0,1,4,1,4,0,0,0,0,1,0,1,1,0,0,1,1,2
401405868,Wright State Raiders,G. Basile,4397787,,True,28.0,6,16,6,14,0,2,6,7,2,5,7,3,0,1,1,2,18
401405868,Wright State Raiders,T. Holden,4431990,,True,39.0,5,11,5,11,0,0,9,11,3,1,4,1,3,0,4,4,19
401405868,Wright State Raiders,T. Calvin,4431915,,True,40.0,9,17,6,12,3,5,0,0,1,5,6,3,2,1,2,1,21
401405868,Wright State Raiders,T. Finke,4396017,,True,40.0,4,5,2,2,2,3,0,0,1,2,3,2,0,0,1,1,10
401405868,Wright State Raiders,C. Wilbourn,4432141,,False,4.0,0,1,0,1,0,0,0,0,1,0,1,0,0,0,2,0,0
401405868,Wright State Raiders,K. Norris,4898194,,False,18.0,0,2,0,1,0,1,0,0,1,2,3,1,1,0,0,2,0
401405868,Wright State Raiders,A. Welage,4702995,,False,18.0,1,1,1,1,0,0,0,0,0,1,1,3,0,0,0,3,2
401405868,Wright State Raiders,TEAM,TOTAL,TOTAL,False,,26,57,21,46,5,11,15,18,13,17,30,14,6,2,11,14,72
401405868,Northern Kentucky Norse,C. Brandon,4397737,,True,25.0,1,4,1,4,0,0,0,0,2,5,7,0,2,4,3,4,2
401405868,Northern Kentucky Norse,S. Vinson,4898164,,True,37.0,1,4,1,2,0,2,0,0,0,4,4,4,1,2,4,2,2
401405868,Northern Kentucky Norse,M. Warrick,4702714,,True,32.0,12,17,9,14,3,3,1,1,0,1,1,0,0,1,3,3,28
401405868,Northern Kentucky Norse,B. Langdon,4593305,,True,38.0,5,11,5,9,0,2,2,4,0,3,3,2,1,0,2,4,12
401405868,Northern Kentucky Norse,T. Faulkner,4397774,,True,35.0,3,9,2,6,1,3,7,8,2,1,3,1,1,1,1,1,14
401405868,Northern Kentucky Norse,A. Nelson,4397772,,False,15.0,4,6,4,6,0,0,2,2,3,2,5,0,0,0,0,1,10
401405868,Northern Kentucky Norse,H. Pivorius,4898167,,False,2.0,0,0,0,0,0,0,0,0,0,0,0,0,0,0,0,1,0
401405868,Northern Kentucky Norse,J. Evans,4702717,,False,2.0,0,0,0,0,0,0,0,0,0,0,0,0,0,0,0,0,0
401405868,Northern Kentucky Norse,T. Robinson,4702713,,False,14.0,1,1,0,0,1,1,0,0,0,2,2,1,0,0,1,1,3
401405868,Northern Kentucky Norse,TEAM,TOTAL,TOTAL,False,,27,52,22,41,5,11,12,15,9,19,28,8,5,8,14,17,71
401405867,Purdue Fort Wayne Mastodons,B. Planutis,4279863,,True,23.0,0,3,0,0,0,3,0,0,0,4,4,0,0,0,0,3,0
401405867,Purdue Fort Wayne Mastodons,R. Kpedi,4278247,,True,28.0,3,5,3,5,0,0,3,5,3,4,7,0,1,2,0,1,9
401405867,Purdue Fort Wayne Mastodons,J. Godfrey,4398080,,True,35.0,3,16,2,9,1,7,4,4,0,6,6,4,2,1,3,2,11
401405867,Purdue Fort Wayne Mastodons,D. Chong Qui,4397976,,True,35.0,4,11,3,7,1,4,0,1,0,4,4,1,1,2,2,2,9
401405867,Purdue Fort Wayne Mastodons,J. Pipkins,4278735,,True,35.0,2,10,2,9,0,1,2,2,0,2,2,1,3,0,5,0,6
401405867,Purdue Fort Wayne Mastodons,J. DeJurnett,4702942,,False,9.0,1,1,1,1,0,0,1,2,1,0,1,0,0,0,0,1,3
401405867,Purdue Fort Wayne Mastodons,C. Benford,4279505,,False,3.0,0,0,0,0,0,0,0,0,0,0,0,0,0,0,0,1,0
401405867,Purdue Fort Wayne Mastodons,J. Peterson,4898175,,False,11.0,1,3,0,0,1,3,0,0,0,3,3,1,1,1,2,2,3
401405867,Purdue Fort Wayne Mastodons,D. Billups,4593718,,False,21.0,1,3,1,1,0,2,0,0,0,1,1,1,1,0,2,3,2
401405867,Purdue Fort Wayne Mastodons,TEAM,TOTAL,TOTAL,False,,15,52,12,32,3,20,10,14,4,25,29,8,9,6,15,15,43
401405867,Northern Kentucky Norse,C. Brandon,4397737,,True,21.0,0,1,0,1,0,0,0,0,2,12,14,0,2,2,2,1,0
401405867,Northern Kentucky Norse,S. Vinson,4898164,,True,29.0,2,7,1,4,1,3,0,1,0,3,3,4,3,0,6,4,5
401405867,Northern Kentucky Norse,M. Warrick,4702714,,True,32.0,7,15,6,9,1,6,4,4,1,4,5,3,2,0,3,1,19
401405867,Northern Kentucky Norse,B. Langdon,4593305,,True,33.0,3,8,2,5,1,3,2,2,0,4,4,4,1,0,1,3,9
401405867,Northern Kentucky Norse,T. Faulkner,4397774,,True,33.0,4,14,3,10,1,4,0,0,2,3,5,0,1,0,2,3,9
401405867,Northern Kentucky Norse,D. Böhm,4702716,,False,1.0,0,0,0,0,0,0,0,2,0,0,0,0,0,0,0,0,0
401405867,Northern Kentucky Norse,A. Nelson,4397772,,False,18.0,3,4,3,4,0,0,1,2,1,8,9,0,2,0,1,1,7
401405867,Northern Kentucky Norse,N. Hupmann,4702718,,False,1.0,0,0,0,0,0,0,0,0,0,0,0,0,0,0,0,0,0
401405867,Northern Kentucky Norse,H. Pivorius,4898167,,False,4.0,1,2,0,0,1,2,0,0,0,0,0,0,0,0,0,0,3
401405867,Northern Kentucky Norse,I. Mason,4898163,,False,1.0,0,0,0,0,0,0,0,0,0,0,0,0,0,0,0,0,0
401405867,Northern Kentucky Norse,J. Evans,4702717,,False,8.0,0,0,0,0,0,0,0,0,1,1,2,0,0,0,0,1,0
401405867,Northern Kentucky Norse,T. Robinson,4702713,,False,19.0,2,5,2,4,0,1,1,2,1,0,1,1,1,1,0,1,5
401405867,Northern Kentucky Norse,TEAM,TOTAL,TOTAL,False,,22,56,17,37,5,19,8,13,10,36,46,12,12,3,16,15,57
401405866,Wright State Raiders,A. Braun,4709318,,True,15.0,2,3,2,3,0,0,0,1,0,2,2,1,0,0,2,2,4
401405866,Wright State Raiders,G. Basile,4397787,,True,37.0,10,15,8,11,2,4,5,7,2,9,11,3,0,4,4,3,27
401405866,Wright State Raiders,T. Holden,4431990,,True,36.0,3,10,3,10,0,0,6,6,3,7,10,2,1,0,3,5,12
401405866,Wright State Raiders,T. Calvin,4431915,,True,35.0,4,11,1,4,3,7,6,6,0,2,2,7,3,0,3,3,17
401405866,Wright State Raiders,T. Finke,4396017,,True,36.0,3,7,2,4,1,3,5,6,3,4,7,0,0,1,2,1,12
401405866,Wright State Raiders,C. Wilbourn,4432141,,False,3.0,0,0,0,0,0,0,0,0,0,1,1,0,0,1,1,0,0
401405866,Wright State Raiders,K. Norris,4898194,,False,28.0,3,5,0,1,3,4,1,1,0,0,0,2,0,0,0,4,10
401405866,Wright State Raiders,A. Welage,4702995,,False,10.0,0,0,0,0,0,0,0,0,0,0,0,2,0,0,1,2,0
401405866,Wright State Raiders,TEAM,TOTAL,TOTAL,False,,25,51,16,33,9,18,23,27,10,26,36,17,4,6,19,20,82
401405866,Cleveland State Vikings,D. Johnson,4399102,,True,16.0,1,4,1,4,0,0,0,0,2,3,5,1,1,1,1,2,2
401405866,Cleveland State Vikings,D. Hodge,4702702,,True,29.0,7,15,5,7,2,8,0,1,0,2,2,1,1,3,1,5,16
401405866,Cleveland State Vikings,T. Gomillion,4592883,,True,21.0,3,10,3,8,0,2,0,0,1,2,3,1,2,0,1,5,6
401405866,Cleveland State Vikings,D. Parker,4397548,,True,23.0,3,3,3,3,0,0,2,4,1,0,1,0,2,0,0,2,8
401405866,Cleveland State Vikings,T. Patton,4279311,,True,27.0,2,10,2,7,0,3,0,2,1,1,2,3,1,0,4,2,4
401405866,Cleveland State Vikings,C. Greene,4702700,,False,1.0,0,0,0,0,0,0,0,0,0,0,0,0,0,0,0,0,0
401405866,Cleveland State Vikings,A. Mirambeaux,4898221,,False,11.0,0,0,0,0,0,0,2,4,1,1,2,2,1,0,1,4,2
401405866,Cleveland State Vikings,M. Majak,4433216,,False,8.0,0,1,0,1,0,0,0,0,2,0,2,1,1,0,0,0,0
401405866,Cleveland State Vikings,J. Woodrich,4702699,,False,15.0,2,5,2,2,0,3,3,3,0,2,2,1,0,0,0,0,7
401405866,Cleveland State Vikings,Y. Hill,4702698,,False,17.0,2,6,2,4,0,2,3,4,0,0,0,1,0,0,1,0,7
401405866,Cleveland State Vikings,B. Finstuen,4593788,,False,26.0,4,7,4,7,0,0,4,6,6,3,9,3,1,0,3,4,12
401405866,Cleveland State Vikings,N. Jack,4592191,,False,6.0,1,2,0,0,1,2,0,0,0,0,0,0,0,0,0,1,3
401405866,Cleveland State Vikings,TEAM,TOTAL,TOTAL,False,,25,63,22,43,3,20,14,24,16,16,32,14,10,4,12,25,67
401405865,UIC Flames,M. Diggins,4279245,,True,34.0,4,5,4,4,0,1,3,4,1,5,6,2,1,2,5,1,11
401405865,UIC Flames,J. Carter,4898186,,True,30.0,6,16,2,6,4,10,0,0,4,5,9,0,1,2,1,3,16
401405865,UIC Flames,D. Franklin,4703420,,True,31.0,6,11,5,5,1,6,1,4,1,5,6,3,0,3,4,4,14
401405865,UIC Flames,J. Warren,4592250,,True,38.0,5,10,2,3,3,7,3,4,0,2,2,3,0,1,4,4,16
401405865,UIC Flames,K. Johnson,4278304,,True,35.0,3,7,2,4,1,3,0,0,0,2,2,4,0,0,2,4,7
401405865,UIC Flames,F. Skobalj,4898188,,False,4.0,0,1,0,1,0,0,0,0,0,0,0,0,0,0,0,0,0
401405865,UIC Flames,J. Johnson,4702706,,False,1.0,0,0,0,0,0,0,0,0,0,0,0,0,0,0,0,0,0
401405865,UIC Flames,J. Ahale,4397767,,False,27.0,2,6,0,1,2,5,2,2,0,5,5,0,0,1,0,4,8
401405865,UIC Flames,TEAM,TOTAL,TOTAL,False,,26,56,15,24,11,32,9,14,6,26,32,12,2,9,16,20,72
401405865,Purdue Fort Wayne Mastodons,B. Planutis,4279863,,True,20.0,3,4,1,1,2,3,0,0,0,3,3,0,0,0,0,2,8
401405865,Purdue Fort Wayne Mastodons,R. Kpedi,4278247,,True,27.0,1,3,1,3,0,0,1,3,3,5,8,1,1,0,0,3,3
401405865,Purdue Fort Wayne Mastodons,J. Godfrey,4398080,,True,35.0,6,14,4,9,2,5,8,9,0,5,5,1,3,0,0,1,22
401405865,Purdue Fort Wayne Mastodons,D. Chong Qui,4397976,,True,32.0,4,12,3,11,1,1,5,6,1,1,2,3,1,0,2,2,14
401405865,Purdue Fort Wayne Mastodons,J. Pipkins,4278735,,True,31.0,10,20,10,18,0,2,1,1,1,3,4,1,2,0,0,2,21
401405865,Purdue Fort Wayne Mastodons,J. DeJurnett,4702942,,False,11.0,0,3,0,3,0,0,0,0,2,1,3,0,1,0,0,2,0
401405865,Purdue Fort Wayne Mastodons,C. Benford,4279505,,False,2.0,0,0,0,0,0,0,0,0,0,0,0,0,0,0,0,0,0
401405865,Purdue Fort Wayne Mastodons,J. Peterson,4898175,,False,17.0,1,1,1,1,0,0,1,2,0,4,4,0,1,0,3,2,3
401405865,Purdue Fort Wayne Mastodons,D. Billups,4593718,,False,25.0,2,5,1,3,1,2,2,2,1,4,5,0,1,0,1,1,7
401405865,Purdue Fort Wayne Mastodons,TEAM,TOTAL,TOTAL,False,,27,62,21,49,6,13,18,23,10,27,37,6,10,0,7,15,78
401405864,Northern Kentucky Norse,C. Brandon,4397737,,True,20.0,3,7,3,7,0,0,2,2,6,5,11,0,1,0,1,5,8
401405864,Northern Kentucky Norse,S. Vinson,4898164,,True,35.0,2,9,0,4,2,5,3,4,0,5,5,5,3,0,0,4,9
401405864,Northern Kentucky Norse,M. Warrick,4702714,,True,36.0,8,12,6,8,2,4,7,8,0,4,4,2,1,0,2,0,25
401405864,Northern Kentucky Norse,B. Langdon,4593305,,True,37.0,4,9,4,9,0,0,2,2,1,2,3,4,0,0,1,2,10
401405864,Northern Kentucky Norse,T. Faulkner,4397774,,True,30.0,4,8,3,3,1,5,4,4,2,3,5,0,0,0,6,4,13
401405864,Northern Kentucky Norse,A. Nelson,4397772,,False,19.0,2,2,2,2,0,0,3,3,1,4,5,1,0,1,0,1,7
401405864,Northern Kentucky Norse,H. Pivorius,4898167,,False,3.0,0,0,0,0,0,0,0,0,0,0,0,0,0,0,0,0,0
401405864,Northern Kentucky Norse,J. Evans,4702717,,False,4.0,0,0,0,0,0,0,0,0,0,1,1,0,0,0,0,0,0
401405864,Northern Kentucky Norse,T. Robinson,4702713,,False,16.0,1,2,0,0,1,2,2,2,0,2,2,0,0,0,0,2,5
401405864,Northern Kentucky Norse,TEAM,TOTAL,TOTAL,False,,24,49,18,33,6,16,23,25,10,26,36,12,5,1,11,18,77
401405864,Detroit Mercy Titans,N. Waterman,4593355,,True,18.0,1,3,1,1,0,2,1,2,2,3,5,0,1,1,0,2,3
401405864,Detroit Mercy Titans,W. Isiani,4397740,,True,31.0,1,5,0,1,1,4,0,1,1,1,2,1,0,1,1,2,3
401405864,Detroit Mercy Titans,M. Johnson,4592487,,True,30.0,3,6,1,2,2,4,0,0,2,3,5,1,0,0,1,4,8
401405864,Detroit Mercy Titans,A. Davis,4397732,,True,36.0,5,17,4,10,1,7,6,6,2,2,4,3,0,0,5,2,17
401405864,Detroit Mercy Titans,D.J. Harvey,4278010,,True,27.0,2,8,1,4,1,4,0,0,3,3,6,0,1,0,1,5,5
401405864,Detroit Mercy Titans,M. Akec,4396647,,False,17.0,2,4,2,2,0,2,0,0,1,2,3,0,0,0,0,0,4
401405864,Detroit Mercy Titans,B. Koka,4278375,,False,2.0,0,0,0,0,0,0,0,0,0,0,0,0,0,0,0,0,0
401405864,Detroit Mercy Titans,K. LeGreair,4567749,,False,11.0,0,0,0,0,0,0,0,0,1,0,1,0,1,0,0,1,0
401405864,Detroit Mercy Titans,K. McAdoo,4279331,,False,28.0,6,13,4,8,2,5,5,5,0,0,0,1,0,0,1,1,19
401405864,Detroit Mercy Titans,TEAM,TOTAL,TOTAL,False,,20,56,13,28,7,28,12,14,12,15,27,6,3,2,9,18,59
401405863,Wright State Raiders,G. Basile,4397787,,True,33.0,7,15,7,14,0,1,4,4,4,7,11,1,0,0,1,3,18
401405863,Wright State Raiders,K. Norris,4898194,,True,17.0,0,1,0,0,0,1,0,0,0,0,0,0,0,0,0,0,0
401405863,Wright State Raiders,T. Holden,4431990,,True,37.0,7,17,7,15,0,2,13,17,4,6,10,0,1,0,2,1,27
401405863,Wright State Raiders,T. Calvin,4431915,,True,38.0,7,12,5,7,2,5,0,0,0,3,3,5,1,0,0,2,16
401405863,Wright State Raiders,T. Finke,4396017,,True,38.0,1,8,0,2,1,6,0,0,1,4,5,6,0,0,0,1,3
401405863,Wright State Raiders,A. Braun,4709318,,False,6.0,0,1,0,1,0,0,0,0,2,1,3,0,0,0,0,2,0
401405863,Wright State Raiders,C. Wilbourn,4432141,,False,2.0,0,0,0,0,0,0,0,0,0,1,1,0,0,0,0,1,0
401405863,Wright State Raiders,A. Neff,4397786,,False,1.0,0,0,0,0,0,0,0,0,0,0,0,0,0,0,0,0,0
401405863,Wright State Raiders,A. Welage,4702995,,False,27.0,4,9,1,3,3,6,0,0,2,1,3,1,0,0,0,3,11
401405863,Wright State Raiders,T. Nagy,4593400,,False,1.0,0,0,0,0,0,0,0,0,0,0,0,0,0,0,0,0,0
401405863,Wright State Raiders,TEAM,TOTAL,TOTAL,False,,26,63,20,42,6,21,17,21,15,24,39,13,2,0,3,13,75
401405863,Oakland Golden Grizzlies,T. Townsend,4702721,,True,36.0,4,8,4,7,0,1,2,2,1,2,3,0,0,0,1,4,10
401405863,Oakland Golden Grizzlies,J. Cain,4278572,,True,34.0,7,11,7,9,0,2,3,3,2,13,15,0,0,1,2,5,17
401405863,Oakland Golden Grizzlies,M. Parrish,4702719,,True,33.0,5,8,3,4,2,4,8,10,2,5,7,0,0,0,1,4,20
401405863,Oakland Golden Grizzlies,J. Moore,4702724,,True,39.0,6,21,5,13,1,8,3,5,2,2,4,1,1,0,4,2,16
401405863,Oakland Golden Grizzlies,B. Lampman,4593343,,True,34.0,0,5,0,0,0,5,0,0,0,3,3,0,2,0,0,1,0
401405863,Oakland Golden Grizzlies,W. Shepherd,4898168,,False,4.0,0,0,0,0,0,0,0,0,0,0,0,0,0,0,0,1,0
401405863,Oakland Golden Grizzlies,T. Wyman,4898172,,False,0.0,0,0,0,0,0,0,0,0,0,0,0,0,0,0,0,0,0
401405863,Oakland Golden Grizzlies,B. Parker,4898171,,False,1.0,0,0,0,0,0,0,0,0,0,0,0,0,0,0,0,0,0
401405863,Oakland Golden Grizzlies,O. Price,4898170,,False,19.0,0,0,0,0,0,0,0,0,0,0,0,0,0,0,0,1,0
401405863,Oakland Golden Grizzlies,TEAM,TOTAL,TOTAL,False,,22,53,19,33,3,20,16,20,8,25,33,1,3,1,8,18,63
401405862,Robert Morris Colonials,M. Mayers,4898180,,True,16.0,3,4,3,4,0,0,0,0,2,3,5,1,0,0,0,1,6
401405862,Robert Morris Colonials,J. Williams,4703403,,True,19.0,1,6,0,1,1,5,0,0,0,0,0,1,0,0,3,4,3
401405862,Robert Morris Colonials,K. Spear,4702997,,True,40.0,6,9,5,7,1,2,2,5,1,4,5,3,2,2,5,2,15
401405862,Robert Morris Colonials,E. Cheeks,4703000,,True,39.0,6,12,5,7,1,5,8,8,3,4,7,6,0,3,4,1,21
401405862,Robert Morris Colonials,M. Green III,4593261,,True,40.0,3,5,3,3,0,2,0,0,0,2,2,1,2,0,3,2,6
401405862,Robert Morris Colonials,B. Stone,4432906,,False,19.0,4,4,3,3,1,1,1,2,1,3,4,1,0,1,1,2,10
401405862,Robert Morris Colonials,K. Farris,4702996,,False,27.0,2,10,1,4,1,6,1,2,0,1,1,2,1,0,2,2,6
401405862,Robert Morris Colonials,TEAM,TOTAL,TOTAL,False,,25,50,20,29,5,21,12,17,8,17,25,15,5,6,18,14,67
401405862,Cleveland State Vikings,D. Johnson,4399102,,True,38.0,3,4,3,4,0,0,3,3,1,7,8,1,0,2,1,2,9
401405862,Cleveland State Vikings,D. Hodge,4702702,,True,31.0,5,9,2,3,3,6,2,2,0,0,0,4,3,0,1,1,15
401405862,Cleveland State Vikings,T. Gomillion,4592883,,True,33.0,6,13,5,10,1,3,0,0,1,2,3,2,2,0,1,3,13
401405862,Cleveland State Vikings,D. Parker,4397548,,True,24.0,1,3,1,3,0,0,0,0,2,2,4,4,0,0,0,1,2
401405862,Cleveland State Vikings,T. Patton,4279311,,True,35.0,9,15,8,13,1,2,6,8,4,2,6,4,3,0,5,1,25
401405862,Cleveland State Vikings,A. Mirambeaux,4898221,,False,2.0,1,1,1,1,0,0,0,0,0,0,0,0,0,0,1,1,2
401405862,Cleveland State Vikings,J. Woodrich,4702699,,False,5.0,1,3,1,1,0,2,0,0,0,0,0,1,0,0,0,1,2
401405862,Cleveland State Vikings,Y. Hill,4702698,,False,9.0,1,4,1,3,0,1,0,0,0,1,1,1,1,0,0,1,2
401405862,Cleveland State Vikings,B. Finstuen,4593788,,False,19.0,4,5,4,5,0,0,2,2,2,4,6,1,0,0,0,2,10
401405862,Cleveland State Vikings,N. Jack,4592191,,False,4.0,1,2,0,0,1,2,0,0,0,0,0,0,0,0,0,0,3
401405862,Cleveland State Vikings,TEAM,TOTAL,TOTAL,False,,32,59,26,43,6,16,13,15,10,20,30,18,9,2,10,13,83
401405861,Oakland Golden Grizzlies,T. Townsend,4702721,,True,22.0,3,5,3,5,0,0,3,5,2,4,6,0,0,0,0,0,9
401405861,Oakland Golden Grizzlies,J. Cain,4278572,,True,39.0,7,11,5,7,2,4,1,3,1,5,6,1,3,1,2,1,17
401405861,Oakland Golden Grizzlies,M. Parrish,4702719,,True,38.0,3,13,2,3,1,10,2,2,1,3,4,3,4,0,1,3,9
401405861,Oakland Golden Grizzlies,J. Moore,4702724,,True,37.0,5,10,4,7,1,3,5,6,1,6,7,9,1,0,4,2,16
401405861,Oakland Golden Grizzlies,B. Lampman,4593343,,True,38.0,5,10,1,3,4,7,0,0,1,1,2,1,3,0,1,0,14
401405861,Oakland Golden Grizzlies,W. Shepherd,4898168,,False,3.0,0,0,0,0,0,0,0,0,0,0,0,0,0,0,1,0,0
401405861,Oakland Golden Grizzlies,C. Conway,4702722,,False,3.0,0,0,0,0,0,0,0,0,0,0,0,0,0,0,0,0,0
401405861,Oakland Golden Grizzlies,T. Wyman,4898172,,False,0.0,0,0,0,0,0,0,0,0,0,0,0,0,0,0,0,0,0
401405861,Oakland Golden Grizzlies,O. Price,4898170,,False,20.0,2,6,1,2,1,4,0,0,0,0,0,0,3,0,0,4,5
401405861,Oakland Golden Grizzlies,TEAM,TOTAL,TOTAL,False,,25,55,16,27,9,28,11,16,7,21,28,14,14,1,9,10,70
401405861,IU Indianapolis Jaguars,C. Isitua,4433271,,True,40.0,5,11,5,11,0,0,1,2,3,11,14,0,0,2,2,3,11
401405861,IU Indianapolis Jaguars,B. Stanton III,4898073,,True,40.0,4,6,1,3,3,3,2,2,0,2,2,2,2,0,2,4,13
401405861,IU Indianapolis Jaguars,M. DePersia,4432965,,True,40.0,3,10,2,6,1,4,0,0,0,2,2,9,1,1,2,2,7
401405861,IU Indianapolis Jaguars,N. McClure,4397701,,True,40.0,5,12,3,8,2,4,0,0,1,7,8,1,0,0,8,4,12
401405861,IU Indianapolis Jaguars,B.J. Maxwell,3922057,,True,40.0,6,8,3,4,3,4,0,0,0,3,3,1,2,1,5,3,15
401405861,IU Indianapolis Jaguars,TEAM,TOTAL,TOTAL,False,,23,47,14,32,9,15,3,4,4,26,30,13,5,4,20,16,58
401405860,UIC Flames,M. Diggins,4279245,,True,26.0,4,9,3,6,1,3,4,6,0,6,6,0,2,2,3,0,13
401405860,UIC Flames,J. Carter,4898186,,True,26.0,1,6,0,1,1,5,0,0,2,6,8,0,1,2,2,5,3
401405860,UIC Flames,D. Franklin,4703420,,True,35.0,5,12,4,7,1,5,1,2,0,6,6,3,1,2,4,2,12
401405860,UIC Flames,J. Warren,4592250,,True,31.0,4,7,3,5,1,2,3,3,0,3,3,4,0,0,1,0,12
401405860,UIC Flames,K. Johnson,4278304,,True,34.0,6,11,4,7,2,4,7,8,1,3,4,3,2,0,2,1,21
401405860,UIC Flames,F. Skobalj,4898188,,False,14.0,4,5,0,0,4,5,0,0,1,2,3,0,0,0,0,1,12
401405860,UIC Flames,Z. Griffin,4396988,,False,18.0,1,4,1,3,0,1,0,0,1,1,2,0,0,0,0,0,2
401405860,UIC Flames,J. Johnson,4702706,,False,1.0,0,0,0,0,0,0,2,2,0,0,0,0,0,0,0,1,2
401405860,UIC Flames,J. Ahale,4397767,,False,15.0,1,1,0,0,1,1,0,0,0,0,0,0,0,0,1,2,3
401405860,UIC Flames,TEAM,TOTAL,TOTAL,False,,26,55,15,29,11,26,17,21,5,29,34,10,6,6,13,12,80
401405860,Milwaukee Panthers,J. St. Pierre,4702939,,True,28.0,8,12,8,12,0,0,0,3,9,1,10,1,0,1,0,1,16
401405860,Milwaukee Panthers,J. Sinani,4838557,,True,6.0,0,1,0,1,0,0,0,0,0,1,1,1,1,0,1,0,0
401405860,Milwaukee Panthers,D. Hancock,4702933,,True,11.0,0,2,0,1,0,1,0,0,0,2,2,1,1,0,2,1,0
401405860,Milwaukee Panthers,D. Newby,4702932,,True,31.0,2,2,0,0,2,2,0,0,0,4,4,2,2,0,0,5,6
401405860,Milwaukee Panthers,J. Lathon,4397863,,True,33.0,6,11,2,5,4,6,3,4,1,9,10,1,0,1,2,2,19
401405860,Milwaukee Panthers,T. Simms,4702936,,False,2.0,1,3,1,2,0,1,1,1,0,1,1,0,0,1,0,1,3
401405860,Milwaukee Panthers,K. Ross,4684300,,False,0.0,0,0,0,0,0,0,0,0,0,0,0,0,0,0,0,0,0
401405860,Milwaukee Panthers,M. Browning II,4898074,,False,23.0,4,8,3,6,1,2,2,4,1,1,2,3,3,0,2,3,11
401405860,Milwaukee Panthers,D. Gholston,4702934,,False,28.0,4,17,3,12,1,5,1,1,0,3,3,1,0,0,4,3,10
401405860,Milwaukee Panthers,J. Thomas,4593291,,False,27.0,2,8,2,8,0,0,0,0,0,2,2,1,1,0,1,2,4
401405860,Milwaukee Panthers,V. Baker Jr.,4277830,,False,11.0,0,2,0,2,0,0,0,0,0,2,2,1,0,2,0,0,0
401405860,Milwaukee Panthers,TEAM,TOTAL,TOTAL,False,,27,66,19,49,8,17,7,13,13,26,39,12,8,5,13,18,69
401405859,Green Bay Phoenix,C. Meyer,4897724,,True,16.0,1,5,1,5,0,0,0,1,0,1,1,0,0,1,1,2,2
401405859,Green Bay Phoenix,J. Kellogg III,4592887,,True,13.0,1,1,1,1,0,0,0,0,0,0,0,0,0,0,0,1,2
401405859,Green Bay Phoenix,E. Ansong,4702930,,True,28.0,4,7,4,6,0,1,3,4,0,2,2,1,1,0,3,1,11
401405859,Green Bay Phoenix,K. McGee,4897723,,True,37.0,8,16,6,12,2,4,2,2,1,8,9,2,0,0,5,2,20
401405859,Green Bay Phoenix,N. Jenkins,4592209,,True,19.0,1,3,1,2,0,1,2,4,0,0,0,0,0,0,2,3,4
401405859,Green Bay Phoenix,R. Claflin,4702926,,False,19.0,3,4,2,2,1,2,0,0,0,1,1,0,1,0,0,0,7
401405859,Green Bay Phoenix,C. Kirciman,4702925,,False,16.0,2,4,2,3,0,1,4,4,3,1,4,1,1,0,2,1,8
401405859,Green Bay Phoenix,R. Tucker,4897725,,False,21.0,3,8,1,1,2,7,0,0,1,2,3,0,0,0,0,2,8
401405859,Green Bay Phoenix,L. Stieber,4592889,,False,24.0,0,2,0,0,0,2,0,0,1,3,4,4,0,2,1,1,0
401405859,Green Bay Phoenix,M. Listau,4398299,,False,7.0,0,1,0,0,0,1,0,0,0,1,1,1,0,0,0,0,0
401405859,Green Bay Phoenix,TEAM,TOTAL,TOTAL,False,,23,51,18,32,5,19,11,15,7,21,28,9,3,3,14,13,62
401405859,Detroit Mercy Titans,N. Waterman,4593355,,True,27.0,2,5,1,2,1,3,2,2,1,0,1,0,0,1,0,2,7
401405859,Detroit Mercy Titans,W. Isiani,4397740,,True,5.0,0,1,0,1,0,0,2,2,0,1,1,0,0,0,1,1,2
401405859,Detroit Mercy Titans,M. Johnson,4592487,,True,25.0,1,4,1,4,0,0,0,0,0,3,3,3,0,0,2,2,2
401405859,Detroit Mercy Titans,A. Davis,4397732,,True,33.0,15,24,9,14,6,10,2,2,0,5,5,2,1,0,2,1,38
401405859,Detroit Mercy Titans,D.J. Harvey,4278010,,True,32.0,4,9,4,6,0,3,2,2,1,6,7,1,3,1,0,3,10
401405859,Detroit Mercy Titans,M. Akec,4396647,,False,16.0,0,0,0,0,0,0,0,0,3,3,6,1,0,0,0,1,0
401405859,Detroit Mercy Titans,M. Sylla,4897722,,False,3.0,1,1,1,1,0,0,0,0,0,0,0,0,0,0,1,2,2
401405859,Detroit Mercy Titans,B. Koka,4278375,,False,8.0,2,3,2,3,0,0,0,0,0,1,1,0,0,0,0,0,4
401405859,Detroit Mercy Titans,K. LeGreair,4567749,,False,23.0,0,0,0,0,0,0,0,0,0,1,1,2,0,0,0,2,0
401405859,Detroit Mercy Titans,K. McAdoo,4279331,,False,28.0,6,10,4,7,2,3,0,0,0,3,3,2,3,0,2,1,14
401405859,Detroit Mercy Titans,TEAM,TOTAL,TOTAL,False,,31,57,22,38,9,19,8,8,5,23,28,11,7,2,10,15,79
401405858,Youngstown State Penguins,W. Dunn,4702992,,True,17.0,2,6,2,2,0,4,1,2,1,3,4,0,0,1,1,4,5
401405858,Youngstown State Penguins,M. Akuchie,4279695,,True,33.0,3,11,3,8,0,3,2,2,3,2,5,2,0,1,3,3,8
401405858,Youngstown State Penguins,T. Olison,4898195,,True,34.0,6,14,4,8,2,6,3,3,5,4,9,2,3,0,3,3,17
401405858,Youngstown State Penguins,S. Rathan-Mayes,4702990,,True,30.0,2,5,1,1,1,4,2,2,0,1,1,2,1,0,1,4,7
401405858,Youngstown State Penguins,D. Cohill,4396791,,True,30.0,9,18,6,14,3,4,4,5,2,4,6,1,3,1,0,4,25
401405858,Youngstown State Penguins,J. Thomas,4593431,,False,8.0,0,3,0,3,0,0,1,2,1,2,3,0,0,0,0,1,1
401405858,Youngstown State Penguins,L. Chicone,4898197,,False,8.0,0,1,0,1,0,0,0,0,0,2,2,3,0,0,0,0,0
401405858,Youngstown State Penguins,M. Hunter,4702989,,False,22.0,2,6,2,5,0,1,0,1,1,1,2,0,1,0,0,1,4
401405858,Youngstown State Penguins,O. Long,4606875,,False,9.0,1,3,0,0,1,3,0,1,1,0,1,0,0,0,1,2,3
401405858,Youngstown State Penguins,D. Ogoro,4593433,,False,3.0,0,1,0,0,0,1,0,0,0,0,0,0,0,0,0,0,0
401405858,Youngstown State Penguins,C. Shelton,4592667,,False,6.0,1,2,0,0,1,2,0,0,1,0,1,0,0,0,0,0,3
401405858,Youngstown State Penguins,TEAM,TOTAL,TOTAL,False,,26,70,18,42,8,28,13,18,17,20,37,10,8,3,9,22,73
401405858,Robert Morris Colonials,M. Mayers,4898180,,True,22.0,5,7,5,7,0,0,0,0,2,2,4,1,0,2,1,2,10
401405858,Robert Morris Colonials,J. Williams,4703403,,True,26.0,3,7,2,4,1,3,0,0,0,1,1,0,0,0,1,3,7
401405858,Robert Morris Colonials,K. Spear,4702997,,True,39.0,7,8,6,7,1,1,4,8,1,12,13,2,3,2,5,3,19
401405858,Robert Morris Colonials,E. Cheeks,4703000,,True,28.0,3,8,3,6,0,2,6,8,0,6,6,5,1,1,2,4,12
401405858,Robert Morris Colonials,M. Green III,4593261,,True,35.0,3,7,3,5,0,2,4,5,2,2,4,4,0,0,2,1,10
401405858,Robert Morris Colonials,B. Stone,4432906,,False,20.0,2,5,2,5,0,0,0,0,1,5,6,0,1,2,1,3,4
401405858,Robert Morris Colonials,C. Cook,4702998,,False,5.0,1,1,0,0,1,1,0,0,0,0,0,0,0,0,1,1,3
401405858,Robert Morris Colonials,K. Farris,4702996,,False,25.0,4,9,3,5,1,4,3,4,0,0,0,0,1,0,1,1,12
401405858,Robert Morris Colonials,TEAM,TOTAL,TOTAL,False,,28,52,24,39,4,13,17,25,8,28,36,12,6,7,14,18,77
401405856,Winthrop Eagles,C. Claxton,4431928,,True,28.0,2,2,2,2,0,0,0,0,0,1,1,1,0,0,0,3,4
401405856,Winthrop Eagles,C. Hightower,4397655,,True,24.0,1,6,1,2,0,4,0,0,1,3,4,1,0,0,3,0,2
401405856,Winthrop Eagles,D.J. Burns Jr.,4396933,,True,26.0,6,10,6,10,0,0,2,3,5,0,5,2,0,0,5,4,14
401405856,Winthrop Eagles,M. Anumba,4397840,,True,35.0,3,7,1,2,2,5,4,4,2,4,6,0,1,1,3,2,12
401405856,Winthrop Eagles,D. Buggs,4066911,,True,25.0,3,8,3,7,0,1,2,2,0,5,5,2,1,0,4,0,8
401405856,Winthrop Eagles,K. Talford,4576140,,False,14.0,2,2,2,2,0,0,0,0,0,1,1,0,0,0,0,1,4
401405856,Winthrop Eagles,S. McMahon,4703879,,False,9.0,0,1,0,0,0,1,0,0,0,1,1,0,0,0,1,0,0
401405856,Winthrop Eagles,R. Jones Jr.,4592771,,False,11.0,1,3,0,2,1,1,0,0,0,1,1,3,1,0,1,2,3
401405856,Winthrop Eagles,P. Good,4067769,,False,28.0,3,12,0,0,3,12,2,2,0,0,0,0,5,0,0,4,11
401405856,Winthrop Eagles,TEAM,TOTAL,TOTAL,False,,21,51,15,27,6,24,10,11,9,17,26,9,8,1,19,16,58
401405856,Longwood Lancers,J. Granlund,4702126,,True,19.0,2,5,1,3,1,2,0,0,1,0,1,1,0,0,1,1,5
401405856,Longwood Lancers,Z. Watson,4397617,,True,22.0,2,4,2,4,0,0,2,2,1,0,1,0,1,0,0,4,6
401405856,Longwood Lancers,J. Hill,4702127,,True,32.0,3,8,2,6,1,2,2,2,0,8,8,5,2,0,6,0,9
401405856,Longwood Lancers,D. Wade,4396618,,True,31.0,2,6,1,4,1,2,2,2,2,1,3,1,1,0,0,3,7
401405856,Longwood Lancers,I. Wilkins,4395681,,True,30.0,7,11,4,5,3,6,2,2,0,8,8,3,3,0,1,1,19
401405856,Longwood Lancers,L. Nkereuwem,4432064,,False,18.0,3,5,3,5,0,0,5,8,4,2,6,0,1,0,2,2,11
401405856,Longwood Lancers,D. Houston,4585602,,False,17.0,2,2,1,1,1,1,0,1,1,0,1,0,1,0,0,2,5
401405856,Longwood Lancers,N. Lliteras,4432036,,False,10.0,3,6,0,2,3,4,0,0,0,0,0,0,0,0,0,0,9
401405856,Longwood Lancers,J. Perkins,4284169,,False,21.0,4,6,4,6,0,0,0,0,0,2,2,3,1,0,0,1,8
401405856,Longwood Lancers,TEAM,TOTAL,TOTAL,False,,28,53,18,36,10,17,13,17,9,22,31,13,10,0,12,14,79
401405855,Winthrop Eagles,C. Claxton,4431928,,True,33.0,2,2,2,2,0,0,3,4,2,5,7,1,0,3,0,2,7
401405855,Winthrop Eagles,C. Hightower,4397655,,True,32.0,5,11,2,5,3,6,7,8,0,5,5,1,1,2,2,2,20
401405855,Winthrop Eagles,D.J. Burns Jr.,4396933,,True,18.0,5,11,5,11,0,0,4,5,1,1,2,1,0,0,3,3,14
401405855,Winthrop Eagles,M. Anumba,4397840,,True,28.0,2,3,1,2,1,1,2,2,1,3,4,0,0,1,1,5,7
401405855,Winthrop Eagles,D. Buggs,4066911,,True,32.0,3,9,2,6,1,3,2,2,0,1,1,4,1,0,1,0,9
401405855,Winthrop Eagles,K. Talford,4576140,,False,18.0,0,2,0,2,0,0,9,10,4,8,12,0,0,0,2,2,9
401405855,Winthrop Eagles,S. McMahon,4703879,,False,10.0,0,1,0,0,0,1,0,1,0,0,0,1,0,0,0,3,0
401405855,Winthrop Eagles,R. Jones Jr.,4592771,,False,6.0,0,1,0,0,0,1,0,0,0,0,0,0,0,0,0,3,0
401405855,Winthrop Eagles,P. Good,4067769,,False,23.0,3,6,1,2,2,4,2,2,0,5,5,1,1,0,2,1,10
401405855,Winthrop Eagles,TEAM,TOTAL,TOTAL,False,,20,46,13,30,7,16,29,34,8,28,36,9,3,6,11,21,76
401405855,Gardner-Webb Runnin' Bulldogs,K. Reid,4592662,,True,7.0,0,5,0,5,0,0,0,0,2,2,4,0,0,1,1,4,0
401405855,Gardner-Webb Runnin' Bulldogs,L. Dufeal,4397530,,True,27.0,2,3,2,2,0,1,3,4,2,5,7,2,1,1,0,3,7
401405855,Gardner-Webb Runnin' Bulldogs,Z. Williams,4593965,,True,33.0,4,8,2,5,2,3,1,2,1,1,2,0,1,0,2,4,11
401405855,Gardner-Webb Runnin' Bulldogs,D. Williams,4702065,,True,38.0,7,12,4,6,3,6,5,6,0,1,1,1,1,1,2,4,22
401405855,Gardner-Webb Runnin' Bulldogs,L. Terry,4432121,,True,34.0,4,13,3,8,1,5,2,2,2,3,5,0,0,0,3,3,11
401405855,Gardner-Webb Runnin' Bulldogs,A. Badmus,4897628,,False,12.0,0,2,0,2,0,0,0,0,1,1,2,0,1,0,0,4,0
401405855,Gardner-Webb Runnin' Bulldogs,C. Alexander,4702060,,False,5.0,0,1,0,1,0,0,0,0,0,2,2,0,0,0,0,1,0
401405855,Gardner-Webb Runnin' Bulldogs,L. Williams,4897629,,False,8.0,0,0,0,0,0,0,0,0,0,2,2,0,0,0,1,1,0
401405855,Gardner-Webb Runnin' Bulldogs,J. Soumaoro,4897626,,False,5.0,0,0,0,0,0,0,0,0,0,0,0,0,0,0,0,0,0
401405855,Gardner-Webb Runnin' Bulldogs,J. Sears,4702063,,False,31.0,5,11,5,11,0,0,6,7,0,3,3,0,2,0,1,3,16
401405855,Gardner-Webb Runnin' Bulldogs,TEAM,TOTAL,TOTAL,False,,22,55,16,40,6,15,17,21,8,21,29,3,6,3,11,27,67
401405854,South Carolina Upstate Spartans,J. Aldrich,4397838,,True,27.0,3,6,3,6,0,0,2,2,1,7,8,0,0,2,1,4,8
401405854,South Carolina Upstate Spartans,B. Mozone,4397835,,True,38.0,9,14,3,3,6,11,0,0,1,5,6,0,0,0,1,3,24
401405854,South Carolina Upstate Spartans,J. Gainey,4897649,,True,36.0,3,16,1,5,2,11,5,7,0,1,1,2,2,3,1,4,13
401405854,South Carolina Upstate Spartans,M. Goodloe,4592766,,True,36.0,6,9,5,6,1,3,2,2,2,2,4,6,3,1,3,3,15
401405854,South Carolina Upstate Spartans,D. White,4397832,,True,30.0,3,9,3,5,0,4,0,0,0,1,1,4,0,0,1,2,6
401405854,South Carolina Upstate Spartans,K. Smith,4433079,,False,15.0,0,1,0,1,0,0,0,0,0,3,3,1,0,0,0,2,0
401405854,South Carolina Upstate Spartans,J. Breazeale,4897648,,False,10.0,0,1,0,1,0,0,0,0,0,0,0,2,0,0,0,1,0
401405854,South Carolina Upstate Spartans,F. Rideau Jr.,4704083,,False,8.0,2,3,2,2,0,1,0,0,0,1,1,0,0,1,0,2,4
401405854,South Carolina Upstate Spartans,TEAM,TOTAL,TOTAL,False,,26,59,17,29,9,30,9,11,4,20,24,15,5,7,7,21,70
401405854,Longwood Lancers,J. Granlund,4702126,,True,20.0,2,4,1,2,1,2,1,2,0,0,0,0,0,1,1,1,6
401405854,Longwood Lancers,Z. Watson,4397617,,True,22.0,3,7,3,7,0,0,4,4,3,4,7,1,0,0,1,3,10
401405854,Longwood Lancers,J. Hill,4702127,,True,31.0,4,10,2,8,2,2,8,10,2,6,8,9,0,0,4,1,18
401405854,Longwood Lancers,D. Wade,4396618,,True,30.0,5,8,2,3,3,5,5,6,1,1,2,1,1,0,1,2,18
401405854,Longwood Lancers,I. Wilkins,4395681,,True,31.0,5,12,2,4,3,8,0,0,1,6,7,2,0,1,2,1,13
401405854,Longwood Lancers,L. Nkereuwem,4432064,,False,18.0,1,4,1,4,0,0,0,2,3,6,9,0,2,0,1,2,2
401405854,Longwood Lancers,J. Darden,4897636,,False,3.0,0,0,0,0,0,0,0,0,0,1,1,0,0,0,0,0,0
401405854,Longwood Lancers,D. Houston,4585602,,False,21.0,2,5,2,3,0,2,3,4,1,1,2,2,0,0,2,3,7
401405854,Longwood Lancers,N. Lliteras,4432036,,False,9.0,1,1,0,0,1,1,0,0,0,0,0,0,0,0,0,0,3
401405854,Longwood Lancers,J. Perkins,4284169,,False,15.0,1,2,1,2,0,0,0,0,0,3,3,1,0,0,0,0,2
401405854,Longwood Lancers,TEAM,TOTAL,TOTAL,False,,24,53,14,33,10,20,21,28,14,29,43,16,3,2,12,13,79
401405853,Gardner-Webb Runnin' Bulldogs,K. Reid,4592662,,True,22.0,4,5,4,5,0,0,0,0,3,5,8,1,1,2,3,0,8
401405853,Gardner-Webb Runnin' Bulldogs,L. Dufeal,4397530,,True,27.0,2,4,2,3,0,1,0,4,5,5,10,1,2,0,1,4,4
401405853,Gardner-Webb Runnin' Bulldogs,Z. Williams,4593965,,True,21.0,3,4,3,4,0,0,1,2,2,2,4,0,0,0,5,3,7
401405853,Gardner-Webb Runnin' Bulldogs,D. Williams,4702065,,True,37.0,4,15,1,9,3,6,0,0,0,1,1,1,0,0,1,2,11
401405853,Gardner-Webb Runnin' Bulldogs,L. Terry,4432121,,True,36.0,6,14,4,7,2,7,0,0,1,4,5,1,0,0,2,4,14
401405853,Gardner-Webb Runnin' Bulldogs,C. Alexander,4702060,,False,1.0,0,0,0,0,0,0,0,0,0,1,1,1,0,0,0,0,0
401405853,Gardner-Webb Runnin' Bulldogs,J. Soumaoro,4897626,,False,6.0,0,1,0,0,0,1,0,0,0,1,1,0,1,0,0,1,0
401405853,Gardner-Webb Runnin' Bulldogs,J. Sears,4702063,,False,33.0,3,11,2,8,1,3,0,0,0,6,6,3,1,0,4,3,7
401405853,Gardner-Webb Runnin' Bulldogs,A. Selden,4592663,,False,17.0,1,4,0,2,1,2,0,0,1,2,3,1,0,0,1,2,3
401405853,Gardner-Webb Runnin' Bulldogs,TEAM,TOTAL,TOTAL,False,,23,58,16,38,7,20,1,6,14,30,44,9,5,2,17,19,54
401405853,Campbell Fighting Camels,J. Carralero,4592654,,True,28.0,2,7,1,4,1,3,0,0,3,5,8,1,0,1,2,1,5
401405853,Campbell Fighting Camels,C. Henderson Jr.,4592657,,True,33.0,4,12,3,8,1,4,2,2,1,3,4,1,2,0,1,4,11
401405853,Campbell Fighting Camels,R. Clemons,4397332,,True,38.0,0,4,0,2,0,2,4,4,1,1,2,0,0,1,1,3,4
401405853,Campbell Fighting Camels,J. Whitfield,4278681,,True,34.0,7,14,6,8,1,6,5,8,0,3,3,0,1,0,3,1,20
401405853,Campbell Fighting Camels,A. McCullough,4278142,,True,26.0,1,4,1,2,0,2,0,0,0,3,3,0,2,0,1,2,2
401405853,Campbell Fighting Camels,J. Lusane,4592655,,False,3.0,0,0,0,0,0,0,0,0,0,1,1,1,0,0,0,0,0
401405853,Campbell Fighting Camels,M. Stajcic,4397334,,False,18.0,1,2,0,1,1,1,2,2,0,4,4,0,2,0,3,0,5
401405853,Campbell Fighting Camels,M. Thompson,4432127,,False,20.0,1,7,1,3,0,4,4,4,0,3,3,1,3,0,0,3,6
401405853,Campbell Fighting Camels,TEAM,TOTAL,TOTAL,False,,16,50,12,28,4,22,17,20,5,24,29,4,10,2,12,14,53
401405852,Winthrop Eagles,C. Claxton,4431928,,True,28.0,1,2,1,2,0,0,0,0,1,4,5,1,1,1,0,1,2
401405852,Winthrop Eagles,C. Hightower,4397655,,True,32.0,7,13,4,4,3,9,4,4,0,6,6,0,0,1,2,0,21
401405852,Winthrop Eagles,D.J. Burns Jr.,4396933,,True,20.0,5,9,5,9,0,0,0,1,1,3,4,0,0,0,2,2,10
401405852,Winthrop Eagles,M. Anumba,4397840,,True,22.0,3,4,2,3,1,1,4,8,1,3,4,2,1,1,2,5,11
401405852,Winthrop Eagles,D. Buggs,4066911,,True,25.0,4,9,4,7,0,2,0,0,2,4,6,5,1,0,2,0,8
401405852,Winthrop Eagles,K. Talford,4576140,,False,20.0,2,3,2,3,0,0,1,4,3,4,7,0,0,0,2,1,5
401405852,Winthrop Eagles,S. McMahon,4703879,,False,20.0,2,5,1,2,1,3,0,0,0,1,1,3,1,0,1,3,5
401405852,Winthrop Eagles,N. Buss,4702225,,False,0.0,0,0,0,0,0,0,0,0,0,0,0,0,0,0,0,0,0
401405852,Winthrop Eagles,R. Jones Jr.,4592771,,False,11.0,1,2,0,0,1,2,0,0,0,0,0,0,0,0,0,0,3
401405852,Winthrop Eagles,P. Good,4067769,,False,22.0,1,5,0,0,1,5,0,0,0,4,4,3,1,0,0,0,3
401405852,Winthrop Eagles,TEAM,TOTAL,TOTAL,False,,26,52,19,30,7,22,9,17,8,29,37,14,5,3,13,12,68
401405852,High Point Panthers,E. Izunabor,4431998,,True,16.0,0,3,0,3,0,0,0,0,1,1,2,0,0,0,2,5,0
401405852,High Point Panthers,Z. Austin,4702099,,True,37.0,0,10,0,2,0,8,0,0,3,5,8,1,0,0,2,3,0
401405852,High Point Panthers,R. Peterson III,4397627,,True,24.0,1,1,1,1,0,0,0,0,1,1,2,1,1,0,1,3,2
401405852,High Point Panthers,B. Randleman,4592743,,True,30.0,2,3,1,2,1,1,1,2,0,3,3,1,3,0,2,3,6
401405852,High Point Panthers,Jo. Wright,4592741,,True,37.0,8,17,5,11,3,6,2,4,3,5,8,2,0,0,2,0,21
401405852,High Point Panthers,C. Wright,4706629,,False,0.0,0,0,0,0,0,0,0,0,0,0,0,0,0,0,0,0,0
401405852,High Point Panthers,A. Holt,4702103,,False,16.0,1,5,1,5,0,0,0,2,3,2,5,0,0,1,0,0,2
401405852,High Point Panthers,B. Williams,4897634,,False,4.0,0,3,0,2,0,1,0,0,1,0,1,0,0,0,0,0,0
401405852,High Point Panthers,A. Hoynack,4706630,,False,0.0,0,0,0,0,0,0,0,0,0,0,0,0,0,0,0,0,0
401405852,High Point Panthers,J. House,4702104,,False,31.0,7,18,5,11,2,7,4,6,0,3,3,1,0,0,2,4,20
401405852,High Point Panthers,B. Childress,4702100,,False,5.0,0,0,0,0,0,0,0,0,0,0,0,0,0,0,0,0,0
401405852,High Point Panthers,J. Hughes,4397628,,False,0.0,0,0,0,0,0,0,0,0,0,0,0,0,0,0,0,0,0
401405852,High Point Panthers,TEAM,TOTAL,TOTAL,False,,19,60,13,37,6,23,7,14,14,21,35,6,4,1,12,18,51
401405851,South Carolina Upstate Spartans,J. Aldrich,4397838,,True,26.0,4,6,3,5,1,1,4,6,2,4,6,1,1,2,1,3,13
401405851,South Carolina Upstate Spartans,B. Mozone,4397835,,True,34.0,5,13,4,8,1,5,1,1,1,7,8,3,0,0,2,1,12
401405851,South Carolina Upstate Spartans,J. Gainey,4897649,,True,34.0,7,10,4,7,3,3,3,3,0,2,2,1,2,0,1,1,20
401405851,South Carolina Upstate Spartans,M. Goodloe,4592766,,True,25.0,4,8,4,6,0,2,0,0,0,6,6,1,3,1,1,4,8
401405851,South Carolina Upstate Spartans,D. White,4397832,,True,24.0,1,6,1,3,0,3,0,0,0,1,1,4,2,0,0,2,2
401405851,South Carolina Upstate Spartans,D. Dickerson III,4702221,,False,0.0,0,0,0,0,0,0,0,0,0,0,0,0,0,0,0,0,0
401405851,South Carolina Upstate Spartans,K. Smith,4433079,,False,16.0,4,8,4,8,0,0,0,0,1,3,4,1,2,2,0,1,8
401405851,South Carolina Upstate Spartans,J. Breazeale,4897648,,False,20.0,2,4,2,4,0,0,3,3,1,0,1,5,0,0,2,3,7
401405851,South Carolina Upstate Spartans,F. Rideau Jr.,4704083,,False,18.0,1,6,1,4,0,2,0,0,0,1,1,0,1,0,1,5,2
401405851,South Carolina Upstate Spartans,T. Sheida,4592768,,False,0.0,0,0,0,0,0,0,0,0,0,0,0,0,0,0,0,0,0
401405851,South Carolina Upstate Spartans,TEAM,TOTAL,TOTAL,False,,28,61,23,45,5,16,11,13,5,27,32,16,11,5,9,20,72
401405851,Charleston Southern Buccaneers,T. Kelly,4896986,,True,22.0,3,7,3,7,0,0,1,4,3,4,7,1,0,0,2,3,7
401405851,Charleston Southern Buccaneers,C. Faye,4703236,,True,31.0,3,5,0,1,3,4,2,2,2,6,8,0,0,0,0,4,11
401405851,Charleston Southern Buccaneers,C. Harris Jr.,4896985,,True,36.0,4,13,2,8,2,5,5,6,1,1,2,3,1,0,4,1,15
401405851,Charleston Southern Buccaneers,T. Chavez,4703010,,True,33.0,3,11,0,2,3,9,1,2,2,5,7,1,1,0,3,2,10
401405851,Charleston Southern Buccaneers,D. Buskey,4278684,,True,37.0,5,19,4,11,1,8,3,7,4,5,9,2,0,0,8,4,14
401405851,Charleston Southern Buccaneers,S. Bowser,4397413,,False,18.0,1,2,1,2,0,0,0,0,1,4,5,0,0,1,0,0,2
401405851,Charleston Southern Buccaneers,J. Moore,4397409,,False,9.0,0,0,0,0,0,0,1,3,1,1,2,0,0,0,0,0,1
401405851,Charleston Southern Buccaneers,S. Price,4278689,,False,14.0,1,3,1,3,0,0,0,0,1,1,2,0,1,1,1,1,2
401405851,Charleston Southern Buccaneers,TEAM,TOTAL,TOTAL,False,,20,60,11,34,9,26,13,24,18,29,47,7,3,2,18,15,62
401405850,North Carolina A&T Aggies,J. Whatley,4278249,,True,13.0,0,2,0,1,0,1,0,0,0,1,1,0,0,1,1,4,0
401405850,North Carolina A&T Aggies,M. Watson,4897640,,True,36.0,10,17,8,10,2,7,5,6,2,10,12,0,0,2,5,4,27
401405850,North Carolina A&T Aggies,D. Horton,4702944,,True,34.0,5,12,3,6,2,6,0,0,1,2,3,2,1,2,3,4,12
401405850,North Carolina A&T Aggies,K. Langley,4279819,,True,35.0,3,6,3,5,0,1,0,3,1,2,3,6,4,1,3,5,6
401405850,North Carolina A&T Aggies,T. Maye,4278423,,True,31.0,0,2,0,2,0,0,0,0,0,0,0,0,1,1,1,2,0
401405850,North Carolina A&T Aggies,J. Robinson,4704088,,False,30.0,4,9,1,4,3,5,1,2,4,3,7,1,0,2,0,1,12
401405850,North Carolina A&T Aggies,W. Filmore,4398217,,False,19.0,0,0,0,0,0,0,0,0,0,3,3,0,0,0,2,3,0
401405850,North Carolina A&T Aggies,K. Duke,4897639,,False,1.0,0,0,0,0,0,0,0,0,0,0,0,0,0,0,0,0,0
401405850,North Carolina A&T Aggies,D. Beatty,4278107,,False,26.0,4,10,4,8,0,2,0,0,0,4,4,5,0,2,1,3,8
401405850,North Carolina A&T Aggies,TEAM,TOTAL,TOTAL,False,,26,58,19,36,7,22,6,11,8,25,33,14,6,11,16,26,65
401405850,Longwood Lancers,J. Granlund,4702126,,True,17.0,2,4,2,3,0,1,0,0,1,0,1,0,1,0,0,1,4
401405850,Longwood Lancers,Z. Watson,4397617,,True,26.0,4,5,4,5,0,0,4,8,3,4,7,0,1,1,1,2,12
401405850,Longwood Lancers,J. Hill,4702127,,True,41.0,6,17,6,13,0,4,12,14,1,6,7,5,1,0,2,4,24
401405850,Longwood Lancers,D. Wade,4396618,,True,37.0,6,12,2,7,4,5,1,2,3,2,5,1,3,0,0,1,17
401405850,Longwood Lancers,I. Wilkins,4395681,,True,36.0,3,9,2,5,1,4,8,8,1,11,12,1,1,0,3,2,15
401405850,Longwood Lancers,L. Nkereuwem,4432064,,False,18.0,3,7,3,7,0,0,1,1,2,2,4,0,0,0,1,1,7
401405850,Longwood Lancers,M. Christmas,4431827,,False,1.0,0,0,0,0,0,0,0,0,0,0,0,0,0,0,0,0,0
401405850,Longwood Lancers,D. Houston,4585602,,False,24.0,0,3,0,2,0,1,0,0,1,2,3,1,0,0,0,3,0
401405850,Longwood Lancers,N. Lliteras,4432036,,False,6.0,0,1,0,0,0,1,0,0,0,1,1,0,0,1,0,1,0
401405850,Longwood Lancers,J. Perkins,4284169,,False,19.0,0,5,0,3,0,2,0,0,0,0,0,2,1,0,1,2,0
401405850,Longwood Lancers,TEAM,TOTAL,TOTAL,False,,24,63,19,45,5,18,26,33,15,28,43,10,8,2,10,17,79
401405849,Presbyterian Blue Hose,T. Ard Jr.,4703134,,True,35.0,1,6,1,6,0,0,2,4,3,5,8,2,0,1,1,5,4
401405849,Presbyterian Blue Hose,W. Hill,4702197,,True,41.0,6,13,5,8,1,5,7,12,4,5,9,1,1,0,1,5,20
401405849,Presbyterian Blue Hose,M. Barnett,4897641,,True,36.0,7,12,4,5,3,7,0,0,0,0,0,2,0,1,1,4,17
401405849,Presbyterian Blue Hose,R. Harrison,4702195,,True,34.0,7,17,3,8,4,9,0,0,1,3,4,2,2,0,3,2,18
401405849,Presbyterian Blue Hose,T. Reddish,4597991,,True,44.0,5,8,5,8,0,0,2,5,3,4,7,3,2,0,5,5,12
401405849,Presbyterian Blue Hose,O. McCormack,4592758,,False,9.0,0,3,0,1,0,2,0,0,0,0,0,0,0,0,0,0,0
401405849,Presbyterian Blue Hose,A. Le Gregam,4702200,,False,26.0,0,4,0,1,0,3,1,2,0,3,3,0,0,0,1,1,1
401405849,Presbyterian Blue Hose,K. Stewart,4702196,,False,10.0,0,1,0,0,0,1,0,0,1,1,2,0,0,1,0,1,0
401405849,Presbyterian Blue Hose,Z. Graham,4592756,,False,6.0,0,1,0,1,0,0,0,0,1,1,2,2,0,0,0,0,0
401405849,Presbyterian Blue Hose,B. Younger,4397472,,False,9.0,0,2,0,2,0,0,0,0,1,2,3,0,0,0,0,1,0
401405849,Presbyterian Blue Hose,TEAM,TOTAL,TOTAL,False,,26,67,18,40,8,27,12,23,18,26,44,12,5,3,13,24,72
401405849,Campbell Fighting Camels,J. Carralero,4592654,,True,36.0,3,8,3,7,0,1,8,13,3,10,13,8,1,3,5,5,14
401405849,Campbell Fighting Camels,C. Henderson Jr.,4592657,,True,47.0,5,12,3,7,2,5,3,5,0,5,5,0,2,0,4,4,15
401405849,Campbell Fighting Camels,R. Clemons,4397332,,True,44.0,1,2,1,2,0,0,3,4,0,4,4,1,0,1,1,4,5
401405849,Campbell Fighting Camels,J. Whitfield,4278681,,True,44.0,7,15,5,8,2,7,0,0,0,3,3,1,0,0,1,2,16
401405849,Campbell Fighting Camels,A. McCullough,4278142,,True,39.0,3,8,2,3,1,5,3,5,1,4,5,0,0,0,1,1,10
401405849,Campbell Fighting Camels,J. Lusane,4592655,,False,0.0,0,0,0,0,0,0,0,0,0,0,0,0,0,0,0,0,0
401405849,Campbell Fighting Camels,M. Stajcic,4397334,,False,16.0,3,5,1,2,2,3,3,3,0,2,2,1,1,1,0,3,11
401405849,Campbell Fighting Camels,M. Thompson,4432127,,False,24.0,2,4,2,3,0,1,0,0,0,1,1,3,0,0,1,1,4
401405849,Campbell Fighting Camels,TEAM,TOTAL,TOTAL,False,,24,54,17,32,7,22,20,30,7,29,36,14,4,5,14,20,75
401405848,High Point Panthers,E. Izunabor,4431998,,True,16.0,1,4,1,4,0,0,1,2,2,3,5,0,0,1,1,2,3
401405848,High Point Panthers,Z. Austin,4702099,,True,40.0,8,21,4,8,4,13,4,6,5,11,16,2,1,2,0,1,24
401405848,High Point Panthers,R. Peterson III,4397627,,True,19.0,0,3,0,3,0,0,0,1,2,0,2,1,0,0,0,4,0
401405848,High Point Panthers,B. Randleman,4592743,,True,41.0,2,9,2,8,0,1,6,11,1,5,6,1,0,0,1,4,10
401405848,High Point Panthers,Jo. Wright,4592741,,True,41.0,4,12,3,8,1,4,4,7,0,4,4,3,1,0,6,3,13
401405848,High Point Panthers,A. Holt,4702103,,False,28.0,5,10,5,10,0,0,3,6,4,5,9,0,0,0,0,3,13
401405848,High Point Panthers,B. Williams,4897634,,False,4.0,1,2,1,1,0,1,0,0,0,0,0,0,1,0,0,1,2
401405848,High Point Panthers,J. House,4702104,,False,33.0,6,9,3,6,3,3,4,6,2,2,4,0,0,0,2,4,19
401405848,High Point Panthers,B. Childress,4702100,,False,3.0,0,1,0,0,0,1,0,0,0,0,0,0,0,0,0,1,0
401405848,High Point Panthers,TEAM,TOTAL,TOTAL,False,,27,71,19,48,8,23,22,39,19,30,49,7,3,3,10,23,84
401405848,Hampton Pirates,D. Dickens,4278576,,True,6.0,2,3,2,3,0,0,0,0,1,3,4,0,0,2,1,5,4
401405848,Hampton Pirates,N. Garvin,4066966,,True,45.0,5,11,5,9,0,2,5,8,0,13,13,1,1,2,2,5,15
401405848,Hampton Pirates,M. Haskett Jr,4897632,,True,30.0,2,3,2,2,0,1,2,3,1,1,2,1,0,0,2,5,6
401405848,Hampton Pirates,R. Dean,4592665,,True,38.0,5,17,5,14,0,3,18,25,1,7,8,5,1,2,7,5,28
401405848,Hampton Pirates,M. Godwin,4279093,,True,37.0,3,8,1,3,2,5,2,2,0,4,4,0,1,0,1,3,10
401405848,Hampton Pirates,L. Therrien,4897631,,False,29.0,2,2,2,2,0,0,0,0,0,2,2,0,0,0,0,3,4
401405848,Hampton Pirates,A. Nesbitt,4703820,,False,12.0,0,4,0,2,0,2,2,2,0,1,1,0,0,0,0,3,2
401405848,Hampton Pirates,R. Bethea Jr.,4398163,,False,24.0,4,8,4,7,0,1,0,0,3,2,5,1,0,1,1,2,8
401405848,Hampton Pirates,J. Wiley,4283602,,False,4.0,0,1,0,0,0,1,0,0,1,0,1,0,0,0,0,0,0
401405848,Hampton Pirates,TEAM,TOTAL,TOTAL,False,,23,57,21,42,2,15,29,40,8,35,43,8,3,7,14,31,77
401405847,UNC Asheville Bulldogs,D. Pember,4431793,,True,15.0,6,8,2,2,4,6,0,0,1,2,3,0,0,1,2,5,16
401405847,UNC Asheville Bulldogs,C. Jude,4397803,,True,17.0,2,6,1,1,1,5,0,0,0,1,1,1,0,1,0,0,5
401405847,UNC Asheville Bulldogs,LJ Thorpe,4279050,,True,27.0,5,11,4,9,1,2,7,9,1,2,3,5,1,1,3,3,18
401405847,UNC Asheville Bulldogs,T. Stephney,4592753,,True,34.0,1,3,0,2,1,1,2,2,1,2,3,4,2,0,0,3,5
401405847,UNC Asheville Bulldogs,T. Jones,4279052,,True,30.0,4,10,2,4,2,6,1,3,4,4,8,2,1,0,2,1,11
401405847,UNC Asheville Bulldogs,S. Mason,4702142,,False,24.0,2,6,2,6,0,0,6,9,2,0,2,0,0,2,0,1,10
401405847,UNC Asheville Bulldogs,BJ Marable,4702141,,False,14.0,1,2,1,2,0,0,0,0,0,3,3,0,0,0,1,2,2
401405847,UNC Asheville Bulldogs,J. Battle,4592754,,False,30.0,3,7,3,7,0,0,2,5,1,2,3,3,1,0,0,3,8
401405847,UNC Asheville Bulldogs,Q. Kimble,4283783,,False,9.0,1,1,0,0,1,1,0,0,0,2,2,1,2,0,1,1,3
401405847,UNC Asheville Bulldogs,TEAM,TOTAL,TOTAL,False,,25,54,15,33,10,21,18,28,11,20,31,16,7,5,9,19,78
401405847,Charleston Southern Buccaneers,T. Kelly,4896986,,True,28.0,11,14,11,14,0,0,2,4,4,3,7,0,0,1,2,2,24
401405847,Charleston Southern Buccaneers,C. Faye,4703236,,True,27.0,2,5,0,1,2,4,0,0,1,4,5,2,1,0,0,5,6
401405847,Charleston Southern Buccaneers,C. Harris Jr.,4896985,,True,40.0,3,7,2,5,1,2,3,4,0,5,5,3,2,0,2,4,10
401405847,Charleston Southern Buccaneers,T. Chavez,4703010,,True,31.0,4,7,2,2,2,5,3,4,1,3,4,1,1,0,0,2,13
401405847,Charleston Southern Buccaneers,D. Buskey,4278684,,True,37.0,7,16,5,8,2,8,2,3,0,7,7,6,1,0,4,4,18
401405847,Charleston Southern Buccaneers,S. Bowser,4397413,,False,12.0,2,3,2,3,0,0,2,2,0,0,0,0,0,0,0,1,6
401405847,Charleston Southern Buccaneers,J. Moore,4397409,,False,11.0,0,1,0,0,0,1,0,0,1,0,1,1,0,0,1,1,0
401405847,Charleston Southern Buccaneers,S. Price,4278689,,False,14.0,0,2,0,1,0,1,2,2,0,1,1,2,0,0,0,1,2
401405847,Charleston Southern Buccaneers,TEAM,TOTAL,TOTAL,False,,29,55,22,34,7,21,14,19,8,24,32,15,5,1,11,20,79
401405846,Radford Highlanders,D. Mangum,4397471,,True,37.0,2,9,2,5,0,4,2,4,3,7,10,1,3,0,0,4,6
401405846,Radford Highlanders,C. Walker,4279192,,True,28.0,3,4,3,4,0,0,0,2,2,4,6,1,0,0,2,3,6
401405846,Radford Highlanders,A. Stapleton,4708648,,True,15.0,2,4,2,4,0,0,6,7,0,1,1,1,1,0,2,1,10
401405846,Radford Highlanders,B. Hart,4702216,,True,37.0,4,12,2,4,2,8,0,0,0,2,2,1,0,0,0,3,10
401405846,Radford Highlanders,J. Jeffers,4397819,,True,32.0,7,16,5,11,2,5,2,3,0,4,4,4,2,0,1,4,18
401405846,Radford Highlanders,L. Djonkam,4278422,,False,14.0,3,3,3,3,0,0,4,4,3,0,3,2,1,0,1,5,10
401405846,Radford Highlanders,S. Jules,4702215,,False,4.0,1,1,1,1,0,0,0,0,0,1,1,0,0,0,1,1,2
401405846,Radford Highlanders,R. Williams,4396643,,False,37.0,2,15,1,6,1,9,2,2,1,4,5,0,0,0,1,2,7
401405846,Radford Highlanders,C. McNeil,4897647,,False,11.0,1,4,1,4,0,0,0,0,1,2,3,0,0,0,1,0,2
401405846,Radford Highlanders,T. Joseph,4703215,,False,5.0,0,0,0,0,0,0,0,0,0,0,0,0,0,0,0,0,0
401405846,Radford Highlanders,X. Lipscomb,4702218,,False,3.0,0,1,0,0,0,1,0,0,0,0,0,0,0,0,0,0,0
401405846,Radford Highlanders,TEAM,TOTAL,TOTAL,False,,25,69,20,42,5,27,16,22,14,27,41,10,7,0,9,23,71
401405846,North Carolina A&T Aggies,C. Smith,4278481,,True,15.0,1,5,1,5,0,0,2,2,0,1,1,0,0,1,0,4,4
401405846,North Carolina A&T Aggies,J. Whatley,4278249,,True,13.0,1,1,1,1,0,0,0,0,0,2,2,0,0,0,1,5,2
401405846,North Carolina A&T Aggies,M. Watson,4897640,,True,32.0,7,11,5,8,2,3,2,6,2,9,11,3,0,1,2,3,18
401405846,North Carolina A&T Aggies,D. Horton,4702944,,True,21.0,2,4,2,2,0,2,3,4,0,4,4,0,0,0,2,1,7
401405846,North Carolina A&T Aggies,K. Langley,4279819,,True,35.0,1,3,1,2,0,1,7,8,1,5,6,3,4,0,2,3,9
401405846,North Carolina A&T Aggies,J. Robinson,4704088,,False,36.0,4,6,1,2,3,4,6,7,0,3,3,1,1,0,3,2,17
401405846,North Carolina A&T Aggies,W. Filmore,4398217,,False,22.0,2,5,2,5,0,0,2,2,1,2,3,0,1,1,0,2,6
401405846,North Carolina A&T Aggies,T. Maye,4278423,,False,20.0,4,8,4,8,0,0,2,2,2,1,3,0,0,0,1,2,10
401405846,North Carolina A&T Aggies,D. Beatty,4278107,,False,29.0,2,8,1,4,1,4,0,0,0,4,4,2,0,0,1,1,5
401405846,North Carolina A&T Aggies,TEAM,TOTAL,TOTAL,False,,24,51,18,37,6,14,24,31,6,35,41,9,6,3,13,23,78
401405842,Texas Tech Red Raiders,K. Obanor,4398304,,True,26.0,4,6,3,5,1,1,2,2,3,3,6,0,0,0,2,1,11
401405842,Texas Tech Red Raiders,B. Williams,4066678,,True,31.0,8,17,7,12,1,5,0,2,0,4,4,0,0,0,1,5,17
401405842,Texas Tech Red Raiders,K. McCullar,4411057,,True,33.0,3,10,3,7,0,3,2,2,0,3,3,5,1,0,2,2,8
401405842,Texas Tech Red Raiders,T. Shannon Jr.,4432847,,True,24.0,5,7,2,3,3,4,1,1,0,1,1,0,0,0,4,3,14
401405842,Texas Tech Red Raiders,A. Arms,4406489,,True,29.0,1,7,1,3,0,4,0,0,1,7,8,4,1,0,2,2,2
401405842,Texas Tech Red Raiders,D. Batcho,4683631,,False,7.0,1,1,1,1,0,0,0,0,1,0,1,1,0,0,0,0,2
401405842,Texas Tech Red Raiders,M. Santos-Silva,4278420,,False,16.0,4,5,4,5,0,0,0,2,3,3,6,0,2,2,1,3,8
401405842,Texas Tech Red Raiders,D. Warren,4592666,,False,20.0,1,7,1,5,0,2,1,2,0,1,1,1,1,0,1,2,3
401405842,Texas Tech Red Raiders,M. Wilson,4432902,,False,7.0,0,1,0,1,0,0,0,0,1,0,1,3,0,0,0,0,0
401405842,Texas Tech Red Raiders,C. Nadolny,4431841,,False,7.0,0,0,0,0,0,0,0,2,0,1,1,0,2,1,1,2,0
401405842,Texas Tech Red Raiders,TEAM,TOTAL,TOTAL,False,,27,61,22,42,5,19,6,13,10,24,34,14,7,3,14,20,65
401405842,Kansas Jayhawks,J. Wilson,4431714,,True,35.0,5,9,5,6,0,3,2,4,0,5,5,2,2,1,2,5,12
401405842,Kansas Jayhawks,D. McCormack,4397019,,True,29.0,5,10,5,9,0,1,8,9,4,7,11,1,0,0,4,1,18
401405842,Kansas Jayhawks,D. Harris,4431983,,True,19.0,0,3,0,0,0,3,0,0,0,0,0,1,0,0,1,2,0
401405842,Kansas Jayhawks,C. Braun,4431767,,True,36.0,3,7,3,5,0,2,8,9,0,5,5,1,2,0,1,2,14
401405842,Kansas Jayhawks,O. Agbaji,4397018,,True,38.0,4,10,1,4,3,6,5,6,2,5,7,2,0,1,5,2,16
401405842,Kansas Jayhawks,K.J. Adams,4433259,,False,0.0,0,0,0,0,0,0,0,0,0,0,0,0,0,0,0,0,0
401405842,Kansas Jayhawks,M. Lightfoot,4066300,,False,11.0,1,1,1,1,0,0,0,2,0,0,0,0,0,0,0,1,2
401405842,Kansas Jayhawks,J. Yesufu,4431856,,False,4.0,0,2,0,1,0,1,0,0,0,1,1,1,1,0,0,0,0
401405842,Kansas Jayhawks,R. Martin,4278133,,False,26.0,4,9,2,3,2,6,2,2,0,4,4,4,3,0,0,3,12
401405842,Kansas Jayhawks,J. Coleman-Lands,3911842,,False,2.0,0,0,0,0,0,0,0,0,0,0,0,0,0,0,0,0,0
401405842,Kansas Jayhawks,TEAM,TOTAL,TOTAL,False,,22,51,17,29,5,22,25,32,7,27,34,12,8,2,13,16,74
401405841,Texas Tech Red Raiders,K. Obanor,4398304,,True,32.0,4,7,1,1,3,6,0,0,0,3,3,0,0,0,1,3,11
401405841,Texas Tech Red Raiders,B. Williams,4066678,,True,29.0,4,9,3,6,1,3,0,0,2,1,3,0,0,0,2,1,9
401405841,Texas Tech Red Raiders,D. Warren,4592666,,True,26.0,5,9,4,6,1,3,0,0,0,3,3,1,3,0,4,2,11
401405841,Texas Tech Red Raiders,T. Shannon Jr.,4432847,,True,23.0,1,4,0,2,1,2,1,2,0,2,2,3,0,0,1,1,4
401405841,Texas Tech Red Raiders,A. Arms,4406489,,True,32.0,2,4,2,3,0,1,5,6,0,2,2,5,0,1,1,2,9
401405841,Texas Tech Red Raiders,D. Batcho,4683631,,False,2.0,0,0,0,0,0,0,0,0,0,0,0,0,0,0,0,2,0
401405841,Texas Tech Red Raiders,M. Santos-Silva,4278420,,False,15.0,3,5,3,5,0,0,0,0,1,5,6,0,0,1,1,1,6
401405841,Texas Tech Red Raiders,K. McCullar,4411057,,False,30.0,2,7,2,5,0,2,0,1,0,5,5,3,0,0,3,3,4
401405841,Texas Tech Red Raiders,C. Agbo,4433197,,False,1.0,0,0,0,0,0,0,0,0,0,0,0,0,0,0,0,0,0
401405841,Texas Tech Red Raiders,M. Wilson,4432902,,False,3.0,0,0,0,0,0,0,0,0,0,0,0,0,1,1,1,0,0
401405841,Texas Tech Red Raiders,C. Nadolny,4431841,,False,7.0,0,0,0,0,0,0,2,2,0,0,0,0,0,1,0,1,2
401405841,Texas Tech Red Raiders,TEAM,TOTAL,TOTAL,False,,21,45,15,28,6,17,8,11,3,21,24,12,4,4,15,16,56
401405841,Oklahoma Sooners,J. Hill,4592214,,True,35.0,5,10,4,8,1,2,2,3,2,3,5,1,0,0,3,4,13
401405841,Oklahoma Sooners,T. Groves,4278603,,True,16.0,1,3,1,2,0,1,0,1,2,7,9,0,0,0,3,1,2
401405841,Oklahoma Sooners,J. Groves,4592583,,True,26.0,0,1,0,0,0,1,1,2,3,4,7,2,1,0,2,1,1
401405841,Oklahoma Sooners,U. Gibson,4279087,,True,36.0,5,12,1,3,4,9,2,2,0,1,1,1,1,0,3,2,16
401405841,Oklahoma Sooners,J. Goldwire,4277845,,True,34.0,5,13,5,10,0,3,4,6,0,2,2,1,1,0,0,1,14
401405841,Oklahoma Sooners,E. Chargois,4278297,,False,23.0,1,4,1,3,0,1,2,2,2,2,4,2,0,1,2,3,4
401405841,Oklahoma Sooners,C.J. Noland,4694228,,False,6.0,0,1,0,0,0,1,0,0,0,0,0,0,0,0,0,0,0
401405841,Oklahoma Sooners,M. Johnson,4593466,,False,24.0,2,6,2,5,0,1,1,2,0,1,1,4,3,1,2,3,5
401405841,Oklahoma Sooners,TEAM,TOTAL,TOTAL,False,,19,50,14,31,5,19,12,18,14,22,36,11,6,2,18,15,55
401405840,TCU Horned Frogs,E. Miller,4432872,,True,25.0,3,8,3,7,0,1,1,2,2,3,5,1,0,1,1,0,7
401405840,TCU Horned Frogs,C. O'Bannon Jr.,4278533,,True,28.0,6,8,3,3,3,5,0,0,1,6,7,0,0,2,1,0,15
401405840,TCU Horned Frogs,E. Lampkin,4433191,,True,25.0,3,8,3,8,0,0,2,5,4,0,4,0,0,0,2,1,8
401405840,TCU Horned Frogs,M. Miles,4432550,,True,33.0,6,13,5,9,1,4,1,2,0,5,5,3,0,1,2,2,14
401405840,TCU Horned Frogs,D. Baugh,4431766,,True,34.0,1,2,1,1,0,1,5,10,1,6,7,9,1,1,7,1,7
401405840,TCU Horned Frogs,S. Doumbia,4897753,,False,3.0,0,0,0,0,0,0,0,0,0,0,0,0,1,0,0,1,0
401405840,TCU Horned Frogs,X. Cork,4593722,,False,12.0,0,3,0,3,0,0,1,2,2,2,4,0,0,0,0,3,1
401405840,TCU Horned Frogs,J. Coles,4432282,,False,6.0,0,1,0,0,0,1,0,0,0,1,1,0,0,0,0,1,0
401405840,TCU Horned Frogs,H. Young,4592292,,False,0.0,0,0,0,0,0,0,0,0,0,0,0,0,0,0,0,0,0
401405840,TCU Horned Frogs,M. Peavy,4432185,,False,17.0,2,5,2,4,0,1,0,0,0,1,1,0,0,0,1,2,4
401405840,TCU Horned Frogs,F. Farabello,4431952,,False,17.0,2,2,0,0,2,2,0,0,0,1,1,1,1,0,0,1,6
401405840,TCU Horned Frogs,TEAM,TOTAL,TOTAL,False,,23,50,17,35,6,15,10,21,12,25,37,14,3,5,18,12,62
401405840,Kansas Jayhawks,J. Wilson,4431714,,True,32.0,4,6,3,4,1,2,0,0,1,1,2,5,1,1,1,1,9
401405840,Kansas Jayhawks,D. McCormack,4397019,,True,13.0,1,3,1,3,0,0,3,4,1,1,2,1,0,1,0,3,5
401405840,Kansas Jayhawks,D. Harris,4431983,,True,25.0,1,3,1,2,0,1,0,0,0,0,0,5,2,0,3,4,2
401405840,Kansas Jayhawks,C. Braun,4431767,,True,33.0,4,11,3,8,1,3,0,0,0,6,6,2,1,1,0,1,9
401405840,Kansas Jayhawks,O. Agbaji,4397018,,True,34.0,9,17,7,11,2,6,2,3,0,3,3,0,0,1,1,2,22
401405840,Kansas Jayhawks,Z. Clemence,4683146,,False,1.0,0,0,0,0,0,0,0,0,0,1,1,0,0,0,0,0,0
401405840,Kansas Jayhawks,K.J. Adams,4433259,,False,1.0,0,0,0,0,0,0,0,0,0,0,0,0,0,0,0,0,0
401405840,Kansas Jayhawks,M. Lightfoot,4066300,,False,25.0,6,8,5,6,1,2,2,2,1,4,5,1,2,2,1,3,15
401405840,Kansas Jayhawks,J. Yesufu,4431856,,False,14.0,1,1,0,0,1,1,0,0,0,2,2,1,0,0,0,1,3
401405840,Kansas Jayhawks,R. Martin,4278133,,False,19.0,4,10,4,7,0,3,2,2,1,2,3,3,0,0,0,2,10
401405840,Kansas Jayhawks,C. Teahan,4277893,,False,1.0,0,0,0,0,0,0,0,0,0,0,0,0,0,0,0,0,0
401405840,Kansas Jayhawks,J. Coleman-Lands,3911842,,False,2.0,0,1,0,1,0,0,0,0,0,0,0,0,0,0,0,0,0
401405840,Kansas Jayhawks,TEAM,TOTAL,TOTAL,False,,30,60,24,42,6,18,9,11,5,21,26,18,6,6,7,17,75
401405839,Texas Tech Red Raiders,K. Obanor,4398304,,True,23.0,4,9,4,7,0,2,2,2,2,4,6,0,0,0,0,1,10
401405839,Texas Tech Red Raiders,B. Williams,4066678,,True,19.0,2,6,2,5,0,1,2,4,3,2,5,2,0,0,0,1,6
401405839,Texas Tech Red Raiders,D. Warren,4592666,,True,20.0,4,7,3,4,1,3,0,0,0,5,5,3,3,0,5,0,9
401405839,Texas Tech Red Raiders,T. Shannon Jr.,4432847,,True,22.0,5,9,3,6,2,3,3,4,0,4,4,1,3,0,5,1,15
401405839,Texas Tech Red Raiders,A. Arms,4406489,,True,22.0,5,7,5,6,0,1,0,2,0,2,2,2,1,0,0,1,10
401405839,Texas Tech Red Raiders,KJ Allen,4897776,,False,6.0,0,1,0,0,0,1,0,0,1,1,2,0,0,0,0,0,0
401405839,Texas Tech Red Raiders,D. Batcho,4683631,,False,14.0,0,0,0,0,0,0,0,0,1,1,2,0,0,1,1,1,0
401405839,Texas Tech Red Raiders,M. Santos-Silva,4278420,,False,15.0,2,5,2,5,0,0,1,2,1,4,5,1,0,1,0,1,5
401405839,Texas Tech Red Raiders,K. McCullar,4411057,,False,18.0,4,6,1,2,3,4,0,0,1,2,3,3,2,0,1,4,11
401405839,Texas Tech Red Raiders,C. Agbo,4433197,,False,8.0,1,3,1,2,0,1,0,0,0,0,0,0,1,0,0,0,2
401405839,Texas Tech Red Raiders,M. Wilson,4432902,,False,14.0,0,0,0,0,0,0,0,0,0,1,1,1,1,2,1,0,0
401405839,Texas Tech Red Raiders,C. Nadolny,4431841,,False,19.0,1,3,1,2,0,1,2,2,1,3,4,1,1,0,0,2,4
401405839,Texas Tech Red Raiders,TEAM,TOTAL,TOTAL,False,,28,56,22,39,6,17,10,16,10,30,40,14,12,4,15,12,72
401405839,Iowa State Cyclones,A. Kunc,4397167,,True,24.0,1,3,0,1,1,2,2,2,0,6,6,1,2,0,2,3,5
401405839,Iowa State Cyclones,G. Conditt IV,4396989,,True,14.0,1,1,1,1,0,0,0,0,0,2,2,1,0,0,4,4,2
401405839,Iowa State Cyclones,T. Hunter,4683751,,True,32.0,4,9,3,5,1,4,0,2,0,5,5,2,1,0,7,1,9
401405839,Iowa State Cyclones,G. Kalscheur,4397214,,True,37.0,1,5,1,1,0,4,3,4,1,1,2,1,1,0,3,2,5
401405839,Iowa State Cyclones,I. Brockington,4278412,,True,33.0,3,16,2,10,1,6,0,0,2,0,2,2,0,0,0,1,7
401405839,Iowa State Cyclones,R. Jones,4593702,,False,20.0,2,4,2,4,0,0,1,2,1,2,3,3,2,0,1,1,5
401405839,Iowa State Cyclones,T. Enaruna,4431734,,False,4.0,0,1,0,0,0,1,0,0,0,0,0,0,0,0,0,0,0
401405839,Iowa State Cyclones,J. Walker,4433024,,False,9.0,1,1,1,1,0,0,0,0,0,0,0,1,0,0,2,2,2
401405839,Iowa State Cyclones,T. Jackson,4431999,,False,4.0,0,2,0,0,0,2,0,0,0,1,1,0,0,0,0,0,0
401405839,Iowa State Cyclones,C. Grill,4431973,,False,22.0,2,6,0,0,2,6,0,0,0,2,2,0,0,0,1,2,6
401405839,Iowa State Cyclones,C. Boothe,4396992,,False,1.0,0,0,0,0,0,0,0,0,0,0,0,0,0,0,0,0,0
401405839,Iowa State Cyclones,TEAM,TOTAL,TOTAL,False,,15,48,10,23,5,25,6,10,4,20,24,11,6,0,20,16,41
401405838,Oklahoma Sooners,J. Hill,4592214,,True,34.0,5,10,5,8,0,2,0,1,2,3,5,1,1,0,2,2,10
401405838,Oklahoma Sooners,T. Groves,4278603,,True,15.0,2,4,1,2,1,2,0,0,1,5,6,0,0,0,1,4,5
401405838,Oklahoma Sooners,J. Groves,4592583,,True,31.0,5,7,2,2,3,5,2,2,0,9,9,2,1,1,1,1,15
401405838,Oklahoma Sooners,U. Gibson,4279087,,True,34.0,4,11,3,6,1,5,5,6,0,5,5,3,0,0,3,2,14
401405838,Oklahoma Sooners,J. Goldwire,4277845,,True,35.0,4,12,2,10,2,2,0,0,0,3,3,6,0,0,1,2,10
401405838,Oklahoma Sooners,E. Chargois,4278297,,False,25.0,1,1,0,0,1,1,0,0,1,1,2,5,0,1,1,2,3
401405838,Oklahoma Sooners,C.J. Noland,4694228,,False,6.0,1,1,0,0,1,1,0,0,0,0,0,0,0,0,1,1,3
401405838,Oklahoma Sooners,M. Johnson,4593466,,False,20.0,4,5,2,2,2,3,2,3,0,3,3,1,1,0,6,3,12
401405838,Oklahoma Sooners,TEAM,TOTAL,TOTAL,False,,26,51,15,30,11,21,9,12,5,30,35,18,3,2,16,17,72
401405838,Baylor Bears,M. Mayer,4395697,,True,26.0,3,8,3,4,0,4,4,4,0,5,5,0,1,2,0,2,10
401405838,Baylor Bears,F. Thamba,4395692,,True,29.0,4,6,4,6,0,0,2,2,2,5,7,0,0,2,0,3,10
401405838,Baylor Bears,K. Brown,4433254,,True,27.0,3,6,2,5,1,1,0,0,2,0,2,2,0,0,3,2,7
401405838,Baylor Bears,A. Flagler,4397654,,True,37.0,1,10,1,4,0,6,0,0,0,0,0,4,0,0,1,1,2
401405838,Baylor Bears,J. Akinjo,4397072,,True,31.0,6,16,6,13,0,3,4,5,2,4,6,2,3,0,0,3,16
401405838,Baylor Bears,J. Sochan,4610139,,False,31.0,4,11,3,6,1,5,4,5,2,7,9,2,2,1,1,4,13
401405838,Baylor Bears,D. Bonner,4601289,,False,19.0,4,8,3,5,1,3,0,0,1,0,1,1,6,0,1,2,9
401405838,Baylor Bears,TEAM,TOTAL,TOTAL,False,,25,65,22,43,3,22,14,16,12,22,34,11,12,5,6,17,67
401405836,West Virginia Mountaineers,J. Bridges,4432946,,True,20.0,3,5,3,4,0,1,0,2,1,0,1,0,2,0,0,2,6
401405836,West Virginia Mountaineers,G. Osabuohien,4278051,,True,23.0,2,8,2,7,0,1,0,2,3,0,3,1,2,1,0,2,4
401405836,West Virginia Mountaineers,T. Sherman,4592307,,True,31.0,3,14,2,11,1,3,3,3,0,3,3,1,2,0,1,1,10
401405836,West Virginia Mountaineers,S. McNeil,4592306,,True,34.0,1,9,0,4,1,5,0,0,0,3,3,1,0,0,1,1,3
401405836,West Virginia Mountaineers,Ke. Johnson,4279756,,True,14.0,1,1,0,0,1,1,3,4,0,0,0,1,3,0,1,3,6
401405836,West Virginia Mountaineers,D. Carrigan,4592849,,False,4.0,0,1,0,1,0,0,0,0,2,0,2,0,0,1,1,1,0
401405836,West Virginia Mountaineers,I. Cottrell,4432201,,False,15.0,3,6,0,3,3,3,0,0,1,2,3,1,0,0,0,0,9
401405836,West Virginia Mountaineers,P. Paulicap,4279706,,False,17.0,1,3,1,3,0,0,2,4,1,4,5,0,0,1,4,4,4
401405836,West Virginia Mountaineers,Ko. Johnson,4686333,,False,11.0,1,2,1,2,0,0,0,0,1,2,3,0,0,1,0,0,2
401405836,West Virginia Mountaineers,M. Curry,4592874,,False,24.0,4,9,4,9,0,0,11,11,0,0,0,2,1,0,3,0,19
401405836,West Virginia Mountaineers,S. Wilson,4581445,,False,7.0,0,0,0,0,0,0,0,0,0,0,0,1,0,0,0,1,0
401405836,West Virginia Mountaineers,TEAM,TOTAL,TOTAL,False,,19,58,13,44,6,14,19,26,12,15,27,8,10,4,11,15,63
401405836,Kansas Jayhawks,J. Wilson,4431714,,True,27.0,4,9,2,5,2,4,5,6,0,5,5,0,0,1,3,4,15
401405836,Kansas Jayhawks,D. McCormack,4397019,,True,10.0,2,4,2,4,0,0,5,6,3,2,5,0,0,0,3,2,9
401405836,Kansas Jayhawks,D. Harris,4431983,,True,25.0,3,6,3,5,0,1,0,0,1,2,3,7,2,0,0,2,6
401405836,Kansas Jayhawks,C. Braun,4431767,,True,31.0,4,8,3,6,1,2,2,2,4,10,14,2,1,0,2,2,11
401405836,Kansas Jayhawks,O. Agbaji,4397018,,True,30.0,7,15,6,9,1,6,3,3,1,2,3,0,2,0,2,1,18
401405836,Kansas Jayhawks,Z. Clemence,4683146,,False,7.0,1,1,1,1,0,0,0,0,0,3,3,2,0,1,0,2,2
401405836,Kansas Jayhawks,K.J. Adams,4433259,,False,6.0,0,1,0,1,0,0,0,0,0,0,0,2,0,0,1,1,0
401405836,Kansas Jayhawks,M. Lightfoot,4066300,,False,23.0,5,6,5,6,0,0,0,0,1,4,5,1,0,5,0,1,10
401405836,Kansas Jayhawks,J. Yesufu,4431856,,False,17.0,1,4,1,3,0,1,0,0,2,2,4,1,0,0,1,3,2
401405836,Kansas Jayhawks,R. Martin,4278133,,False,12.0,2,3,2,3,0,0,0,0,0,2,2,2,1,0,3,2,4
401405836,Kansas Jayhawks,C. Teahan,4277893,,False,2.0,1,1,0,0,1,1,0,0,0,0,0,0,0,0,0,1,3
401405836,Kansas Jayhawks,J. Coleman-Lands,3911842,,False,10.0,3,5,2,2,1,3,0,0,1,0,1,0,1,0,1,0,7
401405836,Kansas Jayhawks,TEAM,TOTAL,TOTAL,False,,33,63,27,45,6,18,15,17,16,32,48,17,7,7,17,21,87
401405835,Texas Longhorns,T. Allen,4397148,,True,36.0,6,11,6,11,0,0,4,4,5,4,9,2,3,1,2,1,16
401405835,Texas Longhorns,C. Bishop,4397037,,True,26.0,2,4,2,4,0,0,3,8,4,3,7,0,1,1,2,0,7
401405835,Texas Longhorns,C. Ramey,4334018,,True,37.0,6,14,3,7,3,7,0,0,2,7,9,3,1,0,1,0,15
401405835,Texas Longhorns,M. Carr,4278014,,True,35.0,3,13,2,7,1,6,0,0,0,0,0,2,1,0,2,5,7
401405835,Texas Longhorns,A. Jones,4066325,,True,32.0,2,7,1,1,1,6,0,0,0,1,1,2,0,0,2,2,5
401405835,Texas Longhorns,B. Cunningham,4397079,,False,12.0,1,1,0,0,1,1,0,0,0,2,2,0,1,0,0,1,3
401405835,Texas Longhorns,D. Disu,4432866,,False,6.0,0,1,0,1,0,0,0,0,0,0,0,0,0,0,2,1,0
401405835,Texas Longhorns,D. Askew,4702467,,False,9.0,1,2,0,1,1,1,1,2,0,1,1,0,1,0,0,2,4
401405835,Texas Longhorns,J. Febres,4277921,,False,7.0,1,1,0,0,1,1,0,0,0,1,1,3,0,0,0,3,3
401405835,Texas Longhorns,TEAM,TOTAL,TOTAL,False,,22,54,14,32,8,22,8,14,11,20,31,12,8,2,12,15,60
401405835,TCU Horned Frogs,E. Miller,4432872,,True,31.0,4,11,4,11,0,0,1,5,5,7,12,0,1,1,1,3,9
401405835,TCU Horned Frogs,C. O'Bannon Jr.,4278533,,True,18.0,1,4,1,4,0,0,2,3,2,1,3,0,1,1,0,0,4
401405835,TCU Horned Frogs,E. Lampkin,4433191,,True,29.0,5,6,5,6,0,0,0,0,4,5,9,0,3,2,2,2,10
401405835,TCU Horned Frogs,M. Miles,4432550,,True,34.0,4,12,2,5,2,7,3,4,0,4,4,3,0,0,0,1,13
401405835,TCU Horned Frogs,D. Baugh,4431766,,True,36.0,4,11,1,7,3,4,6,8,0,2,2,4,1,1,3,0,17
401405835,TCU Horned Frogs,X. Cork,4593722,,False,8.0,1,1,1,1,0,0,0,0,0,1,1,0,0,0,1,3,2
401405835,TCU Horned Frogs,J. Coles,4432282,,False,5.0,0,0,0,0,0,0,0,0,0,0,0,0,0,0,0,1,0
401405835,TCU Horned Frogs,M. Peavy,4432185,,False,24.0,3,5,3,4,0,1,2,3,0,2,2,0,0,2,3,2,8
401405835,TCU Horned Frogs,F. Farabello,4431952,,False,15.0,0,1,0,0,0,1,2,2,0,2,2,1,2,0,1,0,2
401405835,TCU Horned Frogs,TEAM,TOTAL,TOTAL,False,,22,51,17,38,5,13,16,25,13,25,38,8,8,7,13,12,65
401405834,West Virginia Mountaineers,J. Bridges,4432946,,True,33.0,3,5,2,2,1,3,0,0,3,3,6,3,2,1,0,3,7
401405834,West Virginia Mountaineers,G. Osabuohien,4278051,,True,11.0,1,2,1,2,0,0,0,0,0,1,1,3,0,0,1,4,2
401405834,West Virginia Mountaineers,T. Sherman,4592307,,True,37.0,4,11,3,5,1,6,0,0,0,9,9,3,2,1,4,1,9
401405834,West Virginia Mountaineers,S. McNeil,4592306,,True,32.0,7,10,4,5,3,5,4,4,0,6,6,1,2,0,2,0,21
401405834,West Virginia Mountaineers,Ke. Johnson,4279756,,True,15.0,2,2,2,2,0,0,1,2,0,1,1,0,0,0,1,1,5
401405834,West Virginia Mountaineers,D. Carrigan,4592849,,False,13.0,2,3,2,3,0,0,0,0,1,0,1,0,0,1,0,2,4
401405834,West Virginia Mountaineers,I. Cottrell,4432201,,False,7.0,1,1,1,1,0,0,0,0,1,0,1,0,1,0,0,0,2
401405834,West Virginia Mountaineers,P. Paulicap,4279706,,False,16.0,2,6,2,6,0,0,2,3,1,3,4,0,0,2,1,1,6
401405834,West Virginia Mountaineers,Ko. Johnson,4686333,,False,6.0,0,0,0,0,0,0,0,0,0,0,0,0,0,0,0,0,0
401405834,West Virginia Mountaineers,M. Curry,4592874,,False,27.0,6,12,5,11,1,1,4,5,0,2,2,2,2,0,3,1,17
401405834,West Virginia Mountaineers,S. Wilson,4581445,,False,3.0,0,1,0,0,0,1,0,0,0,0,0,1,0,0,1,0,0
401405834,West Virginia Mountaineers,TEAM,TOTAL,TOTAL,False,,28,53,22,37,6,16,11,14,6,27,33,13,9,5,14,13,73
401405834,Kansas State Wildcats,I. Massoud,4431761,,True,35.0,4,8,1,4,3,4,2,3,3,3,6,0,2,2,1,3,13
401405834,Kansas State Wildcats,N. Pack,4576062,,True,38.0,5,13,2,6,3,7,5,5,0,6,6,1,1,0,1,2,18
401405834,Kansas State Wildcats,M. Nowell,4397554,,True,35.0,3,12,1,3,2,9,0,0,1,1,2,4,1,0,2,3,8
401405834,Kansas State Wildcats,M. Smith,4277939,,True,33.0,6,8,3,4,3,4,2,2,0,4,4,3,2,0,3,2,17
401405834,Kansas State Wildcats,M. McGuirl,4277895,,True,26.0,3,8,3,3,0,5,0,0,0,4,4,1,1,0,4,0,6
401405834,Kansas State Wildcats,K. Ezeagu,4397867,,False,3.0,0,0,0,0,0,0,0,0,0,0,0,0,0,0,2,2,0
401405834,Kansas State Wildcats,D. Bradford,4700530,,False,4.0,0,0,0,0,0,0,0,0,0,0,0,0,1,0,0,0,0
401405834,Kansas State Wildcats,S. Miguel,4433187,,False,26.0,2,6,2,5,0,1,1,2,0,2,2,0,0,0,1,3,5
401405834,Kansas State Wildcats,TEAM,TOTAL,TOTAL,False,,23,55,12,25,11,30,10,12,6,22,28,9,8,2,15,15,67
401405833,Vermont Catamounts,I. Powell,4592945,,True,22.0,2,5,1,2,1,3,0,0,0,3,3,2,0,0,0,1,5
401405833,Vermont Catamounts,R. Davis,4396597,,True,19.0,5,7,4,5,1,2,2,2,3,4,7,0,0,1,2,2,13
401405833,Vermont Catamounts,F. Sullivan,4397759,,True,22.0,2,6,0,1,2,5,2,2,0,3,3,3,2,0,1,1,8
401405833,Vermont Catamounts,J. Mazzulla,4278493,,True,23.0,5,6,5,6,0,0,1,1,1,4,5,4,0,0,1,3,11
401405833,Vermont Catamounts,B. Shungu,4066789,,True,24.0,7,12,6,7,1,5,0,0,2,3,5,1,2,1,1,2,15
401405833,Vermont Catamounts,G. Lefebvre,4701185,,False,4.0,0,0,0,0,0,0,3,4,1,1,2,0,0,0,1,2,3
401405833,Vermont Catamounts,N. Fiorillo,4592946,,False,17.0,4,6,2,3,2,3,2,2,0,3,3,0,0,0,1,1,12
401405833,Vermont Catamounts,B. Patella,4278246,,False,7.0,2,3,2,2,0,1,0,0,0,0,0,0,0,0,0,0,4
401405833,Vermont Catamounts,E. Guillory,4898005,,False,4.0,1,1,1,1,0,0,0,0,0,0,0,0,0,0,0,0,2
401405833,Vermont Catamounts,A. Deloney,4431940,,False,18.0,4,6,1,2,3,4,0,0,0,0,0,3,1,0,0,0,11
401405833,Vermont Catamounts,K. Gibson,4398273,,False,16.0,4,7,1,2,3,5,1,2,1,1,2,1,0,0,0,0,12
401405833,Vermont Catamounts,R. Duncan,4396594,,False,24.0,1,3,1,2,0,1,0,0,2,5,7,9,1,0,1,2,2
401405833,Vermont Catamounts,TEAM,TOTAL,TOTAL,False,,37,62,24,33,13,29,11,13,10,29,39,23,6,2,8,14,98
401405833,NJIT Highlanders,M. Coleman,4701159,,True,36.0,9,17,7,11,2,6,2,4,0,2,2,1,1,0,2,3,22
401405833,NJIT Highlanders,D. Faison,4432978,,True,40.0,3,6,3,6,0,0,0,0,0,1,1,3,0,1,0,2,6
401405833,NJIT Highlanders,S. Diakite,4396754,,True,13.0,1,4,1,4,0,0,0,0,0,2,2,0,0,0,0,2,2
401405833,NJIT Highlanders,M. Faw,4280072,,True,32.0,3,10,0,4,3,6,2,2,0,3,3,0,0,0,2,4,11
401405833,NJIT Highlanders,M. Gray,4701160,,True,39.0,2,7,1,4,1,3,2,4,1,2,3,1,0,0,5,1,7
401405833,NJIT Highlanders,E. Nankin,4897183,,False,9.0,0,0,0,0,0,0,0,0,0,1,1,2,0,0,0,0,0
401405833,NJIT Highlanders,K. Mason,4710326,,False,20.0,4,5,4,5,0,0,0,1,0,2,2,0,1,0,4,3,8
401405833,NJIT Highlanders,K. de Graaf,4396755,,False,11.0,1,1,0,0,1,1,0,0,0,2,2,3,0,0,0,0,3
401405833,NJIT Highlanders,TEAM,TOTAL,TOTAL,False,,23,50,16,34,7,16,6,11,2,15,17,10,2,1,13,15,59
401405832,UMass Lowell River Hawks,M. Brooks,4700953,,True,25.0,5,6,5,6,0,0,1,1,0,2,2,0,1,1,3,5,11
401405832,UMass Lowell River Hawks,Al. Blunt,4396569,,True,45.0,11,17,7,10,4,7,7,9,2,5,7,3,0,0,3,4,33
401405832,UMass Lowell River Hawks,K. Thomas,4592912,,True,31.0,3,9,3,6,0,3,0,0,1,1,2,2,1,0,1,5,6
401405832,UMass Lowell River Hawks,A. Hikim,4431843,,True,38.0,10,17,9,15,1,2,1,2,2,5,7,4,2,0,4,2,22
401405832,UMass Lowell River Hawks,E. Hammond,4397833,,True,36.0,1,7,1,5,0,2,4,4,0,2,2,2,1,0,1,2,6
401405832,UMass Lowell River Hawks,J. Hall,4066996,,False,20.0,1,5,0,2,1,3,0,0,1,2,3,0,0,0,1,2,3
401405832,UMass Lowell River Hawks,An. Blunt,4700954,,False,18.0,1,3,1,3,0,0,0,0,3,1,4,1,0,0,0,2,2
401405832,UMass Lowell River Hawks,Q. Mincey,4567710,,False,12.0,1,5,1,2,0,3,0,0,0,3,3,0,1,1,1,2,2
401405832,UMass Lowell River Hawks,TEAM,TOTAL,TOTAL,False,,33,69,27,49,6,20,13,16,12,22,34,12,6,2,14,24,85
401405832,UMBC Retrievers,Y. Obeng-Mensah,4898002,,True,8.0,3,3,3,3,0,0,0,0,1,0,1,2,1,0,0,2,6
401405832,UMBC Retrievers,N. Johnson,4592939,,True,38.0,1,2,1,2,0,0,3,5,3,6,9,3,1,1,3,3,5
401405832,UMBC Retrievers,K. Kennedy,4592938,,True,38.0,7,13,4,8,3,5,0,0,0,4,4,3,0,0,2,1,17
401405832,UMBC Retrievers,L.J. Owens,4397601,,True,42.0,4,9,2,4,2,5,3,3,0,1,1,0,0,0,0,1,13
401405832,UMBC Retrievers,D. Rogers,4278386,,True,36.0,5,15,1,7,4,8,9,10,1,3,4,3,5,0,3,2,23
401405832,UMBC Retrievers,S. Wojcik,4397468,,False,28.0,4,9,4,7,0,2,9,10,3,5,8,0,0,3,1,2,17
401405832,UMBC Retrievers,D. Spasojevic,4278250,,False,9.0,3,4,3,4,0,0,0,0,0,1,1,0,0,0,1,0,6
401405832,UMBC Retrievers,M. Picarelli,4701172,,False,1.0,0,0,0,0,0,0,0,0,0,0,0,0,0,0,0,0,0
401405832,UMBC Retrievers,J. Boonyasith,4397587,,False,25.0,2,4,2,2,0,2,2,2,0,2,2,1,0,0,0,2,6
401405832,UMBC Retrievers,TEAM,TOTAL,TOTAL,False,,29,59,20,37,9,22,26,30,8,23,31,12,7,4,12,13,93
401405831,New Hampshire Wildcats,J. Martinez,4396579,,True,38.0,6,12,3,5,3,7,2,6,2,4,6,2,0,1,2,1,17
401405831,New Hampshire Wildcats,N. Guadarrama,4396578,,True,40.0,4,11,2,2,2,9,1,5,0,4,4,1,2,0,3,2,11
401405831,New Hampshire Wildcats,T. Mattos,4397814,,True,10.0,1,3,1,3,0,0,2,3,1,4,5,0,1,0,1,2,4
401405831,New Hampshire Wildcats,B. Tchoukuiegno,4593989,,True,40.0,5,9,3,6,2,3,3,4,0,6,6,4,0,0,2,1,15
401405831,New Hampshire Wildcats,N. Johnson,4593988,,True,35.0,4,10,4,8,0,2,1,2,3,5,8,2,1,0,0,2,9
401405831,New Hampshire Wildcats,C. Lester,4066728,,False,2.0,0,0,0,0,0,0,0,0,0,0,0,0,0,0,0,0,0
401405831,New Hampshire Wildcats,M. Foster,4897193,,False,30.0,4,8,2,4,2,4,0,0,1,2,3,1,0,0,0,3,10
401405831,New Hampshire Wildcats,Q. Murphy,4398022,,False,5.0,1,1,1,1,0,0,1,2,0,2,2,0,0,0,0,0,3
401405831,New Hampshire Wildcats,TEAM,TOTAL,TOTAL,False,,25,54,16,29,9,25,10,22,8,30,38,10,4,1,8,11,69
401405831,Binghamton Bearcats,O. Akuwovo,4398164,,True,27.0,4,5,4,5,0,0,2,2,2,3,5,1,0,0,2,4,10
401405831,Binghamton Bearcats,J. Falko,4702061,,True,33.0,8,17,4,8,4,9,1,2,0,2,2,5,1,0,4,3,21
401405831,Binghamton Bearcats,D. Petcash,4592893,,True,22.0,1,3,0,2,1,1,0,0,0,2,2,0,0,0,0,3,3
401405831,Binghamton Bearcats,J. McGriff,4432056,,True,36.0,4,12,4,9,0,3,0,1,0,1,1,6,2,0,2,2,8
401405831,Binghamton Bearcats,C. Hinckson,4398106,,True,29.0,3,6,1,4,2,2,1,2,0,12,12,0,0,2,2,5,9
401405831,Binghamton Bearcats,B. Beamer,4701165,,False,12.0,2,4,1,1,1,3,0,0,0,1,1,0,2,0,0,1,5
401405831,Binghamton Bearcats,T. White,4432139,,False,1.0,0,0,0,0,0,0,0,0,0,0,0,0,0,0,0,0,0
401405831,Binghamton Bearcats,G. Tinsley,4432126,,False,9.0,1,3,1,2,0,1,0,0,0,3,3,1,0,0,0,0,2
401405831,Binghamton Bearcats,Y. Willis,4592897,,False,1.0,1,1,1,1,0,0,0,0,0,0,0,0,0,0,0,0,2
401405831,Binghamton Bearcats,T. Bertram,4397473,,False,30.0,4,8,1,4,3,4,1,1,0,3,3,1,0,0,1,1,12
401405831,Binghamton Bearcats,TEAM,TOTAL,TOTAL,False,,28,59,17,36,11,23,5,8,4,29,33,14,5,2,11,19,72
401405830,UAlbany Great Danes,J. Doles,4279195,,True,28.0,2,10,2,6,0,4,0,2,1,2,3,0,0,0,1,2,4
401405830,UAlbany Great Danes,P. Newman,4280043,,True,23.0,1,5,1,5,0,0,4,4,4,4,8,1,0,0,3,4,6
401405830,UAlbany Great Danes,M. Cerruti,4896617,,True,38.0,6,14,5,10,1,4,0,0,3,1,4,0,1,0,1,1,13
401405830,UAlbany Great Danes,J. Horton,4700941,,True,40.0,4,14,3,12,1,2,3,5,2,7,9,0,2,1,2,2,12
401405830,UAlbany Great Danes,C. Champion,4067132,,True,30.0,2,10,2,8,0,2,1,2,1,2,3,3,3,0,1,4,5
401405830,UAlbany Great Danes,A. Reddish,4896621,,False,5.0,0,1,0,0,0,1,1,2,0,0,0,1,1,0,0,1,1
401405830,UAlbany Great Danes,J. Neely,4896620,,False,10.0,0,5,0,5,0,0,2,2,2,1,3,0,0,1,1,1,2
401405830,UAlbany Great Danes,T. Ketner,4896618,,False,0.0,0,1,0,1,0,0,0,0,0,0,0,0,0,0,0,0,0
401405830,UAlbany Great Danes,T. Hutcheson,4433012,,False,18.0,1,3,0,0,1,3,0,0,1,2,3,0,3,0,1,3,3
401405830,UAlbany Great Danes,N. Little,4896619,,False,8.0,1,3,0,0,1,3,0,2,0,0,0,0,1,0,0,3,3
401405830,UAlbany Great Danes,TEAM,TOTAL,TOTAL,False,,17,66,13,47,4,19,11,19,19,22,41,5,11,2,10,21,49
401405830,Hartford Hawks,J. Kimbrough,4397154,,True,30.0,0,0,0,0,0,0,0,0,1,6,7,0,1,2,0,5,0
401405830,Hartford Hawks,D. Shriver,4902627,,True,39.0,5,11,1,2,4,9,2,2,0,3,3,0,2,1,1,2,16
401405830,Hartford Hawks,M. Flowers,4432982,,True,22.0,1,4,1,2,0,2,4,4,1,5,6,2,0,0,3,1,6
401405830,Hartford Hawks,A. Williams,4279709,,True,23.0,5,9,5,8,0,1,4,6,2,6,8,1,1,0,4,3,14
401405830,Hartford Hawks,T. Carter,3906520,,True,38.0,4,10,1,5,3,5,10,12,0,6,6,1,0,2,3,2,21
401405830,Hartford Hawks,T. Webley,4702191,,False,3.0,0,0,0,0,0,0,0,0,0,0,0,0,0,1,0,0,0
401405830,Hartford Hawks,B. McClain,4702189,,False,9.0,0,2,0,1,0,1,0,0,0,2,2,0,0,0,2,0,0
401405830,Hartford Hawks,D.J. Mitchell,4395893,,False,34.0,1,5,1,1,0,4,2,2,0,5,5,3,2,0,3,1,4
401405830,Hartford Hawks,M. Hobbs,4395891,,False,2.0,0,1,0,0,0,1,0,0,0,0,0,0,0,0,0,0,0
401405830,Hartford Hawks,TEAM,TOTAL,TOTAL,False,,16,42,9,19,7,23,22,26,4,35,39,7,6,6,16,14,61
401405809,UMBC Retrievers,Y. Obeng-Mensah,4898002,,True,9.0,1,3,1,3,0,0,3,6,2,3,5,0,0,0,0,1,5
401405809,UMBC Retrievers,N. Johnson,4592939,,True,29.0,5,8,3,4,2,4,1,2,0,4,4,0,0,2,1,2,13
401405809,UMBC Retrievers,K. Kennedy,4592938,,True,35.0,4,8,2,5,2,3,1,2,0,3,3,5,0,0,1,0,11
401405809,UMBC Retrievers,L.J. Owens,4397601,,True,34.0,4,8,1,3,3,5,1,2,0,2,2,3,2,0,1,0,12
401405809,UMBC Retrievers,D. Rogers,4278386,,True,26.0,5,11,4,8,1,3,2,2,0,3,3,3,0,0,2,3,13
401405809,UMBC Retrievers,S. Wojcik,4397468,,False,23.0,7,9,5,6,2,3,3,4,0,9,9,3,1,2,2,0,19
401405809,UMBC Retrievers,D. Spasojevic,4278250,,False,6.0,1,1,1,1,0,0,0,0,0,2,2,0,0,0,0,0,2
401405809,UMBC Retrievers,J. Harris,4898003,,False,2.0,0,1,0,0,0,1,0,0,0,2,2,0,0,0,0,0,0
401405809,UMBC Retrievers,K. Sumpter,4898001,,False,2.0,0,0,0,0,0,0,0,0,0,0,0,0,0,0,0,0,0
401405809,UMBC Retrievers,M. Picarelli,4701172,,False,7.0,0,0,0,0,0,0,0,0,0,0,0,0,0,0,0,0,0
401405809,UMBC Retrievers,B. Davis,4701171,,False,2.0,1,2,1,1,0,1,0,0,0,0,0,0,0,0,0,0,2
401405809,UMBC Retrievers,H. Byrd,4590396,,False,2.0,0,0,0,0,0,0,0,0,0,0,0,0,0,0,0,0,0
401405809,UMBC Retrievers,J. Boonyasith,4397587,,False,23.0,1,1,0,0,1,1,0,0,0,4,4,3,0,0,1,1,3
401405809,UMBC Retrievers,TEAM,TOTAL,TOTAL,False,,29,52,18,31,11,21,11,18,2,33,35,17,3,4,8,7,80
401405809,Hartford Hawks,J. Kimbrough,4397154,,True,28.0,7,10,7,10,0,0,2,2,3,6,9,0,0,0,0,3,16
401405809,Hartford Hawks,D. Shriver,4902627,,True,33.0,2,9,1,3,1,6,1,2,0,3,3,0,1,0,0,2,6
401405809,Hartford Hawks,M. Flowers,4432982,,True,27.0,1,7,0,2,1,5,2,2,0,4,4,2,0,0,0,2,5
401405809,Hartford Hawks,A. Williams,4279709,,True,38.0,6,14,6,12,0,2,0,0,1,7,8,5,0,0,6,2,12
401405809,Hartford Hawks,T. Carter,3906520,,True,34.0,6,14,3,6,3,8,0,0,2,3,5,1,0,0,0,3,15
401405809,Hartford Hawks,T. Webley,4702191,,False,6.0,1,2,1,2,0,0,0,0,0,1,1,0,0,0,0,0,2
401405809,Hartford Hawks,C. Edmundo,4902632,,False,2.0,0,0,0,0,0,0,0,0,0,0,0,0,0,0,0,0,0
401405809,Hartford Hawks,K. Henderson,4902628,,False,3.0,0,1,0,0,0,1,0,0,0,0,0,0,0,0,0,0,0
401405809,Hartford Hawks,B. McClain,4702189,,False,3.0,1,3,1,2,0,1,0,0,0,1,1,0,0,0,0,0,2
401405809,Hartford Hawks,D.J. Mitchell,4395893,,False,24.0,0,4,0,1,0,3,2,3,0,0,0,1,0,0,0,0,2
401405809,Hartford Hawks,M. Hobbs,4395891,,False,2.0,0,0,0,0,0,0,0,0,0,0,0,0,0,0,0,0,0
401405809,Hartford Hawks,TEAM,TOTAL,TOTAL,False,,24,64,19,38,5,26,7,9,7,26,33,9,1,0,6,12,60
401405808,Vermont Catamounts,I. Powell,4592945,,True,28.0,0,4,0,3,0,1,3,4,2,5,7,3,0,1,0,0,3
401405808,Vermont Catamounts,R. Davis,4396597,,True,22.0,8,12,6,9,2,3,1,1,0,3,3,1,0,1,0,3,19
401405808,Vermont Catamounts,F. Sullivan,4397759,,True,23.0,1,5,1,3,0,2,0,0,1,3,4,3,1,0,1,3,2
401405808,Vermont Catamounts,J. Mazzulla,4278493,,True,29.0,0,0,0,0,0,0,3,4,0,6,6,1,2,0,1,3,3
401405808,Vermont Catamounts,B. Shungu,4066789,,True,31.0,10,18,7,9,3,9,0,3,0,4,4,1,2,0,2,1,23
401405808,Vermont Catamounts,G. Lefebvre,4701185,,False,2.0,0,0,0,0,0,0,0,0,0,0,0,0,0,0,0,0,0
401405808,Vermont Catamounts,N. Fiorillo,4592946,,False,16.0,2,4,1,2,1,2,2,2,2,2,4,1,1,0,0,1,7
401405808,Vermont Catamounts,B. Patella,4278246,,False,2.0,0,0,0,0,0,0,0,0,0,1,1,0,0,0,0,0,0
401405808,Vermont Catamounts,E. Guillory,4898005,,False,2.0,0,0,0,0,0,0,0,0,0,1,1,0,0,0,0,0,0
401405808,Vermont Catamounts,A. Deloney,4431940,,False,17.0,2,6,1,2,1,4,2,2,0,0,0,3,0,0,0,1,7
401405808,Vermont Catamounts,K. Gibson,4398273,,False,9.0,2,2,0,0,2,2,0,0,0,1,1,1,0,0,0,0,6
401405808,Vermont Catamounts,R. Duncan,4396594,,False,19.0,1,2,0,1,1,1,1,2,0,0,0,1,1,0,0,2,4
401405808,Vermont Catamounts,TEAM,TOTAL,TOTAL,False,,26,53,16,29,10,24,12,18,6,28,34,15,7,2,4,14,74
401405808,Binghamton Bearcats,O. Akuwovo,4398164,,True,20.0,2,3,2,3,0,0,0,1,1,3,4,1,0,1,3,3,4
401405808,Binghamton Bearcats,J. Falko,4702061,,True,32.0,4,10,3,7,1,3,4,6,0,5,5,2,1,1,1,2,13
401405808,Binghamton Bearcats,D. Petcash,4592893,,True,24.0,2,3,2,2,0,1,0,0,0,3,3,0,0,1,0,2,4
401405808,Binghamton Bearcats,J. McGriff,4432056,,True,26.0,3,8,2,6,1,2,0,0,0,1,1,1,0,0,3,2,7
401405808,Binghamton Bearcats,C. Hinckson,4398106,,True,28.0,3,9,2,6,1,3,0,0,2,2,4,0,1,1,2,5,7
401405808,Binghamton Bearcats,B. Beamer,4701165,,False,12.0,0,3,0,2,0,1,0,0,0,1,1,0,0,0,0,1,0
401405808,Binghamton Bearcats,T. White,4432139,,False,8.0,0,0,0,0,0,0,0,0,0,0,0,0,0,1,0,1,0
401405808,Binghamton Bearcats,G. Tinsley,4432126,,False,15.0,0,1,0,1,0,0,0,0,0,3,3,0,0,0,0,0,0
401405808,Binghamton Bearcats,A. Athuai,4592895,,False,3.0,0,0,0,0,0,0,0,0,0,0,0,0,0,0,0,0,0
401405808,Binghamton Bearcats,K. Amos,4701166,,False,3.0,0,0,0,0,0,0,0,0,0,1,1,0,0,0,1,0,0
401405808,Binghamton Bearcats,A. Brodsky,4592894,,False,2.0,0,1,0,0,0,1,0,0,0,0,0,0,0,0,0,0,0
401405808,Binghamton Bearcats,H. Hjalmarsson,4592890,,False,3.0,1,2,1,2,0,0,0,0,0,0,0,0,0,0,0,0,2
401405808,Binghamton Bearcats,T. Bertram,4397473,,False,24.0,1,4,0,2,1,2,2,4,0,4,4,1,0,0,1,3,5
401405808,Binghamton Bearcats,TEAM,TOTAL,TOTAL,False,,16,44,12,31,4,13,6,11,4,25,29,5,2,5,13,19,42
401405807,Vermont Catamounts,I. Powell,4592945,,True,25.0,4,6,4,5,0,1,0,1,0,6,6,1,0,0,2,1,8
401405807,Vermont Catamounts,R. Davis,4396597,,True,21.0,9,13,7,11,2,2,0,1,3,2,5,1,0,0,1,2,20
401405807,Vermont Catamounts,F. Sullivan,4397759,,True,22.0,5,8,2,3,3,5,1,1,0,3,3,2,3,0,1,1,14
401405807,Vermont Catamounts,J. Mazzulla,4278493,,True,30.0,3,5,3,4,0,1,0,0,1,3,4,3,0,0,0,3,6
401405807,Vermont Catamounts,B. Shungu,4066789,,True,35.0,9,17,8,12,1,5,0,0,0,6,6,1,3,0,0,1,19
401405807,Vermont Catamounts,G. Lefebvre,4701185,,False,3.0,0,0,0,0,0,0,0,0,0,1,1,0,0,0,0,0,0
401405807,Vermont Catamounts,N. Fiorillo,4592946,,False,14.0,1,4,1,3,0,1,0,0,1,5,6,0,1,0,1,2,2
401405807,Vermont Catamounts,B. Patella,4278246,,False,3.0,2,2,2,2,0,0,0,0,0,0,0,0,0,0,0,0,4
401405807,Vermont Catamounts,E. Guillory,4898005,,False,3.0,1,1,1,1,0,0,0,0,0,0,0,1,0,0,0,0,2
401405807,Vermont Catamounts,A. Deloney,4431940,,False,21.0,1,3,0,2,1,1,0,0,0,2,2,5,1,0,1,3,3
401405807,Vermont Catamounts,K. Gibson,4398273,,False,5.0,0,1,0,0,0,1,0,0,0,1,1,0,0,1,0,0,0
401405807,Vermont Catamounts,R. Duncan,4396594,,False,18.0,2,3,2,3,0,0,0,0,0,2,2,3,0,0,1,1,4
401405807,Vermont Catamounts,TEAM,TOTAL,TOTAL,False,,37,63,30,46,7,17,1,3,7,32,39,17,8,1,7,14,82
401405807,UMBC Retrievers,Y. Obeng-Mensah,4898002,,True,13.0,2,5,2,5,0,0,0,0,1,2,3,1,1,0,0,2,4
401405807,UMBC Retrievers,N. Johnson,4592939,,True,24.0,0,3,0,2,0,1,0,0,0,1,1,1,1,0,0,2,0
401405807,UMBC Retrievers,K. Kennedy,4592938,,True,32.0,3,8,1,3,2,5,0,0,0,8,8,1,1,1,4,1,8
401405807,UMBC Retrievers,L.J. Owens,4397601,,True,27.0,1,5,1,3,0,2,2,4,0,2,2,0,1,0,1,3,4
401405807,UMBC Retrievers,D. Rogers,4278386,,True,31.0,4,13,2,6,2,7,0,0,0,0,0,0,0,0,1,0,10
401405807,UMBC Retrievers,S. Wojcik,4397468,,False,18.0,2,7,2,6,0,1,2,2,2,5,7,0,0,1,2,1,6
401405807,UMBC Retrievers,D. Spasojevic,4278250,,False,9.0,0,4,0,4,0,0,0,0,1,1,2,1,0,0,0,0,0
401405807,UMBC Retrievers,M. Picarelli,4701172,,False,16.0,2,5,1,3,1,2,4,5,0,0,0,0,0,0,1,0,9
401405807,UMBC Retrievers,B. Davis,4701171,,False,3.0,0,1,0,1,0,0,0,0,0,1,1,0,0,0,0,0,0
401405807,UMBC Retrievers,H. Byrd,4590396,,False,3.0,1,1,1,1,0,0,0,0,0,0,0,0,0,0,0,0,2
401405807,UMBC Retrievers,J. Boonyasith,4397587,,False,24.0,0,2,0,2,0,0,0,0,1,0,1,1,0,0,2,0,0
401405807,UMBC Retrievers,TEAM,TOTAL,TOTAL,False,,15,54,10,36,5,18,8,11,7,21,28,5,4,2,12,9,43
401405806,Virginia Tech Hokies,K. Aluma,4280120,,True,33.0,6,8,5,7,1,1,6,9,3,7,10,7,1,0,2,3,19
401405806,Virginia Tech Hokies,J. Mutts,4278693,,True,33.0,3,4,3,4,0,0,0,1,1,3,4,4,1,0,4,3,6
401405806,Virginia Tech Hokies,H. Cattoor,4432954,,True,32.0,11,16,4,7,7,9,2,2,0,4,4,1,3,0,0,3,31
401405806,Virginia Tech Hokies,N. Alleyne,4432934,,True,27.0,2,5,1,2,1,3,0,0,0,2,2,0,1,0,0,1,5
401405806,Virginia Tech Hokies,S. Murphy,4280118,,True,33.0,4,11,3,8,1,3,0,0,0,2,2,6,1,0,2,1,9
401405806,Virginia Tech Hokies,L. Kidd,4701224,,False,1.0,1,1,1,1,0,0,0,0,1,1,2,0,0,0,0,0,2
401405806,Virginia Tech Hokies,J. Ojiako,4592425,,False,1.0,1,1,1,1,0,0,0,0,1,0,1,0,0,0,0,0,2
401405806,Virginia Tech Hokies,D. N'Guessan,4701984,,False,9.0,1,3,1,3,0,0,0,0,2,0,2,0,0,0,0,3,2
401405806,Virginia Tech Hokies,B. Varga,4897406,,False,1.0,0,2,0,1,0,1,0,0,0,0,0,0,0,0,0,0,0
401405806,Virginia Tech Hokies,C. Johnson,4897405,,False,1.0,0,0,0,0,0,0,0,0,0,0,0,0,0,0,0,0,0
401405806,Virginia Tech Hokies,S. Pedulla,4709131,,False,6.0,0,3,0,1,0,2,0,0,0,2,2,0,0,0,0,1,0
401405806,Virginia Tech Hokies,D. Maddox,4432257,,False,23.0,3,10,3,7,0,3,0,0,3,2,5,0,0,0,0,3,6
401405806,Virginia Tech Hokies,TEAM,TOTAL,TOTAL,False,,32,64,22,42,10,22,8,12,13,24,37,18,7,0,9,18,82
401405806,Duke Blue Devils,P. Banchero,4432573,,True,37.0,8,11,8,10,0,1,4,7,1,4,5,1,0,1,2,3,20
401405806,Duke Blue Devils,W. Moore Jr.,4592187,,True,37.0,4,8,3,5,1,3,2,2,1,5,6,1,0,2,1,1,11
401405806,Duke Blue Devils,M. Williams,4701232,,True,19.0,3,3,3,3,0,0,2,2,1,2,3,1,0,1,0,4,8
401405806,Duke Blue Devils,AJ Griffin,4432585,,True,35.0,4,12,3,4,1,8,1,2,0,3,3,1,4,1,1,0,10
401405806,Duke Blue Devils,T. Keels,4432645,,True,36.0,1,7,1,3,0,4,4,6,0,4,4,4,0,1,2,0,6
401405806,Duke Blue Devils,K. Worthington,4592189,,False,1.0,0,0,0,0,0,0,0,0,0,0,0,0,0,0,0,0,0
401405806,Duke Blue Devils,T. John,4278569,,False,4.0,0,0,0,0,0,0,0,0,0,0,0,0,1,0,1,3,0
401405806,Duke Blue Devils,B. Jones,4278348,,False,1.0,0,0,0,0,0,0,0,0,0,0,0,0,0,0,0,0,0
401405806,Duke Blue Devils,J. Baker,4395624,,False,4.0,0,2,0,2,0,0,0,0,0,0,0,0,0,0,0,0,0
401405806,Duke Blue Devils,J. Blakes,4683735,,False,1.0,0,0,0,0,0,0,0,0,0,0,0,1,0,0,0,0,0
401405806,Duke Blue Devils,M. Savarino,4592188,,False,1.0,1,1,0,0,1,1,0,0,0,0,0,0,0,0,0,0,3
401405806,Duke Blue Devils,J. Roach,4433135,,False,24.0,3,5,2,2,1,3,2,4,0,1,1,0,0,0,3,4,9
401405806,Duke Blue Devils,TEAM,TOTAL,TOTAL,False,,24,49,20,29,4,20,15,23,4,22,26,9,5,6,10,15,67
401405805,Virginia Tech Hokies,K. Aluma,4280120,,True,30.0,6,14,5,10,1,4,5,5,1,3,4,3,0,1,0,0,18
401405805,Virginia Tech Hokies,J. Mutts,4278693,,True,19.0,4,7,3,6,1,1,0,0,2,2,4,2,2,2,2,4,9
401405805,Virginia Tech Hokies,H. Cattoor,4432954,,True,37.0,1,5,0,2,1,3,0,0,0,4,4,0,0,0,0,3,3
401405805,Virginia Tech Hokies,N. Alleyne,4432934,,True,30.0,1,3,0,1,1,2,2,2,0,5,5,1,1,0,1,1,5
401405805,Virginia Tech Hokies,S. Murphy,4280118,,True,23.0,3,8,2,4,1,4,0,0,0,2,2,7,1,0,1,1,7
401405805,Virginia Tech Hokies,L. Kidd,4701224,,False,1.0,0,0,0,0,0,0,0,0,0,0,0,0,0,0,0,0,0
401405805,Virginia Tech Hokies,J. Ojiako,4592425,,False,3.0,0,1,0,1,0,0,0,0,1,1,2,0,0,0,0,1,0
401405805,Virginia Tech Hokies,D. N'Guessan,4701984,,False,8.0,1,2,1,2,0,0,0,0,1,1,2,0,0,0,0,0,2
401405805,Virginia Tech Hokies,B. Varga,4897406,,False,1.0,0,0,0,0,0,0,0,0,0,0,0,0,0,0,0,0,0
401405805,Virginia Tech Hokies,C. Johnson,4897405,,False,1.0,0,0,0,0,0,0,0,0,0,0,0,0,0,0,0,0,0
401405805,Virginia Tech Hokies,S. Pedulla,4709131,,False,18.0,2,5,2,4,0,1,4,4,0,3,3,1,1,0,0,2,8
401405805,Virginia Tech Hokies,D. Maddox,4432257,,False,29.0,7,12,3,7,4,5,2,3,0,6,6,0,0,0,2,3,20
401405805,Virginia Tech Hokies,TEAM,TOTAL,TOTAL,False,,25,57,16,37,9,20,13,14,7,27,34,14,5,3,7,15,72
401405805,North Carolina Tar Heels,A. Bacot,4431674,,True,36.0,9,10,9,10,0,0,1,2,5,9,14,2,0,0,3,5,19
401405805,North Carolina Tar Heels,B. Manek,4277902,,True,29.0,4,10,4,5,0,5,2,2,0,1,1,1,0,0,3,3,10
401405805,North Carolina Tar Heels,L. Black,4395650,,True,25.0,2,5,2,3,0,2,0,0,2,2,4,4,3,1,2,4,4
401405805,North Carolina Tar Heels,R.J. Davis,4433176,,True,36.0,2,10,1,4,1,6,5,6,1,4,5,1,1,0,3,2,10
401405805,North Carolina Tar Heels,C. Love,4433144,,True,38.0,3,17,1,7,2,10,2,2,0,5,5,4,0,0,0,1,10
401405805,North Carolina Tar Heels,J. McKoy,4432058,,False,7.0,0,1,0,1,0,0,0,0,0,1,1,1,0,0,0,0,0
401405805,North Carolina Tar Heels,P. Johnson,4701846,,False,18.0,1,4,1,2,0,2,1,1,2,2,4,1,0,1,0,0,3
401405805,North Carolina Tar Heels,D. Dunn,4683638,,False,2.0,0,2,0,1,0,1,0,0,0,0,0,0,0,0,0,0,0
401405805,North Carolina Tar Heels,D. Styles,4611413,,False,2.0,0,0,0,0,0,0,0,0,0,1,1,0,0,0,0,0,0
401405805,North Carolina Tar Heels,K. Walton,4567079,,False,7.0,1,1,1,1,0,0,1,1,0,0,0,0,0,0,0,0,3
401405805,North Carolina Tar Heels,TEAM,TOTAL,TOTAL,False,,22,60,19,34,3,26,12,14,13,25,38,14,4,2,11,15,59
401405804,Miami Hurricanes,S. Waardenburg,4079701,,True,35.0,3,6,1,1,2,5,0,2,1,2,3,7,2,2,0,4,8
401405804,Miami Hurricanes,I. Wong,4431727,,True,30.0,1,11,1,8,0,3,5,7,2,0,2,0,0,0,1,5,7
401405804,Miami Hurricanes,J. Miller,4396818,,True,37.0,8,15,8,15,0,0,1,2,5,8,13,1,3,0,1,4,17
401405804,Miami Hurricanes,C. Moore,4066345,,True,39.0,6,12,3,6,3,6,0,0,0,1,1,8,1,0,1,3,15
401405804,Miami Hurricanes,K. McGusty,4066310,,True,38.0,11,19,9,14,2,5,0,1,1,6,7,1,0,0,2,3,24
401405804,Miami Hurricanes,A. Walker,4592205,,False,9.0,2,3,1,1,1,2,0,0,0,0,0,0,0,0,0,1,5
401405804,Miami Hurricanes,W. Poplar,4897397,,False,5.0,0,0,0,0,0,0,0,0,0,0,0,0,0,0,0,0,0
401405804,Miami Hurricanes,B. Joseph,4683753,,False,7.0,0,0,0,0,0,0,0,0,0,1,1,0,0,0,0,1,0
401405804,Miami Hurricanes,TEAM,TOTAL,TOTAL,False,,31,66,23,45,8,21,6,12,11,20,31,17,6,2,6,21,76
401405804,Duke Blue Devils,P. Banchero,4432573,,True,38.0,8,10,8,9,0,1,2,4,4,7,11,4,1,1,0,3,18
401405804,Duke Blue Devils,W. Moore Jr.,4592187,,True,36.0,6,12,5,8,1,4,4,4,4,2,6,2,1,3,4,2,17
401405804,Duke Blue Devils,M. Williams,4701232,,True,32.0,4,8,4,8,0,0,1,2,2,8,10,0,0,3,1,1,9
401405804,Duke Blue Devils,AJ Griffin,4432585,,True,30.0,7,12,3,6,4,6,3,4,0,7,7,0,0,0,0,3,21
401405804,Duke Blue Devils,T. Keels,4432645,,True,33.0,1,7,1,3,0,4,2,2,0,1,1,3,1,0,2,1,4
401405804,Duke Blue Devils,T. John,4278569,,False,6.0,0,0,0,0,0,0,2,2,0,0,0,0,0,1,0,2,2
401405804,Duke Blue Devils,J. Baker,4395624,,False,3.0,0,1,0,0,0,1,0,0,0,0,0,0,0,0,0,0,0
401405804,Duke Blue Devils,J. Roach,4433135,,False,22.0,3,8,3,5,0,3,3,4,1,2,3,0,0,0,2,0,9
401405804,Duke Blue Devils,TEAM,TOTAL,TOTAL,False,,29,58,24,39,5,19,17,22,12,28,40,9,3,8,10,12,80
401405803,Virginia Cavaliers,J. Gardner,4396614,,True,29.0,8,16,8,14,0,2,1,1,0,2,2,1,0,0,1,2,17
401405803,Virginia Cavaliers,F. Caffaro,4395679,,True,17.0,0,1,0,1,0,0,0,0,1,5,6,0,0,1,1,1,0
401405803,Virginia Cavaliers,R. Beekman,4432187,,True,37.0,1,8,0,6,1,2,0,2,0,4,4,5,3,2,2,1,3
401405803,Virginia Cavaliers,A. Franklin,4431744,,True,30.0,1,7,1,5,0,2,3,4,0,4,4,3,1,1,1,1,5
401405803,Virginia Cavaliers,K. Clark,4395677,,True,36.0,3,9,2,7,1,2,0,0,0,4,4,4,0,1,3,2,7
401405803,Virginia Cavaliers,K. Shedrick,4431710,,False,23.0,4,6,4,6,0,0,0,2,1,4,5,0,1,1,1,3,8
401405803,Virginia Cavaliers,I. Milicic Jr.,4897404,,False,3.0,0,0,0,0,0,0,0,0,0,1,1,0,0,0,0,0,0
401405803,Virginia Cavaliers,M. Poindexter,4701986,,False,6.0,1,1,0,0,1,1,0,0,0,0,0,1,0,0,0,0,3
401405803,Virginia Cavaliers,T. Murray,4692906,,False,3.0,0,1,0,0,0,1,0,0,0,0,0,0,0,0,0,0,0
401405803,Virginia Cavaliers,C. McCorkle,4432511,,False,3.0,0,1,0,1,0,0,0,0,0,0,0,0,0,0,0,1,0
401405803,Virginia Cavaliers,K. Stattmann,4395680,,False,13.0,0,2,0,1,0,1,0,0,0,5,5,0,0,0,2,0,0
401405803,Virginia Cavaliers,TEAM,TOTAL,TOTAL,False,,18,52,15,41,3,11,4,9,2,30,32,14,5,6,11,11,43
401405803,North Carolina Tar Heels,A. Bacot,4431674,,True,33.0,5,12,5,11,0,1,0,0,2,9,11,0,3,2,1,2,10
401405803,North Carolina Tar Heels,B. Manek,4277902,,True,28.0,8,15,5,8,3,7,2,2,1,6,7,3,1,0,1,0,21
401405803,North Carolina Tar Heels,L. Black,4395650,,True,32.0,3,6,3,3,0,3,0,0,1,3,4,3,3,0,1,0,6
401405803,North Carolina Tar Heels,R.J. Davis,4433176,,True,31.0,4,13,4,9,0,4,0,0,3,5,8,6,1,1,2,1,8
401405803,North Carolina Tar Heels,C. Love,4433144,,True,32.0,2,10,0,4,2,6,4,5,0,3,3,5,0,0,1,0,10
401405803,North Carolina Tar Heels,J. McKoy,4432058,,False,17.0,2,4,1,2,1,2,0,0,0,5,5,0,0,0,0,3,5
401405803,North Carolina Tar Heels,P. Johnson,4701846,,False,17.0,1,2,1,2,0,0,0,0,2,0,2,0,0,0,0,1,2
401405803,North Carolina Tar Heels,D. Dunn,4683638,,False,4.0,0,2,0,2,0,0,0,0,0,0,0,0,0,0,1,0,0
401405803,North Carolina Tar Heels,D. Styles,4611413,,False,3.0,0,1,0,1,0,0,1,2,0,1,1,0,0,0,0,0,1
401405803,North Carolina Tar Heels,K. Walton,4567079,,False,3.0,0,0,0,0,0,0,0,0,0,0,0,0,0,0,0,1,0
401405803,North Carolina Tar Heels,TEAM,TOTAL,TOTAL,False,,25,65,19,42,6,23,7,9,11,35,46,17,8,3,7,8,63
401405802,Virginia Tech Hokies,K. Aluma,4280120,,True,30.0,8,12,7,10,1,2,3,3,0,2,2,2,1,0,1,3,20
401405802,Virginia Tech Hokies,J. Mutts,4278693,,True,34.0,4,10,4,9,0,1,3,7,2,8,10,5,3,3,0,3,11
401405802,Virginia Tech Hokies,H. Cattoor,4432954,,True,33.0,3,6,2,3,1,3,2,2,0,2,2,2,3,0,0,3,9
401405802,Virginia Tech Hokies,N. Alleyne,4432934,,True,28.0,5,7,4,5,1,2,1,1,0,0,0,0,0,0,0,1,12
401405802,Virginia Tech Hokies,S. Murphy,4280118,,True,25.0,5,7,3,3,2,4,4,5,0,2,2,1,0,0,2,2,16
401405802,Virginia Tech Hokies,D. N'Guessan,4701984,,False,12.0,1,1,1,1,0,0,0,0,0,3,3,0,1,0,1,3,2
401405802,Virginia Tech Hokies,S. Pedulla,4709131,,False,15.0,3,6,1,1,2,5,5,6,0,0,0,0,0,0,1,1,13
401405802,Virginia Tech Hokies,D. Maddox,4432257,,False,23.0,2,5,2,3,0,2,0,0,0,1,1,1,0,0,1,2,4
401405802,Virginia Tech Hokies,TEAM,TOTAL,TOTAL,False,,31,54,24,35,7,19,18,24,5,20,25,11,8,3,6,18,87
401405802,Notre Dame Fighting Irish,N. Laszewski,4395665,,True,38.0,5,9,4,5,1,4,1,1,0,10,10,1,1,0,0,4,12
401405802,Notre Dame Fighting Irish,P. Atkinson Jr.,4279699,,True,28.0,2,5,2,5,0,0,1,2,2,1,3,3,0,1,3,2,5
401405802,Notre Dame Fighting Irish,B. Wesley,4683935,,True,21.0,2,8,2,6,0,2,5,6,0,3,3,1,0,0,3,2,9
401405802,Notre Dame Fighting Irish,C. Ryan,4397114,,True,35.0,5,9,3,4,2,5,8,8,1,4,5,1,2,0,0,4,20
401405802,Notre Dame Fighting Irish,P. Hubb,4395664,,True,32.0,8,12,5,6,3,6,4,5,0,1,1,5,0,0,4,3,23
401405802,Notre Dame Fighting Irish,T. Wertz,4397753,,False,11.0,0,0,0,0,0,0,0,0,0,1,1,1,0,0,0,0,0
401405802,Notre Dame Fighting Irish,D. Goodwin,4395667,,False,35.0,5,8,4,6,1,2,0,0,1,2,3,3,0,0,1,2,11
401405802,Notre Dame Fighting Irish,TEAM,TOTAL,TOTAL,False,,27,51,20,32,7,19,19,22,5,22,27,15,3,1,12,17,80
401405801,Miami Hurricanes,S. Waardenburg,4079701,,True,40.0,3,6,2,3,1,3,2,2,4,5,9,1,1,3,3,3,9
401405801,Miami Hurricanes,I. Wong,4431727,,True,42.0,6,12,4,8,2,4,0,0,0,6,6,6,2,0,4,2,14
401405801,Miami Hurricanes,J. Miller,4396818,,True,39.0,6,8,6,7,0,1,1,2,1,2,3,0,2,0,1,2,13
401405801,Miami Hurricanes,C. Moore,4066345,,True,37.0,7,14,6,9,1,5,0,0,1,3,4,6,1,0,3,4,15
401405801,Miami Hurricanes,K. McGusty,4066310,,True,43.0,6,12,4,8,2,4,2,4,0,3,3,1,2,0,1,2,16
401405801,Miami Hurricanes,A. Walker,4592205,,False,11.0,2,2,2,2,0,0,0,0,1,0,1,0,0,0,0,0,4
401405801,Miami Hurricanes,B. Joseph,4683753,,False,13.0,0,2,0,0,0,2,0,0,0,0,0,0,0,0,0,0,0
401405801,Miami Hurricanes,TEAM,TOTAL,TOTAL,False,,30,56,24,37,6,19,5,8,7,21,28,14,8,3,13,13,71
401405801,Boston College Eagles,J. Karnik,4280080,,True,26.0,5,7,5,6,0,1,0,0,1,1,2,1,0,0,2,3,10
401405801,Boston College Eagles,Q. Post,4593016,,True,28.0,6,10,4,8,2,2,0,0,1,4,5,1,0,1,0,1,14
401405801,Boston College Eagles,J. Zackery,4896615,,True,42.0,4,4,2,2,2,2,1,3,0,3,3,3,2,0,1,0,11
401405801,Boston College Eagles,D. Langford Jr.,4433165,,True,40.0,4,8,4,7,0,1,2,4,4,3,7,3,1,0,2,1,10
401405801,Boston College Eagles,M. Ashton-Langford,4278574,,True,39.0,4,15,3,11,1,4,0,0,1,1,2,4,1,1,5,3,9
401405801,Boston College Eagles,T.J. Bickerstaff,4592778,,False,20.0,1,3,1,3,0,0,1,2,2,4,6,2,0,0,0,1,3
401405801,Boston College Eagles,K. Jones,4791225,,False,3.0,0,1,0,0,0,1,0,0,0,0,0,0,0,0,1,0,0
401405801,Boston College Eagles,B. Galloway,4067219,,False,27.0,5,9,4,5,1,4,1,2,0,1,1,3,1,1,2,1,12
401405801,Boston College Eagles,TEAM,TOTAL,TOTAL,False,,29,57,23,42,6,15,5,11,10,18,28,17,5,3,14,10,69
401405800,Syracuse Orange,C. Swider,4397134,,True,38.0,4,15,1,4,3,11,4,5,0,4,4,3,1,0,2,4,15
401405800,Syracuse Orange,J. Boeheim,4279472,,True,40.0,11,20,5,11,6,9,0,0,2,5,7,2,3,0,2,2,28
401405800,Syracuse Orange,B. Sidibe,4278033,,True,17.0,0,1,0,1,0,0,0,0,3,2,5,0,0,3,0,4,0
401405800,Syracuse Orange,J. Girard III,4431746,,True,40.0,7,17,3,6,4,11,5,6,2,4,6,2,1,0,3,3,23
401405800,Syracuse Orange,S. Torrence,4431696,,True,40.0,2,9,2,9,0,0,3,4,4,2,6,11,1,0,2,0,7
401405800,Syracuse Orange,J. Ajak,4592369,,False,2.0,0,0,0,0,0,0,0,0,0,0,0,0,0,0,0,1,0
401405800,Syracuse Orange,F. Anselem,4701842,,False,23.0,3,5,3,5,0,0,0,0,2,2,4,0,1,1,2,2,6
401405800,Syracuse Orange,TEAM,TOTAL,TOTAL,False,,27,67,14,36,13,31,12,15,16,23,39,18,7,4,11,16,79
401405800,Duke Blue Devils,P. Banchero,4432573,,True,35.0,3,9,3,5,0,4,4,7,3,7,10,7,5,1,4,1,10
401405800,Duke Blue Devils,W. Moore Jr.,4592187,,True,39.0,9,20,5,10,4,10,4,4,0,3,3,8,1,1,1,0,26
401405800,Duke Blue Devils,M. Williams,4701232,,True,33.0,7,11,7,11,0,0,1,2,7,9,16,4,1,3,1,2,15
401405800,Duke Blue Devils,AJ Griffin,4432585,,True,22.0,1,3,1,2,0,1,2,2,0,4,4,0,0,0,0,2,4
401405800,Duke Blue Devils,T. Keels,4432645,,True,36.0,6,11,4,5,2,6,0,0,1,2,3,3,0,0,0,2,14
401405800,Duke Blue Devils,T. John,4278569,,False,7.0,0,0,0,0,0,0,0,0,1,1,2,0,2,0,1,1,0
401405800,Duke Blue Devils,J. Baker,4395624,,False,4.0,0,1,0,0,0,1,0,0,0,0,0,0,0,0,1,1,0
401405800,Duke Blue Devils,J. Roach,4433135,,False,24.0,6,12,1,2,5,10,2,3,1,1,2,2,1,0,1,3,19
401405800,Duke Blue Devils,TEAM,TOTAL,TOTAL,False,,32,67,21,35,11,32,13,18,16,27,43,24,10,5,9,12,88
401405799,Virginia Cavaliers,K. Shedrick,4431710,,True,21.0,1,2,1,2,0,0,3,4,0,2,2,0,0,3,1,3,5
401405799,Virginia Cavaliers,J. Gardner,4396614,,True,37.0,7,12,7,12,0,0,3,4,0,4,4,0,1,0,1,2,17
401405799,Virginia Cavaliers,R. Beekman,4432187,,True,37.0,3,9,3,7,0,2,2,3,1,4,5,9,1,1,2,1,8
401405799,Virginia Cavaliers,A. Franklin,4431744,,True,24.0,0,8,0,6,0,2,0,0,1,4,5,0,0,0,0,1,0
401405799,Virginia Cavaliers,K. Clark,4395677,,True,38.0,7,14,7,12,0,2,1,2,1,3,4,1,2,0,3,2,15
401405799,Virginia Cavaliers,F. Caffaro,4395679,,False,21.0,2,3,2,3,0,0,0,0,2,6,8,0,0,0,2,1,4
401405799,Virginia Cavaliers,M. Poindexter,4701986,,False,4.0,1,1,1,1,0,0,0,0,0,0,0,0,0,0,1,0,2
401405799,Virginia Cavaliers,K. Stattmann,4395680,,False,18.0,0,1,0,1,0,0,0,0,0,1,1,1,0,0,0,1,0
401405799,Virginia Cavaliers,TEAM,TOTAL,TOTAL,False,,21,50,21,44,0,6,9,13,8,26,34,11,4,4,10,11,51
401405799,Louisville Cardinals,S. Curry,4897146,,True,18.0,3,7,3,7,0,0,0,1,4,3,7,0,1,0,3,3,6
401405799,Louisville Cardinals,M. Williams,4277880,,True,37.0,5,12,4,10,1,2,0,2,3,10,13,0,3,3,0,3,11
401405799,Louisville Cardinals,N. Locke,4395713,,True,25.0,3,10,1,3,2,7,0,0,0,1,1,2,0,0,1,0,8
401405799,Louisville Cardinals,J. West,4279077,,True,31.0,1,6,0,1,1,5,0,0,0,3,3,3,2,0,2,3,3
401405799,Louisville Cardinals,M. Faulkner,4067444,,True,20.0,1,4,1,2,0,2,0,0,1,0,1,0,0,0,1,3,2
401405799,Louisville Cardinals,S. Williamson,4431676,,False,28.0,4,6,4,6,0,0,1,2,0,3,3,0,2,0,0,2,9
401405799,Louisville Cardinals,E. Ellis,4897145,,False,19.0,2,5,1,1,1,4,2,2,0,2,2,1,1,0,1,1,7
401405799,Louisville Cardinals,D. Davis,4701318,,False,22.0,1,6,1,4,0,2,2,2,3,1,4,1,0,1,2,2,4
401405799,Louisville Cardinals,TEAM,TOTAL,TOTAL,False,,20,56,15,34,5,22,5,9,12,24,36,7,9,4,12,17,50
401405798,Virginia Tech Hokies,K. Aluma,4280120,,True,34.0,7,15,4,10,3,5,2,4,1,9,10,1,0,2,3,3,19
401405798,Virginia Tech Hokies,J. Mutts,4278693,,True,37.0,4,8,4,6,0,2,1,2,3,7,10,2,1,2,3,3,9
401405798,Virginia Tech Hokies,H. Cattoor,4432954,,True,29.0,2,6,0,0,2,6,0,3,1,3,4,3,0,1,1,3,6
401405798,Virginia Tech Hokies,N. Alleyne,4432934,,True,39.0,2,5,2,2,0,3,0,0,0,2,2,2,0,0,1,2,4
401405798,Virginia Tech Hokies,S. Murphy,4280118,,True,33.0,5,9,0,1,5,8,0,0,0,1,1,4,0,0,2,0,15
401405798,Virginia Tech Hokies,D. N'Guessan,4701984,,False,18.0,2,2,2,2,0,0,5,7,2,4,6,0,0,0,0,4,9
401405798,Virginia Tech Hokies,S. Pedulla,4709131,,False,12.0,1,4,1,3,0,1,4,4,0,1,1,2,2,0,2,2,6
401405798,Virginia Tech Hokies,D. Maddox,4432257,,False,23.0,3,6,1,3,2,3,0,0,1,0,1,0,0,0,2,2,8
401405798,Virginia Tech Hokies,TEAM,TOTAL,TOTAL,False,,26,55,14,27,12,28,12,20,8,28,36,14,3,5,14,19,76
401405798,Clemson Tigers,H. Tyson,4395620,,True,31.0,5,9,4,4,1,5,1,1,0,7,7,2,2,0,0,2,12
401405798,Clemson Tigers,PJ Hall,4701225,,True,33.0,5,11,3,7,2,4,4,6,2,3,5,3,0,2,0,4,16
401405798,Clemson Tigers,C. Hunter,4592184,,True,40.0,5,10,3,7,2,3,1,2,0,2,2,3,0,0,0,2,13
401405798,Clemson Tigers,N. Honor,4396810,,True,32.0,3,8,2,4,1,4,0,0,0,2,2,2,1,0,0,0,7
401405798,Clemson Tigers,D. Collins,4278306,,True,30.0,5,10,5,8,0,2,2,2,0,4,4,1,1,0,2,5,12
401405798,Clemson Tigers,I. Schieffelin,4693954,,False,4.0,0,1,0,1,0,0,0,0,2,0,2,0,0,0,1,0,0
401405798,Clemson Tigers,B. Middlebrooks,4684998,,False,2.0,0,0,0,0,0,0,0,0,0,0,0,0,0,0,0,1,0
401405798,Clemson Tigers,N. Bohannon,4285366,,False,16.0,1,4,1,4,0,0,2,2,1,2,3,1,2,0,0,0,4
401405798,Clemson Tigers,A. Hemenway,4433001,,False,11.0,2,3,1,1,1,2,0,0,0,0,0,0,1,0,1,1,5
401405798,Clemson Tigers,A. Dawes,4431730,,False,26.0,2,4,1,1,1,3,1,3,0,1,1,4,0,0,1,1,6
401405798,Clemson Tigers,TEAM,TOTAL,TOTAL,False,,28,60,20,37,8,23,11,16,6,23,29,16,7,2,7,16,75
401405797,Wake Forest Demon Deacons,D. Walton,4066353,,True,27.0,4,8,4,7,0,1,2,3,1,2,3,0,0,1,1,4,10
401405797,Wake Forest Demon Deacons,I. Mucius,4395686,,True,24.0,1,6,0,0,1,6,0,0,0,1,1,1,0,1,1,2,3
401405797,Wake Forest Demon Deacons,J. LaRavia,4592691,,True,43.0,9,13,8,11,1,2,2,5,1,6,7,4,4,3,6,4,21
401405797,Wake Forest Demon Deacons,A. Williams,4592216,,True,38.0,6,14,6,11,0,3,5,7,2,1,3,4,2,0,5,5,17
401405797,Wake Forest Demon Deacons,D. Williamson,4398180,,True,38.0,1,8,1,4,0,4,2,4,0,2,2,2,0,0,1,5,4
401405797,Wake Forest Demon Deacons,K. Sy,4065740,,False,19.0,3,5,3,5,0,0,0,2,2,4,6,1,1,0,2,1,6
401405797,Wake Forest Demon Deacons,C. Hildreth,4696316,,False,15.0,1,2,1,2,0,0,2,3,0,3,3,2,1,0,0,1,4
401405797,Wake Forest Demon Deacons,D. Monsanto,4432916,,False,21.0,4,8,0,2,4,6,0,0,3,1,4,0,2,0,0,4,12
401405797,Wake Forest Demon Deacons,TEAM,TOTAL,TOTAL,False,,29,64,23,42,6,22,13,24,10,23,33,14,10,5,17,26,77
401405797,Boston College Eagles,J. Karnik,4280080,,True,20.0,3,6,3,5,0,1,2,4,1,6,7,1,0,0,0,3,8
401405797,Boston College Eagles,Q. Post,4593016,,True,34.0,7,12,6,11,1,1,2,2,1,5,6,0,4,2,3,1,17
401405797,Boston College Eagles,J. Zackery,4896615,,True,30.0,3,7,1,3,2,4,4,6,0,3,3,2,1,0,2,4,12
401405797,Boston College Eagles,D. Langford Jr.,4433165,,True,38.0,6,14,6,13,0,1,7,10,2,2,4,3,0,0,6,3,19
401405797,Boston College Eagles,M. Ashton-Langford,4278574,,True,44.0,5,7,4,4,1,3,2,4,1,6,7,5,2,0,3,2,13
401405797,Boston College Eagles,T.J. Bickerstaff,4592778,,False,24.0,0,0,0,0,0,0,2,2,1,4,5,2,1,0,1,2,2
401405797,Boston College Eagles,K. Jones,4791225,,False,3.0,0,0,0,0,0,0,0,0,0,0,0,0,0,0,0,1,0
401405797,Boston College Eagles,B. Galloway,4067219,,False,32.0,2,6,0,2,2,4,5,6,0,1,1,1,0,0,1,2,11
401405797,Boston College Eagles,TEAM,TOTAL,TOTAL,False,,26,52,20,38,6,14,24,34,6,29,35,14,8,2,17,18,82
401405796,Syracuse Orange,C. Swider,4397134,,True,28.0,9,15,5,9,4,6,6,6,3,10,13,0,1,1,0,2,28
401405796,Syracuse Orange,J. Boeheim,4279472,,True,22.0,6,9,6,8,0,1,0,0,1,5,6,2,0,0,1,2,12
401405796,Syracuse Orange,B. Sidibe,4278033,,True,8.0,1,2,1,2,0,0,0,0,1,2,3,0,0,1,1,4,2
401405796,Syracuse Orange,J. Girard III,4431746,,True,32.0,6,15,2,4,4,11,0,1,0,1,1,4,1,0,1,1,16
401405796,Syracuse Orange,B. Boeheim,4395676,,True,33.0,5,14,2,5,3,9,1,2,0,2,2,3,1,0,2,0,14
401405796,Syracuse Orange,J. Ajak,4592369,,False,6.0,0,1,0,1,0,0,0,0,1,2,3,0,0,0,1,0,0
401405796,Syracuse Orange,C. Owens,4691167,,False,3.0,1,1,1,1,0,0,0,0,0,1,1,0,0,0,0,1,2
401405796,Syracuse Orange,N. Giancola,4592370,,False,1.0,0,0,0,0,0,0,0,0,0,2,2,0,0,0,0,0,0
401405796,Syracuse Orange,F. Anselem,4701842,,False,31.0,4,7,4,7,0,0,1,2,9,6,15,4,1,3,0,3,9
401405796,Syracuse Orange,N. Ruffin,4897403,,False,1.0,0,1,0,1,0,0,0,0,0,0,0,0,0,0,0,0,0
401405796,Syracuse Orange,P. Casey,4897402,,False,4.0,1,2,1,1,0,1,0,0,0,0,0,1,0,0,0,0,2
401405796,Syracuse Orange,A. Cordes,4701843,,False,1.0,0,2,0,2,0,0,0,0,0,0,0,0,0,0,0,0,0
401405796,Syracuse Orange,C. LaValle,4592371,,False,1.0,1,1,1,1,0,0,0,0,0,0,0,0,0,0,0,0,2
401405796,Syracuse Orange,S. Torrence,4431696,,False,29.0,4,4,4,4,0,0,1,1,0,3,3,9,2,0,1,1,9
401405796,Syracuse Orange,TEAM,TOTAL,TOTAL,False,,38,74,27,46,11,28,9,12,15,37,52,23,6,5,7,14,96
401405796,Florida State Seminoles,J. Butler,4432588,,True,26.0,2,8,1,4,1,4,1,2,1,4,5,2,0,2,1,3,6
401405796,Florida State Seminoles,T. Ngom,4701240,,True,13.0,4,6,4,6,0,0,1,2,2,2,4,0,0,0,2,1,9
401405796,Florida State Seminoles,W. Wilkes,4277855,,True,15.0,1,4,1,1,0,3,0,1,1,0,1,2,1,0,0,0,2
401405796,Florida State Seminoles,R. Evans,4592190,,True,26.0,1,7,1,4,0,3,2,2,1,3,4,5,3,0,1,2,4
401405796,Florida State Seminoles,A. Polite,4277852,,True,27.0,2,7,2,5,0,2,4,4,3,4,7,3,0,2,0,2,8
401405796,Florida State Seminoles,H. Prieto,4277856,,False,15.0,2,6,2,5,0,1,0,0,1,0,1,0,0,1,0,0,4
401405796,Florida State Seminoles,Q. Ballard,4683134,,False,4.0,1,2,1,2,0,0,2,2,0,1,1,0,0,1,0,0,4
401405796,Florida State Seminoles,M. Cleveland,4897007,,False,29.0,6,13,6,11,0,2,1,2,2,1,3,1,0,1,2,2,13
401405796,Florida State Seminoles,M. Thorpe,4701242,,False,1.0,0,0,0,0,0,0,0,1,0,0,0,0,0,0,0,0,0
401405796,Florida State Seminoles,I. Spainhour,4701241,,False,1.0,0,1,0,0,0,1,0,0,0,1,1,0,0,0,0,0,0
401405796,Florida State Seminoles,J. Warley,4683147,,False,18.0,1,3,1,1,0,2,0,0,0,1,1,1,1,0,1,0,2
401405796,Florida State Seminoles,C. Mills,4412211,,False,24.0,2,11,1,4,1,7,0,0,0,3,3,2,0,0,1,1,5
401405796,Florida State Seminoles,J. Lindner,4277853,,False,1.0,0,0,0,0,0,0,0,0,0,0,0,0,0,0,0,0,0
401405796,Florida State Seminoles,TEAM,TOTAL,TOTAL,False,,22,68,20,43,2,25,11,16,13,22,35,16,5,7,8,11,57
401405795,Louisville Cardinals,S. Curry,4897146,,True,25.0,5,9,5,9,0,0,2,5,3,3,6,1,0,0,1,3,12
401405795,Louisville Cardinals,M. Williams,4277880,,True,34.0,6,13,6,9,0,4,2,2,2,8,10,2,0,1,3,3,14
401405795,Louisville Cardinals,N. Locke,4395713,,True,37.0,6,16,2,4,4,12,0,0,2,5,7,4,0,0,0,1,16
401405795,Louisville Cardinals,J. West,4279077,,True,39.0,6,8,2,2,4,6,4,5,0,0,0,3,4,0,0,2,20
401405795,Louisville Cardinals,M. Faulkner,4067444,,True,21.0,2,3,0,0,2,3,0,0,1,0,1,1,0,0,2,5,6
401405795,Louisville Cardinals,S. Williamson,4431676,,False,20.0,3,5,3,5,0,0,0,0,2,3,5,1,1,0,1,2,6
401405795,Louisville Cardinals,E. Ellis,4897145,,False,24.0,2,8,1,5,1,3,5,6,1,4,5,6,0,0,2,2,10
401405795,Louisville Cardinals,TEAM,TOTAL,TOTAL,False,,30,62,19,34,11,28,13,18,12,26,38,18,5,1,9,18,84
401405795,Georgia Tech Yellow Jackets,R. Howard,4433010,,True,19.0,2,3,2,3,0,0,0,0,0,5,5,3,0,0,1,4,4
401405795,Georgia Tech Yellow Jackets,J. Moore,4701819,,True,14.0,1,2,1,2,0,0,0,0,1,1,2,0,0,0,1,3,2
401405795,Georgia Tech Yellow Jackets,M. Kelly,4696317,,True,31.0,7,9,4,5,3,4,2,2,0,0,0,1,1,0,0,1,19
401405795,Georgia Tech Yellow Jackets,D. Coleman,4433595,,True,25.0,0,2,0,1,0,1,2,4,0,4,4,2,0,0,1,0,2
401405795,Georgia Tech Yellow Jackets,K. Sturdivant,4431774,,True,25.0,4,9,3,6,1,3,0,0,0,3,3,1,0,0,0,2,9
401405795,Georgia Tech Yellow Jackets,J. Meka,4432485,,False,6.0,0,1,0,1,0,0,0,0,0,0,0,1,0,0,1,2,0
401405795,Georgia Tech Yellow Jackets,K. Moore,4395632,,False,23.0,2,4,2,3,0,1,0,0,2,3,5,0,2,0,0,2,4
401405795,Georgia Tech Yellow Jackets,M. Devoe,4395631,,False,24.0,5,13,4,9,1,4,4,5,0,1,1,0,2,0,4,3,15
401405795,Georgia Tech Yellow Jackets,J. Usher,4278532,,False,33.0,6,14,3,9,3,5,4,4,2,4,6,9,2,0,1,2,19
401405795,Georgia Tech Yellow Jackets,TEAM,TOTAL,TOTAL,False,,27,57,19,39,8,18,12,15,5,23,28,17,7,0,10,19,74
401405794,NC State Wolfpack,E. Dowuona,4432447,,True,21.0,3,5,3,5,0,0,0,0,1,1,2,0,0,1,0,3,6
401405794,NC State Wolfpack,J. Hellems,4395661,,True,40.0,3,13,0,5,3,8,4,5,1,7,8,0,3,0,1,4,13
401405794,NC State Wolfpack,T. Smith,4683940,,True,29.0,2,13,2,6,0,7,3,3,2,2,4,4,0,0,2,3,7
401405794,NC State Wolfpack,D. Seabron,4431811,,True,38.0,5,16,5,14,0,2,9,11,3,9,12,6,1,2,1,4,19
401405794,NC State Wolfpack,C. Morsell,4431704,,True,34.0,3,10,2,4,1,6,0,2,0,5,5,1,2,0,0,3,7
401405794,NC State Wolfpack,J. Gibson,4576139,,False,19.0,4,4,4,4,0,0,0,1,0,5,5,0,0,0,0,1,8
401405794,NC State Wolfpack,C. Hayes,4701837,,False,7.0,0,0,0,0,0,0,0,0,0,0,0,2,0,0,1,0,0
401405794,NC State Wolfpack,B. Pass,4697269,,False,12.0,2,2,2,2,0,0,0,0,0,0,0,0,0,0,1,2,4
401405794,NC State Wolfpack,TEAM,TOTAL,TOTAL,False,,22,63,18,40,4,23,16,22,10,31,41,13,6,3,7,20,64
401405794,Clemson Tigers,H. Tyson,4395620,,True,23.0,2,7,2,4,0,3,2,2,3,4,7,2,2,0,1,2,6
401405794,Clemson Tigers,PJ Hall,4701225,,True,32.0,7,12,7,10,0,2,4,6,3,7,10,3,0,4,3,4,18
401405794,Clemson Tigers,C. Hunter,4592184,,True,20.0,2,5,1,2,1,3,3,4,0,1,1,4,1,0,1,4,8
401405794,Clemson Tigers,N. Honor,4396810,,True,35.0,5,11,3,6,2,5,1,2,0,1,1,0,0,0,1,1,13
401405794,Clemson Tigers,D. Collins,4278306,,True,21.0,2,6,2,5,0,1,3,6,1,9,10,0,0,0,0,4,7
401405794,Clemson Tigers,I. Schieffelin,4693954,,False,6.0,0,2,0,2,0,0,0,0,1,2,3,0,0,0,0,2,0
401405794,Clemson Tigers,B. Middlebrooks,4684998,,False,2.0,0,0,0,0,0,0,0,0,0,1,1,0,0,0,1,1,0
401405794,Clemson Tigers,N. Bohannon,4285366,,False,24.0,3,6,3,6,0,0,0,0,2,2,4,0,1,0,0,1,6
401405794,Clemson Tigers,A. Hemenway,4433001,,False,11.0,0,2,0,1,0,1,0,1,0,0,0,1,0,0,0,1,0
401405794,Clemson Tigers,A. Dawes,4431730,,False,26.0,4,9,1,1,3,8,1,2,0,3,3,0,0,0,2,0,12
401405794,Clemson Tigers,TEAM,TOTAL,TOTAL,False,,25,60,19,37,6,23,14,23,11,35,46,10,4,4,10,20,70
401405793,Pittsburgh Panthers,M. Gueye,4592933,,True,40.0,4,10,2,5,2,5,2,4,1,5,6,3,1,1,1,2,12
401405793,Pittsburgh Panthers,J. Hugley,4432897,,True,33.0,7,12,7,11,0,1,1,2,2,6,8,2,0,1,3,4,15
401405793,Pittsburgh Panthers,F. Odukale,4701839,,True,19.0,0,4,0,3,0,1,0,0,1,1,2,1,0,0,3,4,0
401405793,Pittsburgh Panthers,I. Horton,4397401,,True,36.0,3,8,3,6,0,2,0,0,0,2,2,2,1,0,2,1,6
401405793,Pittsburgh Panthers,J. Burton,4396677,,True,34.0,4,9,3,8,1,1,1,2,0,3,3,2,3,0,2,4,10
401405793,Pittsburgh Panthers,A. Fisch,4701840,,False,1.0,0,0,0,0,0,0,0,0,0,0,0,0,0,0,0,0,0
401405793,Pittsburgh Panthers,N. Santos,4433585,,False,8.0,0,2,0,1,0,1,0,0,0,0,0,0,0,0,1,0,0
401405793,Pittsburgh Panthers,N. Collier,4432204,,False,7.0,0,0,0,0,0,0,1,2,0,0,0,0,1,0,0,1,1
401405793,Pittsburgh Panthers,W. Jeffress,4701841,,False,7.0,0,0,0,0,0,0,2,2,0,0,0,0,1,0,1,1,2
401405793,Pittsburgh Panthers,O. Ezeakudo,4409403,,False,15.0,0,0,0,0,0,0,0,0,1,1,2,0,0,0,0,1,0
401405793,Pittsburgh Panthers,TEAM,TOTAL,TOTAL,False,,18,45,15,34,3,11,7,12,6,20,26,10,7,2,14,18,46
401405793,Boston College Eagles,J. Karnik,4280080,,True,27.0,6,8,5,5,1,3,0,0,0,4,4,3,0,0,1,2,13
401405793,Boston College Eagles,Q. Post,4593016,,True,20.0,3,6,1,3,2,3,3,4,0,3,3,0,2,1,1,3,11
401405793,Boston College Eagles,J. Zackery,4896615,,True,32.0,2,5,1,3,1,2,3,4,0,1,1,2,1,0,5,2,8
401405793,Boston College Eagles,D. Langford Jr.,4433165,,True,37.0,5,9,5,9,0,0,2,2,0,5,5,4,1,0,0,0,12
401405793,Boston College Eagles,M. Ashton-Langford,4278574,,True,30.0,3,6,2,3,1,3,2,3,0,2,2,2,3,0,2,1,9
401405793,Boston College Eagles,G. Thompson,4684304,,False,4.0,0,1,0,1,0,0,0,0,0,0,0,0,0,0,0,1,0
401405793,Boston College Eagles,T.J. Bickerstaff,4592778,,False,15.0,0,0,0,0,0,0,2,2,1,3,4,5,0,0,0,1,2
401405793,Boston College Eagles,J. Vander Baan,4701168,,False,1.0,0,0,0,0,0,0,0,0,0,0,0,0,0,0,0,0,0
401405793,Boston College Eagles,K. Jones,4791225,,False,9.0,1,1,1,1,0,0,0,2,0,1,1,0,0,0,1,0,2
401405793,Boston College Eagles,Q. Pemberton,4714770,,False,1.0,0,0,0,0,0,0,0,0,0,0,0,0,0,0,0,0,0
401405793,Boston College Eagles,A. Atiyeh,4701167,,False,1.0,0,0,0,0,0,0,0,0,0,0,0,0,1,0,0,0,0
401405793,Boston College Eagles,B. Galloway,4067219,,False,23.0,3,7,1,3,2,4,1,1,0,3,3,1,1,0,2,1,9
401405793,Boston College Eagles,TEAM,TOTAL,TOTAL,False,,23,43,16,28,7,15,13,18,2,23,25,17,9,1,12,11,66
401403491,Saint Mary's Gaels,K. Bowen,4431902,,True,27.0,2,5,1,1,1,4,0,0,0,5,5,0,0,1,0,5,5
401403491,Saint Mary's Gaels,M. Tass,4397724,,True,35.0,5,8,5,8,0,0,2,2,1,0,1,1,1,0,4,5,12
401403491,Saint Mary's Gaels,A. Ducas,4432971,,True,35.0,3,7,1,3,2,4,2,2,0,3,3,1,1,0,2,1,10
401403491,Saint Mary's Gaels,L. Johnson,4396608,,True,36.0,9,14,9,14,0,0,3,4,0,3,3,2,1,1,3,4,21
401403491,Saint Mary's Gaels,T. Kuhse,4066735,,True,40.0,6,15,4,11,2,4,1,2,2,5,7,2,2,0,1,1,15
401403491,Saint Mary's Gaels,D. Fotu,4397722,,False,15.0,2,6,2,3,0,3,2,2,0,1,1,0,0,0,0,0,6
401403491,Saint Mary's Gaels,M. Saxen,4701182,,False,3.0,0,0,0,0,0,0,0,0,1,1,2,0,0,0,0,1,0
401403491,Saint Mary's Gaels,A. Marciulionis,4897197,,False,4.0,0,0,0,0,0,0,0,0,0,0,0,2,0,0,0,1,0
401403491,Saint Mary's Gaels,J. Mullins,4701181,,False,5.0,0,2,0,1,0,1,0,0,1,0,1,0,0,0,0,0,0
401403491,Saint Mary's Gaels,TEAM,TOTAL,TOTAL,False,,27,57,22,41,5,16,10,12,8,20,28,8,5,2,12,18,69
401403491,Gonzaga Bulldogs,D. Timme,4431695,,True,30.0,4,6,4,6,0,0,2,3,0,4,4,2,0,0,3,1,10
401403491,Gonzaga Bulldogs,C. Holmgren,4433255,,True,26.0,3,9,3,5,0,4,2,2,1,7,8,1,2,1,3,4,8
401403491,Gonzaga Bulldogs,J. Strawther,4432181,,True,36.0,5,6,2,3,3,3,3,4,0,2,2,1,0,0,0,2,16
401403491,Gonzaga Bulldogs,R. Bolton,4397242,,True,30.0,5,8,3,5,2,3,6,7,0,2,2,1,1,0,2,4,18
401403491,Gonzaga Bulldogs,A. Nembhard,4395712,,True,40.0,8,16,5,11,3,5,0,0,0,3,3,7,2,0,1,3,19
401403491,Gonzaga Bulldogs,A. Watson,4431705,,False,24.0,5,6,5,6,0,0,0,0,2,3,5,0,0,0,0,1,10
401403491,Gonzaga Bulldogs,N. Hickman,4683737,,False,7.0,0,0,0,0,0,0,0,0,0,0,0,0,0,0,0,1,0
401403491,Gonzaga Bulldogs,H. Sallis,4433281,,False,7.0,0,1,0,0,0,1,1,2,0,0,0,1,0,0,0,1,1
401403491,Gonzaga Bulldogs,TEAM,TOTAL,TOTAL,False,,30,52,22,36,8,16,14,18,4,23,27,13,5,1,9,17,82
401403490,Santa Clara Broncos,K. Justice,4397751,,True,36.0,6,12,2,6,4,6,5,6,1,1,2,0,0,0,0,2,21
401403490,Santa Clara Broncos,P. Braun,4396957,,True,8.0,0,0,0,0,0,0,0,0,0,0,0,0,0,0,0,0,0
401403490,Santa Clara Broncos,J. Vrankic,4280250,,True,36.0,8,13,8,12,0,1,5,6,4,4,8,1,1,1,0,3,21
401403490,Santa Clara Broncos,J. Williams,4593803,,True,38.0,6,17,5,13,1,4,2,6,0,3,3,6,2,1,2,3,15
401403490,Santa Clara Broncos,PJ Pipes,4279237,,True,34.0,2,10,2,9,0,1,0,0,0,2,2,0,0,0,0,2,4
401403490,Santa Clara Broncos,J. Holt,4897210,,False,8.0,2,2,2,2,0,0,3,5,1,5,6,0,0,0,0,1,7
401403490,Santa Clara Broncos,J. Bediako,4431889,,False,28.0,2,7,2,7,0,0,0,0,6,6,12,2,0,5,0,2,4
401403490,Santa Clara Broncos,C. Stewart,4683956,,False,6.0,0,1,0,1,0,0,0,0,0,0,0,1,0,0,1,1,0
401403490,Santa Clara Broncos,G. Williams,4432146,,False,6.0,0,2,0,1,0,1,0,0,0,1,1,0,0,0,0,0,0
401403490,Santa Clara Broncos,TEAM,TOTAL,TOTAL,False,,26,64,21,51,5,13,15,23,13,22,35,10,3,7,3,14,72
401403490,Saint Mary's Gaels,K. Bowen,4431902,,True,25.0,2,3,0,0,2,3,0,0,0,6,6,1,0,1,0,4,6
401403490,Saint Mary's Gaels,M. Tass,4397724,,True,33.0,8,11,8,10,0,1,2,3,1,6,7,3,0,0,4,4,18
401403490,Saint Mary's Gaels,A. Ducas,4432971,,True,34.0,1,5,1,3,0,2,3,5,1,3,4,1,0,1,0,3,5
401403490,Saint Mary's Gaels,L. Johnson,4396608,,True,37.0,5,12,5,12,0,0,4,4,1,6,7,2,0,1,0,3,14
401403490,Saint Mary's Gaels,T. Kuhse,4066735,,True,40.0,11,18,8,15,3,3,2,2,2,3,5,4,1,0,2,2,27
401403490,Saint Mary's Gaels,D. Fotu,4397722,,False,15.0,1,4,0,1,1,3,2,2,0,1,1,0,0,0,0,1,5
401403490,Saint Mary's Gaels,M. Saxen,4701182,,False,7.0,0,3,0,3,0,0,0,0,1,1,2,0,0,2,0,2,0
401403490,Saint Mary's Gaels,A. Marciulionis,4897197,,False,3.0,0,0,0,0,0,0,0,0,0,1,1,0,0,0,0,1,0
401403490,Saint Mary's Gaels,J. Mullins,4701181,,False,6.0,0,1,0,0,0,1,0,0,0,1,1,0,0,0,0,0,0
401403490,Saint Mary's Gaels,TEAM,TOTAL,TOTAL,False,,28,57,22,44,6,13,13,16,8,30,38,11,1,5,8,20,75
401403489,San Francisco Dons,J. Kunen,4432026,,True,28.0,2,4,1,2,1,2,1,2,1,3,4,3,0,0,1,1,6
401403489,San Francisco Dons,P. Tapé,4066805,,True,27.0,1,3,1,3,0,0,3,4,1,5,6,1,1,1,0,3,5
401403489,San Francisco Dons,K. Shabazz,4397745,,True,34.0,10,25,5,10,5,15,2,2,1,2,3,2,3,0,3,4,27
401403489,San Francisco Dons,J. Bouyea,4280245,,True,38.0,1,11,1,4,0,7,3,6,2,3,5,2,4,1,2,3,5
401403489,San Francisco Dons,G. Stefanini,4279467,,True,19.0,2,5,0,2,2,3,0,0,0,0,0,0,1,0,5,2,6
401403489,San Francisco Dons,N. Newbury,4875213,,False,2.0,0,0,0,0,0,0,0,0,0,0,0,0,0,0,0,0,0
401403489,San Francisco Dons,Z. Meeks,4593064,,False,10.0,0,2,0,0,0,2,0,0,0,2,2,0,0,0,0,1,0
401403489,San Francisco Dons,V. Markovetskyy,4592672,,False,13.0,1,2,1,2,0,0,0,0,1,0,1,0,1,0,0,2,2
401403489,San Francisco Dons,J. Rishwain,4431875,,False,29.0,7,11,4,6,3,5,3,4,3,5,8,1,1,0,1,2,20
401403489,San Francisco Dons,TEAM,TOTAL,TOTAL,False,,24,63,13,29,11,34,12,18,11,20,31,9,11,2,12,18,71
401403489,Gonzaga Bulldogs,D. Timme,4431695,,True,25.0,9,13,9,13,0,0,4,5,1,3,4,4,0,1,2,4,22
401403489,Gonzaga Bulldogs,C. Holmgren,4433255,,True,30.0,7,10,6,6,1,4,2,3,0,8,8,1,3,6,2,4,17
401403489,Gonzaga Bulldogs,J. Strawther,4432181,,True,26.0,0,3,0,2,0,1,5,6,1,1,2,0,0,0,1,2,5
401403489,Gonzaga Bulldogs,R. Bolton,4397242,,True,26.0,3,6,2,2,1,4,3,4,0,1,1,0,0,0,2,4,10
401403489,Gonzaga Bulldogs,A. Nembhard,4395712,,True,40.0,8,12,7,10,1,2,0,0,0,2,2,9,0,0,1,2,17
401403489,Gonzaga Bulldogs,A. Watson,4431705,,False,25.0,4,7,4,6,0,1,0,0,2,8,10,3,1,1,4,2,8
401403489,Gonzaga Bulldogs,N. Hickman,4683737,,False,14.0,0,2,0,1,0,1,0,0,0,1,1,1,0,1,0,0,0
401403489,Gonzaga Bulldogs,H. Sallis,4433281,,False,14.0,1,2,1,2,0,0,0,0,0,0,0,2,0,0,1,1,2
401403489,Gonzaga Bulldogs,TEAM,TOTAL,TOTAL,False,,32,55,29,42,3,13,14,18,4,30,34,20,4,9,13,19,81
401403488,Santa Clara Broncos,K. Justice,4397751,,True,33.0,5,10,1,2,4,8,2,2,0,7,7,0,0,0,1,0,16
401403488,Santa Clara Broncos,P. Braun,4396957,,True,32.0,2,3,2,3,0,0,0,0,1,4,5,0,0,3,3,3,4
401403488,Santa Clara Broncos,J. Vrankic,4280250,,True,32.0,7,10,4,6,3,4,2,2,1,6,7,5,0,1,2,2,19
401403488,Santa Clara Broncos,J. Williams,4593803,,True,32.0,9,13,5,7,4,6,2,2,0,3,3,6,0,1,1,3,24
401403488,Santa Clara Broncos,PJ Pipes,4279237,,True,31.0,6,13,4,6,2,7,7,8,0,5,5,5,2,0,3,3,21
401403488,Santa Clara Broncos,J. Holt,4897210,,False,8.0,1,1,1,1,0,0,0,0,0,1,1,0,0,0,1,2,2
401403488,Santa Clara Broncos,C. Tongue,4684310,,False,3.0,0,0,0,0,0,0,0,0,0,1,1,0,0,0,1,1,0
401403488,Santa Clara Broncos,J. Bediako,4431889,,False,6.0,1,3,1,3,0,0,0,0,2,4,6,0,0,0,1,4,2
401403488,Santa Clara Broncos,C. Stewart,4683956,,False,9.0,0,3,0,2,0,1,3,4,0,2,2,0,1,0,2,3,3
401403488,Santa Clara Broncos,M. Tomley,4433104,,False,3.0,0,0,0,0,0,0,0,0,0,1,1,0,0,0,0,0,0
401403488,Santa Clara Broncos,G. Williams,4432146,,False,11.0,0,2,0,1,0,1,0,0,0,0,0,0,1,0,1,1,0
401403488,Santa Clara Broncos,TEAM,TOTAL,TOTAL,False,,31,58,18,31,13,27,16,18,6,36,42,16,4,5,16,22,91
401403488,Portland Pilots,M. Wood,4396657,,True,34.0,3,12,2,8,1,4,2,2,1,5,6,2,1,0,1,1,9
401403488,Portland Pilots,K. Sjolund,4395633,,True,28.0,3,11,3,6,0,5,1,1,1,2,3,0,2,0,1,0,7
401403488,Portland Pilots,C. Nduka,4897190,,True,29.0,3,8,3,8,0,0,1,3,4,2,6,1,0,0,1,2,7
401403488,Portland Pilots,T. Robertson,4592580,,True,35.0,5,16,3,13,2,3,2,3,0,6,6,1,0,0,1,1,14
401403488,Portland Pilots,C. Austin,4396811,,True,33.0,7,15,5,11,2,4,3,4,1,2,3,0,1,0,3,1,19
401403488,Portland Pilots,M. Svetozarevic,4897189,,False,12.0,1,3,1,3,0,0,0,0,1,1,2,0,0,0,0,3,2
401403488,Portland Pilots,M. Silveira,4398045,,False,5.0,1,1,1,1,0,0,0,1,0,0,0,0,0,0,1,0,2
401403488,Portland Pilots,V. Vucinic,4897191,,False,12.0,1,3,1,3,0,0,3,4,0,1,1,1,1,1,3,0,5
401403488,Portland Pilots,N. Milosevic,4897187,,False,3.0,0,0,0,0,0,0,0,0,0,1,1,0,0,0,1,2,0
401403488,Portland Pilots,Y. Harvey,4897184,,False,9.0,1,2,1,2,0,0,0,0,1,1,2,1,1,0,0,4,2
401403488,Portland Pilots,TEAM,TOTAL,TOTAL,False,,25,71,20,55,5,16,12,18,14,22,36,6,6,1,12,14,67
401403487,San Francisco Dons,Y. Massalski,4285624,,True,26.0,3,7,3,7,0,0,2,3,4,5,9,0,0,0,1,4,8
401403487,San Francisco Dons,P. Tapé,4066805,,True,25.0,1,4,1,3,0,1,4,6,3,4,7,0,1,2,0,0,6
401403487,San Francisco Dons,K. Shabazz,4397745,,True,36.0,7,15,2,6,5,9,3,4,0,4,4,2,0,0,2,4,22
401403487,San Francisco Dons,J. Bouyea,4280245,,True,40.0,7,16,6,10,1,6,3,3,0,6,6,4,3,1,2,3,18
401403487,San Francisco Dons,G. Stefanini,4279467,,True,20.0,4,8,3,5,1,3,1,2,0,2,2,2,1,0,1,5,10
401403487,San Francisco Dons,Z. Meeks,4593064,,False,2.0,0,0,0,0,0,0,0,0,0,0,0,0,0,0,0,0,0
401403487,San Francisco Dons,J. Kunen,4432026,,False,12.0,0,1,0,1,0,0,4,8,0,3,3,0,0,0,0,4,4
401403487,San Francisco Dons,V. Markovetskyy,4592672,,False,15.0,1,2,1,2,0,0,1,2,0,4,4,0,0,1,1,1,3
401403487,San Francisco Dons,J. Rishwain,4431875,,False,24.0,1,3,1,2,0,1,2,2,0,1,1,0,1,0,1,4,4
401403487,San Francisco Dons,TEAM,TOTAL,TOTAL,False,,24,56,17,36,7,20,20,30,9,32,41,8,6,4,8,25,75
401403487,BYU Cougars,G. George,4701218,,True,30.0,1,7,1,3,0,4,4,6,1,1,2,1,0,1,1,2,6
401403487,BYU Cougars,C. Lohner,4432208,,True,27.0,0,6,0,2,0,4,0,1,2,7,9,0,0,0,1,4,0
401403487,BYU Cougars,F. Traore,4712348,,True,34.0,6,11,6,11,0,0,4,5,1,11,12,0,2,1,3,4,16
401403487,BYU Cougars,A. Barcello,4278130,,True,35.0,5,12,4,7,1,5,7,9,0,2,2,3,1,0,4,4,18
401403487,BYU Cougars,T. Lucas,4066357,,True,26.0,4,11,4,9,0,2,0,0,0,1,1,4,1,0,1,4,8
401403487,BYU Cougars,A. Ally Atiki,4896973,,False,6.0,1,2,1,2,0,0,0,0,2,1,3,0,0,0,0,1,2
401403487,BYU Cougars,S. Johnson,4701219,,False,27.0,4,4,2,2,2,2,1,4,0,3,3,0,0,0,0,2,11
401403487,BYU Cougars,T. Knell,4593744,,False,15.0,1,5,1,2,0,3,0,0,1,0,1,1,0,0,1,3,2
401403487,BYU Cougars,TEAM,TOTAL,TOTAL,False,,22,58,19,38,3,20,16,25,9,28,37,9,4,2,11,24,63
401403486,San Diego Toreros,Y. Gultekin,4432878,,True,35.0,1,8,1,5,0,3,0,0,0,8,8,3,0,0,1,1,2
401403486,San Diego Toreros,V. Pinchuk,4278701,,True,15.0,4,8,4,8,0,0,1,1,1,4,5,0,1,1,0,3,9
401403486,San Diego Toreros,M. Earlington,4397124,,True,26.0,2,10,1,6,1,4,1,1,3,2,5,0,0,0,1,3,6
401403486,San Diego Toreros,J. Townsend,4398060,,True,34.0,6,15,5,10,1,5,4,5,1,7,8,3,0,0,1,4,17
401403486,San Diego Toreros,J. Calcaterra,4280214,,True,28.0,2,8,2,5,0,3,0,0,0,0,0,2,1,0,1,2,4
401403486,San Diego Toreros,T. Brown,4278018,,False,24.0,7,10,7,10,0,0,0,0,5,7,12,0,0,2,2,4,14
401403486,San Diego Toreros,M. Reath,4897206,,False,1.0,0,0,0,0,0,0,0,0,0,0,0,0,0,0,0,0,0
401403486,San Diego Toreros,P. Caero,4897205,,False,1.0,0,0,0,0,0,0,0,0,0,0,0,0,1,0,0,0,0
401403486,San Diego Toreros,D. Muncey,4897203,,False,1.0,0,0,0,0,0,0,0,0,0,0,0,0,0,0,0,0,0
401403486,San Diego Toreros,W. McKinney III,4897202,,False,29.0,1,4,0,0,1,4,0,0,0,0,0,0,0,0,1,2,3
401403486,San Diego Toreros,S. Prunty,4701194,,False,1.0,0,1,0,0,0,1,0,0,0,0,0,0,0,0,0,0,0
401403486,San Diego Toreros,T.J. Berger,4433589,,False,5.0,0,0,0,0,0,0,0,0,0,0,0,0,0,0,0,1,0
401403486,San Diego Toreros,TEAM,TOTAL,TOTAL,False,,23,64,20,44,3,20,6,7,11,30,41,8,3,3,7,20,55
401403486,Portland Pilots,C. Nduka,4897190,,True,35.0,7,11,7,11,0,0,0,1,4,3,7,1,1,0,2,2,14
401403486,Portland Pilots,M. Wood,4396657,,True,39.0,9,15,4,7,5,8,5,8,0,4,4,3,0,1,0,0,28
401403486,Portland Pilots,K. Sjolund,4395633,,True,39.0,5,11,3,7,2,4,2,3,2,9,11,3,0,0,0,3,14
401403486,Portland Pilots,T. Robertson,4592580,,True,39.0,4,13,4,11,0,2,2,4,1,5,6,9,1,0,2,2,10
401403486,Portland Pilots,C. Austin,4396811,,True,39.0,1,7,0,5,1,2,2,3,0,6,6,2,0,0,0,0,5
401403486,Portland Pilots,W. Watson,4397720,,False,1.0,0,0,0,0,0,0,0,0,0,0,0,0,0,0,0,0,0
401403486,Portland Pilots,M. Svetozarevic,4897189,,False,1.0,0,0,0,0,0,0,0,0,0,0,0,0,0,0,0,0,0
401403486,Portland Pilots,V. Vucinic,4897191,,False,1.0,0,0,0,0,0,0,0,0,0,0,0,0,0,0,0,0,0
401403486,Portland Pilots,N. Milosevic,4897187,,False,1.0,0,0,0,0,0,0,0,0,0,0,0,0,0,0,0,0,0
401403486,Portland Pilots,Y. Harvey,4897184,,False,5.0,1,1,1,1,0,0,0,0,0,2,2,0,0,0,1,2,2
401403486,Portland Pilots,TEAM,TOTAL,TOTAL,False,,27,58,19,42,8,16,11,19,8,30,38,18,2,1,5,9,73
401403485,Loyola Marymount Lions,A. Merkviladze,4702495,,True,33.0,1,3,0,2,1,1,0,0,0,4,4,0,1,0,0,4,3
401403485,Loyola Marymount Lions,E. Scott,4280158,,True,32.0,9,16,9,16,0,0,6,8,2,4,6,1,1,0,4,1,24
401403485,Loyola Marymount Lions,L. Lewis,4896979,,True,19.0,0,2,0,0,0,2,1,2,0,2,2,1,0,0,1,3,1
401403485,Loyola Marymount Lions,C. Shelton,4397305,,True,25.0,3,7,2,3,1,4,0,2,2,2,4,1,1,0,0,3,7
401403485,Loyola Marymount Lions,J. Quintana,4280163,,True,33.0,3,11,2,5,1,6,5,6,0,4,4,1,1,0,2,2,12
401403485,Loyola Marymount Lions,J. Anderson,4701211,,False,28.0,2,9,2,7,0,2,0,0,0,1,1,3,1,0,1,4,4
401403485,Loyola Marymount Lions,K. Marble II,4593129,,False,28.0,4,4,4,4,0,0,1,3,0,2,2,1,0,1,2,3,9
401403485,Loyola Marymount Lions,Q. Jackson Jr.,4066968,,False,2.0,0,1,0,1,0,0,0,0,0,0,0,0,0,0,1,0,0
401403485,Loyola Marymount Lions,TEAM,TOTAL,TOTAL,False,,22,53,19,38,3,15,13,21,4,21,25,8,5,1,11,20,60
401403485,BYU Cougars,G. George,4701218,,True,21.0,3,5,2,2,1,3,2,2,1,3,4,0,0,0,2,3,9
401403485,BYU Cougars,C. Lohner,4432208,,True,25.0,3,4,3,4,0,0,0,1,2,8,10,2,0,0,1,2,6
401403485,BYU Cougars,F. Traore,4712348,,True,22.0,6,8,6,8,0,0,3,4,6,5,11,1,1,1,1,2,15
401403485,BYU Cougars,A. Barcello,4278130,,True,26.0,7,13,5,9,2,4,6,7,0,3,3,3,1,0,3,1,22
401403485,BYU Cougars,T. Lucas,4066357,,True,26.0,2,9,2,7,0,2,3,4,0,1,1,4,0,0,2,4,7
401403485,BYU Cougars,A. Ally Atiki,4896973,,False,15.0,3,4,3,4,0,0,0,1,1,5,6,0,0,2,1,3,6
401403485,BYU Cougars,S. Johnson,4701219,,False,30.0,2,4,2,2,0,2,1,2,0,3,3,1,4,0,1,3,5
401403485,BYU Cougars,H. Erickson,4701217,,False,10.0,0,0,0,0,0,0,0,0,0,0,0,2,0,0,0,0,0
401403485,BYU Cougars,T. Knell,4593744,,False,25.0,6,12,4,8,2,4,1,1,0,1,1,1,0,0,1,2,15
401403485,BYU Cougars,TEAM,TOTAL,TOTAL,False,,32,59,27,44,5,15,16,22,11,33,44,14,6,3,12,20,85
401403484,San Diego Toreros,V. Pinchuk,4278701,,True,23.0,2,4,2,4,0,0,1,4,1,1,2,3,0,1,0,3,5
401403484,San Diego Toreros,M. Earlington,4397124,,True,34.0,6,16,5,11,1,5,0,1,2,11,13,5,2,1,1,2,13
401403484,San Diego Toreros,W. McKinney III,4897202,,True,18.0,3,6,2,5,1,1,2,2,2,1,3,1,0,0,2,5,9
401403484,San Diego Toreros,J. Townsend,4398060,,True,39.0,3,13,2,7,1,6,4,4,0,2,2,3,3,0,1,0,11
401403484,San Diego Toreros,J. Calcaterra,4280214,,True,32.0,6,9,3,5,3,4,5,6,0,3,3,2,0,0,3,3,20
401403484,San Diego Toreros,Y. Gultekin,4432878,,False,20.0,5,8,3,6,2,2,2,2,0,5,5,1,0,0,1,2,14
401403484,San Diego Toreros,T. Brown,4278018,,False,16.0,1,3,1,3,0,0,0,1,1,5,6,0,1,1,0,0,2
401403484,San Diego Toreros,M. Reath,4897206,,False,0.0,0,0,0,0,0,0,0,0,0,0,0,0,0,0,0,0,0
401403484,San Diego Toreros,T.J. Berger,4433589,,False,18.0,0,1,0,0,0,1,0,0,0,1,1,0,0,0,1,1,0
401403484,San Diego Toreros,TEAM,TOTAL,TOTAL,False,,26,60,18,41,8,19,14,20,6,33,39,15,6,3,9,16,74
401403484,Pepperdine Waves,C. Basham,4699582,,True,25.0,4,6,4,6,0,0,1,4,0,6,6,0,1,2,0,3,9
401403484,Pepperdine Waves,J. Zidek,4593792,,True,26.0,2,10,2,7,0,3,6,6,1,3,4,2,0,0,1,0,10
401403484,Pepperdine Waves,M. Mitchell Jr.,4897176,,True,38.0,5,12,3,8,2,4,0,1,1,9,10,8,0,0,2,3,12
401403484,Pepperdine Waves,H. Mallette,4709141,,True,36.0,5,15,3,11,2,4,0,0,1,5,6,1,0,0,2,2,12
401403484,Pepperdine Waves,J. Yoon,4397698,,True,27.0,4,7,4,5,0,2,0,0,0,4,4,2,0,0,1,3,8
401403484,Pepperdine Waves,V. Ohia Obioha,4397694,,False,10.0,1,1,1,1,0,0,0,0,2,2,4,0,0,1,2,4,2
401403484,Pepperdine Waves,K. Munson,4433229,,False,17.0,3,4,3,4,0,0,0,0,0,0,0,0,0,2,0,3,6
401403484,Pepperdine Waves,J. Smith,4280202,,False,21.0,3,7,3,7,0,0,2,4,0,0,0,2,2,0,2,2,8
401403484,Pepperdine Waves,TEAM,TOTAL,TOTAL,False,,27,62,23,49,4,13,9,15,6,30,36,15,3,5,12,20,67
401403483,Pacific Tigers,J. Bailey,4397671,,True,28.0,4,8,4,7,0,1,3,5,1,7,8,1,0,1,3,5,11
401403483,Pacific Tigers,A. Anderson,4066575,,True,30.0,5,8,4,7,1,1,2,2,1,5,6,2,0,0,2,4,13
401403483,Pacific Tigers,K. Wilson-Rouse,4897169,,True,28.0,3,6,3,5,0,1,1,2,0,2,2,2,0,0,2,3,7
401403483,Pacific Tigers,P. Crockrell II,4432962,,True,33.0,4,8,4,8,0,0,0,1,0,4,4,9,2,0,2,3,8
401403483,Pacific Tigers,L. Avdalovic,4278644,,True,34.0,3,9,1,2,2,7,0,0,0,1,1,0,1,0,2,0,8
401403483,Pacific Tigers,J. Bell,4067766,,False,1.0,0,0,0,0,0,0,1,2,0,0,0,0,0,0,0,1,1
401403483,Pacific Tigers,S. Freeman,4431771,,False,8.0,2,3,2,3,0,0,5,6,2,3,5,0,0,0,0,1,9
401403483,Pacific Tigers,J. Byers,4897170,,False,6.0,1,2,1,1,0,1,1,1,0,2,2,0,0,0,0,0,3
401403483,Pacific Tigers,N. Blake,4703391,,False,27.0,3,5,3,4,0,1,0,0,0,3,3,0,1,0,5,2,6
401403483,Pacific Tigers,J. Brown,4701210,,False,5.0,0,0,0,0,0,0,0,0,0,1,1,0,0,0,0,0,0
401403483,Pacific Tigers,TEAM,TOTAL,TOTAL,False,,25,49,22,37,3,12,13,19,4,28,32,14,4,1,17,19,66
401403483,Loyola Marymount Lions,A. Merkviladze,4702495,,True,23.0,2,5,2,2,0,3,2,3,0,4,4,0,1,0,2,3,6
401403483,Loyola Marymount Lions,E. Scott,4280158,,True,39.0,8,16,8,16,0,0,4,4,1,7,8,3,0,1,0,2,20
401403483,Loyola Marymount Lions,L. Lewis,4896979,,True,25.0,0,4,0,2,0,2,0,2,0,1,1,2,1,0,1,4,0
401403483,Loyola Marymount Lions,C. Shelton,4397305,,True,24.0,0,4,0,2,0,2,0,0,0,3,3,0,2,0,2,4,0
401403483,Loyola Marymount Lions,J. Quintana,4280163,,True,38.0,10,15,2,5,8,10,3,3,0,2,2,3,3,1,2,1,31
401403483,Loyola Marymount Lions,J. Anderson,4701211,,False,27.0,4,7,2,4,2,3,0,0,0,3,3,6,0,0,0,3,10
401403483,Loyola Marymount Lions,K. Marble II,4593129,,False,24.0,7,9,4,5,3,4,2,3,2,2,4,1,1,0,0,2,19
401403483,Loyola Marymount Lions,TEAM,TOTAL,TOTAL,False,,31,60,18,36,13,24,11,15,3,22,25,15,8,2,8,19,86
401403482,Louisiana Ragin' Cajuns,T. Akwuba,4397716,,True,28.0,3,4,3,4,0,0,0,1,1,2,3,0,0,3,2,2,6
401403482,Louisiana Ragin' Cajuns,J. Brown,4397340,,True,36.0,8,14,8,14,0,0,8,13,4,4,8,3,1,2,0,0,24
401403482,Louisiana Ragin' Cajuns,J. Dalcourt,4703343,,True,28.0,4,11,2,4,2,7,0,0,1,2,3,0,0,0,0,3,10
401403482,Louisiana Ragin' Cajuns,M. Thomas,4702105,,True,27.0,2,7,2,6,0,1,0,0,3,3,6,2,0,0,3,3,4
401403482,Louisiana Ragin' Cajuns,G. Williams Jr.,4397123,,True,35.0,4,11,1,5,3,6,4,4,0,5,5,0,1,0,2,5,15
401403482,Louisiana Ragin' Cajuns,J. Charles,4708075,,False,7.0,1,3,1,2,0,1,0,0,1,1,2,1,0,0,0,1,2
401403482,Louisiana Ragin' Cajuns,D. Gueye,4593896,,False,8.0,0,2,0,2,0,0,0,1,0,2,2,1,0,0,0,1,0
401403482,Louisiana Ragin' Cajuns,K. Garnett,4702106,,False,17.0,2,4,1,1,1,3,0,0,0,0,0,0,0,0,0,3,5
401403482,Louisiana Ragin' Cajuns,D. Cadwell,4593895,,False,2.0,0,0,0,0,0,0,0,0,0,0,0,0,0,0,1,0,0
401403482,Louisiana Ragin' Cajuns,T. Wesley,4397660,,False,12.0,1,2,1,2,0,0,3,3,2,0,2,0,0,0,1,1,5
401403482,Louisiana Ragin' Cajuns,TEAM,TOTAL,TOTAL,False,,25,58,19,40,6,18,15,22,14,21,35,7,2,5,10,19,71
401403482,Georgia State Panthers,J. Thomas,4593903,,True,30.0,5,11,5,11,0,0,2,3,0,2,2,0,1,2,0,4,12
401403482,Georgia State Panthers,E. Nsoseme,4278220,,True,34.0,5,9,5,9,0,0,2,3,6,7,13,1,0,2,1,1,12
401403482,Georgia State Panthers,J. Roberts,4397535,,True,29.0,3,6,0,2,3,4,0,0,2,5,7,6,2,0,1,3,9
401403482,Georgia State Panthers,K. Williams,4280167,,True,34.0,2,9,2,8,0,1,6,6,0,3,3,3,0,0,2,2,10
401403482,Georgia State Panthers,C. Allen,4067418,,True,36.0,6,12,1,6,5,6,12,12,0,1,1,6,1,0,1,1,29
401403482,Georgia State Panthers,J. Hudson,4897218,,False,14.0,2,5,1,3,1,2,0,0,0,2,2,1,0,0,0,3,5
401403482,Georgia State Panthers,C. Moore,4702110,,False,6.0,0,0,0,0,0,0,0,0,0,0,0,1,0,0,0,0,0
401403482,Georgia State Panthers,E. Johnson,4702109,,False,17.0,1,3,0,1,1,2,0,0,1,3,4,2,1,0,1,3,3
401403482,Georgia State Panthers,TEAM,TOTAL,TOTAL,False,,24,55,14,40,10,15,22,24,11,25,36,20,5,4,7,17,80
401403481,Georgia State Panthers,J. Thomas,4593903,,True,31.0,5,12,5,12,0,0,1,2,2,5,7,0,1,1,3,2,11
401403481,Georgia State Panthers,E. Nsoseme,4278220,,True,29.0,6,10,6,10,0,0,0,1,4,6,10,1,0,3,0,4,12
401403481,Georgia State Panthers,J. Roberts,4397535,,True,20.0,1,5,1,4,0,1,0,0,0,0,0,0,1,0,2,3,2
401403481,Georgia State Panthers,K. Williams,4280167,,True,35.0,2,8,1,6,1,2,3,4,0,3,3,6,2,1,1,0,8
401403481,Georgia State Panthers,C. Allen,4067418,,True,37.0,9,16,3,7,6,9,5,5,1,5,6,8,0,0,0,0,29
401403481,Georgia State Panthers,J. Hudson,4897218,,False,11.0,0,1,0,1,0,0,2,2,0,1,1,1,0,0,3,2,2
401403481,Georgia State Panthers,C. Moore,4702110,,False,20.0,1,1,1,1,0,0,0,0,2,1,3,0,1,1,0,1,2
401403481,Georgia State Panthers,E. Johnson,4702109,,False,17.0,1,5,0,2,1,3,2,3,0,2,2,3,0,0,0,0,5
401403481,Georgia State Panthers,TEAM,TOTAL,TOTAL,False,,25,58,17,43,8,15,13,17,12,23,35,19,5,6,11,12,71
401403481,App State Mountaineers,J. Lewis Jr.,4280003,,True,23.0,0,2,0,2,0,0,1,2,2,2,4,1,1,0,1,2,1
401403481,App State Mountaineers,D. Gregory,4432904,,True,33.0,3,6,3,6,0,0,1,3,3,2,5,5,0,1,4,4,7
401403481,App State Mountaineers,A. Delph,4397415,,True,40.0,9,21,4,11,5,10,2,2,0,5,5,1,0,1,2,4,25
401403481,App State Mountaineers,J. Forrest,4280137,,True,32.0,1,8,0,5,1,3,0,0,0,3,3,0,0,0,3,2,3
401403481,App State Mountaineers,M. Almonacy,4066766,,True,35.0,5,13,1,5,4,8,0,0,0,2,2,1,1,0,3,2,14
401403481,App State Mountaineers,C. Mantis,4897226,,False,0.0,0,0,0,0,0,0,0,0,0,0,0,0,0,0,0,0,0
401403481,App State Mountaineers,RJ Duhart,4702600,,False,25.0,2,3,2,2,0,1,3,3,4,5,9,0,1,3,1,2,7
401403481,App State Mountaineers,M. Eads Jr.,4702601,,False,12.0,2,3,0,0,2,3,0,0,0,1,1,1,0,0,0,0,6
401403481,App State Mountaineers,T. Harcum,4897227,,False,0.0,1,1,0,0,1,1,0,0,0,0,0,0,0,0,0,1,3
401403481,App State Mountaineers,TEAM,TOTAL,TOTAL,False,,23,57,10,31,13,26,7,10,13,21,34,9,3,5,15,17,66
401403480,Troy Trojans,E. Odigie,4397868,,True,26.0,4,11,4,10,0,1,1,2,1,5,6,0,0,1,2,1,9
401403480,Troy Trojans,Z. Williams,4397711,,True,14.0,1,4,1,3,0,1,0,0,0,2,2,0,0,0,0,4,2
401403480,Troy Trojans,D. Deen,4897149,,True,30.0,0,6,0,1,0,5,4,4,0,7,7,2,0,0,3,2,4
401403480,Troy Trojans,K. Punter,4702044,,True,12.0,1,2,1,1,0,1,0,0,0,0,0,1,0,0,0,1,2
401403480,Troy Trojans,D. Williams,4593930,,True,23.0,2,5,1,2,1,3,0,0,0,1,1,0,0,0,0,2,5
401403480,Troy Trojans,R. Miguel,4703533,,False,12.0,1,4,1,3,0,1,0,1,2,3,5,1,0,0,1,1,2
401403480,Troy Trojans,C. Turner,4702052,,False,6.0,0,0,0,0,0,0,0,0,1,0,1,0,0,0,1,0,0
401403480,Troy Trojans,N. Stampley,4593932,,False,14.0,0,2,0,1,0,1,0,0,1,4,5,0,0,0,1,1,0
401403480,Troy Trojans,K. Waters,4593931,,False,26.0,4,9,2,6,2,3,9,11,1,1,2,0,2,0,1,4,19
401403480,Troy Trojans,C. Eugene,4897147,,False,16.0,2,5,2,3,0,2,0,0,0,1,1,0,1,0,0,2,4
401403480,Troy Trojans,T. Smith,4703552,,False,5.0,0,0,0,0,0,0,0,0,0,0,0,0,0,0,0,0,0
401403480,Troy Trojans,D. Miles,4702049,,False,16.0,3,7,2,4,1,3,3,4,1,1,2,2,2,0,2,4,10
401403480,Troy Trojans,TEAM,TOTAL,TOTAL,False,,18,55,14,34,4,21,17,22,9,28,37,6,5,1,11,22,57
401403480,Louisiana Ragin' Cajuns,T. Akwuba,4397716,,True,30.0,5,9,5,8,0,1,5,5,2,6,8,0,1,1,0,2,15
401403480,Louisiana Ragin' Cajuns,J. Brown,4397340,,True,18.0,4,8,4,8,0,0,0,0,2,5,7,0,1,1,1,4,8
401403480,Louisiana Ragin' Cajuns,J. Dalcourt,4703343,,True,26.0,2,6,1,4,1,2,4,4,1,4,5,0,1,0,1,1,9
401403480,Louisiana Ragin' Cajuns,M. Thomas,4702105,,True,24.0,0,2,0,2,0,0,0,0,0,2,2,3,1,0,3,4,0
401403480,Louisiana Ragin' Cajuns,G. Williams Jr.,4397123,,True,34.0,5,9,3,5,2,4,4,6,0,5,5,1,1,0,1,2,16
401403480,Louisiana Ragin' Cajuns,J. Charles,4708075,,False,16.0,1,3,1,2,0,1,2,2,0,2,2,1,1,1,0,2,4
401403480,Louisiana Ragin' Cajuns,D. Gueye,4593896,,False,12.0,1,5,1,5,0,0,3,3,0,3,3,0,0,0,1,3,5
401403480,Louisiana Ragin' Cajuns,K. Garnett,4702106,,False,14.0,1,3,0,0,1,3,0,0,0,1,1,0,1,0,0,0,3
401403480,Louisiana Ragin' Cajuns,D. Cadwell,4593895,,False,9.0,0,2,0,1,0,1,0,0,0,0,0,0,0,0,0,0,0
401403480,Louisiana Ragin' Cajuns,T. Wesley,4397660,,False,17.0,2,6,2,2,0,4,2,2,0,3,3,1,0,0,2,3,6
401403480,Louisiana Ragin' Cajuns,TEAM,TOTAL,TOTAL,False,,21,53,17,37,4,16,20,22,5,32,37,6,7,3,10,21,66
401403479,Georgia Southern Eagles,P. Toyambi,4396611,,True,21.0,4,5,4,5,0,0,2,3,2,2,4,0,1,0,0,3,10
401403479,Georgia Southern Eagles,E. McCadden,4397519,,True,35.0,2,14,1,12,1,2,5,6,2,5,7,6,0,0,0,4,10
401403479,Georgia Southern Eagles,G. Juozapaitis,4596787,,True,14.0,0,2,0,1,0,1,0,0,0,0,0,0,0,0,3,1,0
401403479,Georgia Southern Eagles,T. Cobbs,4067443,,True,25.0,2,4,2,3,0,1,0,0,1,1,2,2,0,1,3,5,4
401403479,Georgia Southern Eagles,G. Weatherford,3906672,,True,8.0,0,0,0,0,0,0,0,0,0,0,0,0,2,0,0,2,0
401403479,Georgia Southern Eagles,A. Savrasov,4433073,,False,17.0,3,7,3,6,0,1,1,1,0,2,2,0,1,2,1,1,7
401403479,Georgia Southern Eagles,C. Bryant,4702115,,False,25.0,3,9,1,6,2,3,0,0,2,4,6,0,1,2,2,2,8
401403479,Georgia Southern Eagles,C. Curry,4396966,,False,3.0,0,2,0,2,0,0,0,0,1,0,1,0,0,0,0,0,0
401403479,Georgia Southern Eagles,K. Brown,4702113,,False,23.0,2,10,2,7,0,3,0,0,3,3,6,0,0,0,0,1,4
401403479,Georgia Southern Eagles,K. Archie,4397065,,False,29.0,7,13,4,9,3,4,0,0,3,2,5,2,2,0,1,3,17
401403479,Georgia Southern Eagles,TEAM,TOTAL,TOTAL,False,,23,66,17,51,6,15,8,10,14,23,37,10,7,5,12,22,60
401403479,App State Mountaineers,J. Lewis Jr.,4280003,,True,20.0,1,1,1,1,0,0,0,0,0,4,4,0,0,0,2,3,2
401403479,App State Mountaineers,D. Gregory,4432904,,True,35.0,5,9,5,9,0,0,7,9,3,6,9,3,2,0,3,2,17
401403479,App State Mountaineers,A. Delph,4397415,,True,38.0,3,12,3,8,0,4,7,8,0,3,3,1,2,0,1,2,13
401403479,App State Mountaineers,J. Forrest,4280137,,True,32.0,6,12,1,3,5,9,3,7,0,2,2,2,0,0,4,3,20
401403479,App State Mountaineers,M. Almonacy,4066766,,True,34.0,4,12,3,7,1,5,2,3,1,3,4,3,1,0,0,1,11
401403479,App State Mountaineers,C. Mantis,4897226,,False,2.0,0,0,0,0,0,0,0,0,0,0,0,0,0,0,0,0,0
401403479,App State Mountaineers,CJ Huntley,4702602,,False,7.0,2,2,2,2,0,0,1,2,1,0,1,0,0,0,1,0,5
401403479,App State Mountaineers,RJ Duhart,4702600,,False,21.0,1,2,1,2,0,0,0,0,1,4,5,1,0,4,0,1,2
401403479,App State Mountaineers,M. Eads Jr.,4702601,,False,11.0,1,2,0,1,1,1,0,0,0,5,5,1,0,0,0,1,3
401403479,App State Mountaineers,TEAM,TOTAL,TOTAL,False,,23,52,16,33,7,19,20,29,9,29,38,11,5,4,11,13,73
401403478,Georgia State Panthers,J. Thomas,4593903,,True,29.0,2,4,2,2,0,2,4,5,3,4,7,1,1,2,2,3,8
401403478,Georgia State Panthers,E. Nsoseme,4278220,,True,31.0,4,7,4,7,0,0,2,3,5,7,12,0,0,3,0,2,10
401403478,Georgia State Panthers,J. Roberts,4397535,,True,27.0,3,7,2,4,1,3,1,1,0,3,3,2,1,0,3,3,8
401403478,Georgia State Panthers,K. Williams,4280167,,True,34.0,8,13,7,10,1,3,6,9,0,3,3,1,6,0,2,3,23
401403478,Georgia State Panthers,C. Allen,4067418,,True,38.0,4,17,3,8,1,9,2,2,0,1,1,2,1,0,1,1,11
401403478,Georgia State Panthers,J. Hudson,4897218,,False,17.0,0,1,0,1,0,0,0,0,3,0,3,0,0,1,0,2,0
401403478,Georgia State Panthers,C. Moore,4702110,,False,11.0,0,4,0,3,0,1,2,2,0,2,2,1,1,0,0,4,2
401403478,Georgia State Panthers,E. Johnson,4702109,,False,12.0,1,5,0,2,1,3,0,0,0,3,3,1,0,1,1,1,3
401403478,Georgia State Panthers,K. Brooks,4593901,,False,1.0,0,0,0,0,0,0,0,0,0,0,0,0,0,0,0,0,0
401403478,Georgia State Panthers,TEAM,TOTAL,TOTAL,False,,22,58,18,37,4,21,17,22,12,24,36,8,10,7,11,19,65
401403478,Arkansas State Red Wolves,K. Wesley,4702136,,True,14.0,1,2,1,2,0,0,0,0,0,3,3,0,1,0,0,1,2
401403478,Arkansas State Red Wolves,N. Omier,4702134,,True,37.0,7,17,7,17,0,0,7,7,9,8,17,1,1,0,2,3,21
401403478,Arkansas State Red Wolves,C. Fields,4593869,,True,35.0,3,5,3,5,0,0,5,5,0,2,2,3,0,0,0,0,11
401403478,Arkansas State Red Wolves,D. Sills,4395701,,True,33.0,3,12,3,8,0,4,3,3,1,4,5,1,0,0,3,4,9
401403478,Arkansas State Red Wolves,M. Eaton,4280139,,True,34.0,2,9,1,5,1,4,0,1,0,2,2,4,2,0,5,1,5
401403478,Arkansas State Red Wolves,A. Jackson,4432004,,False,8.0,0,0,0,0,0,0,0,0,0,1,1,0,0,0,1,1,0
401403478,Arkansas State Red Wolves,M. Davis,4702130,,False,17.0,3,7,1,3,2,4,1,2,0,3,3,0,0,0,2,5,9
401403478,Arkansas State Red Wolves,A. Felts,4431959,,False,8.0,0,3,0,1,0,2,0,0,0,0,0,0,0,0,0,0,0
401403478,Arkansas State Red Wolves,M. Farrington,4431957,,False,14.0,2,4,1,1,1,3,0,0,0,4,4,0,1,0,1,3,5
401403478,Arkansas State Red Wolves,TEAM,TOTAL,TOTAL,False,,21,59,17,42,4,17,16,18,15,28,43,9,5,0,16,18,62
401403477,Troy Trojans,E. Odigie,4397868,,True,32.0,5,12,5,11,0,1,6,7,6,5,11,1,2,1,2,2,16
401403477,Troy Trojans,Z. Williams,4397711,,True,23.0,1,3,1,3,0,0,3,4,0,1,1,1,0,0,1,0,5
401403477,Troy Trojans,D. Deen,4897149,,True,30.0,4,10,0,1,4,9,3,4,0,1,1,5,2,0,2,2,15
401403477,Troy Trojans,K. Punter,4702044,,True,27.0,2,9,1,4,1,5,5,5,2,3,5,2,0,0,0,2,10
401403477,Troy Trojans,D. Williams,4593930,,True,13.0,2,3,0,0,2,3,0,0,0,1,1,0,0,0,1,0,6
401403477,Troy Trojans,N. Tshimanga,4709322,,False,1.0,0,0,0,0,0,0,0,0,0,0,0,0,0,0,1,1,0
401403477,Troy Trojans,R. Miguel,4703533,,False,7.0,1,1,1,1,0,0,0,0,0,2,2,1,0,0,0,1,2
401403477,Troy Trojans,C. Turner,4702052,,False,6.0,1,2,1,2,0,0,1,3,1,0,1,0,0,0,1,0,3
401403477,Troy Trojans,N. Stampley,4593932,,False,12.0,0,1,0,1,0,0,0,0,0,1,1,0,0,0,1,2,0
401403477,Troy Trojans,K. Waters,4593931,,False,12.0,0,2,0,1,0,1,1,2,0,0,0,1,0,0,3,2,1
401403477,Troy Trojans,C. Eugene,4897147,,False,16.0,3,4,0,1,3,3,0,0,1,0,1,0,0,0,1,0,9
401403477,Troy Trojans,D. Miles,4702049,,False,21.0,1,1,1,1,0,0,0,0,1,0,1,2,1,0,1,4,2
401403477,Troy Trojans,TEAM,TOTAL,TOTAL,False,,20,48,10,26,10,22,19,25,13,16,29,13,5,1,15,16,69
401403477,Little Rock Trojans,M. Gardner,4431772,,True,27.0,3,9,2,7,1,2,0,0,1,3,4,0,2,0,1,4,7
401403477,Little Rock Trojans,N. Maric,4397558,,True,35.0,8,14,8,14,0,0,2,4,5,4,9,4,1,0,1,3,18
401403477,Little Rock Trojans,D. Smith,4897215,,True,11.0,1,3,0,2,1,1,0,0,0,0,0,1,0,0,2,2,3
401403477,Little Rock Trojans,J. Jefferson,4897214,,True,39.0,5,7,4,5,1,2,6,7,2,3,5,0,0,0,6,2,17
401403477,Little Rock Trojans,J. Stulic,4432118,,True,29.0,3,5,0,0,3,5,0,2,1,0,1,0,0,1,2,5,9
401403477,Little Rock Trojans,A. Besovic,4278627,,False,7.0,1,3,1,3,0,0,0,0,2,1,3,0,0,1,1,0,2
401403477,Little Rock Trojans,I. Palermo,4431834,,False,20.0,0,2,0,1,0,1,0,0,0,2,2,1,1,0,0,2,0
401403477,Little Rock Trojans,CJ White,4396639,,False,32.0,2,7,2,3,0,4,2,2,1,3,4,4,4,0,1,1,6
401403477,Little Rock Trojans,TEAM,TOTAL,TOTAL,False,,23,50,17,35,6,15,10,15,12,17,29,10,8,2,14,19,62
401403476,Texas State Bobcats,N. Martin,4702068,,True,13.0,1,2,1,2,0,0,0,0,1,0,1,0,0,0,1,0,2
401403476,Texas State Bobcats,I. Small,4593923,,True,28.0,6,16,5,13,1,3,1,3,5,6,11,0,0,1,0,3,14
401403476,Texas State Bobcats,C. Asberry,4593924,,True,30.0,5,11,3,6,2,5,3,6,0,3,3,2,3,0,1,3,15
401403476,Texas State Bobcats,M. Harrell,4397702,,True,28.0,4,10,3,6,1,4,7,8,0,1,1,2,3,0,1,5,16
401403476,Texas State Bobcats,S. Adams,4280276,,True,29.0,2,9,1,7,1,2,6,8,1,6,7,3,1,1,0,2,11
401403476,Texas State Bobcats,T. Morgan,4897157,,False,16.0,0,3,0,2,0,1,0,0,0,1,1,1,1,1,2,3,0
401403476,Texas State Bobcats,N. Ceaser,4702071,,False,23.0,4,10,3,8,1,2,0,0,1,1,2,0,0,1,1,5,9
401403476,Texas State Bobcats,D. Dawson,4702066,,False,13.0,1,2,0,0,1,2,0,0,0,0,0,0,0,0,0,2,3
401403476,Texas State Bobcats,D. Drinnon,4397358,,False,20.0,1,4,1,3,0,1,0,0,0,1,1,2,0,0,0,2,2
401403476,Texas State Bobcats,TEAM,TOTAL,TOTAL,False,,24,67,17,47,7,20,17,25,12,21,33,10,8,4,6,25,72
401403476,Louisiana Ragin' Cajuns,T. Akwuba,4397716,,True,34.0,4,5,4,5,0,0,0,0,4,7,11,3,2,5,1,2,8
401403476,Louisiana Ragin' Cajuns,J. Brown,4397340,,True,37.0,12,20,11,18,1,2,6,8,3,5,8,0,1,2,2,1,31
401403476,Louisiana Ragin' Cajuns,J. Dalcourt,4703343,,True,25.0,1,7,0,4,1,3,3,4,1,2,3,0,0,0,1,3,6
401403476,Louisiana Ragin' Cajuns,B. Au,4702108,,True,9.0,0,1,0,0,0,1,0,0,0,2,2,1,0,0,1,0,0
401403476,Louisiana Ragin' Cajuns,G. Williams Jr.,4397123,,True,33.0,5,13,2,7,3,6,2,2,1,6,7,5,0,1,0,2,15
401403476,Louisiana Ragin' Cajuns,D. Gueye,4593896,,False,8.0,0,1,0,1,0,0,4,6,0,3,3,1,0,0,2,1,4
401403476,Louisiana Ragin' Cajuns,K. Garnett,4702106,,False,15.0,0,1,0,0,0,1,0,0,0,2,2,1,0,0,0,1,0
401403476,Louisiana Ragin' Cajuns,M. Thomas,4702105,,False,27.0,1,2,1,2,0,0,6,6,1,4,5,5,0,0,5,3,8
401403476,Louisiana Ragin' Cajuns,D. Cadwell,4593895,,False,7.0,1,2,0,1,1,1,0,0,0,1,1,0,0,0,0,2,3
401403476,Louisiana Ragin' Cajuns,T. Wesley,4397660,,False,5.0,0,0,0,0,0,0,4,6,0,0,0,0,0,0,1,3,4
401403476,Louisiana Ragin' Cajuns,TEAM,TOTAL,TOTAL,False,,24,52,18,38,6,14,25,32,11,34,45,16,3,8,14,18,79
401403475,Georgia Southern Eagles,P. Toyambi,4396611,,True,15.0,2,3,2,3,0,0,0,0,2,0,2,0,1,1,0,3,4
401403475,Georgia Southern Eagles,E. McCadden,4397519,,True,30.0,5,8,4,5,1,3,4,8,0,4,4,4,1,0,3,1,15
401403475,Georgia Southern Eagles,G. Juozapaitis,4596787,,True,26.0,2,3,0,1,2,2,0,0,0,0,0,1,1,1,1,2,6
401403475,Georgia Southern Eagles,T. Cobbs,4067443,,True,23.0,2,9,1,4,1,5,1,2,0,1,1,4,0,0,2,1,6
401403475,Georgia Southern Eagles,G. Weatherford,3906672,,True,9.0,1,1,0,0,1,1,0,0,0,2,2,2,0,0,0,0,3
401403475,Georgia Southern Eagles,A. Savrasov,4433073,,False,20.0,4,9,3,6,1,3,3,4,1,5,6,0,1,0,1,2,12
401403475,Georgia Southern Eagles,C. Bryant,4702115,,False,21.0,3,7,0,1,3,6,0,0,0,4,4,2,1,0,0,4,9
401403475,Georgia Southern Eagles,C. Curry,4396966,,False,6.0,1,1,1,1,0,0,0,0,2,0,2,0,0,1,1,0,2
401403475,Georgia Southern Eagles,K. Brown,4702113,,False,24.0,4,8,4,6,0,2,2,2,0,8,8,0,0,2,1,2,10
401403475,Georgia Southern Eagles,K. Archie,4397065,,False,26.0,1,4,1,3,0,1,1,2,0,2,2,0,0,0,0,3,3
401403475,Georgia Southern Eagles,TEAM,TOTAL,TOTAL,False,,25,53,16,30,9,23,11,18,7,27,34,13,5,5,9,18,70
401403475,Coastal Carolina Chanticleers,E. Mostafa,4433052,,True,32.0,4,7,4,7,0,0,2,6,3,12,15,1,0,1,1,2,10
401403475,Coastal Carolina Chanticleers,V. Cole,4702008,,True,34.0,5,14,3,8,2,6,5,6,0,0,0,0,2,0,0,0,17
401403475,Coastal Carolina Chanticleers,R. Williams,4700534,,True,37.0,5,12,3,9,2,3,2,3,0,1,1,2,4,0,4,3,14
401403475,Coastal Carolina Chanticleers,G. Green,4593880,,True,27.0,2,6,2,4,0,2,1,3,5,4,9,1,0,0,0,3,5
401403475,Coastal Carolina Chanticleers,E. Dibba,4397504,,True,35.0,4,13,3,11,1,2,4,5,1,7,8,2,0,0,1,4,13
401403475,Coastal Carolina Chanticleers,W. Likayi,4593814,,False,15.0,1,4,1,3,0,1,0,0,4,0,4,1,0,0,0,2,2
401403475,Coastal Carolina Chanticleers,D. Thomas,4593022,,False,7.0,0,0,0,0,0,0,0,0,1,0,1,0,0,0,1,0,0
401403475,Coastal Carolina Chanticleers,J. Uduje,4897224,,False,13.0,1,2,1,2,0,0,1,2,0,1,1,0,0,0,2,1,3
401403475,Coastal Carolina Chanticleers,TEAM,TOTAL,TOTAL,False,,22,58,17,44,5,14,15,25,16,25,41,7,6,1,9,15,64
401403474,UL Monroe Warhawks,T. Howell,4702092,,True,21.0,4,5,4,5,0,0,0,0,1,0,1,0,0,0,0,5,8
401403474,UL Monroe Warhawks,R. Harrison,4702096,,True,29.0,5,8,1,2,4,6,2,2,0,2,2,1,0,0,2,4,16
401403474,UL Monroe Warhawks,E. Gonzales,4702089,,True,30.0,3,6,2,3,1,3,0,0,0,3,3,3,2,0,2,3,7
401403474,UL Monroe Warhawks,K. Ozier,4397996,,True,40.0,4,9,2,6,2,3,0,2,1,5,6,1,0,0,3,4,10
401403474,UL Monroe Warhawks,A. Jones,4067818,,True,38.0,10,22,9,19,1,3,3,3,1,5,6,4,2,0,2,1,24
401403474,UL Monroe Warhawks,N. Metskhvarishvili,4897141,,False,28.0,4,7,3,4,1,3,1,1,0,4,4,3,2,2,4,3,10
401403474,UL Monroe Warhawks,L. Phillips,4593912,,False,2.0,0,0,0,0,0,0,0,0,0,0,0,0,0,0,0,1,0
401403474,UL Monroe Warhawks,J. Williams IV,4702095,,False,0.0,0,0,0,0,0,0,0,0,0,0,0,0,0,0,0,0,0
401403474,UL Monroe Warhawks,L. Powell,4593909,,False,12.0,1,2,1,2,0,0,0,1,0,1,1,0,0,0,0,0,2
401403474,UL Monroe Warhawks,TEAM,TOTAL,TOTAL,False,,31,59,22,41,9,18,6,9,4,21,25,12,6,2,13,21,77
401403474,Arkansas State Red Wolves,K. Wesley,4702136,,True,11.0,1,2,1,2,0,0,2,5,1,1,2,1,0,0,1,3,4
401403474,Arkansas State Red Wolves,N. Omier,4702134,,True,32.0,13,21,13,21,0,0,9,12,4,9,13,1,2,1,4,4,35
401403474,Arkansas State Red Wolves,C. Fields,4593869,,True,32.0,0,2,0,1,0,1,0,0,0,2,2,2,0,0,1,2,0
401403474,Arkansas State Red Wolves,D. Sills,4395701,,True,32.0,4,7,2,3,2,4,0,0,2,6,8,1,1,0,3,3,10
401403474,Arkansas State Red Wolves,M. Eaton,4280139,,True,37.0,3,12,2,9,1,3,6,6,1,2,3,5,2,0,4,2,13
401403474,Arkansas State Red Wolves,A. Jackson,4432004,,False,7.0,1,1,1,1,0,0,1,2,1,1,2,0,1,0,0,0,3
401403474,Arkansas State Red Wolves,M. Davis,4702130,,False,20.0,2,9,2,7,0,2,1,2,2,2,4,0,1,0,0,3,5
401403474,Arkansas State Red Wolves,A. Felts,4431959,,False,10.0,0,1,0,0,0,1,0,0,0,2,2,1,1,0,0,0,0
401403474,Arkansas State Red Wolves,M. Farrington,4431957,,False,19.0,3,5,0,1,3,4,2,2,0,2,2,1,2,0,1,1,11
401403474,Arkansas State Red Wolves,TEAM,TOTAL,TOTAL,False,,27,60,21,45,6,15,21,29,15,27,42,12,10,1,14,18,81
401403473,South Alabama Jaguars,J. Franklin,4592747,,True,32.0,6,8,6,8,0,0,2,4,2,7,9,0,4,1,2,5,14
401403473,South Alabama Jaguars,D. Smith,4431819,,True,19.0,0,2,0,2,0,0,0,0,0,0,0,0,1,0,0,1,0
401403473,South Alabama Jaguars,K. Goncalves,4402692,,True,29.0,1,7,0,2,1,5,1,1,1,0,1,0,0,0,1,2,4
401403473,South Alabama Jaguars,L. Thomas,4277877,,True,18.0,2,4,0,1,2,3,1,2,2,0,2,0,0,0,1,3,7
401403473,South Alabama Jaguars,C. Manning Jr.,4593021,,True,38.0,8,17,8,15,0,2,10,13,4,4,8,1,1,2,4,2,26
401403473,South Alabama Jaguars,M. Kearing,4897174,,False,6.0,0,1,0,1,0,0,0,0,0,0,0,1,0,1,2,3,0
401403473,South Alabama Jaguars,Al. Anderson,4897173,,False,29.0,2,2,2,2,0,0,1,1,0,2,2,3,0,0,1,2,5
401403473,South Alabama Jaguars,T. Jones,4432853,,False,29.0,3,5,2,2,1,3,8,9,0,3,3,4,2,0,0,0,15
401403473,South Alabama Jaguars,TEAM,TOTAL,TOTAL,False,,22,46,18,33,4,13,23,30,9,18,27,9,8,4,12,18,71
401403473,Little Rock Trojans,M. Gardner,4431772,,True,36.0,4,8,4,6,0,2,4,4,2,5,7,5,0,0,4,4,12
401403473,Little Rock Trojans,N. Maric,4397558,,True,27.0,4,4,4,4,0,0,3,4,1,4,5,0,0,0,0,5,11
401403473,Little Rock Trojans,D. Smith,4897215,,True,11.0,1,4,0,3,1,1,0,0,0,0,0,1,2,0,3,0,3
401403473,Little Rock Trojans,J. Jefferson,4897214,,True,37.0,8,11,0,2,8,9,0,0,1,1,2,1,0,0,2,3,24
401403473,Little Rock Trojans,J. Stulic,4432118,,True,26.0,2,6,0,1,2,5,0,0,0,4,4,2,1,1,0,3,6
401403473,Little Rock Trojans,A. Besovic,4278627,,False,15.0,0,0,0,0,0,0,0,0,1,2,3,1,0,1,1,2,0
401403473,Little Rock Trojans,I. Palermo,4431834,,False,16.0,1,5,0,3,1,2,2,2,1,0,1,2,1,0,0,2,5
401403473,Little Rock Trojans,CJ White,4396639,,False,32.0,3,9,1,4,2,5,6,6,0,6,6,5,0,0,0,4,14
401403473,Little Rock Trojans,TEAM,TOTAL,TOTAL,False,,23,47,9,23,14,24,15,16,7,22,29,17,4,2,11,24,75
401403472,UT Arlington Mavericks,K. Akobundu-Ehiogu,4403467,,True,30.0,3,3,2,2,1,1,1,1,3,3,6,0,2,4,0,3,8
401403472,UT Arlington Mavericks,P. Mwamba,4397685,,True,34.0,6,16,2,6,4,10,3,4,3,4,7,2,4,0,1,4,19
401403472,UT Arlington Mavericks,N. Elame,4593919,,True,27.0,3,6,3,6,0,0,3,6,1,3,4,1,1,0,2,2,9
401403472,UT Arlington Mavericks,D. Azore,4280270,,True,37.0,6,19,4,12,2,7,9,9,0,4,4,1,1,0,3,2,23
401403472,UT Arlington Mavericks,J. Levi,4280187,,True,30.0,2,8,2,5,0,3,0,1,2,2,4,5,2,0,2,4,4
401403472,UT Arlington Mavericks,M. Young Jr.,4897136,,False,2.0,0,1,0,1,0,0,0,0,0,0,0,0,0,0,0,2,0
401403472,UT Arlington Mavericks,S. Wilson,4897135,,False,9.0,0,1,0,1,0,0,1,2,0,3,3,0,0,0,0,3,1
401403472,UT Arlington Mavericks,L. Rojas,4066681,,False,6.0,0,1,0,0,0,1,0,0,0,0,0,0,0,0,0,0,0
401403472,UT Arlington Mavericks,B. Talbot,4702054,,False,1.0,0,1,0,0,0,1,0,0,0,0,0,0,0,0,0,0,0
401403472,UT Arlington Mavericks,C. Bischoff,4593101,,False,16.0,0,5,0,2,0,3,0,0,1,0,1,0,1,0,0,1,0
401403472,UT Arlington Mavericks,J. Hoiberg,4277962,,False,8.0,0,3,0,2,0,1,0,0,1,1,2,1,0,0,0,1,0
401403472,UT Arlington Mavericks,TEAM,TOTAL,TOTAL,False,,20,64,13,37,7,27,17,23,13,22,35,10,11,4,9,22,64
401403472,Louisiana Ragin' Cajuns,T. Akwuba,4397716,,True,31.0,3,3,3,3,0,0,1,2,1,3,4,1,0,1,0,2,7
401403472,Louisiana Ragin' Cajuns,J. Brown,4397340,,True,24.0,2,3,2,3,0,0,2,4,1,5,6,2,0,1,2,3,6
401403472,Louisiana Ragin' Cajuns,J. Dalcourt,4703343,,True,31.0,5,8,0,2,5,6,1,4,0,2,2,0,2,1,1,3,16
401403472,Louisiana Ragin' Cajuns,B. Au,4702108,,True,20.0,1,6,1,5,0,1,0,0,0,5,5,4,0,1,3,3,2
401403472,Louisiana Ragin' Cajuns,G. Williams Jr.,4397123,,True,35.0,4,11,3,7,1,4,3,3,0,7,7,2,0,0,3,3,12
401403472,Louisiana Ragin' Cajuns,J. Charles,4708075,,False,3.0,0,0,0,0,0,0,1,2,0,0,0,1,0,0,1,0,1
401403472,Louisiana Ragin' Cajuns,D. Gueye,4593896,,False,22.0,3,8,3,8,0,0,3,4,1,4,5,2,2,0,0,2,9
401403472,Louisiana Ragin' Cajuns,K. Garnett,4702106,,False,9.0,1,3,0,1,1,2,4,4,0,1,1,0,0,0,0,1,7
401403472,Louisiana Ragin' Cajuns,M. Thomas,4702105,,False,17.0,0,1,0,1,0,0,2,2,0,2,2,2,1,0,3,0,2
401403472,Louisiana Ragin' Cajuns,D. Cadwell,4593895,,False,5.0,1,1,0,0,1,1,0,0,0,1,1,0,0,0,0,0,3
401403472,Louisiana Ragin' Cajuns,T. Wesley,4397660,,False,3.0,0,0,0,0,0,0,2,2,0,0,0,0,0,0,1,0,2
401403472,Louisiana Ragin' Cajuns,TEAM,TOTAL,TOTAL,False,,20,44,12,30,8,14,19,27,6,33,39,14,5,4,16,17,67
401403471,Navy Midshipmen,T. Nelson,4593139,,True,20.0,4,10,2,5,2,5,1,2,1,5,6,1,0,0,1,5,11
401403471,Navy Midshipmen,R. Njoku,4398153,,True,15.0,2,5,2,5,0,0,0,0,3,1,4,0,1,0,3,2,4
401403471,Navy Midshipmen,A. Inge,4702521,,True,16.0,1,5,0,1,1,4,0,0,0,0,0,1,0,0,0,2,3
401403471,Navy Midshipmen,S. Yoder,4433132,,True,21.0,3,5,2,2,1,3,2,2,0,4,4,0,2,0,2,5,9
401403471,Navy Midshipmen,J. Carter Jr.,4398147,,True,35.0,4,8,2,4,2,4,0,0,2,3,5,1,2,0,1,0,10
401403471,Navy Midshipmen,D. Deaver,4593145,,False,15.0,0,4,0,4,0,0,0,0,0,2,2,2,0,0,1,1,0
401403471,Navy Midshipmen,J. Walker,4593141,,False,28.0,1,6,1,4,0,2,1,2,2,3,5,0,1,0,1,3,3
401403471,Navy Midshipmen,P. Dorsey,4593143,,False,5.0,0,2,0,0,0,2,0,0,0,0,0,0,0,0,0,0,0
401403471,Navy Midshipmen,P.J. Roach Jr.,4593142,,False,7.0,0,2,0,2,0,0,0,0,1,0,1,0,0,0,0,0,0
401403471,Navy Midshipmen,C. Silva,4398152,,False,4.0,0,2,0,0,0,2,0,0,0,0,0,1,1,0,0,0,0
401403471,Navy Midshipmen,G. Summers,4398149,,False,34.0,7,13,7,13,0,0,4,7,5,3,8,0,3,0,7,5,18
401403471,Navy Midshipmen,TEAM,TOTAL,TOTAL,False,,22,62,16,40,6,22,8,13,18,23,41,6,10,0,17,23,58
401403471,Colgate Raiders,K. Records,4593089,,True,20.0,1,2,1,2,0,0,0,2,1,1,2,1,0,0,1,2,2
401403471,Colgate Raiders,R. Moffatt,4593087,,True,32.0,2,5,1,1,1,4,0,0,0,4,4,2,0,0,1,3,5
401403471,Colgate Raiders,T. Richardson,4398040,,True,36.0,4,7,2,3,2,4,2,4,0,4,4,4,4,1,4,1,12
401403471,Colgate Raiders,J. Ferguson,4280048,,True,32.0,4,6,2,3,2,3,7,8,0,5,5,5,2,0,2,2,17
401403471,Colgate Raiders,N. Cummings,4279317,,True,33.0,3,9,2,5,1,4,8,9,0,0,0,2,3,0,0,1,15
401403471,Colgate Raiders,J. Woodward,4702503,,False,18.0,5,7,5,7,0,0,2,3,1,7,8,0,0,3,3,2,12
401403471,Colgate Raiders,S. Thomson,4702501,,False,8.0,0,1,0,1,0,0,1,2,0,1,1,0,0,0,0,0,1
401403471,Colgate Raiders,O. Lynch-Daniels,4278275,,False,21.0,4,4,2,2,2,2,0,0,0,1,1,1,1,1,3,2,10
401403471,Colgate Raiders,TEAM,TOTAL,TOTAL,False,,23,41,15,24,8,17,20,28,2,24,26,15,10,5,14,13,74
401403470,Lehigh Mountain Hawks,J. Wilson,4398116,,True,31.0,3,8,2,5,1,3,2,2,1,4,5,3,0,0,1,2,9
401403470,Lehigh Mountain Hawks,N. Lynch,4398119,,True,19.0,3,9,2,5,1,4,2,2,0,0,0,1,0,2,2,3,9
401403470,Lehigh Mountain Hawks,K. Higgins Jr.,4897894,,True,36.0,7,17,4,11,3,6,0,0,0,4,4,0,2,1,1,4,17
401403470,Lehigh Mountain Hawks,T. Whitney-Sidney,4683862,,True,22.0,1,2,1,2,0,0,2,2,0,3,3,0,0,0,2,3,4
401403470,Lehigh Mountain Hawks,E. Taylor,4432122,,True,27.0,1,8,1,7,0,1,1,1,1,4,5,0,0,1,1,2,3
401403470,Lehigh Mountain Hawks,D. Parolin,4702518,,False,20.0,2,5,1,3,1,2,3,4,2,2,4,1,2,0,0,1,8
401403470,Lehigh Mountain Hawks,JT Tan,4702519,,False,1.0,0,0,0,0,0,0,0,0,0,0,0,0,0,0,0,0,0
401403470,Lehigh Mountain Hawks,J. Alamudun,4432933,,False,1.0,0,1,0,0,0,1,0,0,0,0,0,0,0,0,0,0,0
401403470,Lehigh Mountain Hawks,J. Saigal,4702516,,False,0.0,0,0,0,0,0,0,0,0,0,0,0,0,0,0,0,0,0
401403470,Lehigh Mountain Hawks,J. Betlow,4593111,,False,7.0,0,2,0,0,0,2,0,0,1,0,1,0,0,0,1,3,0
401403470,Lehigh Mountain Hawks,R. Fenton,4431962,,False,10.0,0,0,0,0,0,0,0,0,0,1,1,2,1,0,0,0,0
401403470,Lehigh Mountain Hawks,M. Wilson,4280081,,False,26.0,5,11,4,7,1,4,0,0,2,4,6,5,2,0,1,1,11
401403470,Lehigh Mountain Hawks,TEAM,TOTAL,TOTAL,False,,22,63,15,40,7,23,10,11,9,23,32,12,7,4,9,19,61
401403470,Colgate Raiders,K. Records,4593089,,True,25.0,6,10,6,9,0,1,0,0,3,2,5,1,1,2,1,2,12
401403470,Colgate Raiders,R. Moffatt,4593087,,True,31.0,3,7,1,2,2,5,0,0,2,4,6,1,0,0,1,2,8
401403470,Colgate Raiders,T. Richardson,4398040,,True,34.0,5,9,3,6,2,3,4,4,0,6,6,4,0,0,0,0,16
401403470,Colgate Raiders,J. Ferguson,4280048,,True,30.0,4,7,0,2,4,5,5,8,2,3,5,2,0,0,2,2,17
401403470,Colgate Raiders,N. Cummings,4279317,,True,30.0,4,13,4,10,0,3,1,2,0,3,3,3,1,0,1,2,9
401403470,Colgate Raiders,J. Woodward,4702503,,False,18.0,4,7,4,7,0,0,3,5,1,6,7,5,3,3,2,0,11
401403470,Colgate Raiders,S. Thomson,4702501,,False,9.0,2,2,2,2,0,0,0,0,1,4,5,0,1,0,3,0,4
401403470,Colgate Raiders,B. Henry,4593088,,False,1.0,0,0,0,0,0,0,0,0,0,0,0,0,0,0,0,0,0
401403470,Colgate Raiders,Z. Light,4398038,,False,1.0,0,0,0,0,0,0,2,2,0,0,0,0,0,0,0,0,2
401403470,Colgate Raiders,O. Lynch-Daniels,4278275,,False,21.0,1,4,1,3,0,1,0,0,0,3,3,3,1,0,0,0,2
401403470,Colgate Raiders,TEAM,TOTAL,TOTAL,False,,29,59,21,41,8,18,15,21,10,33,43,19,7,5,10,8,81
401403449,Navy Midshipmen,T. Nelson,4593139,,True,15.0,1,6,1,4,0,2,4,4,0,3,3,2,0,0,0,1,6
401403449,Navy Midshipmen,R. Njoku,4398153,,True,25.0,2,3,2,3,0,0,1,2,3,3,6,0,0,2,2,2,5
401403449,Navy Midshipmen,A. Inge,4702521,,True,13.0,1,2,1,1,0,1,0,0,1,1,2,1,0,0,1,0,2
401403449,Navy Midshipmen,S. Yoder,4433132,,True,26.0,1,3,0,0,1,3,5,6,0,3,3,1,0,0,0,3,8
401403449,Navy Midshipmen,J. Carter Jr.,4398147,,True,37.0,9,19,6,8,3,11,0,0,0,6,6,0,1,0,1,2,21
401403449,Navy Midshipmen,D. Deaver,4593145,,False,20.0,1,7,1,7,0,0,2,3,2,1,3,4,1,0,2,3,4
401403449,Navy Midshipmen,J. Walker,4593141,,False,30.0,5,8,3,4,2,4,1,2,1,3,4,2,0,3,0,3,13
401403449,Navy Midshipmen,P. Dorsey,4593143,,False,3.0,0,1,0,0,0,1,0,0,0,0,0,0,0,0,0,0,0
401403449,Navy Midshipmen,P.J. Roach Jr.,4593142,,False,16.0,1,1,0,0,1,1,0,0,0,2,2,2,0,0,0,0,3
401403449,Navy Midshipmen,C. Silva,4398152,,False,5.0,1,3,1,1,0,2,0,0,1,0,1,0,1,0,0,0,2
401403449,Navy Midshipmen,G. Summers,4398149,,False,35.0,7,11,7,11,0,0,7,8,3,3,6,5,0,1,2,1,21
401403449,Navy Midshipmen,TEAM,TOTAL,TOTAL,False,,29,64,22,39,7,25,20,25,14,28,42,17,3,6,9,15,85
401403449,Boston University Terriers,S. Mathon,4280042,,True,32.0,4,10,4,10,0,0,6,6,1,5,6,3,2,2,2,4,14
401403449,Boston University Terriers,F. Tynen,4397634,,True,38.0,2,9,1,6,1,3,2,3,3,6,9,1,0,0,0,3,7
401403449,Boston University Terriers,M. Brewster,4702490,,True,27.0,3,4,2,2,1,2,1,2,0,1,1,1,0,0,0,3,8
401403449,Boston University Terriers,J. Harper,4397631,,True,35.0,3,4,1,2,2,2,0,0,0,2,2,2,3,0,1,5,8
401403449,Boston University Terriers,J. McCoy,4280041,,True,44.0,12,24,8,15,4,9,2,3,2,3,5,4,1,0,2,4,30
401403449,Boston University Terriers,M. Chimezie,4684448,,False,13.0,0,2,0,2,0,0,0,0,1,2,3,0,0,0,0,2,0
401403449,Boston University Terriers,A. Morales,4590364,,False,0.0,0,0,0,0,0,0,0,0,0,0,0,0,0,0,0,0,0
401403449,Boston University Terriers,C. Jones,4702488,,False,2.0,0,1,0,0,0,1,0,0,0,0,0,0,0,0,0,0,0
401403449,Boston University Terriers,D. Tate,4593079,,False,3.0,0,1,0,0,0,1,0,0,0,0,0,0,0,0,0,0,0
401403449,Boston University Terriers,E. Brittain-Watts,4431909,,False,31.0,3,7,1,2,2,5,5,6,0,3,3,0,0,0,1,1,13
401403449,Boston University Terriers,G. Pascoe,4397630,,False,0.0,0,0,0,0,0,0,0,0,0,0,0,0,0,0,0,2,0
401403449,Boston University Terriers,TEAM,TOTAL,TOTAL,False,,27,62,17,39,10,23,16,20,9,23,32,11,6,2,6,24,80
401403448,Colgate Raiders,K. Records,4593089,,True,21.0,5,6,5,6,0,0,0,0,1,3,4,1,1,1,0,1,10
401403448,Colgate Raiders,R. Moffatt,4593087,,True,24.0,3,5,2,4,1,1,0,0,1,3,4,6,1,0,0,0,7
401403448,Colgate Raiders,T. Richardson,4398040,,True,34.0,4,8,3,5,1,3,0,0,1,3,4,6,1,0,0,0,9
401403448,Colgate Raiders,J. Ferguson,4280048,,True,32.0,10,12,3,4,7,8,1,1,0,7,7,5,0,2,3,2,28
401403448,Colgate Raiders,N. Cummings,4279317,,True,30.0,6,13,4,9,2,4,1,2,0,3,3,4,3,0,1,1,15
401403448,Colgate Raiders,J. Woodward,4702503,,False,17.0,5,5,5,5,0,0,1,2,0,5,5,2,1,1,1,1,11
401403448,Colgate Raiders,S. Thomson,4702501,,False,16.0,4,5,4,5,0,0,0,0,0,2,2,3,2,1,0,1,8
401403448,Colgate Raiders,B. Henry,4593088,,False,2.0,1,2,1,2,0,0,0,0,0,0,0,0,0,1,0,1,2
401403448,Colgate Raiders,N. Louis-Jacques,4897909,,False,2.0,0,1,0,0,0,1,0,0,0,0,0,1,0,0,0,0,0
401403448,Colgate Raiders,Z. Light,4398038,,False,2.0,0,1,0,1,0,0,0,0,0,1,1,0,0,0,0,0,0
401403448,Colgate Raiders,O. Lynch-Daniels,4278275,,False,20.0,2,2,0,0,2,2,0,0,0,1,1,2,2,0,2,0,6
401403448,Colgate Raiders,TEAM,TOTAL,TOTAL,False,,40,60,27,41,13,19,3,5,4,29,33,30,11,6,8,7,96
401403448,Bucknell Bison,J. van der Heijden,4593081,,True,25.0,3,9,1,4,2,5,0,0,2,2,4,0,0,1,1,1,8
401403448,Bucknell Bison,A. Screen,4702499,,True,24.0,2,8,2,8,0,0,1,3,2,3,5,3,0,1,2,1,5
401403448,Bucknell Bison,E. Edmonds IV,4897911,,True,30.0,3,9,2,4,1,5,0,0,0,0,0,2,1,1,2,1,7
401403448,Bucknell Bison,X. Rice,4593080,,True,29.0,6,11,2,5,4,6,1,1,0,2,2,6,2,0,2,3,17
401403448,Bucknell Bison,A. Funk,4397650,,True,38.0,5,13,2,5,3,8,0,0,0,2,2,7,1,0,4,0,13
401403448,Bucknell Bison,B. Newton,4897912,,False,1.0,0,0,0,0,0,0,0,0,0,0,0,0,0,0,0,0,0
401403448,Bucknell Bison,I. Motta,4897910,,False,11.0,0,0,0,0,0,0,0,0,0,2,2,1,0,0,0,0,0
401403448,Bucknell Bison,M. Rhodes,4433064,,False,14.0,2,3,1,2,1,1,0,0,1,3,4,0,0,0,0,1,5
401403448,Bucknell Bison,A. Timmerman,4593082,,False,16.0,4,6,3,5,1,1,0,0,1,0,1,0,1,0,0,0,9
401403448,Bucknell Bison,J. Bascoe,4897913,,False,11.0,2,2,2,2,0,0,0,0,0,1,1,0,1,0,1,1,4
401403448,Bucknell Bison,J. Adoh,4702498,,False,1.0,0,0,0,0,0,0,0,0,0,0,0,0,0,0,0,0,0
401403448,Bucknell Bison,TEAM,TOTAL,TOTAL,False,,27,61,15,35,12,26,2,4,7,17,24,19,6,3,12,8,68
401403447,Navy Midshipmen,T. Nelson,4593139,,True,18.0,1,4,1,3,0,1,0,0,1,0,1,1,0,1,2,0,2
401403447,Navy Midshipmen,R. Njoku,4398153,,True,17.0,2,3,2,3,0,0,3,4,0,1,1,2,1,0,2,3,7
401403447,Navy Midshipmen,A. Inge,4702521,,True,21.0,1,3,1,3,0,0,2,4,0,4,4,2,1,0,1,0,4
401403447,Navy Midshipmen,S. Yoder,4433132,,True,13.0,1,2,1,2,0,0,0,1,0,3,3,1,1,0,2,0,2
401403447,Navy Midshipmen,J. Carter Jr.,4398147,,True,33.0,5,13,1,4,4,9,7,9,0,4,4,0,1,0,1,1,21
401403447,Navy Midshipmen,D. Deaver,4593145,,False,21.0,4,8,4,8,0,0,5,5,5,3,8,4,1,0,2,2,13
401403447,Navy Midshipmen,J. Walker,4593141,,False,23.0,3,4,2,2,1,2,0,0,1,1,2,1,0,1,1,0,7
401403447,Navy Midshipmen,P.J. Roach Jr.,4593142,,False,19.0,0,0,0,0,0,0,2,6,1,2,3,3,0,0,1,2,2
401403447,Navy Midshipmen,C. Silva,4398152,,False,8.0,0,2,0,1,0,1,3,3,1,0,1,0,1,0,0,0,3
401403447,Navy Midshipmen,G. Summers,4398149,,False,27.0,4,9,4,9,0,0,2,5,1,6,7,1,2,2,2,1,10
401403447,Navy Midshipmen,TEAM,TOTAL,TOTAL,False,,21,48,16,35,5,13,24,37,11,26,37,15,8,4,14,9,71
401403447,American University Eagles,J. O'Neil,4702481,,True,32.0,6,8,1,1,5,7,0,0,2,8,10,0,2,1,2,4,17
401403447,American University Eagles,M. Rogers,4575108,,True,25.0,5,10,5,9,0,1,2,2,5,1,6,2,0,0,1,3,12
401403447,American University Eagles,E. Stephens,4897139,,True,39.0,2,5,1,1,1,4,3,4,1,2,3,5,2,0,2,3,8
401403447,American University Eagles,C. Smalls,4433245,,True,33.0,4,8,1,3,3,5,0,0,0,2,2,4,2,0,1,4,11
401403447,American University Eagles,S. Beckton Jr.,4280025,,True,39.0,4,20,2,13,2,7,0,0,0,7,7,4,1,2,5,2,10
401403447,American University Eagles,J. Alexander,4397585,,False,14.0,2,4,2,4,0,0,2,2,0,0,0,0,0,0,0,3,6
401403447,American University Eagles,L. Donadio,4702478,,False,8.0,0,0,0,0,0,0,0,0,0,1,1,0,0,0,0,1,0
401403447,American University Eagles,J. Knotek,4398212,,False,10.0,0,2,0,0,0,2,0,0,0,2,2,0,0,0,1,3,0
401403447,American University Eagles,TEAM,TOTAL,TOTAL,False,,23,57,12,31,11,26,7,8,9,25,34,15,7,3,15,23,64
401403446,Loyola Maryland Greyhounds,A. Faure,4702520,,True,16.0,1,3,1,2,0,1,0,0,1,1,2,0,1,0,1,0,2
401403446,Loyola Maryland Greyhounds,G. Dike,4593122,,True,28.0,2,3,2,3,0,0,2,2,2,3,5,1,2,0,4,4,6
401403446,Loyola Maryland Greyhounds,C. Spencer,4433083,,True,38.0,11,20,9,14,2,6,4,4,1,1,2,1,2,0,2,3,28
401403446,Loyola Maryland Greyhounds,K. Jones,4398136,,True,35.0,5,13,4,9,1,4,0,0,0,3,3,5,1,0,0,3,11
401403446,Loyola Maryland Greyhounds,J. Andrews,4398132,,True,37.0,4,9,4,6,0,3,2,3,1,2,3,1,1,0,1,3,10
401403446,Loyola Maryland Greyhounds,V. Ilic,4897888,,False,12.0,1,2,1,2,0,0,1,1,0,2,2,2,0,0,0,2,3
401403446,Loyola Maryland Greyhounds,D. Brown III,4897893,,False,14.0,2,4,2,2,0,2,0,0,1,0,1,1,0,0,0,1,4
401403446,Loyola Maryland Greyhounds,C. Kuzemka,4897889,,False,8.0,0,0,0,0,0,0,0,0,0,0,0,0,0,0,1,0,0
401403446,Loyola Maryland Greyhounds,W. Jackson,4589477,,False,12.0,0,1,0,0,0,1,0,0,0,1,1,0,0,0,0,1,0
401403446,Loyola Maryland Greyhounds,TEAM,TOTAL,TOTAL,False,,26,55,23,38,3,17,9,10,6,13,19,11,7,0,10,17,64
401403446,Boston University Terriers,S. Mathon,4280042,,True,32.0,6,9,6,9,0,0,5,6,4,8,12,1,1,1,2,4,17
401403446,Boston University Terriers,F. Tynen,4397634,,True,21.0,1,4,1,3,0,1,2,2,0,1,1,4,1,0,2,3,4
401403446,Boston University Terriers,W. Whyte,4280039,,True,35.0,8,10,5,5,3,5,0,0,0,6,6,0,0,1,3,1,19
401403446,Boston University Terriers,J. Harper,4397631,,True,34.0,1,4,0,1,1,3,1,2,0,0,0,4,3,0,1,3,4
401403446,Boston University Terriers,J. McCoy,4280041,,True,37.0,11,14,9,12,2,2,2,3,0,5,5,1,1,0,3,0,26
401403446,Boston University Terriers,M. Chimezie,4684448,,False,8.0,1,1,1,1,0,0,0,0,0,2,2,0,0,0,2,0,2
401403446,Boston University Terriers,M. Brewster,4702490,,False,9.0,1,2,1,1,0,1,0,0,0,1,1,1,0,0,1,2,2
401403446,Boston University Terriers,C. Jones,4702488,,False,11.0,0,2,0,0,0,2,0,0,0,0,0,0,1,0,0,0,0
401403446,Boston University Terriers,E. Brittain-Watts,4431909,,False,13.0,1,1,1,1,0,0,0,0,0,0,0,0,0,0,1,0,2
401403446,Boston University Terriers,TEAM,TOTAL,TOTAL,False,,30,47,24,33,6,14,10,13,5,23,28,11,7,2,16,13,76
401403445,Lehigh Mountain Hawks,J. Wilson,4398116,,True,33.0,8,12,4,6,4,6,3,3,0,2,2,3,0,0,2,1,23
401403445,Lehigh Mountain Hawks,N. Lynch,4398119,,True,14.0,1,2,1,1,0,1,0,0,1,2,3,0,0,0,1,3,2
401403445,Lehigh Mountain Hawks,K. Higgins Jr.,4897894,,True,29.0,4,10,2,5,2,5,0,0,0,2,2,4,2,1,0,3,10
401403445,Lehigh Mountain Hawks,T. Whitney-Sidney,4683862,,True,37.0,7,13,6,11,1,2,0,1,1,5,6,8,2,0,2,1,15
401403445,Lehigh Mountain Hawks,E. Taylor,4432122,,True,33.0,7,16,3,5,4,11,2,2,0,9,9,1,1,1,0,1,20
401403445,Lehigh Mountain Hawks,D. Parolin,4702518,,False,23.0,2,4,1,3,1,1,2,2,4,2,6,2,0,1,2,3,7
401403445,Lehigh Mountain Hawks,B. Knostman,4897896,,False,6.0,1,2,0,1,1,1,0,0,0,0,0,1,0,0,1,0,3
401403445,Lehigh Mountain Hawks,J. Betlow,4593111,,False,1.0,0,0,0,0,0,0,0,0,0,0,0,0,0,0,0,0,0
401403445,Lehigh Mountain Hawks,R. Fenton,4431962,,False,7.0,1,1,1,1,0,0,0,0,1,1,2,3,0,0,0,0,2
401403445,Lehigh Mountain Hawks,M. Wilson,4280081,,False,17.0,1,4,0,0,1,4,6,8,0,2,2,1,0,0,2,1,9
401403445,Lehigh Mountain Hawks,TEAM,TOTAL,TOTAL,False,,32,64,18,33,14,31,13,16,12,26,38,23,5,3,10,13,91
401403445,Army Black Knights,C. Peterson,4705305,,True,26.0,3,5,3,5,0,0,5,5,0,5,5,0,0,0,1,3,11
401403445,Army Black Knights,C. Mann,4593075,,True,21.0,5,7,3,4,2,3,0,0,2,2,4,0,1,0,0,3,12
401403445,Army Black Knights,A. Duhart,4397609,,True,32.0,3,7,2,2,1,5,4,4,0,1,1,1,1,0,1,3,11
401403445,Army Black Knights,J. Rucker,4705299,,True,34.0,12,27,11,20,1,7,1,2,2,2,4,5,2,0,0,4,26
401403445,Army Black Knights,J. Caldwell,4397607,,True,35.0,5,12,5,11,0,1,2,3,3,2,5,0,3,0,3,1,12
401403445,Army Black Knights,N. Naess,4897934,,False,1.0,0,0,0,0,0,0,0,0,0,0,0,0,0,0,0,0,0
401403445,Army Black Knights,A. Johnson,4705309,,False,2.0,0,0,0,0,0,0,0,0,0,0,0,0,0,0,0,0,0
401403445,Army Black Knights,M. Dove,4705307,,False,9.0,0,1,0,1,0,0,0,0,0,2,2,0,0,1,2,0,0
401403445,Army Black Knights,AJ Allenspach,4699592,,False,9.0,0,1,0,1,0,0,0,0,1,1,2,0,0,2,1,0,0
401403445,Army Black Knights,T. Small,4897933,,False,17.0,2,8,1,3,1,5,0,0,0,4,4,0,0,0,0,2,5
401403445,Army Black Knights,I. Caldwell,4897929,,False,3.0,0,0,0,0,0,0,0,0,0,0,0,0,0,0,0,0,0
401403445,Army Black Knights,J. Cross,4705304,,False,11.0,0,1,0,0,0,1,0,0,0,0,0,1,0,1,0,0,0
401403445,Army Black Knights,TEAM,TOTAL,TOTAL,False,,30,69,25,47,5,22,12,14,14,21,35,7,7,4,8,16,77
401403444,Holy Cross Crusaders,G. Gates,4398092,,True,37.0,5,13,5,12,0,1,8,8,2,8,10,3,0,5,2,1,18
401403444,Holy Cross Crusaders,C. Kenney,4897907,,True,26.0,2,4,2,4,0,0,0,0,1,2,3,1,0,1,2,1,4
401403444,Holy Cross Crusaders,N. Dorsey,4703253,,True,36.0,2,3,0,0,2,3,0,0,1,1,2,2,1,0,1,5,6
401403444,Holy Cross Crusaders,K. Luc,4897904,,True,39.0,6,11,4,5,2,6,0,0,0,2,2,4,0,1,3,3,14
401403444,Holy Cross Crusaders,Bo Montgomery,4702509,,True,14.0,0,3,0,2,0,1,0,0,1,3,4,0,0,0,2,3,0
401403444,Holy Cross Crusaders,L. Coulibaly,4702513,,False,6.0,2,3,2,3,0,0,0,1,1,0,1,0,0,0,0,2,4
401403444,Holy Cross Crusaders,J. Martindale,4702512,,False,29.0,6,11,5,8,1,3,0,1,1,0,1,1,1,0,3,3,13
401403444,Holy Cross Crusaders,D. Humphrey,4589475,,False,13.0,0,6,0,3,0,3,4,4,0,1,1,2,0,0,0,2,4
401403444,Holy Cross Crusaders,TEAM,TOTAL,TOTAL,False,,23,54,18,37,5,17,12,14,7,19,26,13,2,7,14,20,63
401403444,American University Eagles,M. Rogers,4575108,,True,21.0,2,5,2,5,0,0,0,0,1,0,1,3,0,1,1,4,4
401403444,American University Eagles,J. O'Neil,4702481,,True,26.0,3,4,3,3,0,1,2,4,1,3,4,0,4,0,0,0,8
401403444,American University Eagles,S. Beckton Jr.,4280025,,True,39.0,9,15,9,14,0,1,5,8,1,8,9,0,0,0,2,1,23
401403444,American University Eagles,E. Stephens,4897139,,True,29.0,2,6,2,6,0,0,8,8,1,2,3,8,0,0,2,3,12
401403444,American University Eagles,C. Smalls,4433245,,True,38.0,4,5,4,5,0,0,0,0,0,6,6,2,2,0,2,1,8
401403444,American University Eagles,J. Alexander,4397585,,False,19.0,4,8,4,8,0,0,2,3,2,1,3,2,1,0,2,4,10
401403444,American University Eagles,L. Donadio,4702478,,False,14.0,0,2,0,1,0,1,0,0,0,2,2,0,1,0,1,1,0
401403444,American University Eagles,J. Knotek,4398212,,False,14.0,1,2,1,2,0,0,2,2,0,2,2,0,0,1,0,2,4
401403444,American University Eagles,TEAM,TOTAL,TOTAL,False,,25,47,25,44,0,3,19,25,6,26,32,15,8,2,11,16,69
401403443,Lafayette Leopards,K. Jenkins,4704950,,True,44.0,7,15,4,6,3,9,0,0,5,4,9,0,3,0,2,1,17
401403443,Lafayette Leopards,L. O'Boyle,4432065,,True,19.0,3,5,1,2,2,3,0,0,0,2,2,0,0,0,1,5,8
401403443,Lafayette Leopards,N. Quinn,4593100,,True,35.0,6,10,6,9,0,1,6,9,4,2,6,7,3,3,2,1,18
401403443,Lafayette Leopards,C. Fulton,4897901,,True,35.0,1,6,1,4,0,2,0,0,2,5,7,8,3,0,1,2,2
401403443,Lafayette Leopards,T. Perry,4398070,,True,41.0,7,15,2,3,5,12,3,3,0,1,1,4,2,1,2,2,22
401403443,Lafayette Leopards,C. Rubayo,4897903,,False,10.0,0,1,0,1,0,0,0,0,3,1,4,1,0,2,1,1,0
401403443,Lafayette Leopards,T. Verbinskis,4278382,,False,15.0,0,1,0,0,0,1,0,0,0,0,0,1,0,0,1,1,0
401403443,Lafayette Leopards,D. Hines,4897902,,False,5.0,1,2,1,1,0,1,0,0,1,0,1,0,1,0,0,0,2
401403443,Lafayette Leopards,J. Brantley,4704949,,False,21.0,4,9,0,0,4,9,0,0,0,1,1,2,0,0,1,0,12
401403443,Lafayette Leopards,TEAM,TOTAL,TOTAL,False,,29,64,15,26,14,38,9,12,15,16,31,23,12,6,13,13,81
401403443,Bucknell Bison,J. van der Heijden,4593081,,True,21.0,2,2,0,0,2,2,0,0,0,1,1,1,0,0,0,1,6
401403443,Bucknell Bison,A. Screen,4702499,,True,27.0,6,9,6,9,0,0,4,5,2,3,5,2,0,1,3,4,16
401403443,Bucknell Bison,E. Edmonds IV,4897911,,True,37.0,3,6,1,2,2,4,0,0,0,2,2,2,1,0,3,0,8
401403443,Bucknell Bison,X. Rice,4593080,,True,38.0,3,5,2,3,1,2,0,0,0,2,2,4,3,0,4,1,7
401403443,Bucknell Bison,A. Funk,4397650,,True,43.0,9,15,6,9,3,6,0,0,0,5,5,7,1,0,1,1,21
401403443,Bucknell Bison,I. Motta,4897910,,False,9.0,0,3,0,1,0,2,0,0,0,0,0,1,0,0,0,0,0
401403443,Bucknell Bison,M. Rhodes,4433064,,False,24.0,4,7,3,6,1,1,3,4,4,4,8,2,1,0,3,3,12
401403443,Bucknell Bison,A. Timmerman,4593082,,False,18.0,5,8,5,8,0,0,2,2,0,3,3,3,0,1,0,3,12
401403443,Bucknell Bison,J. Bascoe,4897913,,False,8.0,0,0,0,0,0,0,0,0,0,0,0,0,0,0,1,4,0
401403443,Bucknell Bison,TEAM,TOTAL,TOTAL,False,,32,55,23,38,9,17,9,11,9,22,31,22,6,2,16,17,82
401403442,Loyola Chicago Ramblers,C. Knight,4279553,,True,14.0,0,1,0,1,0,0,0,0,2,0,2,1,1,1,3,4,0
401403442,Loyola Chicago Ramblers,A. Uguak,4066717,,True,34.0,5,11,5,9,0,2,6,7,4,6,10,2,1,0,3,2,16
401403442,Loyola Chicago Ramblers,B. Norris,4397778,,True,31.0,3,8,1,2,2,6,2,2,0,2,2,1,0,0,4,1,10
401403442,Loyola Chicago Ramblers,T. Hall,4289536,,True,19.0,1,5,1,3,0,2,0,0,1,3,4,0,1,0,0,3,2
401403442,Loyola Chicago Ramblers,L. Williamson,4279147,,True,37.0,6,12,5,9,1,3,5,7,2,8,10,2,1,0,0,0,18
401403442,Loyola Chicago Ramblers,T. Welch,4432136,,False,8.0,0,1,0,1,0,0,0,0,1,0,1,0,0,0,1,3,0
401403442,Loyola Chicago Ramblers,R. Schwieger,4279565,,False,24.0,4,7,2,3,2,4,3,4,1,4,5,1,2,0,1,4,13
401403442,Loyola Chicago Ramblers,K. Clemons,4592695,,False,2.0,0,0,0,0,0,0,0,0,0,0,0,0,0,0,0,0,0
401403442,Loyola Chicago Ramblers,M. Kennedy,4433019,,False,31.0,2,11,2,6,0,5,1,4,0,7,7,4,2,0,1,5,5
401403442,Loyola Chicago Ramblers,TEAM,TOTAL,TOTAL,False,,21,56,16,34,5,22,17,24,11,31,42,11,8,1,16,22,64
401403442,Drake Bulldogs,S. Hemphill,4397747,,True,34.0,3,7,3,7,0,0,0,2,4,6,10,0,1,0,2,4,6
401403442,Drake Bulldogs,T. Murphy,4397346,,True,38.0,3,9,1,2,2,7,0,0,2,3,5,1,1,2,2,1,8
401403442,Drake Bulldogs,T. Devries,4837238,,True,40.0,4,14,1,7,3,7,4,5,1,7,8,3,0,5,1,3,15
401403442,Drake Bulldogs,G. Sturtz,4397348,,True,29.0,3,8,3,7,0,1,1,1,1,5,6,2,4,0,2,5,7
401403442,Drake Bulldogs,R. Penn,4279754,,True,38.0,6,16,6,12,0,4,6,8,0,2,2,4,0,0,1,4,18
401403442,Drake Bulldogs,D. Brodie,4397121,,False,19.0,2,4,2,4,0,0,0,2,3,3,6,0,0,1,3,3,4
401403442,Drake Bulldogs,A. Akinwole,4279508,,False,2.0,0,1,0,0,0,1,0,0,0,0,0,1,0,0,0,2,0
401403442,Drake Bulldogs,TEAM,TOTAL,TOTAL,False,,21,59,16,39,5,20,11,18,12,28,40,11,6,8,12,22,58
401403441,Missouri State Bears,G. Prim,4592711,,True,36.0,7,9,7,9,0,0,7,9,3,5,8,0,1,1,2,4,21
401403441,Missouri State Bears,D. Clay,4592730,,True,45.0,7,13,7,9,0,4,0,0,0,10,10,0,1,1,3,3,14
401403441,Missouri State Bears,L. Patterson,4703979,,True,24.0,4,6,4,6,0,0,1,2,0,3,3,1,0,0,1,2,9
401403441,Missouri State Bears,J. Black,4592709,,True,37.0,1,6,0,1,1,5,0,0,0,1,1,0,0,1,2,3,3
401403441,Missouri State Bears,I. Mosley,4432879,,True,45.0,9,20,7,15,2,5,7,8,1,4,5,5,0,0,4,2,27
401403441,Missouri State Bears,D. Carper,4397464,,False,7.0,1,1,1,1,0,0,0,1,1,2,3,0,0,1,1,0,2
401403441,Missouri State Bears,I. Haney,4897477,,False,26.0,1,2,1,1,0,1,0,0,1,1,2,1,0,0,0,3,2
401403441,Missouri State Bears,J. Minnett,4279244,,False,5.0,0,2,0,1,0,1,0,0,0,1,1,0,0,0,0,1,0
401403441,Missouri State Bears,TEAM,TOTAL,TOTAL,False,,30,59,27,43,3,16,15,20,9,30,39,7,2,4,14,18,78
401403441,Drake Bulldogs,S. Hemphill,4397747,,True,41.0,3,5,3,5,0,0,1,3,1,1,2,1,3,1,1,3,7
401403441,Drake Bulldogs,T. Murphy,4397346,,True,38.0,6,15,6,10,0,5,3,3,3,4,7,0,1,1,0,4,15
401403441,Drake Bulldogs,T. Devries,4837238,,True,39.0,6,16,3,9,3,7,8,8,0,3,3,3,2,0,0,4,23
401403441,Drake Bulldogs,G. Sturtz,4397348,,True,43.0,6,11,5,9,1,2,0,0,4,4,8,2,0,0,2,3,13
401403441,Drake Bulldogs,R. Penn,4279754,,True,40.0,6,17,4,10,2,7,5,5,0,7,7,6,0,0,2,3,19
401403441,Drake Bulldogs,D. Brodie,4397121,,False,11.0,1,2,1,2,0,0,0,0,0,3,3,0,0,0,0,1,2
401403441,Drake Bulldogs,O. Djamgouz,4592679,,False,7.0,0,1,0,0,0,1,0,0,1,0,1,0,0,0,0,1,0
401403441,Drake Bulldogs,A. Akinwole,4279508,,False,5.0,0,2,0,0,0,2,0,0,1,0,1,0,0,0,0,0,0
401403441,Drake Bulldogs,TEAM,TOTAL,TOTAL,False,,28,69,22,45,6,24,17,19,13,22,35,12,6,2,5,19,79
401403440,Northern Iowa Panthers,N. Carter,4431923,,True,30.0,2,11,2,8,0,3,3,5,2,3,5,1,2,0,3,2,7
401403440,Northern Iowa Panthers,N. Heise,4703912,,True,35.0,1,3,0,1,1,2,1,2,0,5,5,1,1,1,0,3,4
401403440,Northern Iowa Panthers,AJ Green,4397475,,True,38.0,4,20,3,13,1,7,4,4,0,6,6,3,2,1,2,2,13
401403440,Northern Iowa Panthers,T. Berhow,4280203,,True,38.0,2,10,0,2,2,8,2,2,4,4,8,0,1,0,1,3,8
401403440,Northern Iowa Panthers,T. Pickford,4279167,,True,27.0,2,5,2,4,0,1,0,0,2,1,3,2,0,0,2,0,4
401403440,Northern Iowa Panthers,C. Henry,4433004,,False,1.0,0,0,0,0,0,0,0,0,0,0,0,0,0,0,0,0,0
401403440,Northern Iowa Panthers,J. Betz,4431904,,False,1.0,0,0,0,0,0,0,0,0,0,0,0,0,0,0,0,0,0
401403440,Northern Iowa Panthers,A. Phyfe,4279169,,False,8.0,1,2,1,2,0,0,2,2,2,0,2,0,1,0,0,1,4
401403440,Northern Iowa Panthers,T. Anderson,4703914,,False,1.0,0,0,0,0,0,0,0,0,0,0,0,0,0,0,0,0,0
401403440,Northern Iowa Panthers,B. Born,4703913,,False,17.0,1,5,1,2,0,3,0,0,0,1,1,0,1,0,4,2,2
401403440,Northern Iowa Panthers,A. Kimmons,4433020,,False,4.0,0,0,0,0,0,0,1,2,0,0,0,0,0,0,0,0,1
401403440,Northern Iowa Panthers,TEAM,TOTAL,TOTAL,False,,13,56,9,32,4,24,13,17,11,22,33,7,8,2,12,13,43
401403440,Loyola Chicago Ramblers,C. Knight,4279553,,True,13.0,0,3,0,3,0,0,0,0,4,1,5,0,0,2,3,2,0
401403440,Loyola Chicago Ramblers,A. Uguak,4066717,,True,27.0,1,7,1,4,0,3,1,2,1,6,7,1,1,0,2,0,3
401403440,Loyola Chicago Ramblers,B. Norris,4397778,,True,30.0,7,10,3,4,4,6,1,2,0,1,1,1,0,0,6,0,19
401403440,Loyola Chicago Ramblers,T. Hall,4289536,,True,27.0,1,5,1,2,0,3,0,0,0,4,4,1,1,0,1,1,2
401403440,Loyola Chicago Ramblers,L. Williamson,4279147,,True,31.0,2,6,1,1,1,5,2,2,0,6,6,5,2,0,0,3,7
401403440,Loyola Chicago Ramblers,S. Thomas,4897471,,False,1.0,1,1,0,0,1,1,0,0,0,0,0,0,0,0,0,0,3
401403440,Loyola Chicago Ramblers,T. Welch,4432136,,False,17.0,3,6,3,6,0,0,1,1,3,1,4,1,2,0,0,2,7
401403440,Loyola Chicago Ramblers,W. Alcock,4397432,,False,2.0,0,0,0,0,0,0,0,0,0,0,0,0,0,0,0,0,0
401403440,Loyola Chicago Ramblers,R. Schwieger,4279565,,False,26.0,4,9,1,3,3,6,1,2,0,6,6,0,0,0,1,4,12
401403440,Loyola Chicago Ramblers,J. Hutson,4590402,,False,2.0,0,1,0,1,0,0,0,0,1,1,2,0,0,0,0,0,0
401403440,Loyola Chicago Ramblers,Ty Johnson,4897472,,False,1.0,0,0,0,0,0,0,0,0,0,0,0,0,0,0,0,1,0
401403440,Loyola Chicago Ramblers,M. Kennedy,4433019,,False,23.0,4,8,3,6,1,2,4,4,2,4,6,2,2,0,1,2,13
401403440,Loyola Chicago Ramblers,TEAM,TOTAL,TOTAL,False,,23,56,13,30,10,26,10,13,11,32,43,11,8,2,15,16,66
401403439,Southern Illinois Salukis,M. Domask,4431943,,True,38.0,7,13,7,9,0,4,4,5,1,7,8,3,0,0,1,1,18
401403439,Southern Illinois Salukis,S. Verplancken Jr.,4703924,,True,33.0,1,5,1,1,0,4,0,0,1,2,3,1,0,0,0,1,2
401403439,Southern Illinois Salukis,D. Banks,4703921,,True,18.0,1,3,1,1,0,2,0,0,1,1,2,0,0,0,4,2,2
401403439,Southern Illinois Salukis,L. Jones,4432002,,True,32.0,6,15,3,5,3,10,0,0,0,5,5,1,0,0,3,5,15
401403439,Southern Illinois Salukis,B. Coupet Jr.,4066780,,True,27.0,3,7,2,4,1,3,1,2,2,2,4,1,1,1,1,3,8
401403439,Southern Illinois Salukis,T. D'Amico,4897483,,False,18.0,0,2,0,1,0,1,1,2,1,1,2,1,0,2,1,1,1
401403439,Southern Illinois Salukis,J.D. Muila,4703922,,False,13.0,2,2,2,2,0,0,0,0,1,2,3,0,0,0,2,4,4
401403439,Southern Illinois Salukis,K. Filewich,4703923,,False,4.0,0,1,0,1,0,0,0,0,0,2,2,0,0,0,0,1,0
401403439,Southern Illinois Salukis,T. Brown,4592722,,False,17.0,1,3,1,1,0,2,0,0,0,0,0,0,1,0,0,0,2
401403439,Southern Illinois Salukis,TEAM,TOTAL,TOTAL,False,,21,51,17,25,4,26,6,9,7,22,29,7,2,3,13,18,52
401403439,Drake Bulldogs,S. Hemphill,4397747,,True,39.0,6,8,6,8,0,0,7,8,3,7,10,1,2,0,2,3,19
401403439,Drake Bulldogs,T. Murphy,4397346,,True,26.0,3,6,3,5,0,1,2,2,3,3,6,1,1,2,2,4,8
401403439,Drake Bulldogs,T. Devries,4837238,,True,30.0,6,12,6,9,0,3,1,3,0,5,5,2,2,0,1,3,13
401403439,Drake Bulldogs,G. Sturtz,4397348,,True,36.0,3,6,3,6,0,0,3,4,1,1,2,0,4,0,0,2,9
401403439,Drake Bulldogs,R. Penn,4279754,,True,34.0,5,12,5,11,0,1,3,3,1,3,4,3,0,0,2,1,13
401403439,Drake Bulldogs,D. Brodie,4397121,,False,13.0,0,3,0,3,0,0,0,0,0,1,1,0,0,0,0,0,0
401403439,Drake Bulldogs,O. Djamgouz,4592679,,False,9.0,1,4,0,1,1,3,0,0,0,0,0,0,0,0,0,1,3
401403439,Drake Bulldogs,A. Akinwole,4279508,,False,13.0,0,3,0,2,0,1,0,0,0,2,2,0,1,0,0,0,0
401403439,Drake Bulldogs,TEAM,TOTAL,TOTAL,False,,24,54,23,45,1,9,16,20,9,25,34,7,10,2,7,14,65
401403438,Valparaiso Beacons,B. Krikke,4592733,,True,33.0,3,9,3,8,0,1,3,4,1,2,3,2,0,2,0,4,9
401403438,Valparaiso Beacons,T. Kithier,4397211,,True,30.0,8,12,8,11,0,1,1,1,2,5,7,1,0,0,3,4,17
401403438,Valparaiso Beacons,K. Taylor,4897488,,True,37.0,4,11,2,4,2,7,3,3,0,4,4,1,0,0,0,0,13
401403438,Valparaiso Beacons,P. Ruedinger,4897485,,True,21.0,1,6,1,2,0,4,0,0,0,2,2,1,1,0,1,1,2
401403438,Valparaiso Beacons,K. King,4277992,,True,36.0,2,10,2,8,0,2,1,2,3,6,9,2,1,1,0,0,5
401403438,Valparaiso Beacons,S. Edwards,4703982,,False,30.0,4,12,2,3,2,9,0,0,0,10,10,0,2,1,3,1,10
401403438,Valparaiso Beacons,E. Gordon,4065815,,False,13.0,0,1,0,1,0,0,2,2,0,1,1,1,0,0,1,2,2
401403438,Valparaiso Beacons,TEAM,TOTAL,TOTAL,False,,22,61,18,37,4,24,10,12,8,30,38,8,4,4,10,12,58
401403438,Missouri State Bears,G. Prim,4592711,,True,32.0,6,15,6,14,0,1,4,4,4,13,17,2,2,2,2,3,16
401403438,Missouri State Bears,D. Clay,4592730,,True,38.0,6,10,4,8,2,2,3,4,0,5,5,1,0,0,0,1,17
401403438,Missouri State Bears,L. Patterson,4703979,,True,23.0,4,6,4,6,0,0,1,1,0,2,2,2,0,0,1,3,9
401403438,Missouri State Bears,J. Black,4592709,,True,24.0,0,2,0,1,0,1,0,0,0,1,1,1,1,0,0,2,0
401403438,Missouri State Bears,I. Mosley,4432879,,True,39.0,8,17,6,11,2,6,0,0,1,4,5,4,3,1,4,0,18
401403438,Missouri State Bears,D. Carper,4397464,,False,8.0,2,3,2,3,0,0,0,0,0,3,3,1,0,1,0,2,4
401403438,Missouri State Bears,I. Haney,4897477,,False,19.0,0,1,0,1,0,0,0,0,0,1,1,0,0,0,1,2,0
401403438,Missouri State Bears,J. Minnett,4279244,,False,17.0,1,7,0,2,1,5,0,0,0,2,2,3,0,0,0,1,3
401403438,Missouri State Bears,TEAM,TOTAL,TOTAL,False,,27,61,22,46,5,15,8,9,5,31,36,14,6,4,8,14,67
401403437,Loyola Chicago Ramblers,C. Knight,4279553,,True,27.0,2,6,2,6,0,0,2,2,5,0,5,1,0,0,0,2,6
401403437,Loyola Chicago Ramblers,A. Uguak,4066717,,True,27.0,2,4,1,1,1,3,3,4,0,2,2,1,2,0,3,1,8
401403437,Loyola Chicago Ramblers,B. Norris,4397778,,True,29.0,2,3,1,2,1,1,1,2,0,5,5,1,1,0,1,2,6
401403437,Loyola Chicago Ramblers,T. Hall,4289536,,True,29.0,2,5,2,2,0,3,1,5,0,7,7,1,1,0,1,1,5
401403437,Loyola Chicago Ramblers,L. Williamson,4279147,,True,32.0,4,10,2,4,2,6,3,4,0,4,4,3,3,0,2,2,13
401403437,Loyola Chicago Ramblers,S. Thomas,4897471,,False,2.0,0,0,0,0,0,0,0,0,0,1,1,0,1,0,0,0,0
401403437,Loyola Chicago Ramblers,T. Welch,4432136,,False,11.0,3,3,3,3,0,0,2,2,0,2,2,1,1,0,0,3,8
401403437,Loyola Chicago Ramblers,W. Alcock,4397432,,False,1.0,0,0,0,0,0,0,0,0,0,0,0,0,0,0,0,0,0
401403437,Loyola Chicago Ramblers,R. Schwieger,4279565,,False,23.0,4,8,2,4,2,4,1,1,0,3,3,1,0,0,1,2,11
401403437,Loyola Chicago Ramblers,Ty Johnson,4897472,,False,2.0,0,0,0,0,0,0,0,2,0,0,0,1,0,0,0,1,0
401403437,Loyola Chicago Ramblers,M. Kennedy,4433019,,False,17.0,4,8,4,8,0,0,1,2,0,3,3,1,2,1,2,3,9
401403437,Loyola Chicago Ramblers,TEAM,TOTAL,TOTAL,False,,23,47,17,30,6,17,14,24,5,27,32,11,11,1,11,17,66
401403437,Bradley Braves,M. Leons,4897449,,True,35.0,1,3,1,1,0,2,3,4,3,5,8,2,0,1,1,1,5
401403437,Bradley Braves,R. Mast,4592677,,True,29.0,3,11,2,6,1,5,4,4,4,9,13,1,0,1,2,1,11
401403437,Bradley Braves,J. Kent,4703889,,True,15.0,0,3,0,2,0,1,0,1,0,1,1,0,0,0,0,3,0
401403437,Bradley Braves,C. Hickman,4897447,,True,26.0,4,8,2,4,2,4,0,0,0,3,3,2,1,0,3,4,10
401403437,Bradley Braves,T. Roberts,4897444,,True,32.0,5,12,5,10,0,2,7,7,0,2,2,2,3,0,6,3,17
401403437,Bradley Braves,A. Boya,4397323,,False,11.0,0,0,0,0,0,0,0,0,0,1,1,0,0,0,0,1,0
401403437,Bradley Braves,Z. Montgomery,4897446,,False,16.0,0,3,0,2,0,1,0,0,0,2,2,0,0,1,0,1,0
401403437,Bradley Braves,M. Ekono,4897445,,False,3.0,0,0,0,0,0,0,0,0,0,0,0,0,0,0,0,0,0
401403437,Bradley Braves,M. Howell,4702604,,False,18.0,2,6,1,4,1,2,0,0,0,1,1,0,1,0,2,0,5
401403437,Bradley Braves,V. Tahvanainen,4433093,,False,15.0,1,5,1,2,0,3,0,0,0,0,0,0,1,0,0,3,2
401403437,Bradley Braves,TEAM,TOTAL,TOTAL,False,,16,51,12,31,4,20,14,16,9,25,34,7,6,3,15,17,50
401403436,Northern Iowa Panthers,N. Carter,4431923,,True,34.0,5,13,4,7,1,6,5,6,2,3,5,5,1,0,1,3,16
401403436,Northern Iowa Panthers,N. Heise,4703912,,True,33.0,3,6,2,4,1,2,2,2,1,2,3,0,2,0,1,1,9
401403436,Northern Iowa Panthers,AJ Green,4397475,,True,38.0,4,8,1,2,3,6,6,6,0,6,6,7,0,0,3,1,17
401403436,Northern Iowa Panthers,T. Berhow,4280203,,True,32.0,6,11,3,6,3,5,0,0,2,2,4,1,2,0,2,3,15
401403436,Northern Iowa Panthers,T. Pickford,4279167,,True,24.0,3,6,3,4,0,2,0,0,2,3,5,2,0,0,0,1,6
401403436,Northern Iowa Panthers,D. Krogmann,4592718,,False,1.0,0,0,0,0,0,0,0,0,0,0,0,0,0,0,0,0,0
401403436,Northern Iowa Panthers,C. Henry,4433004,,False,0.0,0,0,0,0,0,0,0,0,0,0,0,0,0,0,0,0,0
401403436,Northern Iowa Panthers,J. Betz,4431904,,False,1.0,0,0,0,0,0,0,0,0,0,0,0,0,0,0,0,0,0
401403436,Northern Iowa Panthers,A. Phyfe,4279169,,False,5.0,3,5,3,5,0,0,0,0,0,2,2,0,0,1,0,0,6
401403436,Northern Iowa Panthers,D. Daniel,4703915,,False,1.0,0,0,0,0,0,0,0,0,0,0,0,0,0,0,0,0,0
401403436,Northern Iowa Panthers,T. Anderson,4703914,,False,6.0,1,1,1,1,0,0,0,0,0,2,2,0,0,0,1,0,2
401403436,Northern Iowa Panthers,B. Born,4703913,,False,22.0,3,8,3,5,0,3,1,2,0,2,2,1,1,0,0,0,7
401403436,Northern Iowa Panthers,A. Kimmons,4433020,,False,3.0,0,1,0,1,0,0,0,0,0,0,0,0,0,0,0,0,0
401403436,Northern Iowa Panthers,TEAM,TOTAL,TOTAL,False,,28,59,20,35,8,24,14,16,9,24,33,16,6,1,8,9,78
401403436,Illinois State Redbirds,K. Lewis,4593851,,True,33.0,3,9,2,5,1,4,1,2,3,2,5,1,2,0,0,3,8
401403436,Illinois State Redbirds,A. Ndiaye,4397375,,True,19.0,1,2,1,2,0,0,0,0,2,2,4,0,1,1,2,3,2
401403436,Illinois State Redbirds,H. Fleming Jr.,4703899,,True,22.0,3,7,1,1,2,6,0,0,1,4,5,2,0,1,3,5,8
401403436,Illinois State Redbirds,A. Reeves,4592686,,True,37.0,6,13,5,9,1,4,7,7,0,5,5,4,0,3,2,1,20
401403436,Illinois State Redbirds,J. Strong,4398146,,True,35.0,3,11,1,2,2,9,0,0,0,6,6,3,2,0,0,0,8
401403436,Illinois State Redbirds,R. Schmitt,4897463,,False,2.0,0,1,0,1,0,0,0,0,0,0,0,0,0,0,0,1,0
401403436,Illinois State Redbirds,A. Andrews,4703901,,False,5.0,0,0,0,0,0,0,0,0,0,0,0,0,0,0,1,0,0
401403436,Illinois State Redbirds,H. Sissoko,4592687,,False,3.0,0,0,0,0,0,0,0,0,0,1,1,0,1,0,0,0,0
401403436,Illinois State Redbirds,L. McChesney,4433038,,False,23.0,4,6,1,1,3,5,2,2,1,1,2,1,0,0,0,1,13
401403436,Illinois State Redbirds,J. Johnson,4703904,,False,2.0,0,0,0,0,0,0,0,0,1,1,2,0,0,0,0,0,0
401403436,Illinois State Redbirds,N. Stadelman,4703902,,False,1.0,0,1,0,1,0,0,0,0,0,0,0,0,0,0,0,0,0
401403436,Illinois State Redbirds,E. Washington,4703900,,False,3.0,0,0,0,0,0,0,0,0,0,0,0,0,0,0,0,1,0
401403436,Illinois State Redbirds,M. Miller,4592685,,False,1.0,0,1,0,1,0,0,0,0,0,0,0,0,0,0,0,0,0
401403436,Illinois State Redbirds,M. Freeman,4432988,,False,14.0,2,4,0,1,2,3,0,0,0,1,1,0,2,0,6,2,6
401403436,Illinois State Redbirds,TEAM,TOTAL,TOTAL,False,,22,55,11,24,11,31,10,11,10,24,34,11,8,5,15,17,65
401403435,Valparaiso Beacons,B. Krikke,4592733,,True,25.0,4,4,4,4,0,0,2,2,0,3,3,1,1,0,1,1,10
401403435,Valparaiso Beacons,T. Kithier,4397211,,True,22.0,4,7,4,7,0,0,2,2,2,2,4,3,0,2,0,2,10
401403435,Valparaiso Beacons,K. Taylor,4897488,,True,33.0,3,9,3,4,0,5,3,4,0,5,5,2,1,0,1,1,9
401403435,Valparaiso Beacons,P. Ruedinger,4897485,,True,25.0,3,4,0,0,3,4,3,3,1,2,3,3,0,0,1,3,12
401403435,Valparaiso Beacons,K. King,4277992,,True,33.0,7,10,4,6,3,4,1,2,0,5,5,1,0,0,4,2,18
401403435,Valparaiso Beacons,T. Woodyard,4897489,,False,7.0,0,0,0,0,0,0,0,0,0,0,0,0,0,0,1,1,0
401403435,Valparaiso Beacons,B. Pappas,4592729,,False,1.0,0,0,0,0,0,0,0,0,0,0,0,0,0,0,0,0,0
401403435,Valparaiso Beacons,E. Freese-Vilien,4592731,,False,1.0,0,0,0,0,0,0,0,0,0,0,0,0,0,0,0,0,0
401403435,Valparaiso Beacons,J. Hedstrom,4397278,,False,2.0,0,0,0,0,0,0,0,0,0,0,0,0,0,0,0,0,0
401403435,Valparaiso Beacons,S. Edwards,4703982,,False,28.0,6,11,2,5,4,6,2,2,2,5,7,4,0,0,1,1,18
401403435,Valparaiso Beacons,L. Morrill,4592732,,False,1.0,1,1,1,1,0,0,0,0,0,0,0,0,0,0,0,0,2
401403435,Valparaiso Beacons,E. Gordon,4065815,,False,22.0,0,2,0,0,0,2,2,2,0,2,2,1,2,0,1,0,2
401403435,Valparaiso Beacons,TEAM,TOTAL,TOTAL,False,,28,48,18,27,10,21,15,17,5,26,31,15,4,2,11,11,81
401403435,Evansville Purple Aces,B. Sisley,4897452,,True,28.0,6,11,5,8,1,3,0,0,0,0,0,0,0,0,0,2,13
401403435,Evansville Purple Aces,E. Kuhlman,4279131,,True,37.0,5,10,4,9,1,1,2,2,0,2,2,1,1,0,4,0,13
401403435,Evansville Purple Aces,B. Beauchamp,4897454,,True,38.0,3,11,2,5,1,6,2,2,0,3,3,0,1,0,1,3,9
401403435,Evansville Purple Aces,S. Givance,4397353,,True,32.0,4,8,3,5,1,3,1,4,2,3,5,6,3,0,3,4,10
401403435,Evansville Purple Aces,N. Frederking,4279133,,True,38.0,5,8,2,2,3,6,0,0,1,5,6,0,0,0,0,1,13
401403435,Evansville Purple Aces,P. Phillips,4897456,,False,14.0,0,1,0,0,0,1,0,0,0,2,2,2,0,2,0,2,0
401403435,Evansville Purple Aces,E. Page,4703892,,False,1.0,0,0,0,0,0,0,0,0,0,0,0,0,0,0,0,0,0
401403435,Evansville Purple Aces,G. Bobe,4592682,,False,5.0,0,0,0,0,0,0,0,0,0,0,0,1,0,0,1,0,0
401403435,Evansville Purple Aces,J. Newton,4397354,,False,7.0,0,3,0,3,0,0,1,2,1,0,1,0,0,0,0,0,1
401403435,Evansville Purple Aces,TEAM,TOTAL,TOTAL,False,,23,52,16,32,7,20,6,10,5,15,20,10,5,2,9,12,59
401403434,Indiana State Sycamores,S. Wilbar,4897468,,True,10.0,1,7,1,3,0,4,0,0,1,2,3,1,1,0,0,0,2
401403434,Indiana State Sycamores,K. Stephens,4703906,,True,30.0,4,7,3,5,1,2,3,4,0,7,7,0,2,0,1,1,12
401403434,Indiana State Sycamores,C. Henry,4897469,,True,34.0,4,11,4,8,0,3,1,2,1,0,1,4,3,0,4,4,9
401403434,Indiana State Sycamores,J. Larry,4703907,,True,38.0,2,3,2,2,0,1,0,0,1,7,8,2,1,0,1,1,4
401403434,Indiana State Sycamores,C. Neese,4288068,,True,35.0,2,11,1,2,1,9,0,1,0,4,4,1,1,0,5,1,5
401403434,Indiana State Sycamores,Z. Hobbs,4897470,,False,24.0,4,8,0,0,4,8,0,0,1,3,4,0,0,1,0,3,12
401403434,Indiana State Sycamores,M. Thomas,4897467,,False,3.0,0,0,0,0,0,0,2,2,0,1,1,0,0,1,2,0,2
401403434,Indiana State Sycamores,X. Bledson,4897464,,False,26.0,2,5,1,2,1,3,2,2,0,1,1,3,1,0,0,0,7
401403434,Indiana State Sycamores,TEAM,TOTAL,TOTAL,False,,19,52,12,22,7,30,8,11,6,27,33,11,9,2,14,10,53
401403434,Illinois State Redbirds,K. Lewis,4593851,,True,30.0,3,4,3,3,0,1,2,2,1,7,8,0,1,0,2,4,8
401403434,Illinois State Redbirds,A. Ndiaye,4397375,,True,30.0,2,3,2,2,0,1,0,0,2,4,6,3,1,2,0,2,4
401403434,Illinois State Redbirds,H. Fleming Jr.,4703899,,True,24.0,2,7,0,4,2,3,1,2,1,5,6,4,1,0,1,1,7
401403434,Illinois State Redbirds,A. Reeves,4592686,,True,38.0,7,15,6,11,1,4,0,0,0,4,4,0,2,0,3,0,15
401403434,Illinois State Redbirds,J. Strong,4398146,,True,28.0,5,13,2,6,3,7,0,0,0,0,0,2,1,0,0,0,13
401403434,Illinois State Redbirds,R. Schmitt,4897463,,False,10.0,1,3,1,3,0,0,0,0,0,1,1,1,0,0,0,0,2
401403434,Illinois State Redbirds,L. McChesney,4433038,,False,17.0,2,4,1,1,1,3,0,0,1,4,5,0,0,0,1,2,5
401403434,Illinois State Redbirds,M. Miller,4592685,,False,3.0,0,1,0,0,0,1,0,0,0,0,0,0,1,0,0,0,0
401403434,Illinois State Redbirds,M. Freeman,4432988,,False,20.0,0,6,0,4,0,2,4,4,0,3,3,2,1,0,3,1,4
401403434,Illinois State Redbirds,TEAM,TOTAL,TOTAL,False,,22,56,15,34,7,22,7,8,8,29,37,12,8,2,12,10,58
401403433,Howard Bison,S. Settle III,4704043,,True,34.0,5,13,4,9,1,4,5,6,3,9,12,0,2,0,2,1,16
401403433,Howard Bison,R. Brumant,4279466,,True,26.0,3,4,3,4,0,0,3,4,4,1,5,2,0,0,2,3,9
401403433,Howard Bison,E. Hawkins,4897766,,True,38.0,3,16,3,11,0,5,5,7,0,6,6,4,1,0,9,1,11
401403433,Howard Bison,K. Foster,4279792,,True,37.0,3,11,1,5,2,6,0,0,0,6,6,0,1,0,1,1,8
401403433,Howard Bison,T. Bibbs,4279470,,True,23.0,1,7,1,5,0,2,2,2,5,2,7,0,1,0,1,1,4
401403433,Howard Bison,S. Green,4067227,,False,13.0,0,2,0,1,0,1,0,0,1,1,2,0,0,0,1,2,0
401403433,Howard Bison,B. Harris,4897768,,False,10.0,3,6,3,5,0,1,3,4,6,4,10,0,0,1,3,0,9
401403433,Howard Bison,D. Richmond,4704044,,False,7.0,0,0,0,0,0,0,0,0,1,0,1,0,0,0,2,1,0
401403433,Howard Bison,K. Robinson,4432102,,False,12.0,0,2,0,1,0,1,0,0,0,1,1,1,0,0,1,2,0
401403433,Howard Bison,TEAM,TOTAL,TOTAL,False,,18,61,15,41,3,20,18,23,21,30,51,7,5,1,23,12,57
401403433,Coppin State Eagles,S. Conteh,4593442,,True,28.0,0,4,0,2,0,2,0,0,0,2,2,1,2,2,0,3,0
401403433,Coppin State Eagles,J. Zarzuela,4897759,,True,30.0,3,11,2,5,1,6,1,2,0,2,2,0,0,0,7,4,8
401403433,Coppin State Eagles,A. Rojas,4897756,,True,18.0,2,4,1,3,1,1,0,0,2,1,3,0,1,0,0,1,5
401403433,Coppin State Eagles,N. Tarke,4704077,,True,38.0,7,13,6,10,1,3,0,0,1,9,10,6,4,0,2,2,15
401403433,Coppin State Eagles,K. Cardaci,4397944,,True,37.0,4,7,0,2,4,5,3,3,1,1,2,1,1,0,1,0,15
401403433,Coppin State Eagles,N. Stokes,4593262,,False,1.0,0,0,0,0,0,0,0,0,0,0,0,0,0,0,1,2,0
401403433,Coppin State Eagles,G. Spurlock,4897755,,False,7.0,0,2,0,1,0,1,0,0,0,0,0,0,0,0,0,1,0
401403433,Coppin State Eagles,M. Hood,4702075,,False,25.0,3,8,2,3,1,5,1,3,0,1,1,2,1,0,3,2,8
401403433,Coppin State Eagles,J. Steers,4398112,,False,16.0,3,7,3,7,0,0,2,3,1,4,5,1,0,0,2,5,8
401403433,Coppin State Eagles,TEAM,TOTAL,TOTAL,False,,22,56,14,33,8,23,7,11,5,23,28,11,9,2,16,20,59
401403432,Norfolk State Spartans,D. Tate,4397180,,True,37.0,4,8,2,6,2,2,4,6,1,6,7,3,0,0,4,2,14
401403432,Norfolk State Spartans,K. Bankston,4280289,,True,36.0,5,10,5,10,0,0,4,6,2,5,7,2,2,2,2,3,14
401403432,Norfolk State Spartans,J. Hawkins,4593134,,True,34.0,5,12,4,5,1,7,6,8,2,5,7,3,3,0,4,3,17
401403432,Norfolk State Spartans,T. Jenkins,4595430,,True,19.0,1,4,0,1,1,3,2,2,2,2,4,0,0,1,0,2,5
401403432,Norfolk State Spartans,J. Bryant Jr.,4398206,,True,37.0,2,9,1,4,1,5,4,4,0,5,5,2,1,1,6,2,9
401403432,Norfolk State Spartans,N. Chambers,4593404,,False,4.0,2,2,2,2,0,0,0,0,1,1,2,0,0,0,0,0,4
401403432,Norfolk State Spartans,T. Jones,4898280,,False,2.0,1,1,0,0,1,1,0,0,0,1,1,0,0,0,0,0,3
401403432,Norfolk State Spartans,D. Anderson,4593406,,False,10.0,0,1,0,0,0,1,0,2,1,0,1,0,0,0,0,2,0
401403432,Norfolk State Spartans,C. Ings,4431996,,False,21.0,1,3,0,1,1,2,5,6,2,1,3,6,1,0,4,1,8
401403432,Norfolk State Spartans,TEAM,TOTAL,TOTAL,False,,21,50,14,29,7,21,25,34,14,27,41,16,7,4,21,15,74
401403432,Delaware State Hornets,Z. Kent,4278115,,True,9.0,1,1,1,1,0,0,0,0,2,1,3,0,0,0,3,3,2
401403432,Delaware State Hornets,C. Sodom,4278568,,True,17.0,0,0,0,0,0,0,0,0,0,1,1,0,0,2,0,3,0
401403432,Delaware State Hornets,M. Robinson,4703996,,True,33.0,1,7,1,4,0,3,0,0,0,5,5,4,0,1,2,4,2
401403432,Delaware State Hornets,J. Stansbury,4599907,,True,33.0,3,7,2,5,1,2,5,5,0,2,2,1,2,0,4,4,12
401403432,Delaware State Hornets,M. Carter,4284101,,True,38.0,10,24,7,18,3,6,4,5,3,6,9,4,3,0,3,2,27
401403432,Delaware State Hornets,D. Baucum,4410587,,False,21.0,4,7,2,3,2,4,0,0,0,1,1,1,4,0,2,1,10
401403432,Delaware State Hornets,R. Lucas,4398122,,False,5.0,0,1,0,1,0,0,0,0,0,0,0,0,0,0,1,0,0
401403432,Delaware State Hornets,I. Palmer,4897763,,False,0.0,0,0,0,0,0,0,0,0,0,0,0,0,0,0,0,0,0
401403432,Delaware State Hornets,C. Perkins,4897761,,False,16.0,0,2,0,1,0,1,2,2,0,1,1,1,1,0,0,2,2
401403432,Delaware State Hornets,D. Fragala,4279737,,False,28.0,4,11,1,2,3,9,0,1,0,1,1,0,0,0,0,4,11
401403432,Delaware State Hornets,TEAM,TOTAL,TOTAL,False,,23,60,14,35,9,25,11,13,7,18,25,11,10,3,17,23,66
401403431,North Carolina Central Eagles,C. Butler,4898289,,True,26.0,1,2,1,2,0,0,2,6,2,4,6,0,0,0,2,4,4
401403431,North Carolina Central Eagles,K. Monroe,4397106,,True,21.0,4,6,3,4,1,2,1,1,2,2,4,1,1,0,3,4,10
401403431,North Carolina Central Eagles,J. Wright,4704109,,True,30.0,4,14,4,11,0,3,6,12,0,6,6,0,4,0,3,2,14
401403431,North Carolina Central Eagles,E. Boone,4702114,,True,30.0,2,5,2,3,0,2,8,10,0,6,6,3,3,1,5,2,12
401403431,North Carolina Central Eagles,R. Miller Jr.,4398239,,True,22.0,0,3,0,3,0,0,0,0,2,0,2,1,0,0,3,1,0
401403431,North Carolina Central Eagles,A. Caldwell,4715106,,False,5.0,0,1,0,0,0,1,0,0,0,0,0,0,0,0,1,1,0
401403431,North Carolina Central Eagles,J. Harris,4593705,,False,14.0,3,4,1,1,2,3,2,2,0,2,2,0,0,0,2,1,10
401403431,North Carolina Central Eagles,N. Fennell,4398240,,False,32.0,5,5,5,5,0,0,5,7,1,6,7,3,0,0,1,2,15
401403431,North Carolina Central Eagles,M. Maultsby,4396576,,False,20.0,1,4,0,1,1,3,0,0,0,1,1,1,0,0,0,0,3
401403431,North Carolina Central Eagles,TEAM,TOTAL,TOTAL,False,,20,44,16,30,4,14,24,38,8,28,36,9,8,1,20,17,68
401403431,Maryland Eastern Shore Hawks,N. Pollard Jr.,4704102,,True,29.0,7,11,7,10,0,1,5,7,3,4,7,0,1,2,4,2,19
401403431,Maryland Eastern Shore Hawks,Z. Styles,4704099,,True,31.0,2,9,1,6,1,3,3,4,2,4,6,1,1,1,5,4,8
401403431,Maryland Eastern Shore Hawks,D. London,4700872,,True,29.0,1,5,1,3,0,2,7,8,0,1,1,1,3,0,2,2,9
401403431,Maryland Eastern Shore Hawks,D. Phillip,4593381,,True,29.0,2,9,2,5,0,4,1,2,1,5,6,3,2,0,5,4,5
401403431,Maryland Eastern Shore Hawks,K. Voyles,4593380,,True,30.0,6,14,5,10,1,4,0,0,1,1,2,0,1,0,2,1,13
401403431,Maryland Eastern Shore Hawks,M. Akinsanya,4704101,,False,4.0,0,0,0,0,0,0,0,0,0,2,2,0,0,0,0,1,0
401403431,Maryland Eastern Shore Hawks,C. Davis,4898269,,False,21.0,1,4,1,2,0,2,0,0,3,0,3,2,1,0,1,3,2
401403431,Maryland Eastern Shore Hawks,D. Nugent,4704097,,False,16.0,0,2,0,0,0,2,0,0,0,0,0,1,0,0,0,1,0
401403431,Maryland Eastern Shore Hawks,M. Mensah,4704096,,False,8.0,0,3,0,0,0,3,0,0,0,0,0,0,0,0,0,4,0
401403431,Maryland Eastern Shore Hawks,G. Anderson,4593382,,False,3.0,0,1,0,0,0,1,0,0,0,0,0,0,1,0,1,0,0
401403431,Maryland Eastern Shore Hawks,TEAM,TOTAL,TOTAL,False,,19,58,17,36,2,22,16,21,12,20,32,8,10,3,20,22,56
401403430,South Carolina State Bulldogs,J. Davis,4898328,,True,36.0,3,8,3,6,0,2,4,6,2,0,2,1,1,0,1,0,10
401403430,South Carolina State Bulldogs,O. Croskey,4593418,,True,33.0,4,7,2,2,2,5,1,2,1,1,2,1,2,3,4,5,11
401403430,South Carolina State Bulldogs,D. Williams,4286093,,True,24.0,2,3,2,3,0,0,3,5,3,2,5,0,1,1,2,4,7
401403430,South Carolina State Bulldogs,TJ Madlock,4898331,,True,35.0,8,16,6,14,2,2,1,3,4,7,11,2,1,0,3,1,19
401403430,South Carolina State Bulldogs,R. Edwards,4593417,,True,30.0,3,13,1,4,2,9,0,1,0,0,0,2,0,0,4,2,8
401403430,South Carolina State Bulldogs,R. Gary,4898329,,False,12.0,4,8,2,3,2,5,0,0,1,1,2,2,0,0,0,3,10
401403430,South Carolina State Bulldogs,L. Lawrence,4704080,,False,5.0,1,1,1,1,0,0,1,1,1,0,1,0,1,0,1,0,3
401403430,South Carolina State Bulldogs,E. Oliver-Hampton,4592668,,False,8.0,1,2,1,2,0,0,1,2,2,0,2,1,0,0,0,1,3
401403430,South Carolina State Bulldogs,R. Brown,4432948,,False,17.0,3,3,3,3,0,0,0,0,2,2,4,0,0,1,1,3,6
401403430,South Carolina State Bulldogs,TEAM,TOTAL,TOTAL,False,,29,61,21,38,8,23,11,20,16,16,32,9,6,5,17,19,77
401403430,Morgan State Bears,C. Venning,4711312,,True,20.0,7,12,7,12,0,0,1,2,2,1,3,1,1,2,1,3,15
401403430,Morgan State Bears,M. Miller,4398197,,True,35.0,8,8,8,8,0,0,0,0,2,5,7,3,3,0,2,4,16
401403430,Morgan State Bears,S. Devonish,4398196,,True,33.0,2,5,2,5,0,0,1,2,2,3,5,3,0,0,2,3,5
401403430,Morgan State Bears,T. Moore,4278218,,True,23.0,4,7,3,4,1,3,0,0,0,0,0,1,1,0,1,2,9
401403430,Morgan State Bears,S. Woods,4065676,,True,15.0,0,1,0,1,0,0,0,0,1,0,1,1,1,0,1,2,0
401403430,Morgan State Bears,L. Grantsaan,4593392,,False,20.0,5,10,4,8,1,2,1,2,2,3,5,3,0,0,2,4,12
401403430,Morgan State Bears,C. Nnamene,4397977,,False,2.0,0,0,0,0,0,0,0,0,0,1,1,0,0,0,0,0,0
401403430,Morgan State Bears,D. Ware,4398326,,False,24.0,2,8,1,6,1,2,3,6,1,2,3,1,1,0,2,0,8
401403430,Morgan State Bears,I. Burke,4398199,,False,20.0,3,5,1,2,2,3,5,6,0,0,0,1,1,0,1,1,13
401403430,Morgan State Bears,K. McGee,4397356,,False,8.0,0,1,0,0,0,1,2,2,0,1,1,1,1,0,0,2,2
401403430,Morgan State Bears,TEAM,TOTAL,TOTAL,False,,31,57,26,46,5,11,13,20,11,18,29,15,9,2,14,21,80
401403429,North Carolina Central Eagles,C. Butler,4898289,,True,18.0,1,3,1,3,0,0,1,2,3,7,10,0,0,0,2,2,3
401403429,North Carolina Central Eagles,K. Monroe,4397106,,True,40.0,7,11,5,6,2,5,2,3,2,5,7,1,0,1,2,4,18
401403429,North Carolina Central Eagles,J. Wright,4704109,,True,39.0,6,15,5,11,1,4,1,3,2,5,7,4,3,0,3,2,14
401403429,North Carolina Central Eagles,E. Boone,4702114,,True,37.0,4,15,3,12,1,3,3,4,3,3,6,1,1,0,4,2,12
401403429,North Carolina Central Eagles,R. Miller Jr.,4398239,,True,30.0,3,9,1,4,2,5,4,4,0,1,1,1,0,0,1,1,12
401403429,North Carolina Central Eagles,A. Caldwell,4715106,,False,3.0,2,4,1,2,1,2,0,0,1,0,1,1,0,0,0,3,5
401403429,North Carolina Central Eagles,J. Harris,4593705,,False,8.0,0,2,0,0,0,2,0,0,1,0,1,1,0,0,0,0,0
401403429,North Carolina Central Eagles,N. Fennell,4398240,,False,20.0,3,3,2,2,1,1,2,2,2,2,4,1,0,1,1,5,9
401403429,North Carolina Central Eagles,M. Maultsby,4396576,,False,5.0,0,1,0,0,0,1,0,0,0,1,1,0,0,0,0,1,0
401403429,North Carolina Central Eagles,TEAM,TOTAL,TOTAL,False,,26,63,18,40,8,23,13,18,15,25,40,10,4,2,14,20,73
401403429,Coppin State Eagles,S. Conteh,4593442,,True,25.0,0,2,0,0,0,2,4,5,0,2,2,0,0,0,2,1,4
401403429,Coppin State Eagles,J. Zarzuela,4897759,,True,35.0,8,13,2,5,6,8,5,6,1,4,5,7,2,0,2,0,27
401403429,Coppin State Eagles,A. Rojas,4897756,,True,30.0,2,3,1,1,1,2,0,0,1,1,2,0,0,0,0,2,5
401403429,Coppin State Eagles,N. Tarke,4704077,,True,36.0,4,14,3,8,1,6,5,8,1,2,3,2,1,1,4,4,14
401403429,Coppin State Eagles,K. Cardaci,4397944,,True,29.0,3,8,0,0,3,8,0,0,0,1,1,2,1,0,0,2,9
401403429,Coppin State Eagles,D. Titus,4897758,,False,3.0,0,0,0,0,0,0,0,0,0,0,0,0,0,1,1,1,0
401403429,Coppin State Eagles,G. Spurlock,4897755,,False,5.0,0,0,0,0,0,0,0,0,0,0,0,0,0,0,0,0,0
401403429,Coppin State Eagles,M. Hood,4702075,,False,19.0,2,4,1,2,1,2,2,2,0,1,1,0,1,0,2,2,7
401403429,Coppin State Eagles,J. Steers,4398112,,False,18.0,4,9,4,8,0,1,5,7,2,11,13,1,1,2,1,2,13
401403429,Coppin State Eagles,TEAM,TOTAL,TOTAL,False,,23,53,11,24,12,29,21,28,9,23,32,12,6,4,12,14,79
401403428,Norfolk State Spartans,D. Tate,4397180,,True,31.0,6,13,4,10,2,3,0,0,3,8,11,2,0,2,3,5,14
401403428,Norfolk State Spartans,K. Bankston,4280289,,True,32.0,6,7,6,7,0,0,2,2,2,3,5,1,2,4,2,3,14
401403428,Norfolk State Spartans,J. Hawkins,4593134,,True,39.0,6,13,5,10,1,3,6,7,0,2,2,1,0,1,1,1,19
401403428,Norfolk State Spartans,T. Jenkins,4595430,,True,27.0,0,1,0,0,0,1,0,0,0,2,2,3,0,1,2,3,0
401403428,Norfolk State Spartans,J. Bryant Jr.,4398206,,True,38.0,6,13,6,10,0,3,7,8,0,5,5,4,1,0,3,2,19
401403428,Norfolk State Spartans,N. Chambers,4593404,,False,10.0,1,1,1,1,0,0,1,2,1,2,3,0,0,0,0,0,3
401403428,Norfolk State Spartans,C. Ford,4398209,,False,4.0,1,1,1,1,0,0,0,0,0,0,0,0,0,1,0,1,2
401403428,Norfolk State Spartans,D. Anderson,4593406,,False,5.0,0,0,0,0,0,0,0,0,0,0,0,0,0,0,1,0,0
401403428,Norfolk State Spartans,C. Ings,4431996,,False,14.0,0,2,0,1,0,1,1,2,0,0,0,0,0,0,2,1,1
401403428,Norfolk State Spartans,TEAM,TOTAL,TOTAL,False,,26,51,23,40,3,11,17,21,8,24,32,11,3,9,14,16,72
401403428,Morgan State Bears,C. Venning,4711312,,True,20.0,1,6,1,6,0,0,1,2,2,1,3,0,0,3,1,4,3
401403428,Morgan State Bears,M. Miller,4398197,,True,31.0,6,12,5,11,1,1,1,4,3,5,8,1,1,2,3,2,14
401403428,Morgan State Bears,S. Devonish,4398196,,True,33.0,0,4,0,4,0,0,0,0,1,2,3,4,0,0,1,3,0
401403428,Morgan State Bears,T. Moore,4278218,,True,27.0,3,6,1,1,2,5,0,0,3,1,4,2,2,0,1,2,8
401403428,Morgan State Bears,S. Woods,4065676,,True,14.0,0,3,0,1,0,2,2,2,0,3,3,0,1,1,1,1,2
401403428,Morgan State Bears,L. Grantsaan,4593392,,False,16.0,4,8,4,7,0,1,1,2,1,3,4,0,0,1,0,3,9
401403428,Morgan State Bears,C. Nnamene,4397977,,False,2.0,0,0,0,0,0,0,0,0,0,0,0,0,0,0,0,0,0
401403428,Morgan State Bears,D. Ware,4398326,,False,15.0,2,7,2,2,0,5,2,2,0,1,1,0,0,0,2,1,6
401403428,Morgan State Bears,I. Burke,4398199,,False,25.0,5,7,1,1,4,6,0,2,2,2,4,5,1,1,1,2,14
401403428,Morgan State Bears,K. McGee,4397356,,False,17.0,2,7,1,3,1,4,2,2,0,1,1,3,3,0,2,2,7
401403428,Morgan State Bears,TEAM,TOTAL,TOTAL,False,,23,60,15,36,8,24,9,16,16,19,35,15,8,8,13,20,63
401403427,Norfolk State Spartans,D. Tate,4397180,,True,37.0,5,11,3,7,2,4,1,1,1,7,8,1,1,0,2,3,13
401403427,Norfolk State Spartans,K. Bankston,4280289,,True,36.0,3,6,3,6,0,0,3,4,2,6,8,3,0,1,3,0,9
401403427,Norfolk State Spartans,J. Hawkins,4593134,,True,37.0,5,9,3,5,2,4,5,6,1,4,5,2,2,2,5,3,17
401403427,Norfolk State Spartans,T. Jenkins,4595430,,True,24.0,1,5,1,1,0,4,0,0,0,3,3,2,0,0,1,2,2
401403427,Norfolk State Spartans,J. Bryant Jr.,4398206,,True,39.0,7,14,2,5,5,9,4,4,1,3,4,2,1,0,5,3,23
401403427,Norfolk State Spartans,N. Chambers,4593404,,False,4.0,0,2,0,2,0,0,0,0,1,0,1,2,0,1,1,0,0
401403427,Norfolk State Spartans,D. Anderson,4593406,,False,19.0,2,2,0,0,2,2,0,0,1,3,4,1,0,0,2,0,6
401403427,Norfolk State Spartans,C. Ings,4431996,,False,4.0,1,1,1,1,0,0,0,0,0,2,2,0,0,0,0,0,2
401403427,Norfolk State Spartans,TEAM,TOTAL,TOTAL,False,,24,50,13,27,11,23,13,15,8,33,41,13,4,4,20,11,72
401403427,Coppin State Eagles,S. Conteh,4593442,,True,13.0,0,3,0,0,0,3,0,0,0,1,1,0,0,0,0,1,0
401403427,Coppin State Eagles,J. Zarzuela,4897759,,True,38.0,3,13,3,4,0,9,5,7,0,2,2,6,5,0,3,2,11
401403427,Coppin State Eagles,A. Rojas,4897756,,True,15.0,1,3,0,0,1,3,0,0,0,1,1,0,1,0,0,3,3
401403427,Coppin State Eagles,N. Tarke,4704077,,True,38.0,6,16,5,8,1,8,3,6,1,4,5,3,2,0,3,3,16
401403427,Coppin State Eagles,K. Cardaci,4397944,,True,37.0,3,8,2,2,1,6,2,2,0,1,1,0,3,0,0,0,9
401403427,Coppin State Eagles,R. Lemovou,4897757,,False,1.0,0,0,0,0,0,0,0,0,0,0,0,0,0,0,0,0,0
401403427,Coppin State Eagles,G. Spurlock,4897755,,False,10.0,0,0,0,0,0,0,0,0,0,0,0,1,1,0,0,2,0
401403427,Coppin State Eagles,M. Hood,4702075,,False,19.0,2,7,0,1,2,6,0,2,1,1,2,1,0,0,1,1,6
401403427,Coppin State Eagles,J. Steers,4398112,,False,29.0,6,10,6,10,0,0,0,0,4,3,7,0,1,1,2,4,12
401403427,Coppin State Eagles,TEAM,TOTAL,TOTAL,False,,21,60,16,25,5,35,10,17,9,17,26,11,13,1,9,16,57
401403426,Saint Peter's Peacocks,C. Rupert,4898258,,True,8.0,0,2,0,2,0,0,0,0,0,0,0,0,0,1,0,1,0
401403426,Saint Peter's Peacocks,H. Drame,4593387,,True,25.0,2,6,2,5,0,1,2,2,3,3,6,1,0,0,1,4,6
401403426,Saint Peter's Peacocks,K. Ndefo,4398386,,True,27.0,3,5,3,5,0,0,1,5,2,5,7,2,0,4,3,5,7
401403426,Saint Peter's Peacocks,M. Lee,4593388,,True,21.0,3,6,1,1,2,5,0,0,0,2,2,2,0,0,1,4,8
401403426,Saint Peter's Peacocks,D. Banks III,4593386,,True,25.0,2,5,0,2,2,3,2,2,0,0,0,2,0,0,3,3,8
401403426,Saint Peter's Peacocks,F. Drame,4432970,,False,25.0,2,3,2,2,0,1,0,0,1,9,10,0,0,1,1,5,4
401403426,Saint Peter's Peacocks,L. Reid,4898255,,False,9.0,0,1,0,1,0,0,0,0,0,1,1,0,0,0,1,1,0
401403426,Saint Peter's Peacocks,I. Dasher,4701199,,False,19.0,1,4,0,1,1,3,2,2,0,3,3,0,2,0,1,0,5
401403426,Saint Peter's Peacocks,J. Murray,4683865,,False,9.0,1,4,1,3,0,1,0,1,0,1,1,0,0,0,1,0,2
401403426,Saint Peter's Peacocks,D. Edert,4432977,,False,32.0,5,10,3,4,2,6,8,9,0,1,1,2,0,0,0,1,20
401403426,Saint Peter's Peacocks,TEAM,TOTAL,TOTAL,False,,19,46,12,26,7,20,15,21,8,26,34,9,2,6,12,24,60
401403426,Monmouth Hawks,J. Vaughan,4593338,,True,18.0,3,6,2,4,1,2,3,4,1,3,4,0,3,1,1,5,10
401403426,Monmouth Hawks,W. Miller,4277910,,True,35.0,2,12,2,9,0,3,11,14,3,3,6,1,1,2,1,1,15
401403426,Monmouth Hawks,M. McClary,4279736,,True,23.0,1,5,1,4,0,1,1,1,2,3,5,0,1,0,1,3,3
401403426,Monmouth Hawks,G. Papas,4279735,,True,38.0,2,11,0,2,2,9,0,0,1,2,3,3,3,0,1,1,6
401403426,Monmouth Hawks,S. Reynolds,4278578,,True,34.0,3,11,3,8,0,3,6,6,1,4,5,2,0,0,3,5,12
401403426,Monmouth Hawks,M. Foster,4703425,,False,5.0,0,1,0,1,0,0,0,0,0,1,1,1,0,0,1,2,0
401403426,Monmouth Hawks,N. Rutty,4398408,,False,17.0,0,1,0,1,0,0,4,6,3,3,6,0,0,0,1,1,4
401403426,Monmouth Hawks,M. Ruth,4703427,,False,20.0,1,3,1,2,0,1,2,2,0,5,5,0,0,0,0,2,4
401403426,Monmouth Hawks,S. Chaput,4398409,,False,10.0,0,1,0,1,0,0,0,0,0,0,0,0,1,0,0,0,0
401403426,Monmouth Hawks,TEAM,TOTAL,TOTAL,False,,12,51,9,32,3,19,27,33,16,24,40,7,9,3,9,20,54
401403425,Saint Peter's Peacocks,C. Rupert,4898258,,True,15.0,2,5,2,5,0,0,0,0,2,4,6,1,0,0,1,0,4
401403425,Saint Peter's Peacocks,H. Drame,4593387,,True,30.0,2,2,1,1,1,1,0,0,1,5,6,0,3,0,0,3,5
401403425,Saint Peter's Peacocks,K. Ndefo,4398386,,True,26.0,6,11,6,11,0,0,1,2,1,6,7,2,1,3,2,3,13
401403425,Saint Peter's Peacocks,M. Lee,4593388,,True,29.0,5,10,3,5,2,5,2,4,0,2,2,1,2,1,1,0,14
401403425,Saint Peter's Peacocks,D. Banks III,4593386,,True,30.0,1,8,1,5,0,3,4,5,0,0,0,2,4,1,2,3,6
401403425,Saint Peter's Peacocks,F. Drame,4432970,,False,15.0,3,4,2,3,1,1,1,1,1,3,4,0,0,1,2,3,8
401403425,Saint Peter's Peacocks,L. Reid,4898255,,False,0.0,0,0,0,0,0,0,0,0,0,0,0,0,0,0,0,0,0
401403425,Saint Peter's Peacocks,I. Dasher,4701199,,False,16.0,0,2,0,2,0,0,0,0,0,1,1,1,1,0,1,1,0
401403425,Saint Peter's Peacocks,J. Murray,4683865,,False,11.0,1,4,0,2,1,2,1,2,0,1,1,2,0,0,0,1,4
401403425,Saint Peter's Peacocks,D. Edert,4432977,,False,28.0,3,9,1,4,2,5,2,2,1,6,7,0,1,0,1,0,10
401403425,Saint Peter's Peacocks,TEAM,TOTAL,TOTAL,False,,23,55,16,38,7,17,11,16,7,28,35,9,12,6,10,14,64
401403425,Quinnipiac Bobcats,J. Rigoni,4279743,,True,30.0,0,4,0,0,0,4,5,5,0,2,2,2,0,1,0,2,5
401403425,Quinnipiac Bobcats,K. Marfo,4066877,,True,31.0,5,11,5,11,0,0,0,0,1,10,11,4,1,0,4,3,10
401403425,Quinnipiac Bobcats,T. Chenery,4703434,,True,28.0,1,1,1,1,0,0,4,8,2,1,3,1,0,1,2,2,6
401403425,Quinnipiac Bobcats,D. Jones,4898242,,True,38.0,3,11,3,8,0,3,4,4,0,4,4,2,2,0,3,5,10
401403425,Quinnipiac Bobcats,M. Balanc,4398397,,True,30.0,5,12,1,6,4,6,0,0,0,0,0,1,1,0,2,3,14
401403425,Quinnipiac Bobcats,J. Riggins,4432089,,False,8.0,1,4,1,4,0,0,1,2,1,2,3,0,0,0,0,3,3
401403425,Quinnipiac Bobcats,L. Kortright,4703435,,False,16.0,1,4,1,2,0,2,0,0,0,1,1,0,1,0,3,0,2
401403425,Quinnipiac Bobcats,B. Martin,4609885,,False,0.0,0,0,0,0,0,0,0,0,0,0,0,0,0,0,0,0,0
401403425,Quinnipiac Bobcats,B. McGuire,4433042,,False,19.0,1,4,1,3,0,1,0,0,0,4,4,2,0,2,0,1,2
401403425,Quinnipiac Bobcats,TEAM,TOTAL,TOTAL,False,,17,51,13,35,4,16,14,19,8,29,37,12,5,4,15,19,52
401403424,Rider Broncs,M. James,4592283,,True,31.0,3,9,2,6,1,3,0,0,0,2,2,2,0,2,2,4,7
401403424,Rider Broncs,A. Ogemuno-Johnson,4406151,,True,30.0,2,4,2,4,0,0,3,4,3,5,8,4,0,0,0,2,7
401403424,Rider Broncs,D. Vaughn,4067347,,True,31.0,6,11,6,11,0,0,1,2,0,6,6,0,1,0,3,4,13
401403424,Rider Broncs,A. Powell,4593364,,True,37.0,7,11,2,4,5,7,0,0,0,1,1,1,1,0,1,1,19
401403424,Rider Broncs,D. Murray Jr.,4398029,,True,40.0,8,13,6,7,2,6,2,2,0,3,3,4,0,0,3,1,20
401403424,Rider Broncs,N. Benson,4705270,,False,9.0,0,0,0,0,0,0,0,0,0,1,1,1,0,0,2,3,0
401403424,Rider Broncs,C. McKeithan,4433243,,False,7.0,0,0,0,0,0,0,0,0,0,0,0,0,0,0,0,2,0
401403424,Rider Broncs,S. Altman,4432935,,False,13.0,1,3,1,2,0,1,0,0,0,2,2,0,1,0,0,1,2
401403424,Rider Broncs,J. Pope,4288898,,False,2.0,0,1,0,1,0,0,0,0,0,1,1,1,0,0,0,0,0
401403424,Rider Broncs,TEAM,TOTAL,TOTAL,False,,27,52,19,35,8,17,6,8,5,23,28,13,3,2,11,18,68
401403424,Monmouth Hawks,J. Vaughan,4593338,,True,23.0,3,5,1,3,2,2,0,0,2,2,4,1,0,0,0,3,8
401403424,Monmouth Hawks,W. Miller,4277910,,True,31.0,5,11,5,9,0,2,2,2,0,2,2,3,1,0,0,0,12
401403424,Monmouth Hawks,M. McClary,4279736,,True,38.0,1,5,1,4,0,1,3,4,3,3,6,2,3,0,0,2,5
401403424,Monmouth Hawks,G. Papas,4279735,,True,35.0,4,11,1,4,3,7,9,9,0,6,6,3,2,0,0,2,20
401403424,Monmouth Hawks,S. Reynolds,4278578,,True,30.0,5,10,1,4,4,6,3,4,0,2,2,3,0,0,2,2,17
401403424,Monmouth Hawks,M. Foster,4703425,,False,9.0,1,2,1,2,0,0,1,2,0,1,1,0,0,0,1,1,3
401403424,Monmouth Hawks,N. Rutty,4398408,,False,17.0,1,1,1,1,0,0,0,2,0,4,4,0,1,0,0,1,2
401403424,Monmouth Hawks,M. Ruth,4703427,,False,5.0,1,1,0,0,1,1,0,0,1,0,1,1,1,0,2,0,3
401403424,Monmouth Hawks,S. Chaput,4398409,,False,12.0,1,4,1,3,0,1,0,0,0,0,0,1,0,0,1,2,2
401403424,Monmouth Hawks,TEAM,TOTAL,TOTAL,False,,22,50,12,30,10,20,18,23,6,21,27,14,8,0,6,13,72
401403423,Niagara Purple Eagles,G. Kuakumensah,4279739,,True,27.0,1,3,1,3,0,0,2,4,2,1,3,0,1,0,1,3,4
401403423,Niagara Purple Eagles,J. Cintron,4278891,,True,32.0,4,7,4,6,0,1,3,6,4,4,8,1,1,1,1,3,11
401403423,Niagara Purple Eagles,N. Thomasson,4593752,,True,38.0,5,14,2,8,3,6,0,0,2,2,4,1,2,0,1,1,13
401403423,Niagara Purple Eagles,M. Hammond,4398404,,True,40.0,6,21,4,14,2,7,3,5,1,0,1,5,0,0,0,1,17
401403423,Niagara Purple Eagles,J. Roberts,4067403,,True,37.0,4,7,2,3,2,4,3,3,0,1,1,1,1,0,0,4,13
401403423,Niagara Purple Eagles,T. Traore,4703431,,False,5.0,0,1,0,1,0,0,0,0,0,2,2,0,0,0,0,1,0
401403423,Niagara Purple Eagles,S. Iorio,4280029,,False,16.0,0,1,0,1,0,0,0,2,2,6,8,0,1,1,3,0,0
401403423,Niagara Purple Eagles,J. Mackey,4719433,,False,5.0,0,1,0,0,0,1,0,0,0,2,2,1,0,0,0,0,0
401403423,Niagara Purple Eagles,S. Brown,4396836,,False,0.0,0,0,0,0,0,0,0,0,0,0,0,0,0,0,0,2,0
401403423,Niagara Purple Eagles,TEAM,TOTAL,TOTAL,False,,20,55,13,36,7,19,11,20,13,20,33,9,6,2,6,15,58
401403423,Monmouth Hawks,J. Vaughan,4593338,,True,9.0,1,2,0,0,1,2,0,0,2,2,4,0,0,0,2,3,3
401403423,Monmouth Hawks,W. Miller,4277910,,True,35.0,7,15,4,11,3,4,0,2,1,2,3,4,2,2,1,2,17
401403423,Monmouth Hawks,M. McClary,4279736,,True,35.0,3,9,2,7,1,2,3,4,2,2,4,0,0,0,1,1,10
401403423,Monmouth Hawks,G. Papas,4279735,,True,37.0,2,8,1,5,1,3,2,2,1,4,5,5,0,0,3,1,7
401403423,Monmouth Hawks,S. Reynolds,4278578,,True,33.0,6,10,4,7,2,3,1,2,1,4,5,5,0,0,1,4,15
401403423,Monmouth Hawks,K. Vuga,4703428,,False,5.0,1,2,0,1,1,1,0,0,2,0,2,1,0,0,1,0,3
401403423,Monmouth Hawks,M. Foster,4703425,,False,10.0,1,3,1,3,0,0,2,4,2,4,6,0,0,2,0,0,4
401403423,Monmouth Hawks,N. Rutty,4398408,,False,22.0,1,2,1,1,0,1,0,0,4,5,9,0,0,1,1,3,2
401403423,Monmouth Hawks,M. Ruth,4703427,,False,4.0,0,1,0,1,0,0,0,0,0,0,0,0,0,0,1,3,0
401403423,Monmouth Hawks,S. Chaput,4398409,,False,10.0,0,2,0,2,0,0,0,0,0,0,0,0,0,0,0,0,0
401403423,Monmouth Hawks,TEAM,TOTAL,TOTAL,False,,22,54,13,38,9,16,8,14,15,27,42,15,2,5,13,17,61
401403422,Siena Saints,J. Stormo,4397697,,True,33.0,5,10,5,10,0,0,2,4,3,3,6,2,0,2,2,2,12
401403422,Siena Saints,M. Baer,4397031,,True,29.0,2,7,0,4,2,3,2,2,2,4,6,1,2,0,0,1,8
401403422,Siena Saints,J. McCollum,4898267,,True,33.0,7,16,5,11,2,5,0,1,0,2,2,4,1,0,4,0,16
401403422,Siena Saints,J. Billups,4898266,,True,37.0,5,12,5,9,0,3,1,1,3,6,9,3,3,0,0,5,11
401403422,Siena Saints,C. Rogers,4592921,,True,38.0,5,18,2,13,3,5,1,2,3,2,5,1,1,1,1,2,14
401403422,Siena Saints,J. Kellier,4702457,,False,9.0,1,2,0,0,1,2,0,0,1,0,1,0,1,0,0,1,3
401403422,Siena Saints,R. Mahala,4398389,,False,1.0,0,0,0,0,0,0,0,0,0,0,0,0,0,0,0,0,0
401403422,Siena Saints,N. Hopkins,4067151,,False,20.0,1,6,0,2,1,4,4,4,1,2,3,1,0,0,0,1,7
401403422,Siena Saints,TEAM,TOTAL,TOTAL,False,,26,71,17,49,9,22,10,14,16,21,37,12,8,3,7,12,71
401403422,Quinnipiac Bobcats,J. Rigoni,4279743,,True,35.0,4,7,0,1,4,6,4,4,1,7,8,0,2,2,1,2,16
401403422,Quinnipiac Bobcats,K. Marfo,4066877,,True,25.0,4,6,4,6,0,0,1,1,2,9,11,2,2,1,1,1,9
401403422,Quinnipiac Bobcats,T. Chenery,4703434,,True,20.0,3,4,2,2,1,2,0,0,1,2,3,1,0,0,1,2,7
401403422,Quinnipiac Bobcats,D. Jones,4898242,,True,27.0,4,8,3,5,1,3,2,2,1,4,5,4,0,0,3,2,11
401403422,Quinnipiac Bobcats,M. Balanc,4398397,,True,37.0,6,16,3,8,3,8,0,0,1,2,3,1,0,0,4,0,15
401403422,Quinnipiac Bobcats,J. Riggins,4432089,,False,15.0,3,7,3,7,0,0,0,0,0,2,2,1,1,0,0,3,6
401403422,Quinnipiac Bobcats,L. Kortright,4703435,,False,21.0,4,7,3,5,1,2,0,1,2,2,4,7,1,0,3,2,9
401403422,Quinnipiac Bobcats,B. McGuire,4433042,,False,20.0,1,3,1,3,0,0,2,2,0,0,0,1,0,0,0,3,4
401403422,Quinnipiac Bobcats,TEAM,TOTAL,TOTAL,False,,29,58,19,37,10,21,9,10,9,31,40,17,6,3,14,15,77
401403421,Saint Peter's Peacocks,C. Rupert,4898258,,True,17.0,1,2,1,1,0,1,0,0,2,4,6,1,0,0,0,3,2
401403421,Saint Peter's Peacocks,H. Drame,4593387,,True,16.0,2,3,2,3,0,0,0,0,2,3,5,0,0,0,0,4,4
401403421,Saint Peter's Peacocks,K. Ndefo,4398386,,True,31.0,6,14,5,13,1,1,7,11,1,2,3,1,2,3,2,2,20
401403421,Saint Peter's Peacocks,M. Lee,4593388,,True,29.0,3,6,3,4,0,2,3,3,0,2,2,1,0,0,2,4,9
401403421,Saint Peter's Peacocks,D. Banks III,4593386,,True,30.0,5,10,4,7,1,3,3,6,2,2,4,2,2,0,0,1,14
401403421,Saint Peter's Peacocks,F. Drame,4432970,,False,26.0,4,5,4,5,0,0,2,3,2,1,3,0,0,0,0,3,10
401403421,Saint Peter's Peacocks,I. Dasher,4701199,,False,14.0,1,2,1,1,0,1,0,0,0,3,3,0,0,0,2,1,2
401403421,Saint Peter's Peacocks,J. Murray,4683865,,False,11.0,3,6,1,4,2,2,0,0,0,0,0,1,0,0,3,0,8
401403421,Saint Peter's Peacocks,D. Edert,4432977,,False,26.0,2,6,1,3,1,3,3,3,0,5,5,2,1,0,0,1,8
401403421,Saint Peter's Peacocks,TEAM,TOTAL,TOTAL,False,,27,54,22,41,5,13,18,26,9,25,34,8,5,3,10,19,77
401403421,Fairfield Stags,S. Cook,4702946,,True,24.0,3,8,3,8,0,0,7,8,2,7,9,0,1,0,2,1,13
401403421,Fairfield Stags,Z. Crisler,4431936,,True,11.0,0,2,0,0,0,2,0,0,0,0,0,0,2,0,0,1,0
401403421,Fairfield Stags,C. Green,4280068,,True,27.0,0,4,0,2,0,2,0,0,0,1,1,1,0,0,2,3,0
401403421,Fairfield Stags,J. Cruz,4279488,,True,28.0,2,7,2,6,0,1,2,2,1,4,5,0,1,0,1,5,6
401403421,Fairfield Stags,T. Benning,4279483,,True,39.0,7,14,5,10,2,4,3,3,0,4,4,3,0,0,1,3,19
401403421,Fairfield Stags,C. Maidoh,4593276,,False,16.0,3,3,3,3,0,0,2,3,1,3,4,1,0,0,1,1,8
401403421,Fairfield Stags,TJ Long,4896370,,False,30.0,3,8,1,2,2,6,0,0,0,3,3,0,1,2,0,4,8
401403421,Fairfield Stags,J. Wojcik,4397191,,False,25.0,1,4,0,1,1,3,6,6,0,0,0,0,1,0,0,2,9
401403421,Fairfield Stags,TEAM,TOTAL,TOTAL,False,,19,50,14,32,5,18,20,22,6,22,28,5,6,2,9,20,63
401403420,Rider Broncs,M. James,4592283,,True,34.0,5,12,4,10,1,2,2,3,2,4,6,2,1,0,0,4,13
401403420,Rider Broncs,A. Ogemuno-Johnson,4406151,,True,36.0,5,10,5,10,0,0,2,3,4,8,12,1,2,1,1,2,12
401403420,Rider Broncs,D. Vaughn,4067347,,True,19.0,3,4,3,4,0,0,0,0,1,0,1,1,1,0,2,4,6
401403420,Rider Broncs,A. Powell,4593364,,True,38.0,4,11,1,4,3,7,0,0,0,1,1,3,1,0,4,1,11
401403420,Rider Broncs,D. Murray Jr.,4398029,,True,37.0,8,14,6,11,2,3,3,3,0,4,4,8,0,0,0,0,21
401403420,Rider Broncs,N. Benson,4705270,,False,22.0,2,3,2,2,0,1,0,0,0,1,1,0,1,0,0,2,4
401403420,Rider Broncs,C. McKeithan,4433243,,False,4.0,0,1,0,1,0,0,0,0,0,0,0,0,1,0,1,1,0
401403420,Rider Broncs,S. Altman,4432935,,False,8.0,2,2,2,2,0,0,0,0,0,0,0,0,0,0,2,1,4
401403420,Rider Broncs,J. Pope,4288898,,False,2.0,0,0,0,0,0,0,0,0,0,0,0,0,0,0,1,1,0
401403420,Rider Broncs,TEAM,TOTAL,TOTAL,False,,29,57,23,44,6,13,7,9,10,20,30,15,7,1,13,16,71
401403420,Iona Gaels,D. van Eyck,4593320,,True,32.0,3,9,2,4,1,5,0,2,2,2,4,5,2,1,3,3,7
401403420,Iona Gaels,N. Junior Joseph,4703015,,True,33.0,4,9,4,9,0,0,3,4,3,3,6,1,0,5,2,1,11
401403420,Iona Gaels,B. JeanLouis,4703008,,True,19.0,0,2,0,1,0,1,0,0,1,1,2,1,0,0,1,1,0
401403420,Iona Gaels,E. Joiner,4278407,,True,36.0,5,9,2,5,3,4,0,0,0,3,3,3,0,0,3,3,13
401403420,Iona Gaels,T. Jolly,4066291,,True,34.0,7,12,5,8,2,4,3,3,2,2,4,1,2,0,1,1,19
401403420,Iona Gaels,O. Shema,4703016,,False,7.0,0,0,0,0,0,0,0,0,0,0,0,1,0,1,0,1,0
401403420,Iona Gaels,Q. Slazinski,4431768,,False,8.0,0,2,0,1,0,1,2,2,0,3,3,1,1,0,3,2,2
401403420,Iona Gaels,J. Duach,4896373,,False,3.0,2,3,0,0,2,3,0,0,0,0,0,0,0,0,0,0,6
401403420,Iona Gaels,W. Clayton Jr.,4896372,,False,23.0,4,7,2,2,2,5,2,4,0,3,3,6,1,0,2,1,12
401403420,Iona Gaels,R. Myers,4703009,,False,5.0,0,0,0,0,0,0,0,0,0,2,2,0,0,0,0,1,0
401403420,Iona Gaels,TEAM,TOTAL,TOTAL,False,,25,53,15,30,10,23,10,15,11,19,30,19,6,7,15,14,70
401403419,Quinnipiac Bobcats,J. Rigoni,4279743,,True,32.0,8,14,1,3,7,11,3,3,0,6,6,0,1,0,0,1,26
401403419,Quinnipiac Bobcats,K. Marfo,4066877,,True,31.0,1,2,1,2,0,0,0,0,2,7,9,2,1,0,2,4,2
401403419,Quinnipiac Bobcats,T. Chenery,4703434,,True,25.0,0,7,0,3,0,4,0,0,1,2,3,0,0,0,0,2,0
401403419,Quinnipiac Bobcats,D. Jones,4898242,,True,38.0,7,13,3,4,4,9,2,2,1,9,10,8,2,1,5,0,20
401403419,Quinnipiac Bobcats,M. Balanc,4398397,,True,32.0,6,10,2,5,4,5,2,2,0,0,0,1,0,0,1,3,18
401403419,Quinnipiac Bobcats,J. Riggins,4432089,,False,9.0,1,4,1,4,0,0,1,2,3,1,4,0,0,0,0,3,3
401403419,Quinnipiac Bobcats,L. Kortright,4703435,,False,12.0,1,6,0,3,1,3,0,0,2,2,4,1,0,0,1,0,3
401403419,Quinnipiac Bobcats,B. McGuire,4433042,,False,21.0,2,4,1,1,1,3,0,0,1,1,2,3,0,0,0,2,5
401403419,Quinnipiac Bobcats,TEAM,TOTAL,TOTAL,False,,26,60,9,25,17,35,8,9,12,29,41,15,4,1,10,15,77
401403419,Marist Red Foxes,V. Enoh,4278286,,True,17.0,2,2,2,2,0,0,1,4,1,1,2,0,0,0,2,1,5
401403419,Marist Red Foxes,S. Cele,4703202,,True,16.0,0,1,0,1,0,0,0,0,0,3,3,0,1,0,0,0,0
401403419,Marist Red Foxes,J. Ituka,4896378,,True,20.0,4,9,4,6,0,3,0,0,0,4,4,0,0,0,2,2,8
401403419,Marist Red Foxes,R. Wright,4703831,,True,33.0,6,16,5,10,1,6,1,2,0,5,5,2,0,0,0,2,14
401403419,Marist Red Foxes,M. Herasme,4398413,,True,34.0,1,3,0,0,1,3,0,0,3,2,5,0,2,0,0,2,3
401403419,Marist Red Foxes,B. Bell,4593334,,False,21.0,0,6,0,3,0,3,0,0,2,0,2,0,0,0,2,2,0
401403419,Marist Red Foxes,J. Jones,4067302,,False,23.0,5,13,5,13,0,0,2,4,2,3,5,0,1,1,3,0,12
401403419,Marist Red Foxes,N. Harris,4896379,,False,13.0,0,1,0,0,0,1,0,0,0,0,0,0,0,0,1,1,0
401403419,Marist Red Foxes,R. Sullivan,4703830,,False,23.0,5,7,5,6,0,1,0,0,0,1,1,0,1,0,0,2,10
401403419,Marist Red Foxes,TEAM,TOTAL,TOTAL,False,,23,58,21,41,2,17,4,10,9,20,29,2,5,1,10,12,52
401403418,Fairfield Stags,S. Cook,4702946,,True,20.0,0,6,0,6,0,0,2,3,2,7,9,2,2,2,0,1,2
401403418,Fairfield Stags,A. Jeanne-Rose,4593277,,True,19.0,3,4,3,4,0,0,0,1,1,2,3,1,0,1,0,1,6
401403418,Fairfield Stags,C. Green,4280068,,True,34.0,4,9,4,8,0,1,2,2,0,4,4,6,0,0,2,1,10
401403418,Fairfield Stags,J. Cruz,4279488,,True,31.0,8,15,7,10,1,5,2,4,0,1,1,2,1,2,0,2,19
401403418,Fairfield Stags,T. Benning,4279483,,True,39.0,4,12,2,8,2,4,5,6,1,3,4,1,0,0,1,2,15
401403418,Fairfield Stags,C. Maidoh,4593276,,False,16.0,3,3,3,3,0,0,0,0,0,4,4,0,0,1,0,3,6
401403418,Fairfield Stags,Z. Crisler,4431936,,False,13.0,2,3,0,1,2,2,2,2,0,4,4,2,2,0,1,2,8
401403418,Fairfield Stags,TJ Long,4896370,,False,28.0,2,5,0,2,2,3,0,0,0,5,5,1,1,0,1,3,6
401403418,Fairfield Stags,TEAM,TOTAL,TOTAL,False,,26,57,19,42,7,15,13,18,5,30,35,15,6,6,7,15,72
401403418,Canisius Golden Griffins,G. Maslennikov,4702952,,True,11.0,0,2,0,2,0,0,0,0,1,0,1,0,0,0,1,0,0
401403418,Canisius Golden Griffins,J. Fritz,4593148,,True,19.0,1,2,1,2,0,0,0,0,0,3,3,0,0,1,2,4,2
401403418,Canisius Golden Griffins,A. Fofana,4702949,,True,33.0,2,6,1,3,1,3,0,0,0,3,3,1,0,0,4,1,5
401403418,Canisius Golden Griffins,A. Harried,4593149,,True,27.0,3,14,3,11,0,3,0,1,1,5,6,1,1,3,1,0,6
401403418,Canisius Golden Griffins,J. Henderson,4398046,,True,38.0,2,14,1,8,1,6,2,3,1,4,5,3,1,0,0,2,7
401403418,Canisius Golden Griffins,M. Green,4279878,,False,13.0,2,6,1,4,1,2,3,4,1,2,3,0,0,0,1,4,8
401403418,Canisius Golden Griffins,S. Hitchon,4279482,,False,7.0,2,5,2,3,0,2,0,0,0,1,1,0,1,0,0,3,4
401403418,Canisius Golden Griffins,X. Long,4896367,,False,21.0,2,7,1,3,1,4,0,2,4,6,10,2,0,0,2,2,5
401403418,Canisius Golden Griffins,S. Uijtendaal,4702950,,False,14.0,1,2,1,1,0,1,2,2,0,1,1,0,0,0,1,0,4
401403418,Canisius Golden Griffins,A. Ahemed,4593147,,False,17.0,2,6,1,4,1,2,4,4,2,2,4,0,1,0,0,2,9
401403418,Canisius Golden Griffins,TEAM,TOTAL,TOTAL,False,,17,64,12,41,5,23,11,16,14,28,42,7,4,4,12,18,50
401403417,Rider Broncs,M. James,4592283,,True,36.0,5,10,4,8,1,2,5,8,3,5,8,4,2,2,3,2,16
401403417,Rider Broncs,A. Ogemuno-Johnson,4406151,,True,31.0,7,9,7,9,0,0,1,2,2,10,12,1,1,0,3,2,15
401403417,Rider Broncs,D. Vaughn,4067347,,True,37.0,8,15,6,12,2,3,2,2,2,5,7,1,4,0,1,4,20
401403417,Rider Broncs,A. Powell,4593364,,True,39.0,4,13,0,5,4,8,4,5,1,2,3,3,2,1,1,2,16
401403417,Rider Broncs,D. Murray Jr.,4398029,,True,39.0,4,14,3,12,1,2,2,2,1,6,7,6,1,0,3,1,11
401403417,Rider Broncs,N. Benson,4705270,,False,13.0,0,0,0,0,0,0,1,2,3,0,3,3,0,0,0,2,1
401403417,Rider Broncs,C. McKeithan,4433243,,False,5.0,0,1,0,0,0,1,0,0,0,0,0,0,0,0,0,0,0
401403417,Rider Broncs,S. Altman,4432935,,False,0.0,0,0,0,0,0,0,0,0,0,0,0,0,0,0,0,0,0
401403417,Rider Broncs,TEAM,TOTAL,TOTAL,False,,28,62,20,46,8,16,15,21,13,29,42,18,10,3,12,13,79
401403417,Manhattan Jaspers,S. Diallo,4397161,,True,25.0,2,3,1,1,1,2,1,2,3,3,6,1,1,0,2,5,6
401403417,Manhattan Jaspers,W. Williams,4279701,,True,17.0,4,4,4,4,0,0,0,2,1,0,1,0,1,0,1,1,8
401403417,Manhattan Jaspers,M. Watson,4703172,,True,10.0,0,1,0,0,0,1,0,0,0,0,0,1,0,0,1,2,0
401403417,Manhattan Jaspers,R. Reid,4593324,,True,10.0,0,4,0,2,0,2,0,0,0,0,0,1,0,0,2,1,0
401403417,Manhattan Jaspers,J. Perez,4397528,,True,40.0,6,15,4,9,2,6,7,7,2,1,3,5,4,0,4,3,21
401403417,Manhattan Jaspers,J. Roberts,4397122,,False,23.0,5,7,5,7,0,0,0,1,1,6,7,0,0,3,0,2,10
401403417,Manhattan Jaspers,N. Brennen,4703175,,False,20.0,2,5,0,0,2,5,0,0,1,0,1,1,1,0,0,0,6
401403417,Manhattan Jaspers,E. Buchanan,4398103,,False,24.0,3,10,2,5,1,5,0,0,1,5,6,5,1,0,1,2,7
401403417,Manhattan Jaspers,A. Nelson,4397118,,False,31.0,3,11,1,3,2,8,1,2,0,6,6,5,1,0,1,2,9
401403417,Manhattan Jaspers,TEAM,TOTAL,TOTAL,False,,25,60,17,31,8,29,9,14,10,22,32,19,9,3,12,18,67
401403416,Long Beach State Beach,A. Traore,4897670,,True,21.0,0,0,0,0,0,0,0,0,0,2,2,1,2,0,2,4,0
401403416,Long Beach State Beach,J. Roberts,4278751,,True,34.0,5,10,4,7,1,3,2,3,4,3,7,4,0,0,4,3,13
401403416,Long Beach State Beach,J. Murray,4897669,,True,38.0,9,15,6,10,3,5,3,5,2,2,4,3,1,0,1,2,24
401403416,Long Beach State Beach,J. Jones,4611534,,True,37.0,3,8,1,1,2,7,0,0,2,5,7,1,2,0,2,4,8
401403416,Long Beach State Beach,C. Slater,4066475,,True,35.0,8,14,3,5,5,9,2,2,1,1,2,4,0,0,5,3,23
401403416,Long Beach State Beach,T. Rotegaard,4703135,,False,8.0,1,2,0,0,1,2,0,0,0,0,0,0,0,0,0,1,3
401403416,Long Beach State Beach,R. Mansel,4431835,,False,7.0,0,0,0,0,0,0,0,0,0,0,0,0,0,0,0,0,0
401403416,Long Beach State Beach,D. Cobb,4397496,,False,17.0,0,1,0,0,0,1,0,0,1,0,1,2,0,0,0,1,0
401403416,Long Beach State Beach,E. Scott,4279560,,False,3.0,0,0,0,0,0,0,0,0,0,0,0,0,0,0,0,1,0
401403416,Long Beach State Beach,TEAM,TOTAL,TOTAL,False,,26,50,14,23,12,27,7,10,12,13,25,15,5,0,18,19,71
401403416,Cal State Fullerton Titans,V. Lee,4397342,,True,16.0,1,2,1,2,0,0,0,0,0,5,5,0,0,0,0,2,2
401403416,Cal State Fullerton Titans,E.J. Anosike,4279647,,True,39.0,6,6,6,6,0,0,10,14,5,3,8,2,2,0,1,2,22
401403416,Cal State Fullerton Titans,L. Wrightsell Jr.,4702484,,True,33.0,2,6,1,3,1,3,0,0,0,1,1,4,3,0,2,2,5
401403416,Cal State Fullerton Titans,T. San Antonio,4432108,,True,30.0,1,2,0,0,1,2,0,0,0,1,1,0,1,0,2,2,3
401403416,Cal State Fullerton Titans,D. Milstead,4280171,,True,33.0,6,14,1,6,5,8,0,1,1,0,1,3,2,0,2,2,17
401403416,Cal State Fullerton Titans,J. Harris,4702482,,False,17.0,4,8,2,5,2,3,0,0,1,0,1,0,0,0,6,1,10
401403416,Cal State Fullerton Titans,T. Maddox Jr.,4397779,,False,32.0,5,10,3,6,2,4,1,1,0,1,1,6,0,0,0,4,13
401403416,Cal State Fullerton Titans,TEAM,TOTAL,TOTAL,False,,25,48,14,28,11,20,11,16,7,11,18,15,8,0,14,15,72
401403415,Hawai'i Rainbow Warriors,B. da Silva,4431868,,True,13.0,1,4,1,4,0,0,0,0,0,3,3,0,0,1,0,3,2
401403415,Hawai'i Rainbow Warriors,K. Hepa,4397080,,True,21.0,2,5,1,3,1,2,0,0,0,2,2,1,0,2,2,5,5
401403415,Hawai'i Rainbow Warriors,J. Desrosiers,4279566,,True,33.0,1,7,0,1,1,6,2,2,0,3,3,0,0,0,1,3,5
401403415,Hawai'i Rainbow Warriors,J. McClanahan,4702504,,True,32.0,3,8,1,5,2,3,1,2,3,1,4,2,1,0,5,3,9
401403415,Hawai'i Rainbow Warriors,J. Madut,4610175,,True,38.0,3,11,2,6,1,5,0,0,4,6,10,1,1,0,4,2,7
401403415,Hawai'i Rainbow Warriors,M. Colina,4397460,,False,25.0,3,9,3,8,0,1,6,6,1,6,7,0,1,0,1,0,12
401403415,Hawai'i Rainbow Warriors,J. Jackson,4912957,,False,1.0,0,0,0,0,0,0,0,0,0,0,0,0,0,0,0,2,0
401403415,Hawai'i Rainbow Warriors,A. Lado,4897665,,False,30.0,2,8,0,2,2,6,0,0,0,1,1,1,0,0,2,2,6
401403415,Hawai'i Rainbow Warriors,B. Riley,4702505,,False,7.0,0,2,0,1,0,1,0,0,2,2,4,1,0,0,0,1,0
401403415,Hawai'i Rainbow Warriors,TEAM,TOTAL,TOTAL,False,,15,54,8,30,7,24,9,10,10,24,34,6,3,3,16,21,46
401403415,Cal State Fullerton Titans,V. Lee,4397342,,True,33.0,2,5,2,5,0,0,1,3,2,4,6,1,1,0,3,4,5
401403415,Cal State Fullerton Titans,E.J. Anosike,4279647,,True,36.0,6,12,5,11,1,1,3,4,2,11,13,2,0,0,0,2,16
401403415,Cal State Fullerton Titans,L. Wrightsell Jr.,4702484,,True,29.0,1,5,1,5,0,0,3,4,0,5,5,4,1,1,0,3,5
401403415,Cal State Fullerton Titans,T. San Antonio,4432108,,True,28.0,2,3,1,1,1,2,3,5,2,3,5,1,1,2,1,2,8
401403415,Cal State Fullerton Titans,D. Milstead,4280171,,True,34.0,7,17,5,11,2,6,2,2,0,1,1,2,3,0,3,1,18
401403415,Cal State Fullerton Titans,I. Doumbia,4278109,,False,2.0,0,0,0,0,0,0,0,0,0,0,0,0,0,0,0,0,0
401403415,Cal State Fullerton Titans,J. Harris,4702482,,False,21.0,1,4,1,3,0,1,4,5,0,1,1,1,2,1,1,2,6
401403415,Cal State Fullerton Titans,T. Maddox Jr.,4397779,,False,17.0,0,3,0,1,0,2,0,0,0,0,0,0,0,0,0,1,0
401403415,Cal State Fullerton Titans,TEAM,TOTAL,TOTAL,False,,19,49,15,37,4,12,16,23,6,25,31,11,8,4,11,15,58
401403414,UC Santa Barbara Gauchos,A. Sow,4397644,,True,31.0,2,6,2,6,0,0,1,3,1,5,6,0,1,0,2,1,5
401403414,UC Santa Barbara Gauchos,M. Norris,4397104,,True,30.0,6,14,3,8,3,6,0,0,0,7,7,1,0,1,0,2,15
401403414,UC Santa Barbara Gauchos,A. Mitchell,4900671,,True,37.0,5,9,5,7,0,2,1,1,0,5,5,2,0,1,2,3,11
401403414,UC Santa Barbara Gauchos,A. Sanni,4397676,,True,37.0,5,14,3,8,2,6,3,3,0,3,3,6,1,0,2,1,15
401403414,UC Santa Barbara Gauchos,C. Wishart,4397521,,True,33.0,3,6,2,2,1,4,0,0,1,4,5,4,0,1,2,4,7
401403414,UC Santa Barbara Gauchos,R. Idehen,4397646,,False,12.0,3,4,3,4,0,0,0,1,0,2,2,0,1,1,1,1,6
401403414,UC Santa Barbara Gauchos,J. Nagle,4397643,,False,6.0,1,1,0,0,1,1,0,0,0,1,1,1,0,1,0,1,3
401403414,UC Santa Barbara Gauchos,C. Anderson,4900668,,False,2.0,0,1,0,0,0,1,0,0,0,0,0,0,0,0,0,0,0
401403414,UC Santa Barbara Gauchos,S. Touré,4397642,,False,12.0,1,2,1,1,0,1,0,0,1,0,1,4,0,0,0,3,2
401403414,UC Santa Barbara Gauchos,TEAM,TOTAL,TOTAL,False,,26,57,19,36,7,21,5,8,4,28,32,18,3,5,10,16,64
401403414,Long Beach State Beach,A. Traore,4897670,,True,33.0,5,8,5,8,0,0,2,2,1,8,9,0,0,0,1,2,12
401403414,Long Beach State Beach,J. Roberts,4278751,,True,30.0,2,7,2,7,0,0,0,0,1,3,4,1,0,0,1,3,4
401403414,Long Beach State Beach,J. Murray,4897669,,True,36.0,3,15,3,14,0,1,1,2,2,5,7,2,1,0,1,2,7
401403414,Long Beach State Beach,J. Jones,4611534,,True,31.0,2,5,0,0,2,5,3,3,1,6,7,0,3,0,0,3,9
401403414,Long Beach State Beach,C. Slater,4066475,,True,36.0,11,18,11,14,0,4,8,8,0,3,3,3,0,0,1,2,30
401403414,Long Beach State Beach,T. Rotegaard,4703135,,False,6.0,1,3,0,0,1,3,0,0,0,0,0,1,0,0,0,0,3
401403414,Long Beach State Beach,R. Mansel,4431835,,False,4.0,0,0,0,0,0,0,0,0,0,0,0,0,1,0,1,0,0
401403414,Long Beach State Beach,D. Cobb,4397496,,False,24.0,1,2,1,1,0,1,0,0,1,0,1,4,0,0,2,0,2
401403414,Long Beach State Beach,TEAM,TOTAL,TOTAL,False,,25,58,22,44,3,14,14,15,6,29,35,11,5,0,7,12,67
401403413,UC Riverside Highlanders,W. Tattersall,4702357,,True,36.0,1,8,1,4,0,4,0,0,2,4,6,2,0,0,1,2,2
401403413,UC Riverside Highlanders,C. McRae,4397619,,True,27.0,2,9,2,9,0,0,2,2,2,4,6,2,0,2,1,2,6
401403413,UC Riverside Highlanders,Z. Pullin,4592979,,True,37.0,8,14,7,13,1,1,6,6,0,4,4,5,0,0,4,2,23
401403413,UC Riverside Highlanders,F. Cameron,4293886,,True,35.0,6,12,1,3,5,9,0,0,0,2,2,1,1,0,1,4,17
401403413,UC Riverside Highlanders,D. Pickett,4081600,,True,37.0,4,9,1,5,3,4,2,2,0,2,2,2,3,0,1,3,13
401403413,UC Riverside Highlanders,D. Mading,4592978,,False,9.0,0,0,0,0,0,0,0,0,0,0,0,0,0,1,0,1,0
401403413,UC Riverside Highlanders,J. Martinez,4703388,,False,13.0,3,6,3,6,0,0,0,0,2,1,3,0,0,1,1,0,6
401403413,UC Riverside Highlanders,D. Elkaz,4397614,,False,6.0,0,1,0,0,0,1,0,0,0,0,0,0,0,0,0,1,0
401403413,UC Riverside Highlanders,TEAM,TOTAL,TOTAL,False,,24,59,15,40,9,19,10,10,7,20,27,12,4,4,9,15,67
401403413,Hawai'i Rainbow Warriors,B. da Silva,4431868,,True,23.0,3,10,3,10,0,0,0,0,3,6,9,1,1,4,1,2,6
401403413,Hawai'i Rainbow Warriors,K. Hepa,4397080,,True,35.0,1,3,0,1,1,2,2,2,1,3,4,1,0,0,2,0,5
401403413,Hawai'i Rainbow Warriors,J. Desrosiers,4279566,,True,36.0,4,6,4,4,0,2,6,7,5,7,12,4,0,0,1,1,14
401403413,Hawai'i Rainbow Warriors,J. McClanahan,4702504,,True,22.0,2,7,1,6,1,1,0,0,0,2,2,2,0,0,3,4,5
401403413,Hawai'i Rainbow Warriors,J. Madut,4610175,,True,35.0,7,15,6,9,1,6,2,3,0,8,8,2,0,0,3,3,17
401403413,Hawai'i Rainbow Warriors,M. Colina,4397460,,False,10.0,3,5,2,4,1,1,2,2,3,0,3,0,0,0,2,4,9
401403413,Hawai'i Rainbow Warriors,A. Lado,4897665,,False,27.0,4,10,2,5,2,5,2,2,0,1,1,0,1,0,2,1,12
401403413,Hawai'i Rainbow Warriors,B. Riley,4702505,,False,12.0,0,0,0,0,0,0,0,0,1,0,1,0,0,0,0,1,0
401403413,Hawai'i Rainbow Warriors,TEAM,TOTAL,TOTAL,False,,24,56,18,39,6,17,14,16,13,28,41,10,2,4,14,16,68
401403412,UC Davis Aggies,C. Anigwe,4397396,,True,20.0,4,6,4,6,0,0,0,0,3,1,4,0,0,3,0,4,8
401403412,UC Davis Aggies,K. Milling,4593062,,True,39.0,2,8,1,4,1,4,0,0,1,6,7,2,1,0,1,2,5
401403412,UC Davis Aggies,E. Pepper,4432077,,True,31.0,5,12,5,8,0,4,2,3,2,7,9,1,3,0,3,4,12
401403412,UC Davis Aggies,E. Manjon,4432033,,True,34.0,2,17,2,13,0,4,0,0,0,0,0,6,0,1,1,0,4
401403412,UC Davis Aggies,C. Fuller,4397580,,True,35.0,4,13,2,5,2,8,3,4,0,4,4,3,1,3,1,2,13
401403412,UC Davis Aggies,F. Borra,4702344,,False,7.0,0,0,0,0,0,0,0,0,1,0,1,0,0,0,0,3,0
401403412,UC Davis Aggies,A. Murphy,4432060,,False,6.0,0,2,0,2,0,0,0,0,1,1,2,0,0,0,0,4,0
401403412,UC Davis Aggies,A. Adebayo,4592953,,False,6.0,0,0,0,0,0,0,0,0,0,1,1,0,0,0,0,0,0
401403412,UC Davis Aggies,L. DeBruhl,4897673,,False,6.0,2,4,1,2,1,2,2,3,1,0,1,0,0,0,0,0,7
401403412,UC Davis Aggies,C. Ba,4397582,,False,15.0,2,4,0,1,2,3,0,0,0,0,0,1,0,0,0,0,6
401403412,UC Davis Aggies,B.J. Shaw,4397581,,False,1.0,0,0,0,0,0,0,0,0,0,0,0,0,0,0,0,0,0
401403412,UC Davis Aggies,TEAM,TOTAL,TOTAL,False,,21,66,15,41,6,25,7,10,12,23,35,13,5,7,6,19,55
401403412,Cal State Fullerton Titans,V. Lee,4397342,,True,19.0,0,0,0,0,0,0,2,2,2,1,3,0,0,0,5,3,2
401403412,Cal State Fullerton Titans,E.J. Anosike,4279647,,True,33.0,5,13,5,13,0,0,6,9,2,18,20,1,0,0,2,2,16
401403412,Cal State Fullerton Titans,L. Wrightsell Jr.,4702484,,True,33.0,4,11,3,6,1,5,1,1,0,5,5,3,2,0,3,0,10
401403412,Cal State Fullerton Titans,T. San Antonio,4432108,,True,19.0,1,2,1,2,0,0,0,0,2,2,4,1,0,0,2,3,2
401403412,Cal State Fullerton Titans,D. Milstead,4280171,,True,33.0,8,13,3,7,5,6,3,4,2,3,5,3,2,0,1,2,24
401403412,Cal State Fullerton Titans,L. Laku,4703699,,False,2.0,0,0,0,0,0,0,0,0,0,0,0,0,0,0,0,0,0
401403412,Cal State Fullerton Titans,I. Doumbia,4278109,,False,3.0,0,0,0,0,0,0,0,2,2,0,2,0,0,0,0,0,0
401403412,Cal State Fullerton Titans,G. Carper,4897658,,False,2.0,1,1,0,0,1,1,0,0,0,0,0,0,0,0,0,1,3
401403412,Cal State Fullerton Titans,D. Maddox Jr.,4702487,,False,9.0,1,1,0,0,1,1,0,0,0,0,0,1,0,0,0,3,3
401403412,Cal State Fullerton Titans,J. Harris,4702482,,False,23.0,1,5,1,5,0,0,0,0,0,1,1,1,0,0,0,0,2
401403412,Cal State Fullerton Titans,C. Carter,4592926,,False,2.0,0,0,0,0,0,0,0,0,0,0,0,0,0,0,0,0,0
401403412,Cal State Fullerton Titans,T. Maddox Jr.,4397779,,False,22.0,4,11,1,5,3,6,0,0,0,1,1,1,0,1,0,2,11
401403412,Cal State Fullerton Titans,TEAM,TOTAL,TOTAL,False,,25,57,14,38,11,19,12,18,13,35,48,11,4,1,13,16,73
401403411,UC Santa Barbara Gauchos,A. Sow,4397644,,True,34.0,10,16,10,16,0,0,1,2,6,10,16,2,0,2,2,2,21
401403411,UC Santa Barbara Gauchos,M. Norris,4397104,,True,35.0,2,9,2,7,0,2,3,4,3,5,8,1,1,2,1,0,7
401403411,UC Santa Barbara Gauchos,A. Mitchell,4900671,,True,33.0,1,10,1,8,0,2,5,6,0,2,2,3,1,0,3,3,7
401403411,UC Santa Barbara Gauchos,J. Pierre-Louis,4431795,,True,12.0,2,2,2,2,0,0,0,0,0,1,1,1,0,0,1,1,4
401403411,UC Santa Barbara Gauchos,C. Wishart,4397521,,True,34.0,5,6,3,3,2,3,2,2,0,3,3,5,2,0,1,2,14
401403411,UC Santa Barbara Gauchos,R. Idehen,4397646,,False,8.0,1,2,1,2,0,0,0,0,0,2,2,0,0,0,0,2,2
401403411,UC Santa Barbara Gauchos,J. Nagle,4397643,,False,3.0,0,0,0,0,0,0,0,0,0,0,0,0,0,0,0,0,0
401403411,UC Santa Barbara Gauchos,C. Anderson,4900668,,False,9.0,1,1,0,0,1,1,0,0,0,0,0,1,0,0,0,0,3
401403411,UC Santa Barbara Gauchos,A. Sanni,4397676,,False,27.0,6,8,2,4,4,4,4,4,0,2,2,2,1,0,3,2,20
401403411,UC Santa Barbara Gauchos,S. Touré,4397642,,False,5.0,0,1,0,1,0,0,0,2,0,1,1,0,0,0,0,2,0
401403411,UC Santa Barbara Gauchos,TEAM,TOTAL,TOTAL,False,,28,55,21,43,7,12,15,20,10,26,36,15,5,4,11,14,78
401403411,UC Irvine Anteaters,A. Johnson,4592959,,True,29.0,1,4,1,4,0,0,1,2,1,4,5,1,0,3,1,0,3
401403411,UC Irvine Anteaters,JC Butler,4397596,,True,23.0,0,4,0,3,0,1,1,2,0,2,2,2,2,0,0,3,1
401403411,UC Irvine Anteaters,C. Welp,4279073,,True,29.0,7,18,6,14,1,4,2,2,3,5,8,1,1,1,1,1,17
401403411,UC Irvine Anteaters,D. Baker,4702626,,True,31.0,7,15,6,13,1,2,1,1,2,0,2,2,1,1,1,0,16
401403411,UC Irvine Anteaters,J. Hohn,4433009,,True,22.0,4,6,3,4,1,2,0,0,0,2,2,1,1,0,3,4,9
401403411,UC Irvine Anteaters,E. Tshimanga,4592961,,False,4.0,0,1,0,1,0,0,0,0,1,0,1,0,0,0,1,2,0
401403411,UC Irvine Anteaters,D. Keeler,4592962,,False,4.0,0,1,0,1,0,0,0,0,0,0,0,0,1,0,0,0,0
401403411,UC Irvine Anteaters,B. Leuchten,4897676,,False,1.0,0,0,0,0,0,0,0,0,0,0,0,0,0,0,1,2,0
401403411,UC Irvine Anteaters,L. Redfield,4897677,,False,7.0,0,0,0,0,0,0,0,0,0,1,1,0,0,0,0,0,0
401403411,UC Irvine Anteaters,DJ Davis,4702628,,False,26.0,7,11,3,6,4,5,3,3,0,2,2,1,2,0,1,2,21
401403411,UC Irvine Anteaters,I. Lee,4592958,,False,11.0,0,0,0,0,0,0,0,0,0,1,1,1,0,0,1,2,0
401403411,UC Irvine Anteaters,O. Ujadughele,4432132,,False,13.0,1,4,1,3,0,1,0,0,1,1,2,2,1,0,0,5,2
401403411,UC Irvine Anteaters,TEAM,TOTAL,TOTAL,False,,27,64,20,49,7,15,8,10,11,18,29,11,9,5,10,21,69
401403410,Long Beach State Beach,A. Traore,4897670,,True,21.0,2,4,2,4,0,0,3,6,2,7,9,2,1,0,2,4,7
401403410,Long Beach State Beach,J. Roberts,4278751,,True,34.0,4,10,2,5,2,5,6,6,0,2,2,0,0,1,4,2,16
401403410,Long Beach State Beach,J. Murray,4897669,,True,33.0,9,13,7,11,2,2,5,6,1,2,3,4,0,0,4,1,25
401403410,Long Beach State Beach,J. Jones,4611534,,True,33.0,4,9,1,2,3,7,3,3,0,2,2,0,2,1,0,3,14
401403410,Long Beach State Beach,C. Slater,4066475,,True,28.0,2,7,1,6,1,1,0,0,1,0,1,4,3,0,1,3,5
401403410,Long Beach State Beach,T. Rotegaard,4703135,,False,10.0,0,4,0,2,0,2,0,0,0,1,1,0,0,1,1,2,0
401403410,Long Beach State Beach,R. Mansel,4431835,,False,7.0,0,1,0,1,0,0,0,0,1,2,3,0,0,0,1,0,0
401403410,Long Beach State Beach,J. Yan,4410862,,False,2.0,0,0,0,0,0,0,0,0,0,0,0,0,0,0,0,0,0
401403410,Long Beach State Beach,A. Neal,4897671,,False,3.0,0,0,0,0,0,0,0,0,0,0,0,1,0,0,0,1,0
401403410,Long Beach State Beach,RJ Rhoden,4592940,,False,2.0,0,0,0,0,0,0,0,0,0,1,1,0,0,0,2,0,0
401403410,Long Beach State Beach,D. Cobb,4397496,,False,23.0,1,3,1,2,0,1,2,3,0,1,1,0,2,0,0,1,4
401403410,Long Beach State Beach,E. Scott,4279560,,False,5.0,0,0,0,0,0,0,1,2,0,1,1,1,1,0,1,1,1
401403410,Long Beach State Beach,TEAM,TOTAL,TOTAL,False,,22,51,14,33,8,18,20,26,8,22,30,12,9,3,16,18,72
401403410,Cal State Bakersfield Roadrunners,S. Stith,4594131,,True,27.0,1,3,1,3,0,0,0,0,0,2,2,1,0,0,2,2,2
401403410,Cal State Bakersfield Roadrunners,J. Schoemann,4397272,,True,7.0,0,1,0,0,0,1,0,0,0,0,0,1,0,0,0,1,0
401403410,Cal State Bakersfield Roadrunners,J. McCall,4278732,,True,30.0,7,13,7,13,0,0,5,7,2,3,5,0,1,0,2,2,19
401403410,Cal State Bakersfield Roadrunners,I. Reynolds,4897656,,True,22.0,1,1,1,1,0,0,0,1,0,2,2,1,1,0,4,3,2
401403410,Cal State Bakersfield Roadrunners,K. Higgins,4897654,,True,28.0,3,11,1,7,2,4,0,0,0,2,2,3,0,0,4,2,8
401403410,Cal State Bakersfield Roadrunners,B. Washington,4897655,,False,1.0,0,0,0,0,0,0,0,0,0,1,1,0,0,0,0,0,0
401403410,Cal State Bakersfield Roadrunners,C. Smith,4702472,,False,26.0,6,11,6,11,0,0,2,3,2,4,6,1,3,2,3,3,14
401403410,Cal State Bakersfield Roadrunners,T. Henson,4702471,,False,15.0,3,5,2,3,1,2,0,0,0,1,1,1,1,0,0,3,7
401403410,Cal State Bakersfield Roadrunners,D. Panopio,4897653,,False,10.0,0,2,0,1,0,1,0,0,0,0,0,1,1,0,3,0,0
401403410,Cal State Bakersfield Roadrunners,D. Walker,4702079,,False,1.0,0,0,0,0,0,0,0,0,0,0,0,0,0,0,0,0,0
401403410,Cal State Bakersfield Roadrunners,G. Easter,4398050,,False,13.0,0,1,0,0,0,1,0,0,1,1,2,2,1,0,1,3,0
401403410,Cal State Bakersfield Roadrunners,J. Edler-Davis,4396025,,False,18.0,4,9,3,6,1,3,0,0,3,6,9,0,2,0,0,4,9
401403410,Cal State Bakersfield Roadrunners,TEAM,TOTAL,TOTAL,False,,25,57,21,45,4,12,7,11,12,24,36,11,10,2,21,23,61
401403409,UC Davis Aggies,C. Anigwe,4397396,,True,21.0,2,3,2,3,0,0,3,4,1,3,4,1,1,0,1,4,7
401403409,UC Davis Aggies,K. Milling,4593062,,True,34.0,2,4,2,4,0,0,0,0,1,3,4,0,2,0,1,1,4
401403409,UC Davis Aggies,E. Pepper,4432077,,True,36.0,4,14,2,6,2,8,4,4,0,9,9,0,1,1,2,2,14
401403409,UC Davis Aggies,E. Manjon,4432033,,True,36.0,5,14,5,14,0,0,7,8,0,3,3,3,1,1,2,0,17
401403409,UC Davis Aggies,C. Fuller,4397580,,True,35.0,6,14,5,9,1,5,3,6,2,6,8,1,1,0,3,3,16
401403409,UC Davis Aggies,F. Borra,4702344,,False,6.0,0,0,0,0,0,0,0,0,0,1,1,0,0,0,1,1,0
401403409,UC Davis Aggies,A. Murphy,4432060,,False,7.0,1,1,1,1,0,0,0,0,0,0,0,0,0,0,0,4,2
401403409,UC Davis Aggies,A. Adebayo,4592953,,False,5.0,0,0,0,0,0,0,0,0,0,0,0,0,0,0,0,2,0
401403409,UC Davis Aggies,L. DeBruhl,4897673,,False,5.0,0,0,0,0,0,0,0,0,0,0,0,0,0,0,1,1,0
401403409,UC Davis Aggies,C. Ba,4397582,,False,15.0,1,2,0,1,1,1,0,0,1,0,1,0,0,0,0,0,3
401403409,UC Davis Aggies,TEAM,TOTAL,TOTAL,False,,21,52,17,38,4,14,17,22,7,28,35,5,6,2,11,18,63
401403409,Cal Poly Mustangs,A. Koroma,4592922,,True,21.0,1,6,1,4,0,2,0,0,0,4,4,1,0,0,3,3,2
401403409,Cal Poly Mustangs,C. Pierce,4702351,,True,39.0,5,8,5,7,0,1,1,2,1,3,4,3,1,0,2,4,11
401403409,Cal Poly Mustangs,B. Stevenson,4702353,,True,39.0,4,10,3,6,1,4,0,0,1,6,7,2,1,1,5,2,9
401403409,Cal Poly Mustangs,K. Sanders,4702352,,True,29.0,0,5,0,0,0,5,4,4,1,1,2,3,1,0,2,1,4
401403409,Cal Poly Mustangs,T. Taylor,4397446,,True,38.0,9,15,8,14,1,1,1,3,2,6,8,1,0,0,3,2,20
401403409,Cal Poly Mustangs,K. Colvin,4397366,,False,3.0,0,0,0,0,0,0,0,0,0,0,0,0,0,0,0,0,0
401403409,Cal Poly Mustangs,T. Jaakkola,4397363,,False,8.0,0,2,0,2,0,0,0,0,0,1,1,0,1,1,1,3,0
401403409,Cal Poly Mustangs,J. Franklin,4431954,,False,21.0,2,6,0,0,2,6,1,2,0,1,1,0,0,0,0,4,7
401403409,Cal Poly Mustangs,D. Esparza,4897664,,False,1.0,0,0,0,0,0,0,0,0,0,0,0,0,0,0,0,0,0
401403409,Cal Poly Mustangs,M. Dhal,4709319,,False,1.0,0,0,0,0,0,0,0,0,0,0,0,0,0,0,0,0,0
401403409,Cal Poly Mustangs,TEAM,TOTAL,TOTAL,False,,21,52,17,33,4,19,7,11,6,26,32,10,4,2,17,19,53
401403408,Cal State Northridge Matadors,O. Eyisi,4396816,,True,22.0,2,4,2,4,0,0,2,3,0,3,3,1,1,0,1,4,6
401403408,Cal State Northridge Matadors,A. Wright,4702491,,True,34.0,1,10,0,4,1,6,4,4,1,0,1,2,0,0,4,2,7
401403408,Cal State Northridge Matadors,M. James,4592972,,True,14.0,0,4,0,2,0,2,0,0,1,1,2,0,0,0,0,3,0
401403408,Cal State Northridge Matadors,D. Beane,4397490,,True,32.0,2,5,2,5,0,0,0,0,0,3,3,0,0,0,3,2,4
401403408,Cal State Northridge Matadors,E. Hardy,4397156,,True,28.0,5,13,4,7,1,6,2,3,1,1,2,2,0,0,1,3,13
401403408,Cal State Northridge Matadors,E. Uche,4897661,,False,1.0,0,0,0,0,0,0,0,0,0,0,0,0,0,0,1,0,0
401403408,Cal State Northridge Matadors,F. Okereke,4702496,,False,27.0,2,4,2,4,0,0,0,0,1,9,10,3,0,1,0,5,4
401403408,Cal State Northridge Matadors,M. Stevens,4702493,,False,23.0,1,2,0,1,1,1,4,4,0,1,1,0,1,0,0,3,7
401403408,Cal State Northridge Matadors,K. Rains,4590351,,False,19.0,2,4,2,3,0,1,0,0,0,3,3,0,0,0,0,0,4
401403408,Cal State Northridge Matadors,TEAM,TOTAL,TOTAL,False,,15,46,12,30,3,16,12,14,6,22,28,8,2,1,11,22,45
401403408,Cal State Bakersfield Roadrunners,S. Stith,4594131,,True,34.0,5,6,5,6,0,0,5,11,2,4,6,1,0,1,2,3,15
401403408,Cal State Bakersfield Roadrunners,J. McCall,4278732,,True,25.0,4,9,4,8,0,1,3,6,1,2,3,2,1,1,0,0,11
401403408,Cal State Bakersfield Roadrunners,I. Reynolds,4897656,,True,28.0,1,2,1,1,0,1,0,0,1,3,4,3,0,1,1,3,2
401403408,Cal State Bakersfield Roadrunners,K. Higgins,4897654,,True,29.0,7,11,6,9,1,2,0,1,1,3,4,4,1,0,1,2,15
401403408,Cal State Bakersfield Roadrunners,J. Edler-Davis,4396025,,True,9.0,0,4,0,3,0,1,0,0,1,2,3,0,0,0,0,2,0
401403408,Cal State Bakersfield Roadrunners,B. Washington,4897655,,False,4.0,0,0,0,0,0,0,0,0,0,0,0,0,0,0,0,1,0
401403408,Cal State Bakersfield Roadrunners,C. Smith,4702472,,False,31.0,3,6,3,6,0,0,3,4,0,5,5,1,1,2,0,2,9
401403408,Cal State Bakersfield Roadrunners,T. Henson,4702471,,False,8.0,0,1,0,1,0,0,0,0,0,2,2,1,0,0,0,0,0
401403408,Cal State Bakersfield Roadrunners,A. Collum,4432856,,False,2.0,0,1,0,1,0,0,0,0,0,1,1,0,0,0,0,0,0
401403408,Cal State Bakersfield Roadrunners,D. Panopio,4897653,,False,8.0,1,2,0,0,1,2,0,0,0,1,1,0,0,0,0,0,3
401403408,Cal State Bakersfield Roadrunners,D. Walker,4702079,,False,11.0,1,2,1,2,0,0,1,2,0,1,1,0,1,0,1,0,3
401403408,Cal State Bakersfield Roadrunners,G. Easter,4398050,,False,11.0,0,1,0,0,0,1,0,0,0,1,1,0,1,0,3,3,0
401403408,Cal State Bakersfield Roadrunners,TEAM,TOTAL,TOTAL,False,,22,45,20,37,2,8,12,24,8,27,35,12,5,5,9,16,58
401403407,Purdue Boilermakers,M. Gillis,4431753,,True,28.0,0,4,0,3,0,1,2,3,4,4,8,1,0,0,1,3,2
401403407,Purdue Boilermakers,Z. Edey,4600663,,True,17.0,4,8,4,8,0,0,4,5,7,7,14,0,0,0,2,2,12
401403407,Purdue Boilermakers,J. Ivey,4433218,,True,34.0,9,18,8,10,1,8,1,2,0,3,3,6,0,0,5,3,20
401403407,Purdue Boilermakers,E. Hunter Jr.,4397243,,True,29.0,3,7,1,4,2,3,1,2,0,0,0,0,1,0,2,2,9
401403407,Purdue Boilermakers,S. Stefanovic,4277985,,True,33.0,1,8,0,2,1,6,0,0,0,4,4,1,0,0,1,3,3
401403407,Purdue Boilermakers,T. Williams,4397246,,False,23.0,5,11,5,10,0,1,3,4,5,6,11,3,2,1,2,4,13
401403407,Purdue Boilermakers,B. Newman,4592726,,False,10.0,1,1,1,1,0,0,0,0,0,0,0,1,0,1,0,4,2
401403407,Purdue Boilermakers,E. Morton,4433151,,False,15.0,2,2,1,1,1,1,0,1,1,2,3,1,0,0,2,0,5
401403407,Purdue Boilermakers,I. Thompson,4431749,,False,11.0,0,0,0,0,0,0,0,0,0,1,1,0,1,0,2,1,0
401403407,Purdue Boilermakers,TEAM,TOTAL,TOTAL,False,,25,59,20,39,5,20,11,17,17,31,48,13,4,2,17,22,66
401403407,Iowa Hawkeyes,Ke. Murray,4594327,,True,40.0,6,16,3,8,3,8,4,4,4,7,11,3,2,1,2,1,19
401403407,Iowa Hawkeyes,P. McCaffery,4432836,,True,19.0,2,5,1,3,1,2,1,3,1,2,3,1,0,1,0,1,6
401403407,Iowa Hawkeyes,F. Rebraca,4398190,,True,12.0,1,2,1,2,0,0,1,3,1,1,2,1,1,0,0,4,3
401403407,Iowa Hawkeyes,T. Perkins,4433130,,True,27.0,4,8,4,6,0,2,3,5,3,1,4,4,1,0,0,2,11
401403407,Iowa Hawkeyes,J. Bohannon,4066366,,True,29.0,2,8,1,1,1,7,2,2,0,2,2,2,2,0,1,1,7
401403407,Iowa Hawkeyes,R. Mulvey,4685004,,False,4.0,0,1,0,0,0,1,0,0,0,0,0,0,0,0,0,1,0
401403407,Iowa Hawkeyes,Kr. Murray,4594326,,False,14.0,2,5,1,3,1,2,3,4,1,1,2,1,1,0,1,4,8
401403407,Iowa Hawkeyes,J. Ogundele,4433231,,False,10.0,2,3,2,3,0,0,0,1,0,0,0,0,1,0,0,1,4
401403407,Iowa Hawkeyes,P. Sandfort,4697270,,False,15.0,4,4,2,2,2,2,0,0,0,0,0,0,1,0,1,1,10
401403407,Iowa Hawkeyes,J. Toussaint,4432880,,False,10.0,2,5,2,4,0,1,0,0,0,1,1,1,4,1,1,0,4
401403407,Iowa Hawkeyes,A. Ulis,4432454,,False,3.0,0,0,0,0,0,0,0,0,0,0,0,1,0,0,0,0,0
401403407,Iowa Hawkeyes,C. McCaffery,4277950,,False,17.0,1,4,1,1,0,3,1,1,0,4,4,1,0,0,0,1,3
401403407,Iowa Hawkeyes,TEAM,TOTAL,TOTAL,False,,26,61,18,33,8,28,15,23,10,20,30,15,13,3,6,17,75
401403406,Purdue Boilermakers,M. Gillis,4431753,,True,30.0,3,5,1,1,2,4,2,2,3,4,7,0,0,0,1,0,10
401403406,Purdue Boilermakers,Z. Edey,4600663,,True,20.0,5,10,5,10,0,0,1,1,5,5,10,0,0,0,0,1,11
401403406,Purdue Boilermakers,J. Ivey,4433218,,True,36.0,7,14,5,9,2,5,6,8,1,8,9,5,0,0,1,2,22
401403406,Purdue Boilermakers,E. Hunter Jr.,4397243,,True,31.0,4,6,2,3,2,3,1,2,1,1,2,2,1,0,1,3,11
401403406,Purdue Boilermakers,S. Stefanovic,4277985,,True,22.0,2,5,0,0,2,5,0,0,0,0,0,0,1,0,1,1,6
401403406,Purdue Boilermakers,C. Furst,4433598,,False,10.0,0,1,0,0,0,1,0,0,1,2,3,0,0,0,2,0,0
401403406,Purdue Boilermakers,T. Williams,4397246,,False,20.0,4,8,4,8,0,0,7,12,3,4,7,3,0,0,3,1,15
401403406,Purdue Boilermakers,B. Newman,4592726,,False,18.0,0,6,0,2,0,4,0,0,0,2,2,0,1,1,0,0,0
401403406,Purdue Boilermakers,E. Morton,4433151,,False,4.0,0,1,0,0,0,1,0,0,0,2,2,0,0,1,0,0,0
401403406,Purdue Boilermakers,I. Thompson,4431749,,False,9.0,0,1,0,0,0,1,0,0,0,0,0,0,0,1,0,1,0
401403406,Purdue Boilermakers,TEAM,TOTAL,TOTAL,False,,25,57,17,33,8,24,17,25,15,28,43,10,3,3,9,9,75
401403406,Michigan State Spartans,M. Bingham Jr.,4397212,,True,23.0,4,11,3,7,1,4,0,0,2,4,6,0,1,3,0,4,9
401403406,Michigan State Spartans,G. Brown,4397210,,True,31.0,6,11,3,5,3,6,1,2,3,1,4,1,0,0,1,1,16
401403406,Michigan State Spartans,J. Hauser,4295180,,True,21.0,0,4,0,1,0,3,0,0,1,3,4,1,0,0,0,5,0
401403406,Michigan State Spartans,M. Christie,4432582,,True,29.0,3,10,1,4,2,6,1,2,2,4,6,2,0,0,3,0,9
401403406,Michigan State Spartans,T. Walker,4432129,,True,3.0,0,1,0,0,0,1,0,0,0,0,0,0,0,0,0,1,0
401403406,Michigan State Spartans,M. Hall,4592693,,False,22.0,4,5,3,3,1,2,0,0,0,2,2,2,3,0,0,0,9
401403406,Michigan State Spartans,J. Marble II,4433031,,False,9.0,2,5,2,5,0,0,0,0,0,2,2,0,0,0,0,5,4
401403406,Michigan State Spartans,P. Brooks,4683731,,False,2.0,0,0,0,0,0,0,0,0,0,0,0,0,0,0,0,0,0
401403406,Michigan State Spartans,M. Sissoko,4433154,,False,5.0,1,1,1,1,0,0,0,0,0,1,1,0,0,0,0,1,2
401403406,Michigan State Spartans,J. Akins,4683730,,False,21.0,2,4,2,3,0,1,0,0,2,1,3,0,0,0,0,2,4
401403406,Michigan State Spartans,A. Hoggard,4432206,,False,34.0,8,17,8,15,0,2,1,2,1,3,4,10,2,0,0,2,17
401403406,Michigan State Spartans,TEAM,TOTAL,TOTAL,False,,30,69,23,44,7,25,3,6,12,23,35,16,6,3,4,21,70
401403405,Iowa Hawkeyes,Ke. Murray,4594327,,True,39.0,11,17,3,7,8,10,2,3,3,6,9,3,2,2,3,3,32
401403405,Iowa Hawkeyes,P. McCaffery,4432836,,True,26.0,7,11,7,10,0,1,2,2,1,1,2,1,0,1,1,1,16
401403405,Iowa Hawkeyes,F. Rebraca,4398190,,True,19.0,0,1,0,1,0,0,0,0,1,3,4,0,0,0,0,1,0
401403405,Iowa Hawkeyes,T. Perkins,4433130,,True,26.0,3,8,3,5,0,3,2,3,1,2,3,5,0,0,3,3,8
401403405,Iowa Hawkeyes,J. Bohannon,4066366,,True,29.0,4,10,0,1,4,9,0,0,0,3,3,3,0,0,1,1,12
401403405,Iowa Hawkeyes,Kr. Murray,4594326,,False,22.0,2,6,1,3,1,3,0,0,0,1,1,2,1,0,1,3,5
401403405,Iowa Hawkeyes,P. Sandfort,4697270,,False,7.0,1,3,0,1,1,2,0,0,1,1,2,2,0,0,0,0,3
401403405,Iowa Hawkeyes,J. Toussaint,4432880,,False,14.0,0,3,0,1,0,2,4,4,0,0,0,1,2,0,0,3,4
401403405,Iowa Hawkeyes,A. Ulis,4432454,,False,4.0,0,0,0,0,0,0,0,0,1,0,1,0,1,0,2,0,0
401403405,Iowa Hawkeyes,C. McCaffery,4277950,,False,14.0,0,2,0,0,0,2,0,0,1,1,2,3,0,0,0,2,0
401403405,Iowa Hawkeyes,TEAM,TOTAL,TOTAL,False,,28,61,14,29,14,32,10,12,10,20,30,20,6,3,11,17,80
401403405,Indiana Hoosiers,T. Jackson-Davis,4431684,,True,38.0,15,21,15,21,0,0,1,3,4,6,10,3,1,2,2,2,31
401403405,Indiana Hoosiers,M. Kopp,4397231,,True,33.0,2,11,0,4,2,7,2,2,1,2,3,1,1,1,1,4,8
401403405,Indiana Hoosiers,R. Thompson,4277947,,True,35.0,5,7,5,7,0,0,1,1,4,3,7,3,1,1,2,2,11
401403405,Indiana Hoosiers,X. Johnson,4395669,,True,33.0,5,11,3,5,2,6,8,8,0,4,4,9,1,0,4,2,20
401403405,Indiana Hoosiers,P. Stewart,4278013,,True,22.0,1,5,1,3,0,2,0,0,0,4,4,0,1,0,0,1,2
401403405,Indiana Hoosiers,T. Bates,4683933,,False,1.0,1,1,0,0,1,1,0,0,0,0,0,0,0,0,0,1,3
401403405,Indiana Hoosiers,T. Galloway,4432315,,False,21.0,1,5,1,2,0,3,0,0,1,0,1,3,1,0,1,4,2
401403405,Indiana Hoosiers,R. Phinisee,4397010,,False,17.0,0,2,0,2,0,0,0,0,1,2,3,3,3,0,0,0,0
401403405,Indiana Hoosiers,TEAM,TOTAL,TOTAL,False,,30,63,25,44,5,19,12,14,13,23,36,22,9,4,10,16,77
401403404,Purdue Boilermakers,M. Gillis,4431753,,True,23.0,2,3,2,2,0,1,0,0,1,4,5,3,2,0,1,0,4
401403404,Purdue Boilermakers,Z. Edey,4600663,,True,18.0,6,10,6,10,0,0,3,4,3,2,5,0,0,2,2,1,15
401403404,Purdue Boilermakers,J. Ivey,4433218,,True,37.0,6,13,5,9,1,4,4,4,0,7,7,2,1,2,2,2,17
401403404,Purdue Boilermakers,E. Hunter Jr.,4397243,,True,35.0,3,7,1,4,2,3,0,1,0,3,3,1,0,0,1,1,8
401403404,Purdue Boilermakers,S. Stefanovic,4277985,,True,23.0,0,4,0,1,0,3,2,2,1,1,2,2,0,0,1,3,2
401403404,Purdue Boilermakers,T. Williams,4397246,,False,22.0,4,7,4,7,0,0,1,2,0,5,5,5,1,1,3,2,9
401403404,Purdue Boilermakers,B. Newman,4592726,,False,21.0,4,4,2,2,2,2,2,4,0,2,2,1,1,0,0,1,12
401403404,Purdue Boilermakers,E. Morton,4433151,,False,12.0,1,3,1,3,0,0,0,0,2,1,3,0,0,0,0,0,2
401403404,Purdue Boilermakers,I. Thompson,4431749,,False,9.0,0,1,0,0,0,1,0,0,0,0,0,0,0,0,0,1,0
401403404,Purdue Boilermakers,TEAM,TOTAL,TOTAL,False,,26,52,21,38,5,14,12,17,9,25,34,14,5,5,10,11,69
401403404,Penn State Nittany Lions,J. Harrar,4277980,,True,29.0,7,9,7,9,0,0,1,2,6,6,12,2,1,0,0,3,15
401403404,Penn State Nittany Lions,S. Lundy,4431775,,True,29.0,0,8,0,1,0,7,2,3,0,4,4,0,0,2,0,2,2
401403404,Penn State Nittany Lions,D. Johnson,4433567,,True,26.0,3,10,2,4,1,6,0,0,0,1,1,0,0,0,0,0,7
401403404,Penn State Nittany Lions,J. Pickett,4398390,,True,36.0,6,10,4,7,2,3,2,2,1,3,4,6,2,0,2,3,16
401403404,Penn State Nittany Lions,M. Dread,4397239,,True,25.0,2,4,0,1,2,3,0,0,2,1,3,1,1,0,1,4,6
401403404,Penn State Nittany Lions,J. Scott,4897435,,False,3.0,0,1,0,0,0,1,0,0,0,0,0,0,0,0,0,2,0
401403404,Penn State Nittany Lions,G. Lee,4066811,,False,5.0,0,0,0,0,0,0,0,0,0,1,1,0,0,0,1,2,0
401403404,Penn State Nittany Lions,S. Sessoms,4395880,,False,32.0,4,14,3,11,1,3,0,0,0,1,1,1,1,0,1,1,9
401403404,Penn State Nittany Lions,J. Cornwall,4278690,,False,15.0,2,3,0,0,2,3,0,0,0,1,1,1,2,0,1,0,6
401403404,Penn State Nittany Lions,TEAM,TOTAL,TOTAL,False,,24,59,16,33,8,26,5,7,10,19,29,11,7,2,8,17,61
401403403,Wisconsin Badgers,S. Crowl,4588201,,True,21.0,4,6,3,4,1,2,0,0,0,1,1,2,0,0,1,2,9
401403403,Wisconsin Badgers,T. Wahl,4433105,,True,35.0,3,4,3,3,0,1,2,4,3,2,5,0,2,1,1,1,8
401403403,Wisconsin Badgers,C. Hepburn,4590360,,True,34.0,4,9,1,4,3,5,0,2,0,3,3,4,0,0,1,3,11
401403403,Wisconsin Badgers,Joh. Davis,4432356,,True,34.0,3,19,3,14,0,5,5,6,1,10,11,3,1,0,3,4,11
401403403,Wisconsin Badgers,B. Davison,4277993,,True,36.0,8,15,5,7,3,8,4,5,0,3,3,3,0,0,0,5,23
401403403,Wisconsin Badgers,B. Carlson,4433166,,False,11.0,0,2,0,1,0,1,0,0,1,2,3,0,1,0,0,3,0
401403403,Wisconsin Badgers,C. Vogt,4279252,,False,13.0,0,1,0,1,0,0,1,4,1,0,1,1,0,1,0,3,1
401403403,Wisconsin Badgers,Jor. Davis,4433242,,False,10.0,0,3,0,1,0,2,0,0,0,1,1,0,0,0,1,1,0
401403403,Wisconsin Badgers,J. Neath,4432066,,False,6.0,0,1,0,1,0,0,0,0,0,0,0,0,0,0,0,0,0
401403403,Wisconsin Badgers,TEAM,TOTAL,TOTAL,False,,22,60,15,36,7,24,12,21,10,24,34,13,4,2,7,22,63
401403403,Michigan State Spartans,M. Bingham Jr.,4397212,,True,22.0,7,11,7,11,0,0,5,7,2,9,11,0,1,3,1,1,19
401403403,Michigan State Spartans,G. Brown,4397210,,True,22.0,2,4,2,2,0,2,0,0,1,3,4,0,0,0,0,3,4
401403403,Michigan State Spartans,J. Hauser,4295180,,True,19.0,4,7,3,5,1,2,0,0,0,4,4,0,0,0,1,4,9
401403403,Michigan State Spartans,M. Christie,4432582,,True,32.0,2,5,2,5,0,0,4,4,0,2,2,0,0,2,1,0,8
401403403,Michigan State Spartans,T. Walker,4432129,,True,32.0,3,9,3,7,0,2,5,7,0,0,0,7,0,0,0,1,11
401403403,Michigan State Spartans,M. Hall,4592693,,False,18.0,1,5,1,2,0,3,0,2,1,4,5,0,0,1,1,4,2
401403403,Michigan State Spartans,J. Marble II,4433031,,False,17.0,3,3,3,3,0,0,2,2,0,4,4,0,2,0,2,2,8
401403403,Michigan State Spartans,J. Akins,4683730,,False,17.0,0,2,0,1,0,1,0,0,1,2,3,0,0,0,0,2,0
401403403,Michigan State Spartans,A. Hoggard,4432206,,False,21.0,3,6,3,5,0,1,2,2,0,4,4,4,1,1,1,2,8
401403403,Michigan State Spartans,TEAM,TOTAL,TOTAL,False,,25,52,24,41,1,11,18,24,5,34,39,11,4,7,7,19,69
401403402,Rutgers Scarlet Knights,R. Harper Jr.,4397251,,True,36.0,5,16,4,10,1,6,2,2,2,1,3,1,0,2,1,4,13
401403402,Rutgers Scarlet Knights,C. Omoruyi,4433155,,True,32.0,6,9,6,8,0,1,5,6,2,5,7,1,0,0,0,3,17
401403402,Rutgers Scarlet Knights,P. Mulcahy,4432849,,True,34.0,6,10,6,8,0,2,1,2,2,4,6,9,0,0,1,3,13
401403402,Rutgers Scarlet Knights,C. McConnell,4397249,,True,37.0,3,9,2,5,1,4,1,2,1,2,3,1,2,0,1,4,8
401403402,Rutgers Scarlet Knights,G. Baker,4277986,,True,39.0,9,16,5,9,4,7,1,2,2,1,3,2,3,0,1,1,23
401403402,Rutgers Scarlet Knights,M. Mag,4602948,,False,7.0,0,0,0,0,0,0,0,0,0,0,0,0,0,0,0,1,0
401403402,Rutgers Scarlet Knights,D. Reiber,4581507,,False,5.0,0,1,0,1,0,0,0,0,1,1,2,0,1,0,0,2,0
401403402,Rutgers Scarlet Knights,A. Hyatt,4396975,,False,5.0,0,4,0,3,0,1,0,0,0,0,0,0,0,0,0,2,0
401403402,Rutgers Scarlet Knights,J. Miller,4708076,,False,5.0,0,0,0,0,0,0,0,0,0,0,0,1,1,0,0,2,0
401403402,Rutgers Scarlet Knights,TEAM,TOTAL,TOTAL,False,,29,65,23,44,6,21,10,14,10,18,28,15,7,2,5,24,74
401403402,Iowa Hawkeyes,Ke. Murray,4594327,,True,36.0,10,19,10,14,0,5,6,6,4,4,8,2,1,1,0,1,26
401403402,Iowa Hawkeyes,P. McCaffery,4432836,,True,16.0,1,2,1,2,0,0,1,2,0,2,2,1,0,0,2,1,3
401403402,Iowa Hawkeyes,F. Rebraca,4398190,,True,26.0,2,3,2,3,0,0,1,1,1,5,6,1,0,1,0,3,5
401403402,Iowa Hawkeyes,T. Perkins,4433130,,True,25.0,6,9,4,6,2,3,2,2,0,1,1,3,0,0,2,1,16
401403402,Iowa Hawkeyes,J. Bohannon,4066366,,True,31.0,3,6,0,0,3,6,7,8,0,1,1,1,1,0,4,2,16
401403402,Iowa Hawkeyes,Kr. Murray,4594326,,False,18.0,2,6,1,3,1,3,4,4,1,4,5,0,0,2,1,2,9
401403402,Iowa Hawkeyes,P. Sandfort,4697270,,False,9.0,0,3,0,2,0,1,2,2,0,5,5,1,0,0,0,0,2
401403402,Iowa Hawkeyes,J. Toussaint,4432880,,False,15.0,1,2,1,1,0,1,2,2,1,1,2,1,1,0,0,2,4
401403402,Iowa Hawkeyes,C. McCaffery,4277950,,False,24.0,1,3,0,0,1,3,0,0,0,2,2,5,0,0,1,2,3
401403402,Iowa Hawkeyes,TEAM,TOTAL,TOTAL,False,,26,53,19,31,7,22,25,27,8,26,34,15,3,4,11,14,84
401403401,Indiana Hoosiers,T. Jackson-Davis,4431684,,True,36.0,9,13,9,13,0,0,3,4,0,7,7,3,0,1,3,3,21
401403401,Indiana Hoosiers,M. Kopp,4397231,,True,22.0,1,3,0,0,1,3,0,1,0,5,5,0,0,1,1,1,3
401403401,Indiana Hoosiers,R. Thompson,4277947,,True,25.0,3,7,1,5,2,2,2,2,2,7,9,1,1,0,1,4,10
401403401,Indiana Hoosiers,X. Johnson,4395669,,True,36.0,5,15,5,14,0,1,3,4,0,4,4,6,2,0,1,3,13
401403401,Indiana Hoosiers,P. Stewart,4278013,,True,16.0,1,3,1,2,0,1,0,0,0,1,1,2,0,0,0,2,2
401403401,Indiana Hoosiers,M. Durr,4396642,,False,4.0,0,1,0,1,0,0,0,0,0,1,1,0,0,0,0,1,0
401403401,Indiana Hoosiers,J. Geronimo,4432512,,False,9.0,0,0,0,0,0,0,2,2,1,1,2,0,0,0,1,1,2
401403401,Indiana Hoosiers,T. Bates,4683933,,False,3.0,0,1,0,1,0,0,0,0,0,2,2,0,0,0,0,0,0
401403401,Indiana Hoosiers,T. Galloway,4432315,,False,24.0,4,6,4,6,0,0,0,0,0,2,2,2,1,0,0,2,8
401403401,Indiana Hoosiers,R. Phinisee,4397010,,False,25.0,3,7,3,4,0,3,0,0,0,0,0,2,0,0,0,2,6
401403401,Indiana Hoosiers,TEAM,TOTAL,TOTAL,False,,26,56,23,46,3,10,10,13,4,31,35,16,4,2,7,19,65
401403401,Illinois Fighting Illini,K. Cockburn,4432828,,True,33.0,8,13,8,13,0,0,7,8,3,7,10,0,0,2,1,3,23
401403401,Illinois Fighting Illini,C. Hawkins,4432976,,True,32.0,5,10,1,3,4,7,4,7,2,2,4,2,2,0,1,0,18
401403401,Illinois Fighting Illini,A. Plummer,4592434,,True,34.0,2,12,0,5,2,7,0,0,0,2,2,1,1,0,0,1,6
401403401,Illinois Fighting Illini,D. Williams,4277940,,True,20.0,0,0,0,0,0,0,0,0,1,5,6,2,0,0,1,0,0
401403401,Illinois Fighting Illini,T. Frazier,4277936,,True,38.0,4,10,2,4,2,6,1,1,0,1,1,6,0,1,3,2,11
401403401,Illinois Fighting Illini,O. Payne,4432825,,False,7.0,0,1,0,1,0,0,0,0,1,0,1,0,0,1,0,3,0
401403401,Illinois Fighting Illini,L. Goode,4683743,,False,4.0,0,1,0,0,0,1,0,0,0,0,0,0,0,0,0,1,0
401403401,Illinois Fighting Illini,R. Melendez,4683738,,False,4.0,0,2,0,2,0,0,0,0,0,0,0,0,1,0,0,0,0
401403401,Illinois Fighting Illini,A. Curbelo,4432195,,False,28.0,1,7,1,6,0,1,3,7,2,8,10,4,1,1,1,3,5
401403401,Illinois Fighting Illini,TEAM,TOTAL,TOTAL,False,,20,56,12,34,8,22,15,23,9,28,37,15,5,5,8,13,63
401403400,Penn State Nittany Lions,J. Harrar,4277980,,True,31.0,3,8,3,8,0,0,6,7,3,6,9,1,1,0,1,2,12
401403400,Penn State Nittany Lions,G. Lee,4066811,,True,14.0,1,4,1,4,0,0,0,0,2,3,5,0,0,0,1,1,2
401403400,Penn State Nittany Lions,S. Lundy,4431775,,True,35.0,2,9,1,3,1,6,2,2,0,1,1,0,1,0,1,4,7
401403400,Penn State Nittany Lions,D. Johnson,4433567,,True,14.0,1,2,1,1,0,1,0,0,0,1,1,0,0,0,1,0,2
401403400,Penn State Nittany Lions,J. Pickett,4398390,,True,40.0,6,11,5,7,1,4,3,5,0,8,8,5,1,0,1,3,16
401403400,Penn State Nittany Lions,M. Dread,4397239,,False,31.0,4,5,1,2,3,3,1,2,0,3,3,3,2,0,0,4,12
401403400,Penn State Nittany Lions,S. Sessoms,4395880,,False,29.0,7,12,6,9,1,3,3,3,0,0,0,1,1,0,0,1,18
401403400,Penn State Nittany Lions,J. Cornwall,4278690,,False,6.0,1,3,1,1,0,2,0,1,0,0,0,0,0,0,0,0,2
401403400,Penn State Nittany Lions,TEAM,TOTAL,TOTAL,False,,25,54,19,35,6,19,15,20,6,23,29,10,6,0,6,15,71
401403400,Ohio State Buckeyes,E.J. Liddell,4432821,,True,37.0,6,14,4,9,2,5,11,13,2,6,8,1,0,2,3,2,25
401403400,Ohio State Buckeyes,J. Brunk,4065763,,True,31.0,5,9,5,9,0,0,0,0,1,6,7,1,2,1,0,3,10
401403400,Ohio State Buckeyes,J. Ahrens,4397236,,True,14.0,0,1,0,0,0,1,0,0,0,1,1,1,1,0,1,1,0
401403400,Ohio State Buckeyes,M. Branham,4565201,,True,36.0,6,12,6,10,0,2,4,4,3,1,4,4,0,0,3,2,16
401403400,Ohio State Buckeyes,J. Wheeler,4277978,,True,34.0,3,9,1,2,2,7,0,0,0,2,2,2,1,1,0,4,8
401403400,Ohio State Buckeyes,E. Brown III,4433179,,False,14.0,1,2,0,1,1,1,0,0,0,3,3,0,0,0,0,1,3
401403400,Ohio State Buckeyes,C. Russell,4280257,,False,28.0,2,5,0,3,2,2,0,0,0,1,1,2,0,0,0,2,6
401403400,Ohio State Buckeyes,J. Sotos,4280044,,False,6.0,0,0,0,0,0,0,0,0,0,0,0,0,0,0,1,2,0
401403400,Ohio State Buckeyes,TEAM,TOTAL,TOTAL,False,,23,52,16,34,7,18,15,17,6,22,28,11,4,4,8,17,68
401403399,Michigan State Spartans,M. Bingham Jr.,4397212,,True,14.0,4,7,4,6,0,1,1,2,1,4,5,1,1,0,1,2,9
401403399,Michigan State Spartans,G. Brown,4397210,,True,33.0,5,8,3,4,2,4,1,1,0,6,6,0,0,0,0,0,13
401403399,Michigan State Spartans,J. Hauser,4295180,,True,23.0,1,3,0,1,1,2,0,0,1,4,5,2,0,0,3,5,3
401403399,Michigan State Spartans,M. Christie,4432582,,True,33.0,4,6,1,3,3,3,5,6,0,6,6,2,1,0,1,1,16
401403399,Michigan State Spartans,T. Walker,4432129,,True,21.0,3,6,2,3,1,3,2,2,0,1,1,3,0,1,4,2,9
401403399,Michigan State Spartans,M. Hall,4592693,,False,24.0,3,9,3,7,0,2,2,3,2,4,6,0,1,0,3,1,8
401403399,Michigan State Spartans,J. Marble II,4433031,,False,12.0,3,5,3,5,0,0,2,2,0,2,2,0,0,1,2,0,8
401403399,Michigan State Spartans,M. Sissoko,4433154,,False,5.0,0,1,0,1,0,0,0,0,0,0,0,0,0,1,1,1,0
401403399,Michigan State Spartans,J. Akins,4683730,,False,15.0,2,4,0,1,2,3,0,0,0,3,3,1,0,0,0,4,6
401403399,Michigan State Spartans,A. Hoggard,4432206,,False,20.0,2,5,2,4,0,1,0,0,1,0,1,6,1,0,1,1,4
401403399,Michigan State Spartans,TEAM,TOTAL,TOTAL,False,,27,54,18,35,9,19,13,16,8,32,40,15,4,3,16,17,76
401403399,Maryland Terrapins,Q. Wahab,4431739,,True,11.0,0,1,0,1,0,0,0,2,0,2,2,0,0,0,1,0,0
401403399,Maryland Terrapins,D. Scott,4432852,,True,34.0,5,11,3,5,2,6,3,3,3,3,6,3,0,0,0,3,15
401403399,Maryland Terrapins,H. Hart,4431984,,True,35.0,5,10,4,5,1,5,0,0,1,3,4,2,2,0,1,4,11
401403399,Maryland Terrapins,E. Ayala,4397184,,True,38.0,5,17,3,7,2,10,5,6,2,4,6,3,1,0,2,1,17
401403399,Maryland Terrapins,F. Russell,4278371,,True,36.0,6,15,3,8,3,7,5,7,1,6,7,6,2,2,1,1,20
401403399,Maryland Terrapins,J. Reese,4683742,,False,14.0,0,4,0,4,0,0,0,0,1,2,3,0,0,1,1,3,0
401403399,Maryland Terrapins,I. Martinez,4601026,,False,6.0,2,3,2,3,0,0,0,0,0,0,0,0,0,1,0,2,4
401403399,Maryland Terrapins,X. Green,4067031,,False,26.0,2,3,1,2,1,1,0,0,0,1,1,3,4,0,0,1,5
401403399,Maryland Terrapins,TEAM,TOTAL,TOTAL,False,,25,64,16,35,9,29,13,18,9,21,30,17,9,4,6,15,72
401403398,Michigan Wolverines,M. Diabate,4433249,,True,33.0,1,6,1,6,0,0,2,2,2,10,12,1,1,2,3,2,4
401403398,Michigan Wolverines,C. Houstan,4433623,,True,32.0,3,10,0,2,3,8,0,0,1,3,4,3,0,0,1,3,9
401403398,Michigan Wolverines,H. Dickinson,4432180,,True,33.0,7,12,6,9,1,3,0,0,1,4,5,2,0,1,0,4,15
401403398,Michigan Wolverines,D. Jones,4397506,,True,35.0,5,10,5,8,0,2,8,9,2,2,4,3,2,0,3,0,18
401403398,Michigan Wolverines,E. Brooks,4277960,,True,38.0,4,13,2,8,2,5,7,8,0,2,2,3,4,0,3,3,17
401403398,Michigan Wolverines,T. Williams II,4702236,,False,9.0,0,2,0,1,0,1,0,0,0,0,0,0,0,0,0,1,0
401403398,Michigan Wolverines,B. Johns Jr.,4397206,,False,13.0,1,4,1,3,0,1,2,2,0,1,1,0,0,0,0,0,4
401403398,Michigan Wolverines,F. Collins,4433616,,False,7.0,1,1,1,1,0,0,0,0,0,0,0,1,0,1,1,0,2
401403398,Michigan Wolverines,TEAM,TOTAL,TOTAL,False,,22,58,16,38,6,20,19,21,10,24,34,13,7,4,12,13,69
401403398,Indiana Hoosiers,T. Jackson-Davis,4431684,,True,36.0,10,17,10,17,0,0,4,6,1,7,8,1,1,4,2,2,24
401403398,Indiana Hoosiers,M. Kopp,4397231,,True,33.0,3,6,1,2,2,4,1,2,0,3,3,0,0,1,1,2,9
401403398,Indiana Hoosiers,R. Thompson,4277947,,True,20.0,2,5,2,5,0,0,1,2,0,4,4,1,0,1,3,2,5
401403398,Indiana Hoosiers,X. Johnson,4395669,,True,27.0,5,10,2,6,3,4,4,4,2,6,8,7,1,0,3,3,17
401403398,Indiana Hoosiers,P. Stewart,4278013,,True,13.0,1,3,0,1,1,2,2,2,0,1,1,0,0,0,0,2,5
401403398,Indiana Hoosiers,M. Durr,4396642,,False,4.0,0,0,0,0,0,0,0,0,0,0,0,1,0,0,1,1,0
401403398,Indiana Hoosiers,J. Geronimo,4432512,,False,20.0,1,3,0,1,1,2,2,2,0,2,2,1,0,2,0,1,5
401403398,Indiana Hoosiers,T. Galloway,4432315,,False,28.0,2,6,2,6,0,0,0,0,0,1,1,5,3,0,1,0,4
401403398,Indiana Hoosiers,R. Phinisee,4397010,,False,19.0,2,6,1,3,1,3,0,1,1,0,1,2,0,0,0,4,5
401403398,Indiana Hoosiers,TEAM,TOTAL,TOTAL,False,,26,56,18,41,8,15,14,19,8,24,32,18,5,8,12,18,74
401403397,Northwestern Wildcats,R. Beran,4431737,,True,14.0,4,5,2,2,2,3,0,0,1,1,2,0,0,0,0,3,10
401403397,Northwestern Wildcats,P. Nance,4397233,,True,23.0,5,9,5,8,0,1,1,3,0,2,2,2,0,0,1,1,11
401403397,Northwestern Wildcats,J. Roper II,4683949,,True,18.0,3,5,0,1,3,4,0,0,0,2,2,1,0,3,0,5,9
401403397,Northwestern Wildcats,B. Buie,4592712,,True,23.0,4,8,2,4,2,4,2,2,1,1,2,2,0,0,3,0,12
401403397,Northwestern Wildcats,C. Audige,4397602,,True,21.0,0,6,0,6,0,0,0,0,1,1,2,2,1,0,1,0,0
401403397,Northwestern Wildcats,E. Williams,4279627,,False,6.0,0,0,0,0,0,0,0,0,0,1,1,0,0,0,0,0,0
401403397,Northwestern Wildcats,C. Simmons,4432692,,False,18.0,2,5,1,3,1,2,0,0,1,0,1,1,0,0,0,1,5
401403397,Northwestern Wildcats,M. Nicholson,4702289,,False,8.0,1,2,1,2,0,0,0,1,1,0,1,0,0,0,0,1,2
401403397,Northwestern Wildcats,R. Young,4397232,,False,17.0,6,8,6,8,0,0,2,2,1,0,1,1,1,1,2,0,14
401403397,Northwestern Wildcats,T. Berry,4702288,,False,16.0,1,6,0,2,1,4,0,2,0,0,0,2,1,0,0,0,3
401403397,Northwestern Wildcats,B. Barnhizer,4684208,,False,14.0,3,9,3,7,0,2,0,0,2,0,2,0,1,1,0,0,6
401403397,Northwestern Wildcats,R. Dixon III,4592715,,False,2.0,0,0,0,0,0,0,0,0,0,0,0,0,0,0,0,0,0
401403397,Northwestern Wildcats,R. Greer,4397230,,False,20.0,2,5,2,4,0,1,0,0,0,0,0,4,0,0,0,0,4
401403397,Northwestern Wildcats,TEAM,TOTAL,TOTAL,False,,31,68,22,47,9,21,5,10,9,9,18,15,4,5,8,11,76
401403397,Iowa Hawkeyes,Ke. Murray,4594327,,True,21.0,11,16,8,13,3,3,1,1,3,5,8,2,1,0,0,1,26
401403397,Iowa Hawkeyes,P. McCaffery,4432836,,True,18.0,3,6,2,2,1,4,3,5,0,2,2,1,1,0,0,0,10
401403397,Iowa Hawkeyes,F. Rebraca,4398190,,True,23.0,5,5,5,5,0,0,0,0,3,6,9,4,0,2,1,3,10
401403397,Iowa Hawkeyes,T. Perkins,4433130,,True,18.0,2,6,0,4,2,2,0,0,2,2,4,6,1,0,0,1,6
401403397,Iowa Hawkeyes,J. Bohannon,4066366,,True,24.0,6,9,1,1,5,8,0,0,0,0,0,3,1,0,2,1,17
401403397,Iowa Hawkeyes,R. Mulvey,4685004,,False,8.0,1,2,1,1,0,1,0,0,0,0,0,0,0,3,0,0,2
401403397,Iowa Hawkeyes,Kr. Murray,4594326,,False,18.0,2,3,1,2,1,1,1,1,0,1,1,0,0,0,1,1,6
401403397,Iowa Hawkeyes,J. Ogundele,4433231,,False,11.0,2,5,2,5,0,0,0,2,3,2,5,0,0,0,3,3,4
401403397,Iowa Hawkeyes,P. Sandfort,4697270,,False,15.0,5,9,2,4,3,5,0,0,0,2,2,0,0,0,1,2,13
401403397,Iowa Hawkeyes,L. Laketa,4897422,,False,4.0,1,1,0,0,1,1,0,0,0,1,1,0,0,0,0,0,3
401403397,Iowa Hawkeyes,J. Toussaint,4432880,,False,8.0,1,1,0,0,1,1,0,0,0,0,0,1,1,0,3,3,3
401403397,Iowa Hawkeyes,A. Ulis,4432454,,False,11.0,1,3,1,3,0,0,0,0,0,1,1,2,0,0,2,2,2
401403397,Iowa Hawkeyes,C. McCaffery,4277950,,False,15.0,2,3,1,1,1,2,0,0,0,2,2,3,0,0,0,0,5
401403397,Iowa Hawkeyes,A. Ash,4277949,,False,6.0,1,1,0,0,1,1,2,3,0,2,2,3,0,0,1,0,5
401403397,Iowa Hawkeyes,TEAM,TOTAL,TOTAL,False,,43,70,24,41,19,29,7,12,16,29,45,25,5,5,15,17,112
401403396,Penn State Nittany Lions,J. Harrar,4277980,,True,25.0,2,4,2,4,0,0,2,2,4,8,12,3,1,1,3,2,6
401403396,Penn State Nittany Lions,S. Lundy,4431775,,True,37.0,3,8,1,3,2,5,3,3,0,4,4,1,1,1,1,3,11
401403396,Penn State Nittany Lions,D. Johnson,4433567,,True,20.0,0,5,0,1,0,4,0,0,1,1,2,0,0,0,1,0,0
401403396,Penn State Nittany Lions,J. Pickett,4398390,,True,40.0,9,14,6,10,3,4,1,1,0,7,7,4,1,0,3,1,22
401403396,Penn State Nittany Lions,M. Dread,4397239,,True,27.0,1,3,0,0,1,3,0,1,0,2,2,0,1,1,0,0,3
401403396,Penn State Nittany Lions,C. Dorsey,4581505,,False,1.0,0,0,0,0,0,0,0,0,0,0,0,0,0,0,0,0,0
401403396,Penn State Nittany Lions,G. Lee,4066811,,False,19.0,2,4,2,2,0,2,0,0,0,2,2,1,0,0,0,3,4
401403396,Penn State Nittany Lions,A. Christos,4702328,,False,1.0,0,0,0,0,0,0,0,0,0,0,0,0,0,0,0,0,0
401403396,Penn State Nittany Lions,S. Sessoms,4395880,,False,31.0,5,12,3,8,2,4,2,3,1,4,5,0,1,0,2,2,14
401403396,Penn State Nittany Lions,TEAM,TOTAL,TOTAL,False,,22,50,14,28,8,22,8,10,7,30,37,9,5,3,10,11,60
401403396,Minnesota Golden Gophers,J. Battle,4431893,,True,40.0,7,16,4,8,3,8,2,2,0,6,6,0,1,0,0,2,19
401403396,Minnesota Golden Gophers,E. Curry,4066388,,True,39.0,4,10,4,9,0,1,2,2,2,3,5,6,2,2,2,2,10
401403396,Minnesota Golden Gophers,S. Sutherlin,4593987,,True,40.0,5,7,5,7,0,0,0,0,1,5,6,4,1,1,1,2,10
401403396,Minnesota Golden Gophers,L. Loewe,4279227,,True,40.0,1,8,1,4,0,4,0,0,0,1,1,2,1,0,1,4,2
401403396,Minnesota Golden Gophers,P. Willis,4066230,,True,40.0,3,13,1,7,2,6,2,4,0,5,5,1,1,1,1,2,10
401403396,Minnesota Golden Gophers,E. Stephens,4280074,,False,1.0,0,0,0,0,0,0,0,0,0,0,0,0,0,0,0,0,0
401403396,Minnesota Golden Gophers,TEAM,TOTAL,TOTAL,False,,20,54,15,35,5,19,6,8,4,22,26,13,6,4,5,12,51
401403395,Northwestern Wildcats,R. Beran,4431737,,True,17.0,1,4,1,2,0,2,1,2,0,4,4,0,0,2,1,1,3
401403395,Northwestern Wildcats,P. Nance,4397233,,True,30.0,5,9,3,6,2,3,2,2,1,7,8,8,0,1,2,2,14
401403395,Northwestern Wildcats,J. Roper II,4683949,,True,29.0,3,8,2,4,1,4,1,1,3,2,5,1,0,0,0,2,8
401403395,Northwestern Wildcats,B. Buie,4592712,,True,32.0,4,11,1,1,3,10,5,6,0,0,0,3,1,0,6,2,16
401403395,Northwestern Wildcats,C. Audige,4397602,,True,25.0,2,11,0,5,2,6,3,4,2,4,6,2,2,0,1,3,9
401403395,Northwestern Wildcats,E. Williams,4279627,,False,16.0,3,4,2,3,1,1,0,0,0,1,1,2,0,0,1,3,7
401403395,Northwestern Wildcats,C. Simmons,4432692,,False,5.0,1,2,1,2,0,0,0,0,2,0,2,0,0,0,0,0,2
401403395,Northwestern Wildcats,R. Young,4397232,,False,17.0,3,4,3,4,0,0,1,3,2,2,4,0,0,1,0,2,7
401403395,Northwestern Wildcats,T. Berry,4702288,,False,23.0,2,6,1,2,1,4,0,0,0,4,4,2,0,0,1,3,5
401403395,Northwestern Wildcats,R. Greer,4397230,,False,6.0,0,0,0,0,0,0,0,0,1,1,2,0,0,0,2,0,0
401403395,Northwestern Wildcats,TEAM,TOTAL,TOTAL,False,,24,59,14,29,10,30,13,18,11,27,38,18,3,4,14,18,71
401403395,Nebraska Cornhuskers,D. Walker,4278113,,True,33.0,4,5,4,5,0,0,8,9,1,6,7,1,1,2,2,5,16
401403395,Nebraska Cornhuskers,L. Mayen,4277914,,True,27.0,3,6,2,3,1,3,2,2,1,6,7,0,0,0,1,2,9
401403395,Nebraska Cornhuskers,A. Verge Jr.,4592358,,True,38.0,7,13,7,11,0,2,7,9,1,6,7,9,4,0,3,2,21
401403395,Nebraska Cornhuskers,B. McGowens,4576086,,True,32.0,2,10,2,7,0,3,2,4,1,2,3,0,1,0,2,1,6
401403395,Nebraska Cornhuskers,T. McGowens,4395670,,True,33.0,2,7,2,6,0,1,3,3,0,5,5,0,4,0,2,2,7
401403395,Nebraska Cornhuskers,E. Andre,4702281,,False,7.0,1,2,1,2,0,0,0,0,0,1,1,0,0,0,0,0,2
401403395,Nebraska Cornhuskers,K. Tominaga,4897433,,False,0.0,0,0,0,0,0,0,0,0,0,0,0,0,0,0,0,0,0
401403395,Nebraska Cornhuskers,K. Edwards,4711442,,False,1.0,0,0,0,0,0,0,0,0,0,0,0,0,0,0,0,0,0
401403395,Nebraska Cornhuskers,C.J. Wilcher,4432590,,False,12.0,0,1,0,0,0,1,0,0,0,0,0,0,0,0,0,4,0
401403395,Nebraska Cornhuskers,K. Webster,4279535,,False,17.0,3,7,1,2,2,5,0,0,0,0,0,0,1,0,0,1,8
401403395,Nebraska Cornhuskers,TEAM,TOTAL,TOTAL,False,,22,51,19,36,3,15,22,27,5,27,32,10,11,2,11,17,69
401403394,Jacksonville Dolphins,O. Osifo,4702251,,True,24.0,4,5,4,5,0,0,3,4,3,3,6,0,0,0,1,3,11
401403394,Jacksonville Dolphins,M. Marsh,4897563,,True,18.0,4,5,4,5,0,0,0,0,2,1,3,0,0,0,0,1,8
401403394,Jacksonville Dolphins,T. Davis,4396697,,True,29.0,3,8,2,3,1,5,4,4,2,4,6,2,0,0,0,4,11
401403394,Jacksonville Dolphins,K. Nolan,4280064,,True,38.0,2,11,1,4,1,7,2,3,1,4,5,5,0,0,0,2,7
401403394,Jacksonville Dolphins,J. Davis,4278351,,True,31.0,8,14,5,8,3,6,3,3,0,2,2,3,0,0,0,3,22
401403394,Jacksonville Dolphins,B. Workman,4396696,,False,16.0,1,2,1,2,0,0,2,2,2,5,7,1,0,0,2,3,4
401403394,Jacksonville Dolphins,R. Brown,4278483,,False,17.0,1,3,1,2,0,1,0,1,2,1,3,0,1,0,1,1,2
401403394,Jacksonville Dolphins,G. Pridgett,4897566,,False,7.0,0,2,0,1,0,1,0,0,0,0,0,0,1,0,0,0,0
401403394,Jacksonville Dolphins,G. Powell,4897562,,False,20.0,3,8,2,4,1,4,0,0,0,1,1,1,1,0,1,0,7
401403394,Jacksonville Dolphins,TEAM,TOTAL,TOTAL,False,,26,58,20,34,6,24,14,17,13,21,34,12,3,0,6,17,72
401403394,Bellarmine Knights,C. Hopf,4897013,,True,23.0,1,2,0,1,1,1,0,0,0,2,2,0,0,0,1,4,3
401403394,Bellarmine Knights,E. Claycomb,4067013,,True,35.0,1,4,1,1,0,3,1,3,2,2,4,2,1,0,3,4,3
401403394,Bellarmine Knights,CJ Fleming,4700829,,True,39.0,6,16,2,5,4,11,11,11,1,1,2,2,0,0,0,1,27
401403394,Bellarmine Knights,D. Penn,4700826,,True,37.0,9,15,8,13,1,2,3,3,0,6,6,4,0,0,0,1,22
401403394,Bellarmine Knights,J. Betz,4700822,,True,30.0,3,5,1,3,2,2,0,0,1,8,9,2,2,0,1,5,8
401403394,Bellarmine Knights,S. DeVault,4432966,,False,14.0,3,6,0,1,3,5,0,0,0,0,0,0,0,0,0,1,9
401403394,Bellarmine Knights,B. Wieland,4700827,,False,1.0,0,0,0,0,0,0,0,0,0,0,0,0,0,0,0,1,0
401403394,Bellarmine Knights,G. Tipton,4700825,,False,21.0,2,2,1,1,1,1,0,0,1,1,2,0,0,0,0,0,5
401403394,Bellarmine Knights,TEAM,TOTAL,TOTAL,False,,25,50,13,25,12,25,15,17,6,21,27,10,3,0,5,17,77
401403393,Jacksonville State Gamecocks,K. Henry,4593671,,True,27.0,6,15,4,6,2,9,0,0,2,3,5,0,3,0,1,2,14
401403393,Jacksonville State Gamecocks,B. Huffman,4277912,,True,17.0,0,2,0,2,0,0,0,0,0,4,4,0,1,1,3,2,0
401403393,Jacksonville State Gamecocks,J. Finch,4703243,,True,34.0,3,7,3,4,0,3,0,0,0,2,2,5,2,0,2,0,6
401403393,Jacksonville State Gamecocks,J. Gibbs,4278993,,True,28.0,2,7,2,3,0,4,1,2,0,3,3,0,2,0,1,1,5
401403393,Jacksonville State Gamecocks,D. Adams,4067814,,True,39.0,3,10,1,3,2,7,2,2,2,4,6,3,0,1,6,3,10
401403393,Jacksonville State Gamecocks,J. Pal,4703247,,False,1.0,0,0,0,0,0,0,0,0,0,0,0,0,0,0,0,0,0
401403393,Jacksonville State Gamecocks,J. Perdue,4433059,,False,9.0,2,4,2,4,0,0,0,0,0,1,1,0,0,0,0,2,4
401403393,Jacksonville State Gamecocks,M. Zeliznak,4398323,,False,22.0,2,3,2,3,0,0,0,1,5,2,7,0,1,2,0,3,4
401403393,Jacksonville State Gamecocks,D. King,4703244,,False,23.0,3,5,1,1,2,4,0,0,0,1,1,3,0,0,1,1,8
401403393,Jacksonville State Gamecocks,C. Byrd,4702737,,False,0.0,0,0,0,0,0,0,0,0,0,0,0,0,0,0,0,0,0
401403393,Jacksonville State Gamecocks,TEAM,TOTAL,TOTAL,False,,21,53,15,26,6,27,3,5,10,22,32,11,9,4,15,17,51
401403393,Jacksonville Dolphins,O. Osifo,4702251,,True,14.0,2,4,2,4,0,0,0,0,2,0,2,0,0,0,2,3,4
401403393,Jacksonville Dolphins,M. Marsh,4897563,,True,33.0,2,7,2,7,0,0,4,6,2,5,7,1,1,0,1,2,8
401403393,Jacksonville Dolphins,T. Davis,4396697,,True,35.0,1,3,0,0,1,3,2,2,1,4,5,2,1,0,2,2,5
401403393,Jacksonville Dolphins,K. Nolan,4280064,,True,37.0,6,15,3,7,3,8,4,4,0,1,1,2,3,0,4,0,19
401403393,Jacksonville Dolphins,J. Davis,4278351,,True,33.0,3,5,2,2,1,3,0,0,2,0,2,1,2,0,5,3,7
401403393,Jacksonville Dolphins,B. Workman,4396696,,False,24.0,2,8,2,8,0,0,3,4,2,7,9,0,0,0,2,2,7
401403393,Jacksonville Dolphins,R. Brown,4278483,,False,9.0,1,3,1,3,0,0,0,0,1,0,1,0,0,0,0,0,2
401403393,Jacksonville Dolphins,G. Powell,4897562,,False,15.0,1,4,1,2,0,2,0,0,0,1,1,0,1,0,0,1,2
401403393,Jacksonville Dolphins,TEAM,TOTAL,TOTAL,False,,18,49,13,33,5,16,13,16,11,23,34,6,8,0,16,13,54
401403392,Liberty Flames,K. Rode,4592272,,True,35.0,3,6,3,4,0,2,0,0,0,3,3,2,1,0,1,0,6
401403392,Liberty Flames,S. Robinson,4592271,,True,29.0,0,4,0,2,0,2,0,0,0,8,8,1,1,2,2,0,0
401403392,Liberty Flames,K. McDowell,4278884,,True,33.0,3,8,2,3,1,5,0,0,1,2,3,1,0,0,0,2,7
401403392,Liberty Flames,J. Venzant,4897572,,True,20.0,0,0,0,0,0,0,2,2,2,3,5,1,1,1,0,2,2
401403392,Liberty Flames,D. McGhee,4396745,,True,34.0,8,19,5,7,3,12,2,2,0,3,3,3,1,0,3,2,21
401403392,Liberty Flames,B. Preston,4396747,,False,10.0,0,1,0,1,0,0,0,0,1,2,3,1,0,0,4,2,0
401403392,Liberty Flames,B. Peebles,4897570,,False,15.0,3,5,1,2,2,3,2,3,0,3,3,0,0,0,1,0,10
401403392,Liberty Flames,D. Moore,4897569,,False,0.0,0,0,0,0,0,0,0,0,0,0,0,0,0,0,0,0,0
401403392,Liberty Flames,I. Warfield,4700843,,False,24.0,2,2,2,2,0,0,0,0,0,1,1,2,0,0,2,2,4
401403392,Liberty Flames,TEAM,TOTAL,TOTAL,False,,19,45,13,21,6,24,6,7,4,25,29,11,4,3,13,10,50
401403392,Bellarmine Knights,C. Hopf,4897013,,True,33.0,2,5,2,3,0,2,0,0,2,4,6,0,0,0,1,2,4
401403392,Bellarmine Knights,E. Claycomb,4067013,,True,35.0,6,9,5,6,1,3,3,3,2,4,6,1,2,0,1,3,16
401403392,Bellarmine Knights,CJ Fleming,4700829,,True,36.0,3,12,0,2,3,10,2,2,1,1,2,0,0,0,0,0,11
401403392,Bellarmine Knights,D. Penn,4700826,,True,40.0,9,23,8,21,1,2,0,0,0,3,3,4,2,1,3,1,19
401403392,Bellarmine Knights,J. Betz,4700822,,True,39.0,1,4,1,4,0,0,1,2,2,6,8,1,3,0,0,2,3
401403392,Bellarmine Knights,S. DeVault,4432966,,False,2.0,0,0,0,0,0,0,0,0,0,0,0,0,0,0,0,0,0
401403392,Bellarmine Knights,G. Tipton,4700825,,False,14.0,0,0,0,0,0,0,0,0,0,3,3,1,0,0,2,0,0
401403392,Bellarmine Knights,TEAM,TOTAL,TOTAL,False,,21,53,16,36,5,17,6,7,7,23,30,7,7,1,9,8,53
401403391,Jacksonville Dolphins,O. Osifo,4702251,,True,9.0,1,1,1,1,0,0,0,0,0,1,1,0,0,0,1,5,2
401403391,Jacksonville Dolphins,M. Marsh,4897563,,True,33.0,6,12,6,12,0,0,6,11,1,1,2,1,1,0,1,2,18
401403391,Jacksonville Dolphins,T. Davis,4396697,,True,38.0,2,6,1,4,1,2,0,2,0,2,2,4,0,1,0,2,5
401403391,Jacksonville Dolphins,K. Nolan,4280064,,True,36.0,4,11,1,5,3,6,4,4,1,9,10,2,1,0,0,1,15
401403391,Jacksonville Dolphins,J. Davis,4278351,,True,32.0,5,8,5,6,0,2,2,3,0,4,4,3,1,1,0,1,12
401403391,Jacksonville Dolphins,B. Workman,4396696,,False,34.0,8,14,8,14,0,0,5,5,3,3,6,1,0,0,2,2,21
401403391,Jacksonville Dolphins,R. Brown,4278483,,False,4.0,1,2,1,1,0,1,0,0,1,0,1,0,0,0,0,1,2
401403391,Jacksonville Dolphins,G. Pridgett,4897566,,False,2.0,0,0,0,0,0,0,0,0,0,0,0,0,0,0,0,0,0
401403391,Jacksonville Dolphins,G. Powell,4897562,,False,12.0,2,4,2,3,0,1,0,0,1,2,3,0,0,0,0,2,4
401403391,Jacksonville Dolphins,TEAM,TOTAL,TOTAL,False,,29,58,25,46,4,12,17,25,10,24,34,11,3,2,4,16,79
401403391,Central Arkansas Bears,J. Chatham,4067640,,True,34.0,6,14,5,10,1,4,2,2,0,6,6,1,1,3,0,4,15
401403391,Central Arkansas Bears,E. Kayouloud,4397987,,True,28.0,7,10,6,9,1,1,2,2,2,4,6,0,0,1,1,4,17
401403391,Central Arkansas Bears,D. Hall,4278050,,True,36.0,5,13,5,12,0,1,8,11,0,1,1,2,0,0,3,5,18
401403391,Central Arkansas Bears,C. Hunter,4897018,,True,37.0,3,8,3,5,0,3,3,3,2,4,6,5,0,0,1,2,9
401403391,Central Arkansas Bears,C. Cooper,4431932,,True,36.0,2,5,2,2,0,3,0,0,0,4,4,2,0,0,1,4,4
401403391,Central Arkansas Bears,C. Bounds,4703608,,False,1.0,0,0,0,0,0,0,0,0,0,0,0,0,0,0,0,0,0
401403391,Central Arkansas Bears,J. Baker,4397988,,False,7.0,2,3,0,0,2,3,0,0,0,0,0,0,0,0,0,0,6
401403391,Central Arkansas Bears,I. Klintman,4897015,,False,11.0,0,0,0,0,0,0,0,0,1,1,2,1,0,0,1,0,0
401403391,Central Arkansas Bears,M. Olowokere,4596536,,False,10.0,0,1,0,0,0,1,0,0,0,3,3,0,0,1,1,1,0
401403391,Central Arkansas Bears,TEAM,TOTAL,TOTAL,False,,25,54,21,38,4,16,15,18,6,24,30,11,1,5,8,20,69
401403390,Kennesaw State Owls,D. Robinson,4433069,,True,22.0,0,5,0,5,0,0,0,0,1,4,5,1,0,0,1,4,0
401403390,Kennesaw State Owls,C. Youngblood,4706557,,True,34.0,7,12,2,4,5,8,1,2,2,1,3,1,1,0,1,3,20
401403390,Kennesaw State Owls,T. Burden,4592262,,True,27.0,1,7,1,5,0,2,2,2,0,3,3,7,0,1,1,2,4
401403390,Kennesaw State Owls,B. Stroud,4433177,,True,31.0,4,9,3,5,1,4,0,3,3,4,7,0,1,0,3,3,9
401403390,Kennesaw State Owls,S. Rodgers,4397715,,True,28.0,1,9,0,3,1,6,2,2,1,2,3,2,2,0,2,1,5
401403390,Kennesaw State Owls,A. Peterson,4700839,,False,17.0,2,2,2,2,0,0,0,0,1,2,3,0,0,0,0,3,4
401403390,Kennesaw State Owls,C. LaRue,4700838,,False,2.0,0,0,0,0,0,0,0,0,0,0,0,0,0,0,0,1,0
401403390,Kennesaw State Owls,I. Reddish,4897567,,False,9.0,2,3,1,1,1,2,0,0,0,1,1,0,0,0,0,1,5
401403390,Kennesaw State Owls,K. Jennings,4700841,,False,12.0,3,5,1,1,2,4,0,0,0,0,0,0,0,0,0,0,8
401403390,Kennesaw State Owls,J. Moultrie,4278365,,False,18.0,4,8,0,1,4,7,0,0,0,0,0,1,0,0,1,1,12
401403390,Kennesaw State Owls,TEAM,TOTAL,TOTAL,False,,24,60,10,27,14,33,5,9,9,19,28,12,4,1,10,19,67
401403390,Jacksonville State Gamecocks,K. Henry,4593671,,True,28.0,3,6,3,5,0,1,6,6,1,5,6,1,0,1,1,3,12
401403390,Jacksonville State Gamecocks,B. Huffman,4277912,,True,21.0,6,7,6,7,0,0,2,4,0,7,7,0,0,1,0,2,14
401403390,Jacksonville State Gamecocks,J. Finch,4703243,,True,18.0,2,5,2,5,0,0,4,4,0,1,1,2,0,0,3,2,8
401403390,Jacksonville State Gamecocks,J. Gibbs,4278993,,True,34.0,1,7,1,3,0,4,2,2,0,3,3,3,0,0,0,2,4
401403390,Jacksonville State Gamecocks,D. Adams,4067814,,True,37.0,5,10,4,7,1,3,6,6,0,0,0,5,0,0,2,1,17
401403390,Jacksonville State Gamecocks,J. Pal,4703247,,False,11.0,1,1,1,1,0,0,0,0,0,2,2,1,2,1,1,0,2
401403390,Jacksonville State Gamecocks,J. Perdue,4433059,,False,10.0,1,1,1,1,0,0,0,0,0,0,0,1,0,0,0,0,2
401403390,Jacksonville State Gamecocks,M. Zeliznak,4398323,,False,17.0,6,6,6,6,0,0,2,4,3,6,9,0,0,0,2,2,14
401403390,Jacksonville State Gamecocks,D. King,4703244,,False,24.0,2,8,1,4,1,4,0,0,2,3,5,3,0,0,1,1,5
401403390,Jacksonville State Gamecocks,TEAM,TOTAL,TOTAL,False,,27,51,25,39,2,12,22,26,6,29,35,16,2,3,11,13,78
401403389,Florida Gulf Coast Eagles,K. Samuel,4277915,,True,35.0,5,13,5,13,0,0,0,2,8,2,10,1,1,2,2,2,10
401403389,Florida Gulf Coast Eagles,C. Largie,4592249,,True,18.0,3,3,1,1,2,2,2,2,1,2,3,1,0,0,3,0,10
401403389,Florida Gulf Coast Eagles,A. Richie,4397858,,True,36.0,5,12,2,3,3,9,0,0,1,3,4,0,0,1,1,1,13
401403389,Florida Gulf Coast Eagles,C. Catto,4396688,,True,34.0,1,3,0,0,1,3,0,0,1,2,3,2,1,0,1,4,3
401403389,Florida Gulf Coast Eagles,T. Dunn-Martin,4067358,,True,39.0,9,19,6,11,3,8,6,6,0,3,3,4,1,0,4,2,27
401403389,Florida Gulf Coast Eagles,Z. Anderson,4700870,,False,23.0,0,1,0,1,0,0,0,0,2,3,5,1,0,0,2,0,0
401403389,Florida Gulf Coast Eagles,D. Rivers,4592248,,False,12.0,2,3,2,2,0,1,0,0,1,1,2,0,1,0,0,2,4
401403389,Florida Gulf Coast Eagles,A. Weir,4741885,,False,3.0,0,1,0,1,0,0,1,2,1,0,1,0,0,0,0,0,1
401403389,Florida Gulf Coast Eagles,TEAM,TOTAL,TOTAL,False,,25,55,16,32,9,23,9,12,16,21,37,9,4,3,14,11,68
401403389,Bellarmine Knights,C. Hopf,4897013,,True,32.0,4,9,1,3,3,6,0,0,1,2,3,0,0,0,0,2,11
401403389,Bellarmine Knights,E. Claycomb,4067013,,True,27.0,6,13,2,3,4,10,0,0,1,3,4,2,3,1,1,3,16
401403389,Bellarmine Knights,CJ Fleming,4700829,,True,39.0,6,10,2,3,4,7,3,4,0,2,2,1,2,0,0,2,19
401403389,Bellarmine Knights,D. Penn,4700826,,True,40.0,8,14,7,12,1,2,0,0,2,1,3,10,1,0,3,0,17
401403389,Bellarmine Knights,J. Betz,4700822,,True,39.0,5,6,5,5,0,1,0,0,2,5,7,3,3,0,1,2,10
401403389,Bellarmine Knights,N. Thelen,4700830,,False,0.0,0,0,0,0,0,0,0,0,0,0,0,0,0,0,0,0,0
401403389,Bellarmine Knights,S. DeVault,4432966,,False,3.0,1,2,0,0,1,2,0,0,0,0,0,0,0,0,0,0,3
401403389,Bellarmine Knights,B. Younker,4700831,,False,0.0,0,0,0,0,0,0,0,0,0,0,0,0,0,0,0,0,0
401403389,Bellarmine Knights,B. Wieland,4700827,,False,0.0,0,0,0,0,0,0,0,0,0,0,0,0,0,0,0,0,0
401403389,Bellarmine Knights,G. Tipton,4700825,,False,20.0,2,4,1,1,1,3,0,0,0,1,1,1,0,0,0,0,5
401403389,Bellarmine Knights,TEAM,TOTAL,TOTAL,False,,32,58,18,27,14,31,3,4,6,15,21,17,9,1,6,9,81
401403388,Lipscomb Bisons,P. Hazen,4279172,,True,32.0,1,3,1,2,0,1,2,4,0,6,6,0,0,0,0,2,4
401403388,Lipscomb Bisons,A. Asadullah,4278445,,True,24.0,5,14,5,13,0,1,0,0,2,6,8,1,0,0,1,4,10
401403388,Lipscomb Bisons,T. Benham,4897579,,True,36.0,9,20,6,10,3,10,0,0,1,3,4,0,0,0,0,1,21
401403388,Lipscomb Bisons,W. Pruitt,4590356,,True,34.0,2,7,2,5,0,2,2,3,0,5,5,1,1,0,2,4,6
401403388,Lipscomb Bisons,G. Jones,4278444,,True,35.0,0,5,0,1,0,4,0,0,1,5,6,0,4,0,1,2,0
401403388,Lipscomb Bisons,J. Ognacevic,4703983,,False,5.0,0,1,0,1,0,0,0,0,0,1,1,0,0,0,0,0,0
401403388,Lipscomb Bisons,K. Coleman,4592274,,False,2.0,0,1,0,0,0,1,0,0,0,0,0,0,0,0,0,0,0
401403388,Lipscomb Bisons,T. Murr,4700835,,False,10.0,0,0,0,0,0,0,0,0,0,2,2,1,0,0,0,0,0
401403388,Lipscomb Bisons,T. Shulman,4592275,,False,4.0,0,0,0,0,0,0,0,0,0,1,1,0,0,0,0,0,0
401403388,Lipscomb Bisons,KJ Johnson,4592273,,False,18.0,2,7,2,6,0,1,2,4,0,2,2,0,0,0,0,0,6
401403388,Lipscomb Bisons,TEAM,TOTAL,TOTAL,False,,19,58,16,38,3,20,6,11,5,32,37,3,5,0,5,13,47
401403388,Liberty Flames,K. Rode,4592272,,True,35.0,1,10,1,5,0,5,4,4,0,8,8,6,0,0,2,3,6
401403388,Liberty Flames,S. Robinson,4592271,,True,24.0,1,4,1,2,0,2,4,4,1,7,8,0,0,0,2,1,6
401403388,Liberty Flames,K. McDowell,4278884,,True,37.0,3,8,1,1,2,7,2,2,0,4,4,0,0,0,1,0,10
401403388,Liberty Flames,J. Venzant,4897572,,True,14.0,0,1,0,0,0,1,0,0,0,4,4,0,0,1,0,3,0
401403388,Liberty Flames,D. McGhee,4396745,,True,40.0,10,25,6,10,4,15,2,3,2,2,4,2,0,1,2,0,26
401403388,Liberty Flames,B. Preston,4396747,,False,21.0,2,7,2,7,0,0,0,0,4,5,9,0,1,0,1,2,4
401403388,Liberty Flames,B. Peebles,4897570,,False,5.0,0,0,0,0,0,0,0,0,0,0,0,0,0,0,0,0,0
401403388,Liberty Flames,I. Warfield,4700843,,False,24.0,0,2,0,0,0,2,0,0,0,4,4,0,0,0,0,1,0
401403388,Liberty Flames,TEAM,TOTAL,TOTAL,False,,17,57,11,25,6,32,12,13,9,36,45,8,1,2,8,10,52
401403387,Stetson Hatters,M. Diawara,4432875,,True,26.0,4,8,4,8,0,0,2,2,0,5,5,1,3,1,1,3,10
401403387,Stetson Hatters,A. Tumblin,4897621,,True,23.0,4,5,4,4,0,1,0,0,1,4,5,0,1,1,3,1,8
401403387,Stetson Hatters,S. Swenson,4700860,,True,36.0,6,14,5,11,1,3,0,0,0,1,1,10,2,0,2,0,13
401403387,Stetson Hatters,C. Johnston,4612709,,True,37.0,3,13,2,7,1,6,5,7,0,1,1,2,1,0,4,2,12
401403387,Stetson Hatters,C. Jones,4278470,,True,34.0,5,9,2,6,3,3,0,2,2,5,7,1,1,0,2,1,13
401403387,Stetson Hatters,A. Crawford,4897620,,False,14.0,2,2,2,2,0,0,1,1,0,1,1,0,0,0,0,0,5
401403387,Stetson Hatters,A. Gateretse,4897618,,False,0.0,0,0,0,0,0,0,0,0,0,0,0,0,0,0,0,0,0
401403387,Stetson Hatters,T. Cook,4897617,,False,0.0,0,0,0,0,0,0,0,0,0,0,0,0,0,0,0,0,0
401403387,Stetson Hatters,G. Valdez,4700857,,False,0.0,0,0,0,0,0,0,0,0,0,0,0,0,0,0,0,0,0
401403387,Stetson Hatters,W. Panzo,4592296,,False,30.0,4,5,0,0,4,5,0,0,0,1,1,1,1,1,0,3,12
401403387,Stetson Hatters,TEAM,TOTAL,TOTAL,False,,28,56,19,38,9,18,8,12,6,22,28,15,9,3,12,10,73
401403387,Central Arkansas Bears,J. Chatham,4067640,,True,30.0,2,8,2,7,0,1,2,2,2,7,9,0,0,1,1,1,6
401403387,Central Arkansas Bears,E. Kayouloud,4397987,,True,33.0,8,12,8,11,0,1,1,1,8,3,11,2,1,2,2,2,17
401403387,Central Arkansas Bears,D. Hall,4278050,,True,32.0,6,13,5,8,1,5,0,0,1,3,4,1,2,1,3,3,13
401403387,Central Arkansas Bears,C. Hunter,4897018,,True,37.0,2,13,2,8,0,5,4,4,4,1,5,7,1,0,2,3,8
401403387,Central Arkansas Bears,C. Cooper,4431932,,True,31.0,7,13,2,3,5,10,2,3,0,3,3,2,2,0,1,2,21
401403387,Central Arkansas Bears,J. Baker,4397988,,False,8.0,2,6,1,2,1,4,0,0,1,0,1,0,0,0,0,0,5
401403387,Central Arkansas Bears,I. Klintman,4897015,,False,20.0,0,2,0,0,0,2,0,0,0,3,3,1,0,1,2,0,0
401403387,Central Arkansas Bears,M. Olowokere,4596536,,False,9.0,2,4,2,4,0,0,0,0,1,1,2,1,0,0,0,1,4
401403387,Central Arkansas Bears,TEAM,TOTAL,TOTAL,False,,29,71,22,43,7,28,9,10,20,24,44,14,6,5,11,12,74
401403386,Kennesaw State Owls,D. Robinson,4433069,,True,23.0,7,8,6,7,1,1,3,5,0,4,4,0,0,0,2,1,18
401403386,Kennesaw State Owls,C. Youngblood,4706557,,True,34.0,3,8,2,7,1,1,2,2,1,4,5,1,0,0,2,2,9
401403386,Kennesaw State Owls,T. Burden,4592262,,True,31.0,5,10,4,8,1,2,4,6,0,4,4,8,4,1,1,2,15
401403386,Kennesaw State Owls,B. Stroud,4433177,,True,26.0,3,6,2,4,1,2,0,2,1,6,7,4,1,0,1,4,7
401403386,Kennesaw State Owls,S. Rodgers,4397715,,True,29.0,7,11,1,2,6,9,2,2,0,2,2,4,1,1,1,0,22
401403386,Kennesaw State Owls,A. Peterson,4700839,,False,17.0,1,2,1,2,0,0,0,0,3,4,7,0,0,0,0,2,2
401403386,Kennesaw State Owls,I. Reddish,4897567,,False,14.0,1,5,1,3,0,2,1,2,1,3,4,1,0,0,1,0,3
401403386,Kennesaw State Owls,K. Jennings,4700841,,False,14.0,1,3,1,1,0,2,4,4,0,0,0,0,0,0,1,1,6
401403386,Kennesaw State Owls,J. Moultrie,4278365,,False,12.0,0,2,0,0,0,2,0,0,0,1,1,1,0,0,1,0,0
401403386,Kennesaw State Owls,TEAM,TOTAL,TOTAL,False,,28,55,18,34,10,21,16,23,6,30,36,19,6,2,11,12,82
401403386,Eastern Kentucky Colonels,D. Blanton,4703234,,True,31.0,8,19,5,15,3,4,4,5,2,6,8,1,0,1,1,3,23
401403386,Eastern Kentucky Colonels,M. Moreno,4431810,,True,31.0,3,10,1,4,2,6,1,2,4,4,8,2,2,2,1,3,9
401403386,Eastern Kentucky Colonels,C. Lewis,4593474,,True,34.0,2,8,1,4,1,4,1,2,1,3,4,2,0,0,2,3,6
401403386,Eastern Kentucky Colonels,R. Cruickshank,4593473,,True,25.0,3,7,0,1,3,6,0,0,0,1,1,1,0,0,1,1,9
401403386,Eastern Kentucky Colonels,C. Robb,4397469,,True,38.0,1,7,1,3,0,4,0,0,2,3,5,5,1,0,3,3,2
401403386,Eastern Kentucky Colonels,M. Wardy,4896991,,False,11.0,1,2,1,2,0,0,0,1,1,1,2,1,0,1,0,3,2
401403386,Eastern Kentucky Colonels,I. Bennett,4397538,,False,3.0,0,0,0,0,0,0,0,0,0,1,1,0,0,0,0,0,0
401403386,Eastern Kentucky Colonels,D. Jackson,4896993,,False,1.0,0,0,0,0,0,0,0,0,0,0,0,0,0,0,0,0,0
401403386,Eastern Kentucky Colonels,J. Brown,4398318,,False,26.0,8,14,6,10,2,4,4,4,1,2,3,2,1,0,2,4,22
401403386,Eastern Kentucky Colonels,TEAM,TOTAL,TOTAL,False,,26,67,15,39,11,28,10,14,13,22,35,14,4,4,10,20,73
401403385,North Alabama Lions,D. Forrest,4897608,,True,25.0,3,3,3,3,0,0,2,3,2,3,5,0,2,0,1,4,8
401403385,North Alabama Lions,I. Chatman,4397339,,True,24.0,1,4,0,3,1,1,0,0,2,5,7,0,0,1,0,0,3
401403385,North Alabama Lions,D. Ortiz,4897604,,True,40.0,12,27,7,15,5,12,0,0,1,3,4,1,1,0,1,0,29
401403385,North Alabama Lions,W. Soucie,4613134,,True,28.0,2,5,2,4,0,1,2,4,2,0,2,2,0,0,1,4,6
401403385,North Alabama Lions,C.J. Brim,4592284,,True,30.0,4,10,3,6,1,4,1,2,0,3,3,2,0,0,3,1,10
401403385,North Alabama Lions,P. Momar Cisse,4897609,,False,2.0,1,1,1,1,0,0,0,0,0,0,0,0,0,0,0,1,2
401403385,North Alabama Lions,D. Agbaosi,4897606,,False,15.0,3,6,3,6,0,0,1,1,4,2,6,0,0,0,0,2,7
401403385,North Alabama Lions,D. Howell,4709454,,False,2.0,0,2,0,0,0,2,0,0,0,0,0,0,0,0,0,0,0
401403385,North Alabama Lions,O. Figueroa,4897605,,False,4.0,0,1,0,1,0,0,0,0,0,0,0,0,0,0,0,0,0
401403385,North Alabama Lions,D. Brown,4700848,,False,29.0,2,6,1,3,1,3,2,2,0,2,2,0,2,0,1,3,7
401403385,North Alabama Lions,A. Matic,4396766,,False,1.0,0,1,0,0,0,1,0,0,0,1,1,0,0,0,0,2,0
401403385,North Alabama Lions,TEAM,TOTAL,TOTAL,False,,28,66,20,42,8,24,8,12,11,22,33,5,5,1,8,17,72
401403385,Florida Gulf Coast Eagles,K. Samuel,4277915,,True,26.0,8,8,8,8,0,0,1,4,3,7,10,2,0,1,0,1,17
401403385,Florida Gulf Coast Eagles,C. Largie,4592249,,True,26.0,3,8,3,6,0,2,2,2,0,5,5,2,1,0,2,2,8
401403385,Florida Gulf Coast Eagles,A. Richie,4397858,,True,32.0,2,7,1,2,1,5,0,0,0,2,2,0,0,1,0,2,5
401403385,Florida Gulf Coast Eagles,C. Catto,4396688,,True,29.0,3,5,2,2,1,3,0,0,0,0,0,4,0,0,2,0,7
401403385,Florida Gulf Coast Eagles,T. Dunn-Martin,4067358,,True,32.0,7,16,3,6,4,10,8,8,1,1,2,3,2,0,4,1,26
401403385,Florida Gulf Coast Eagles,Z. Anderson,4700870,,False,22.0,4,5,3,3,1,2,0,2,0,4,4,1,0,0,0,1,9
401403385,Florida Gulf Coast Eagles,D. Rivers,4592248,,False,17.0,0,0,0,0,0,0,0,2,1,3,4,1,2,2,0,1,0
401403385,Florida Gulf Coast Eagles,A. Weir,4741885,,False,13.0,4,4,4,4,0,0,1,3,1,3,4,1,0,1,2,2,9
401403385,Florida Gulf Coast Eagles,M. Halvorsen,4280115,,False,3.0,0,0,0,0,0,0,0,0,0,0,0,0,0,0,0,0,0
401403385,Florida Gulf Coast Eagles,TEAM,TOTAL,TOTAL,False,,31,53,24,31,7,22,12,21,6,28,34,14,5,5,10,10,81
401403384,North Florida Ospreys,J. Parker,4700856,,True,23.0,7,9,6,8,1,1,2,3,1,3,4,0,1,2,1,4,17
401403384,North Florida Ospreys,D. James,4396774,,True,18.0,0,1,0,1,0,0,0,0,0,5,5,0,0,0,1,2,0
401403384,North Florida Ospreys,J. Hicklen,4897614,,True,34.0,3,8,0,1,3,7,0,0,0,3,3,4,2,0,3,4,9
401403384,North Florida Ospreys,C. Lanier,4700852,,True,27.0,1,3,1,2,0,1,0,0,1,3,4,1,0,1,0,3,2
401403384,North Florida Ospreys,E. Adedoyin,4594333,,True,28.0,2,8,0,3,2,5,0,0,0,1,1,4,0,0,3,0,6
401403384,North Florida Ospreys,J. Aybar,4700854,,False,16.0,1,2,1,2,0,0,7,8,2,1,3,1,1,2,1,2,9
401403384,North Florida Ospreys,C. Hendricksen,4396776,,False,23.0,5,13,3,5,2,8,0,0,1,6,7,1,1,1,1,2,12
401403384,North Florida Ospreys,J. Berenbaum,4700855,,False,3.0,0,1,0,0,0,1,0,0,1,0,1,0,0,0,0,1,0
401403384,North Florida Ospreys,J. Placer,4396592,,False,28.0,3,9,2,5,1,4,3,3,1,2,3,1,0,1,2,3,10
401403384,North Florida Ospreys,TEAM,TOTAL,TOTAL,False,,22,54,13,27,9,27,12,14,7,24,31,12,5,7,12,21,65
401403384,Lipscomb Bisons,P. Hazen,4279172,,True,32.0,5,10,4,9,1,1,6,8,4,3,7,3,3,0,0,1,17
401403384,Lipscomb Bisons,A. Asadullah,4278445,,True,29.0,12,20,12,19,0,1,4,7,3,9,12,6,1,1,3,2,28
401403384,Lipscomb Bisons,T. Benham,4897579,,True,34.0,3,9,2,5,1,4,0,0,1,2,3,1,1,1,0,2,7
401403384,Lipscomb Bisons,W. Pruitt,4590356,,True,37.0,4,10,4,8,0,2,5,6,1,5,6,1,1,0,0,0,13
401403384,Lipscomb Bisons,G. Jones,4278444,,True,34.0,0,3,0,1,0,2,2,2,0,3,3,2,0,2,0,1,2
401403384,Lipscomb Bisons,J. Ognacevic,4703983,,False,4.0,1,1,1,1,0,0,0,2,0,0,0,0,0,0,0,0,2
401403384,Lipscomb Bisons,K. Coleman,4592274,,False,9.0,1,2,0,0,1,2,0,0,0,2,2,0,1,0,0,4,3
401403384,Lipscomb Bisons,T. Murr,4700835,,False,3.0,0,2,0,1,0,1,2,2,0,1,1,1,0,0,0,0,2
401403384,Lipscomb Bisons,T. Shulman,4592275,,False,7.0,0,0,0,0,0,0,0,0,0,1,1,0,0,0,0,0,0
401403384,Lipscomb Bisons,KJ Johnson,4592273,,False,11.0,0,2,0,0,0,2,0,0,0,0,0,1,0,0,3,0,0
401403384,Lipscomb Bisons,TEAM,TOTAL,TOTAL,False,,26,59,23,44,3,15,19,27,12,26,38,15,7,4,7,10,74
401403383,Richmond Spiders,T. Burton,4431914,,True,28.0,6,14,5,11,1,3,3,4,1,11,12,0,0,0,4,4,16
401403383,Richmond Spiders,N. Cayo,4278380,,True,33.0,3,6,3,6,0,0,3,4,0,7,7,3,0,0,1,3,9
401403383,Richmond Spiders,G. Golden,4066836,,True,30.0,2,4,2,4,0,0,2,2,0,2,2,2,1,0,2,2,6
401403383,Richmond Spiders,A. Gustavson,4397193,,True,28.0,0,2,0,1,0,1,0,0,1,0,1,0,1,0,1,4,0
401403383,Richmond Spiders,J. Gilyard,4278378,,True,40.0,9,17,5,9,4,8,4,5,1,3,4,2,2,0,1,1,26
401403383,Richmond Spiders,M. Grace,4397192,,False,16.0,1,5,1,2,0,3,1,1,0,1,1,0,0,0,1,0,3
401403383,Richmond Spiders,I. Wilson,4700973,,False,6.0,0,0,0,0,0,0,0,0,0,0,0,0,0,0,0,1,0
401403383,Richmond Spiders,C. Crabtree,4396658,,False,6.0,0,0,0,0,0,0,2,2,0,0,0,0,0,0,0,1,2
401403383,Richmond Spiders,N. Sherod,4066832,,False,13.0,1,3,1,2,0,1,0,0,0,3,3,1,1,0,0,1,2
401403383,Richmond Spiders,TEAM,TOTAL,TOTAL,False,,22,51,17,35,5,16,15,18,4,29,33,8,5,0,11,17,64
401403383,Davidson Wildcats,S. Mennenga,4700862,,True,27.0,5,8,1,4,4,4,4,4,0,5,5,1,1,0,0,3,18
401403383,Davidson Wildcats,L. Brajkovic,4396787,,True,36.0,5,9,5,7,0,2,3,4,3,8,11,1,0,0,0,2,13
401403383,Davidson Wildcats,H. Lee,4592308,,True,34.0,1,9,0,2,1,7,2,2,0,4,4,2,0,2,4,1,5
401403383,Davidson Wildcats,F. Loyer,4397208,,True,21.0,1,7,0,3,1,4,4,4,0,0,0,4,1,0,2,3,7
401403383,Davidson Wildcats,M. Jones,4396784,,True,38.0,6,14,3,5,3,9,2,2,0,5,5,1,1,0,0,4,17
401403383,Davidson Wildcats,N. Boachie-Yiadom,4396786,,False,17.0,0,1,0,1,0,0,0,0,1,0,1,1,1,0,0,0,0
401403383,Davidson Wildcats,D. Watson,4897098,,False,2.0,0,0,0,0,0,0,0,0,0,0,0,0,0,0,0,0,0
401403383,Davidson Wildcats,G. Huffman,4432522,,False,25.0,1,3,1,2,0,1,0,1,0,3,3,2,0,0,1,3,2
401403383,Davidson Wildcats,TEAM,TOTAL,TOTAL,False,,19,51,10,24,9,27,15,17,4,26,30,12,4,2,9,16,62
401403382,Richmond Spiders,T. Burton,4431914,,True,34.0,5,10,5,8,0,2,6,6,1,7,8,0,0,1,1,1,16
401403382,Richmond Spiders,N. Cayo,4278380,,True,22.0,1,7,1,7,0,0,0,0,1,1,2,1,0,0,0,3,2
401403382,Richmond Spiders,G. Golden,4066836,,True,30.0,8,17,8,16,0,1,2,2,4,5,9,4,0,0,2,1,18
401403382,Richmond Spiders,A. Gustavson,4397193,,True,33.0,0,2,0,1,0,1,2,4,1,3,4,3,2,1,1,4,2
401403382,Richmond Spiders,J. Gilyard,4278378,,True,40.0,3,13,2,6,1,7,4,6,0,2,2,5,4,0,1,3,11
401403382,Richmond Spiders,M. Grace,4397192,,False,22.0,5,6,3,3,2,3,0,0,0,4,4,0,1,0,0,0,12
401403382,Richmond Spiders,I. Wilson,4700973,,False,5.0,1,1,0,0,1,1,0,0,0,0,0,0,0,0,0,0,3
401403382,Richmond Spiders,C. Crabtree,4396658,,False,3.0,0,0,0,0,0,0,0,0,0,0,0,0,0,0,0,0,0
401403382,Richmond Spiders,N. Sherod,4066832,,False,11.0,2,3,2,2,0,1,0,0,0,1,1,0,0,0,0,1,4
401403382,Richmond Spiders,TEAM,TOTAL,TOTAL,False,,25,59,21,43,4,16,14,18,8,24,32,13,7,2,5,13,68
401403382,Dayton Flyers,R.J. Blakney,4700864,,True,27.0,4,9,4,5,0,4,0,0,1,3,4,1,0,0,1,4,8
401403382,Dayton Flyers,T. Camara,4431736,,True,34.0,6,8,5,6,1,2,4,8,2,12,14,2,1,2,3,3,17
401403382,Dayton Flyers,D. Holmes II,4433607,,True,36.0,6,11,6,10,0,1,3,3,1,4,5,1,0,3,0,1,15
401403382,Dayton Flyers,M. Smith,4683861,,True,18.0,3,6,2,5,1,1,0,0,0,1,1,2,2,0,0,1,7
401403382,Dayton Flyers,K. Elvis,4683135,,True,35.0,2,10,1,5,1,5,0,0,0,2,2,5,0,0,2,2,5
401403382,Dayton Flyers,M. Amzil,4711607,,False,15.0,0,2,0,0,0,2,2,2,2,2,4,1,0,0,1,1,2
401403382,Dayton Flyers,Z. Nwokeji,4618121,,False,2.0,0,0,0,0,0,0,0,0,0,1,1,0,0,0,1,0,0
401403382,Dayton Flyers,K. Brea,4591259,,False,33.0,4,8,2,3,2,5,0,0,0,1,1,1,0,1,1,2,10
401403382,Dayton Flyers,TEAM,TOTAL,TOTAL,False,,25,54,20,34,5,20,9,13,7,28,35,13,3,6,12,14,64
401403381,Saint Louis Billikens,F. Okoro,4397105,,True,29.0,0,5,0,5,0,0,3,4,2,3,5,0,1,2,0,4,3
401403381,Saint Louis Billikens,J. Nesbitt,4714246,,True,22.0,1,2,0,1,1,1,0,0,0,1,1,2,0,1,1,1,3
401403381,Saint Louis Billikens,Y. Collins,4432957,,True,29.0,4,8,4,8,0,0,5,5,0,5,5,7,0,0,3,5,13
401403381,Saint Louis Billikens,G. Jimerson,4432008,,True,38.0,3,12,0,2,3,10,0,0,0,1,1,1,1,0,2,2,9
401403381,Saint Louis Billikens,F. Thatch Jr.,4397199,,True,23.0,3,9,3,6,0,3,2,2,1,2,3,2,2,1,2,4,8
401403381,Saint Louis Billikens,T. Hargrove Jr.,4592484,,False,27.0,5,10,1,5,4,5,0,0,0,6,6,1,0,0,0,0,14
401403381,Saint Louis Billikens,M. Linssen,4279174,,False,11.0,4,5,4,5,0,0,0,3,0,2,2,0,0,1,1,1,8
401403381,Saint Louis Billikens,D. Jones,4278267,,False,21.0,5,8,4,4,1,4,0,0,0,2,2,2,1,0,0,4,11
401403381,Saint Louis Billikens,TEAM,TOTAL,TOTAL,False,,25,59,16,36,9,23,10,14,5,24,29,15,5,5,9,21,69
401403381,Davidson Wildcats,S. Mennenga,4700862,,True,15.0,2,2,2,2,0,0,0,0,0,4,4,2,0,0,1,3,4
401403381,Davidson Wildcats,L. Brajkovic,4396787,,True,34.0,6,16,5,11,1,5,1,2,1,9,10,5,0,0,2,1,14
401403381,Davidson Wildcats,H. Lee,4592308,,True,32.0,5,9,3,3,2,6,4,5,0,6,6,2,0,0,1,1,16
401403381,Davidson Wildcats,F. Loyer,4397208,,True,23.0,6,10,3,5,3,5,6,6,1,4,5,0,1,0,1,0,21
401403381,Davidson Wildcats,M. Jones,4396784,,True,37.0,5,7,3,3,2,4,1,1,0,3,3,0,0,2,1,2,13
401403381,Davidson Wildcats,D. Kristensen,4432020,,False,1.0,0,1,0,0,0,1,0,0,0,1,1,1,0,0,0,0,0
401403381,Davidson Wildcats,N. Boachie-Yiadom,4396786,,False,22.0,0,3,0,3,0,0,0,0,2,1,3,4,0,0,1,1,0
401403381,Davidson Wildcats,S. Thrastarson,4897100,,False,1.0,0,0,0,0,0,0,0,0,0,1,1,0,0,0,0,0,0
401403381,Davidson Wildcats,D. Watson,4897098,,False,11.0,1,5,1,5,0,0,2,2,0,2,2,0,0,0,1,0,4
401403381,Davidson Wildcats,E. Lanier,4567082,,False,2.0,0,0,0,0,0,0,0,0,0,0,0,0,0,0,0,0,0
401403381,Davidson Wildcats,G. Huffman,4432522,,False,22.0,4,4,2,2,2,2,2,2,0,1,1,2,2,0,0,4,12
401403381,Davidson Wildcats,TEAM,TOTAL,TOTAL,False,,29,57,19,34,10,23,16,18,5,32,37,16,3,2,8,12,84
401403380,Massachusetts Minutemen,G. Jones,4279211,,True,29.0,2,6,1,3,1,3,2,2,2,2,4,0,1,0,2,3,7
401403380,Massachusetts Minutemen,T. Buttrick,4277981,,True,18.0,3,6,2,3,1,3,0,0,1,5,6,0,1,0,1,5,7
401403380,Massachusetts Minutemen,T.J. Weeks,4433108,,True,27.0,3,8,2,5,1,3,3,4,2,4,6,1,0,0,0,1,10
401403380,Massachusetts Minutemen,N. Fernandes,4431791,,True,38.0,10,20,9,15,1,5,5,6,0,4,4,4,2,0,2,3,26
401403380,Massachusetts Minutemen,R. Kelly,4279741,,True,33.0,2,8,2,6,0,2,1,2,0,1,1,1,1,1,0,2,5
401403380,Massachusetts Minutemen,M. Steadman,4397393,,False,12.0,2,3,2,3,0,0,0,0,1,3,4,0,0,0,0,2,4
401403380,Massachusetts Minutemen,J. Garcia,4701125,,False,26.0,5,7,4,5,1,2,2,4,4,1,5,2,0,0,0,3,13
401403380,Massachusetts Minutemen,C.J. Kelly,4398208,,False,17.0,0,2,0,0,0,2,0,0,0,0,0,1,0,0,0,2,0
401403380,Massachusetts Minutemen,TEAM,TOTAL,TOTAL,False,,27,60,22,40,5,20,13,18,11,22,33,9,5,1,6,21,72
401403380,Dayton Flyers,R.J. Blakney,4700864,,True,33.0,3,5,1,1,2,4,2,3,1,1,2,2,0,0,1,3,10
401403380,Dayton Flyers,T. Camara,4431736,,True,26.0,4,8,3,6,1,2,3,4,3,4,7,1,0,0,1,3,12
401403380,Dayton Flyers,D. Holmes II,4433607,,True,37.0,12,15,12,15,0,0,4,7,1,4,5,1,0,3,2,2,28
401403380,Dayton Flyers,M. Smith,4683861,,True,35.0,3,7,2,4,1,3,8,10,0,5,5,6,1,0,1,1,15
401403380,Dayton Flyers,K. Elvis,4683135,,True,26.0,2,7,2,4,0,3,0,0,0,1,1,2,0,0,3,2,4
401403380,Dayton Flyers,M. Sissoko,4431824,,False,2.0,0,0,0,0,0,0,1,2,0,1,1,0,0,0,0,0,1
401403380,Dayton Flyers,M. Amzil,4711607,,False,15.0,0,2,0,0,0,2,0,0,1,4,5,2,0,0,1,3,0
401403380,Dayton Flyers,K. Brea,4591259,,False,26.0,2,6,2,4,0,2,1,2,1,2,3,0,1,0,0,2,5
401403380,Dayton Flyers,TEAM,TOTAL,TOTAL,False,,26,50,22,34,4,16,19,28,8,24,32,14,2,3,9,17,75
401403379,VCU Rams,H. Ward,4592495,,True,26.0,2,2,2,2,0,0,2,3,1,3,4,1,0,3,0,1,6
401403379,VCU Rams,V. Williams Jr.,4397227,,True,37.0,7,14,3,6,4,8,0,0,3,6,9,2,2,1,4,5,18
401403379,VCU Rams,J. Nunn,4896614,,True,29.0,2,4,1,1,1,3,0,0,0,1,1,1,1,0,2,1,5
401403379,VCU Rams,A. Baldwin Jr.,4433182,,True,39.0,5,13,3,7,2,6,0,0,1,3,4,7,0,1,5,3,12
401403379,VCU Rams,K. Curry,4397228,,True,30.0,5,8,5,7,0,1,4,6,0,5,5,0,2,1,4,5,14
401403379,VCU Rams,M. Brown-Jones,4433224,,False,9.0,0,2,0,1,0,1,0,0,0,0,0,0,0,0,0,3,0
401403379,VCU Rams,J. DeLoach,4432483,,False,6.0,0,0,0,0,0,0,0,0,0,1,1,0,0,1,0,2,0
401403379,VCU Rams,L. Stockard III,4277897,,False,8.0,2,3,2,3,0,0,0,0,0,0,0,0,0,0,0,2,4
401403379,VCU Rams,N. Kern,4684145,,False,5.0,1,2,1,2,0,0,0,0,0,2,2,0,0,0,1,2,2
401403379,VCU Rams,M. Tsohonis,4592438,,False,11.0,1,3,0,0,1,3,0,0,0,0,0,0,1,0,0,1,3
401403379,VCU Rams,J. Banks,4432402,,False,0.0,0,0,0,0,0,0,0,0,0,0,0,0,0,0,0,0,0
401403379,VCU Rams,TEAM,TOTAL,TOTAL,False,,25,51,17,29,8,22,6,9,6,22,28,11,6,7,16,25,64
401403379,Richmond Spiders,T. Burton,4431914,,True,39.0,2,7,1,5,1,2,9,11,0,8,8,2,1,0,1,4,14
401403379,Richmond Spiders,N. Cayo,4278380,,True,33.0,3,7,3,7,0,0,5,6,2,1,3,1,1,1,2,3,11
401403379,Richmond Spiders,G. Golden,4066836,,True,25.0,1,6,1,5,0,1,2,3,1,4,5,1,0,0,3,1,4
401403379,Richmond Spiders,A. Gustavson,4397193,,True,32.0,3,4,2,2,1,2,3,5,0,3,3,1,2,0,1,3,10
401403379,Richmond Spiders,J. Gilyard,4278378,,True,40.0,9,17,2,5,7,12,7,7,0,0,0,3,4,0,2,1,32
401403379,Richmond Spiders,M. Grace,4397192,,False,17.0,2,5,2,3,0,2,0,0,2,3,5,2,2,0,2,3,4
401403379,Richmond Spiders,I. Wilson,4700973,,False,7.0,0,0,0,0,0,0,0,0,0,0,0,0,0,0,0,3,0
401403379,Richmond Spiders,C. Crabtree,4396658,,False,1.0,0,0,0,0,0,0,0,0,0,0,0,0,0,0,0,0,0
401403379,Richmond Spiders,N. Sherod,4066832,,False,6.0,0,1,0,1,0,0,0,0,0,2,2,0,0,0,0,0,0
401403379,Richmond Spiders,TEAM,TOTAL,TOTAL,False,,20,47,11,28,9,19,26,32,6,22,28,10,10,1,11,18,75
401403378,St. Bonaventure Bonnies,O. Osunniyi,4397224,,True,32.0,2,2,2,2,0,0,2,5,2,7,9,4,0,3,4,2,6
401403378,St. Bonaventure Bonnies,J. Adaway,4279431,,True,40.0,7,17,4,11,3,6,1,1,1,4,5,1,2,1,1,1,18
401403378,St. Bonaventure Bonnies,J. Holmes,4701016,,True,38.0,2,13,2,9,0,4,0,0,1,1,2,3,2,1,0,1,4
401403378,St. Bonaventure Bonnies,D. Welch,4397221,,True,40.0,6,11,4,5,2,6,0,0,3,4,7,1,1,0,1,2,14
401403378,St. Bonaventure Bonnies,K. Lofton,4397220,,True,40.0,5,15,5,11,0,4,0,2,3,0,3,4,2,1,4,4,10
401403378,St. Bonaventure Bonnies,A. Coulibaly,4432889,,False,8.0,2,5,2,5,0,0,0,0,1,0,1,1,2,1,0,1,4
401403378,St. Bonaventure Bonnies,Q. Adams,4585591,,False,2.0,0,0,0,0,0,0,0,0,0,0,0,0,0,0,0,0,0
401403378,St. Bonaventure Bonnies,TEAM,TOTAL,TOTAL,False,,24,63,19,43,5,20,3,8,13,18,31,14,9,7,10,11,56
401403378,Saint Louis Billikens,F. Okoro,4397105,,True,33.0,5,7,5,7,0,0,4,4,5,7,12,0,2,0,3,3,14
401403378,Saint Louis Billikens,J. Nesbitt,4714246,,True,34.0,0,8,0,6,0,2,0,0,3,2,5,0,1,0,1,4,0
401403378,Saint Louis Billikens,Y. Collins,4432957,,True,40.0,4,13,4,12,0,1,3,4,0,7,7,9,0,1,6,3,11
401403378,Saint Louis Billikens,G. Jimerson,4432008,,True,40.0,7,14,1,5,6,9,0,0,0,2,2,1,0,0,2,1,20
401403378,Saint Louis Billikens,F. Thatch Jr.,4397199,,True,27.0,4,9,4,9,0,0,0,0,1,2,3,1,0,0,2,3,8
401403378,Saint Louis Billikens,T. Hargrove Jr.,4592484,,False,13.0,1,2,1,1,0,1,0,0,0,2,2,0,0,0,0,0,2
401403378,Saint Louis Billikens,M. Linssen,4279174,,False,6.0,1,2,1,2,0,0,0,0,0,2,2,0,0,0,0,1,2
401403378,Saint Louis Billikens,D. Jones,4278267,,False,7.0,0,1,0,0,0,1,0,0,1,0,1,0,0,0,1,1,0
401403378,Saint Louis Billikens,TEAM,TOTAL,TOTAL,False,,22,56,16,42,6,14,7,8,14,26,40,11,3,1,17,16,57
401403377,Fordham Rams,A. Tsimbila,4702329,,True,8.0,0,0,0,0,0,0,0,0,0,4,4,0,0,0,1,5,0
401403377,Fordham Rams,C. Ohams,4066856,,True,27.0,4,6,4,6,0,0,6,7,0,9,9,1,0,0,3,1,14
401403377,Fordham Rams,A. Charlton,4897085,,True,30.0,1,6,0,3,1,3,0,1,1,5,6,3,2,0,3,5,3
401403377,Fordham Rams,J. Navarro,4592316,,True,26.0,1,7,0,2,1,5,0,0,1,2,3,0,0,0,1,0,3
401403377,Fordham Rams,K. Rose,4592315,,True,26.0,3,10,2,4,1,6,2,4,2,0,2,1,0,0,1,2,9
401403377,Fordham Rams,P. Kelly,4432014,,False,16.0,1,7,1,2,0,5,0,0,1,0,1,0,0,0,0,1,2
401403377,Fordham Rams,R. Novitskyi,4897084,,False,32.0,7,12,6,10,1,2,3,4,3,2,5,1,1,3,1,2,18
401403377,Fordham Rams,K. Cunningham,4705891,,False,10.0,1,2,1,1,0,1,0,0,0,1,1,0,0,0,1,1,2
401403377,Fordham Rams,A. Evans,4700881,,False,1.0,0,0,0,0,0,0,0,0,1,0,1,0,0,0,0,0,0
401403377,Fordham Rams,Z. Riley,4914388,,False,24.0,1,7,1,1,0,6,3,4,1,3,4,1,0,0,0,4,5
401403377,Fordham Rams,TEAM,TOTAL,TOTAL,False,,19,57,15,29,4,28,14,20,11,26,37,7,3,3,12,21,56
401403377,Davidson Wildcats,S. Mennenga,4700862,,True,28.0,4,11,4,10,0,1,7,8,2,7,9,5,0,1,0,1,15
401403377,Davidson Wildcats,L. Brajkovic,4396787,,True,21.0,2,3,1,2,1,1,1,2,0,1,1,2,0,1,1,2,6
401403377,Davidson Wildcats,H. Lee,4592308,,True,30.0,4,7,3,6,1,1,2,3,1,7,8,0,0,0,1,3,11
401403377,Davidson Wildcats,F. Loyer,4397208,,True,22.0,3,7,2,3,1,4,1,2,0,2,2,2,0,0,0,2,8
401403377,Davidson Wildcats,M. Jones,4396784,,True,33.0,2,7,2,4,0,3,4,4,0,5,5,2,0,1,0,3,8
401403377,Davidson Wildcats,C. Ford,4897099,,False,1.0,1,1,1,1,0,0,0,0,0,0,0,0,0,0,0,0,2
401403377,Davidson Wildcats,D. Kristensen,4432020,,False,2.0,0,0,0,0,0,0,0,0,0,1,1,0,0,0,0,1,0
401403377,Davidson Wildcats,N. Boachie-Yiadom,4396786,,False,14.0,1,1,1,1,0,0,0,0,0,1,1,2,0,0,0,3,2
401403377,Davidson Wildcats,S. Thrastarson,4897100,,False,2.0,0,0,0,0,0,0,0,0,1,0,1,0,0,0,0,0,0
401403377,Davidson Wildcats,D. Watson,4897098,,False,15.0,6,12,6,11,0,1,1,2,1,1,2,1,0,0,3,1,13
401403377,Davidson Wildcats,E. Lanier,4567082,,False,2.0,0,1,0,0,0,1,0,0,0,0,0,0,0,0,0,1,0
401403377,Davidson Wildcats,G. Huffman,4432522,,False,29.0,3,4,0,0,3,4,0,0,0,5,5,2,1,0,3,2,9
401403377,Davidson Wildcats,TEAM,TOTAL,TOTAL,False,,26,54,20,38,6,16,16,21,6,31,37,16,1,3,8,19,74
401403376,Massachusetts Minutemen,G. Jones,4279211,,True,27.0,3,8,3,8,0,0,0,0,2,1,3,1,1,1,0,1,6
401403376,Massachusetts Minutemen,T. Buttrick,4277981,,True,34.0,5,9,2,4,3,5,0,0,4,12,16,1,1,2,3,0,13
401403376,Massachusetts Minutemen,T.J. Weeks,4433108,,True,17.0,4,8,0,1,4,7,3,3,2,2,4,0,0,0,1,5,15
401403376,Massachusetts Minutemen,N. Fernandes,4431791,,True,39.0,11,17,9,11,2,6,5,6,0,1,1,7,7,0,4,3,29
401403376,Massachusetts Minutemen,R. Kelly,4279741,,True,31.0,6,15,5,10,1,5,0,0,0,2,2,5,1,0,3,2,13
401403376,Massachusetts Minutemen,J. Garcia,4701125,,False,29.0,3,7,3,5,0,2,2,2,1,2,3,3,1,1,0,3,8
401403376,Massachusetts Minutemen,C.J. Kelly,4398208,,False,23.0,5,7,3,3,2,4,3,4,0,1,1,0,3,0,0,2,15
401403376,Massachusetts Minutemen,TEAM,TOTAL,TOTAL,False,,37,71,25,42,12,29,13,15,11,22,33,17,14,4,11,16,99
401403376,George Washington Revolutionaries,H. Dean,4593273,,True,16.0,1,2,1,2,0,0,2,2,1,3,4,2,0,0,0,2,4
401403376,George Washington Revolutionaries,R. Lindo Jr.,4397186,,True,27.0,4,4,2,2,2,2,0,0,2,9,11,0,2,1,3,5,10
401403376,George Washington Revolutionaries,B. Freeman,4613126,,True,37.0,4,8,3,6,1,2,9,11,0,2,2,7,1,1,6,1,18
401403376,George Washington Revolutionaries,J. Bamisile,4432537,,True,36.0,11,20,10,14,1,6,2,3,2,3,5,1,1,2,2,2,25
401403376,George Washington Revolutionaries,J. Bishop,4431770,,True,38.0,5,15,4,10,1,5,4,5,0,0,0,0,1,0,4,2,15
401403376,George Washington Revolutionaries,Q. Samuels,4592251,,False,15.0,2,3,1,2,1,1,1,2,0,3,3,1,0,0,1,1,6
401403376,George Washington Revolutionaries,A. Harris,4397216,,False,1.0,0,2,0,2,0,0,0,0,2,1,3,0,0,0,0,0,0
401403376,George Washington Revolutionaries,B. Adams,4396612,,False,30.0,4,5,2,3,2,2,0,0,1,3,4,2,1,0,2,0,10
401403376,George Washington Revolutionaries,TEAM,TOTAL,TOTAL,False,,31,59,23,41,8,18,18,23,10,25,35,13,6,4,18,13,88
401403375,Richmond Spiders,T. Burton,4431914,,True,38.0,2,8,1,5,1,3,7,8,1,10,11,2,1,0,2,3,12
401403375,Richmond Spiders,N. Cayo,4278380,,True,34.0,4,6,4,6,0,0,1,6,1,5,6,3,0,1,2,2,9
401403375,Richmond Spiders,G. Golden,4066836,,True,28.0,6,12,6,12,0,0,7,10,0,3,3,1,1,0,2,3,19
401403375,Richmond Spiders,A. Gustavson,4397193,,True,29.0,2,6,0,0,2,6,2,2,0,2,2,1,1,0,0,3,8
401403375,Richmond Spiders,J. Gilyard,4278378,,True,40.0,3,8,1,3,2,5,2,2,1,2,3,4,6,0,1,2,10
401403375,Richmond Spiders,M. Grace,4397192,,False,15.0,1,3,0,1,1,2,0,0,0,3,3,1,0,1,2,2,3
401403375,Richmond Spiders,C. Crabtree,4396658,,False,11.0,0,1,0,0,0,1,3,5,0,0,0,0,0,0,0,0,3
401403375,Richmond Spiders,N. Sherod,4066832,,False,5.0,0,3,0,0,0,3,0,0,0,1,1,0,0,0,0,0,0
401403375,Richmond Spiders,TEAM,TOTAL,TOTAL,False,,18,47,12,27,6,20,22,33,3,26,29,12,9,2,10,15,64
401403375,Rhode Island Rams,A. Walker,4278567,,True,20.0,2,4,2,3,0,1,0,0,1,2,3,0,0,0,2,3,4
401403375,Rhode Island Rams,I. Leggett,4606837,,True,25.0,0,6,0,3,0,3,3,5,1,1,2,1,1,0,1,2,3
401403375,Rhode Island Rams,M. Martin,4397470,,True,33.0,8,11,6,7,2,4,2,3,4,5,9,0,2,2,3,1,20
401403375,Rhode Island Rams,I. El-Amin,4279313,,True,23.0,1,5,1,2,0,3,0,0,1,3,4,0,0,0,0,4,2
401403375,Rhode Island Rams,J. Sheppard,4066445,,True,29.0,0,4,0,1,0,3,0,0,0,1,1,4,2,0,5,4,0
401403375,Rhode Island Rams,Makhel Mitchell,4431777,,False,17.0,4,8,4,8,0,0,1,3,2,4,6,1,0,0,0,4,9
401403375,Rhode Island Rams,Makhi Mitchell,4431708,,False,23.0,6,13,6,11,0,2,1,2,0,8,8,0,1,1,0,3,13
401403375,Rhode Island Rams,J. Carey,4395673,,False,19.0,4,6,4,5,0,1,0,0,1,5,6,1,2,0,2,3,8
401403375,Rhode Island Rams,S. Thomas,4897065,,False,11.0,0,3,0,3,0,0,0,2,1,0,1,0,0,0,1,0,0
401403375,Rhode Island Rams,TEAM,TOTAL,TOTAL,False,,25,60,23,43,2,17,7,15,13,32,45,7,8,3,18,24,59
401403374,Saint Louis Billikens,F. Okoro,4397105,,True,24.0,8,11,8,11,0,0,1,2,3,10,13,1,0,2,2,1,17
401403374,Saint Louis Billikens,J. Nesbitt,4714246,,True,25.0,0,1,0,0,0,1,2,5,1,5,6,3,2,0,1,5,2
401403374,Saint Louis Billikens,Y. Collins,4432957,,True,29.0,5,9,5,7,0,2,3,4,0,3,3,3,1,0,3,3,13
401403374,Saint Louis Billikens,G. Jimerson,4432008,,True,27.0,7,14,4,6,3,8,2,2,1,1,2,2,0,0,0,0,19
401403374,Saint Louis Billikens,F. Thatch Jr.,4397199,,True,29.0,4,11,3,9,1,2,1,2,4,7,11,4,1,0,1,1,10
401403374,Saint Louis Billikens,L. Traore,4897052,,False,2.0,0,0,0,0,0,0,0,0,1,1,2,0,1,0,0,0,0
401403374,Saint Louis Billikens,A. Lorentsson,4701121,,False,2.0,0,1,0,0,0,1,0,0,0,0,0,0,0,0,0,0,0
401403374,Saint Louis Billikens,T. Hargrove Jr.,4592484,,False,17.0,1,5,1,4,0,1,0,0,1,3,4,0,0,0,0,0,2
401403374,Saint Louis Billikens,M. Linssen,4279174,,False,14.0,1,4,1,4,0,0,0,0,1,3,4,1,0,0,1,3,2
401403374,Saint Louis Billikens,M. Strickland,4432494,,False,3.0,0,0,0,0,0,0,0,0,0,0,0,0,0,0,2,0,0
401403374,Saint Louis Billikens,R. Williams,4399106,,False,7.0,0,4,0,0,0,4,0,0,0,0,0,1,0,0,1,0,0
401403374,Saint Louis Billikens,D. Jones,4278267,,False,21.0,1,1,0,0,1,1,3,4,0,1,1,1,0,1,0,4,6
401403374,Saint Louis Billikens,TEAM,TOTAL,TOTAL,False,,27,61,22,41,5,20,12,19,13,35,48,16,5,3,11,17,71
401403374,La Salle Explorers,C. Moore,4277945,,True,25.0,1,10,1,9,0,1,1,1,0,2,2,0,0,2,1,2,3
401403374,La Salle Explorers,J. Clark,4397152,,True,32.0,1,9,1,4,0,5,2,2,1,8,9,3,0,0,0,3,4
401403374,La Salle Explorers,J. Brickus,4700970,,True,22.0,4,6,3,4,1,2,2,2,0,3,3,0,0,0,1,1,11
401403374,La Salle Explorers,A. Gill,4700969,,True,24.0,2,8,2,7,0,1,1,1,1,2,3,1,1,0,1,3,5
401403374,La Salle Explorers,C. Ray,4592448,,True,27.0,2,3,2,3,0,0,1,2,2,4,6,0,0,0,1,0,5
401403374,La Salle Explorers,M. McFarlane,4897068,,False,3.0,0,0,0,0,0,0,0,0,0,0,0,0,0,0,0,0,0
401403374,La Salle Explorers,M. Doucoure,4277988,,False,11.0,1,1,1,1,0,0,1,2,0,3,3,0,1,0,1,1,3
401403374,La Salle Explorers,D. Shepherd,4710357,,False,12.0,2,3,2,3,0,0,0,0,0,1,1,0,0,0,1,0,4
401403374,La Salle Explorers,K. Brantley,4709132,,False,20.0,3,10,3,8,0,2,5,8,0,0,0,3,2,1,2,3,11
401403374,La Salle Explorers,K. Thompson,4592449,,False,2.0,0,1,0,1,0,0,0,0,0,1,1,0,0,0,0,0,0
401403374,La Salle Explorers,J. Nickelberry,4432845,,False,20.0,1,3,0,1,1,2,2,2,0,2,2,0,2,0,3,5,5
401403374,La Salle Explorers,A. Lafond,4404355,,False,2.0,0,0,0,0,0,0,0,0,0,0,0,0,0,0,0,0,0
401403374,La Salle Explorers,TEAM,TOTAL,TOTAL,False,,17,54,15,41,2,13,15,20,6,27,33,7,6,3,11,18,51
401403373,George Mason Patriots,J. Oduro,4432068,,True,29.0,5,9,5,8,0,1,1,4,2,8,10,2,2,3,5,4,11
401403373,George Mason Patriots,X. Johnson,4592439,,True,20.0,3,8,1,3,2,5,0,0,0,2,2,3,3,0,2,3,8
401403373,George Mason Patriots,D. Gaines,4431961,,True,36.0,0,7,0,2,0,5,0,1,2,8,10,2,0,1,1,0,0
401403373,George Mason Patriots,D. Cooper,4279876,,True,36.0,3,9,1,3,2,6,1,1,0,3,3,2,0,0,0,2,9
401403373,George Mason Patriots,D. Schwartz,4278501,,True,38.0,3,8,2,5,1,3,0,0,0,5,5,0,1,0,1,1,7
401403373,George Mason Patriots,B. Jones,4897083,,False,9.0,1,2,1,1,0,1,0,0,1,0,1,0,0,0,0,2,2
401403373,George Mason Patriots,R. Polite III,4567711,,False,18.0,3,11,2,5,1,6,3,3,0,0,0,2,0,0,2,2,10
401403373,George Mason Patriots,J. Hartwell II,4396817,,False,14.0,1,1,1,1,0,0,0,0,0,1,1,0,0,0,0,2,2
401403373,George Mason Patriots,TEAM,TOTAL,TOTAL,False,,19,55,13,28,6,27,5,9,5,28,33,11,6,4,11,16,49
401403373,Fordham Rams,A. Tsimbila,4702329,,True,15.0,1,4,1,4,0,0,3,4,7,3,10,0,0,1,1,0,5
401403373,Fordham Rams,C. Ohams,4066856,,True,34.0,7,20,7,20,0,0,6,10,3,13,16,0,2,0,1,2,20
401403373,Fordham Rams,J. Navarro,4592316,,True,24.0,1,6,0,3,1,3,0,0,0,2,2,2,1,0,1,1,3
401403373,Fordham Rams,K. Rose,4592315,,True,31.0,0,3,0,0,0,3,0,0,0,1,1,1,1,0,1,0,0
401403373,Fordham Rams,D. Quisenberry,4397790,,True,22.0,0,6,0,2,0,4,0,0,0,1,1,0,0,0,1,0,0
401403373,Fordham Rams,P. Kelly,4432014,,False,21.0,3,3,0,0,3,3,0,1,1,3,4,0,0,1,0,4,9
401403373,Fordham Rams,R. Novitskyi,4897084,,False,10.0,0,2,0,1,0,1,0,0,1,3,4,0,0,0,1,2,0
401403373,Fordham Rams,A. Charlton,4897085,,False,34.0,5,11,4,6,1,5,0,0,0,7,7,5,2,0,5,4,11
401403373,Fordham Rams,Z. Riley,4914388,,False,9.0,1,1,1,1,0,0,4,4,0,0,0,0,1,0,0,0,6
401403373,Fordham Rams,TEAM,TOTAL,TOTAL,False,,18,56,13,37,5,19,13,19,13,34,47,8,7,2,11,13,54
401403372,Rhode Island Rams,A. Walker,4278567,,True,33.0,6,8,3,5,3,3,2,2,4,7,11,1,1,2,2,0,17
401403372,Rhode Island Rams,I. Leggett,4606837,,True,24.0,5,10,3,7,2,3,0,1,4,3,7,0,1,0,0,4,12
401403372,Rhode Island Rams,M. Martin,4397470,,True,33.0,3,5,2,2,1,3,1,1,1,3,4,0,2,2,2,3,8
401403372,Rhode Island Rams,I. El-Amin,4279313,,True,19.0,2,3,1,1,1,2,0,0,0,2,2,2,0,0,2,1,5
401403372,Rhode Island Rams,J. Sheppard,4066445,,True,30.0,4,11,2,5,2,6,5,8,0,2,2,6,1,0,5,4,15
401403372,Rhode Island Rams,Makhel Mitchell,4431777,,False,18.0,5,8,5,7,0,1,0,0,1,3,4,0,0,3,2,0,10
401403372,Rhode Island Rams,Makhi Mitchell,4431708,,False,12.0,3,6,2,5,1,1,3,6,2,6,8,0,0,0,0,0,10
401403372,Rhode Island Rams,J. Carey,4395673,,False,13.0,0,4,0,3,0,1,0,0,0,0,0,3,0,1,1,1,0
401403372,Rhode Island Rams,S. Thomas,4897065,,False,18.0,1,4,1,4,0,0,0,0,0,0,0,3,2,0,3,1,2
401403372,Rhode Island Rams,TEAM,TOTAL,TOTAL,False,,29,59,19,39,10,20,11,18,13,26,39,15,7,8,19,14,79
401403372,Duquesne Dukes,M. Hima,4700878,,True,7.0,2,2,2,2,0,0,0,0,1,0,1,0,0,1,1,4,4
401403372,Duquesne Dukes,K. Easley,4398159,,True,37.0,8,12,6,7,2,5,2,3,4,3,7,3,4,0,2,3,20
401403372,Duquesne Dukes,D. Larson,4897091,,True,33.0,1,7,1,5,0,2,1,2,1,3,4,0,2,0,1,4,3
401403372,Duquesne Dukes,A. Spears,4897090,,True,40.0,12,25,9,16,3,9,3,4,0,6,6,5,2,0,1,1,30
401403372,Duquesne Dukes,T. Acuff,4606831,,True,24.0,1,4,1,2,0,2,0,0,0,4,4,3,1,0,0,2,2
401403372,Duquesne Dukes,J. Johnson III,4897088,,False,23.0,5,10,4,8,1,2,2,3,0,2,2,0,1,0,2,1,13
401403372,Duquesne Dukes,M. Bekelja,4700874,,False,13.0,0,1,0,0,0,1,0,0,0,0,0,0,0,0,0,1,0
401403372,Duquesne Dukes,T. Okani,4700873,,False,23.0,2,4,2,4,0,0,1,2,1,2,3,1,2,2,1,4,5
401403372,Duquesne Dukes,TEAM,TOTAL,TOTAL,False,,31,65,25,44,6,21,9,14,8,22,30,12,12,3,8,20,77
401403371,Saint Joseph's Hawks,A. Jansson,4701029,,True,4.0,0,0,0,0,0,0,0,0,0,0,0,0,0,0,0,0,0
401403371,Saint Joseph's Hawks,E. Obinna,4278125,,True,36.0,7,10,7,10,0,0,0,2,6,8,14,1,0,0,1,2,14
401403371,Saint Joseph's Hawks,J. Hall,4701031,,True,39.0,4,17,1,12,3,5,0,0,1,8,9,6,2,0,4,1,11
401403371,Saint Joseph's Hawks,E. Reynolds II,4683952,,True,39.0,3,17,3,7,0,10,0,0,0,2,2,2,2,0,7,5,6
401403371,Saint Joseph's Hawks,C. Brown,4592476,,True,31.0,3,13,2,6,1,7,0,0,2,2,4,1,2,1,0,1,7
401403371,Saint Joseph's Hawks,C. Coleman,4431807,,False,27.0,7,9,3,4,4,5,0,0,2,9,11,1,0,0,1,3,18
401403371,Saint Joseph's Hawks,J. Forrest,4701032,,False,19.0,0,2,0,1,0,1,0,0,0,1,1,0,0,1,0,4,0
401403371,Saint Joseph's Hawks,D. Bishop,4701028,,False,5.0,0,0,0,0,0,0,0,0,0,0,0,0,0,0,0,0,0
401403371,Saint Joseph's Hawks,TEAM,TOTAL,TOTAL,False,,24,68,16,40,8,28,0,2,14,32,46,11,6,2,14,16,56
401403371,La Salle Explorers,C. Moore,4277945,,True,36.0,7,15,5,10,2,5,3,6,2,5,7,1,0,4,0,0,19
401403371,La Salle Explorers,J. Clark,4397152,,True,33.0,9,20,8,17,1,3,1,3,3,10,13,3,1,0,1,2,20
401403371,La Salle Explorers,J. Brickus,4700970,,True,24.0,0,3,0,0,0,3,0,2,0,3,3,1,3,0,2,1,0
401403371,La Salle Explorers,A. Gill,4700969,,True,24.0,3,5,2,4,1,1,0,0,1,2,3,4,0,1,3,3,7
401403371,La Salle Explorers,C. Ray,4592448,,True,36.0,2,5,0,0,2,5,0,0,1,3,4,0,2,1,1,1,6
401403371,La Salle Explorers,M. Doucoure,4277988,,False,7.0,0,0,0,0,0,0,0,0,0,1,1,0,0,0,0,0,0
401403371,La Salle Explorers,D. Shepherd,4710357,,False,1.0,0,0,0,0,0,0,0,0,0,0,0,0,0,0,0,0,0
401403371,La Salle Explorers,K. Brantley,4709132,,False,20.0,1,6,1,4,0,2,4,5,0,2,2,0,3,0,2,0,6
401403371,La Salle Explorers,J. Nickelberry,4432845,,False,19.0,2,5,1,2,1,3,0,0,0,3,3,3,0,0,0,0,5
401403371,La Salle Explorers,TEAM,TOTAL,TOTAL,False,,24,59,17,37,7,22,8,16,9,29,38,12,9,6,9,7,63
401403370,Seton Hall Pirates,T. Jackson,4593010,,True,8.0,1,4,0,1,1,3,0,0,0,2,2,0,1,0,1,4,3
401403370,Seton Hall Pirates,I. Obiagu,4277851,,True,28.0,0,2,0,2,0,0,0,0,3,1,4,0,0,7,1,3,0
401403370,Seton Hall Pirates,J. Rhoden,4397119,,True,38.0,6,13,4,10,2,3,3,3,1,3,4,2,0,2,3,1,17
401403370,Seton Hall Pirates,K. Richmond,4701845,,True,17.0,4,8,4,6,0,2,1,1,0,2,2,3,1,1,3,1,9
401403370,Seton Hall Pirates,M. Cale,4278579,,True,37.0,6,10,4,6,2,4,0,0,1,4,5,1,1,0,1,1,14
401403370,Seton Hall Pirates,T. Samuel,4432105,,False,12.0,0,3,0,2,0,1,0,0,0,1,1,0,0,0,0,0,0
401403370,Seton Hall Pirates,A. Yetna,4278308,,False,32.0,2,9,2,6,0,3,1,3,3,8,11,2,0,0,1,1,5
401403370,Seton Hall Pirates,J. Harris,4277966,,False,28.0,3,8,0,1,3,7,0,0,0,3,3,2,1,0,2,1,9
401403370,Seton Hall Pirates,TEAM,TOTAL,TOTAL,False,,22,57,14,34,8,23,5,7,9,25,34,10,4,10,12,12,57
401403370,Georgetown Hoyas,C. Holloway,4701559,,True,39.0,4,15,3,10,1,5,2,3,0,4,4,1,2,0,4,3,11
401403370,Georgetown Hoyas,T. Ighoefe,4431991,,True,31.0,2,8,2,8,0,0,1,2,7,6,13,1,2,4,2,2,5
401403370,Georgetown Hoyas,D. Harris,4596531,,True,8.0,0,4,0,4,0,0,0,0,0,2,2,1,0,0,1,0,0
401403370,Georgetown Hoyas,A. Mohammed,4433252,,True,35.0,4,8,3,6,1,2,3,4,2,8,10,3,1,1,3,3,12
401403370,Georgetown Hoyas,D. Carey,4402802,,True,34.0,4,12,2,4,2,8,1,1,3,1,4,3,3,0,1,1,11
401403370,Georgetown Hoyas,J. Billingsley,4687376,,False,4.0,0,0,0,0,0,0,0,0,0,0,0,0,0,0,0,0,0
401403370,Georgetown Hoyas,K. Clark,4432477,,False,4.0,0,0,0,0,0,0,0,0,1,0,1,0,0,0,2,1,0
401403370,Georgetown Hoyas,R. Mutombo,4683739,,False,1.0,0,0,0,0,0,0,0,0,0,0,0,0,0,0,0,2,0
401403370,Georgetown Hoyas,T. Beard,4433195,,False,19.0,3,7,1,4,2,3,0,0,0,1,1,0,0,0,1,0,8
401403370,Georgetown Hoyas,K. Rice,4280011,,False,25.0,2,8,0,1,2,7,0,0,0,3,3,0,0,0,0,3,6
401403370,Georgetown Hoyas,TEAM,TOTAL,TOTAL,False,,19,62,11,37,8,25,7,10,21,27,48,9,8,5,16,15,53
401403349,St. John's Red Storm,A. Wheeler,4277982,,True,16.0,2,7,2,5,0,2,4,4,0,4,4,2,0,1,0,3,8
401403349,St. John's Red Storm,J. Soriano,4592317,,True,18.0,4,5,4,5,0,0,0,1,3,1,4,1,0,0,0,2,8
401403349,St. John's Red Storm,J. Champagnie,4592479,,True,30.0,10,20,7,13,3,7,3,4,3,4,7,1,2,0,0,0,26
401403349,St. John's Red Storm,P. Alexander,4433156,,True,28.0,3,7,3,6,0,1,2,2,0,0,0,7,2,0,0,1,8
401403349,St. John's Red Storm,T. Coburn,4066515,,True,6.0,1,2,1,1,0,1,0,0,0,0,0,0,0,0,0,1,2
401403349,St. John's Red Storm,E. Nyiwe,4897419,,False,21.0,5,8,5,7,0,1,0,0,1,8,9,1,0,1,0,2,10
401403349,St. John's Red Storm,O. Stanley,4703032,,False,3.0,0,0,0,0,0,0,0,0,0,0,0,1,0,0,0,0,0
401403349,St. John's Red Storm,R. Pinzon,4683951,,False,7.0,1,3,1,2,0,1,0,0,0,0,0,0,0,0,0,0,2
401403349,St. John's Red Storm,D. Addae-Wusu,4590361,,False,28.0,3,5,1,3,2,2,0,1,0,2,2,5,1,0,1,2,8
401403349,St. John's Red Storm,M. Mathis,4397250,,False,17.0,3,8,2,6,1,2,0,0,0,0,0,2,0,0,1,2,7
401403349,St. John's Red Storm,S. Smith,4278244,,False,26.0,5,9,4,5,1,4,2,2,1,1,2,2,1,0,0,1,13
401403349,St. John's Red Storm,TEAM,TOTAL,TOTAL,False,,37,74,30,53,7,21,11,14,9,23,32,22,6,2,2,14,92
401403349,DePaul Blue Demons,D. Jones,4713010,,True,25.0,5,7,4,5,1,2,0,0,2,6,8,2,0,2,2,3,11
401403349,DePaul Blue Demons,B. Johnson,4067410,,True,33.0,5,11,5,8,0,3,1,2,1,2,3,0,0,0,3,1,11
401403349,DePaul Blue Demons,N. Ongenda,4431760,,True,25.0,5,8,5,8,0,0,3,3,1,7,8,0,0,1,2,3,13
401403349,DePaul Blue Demons,J. Terry,4702387,,True,28.0,1,5,1,2,0,3,0,0,1,3,4,4,0,0,1,4,2
401403349,DePaul Blue Demons,J. Freeman-Liberty,4397511,,True,36.0,6,13,6,9,0,4,5,6,1,5,6,5,0,0,4,4,17
401403349,DePaul Blue Demons,Y. Anei,4397046,,False,15.0,1,2,1,2,0,0,2,2,1,2,3,1,1,1,2,0,4
401403349,DePaul Blue Demons,C. McCauley,4701557,,False,20.0,3,8,3,5,0,3,3,4,1,5,6,0,0,0,1,3,9
401403349,DePaul Blue Demons,P. Gebrewhit,4397991,,False,18.0,2,4,0,1,2,3,0,0,0,0,0,0,0,0,0,0,6
401403349,DePaul Blue Demons,TEAM,TOTAL,TOTAL,False,,28,58,25,40,3,18,14,17,8,31,39,12,1,4,15,18,73
401403348,Xavier Musketeers,Z. Freemantle,4432869,,True,40.0,5,12,4,10,1,2,3,4,3,10,13,3,2,1,1,2,14
401403348,Xavier Musketeers,J. Nunge,4277948,,True,38.0,9,12,8,9,1,3,5,11,2,7,9,0,1,0,0,1,24
401403348,Xavier Musketeers,C. Jones,4433378,,True,39.0,6,13,6,13,0,0,2,7,3,3,6,3,1,0,2,3,14
401403348,Xavier Musketeers,P. Scruggs,4278591,,True,39.0,7,13,6,10,1,3,0,3,1,2,3,6,0,1,2,5,15
401403348,Xavier Musketeers,N. Johnson,4067338,,True,37.0,3,9,3,5,0,4,2,2,0,5,5,1,0,0,0,2,8
401403348,Xavier Musketeers,J. Hunter,4397011,,False,4.0,0,1,0,0,0,1,0,0,0,0,0,0,0,0,0,1,0
401403348,Xavier Musketeers,D. Odom,4432632,,False,12.0,2,3,2,3,0,0,0,0,0,0,0,0,0,0,1,5,4
401403348,Xavier Musketeers,A. Kunkel,4398300,,False,16.0,1,7,1,5,0,2,1,2,0,1,1,0,0,0,0,5,3
401403348,Xavier Musketeers,TEAM,TOTAL,TOTAL,False,,33,70,30,55,3,15,13,29,11,31,42,13,4,2,6,24,82
401403348,Butler Bulldogs,B. Nze,4067439,,True,32.0,5,9,4,6,1,3,4,4,2,13,15,0,0,1,3,4,15
401403348,Butler Bulldogs,B. Golden,4397026,,True,32.0,0,4,0,3,0,1,1,2,1,7,8,0,1,1,0,2,1
401403348,Butler Bulldogs,C. Harris,4701551,,True,32.0,12,20,10,10,2,10,3,6,0,0,0,2,0,0,2,5,29
401403348,Butler Bulldogs,Bo Hodges,4280018,,True,35.0,2,9,2,7,0,2,0,0,3,2,5,1,2,1,0,5,4
401403348,Butler Bulldogs,A. Thompson,4278552,,True,39.0,3,6,2,4,1,2,0,1,0,0,0,4,1,0,1,5,7
401403348,Butler Bulldogs,D. Hughes,4684308,,False,3.0,0,0,0,0,0,0,0,0,0,0,0,0,0,0,0,0,0
401403348,Butler Bulldogs,M. Wilmoth,4433560,,False,0.0,0,0,0,0,0,0,0,0,0,0,0,0,0,0,0,0,0
401403348,Butler Bulldogs,S. Lukosius,4897411,,False,31.0,6,13,2,5,4,8,11,13,0,7,7,2,0,0,2,1,27
401403348,Butler Bulldogs,J. Taylor,4589483,,False,17.0,0,3,0,0,0,3,4,4,0,3,3,1,0,0,0,2,4
401403348,Butler Bulldogs,M. Tate,4572452,,False,4.0,0,0,0,0,0,0,2,2,0,0,0,0,0,0,0,1,2
401403348,Butler Bulldogs,TEAM,TOTAL,TOTAL,False,,28,64,20,35,8,29,25,32,10,34,44,10,4,3,8,25,89
401403347,UConn Huskies,I. Whaley,4278231,,True,30.0,4,12,4,9,0,3,2,2,6,1,7,0,0,4,1,3,10
401403347,UConn Huskies,A. Sanogo,4702023,,True,35.0,2,11,2,11,0,0,2,2,5,6,11,1,0,1,2,1,6
401403347,UConn Huskies,A. Jackson,4432190,,True,36.0,2,7,1,4,1,3,1,3,1,5,6,4,2,1,1,2,6
401403347,UConn Huskies,T. Martin,4397179,,True,37.0,6,14,5,8,1,6,4,4,1,7,8,4,2,1,4,1,17
401403347,UConn Huskies,R.J. Cole,4279789,,True,36.0,6,12,3,7,3,5,2,2,0,5,5,1,1,0,2,1,17
401403347,UConn Huskies,R. Springs,4592905,,False,1.0,0,0,0,0,0,0,0,0,0,0,0,0,0,0,0,0,0
401403347,UConn Huskies,T. Polley,4278230,,False,16.0,2,5,1,2,1,3,1,1,1,1,2,1,0,0,0,1,6
401403347,UConn Huskies,S. Johnson,4683752,,False,1.0,0,0,0,0,0,0,0,0,0,0,0,0,0,0,0,0,0
401403347,UConn Huskies,R. Diggins,4683733,,False,1.0,0,0,0,0,0,0,0,0,0,0,0,0,0,0,0,0,0
401403347,UConn Huskies,J. Gaffney,4431732,,False,7.0,0,0,0,0,0,0,0,0,0,0,0,0,0,0,0,1,0
401403347,UConn Huskies,TEAM,TOTAL,TOTAL,False,,22,61,16,41,6,20,12,14,18,28,46,11,5,7,10,10,62
401403347,Seton Hall Pirates,T. Jackson,4593010,,True,14.0,0,2,0,0,0,2,0,0,0,2,2,1,0,1,1,3,0
401403347,Seton Hall Pirates,I. Obiagu,4277851,,True,22.0,1,1,1,1,0,0,0,0,1,3,4,0,0,5,3,3,2
401403347,Seton Hall Pirates,J. Rhoden,4397119,,True,33.0,2,13,1,11,1,2,2,2,1,5,6,0,0,0,0,3,7
401403347,Seton Hall Pirates,K. Richmond,4701845,,True,26.0,6,13,6,11,0,2,2,4,0,2,2,1,3,0,2,3,14
401403347,Seton Hall Pirates,M. Cale,4278579,,True,37.0,7,10,4,7,3,3,0,0,2,4,6,1,2,0,0,1,17
401403347,Seton Hall Pirates,J. Smith,4897417,,False,1.0,0,0,0,0,0,0,0,0,0,0,0,0,0,0,0,0,0
401403347,Seton Hall Pirates,T. Samuel,4432105,,False,18.0,0,3,0,2,0,1,0,0,2,1,3,0,1,0,1,3,0
401403347,Seton Hall Pirates,A. Yetna,4278308,,False,26.0,2,8,1,4,1,4,1,3,2,4,6,2,1,0,2,0,6
401403347,Seton Hall Pirates,T. Powell,4684146,,False,1.0,0,0,0,0,0,0,0,0,0,0,0,0,0,0,0,0,0
401403347,Seton Hall Pirates,J. Harris,4277966,,False,22.0,2,6,0,1,2,5,0,0,0,0,0,1,0,0,2,1,6
401403347,Seton Hall Pirates,TEAM,TOTAL,TOTAL,False,,20,56,13,37,7,19,5,9,11,22,33,6,7,6,11,17,52
401403346,Villanova Wildcats,E. Dixon,4431718,,True,14.0,1,3,1,3,0,0,2,2,7,2,9,1,2,0,3,1,4
401403346,Villanova Wildcats,B. Slater,4397133,,True,37.0,1,3,1,2,0,1,5,5,1,3,4,2,0,1,2,4,7
401403346,Villanova Wildcats,J. Moore,4592491,,True,36.0,5,16,3,7,2,9,3,4,0,1,1,1,0,0,1,1,15
401403346,Villanova Wildcats,C. Gillespie,4278585,,True,37.0,5,11,3,5,2,6,2,4,1,5,6,3,0,0,4,3,14
401403346,Villanova Wildcats,C. Daniels,4278373,,True,37.0,6,14,1,5,5,9,2,2,1,6,7,0,0,0,0,2,19
401403346,Villanova Wildcats,J. Samuels,4278588,,False,26.0,2,6,2,5,0,1,3,3,5,3,8,0,2,0,2,0,7
401403346,Villanova Wildcats,J. Longino,4684153,,False,3.0,0,0,0,0,0,0,0,0,0,0,0,0,0,0,1,3,0
401403346,Villanova Wildcats,C. Arcidiacono,4592490,,False,5.0,0,1,0,0,0,1,0,0,1,0,1,0,0,0,0,0,0
401403346,Villanova Wildcats,B. Antoine,4432814,,False,5.0,0,2,0,0,0,2,0,0,0,1,1,0,0,0,0,0,0
401403346,Villanova Wildcats,TEAM,TOTAL,TOTAL,False,,20,56,11,27,9,29,17,20,16,23,39,7,4,1,13,14,66
401403346,St. John's Red Storm,A. Wheeler,4277982,,True,29.0,3,6,3,4,0,2,0,0,1,4,5,2,0,2,3,2,6
401403346,St. John's Red Storm,J. Soriano,4592317,,True,15.0,2,2,2,2,0,0,2,2,0,2,2,1,0,1,0,3,6
401403346,St. John's Red Storm,J. Champagnie,4592479,,True,38.0,9,19,8,13,1,6,4,6,2,7,9,3,4,1,1,3,23
401403346,St. John's Red Storm,P. Alexander,4433156,,True,30.0,4,9,3,8,1,1,0,0,3,1,4,5,3,0,2,4,9
401403346,St. John's Red Storm,M. Mathis,4397250,,True,21.0,2,4,1,2,1,2,0,0,0,0,0,1,0,0,0,2,5
401403346,St. John's Red Storm,E. Nyiwe,4897419,,False,17.0,2,3,2,3,0,0,0,2,1,3,4,1,0,0,0,0,4
401403346,St. John's Red Storm,D. Addae-Wusu,4590361,,False,24.0,1,4,1,2,0,2,0,0,0,3,3,1,0,0,1,3,2
401403346,St. John's Red Storm,S. Smith,4278244,,False,22.0,4,11,3,6,1,5,1,1,1,1,2,0,1,0,4,2,10
401403346,St. John's Red Storm,T. Coburn,4066515,,False,4.0,0,1,0,0,0,1,0,0,0,0,0,0,0,0,0,0,0
401403346,St. John's Red Storm,TEAM,TOTAL,TOTAL,False,,27,59,23,40,4,19,7,11,10,22,32,14,8,4,11,19,65
401403345,Marquette Golden Eagles,O. Prosper,4595400,,True,22.0,3,6,1,3,2,3,1,1,1,0,1,0,0,0,1,3,9
401403345,Marquette Golden Eagles,J. Lewis,4432239,,True,32.0,6,14,5,7,1,7,4,4,0,7,7,0,2,1,2,2,17
401403345,Marquette Golden Eagles,K. Kuath,4397028,,True,11.0,1,2,1,2,0,0,0,0,0,1,1,1,1,0,2,2,2
401403345,Marquette Golden Eagles,T. Kolek,4433225,,True,33.0,2,7,0,2,2,5,0,0,2,5,7,6,1,0,3,1,6
401403345,Marquette Golden Eagles,D. Morsell,4277954,,True,31.0,7,16,5,11,2,5,2,2,0,1,1,1,1,1,3,3,18
401403345,Marquette Golden Eagles,D. Joplin,4684306,,False,11.0,0,0,0,0,0,0,0,0,0,0,0,1,0,0,0,0,0
401403345,Marquette Golden Eagles,O. Ighodaro,4601023,,False,14.0,0,0,0,0,0,0,0,0,1,1,2,0,0,0,2,2,0
401403345,Marquette Golden Eagles,K. Jones,4697268,,False,14.0,3,7,1,2,2,5,0,0,0,1,1,0,2,0,1,0,8
401403345,Marquette Golden Eagles,S. Mitchell,4683840,,False,18.0,0,0,0,0,0,0,0,0,0,0,0,0,0,0,0,0,0
401403345,Marquette Golden Eagles,G. Elliott,4278570,,False,14.0,1,6,1,3,0,3,1,1,0,2,2,1,0,0,1,1,3
401403345,Marquette Golden Eagles,TEAM,TOTAL,TOTAL,False,,23,58,14,30,9,28,8,8,7,20,27,10,7,2,15,14,63
401403345,Creighton Bluejays,R. Hawkins,4897413,,True,40.0,7,12,3,5,4,7,0,0,2,4,6,1,3,0,3,0,18
401403345,Creighton Bluejays,A. Kaluma,4433599,,True,25.0,5,9,4,6,1,3,3,3,1,2,3,1,1,0,2,3,14
401403345,Creighton Bluejays,R. Kalkbrenner,4576060,,True,36.0,5,6,5,6,0,0,4,6,6,3,9,3,1,2,2,1,14
401403345,Creighton Bluejays,T. Alexander,4433268,,True,39.0,4,13,4,12,0,1,3,4,0,6,6,8,2,1,4,2,11
401403345,Creighton Bluejays,A. O'Connell,4277846,,True,37.0,4,11,3,6,1,5,0,0,0,9,9,1,1,0,2,3,9
401403345,Creighton Bluejays,K. Feazell,4278099,,False,10.0,2,2,2,2,0,0,1,1,0,1,1,0,0,0,0,1,5
401403345,Creighton Bluejays,R. Andronikashvili,4701555,,False,12.0,1,4,0,3,1,1,0,0,0,2,2,0,2,0,3,2,3
401403345,Creighton Bluejays,D. Davis,4701554,,False,1.0,0,0,0,0,0,0,0,0,0,0,0,0,0,0,0,0,0
401403345,Creighton Bluejays,TEAM,TOTAL,TOTAL,False,,28,57,21,40,7,17,11,14,11,28,39,14,10,3,17,12,74
401403344,Providence Friars,N. Horchler,4278453,,True,40.0,3,9,1,2,2,7,0,0,0,6,6,2,3,1,0,4,8
401403344,Providence Friars,J. Minaya,4278111,,True,33.0,2,6,1,1,1,5,0,0,3,5,8,0,0,3,1,2,5
401403344,Providence Friars,N. Watson,4278573,,True,36.0,9,14,9,14,0,0,8,13,4,3,7,2,0,1,1,1,26
401403344,Providence Friars,A.J. Reeves,4397109,,True,23.0,1,6,0,2,1,4,0,0,0,1,1,3,0,0,0,4,3
401403344,Providence Friars,Al Durham,4277942,,True,32.0,2,9,1,4,1,5,2,4,1,2,3,2,0,1,2,2,7
401403344,Providence Friars,Ed Croswell,4397153,,False,4.0,0,1,0,1,0,0,0,0,0,2,2,0,0,0,0,2,0
401403344,Providence Friars,A. Breed,4585590,,False,8.0,0,2,0,1,0,1,0,0,0,2,2,0,0,0,1,0,0
401403344,Providence Friars,B. Goodine,4431716,,False,1.0,0,0,0,0,0,0,0,0,0,0,0,0,0,0,0,0,0
401403344,Providence Friars,J. Bynum,4397194,,False,23.0,3,7,2,4,1,3,9,12,0,3,3,1,0,0,2,3,16
401403344,Providence Friars,TEAM,TOTAL,TOTAL,False,,20,54,14,29,6,25,19,29,11,30,41,10,3,6,7,18,65
401403344,Butler Bulldogs,B. Nze,4067439,,True,27.0,3,6,2,5,1,1,1,6,1,2,3,2,0,0,1,3,8
401403344,Butler Bulldogs,B. Golden,4397026,,True,23.0,6,11,5,7,1,4,0,0,1,0,1,0,1,0,0,3,13
401403344,Butler Bulldogs,C. Harris,4701551,,True,39.0,4,12,3,7,1,5,5,7,0,2,2,1,1,0,2,2,14
401403344,Butler Bulldogs,B. Hodges,4280018,,True,29.0,3,9,3,8,0,1,4,6,6,9,15,3,1,0,1,4,10
401403344,Butler Bulldogs,A. Thompson,4278552,,True,28.0,4,8,4,8,0,0,0,0,0,3,3,0,0,0,2,3,8
401403344,Butler Bulldogs,Ty Groce,4067382,,False,17.0,0,2,0,1,0,1,0,0,3,3,6,0,2,0,0,2,0
401403344,Butler Bulldogs,S. Lukosius,4897411,,False,29.0,1,11,1,4,0,7,2,2,0,6,6,2,0,0,2,4,4
401403344,Butler Bulldogs,J. Taylor,4589483,,False,7.0,1,2,1,2,0,0,0,0,0,2,2,0,0,0,0,3,2
401403344,Butler Bulldogs,M. Tate,4572452,,False,1.0,0,0,0,0,0,0,2,2,0,0,0,0,0,0,0,0,2
401403344,Butler Bulldogs,TEAM,TOTAL,TOTAL,False,,22,61,19,42,3,19,14,23,14,30,44,8,5,0,8,24,61
401403343,Villanova Wildcats,E. Dixon,4431718,,True,12.0,2,2,1,1,1,1,0,0,0,1,1,0,1,0,1,1,5
401403343,Villanova Wildcats,B. Slater,4397133,,True,38.0,5,8,2,2,3,6,2,2,1,3,4,0,2,1,2,2,15
401403343,Villanova Wildcats,J. Samuels,4278588,,True,30.0,7,17,4,9,3,8,4,4,1,11,12,1,1,1,1,0,21
401403343,Villanova Wildcats,J. Moore,4592491,,True,38.0,3,9,3,4,0,5,0,0,0,4,4,3,0,0,1,2,6
401403343,Villanova Wildcats,C. Gillespie,4278585,,True,38.0,2,5,2,3,0,2,1,2,0,0,0,10,0,0,1,3,5
401403343,Villanova Wildcats,J. Longino,4684153,,False,10.0,2,3,1,1,1,2,0,0,0,1,1,0,0,0,0,1,5
401403343,Villanova Wildcats,C. Daniels,4278373,,False,34.0,2,10,0,4,2,6,0,0,1,2,3,0,0,1,0,2,6
401403343,Villanova Wildcats,TEAM,TOTAL,TOTAL,False,,23,54,13,24,10,30,7,8,6,24,30,14,4,3,6,11,63
401403343,UConn Huskies,I. Whaley,4278231,,True,32.0,0,3,0,3,0,0,0,0,1,3,4,2,0,4,1,1,0
401403343,UConn Huskies,A. Sanogo,4702023,,True,32.0,6,15,6,15,0,0,3,7,7,6,13,0,0,0,2,3,15
401403343,UConn Huskies,A. Jackson,4432190,,True,38.0,4,10,2,5,2,5,0,0,1,4,5,2,2,0,0,2,10
401403343,UConn Huskies,T. Martin,4397179,,True,36.0,7,17,3,9,4,8,1,1,3,4,7,0,2,0,0,2,19
401403343,UConn Huskies,R.J. Cole,4279789,,True,38.0,3,9,2,3,1,6,4,5,1,7,8,8,0,0,3,2,11
401403343,UConn Huskies,T. Polley,4278230,,False,21.0,2,4,1,1,1,3,0,0,0,1,1,0,0,0,1,2,5
401403343,UConn Huskies,J. Gaffney,4431732,,False,3.0,0,0,0,0,0,0,0,0,0,0,0,0,0,0,0,0,0
401403343,UConn Huskies,TEAM,TOTAL,TOTAL,False,,22,58,14,36,8,22,8,13,15,25,40,12,4,4,7,12,60
401403342,Providence Friars,N. Horchler,4278453,,True,30.0,0,3,0,0,0,3,2,2,3,2,5,0,0,0,1,3,2
401403342,Providence Friars,J. Minaya,4278111,,True,27.0,1,7,1,2,0,5,1,3,3,3,6,1,2,0,0,1,3
401403342,Providence Friars,N. Watson,4278573,,True,25.0,2,7,2,7,0,0,1,2,1,0,1,1,0,0,0,1,5
401403342,Providence Friars,A.J. Reeves,4397109,,True,22.0,4,12,4,7,0,5,0,1,1,3,4,1,1,0,1,2,8
401403342,Providence Friars,Al Durham,4277942,,True,32.0,7,12,5,8,2,4,5,5,1,4,5,3,0,0,2,3,21
401403342,Providence Friars,Ed Croswell,4397153,,False,14.0,0,4,0,4,0,0,2,2,1,4,5,0,2,0,1,1,2
401403342,Providence Friars,A. Breed,4585590,,False,10.0,3,6,3,5,0,1,1,3,0,1,1,0,0,0,1,4,7
401403342,Providence Friars,B. Goodine,4431716,,False,8.0,1,2,0,0,1,2,2,2,2,0,2,0,0,0,0,2,5
401403342,Providence Friars,J. Bynum,4397194,,False,27.0,2,12,2,8,0,4,1,2,0,5,5,0,1,0,0,0,5
401403342,Providence Friars,A. Fonts,4278575,,False,5.0,0,0,0,0,0,0,0,0,0,1,1,0,0,0,1,0,0
401403342,Providence Friars,TEAM,TOTAL,TOTAL,False,,20,65,17,41,3,24,15,22,17,23,40,6,6,0,9,17,58
401403342,Creighton Bluejays,R. Hawkins,4897413,,True,36.0,4,11,4,6,0,5,0,1,1,11,12,1,0,1,2,2,8
401403342,Creighton Bluejays,A. Kaluma,4433599,,True,28.0,6,12,4,7,2,5,3,3,2,2,4,1,2,0,1,5,17
401403342,Creighton Bluejays,R. Kalkbrenner,4576060,,True,25.0,6,8,6,8,0,0,3,4,4,5,9,1,0,4,1,2,15
401403342,Creighton Bluejays,T. Alexander,4433268,,True,23.0,5,6,4,4,1,2,4,4,0,3,3,2,1,1,3,2,15
401403342,Creighton Bluejays,A. O'Connell,4277846,,True,35.0,5,10,1,4,4,6,4,4,0,3,3,3,1,0,1,3,18
401403342,Creighton Bluejays,M. Kancleris,4701556,,False,4.0,0,0,0,0,0,0,0,0,0,1,1,0,1,0,0,0,0
401403342,Creighton Bluejays,K. Feazell,4278099,,False,14.0,1,3,1,2,0,1,0,0,1,4,5,2,0,1,0,2,2
401403342,Creighton Bluejays,R. Andronikashvili,4701555,,False,28.0,2,5,1,3,1,2,2,4,0,4,4,3,1,0,2,1,7
401403342,Creighton Bluejays,D. Davis,4701554,,False,4.0,1,1,0,0,1,1,0,0,0,0,0,0,0,0,0,1,3
401403342,Creighton Bluejays,S. Osmani,4701553,,False,3.0,0,1,0,0,0,1,0,0,0,0,0,0,0,0,0,0,0
401403342,Creighton Bluejays,TEAM,TOTAL,TOTAL,False,,30,57,21,34,9,23,16,20,8,34,42,13,6,7,10,18,85
401403341,Villanova Wildcats,E. Dixon,4431718,,True,14.0,2,4,2,3,0,1,0,0,1,2,3,1,0,0,3,1,4
401403341,Villanova Wildcats,B. Slater,4397133,,True,34.0,2,5,1,2,1,3,0,0,3,4,7,0,2,0,1,3,5
401403341,Villanova Wildcats,J. Samuels,4278588,,True,24.0,2,7,2,3,0,4,1,1,4,4,8,2,1,0,2,2,5
401403341,Villanova Wildcats,J. Moore,4592491,,True,39.0,5,15,2,7,3,8,3,6,0,6,6,0,0,0,0,0,16
401403341,Villanova Wildcats,C. Gillespie,4278585,,True,36.0,5,14,2,6,3,8,4,4,0,7,7,5,2,0,1,1,17
401403341,Villanova Wildcats,J. Longino,4684153,,False,12.0,0,4,0,2,0,2,0,0,0,0,0,0,0,0,0,0,0
401403341,Villanova Wildcats,C. Arcidiacono,4592490,,False,6.0,0,0,0,0,0,0,0,0,0,2,2,1,0,0,0,0,0
401403341,Villanova Wildcats,C. Daniels,4278373,,False,35.0,3,8,2,2,1,6,0,1,1,4,5,0,1,0,1,3,7
401403341,Villanova Wildcats,TEAM,TOTAL,TOTAL,False,,19,57,11,25,8,32,8,12,10,29,39,9,6,0,9,10,54
401403341,Creighton Bluejays,R. Hawkins,4897413,,True,37.0,1,10,1,5,0,5,0,0,1,7,8,1,0,0,0,3,2
401403341,Creighton Bluejays,A. Kaluma,4433599,,True,38.0,4,12,4,7,0,5,1,2,3,9,12,3,0,0,4,3,9
401403341,Creighton Bluejays,R. Kalkbrenner,4576060,,True,36.0,8,11,8,11,0,0,3,4,7,1,8,1,0,3,2,2,19
401403341,Creighton Bluejays,T. Alexander,4433268,,True,40.0,2,10,1,4,1,6,3,4,0,5,5,2,2,0,0,3,8
401403341,Creighton Bluejays,A. O'Connell,4277846,,True,34.0,4,13,2,2,2,11,0,0,0,3,3,2,1,0,3,2,10
401403341,Creighton Bluejays,K. Feazell,4278099,,False,5.0,0,0,0,0,0,0,0,0,1,0,1,0,0,0,0,0,0
401403341,Creighton Bluejays,R. Andronikashvili,4701555,,False,10.0,0,2,0,0,0,2,0,0,0,0,0,0,0,0,2,0,0
401403341,Creighton Bluejays,TEAM,TOTAL,TOTAL,False,,19,58,16,29,3,29,7,10,12,28,40,9,3,3,11,13,48
401403340,New Mexico State Aggies,Y. Alok,4397070,,True,9.0,0,1,0,1,0,0,2,2,0,0,0,1,0,0,1,1,2
401403340,New Mexico State Aggies,J. McCants,4067472,,True,31.0,3,6,3,4,0,2,2,4,2,5,7,3,0,3,0,3,8
401403340,New Mexico State Aggies,C. Henry,4396010,,True,34.0,6,11,3,4,3,7,0,0,3,5,8,1,0,1,1,0,15
401403340,New Mexico State Aggies,J. Rice,4280181,,True,34.0,3,11,0,3,3,8,2,2,0,2,2,0,1,0,4,4,11
401403340,New Mexico State Aggies,T. Allen,4277932,,True,23.0,2,8,1,5,1,3,5,5,1,4,5,3,0,0,4,5,10
401403340,New Mexico State Aggies,M. Peake,4572450,,False,7.0,0,1,0,0,0,1,2,2,1,3,4,0,0,0,0,1,2
401403340,New Mexico State Aggies,W. McNair Jr.,4396012,,False,28.0,3,5,2,3,1,2,1,2,5,4,9,2,1,2,1,2,8
401403340,New Mexico State Aggies,M. McKinney Jr.,4896928,,False,24.0,3,6,3,5,0,1,4,6,2,2,4,2,1,0,3,1,10
401403340,New Mexico State Aggies,N. Pryor,4702460,,False,6.0,0,2,0,2,0,0,0,0,1,0,1,0,0,0,0,0,0
401403340,New Mexico State Aggies,V. Cotton,4279307,,False,4.0,0,2,0,1,0,1,0,0,0,0,0,0,0,0,0,0,0
401403340,New Mexico State Aggies,TEAM,TOTAL,TOTAL,False,,20,53,12,28,8,25,18,23,17,27,44,12,3,6,15,17,66
401403340,Abilene Christian Wildcats,A. Simmons,4433077,,True,24.0,4,10,1,3,3,7,1,2,0,2,2,1,0,0,4,4,12
401403340,Abilene Christian Wildcats,C. Mason,4593750,,True,35.0,3,10,1,7,2,3,6,8,1,3,4,0,2,0,1,3,14
401403340,Abilene Christian Wildcats,M. Morris,4593748,,True,24.0,4,10,3,6,1,4,3,4,0,3,3,1,0,0,0,2,12
401403340,Abilene Christian Wildcats,R. Miller,4593747,,True,36.0,0,4,0,3,0,1,0,0,1,1,2,3,0,1,0,3,0
401403340,Abilene Christian Wildcats,T. Cameron,4278255,,True,29.0,1,4,1,2,0,2,2,2,1,4,5,1,1,0,2,3,4
401403340,Abilene Christian Wildcats,F. Cadeaux de Dieu,4896507,,False,1.0,0,0,0,0,0,0,0,0,0,0,0,0,0,0,0,0,0
401403340,Abilene Christian Wildcats,C. Steele,4703600,,False,18.0,2,4,2,2,0,2,0,0,0,1,1,0,0,0,2,0,4
401403340,Abilene Christian Wildcats,S. Smith,4896506,,False,1.0,0,0,0,0,0,0,0,0,0,0,0,0,0,0,0,0,0
401403340,Abilene Christian Wildcats,J. Jackson,4896504,,False,3.0,0,1,0,0,0,1,0,0,0,0,0,0,0,0,0,0,0
401403340,Abilene Christian Wildcats,I. Allen,4593749,,False,10.0,1,3,1,2,0,1,0,0,1,1,2,0,1,0,1,1,2
401403340,Abilene Christian Wildcats,D. Daniels,4397957,,False,19.0,2,6,2,5,0,1,0,0,0,2,2,0,1,0,1,2,4
401403340,Abilene Christian Wildcats,TEAM,TOTAL,TOTAL,False,,17,52,11,30,6,22,12,16,9,19,28,6,5,1,11,18,52
401403339,Seattle U Redhawks,E. Udenyi,4702013,,True,23.0,2,4,2,4,0,0,0,0,1,9,10,5,1,1,4,5,4
401403339,Seattle U Redhawks,K. Williamson,4702017,,True,15.0,1,2,0,1,1,1,0,0,1,4,5,0,0,2,1,0,3
401403339,Seattle U Redhawks,D. Trammell,4702011,,True,32.0,10,21,8,14,2,7,17,20,1,6,7,2,1,0,2,4,39
401403339,Seattle U Redhawks,C. Tyson,4397285,,True,29.0,5,12,1,2,4,10,0,0,1,1,2,0,0,0,2,3,14
401403339,Seattle U Redhawks,R. Grigsby,4396001,,True,27.0,2,4,1,1,1,3,1,2,1,2,3,1,0,0,2,5,6
401403339,Seattle U Redhawks,V. Rajković,4702014,,False,20.0,2,4,1,2,1,2,0,0,3,4,7,0,0,0,2,3,5
401403339,Seattle U Redhawks,B. Chatfield,4592671,,False,14.0,0,1,0,1,0,0,0,0,1,0,1,0,0,0,0,0,0
401403339,Seattle U Redhawks,K. Brown,4896942,,False,23.0,0,4,0,4,0,0,2,4,0,3,3,1,0,0,3,5,2
401403339,Seattle U Redhawks,V. Pandža,4702010,,False,17.0,1,3,0,0,1,3,0,1,1,2,3,0,0,0,3,4,3
401403339,Seattle U Redhawks,TEAM,TOTAL,TOTAL,False,,23,55,13,29,10,26,20,27,12,32,44,9,2,3,19,29,76
401403339,Abilene Christian Wildcats,A. Simmons,4433077,,True,30.0,8,15,5,9,3,6,2,3,2,6,8,0,1,2,3,2,21
401403339,Abilene Christian Wildcats,C. Mason,4593750,,True,21.0,1,5,1,4,0,1,0,2,0,1,1,1,0,0,2,4,2
401403339,Abilene Christian Wildcats,M. Morris,4593748,,True,35.0,4,10,4,8,0,2,5,6,0,7,7,0,2,0,0,2,13
401403339,Abilene Christian Wildcats,R. Miller,4593747,,True,32.0,1,4,1,2,0,2,3,4,1,1,2,1,3,0,0,4,5
401403339,Abilene Christian Wildcats,T. Cameron,4278255,,True,31.0,4,8,4,5,0,3,10,11,1,3,4,3,1,0,2,3,18
401403339,Abilene Christian Wildcats,C. Steele,4703600,,False,18.0,1,6,0,3,1,3,3,4,2,2,4,0,0,0,0,4,6
401403339,Abilene Christian Wildcats,J. Jackson,4896504,,False,7.0,0,1,0,1,0,0,0,0,0,0,0,0,0,0,0,0,0
401403339,Abilene Christian Wildcats,I. Allen,4593749,,False,9.0,1,4,1,3,0,1,1,3,2,2,4,0,0,0,0,1,3
401403339,Abilene Christian Wildcats,D. Daniels,4397957,,False,17.0,3,7,3,5,0,2,4,6,1,3,4,2,1,0,0,4,10
401403339,Abilene Christian Wildcats,TEAM,TOTAL,TOTAL,False,,23,60,19,40,4,20,28,39,10,26,36,7,8,2,7,24,78
401403338,New Mexico State Aggies,Y. Alok,4397070,,True,9.0,3,6,3,5,0,1,0,0,0,0,0,0,0,0,0,2,6
401403338,New Mexico State Aggies,J. McCants,4067472,,True,24.0,1,4,1,2,0,2,1,2,2,2,4,2,0,1,1,5,3
401403338,New Mexico State Aggies,C. Henry,4396010,,True,17.0,0,1,0,0,0,1,0,0,1,3,4,0,0,0,0,3,0
401403338,New Mexico State Aggies,J. Rice,4280181,,True,37.0,6,8,3,3,3,5,6,8,2,3,5,4,1,0,2,2,21
401403338,New Mexico State Aggies,T. Allen,4277932,,True,40.0,5,12,2,5,3,7,12,12,2,5,7,6,1,0,2,1,25
401403338,New Mexico State Aggies,M. Peake,4572450,,False,19.0,1,4,1,3,0,1,1,2,0,1,1,3,0,1,1,1,3
401403338,New Mexico State Aggies,W. McNair Jr.,4396012,,False,28.0,3,4,3,4,0,0,0,0,1,2,3,0,0,0,2,1,6
401403338,New Mexico State Aggies,M. McKinney Jr.,4896928,,False,12.0,3,6,2,4,1,2,0,0,1,2,3,1,2,0,1,1,7
401403338,New Mexico State Aggies,N. Pryor,4702460,,False,14.0,2,5,2,4,0,1,0,2,1,2,3,1,2,0,1,0,4
401403338,New Mexico State Aggies,TEAM,TOTAL,TOTAL,False,,24,50,17,30,7,20,20,26,10,22,32,17,6,2,11,16,75
401403338,Grand Canyon Lopes,Y. Ouedraogo,4592706,,True,24.0,0,1,0,1,0,0,1,3,4,4,8,0,2,0,2,3,1
401403338,Grand Canyon Lopes,G. McGlothan,4398356,,True,33.0,6,16,3,5,3,11,4,4,2,5,7,3,1,0,1,4,19
401403338,Grand Canyon Lopes,S. Miller-Moore,4592413,,True,17.0,1,4,1,4,0,0,0,0,2,1,3,3,0,0,2,2,2
401403338,Grand Canyon Lopes,J. Blacksher Jr.,4431826,,True,38.0,6,13,6,8,0,5,1,2,1,3,4,5,1,0,3,3,13
401403338,Grand Canyon Lopes,H. Woods,4278657,,True,40.0,8,16,5,10,3,6,5,6,2,2,4,1,2,0,2,2,24
401403338,Grand Canyon Lopes,A. Igiehon,4431697,,False,6.0,0,0,0,0,0,0,0,0,1,0,1,0,0,0,0,1,0
401403338,Grand Canyon Lopes,T. Cherry,4397024,,False,16.0,2,5,0,1,2,4,0,0,3,3,6,1,0,0,1,1,6
401403338,Grand Canyon Lopes,C. McMillian,4702027,,False,21.0,2,5,2,2,0,3,1,2,2,1,3,2,0,0,1,1,5
401403338,Grand Canyon Lopes,W. Ellis,4397649,,False,5.0,0,1,0,0,0,1,0,0,0,0,0,0,0,0,1,2,0
401403338,Grand Canyon Lopes,TEAM,TOTAL,TOTAL,False,,25,61,17,31,8,30,12,17,19,21,40,15,6,0,13,19,70
401403337,Stephen F. Austin Lumberjacks,C. Solomon,4594155,,True,15.0,1,4,1,4,0,0,2,3,1,1,2,1,1,1,4,4,4
401403337,Stephen F. Austin Lumberjacks,G. Kensmil,4279493,,True,34.0,4,7,4,7,0,0,7,8,2,5,7,1,2,2,4,3,15
401403337,Stephen F. Austin Lumberjacks,D. Tezeno,4896946,,True,21.0,2,4,2,3,0,1,3,3,2,3,5,0,1,0,1,0,7
401403337,Stephen F. Austin Lumberjacks,L. Jossell,4601284,,True,37.0,2,8,0,1,2,7,0,0,0,2,2,1,0,0,2,3,6
401403337,Stephen F. Austin Lumberjacks,D. Kachelries,4278450,,True,26.0,3,6,2,3,1,3,2,2,0,3,3,1,0,0,4,5,9
401403337,Stephen F. Austin Lumberjacks,S. Hall,4713935,,False,15.0,2,6,2,6,0,0,0,0,1,3,4,0,0,2,0,3,4
401403337,Stephen F. Austin Lumberjacks,N. Antwi-Boasiako,4703693,,False,17.0,1,4,1,4,0,0,4,4,1,2,3,0,0,0,3,3,6
401403337,Stephen F. Austin Lumberjacks,J. Aku,4592830,,False,2.0,0,1,0,1,0,0,0,0,0,1,1,0,0,0,0,1,0
401403337,Stephen F. Austin Lumberjacks,J. Jackson-Posey,4703691,,False,23.0,2,9,0,3,2,6,3,4,1,1,2,2,1,1,1,0,9
401403337,Stephen F. Austin Lumberjacks,N. Hawkins,4397862,,False,6.0,1,1,1,1,0,0,0,0,0,0,0,1,0,0,0,1,2
401403337,Stephen F. Austin Lumberjacks,D. Willis,4396753,,False,4.0,0,1,0,0,0,1,0,0,1,0,1,0,0,0,2,0,0
401403337,Stephen F. Austin Lumberjacks,TEAM,TOTAL,TOTAL,False,,18,51,13,33,5,18,21,24,11,21,32,7,5,6,22,23,62
401403337,Abilene Christian Wildcats,A. Simmons,4433077,,True,21.0,2,4,2,4,0,0,5,6,1,4,5,4,0,0,2,4,9
401403337,Abilene Christian Wildcats,C. Mason,4593750,,True,30.0,4,9,2,5,2,4,2,2,0,1,1,1,5,0,0,4,12
401403337,Abilene Christian Wildcats,M. Morris,4593748,,True,30.0,8,10,5,5,3,5,3,5,0,2,2,4,2,0,1,2,22
401403337,Abilene Christian Wildcats,R. Miller,4593747,,True,36.0,2,8,1,4,1,4,3,4,0,3,3,1,4,0,4,2,8
401403337,Abilene Christian Wildcats,T. Cameron,4278255,,True,27.0,2,5,2,4,0,1,2,2,0,7,7,4,0,2,2,1,6
401403337,Abilene Christian Wildcats,F. Cadeaux de Dieu,4896507,,False,4.0,0,1,0,1,0,0,1,2,1,0,1,0,0,0,0,1,1
401403337,Abilene Christian Wildcats,C. Steele,4703600,,False,29.0,4,7,4,7,0,0,0,0,0,3,3,1,2,0,1,3,8
401403337,Abilene Christian Wildcats,J. Jackson,4896504,,False,1.0,0,0,0,0,0,0,0,0,0,0,0,0,0,0,0,0,0
401403337,Abilene Christian Wildcats,I. Allen,4593749,,False,6.0,2,3,1,2,1,1,0,0,0,0,0,1,0,0,1,2,5
401403337,Abilene Christian Wildcats,D. Daniels,4397957,,False,16.0,2,2,2,2,0,0,1,2,0,1,1,1,0,0,2,4,5
401403337,Abilene Christian Wildcats,TEAM,TOTAL,TOTAL,False,,26,49,19,34,7,15,17,23,4,23,27,17,13,2,15,23,76
401403336,Sam Houston Bearkats,T. Ikpe,4703681,,True,29.0,3,7,3,6,0,1,4,4,3,2,5,0,1,1,1,4,10
401403336,Sam Houston Bearkats,J. Ray,4896937,,True,28.0,4,6,4,4,0,2,1,1,0,4,4,3,0,0,3,2,9
401403336,Sam Houston Bearkats,J. May,4703680,,True,28.0,1,2,0,1,1,1,1,3,0,1,1,0,2,0,0,5,4
401403336,Sam Houston Bearkats,D. Lampley,4594132,,True,34.0,5,9,1,4,4,5,3,3,0,0,0,0,1,0,0,0,17
401403336,Sam Houston Bearkats,S. Flagg,4278119,,True,38.0,9,23,8,14,1,9,1,3,1,4,5,4,2,1,0,3,20
401403336,Sam Houston Bearkats,K. Karwowski,4593103,,False,11.0,0,2,0,2,0,0,0,0,1,1,2,0,0,3,3,0,0
401403336,Sam Houston Bearkats,J. Grant,4896935,,False,15.0,0,3,0,1,0,2,0,0,0,1,1,1,0,1,0,1,0
401403336,Sam Houston Bearkats,D. Powers,4703683,,False,15.0,1,3,0,1,1,2,3,3,0,2,2,0,0,0,1,2,6
401403336,Sam Houston Bearkats,J. Cook,4703679,,False,2.0,0,0,0,0,0,0,0,0,0,0,0,0,0,0,0,1,0
401403336,Sam Houston Bearkats,TEAM,TOTAL,TOTAL,False,,23,55,16,33,7,22,13,17,7,17,24,8,6,6,8,18,66
401403336,Grand Canyon Lopes,Y. Ouedraogo,4592706,,True,24.0,2,2,2,2,0,0,0,0,0,5,5,0,0,0,2,2,4
401403336,Grand Canyon Lopes,G. McGlothan,4398356,,True,32.0,2,5,0,0,2,5,0,0,0,6,6,0,0,0,1,3,6
401403336,Grand Canyon Lopes,S. Miller-Moore,4592413,,True,16.0,1,2,1,1,0,1,2,3,1,1,2,0,1,0,1,3,4
401403336,Grand Canyon Lopes,J. Blacksher Jr.,4431826,,True,38.0,4,14,3,12,1,2,4,4,0,4,4,4,0,0,3,1,13
401403336,Grand Canyon Lopes,H. Woods,4278657,,True,33.0,8,15,5,8,3,7,5,7,0,3,3,2,1,0,3,3,24
401403336,Grand Canyon Lopes,A. Igiehon,4431697,,False,11.0,2,3,2,3,0,0,0,0,0,5,5,0,0,1,1,0,4
401403336,Grand Canyon Lopes,T. Cherry,4397024,,False,13.0,2,4,2,4,0,0,0,0,2,0,2,0,0,0,0,3,4
401403336,Grand Canyon Lopes,C. McMillian,4702027,,False,21.0,4,6,1,2,3,4,1,2,1,2,3,2,1,0,0,1,12
401403336,Grand Canyon Lopes,W. Ellis,4397649,,False,12.0,0,1,0,0,0,1,0,0,1,1,2,1,1,0,1,1,0
401403336,Grand Canyon Lopes,TEAM,TOTAL,TOTAL,False,,25,52,16,32,9,20,12,16,9,29,38,9,4,1,14,17,71
401403335,Utah Valley Wolverines,F. Aimaq,4398226,,True,36.0,8,11,8,11,0,0,4,5,2,9,11,1,0,1,3,1,20
401403335,Utah Valley Wolverines,T. Fuller,4397392,,True,14.0,1,1,1,1,0,0,0,0,2,0,2,1,1,1,1,2,2
401403335,Utah Valley Wolverines,L. Darthard,4702362,,True,28.0,5,8,2,3,3,5,0,1,0,3,3,3,1,3,1,1,13
401403335,Utah Valley Wolverines,B. Nield,4593745,,True,22.0,1,2,0,0,1,2,0,0,0,0,0,3,0,0,4,5,3
401403335,Utah Valley Wolverines,C. Harding,4397648,,True,26.0,3,7,1,1,2,6,4,4,1,4,5,3,0,0,1,3,12
401403335,Utah Valley Wolverines,A. McCord,4702366,,False,6.0,0,1,0,0,0,1,2,2,1,0,1,0,1,0,1,0,2
401403335,Utah Valley Wolverines,T. Ceaser,4593882,,False,11.0,0,0,0,0,0,0,0,0,1,3,4,2,0,1,1,0,0
401403335,Utah Valley Wolverines,J. Harmon,4896970,,False,14.0,0,4,0,2,0,2,0,0,1,1,2,1,0,0,3,2,0
401403335,Utah Valley Wolverines,J. McClanahan,4702365,,False,18.0,4,5,0,0,4,5,0,0,1,1,2,1,0,0,2,5,12
401403335,Utah Valley Wolverines,T. Woodbury,4397434,,False,25.0,2,7,1,2,1,5,5,6,0,3,3,3,1,0,3,2,10
401403335,Utah Valley Wolverines,TEAM,TOTAL,TOTAL,False,,24,46,13,20,11,26,15,18,9,24,33,18,4,6,21,21,74
401403335,Abilene Christian Wildcats,A. Simmons,4433077,,True,25.0,7,12,3,6,4,6,1,2,0,3,3,2,0,0,2,2,19
401403335,Abilene Christian Wildcats,C. Mason,4593750,,True,24.0,1,7,1,7,0,0,4,4,0,2,2,1,1,0,1,4,6
401403335,Abilene Christian Wildcats,M. Morris,4593748,,True,29.0,4,7,3,5,1,2,2,3,0,1,1,6,2,0,0,5,11
401403335,Abilene Christian Wildcats,R. Miller,4593747,,True,33.0,4,8,4,7,0,1,1,2,0,3,3,1,4,0,1,3,9
401403335,Abilene Christian Wildcats,T. Cameron,4278255,,True,32.0,6,10,3,4,3,6,2,2,1,1,2,1,1,1,3,0,17
401403335,Abilene Christian Wildcats,C. Steele,4703600,,False,23.0,5,7,2,2,3,5,0,0,1,0,1,2,0,0,1,3,13
401403335,Abilene Christian Wildcats,Y. Gai,4896508,,False,1.0,0,0,0,0,0,0,0,0,0,0,0,0,0,0,0,0,0
401403335,Abilene Christian Wildcats,J. Jackson,4896504,,False,2.0,0,0,0,0,0,0,0,0,0,0,0,0,0,0,0,0,0
401403335,Abilene Christian Wildcats,I. Allen,4593749,,False,6.0,0,1,0,1,0,0,1,2,1,1,2,0,0,0,0,2,1
401403335,Abilene Christian Wildcats,D. Daniels,4397957,,False,25.0,1,3,1,2,0,1,4,4,0,2,2,2,2,0,1,1,6
401403335,Abilene Christian Wildcats,TEAM,TOTAL,TOTAL,False,,28,55,17,34,11,21,15,19,5,14,19,15,10,1,9,20,82
401403334,Sam Houston Bearkats,T. Ikpe,4703681,,True,25.0,2,5,2,5,0,0,1,2,1,6,7,2,2,0,3,1,5
401403334,Sam Houston Bearkats,J. Ray,4896937,,True,23.0,1,5,1,4,0,1,0,0,0,1,1,3,2,0,1,3,2
401403334,Sam Houston Bearkats,J. May,4703680,,True,18.0,1,2,0,0,1,2,0,0,1,4,5,1,0,1,1,3,3
401403334,Sam Houston Bearkats,D. Lampley,4594132,,True,24.0,2,6,0,1,2,5,1,2,1,1,2,0,0,0,0,1,7
401403334,Sam Houston Bearkats,S. Flagg,4278119,,True,31.0,6,13,3,6,3,7,0,0,1,12,13,2,2,1,2,0,15
401403334,Sam Houston Bearkats,K. Martina,4896938,,False,3.0,1,1,0,0,1,1,0,0,0,0,0,0,0,0,1,1,3
401403334,Sam Houston Bearkats,K. Scroggins,4703685,,False,5.0,1,1,1,1,0,0,0,0,0,1,1,0,0,0,0,1,2
401403334,Sam Houston Bearkats,K. Karwowski,4593103,,False,13.0,1,1,1,1,0,0,1,2,2,2,4,2,1,0,3,3,3
401403334,Sam Houston Bearkats,D. Nicholas Jr.,4896936,,False,4.0,0,1,0,1,0,0,0,0,0,0,0,1,1,0,0,0,0
401403334,Sam Houston Bearkats,J. Grant,4896935,,False,17.0,4,5,3,3,1,2,3,4,0,1,1,3,4,0,1,2,12
401403334,Sam Houston Bearkats,D. Powers,4703683,,False,20.0,2,3,2,2,0,1,0,0,0,2,2,1,0,0,1,0,4
401403334,Sam Houston Bearkats,J. Cook,4703679,,False,17.0,3,8,0,1,3,7,0,0,0,0,0,1,0,0,0,1,9
401403334,Sam Houston Bearkats,TEAM,TOTAL,TOTAL,False,,24,51,13,25,11,26,6,10,6,32,38,16,12,2,14,16,65
401403334,California Baptist Lancers,D. Akin,4279163,,True,21.0,1,3,1,3,0,0,0,0,1,2,3,0,0,0,4,0,2
401403334,California Baptist Lancers,E. Thomas,4066734,,True,16.0,1,1,1,1,0,0,0,0,1,0,1,0,0,0,4,0,2
401403334,California Baptist Lancers,Ta. Armstrong,4896850,,True,31.0,3,9,2,7,1,2,4,8,2,1,3,2,0,1,2,2,11
401403334,California Baptist Lancers,Tr. Armstrong,4593806,,True,32.0,0,11,0,4,0,7,3,4,0,5,5,3,2,0,1,1,3
401403334,California Baptist Lancers,Ty Rowell,4398423,,True,32.0,2,7,0,2,2,5,0,0,1,4,5,1,0,0,1,1,6
401403334,California Baptist Lancers,T. Sawyer,4702042,,False,3.0,1,2,1,1,0,1,1,1,0,0,0,0,0,0,0,0,3
401403334,California Baptist Lancers,J. Stone,4702041,,False,13.0,4,5,4,5,0,0,0,1,1,2,3,0,0,0,0,3,8
401403334,California Baptist Lancers,M. Wade,4702040,,False,6.0,0,0,0,0,0,0,0,0,0,1,1,0,0,0,1,0,0
401403334,California Baptist Lancers,C. Hunter,4592943,,False,10.0,0,4,0,0,0,4,0,0,1,2,3,0,0,0,1,1,0
401403334,California Baptist Lancers,A. Ruiz Ortiz,4896851,,False,1.0,0,0,0,0,0,0,0,0,0,0,0,0,0,0,0,0,0
401403334,California Baptist Lancers,T. Kund,4702038,,False,3.0,0,1,0,0,0,1,0,0,0,0,0,0,0,0,0,0,0
401403334,California Baptist Lancers,F. Dybala,4702037,,False,3.0,0,0,0,0,0,0,0,0,0,0,0,0,0,0,1,0,0
401403334,California Baptist Lancers,T. Campbell,4702036,,False,3.0,0,0,0,0,0,0,0,0,0,1,1,0,0,0,0,0,0
401403334,California Baptist Lancers,R. Nottage,4593807,,False,26.0,0,6,0,0,0,6,0,0,0,1,1,0,1,0,1,0,0
401403334,California Baptist Lancers,TEAM,TOTAL,TOTAL,False,,12,49,9,23,3,26,8,14,8,21,29,6,3,1,16,8,35
401403333,Utah Valley Wolverines,F. Aimaq,4398226,,True,31.0,7,11,5,9,2,2,4,6,1,5,6,1,0,0,0,1,20
401403333,Utah Valley Wolverines,T. Fuller,4397392,,True,16.0,3,3,3,3,0,0,0,2,2,0,2,1,1,2,2,4,6
401403333,Utah Valley Wolverines,L. Darthard,4702362,,True,26.0,2,7,1,4,1,3,0,0,0,3,3,0,0,0,0,1,5
401403333,Utah Valley Wolverines,B. Nield,4593745,,True,22.0,5,6,5,5,0,1,2,2,0,3,3,6,0,0,1,1,12
401403333,Utah Valley Wolverines,C. Harding,4397648,,True,27.0,2,4,1,3,1,1,0,0,0,2,2,1,0,2,1,0,5
401403333,Utah Valley Wolverines,A. McCord,4702366,,False,5.0,0,1,0,1,0,0,2,2,0,0,0,0,1,0,0,0,2
401403333,Utah Valley Wolverines,T. Farrer,4702363,,False,8.0,0,0,0,0,0,0,1,2,1,2,3,0,0,1,0,1,1
401403333,Utah Valley Wolverines,B. Anderson,4702360,,False,1.0,0,0,0,0,0,0,0,0,0,0,0,0,0,0,0,0,0
401403333,Utah Valley Wolverines,T. Ceaser,4593882,,False,8.0,2,3,2,3,0,0,0,0,1,2,3,0,1,1,2,1,4
401403333,Utah Valley Wolverines,J. Harmon,4896970,,False,18.0,1,5,0,4,1,1,4,4,0,7,7,1,0,0,1,1,7
401403333,Utah Valley Wolverines,J. Battle,4896969,,False,1.0,0,0,0,0,0,0,0,0,0,0,0,0,0,0,0,0,0
401403333,Utah Valley Wolverines,J. McClanahan,4702365,,False,18.0,1,2,1,2,0,0,0,0,1,1,2,2,0,0,1,1,2
401403333,Utah Valley Wolverines,T. Woodbury,4397434,,False,16.0,2,8,1,5,1,3,0,0,2,2,4,2,0,0,1,1,5
401403333,Utah Valley Wolverines,C. Leifson,4066653,,False,3.0,0,1,0,1,0,0,0,0,0,0,0,0,0,0,0,0,0
401403333,Utah Valley Wolverines,TEAM,TOTAL,TOTAL,False,,25,51,19,40,6,11,13,18,11,30,41,14,3,6,11,12,69
401403333,Chicago State Cougars,N. Bigirumwami,4396020,,True,24.0,1,3,0,1,1,2,0,0,2,4,6,1,0,0,1,4,3
401403333,Chicago State Cougars,T. Bayi Ba Mandeng,4896865,,True,28.0,1,4,1,4,0,0,0,0,2,2,4,2,1,1,3,2,2
401403333,Chicago State Cougars,F. Chukwukelu,4896867,,True,20.0,1,4,1,1,0,3,0,0,0,0,0,1,0,0,0,0,2
401403333,Chicago State Cougars,B. Betson,4896861,,True,36.0,4,19,2,10,2,9,2,4,1,3,4,2,0,0,1,4,12
401403333,Chicago State Cougars,J. Corbett,4896860,,True,37.0,8,18,5,12,3,6,2,2,4,4,8,0,1,2,1,1,21
401403333,Chicago State Cougars,K. Green,4896864,,False,16.0,0,4,0,2,0,2,0,0,0,0,0,0,0,0,0,3,0
401403333,Chicago State Cougars,B. Johnson,4896859,,False,19.0,1,3,1,2,0,1,0,0,0,2,2,0,0,0,0,3,2
401403333,Chicago State Cougars,J. Harris,4896857,,False,20.0,2,8,1,4,1,4,0,2,1,2,3,0,0,0,0,2,5
401403333,Chicago State Cougars,TEAM,TOTAL,TOTAL,False,,18,63,11,36,7,27,4,8,13,17,30,6,2,3,9,19,47
401403332,UT Rio Grande Valley Vaqueros,R. Taylor,4896966,,True,11.0,0,1,0,1,0,0,0,0,2,2,4,0,0,0,2,4,0
401403332,UT Rio Grande Valley Vaqueros,M. Nelson,4279122,,True,40.0,7,13,7,11,0,2,3,5,2,7,9,2,3,0,3,3,17
401403332,UT Rio Grande Valley Vaqueros,J. Johnson,4703110,,True,21.0,2,5,2,3,0,2,2,2,1,4,5,0,0,0,2,4,6
401403332,UT Rio Grande Valley Vaqueros,R. Nelson,4278672,,True,40.0,2,5,2,5,0,0,0,0,0,1,1,6,2,0,1,1,4
401403332,UT Rio Grande Valley Vaqueros,M. Adewunmi,4278256,,True,36.0,6,17,4,10,2,7,0,0,2,6,8,1,2,0,2,2,14
401403332,UT Rio Grande Valley Vaqueros,D. Houston Jr.,4896965,,False,17.0,1,1,1,1,0,0,1,2,1,1,2,0,0,0,1,4,3
401403332,UT Rio Grande Valley Vaqueros,X. Johnson,4597988,,False,26.0,9,19,5,9,4,10,5,5,0,2,2,0,0,0,2,4,27
401403332,UT Rio Grande Valley Vaqueros,Q. Johnson II,4395996,,False,9.0,3,4,2,3,1,1,2,2,0,0,0,2,0,0,0,1,9
401403332,UT Rio Grande Valley Vaqueros,TEAM,TOTAL,TOTAL,False,,30,65,23,43,7,22,13,16,10,23,33,11,7,0,13,23,80
401403332,California Baptist Lancers,D. Akin,4279163,,True,29.0,0,2,0,1,0,1,4,4,3,9,12,0,1,0,1,1,4
401403332,California Baptist Lancers,E. Thomas,4066734,,True,14.0,2,4,2,4,0,0,0,1,2,2,4,1,0,0,3,4,4
401403332,California Baptist Lancers,Ta. Armstrong,4896850,,True,29.0,4,6,4,5,0,1,5,8,0,6,6,5,0,0,5,4,13
401403332,California Baptist Lancers,Tr. Armstrong,4593806,,True,36.0,5,12,2,4,3,8,0,1,0,2,2,1,1,0,4,3,13
401403332,California Baptist Lancers,Ty Rowell,4398423,,True,39.0,3,5,0,0,3,5,3,3,0,0,0,2,1,0,4,1,12
401403332,California Baptist Lancers,J. Stone,4702041,,False,16.0,5,6,5,6,0,0,1,4,1,0,1,2,0,1,0,0,11
401403332,California Baptist Lancers,C. Hunter,4592943,,False,15.0,5,7,3,3,2,4,0,0,1,3,4,0,1,0,2,3,12
401403332,California Baptist Lancers,T. Campbell,4702036,,False,2.0,0,0,0,0,0,0,0,0,0,0,0,0,0,0,0,0,0
401403332,California Baptist Lancers,R. Nottage,4593807,,False,20.0,4,9,1,3,3,6,1,1,0,0,0,1,0,1,0,4,12
401403332,California Baptist Lancers,TEAM,TOTAL,TOTAL,False,,28,51,17,26,11,25,14,22,8,22,30,12,4,2,19,20,81
401403331,Furman Paladins,J. Slawson,4398207,,True,32.0,3,11,1,2,2,9,0,0,0,4,4,1,0,3,2,4,8
401403331,Furman Paladins,C. Garrison,4897385,,True,35.0,1,4,1,1,0,3,0,0,1,3,4,2,0,0,1,0,2
401403331,Furman Paladins,M. Foster,4431953,,True,22.0,2,5,2,3,0,2,1,2,0,3,3,0,2,0,1,0,5
401403331,Furman Paladins,M. Bothwell,4398203,,True,40.0,9,13,6,8,3,5,3,3,2,3,5,2,2,1,2,0,24
401403331,Furman Paladins,A. Hunter,4280016,,True,39.0,4,11,0,1,4,10,0,0,0,5,5,2,1,0,1,1,12
401403331,Furman Paladins,T. Hughey,4897382,,False,8.0,0,0,0,0,0,0,0,2,0,2,2,0,0,2,1,2,0
401403331,Furman Paladins,G. Hien,4703810,,False,27.0,4,7,4,5,0,2,0,0,2,1,3,1,0,0,1,1,8
401403331,Furman Paladins,JP Pegues,4897381,,False,13.0,0,1,0,0,0,1,4,4,0,1,1,1,1,0,0,1,4
401403331,Furman Paladins,J. Anderson,4703811,,False,9.0,0,0,0,0,0,0,0,0,0,0,0,0,1,0,0,2,0
401403331,Furman Paladins,TEAM,TOTAL,TOTAL,False,,23,52,14,20,9,32,8,11,5,25,30,9,7,6,10,11,63
401403331,Chattanooga Mocs,KC Hankton,4397200,,True,24.0,4,6,4,4,0,2,0,0,0,3,3,0,1,0,0,1,8
401403331,Chattanooga Mocs,S. De Sousa,4292484,,True,30.0,7,10,7,10,0,0,3,5,6,8,14,0,0,1,1,2,17
401403331,Chattanooga Mocs,D. Banks,4279210,,True,40.0,1,3,1,2,0,1,2,2,0,3,3,6,0,0,2,2,4
401403331,Chattanooga Mocs,M. Smith,4397784,,True,42.0,5,15,4,12,1,3,1,1,4,4,8,4,2,0,5,1,12
401403331,Chattanooga Mocs,D. Jean-Baptiste,4067255,,True,37.0,5,17,2,7,3,10,0,0,0,2,2,0,0,0,0,1,13
401403331,Chattanooga Mocs,J. Ayeni,4066518,,False,10.0,2,3,2,2,0,1,0,0,0,2,2,0,0,0,2,2,4
401403331,Chattanooga Mocs,A. Diggs,4278461,,False,2.0,0,0,0,0,0,0,0,0,0,0,0,0,0,0,0,0,0
401403331,Chattanooga Mocs,G. Ledford,4433029,,False,14.0,0,2,0,0,0,2,0,0,0,1,1,0,0,0,0,2,0
401403331,Chattanooga Mocs,A.J. Caldwell,4280264,,False,26.0,2,6,0,0,2,6,0,0,0,2,2,2,0,0,1,1,6
401403331,Chattanooga Mocs,TEAM,TOTAL,TOTAL,False,,26,62,20,37,6,25,6,8,12,26,38,12,3,1,11,12,64
401403330,Samford Bulldogs,J. Marshall,4703575,,True,36.0,7,11,3,4,4,7,4,5,2,10,12,2,2,0,3,4,22
401403330,Samford Bulldogs,L. Dye,4398246,,True,30.0,2,4,2,3,0,1,0,0,1,6,7,2,0,1,2,4,4
401403330,Samford Bulldogs,J. Campbell,4897375,,True,33.0,4,4,2,2,2,2,4,6,2,2,4,1,1,0,3,3,14
401403330,Samford Bulldogs,Q. Glover,4592827,,True,37.0,7,14,5,11,2,3,7,10,0,1,1,4,2,0,6,3,23
401403330,Samford Bulldogs,C. Kaifes,4397430,,True,35.0,1,4,0,0,1,4,0,0,1,5,6,2,1,0,2,2,3
401403330,Samford Bulldogs,J. Tryon,4397718,,False,14.0,1,2,1,2,0,0,0,0,0,1,1,2,0,0,1,1,2
401403330,Samford Bulldogs,J. Rillie,4703836,,False,10.0,0,1,0,0,0,1,0,0,0,0,0,0,0,0,2,2,0
401403330,Samford Bulldogs,R. Maitre,4397488,,False,5.0,0,0,0,0,0,0,0,1,0,0,0,0,1,0,0,0,0
401403330,Samford Bulldogs,TEAM,TOTAL,TOTAL,False,,22,40,13,22,9,18,15,22,7,25,32,13,7,1,20,19,68
401403330,Furman Paladins,J. Slawson,4398207,,True,30.0,4,8,2,3,2,5,7,9,2,5,7,2,1,1,2,3,17
401403330,Furman Paladins,C. Garrison,4897385,,True,36.0,3,10,1,1,2,9,2,2,1,3,4,2,5,0,0,2,10
401403330,Furman Paladins,M. Foster,4431953,,True,22.0,3,8,2,4,1,4,1,1,0,1,1,2,1,0,1,2,8
401403330,Furman Paladins,M. Bothwell,4398203,,True,32.0,6,12,4,8,2,4,3,5,1,3,4,3,3,0,2,5,17
401403330,Furman Paladins,A. Hunter,4280016,,True,35.0,3,10,1,2,2,8,1,2,2,0,2,2,2,0,2,3,9
401403330,Furman Paladins,T. Hughey,4897382,,False,10.0,1,2,1,2,0,0,0,1,1,2,3,0,1,0,1,3,2
401403330,Furman Paladins,G. Hien,4703810,,False,22.0,4,4,4,4,0,0,0,0,1,1,2,2,2,0,1,2,8
401403330,Furman Paladins,JP Pegues,4897381,,False,8.0,0,1,0,0,0,1,0,0,1,0,1,1,0,0,1,0,0
401403330,Furman Paladins,J. Anderson,4703811,,False,5.0,0,1,0,0,0,1,0,0,0,0,0,0,0,0,0,0,0
401403330,Furman Paladins,TEAM,TOTAL,TOTAL,False,,24,56,15,24,9,32,14,20,10,16,26,14,15,1,10,20,71
401403329,Wofford Terriers,B.J. Mack,4431837,,True,32.0,8,16,6,10,2,6,2,4,2,8,10,1,2,0,2,2,20
401403329,Wofford Terriers,A. Patterson,4710625,,True,23.0,1,1,1,1,0,0,3,5,0,1,1,0,1,0,1,0,5
401403329,Wofford Terriers,M. Klesmit,4703885,,True,36.0,5,11,5,8,0,3,1,3,1,0,1,1,1,0,5,3,11
401403329,Wofford Terriers,M. Safford,4593739,,True,35.0,5,6,1,1,4,5,0,0,0,2,2,0,2,0,1,1,14
401403329,Wofford Terriers,R. Larson,4398276,,True,34.0,1,4,1,3,0,1,0,0,0,0,0,3,1,0,1,1,2
401403329,Wofford Terriers,S. Godwin,4703886,,False,9.0,1,4,1,4,0,0,0,0,0,0,0,0,1,0,1,5,2
401403329,Wofford Terriers,L. Turner,4684160,,False,8.0,0,2,0,1,0,1,0,0,0,0,0,0,0,0,0,1,0
401403329,Wofford Terriers,I. Bigelow,4398275,,False,15.0,1,4,1,3,0,1,0,0,0,2,2,1,0,0,1,2,2
401403329,Wofford Terriers,D. Appelgren,4593740,,False,0.0,0,0,0,0,0,0,0,0,0,0,0,0,0,0,0,0,0
401403329,Wofford Terriers,C. Tripp,4897355,,False,8.0,0,0,0,0,0,0,0,0,0,0,0,0,0,0,1,0,0
401403329,Wofford Terriers,J. Steelman,4593741,,False,0.0,0,0,0,0,0,0,0,0,0,0,0,0,0,0,0,0,0
401403329,Wofford Terriers,TEAM,TOTAL,TOTAL,False,,22,48,16,31,6,17,6,12,5,15,20,6,8,0,13,15,56
401403329,Chattanooga Mocs,KC Hankton,4397200,,True,21.0,2,2,2,2,0,0,0,0,1,2,3,1,1,0,2,0,4
401403329,Chattanooga Mocs,S. De Sousa,4292484,,True,21.0,4,6,4,6,0,0,4,4,3,2,5,3,2,1,3,4,12
401403329,Chattanooga Mocs,D. Banks,4279210,,True,31.0,6,10,5,8,1,2,4,6,0,0,0,1,3,0,1,2,17
401403329,Chattanooga Mocs,M. Smith,4397784,,True,34.0,9,14,6,10,3,4,4,4,2,9,11,2,2,0,1,0,25
401403329,Chattanooga Mocs,D. Jean-Baptiste,4067255,,True,33.0,5,10,4,5,1,5,3,5,0,2,2,1,1,0,1,0,14
401403329,Chattanooga Mocs,J. Frazier,4431955,,False,2.0,0,0,0,0,0,0,0,0,0,0,0,0,0,0,0,1,0
401403329,Chattanooga Mocs,J. Ayeni,4066518,,False,4.0,0,0,0,0,0,0,0,0,0,2,2,0,0,0,0,3,0
401403329,Chattanooga Mocs,A. Diggs,4278461,,False,11.0,1,3,1,3,0,0,2,2,1,3,4,0,0,1,1,1,4
401403329,Chattanooga Mocs,G. Ledford,4433029,,False,16.0,1,2,1,1,0,1,0,0,0,1,1,0,0,1,1,3,2
401403329,Chattanooga Mocs,T. Stricklen,4398327,,False,5.0,0,0,0,0,0,0,0,0,0,0,0,0,0,0,0,0,0
401403329,Chattanooga Mocs,A.J. Caldwell,4280264,,False,22.0,0,1,0,0,0,1,1,2,1,1,2,0,1,0,1,1,1
401403329,Chattanooga Mocs,TEAM,TOTAL,TOTAL,False,,28,48,23,35,5,13,18,23,8,24,32,8,10,3,11,15,79
401403328,UNC Greensboro Spartans,B. Leyte,4593682,,True,30.0,4,8,4,8,0,0,6,10,4,2,6,2,2,0,1,3,14
401403328,UNC Greensboro Spartans,M. Abdulsalam,4398232,,True,31.0,6,8,6,8,0,0,1,1,2,0,2,2,1,0,5,2,13
401403328,UNC Greensboro Spartans,Ko. Langley,4433026,,True,31.0,1,8,0,2,1,6,0,0,0,4,4,3,1,0,2,4,3
401403328,UNC Greensboro Spartans,D. Treacy,4397989,,True,36.0,6,10,2,4,4,6,0,0,0,2,2,5,0,0,2,3,16
401403328,UNC Greensboro Spartans,D. Buckingham,4066833,,True,31.0,6,11,5,7,1,4,0,1,3,5,8,1,0,0,2,2,13
401403328,UNC Greensboro Spartans,J. White,4594139,,False,7.0,1,2,1,2,0,0,1,2,0,0,0,0,0,0,0,0,3
401403328,UNC Greensboro Spartans,M. Jones,4592762,,False,2.0,0,0,0,0,0,0,0,0,0,1,1,0,0,0,0,0,0
401403328,UNC Greensboro Spartans,J.C. Tharrington,4433098,,False,3.0,0,0,0,0,0,0,0,0,0,1,1,0,0,0,0,0,0
401403328,UNC Greensboro Spartans,Ke. Langley,4431864,,False,14.0,0,2,0,0,0,2,0,0,1,0,1,1,1,0,0,4,0
401403328,UNC Greensboro Spartans,K. Hunter,4280038,,False,15.0,0,4,0,0,0,4,2,2,0,1,1,0,0,0,0,0,2
401403328,UNC Greensboro Spartans,TEAM,TOTAL,TOTAL,False,,24,53,18,31,6,22,10,16,15,17,32,14,5,0,12,18,64
401403328,Samford Bulldogs,J. Marshall,4703575,,True,21.0,2,3,0,1,2,2,4,6,0,5,5,1,0,0,2,4,10
401403328,Samford Bulldogs,L. Dye,4398246,,True,36.0,7,14,3,8,4,6,1,2,4,4,8,0,1,2,2,1,19
401403328,Samford Bulldogs,J. Campbell,4897375,,True,36.0,3,8,2,3,1,5,0,0,1,2,3,2,1,0,1,1,7
401403328,Samford Bulldogs,Q. Glover,4592827,,True,36.0,7,17,7,13,0,4,5,7,1,1,2,7,1,0,2,3,19
401403328,Samford Bulldogs,C. Kaifes,4397430,,True,29.0,3,4,0,0,3,4,0,0,3,3,6,0,4,0,0,0,9
401403328,Samford Bulldogs,D. Lobach,4592735,,False,3.0,0,0,0,0,0,0,0,0,1,1,2,0,0,0,0,1,0
401403328,Samford Bulldogs,J. Tryon,4397718,,False,19.0,0,2,0,0,0,2,2,2,1,0,1,0,1,1,0,4,2
401403328,Samford Bulldogs,J. Rillie,4703836,,False,8.0,0,2,0,0,0,2,0,0,0,0,0,0,0,0,1,0,0
401403328,Samford Bulldogs,Q. Richey,4432096,,False,1.0,0,0,0,0,0,0,0,0,0,0,0,0,0,0,0,0,0
401403328,Samford Bulldogs,R. Maitre,4397488,,False,11.0,0,0,0,0,0,0,0,0,1,1,2,0,0,0,2,2,0
401403328,Samford Bulldogs,TEAM,TOTAL,TOTAL,False,,22,50,12,25,10,25,12,17,13,17,30,10,8,3,12,16,66
401403327,Mercer Bears,J. Glisson III,4593676,,True,26.0,2,3,2,2,0,1,0,0,1,2,3,1,1,0,4,2,4
401403327,Mercer Bears,F. Haase,4278110,,True,33.0,6,9,5,7,1,2,3,3,1,5,6,0,0,1,3,3,16
401403327,Mercer Bears,S. Walker Jr.,4897379,,True,28.0,2,5,1,2,1,3,0,0,0,1,1,1,0,0,0,2,5
401403327,Mercer Bears,K. Robertson,4593674,,True,38.0,8,15,8,13,0,2,4,5,0,7,7,4,0,0,0,2,20
401403327,Mercer Bears,J. Johnson,4066216,,True,29.0,3,9,2,4,1,5,0,0,1,0,1,3,0,1,0,1,7
401403327,Mercer Bears,V. Bafutto,4280036,,False,11.0,3,4,3,4,0,0,0,0,1,2,3,0,0,1,1,3,6
401403327,Mercer Bears,S. Grant,4703815,,False,7.0,1,3,1,3,0,0,0,2,1,0,1,0,0,0,0,0,2
401403327,Mercer Bears,J. Jones,4897378,,False,13.0,1,1,1,1,0,0,0,0,0,0,0,0,0,0,1,0,2
401403327,Mercer Bears,J. Tucker,4703816,,False,15.0,2,2,2,2,0,0,0,0,0,2,2,1,0,0,0,0,4
401403327,Mercer Bears,TEAM,TOTAL,TOTAL,False,,28,51,25,38,3,13,7,10,5,20,25,10,1,3,9,13,66
401403327,Furman Paladins,J. Slawson,4398207,,True,27.0,4,8,4,6,0,2,7,7,0,4,4,1,0,1,0,2,15
401403327,Furman Paladins,C. Garrison,4897385,,True,29.0,6,8,3,3,3,5,0,1,0,2,2,4,1,0,0,2,15
401403327,Furman Paladins,M. Foster,4431953,,True,30.0,2,6,2,4,0,2,2,2,0,2,2,1,3,0,0,1,6
401403327,Furman Paladins,M. Bothwell,4398203,,True,32.0,5,9,4,7,1,2,3,4,1,1,2,2,1,0,1,2,14
401403327,Furman Paladins,A. Hunter,4280016,,True,32.0,4,8,2,3,2,5,3,3,0,1,1,3,1,0,0,1,13
401403327,Furman Paladins,A. Williams,4897383,,False,2.0,1,1,0,0,1,1,0,0,0,0,0,0,0,0,0,1,3
401403327,Furman Paladins,T. Hughey,4897382,,False,9.0,0,0,0,0,0,0,0,0,1,2,3,0,0,0,1,1,0
401403327,Furman Paladins,G. Hien,4703810,,False,14.0,2,4,2,4,0,0,0,0,0,0,0,2,0,0,1,2,4
401403327,Furman Paladins,JP Pegues,4897381,,False,21.0,3,7,1,2,2,5,2,2,0,5,5,2,1,1,1,0,10
401403327,Furman Paladins,J. Anderson,4703811,,False,4.0,0,0,0,0,0,0,0,0,0,0,0,1,0,0,0,1,0
401403327,Furman Paladins,TEAM,TOTAL,TOTAL,False,,27,51,18,29,9,22,17,19,5,19,24,16,7,2,4,13,80
401403326,Wofford Terriers,B.J. Mack,4431837,,True,25.0,5,16,3,13,2,3,3,4,4,6,10,2,2,0,2,2,15
401403326,Wofford Terriers,A. Patterson,4710625,,True,37.0,2,5,0,0,2,5,2,2,0,3,3,0,3,0,0,0,8
401403326,Wofford Terriers,M. Klesmit,4703885,,True,30.0,6,11,4,5,2,6,1,1,0,1,1,1,1,0,2,2,15
401403326,Wofford Terriers,M. Safford,4593739,,True,33.0,6,8,3,3,3,5,2,3,2,5,7,4,0,0,1,1,17
401403326,Wofford Terriers,R. Larson,4398276,,True,36.0,1,8,1,2,0,6,0,0,0,5,5,2,3,0,2,3,2
401403326,Wofford Terriers,S. Godwin,4703886,,False,15.0,4,8,4,8,0,0,0,0,0,1,1,1,0,1,0,1,8
401403326,Wofford Terriers,L. Turner,4684160,,False,6.0,0,0,0,0,0,0,0,0,0,0,0,0,0,0,0,0,0
401403326,Wofford Terriers,I. Bigelow,4398275,,False,14.0,1,3,1,1,0,2,1,2,1,2,3,1,0,0,1,0,3
401403326,Wofford Terriers,C. Tripp,4897355,,False,4.0,0,1,0,0,0,1,0,0,0,0,0,0,0,0,0,0,0
401403326,Wofford Terriers,TEAM,TOTAL,TOTAL,False,,25,60,16,32,9,28,9,12,10,26,36,11,9,1,8,9,68
401403326,VMI Keydets,J. Stephens,4398257,,True,33.0,7,18,2,7,5,11,4,4,1,4,5,3,1,1,5,2,23
401403326,VMI Keydets,H. Huff,4897365,,True,38.0,3,8,2,3,1,5,0,0,0,3,3,5,0,0,0,2,7
401403326,VMI Keydets,T. Bonham,4703868,,True,37.0,7,10,5,7,2,3,1,1,1,6,7,4,1,0,4,1,17
401403326,VMI Keydets,S. Conway,4593716,,True,21.0,0,1,0,0,0,1,0,0,0,4,4,1,0,0,0,1,0
401403326,VMI Keydets,K. Curfman,4593713,,True,36.0,4,11,2,3,2,8,0,0,1,3,4,2,2,0,1,1,10
401403326,VMI Keydets,C. Arnold,4398256,,False,2.0,1,1,1,1,0,0,0,0,0,0,0,0,0,0,0,0,2
401403326,VMI Keydets,DJ Nussbaum,4703872,,False,5.0,0,0,0,0,0,0,0,0,0,1,1,0,0,1,0,2,0
401403326,VMI Keydets,B. Watkins,4897364,,False,4.0,2,3,1,1,1,2,0,0,0,0,0,0,1,0,0,0,5
401403326,VMI Keydets,T. Mans,4703870,,False,24.0,1,2,1,1,0,1,0,0,0,2,2,0,0,1,1,2,2
401403326,VMI Keydets,TEAM,TOTAL,TOTAL,False,,25,54,14,23,11,31,5,5,3,27,30,15,5,3,11,11,66
401403325,The Citadel Bulldogs,S. Clark,4593469,,True,33.0,6,11,5,8,1,3,1,4,0,5,5,1,0,0,0,3,14
401403325,The Citadel Bulldogs,H. Brown,4280014,,True,38.0,5,11,4,8,1,3,6,10,0,6,6,1,0,0,1,5,17
401403325,The Citadel Bulldogs,J. Roche,4897373,,True,37.0,3,8,2,2,1,6,0,0,2,3,5,1,2,0,1,2,7
401403325,The Citadel Bulldogs,D. Maynard,4280049,,True,36.0,4,6,3,3,1,3,2,2,2,2,4,1,0,0,0,1,11
401403325,The Citadel Bulldogs,T. Moffe,3948762,,True,34.0,5,13,2,7,3,6,0,1,0,1,1,5,0,0,4,3,13
401403325,The Citadel Bulldogs,B. Spence,4593471,,False,1.0,0,0,0,0,0,0,0,0,0,0,0,0,0,0,0,1,0
401403325,The Citadel Bulldogs,B. Davis,4703801,,False,10.0,1,3,1,2,0,1,0,0,0,2,2,0,1,0,2,2,2
401403325,The Citadel Bulldogs,R. Fitzgibbons III,4593470,,False,11.0,1,5,1,4,0,1,0,0,0,0,0,1,1,0,0,0,2
401403325,The Citadel Bulldogs,TEAM,TOTAL,TOTAL,False,,25,57,18,34,7,23,9,17,6,22,28,10,4,0,8,17,66
401403325,Chattanooga Mocs,KC Hankton,4397200,,True,27.0,6,9,5,6,1,3,0,0,2,5,7,1,1,0,0,1,13
401403325,Chattanooga Mocs,S. De Sousa,4292484,,True,13.0,1,2,1,2,0,0,0,0,1,5,6,0,1,0,0,4,2
401403325,Chattanooga Mocs,D. Banks,4279210,,True,32.0,0,2,0,0,0,2,2,2,1,3,4,6,0,0,3,2,2
401403325,Chattanooga Mocs,M. Smith,4397784,,True,35.0,6,15,5,11,1,4,6,8,1,3,4,1,1,0,0,2,19
401403325,Chattanooga Mocs,D. Jean-Baptiste,4067255,,True,32.0,6,12,4,6,2,6,6,6,0,2,2,2,1,0,3,0,20
401403325,Chattanooga Mocs,J. Ayeni,4066518,,False,6.0,1,3,1,3,0,0,2,2,1,1,2,0,0,0,1,3,4
401403325,Chattanooga Mocs,A. Diggs,4278461,,False,11.0,3,3,3,3,0,0,0,0,0,4,4,0,1,1,1,1,6
401403325,Chattanooga Mocs,G. Ledford,4433029,,False,15.0,1,4,1,1,0,3,1,2,0,2,2,1,0,0,1,0,3
401403325,Chattanooga Mocs,T. Stricklen,4398327,,False,8.0,1,1,1,1,0,0,0,0,1,1,2,0,1,0,0,0,2
401403325,Chattanooga Mocs,A.J. Caldwell,4280264,,False,21.0,0,4,0,0,0,4,0,0,1,3,4,0,0,0,1,2,0
401403325,Chattanooga Mocs,TEAM,TOTAL,TOTAL,False,,25,55,21,33,4,22,17,20,8,31,39,11,6,1,10,15,71
401403324,Western Carolina Catamounts,M. Gilmore,4897360,,True,12.0,0,1,0,1,0,0,0,0,3,1,4,1,0,0,1,3,0
401403324,Western Carolina Catamounts,T. Harris,4593721,,True,27.0,0,5,0,0,0,5,0,0,0,1,1,0,1,0,3,0,0
401403324,Western Carolina Catamounts,M. Banks,4897361,,True,27.0,3,8,2,2,1,6,0,0,1,3,4,0,2,0,0,3,7
401403324,Western Carolina Catamounts,C. Bacote,4279797,,True,31.0,3,10,0,6,3,4,2,2,0,0,0,1,0,0,2,1,11
401403324,Western Carolina Catamounts,N. Robinson,4066509,,True,36.0,6,18,5,11,1,7,1,3,2,10,12,5,0,1,2,4,14
401403324,Western Carolina Catamounts,J. Petrakis,4592211,,False,24.0,3,7,0,0,3,7,1,2,1,1,2,0,0,1,1,0,10
401403324,Western Carolina Catamounts,M. Price,4897358,,False,13.0,0,2,0,0,0,2,0,0,0,1,1,0,0,0,2,1,0
401403324,Western Carolina Catamounts,V. Woolbright,4897357,,False,30.0,5,8,5,7,0,1,1,2,2,4,6,2,1,0,2,0,11
401403324,Western Carolina Catamounts,TEAM,TOTAL,TOTAL,False,,20,59,12,27,8,32,5,9,9,22,31,9,4,2,13,12,53
401403324,Mercer Bears,J. Glisson III,4593676,,True,27.0,5,7,4,5,1,2,2,2,2,0,2,3,0,1,0,0,13
401403324,Mercer Bears,S. Grant,4703815,,True,11.0,2,5,2,5,0,0,0,0,0,2,2,1,0,0,2,2,4
401403324,Mercer Bears,S. Walker Jr.,4897379,,True,25.0,3,5,2,3,1,2,0,0,0,3,3,1,3,0,0,0,7
401403324,Mercer Bears,J. Jones,4897378,,True,10.0,1,1,0,0,1,1,0,0,0,1,1,0,0,0,1,2,3
401403324,Mercer Bears,K. Robertson,4593674,,True,31.0,6,11,5,9,1,2,3,5,1,11,12,4,1,0,3,2,16
401403324,Mercer Bears,V. Bafutto,4280036,,False,4.0,1,1,1,1,0,0,0,0,1,0,1,0,0,1,2,1,2
401403324,Mercer Bears,F. Haase,4278110,,False,30.0,4,8,2,4,2,4,0,0,0,3,3,4,2,0,2,0,10
401403324,Mercer Bears,H. Drake,4897380,,False,4.0,0,0,0,0,0,0,0,0,0,0,0,0,0,0,0,0,0
401403324,Mercer Bears,J. Greco,4703818,,False,9.0,1,2,0,0,1,2,1,3,0,1,1,0,0,0,0,0,4
401403324,Mercer Bears,J. Tucker,4703816,,False,23.0,3,7,2,6,1,1,0,0,0,2,2,2,2,0,1,2,7
401403324,Mercer Bears,D. Rivera,4593675,,False,4.0,2,2,2,2,0,0,0,0,0,1,1,0,0,0,0,0,4
401403324,Mercer Bears,J. Johnson,4066216,,False,22.0,4,10,1,4,3,6,0,0,1,3,4,0,1,2,0,3,11
401403324,Mercer Bears,TEAM,TOTAL,TOTAL,False,,32,59,21,39,11,20,6,10,7,32,39,15,9,4,11,12,81
401403323,The Citadel Bulldogs,S. Clark,4593469,,True,43.0,0,4,0,3,0,1,1,2,1,9,10,8,0,2,1,3,1
401403323,The Citadel Bulldogs,H. Brown,4280014,,True,42.0,11,19,11,17,0,2,5,6,2,15,17,1,2,0,3,3,27
401403323,The Citadel Bulldogs,J. Roche,4897373,,True,43.0,3,10,0,3,3,7,5,6,0,2,2,2,1,0,2,3,14
401403323,The Citadel Bulldogs,D. Maynard,4280049,,True,23.0,3,4,1,1,2,3,4,4,0,0,0,1,0,0,2,3,12
401403323,The Citadel Bulldogs,T. Moffe,3948762,,True,45.0,8,16,5,8,3,8,3,5,0,3,3,4,0,0,1,1,22
401403323,The Citadel Bulldogs,B. Spence,4593471,,False,1.0,0,0,0,0,0,0,0,0,0,0,0,0,0,0,0,1,0
401403323,The Citadel Bulldogs,B. Davis,4703801,,False,21.0,2,5,1,3,1,2,3,5,2,1,3,0,1,0,0,1,8
401403323,The Citadel Bulldogs,R. Fitzgibbons III,4593470,,False,7.0,0,2,0,2,0,0,0,0,1,0,1,0,0,0,0,0,0
401403323,The Citadel Bulldogs,TEAM,TOTAL,TOTAL,False,,27,60,18,37,9,23,21,28,9,32,41,16,4,2,9,15,84
401403323,East Tennessee State Buccaneers,Ty Brewer,4594149,,True,39.0,6,16,5,11,1,5,1,2,3,7,10,0,1,0,1,5,14
401403323,East Tennessee State Buccaneers,J. Seymour,4432433,,True,19.0,3,4,3,3,0,1,1,1,1,6,7,2,0,1,1,4,7
401403323,East Tennessee State Buccaneers,J. King,4593372,,True,45.0,4,17,2,11,2,6,1,1,1,2,3,2,2,1,1,1,11
401403323,East Tennessee State Buccaneers,D. Sloan,4592212,,True,40.0,7,13,5,6,2,7,1,2,1,3,4,2,0,0,0,5,17
401403323,East Tennessee State Buccaneers,L. Brewer,4279897,,True,40.0,6,17,6,10,0,7,2,5,0,4,4,2,0,1,3,2,14
401403323,East Tennessee State Buccaneers,I. Farah,4897390,,False,0.0,0,0,0,0,0,0,0,0,0,0,0,0,0,0,0,0,0
401403323,East Tennessee State Buccaneers,M. Nunez,28443,,False,1.0,1,1,1,1,0,0,0,0,1,0,1,0,0,0,0,1,2
401403323,East Tennessee State Buccaneers,M. Yasser,4897386,,False,41.0,5,8,5,7,0,1,1,1,5,5,10,1,2,0,1,5,11
401403323,East Tennessee State Buccaneers,TEAM,TOTAL,TOTAL,False,,32,76,27,49,5,27,7,12,13,29,42,9,5,3,7,23,76
401403322,Yale Bulldogs,M. Knowling,4898246,,True,30.0,4,6,4,6,0,0,4,4,0,1,1,5,0,0,1,0,12
401403322,Yale Bulldogs,I. Kelly,4398015,,True,22.0,0,0,0,0,0,0,2,4,0,1,1,0,0,2,4,2,2
401403322,Yale Bulldogs,B. Mbeng,4898237,,True,32.0,4,9,3,7,1,2,4,4,1,10,11,2,3,0,3,2,13
401403322,Yale Bulldogs,A. Swain,4279697,,True,36.0,9,21,6,13,3,8,2,2,1,5,6,2,0,0,1,1,23
401403322,Yale Bulldogs,J. Gabbidon,4279696,,True,33.0,2,5,2,2,0,3,0,1,1,4,5,1,2,0,3,2,4
401403322,Yale Bulldogs,EJ Jarvis,4431872,,False,18.0,2,4,2,4,0,0,0,0,0,4,4,0,0,1,0,3,4
401403322,Yale Bulldogs,J. Poulakidas,4898238,,False,2.0,0,0,0,0,0,0,0,0,0,0,0,0,0,0,0,1,0
401403322,Yale Bulldogs,A. Mahoney,4593361,,False,6.0,1,3,1,3,0,0,0,0,0,3,3,0,1,0,0,1,2
401403322,Yale Bulldogs,M. Cotton,4398012,,False,21.0,2,4,0,0,2,4,0,0,1,3,4,0,0,0,0,0,6
401403322,Yale Bulldogs,TEAM,TOTAL,TOTAL,False,,24,52,18,35,6,17,12,15,6,32,38,10,6,3,15,12,66
401403322,Princeton Tigers,T. Evbuomwan,4597865,,True,37.0,8,13,8,13,0,0,4,5,1,10,11,5,2,1,5,3,20
401403322,Princeton Tigers,D. Friberg,4398004,,True,36.0,2,9,0,2,2,7,0,0,0,2,2,0,2,0,0,3,6
401403322,Princeton Tigers,R. Langborg,4597863,,True,21.0,1,5,1,2,0,3,0,0,0,1,1,2,0,1,0,2,2
401403322,Princeton Tigers,E. Wright,4398005,,True,39.0,6,13,3,6,3,7,0,0,1,3,4,0,2,0,2,2,15
401403322,Princeton Tigers,J. Llewellyn,4398002,,True,38.0,7,17,3,6,4,11,0,0,0,4,4,2,2,1,3,3,18
401403322,Princeton Tigers,E. Barnes,4279567,,False,3.0,0,1,0,0,0,1,0,0,0,0,0,0,0,0,0,0,0
401403322,Princeton Tigers,M. Allocco,4898232,,False,26.0,1,3,0,2,1,1,0,0,1,3,4,2,0,0,0,0,3
401403322,Princeton Tigers,M. Johns,4398003,,False,0.0,0,0,0,0,0,0,0,0,0,0,0,0,0,0,0,0,0
401403322,Princeton Tigers,TEAM,TOTAL,TOTAL,False,,25,61,15,31,10,30,4,5,5,24,29,11,8,3,10,13,64
401403321,Yale Bulldogs,M. Knowling,4898246,,True,32.0,5,9,5,9,0,0,0,1,1,0,1,4,0,0,1,0,10
401403321,Yale Bulldogs,I. Kelly,4398015,,True,21.0,0,0,0,0,0,0,0,0,0,6,6,1,0,1,0,2,0
401403321,Yale Bulldogs,B. Mbeng,4898237,,True,26.0,3,7,2,4,1,3,1,3,1,3,4,2,2,1,1,3,8
401403321,Yale Bulldogs,A. Swain,4279697,,True,35.0,9,15,4,7,5,8,2,3,0,2,2,0,0,0,0,0,25
401403321,Yale Bulldogs,J. Gabbidon,4279696,,True,33.0,3,8,2,2,1,6,2,3,1,6,7,1,0,2,4,3,9
401403321,Yale Bulldogs,EJ Jarvis,4431872,,False,19.0,3,7,3,7,0,0,0,0,1,4,5,0,1,0,0,3,6
401403321,Yale Bulldogs,J. Poulakidas,4898238,,False,3.0,0,1,0,1,0,0,0,0,0,1,1,0,0,0,1,0,0
401403321,Yale Bulldogs,A. Mahoney,4593361,,False,13.0,0,1,0,1,0,0,1,2,0,1,1,1,0,0,0,2,1
401403321,Yale Bulldogs,M. Cotton,4398012,,False,17.0,3,6,1,2,2,4,0,0,1,4,5,0,0,0,0,0,8
401403321,Yale Bulldogs,E. Dike,4398011,,False,1.0,0,0,0,0,0,0,0,0,0,0,0,0,0,0,0,0,0
401403321,Yale Bulldogs,TEAM,TOTAL,TOTAL,False,,26,54,17,33,9,21,6,12,6,28,34,9,3,4,7,13,67
401403321,Pennsylvania Quakers,M. Moshkovitz,4702956,,True,17.0,1,2,1,2,0,0,1,2,1,1,2,4,0,0,1,4,3
401403321,Pennsylvania Quakers,M. Martz,4593353,,True,34.0,2,7,0,2,2,5,0,0,2,5,7,0,1,2,0,2,6
401403321,Pennsylvania Quakers,G. Smith,4898227,,True,28.0,0,2,0,1,0,1,0,0,0,5,5,1,0,0,0,1,0
401403321,Pennsylvania Quakers,J. Dingle,4593351,,True,36.0,12,25,8,14,4,11,0,1,1,4,5,0,0,0,3,1,28
401403321,Pennsylvania Quakers,J. Williams,4279561,,True,24.0,1,6,1,3,0,3,0,0,0,4,4,2,3,0,1,4,2
401403321,Pennsylvania Quakers,N. Spinoso,4898224,,False,22.0,5,8,3,6,2,2,2,2,3,2,5,2,0,0,0,2,14
401403321,Pennsylvania Quakers,L. Monroe,4593352,,False,19.0,1,1,1,1,0,0,2,4,0,4,4,2,0,2,0,0,4
401403321,Pennsylvania Quakers,C. Slajchert,4702954,,False,14.0,1,5,1,3,0,2,2,2,0,1,1,1,0,0,0,2,4
401403321,Pennsylvania Quakers,J. Charles,4593350,,False,5.0,0,2,0,0,0,2,0,0,0,0,0,0,0,0,0,0,0
401403321,Pennsylvania Quakers,B. Washington,4397982,,False,1.0,0,0,0,0,0,0,0,0,0,0,0,0,0,0,0,0,0
401403321,Pennsylvania Quakers,TEAM,TOTAL,TOTAL,False,,23,58,15,32,8,26,7,11,9,26,35,12,4,4,7,16,61
401403320,Princeton Tigers,T. Evbuomwan,4597865,,True,33.0,10,18,10,18,0,0,1,2,1,5,6,6,0,1,4,2,21
401403320,Princeton Tigers,D. Friberg,4398004,,True,34.0,2,7,0,1,2,6,2,2,0,4,4,0,1,0,0,0,8
401403320,Princeton Tigers,R. Langborg,4597863,,True,30.0,2,4,0,0,2,4,2,2,0,1,1,1,0,0,0,0,8
401403320,Princeton Tigers,E. Wright,4398005,,True,32.0,5,10,3,4,2,6,0,1,2,4,6,0,1,0,2,2,12
401403320,Princeton Tigers,J. Llewellyn,4398002,,True,34.0,9,15,5,9,4,6,1,4,1,3,4,2,2,0,1,2,23
401403320,Princeton Tigers,E. Barnes,4279567,,False,7.0,0,0,0,0,0,0,0,0,0,2,2,1,0,0,0,0,0
401403320,Princeton Tigers,M. Allocco,4898232,,False,27.0,2,4,1,1,1,3,0,0,0,6,6,1,1,0,0,0,5
401403320,Princeton Tigers,M. Johns,4398003,,False,3.0,0,0,0,0,0,0,0,0,0,0,0,0,0,0,1,0,0
401403320,Princeton Tigers,TEAM,TOTAL,TOTAL,False,,30,58,19,33,11,25,6,11,4,27,31,11,5,1,8,6,77
401403320,Cornell Big Red,K. Boothby,4702970,,True,22.0,1,2,0,0,1,2,0,0,0,2,2,1,0,0,0,1,3
401403320,Cornell Big Red,J. Jones,4593310,,True,14.0,2,3,1,1,1,2,0,0,3,1,4,2,0,0,2,1,5
401403320,Cornell Big Red,K. Dickson,4397937,,True,20.0,5,7,5,6,0,1,0,0,0,6,6,2,0,2,1,2,10
401403320,Cornell Big Red,D. Noll,4397941,,True,25.0,6,14,5,10,1,4,0,0,1,1,2,1,1,0,1,2,13
401403320,Cornell Big Red,S. Patel,4280104,,True,21.0,5,10,2,3,3,7,0,0,1,1,2,2,0,0,0,1,13
401403320,Cornell Big Red,G. Ragland Jr.,4898218,,False,3.0,0,3,0,2,0,1,0,0,1,1,2,0,0,1,0,1,0
401403320,Cornell Big Red,S. Hansen,4702971,,False,16.0,2,4,1,2,1,2,0,0,0,2,2,1,2,1,1,2,5
401403320,Cornell Big Red,M. Filien,4593307,,False,18.0,1,3,1,3,0,0,0,0,0,5,5,0,0,0,0,0,2
401403320,Cornell Big Red,N. Williams,4898217,,False,19.0,6,9,6,9,0,0,0,0,0,0,0,0,0,0,0,1,12
401403320,Cornell Big Red,C. Manon,4702972,,False,17.0,1,6,1,6,0,0,1,2,1,5,6,0,1,0,1,2,3
401403320,Cornell Big Red,G. Dolan,4593308,,False,24.0,3,5,2,4,1,1,0,1,0,3,3,4,1,0,1,1,7
401403320,Cornell Big Red,M. Samberg,4397940,,False,1.0,0,0,0,0,0,0,0,0,0,0,0,0,0,0,0,0,0
401403320,Cornell Big Red,TEAM,TOTAL,TOTAL,False,,32,66,24,46,8,20,1,3,8,28,36,13,5,4,7,14,73
401403319,Northern Colorado Bears,K. Jongkuch,4897945,,True,29.0,5,6,5,6,0,0,2,5,3,5,8,1,0,1,0,5,12
401403319,Northern Colorado Bears,B. Hume,4397311,,True,26.0,2,12,0,3,2,9,4,4,1,5,6,1,0,0,2,4,10
401403319,Northern Colorado Bears,M. Johnson II,4897941,,True,33.0,1,11,0,7,1,4,0,0,2,0,2,1,1,0,1,3,3
401403319,Northern Colorado Bears,D. Kuxhausen,4593774,,True,34.0,2,8,1,4,1,4,2,2,0,2,2,0,3,0,1,5,7
401403319,Northern Colorado Bears,D. Kountz,4397060,,True,32.0,5,15,4,13,1,2,9,10,2,2,4,1,0,0,1,5,20
401403319,Northern Colorado Bears,B. Kennedy,4702085,,False,8.0,0,0,0,0,0,0,0,0,0,0,0,0,0,0,0,0,0
401403319,Northern Colorado Bears,J. Melvin,4702083,,False,5.0,0,0,0,0,0,0,0,0,0,0,0,0,0,0,0,1,0
401403319,Northern Colorado Bears,Z. Bloch,4897944,,False,5.0,0,0,0,0,0,0,0,0,0,0,0,0,0,0,0,0,0
401403319,Northern Colorado Bears,D. Knecht,4897943,,False,28.0,4,11,3,6,1,5,5,6,1,2,3,1,1,1,2,2,14
401403319,Northern Colorado Bears,TEAM,TOTAL,TOTAL,False,,19,63,13,39,6,24,22,27,10,19,29,5,5,2,7,25,66
401403319,Montana State Bobcats,J. Belo,4592617,,True,16.0,2,3,2,3,0,0,4,4,4,2,6,0,0,2,1,3,8
401403319,Montana State Bobcats,A. Mohamed,4397559,,True,25.0,1,4,1,3,0,1,2,4,0,11,11,1,0,2,1,3,4
401403319,Montana State Bobcats,T. Patterson,4702074,,True,28.0,5,6,1,1,4,5,0,0,2,3,5,1,0,1,2,2,14
401403319,Montana State Bobcats,A. Adamu,4592615,,True,26.0,7,11,5,7,2,4,0,0,0,4,4,0,0,0,2,4,16
401403319,Montana State Bobcats,X. Bishop,4067581,,True,38.0,5,15,3,9,2,6,7,8,0,4,4,8,0,0,3,1,19
401403319,Montana State Bobcats,S. Lecholat,4897926,,False,1.0,0,0,0,0,0,0,0,0,0,1,1,0,0,0,0,0,0
401403319,Montana State Bobcats,G. Osobor,4897921,,False,22.0,2,3,2,3,0,0,3,4,2,4,6,0,0,1,1,3,7
401403319,Montana State Bobcats,B. Fernandez,4592619,,False,1.0,0,0,0,0,0,0,0,0,0,0,0,0,0,0,0,0,0
401403319,Montana State Bobcats,I. Spears,4897925,,False,1.0,0,0,0,0,0,0,2,4,0,0,0,0,0,0,0,0,2
401403319,Montana State Bobcats,P. McMahon,4897923,,False,3.0,0,1,0,1,0,0,0,0,0,0,0,0,0,0,0,0,0
401403319,Montana State Bobcats,K. Tynes,4702078,,False,2.0,0,0,0,0,0,0,0,0,0,0,0,0,0,0,1,0,0
401403319,Montana State Bobcats,N. Gazelas,4702072,,False,27.0,4,5,2,3,2,2,5,7,0,1,1,0,0,0,1,1,15
401403319,Montana State Bobcats,R. Battle,4431726,,False,10.0,1,4,1,4,0,0,0,0,0,0,0,0,0,1,0,2,2
401403319,Montana State Bobcats,TEAM,TOTAL,TOTAL,False,,27,52,17,34,10,18,23,31,8,33,41,10,0,7,12,19,87
401403318,Portland State Vikings,K. Thomas,4592361,,True,20.0,4,12,3,8,1,4,4,6,4,2,6,0,1,0,2,4,13
401403318,Portland State Vikings,M. Carter III,4897947,,True,33.0,7,16,6,13,1,3,7,10,0,5,5,3,4,0,2,4,22
401403318,Portland State Vikings,E. Alley,4712247,,True,32.0,5,17,5,13,0,4,1,2,3,3,6,0,3,0,0,1,11
401403318,Portland State Vikings,D. Squire,4397579,,True,27.0,4,11,2,6,2,5,4,4,0,2,2,0,3,0,5,5,14
401403318,Portland State Vikings,I. Burke,4395998,,True,23.0,0,1,0,1,0,0,0,0,0,2,2,1,1,0,0,5,0
401403318,Portland State Vikings,J. Eyman,4396000,,False,11.0,0,2,0,2,0,0,1,2,2,0,2,0,0,0,0,0,1
401403318,Portland State Vikings,H. Curtiss,4701202,,False,13.0,2,3,2,3,0,0,0,0,1,0,1,0,0,1,0,3,4
401403318,Portland State Vikings,M. Starks,4702888,,False,12.0,0,1,0,0,0,1,0,0,0,1,1,1,1,0,1,3,0
401403318,Portland State Vikings,P. Dawson,4702138,,False,6.0,0,0,0,0,0,0,2,2,1,1,2,0,0,0,0,1,2
401403318,Portland State Vikings,M. Ruffin,4593785,,False,23.0,3,7,3,5,0,2,6,10,2,3,5,2,1,0,0,2,12
401403318,Portland State Vikings,TEAM,TOTAL,TOTAL,False,,25,70,21,51,4,19,25,36,15,21,36,7,14,1,10,28,79
401403318,Northern Colorado Bears,K. Jongkuch,4897945,,True,30.0,3,5,3,5,0,0,3,6,1,7,8,0,0,0,1,4,9
401403318,Northern Colorado Bears,B. Hume,4397311,,True,29.0,2,4,2,3,0,1,4,5,1,10,11,1,2,1,1,3,8
401403318,Northern Colorado Bears,M. Johnson II,4897941,,True,33.0,3,8,2,5,1,3,1,2,0,0,0,3,0,0,5,5,8
401403318,Northern Colorado Bears,D. Kuxhausen,4593774,,True,29.0,3,8,1,2,2,6,0,0,0,4,4,0,0,0,2,4,8
401403318,Northern Colorado Bears,D. Kountz,4397060,,True,33.0,11,15,7,9,4,6,10,11,0,7,7,2,0,0,5,4,36
401403318,Northern Colorado Bears,B. Kennedy,4702085,,False,5.0,0,0,0,0,0,0,0,0,0,1,1,0,1,0,0,1,0
401403318,Northern Colorado Bears,J. Melvin,4702083,,False,3.0,0,0,0,0,0,0,0,0,0,0,0,0,0,0,0,0,0
401403318,Northern Colorado Bears,Z. Bloch,4897944,,False,7.0,0,1,0,1,0,0,0,0,0,0,0,0,0,0,2,1,0
401403318,Northern Colorado Bears,D. Knecht,4897943,,False,31.0,4,7,3,3,1,4,8,10,1,3,4,0,0,1,5,3,17
401403318,Northern Colorado Bears,TEAM,TOTAL,TOTAL,False,,26,48,18,28,8,20,26,34,4,33,37,6,3,2,22,25,86
401403317,Weber State Wildcats,D. Jones,4702159,,True,38.0,7,13,5,7,2,6,2,2,4,5,9,3,2,0,4,2,18
401403317,Weber State Wildcats,J. Overton,4593976,,True,34.0,3,9,3,9,0,0,3,8,1,2,3,1,0,0,2,5,9
401403317,Weber State Wildcats,D. Bassett,4066258,,True,31.0,5,10,4,6,1,4,0,0,1,4,5,0,0,3,0,3,11
401403317,Weber State Wildcats,S. Sisoho Jawara,4593773,,True,37.0,4,9,3,7,1,2,0,0,0,4,4,3,1,0,2,0,9
401403317,Weber State Wildcats,K. McEwen,4066755,,True,36.0,3,11,1,6,2,5,9,10,1,0,1,0,3,0,0,2,17
401403317,Weber State Wildcats,D. Koehler,4702350,,False,2.0,0,0,0,0,0,0,0,0,0,1,1,0,0,0,1,2,0
401403317,Weber State Wildcats,A. Tew,4897981,,False,9.0,1,1,1,1,0,0,0,0,1,1,2,0,0,0,0,1,2
401403317,Weber State Wildcats,KJ Cunningham,4592648,,False,4.0,0,0,0,0,0,0,0,0,0,0,0,0,0,0,0,0,0
401403317,Weber State Wildcats,Z. Porter,4405290,,False,9.0,0,1,0,1,0,0,0,0,0,0,0,0,1,0,3,1,0
401403317,Weber State Wildcats,TEAM,TOTAL,TOTAL,False,,23,54,17,37,6,17,14,20,9,19,28,7,7,3,12,16,66
401403317,Montana State Bobcats,J. Belo,4592617,,True,26.0,3,8,3,8,0,0,0,1,1,4,5,0,1,1,4,3,6
401403317,Montana State Bobcats,A. Mohamed,4397559,,True,28.0,2,3,1,2,1,1,0,0,0,6,6,1,1,0,3,3,5
401403317,Montana State Bobcats,T. Patterson,4702074,,True,12.0,0,2,0,0,0,2,0,0,0,0,0,0,0,0,1,0,0
401403317,Montana State Bobcats,A. Adamu,4592615,,True,30.0,7,10,6,7,1,3,0,0,0,4,4,1,0,1,2,0,15
401403317,Montana State Bobcats,X. Bishop,4067581,,True,37.0,5,14,2,5,3,9,1,2,0,5,5,2,1,0,2,4,14
401403317,Montana State Bobcats,S. Lecholat,4897926,,False,2.0,1,1,1,1,0,0,0,0,0,0,0,0,0,0,0,1,2
401403317,Montana State Bobcats,G. Osobor,4897921,,False,24.0,4,6,4,6,0,0,2,3,3,2,5,1,1,2,2,3,10
401403317,Montana State Bobcats,K. Tynes,4702078,,False,3.0,0,0,0,0,0,0,0,0,0,0,0,0,0,0,0,2,0
401403317,Montana State Bobcats,N. Gazelas,4702072,,False,14.0,0,0,0,0,0,0,0,0,0,0,0,0,0,0,0,0,0
401403317,Montana State Bobcats,R. Battle,4431726,,False,24.0,2,4,2,2,0,2,13,14,0,2,2,0,0,0,1,1,17
401403317,Montana State Bobcats,TEAM,TOTAL,TOTAL,False,,24,48,19,31,5,17,16,20,6,24,30,5,4,4,16,17,69
401403316,Southern Utah Thunderbirds,M. Fausett,4397379,,True,36.0,9,14,8,10,1,4,0,0,4,5,9,0,1,0,0,0,19
401403316,Southern Utah Thunderbirds,J. Spurgin,4702155,,True,23.0,3,4,3,3,0,1,6,6,3,3,6,2,1,2,2,3,12
401403316,Southern Utah Thunderbirds,J. Knight III,4397421,,True,35.0,6,12,6,12,0,0,1,3,2,5,7,0,1,1,7,2,13
401403316,Southern Utah Thunderbirds,D. Marin,4278670,,True,31.0,4,14,3,8,1,6,4,4,1,3,4,0,0,0,2,3,13
401403316,Southern Utah Thunderbirds,A. Moody,4278631,,True,34.0,1,11,0,1,1,10,0,0,1,1,2,1,2,0,1,3,3
401403316,Southern Utah Thunderbirds,N. Fleming,4702153,,False,19.0,1,6,1,4,0,2,1,2,0,3,3,0,0,0,0,3,3
401403316,Southern Utah Thunderbirds,D. Barnes,4397973,,False,4.0,0,0,0,0,0,0,0,0,0,0,0,0,0,0,0,2,0
401403316,Southern Utah Thunderbirds,H. Butler,4397380,,False,18.0,1,7,1,5,0,2,0,1,1,1,2,0,0,0,1,3,2
401403316,Southern Utah Thunderbirds,TEAM,TOTAL,TOTAL,False,,25,68,22,43,3,25,12,16,16,23,39,3,5,3,13,19,65
401403316,Portland State Vikings,K. Thomas,4592361,,True,34.0,8,13,6,8,2,5,2,2,0,7,7,2,2,3,2,2,20
401403316,Portland State Vikings,M. Carter III,4897947,,True,26.0,4,8,3,5,1,3,4,4,0,6,6,3,0,0,2,1,13
401403316,Portland State Vikings,E. Alley,4712247,,True,27.0,3,7,3,5,0,2,2,4,0,2,2,2,1,0,3,4,8
401403316,Portland State Vikings,D. Squire,4397579,,True,24.0,2,6,2,5,0,1,4,4,0,1,1,1,0,0,2,3,8
401403316,Portland State Vikings,I. Burke,4395998,,True,31.0,3,4,1,1,2,3,2,2,0,4,4,0,3,1,0,1,10
401403316,Portland State Vikings,J. Eyman,4396000,,False,8.0,0,1,0,1,0,0,0,2,2,1,3,1,0,2,1,3,0
401403316,Portland State Vikings,H. Curtiss,4701202,,False,14.0,3,4,3,4,0,0,3,3,0,3,3,0,0,1,0,1,9
401403316,Portland State Vikings,M. Starks,4702888,,False,21.0,4,6,3,4,1,2,0,0,1,3,4,1,1,0,2,2,9
401403316,Portland State Vikings,M. Ruffin,4593785,,False,15.0,0,3,0,2,0,1,0,0,1,0,1,1,0,0,1,0,0
401403316,Portland State Vikings,TEAM,TOTAL,TOTAL,False,,27,52,21,35,6,17,17,21,4,29,33,11,7,7,13,17,77
401403315,Northern Colorado Bears,K. Jongkuch,4897945,,True,29.0,1,2,1,2,0,0,0,0,4,7,11,2,1,0,2,1,2
401403315,Northern Colorado Bears,B. Hume,4397311,,True,28.0,2,8,1,3,1,5,0,0,2,3,5,4,0,1,4,5,5
401403315,Northern Colorado Bears,M. Johnson II,4897941,,True,37.0,9,16,4,8,5,8,1,3,0,3,3,2,1,0,0,2,24
401403315,Northern Colorado Bears,D. Kuxhausen,4593774,,True,28.0,4,11,1,2,3,9,3,3,0,1,1,1,0,0,0,2,14
401403315,Northern Colorado Bears,D. Kountz,4397060,,True,37.0,6,17,4,14,2,3,3,4,0,4,4,1,1,1,2,4,17
401403315,Northern Colorado Bears,B. Kennedy,4702085,,False,8.0,0,1,0,0,0,1,0,0,3,0,3,0,0,0,0,0,0
401403315,Northern Colorado Bears,J. Melvin,4702083,,False,5.0,0,0,0,0,0,0,0,0,0,0,0,1,0,1,0,0,0
401403315,Northern Colorado Bears,Z. Bloch,4897944,,False,5.0,1,3,0,1,1,2,0,0,0,0,0,0,0,0,0,1,3
401403315,Northern Colorado Bears,D. Knecht,4897943,,False,23.0,1,6,0,3,1,3,0,0,0,5,5,2,0,2,0,2,3
401403315,Northern Colorado Bears,TEAM,TOTAL,TOTAL,False,,24,64,11,33,13,31,7,10,10,23,33,13,3,5,8,17,68
401403315,Eastern Washington Eagles,E. Price,4897852,,True,37.0,4,8,3,6,1,2,0,3,3,5,8,1,0,3,3,3,9
401403315,Eastern Washington Eagles,L. Acliese,4609216,,True,34.0,4,13,4,10,0,3,4,5,1,10,11,2,1,0,2,3,12
401403315,Eastern Washington Eagles,A. Allegri,4398233,,True,36.0,4,9,4,7,0,2,2,2,4,5,9,1,2,1,2,3,10
401403315,Eastern Washington Eagles,S. Venters,4592579,,True,36.0,9,18,7,13,2,5,2,2,0,4,4,1,2,1,1,3,22
401403315,Eastern Washington Eagles,R. Bergersen,4280143,,True,34.0,5,8,5,7,0,1,4,5,1,4,5,0,1,1,0,2,14
401403315,Eastern Washington Eagles,C. Jones,4897857,,False,3.0,0,0,0,0,0,0,0,0,0,1,1,0,0,0,0,1,0
401403315,Eastern Washington Eagles,M. Landdeck,4897855,,False,4.0,0,2,0,1,0,1,0,0,0,0,0,0,0,0,0,1,0
401403315,Eastern Washington Eagles,E. Magnuson,4592585,,False,16.0,0,1,0,0,0,1,0,0,0,0,0,3,0,0,1,0,0
401403315,Eastern Washington Eagles,TEAM,TOTAL,TOTAL,False,,26,60,23,44,3,16,12,17,10,31,41,8,6,6,10,16,67
401403314,Weber State Wildcats,D. Jones,4702159,,True,39.0,7,8,5,6,2,2,7,8,4,7,11,1,3,0,4,2,23
401403314,Weber State Wildcats,J. Overton,4593976,,True,36.0,4,7,4,6,0,1,2,4,2,4,6,0,1,0,3,3,10
401403314,Weber State Wildcats,D. Bassett,4066258,,True,17.0,2,4,2,4,0,0,0,0,0,1,1,0,0,1,1,5,4
401403314,Weber State Wildcats,S. Sisoho Jawara,4593773,,True,32.0,1,8,0,5,1,3,0,0,0,4,4,3,2,0,0,4,3
401403314,Weber State Wildcats,K. McEwen,4066755,,True,33.0,6,11,6,8,0,3,5,6,0,1,1,2,0,0,1,3,17
401403314,Weber State Wildcats,D. Koehler,4702350,,False,4.0,0,0,0,0,0,0,0,0,0,1,1,0,0,0,0,0,0
401403314,Weber State Wildcats,A. Tew,4897981,,False,19.0,2,2,2,2,0,0,1,4,1,0,1,0,0,0,0,3,5
401403314,Weber State Wildcats,KJ Cunningham,4592648,,False,3.0,0,0,0,0,0,0,0,0,0,0,0,0,0,0,0,0,0
401403314,Weber State Wildcats,Z. Porter,4405290,,False,17.0,3,6,3,4,0,2,0,0,0,1,1,0,1,0,2,1,6
401403314,Weber State Wildcats,TEAM,TOTAL,TOTAL,False,,25,46,22,35,3,11,15,22,7,20,27,6,7,1,11,21,68
401403314,Montana Grizzlies,J. Bannan,4702058,,True,38.0,1,8,1,5,0,3,9,10,2,7,9,2,0,0,5,2,11
401403314,Montana Grizzlies,D. Carter-Hollinger,4592605,,True,30.0,4,5,3,4,1,1,3,6,0,3,3,0,0,1,1,2,12
401403314,Montana Grizzlies,L. Martin Jr.,4897914,,True,21.0,0,2,0,1,0,1,0,0,0,2,2,0,0,0,0,4,0
401403314,Montana Grizzlies,B. Whitney,4585617,,True,24.0,3,5,3,5,0,0,6,8,0,2,2,3,0,0,2,5,12
401403314,Montana Grizzlies,R. Beasley,4432435,,True,39.0,4,11,2,5,2,6,2,3,1,3,4,1,0,0,4,4,12
401403314,Montana Grizzlies,K. Owens,4592602,,False,7.0,0,2,0,1,0,1,0,0,0,0,0,0,0,0,1,2,0
401403314,Montana Grizzlies,S. Blakney,4278609,,False,7.0,1,1,1,1,0,0,0,0,0,0,0,0,0,0,0,2,2
401403314,Montana Grizzlies,J. Vazquez,4592603,,False,19.0,2,4,1,2,1,2,0,0,0,0,0,0,0,0,0,2,5
401403314,Montana Grizzlies,C. Parker,4397999,,False,15.0,1,1,1,1,0,0,0,0,0,1,1,1,0,0,3,1,2
401403314,Montana Grizzlies,TEAM,TOTAL,TOTAL,False,,16,39,12,25,4,14,20,27,3,19,22,7,0,1,16,24,56
401403313,Sacramento State Hornets,J. Komagum,4703542,,True,21.0,1,2,1,2,0,0,0,0,0,3,3,0,0,1,1,5,2
401403313,Sacramento State Hornets,C. Wilbon,4397994,,True,32.0,2,11,2,10,0,1,2,2,2,4,6,1,1,0,4,4,6
401403313,Sacramento State Hornets,W. FitzPatrick,4592634,,True,39.0,2,8,1,2,1,6,2,2,0,4,4,0,0,0,1,3,7
401403313,Sacramento State Hornets,Z. Chappell,4397395,,True,36.0,6,13,6,9,0,4,7,8,1,1,2,0,0,0,2,1,19
401403313,Sacramento State Hornets,B. Fowler,4278663,,True,36.0,9,18,9,17,0,1,2,2,4,3,7,1,0,0,3,2,20
401403313,Sacramento State Hornets,T. Seng,4897957,,False,1.0,0,0,0,0,0,0,2,2,0,0,0,0,0,0,0,0,2
401403313,Sacramento State Hornets,H. Clarkin,4703347,,False,14.0,0,0,0,0,0,0,0,0,1,1,2,0,0,0,0,3,0
401403313,Sacramento State Hornets,X. Ford,4897954,,False,1.0,0,0,0,0,0,0,1,2,0,0,0,0,0,0,0,0,1
401403313,Sacramento State Hornets,T. Hardee,4702146,,False,2.0,0,0,0,0,0,0,0,0,0,0,0,0,1,0,0,1,0
401403313,Sacramento State Hornets,R. Barros III,4592632,,False,15.0,1,1,1,1,0,0,0,0,0,0,0,0,0,0,0,1,2
401403313,Sacramento State Hornets,E. McCullough,4397327,,False,3.0,1,1,1,1,0,0,0,0,0,0,0,0,0,0,0,1,2
401403313,Sacramento State Hornets,TEAM,TOTAL,TOTAL,False,,22,54,21,42,1,12,16,18,9,19,28,2,2,1,11,21,61
401403313,Montana State Bobcats,J. Belo,4592617,,True,23.0,4,5,4,5,0,0,3,4,0,5,5,1,0,0,3,2,11
401403313,Montana State Bobcats,A. Mohamed,4397559,,True,33.0,3,6,3,5,0,1,5,6,1,3,4,0,3,1,2,0,11
401403313,Montana State Bobcats,T. Patterson,4702074,,True,20.0,2,5,0,0,2,5,0,0,0,0,0,0,0,0,0,1,6
401403313,Montana State Bobcats,A. Adamu,4592615,,True,28.0,3,6,3,5,0,1,0,0,1,5,6,0,0,0,1,3,6
401403313,Montana State Bobcats,X. Bishop,4067581,,True,31.0,6,13,4,8,2,5,0,0,0,3,3,3,1,0,0,1,14
401403313,Montana State Bobcats,S. Lecholat,4897926,,False,3.0,0,0,0,0,0,0,0,0,0,0,0,0,0,0,0,1,0
401403313,Montana State Bobcats,G. Osobor,4897921,,False,20.0,4,4,4,4,0,0,5,6,1,2,3,2,0,1,1,3,13
401403313,Montana State Bobcats,B. Fernandez,4592619,,False,1.0,0,0,0,0,0,0,0,0,0,0,0,0,0,0,0,0,0
401403313,Montana State Bobcats,I. Spears,4897925,,False,1.0,0,1,0,1,0,0,0,0,0,0,0,0,0,0,1,2,0
401403313,Montana State Bobcats,P. McMahon,4897923,,False,3.0,1,1,1,1,0,0,3,3,0,0,0,0,0,0,0,0,5
401403313,Montana State Bobcats,K. Tynes,4702078,,False,3.0,0,0,0,0,0,0,1,2,0,0,0,0,0,0,0,1,1
401403313,Montana State Bobcats,N. Gazelas,4702072,,False,17.0,2,2,2,2,0,0,2,2,0,0,0,2,0,0,0,1,6
401403313,Montana State Bobcats,R. Battle,4431726,,False,17.0,3,6,1,3,2,3,2,3,0,3,3,1,1,1,0,2,10
401403313,Montana State Bobcats,TEAM,TOTAL,TOTAL,False,,28,49,22,34,6,15,21,26,3,23,26,9,5,3,8,17,83
401403312,Northern Arizona Lumberjacks,C. Towt,4702120,,True,39.0,9,14,9,14,0,0,3,4,8,8,16,4,1,0,2,3,21
401403312,Northern Arizona Lumberjacks,K. Haymon,4397304,,True,27.0,2,7,1,4,1,3,1,2,0,1,1,2,0,0,0,5,6
401403312,Northern Arizona Lumberjacks,N. Mains,4278643,,True,28.0,3,8,2,3,1,5,0,0,0,2,2,0,3,0,1,5,7
401403312,Northern Arizona Lumberjacks,J. Cone,4431698,,True,35.0,8,20,6,12,2,8,1,3,0,4,4,3,1,0,5,4,19
401403312,Northern Arizona Lumberjacks,J. Green,4278952,,True,27.0,3,6,3,6,0,0,4,5,1,3,4,1,1,0,1,2,10
401403312,Northern Arizona Lumberjacks,I. Lewis,4592625,,False,14.0,0,3,0,3,0,0,0,0,4,0,4,0,0,0,0,2,0
401403312,Northern Arizona Lumberjacks,E. Richards,4397752,,False,3.0,0,0,0,0,0,0,0,0,1,0,1,0,1,0,0,0,0
401403312,Northern Arizona Lumberjacks,M. Stark,4897937,,False,27.0,4,9,0,2,4,7,0,0,1,1,2,0,0,0,1,3,12
401403312,Northern Arizona Lumberjacks,TEAM,TOTAL,TOTAL,False,,29,67,21,44,8,23,9,14,18,19,37,10,7,0,10,24,75
401403312,Eastern Washington Eagles,E. Price,4897852,,True,35.0,2,5,2,4,0,1,2,3,4,5,9,1,0,2,3,4,6
401403312,Eastern Washington Eagles,L. Acliese,4609216,,True,34.0,7,13,6,7,1,6,5,6,2,4,6,2,0,0,0,2,20
401403312,Eastern Washington Eagles,A. Allegri,4398233,,True,37.0,4,11,1,4,3,7,1,2,1,4,5,2,2,0,3,4,12
401403312,Eastern Washington Eagles,S. Venters,4592579,,True,32.0,6,13,4,7,2,6,5,5,2,3,5,5,1,0,4,2,19
401403312,Eastern Washington Eagles,R. Bergersen,4280143,,True,38.0,5,7,4,6,1,1,7,8,0,2,2,6,0,0,2,3,18
401403312,Eastern Washington Eagles,C. Jones,4897857,,False,3.0,0,1,0,1,0,0,0,0,0,1,1,0,0,0,0,0,0
401403312,Eastern Washington Eagles,I. George,4897856,,False,0.0,0,0,0,0,0,0,0,0,0,0,0,0,0,0,0,0,0
401403312,Eastern Washington Eagles,M. Landdeck,4897855,,False,5.0,0,1,0,0,0,1,0,0,0,0,0,0,0,0,1,0,0
401403312,Eastern Washington Eagles,E. Magnuson,4592585,,False,16.0,1,3,1,2,0,1,1,1,1,1,2,1,0,0,0,1,3
401403312,Eastern Washington Eagles,TEAM,TOTAL,TOTAL,False,,25,54,18,31,7,23,21,25,11,21,32,17,3,2,13,16,78
401403311,Portland State Vikings,K. Thomas,4592361,,True,32.0,7,13,4,6,3,7,0,1,0,5,5,1,1,1,2,3,17
401403311,Portland State Vikings,M. Carter III,4897947,,True,25.0,5,10,5,9,0,1,0,1,0,2,2,1,3,0,0,3,10
401403311,Portland State Vikings,E. Alley,4712247,,True,33.0,6,14,5,11,1,3,2,6,0,5,5,2,1,0,1,2,15
401403311,Portland State Vikings,D. Squire,4397579,,True,19.0,0,3,0,3,0,0,0,0,0,0,0,3,0,0,3,2,0
401403311,Portland State Vikings,I. Burke,4395998,,True,19.0,1,3,0,1,1,2,2,2,0,1,1,0,0,0,0,3,5
401403311,Portland State Vikings,T. Wood,4592629,,False,1.0,0,0,0,0,0,0,0,0,0,0,0,0,0,0,0,1,0
401403311,Portland State Vikings,J. Eyman,4396000,,False,13.0,0,0,0,0,0,0,0,0,0,1,1,0,0,0,0,2,0
401403311,Portland State Vikings,H. Curtiss,4701202,,False,14.0,1,1,1,1,0,0,3,3,0,1,1,0,0,1,0,2,5
401403311,Portland State Vikings,M. Starks,4702888,,False,19.0,0,1,0,0,0,1,4,4,0,6,6,2,1,0,2,4,4
401403311,Portland State Vikings,P. Dawson,4702138,,False,1.0,0,0,0,0,0,0,2,2,0,0,0,0,0,0,0,0,2
401403311,Portland State Vikings,M. Ruffin,4593785,,False,24.0,4,7,4,6,0,1,0,0,2,0,2,1,2,0,2,3,8
401403311,Portland State Vikings,TEAM,TOTAL,TOTAL,False,,24,52,19,37,5,15,13,19,2,22,24,10,8,2,11,25,66
401403311,Idaho State Bengals,J. Rodriguez,4278606,,True,20.0,1,6,1,3,0,3,2,2,2,6,8,0,0,0,4,5,4
401403311,Idaho State Bengals,B. Parker,4592600,,True,18.0,2,4,2,4,0,0,1,1,0,0,0,0,0,0,0,1,5
401403311,Idaho State Bengals,A. Burgin,4897897,,True,26.0,2,10,2,4,0,6,1,2,2,3,5,1,2,0,1,4,5
401403311,Idaho State Bengals,T. Cool,4592593,,True,25.0,2,7,2,5,0,2,1,2,0,4,4,1,2,0,2,2,5
401403311,Idaho State Bengals,A. Smellie,4397289,,True,36.0,2,6,2,4,0,2,1,2,4,3,7,0,0,0,3,2,5
401403311,Idaho State Bengals,M. Porter,4592594,,False,21.0,2,9,2,9,0,0,4,6,1,5,6,0,0,1,1,1,8
401403311,Idaho State Bengals,D. Carr,4397362,,False,20.0,1,1,1,1,0,0,4,8,1,2,3,0,0,0,1,1,6
401403311,Idaho State Bengals,P. Tamba,4897898,,False,1.0,0,0,0,0,0,0,0,0,0,0,0,0,0,0,0,0,0
401403311,Idaho State Bengals,G. Buzangu,4701587,,False,1.0,0,0,0,0,0,0,0,0,0,0,0,0,0,0,0,0,0
401403311,Idaho State Bengals,E. Taylor III,4701580,,False,1.0,0,0,0,0,0,0,0,0,0,0,0,0,0,0,0,0,0
401403311,Idaho State Bengals,L. Sorensen,4701579,,False,31.0,4,7,4,5,0,2,6,7,0,4,4,1,0,0,7,3,14
401403311,Idaho State Bengals,TEAM,TOTAL,TOTAL,False,,16,50,16,35,0,15,20,30,14,29,43,3,4,1,20,19,52
401403310,Sacramento State Hornets,J. Komagum,4703542,,True,31.0,0,0,0,0,0,0,1,2,0,3,3,0,2,4,0,4,1
401403310,Sacramento State Hornets,C. Wilbon,4397994,,True,37.0,7,15,6,12,1,3,3,6,4,2,6,2,2,1,1,1,18
401403310,Sacramento State Hornets,W. FitzPatrick,4592634,,True,34.0,0,4,0,3,0,1,0,0,0,3,3,1,0,0,0,1,0
401403310,Sacramento State Hornets,Z. Chappell,4397395,,True,31.0,3,10,0,4,3,6,0,0,0,2,2,1,0,0,1,2,9
401403310,Sacramento State Hornets,B. Fowler,4278663,,True,39.0,10,19,10,17,0,2,6,9,0,8,8,4,2,0,3,2,26
401403310,Sacramento State Hornets,H. Clarkin,4703347,,False,8.0,0,0,0,0,0,0,0,0,0,1,1,0,0,0,0,0,0
401403310,Sacramento State Hornets,R. Barros III,4592632,,False,17.0,1,2,0,0,1,2,0,0,0,1,1,0,0,0,0,3,3
401403310,Sacramento State Hornets,E. McCullough,4397327,,False,4.0,0,2,0,0,0,2,0,0,0,0,0,0,0,0,0,0,0
401403310,Sacramento State Hornets,TEAM,TOTAL,TOTAL,False,,21,52,16,36,5,16,10,17,6,20,26,8,6,5,5,13,57
401403310,Idaho Vandals,T. Christensen,4701576,,True,31.0,4,6,4,6,0,0,0,3,2,9,11,0,0,0,0,1,8
401403310,Idaho Vandals,Y. Salih,4897877,,True,31.0,3,5,0,0,3,5,0,0,0,4,4,1,0,0,3,4,9
401403310,Idaho Vandals,R. Smith,4702028,,True,32.0,3,8,3,7,0,1,1,2,3,4,7,1,0,1,2,3,7
401403310,Idaho Vandals,T. Anderson,4397741,,True,27.0,5,12,4,8,1,4,0,0,0,3,3,1,0,0,1,1,11
401403310,Idaho Vandals,M. Dixon,4070682,,True,35.0,4,13,3,8,1,5,0,1,1,2,3,3,1,1,2,2,9
401403310,Idaho Vandals,P. Pepple Jr.,4703383,,False,9.0,2,4,2,4,0,0,0,0,2,1,3,0,0,0,0,0,4
401403310,Idaho Vandals,E. Kilgore,4701575,,False,12.0,0,1,0,0,0,1,0,0,0,1,1,0,0,0,1,1,0
401403310,Idaho Vandals,G. Quinnett,4592592,,False,5.0,0,0,0,0,0,0,0,0,0,0,0,0,0,0,0,0,0
401403310,Idaho Vandals,J. King,4407459,,False,18.0,3,6,3,5,0,1,0,0,0,1,1,2,1,0,4,3,6
401403310,Idaho Vandals,TEAM,TOTAL,TOTAL,False,,24,55,19,38,5,17,1,6,11,26,37,8,2,2,13,15,54
401402797,Saint Peter's Peacocks,O. Diahame,4703529,,True,12.0,1,2,1,2,0,0,0,0,0,3,3,0,0,0,0,2,2
401402797,Saint Peter's Peacocks,H. Drame,4593387,,True,15.0,1,2,0,0,1,2,1,2,1,0,1,0,1,0,4,2,4
401402797,Saint Peter's Peacocks,K. Ndefo,4398386,,True,23.0,5,5,5,5,0,0,2,3,0,4,4,3,2,2,5,2,12
401402797,Saint Peter's Peacocks,M. Lee,4593388,,True,19.0,0,1,0,1,0,0,0,0,0,0,0,2,1,0,1,1,0
401402797,Saint Peter's Peacocks,D. Banks III,4593386,,True,22.0,4,9,3,4,1,5,4,4,1,1,2,1,2,1,0,2,13
401402797,Saint Peter's Peacocks,C. Rupert,4898258,,False,17.0,0,3,0,3,0,0,4,5,2,2,4,2,0,0,1,2,4
401402797,Saint Peter's Peacocks,F. Drame,4432970,,False,25.0,4,4,4,4,0,0,4,7,3,2,5,0,1,2,1,2,12
401402797,Saint Peter's Peacocks,L. Reid,4898255,,False,1.0,0,0,0,0,0,0,0,0,0,1,1,1,1,0,0,0,0
401402797,Saint Peter's Peacocks,M. Silvera,4703527,,False,2.0,0,0,0,0,0,0,0,0,0,0,0,0,0,0,0,0,0
401402797,Saint Peter's Peacocks,I. Dasher,4701199,,False,17.0,2,5,2,4,0,1,1,2,1,2,3,0,0,1,0,2,5
401402797,Saint Peter's Peacocks,J. Murray,4683865,,False,20.0,4,9,3,6,1,3,0,0,0,3,3,0,1,0,2,2,9
401402797,Saint Peter's Peacocks,D. Edert,4432977,,False,27.0,4,10,3,5,1,5,3,4,0,3,3,0,1,0,0,2,12
401402797,Saint Peter's Peacocks,TEAM,TOTAL,TOTAL,False,,25,50,21,34,4,16,19,27,12,23,35,9,10,6,15,19,73
401402797,Manhattan Jaspers,S. Diallo,4397161,,True,26.0,1,5,1,4,0,1,2,2,1,3,4,2,4,0,5,3,4
401402797,Manhattan Jaspers,W. Williams,4279701,,True,17.0,5,8,5,8,0,0,2,2,2,4,6,1,0,2,1,4,12
401402797,Manhattan Jaspers,M. Watson,4703172,,True,27.0,1,4,0,1,1,3,0,0,2,0,2,1,0,0,5,2,3
401402797,Manhattan Jaspers,J. Perez,4397528,,True,32.0,1,11,1,10,0,1,4,6,1,0,1,3,0,0,1,1,6
401402797,Manhattan Jaspers,A. Nelson,4397118,,True,13.0,1,2,0,0,1,2,0,0,0,2,2,2,0,0,2,1,3
401402797,Manhattan Jaspers,A. Cisse,4593329,,False,3.0,0,0,0,0,0,0,0,0,1,0,1,0,0,0,0,2,0
401402797,Manhattan Jaspers,J. Roberts,4397122,,False,21.0,2,3,2,3,0,0,1,4,4,4,8,0,1,1,1,3,5
401402797,Manhattan Jaspers,N. Brennen,4703175,,False,20.0,3,7,1,2,2,5,0,0,1,2,3,0,0,0,0,2,8
401402797,Manhattan Jaspers,R. Reid,4593324,,False,16.0,1,4,0,1,1,3,0,0,0,0,0,0,0,0,4,3,3
401402797,Manhattan Jaspers,E. Buchanan,4398103,,False,25.0,2,11,1,7,1,4,2,5,1,3,4,1,1,0,0,3,7
401402797,Manhattan Jaspers,TEAM,TOTAL,TOTAL,False,,17,55,11,36,6,19,11,19,18,19,37,10,6,3,20,24,51
401382341,Southern Jaguars,T. Williams Jr.,4594110,,True,29.0,4,12,3,7,1,5,2,2,0,1,1,0,2,0,1,4,11
401382341,Southern Jaguars,D. Sears,4067150,,True,7.0,0,0,0,0,0,0,0,0,0,1,1,0,0,0,0,1,0
401382341,Southern Jaguars,J. Saddler,4402919,,True,37.0,8,15,8,15,0,0,2,2,1,2,3,1,3,0,2,2,18
401382341,Southern Jaguars,T. Lyons,4398221,,True,36.0,7,10,6,8,1,2,6,10,5,5,10,1,4,1,3,2,21
401382341,Southern Jaguars,P. Byrd,4397229,,True,28.0,2,5,2,4,0,1,5,6,0,1,1,1,3,0,4,2,9
401382341,Southern Jaguars,J. Ewing,4897807,,False,16.0,0,1,0,1,0,0,0,2,0,3,3,1,1,1,1,3,0
401382341,Southern Jaguars,G. Harris,4897808,,False,1.0,0,0,0,0,0,0,0,0,0,0,0,0,0,0,0,0,0
401382341,Southern Jaguars,J. Holliday,4593685,,False,15.0,2,6,2,5,0,1,2,4,0,0,0,1,2,0,2,3,6
401382341,Southern Jaguars,B. Brooks,4402918,,False,7.0,0,0,0,0,0,0,2,2,0,1,1,0,0,0,0,0,2
401382341,Southern Jaguars,I. Rollins,4398430,,False,6.0,0,3,0,1,0,2,0,0,0,1,1,0,0,0,0,0,0
401382341,Southern Jaguars,B. Whitley,4279890,,False,18.0,0,4,0,1,0,3,0,0,0,0,0,0,0,0,1,4,0
401382341,Southern Jaguars,TEAM,TOTAL,TOTAL,False,,23,56,21,42,2,14,19,28,9,17,26,5,15,2,15,21,67
401382341,Alabama State Hornets,J. O'Neal,4703116,,True,17.0,1,4,1,4,0,0,0,0,2,2,4,2,0,0,0,1,2
401382341,Alabama State Hornets,G. Liddell,4397076,,True,33.0,6,8,5,7,1,1,2,4,3,7,10,1,1,3,6,4,15
401382341,Alabama State Hornets,I. Range,4705379,,True,22.0,4,7,2,4,2,3,4,5,1,5,6,0,1,1,4,3,14
401382341,Alabama State Hornets,E. Clark,4703117,,True,37.0,4,7,4,6,0,1,8,8,0,2,2,3,0,1,5,4,16
401382341,Alabama State Hornets,K. Strawbridge,4395991,,True,36.0,5,10,5,7,0,3,5,6,3,4,7,3,1,0,3,1,15
401382341,Alabama State Hornets,T. Young,4397447,,False,22.0,1,1,0,0,1,1,2,2,0,5,5,0,1,0,5,5,5
401382341,Alabama State Hornets,J. Reyna,4897872,,False,27.0,4,7,2,2,2,5,0,2,0,0,0,2,3,0,3,3,10
401382341,Alabama State Hornets,C. McCray,4702483,,False,6.0,0,3,0,3,0,0,0,0,0,0,0,0,0,1,1,0,0
401382341,Alabama State Hornets,TEAM,TOTAL,TOTAL,False,,25,47,19,33,6,14,21,27,10,28,38,11,7,6,28,21,77
401381915,South Carolina State Bulldogs,J. Davis,4898328,,True,30.0,4,8,4,7,0,1,0,0,1,2,3,2,0,4,3,1,8
401381915,South Carolina State Bulldogs,D. Williams,4286093,,True,13.0,0,3,0,3,0,0,1,2,4,2,6,0,0,1,2,1,1
401381915,South Carolina State Bulldogs,O. Croskey,4593418,,True,30.0,2,7,1,3,1,4,0,0,1,3,4,1,3,1,2,5,5
401381915,South Carolina State Bulldogs,TJ Madlock,4898331,,True,37.0,6,14,2,7,4,7,7,10,1,4,5,2,0,0,0,4,23
401381915,South Carolina State Bulldogs,R. Edwards,4593417,,True,27.0,4,16,2,8,2,8,3,3,1,1,2,2,0,0,0,1,13
401381915,South Carolina State Bulldogs,R. Gary,4898329,,False,14.0,2,2,0,0,2,2,0,0,0,0,0,2,0,0,1,2,6
401381915,South Carolina State Bulldogs,L. Lawrence,4704080,,False,10.0,0,3,0,2,0,1,0,0,2,1,3,0,0,1,1,1,0
401381915,South Carolina State Bulldogs,E. Oliver-Hampton,4592668,,False,27.0,2,5,2,4,0,1,0,0,2,4,6,0,0,1,1,4,4
401381915,South Carolina State Bulldogs,R. Brown,4432948,,False,12.0,1,4,1,3,0,1,0,0,1,1,2,0,1,0,0,2,2
401381915,South Carolina State Bulldogs,TEAM,TOTAL,TOTAL,False,,21,62,12,37,9,25,11,15,15,20,35,9,4,8,10,21,62
401381915,North Carolina Central Eagles,C. Butler,4898289,,True,29.0,4,4,4,4,0,0,1,2,2,3,5,0,0,1,1,4,9
401381915,North Carolina Central Eagles,K. Monroe,4397106,,True,38.0,4,8,4,7,0,1,2,4,1,7,8,4,1,2,0,3,10
401381915,North Carolina Central Eagles,J. Wright,4704109,,True,29.0,8,15,5,10,3,5,5,7,0,3,3,1,2,0,4,2,24
401381915,North Carolina Central Eagles,E. Boone,4702114,,True,40.0,5,10,4,9,1,1,1,5,3,9,12,3,1,2,4,3,12
401381915,North Carolina Central Eagles,R. Miller Jr.,4398239,,True,31.0,1,5,0,3,1,2,0,2,0,1,1,2,0,0,1,3,3
401381915,North Carolina Central Eagles,D. King,4598389,,False,4.0,1,1,1,1,0,0,0,0,0,0,0,0,0,0,0,0,2
401381915,North Carolina Central Eagles,J. Harris,4593705,,False,5.0,0,1,0,0,0,1,0,0,0,0,0,0,1,0,1,0,0
401381915,North Carolina Central Eagles,N. Fennell,4398240,,False,9.0,0,3,0,2,0,1,2,2,2,3,5,1,0,0,0,0,2
401381915,North Carolina Central Eagles,M. Maultsby,4396576,,False,15.0,2,5,1,4,1,1,0,0,0,0,0,0,0,0,1,0,5
401381915,North Carolina Central Eagles,TEAM,TOTAL,TOTAL,False,,25,52,19,40,6,12,11,22,11,28,39,11,5,5,13,15,67
401381764,Southern Jaguars,T. Williams Jr.,4594110,,True,34.0,1,7,1,6,0,1,4,6,4,4,8,1,0,1,2,1,6
401381764,Southern Jaguars,K. Parker,4594117,,True,3.0,0,0,0,0,0,0,0,0,0,1,1,0,0,0,0,0,0
401381764,Southern Jaguars,J. Saddler,4402919,,True,32.0,6,12,6,12,0,0,1,1,0,1,1,0,2,0,2,2,13
401381764,Southern Jaguars,T. Lyons,4398221,,True,27.0,4,11,4,9,0,2,4,6,1,5,6,1,3,0,1,3,12
401381764,Southern Jaguars,P. Byrd,4397229,,True,16.0,0,3,0,1,0,2,0,0,0,0,0,1,0,0,2,1,0
401381764,Southern Jaguars,J. Ewing,4897807,,False,24.0,1,2,1,2,0,0,0,0,1,5,6,0,2,0,2,4,2
401381764,Southern Jaguars,D. Sears,4067150,,False,13.0,0,2,0,2,0,0,0,0,1,5,6,2,0,0,2,1,0
401381764,Southern Jaguars,J. Holliday,4593685,,False,13.0,0,0,0,0,0,0,1,2,0,1,1,1,0,1,0,2,1
401381764,Southern Jaguars,B. Brooks,4402918,,False,11.0,1,6,0,2,1,4,0,0,0,1,1,1,0,0,0,0,3
401381764,Southern Jaguars,I. Rollins,4398430,,False,9.0,2,5,0,1,2,4,0,0,0,0,0,1,0,0,0,0,6
401381764,Southern Jaguars,B. Whitley,4279890,,False,16.0,2,7,2,4,0,3,1,2,2,1,3,0,1,0,3,0,5
401381764,Southern Jaguars,A. Shivers,4067352,,False,2.0,1,3,1,1,0,2,0,0,0,3,3,0,0,0,0,0,2
401381764,Southern Jaguars,TEAM,TOTAL,TOTAL,False,,18,58,15,40,3,18,11,17,11,34,45,8,8,2,14,14,50
401381764,Alabama A&M Bulldogs,M. Parker,4703104,,True,19.0,0,4,0,2,0,2,0,0,1,1,2,1,0,0,1,1,0
401381764,Alabama A&M Bulldogs,J. Johnson,4594013,,True,35.0,7,22,7,21,0,1,2,2,3,5,8,1,1,2,2,3,16
401381764,Alabama A&M Bulldogs,G. Hicks,4594014,,True,35.0,5,13,3,6,2,7,0,0,0,8,8,0,4,0,0,1,12
401381764,Alabama A&M Bulldogs,C. Tucker,4594012,,True,36.0,0,8,0,7,0,1,5,6,1,1,2,2,0,0,3,1,5
401381764,Alabama A&M Bulldogs,B. Powell,4397898,,True,9.0,0,2,0,2,0,0,0,0,1,1,2,0,0,0,1,3,0
401381764,Alabama A&M Bulldogs,A. Cortez,4703108,,False,12.0,0,0,0,0,0,0,0,0,1,2,3,0,0,1,1,0,0
401381764,Alabama A&M Bulldogs,E. Williams,4594016,,False,20.0,2,4,2,4,0,0,2,2,1,1,2,1,0,0,2,3,6
401381764,Alabama A&M Bulldogs,E. Lee,4703109,,False,11.0,1,4,1,3,0,1,0,0,1,1,2,0,1,0,1,2,2
401381764,Alabama A&M Bulldogs,D. Smith,4703106,,False,23.0,2,3,0,0,2,3,2,5,1,5,6,0,1,1,0,4,8
401381764,Alabama A&M Bulldogs,TEAM,TOTAL,TOTAL,False,,17,60,13,45,4,15,11,15,11,30,41,5,7,4,11,18,49
401381696,Norfolk State Spartans,D. Tate,4397180,,True,22.0,1,3,1,2,0,1,0,2,2,1,3,1,1,0,0,1,2
401381696,Norfolk State Spartans,K. Bankston,4280289,,True,21.0,7,9,7,9,0,0,1,1,3,3,6,1,1,1,0,4,15
401381696,Norfolk State Spartans,J. Hawkins,4593134,,True,29.0,6,11,6,8,0,3,1,3,0,2,2,3,1,0,2,1,13
401381696,Norfolk State Spartans,T. Jenkins,4595430,,True,26.0,1,5,1,2,0,3,0,0,3,2,5,1,0,1,2,4,2
401381696,Norfolk State Spartans,J. Bryant Jr.,4398206,,True,34.0,11,22,6,14,5,8,0,0,2,4,6,0,3,0,2,2,27
401381696,Norfolk State Spartans,N. Chambers,4593404,,False,17.0,1,1,1,1,0,0,2,2,1,6,7,1,0,3,0,1,4
401381696,Norfolk State Spartans,C. Ford,4398209,,False,3.0,0,1,0,1,0,0,0,0,0,0,0,0,0,0,0,0,0
401381696,Norfolk State Spartans,T. Jones,4898280,,False,3.0,0,1,0,1,0,0,2,2,0,1,1,0,0,0,0,0,2
401381696,Norfolk State Spartans,A. Bottoms,4704103,,False,6.0,0,0,0,0,0,0,3,4,0,0,0,0,0,0,0,0,3
401381696,Norfolk State Spartans,Y. Sidibe,4595433,,False,2.0,0,0,0,0,0,0,1,2,1,1,2,0,0,0,0,0,1
401381696,Norfolk State Spartans,D. Anderson,4593406,,False,16.0,1,3,0,1,1,2,0,0,1,3,4,1,0,1,0,2,3
401381696,Norfolk State Spartans,C. Ings,4431996,,False,21.0,3,9,2,7,1,2,4,5,0,2,2,3,1,0,2,1,11
401381696,Norfolk State Spartans,TEAM,TOTAL,TOTAL,False,,31,65,24,46,7,19,14,21,16,28,44,11,7,6,9,16,83
401381696,Howard Bison,S. Settle III,4704043,,True,33.0,5,11,3,6,2,5,3,5,1,3,4,1,0,0,0,0,15
401381696,Howard Bison,R. Brumant,4279466,,True,21.0,3,7,3,7,0,0,1,3,2,1,3,1,0,1,0,2,7
401381696,Howard Bison,E. Hawkins,4897766,,True,26.0,3,9,1,4,2,5,3,4,0,2,2,2,0,0,2,4,11
401381696,Howard Bison,K. Foster,4279792,,True,34.0,3,12,1,3,2,9,0,0,0,3,3,1,1,0,0,3,8
401381696,Howard Bison,T. Bibbs,4279470,,True,16.0,0,3,0,1,0,2,0,0,1,1,2,2,0,1,1,1,0
401381696,Howard Bison,A. Vidmar,4897767,,False,4.0,0,1,0,0,0,1,0,0,0,0,0,0,0,0,0,2,0
401381696,Howard Bison,J. Wood,4704048,,False,7.0,0,0,0,0,0,0,0,0,0,1,1,0,0,0,0,0,0
401381696,Howard Bison,S. Green,4067227,,False,10.0,0,2,0,0,0,2,3,4,0,2,2,0,0,0,2,2,3
401381696,Howard Bison,B. Harris,4897768,,False,15.0,2,6,2,5,0,1,2,5,2,2,4,1,0,0,3,1,6
401381696,Howard Bison,D. Richmond,4704044,,False,2.0,0,0,0,0,0,0,0,0,0,0,0,0,0,0,0,0,0
401381696,Howard Bison,T. Weaver,4704042,,False,5.0,0,0,0,0,0,0,0,0,0,0,0,1,0,0,0,1,0
401381696,Howard Bison,K. Robinson,4432102,,False,27.0,4,8,1,4,3,4,0,0,0,2,2,0,1,0,0,2,11
401381696,Howard Bison,TEAM,TOTAL,TOTAL,False,,20,59,11,30,9,29,12,21,10,20,30,9,2,2,9,18,61
401378802,Utah State Aggies,B. Horvath,4279162,,True,25.0,6,14,4,8,2,6,2,2,2,6,8,3,1,0,3,4,16
401378802,Utah State Aggies,J. Bean,4278720,,True,38.0,7,15,4,10,3,5,1,2,5,6,11,2,0,0,3,1,18
401378802,Utah State Aggies,S. Bairstow,4593102,,True,30.0,5,7,5,7,0,0,3,7,3,1,4,2,0,0,1,3,13
401378802,Utah State Aggies,R. Jones,4431751,,True,33.0,3,6,1,1,2,5,0,0,0,6,6,5,0,0,3,4,8
401378802,Utah State Aggies,RJ Eytle-Rock,4396591,,True,28.0,2,4,1,2,1,2,2,2,0,3,3,3,0,0,1,4,7
401378802,Utah State Aggies,N. Thelissen,4897547,,False,1.0,0,0,0,0,0,0,0,0,0,0,0,0,0,1,0,0,0
401378802,Utah State Aggies,T. Wagstaff,4593977,,False,1.0,0,1,0,1,0,0,0,0,1,0,1,0,0,0,0,0,0
401378802,Utah State Aggies,S. Zapala,4701993,,False,4.0,1,1,1,1,0,0,0,0,0,1,1,0,0,0,1,1,2
401378802,Utah State Aggies,T. Dorius,4066764,,False,4.0,0,0,0,0,0,0,0,0,0,1,1,0,0,0,0,0,0
401378802,Utah State Aggies,Z. Hamoda,4897548,,False,10.0,0,1,0,0,0,1,0,0,0,1,1,0,0,0,1,0,0
401378802,Utah State Aggies,M. Shulga,4701992,,False,26.0,4,5,1,2,3,3,0,0,0,3,3,3,0,0,3,2,11
401378802,Utah State Aggies,TEAM,TOTAL,TOTAL,False,,28,54,17,32,11,22,8,13,13,29,42,18,1,1,16,19,75
401378802,San José State Spartans,I. Diallo,4592720,,True,22.0,3,5,3,5,0,0,1,4,1,1,2,1,1,1,4,1,7
401378802,San José State Spartans,T. Anderson,4593007,,True,28.0,4,6,0,1,4,5,0,2,2,0,2,1,0,0,0,4,12
401378802,San José State Spartans,A. Cardenas Torre,4897535,,True,29.0,1,3,0,1,1,2,0,0,1,1,2,4,1,0,0,2,3
401378802,San José State Spartans,O. Moore,4593095,,True,23.0,2,7,2,4,0,3,2,4,1,4,5,4,3,2,4,5,6
401378802,San José State Spartans,C. Simmons,4278716,,True,24.0,0,5,0,2,0,3,0,0,0,2,2,0,3,0,1,1,0
401378802,San José State Spartans,T. Gorener,4702371,,False,28.0,1,6,1,1,0,5,0,0,0,1,1,0,0,0,0,1,2
401378802,San José State Spartans,S. Robinson,4593017,,False,13.0,5,6,4,5,1,1,0,1,0,0,0,0,1,0,3,2,11
401378802,San José State Spartans,H. Dhaliwal,4593099,,False,2.0,0,1,0,1,0,0,0,0,0,1,1,0,0,1,0,0,0
401378802,San José State Spartans,M. Amey Jr.,4897534,,False,27.0,4,11,4,7,0,4,3,4,2,2,4,4,3,0,3,1,11
401378802,San José State Spartans,J. O'Garro,4684167,,False,4.0,0,1,0,1,0,0,0,0,0,0,0,0,0,0,0,1,0
401378802,San José State Spartans,TEAM,TOTAL,TOTAL,False,,20,51,14,28,6,23,6,15,9,15,24,14,12,4,16,18,52
401378660,Mississippi Valley State Delta Devils,G. Grant,4899805,,True,25.0,4,6,4,5,0,1,2,3,0,2,2,0,0,0,3,3,10
401378660,Mississippi Valley State Delta Devils,A. Perry,4705890,,True,35.0,3,8,0,2,3,6,2,2,0,4,4,3,1,0,1,2,11
401378660,Mississippi Valley State Delta Devils,D. Umoh,4899810,,True,8.0,3,5,3,5,0,0,0,0,0,0,0,1,0,0,1,2,6
401378660,Mississippi Valley State Delta Devils,T. Collins,4705894,,True,40.0,6,18,3,7,3,11,1,1,0,3,3,1,1,0,2,2,16
401378660,Mississippi Valley State Delta Devils,Q. Waldon,4899809,,False,6.0,0,0,0,0,0,0,0,0,0,0,0,0,0,0,0,0,0
401378660,Mississippi Valley State Delta Devils,J. Aguer,4899808,,False,7.0,0,0,0,0,0,0,0,0,0,1,1,0,0,0,1,2,0
401378660,Mississippi Valley State Delta Devils,D. Gordon,4705893,,False,0.0,0,0,0,0,0,0,0,0,0,0,0,0,0,0,0,0,0
401378660,Mississippi Valley State Delta Devils,G. Ivory III,4703150,,False,22.0,3,3,2,2,1,1,0,0,0,3,3,1,0,0,1,1,7
401378660,Mississippi Valley State Delta Devils,J. Johnson,4597906,,False,24.0,2,2,2,2,0,0,1,4,1,4,5,0,0,0,1,3,5
401378660,Mississippi Valley State Delta Devils,D. McCoy,4593270,,False,33.0,5,14,4,12,1,2,3,3,2,5,7,6,1,0,2,3,14
401378660,Mississippi Valley State Delta Devils,TEAM,TOTAL,TOTAL,False,,26,56,18,35,8,21,9,13,4,24,28,12,3,0,13,18,69
401378660,Jackson State Tigers,J. McKinnis,4403417,,True,33.0,5,9,5,9,0,0,5,6,1,11,12,0,0,0,1,5,15
401378660,Jackson State Tigers,D. Hicks,4065698,,True,9.0,1,3,0,2,1,1,2,2,2,1,3,2,0,0,0,0,5
401378660,Jackson State Tigers,J. James,4594075,,True,27.0,7,12,5,9,2,3,0,0,0,2,2,4,1,0,2,2,16
401378660,Jackson State Tigers,D. Wilson,4406975,,True,29.0,1,3,0,0,1,3,1,2,0,1,1,1,1,0,1,1,4
401378660,Jackson State Tigers,D. Taylor,4288220,,True,33.0,5,11,4,9,1,2,2,2,1,1,2,4,1,0,3,2,13
401378660,Jackson State Tigers,J. Jones,4703203,,False,2.0,1,2,1,2,0,0,0,0,0,0,0,0,0,0,0,0,2
401378660,Jackson State Tigers,T. Lewis II,4702774,,False,31.0,3,4,3,4,0,0,1,2,3,7,10,1,0,0,1,3,7
401378660,Jackson State Tigers,M. Wideman,4899538,,False,7.0,1,2,1,2,0,0,0,0,0,1,1,0,0,0,1,0,2
401378660,Jackson State Tigers,C. Young,4899535,,False,7.0,1,3,1,1,0,2,0,0,0,0,0,1,0,0,0,0,2
401378660,Jackson State Tigers,K. Evans,4594079,,False,22.0,3,8,1,2,2,6,2,3,0,2,2,3,0,0,0,1,10
401378660,Jackson State Tigers,TEAM,TOTAL,TOTAL,False,,28,57,21,40,7,17,13,17,7,28,35,16,3,0,9,14,76
401377788,UCF Knights,C.J. Walker,4592403,,True,38.0,8,14,7,12,1,2,2,4,2,2,4,0,1,0,0,1,19
401377788,UCF Knights,C. Diong,4278951,,True,25.0,0,1,0,1,0,0,1,4,2,6,8,1,3,0,3,4,1
401377788,UCF Knights,I. Adams,4433527,,True,3.0,0,0,0,0,0,0,0,0,0,0,0,0,0,0,1,0,0
401377788,UCF Knights,D. Johnson,4684809,,True,30.0,3,7,2,3,1,4,0,0,0,5,5,9,2,0,2,4,7
401377788,UCF Knights,D. Green Jr.,4593839,,True,38.0,7,16,2,4,5,12,0,2,0,3,3,2,2,0,0,3,19
401377788,UCF Knights,J. Reynolds,4432407,,False,14.0,1,3,1,3,0,0,0,0,1,0,1,0,1,0,3,3,2
401377788,UCF Knights,T. Freeman,4897194,,False,17.0,2,5,1,3,1,2,2,2,2,1,3,0,0,0,0,2,7
401377788,UCF Knights,D. Fuller Jr.,4396670,,False,6.0,0,3,0,3,0,0,0,0,1,2,3,0,0,0,0,1,0
401377788,UCF Knights,D. Perry,4277878,,False,29.0,6,10,5,5,1,5,4,6,2,5,7,3,1,0,3,1,17
401377788,UCF Knights,TEAM,TOTAL,TOTAL,False,,27,59,18,34,9,25,9,18,11,26,37,15,10,0,13,19,72
401377788,Tulsa Golden Hurricane,R. Idowu,4397373,,True,30.0,3,6,3,6,0,0,1,3,3,2,5,1,0,0,1,2,7
401377788,Tulsa Golden Hurricane,J. Horne,4066390,,True,37.0,7,17,2,6,5,11,2,2,2,7,9,1,1,0,2,2,21
401377788,Tulsa Golden Hurricane,C. Haywood II,4593833,,True,35.0,0,4,0,2,0,2,0,2,0,8,8,5,2,0,4,2,0
401377788,Tulsa Golden Hurricane,L. Draine,4279101,,True,12.0,1,6,0,0,1,6,0,0,0,3,3,0,2,0,1,1,3
401377788,Tulsa Golden Hurricane,D. Jackson,4278408,,True,35.0,8,12,5,8,3,4,3,3,0,2,2,2,0,0,4,2,22
401377788,Tulsa Golden Hurricane,N. Konstantynovskyi,4897154,,False,10.0,2,2,2,2,0,0,1,4,3,1,4,0,0,0,0,1,5
401377788,Tulsa Golden Hurricane,S. Gaston-Chapman,4708216,,False,9.0,0,1,0,1,0,0,0,0,1,0,1,0,0,0,0,1,0
401377788,Tulsa Golden Hurricane,S. Griffin,4432994,,False,32.0,4,9,1,3,3,6,4,4,0,2,2,3,0,0,2,2,15
401377788,Tulsa Golden Hurricane,TEAM,TOTAL,TOTAL,False,,25,57,13,28,12,29,11,18,10,27,37,12,5,0,14,13,73
401377787,Memphis Tigers,D. Williams,4397355,,True,21.0,4,9,4,8,0,1,0,1,1,1,2,1,1,0,1,3,8
401377787,Memphis Tigers,J. Duren,4433621,,True,21.0,3,5,3,5,0,0,2,3,5,3,8,3,0,0,3,4,8
401377787,Memphis Tigers,L. Nolley II,4395684,,True,32.0,4,8,2,4,2,4,1,2,0,4,4,3,2,0,4,2,11
401377787,Memphis Tigers,L. Quinones,4431720,,True,33.0,3,7,1,3,2,4,3,4,1,1,2,1,3,0,1,0,11
401377787,Memphis Tigers,A. Lomax,4396633,,True,28.0,2,4,2,4,0,0,4,4,0,3,3,3,5,1,3,2,8
401377787,Memphis Tigers,M. Dandridge,4431738,,False,12.0,0,2,0,2,0,0,4,4,1,2,3,2,1,1,1,4,4
401377787,Memphis Tigers,J. Minott,4687718,,False,13.0,3,4,3,4,0,0,0,0,1,1,2,0,1,0,1,1,6
401377787,Memphis Tigers,C. Lawson,4431721,,False,8.0,0,0,0,0,0,0,2,2,0,1,1,0,0,0,0,0,2
401377787,Memphis Tigers,T. Jacobs,4897070,,False,1.0,0,0,0,0,0,0,0,0,0,0,0,0,0,0,0,0,0
401377787,Memphis Tigers,C. Glennon,4701207,,False,1.0,0,0,0,0,0,0,0,0,0,0,0,0,0,0,0,0,0
401377787,Memphis Tigers,E. Timberlake,4432193,,False,5.0,1,1,1,1,0,0,0,0,2,0,2,0,0,0,1,1,2
401377787,Memphis Tigers,T. Harris,4396632,,False,25.0,6,14,3,8,3,6,0,0,0,3,3,1,1,0,2,1,15
401377787,Memphis Tigers,TEAM,TOTAL,TOTAL,False,,26,54,19,39,7,15,16,20,13,19,32,14,14,2,17,18,75
401377787,Houston Cougars,F. White Jr.,4278263,,True,34.0,3,6,3,4,0,2,5,8,2,1,3,2,2,1,3,5,11
401377787,Houston Cougars,J. Carlton,4278229,,True,15.0,2,2,2,2,0,0,0,0,1,1,2,1,0,1,3,3,4
401377787,Houston Cougars,J. Shead,4432241,,True,30.0,4,9,3,5,1,4,0,1,1,2,3,8,1,0,4,3,9
401377787,Houston Cougars,K. Edwards,4397081,,True,39.0,6,15,4,6,2,9,5,6,1,6,7,4,3,2,2,0,19
401377787,Houston Cougars,T. Moore,4066808,,True,33.0,5,9,1,3,4,6,2,2,0,1,1,1,4,1,2,4,16
401377787,Houston Cougars,J. Francis,4684301,,False,4.0,0,1,0,1,0,0,0,0,0,1,1,0,0,0,0,0,0
401377787,Houston Cougars,J. Roberts,4433068,,False,18.0,1,1,1,1,0,0,0,0,1,2,3,1,2,0,2,2,2
401377787,Houston Cougars,R. Chaney,4395708,,False,6.0,0,0,0,0,0,0,0,0,0,0,0,0,0,1,1,0,0
401377787,Houston Cougars,R. Armbrester,4684151,,False,7.0,0,3,0,2,0,1,0,0,1,0,1,0,1,0,0,0,0
401377787,Houston Cougars,R. Walker,4708176,,False,13.0,0,1,0,0,0,1,0,0,1,2,3,1,1,0,2,2,0
401377787,Houston Cougars,R. Elvin,4701204,,False,1.0,0,0,0,0,0,0,0,0,0,0,0,0,0,0,0,0,0
401377787,Houston Cougars,TEAM,TOTAL,TOTAL,False,,21,47,14,24,7,23,12,17,9,16,25,18,14,6,20,19,61
401377786,Temple Owls,E. Okpomo,4432517,,True,11.0,1,2,1,2,0,0,2,2,1,0,1,0,0,0,0,2,4
401377786,Temple Owls,N. Jourdain,4701221,,True,18.0,0,5,0,3,0,2,1,2,2,4,6,0,0,2,0,2,1
401377786,Temple Owls,H. Miller,4708218,,True,27.0,1,3,0,1,1,2,0,0,0,4,4,1,0,0,3,2,3
401377786,Temple Owls,J. White,4432514,,True,25.0,2,9,1,8,1,1,4,4,1,6,7,3,1,0,0,0,9
401377786,Temple Owls,D. Dunn,4431946,,True,29.0,8,13,6,7,2,6,9,10,2,7,9,5,1,1,2,1,27
401377786,Temple Owls,Z. Hicks,4708214,,False,20.0,4,9,0,0,4,9,0,0,0,7,7,0,0,0,2,2,12
401377786,Temple Owls,S. Tolbert III,4398355,,False,12.0,0,1,0,1,0,0,0,2,2,2,4,1,0,0,0,1,0
401377786,Temple Owls,J. Forrester,4397009,,False,14.0,1,4,1,4,0,0,3,3,1,1,2,0,0,0,0,2,5
401377786,Temple Owls,A. Parks,4396652,,False,6.0,0,0,0,0,0,0,0,0,0,0,0,0,0,0,1,2,0
401377786,Temple Owls,R. Sayers,4900667,,False,4.0,0,0,0,0,0,0,0,0,0,1,1,1,0,0,0,0,0
401377786,Temple Owls,C. Daly,4711160,,False,5.0,2,2,0,0,2,2,1,2,0,1,1,0,0,0,0,0,7
401377786,Temple Owls,T. Strickland,4397253,,False,29.0,3,8,2,5,1,3,0,0,0,2,2,4,2,0,1,2,7
401377786,Temple Owls,TEAM,TOTAL,TOTAL,False,,22,56,11,31,11,25,20,25,11,35,46,15,4,3,10,16,75
401377786,South Florida Bulls,C. Walker Jr.,4290822,,True,28.0,2,5,2,4,0,1,4,4,1,3,4,1,1,0,2,4,8
401377786,South Florida Bulls,R. Tchewa,4432888,,True,30.0,2,4,2,4,0,0,3,4,1,6,7,0,0,0,0,1,7
401377786,South Florida Bulls,S. Hines Jr.,4702687,,True,28.0,6,9,6,9,0,0,0,0,2,2,4,0,0,2,3,3,12
401377786,South Florida Bulls,C. Murphy,4567587,,True,29.0,2,9,2,9,0,0,3,5,1,2,3,2,1,1,2,0,7
401377786,South Florida Bulls,J. Chaplin,4431925,,True,18.0,2,11,2,7,0,4,0,2,0,1,1,1,1,0,0,1,4
401377786,South Florida Bulls,B. Matos,4612507,,False,10.0,1,3,1,3,0,0,0,0,0,2,2,0,0,1,0,1,2
401377786,South Florida Bulls,J. Boggs,4431899,,False,12.0,0,3,0,0,0,3,0,0,2,1,3,0,0,0,0,1,0
401377786,South Florida Bulls,D. Patrick,4897129,,False,12.0,0,2,0,0,0,2,0,0,0,1,1,0,0,2,0,2,0
401377786,South Florida Bulls,T. Moss,4708220,,False,11.0,1,3,1,1,0,2,0,0,0,1,1,2,0,0,1,1,2
401377786,South Florida Bulls,S. Smith Jr.,4397185,,False,9.0,0,3,0,1,0,2,1,2,0,0,0,0,0,0,0,1,1
401377786,South Florida Bulls,M. Calleja,4396644,,False,4.0,1,1,0,0,1,1,0,0,0,0,0,1,0,0,0,1,3
401377786,South Florida Bulls,J. Greene,4278360,,False,9.0,0,6,0,3,0,3,1,2,0,0,0,1,3,0,0,1,1
401377786,South Florida Bulls,TEAM,TOTAL,TOTAL,False,,17,59,16,41,1,18,12,19,10,23,33,8,6,6,8,17,47
401377785,Tulane Green Wave,K. Cross,4592703,,True,23.0,2,8,2,6,0,2,0,0,4,6,10,6,0,1,4,3,4
401377785,Tulane Green Wave,S. James,4602025,,True,36.0,2,6,2,3,0,3,4,6,2,4,6,4,4,0,2,2,8
401377785,Tulane Green Wave,R.J. McGee,4593828,,True,16.0,2,3,2,2,0,1,0,0,0,2,2,0,2,2,1,1,4
401377785,Tulane Green Wave,J. Forbes,4431722,,True,37.0,6,14,5,11,1,3,3,4,2,5,7,1,0,1,3,4,16
401377785,Tulane Green Wave,D. Baker,4397802,,True,34.0,5,12,5,9,0,3,1,2,0,3,3,1,0,0,0,2,11
401377785,Tulane Green Wave,T. Pope,4593827,,False,13.0,1,1,1,1,0,0,2,2,0,3,3,0,1,1,0,2,4
401377785,Tulane Green Wave,N. Days,4432886,,False,17.0,1,1,1,1,0,0,0,0,1,1,2,2,0,1,0,0,2
401377785,Tulane Green Wave,J. Coleman,4602024,,False,22.0,6,13,3,4,3,9,4,4,1,1,2,0,1,0,2,3,19
401377785,Tulane Green Wave,S. Spencer,4065646,,False,2.0,0,1,0,1,0,0,0,0,0,2,2,0,0,0,0,0,0
401377785,Tulane Green Wave,TEAM,TOTAL,TOTAL,False,,25,59,21,38,4,21,14,18,10,29,39,14,8,6,12,17,68
401377785,SMU Mustangs,T. Clark,4277885,,True,16.0,1,1,1,1,0,0,0,0,1,0,1,2,1,0,0,3,2
401377785,SMU Mustangs,Ma. Weathers,4067390,,True,36.0,5,14,4,11,1,3,1,2,4,9,13,1,0,0,2,2,12
401377785,SMU Mustangs,E. Bandoumel,4593107,,True,37.0,6,15,2,3,4,12,2,2,0,4,4,3,1,1,0,1,18
401377785,SMU Mustangs,K. Davis,4397066,,True,37.0,7,11,3,5,4,6,1,2,0,1,1,4,2,1,3,1,19
401377785,SMU Mustangs,Mi. Weathers,4067391,,True,28.0,5,11,3,8,2,3,4,5,1,5,6,4,1,1,3,3,16
401377785,SMU Mustangs,S. Todorovic,4897080,,False,2.0,0,1,0,0,0,1,0,0,0,1,1,1,0,0,0,2,0
401377785,SMU Mustangs,F. Agunanne,4397431,,False,3.0,0,1,0,1,0,0,0,0,0,0,0,0,0,0,0,0,0
401377785,SMU Mustangs,Z. Phelps,4699725,,False,11.0,0,2,0,1,0,1,1,2,0,0,0,0,0,0,0,0,1
401377785,SMU Mustangs,J. Smith,4690767,,False,6.0,1,1,0,0,1,1,0,0,0,1,1,1,0,0,0,1,3
401377785,SMU Mustangs,Z. Nutall,4398281,,False,24.0,1,3,0,0,1,3,0,0,0,1,1,3,0,1,1,2,3
401377785,SMU Mustangs,TEAM,TOTAL,TOTAL,False,,26,60,13,30,13,30,9,13,7,26,33,19,5,4,9,15,74
401377784,Wichita State Shockers,J. Pleasant,4397958,,True,18.0,1,3,1,1,0,2,0,0,2,3,5,2,1,0,0,2,2
401377784,Wichita State Shockers,M. Udeze,4396681,,True,25.0,6,9,6,9,0,0,0,0,1,4,5,0,0,1,3,2,12
401377784,Wichita State Shockers,C. Porter Jr.,4701233,,True,34.0,6,9,6,9,0,0,3,4,0,10,10,4,1,2,0,3,15
401377784,Wichita State Shockers,T. Etienne,4432887,,True,29.0,4,11,1,3,3,8,1,3,0,2,2,0,3,0,2,2,12
401377784,Wichita State Shockers,D. Dennis,4396676,,True,28.0,1,4,1,1,0,3,3,4,1,2,3,2,1,1,2,4,5
401377784,Wichita State Shockers,C. Jackson,4701238,,False,5.0,0,0,0,0,0,0,0,0,0,2,2,0,0,0,0,0,0
401377784,Wichita State Shockers,K. Pohto,4684445,,False,14.0,1,4,1,3,0,1,0,1,3,0,3,0,0,0,0,0,2
401377784,Wichita State Shockers,Q. Grant,4897201,,False,13.0,1,3,1,3,0,0,0,0,1,2,3,5,3,0,2,1,2
401377784,Wichita State Shockers,C. Jenkins,4701236,,False,3.0,0,0,0,0,0,0,0,0,0,0,0,1,0,0,0,0,0
401377784,Wichita State Shockers,R. Council IV,4701234,,False,30.0,8,15,8,11,0,4,4,4,1,6,7,0,1,0,3,2,20
401377784,Wichita State Shockers,TEAM,TOTAL,TOTAL,False,,28,58,25,40,3,18,11,16,10,31,41,14,10,4,12,16,70
401377784,East Carolina Pirates,V. Jackson,4066442,,True,39.0,3,9,0,4,3,5,1,2,0,6,6,1,1,0,0,2,10
401377784,East Carolina Pirates,L. Debaut,4592970,,True,14.0,1,2,1,2,0,0,0,0,1,1,2,0,2,0,0,3,2
401377784,East Carolina Pirates,T. Robinson-White,4592968,,True,31.0,1,7,0,3,1,4,2,2,0,3,3,2,2,0,1,3,5
401377784,East Carolina Pirates,J.J. Miles,4592967,,True,8.0,1,5,1,3,0,2,0,0,1,0,1,0,0,0,0,1,2
401377784,East Carolina Pirates,T. Newton,4592965,,True,36.0,5,14,4,9,1,5,5,5,3,8,11,6,2,0,5,3,16
401377784,East Carolina Pirates,B. Johnson,4897055,,False,11.0,1,2,1,2,0,0,0,0,1,2,3,0,0,0,2,1,2
401377784,East Carolina Pirates,A. Frink,4396950,,False,15.0,3,4,3,4,0,0,2,3,0,1,1,0,0,1,3,3,8
401377784,East Carolina Pirates,J. Small,4781746,,False,22.0,3,7,1,1,2,6,0,0,0,1,1,4,0,0,1,0,8
401377784,East Carolina Pirates,R. Felton Jr.,4708215,,False,24.0,4,11,3,5,1,6,0,1,1,0,1,1,0,0,0,2,9
401377784,East Carolina Pirates,TEAM,TOTAL,TOTAL,False,,22,61,14,33,8,28,10,13,9,22,31,14,7,1,12,18,62
401377783,UCF Knights,C.J. Walker,4592403,,True,36.0,4,8,3,5,1,3,4,6,4,12,16,1,0,1,1,1,13
401377783,UCF Knights,C. Diong,4278951,,True,23.0,4,6,4,6,0,0,0,0,5,6,11,0,1,0,2,2,8
401377783,UCF Knights,T. Freeman,4897194,,True,25.0,1,9,1,6,0,3,1,2,1,1,2,3,0,0,1,2,3
401377783,UCF Knights,D. Johnson,4684809,,True,31.0,3,11,0,2,3,9,6,7,0,1,1,2,2,0,2,2,15
401377783,UCF Knights,D. Perry,4277878,,True,32.0,4,13,3,4,1,9,1,1,0,0,0,5,2,0,2,3,10
401377783,UCF Knights,J. Reynolds,4432407,,False,15.0,2,2,2,2,0,0,1,2,2,2,4,0,0,2,2,2,5
401377783,UCF Knights,R. Anders,4396674,,False,4.0,2,2,1,1,1,1,0,0,0,0,0,0,0,0,0,0,5
401377783,UCF Knights,I. Adams,4433527,,False,17.0,2,7,1,3,1,4,0,0,0,1,1,2,0,0,1,2,5
401377783,UCF Knights,L. Renaud,4396672,,False,2.0,0,0,0,0,0,0,0,0,0,0,0,0,0,0,0,0,0
401377783,UCF Knights,D. Fuller Jr.,4396670,,False,15.0,1,4,0,2,1,2,0,0,0,1,1,2,2,0,1,1,3
401377783,UCF Knights,TEAM,TOTAL,TOTAL,False,,23,62,15,31,8,31,13,18,14,25,39,15,7,3,12,15,67
401377783,Tulane Green Wave,K. Cross,4592703,,True,23.0,4,9,4,6,0,3,7,7,2,7,9,3,1,0,2,4,15
401377783,Tulane Green Wave,S. James,4602025,,True,36.0,0,1,0,1,0,0,2,2,0,3,3,6,0,0,3,1,2
401377783,Tulane Green Wave,R.J. McGee,4593828,,True,24.0,4,5,2,3,2,2,0,0,0,1,1,1,1,0,1,0,10
401377783,Tulane Green Wave,J. Forbes,4431722,,True,35.0,6,13,2,5,4,8,0,0,1,5,6,1,0,0,1,2,16
401377783,Tulane Green Wave,D. Baker,4397802,,True,35.0,4,9,4,6,0,3,2,3,1,0,1,2,2,0,0,0,10
401377783,Tulane Green Wave,T. Pope,4593827,,False,8.0,2,3,1,1,1,2,1,2,0,1,1,1,0,1,0,1,6
401377783,Tulane Green Wave,O. Jankovic,4592828,,False,1.0,0,0,0,0,0,0,0,0,0,0,0,0,0,0,0,1,0
401377783,Tulane Green Wave,N. Days,4432886,,False,10.0,1,1,1,1,0,0,1,1,2,1,3,0,0,0,0,1,3
401377783,Tulane Green Wave,Q. Scott,4280277,,False,7.0,0,3,0,2,0,1,0,0,0,2,2,0,0,0,0,1,0
401377783,Tulane Green Wave,S. Ryan,4715618,,False,1.0,1,2,1,2,0,0,0,0,1,0,1,0,0,0,0,0,2
401377783,Tulane Green Wave,J. Coleman,4602024,,False,12.0,5,9,2,2,3,7,0,0,0,1,1,0,1,0,2,1,13
401377783,Tulane Green Wave,S. Spencer,4065646,,False,8.0,1,3,0,0,1,3,2,2,0,0,0,0,0,0,1,1,5
401377783,Tulane Green Wave,TEAM,TOTAL,TOTAL,False,,28,58,17,29,11,29,15,17,7,26,33,14,5,1,10,13,82
401377782,Temple Owls,E. Okpomo,4432517,,True,6.0,0,0,0,0,0,0,0,0,0,0,0,0,1,0,0,2,0
401377782,Temple Owls,S. Tolbert III,4398355,,True,16.0,1,3,1,3,0,0,5,6,3,1,4,0,0,0,0,1,7
401377782,Temple Owls,H. Miller,4708218,,True,30.0,0,4,0,3,0,1,0,0,1,2,3,2,0,0,4,1,0
401377782,Temple Owls,D. Dunn,4431946,,True,27.0,2,7,2,6,0,1,1,2,0,3,3,0,0,0,4,2,5
401377782,Temple Owls,T. Strickland,4397253,,True,34.0,1,7,1,5,0,2,4,6,2,3,5,3,3,1,2,0,6
401377782,Temple Owls,Z. Hicks,4708214,,False,29.0,3,4,1,1,2,3,0,0,0,2,2,0,0,1,0,0,8
401377782,Temple Owls,N. Jourdain,4701221,,False,19.0,3,6,2,4,1,2,3,5,1,3,4,1,1,2,3,5,10
401377782,Temple Owls,A. Parks,4396652,,False,10.0,0,0,0,0,0,0,0,1,1,0,1,0,1,0,3,4,0
401377782,Temple Owls,C. Daly,4711160,,False,2.0,0,1,0,0,0,1,0,0,0,0,0,0,0,0,0,0,0
401377782,Temple Owls,J. White,4432514,,False,27.0,3,10,3,8,0,2,4,8,2,2,4,0,2,0,3,3,10
401377782,Temple Owls,TEAM,TOTAL,TOTAL,False,,13,42,10,30,3,12,17,28,12,20,32,6,8,4,20,18,46
401377782,Houston Cougars,F. White Jr.,4278263,,True,33.0,11,18,8,12,3,6,1,3,2,4,6,0,2,1,1,3,26
401377782,Houston Cougars,J. Carlton,4278229,,True,19.0,4,8,4,8,0,0,3,6,7,1,8,1,0,1,2,5,11
401377782,Houston Cougars,J. Shead,4432241,,True,38.0,4,7,2,3,2,4,0,0,0,4,4,13,3,0,1,3,10
401377782,Houston Cougars,K. Edwards,4397081,,True,37.0,3,11,1,2,2,9,1,2,2,3,5,6,3,2,2,2,9
401377782,Houston Cougars,T. Moore,4066808,,True,27.0,8,13,6,8,2,5,1,1,0,4,4,4,2,1,3,4,19
401377782,Houston Cougars,J. Francis,4684301,,False,2.0,0,0,0,0,0,0,0,0,0,0,0,0,0,1,0,1,0
401377782,Houston Cougars,J. Roberts,4433068,,False,21.0,1,3,1,3,0,0,0,2,1,2,3,0,0,1,0,3,2
401377782,Houston Cougars,R. Chaney,4395708,,False,2.0,0,0,0,0,0,0,0,0,0,0,0,0,0,0,0,0,0
401377782,Houston Cougars,R. Armbrester,4684151,,False,7.0,2,3,2,3,0,0,0,0,0,1,1,0,0,0,1,0,4
401377782,Houston Cougars,R. Walker,4708176,,False,13.0,0,0,0,0,0,0,0,0,3,1,4,0,0,0,1,0,0
401377782,Houston Cougars,R. Elvin,4701204,,False,1.0,1,1,0,0,1,1,0,0,0,0,0,0,0,0,0,0,3
401377782,Houston Cougars,TEAM,TOTAL,TOTAL,False,,34,64,24,39,10,25,6,14,15,22,37,24,10,7,11,21,84
401377781,South Florida Bulls,C. Walker Jr.,4290822,,True,34.0,3,7,2,6,1,1,5,5,2,9,11,1,0,4,4,3,12
401377781,South Florida Bulls,R. Tchewa,4432888,,True,24.0,6,7,6,7,0,0,1,2,1,5,6,0,0,0,3,3,13
401377781,South Florida Bulls,S. Hines Jr.,4702687,,True,24.0,0,3,0,3,0,0,2,2,0,3,3,2,0,0,1,3,2
401377781,South Florida Bulls,C. Murphy,4567587,,True,36.0,5,11,4,8,1,3,0,0,0,4,4,8,0,0,1,4,11
401377781,South Florida Bulls,J. Greene,4278360,,True,31.0,3,8,2,3,1,5,0,0,0,0,0,1,1,0,5,5,7
401377781,South Florida Bulls,B. Matos,4612507,,False,7.0,1,3,1,3,0,0,0,0,3,0,3,0,0,0,0,0,2
401377781,South Florida Bulls,J. Boggs,4431899,,False,1.0,0,0,0,0,0,0,0,0,0,0,0,0,0,0,1,0,0
401377781,South Florida Bulls,D. Patrick,4897129,,False,8.0,0,2,0,0,0,2,0,0,0,0,0,0,0,0,0,2,0
401377781,South Florida Bulls,T. Moss,4708220,,False,4.0,1,1,0,0,1,1,0,0,0,1,1,0,0,0,1,0,3
401377781,South Florida Bulls,J. Chaplin,4431925,,False,22.0,3,10,3,8,0,2,0,0,2,3,5,0,0,0,0,5,6
401377781,South Florida Bulls,S. Smith Jr.,4397185,,False,9.0,3,6,1,3,2,3,0,0,1,0,1,1,0,0,0,3,8
401377781,South Florida Bulls,TEAM,TOTAL,TOTAL,False,,25,58,19,41,6,17,8,9,10,27,37,13,1,4,16,28,64
401377781,Memphis Tigers,D. Williams,4397355,,True,34.0,4,6,4,6,0,0,3,6,1,3,4,3,3,1,1,2,11
401377781,Memphis Tigers,J. Duren,4433621,,True,26.0,7,13,7,13,0,0,2,4,4,6,10,0,1,1,0,2,16
401377781,Memphis Tigers,L. Nolley II,4395684,,True,34.0,2,6,2,3,0,3,0,0,0,2,2,5,0,0,1,2,4
401377781,Memphis Tigers,L. Quinones,4431720,,True,21.0,2,6,1,4,1,2,6,7,1,1,2,1,0,0,0,2,11
401377781,Memphis Tigers,A. Lomax,4396633,,True,30.0,3,6,3,6,0,0,6,9,0,4,4,4,2,0,1,2,12
401377781,Memphis Tigers,M. Dandridge,4431738,,False,5.0,1,2,1,2,0,0,1,2,1,0,1,0,0,1,1,2,3
401377781,Memphis Tigers,J. Minott,4687718,,False,15.0,1,5,1,4,0,1,0,0,0,1,1,0,1,1,0,0,2
401377781,Memphis Tigers,E. Timberlake,4432193,,False,8.0,0,0,0,0,0,0,0,0,0,0,0,1,0,0,2,3,0
401377781,Memphis Tigers,T. Harris,4396632,,False,27.0,4,10,2,6,2,4,4,4,0,3,3,2,2,0,0,1,14
401377781,Memphis Tigers,TEAM,TOTAL,TOTAL,False,,24,54,21,44,3,10,22,32,8,24,32,16,9,4,6,16,73
401377780,SMU Mustangs,F. Agunanne,4397431,,True,10.0,0,3,0,3,0,0,0,0,1,2,3,0,0,0,0,0,0
401377780,SMU Mustangs,Ma. Weathers,4067390,,True,34.0,4,14,4,11,0,3,7,10,3,5,8,0,1,0,1,1,15
401377780,SMU Mustangs,E. Bandoumel,4593107,,True,37.0,2,5,0,1,2,4,4,4,2,8,10,2,2,1,1,2,10
401377780,SMU Mustangs,K. Davis,4397066,,True,36.0,5,15,3,10,2,5,13,14,1,1,2,5,0,0,2,4,25
401377780,SMU Mustangs,Mi. Weathers,4067391,,True,32.0,5,8,4,7,1,1,8,9,4,7,11,2,3,1,5,2,19
401377780,SMU Mustangs,S. Todorovic,4897080,,False,5.0,0,1,0,0,0,1,0,0,0,0,0,0,0,0,0,0,0
401377780,SMU Mustangs,J. Young Jr.,4396640,,False,3.0,0,1,0,1,0,0,0,0,1,0,1,0,0,0,1,0,0
401377780,SMU Mustangs,T. Clark,4277885,,False,14.0,2,2,2,2,0,0,0,0,1,2,3,1,0,0,1,1,4
401377780,SMU Mustangs,Z. Phelps,4699725,,False,11.0,0,1,0,1,0,0,0,0,1,0,1,1,0,0,0,2,0
401377780,SMU Mustangs,Z. Nutall,4398281,,False,18.0,1,6,1,3,0,3,1,3,1,3,4,1,2,0,0,1,3
401377780,SMU Mustangs,TEAM,TOTAL,TOTAL,False,,19,56,14,39,5,17,33,40,16,31,47,12,8,2,11,13,76
401377780,Cincinnati Bearcats,A. Ado,4066288,,True,12.0,0,0,0,0,0,0,0,0,0,3,3,1,0,2,0,5,0
401377780,Cincinnati Bearcats,J. Newman III,4395622,,True,6.0,0,2,0,2,0,0,0,0,2,0,2,0,0,0,0,0,0
401377780,Cincinnati Bearcats,J. Davenport,4592898,,True,32.0,6,13,3,7,3,6,2,2,3,4,7,0,3,0,3,1,17
401377780,Cincinnati Bearcats,M. Adams-Woods,4431831,,True,29.0,1,7,1,4,0,3,0,0,1,1,2,3,1,0,0,4,2
401377780,Cincinnati Bearcats,D. DeJulius,4397202,,True,31.0,7,21,4,11,3,10,4,4,0,3,3,4,1,0,1,3,21
401377780,Cincinnati Bearcats,J. Hensley,4703828,,False,19.0,1,1,1,1,0,0,1,2,0,1,1,0,0,0,1,3,3
401377780,Cincinnati Bearcats,O. Oguama,4432075,,False,14.0,2,6,2,6,0,0,2,2,2,4,6,0,1,0,2,3,6
401377780,Cincinnati Bearcats,H. Koval,4278265,,False,4.0,0,1,0,0,0,1,0,0,0,1,1,0,0,0,0,1,0
401377780,Cincinnati Bearcats,V. Lakhin,4701192,,False,14.0,3,4,3,4,0,0,2,3,0,3,3,0,1,0,0,2,8
401377780,Cincinnati Bearcats,M. Madsen,4581506,,False,18.0,2,3,1,2,1,1,0,0,1,2,3,2,0,1,0,1,5
401377780,Cincinnati Bearcats,M. Saunders,4432403,,False,21.0,2,5,0,2,2,3,3,4,0,2,2,3,0,0,3,4,9
401377780,Cincinnati Bearcats,TEAM,TOTAL,TOTAL,False,,24,63,15,39,9,24,14,17,10,25,35,13,7,3,10,27,71
401377779,Wichita State Shockers,J. Pleasant,4397958,,True,16.0,2,5,2,5,0,0,0,0,2,2,4,0,0,0,0,3,4
401377779,Wichita State Shockers,M. Udeze,4396681,,True,23.0,3,6,3,6,0,0,9,9,4,4,8,0,0,0,1,3,15
401377779,Wichita State Shockers,C. Porter Jr.,4701233,,True,25.0,2,7,2,5,0,2,2,4,0,5,5,1,1,1,1,2,6
401377779,Wichita State Shockers,T. Etienne,4432887,,True,33.0,6,11,4,5,2,6,4,4,0,5,5,3,0,0,2,2,18
401377779,Wichita State Shockers,D. Dennis,4396676,,True,35.0,2,8,1,3,1,5,0,0,2,1,3,3,1,0,3,1,5
401377779,Wichita State Shockers,C. Jackson,4701238,,False,11.0,1,1,1,1,0,0,0,0,1,2,3,0,0,0,1,1,2
401377779,Wichita State Shockers,K. Pohto,4684445,,False,9.0,2,3,2,3,0,0,0,0,1,1,2,0,0,0,0,2,4
401377779,Wichita State Shockers,Q. Grant,4897201,,False,18.0,6,8,5,6,1,2,0,0,0,3,3,2,0,0,0,2,13
401377779,Wichita State Shockers,C. Jenkins,4701236,,False,1.0,0,0,0,0,0,0,0,0,0,0,0,0,0,0,0,2,0
401377779,Wichita State Shockers,R. Council IV,4701234,,False,29.0,2,4,1,3,1,1,0,1,1,6,7,0,0,0,3,2,5
401377779,Wichita State Shockers,TEAM,TOTAL,TOTAL,False,,26,53,21,37,5,16,15,18,13,30,43,9,2,1,11,20,72
401377779,Tulsa Golden Hurricane,R. Idowu,4397373,,True,17.0,4,7,4,7,0,0,1,2,1,1,2,0,0,0,1,3,9
401377779,Tulsa Golden Hurricane,J. Horne,4066390,,True,37.0,7,15,6,12,1,3,0,0,0,6,6,4,0,0,0,4,15
401377779,Tulsa Golden Hurricane,C. Haywood II,4593833,,True,33.0,1,1,1,1,0,0,5,6,1,1,2,2,2,1,1,4,7
401377779,Tulsa Golden Hurricane,S. Griffin,4432994,,True,35.0,1,11,0,5,1,6,0,0,0,1,1,2,1,0,0,3,3
401377779,Tulsa Golden Hurricane,D. Jackson,4278408,,True,36.0,3,8,3,4,0,4,9,12,2,1,3,2,0,0,1,1,15
401377779,Tulsa Golden Hurricane,N. Konstantynovskyi,4897154,,False,4.0,1,1,1,1,0,0,0,0,0,1,1,0,0,0,0,4,2
401377779,Tulsa Golden Hurricane,T. Dalger,4897153,,False,8.0,0,1,0,0,0,1,1,2,0,0,0,0,0,0,0,0,1
401377779,Tulsa Golden Hurricane,L. Draine,4279101,,False,30.0,4,7,3,3,1,4,1,2,0,3,3,2,2,0,0,0,10
401377779,Tulsa Golden Hurricane,TEAM,TOTAL,TOTAL,False,,21,51,18,33,3,18,17,24,4,15,19,12,5,1,3,19,62
401377493,USC Trojans,I. Mobley,4432815,,True,37.0,7,12,6,9,1,3,5,8,1,7,8,2,0,0,2,3,20
401377493,USC Trojans,M. Agbonkpolo,4431700,,True,31.0,2,4,1,3,1,1,0,0,0,3,3,1,0,1,2,1,5
401377493,USC Trojans,C. Goodwin,4067218,,True,24.0,2,4,2,4,0,0,1,2,1,1,2,2,0,0,2,1,5
401377493,USC Trojans,B. Ellis,4593106,,True,32.0,5,14,3,8,2,6,1,1,0,2,2,3,0,0,0,4,13
401377493,USC Trojans,D. Peterson,4397689,,True,36.0,4,9,1,3,3,6,2,2,0,9,9,6,0,0,3,3,13
401377493,USC Trojans,J. Morgan,4431830,,False,6.0,2,2,2,2,0,0,1,1,0,0,0,0,0,0,1,4,5
401377493,USC Trojans,K. Johnson,4683857,,False,3.0,1,2,0,0,1,2,0,0,0,0,0,0,0,0,1,0,3
401377493,USC Trojans,R. Waters,4711593,,False,21.0,2,4,2,3,0,1,0,0,0,1,1,1,0,1,1,3,4
401377493,USC Trojans,E. Anderson,4431808,,False,10.0,0,0,0,0,0,0,0,0,0,2,2,0,0,0,1,1,0
401377493,USC Trojans,TEAM,TOTAL,TOTAL,False,,25,51,17,32,8,19,10,14,4,26,30,15,0,2,15,20,68
401377493,UCLA Bruins,C. Riley,4278525,,True,20.0,2,7,2,7,0,0,2,2,2,4,6,0,0,0,0,4,6
401377493,UCLA Bruins,J. Jaquez Jr.,4432848,,True,34.0,10,16,10,14,0,2,7,8,1,5,6,4,0,0,0,2,27
401377493,UCLA Bruins,D. Singleton,4397131,,True,10.0,0,0,0,0,0,0,0,0,0,0,0,0,0,0,0,0,0
401377493,UCLA Bruins,T. Campbell,4397128,,True,38.0,3,8,2,5,1,3,2,2,1,1,2,4,2,1,0,2,9
401377493,UCLA Bruins,J. Bernard,4397127,,True,35.0,6,11,4,7,2,4,5,6,0,3,3,2,1,0,0,1,19
401377493,UCLA Bruins,M. Johnson,4277987,,False,20.0,0,0,0,0,0,0,2,2,2,2,4,2,2,2,1,0,2
401377493,UCLA Bruins,J. Juzang,4432817,,False,32.0,4,13,4,12,0,1,0,2,1,3,4,2,0,0,0,3,8
401377493,UCLA Bruins,J. Clark,4432247,,False,11.0,1,2,1,1,0,1,2,6,0,2,2,1,2,0,0,3,4
401377493,UCLA Bruins,TEAM,TOTAL,TOTAL,False,,26,57,23,46,3,11,20,28,8,22,30,15,7,3,1,15,75
401377492,Utah Utes,B. Carlson,4592435,,True,30.0,6,14,4,11,2,3,4,7,2,1,3,1,0,1,1,3,18
401377492,Utah Utes,R. Battin,4397149,,True,14.0,1,3,1,1,0,2,1,1,1,1,2,2,0,0,0,0,3
401377492,Utah Utes,B. Gach,4397145,,True,16.0,0,2,0,1,0,1,0,0,0,1,1,2,0,0,1,1,0
401377492,Utah Utes,D. Jenkins Jr.,4279527,,True,22.0,6,10,3,4,3,6,3,6,0,6,6,1,2,1,1,3,18
401377492,Utah Utes,M. Anthony,4278034,,True,22.0,1,3,1,3,0,0,0,0,0,2,2,2,0,0,2,1,2
401377492,Utah Utes,L. Thioune,4397151,,False,10.0,1,2,1,2,0,0,0,0,0,2,2,0,0,1,0,1,2
401377492,Utah Utes,L. Stefanovic,4708167,,False,24.0,4,6,2,2,2,4,2,2,1,0,1,1,0,0,1,1,12
401377492,Utah Utes,H. Creer,4702459,,False,0.0,0,0,0,0,0,0,0,0,0,0,0,0,0,0,0,0,0
401377492,Utah Utes,R. Worster,4701995,,False,24.0,1,3,1,3,0,0,1,2,0,1,1,0,0,0,0,3,3
401377492,Utah Utes,E. Ballstaedt,4592433,,False,3.0,0,1,0,0,0,1,0,0,0,0,0,0,0,0,0,0,0
401377492,Utah Utes,J. Brenchley,4592431,,False,15.0,2,3,2,3,0,0,4,4,1,4,5,1,0,0,0,2,8
401377492,Utah Utes,G. Madsen,4432753,,False,20.0,2,7,1,1,1,6,0,0,1,4,5,0,1,1,3,1,5
401377492,Utah Utes,TEAM,TOTAL,TOTAL,False,,24,54,16,31,8,23,15,22,7,23,30,10,3,4,9,16,71
401377492,Colorado Buffaloes,T. da Silva,4702382,,True,16.0,2,2,1,1,1,1,0,0,3,0,3,3,1,1,2,5,5
401377492,Colorado Buffaloes,J. Walker,4432446,,True,35.0,7,14,4,8,3,6,5,6,2,10,12,5,0,0,2,4,22
401377492,Colorado Buffaloes,E. Battey,4278506,,True,35.0,10,17,4,8,6,9,1,2,2,4,6,2,1,0,1,1,27
401377492,Colorado Buffaloes,N. Clifford,4702384,,True,29.0,5,10,4,9,1,1,0,0,1,3,4,2,0,0,1,1,11
401377492,Colorado Buffaloes,J. Hammond III,4692907,,True,17.0,1,4,0,2,1,2,0,0,0,2,2,3,0,0,1,1,3
401377492,Colorado Buffaloes,W. Loughlin,4702383,,False,1.0,0,0,0,0,0,0,0,0,0,0,0,0,0,0,0,0,0
401377492,Colorado Buffaloes,L. O'Brien,4702380,,False,25.0,1,3,1,3,0,0,1,2,0,4,4,0,0,0,0,3,3
401377492,Colorado Buffaloes,KJ Simpson,4683834,,False,20.0,1,4,1,2,0,2,3,5,0,1,1,1,0,0,1,0,5
401377492,Colorado Buffaloes,K. Barthelemy,4581504,,False,22.0,3,5,1,3,2,2,0,0,0,2,2,2,0,0,1,3,8
401377492,Colorado Buffaloes,TEAM,TOTAL,TOTAL,False,,30,59,16,36,14,23,10,15,8,28,36,18,2,1,9,18,84
401377491,Washington Huskies,N. Roberts,4397158,,True,33.0,6,10,6,10,0,0,1,3,6,10,16,1,1,1,2,2,13
401377491,Washington Huskies,E. Matthews Jr.,4397099,,True,31.0,4,8,3,5,1,3,2,2,1,0,1,4,0,0,1,2,11
401377491,Washington Huskies,J. Bey,4397155,,True,37.0,5,16,2,5,3,11,2,2,2,2,4,1,1,0,2,2,15
401377491,Washington Huskies,T. Brown Jr.,4395997,,True,38.0,12,14,12,13,0,1,0,1,0,3,3,3,1,1,3,3,24
401377491,Washington Huskies,D. Davis,4278522,,True,27.0,0,1,0,0,0,1,0,0,0,3,3,5,2,0,3,2,0
401377491,Washington Huskies,J. Grant,4433613,,False,1.0,0,0,0,0,0,0,0,0,0,0,0,0,0,0,0,0,0
401377491,Washington Huskies,R. Lundeen,4404257,,False,1.0,0,0,0,0,0,0,1,2,0,0,0,0,0,0,0,0,1
401377491,Washington Huskies,R. Sorn,4397159,,False,4.0,1,1,1,1,0,0,0,0,0,1,1,0,0,0,0,0,2
401377491,Washington Huskies,A. Iglesia,4898378,,False,1.0,0,1,0,0,0,1,0,0,0,0,0,0,0,0,0,0,0
401377491,Washington Huskies,C. Bajema,4431757,,False,11.0,3,4,1,1,2,3,0,0,0,1,1,0,1,0,1,2,8
401377491,Washington Huskies,PJ Fuller,4431717,,False,15.0,1,2,0,1,1,1,1,2,0,1,1,0,2,1,2,3,4
401377491,Washington Huskies,N. Neubauer,4407470,,False,1.0,0,0,0,0,0,0,0,0,0,1,1,0,0,0,1,1,0
401377491,Washington Huskies,TEAM,TOTAL,TOTAL,False,,32,57,25,36,7,21,7,12,10,25,35,14,8,3,15,17,78
401377491,Oregon State Beavers,G. Taylor Jr.,4833075,,True,30.0,1,4,0,1,1,3,0,0,0,1,1,3,0,0,1,5,3
401377491,Oregon State Beavers,M. Calloo,4397043,,True,30.0,1,9,1,5,0,4,2,2,1,3,4,0,0,0,0,3,4
401377491,Oregon State Beavers,R. Silva,4592414,,True,25.0,5,11,5,11,0,0,2,2,5,0,5,1,1,0,3,2,12
401377491,Oregon State Beavers,D. Akanno,4431877,,True,29.0,3,8,3,6,0,2,4,4,0,4,4,1,1,0,2,1,10
401377491,Oregon State Beavers,J. Lucas,4431765,,True,34.0,3,6,0,1,3,5,4,4,0,1,1,2,0,0,3,2,13
401377491,Oregon State Beavers,A. Rand,4701206,,False,20.0,4,6,4,6,0,0,0,1,2,4,6,0,2,2,1,2,8
401377491,Oregon State Beavers,D. Davis,4898119,,False,32.0,6,14,4,11,2,3,3,3,0,2,2,6,2,0,3,3,17
401377491,Oregon State Beavers,TEAM,TOTAL,TOTAL,False,,23,58,17,41,6,17,15,16,9,16,25,13,6,2,15,18,67
401377490,California Golden Bears,G. Anticevich,4278145,,True,29.0,1,4,0,2,1,2,1,2,3,3,6,0,1,0,0,1,4
401377490,California Golden Bears,L. Thiemann,4433099,,True,24.0,3,7,3,7,0,0,5,9,2,3,5,2,0,0,0,3,11
401377490,California Golden Bears,J. Celestine,4598611,,True,21.0,3,8,3,5,0,3,0,0,0,0,0,1,0,0,2,4,6
401377490,California Golden Bears,M. Foreman,4067252,,True,24.0,4,10,3,5,1,5,3,3,0,1,1,1,0,0,3,0,12
401377490,California Golden Bears,J. Shepherd,4066308,,True,33.0,5,14,5,11,0,3,6,9,0,1,1,1,1,0,0,3,16
401377490,California Golden Bears,S. Alajiki,4708166,,False,13.0,0,0,0,0,0,0,1,2,0,0,0,0,0,1,1,2,1
401377490,California Golden Bears,O. Anyanwu,4433276,,False,10.0,1,2,1,2,0,0,1,2,1,0,1,0,1,0,0,4,3
401377490,California Golden Bears,K. Kuany,4432021,,False,21.0,2,3,1,2,1,1,1,1,0,5,5,1,0,0,1,4,6
401377490,California Golden Bears,M. Roberson,4698720,,False,12.0,1,3,1,3,0,0,0,0,1,1,2,1,1,0,1,2,2
401377490,California Golden Bears,J. Hyder,4593047,,False,13.0,0,1,0,0,0,1,0,0,0,0,0,1,0,0,1,2,0
401377490,California Golden Bears,TEAM,TOTAL,TOTAL,False,,20,52,17,37,3,15,18,28,7,15,22,8,4,1,9,25,61
401377490,Arizona Wildcats,A. Tubelis,4702372,,True,22.0,3,5,3,5,0,0,1,2,0,2,2,0,2,1,1,2,7
401377490,Arizona Wildcats,C. Koloko,4431778,,True,15.0,2,2,2,2,0,0,4,6,0,3,3,1,0,0,1,3,8
401377490,Arizona Wildcats,B. Mathurin,4683634,,True,27.0,3,9,1,4,2,5,5,9,0,6,6,2,0,0,3,1,13
401377490,Arizona Wildcats,D. Terry,4433159,,True,23.0,1,3,1,2,0,1,0,0,0,0,0,3,1,0,1,0,2
401377490,Arizona Wildcats,J. Kier,4066863,,True,25.0,3,5,2,2,1,3,6,7,0,5,5,3,0,0,0,4,13
401377490,Arizona Wildcats,T. Tubelis,4683637,,False,3.0,0,2,0,1,0,1,0,0,0,0,0,0,0,0,0,0,0
401377490,Arizona Wildcats,J. Mains,4609978,,False,2.0,1,1,1,1,0,0,0,0,1,2,3,0,0,0,1,1,2
401377490,Arizona Wildcats,O. Ballo,4594109,,False,17.0,7,7,7,7,0,0,2,2,1,4,5,1,1,0,0,2,16
401377490,Arizona Wildcats,A. Bal,4896365,,False,18.0,3,4,2,2,1,2,0,0,0,2,2,3,0,0,0,2,7
401377490,Arizona Wildcats,G. Weitman,4702373,,False,2.0,1,1,1,1,0,0,0,0,1,0,1,0,0,0,0,0,2
401377490,Arizona Wildcats,K. Kriisa,4683633,,False,22.0,0,0,0,0,0,0,4,4,1,2,3,3,0,0,0,0,4
401377490,Arizona Wildcats,P. Larsson,4601025,,False,17.0,5,8,3,4,2,4,1,1,0,4,4,1,1,0,0,4,13
401377490,Arizona Wildcats,S. Nowell,4433263,,False,6.0,1,1,1,1,0,0,0,0,0,0,0,0,0,0,1,1,2
401377490,Arizona Wildcats,TEAM,TOTAL,TOTAL,False,,30,48,24,32,6,16,23,31,5,30,35,17,5,1,8,20,89
401377489,Washington State Cougars,M. Gueye,4712863,,True,10.0,2,3,2,3,0,0,1,2,2,1,3,1,0,0,0,3,5
401377489,Washington State Cougars,M. DeWolf,4279464,,True,6.0,0,1,0,0,0,1,0,0,0,0,0,0,1,0,1,1,0
401377489,Washington State Cougars,T. Roberts,4702609,,True,29.0,5,8,0,1,5,7,0,0,0,2,2,4,1,0,1,2,15
401377489,Washington State Cougars,N. Williams,4432850,,True,30.0,6,13,3,8,3,5,4,5,0,1,1,8,1,1,3,4,19
401377489,Washington State Cougars,M. Flowers,4279455,,True,33.0,3,9,1,3,2,6,2,3,0,2,2,6,0,0,3,0,10
401377489,Washington State Cougars,A. Jakimovski,4702466,,False,32.0,3,5,0,0,3,5,0,0,3,5,8,2,1,0,0,2,9
401377489,Washington State Cougars,E. Abogidi,4702463,,False,20.0,7,12,7,10,0,2,0,0,2,4,6,0,0,1,1,0,14
401377489,Washington State Cougars,DJ Rodman,4432103,,False,4.0,0,2,0,0,0,2,0,0,0,1,1,0,0,0,0,1,0
401377489,Washington State Cougars,D. Jackson,4432926,,False,14.0,1,2,1,2,0,0,7,9,1,1,2,0,0,1,0,1,9
401377489,Washington State Cougars,W. Burghardt,4898379,,False,1.0,1,1,0,0,1,1,0,0,0,0,0,0,0,0,1,0,3
401377489,Washington State Cougars,TJ Bamba,4596365,,False,21.0,4,8,2,3,2,5,0,0,1,4,5,0,0,0,1,4,10
401377489,Washington State Cougars,R. Rapp,4433062,,False,1.0,0,0,0,0,0,0,0,0,0,0,0,0,0,0,0,0,0
401377489,Washington State Cougars,TEAM,TOTAL,TOTAL,False,,32,64,16,30,16,34,14,19,11,23,34,21,4,3,11,18,94
401377489,Oregon Ducks,Q. Guerrier,4432996,,True,29.0,2,6,1,2,1,4,3,4,3,1,4,1,2,0,2,1,8
401377489,Oregon Ducks,F. Kepnang,4711400,,True,25.0,5,6,5,6,0,0,1,2,1,1,2,0,0,0,2,4,11
401377489,Oregon Ducks,N. Dante,4592401,,True,17.0,0,1,0,1,0,0,2,2,0,4,4,1,0,3,1,3,2
401377489,Oregon Ducks,D. Harmon,4431703,,True,26.0,3,6,3,6,0,0,0,0,0,3,3,2,1,0,3,2,6
401377489,Oregon Ducks,J. Young,4066326,,True,30.0,7,12,6,10,1,2,6,8,0,0,0,4,1,0,3,2,21
401377489,Oregon Ducks,L. Wur,4565434,,False,1.0,1,1,0,0,1,1,0,0,0,0,0,0,0,0,0,0,3
401377489,Oregon Ducks,I. Johnson,4898118,,False,4.0,1,2,1,2,0,0,0,0,0,1,1,0,0,0,0,1,2
401377489,Oregon Ducks,N. Bittle,4432586,,False,16.0,2,3,2,3,0,0,0,0,0,3,3,1,0,0,2,2,4
401377489,Oregon Ducks,E. Williams Jr.,4278490,,False,27.0,3,13,2,9,1,4,4,4,1,3,4,1,3,1,0,1,11
401377489,Oregon Ducks,B. Parris,4902474,,False,1.0,0,0,0,0,0,0,0,0,0,0,0,0,0,0,0,0,0
401377489,Oregon Ducks,R. Soares,4898116,,False,23.0,2,4,2,3,0,1,2,3,0,5,5,0,1,0,0,0,6
401377489,Oregon Ducks,G. Reichle,4702388,,False,1.0,0,0,0,0,0,0,0,0,0,0,0,0,0,0,0,0,0
401377489,Oregon Ducks,TEAM,TOTAL,TOTAL,False,,26,54,22,42,4,12,18,23,6,23,29,10,8,4,14,16,74
401377488,Stanford Cardinal,S. Jones,4592427,,True,30.0,5,11,2,4,3,7,1,2,2,2,4,2,1,2,2,3,14
401377488,Stanford Cardinal,H. Ingram,4433618,,True,33.0,2,10,1,8,1,2,3,4,4,5,9,4,3,1,7,2,8
401377488,Stanford Cardinal,J. Keefe,4433018,,True,15.0,0,0,0,0,0,0,0,0,1,1,2,1,1,0,1,2,0
401377488,Stanford Cardinal,J. Delaire,4397112,,True,27.0,2,9,0,3,2,6,2,6,2,4,6,2,2,0,3,2,8
401377488,Stanford Cardinal,M. O'Connell,4683635,,True,31.0,1,6,1,3,0,3,0,0,1,2,3,3,2,0,4,3,2
401377488,Stanford Cardinal,M. Raynaud,4898371,,False,21.0,3,5,3,4,0,1,0,1,1,6,7,2,0,0,1,1,6
401377488,Stanford Cardinal,B. Angel,4590354,,False,18.0,4,5,0,0,4,5,2,2,0,1,1,0,0,0,2,2,14
401377488,Stanford Cardinal,M. Murrell,4585601,,False,16.0,2,4,2,3,0,1,0,0,0,1,1,0,0,0,0,1,4
401377488,Stanford Cardinal,I. Silva,4433614,,False,9.0,0,1,0,0,0,1,0,0,0,1,1,1,0,0,1,2,0
401377488,Stanford Cardinal,S. Beskind,4397115,,False,0.0,0,0,0,0,0,0,0,0,0,0,0,0,0,0,0,0,0
401377488,Stanford Cardinal,TEAM,TOTAL,TOTAL,False,,19,51,9,25,10,26,8,15,12,24,36,15,9,3,21,18,56
401377488,Arizona State Sun Devils,J. Graham,4432855,,True,33.0,5,6,5,6,0,0,6,8,1,2,3,2,1,1,6,4,16
401377488,Arizona State Sun Devils,A. Gaffney,4431694,,True,24.0,3,4,2,3,1,1,0,0,2,2,4,0,0,0,1,2,7
401377488,Arizona State Sun Devils,K. Lawrence,4278134,,True,29.0,3,6,3,6,0,0,0,0,0,1,1,0,0,1,1,2,6
401377488,Arizona State Sun Devils,DJ Horne,4431993,,True,30.0,4,13,4,8,0,5,4,4,1,3,4,4,0,0,0,2,12
401377488,Arizona State Sun Devils,M. Jackson,4279451,,True,31.0,8,15,8,9,0,6,2,4,0,6,6,6,6,0,2,1,18
401377488,Arizona State Sun Devils,E. Boakye,4898110,,False,4.0,0,0,0,0,0,0,0,0,0,2,2,0,0,0,1,0,0
401377488,Arizona State Sun Devils,J. Olmsted,4592360,,False,0.0,0,0,0,0,0,0,0,0,0,0,0,0,0,0,0,0,0
401377488,Arizona State Sun Devils,J. Neal,4837237,,False,4.0,0,0,0,0,0,0,0,0,0,0,0,0,0,0,0,1,0
401377488,Arizona State Sun Devils,B. Hurley,4898109,,False,0.0,0,0,0,0,0,0,0,0,0,0,0,0,0,0,0,0,0
401377488,Arizona State Sun Devils,C. Ronzone,4702375,,False,0.0,0,0,0,0,0,0,0,0,0,0,0,0,0,0,0,0,0
401377488,Arizona State Sun Devils,A. Ronzone,4702374,,False,0.0,0,0,0,0,0,0,0,0,0,0,0,0,0,0,0,0,0
401377488,Arizona State Sun Devils,M. Burno,4592359,,False,0.0,0,0,0,0,0,0,0,0,0,0,0,0,0,0,0,0,0
401377488,Arizona State Sun Devils,J. Heath,4592181,,False,29.0,2,5,1,1,1,4,1,2,0,3,3,3,1,0,2,1,6
401377488,Arizona State Sun Devils,L. Muhammad,4397234,,False,16.0,0,2,0,1,0,1,0,0,0,1,1,1,0,0,1,1,0
401377488,Arizona State Sun Devils,TEAM,TOTAL,TOTAL,False,,25,51,23,34,2,17,13,18,5,23,28,16,8,2,14,14,65
401377487,Washington State Cougars,M. Gueye,4712863,,True,21.0,3,8,3,8,0,0,1,3,4,2,6,2,1,1,0,3,7
401377487,Washington State Cougars,D. Jackson,4432926,,True,12.0,1,3,1,3,0,0,1,2,1,1,2,0,0,2,0,0,3
401377487,Washington State Cougars,T. Roberts,4702609,,True,29.0,2,9,0,5,2,4,4,4,1,3,4,0,1,0,1,4,10
401377487,Washington State Cougars,N. Williams,4432850,,True,28.0,3,10,2,7,1,3,1,2,1,0,1,4,1,0,2,0,8
401377487,Washington State Cougars,M. Flowers,4279455,,True,37.0,6,12,4,6,2,6,0,0,0,3,3,4,3,1,1,3,14
401377487,Washington State Cougars,A. Jakimovski,4702466,,False,5.0,0,2,0,0,0,2,0,0,0,1,1,0,0,0,0,2,0
401377487,Washington State Cougars,E. Abogidi,4702463,,False,24.0,2,3,1,2,1,1,4,4,1,7,8,1,2,5,0,2,9
401377487,Washington State Cougars,DJ Rodman,4432103,,False,16.0,2,3,2,2,0,1,0,1,1,2,3,0,0,0,2,1,4
401377487,Washington State Cougars,TJ Bamba,4596365,,False,28.0,5,12,2,6,3,6,3,3,4,4,8,0,0,0,0,1,16
401377487,Washington State Cougars,TEAM,TOTAL,TOTAL,False,,24,62,15,39,9,23,14,19,13,24,37,11,8,9,9,16,71
401377487,Oregon State Beavers,G. Taylor Jr.,4833075,,True,40.0,3,10,2,7,1,3,0,0,1,5,6,5,1,0,5,4,7
401377487,Oregon State Beavers,M. Calloo,4397043,,True,38.0,5,13,2,6,3,7,7,8,0,7,7,1,1,0,0,1,20
401377487,Oregon State Beavers,R. Silva,4592414,,True,31.0,4,8,4,8,0,0,0,0,3,6,9,1,2,2,2,3,8
401377487,Oregon State Beavers,D. Akanno,4431877,,True,38.0,5,12,3,9,2,3,0,0,2,2,4,2,0,0,2,3,12
401377487,Oregon State Beavers,J. Lucas,4431765,,True,40.0,3,10,1,4,2,6,3,4,2,2,4,1,0,0,1,3,11
401377487,Oregon State Beavers,A. Rand,4701206,,False,13.0,4,5,3,4,1,1,0,2,1,2,3,0,0,2,1,3,9
401377487,Oregon State Beavers,TEAM,TOTAL,TOTAL,False,,24,58,15,38,9,20,10,14,14,25,39,10,4,4,12,17,67
401377486,Washington Huskies,N. Roberts,4397158,,True,32.0,8,10,8,10,0,0,2,3,6,10,16,0,0,0,2,5,18
401377486,Washington Huskies,E. Matthews Jr.,4397099,,True,38.0,9,13,7,9,2,4,5,6,2,4,6,0,0,0,1,0,25
401377486,Washington Huskies,PJ Fuller,4431717,,True,23.0,0,2,0,1,0,1,0,0,0,4,4,3,1,1,3,0,0
401377486,Washington Huskies,J. Bey,4397155,,True,38.0,1,7,0,2,1,5,0,2,0,4,4,0,2,2,1,1,3
401377486,Washington Huskies,T. Brown Jr.,4395997,,True,40.0,7,16,7,14,0,2,11,13,0,3,3,4,1,0,1,3,25
401377486,Washington Huskies,L. Wilson,4898376,,False,4.0,0,1,0,1,0,0,0,0,1,1,2,0,0,0,0,2,0
401377486,Washington Huskies,C. Bajema,4431757,,False,25.0,2,10,1,3,1,7,2,4,0,4,4,0,1,2,1,4,7
401377486,Washington Huskies,TEAM,TOTAL,TOTAL,False,,27,59,23,40,4,19,20,28,11,30,41,7,5,5,12,15,78
401377486,Oregon Ducks,Q. Guerrier,4432996,,True,31.0,5,12,1,3,4,9,2,4,1,4,5,0,1,0,1,2,16
401377486,Oregon Ducks,N. Dante,4592401,,True,14.0,2,4,2,4,0,0,0,0,1,5,6,0,0,2,1,1,4
401377486,Oregon Ducks,D. Harmon,4431703,,True,31.0,6,13,4,7,2,6,3,5,0,1,1,0,0,0,1,1,17
401377486,Oregon Ducks,W. Richardson,4397101,,True,31.0,0,3,0,2,0,1,0,0,1,6,7,3,1,0,4,2,0
401377486,Oregon Ducks,J. Young,4066326,,True,35.0,5,16,5,12,0,4,4,5,3,2,5,7,2,0,3,3,14
401377486,Oregon Ducks,F. Kepnang,4711400,,False,16.0,2,7,2,7,0,0,0,0,4,1,5,0,1,1,1,4,4
401377486,Oregon Ducks,N. Bittle,4432586,,False,7.0,2,3,2,3,0,0,0,0,3,1,4,0,0,1,0,2,4
401377486,Oregon Ducks,E. Williams Jr.,4278490,,False,20.0,3,8,3,6,0,2,0,2,0,1,1,0,1,0,0,3,6
401377486,Oregon Ducks,R. Soares,4898116,,False,15.0,1,2,1,1,0,1,0,0,0,1,1,1,0,1,0,2,2
401377486,Oregon Ducks,TEAM,TOTAL,TOTAL,False,,26,68,20,45,6,23,9,16,14,24,38,11,6,5,11,20,67
401377485,Stanford Cardinal,S. Jones,4592427,,True,26.0,9,14,5,8,4,6,0,0,3,2,5,1,0,0,0,2,22
401377485,Stanford Cardinal,H. Ingram,4433618,,True,31.0,2,12,2,9,0,3,0,2,1,8,9,5,0,0,2,3,4
401377485,Stanford Cardinal,J. Keefe,4433018,,True,12.0,0,4,0,4,0,0,0,0,1,1,2,2,0,1,0,1,0
401377485,Stanford Cardinal,J. Delaire,4397112,,True,33.0,4,9,4,7,0,2,0,1,0,2,2,4,4,0,5,2,8
401377485,Stanford Cardinal,M. O'Connell,4683635,,True,35.0,6,12,2,6,4,6,0,0,0,3,3,3,0,0,4,2,16
401377485,Stanford Cardinal,M. Raynaud,4898371,,False,17.0,4,5,3,3,1,2,1,2,3,4,7,1,0,0,1,4,10
401377485,Stanford Cardinal,B. Angel,4590354,,False,14.0,1,1,1,1,0,0,0,0,0,1,1,0,1,0,1,4,2
401377485,Stanford Cardinal,M. Murrell,4585601,,False,10.0,1,1,1,1,0,0,0,0,1,0,1,0,0,0,0,0,2
401377485,Stanford Cardinal,L. Kisunas,4397116,,False,11.0,2,3,2,3,0,0,1,4,2,2,4,0,0,1,2,3,5
401377485,Stanford Cardinal,I. Silva,4433614,,False,4.0,0,0,0,0,0,0,0,0,0,0,0,0,0,0,1,1,0
401377485,Stanford Cardinal,S. Beskind,4397115,,False,7.0,0,0,0,0,0,0,0,0,0,0,0,0,0,0,1,1,0
401377485,Stanford Cardinal,TEAM,TOTAL,TOTAL,False,,29,61,20,42,9,19,2,9,11,24,35,16,5,2,17,23,69
401377485,Arizona Wildcats,A. Tubelis,4702372,,True,26.0,5,8,5,8,0,0,1,3,2,3,5,3,3,1,4,1,11
401377485,Arizona Wildcats,C. Koloko,4431778,,True,31.0,7,10,7,10,0,0,7,8,2,8,10,0,0,2,0,3,21
401377485,Arizona Wildcats,B. Mathurin,4683634,,True,34.0,8,14,7,10,1,4,7,9,0,5,5,4,1,0,2,3,24
401377485,Arizona Wildcats,K. Kriisa,4683633,,True,35.0,2,6,0,0,2,6,1,1,0,0,0,7,1,0,1,1,7
401377485,Arizona Wildcats,D. Terry,4433159,,True,22.0,2,5,2,4,0,1,0,0,0,3,3,3,2,0,0,3,4
401377485,Arizona Wildcats,O. Ballo,4594109,,False,7.0,0,1,0,1,0,0,0,0,0,1,1,0,0,2,0,2,0
401377485,Arizona Wildcats,P. Larsson,4601025,,False,21.0,1,6,1,3,0,3,4,4,0,0,0,1,2,0,1,0,6
401377485,Arizona Wildcats,J. Kier,4066863,,False,24.0,2,3,0,1,2,2,2,2,0,3,3,1,1,0,2,1,8
401377485,Arizona Wildcats,TEAM,TOTAL,TOTAL,False,,27,53,22,37,5,16,22,27,4,24,28,19,10,5,10,14,81
401377484,California Golden Bears,G. Anticevich,4278145,,True,27.0,3,9,1,4,2,5,0,0,1,5,6,2,0,0,0,1,8
401377484,California Golden Bears,L. Thiemann,4433099,,True,19.0,1,1,1,1,0,0,0,0,0,3,3,1,1,1,2,3,2
401377484,California Golden Bears,J. Celestine,4598611,,True,24.0,4,12,3,7,1,5,2,2,0,2,2,3,1,0,1,2,11
401377484,California Golden Bears,J. Brown,4431787,,True,27.0,1,5,1,3,0,2,0,0,1,2,3,5,0,0,2,1,2
401377484,California Golden Bears,J. Shepherd,4066308,,True,27.0,4,13,3,9,1,4,0,0,0,3,3,1,2,2,1,1,9
401377484,California Golden Bears,S. Alajiki,4708166,,False,17.0,1,3,1,1,0,2,0,0,0,2,2,0,0,0,1,2,2
401377484,California Golden Bears,O. Anyanwu,4433276,,False,11.0,0,2,0,2,0,0,1,2,3,0,3,0,0,0,0,2,1
401377484,California Golden Bears,K. Kuany,4432021,,False,17.0,2,6,2,4,0,2,0,0,0,1,1,0,0,0,1,0,4
401377484,California Golden Bears,M. Roberson,4698720,,False,12.0,1,3,1,2,0,1,0,1,3,3,6,2,1,0,2,1,2
401377484,California Golden Bears,J. Hyder,4593047,,False,4.0,0,0,0,0,0,0,0,0,0,0,0,0,0,0,0,0,0
401377484,California Golden Bears,M. Foreman,4067252,,False,15.0,1,5,0,0,1,5,0,0,0,2,2,1,0,0,3,1,3
401377484,California Golden Bears,TEAM,TOTAL,TOTAL,False,,18,59,13,33,5,26,3,5,10,24,34,15,5,3,13,14,44
401377484,Arizona State Sun Devils,J. Graham,4432855,,True,28.0,4,10,4,9,0,1,0,4,0,3,3,3,2,4,0,0,8
401377484,Arizona State Sun Devils,A. Gaffney,4431694,,True,20.0,4,5,3,4,1,1,2,2,3,2,5,1,0,0,0,4,11
401377484,Arizona State Sun Devils,K. Lawrence,4278134,,True,27.0,5,7,5,7,0,0,2,2,0,9,9,0,0,0,1,0,12
401377484,Arizona State Sun Devils,J. Heath,4592181,,True,26.0,5,10,3,6,2,4,0,0,0,3,3,3,2,0,3,0,12
401377484,Arizona State Sun Devils,DJ Horne,4431993,,True,28.0,5,9,4,6,1,3,2,4,0,2,2,1,0,0,1,4,13
401377484,Arizona State Sun Devils,E. Boakye,4898110,,False,10.0,0,0,0,0,0,0,0,0,1,1,2,1,0,1,1,0,0
401377484,Arizona State Sun Devils,J. Olmsted,4592360,,False,2.0,0,0,0,0,0,0,0,0,0,1,1,1,0,0,0,1,0
401377484,Arizona State Sun Devils,B. Hurley,4898109,,False,2.0,0,0,0,0,0,0,0,0,0,0,0,0,0,0,0,0,0
401377484,Arizona State Sun Devils,C. Ronzone,4702375,,False,2.0,1,1,1,1,0,0,0,0,0,0,0,0,0,0,0,0,2
401377484,Arizona State Sun Devils,A. Ronzone,4702374,,False,2.0,0,0,0,0,0,0,0,0,0,1,1,0,0,0,0,0,0
401377484,Arizona State Sun Devils,M. Burno,4592359,,False,2.0,1,1,1,1,0,0,0,0,0,0,0,0,0,0,0,0,2
401377484,Arizona State Sun Devils,L. Muhammad,4397234,,False,23.0,0,5,0,3,0,2,0,0,0,3,3,4,2,0,0,0,0
401377484,Arizona State Sun Devils,M. Jackson,4279451,,False,28.0,5,8,4,6,1,2,0,0,0,3,3,4,3,0,2,2,11
401377484,Arizona State Sun Devils,TEAM,TOTAL,TOTAL,False,,30,56,25,43,5,13,6,12,5,33,38,18,9,5,8,11,71
401376586,Jackson State Tigers,T. Lewis II,4702774,,True,28.0,5,8,5,8,0,0,0,0,4,2,6,0,2,0,2,2,10
401376586,Jackson State Tigers,J. McKinnis,4403417,,True,25.0,9,11,9,11,0,0,1,4,6,8,14,0,1,0,1,3,19
401376586,Jackson State Tigers,K. Evans,4594079,,True,38.0,9,20,5,10,4,10,2,3,2,2,4,7,0,0,2,1,24
401376586,Jackson State Tigers,J. James,4594075,,True,36.0,5,13,5,9,0,4,2,3,0,2,2,3,2,2,2,3,12
401376586,Jackson State Tigers,D. Wilson,4406975,,True,24.0,1,5,0,0,1,5,0,0,0,0,0,0,0,0,0,3,3
401376586,Jackson State Tigers,J. Jones,4703203,,False,19.0,6,6,6,6,0,0,3,7,3,2,5,0,0,2,0,1,15
401376586,Jackson State Tigers,D. Hicks,4065698,,False,8.0,1,1,1,1,0,0,0,0,0,0,0,1,0,0,0,1,2
401376586,Jackson State Tigers,C. Young,4899535,,False,3.0,0,0,0,0,0,0,0,0,0,0,0,1,0,0,0,0,0
401376586,Jackson State Tigers,D. Taylor,4288220,,False,19.0,1,3,1,3,0,0,0,0,0,0,0,4,2,0,2,2,2
401376586,Jackson State Tigers,TEAM,TOTAL,TOTAL,False,,37,67,32,48,5,19,8,17,18,18,36,16,7,4,9,16,87
401376586,Arkansas-Pine Bluff Golden Lions,A. Stredic,4594058,,True,30.0,3,3,3,3,0,0,1,2,1,3,4,4,0,0,1,3,7
401376586,Arkansas-Pine Bluff Golden Lions,S. Williams,4897867,,True,40.0,8,15,3,7,5,8,11,11,0,0,0,1,3,0,3,3,32
401376586,Arkansas-Pine Bluff Golden Lions,B. Brown,4897863,,True,29.0,3,5,1,3,2,2,0,0,2,4,6,2,0,0,1,4,8
401376586,Arkansas-Pine Bluff Golden Lions,D. Morris,4594059,,True,34.0,5,11,5,11,0,0,6,7,2,6,8,0,3,0,2,3,16
401376586,Arkansas-Pine Bluff Golden Lions,K. Stokes,4594054,,True,30.0,2,6,2,4,0,2,0,0,2,2,4,0,0,0,3,2,4
401376586,Arkansas-Pine Bluff Golden Lions,T. Doolittle,4703148,,False,12.0,0,1,0,0,0,1,0,0,0,2,2,1,0,0,0,0,0
401376586,Arkansas-Pine Bluff Golden Lions,K. Milton,4703071,,False,23.0,4,11,3,9,1,2,3,3,1,0,1,1,0,0,1,3,12
401376586,Arkansas-Pine Bluff Golden Lions,I. Haralson,4594060,,False,2.0,0,0,0,0,0,0,0,0,0,0,0,0,0,0,0,0,0
401376586,Arkansas-Pine Bluff Golden Lions,TEAM,TOTAL,TOTAL,False,,25,52,17,37,8,15,21,23,9,19,28,9,6,0,11,18,79
401373784,Morgan State Bears,C. Venning,4711312,,True,13.0,3,8,3,8,0,0,1,2,2,6,8,1,1,2,1,1,7
401373784,Morgan State Bears,M. Miller,4398197,,True,32.0,3,10,3,10,0,0,2,9,4,9,13,0,3,0,1,4,8
401373784,Morgan State Bears,S. Devonish,4398196,,True,29.0,4,11,4,10,0,1,2,2,3,2,5,3,3,0,2,5,10
401373784,Morgan State Bears,T. Moore,4278218,,True,23.0,2,6,1,3,1,3,2,2,0,1,1,1,0,0,2,1,7
401373784,Morgan State Bears,S. Woods,4065676,,True,20.0,0,3,0,3,0,0,2,2,0,0,0,1,0,1,1,0,2
401373784,Morgan State Bears,L. Grantsaan,4593392,,False,27.0,4,12,4,11,0,1,0,1,2,7,9,0,0,1,6,3,8
401373784,Morgan State Bears,C. Nnamene,4397977,,False,0.0,0,0,0,0,0,0,0,0,0,0,0,0,0,0,0,0,0
401373784,Morgan State Bears,D. Ware,4398326,,False,13.0,1,4,0,0,1,4,1,2,0,3,3,1,1,0,4,2,4
401373784,Morgan State Bears,I. Burke,4398199,,False,21.0,6,6,5,5,1,1,1,1,0,2,2,1,1,1,2,3,14
401373784,Morgan State Bears,K. McGee,4397356,,False,22.0,1,6,0,3,1,3,0,0,1,2,3,1,0,0,1,0,3
401373784,Morgan State Bears,TEAM,TOTAL,TOTAL,False,,24,66,20,53,4,13,11,21,15,33,48,9,9,5,20,19,63
401373784,Coppin State Eagles,S. Conteh,4593442,,True,22.0,1,5,0,2,1,3,0,0,0,3,3,0,0,2,1,3,3
401373784,Coppin State Eagles,A. Rojas,4897756,,True,29.0,3,5,1,1,2,4,2,2,2,6,8,1,2,1,1,3,10
401373784,Coppin State Eagles,G. Spurlock,4897755,,True,29.0,1,3,1,3,0,0,1,1,0,0,0,1,0,0,2,0,3
401373784,Coppin State Eagles,N. Tarke,4704077,,True,39.0,7,22,7,16,0,6,4,9,2,9,11,5,4,1,7,4,18
401373784,Coppin State Eagles,K. Cardaci,4397944,,True,35.0,0,6,0,2,0,4,0,0,1,4,5,2,5,0,2,2,0
401373784,Coppin State Eagles,R. Lemovou,4897757,,False,3.0,0,0,0,0,0,0,0,0,0,2,2,0,0,0,0,1,0
401373784,Coppin State Eagles,M. Hood,4702075,,False,20.0,3,11,0,3,3,8,1,2,0,0,0,1,1,0,3,2,10
401373784,Coppin State Eagles,I. Gross,4593002,,False,2.0,0,0,0,0,0,0,0,0,0,1,1,0,0,0,0,0,0
401373784,Coppin State Eagles,J. Steers,4398112,,False,21.0,5,7,5,7,0,0,5,8,2,4,6,0,1,4,4,5,15
401373784,Coppin State Eagles,TEAM,TOTAL,TOTAL,False,,20,59,14,34,6,25,13,22,11,33,44,10,13,8,20,20,59
401373765,Florida International Panthers,C. Brown,4066229,,True,24.0,5,8,3,6,2,2,1,2,2,1,3,0,0,2,2,1,13
401373765,Florida International Panthers,S. Pinkney,4593362,,True,17.0,1,2,1,2,0,0,0,0,0,3,3,0,0,2,1,0,2
401373765,Florida International Panthers,D. Jones,4897493,,True,28.0,2,11,2,8,0,3,5,5,0,4,4,2,3,0,2,0,9
401373765,Florida International Panthers,E. Lovett,4592851,,True,28.0,4,13,1,6,3,7,0,0,3,3,6,1,2,0,2,0,11
401373765,Florida International Panthers,I. Banks,4278975,,True,25.0,1,3,0,2,1,1,0,2,0,2,2,0,1,0,1,3,3
401373765,Florida International Panthers,M. Sanogo,4897497,,False,12.0,1,4,1,4,0,0,0,0,1,2,3,0,1,1,2,3,2
401373765,Florida International Panthers,V. Hart,4897495,,False,8.0,1,2,1,2,0,0,0,0,0,1,1,0,0,0,0,1,2
401373765,Florida International Panthers,D. Wilcox,4432143,,False,5.0,0,0,0,0,0,0,0,0,0,1,1,0,0,0,0,1,0
401373765,Florida International Panthers,D. Parrish,4897496,,False,2.0,0,0,0,0,0,0,0,0,0,0,0,0,0,0,0,0,0
401373765,Florida International Panthers,P. Krivokapic,4702675,,False,14.0,1,5,0,2,1,3,0,0,0,1,1,0,1,0,0,0,3
401373765,Florida International Panthers,J. Hawkins,4702674,,False,23.0,2,5,0,1,2,4,0,0,1,1,2,6,1,0,2,1,6
401373765,Florida International Panthers,A. Smart,4590400,,False,14.0,0,3,0,3,0,0,0,0,0,0,0,1,0,0,1,1,0
401373765,Florida International Panthers,TEAM,TOTAL,TOTAL,False,,18,56,9,36,9,20,6,9,7,19,26,10,9,5,13,11,51
401373765,Florida Atlantic Owls,V. Goldin,4700818,,True,19.0,3,5,3,5,0,0,0,0,3,6,9,0,0,1,2,1,6
401373765,Florida Atlantic Owls,A. Martin,4702656,,True,26.0,5,10,2,4,3,6,0,0,0,3,3,1,2,0,1,1,13
401373765,Florida Atlantic Owls,B. Greenlee,4592701,,True,31.0,3,6,2,3,1,3,3,4,0,0,0,3,1,0,1,2,10
401373765,Florida Atlantic Owls,M. Forrest,4397485,,True,23.0,4,9,0,0,4,9,0,0,0,4,4,3,1,0,1,1,12
401373765,Florida Atlantic Owls,E. Winchester,4067456,,True,24.0,1,5,1,5,0,0,2,2,3,3,6,1,0,1,2,2,4
401373765,Florida Atlantic Owls,G. Rosado,4585611,,False,18.0,2,5,2,5,0,0,1,2,2,5,7,1,0,0,3,0,5
401373765,Florida Atlantic Owls,D. Kapiti,4432013,,False,3.0,0,0,0,0,0,0,0,0,0,0,0,0,0,0,0,0,0
401373765,Florida Atlantic Owls,M. Niang,4397482,,False,3.0,2,2,2,2,0,0,1,2,1,1,2,0,0,1,0,0,5
401373765,Florida Atlantic Owls,B. Baruti,4066634,,False,16.0,1,1,1,1,0,0,0,1,1,0,1,0,0,0,1,1,2
401373765,Florida Atlantic Owls,B. Weatherspoon,4897476,,False,10.0,2,6,1,3,1,3,0,0,1,3,4,0,0,0,0,2,5
401373765,Florida Atlantic Owls,B. Zimonjic,4897475,,False,1.0,0,0,0,0,0,0,0,0,0,0,0,0,0,0,0,0,0
401373765,Florida Atlantic Owls,J. Davis,4702655,,False,23.0,2,5,1,2,1,3,4,4,1,4,5,0,4,0,5,0,9
401373765,Florida Atlantic Owls,A. Ralat,4592847,,False,3.0,0,0,0,0,0,0,0,0,0,0,0,1,0,0,0,1,0
401373765,Florida Atlantic Owls,TEAM,TOTAL,TOTAL,False,,25,54,15,30,10,24,11,15,12,29,41,10,8,3,16,11,71
401373757,Hawai'i Rainbow Warriors,B. da Silva,4431868,,True,24.0,3,7,3,7,0,0,5,7,4,2,6,2,1,0,0,2,11
401373757,Hawai'i Rainbow Warriors,K. Hepa,4397080,,True,32.0,3,9,3,4,0,5,9,10,4,3,7,2,0,0,1,0,15
401373757,Hawai'i Rainbow Warriors,J. Desrosiers,4279566,,True,21.0,2,6,1,3,1,3,1,2,1,3,4,1,1,0,1,4,6
401373757,Hawai'i Rainbow Warriors,J. McClanahan,4702504,,True,28.0,2,4,1,2,1,2,0,0,0,0,0,5,0,0,3,2,5
401373757,Hawai'i Rainbow Warriors,J. Madut,4610175,,True,23.0,6,8,2,2,4,6,2,5,1,5,6,0,1,1,0,4,18
401373757,Hawai'i Rainbow Warriors,Z. Nedd,4397462,,False,3.0,0,0,0,0,0,0,0,0,0,2,2,0,0,0,0,0,0
401373757,Hawai'i Rainbow Warriors,M. Colina,4397460,,False,12.0,2,3,2,2,0,1,3,3,0,1,1,0,0,0,0,4,7
401373757,Hawai'i Rainbow Warriors,J. Jackson,4912957,,False,10.0,1,4,1,3,0,1,0,0,0,0,0,0,1,0,1,0,2
401373757,Hawai'i Rainbow Warriors,J. Prevodnik,4897666,,False,2.0,0,0,0,0,0,0,0,2,0,1,1,0,0,0,0,1,0
401373757,Hawai'i Rainbow Warriors,A. Lado,4897665,,False,23.0,4,7,3,3,1,4,2,2,0,0,0,1,0,0,1,1,11
401373757,Hawai'i Rainbow Warriors,B. Riley,4702505,,False,22.0,2,5,2,4,0,1,5,5,1,5,6,1,0,0,0,0,9
401373757,Hawai'i Rainbow Warriors,TEAM,TOTAL,TOTAL,False,,25,53,18,30,7,23,27,36,11,24,35,12,4,1,7,18,84
401373757,Cal State Northridge Matadors,C. Gray,4397274,,True,28.0,2,4,2,4,0,0,1,3,2,7,9,3,1,0,3,3,5
401373757,Cal State Northridge Matadors,O. Eyisi,4396816,,True,15.0,1,2,1,2,0,0,3,4,2,1,3,0,0,0,1,5,5
401373757,Cal State Northridge Matadors,A. Wright,4702491,,True,38.0,9,18,4,8,5,10,5,6,0,1,1,0,2,0,5,2,28
401373757,Cal State Northridge Matadors,B. Harrick,4397454,,True,3.0,0,0,0,0,0,0,0,0,0,0,0,0,0,0,0,0,0
401373757,Cal State Northridge Matadors,E. Hardy,4397156,,True,23.0,4,10,3,6,1,4,0,0,0,3,3,2,1,0,2,1,9
401373757,Cal State Northridge Matadors,E. Uche,4897661,,False,1.0,0,0,0,0,0,0,0,0,0,0,0,0,0,0,0,0,0
401373757,Cal State Northridge Matadors,F. Okereke,4702496,,False,13.0,2,3,2,3,0,0,2,4,2,0,2,1,1,0,1,5,6
401373757,Cal State Northridge Matadors,A. Pezeshkian,4897660,,False,2.0,0,0,0,0,0,0,0,0,0,0,0,0,0,0,0,0,0
401373757,Cal State Northridge Matadors,M. Stevens,4702493,,False,21.0,1,3,0,1,1,2,0,0,0,0,0,1,0,0,0,1,3
401373757,Cal State Northridge Matadors,M. James,4592972,,False,17.0,1,4,1,2,0,2,0,0,0,4,4,1,0,0,0,5,2
401373757,Cal State Northridge Matadors,K. Rains,4590351,,False,18.0,1,5,0,2,1,3,0,0,0,2,2,0,0,0,1,1,3
401373757,Cal State Northridge Matadors,D. Beane,4397490,,False,21.0,0,2,0,1,0,1,1,2,1,0,1,0,0,0,0,2,1
401373757,Cal State Northridge Matadors,TEAM,TOTAL,TOTAL,False,,21,51,13,29,8,22,12,19,9,21,30,8,5,0,14,25,62
401373756,UC Riverside Highlanders,W. Tattersall,4702357,,True,40.0,6,9,3,5,3,4,2,3,0,2,2,1,0,0,0,2,17
401373756,UC Riverside Highlanders,C. McRae,4397619,,True,36.0,5,7,5,7,0,0,4,4,2,8,10,1,0,0,5,1,14
401373756,UC Riverside Highlanders,Z. Pullin,4592979,,True,45.0,10,14,9,12,1,2,3,3,0,7,7,7,0,0,5,1,24
401373756,UC Riverside Highlanders,F. Cameron,4293886,,True,39.0,3,8,2,3,1,5,0,0,0,5,5,0,0,0,2,2,7
401373756,UC Riverside Highlanders,D. Pickett,4081600,,True,43.0,3,11,0,1,3,10,1,2,0,3,3,3,2,0,1,3,10
401373756,UC Riverside Highlanders,D. Mading,4592978,,False,3.0,0,0,0,0,0,0,0,0,0,0,0,0,0,0,0,1,0
401373756,UC Riverside Highlanders,J. Martinez,4703388,,False,9.0,0,0,0,0,0,0,0,0,0,1,1,0,1,0,1,4,0
401373756,UC Riverside Highlanders,D. Elkaz,4397614,,False,10.0,0,2,0,0,0,2,0,0,0,0,0,0,0,0,0,1,0
401373756,UC Riverside Highlanders,TEAM,TOTAL,TOTAL,False,,27,51,19,28,8,23,10,12,4,26,30,12,3,0,15,15,72
401373756,Long Beach State Beach,A. Traore,4897670,,True,27.0,0,6,0,6,0,0,1,3,2,7,9,2,1,0,1,4,1
401373756,Long Beach State Beach,J. Roberts,4278751,,True,37.0,8,14,7,12,1,2,3,3,2,1,3,1,2,0,0,1,20
401373756,Long Beach State Beach,J. Jones,4611534,,True,35.0,2,4,2,3,0,1,2,2,0,4,4,0,0,0,0,1,6
401373756,Long Beach State Beach,D. Cobb,4397496,,True,32.0,0,2,0,1,0,1,0,0,0,2,2,1,1,0,1,2,0
401373756,Long Beach State Beach,C. Slater,4066475,,True,43.0,5,13,5,12,0,1,2,2,0,4,4,4,0,1,2,1,12
401373756,Long Beach State Beach,T. Rotegaard,4703135,,False,4.0,0,0,0,0,0,0,0,0,0,0,0,0,0,0,1,0,0
401373756,Long Beach State Beach,R. Mansel,4431835,,False,13.0,4,6,4,6,0,0,0,0,0,1,1,0,0,0,0,0,8
401373756,Long Beach State Beach,J. Murray,4897669,,False,34.0,9,14,7,12,2,2,6,6,0,2,2,2,1,0,2,1,26
401373756,Long Beach State Beach,TEAM,TOTAL,TOTAL,False,,28,59,25,52,3,7,14,16,7,21,28,10,5,1,9,10,73
401373755,UC Irvine Anteaters,A. Johnson,4592959,,True,25.0,3,4,3,4,0,0,0,0,0,8,8,1,0,3,1,2,6
401373755,UC Irvine Anteaters,JC Butler,4397596,,True,27.0,3,6,3,4,0,2,0,0,0,2,2,1,0,0,0,0,6
401373755,UC Irvine Anteaters,C. Welp,4279073,,True,31.0,3,13,3,10,0,3,1,1,2,2,4,2,0,0,1,0,7
401373755,UC Irvine Anteaters,D. Baker,4702626,,True,21.0,3,5,3,3,0,2,2,2,0,1,1,1,1,0,1,4,8
401373755,UC Irvine Anteaters,J. Hohn,4433009,,True,24.0,4,6,2,3,2,3,2,4,1,6,7,2,2,0,2,2,12
401373755,UC Irvine Anteaters,E. Tshimanga,4592961,,False,8.0,0,0,0,0,0,0,2,2,3,3,6,0,0,0,2,4,2
401373755,UC Irvine Anteaters,D. Keeler,4592962,,False,0.0,0,0,0,0,0,0,0,0,0,0,0,0,0,0,0,0,0
401373755,UC Irvine Anteaters,B. Leuchten,4897676,,False,7.0,0,0,0,0,0,0,1,2,0,0,0,1,0,0,0,0,1
401373755,UC Irvine Anteaters,L. Redfield,4897677,,False,8.0,0,1,0,1,0,0,0,0,0,2,2,1,0,0,0,0,0
401373755,UC Irvine Anteaters,DJ Davis,4702628,,False,26.0,7,13,3,5,4,8,6,6,0,0,0,0,0,0,0,3,24
401373755,UC Irvine Anteaters,I. Lee,4592958,,False,14.0,0,2,0,0,0,2,0,0,0,0,0,0,0,0,1,1,0
401373755,UC Irvine Anteaters,O. Ujadughele,4432132,,False,9.0,0,0,0,0,0,0,0,0,0,1,1,0,0,0,4,3,0
401373755,UC Irvine Anteaters,TEAM,TOTAL,TOTAL,False,,23,50,17,30,6,20,14,17,8,25,33,9,3,3,12,19,66
401373755,Cal State Bakersfield Roadrunners,S. Stith,4594131,,True,27.0,5,13,5,12,0,1,2,3,2,2,4,0,0,0,3,2,12
401373755,Cal State Bakersfield Roadrunners,J. McCall,4278732,,True,32.0,5,12,4,11,1,1,1,2,1,3,4,1,0,1,0,2,12
401373755,Cal State Bakersfield Roadrunners,K. Higgins,4897654,,True,22.0,4,7,3,4,1,3,1,2,0,2,2,0,0,0,2,0,10
401373755,Cal State Bakersfield Roadrunners,G. Easter,4398050,,True,20.0,0,1,0,0,0,1,0,0,1,2,3,0,0,0,0,2,0
401373755,Cal State Bakersfield Roadrunners,J. Edler-Davis,4396025,,True,22.0,2,6,2,6,0,0,2,2,3,3,6,0,0,0,0,2,6
401373755,Cal State Bakersfield Roadrunners,B. Washington,4897655,,False,11.0,0,0,0,0,0,0,0,0,0,2,2,0,1,1,0,2,0
401373755,Cal State Bakersfield Roadrunners,C. Smith,4702472,,False,21.0,2,7,1,5,1,2,6,8,1,2,3,1,1,0,1,4,11
401373755,Cal State Bakersfield Roadrunners,T. Henson,4702471,,False,16.0,3,8,3,8,0,0,0,0,0,1,1,0,0,0,1,0,6
401373755,Cal State Bakersfield Roadrunners,I. Reynolds,4897656,,False,13.0,1,1,1,1,0,0,0,0,0,0,0,1,2,0,1,3,2
401373755,Cal State Bakersfield Roadrunners,D. Panopio,4897653,,False,16.0,1,2,1,2,0,0,0,0,0,0,0,4,0,0,1,0,2
401373755,Cal State Bakersfield Roadrunners,TEAM,TOTAL,TOTAL,False,,23,57,20,49,3,8,12,17,12,19,31,7,4,2,9,17,61
401373754,UC Davis Aggies,C. Anigwe,4397396,,True,17.0,3,6,3,6,0,0,1,3,3,1,4,0,0,0,4,5,7
401373754,UC Davis Aggies,K. Milling,4593062,,True,39.0,6,9,4,4,2,5,0,0,1,6,7,2,1,0,2,0,14
401373754,UC Davis Aggies,E. Pepper,4432077,,True,35.0,3,15,1,7,2,8,0,0,1,9,10,2,2,1,2,3,8
401373754,UC Davis Aggies,E. Manjon,4432033,,True,37.0,3,12,3,10,0,2,2,2,0,1,1,2,1,0,4,0,8
401373754,UC Davis Aggies,C. Fuller,4397580,,True,29.0,5,12,3,7,2,5,6,6,1,4,5,5,2,0,2,4,18
401373754,UC Davis Aggies,F. Borra,4702344,,False,10.0,1,1,1,1,0,0,0,0,2,1,3,1,0,0,2,1,2
401373754,UC Davis Aggies,A. Murphy,4432060,,False,11.0,0,1,0,1,0,0,0,0,1,3,4,0,0,0,0,2,0
401373754,UC Davis Aggies,A. Adebayo,4592953,,False,9.0,0,0,0,0,0,0,0,0,0,0,0,0,0,0,0,0,0
401373754,UC Davis Aggies,L. DeBruhl,4897673,,False,3.0,0,0,0,0,0,0,0,0,0,0,0,1,0,0,1,4,0
401373754,UC Davis Aggies,C. Ba,4397582,,False,10.0,0,0,0,0,0,0,2,3,0,0,0,1,0,0,1,2,2
401373754,UC Davis Aggies,TEAM,TOTAL,TOTAL,False,,21,56,15,36,6,20,11,14,11,26,37,14,6,1,19,21,59
401373754,Cal State Fullerton Titans,V. Lee,4397342,,True,28.0,1,4,1,4,0,0,0,0,1,4,5,0,0,2,2,2,2
401373754,Cal State Fullerton Titans,E.J. Anosike,4279647,,True,27.0,7,10,7,9,0,1,6,7,4,4,8,0,1,0,3,3,20
401373754,Cal State Fullerton Titans,L. Wrightsell Jr.,4702484,,True,33.0,1,7,1,6,0,1,0,0,0,4,4,2,2,0,1,1,2
401373754,Cal State Fullerton Titans,T. San Antonio,4432108,,True,28.0,3,7,2,4,1,3,0,1,2,4,6,2,2,0,0,5,7
401373754,Cal State Fullerton Titans,D. Milstead,4280171,,True,38.0,2,9,1,5,1,4,0,0,1,5,6,1,1,1,6,3,5
401373754,Cal State Fullerton Titans,I. Doumbia,4278109,,False,4.0,0,0,0,0,0,0,0,0,0,0,0,0,0,0,0,0,0
401373754,Cal State Fullerton Titans,J. Harris,4702482,,False,19.0,3,7,1,4,2,3,6,9,0,1,1,0,4,0,2,2,14
401373754,Cal State Fullerton Titans,T. Maddox Jr.,4397779,,False,23.0,4,9,4,6,0,3,4,4,0,0,0,2,0,0,0,1,12
401373754,Cal State Fullerton Titans,TEAM,TOTAL,TOTAL,False,,21,53,17,38,4,15,16,21,8,24,32,7,10,3,14,17,62
401373753,UC San Diego Tritons,F. Nwaokorie,4897686,,True,30.0,8,11,5,7,3,4,2,2,1,5,6,2,0,1,2,4,21
401373753,UC San Diego Tritons,T. Rocak,4702610,,True,32.0,6,16,4,14,2,2,10,10,3,3,6,4,2,0,0,2,24
401373753,UC San Diego Tritons,J. Roquemore,4702611,,True,28.0,1,4,1,3,0,1,2,2,1,2,3,1,1,0,0,3,4
401373753,UC San Diego Tritons,B. Pope,4702606,,True,16.0,0,3,0,2,0,1,2,2,0,0,0,1,0,0,0,0,2
401373753,UC San Diego Tritons,J. Killingsworth,4066807,,True,36.0,2,8,1,4,1,4,0,0,0,4,4,1,2,0,1,3,5
401373753,UC San Diego Tritons,J. Kosakowski,4702605,,False,22.0,5,6,0,0,5,6,0,0,1,0,1,0,0,0,1,1,15
401373753,UC San Diego Tritons,M. Pearson Jr.,4897684,,False,12.0,0,1,0,1,0,0,0,0,0,1,1,0,0,0,0,3,0
401373753,UC San Diego Tritons,K. Rasheed,4702608,,False,24.0,2,8,1,3,1,5,0,0,0,1,1,4,0,0,0,1,5
401373753,UC San Diego Tritons,TEAM,TOTAL,TOTAL,False,,24,57,12,34,12,23,16,16,9,18,27,13,5,1,4,17,76
401373753,Cal Poly Mustangs,T. Jaakkola,4397363,,True,14.0,0,1,0,1,0,0,4,4,1,1,2,1,0,0,0,3,4
401373753,Cal Poly Mustangs,C. Pierce,4702351,,True,37.0,5,10,5,8,0,2,2,3,1,1,2,11,1,0,1,3,12
401373753,Cal Poly Mustangs,B. Stevenson,4702353,,True,33.0,4,6,4,4,0,2,9,10,2,5,7,2,0,2,2,1,17
401373753,Cal Poly Mustangs,K. Sanders,4702352,,True,28.0,6,8,1,2,5,6,0,0,0,3,3,0,0,0,0,3,17
401373753,Cal Poly Mustangs,T. Taylor,4397446,,True,28.0,6,6,6,6,0,0,1,1,1,5,6,0,1,0,2,4,13
401373753,Cal Poly Mustangs,A. Koroma,4592922,,False,25.0,3,6,3,4,0,2,0,1,1,6,7,1,0,0,2,3,6
401373753,Cal Poly Mustangs,K. Colvin,4397366,,False,11.0,2,5,1,2,1,3,0,0,0,1,1,0,0,1,0,0,5
401373753,Cal Poly Mustangs,J. Franklin,4431954,,False,20.0,1,6,0,2,1,4,0,0,0,0,0,0,0,0,2,2,3
401373753,Cal Poly Mustangs,D. Esparza,4897664,,False,4.0,1,3,0,0,1,3,0,0,0,0,0,0,0,0,0,0,3
401373753,Cal Poly Mustangs,TEAM,TOTAL,TOTAL,False,,28,51,20,29,8,22,16,19,8,24,32,15,2,3,9,19,80
401373752,UC Davis Aggies,C. Anigwe,4397396,,True,13.0,0,1,0,1,0,0,2,2,0,3,3,0,1,1,2,4,2
401373752,UC Davis Aggies,K. Milling,4593062,,True,30.0,5,5,2,2,3,3,1,1,0,6,6,1,1,0,2,2,14
401373752,UC Davis Aggies,E. Pepper,4432077,,True,36.0,3,12,1,4,2,8,3,3,1,3,4,3,1,0,2,2,11
401373752,UC Davis Aggies,E. Manjon,4432033,,True,33.0,7,11,7,11,0,0,2,2,1,2,3,5,0,0,5,3,16
401373752,UC Davis Aggies,C. Fuller,4397580,,True,33.0,4,14,3,8,1,6,1,1,0,9,9,2,0,0,4,4,10
401373752,UC Davis Aggies,A. Murphy,4432060,,False,23.0,2,2,2,2,0,0,0,0,1,2,3,0,1,0,0,0,4
401373752,UC Davis Aggies,A. Adebayo,4592953,,False,13.0,1,1,1,1,0,0,0,0,1,0,1,1,0,1,1,1,2
401373752,UC Davis Aggies,L. DeBruhl,4897673,,False,6.0,0,0,0,0,0,0,0,0,0,1,1,1,0,1,0,1,0
401373752,UC Davis Aggies,C. Ba,4397582,,False,13.0,2,4,0,0,2,4,0,0,0,0,0,0,0,0,0,1,6
401373752,UC Davis Aggies,TEAM,TOTAL,TOTAL,False,,24,50,16,29,8,21,9,9,4,31,35,13,4,3,18,18,65
401373752,Long Beach State Beach,A. Traore,4897670,,True,36.0,4,7,4,7,0,0,6,8,5,9,14,4,2,1,1,2,14
401373752,Long Beach State Beach,J. Roberts,4278751,,True,21.0,6,11,6,7,0,4,0,0,0,0,0,2,2,0,1,4,12
401373752,Long Beach State Beach,J. Murray,4897669,,True,37.0,3,11,2,6,1,5,1,2,1,1,2,1,2,0,2,3,8
401373752,Long Beach State Beach,J. Jones,4611534,,True,35.0,7,15,1,2,6,13,1,1,1,4,5,1,2,1,0,1,21
401373752,Long Beach State Beach,C. Slater,4066475,,True,34.0,1,13,0,5,1,8,4,5,0,1,1,2,0,0,1,1,7
401373752,Long Beach State Beach,T. Rotegaard,4703135,,False,5.0,0,1,0,0,0,1,0,0,0,0,0,0,0,0,1,0,0
401373752,Long Beach State Beach,R. Mansel,4431835,,False,14.0,0,0,0,0,0,0,0,2,1,1,2,1,0,0,0,0,0
401373752,Long Beach State Beach,D. Cobb,4397496,,False,18.0,2,5,0,3,2,2,0,0,1,3,4,1,1,0,1,0,6
401373752,Long Beach State Beach,TEAM,TOTAL,TOTAL,False,,23,63,13,30,10,33,12,18,13,22,35,12,9,2,8,11,68
401373751,UC Santa Barbara Gauchos,A. Sow,4397644,,True,34.0,6,7,6,7,0,0,2,2,3,4,7,2,2,1,2,2,14
401373751,UC Santa Barbara Gauchos,M. Norris,4397104,,True,37.0,6,12,6,7,0,5,0,0,3,4,7,2,2,1,2,1,12
401373751,UC Santa Barbara Gauchos,A. Mitchell,4900671,,True,34.0,3,7,3,6,0,1,1,1,0,2,2,2,0,0,1,5,7
401373751,UC Santa Barbara Gauchos,J. Pierre-Louis,4431795,,True,36.0,5,10,5,9,0,1,6,7,1,2,3,2,2,0,5,2,16
401373751,UC Santa Barbara Gauchos,C. Wishart,4397521,,True,19.0,1,2,1,2,0,0,1,2,0,2,2,0,1,0,1,3,3
401373751,UC Santa Barbara Gauchos,R. Idehen,4397646,,False,9.0,3,4,3,4,0,0,2,2,1,0,1,0,0,0,0,2,8
401373751,UC Santa Barbara Gauchos,J. Nagle,4397643,,False,0.0,0,0,0,0,0,0,0,0,0,0,0,0,0,0,0,0,0
401373751,UC Santa Barbara Gauchos,C. Anderson,4900668,,False,5.0,0,1,0,0,0,1,0,0,0,0,0,0,0,0,0,1,0
401373751,UC Santa Barbara Gauchos,A. Sanni,4397676,,False,24.0,2,6,1,2,1,4,2,2,0,3,3,3,1,0,1,2,7
401373751,UC Santa Barbara Gauchos,S. Touré,4397642,,False,2.0,0,0,0,0,0,0,0,0,0,0,0,0,0,0,0,0,0
401373751,UC Santa Barbara Gauchos,TEAM,TOTAL,TOTAL,False,,26,49,25,37,1,12,14,16,9,17,26,11,8,2,14,18,67
401373751,Hawai'i Rainbow Warriors,B. da Silva,4431868,,True,25.0,1,1,1,1,0,0,0,0,2,2,4,2,0,0,4,0,2
401373751,Hawai'i Rainbow Warriors,K. Hepa,4397080,,True,35.0,7,11,2,2,5,9,0,1,1,6,7,1,2,1,5,2,19
401373751,Hawai'i Rainbow Warriors,J. Desrosiers,4279566,,True,35.0,6,11,3,5,3,6,0,0,2,2,4,1,1,0,1,1,15
401373751,Hawai'i Rainbow Warriors,J. McClanahan,4702504,,True,35.0,3,6,3,4,0,2,7,10,0,2,2,6,1,0,1,4,13
401373751,Hawai'i Rainbow Warriors,J. Madut,4610175,,True,37.0,4,13,3,9,1,4,0,0,2,2,4,3,0,0,3,2,9
401373751,Hawai'i Rainbow Warriors,M. Colina,4397460,,False,15.0,1,1,1,1,0,0,0,0,0,1,1,0,0,0,0,4,2
401373751,Hawai'i Rainbow Warriors,J. Jackson,4912957,,False,5.0,0,0,0,0,0,0,0,0,0,0,0,1,0,0,0,1,0
401373751,Hawai'i Rainbow Warriors,A. Lado,4897665,,False,5.0,0,1,0,0,0,1,0,0,0,0,0,0,0,0,1,0,0
401373751,Hawai'i Rainbow Warriors,B. Riley,4702505,,False,8.0,0,0,0,0,0,0,0,0,0,0,0,0,0,0,1,3,0
401373751,Hawai'i Rainbow Warriors,TEAM,TOTAL,TOTAL,False,,22,44,13,22,9,22,7,11,7,16,23,14,4,1,17,17,60
401373750,UC San Diego Tritons,F. Nwaokorie,4897686,,True,30.0,2,8,1,5,1,3,6,6,1,6,7,4,0,0,4,4,11
401373750,UC San Diego Tritons,T. Rocak,4702610,,True,20.0,6,13,6,12,0,1,5,9,1,6,7,4,0,1,3,4,17
401373750,UC San Diego Tritons,J. Roquemore,4702611,,True,34.0,3,6,2,3,1,3,0,0,0,1,1,3,1,0,0,0,7
401373750,UC San Diego Tritons,B. Pope,4702606,,True,35.0,6,8,4,5,2,3,5,5,0,2,2,0,0,1,0,1,19
401373750,UC San Diego Tritons,J. Killingsworth,4066807,,True,37.0,1,2,0,0,1,2,0,0,0,6,6,1,0,0,1,2,3
401373750,UC San Diego Tritons,J. Kosakowski,4702605,,False,13.0,0,2,0,0,0,2,0,0,0,0,0,0,1,0,1,1,0
401373750,UC San Diego Tritons,M. Gray,4397344,,False,2.0,0,1,0,0,0,1,0,0,0,0,0,0,0,0,1,1,0
401373750,UC San Diego Tritons,M. Pearson Jr.,4897684,,False,3.0,1,1,0,0,1,1,0,0,0,0,0,0,0,0,1,0,3
401373750,UC San Diego Tritons,K. Rasheed,4702608,,False,26.0,4,5,0,0,4,5,0,0,0,0,0,2,2,0,0,2,12
401373750,UC San Diego Tritons,TEAM,TOTAL,TOTAL,False,,23,46,13,25,10,21,16,20,4,23,27,14,4,2,11,15,72
401373750,Cal State Bakersfield Roadrunners,S. Stith,4594131,,True,13.0,0,0,0,0,0,0,2,2,0,0,0,0,0,0,2,2,2
401373750,Cal State Bakersfield Roadrunners,J. McCall,4278732,,True,34.0,13,22,13,22,0,0,0,1,3,4,7,1,0,0,2,3,26
401373750,Cal State Bakersfield Roadrunners,K. Higgins,4897654,,True,30.0,2,8,0,2,2,6,0,0,0,0,0,3,2,0,1,3,6
401373750,Cal State Bakersfield Roadrunners,G. Easter,4398050,,True,14.0,0,2,0,2,0,0,1,2,0,1,1,1,0,0,1,1,1
401373750,Cal State Bakersfield Roadrunners,J. Edler-Davis,4396025,,True,28.0,3,7,3,5,0,2,0,1,3,5,8,0,1,0,1,4,6
401373750,Cal State Bakersfield Roadrunners,B. Washington,4897655,,False,6.0,0,0,0,0,0,0,0,0,0,0,0,0,0,0,0,0,0
401373750,Cal State Bakersfield Roadrunners,C. Smith,4702472,,False,21.0,3,12,3,12,0,0,3,3,8,3,11,5,1,2,0,3,9
401373750,Cal State Bakersfield Roadrunners,T. Henson,4702471,,False,11.0,0,0,0,0,0,0,2,2,0,2,2,0,1,0,1,0,2
401373750,Cal State Bakersfield Roadrunners,J. Schoemann,4397272,,False,6.0,2,2,2,2,0,0,0,1,2,1,3,0,0,0,0,0,4
401373750,Cal State Bakersfield Roadrunners,A. Collum,4432856,,False,2.0,0,0,0,0,0,0,0,0,0,1,1,0,0,0,0,0,0
401373750,Cal State Bakersfield Roadrunners,D. Panopio,4897653,,False,10.0,1,3,1,1,0,2,0,0,0,2,2,1,0,0,0,1,2
401373750,Cal State Bakersfield Roadrunners,D. Walker,4702079,,False,25.0,5,11,3,8,2,3,0,0,0,2,2,1,0,0,0,1,12
401373750,Cal State Bakersfield Roadrunners,TEAM,TOTAL,TOTAL,False,,29,67,25,54,4,13,8,12,19,22,41,12,5,2,8,18,70
401373749,UC Irvine Anteaters,A. Johnson,4592959,,True,17.0,0,1,0,1,0,0,2,2,1,3,4,0,0,2,0,2,2
401373749,UC Irvine Anteaters,JC Butler,4397596,,True,13.0,0,1,0,1,0,0,0,0,0,1,1,1,0,0,1,2,0
401373749,UC Irvine Anteaters,C. Welp,4279073,,True,26.0,3,7,2,4,1,3,5,6,0,1,1,1,2,1,1,0,12
401373749,UC Irvine Anteaters,D. Baker,4702626,,True,31.0,7,16,5,10,2,6,2,3,0,1,1,1,1,0,2,3,18
401373749,UC Irvine Anteaters,J. Hohn,4433009,,True,19.0,1,4,1,2,0,2,2,2,0,1,1,1,1,0,2,3,4
401373749,UC Irvine Anteaters,E. Tshimanga,4592961,,False,11.0,0,1,0,1,0,0,0,0,1,3,4,1,0,0,0,0,0
401373749,UC Irvine Anteaters,D. Keeler,4592962,,False,7.0,1,4,1,4,0,0,0,0,2,1,3,0,0,0,0,2,2
401373749,UC Irvine Anteaters,B. Leuchten,4897676,,False,4.0,2,2,2,2,0,0,0,0,0,0,0,0,0,0,0,0,4
401373749,UC Irvine Anteaters,L. Redfield,4897677,,False,2.0,0,0,0,0,0,0,0,0,0,0,0,0,0,0,1,0,0
401373749,UC Irvine Anteaters,A. Henry,4702629,,False,4.0,0,1,0,1,0,0,0,0,0,0,0,0,0,0,1,0,0
401373749,UC Irvine Anteaters,DJ Davis,4702628,,False,26.0,1,6,0,2,1,4,0,1,0,0,0,3,1,0,2,1,3
401373749,UC Irvine Anteaters,I. Lee,4592958,,False,25.0,1,2,0,0,1,2,2,2,1,4,5,0,1,0,1,3,5
401373749,UC Irvine Anteaters,O. Ujadughele,4432132,,False,15.0,2,2,2,2,0,0,0,0,2,2,4,0,1,0,2,2,4
401373749,UC Irvine Anteaters,TEAM,TOTAL,TOTAL,False,,18,47,13,30,5,17,13,16,7,22,29,8,7,3,14,18,54
401373749,Cal Poly Mustangs,A. Koroma,4592922,,True,35.0,8,17,6,10,2,7,9,9,3,4,7,1,1,0,1,2,27
401373749,Cal Poly Mustangs,C. Pierce,4702351,,True,24.0,3,10,2,7,1,3,4,4,0,2,2,3,1,0,2,4,11
401373749,Cal Poly Mustangs,B. Stevenson,4702353,,True,27.0,1,6,1,5,0,1,2,2,1,4,5,6,1,0,0,1,4
401373749,Cal Poly Mustangs,K. Sanders,4702352,,True,24.0,0,1,0,1,0,0,0,0,0,1,1,1,0,0,4,2,0
401373749,Cal Poly Mustangs,T. Taylor,4397446,,True,30.0,2,5,0,2,2,3,2,2,1,6,7,1,1,1,0,3,8
401373749,Cal Poly Mustangs,K. Colvin,4397366,,False,16.0,1,3,1,2,0,1,0,0,2,0,2,0,0,0,2,1,2
401373749,Cal Poly Mustangs,T. Jaakkola,4397363,,False,7.0,1,2,1,2,0,0,0,0,1,1,2,0,0,0,0,0,2
401373749,Cal Poly Mustangs,J. Franklin,4431954,,False,32.0,5,10,4,6,1,4,0,0,1,2,3,0,0,0,2,1,11
401373749,Cal Poly Mustangs,D. Esparza,4897664,,False,3.0,0,0,0,0,0,0,0,0,0,1,1,0,1,0,0,0,0
401373749,Cal Poly Mustangs,H. Jory,4897662,,False,2.0,0,1,0,1,0,0,0,0,0,1,1,0,0,0,0,0,0
401373749,Cal Poly Mustangs,TEAM,TOTAL,TOTAL,False,,21,55,15,36,6,19,17,17,12,24,36,12,5,1,11,14,65
401373748,UC Riverside Highlanders,W. Tattersall,4702357,,True,34.0,6,10,3,5,3,5,0,2,1,1,2,2,3,0,0,3,15
401373748,UC Riverside Highlanders,C. McRae,4397619,,True,29.0,3,5,3,5,0,0,2,3,3,2,5,4,0,1,4,3,8
401373748,UC Riverside Highlanders,Z. Pullin,4592979,,True,39.0,5,11,4,9,1,2,4,6,1,5,6,8,0,0,4,4,15
401373748,UC Riverside Highlanders,F. Cameron,4293886,,True,34.0,4,9,0,1,4,8,2,3,2,4,6,1,0,0,2,3,14
401373748,UC Riverside Highlanders,D. Pickett,4081600,,True,36.0,4,7,2,3,2,4,3,4,1,3,4,5,1,0,2,1,13
401373748,UC Riverside Highlanders,D. Mading,4592978,,False,6.0,1,1,0,0,1,1,0,0,0,0,0,0,0,0,2,0,3
401373748,UC Riverside Highlanders,J. Martinez,4703388,,False,11.0,2,3,2,3,0,0,0,1,0,3,3,0,0,1,0,1,4
401373748,UC Riverside Highlanders,D. Elkaz,4397614,,False,11.0,1,1,0,0,1,1,0,0,0,2,2,0,0,0,1,1,3
401373748,UC Riverside Highlanders,TEAM,TOTAL,TOTAL,False,,26,47,14,26,12,21,11,19,9,23,32,20,4,2,15,16,75
401373748,Cal State Fullerton Titans,V. Lee,4397342,,True,28.0,4,5,4,5,0,0,0,0,2,3,5,1,2,0,0,3,8
401373748,Cal State Fullerton Titans,E.J. Anosike,4279647,,True,36.0,6,15,6,15,0,0,5,6,6,2,8,3,1,0,4,3,17
401373748,Cal State Fullerton Titans,L. Wrightsell Jr.,4702484,,True,33.0,3,6,3,5,0,1,0,0,0,2,2,1,2,0,1,1,6
401373748,Cal State Fullerton Titans,T. San Antonio,4432108,,True,21.0,2,3,1,2,1,1,0,0,1,4,5,3,0,0,0,3,5
401373748,Cal State Fullerton Titans,D. Milstead,4280171,,True,31.0,10,19,8,11,2,8,4,6,0,0,0,1,2,0,0,2,26
401373748,Cal State Fullerton Titans,I. Doumbia,4278109,,False,9.0,1,1,1,1,0,0,0,0,2,1,3,0,0,1,1,1,2
401373748,Cal State Fullerton Titans,D. Maddox Jr.,4702487,,False,3.0,0,1,0,0,0,1,0,0,0,0,0,0,0,0,0,0,0
401373748,Cal State Fullerton Titans,J. Harris,4702482,,False,15.0,1,7,0,4,1,3,0,0,0,1,1,2,1,0,0,3,3
401373748,Cal State Fullerton Titans,T. Maddox Jr.,4397779,,False,24.0,2,6,2,3,0,3,1,1,0,3,3,3,1,0,1,0,5
401373748,Cal State Fullerton Titans,TEAM,TOTAL,TOTAL,False,,29,63,25,46,4,17,10,13,11,17,28,14,9,1,7,16,72
401373747,UC Santa Barbara Gauchos,A. Sow,4397644,,True,26.0,12,15,12,15,0,0,2,3,2,5,7,0,1,0,2,3,26
401373747,UC Santa Barbara Gauchos,M. Norris,4397104,,True,32.0,1,7,1,3,0,4,2,2,3,5,8,2,2,2,1,0,4
401373747,UC Santa Barbara Gauchos,A. Mitchell,4900671,,True,36.0,6,9,5,6,1,3,4,5,1,3,4,3,0,0,2,2,17
401373747,UC Santa Barbara Gauchos,J. Pierre-Louis,4431795,,True,22.0,2,3,2,2,0,1,3,6,2,2,4,2,1,0,2,3,7
401373747,UC Santa Barbara Gauchos,C. Wishart,4397521,,True,31.0,1,4,1,4,0,0,1,2,0,2,2,5,0,0,1,1,3
401373747,UC Santa Barbara Gauchos,R. Idehen,4397646,,False,18.0,0,0,0,0,0,0,0,0,1,2,3,0,0,0,2,0,0
401373747,UC Santa Barbara Gauchos,J. Nagle,4397643,,False,4.0,0,0,0,0,0,0,0,0,0,0,0,0,0,0,0,0,0
401373747,UC Santa Barbara Gauchos,C. Anderson,4900668,,False,7.0,1,2,0,0,1,2,0,0,0,3,3,0,0,0,0,0,3
401373747,UC Santa Barbara Gauchos,A. Sanni,4397676,,False,20.0,2,5,0,3,2,2,2,2,0,1,1,2,0,0,1,2,8
401373747,UC Santa Barbara Gauchos,S. Touré,4397642,,False,4.0,1,2,1,1,0,1,0,0,0,0,0,1,0,0,0,0,2
401373747,UC Santa Barbara Gauchos,TEAM,TOTAL,TOTAL,False,,26,47,22,34,4,13,14,20,9,23,32,15,4,2,13,11,70
401373747,Cal State Northridge Matadors,C. Gray,4397274,,True,20.0,0,0,0,0,0,0,2,2,0,3,3,2,1,0,1,3,2
401373747,Cal State Northridge Matadors,O. Eyisi,4396816,,True,22.0,6,9,6,9,0,0,0,0,3,1,4,1,0,0,0,3,12
401373747,Cal State Northridge Matadors,A. Wright,4702491,,True,37.0,4,16,2,7,2,9,1,1,0,1,1,2,5,0,4,2,11
401373747,Cal State Northridge Matadors,M. James,4592972,,True,38.0,4,10,3,8,1,2,0,0,2,6,8,2,0,0,0,3,9
401373747,Cal State Northridge Matadors,E. Hardy,4397156,,True,37.0,6,12,4,8,2,4,1,1,0,3,3,4,0,0,3,2,15
401373747,Cal State Northridge Matadors,F. Okereke,4702496,,False,13.0,1,1,1,1,0,0,0,2,1,1,2,0,0,0,1,2,2
401373747,Cal State Northridge Matadors,M. Stevens,4702493,,False,3.0,0,0,0,0,0,0,0,0,0,0,0,0,0,0,0,0,0
401373747,Cal State Northridge Matadors,K. Rains,4590351,,False,15.0,1,3,0,1,1,2,1,3,0,0,0,0,1,0,0,2,4
401373747,Cal State Northridge Matadors,D. Beane,4397490,,False,15.0,3,3,3,3,0,0,0,0,0,0,0,0,0,0,0,3,6
401373747,Cal State Northridge Matadors,TEAM,TOTAL,TOTAL,False,,25,54,19,37,6,17,5,9,7,17,24,11,7,0,11,20,61
401373620,St. John's Red Storm,A. Wheeler,4277982,,True,24.0,5,11,5,7,0,4,1,4,0,5,5,3,3,1,1,3,11
401373620,St. John's Red Storm,J. Soriano,4592317,,True,16.0,1,4,1,4,0,0,6,6,1,5,6,1,0,0,1,4,8
401373620,St. John's Red Storm,J. Champagnie,4592479,,True,33.0,6,17,6,13,0,4,3,3,0,5,5,2,1,0,3,3,15
401373620,St. John's Red Storm,P. Alexander,4433156,,True,36.0,0,4,0,3,0,1,0,0,2,1,3,9,2,0,2,2,0
401373620,St. John's Red Storm,T. Coburn,4066515,,True,5.0,0,2,0,0,0,2,0,0,0,0,0,0,0,0,0,1,0
401373620,St. John's Red Storm,E. Nyiwe,4897419,,False,17.0,4,5,3,4,1,1,1,1,0,3,3,0,0,1,0,0,10
401373620,St. John's Red Storm,O. Stanley,4703032,,False,4.0,0,0,0,0,0,0,0,0,0,1,1,0,0,0,0,0,0
401373620,St. John's Red Storm,R. Pinzon,4683951,,False,10.0,3,6,3,4,0,2,0,1,2,2,4,1,1,0,0,1,6
401373620,St. John's Red Storm,D. Addae-Wusu,4590361,,False,25.0,8,10,5,6,3,4,0,0,1,1,2,2,0,0,1,4,19
401373620,St. John's Red Storm,M. Mathis,4397250,,False,21.0,2,8,1,7,1,1,3,4,1,2,3,2,1,0,1,1,8
401373620,St. John's Red Storm,S. Smith,4278244,,False,9.0,0,3,0,3,0,0,0,0,0,3,3,0,0,0,2,2,0
401373620,St. John's Red Storm,TEAM,TOTAL,TOTAL,False,,29,70,24,51,5,19,14,19,10,30,40,20,8,2,11,21,77
401373620,Marquette Golden Eagles,J. Lewis,4432239,,True,33.0,9,20,5,13,4,7,6,7,0,7,7,0,1,2,1,2,28
401373620,Marquette Golden Eagles,K. Kuath,4397028,,True,22.0,5,6,5,6,0,0,2,2,3,4,7,0,0,1,1,4,12
401373620,Marquette Golden Eagles,T. Kolek,4433225,,True,33.0,0,2,0,1,0,1,0,1,0,4,4,6,0,0,2,2,0
401373620,Marquette Golden Eagles,G. Elliott,4278570,,True,18.0,1,3,0,0,1,3,5,5,0,6,6,4,0,0,0,2,8
401373620,Marquette Golden Eagles,D. Morsell,4277954,,True,33.0,8,14,8,10,0,4,4,6,1,5,6,4,0,1,5,2,20
401373620,Marquette Golden Eagles,D. Joplin,4684306,,False,6.0,2,6,1,3,1,3,0,0,0,0,0,0,0,1,0,1,5
401373620,Marquette Golden Eagles,O. Prosper,4595400,,False,20.0,0,3,0,2,0,1,2,2,1,1,2,1,2,0,0,1,2
401373620,Marquette Golden Eagles,O. Ighodaro,4601023,,False,18.0,3,5,3,5,0,0,1,2,1,3,4,0,2,1,2,1,7
401373620,Marquette Golden Eagles,K. Jones,4697268,,False,11.0,0,1,0,0,0,1,0,0,0,3,3,1,0,0,1,2,0
401373620,Marquette Golden Eagles,S. Mitchell,4683840,,False,6.0,1,2,0,0,1,2,0,0,0,0,0,1,1,0,1,1,3
401373620,Marquette Golden Eagles,TEAM,TOTAL,TOTAL,False,,29,62,22,40,7,22,20,25,7,35,42,17,6,6,13,18,85
401373619,Xavier Musketeers,Z. Freemantle,4432869,,True,15.0,2,3,2,3,0,0,0,0,0,1,1,1,0,0,2,4,4
401373619,Xavier Musketeers,J. Nunge,4277948,,True,30.0,6,10,4,7,2,3,2,3,4,5,9,3,2,2,1,2,16
401373619,Xavier Musketeers,C. Jones,4433378,,True,30.0,4,6,3,4,1,2,7,10,0,6,6,7,2,2,0,2,16
401373619,Xavier Musketeers,P. Scruggs,4278591,,True,28.0,3,7,2,4,1,3,1,2,0,4,4,4,1,0,2,4,8
401373619,Xavier Musketeers,N. Johnson,4067338,,True,30.0,9,17,2,6,7,11,0,0,0,1,1,4,0,1,0,0,25
401373619,Xavier Musketeers,J. Hunter,4397011,,False,9.0,1,1,1,1,0,0,0,0,1,1,2,0,1,0,1,2,2
401373619,Xavier Musketeers,C. Edwards,4708074,,False,5.0,2,4,2,4,0,0,0,0,1,1,2,0,1,0,0,0,4
401373619,Xavier Musketeers,S. Cody,4597887,,False,2.0,0,1,0,1,0,0,0,0,1,0,1,1,0,0,0,0,0
401373619,Xavier Musketeers,D. Odom,4432632,,False,24.0,2,3,2,3,0,0,2,2,0,2,2,4,1,0,2,2,6
401373619,Xavier Musketeers,Z. Swetye,4403036,,False,2.0,1,3,1,2,0,1,0,0,0,0,0,0,0,0,0,0,2
401373619,Xavier Musketeers,R. Singh,4403035,,False,2.0,1,1,1,1,0,0,0,0,0,1,1,0,0,0,0,0,2
401373619,Xavier Musketeers,A. Kunkel,4398300,,False,23.0,4,8,1,3,3,5,1,1,0,4,4,8,0,1,1,2,12
401373619,Xavier Musketeers,TEAM,TOTAL,TOTAL,False,,35,64,21,39,14,25,13,18,10,30,40,32,8,6,9,18,97
401373619,Georgetown Hoyas,C. Holloway,4701559,,True,28.0,6,8,5,6,1,2,4,7,1,3,4,2,2,0,3,3,17
401373619,Georgetown Hoyas,T. Ighoefe,4431991,,True,5.0,0,0,0,0,0,0,0,0,0,1,1,0,0,0,0,1,0
401373619,Georgetown Hoyas,D. Harris,4596531,,True,30.0,8,14,5,8,3,6,0,0,0,2,2,1,0,0,3,0,19
401373619,Georgetown Hoyas,A. Mohammed,4433252,,True,39.0,6,16,6,16,0,0,3,7,8,8,16,2,1,2,2,1,15
401373619,Georgetown Hoyas,D. Carey,4402802,,True,29.0,1,6,1,3,0,3,5,5,1,1,2,2,2,0,4,5,7
401373619,Georgetown Hoyas,M. Wilson,4595429,,False,5.0,0,1,0,1,0,0,0,0,1,0,1,0,0,1,0,0,0
401373619,Georgetown Hoyas,J. Billingsley,4687376,,False,6.0,0,0,0,0,0,0,0,0,0,1,1,0,1,0,0,2,0
401373619,Georgetown Hoyas,K. Clark,4432477,,False,7.0,0,0,0,0,0,0,0,0,0,1,1,0,0,1,0,1,0
401373619,Georgetown Hoyas,R. Mutombo,4683739,,False,4.0,1,2,1,2,0,0,2,2,1,0,1,0,0,0,0,1,4
401373619,Georgetown Hoyas,T. Beard,4433195,,False,15.0,2,5,2,5,0,0,0,0,0,1,1,0,0,0,0,0,4
401373619,Georgetown Hoyas,K. Rice,4280011,,False,32.0,3,13,2,4,1,9,2,2,0,4,4,1,0,0,0,1,9
401373619,Georgetown Hoyas,TEAM,TOTAL,TOTAL,False,,27,65,22,45,5,20,16,23,13,22,35,8,6,4,12,15,75
401373618,Seton Hall Pirates,T. Jackson,4593010,,True,11.0,0,2,0,1,0,1,0,0,1,1,2,0,0,0,0,3,0
401373618,Seton Hall Pirates,I. Obiagu,4277851,,True,17.0,1,2,1,2,0,0,0,0,0,2,2,0,0,1,1,5,2
401373618,Seton Hall Pirates,J. Rhoden,4397119,,True,39.0,8,18,6,14,2,4,1,3,1,5,6,3,0,2,0,0,19
401373618,Seton Hall Pirates,K. Richmond,4701845,,True,4.0,0,2,0,2,0,0,0,0,1,0,1,1,0,0,1,0,0
401373618,Seton Hall Pirates,M. Cale,4278579,,True,40.0,3,10,3,8,0,2,0,0,2,3,5,1,5,0,1,2,6
401373618,Seton Hall Pirates,T. Samuel,4432105,,False,23.0,5,9,4,6,1,3,2,2,0,5,5,0,2,1,1,2,13
401373618,Seton Hall Pirates,A. Yetna,4278308,,False,29.0,5,6,4,5,1,1,0,0,4,7,11,1,1,0,1,1,11
401373618,Seton Hall Pirates,T. Powell,4684146,,False,2.0,0,0,0,0,0,0,0,0,0,0,0,0,1,0,0,1,0
401373618,Seton Hall Pirates,J. Harris,4277966,,False,35.0,5,16,2,10,3,6,1,2,1,2,3,1,2,0,2,2,14
401373618,Seton Hall Pirates,TEAM,TOTAL,TOTAL,False,,27,65,20,48,7,17,4,7,11,26,37,7,11,4,8,16,65
401373618,Creighton Bluejays,R. Hawkins,4897413,,True,38.0,6,16,3,7,3,9,2,2,0,7,7,0,2,0,3,2,17
401373618,Creighton Bluejays,A. Kaluma,4433599,,True,28.0,4,9,3,6,1,3,0,0,1,4,5,0,0,0,1,2,9
401373618,Creighton Bluejays,R. Kalkbrenner,4576060,,True,33.0,5,9,3,6,2,3,5,6,5,3,8,1,1,3,1,1,17
401373618,Creighton Bluejays,T. Alexander,4433268,,True,30.0,4,7,3,5,1,2,0,0,1,3,4,3,1,1,4,2,9
401373618,Creighton Bluejays,A. O'Connell,4277846,,True,36.0,1,11,0,4,1,7,3,4,0,6,6,5,0,0,1,0,6
401373618,Creighton Bluejays,K. Feazell,4278099,,False,7.0,1,1,1,1,0,0,0,0,0,1,1,0,0,0,2,0,2
401373618,Creighton Bluejays,R. Andronikashvili,4701555,,False,28.0,0,1,0,1,0,0,0,0,1,2,3,0,0,0,2,3,0
401373618,Creighton Bluejays,TEAM,TOTAL,TOTAL,False,,21,54,13,30,8,24,10,12,8,28,36,9,4,4,14,10,60
401373617,UConn Huskies,I. Whaley,4278231,,True,32.0,5,9,5,8,0,1,0,0,2,4,6,1,0,1,1,3,10
401373617,UConn Huskies,T. Polley,4278230,,True,21.0,2,6,1,3,1,3,3,4,0,2,2,0,0,0,1,2,8
401373617,UConn Huskies,A. Sanogo,4702023,,True,33.0,10,16,10,16,0,0,6,6,3,8,11,1,0,1,2,5,26
401373617,UConn Huskies,T. Martin,4397179,,True,35.0,7,18,6,16,1,2,4,5,6,10,16,2,1,0,0,0,19
401373617,UConn Huskies,R.J. Cole,4279789,,True,32.0,1,9,1,5,0,4,1,2,0,0,0,2,0,0,3,0,3
401373617,UConn Huskies,A. Akok,4431706,,False,6.0,0,0,0,0,0,0,0,0,0,1,1,1,0,3,0,0,0
401373617,UConn Huskies,A. Jackson,4432190,,False,31.0,3,4,2,3,1,1,0,0,1,7,8,4,1,0,1,4,7
401373617,UConn Huskies,J. Gaffney,4431732,,False,10.0,1,2,1,1,0,1,0,0,0,1,1,1,0,0,0,0,2
401373617,UConn Huskies,TEAM,TOTAL,TOTAL,False,,29,64,26,52,3,12,14,17,15,34,49,12,2,5,9,14,75
401373617,DePaul Blue Demons,D. Jones,4713010,,True,32.0,6,16,5,8,1,8,0,0,2,6,8,3,1,3,1,1,13
401373617,DePaul Blue Demons,B. Johnson,4067410,,True,33.0,5,16,3,10,2,6,2,5,2,3,5,0,0,0,0,0,14
401373617,DePaul Blue Demons,N. Ongenda,4431760,,True,25.0,2,3,2,3,0,0,1,4,2,4,6,2,1,2,0,3,5
401373617,DePaul Blue Demons,J. Terry,4702387,,True,22.0,1,3,0,0,1,3,0,0,0,1,1,4,2,0,2,4,3
401373617,DePaul Blue Demons,J. Freeman-Liberty,4397511,,True,34.0,8,18,5,13,3,5,3,5,2,1,3,3,1,0,1,2,22
401373617,DePaul Blue Demons,Y. Anei,4397046,,False,13.0,1,4,1,4,0,0,0,0,1,2,3,0,1,2,0,3,2
401373617,DePaul Blue Demons,C. McCauley,4701557,,False,23.0,2,5,0,2,2,3,0,0,1,1,2,0,0,0,0,1,6
401373617,DePaul Blue Demons,P. Gebrewhit,4397991,,False,18.0,1,1,0,0,1,1,0,0,0,1,1,0,0,1,0,2,3
401373617,DePaul Blue Demons,TEAM,TOTAL,TOTAL,False,,26,66,16,40,10,26,6,14,11,20,31,12,6,8,4,16,68
401373616,Villanova Wildcats,E. Dixon,4431718,,True,14.0,0,4,0,4,0,0,0,0,4,2,6,2,0,1,1,3,0
401373616,Villanova Wildcats,B. Slater,4397133,,True,26.0,3,3,2,2,1,1,0,0,0,2,2,2,1,0,1,4,7
401373616,Villanova Wildcats,J. Samuels,4278588,,True,27.0,7,13,6,10,1,3,0,0,2,2,4,1,0,0,4,1,15
401373616,Villanova Wildcats,J. Moore,4592491,,True,30.0,6,11,4,7,2,4,2,4,0,5,5,1,0,1,2,2,16
401373616,Villanova Wildcats,C. Gillespie,4278585,,True,32.0,4,8,1,3,3,5,0,0,0,2,2,4,0,0,2,1,11
401373616,Villanova Wildcats,T. Patterson,4713885,,False,3.0,0,1,0,0,0,1,0,0,1,0,1,0,0,0,1,0,0
401373616,Villanova Wildcats,K. Voigt,4702030,,False,1.0,0,0,0,0,0,0,0,0,0,0,0,0,0,0,0,0,0
401373616,Villanova Wildcats,J. Longino,4684153,,False,22.0,4,9,2,4,2,5,0,0,2,5,7,1,1,0,0,2,10
401373616,Villanova Wildcats,C. Arcidiacono,4592490,,False,20.0,2,4,1,2,1,2,3,4,1,1,2,1,1,0,0,1,8
401373616,Villanova Wildcats,B. Antoine,4432814,,False,2.0,0,1,0,1,0,0,0,0,0,0,0,0,0,0,0,2,0
401373616,Villanova Wildcats,C. Daniels,4278373,,False,23.0,4,7,3,4,1,3,2,2,0,4,4,1,0,0,2,3,11
401373616,Villanova Wildcats,TEAM,TOTAL,TOTAL,False,,30,61,19,37,11,24,7,10,12,26,38,13,3,2,13,19,78
401373616,Butler Bulldogs,B. Nze,4067439,,True,32.0,1,3,1,2,0,1,4,6,2,7,9,0,0,1,3,4,6
401373616,Butler Bulldogs,B. Golden,4397026,,True,11.0,0,4,0,1,0,3,0,0,0,0,0,1,0,1,0,2,0
401373616,Butler Bulldogs,C. Harris,4701551,,True,36.0,7,13,4,6,3,7,2,2,0,2,2,2,1,0,2,2,19
401373616,Butler Bulldogs,Bo Hodges,4280018,,True,31.0,4,15,3,10,1,5,3,5,2,4,6,0,3,2,0,2,12
401373616,Butler Bulldogs,A. Thompson,4278552,,True,32.0,2,6,2,4,0,2,3,4,0,0,0,3,0,0,2,2,7
401373616,Butler Bulldogs,D. Hughes,4684308,,False,2.0,0,0,0,0,0,0,0,0,0,0,0,0,0,0,0,0,0
401373616,Butler Bulldogs,M. Parker,4592450,,False,3.0,0,0,0,0,0,0,0,0,0,0,0,0,0,0,0,0,0
401373616,Butler Bulldogs,M. Wilmoth,4433560,,False,1.0,0,0,0,0,0,0,0,0,0,0,0,0,0,0,0,0,0
401373616,Butler Bulldogs,J. Mulloy,4432870,,False,4.0,0,0,0,0,0,0,0,0,1,0,1,0,0,0,0,1,0
401373616,Butler Bulldogs,Ty Groce,4067382,,False,6.0,1,1,1,1,0,0,0,0,0,0,0,0,0,0,0,0,2
401373616,Butler Bulldogs,S. Lukosius,4897411,,False,24.0,3,5,2,2,1,3,0,0,0,3,3,1,1,0,1,1,7
401373616,Butler Bulldogs,J. Taylor,4589483,,False,17.0,2,8,2,4,0,4,0,0,0,2,2,0,1,0,1,1,4
401373616,Butler Bulldogs,M. Tate,4572452,,False,1.0,0,0,0,0,0,0,2,2,0,1,1,1,1,0,0,0,2
401373616,Butler Bulldogs,TEAM,TOTAL,TOTAL,False,,20,55,15,30,5,25,14,19,6,21,27,8,7,4,10,16,59
401373615,Marquette Golden Eagles,O. Prosper,4595400,,True,34.0,2,6,2,5,0,1,5,6,1,3,4,2,2,0,2,3,9
401373615,Marquette Golden Eagles,J. Lewis,4432239,,True,32.0,11,18,7,11,4,7,0,0,1,9,10,2,0,0,2,3,26
401373615,Marquette Golden Eagles,K. Kuath,4397028,,True,11.0,2,3,2,3,0,0,0,0,1,1,2,0,0,1,1,3,4
401373615,Marquette Golden Eagles,T. Kolek,4433225,,True,24.0,1,4,1,1,0,3,0,0,1,2,3,3,1,0,4,3,2
401373615,Marquette Golden Eagles,D. Morsell,4277954,,True,25.0,5,10,4,7,1,3,1,1,0,2,2,0,1,1,4,2,12
401373615,Marquette Golden Eagles,D. Joplin,4684306,,False,4.0,1,3,1,1,0,2,0,0,0,0,0,0,0,0,0,0,2
401373615,Marquette Golden Eagles,O. Ighodaro,4601023,,False,26.0,4,6,4,6,0,0,2,4,3,1,4,1,0,2,1,2,10
401373615,Marquette Golden Eagles,K. Jones,4697268,,False,15.0,1,5,0,0,1,5,0,0,0,0,0,1,0,0,2,1,3
401373615,Marquette Golden Eagles,S. Mitchell,4683840,,False,16.0,5,7,3,4,2,3,0,0,0,2,2,1,3,0,1,0,12
401373615,Marquette Golden Eagles,G. Elliott,4278570,,False,13.0,0,4,0,2,0,2,0,0,0,1,1,2,2,0,0,0,0
401373615,Marquette Golden Eagles,TEAM,TOTAL,TOTAL,False,,32,66,24,40,8,26,8,11,8,24,32,12,9,4,17,17,80
401373615,DePaul Blue Demons,D. Jones,4713010,,True,30.0,6,15,6,12,0,3,4,4,2,4,6,4,3,0,3,2,16
401373615,DePaul Blue Demons,B. Johnson,4067410,,True,33.0,4,8,4,7,0,1,5,6,2,2,4,1,2,0,4,3,13
401373615,DePaul Blue Demons,N. Ongenda,4431760,,True,22.0,5,8,5,8,0,0,3,3,2,1,3,2,0,0,2,4,13
401373615,DePaul Blue Demons,J. Terry,4702387,,True,39.0,6,10,2,2,4,8,0,0,0,8,8,1,0,0,2,3,16
401373615,DePaul Blue Demons,J. Freeman-Liberty,4397511,,True,39.0,8,20,6,13,2,7,8,9,3,6,9,5,3,0,2,1,26
401373615,DePaul Blue Demons,Y. Anei,4397046,,False,17.0,1,1,1,1,0,0,0,0,0,4,4,1,1,2,1,2,2
401373615,DePaul Blue Demons,C. McCauley,4701557,,False,17.0,2,5,1,2,1,3,0,0,0,3,3,2,1,0,0,0,5
401373615,DePaul Blue Demons,P. Gebrewhit,4397991,,False,3.0,0,0,0,0,0,0,0,0,0,0,0,0,0,0,0,0,0
401373615,DePaul Blue Demons,TEAM,TOTAL,TOTAL,False,,32,67,25,45,7,22,20,22,11,29,40,16,10,2,15,15,91
401373614,UConn Huskies,I. Whaley,4278231,,True,31.0,1,6,0,3,1,3,0,0,1,1,2,0,0,0,1,0,3
401373614,UConn Huskies,A. Sanogo,4702023,,True,37.0,6,16,6,16,0,0,1,2,5,11,16,0,1,6,1,4,13
401373614,UConn Huskies,A. Jackson,4432190,,True,31.0,2,9,2,3,0,6,1,2,0,3,3,3,0,0,1,1,5
401373614,UConn Huskies,T. Martin,4397179,,True,25.0,5,7,4,6,1,1,0,1,2,3,5,0,1,1,1,5,11
401373614,UConn Huskies,R.J. Cole,4279789,,True,35.0,9,20,7,13,2,7,0,0,1,1,2,4,0,0,1,2,20
401373614,UConn Huskies,T. Polley,4278230,,False,25.0,2,3,0,0,2,3,0,0,1,0,1,0,0,1,0,3,6
401373614,UConn Huskies,J. Hawkins,4683750,,False,5.0,0,1,0,0,0,1,0,0,0,0,0,0,0,0,0,0,0
401373614,UConn Huskies,J. Gaffney,4431732,,False,11.0,2,4,2,3,0,1,0,0,0,1,1,0,1,0,1,2,4
401373614,UConn Huskies,TEAM,TOTAL,TOTAL,False,,27,66,21,44,6,22,2,5,12,21,33,7,3,8,6,17,62
401373614,Creighton Bluejays,R. Hawkins,4897413,,True,38.0,5,12,4,7,1,5,2,2,1,5,6,3,1,0,1,1,13
401373614,Creighton Bluejays,A. Kaluma,4433599,,True,28.0,6,13,3,8,3,5,0,0,1,4,5,1,0,1,2,2,15
401373614,Creighton Bluejays,R. Kalkbrenner,4576060,,True,35.0,10,14,10,13,0,1,2,3,4,6,10,1,0,0,1,0,22
401373614,Creighton Bluejays,T. Alexander,4433268,,True,38.0,3,6,3,6,0,0,2,2,0,2,2,3,0,0,2,1,8
401373614,Creighton Bluejays,A. O'Connell,4277846,,True,34.0,1,3,1,2,0,1,0,2,0,9,9,4,0,0,0,0,2
401373614,Creighton Bluejays,K. Feazell,4278099,,False,5.0,1,2,1,2,0,0,0,0,0,1,1,1,0,1,1,2,2
401373614,Creighton Bluejays,R. Andronikashvili,4701555,,False,22.0,1,5,1,5,0,0,0,1,0,2,2,1,3,1,1,4,2
401373614,Creighton Bluejays,D. Davis,4701554,,False,0.0,0,0,0,0,0,0,0,0,0,0,0,0,0,0,0,0,0
401373614,Creighton Bluejays,TEAM,TOTAL,TOTAL,False,,27,55,23,43,4,12,6,10,7,30,37,14,4,3,10,10,64
401373613,Seton Hall Pirates,T. Jackson,4593010,,True,22.0,2,6,2,3,0,3,0,0,0,2,2,0,0,1,3,2,4
401373613,Seton Hall Pirates,I. Obiagu,4277851,,True,22.0,3,4,3,4,0,0,1,2,4,0,4,0,0,4,0,3,7
401373613,Seton Hall Pirates,J. Rhoden,4397119,,True,36.0,6,17,6,14,0,3,4,6,2,4,6,1,0,0,2,0,16
401373613,Seton Hall Pirates,K. Richmond,4701845,,True,33.0,4,9,2,6,2,3,2,2,0,5,5,10,0,1,1,3,12
401373613,Seton Hall Pirates,M. Cale,4278579,,True,31.0,5,10,5,6,0,4,1,1,2,1,3,0,0,0,0,3,11
401373613,Seton Hall Pirates,T. Samuel,4432105,,False,18.0,3,7,3,7,0,0,3,4,4,2,6,0,1,0,2,2,9
401373613,Seton Hall Pirates,A. Yetna,4278308,,False,17.0,1,3,1,2,0,1,0,0,1,6,7,1,0,1,1,1,2
401373613,Seton Hall Pirates,J. Harris,4277966,,False,21.0,4,9,2,3,2,6,2,2,2,3,5,1,0,0,0,1,12
401373613,Seton Hall Pirates,TEAM,TOTAL,TOTAL,False,,28,65,24,45,4,20,13,17,19,26,45,13,1,7,10,15,73
401373613,Georgetown Hoyas,C. Holloway,4701559,,True,37.0,4,10,4,7,0,3,8,8,1,2,3,0,0,0,2,1,16
401373613,Georgetown Hoyas,T. Ighoefe,4431991,,True,23.0,1,5,1,5,0,0,2,4,4,5,9,1,0,4,1,2,4
401373613,Georgetown Hoyas,D. Harris,4596531,,True,37.0,6,10,6,10,0,0,0,0,0,1,1,6,3,0,3,2,12
401373613,Georgetown Hoyas,A. Mohammed,4433252,,True,24.0,2,10,1,6,1,4,0,0,0,2,2,1,0,1,2,3,5
401373613,Georgetown Hoyas,D. Carey,4402802,,True,37.0,3,10,2,5,1,5,4,4,2,6,8,0,0,0,0,3,11
401373613,Georgetown Hoyas,J. Billingsley,4687376,,False,7.0,1,3,1,2,0,1,1,1,0,0,0,0,1,0,0,1,3
401373613,Georgetown Hoyas,K. Clark,4432477,,False,2.0,0,0,0,0,0,0,0,0,0,1,1,0,0,0,0,0,0
401373613,Georgetown Hoyas,R. Mutombo,4683739,,False,3.0,0,0,0,0,0,0,0,0,0,1,1,0,0,0,0,2,0
401373613,Georgetown Hoyas,K. Rice,4280011,,False,30.0,6,9,1,1,5,8,0,0,0,1,1,0,0,0,0,4,17
401373613,Georgetown Hoyas,TEAM,TOTAL,TOTAL,False,,23,57,16,36,7,21,15,17,9,20,29,8,4,5,8,18,68
401373612,Xavier Musketeers,Z. Freemantle,4432869,,True,18.0,4,6,4,6,0,0,1,2,2,3,5,0,2,1,1,3,9
401373612,Xavier Musketeers,J. Nunge,4277948,,True,28.0,3,8,2,5,1,3,5,9,4,7,11,0,0,1,0,1,12
401373612,Xavier Musketeers,C. Jones,4433378,,True,29.0,5,15,5,10,0,5,3,5,3,3,6,1,0,0,0,3,13
401373612,Xavier Musketeers,D. Odom,4432632,,True,31.0,2,3,2,3,0,0,4,4,0,2,2,3,2,0,1,2,8
401373612,Xavier Musketeers,P. Scruggs,4278591,,True,28.0,3,9,2,5,1,4,0,0,0,2,2,3,0,0,4,3,7
401373612,Xavier Musketeers,J. Hunter,4397011,,False,15.0,2,7,2,4,0,3,2,2,2,1,3,0,1,0,1,2,6
401373612,Xavier Musketeers,C. Edwards,4708074,,False,3.0,0,1,0,1,0,0,0,0,1,2,3,0,0,0,0,0,0
401373612,Xavier Musketeers,A. Kunkel,4398300,,False,28.0,0,10,0,4,0,6,0,0,0,3,3,0,1,0,1,3,0
401373612,Xavier Musketeers,N. Johnson,4067338,,False,20.0,4,12,1,3,3,9,0,0,1,2,3,0,0,0,1,1,11
401373612,Xavier Musketeers,TEAM,TOTAL,TOTAL,False,,23,71,18,41,5,30,15,22,15,26,41,7,6,2,9,18,66
401373612,St. John's Red Storm,J. Soriano,4592317,,True,22.0,5,7,5,7,0,0,0,0,2,3,5,0,0,0,3,4,10
401373612,St. John's Red Storm,J. Champagnie,4592479,,True,36.0,7,15,7,10,0,5,5,6,0,8,8,3,2,2,1,1,19
401373612,St. John's Red Storm,P. Alexander,4433156,,True,33.0,4,11,4,10,0,1,9,11,2,5,7,8,0,0,2,2,17
401373612,St. John's Red Storm,S. Smith,4278244,,True,15.0,1,4,1,2,0,2,0,0,1,4,5,2,1,0,0,2,2
401373612,St. John's Red Storm,T. Coburn,4066515,,True,26.0,6,8,1,1,5,7,3,3,0,1,1,1,1,3,1,1,20
401373612,St. John's Red Storm,E. Nyiwe,4897419,,False,9.0,0,0,0,0,0,0,0,0,0,3,3,0,0,0,0,1,0
401373612,St. John's Red Storm,O. Stanley,4703032,,False,4.0,0,0,0,0,0,0,0,0,0,1,1,0,0,0,0,2,0
401373612,St. John's Red Storm,J. Rosemond,4702009,,False,1.0,0,0,0,0,0,0,0,0,0,0,0,0,0,0,0,0,0
401373612,St. John's Red Storm,A. Wheeler,4277982,,False,26.0,4,8,1,3,3,5,0,0,1,10,11,2,1,1,2,1,11
401373612,St. John's Red Storm,A. Gavalas,4702007,,False,1.0,0,0,0,0,0,0,0,0,0,0,0,0,0,0,0,0,0
401373612,St. John's Red Storm,R. Pinzon,4683951,,False,2.0,0,0,0,0,0,0,0,0,0,0,0,0,0,0,0,0,0
401373612,St. John's Red Storm,D. Addae-Wusu,4590361,,False,12.0,0,3,0,1,0,2,0,0,0,0,0,1,0,0,1,2,0
401373612,St. John's Red Storm,M. Mathis,4397250,,False,13.0,1,4,1,4,0,0,0,0,0,2,2,1,0,0,0,3,2
401373612,St. John's Red Storm,TEAM,TOTAL,TOTAL,False,,28,60,20,38,8,22,17,20,6,38,44,18,5,6,11,19,81
401373611,Villanova Wildcats,E. Dixon,4431718,,True,29.0,5,11,4,9,1,2,4,4,3,1,4,0,3,1,1,3,15
401373611,Villanova Wildcats,B. Slater,4397133,,True,27.0,1,4,1,2,0,2,1,1,1,1,2,2,2,0,1,3,3
401373611,Villanova Wildcats,J. Samuels,4278588,,True,25.0,2,3,2,3,0,0,5,6,2,3,5,1,0,2,1,5,9
401373611,Villanova Wildcats,J. Moore,4592491,,True,38.0,4,14,1,6,3,8,2,4,3,3,6,1,1,1,1,1,13
401373611,Villanova Wildcats,C. Gillespie,4278585,,True,37.0,4,12,1,5,3,7,3,4,0,4,4,5,3,0,0,3,14
401373611,Villanova Wildcats,J. Longino,4684153,,False,7.0,1,1,1,1,0,0,0,0,0,1,1,1,0,0,0,1,2
401373611,Villanova Wildcats,C. Arcidiacono,4592490,,False,7.0,0,1,0,0,0,1,0,0,0,0,0,0,0,0,1,0,0
401373611,Villanova Wildcats,C. Daniels,4278373,,False,30.0,6,11,4,4,2,7,6,6,0,2,2,1,0,0,0,0,20
401373611,Villanova Wildcats,TEAM,TOTAL,TOTAL,False,,23,57,14,30,9,27,21,25,11,19,30,11,9,4,5,16,76
401373611,Providence Friars,N. Horchler,4278453,,True,39.0,5,8,0,0,5,8,0,0,1,6,7,2,1,1,2,3,15
401373611,Providence Friars,J. Minaya,4278111,,True,38.0,4,9,1,2,3,7,0,0,2,2,4,2,0,1,1,3,11
401373611,Providence Friars,N. Watson,4278573,,True,24.0,2,5,2,5,0,0,2,3,3,2,5,0,0,0,2,4,6
401373611,Providence Friars,J. Bynum,4397194,,True,39.0,6,16,5,12,1,4,6,6,0,6,6,10,1,2,4,1,19
401373611,Providence Friars,A.J. Reeves,4397109,,True,25.0,5,9,0,0,5,9,0,0,2,1,3,2,0,0,2,4,15
401373611,Providence Friars,Ed Croswell,4397153,,False,17.0,2,5,2,5,0,0,0,1,4,2,6,1,0,0,1,4,4
401373611,Providence Friars,A. Breed,4585590,,False,15.0,1,3,0,0,1,3,1,2,0,2,2,1,0,1,2,1,4
401373611,Providence Friars,B. Goodine,4431716,,False,3.0,0,1,0,0,0,1,0,0,0,0,0,0,1,0,1,1,0
401373611,Providence Friars,TEAM,TOTAL,TOTAL,False,,25,56,10,24,15,32,9,12,14,25,39,18,3,5,16,21,74
401373187,Texas Southern Tigers,J. Nicholas,4278623,,True,25.0,5,9,5,9,0,0,1,3,0,7,7,1,0,1,4,4,11
401373187,Texas Southern Tigers,J. Hopkins,4067629,,True,22.0,1,6,1,4,0,2,6,6,1,2,3,1,0,0,2,2,8
401373187,Texas Southern Tigers,B. Gresham,4066799,,True,31.0,5,6,5,6,0,0,4,6,4,6,10,1,0,5,0,4,14
401373187,Texas Southern Tigers,A. Lawson,4897771,,True,27.0,5,10,3,7,2,3,4,7,0,3,3,2,5,1,2,3,16
401373187,Texas Southern Tigers,J. Jones,4278696,,True,17.0,3,7,0,1,3,6,1,2,0,1,1,1,0,0,1,1,10
401373187,Texas Southern Tigers,Y. Rasas,4594119,,False,8.0,1,3,1,3,0,0,0,0,1,1,2,0,0,0,0,1,2
401373187,Texas Southern Tigers,J. Walker III,4278121,,False,15.0,1,3,0,2,1,1,4,8,0,0,0,2,0,0,0,1,7
401373187,Texas Southern Tigers,B. Etienne,4594120,,False,23.0,2,8,1,2,1,6,1,1,0,0,0,0,2,1,1,4,6
401373187,Texas Southern Tigers,P. Henry,4431987,,False,7.0,0,1,0,1,0,0,0,0,0,0,0,1,0,0,1,1,0
401373187,Texas Southern Tigers,J. Gilliam,4397615,,False,25.0,1,3,0,1,1,2,1,2,1,1,2,3,2,0,0,0,4
401373187,Texas Southern Tigers,TEAM,TOTAL,TOTAL,False,,24,56,16,36,8,20,22,35,8,25,33,12,9,8,11,21,78
401373187,Prairie View A&M Panthers,M. Bell,4594055,,True,27.0,4,8,4,6,0,2,4,5,2,5,7,0,0,0,2,4,12
401373187,Prairie View A&M Panthers,J. Gambrell,4397884,,True,37.0,8,22,3,8,5,14,6,6,1,1,2,1,0,0,4,0,27
401373187,Prairie View A&M Panthers,J. Daniels,4594103,,True,34.0,5,12,2,7,3,5,4,4,2,6,8,0,1,1,5,3,17
401373187,Prairie View A&M Panthers,D. Cox,4594100,,True,22.0,0,2,0,1,0,1,5,6,2,3,5,2,3,1,1,5,5
401373187,Prairie View A&M Panthers,W. Douglas,4278296,,True,24.0,2,6,2,6,0,0,3,4,1,3,4,3,2,0,1,4,7
401373187,Prairie View A&M Panthers,J. Kendall,4897812,,False,33.0,3,10,3,10,0,0,1,2,3,5,8,1,1,0,1,3,7
401373187,Prairie View A&M Panthers,B. Myles,4897813,,False,12.0,0,1,0,1,0,0,0,0,0,4,4,1,0,0,0,5,0
401373187,Prairie View A&M Panthers,C. Guess,4396958,,False,3.0,0,0,0,0,0,0,0,0,0,0,0,0,0,0,0,0,0
401373187,Prairie View A&M Panthers,D. Ware,4897811,,False,8.0,1,4,1,3,0,1,0,0,1,0,1,0,0,0,0,0,2
401373187,Prairie View A&M Panthers,TEAM,TOTAL,TOTAL,False,,23,65,15,42,8,23,23,27,19,31,50,8,7,2,15,24,77
401373173,Grambling Tigers,A. McCray,4397673,,True,17.0,3,5,3,5,0,0,0,2,0,3,3,0,2,0,0,4,6
401373173,Grambling Tigers,S. Cowart,4702762,,True,33.0,3,5,3,5,0,0,0,0,0,2,2,2,1,0,3,3,6
401373173,Grambling Tigers,T. Moton,4594071,,True,36.0,3,8,1,5,2,3,3,4,0,2,2,3,0,0,2,3,11
401373173,Grambling Tigers,P. Moss,4280109,,True,38.0,6,17,4,11,2,6,1,3,3,5,8,1,1,0,0,3,15
401373173,Grambling Tigers,C. Christon,4278638,,True,29.0,6,10,3,4,3,6,6,9,2,3,5,3,0,0,2,3,21
401373173,Grambling Tigers,M. Lamin,4897848,,False,22.0,5,8,5,8,0,0,0,0,3,6,9,0,1,0,3,3,10
401373173,Grambling Tigers,E. Parrish,4610342,,False,2.0,0,0,0,0,0,0,0,0,0,0,0,0,0,0,1,0,0
401373173,Grambling Tigers,Z. Munford,4594070,,False,21.0,2,7,0,1,2,6,0,1,0,2,2,1,2,0,0,1,6
401373173,Grambling Tigers,C. Robinson,4433101,,False,2.0,0,1,0,1,0,0,0,0,0,0,0,0,0,0,0,0,0
401373173,Grambling Tigers,TEAM,TOTAL,TOTAL,False,,28,61,19,40,9,21,10,19,11,24,35,10,7,0,11,20,75
401373173,Alabama State Hornets,J. O'Neal,4703116,,True,10.0,0,1,0,1,0,0,0,0,0,0,0,0,0,1,0,1,0
401373173,Alabama State Hornets,G. Liddell,4397076,,True,35.0,4,11,3,7,1,4,6,8,1,4,5,1,0,4,3,3,15
401373173,Alabama State Hornets,I. Range,4705379,,True,26.0,1,6,1,3,0,3,1,2,1,6,7,2,2,0,2,2,3
401373173,Alabama State Hornets,E. Clark,4703117,,True,35.0,6,9,5,7,1,2,7,7,0,0,0,4,0,0,1,1,20
401373173,Alabama State Hornets,K. Strawbridge,4395991,,True,30.0,5,9,3,5,2,4,2,2,1,7,8,2,3,0,2,2,14
401373173,Alabama State Hornets,T. Young,4397447,,False,32.0,7,9,3,3,4,6,3,3,1,9,10,3,1,2,3,3,21
401373173,Alabama State Hornets,J. Reyna,4897872,,False,27.0,1,3,1,1,0,2,3,4,1,2,3,2,0,0,0,3,5
401373173,Alabama State Hornets,C. McCray,4702483,,False,5.0,0,1,0,1,0,0,0,0,0,0,0,0,0,0,0,0,0
401373173,Alabama State Hornets,TEAM,TOTAL,TOTAL,False,,24,49,16,28,8,21,22,26,5,29,34,14,6,7,13,15,78
401373172,Grambling Tigers,A. McCray,4397673,,True,16.0,2,6,2,6,0,0,0,0,1,2,3,1,0,0,0,3,4
401373172,Grambling Tigers,S. Cowart,4702762,,True,30.0,4,9,3,6,1,3,0,1,0,4,4,5,0,1,3,2,9
401373172,Grambling Tigers,T. Moton,4594071,,True,25.0,1,7,1,6,0,1,0,0,2,4,6,3,2,0,2,1,2
401373172,Grambling Tigers,P. Moss,4280109,,True,38.0,5,11,4,7,1,4,0,0,3,2,5,3,0,0,0,5,11
401373172,Grambling Tigers,C. Christon,4278638,,True,30.0,4,15,3,9,1,6,3,3,0,3,3,2,1,1,0,2,12
401373172,Grambling Tigers,T. Randolph,4594073,,False,2.0,0,0,0,0,0,0,0,0,0,0,0,0,0,0,0,0,0
401373172,Grambling Tigers,M. Lamin,4897848,,False,21.0,2,6,2,6,0,0,2,2,2,6,8,0,0,2,2,3,6
401373172,Grambling Tigers,E. Parrish,4610342,,False,13.0,0,0,0,0,0,0,1,2,2,3,5,0,1,0,2,0,1
401373172,Grambling Tigers,Z. Munford,4594070,,False,16.0,7,12,4,6,3,6,1,3,3,3,6,0,2,0,0,4,18
401373172,Grambling Tigers,C. Robinson,4433101,,False,9.0,0,4,0,3,0,1,0,0,0,0,0,0,0,0,1,2,0
401373172,Grambling Tigers,TEAM,TOTAL,TOTAL,False,,25,70,19,49,6,21,7,11,13,28,41,14,6,4,10,22,63
401373172,Alabama A&M Bulldogs,M. Parker,4703104,,True,25.0,1,7,1,5,0,2,0,0,2,3,5,1,0,0,1,2,2
401373172,Alabama A&M Bulldogs,J. Johnson,4594013,,True,35.0,7,14,6,13,1,1,6,8,4,6,10,1,0,2,0,1,21
401373172,Alabama A&M Bulldogs,D. Smith,4703106,,True,30.0,4,8,2,4,2,4,0,0,0,6,6,1,1,1,3,3,10
401373172,Alabama A&M Bulldogs,G. Hicks,4594014,,True,38.0,4,10,2,6,2,4,7,8,1,5,6,3,2,1,2,3,17
401373172,Alabama A&M Bulldogs,C. Tucker,4594012,,True,38.0,5,9,5,8,0,1,4,6,0,8,8,4,1,0,3,3,14
401373172,Alabama A&M Bulldogs,A. Cortez,4703108,,False,19.0,1,5,1,5,0,0,1,2,0,0,0,0,0,1,1,0,3
401373172,Alabama A&M Bulldogs,E. Williams,4594016,,False,9.0,2,5,2,5,0,0,0,1,0,2,2,0,0,0,0,1,4
401373172,Alabama A&M Bulldogs,E. Lee,4703109,,False,5.0,0,0,0,0,0,0,0,1,1,2,3,0,1,0,2,2,0
401373172,Alabama A&M Bulldogs,B. Powell,4397898,,False,1.0,0,1,0,1,0,0,0,0,1,0,1,0,0,0,0,1,0
401373172,Alabama A&M Bulldogs,TEAM,TOTAL,TOTAL,False,,24,59,19,47,5,12,18,26,10,35,45,10,5,5,12,16,71
401373153,Florida A&M Rattlers,DJ Jones,4066476,,True,25.0,9,11,9,10,0,1,0,0,3,4,7,0,0,1,0,4,18
401373153,Florida A&M Rattlers,B. Moragne,4279780,,True,34.0,3,5,2,4,1,1,1,2,2,2,4,5,0,0,1,3,8
401373153,Florida A&M Rattlers,J. Speer,4704015,,True,30.0,3,10,2,7,1,3,2,2,0,3,3,9,0,0,0,2,9
401373153,Florida A&M Rattlers,MJ Randolph,4398142,,True,40.0,6,10,6,8,0,2,7,9,1,4,5,3,0,0,3,0,19
401373153,Florida A&M Rattlers,K. Reaves,4279781,,True,33.0,4,10,0,3,4,7,2,2,1,3,4,5,1,0,2,2,14
401373153,Florida A&M Rattlers,J. Brown,4704021,,False,22.0,7,9,5,6,2,3,0,0,0,2,2,1,1,2,0,1,16
401373153,Florida A&M Rattlers,R. Mathews,4899686,,False,0.0,0,0,0,0,0,0,0,0,0,0,0,0,0,0,0,0,0
401373153,Florida A&M Rattlers,K. Littles,4704017,,False,16.0,0,2,0,1,0,1,0,0,1,1,2,3,1,0,1,0,0
401373153,Florida A&M Rattlers,TEAM,TOTAL,TOTAL,False,,32,57,24,39,8,18,12,15,8,19,27,26,3,3,7,12,84
401373153,Bethune-Cookman Wildcats,J. Bolden,4702632,,True,18.0,0,1,0,1,0,0,2,2,1,1,2,0,0,0,0,3,2
401373153,Bethune-Cookman Wildcats,K. Davis,4899526,,True,38.0,5,10,3,6,2,4,5,5,0,4,4,3,0,2,0,2,17
401373153,Bethune-Cookman Wildcats,M. Garrett,4703258,,True,29.0,8,16,6,13,2,3,1,5,2,4,6,4,1,0,5,3,19
401373153,Bethune-Cookman Wildcats,J. French,4592996,,True,36.0,7,12,4,7,3,5,2,2,1,0,1,2,0,0,0,1,19
401373153,Bethune-Cookman Wildcats,D. McEntire,4592639,,True,32.0,4,4,4,4,0,0,1,2,3,2,5,3,3,0,1,3,9
401373153,Bethune-Cookman Wildcats,J. Long,4066295,,False,23.0,0,2,0,2,0,0,0,0,2,3,5,1,0,0,1,3,0
401373153,Bethune-Cookman Wildcats,M. West,4702550,,False,18.0,3,10,2,7,1,3,0,0,1,1,2,0,0,0,1,0,7
401373153,Bethune-Cookman Wildcats,C. Joseph,4398249,,False,6.0,0,2,0,2,0,0,0,0,0,0,0,0,0,0,0,0,0
401373153,Bethune-Cookman Wildcats,TEAM,TOTAL,TOTAL,False,,27,57,19,42,8,15,11,16,12,17,29,13,4,2,9,15,73
401373132,Arkansas-Pine Bluff Golden Lions,A. Stredic,4594058,,True,25.0,0,0,0,0,0,0,2,4,1,2,3,0,1,0,1,3,2
401373132,Arkansas-Pine Bluff Golden Lions,S. Williams,4897867,,True,18.0,1,5,0,0,1,5,0,0,0,1,1,0,0,0,1,0,3
401373132,Arkansas-Pine Bluff Golden Lions,B. Brown,4897863,,True,7.0,0,3,0,1,0,2,1,2,2,1,3,2,0,0,0,1,1
401373132,Arkansas-Pine Bluff Golden Lions,D. Morris,4594059,,True,34.0,5,12,5,12,0,0,8,10,2,2,4,2,2,0,2,3,18
401373132,Arkansas-Pine Bluff Golden Lions,K. Stokes,4594054,,True,31.0,2,8,1,5,1,3,0,0,1,3,4,2,2,2,2,2,5
401373132,Arkansas-Pine Bluff Golden Lions,O. Parchman,4703152,,False,13.0,0,0,0,0,0,0,0,0,0,1,1,0,0,0,0,2,0
401373132,Arkansas-Pine Bluff Golden Lions,T. Doolittle,4703148,,False,20.0,1,4,0,0,1,4,0,0,1,1,2,0,0,0,1,0,3
401373132,Arkansas-Pine Bluff Golden Lions,K. Milton,4703071,,False,33.0,13,25,5,11,8,14,8,11,0,0,0,2,4,0,2,2,42
401373132,Arkansas-Pine Bluff Golden Lions,I. Haralson,4594060,,False,19.0,1,5,0,2,1,3,0,0,0,1,1,0,1,1,0,2,3
401373132,Arkansas-Pine Bluff Golden Lions,TEAM,TOTAL,TOTAL,False,,23,62,11,31,12,31,19,27,8,14,22,8,10,3,10,15,77
401373132,Alcorn State Braves,D. Agnew,4593690,,True,15.0,6,6,6,6,0,0,2,3,1,2,3,1,1,1,0,2,14
401373132,Alcorn State Braves,L. Henry,4278645,,True,27.0,7,14,5,11,2,3,1,2,1,8,9,2,0,1,1,1,17
401373132,Alcorn State Braves,B. Joshua,4703131,,True,24.0,6,8,5,5,1,3,2,3,1,4,5,3,2,0,1,3,15
401373132,Alcorn State Braves,O. Walker,4398293,,True,20.0,3,6,3,3,0,3,0,0,2,2,4,2,0,1,2,3,6
401373132,Alcorn State Braves,J. Thomas,4067394,,True,34.0,5,7,5,6,0,1,1,2,0,3,3,10,3,0,5,2,11
401373132,Alcorn State Braves,D. McQuarter,4705266,,False,27.0,3,6,2,5,1,1,0,2,2,1,3,1,0,1,1,2,7
401373132,Alcorn State Braves,K. Montgomery,4432410,,False,25.0,7,10,2,4,5,6,2,2,1,4,5,2,2,0,0,0,21
401373132,Alcorn State Braves,L. Marshall,4397708,,False,7.0,1,2,1,2,0,0,0,0,1,2,3,1,0,1,3,1,2
401373132,Alcorn State Braves,M. Pajeaud,4899682,,False,4.0,0,0,0,0,0,0,0,0,0,3,3,0,0,1,0,3,0
401373132,Alcorn State Braves,D. Brewton,4594037,,False,8.0,2,3,2,3,0,0,1,2,1,2,3,2,0,0,1,1,5
401373132,Alcorn State Braves,D. Thorn,4594033,,False,9.0,1,1,1,1,0,0,0,1,1,0,1,4,0,0,2,1,2
401373132,Alcorn State Braves,TEAM,TOTAL,TOTAL,False,,41,63,32,46,9,17,9,17,11,34,45,28,8,6,17,19,100
401373131,Mississippi Valley State Delta Devils,G. Grant,4899805,,True,34.0,2,7,2,5,0,2,10,15,0,10,10,4,1,0,7,3,14
401373131,Mississippi Valley State Delta Devils,A. Perry,4705890,,True,31.0,4,14,2,7,2,7,0,0,0,4,4,2,0,0,0,2,10
401373131,Mississippi Valley State Delta Devils,D. Umoh,4899810,,True,11.0,2,4,2,4,0,0,0,0,1,0,1,0,1,0,1,1,4
401373131,Mississippi Valley State Delta Devils,T. Collins,4705894,,True,40.0,8,17,5,7,3,10,5,9,1,4,5,1,3,2,0,3,24
401373131,Mississippi Valley State Delta Devils,D. McCoy,4593270,,True,32.0,4,11,3,8,1,3,5,5,3,5,8,4,3,0,4,5,14
401373131,Mississippi Valley State Delta Devils,Q. Waldon,4899809,,False,8.0,0,0,0,0,0,0,0,0,0,1,1,0,0,0,0,0,0
401373131,Mississippi Valley State Delta Devils,J. Aguer,4899808,,False,10.0,0,0,0,0,0,0,0,0,0,1,1,0,0,1,1,1,0
401373131,Mississippi Valley State Delta Devils,D. Gordon,4705893,,False,1.0,0,0,0,0,0,0,0,0,0,0,0,0,0,0,0,0,0
401373131,Mississippi Valley State Delta Devils,E. Davis,4899806,,False,0.0,0,1,0,0,0,1,0,0,0,0,0,0,0,0,0,0,0
401373131,Mississippi Valley State Delta Devils,G. Ivory III,4703150,,False,17.0,1,3,0,2,1,1,0,0,1,0,1,0,0,0,0,0,3
401373131,Mississippi Valley State Delta Devils,J. Johnson,4597906,,False,16.0,0,5,0,5,0,0,0,0,1,2,3,0,0,0,0,2,0
401373131,Mississippi Valley State Delta Devils,TEAM,TOTAL,TOTAL,False,,21,62,14,38,7,24,20,29,8,29,37,11,8,3,13,17,69
401373131,Alcorn State Braves,D. McQuarter,4705266,,True,20.0,6,8,6,8,0,0,2,3,1,3,4,0,0,2,2,1,14
401373131,Alcorn State Braves,L. Henry,4278645,,True,26.0,4,11,4,11,0,0,0,2,5,8,13,0,1,0,2,2,8
401373131,Alcorn State Braves,B. Joshua,4703131,,True,27.0,3,5,3,4,0,1,2,4,2,4,6,1,0,0,3,4,8
401373131,Alcorn State Braves,O. Walker,4398293,,True,19.0,2,9,0,2,2,7,0,0,1,4,5,0,0,1,1,2,6
401373131,Alcorn State Braves,J. Thomas,4067394,,True,28.0,5,11,5,11,0,0,4,4,1,5,6,4,2,0,1,1,14
401373131,Alcorn State Braves,K. Montgomery,4432410,,False,19.0,3,10,2,5,1,5,3,4,0,3,3,0,1,0,2,2,10
401373131,Alcorn State Braves,L. Marshall,4397708,,False,12.0,0,0,0,0,0,0,2,4,1,2,3,0,0,0,0,2,2
401373131,Alcorn State Braves,M. Pajeaud,4899682,,False,12.0,0,1,0,1,0,0,0,0,0,1,1,0,0,0,0,0,0
401373131,Alcorn State Braves,D. Brewton,4594037,,False,22.0,3,6,3,5,0,1,0,3,0,5,5,2,2,1,2,1,6
401373131,Alcorn State Braves,D. Thorn,4594033,,False,15.0,2,5,2,2,0,3,0,0,1,1,2,0,1,0,0,0,4
401373131,Alcorn State Braves,TEAM,TOTAL,TOTAL,False,,28,66,25,49,3,17,13,24,14,37,51,7,7,4,14,15,72
401373065,Maryland Eastern Shore Hawks,N. Pollard Jr.,4704102,,True,22.0,2,3,2,3,0,0,1,1,1,6,7,2,2,0,4,5,5
401373065,Maryland Eastern Shore Hawks,Z. Styles,4704099,,True,21.0,2,8,0,3,2,5,2,6,1,2,3,3,1,0,0,1,8
401373065,Maryland Eastern Shore Hawks,D. Nugent,4704097,,True,21.0,0,3,0,0,0,3,2,4,1,2,3,3,2,0,2,0,2
401373065,Maryland Eastern Shore Hawks,D. London,4700872,,True,31.0,4,10,1,2,3,8,3,3,2,3,5,4,0,2,2,1,14
401373065,Maryland Eastern Shore Hawks,D. Phillip,4593381,,True,34.0,7,9,7,7,0,2,2,2,0,6,6,1,2,0,5,0,16
401373065,Maryland Eastern Shore Hawks,M. Akinsanya,4704101,,False,18.0,1,1,1,1,0,0,4,4,0,2,2,0,0,0,0,4,6
401373065,Maryland Eastern Shore Hawks,C. Davis,4898269,,False,17.0,1,7,1,3,0,4,0,0,2,1,3,1,0,1,0,1,2
401373065,Maryland Eastern Shore Hawks,M. Mensah,4704096,,False,10.0,1,6,0,0,1,6,0,0,2,2,4,0,0,0,1,1,3
401373065,Maryland Eastern Shore Hawks,K. Voyles,4593380,,False,25.0,2,7,0,1,2,6,1,2,0,1,1,2,2,0,1,2,7
401373065,Maryland Eastern Shore Hawks,G. Anderson,4593382,,False,1.0,0,0,0,0,0,0,0,0,0,0,0,0,0,0,0,0,0
401373065,Maryland Eastern Shore Hawks,TEAM,TOTAL,TOTAL,False,,20,54,12,20,8,34,15,22,10,25,35,16,9,3,15,15,63
401373065,Delaware State Hornets,Z. Kent,4278115,,True,29.0,7,12,7,11,0,1,2,2,2,1,3,0,2,0,3,1,16
401373065,Delaware State Hornets,C. Sodom,4278568,,True,21.0,0,2,0,2,0,0,0,0,2,1,3,0,1,0,1,3,0
401373065,Delaware State Hornets,M. Robinson,4703996,,True,35.0,4,11,3,6,1,5,1,1,0,8,8,1,1,0,3,2,10
401373065,Delaware State Hornets,J. Stansbury,4599907,,True,32.0,4,10,2,4,2,6,3,3,0,4,4,2,3,0,4,3,13
401373065,Delaware State Hornets,M. Carter,4284101,,True,30.0,4,10,4,9,0,1,0,2,1,6,7,2,1,1,4,5,8
401373065,Delaware State Hornets,D. Baucum,4410587,,False,19.0,1,6,0,2,1,4,3,4,0,2,2,0,1,0,0,2,6
401373065,Delaware State Hornets,R. Lucas,4398122,,False,9.0,1,1,1,1,0,0,0,0,0,1,1,0,0,0,2,1,2
401373065,Delaware State Hornets,I. Palmer,4897763,,False,2.0,1,1,1,1,0,0,0,0,0,1,1,0,1,0,0,0,2
401373065,Delaware State Hornets,C. Perkins,4897761,,False,23.0,1,3,1,3,0,0,0,0,0,1,1,3,0,0,0,1,2
401373065,Delaware State Hornets,TEAM,TOTAL,TOTAL,False,,23,56,19,39,4,17,9,12,10,27,37,8,10,1,17,18,59
401372818,UAB Blazers,KJ Buffen,4396968,,True,34.0,2,4,1,3,1,1,0,0,2,4,6,1,0,0,3,3,5
401372818,UAB Blazers,T. Jemison,4395623,,True,21.0,4,6,4,6,0,0,0,1,6,6,12,1,0,2,2,3,8
401372818,UAB Blazers,T. Lovan,4397726,,True,20.0,3,6,3,6,0,0,2,6,2,1,3,1,1,0,1,1,8
401372818,UAB Blazers,J. Walker,4396656,,True,29.0,9,22,6,16,3,6,0,1,0,4,4,6,0,0,2,2,21
401372818,UAB Blazers,Q. Jackson,4067781,,True,28.0,5,11,5,9,0,2,1,2,0,6,6,1,3,0,0,2,11
401372818,UAB Blazers,R. Gordon,4432400,,False,17.0,1,2,1,2,0,0,0,2,1,6,7,1,0,1,1,4,2
401372818,UAB Blazers,T. Toney,4703133,,False,12.0,0,2,0,2,0,0,0,0,0,2,2,1,0,0,0,0,0
401372818,UAB Blazers,M. Ertel,4280260,,False,29.0,6,10,0,2,6,8,2,2,0,1,1,2,2,0,1,2,20
401372818,UAB Blazers,J. Brown,4278307,,False,7.0,2,5,0,2,2,3,0,0,1,1,2,1,0,0,0,0,6
401372818,UAB Blazers,J. Johnson,4278281,,False,3.0,0,0,0,0,0,0,0,0,0,0,0,0,0,0,0,3,0
401372818,UAB Blazers,TEAM,TOTAL,TOTAL,False,,32,68,20,48,12,20,5,14,12,32,44,15,6,3,10,20,81
401372818,Southern Miss Golden Eagles,D. Pinckney,4703112,,True,37.0,6,15,6,11,0,4,2,2,0,8,8,1,1,0,1,1,14
401372818,Southern Miss Golden Eagles,D. Harris,4593268,,True,32.0,4,5,4,5,0,0,4,7,1,6,7,1,0,1,1,3,12
401372818,Southern Miss Golden Eagles,I. Moore,4397384,,True,39.0,3,9,3,7,0,2,10,12,1,9,10,1,2,0,2,2,16
401372818,Southern Miss Golden Eagles,R. Bolden,4897558,,True,32.0,3,11,2,5,1,6,2,4,1,3,4,2,2,0,2,1,9
401372818,Southern Miss Golden Eagles,W. Napper,4897557,,True,39.0,6,11,3,7,3,4,1,1,1,1,2,4,1,0,5,4,16
401372818,Southern Miss Golden Eagles,T. Morman,4593131,,False,9.0,0,1,0,1,0,0,1,2,0,0,0,0,0,0,1,2,1
401372818,Southern Miss Golden Eagles,J. Armstrong,4593269,,False,12.0,0,0,0,0,0,0,0,0,0,0,0,0,0,0,0,0,0
401372818,Southern Miss Golden Eagles,TEAM,TOTAL,TOTAL,False,,22,52,18,36,4,16,20,28,4,29,33,9,6,1,13,13,68
401372803,UTSA Roadrunners,J. Germany,4432877,,True,27.0,6,10,6,10,0,0,1,1,1,3,4,2,1,0,3,3,13
401372803,UTSA Roadrunners,P. Ford,4278381,,True,14.0,0,0,0,0,0,0,0,0,0,1,1,0,0,1,1,4,0
401372803,UTSA Roadrunners,I. Addo-Ankrah,4703125,,True,29.0,5,9,1,2,4,7,0,0,0,3,3,0,1,0,0,1,14
401372803,UTSA Roadrunners,E. Czumbel,4593285,,True,38.0,8,16,5,8,3,8,3,5,0,2,2,5,2,1,3,3,22
401372803,UTSA Roadrunners,D. McNeill,4278139,,True,20.0,0,2,0,1,0,1,3,4,1,2,3,3,3,0,1,3,3
401372803,UTSA Roadrunners,J. Farmer,4897689,,False,3.0,0,1,0,1,0,0,0,0,0,0,0,0,0,0,1,1,0
401372803,UTSA Roadrunners,L. Bofinger,4703124,,False,24.0,2,2,2,2,0,0,2,2,2,3,5,0,0,0,0,2,6
401372803,UTSA Roadrunners,L. Sabally,4897691,,False,4.0,1,2,1,1,0,1,0,0,0,0,0,1,0,0,0,0,2
401372803,UTSA Roadrunners,C. Tucker,4897692,,False,18.0,1,2,0,1,1,1,0,0,0,2,2,2,1,0,0,0,3
401372803,UTSA Roadrunners,D. Deing,4897688,,False,23.0,7,14,2,5,5,9,0,0,1,2,3,2,0,0,2,3,19
401372803,UTSA Roadrunners,TEAM,TOTAL,TOTAL,False,,30,58,17,31,13,27,9,12,5,19,24,15,8,2,11,20,82
401372803,Rice Owls,M. Fiedler,4431964,,True,25.0,4,5,4,5,0,0,3,4,4,6,10,4,2,0,5,1,11
401372803,Rice Owls,T. Evee,4593712,,True,37.0,3,9,1,3,2,6,2,3,0,4,4,2,1,0,3,3,10
401372803,Rice Owls,C. Mullins,4397690,,True,38.0,3,7,1,4,2,3,2,5,1,6,7,4,0,0,3,3,10
401372803,Rice Owls,T. McBride,4279474,,True,39.0,4,11,4,9,0,2,4,5,0,2,2,4,0,1,4,2,12
401372803,Rice Owls,C. Pierre,4278368,,True,36.0,6,11,3,5,3,6,1,4,1,2,3,1,1,0,1,2,16
401372803,Rice Owls,M. Poteat,4590358,,False,9.0,2,4,2,4,0,0,2,2,2,1,3,0,0,1,1,2,6
401372803,Rice Owls,R. Abercrombie,4397265,,False,12.0,2,4,0,0,2,4,0,0,1,2,3,1,1,0,1,0,6
401372803,Rice Owls,C. Sheffield,4432321,,False,4.0,0,0,0,0,0,0,0,0,0,1,1,0,0,0,1,2,0
401372803,Rice Owls,TEAM,TOTAL,TOTAL,False,,24,51,15,30,9,21,14,23,10,24,34,16,5,2,20,15,71
401372802,UTEP Miners,J. Sibley,4433168,,True,18.0,2,6,1,4,1,2,0,0,0,2,2,1,1,2,0,2,5
401372802,UTEP Miners,T. Verhoeven,4278488,,True,29.0,3,3,3,3,0,0,0,0,0,3,3,1,0,1,2,5,6
401372802,UTEP Miners,J. Saterfield,4897578,,True,12.0,1,2,0,1,1,1,0,0,0,0,0,1,0,0,0,0,3
401372802,UTEP Miners,J. Bieniemy,4397027,,True,39.0,5,10,3,6,2,4,0,0,0,6,6,10,1,1,1,1,12
401372802,UTEP Miners,S. Boum,4280244,,True,33.0,5,14,5,11,0,3,2,2,3,2,5,0,1,0,2,0,12
401372802,UTEP Miners,Z. Onyema,4703082,,False,9.0,2,2,2,2,0,0,0,1,0,1,1,0,1,0,0,3,4
401372802,UTEP Miners,A. Hollins,4278515,,False,18.0,3,4,2,2,1,2,0,0,0,2,2,2,0,1,0,3,7
401372802,UTEP Miners,B. Maring,4897576,,False,3.0,0,0,0,0,0,0,0,0,0,0,0,0,0,0,0,0,0
401372802,UTEP Miners,K. Kennedy,4397137,,False,32.0,6,11,5,8,1,3,3,5,0,4,4,2,3,0,3,2,16
401372802,UTEP Miners,C. Agnew,4396762,,False,7.0,2,2,1,1,1,1,0,0,0,2,2,0,0,0,1,2,5
401372802,UTEP Miners,TEAM,TOTAL,TOTAL,False,,29,54,22,38,7,16,5,8,3,24,27,17,7,5,9,18,70
401372802,Rice Owls,M. Fiedler,4431964,,True,30.0,5,6,5,6,0,0,3,4,2,8,10,7,2,0,2,4,13
401372802,Rice Owls,T. Evee,4593712,,True,31.0,0,6,0,2,0,4,0,0,1,1,2,4,0,0,1,3,0
401372802,Rice Owls,C. Mullins,4397690,,True,26.0,4,11,3,6,1,5,1,2,0,1,1,0,0,0,2,2,10
401372802,Rice Owls,T. McBride,4279474,,True,38.0,3,6,3,6,0,0,1,2,1,2,3,3,1,0,2,1,7
401372802,Rice Owls,C. Pierre,4278368,,True,36.0,9,16,3,5,6,11,6,7,3,8,11,2,1,0,2,2,30
401372802,Rice Owls,M. Poteat,4590358,,False,10.0,0,2,0,2,0,0,1,4,0,2,2,1,0,0,2,0,1
401372802,Rice Owls,R. Abercrombie,4397265,,False,6.0,0,2,0,1,0,1,0,0,0,1,1,0,0,0,1,0,0
401372802,Rice Owls,C. Sheffield,4432321,,False,23.0,2,5,0,0,2,5,0,0,2,0,2,0,0,0,0,1,6
401372802,Rice Owls,TEAM,TOTAL,TOTAL,False,,23,54,14,28,9,26,12,19,10,24,34,17,4,0,12,13,67
401372778,UTEP Miners,A. Hollins,4278515,,True,13.0,0,0,0,0,0,0,1,2,0,4,4,1,0,0,1,4,1
401372778,UTEP Miners,T. Verhoeven,4278488,,True,36.0,3,8,3,8,0,0,3,4,2,1,3,1,2,0,3,5,9
401372778,UTEP Miners,K. Kennedy,4397137,,True,40.0,6,12,3,7,3,5,2,2,0,4,4,0,2,0,4,3,17
401372778,UTEP Miners,J. Bieniemy,4397027,,True,38.0,3,7,1,4,2,3,0,0,1,4,5,4,0,0,1,2,8
401372778,UTEP Miners,S. Boum,4280244,,True,37.0,5,10,5,8,0,2,12,13,1,4,5,1,2,0,2,0,22
401372778,UTEP Miners,Z. Onyema,4703082,,False,9.0,1,1,1,1,0,0,0,1,0,0,0,0,0,0,1,2,2
401372778,UTEP Miners,J. Sibley,4433168,,False,21.0,4,7,4,6,0,1,3,3,1,2,3,1,0,0,2,5,11
401372778,UTEP Miners,J. Saterfield,4897578,,False,1.0,0,0,0,0,0,0,0,0,0,0,0,0,0,0,0,1,0
401372778,UTEP Miners,C. Agnew,4396762,,False,5.0,0,0,0,0,0,0,0,0,0,1,1,0,0,0,1,2,0
401372778,UTEP Miners,TEAM,TOTAL,TOTAL,False,,22,45,17,34,5,11,21,25,6,21,27,8,6,0,15,24,70
401372778,North Texas Mean Green,A. Ousmane,4702773,,True,15.0,1,5,1,5,0,0,0,0,1,1,2,1,1,0,0,4,2
401372778,North Texas Mean Green,T. Bell,4592870,,True,36.0,7,8,7,8,0,0,6,16,7,4,11,1,1,0,3,5,20
401372778,North Texas Mean Green,M. McBride,4702770,,True,39.0,5,11,3,5,2,6,0,0,0,5,5,0,1,0,4,2,12
401372778,North Texas Mean Green,R. Jones,4432430,,True,32.0,4,8,4,5,0,3,2,4,1,3,4,1,1,1,3,1,10
401372778,North Texas Mean Green,JJ Murray,4397560,,True,35.0,2,2,1,1,1,1,3,4,0,1,1,3,1,0,1,2,8
401372778,North Texas Mean Green,M. Stone,4897523,,False,0.0,0,0,0,0,0,0,0,0,0,0,0,0,0,0,0,0,0
401372778,North Texas Mean Green,T. Perry,4897518,,False,31.0,4,10,2,3,2,7,5,6,0,1,1,2,0,0,1,4,15
401372778,North Texas Mean Green,A. Scott,4897517,,False,12.0,0,1,0,0,0,1,1,2,1,3,4,1,0,0,2,5,1
401372778,North Texas Mean Green,TEAM,TOTAL,TOTAL,False,,23,45,18,27,5,18,17,32,10,19,29,9,5,1,14,23,68
401372777,UTSA Roadrunners,J. Germany,4432877,,True,31.0,7,16,7,16,0,0,3,6,1,9,10,1,0,0,0,4,17
401372777,UTSA Roadrunners,L. Bofinger,4703124,,True,22.0,1,4,1,4,0,0,0,0,1,2,3,0,0,1,1,4,2
401372777,UTSA Roadrunners,I. Addo-Ankrah,4703125,,True,22.0,0,1,0,0,0,1,0,0,0,1,1,0,1,0,0,1,0
401372777,UTSA Roadrunners,E. Czumbel,4593285,,True,30.0,2,5,1,3,1,2,3,4,0,1,1,3,0,0,3,4,8
401372777,UTSA Roadrunners,D. McNeill,4278139,,True,34.0,5,12,5,9,0,3,2,4,0,2,2,2,0,0,0,1,12
401372777,UTSA Roadrunners,P. Ford,4278381,,False,15.0,1,1,1,1,0,0,1,2,0,1,1,0,1,0,3,4,3
401372777,UTSA Roadrunners,C. Tucker,4897692,,False,16.0,0,1,0,0,0,1,0,0,0,4,4,0,1,1,1,1,0
401372777,UTSA Roadrunners,D. Deing,4897688,,False,30.0,3,8,3,4,0,4,0,0,0,6,6,1,0,0,1,2,6
401372777,UTSA Roadrunners,TEAM,TOTAL,TOTAL,False,,19,48,18,37,1,11,9,16,3,26,29,7,3,2,9,21,48
401372777,North Texas Mean Green,A. Ousmane,4702773,,True,13.0,4,6,4,6,0,0,0,2,0,1,1,1,0,1,3,4,8
401372777,North Texas Mean Green,T. Bell,4592870,,True,37.0,5,10,4,6,1,4,5,11,1,6,7,1,1,1,3,1,16
401372777,North Texas Mean Green,M. McBride,4702770,,True,38.0,4,9,2,3,2,6,1,2,0,3,3,0,0,0,2,0,11
401372777,North Texas Mean Green,R. Jones,4432430,,True,37.0,2,5,0,1,2,4,3,5,0,4,4,3,0,0,2,3,9
401372777,North Texas Mean Green,JJ Murray,4397560,,True,27.0,0,3,0,1,0,2,0,0,2,4,6,2,0,0,0,2,0
401372777,North Texas Mean Green,T. Perry,4897518,,False,32.0,4,8,2,2,2,6,2,4,0,4,4,5,1,0,0,2,12
401372777,North Texas Mean Green,A. Scott,4897517,,False,16.0,1,4,1,4,0,0,1,2,2,3,5,1,0,1,0,1,3
401372777,North Texas Mean Green,TEAM,TOTAL,TOTAL,False,,20,45,13,23,7,22,12,26,6,29,35,13,2,3,11,13,59
401372766,Old Dominion Monarchs,K. Ezikpe,4397564,,True,31.0,4,5,4,5,0,0,6,7,2,4,6,3,2,1,1,4,14
401372766,Old Dominion Monarchs,A. Trice,4397007,,True,28.0,3,8,3,8,0,0,1,2,6,2,8,3,0,0,2,4,7
401372766,Old Dominion Monarchs,A.J. Oliver II,4592878,,True,22.0,1,2,1,1,0,1,0,0,1,2,3,0,1,1,5,4,2
401372766,Old Dominion Monarchs,J. Hunter,4592875,,True,38.0,3,10,2,6,1,4,6,7,2,5,7,0,3,0,2,0,13
401372766,Old Dominion Monarchs,C.J. Keyser,4066455,,True,35.0,7,22,5,13,2,9,0,1,0,3,3,1,2,0,2,3,16
401372766,Old Dominion Monarchs,M. Long,4431804,,False,34.0,2,6,2,5,0,1,6,8,3,2,5,2,2,2,1,2,10
401372766,Old Dominion Monarchs,I. Essien,4897541,,False,3.0,1,1,0,0,1,1,0,0,0,0,0,1,0,0,0,0,3
401372766,Old Dominion Monarchs,C. Smith IV,4431798,,False,9.0,1,1,0,0,1,1,0,0,0,0,0,0,0,0,1,0,3
401372766,Old Dominion Monarchs,TEAM,TOTAL,TOTAL,False,,22,55,17,38,5,17,19,25,16,20,36,10,10,4,14,17,68
401372766,Middle Tennessee Blue Raiders,T. Millin,4592866,,True,14.0,1,4,0,1,1,3,0,0,0,0,0,0,1,0,2,4,3
401372766,Middle Tennessee Blue Raiders,D. Dishman,4067165,,True,30.0,2,3,2,3,0,0,3,4,0,2,2,4,2,0,3,2,7
401372766,Middle Tennessee Blue Raiders,T. Lenard,4897509,,True,27.0,2,5,1,2,1,3,0,0,0,2,2,0,0,2,1,1,5
401372766,Middle Tennessee Blue Raiders,E. Lawrence,4432029,,True,33.0,3,10,3,6,0,4,3,3,0,4,4,1,0,0,2,4,9
401372766,Middle Tennessee Blue Raiders,D. Sims,4279080,,True,28.0,6,11,2,4,4,7,2,2,1,4,5,1,0,0,3,2,18
401372766,Middle Tennessee Blue Raiders,C. Fussell,4590357,,False,10.0,0,2,0,1,0,1,0,0,2,1,3,1,0,1,1,1,0
401372766,Middle Tennessee Blue Raiders,C. Weston,4897511,,False,27.0,5,7,3,5,2,2,3,4,0,5,5,3,1,0,4,3,15
401372766,Middle Tennessee Blue Raiders,J. Bufford,4897508,,False,17.0,1,1,1,1,0,0,1,1,0,1,1,0,1,1,0,4,3
401372766,Middle Tennessee Blue Raiders,E. King,4431742,,False,14.0,1,3,1,2,0,1,2,2,1,0,1,1,2,0,0,1,4
401372766,Middle Tennessee Blue Raiders,TEAM,TOTAL,TOTAL,False,,21,46,13,25,8,21,14,16,5,20,25,11,7,4,16,22,64
401372744,Western Kentucky Hilltoppers,J. Sharp,4897696,,True,32.0,5,7,5,7,0,0,2,6,6,6,12,0,1,7,1,1,12
401372744,Western Kentucky Hilltoppers,D. McKnight,4574710,,True,40.0,5,21,4,18,1,3,5,6,3,3,6,4,4,0,0,1,16
401372744,Western Kentucky Hilltoppers,J. Anderson,4279119,,True,31.0,4,12,4,9,0,3,3,3,0,8,8,4,4,0,0,0,11
401372744,Western Kentucky Hilltoppers,L. Frampton,4278350,,True,36.0,4,8,0,0,4,8,0,0,1,1,2,0,1,0,0,1,12
401372744,Western Kentucky Hilltoppers,C. Justice,3911625,,True,33.0,4,15,3,6,1,9,0,0,0,4,4,3,2,0,4,1,9
401372744,Western Kentucky Hilltoppers,B. Conrad,4703074,,False,0.0,0,0,0,0,0,0,0,0,0,0,0,0,0,0,0,0,0
401372744,Western Kentucky Hilltoppers,I. Cozart,4431931,,False,7.0,1,1,1,1,0,0,0,0,0,1,1,0,0,0,0,1,2
401372744,Western Kentucky Hilltoppers,J. Hamilton,4395617,,False,21.0,7,11,5,6,2,5,0,0,2,4,6,2,1,0,0,1,16
401372744,Western Kentucky Hilltoppers,N. Stansbury,4703073,,False,0.0,0,0,0,0,0,0,0,0,0,0,0,0,0,0,0,0,0
401372744,Western Kentucky Hilltoppers,TEAM,TOTAL,TOTAL,False,,30,75,22,47,8,28,10,15,15,29,44,13,13,7,5,6,78
401372744,Marshall Thundering Herd,O. Anochili-Killen,4432441,,True,19.0,3,6,2,3,1,3,0,0,2,5,7,1,2,2,0,5,7
401372744,Marshall Thundering Herd,M. Beyers,4397545,,True,3.0,0,1,0,0,0,1,0,0,0,0,0,0,0,0,0,0,0
401372744,Marshall Thundering Herd,G. Miladinovic,4592865,,True,25.0,3,8,3,8,0,0,1,2,6,5,11,1,0,0,3,2,7
401372744,Marshall Thundering Herd,A. Taylor,4592859,,True,40.0,6,18,2,7,4,11,0,0,2,5,7,4,1,0,2,2,16
401372744,Marshall Thundering Herd,T. Kinsey,4397537,,True,40.0,7,21,7,21,0,0,2,3,2,5,7,7,0,0,7,2,16
401372744,Marshall Thundering Herd,C. McKey,4897502,,False,4.0,0,0,0,0,0,0,0,0,0,0,0,0,0,0,0,0,0
401372744,Marshall Thundering Herd,D. George,4279078,,False,4.0,0,1,0,0,0,1,0,0,0,1,1,0,0,0,1,0,0
401372744,Marshall Thundering Herd,A. Toussaint,4897505,,False,11.0,1,1,1,1,0,0,0,0,1,0,1,0,0,1,0,1,2
401372744,Marshall Thundering Herd,M. Sarenac,4592862,,False,37.0,6,11,0,1,6,10,0,0,1,6,7,1,2,1,2,0,18
401372744,Marshall Thundering Herd,D. Early,4702695,,False,17.0,1,2,0,0,1,2,0,0,1,3,4,1,0,0,0,2,3
401372744,Marshall Thundering Herd,J. Dillon,4397540,,False,0.0,0,0,0,0,0,0,0,0,0,0,0,0,0,0,0,0,0
401372744,Marshall Thundering Herd,TEAM,TOTAL,TOTAL,False,,27,69,15,41,12,28,3,5,15,32,47,15,5,4,15,14,69
401372743,Western Kentucky Hilltoppers,J. Sharp,4897696,,True,30.0,6,6,6,6,0,0,0,2,2,9,11,0,2,5,2,3,12
401372743,Western Kentucky Hilltoppers,D. McKnight,4574710,,True,37.0,11,21,10,20,1,1,0,0,1,0,1,4,0,0,4,2,23
401372743,Western Kentucky Hilltoppers,J. Anderson,4279119,,True,36.0,7,14,6,10,1,4,1,1,1,4,5,2,4,0,1,1,16
401372743,Western Kentucky Hilltoppers,L. Frampton,4278350,,True,34.0,2,5,0,1,2,4,0,0,1,4,5,0,2,0,1,0,6
401372743,Western Kentucky Hilltoppers,C. Justice,3911625,,True,36.0,12,15,9,9,3,6,0,0,0,4,4,4,3,0,3,1,27
401372743,Western Kentucky Hilltoppers,B. Conrad,4703074,,False,1.0,0,0,0,0,0,0,1,2,0,0,0,0,0,0,0,0,1
401372743,Western Kentucky Hilltoppers,I. Cozart,4431931,,False,10.0,0,1,0,1,0,0,0,0,2,3,5,0,0,0,1,0,0
401372743,Western Kentucky Hilltoppers,J. Butz,4278559,,False,4.0,0,1,0,1,0,0,1,2,0,0,0,0,0,1,0,1,1
401372743,Western Kentucky Hilltoppers,S. Brashear,4897695,,False,10.0,0,2,0,1,0,1,0,0,0,0,0,0,0,0,0,1,0
401372743,Western Kentucky Hilltoppers,T. Olden,4897694,,False,1.0,0,1,0,0,0,1,0,0,0,0,0,0,0,0,0,0,0
401372743,Western Kentucky Hilltoppers,N. Stansbury,4703073,,False,1.0,0,0,0,0,0,0,0,0,0,0,0,0,0,0,1,0,0
401372743,Western Kentucky Hilltoppers,TEAM,TOTAL,TOTAL,False,,38,66,31,49,7,17,3,7,9,26,35,10,11,6,14,9,86
401372743,Marshall Thundering Herd,O. Anochili-Killen,4432441,,True,33.0,5,11,2,5,3,6,0,0,1,8,9,4,1,1,3,1,13
401372743,Marshall Thundering Herd,M. Beyers,4397545,,True,26.0,2,7,0,2,2,5,0,0,0,2,2,1,0,2,1,2,6
401372743,Marshall Thundering Herd,D. George,4279078,,True,15.0,1,3,1,3,0,0,0,0,0,1,1,0,0,0,0,1,2
401372743,Marshall Thundering Herd,A. Taylor,4592859,,True,38.0,7,13,4,6,3,7,1,2,0,5,5,5,1,0,4,1,18
401372743,Marshall Thundering Herd,T. Kinsey,4397537,,True,37.0,10,19,10,18,0,1,4,6,5,1,6,5,3,1,1,1,24
401372743,Marshall Thundering Herd,G. Miladinovic,4592865,,False,9.0,0,2,0,2,0,0,0,2,2,0,2,0,2,0,2,0,0
401372743,Marshall Thundering Herd,A. Toussaint,4897505,,False,16.0,2,3,2,3,0,0,0,0,1,1,2,0,0,0,2,1,4
401372743,Marshall Thundering Herd,M. Sarenac,4592862,,False,16.0,0,3,0,0,0,3,0,0,0,0,0,1,0,1,1,3,0
401372743,Marshall Thundering Herd,D. Early,4702695,,False,10.0,2,4,1,1,1,3,0,0,0,1,1,0,0,0,0,2,5
401372743,Marshall Thundering Herd,TEAM,TOTAL,TOTAL,False,,29,65,20,40,9,25,5,10,12,22,34,16,7,5,14,12,72
401372723,UAB Blazers,T. Jemison,4395623,,True,28.0,8,9,8,9,0,0,0,0,1,8,9,1,1,2,2,4,16
401372723,UAB Blazers,J. Walker,4396656,,True,37.0,7,16,2,7,5,9,5,5,0,5,5,7,1,0,5,2,24
401372723,UAB Blazers,M. Ertel,4280260,,True,35.0,6,11,1,1,5,10,3,3,0,2,2,2,3,0,1,1,20
401372723,UAB Blazers,J. Brown,4278307,,True,7.0,0,1,0,1,0,0,0,0,0,0,0,0,0,0,0,0,0
401372723,UAB Blazers,Q. Jackson,4067781,,True,32.0,7,11,7,10,0,1,2,4,1,5,6,4,2,1,1,2,16
401372723,UAB Blazers,R. Gordon,4432400,,False,6.0,0,0,0,0,0,0,0,0,1,0,1,1,0,1,1,4,0
401372723,UAB Blazers,KJ Buffen,4396968,,False,34.0,2,5,2,4,0,1,3,3,1,2,3,3,0,3,1,3,7
401372723,UAB Blazers,T. Toney,4703133,,False,1.0,0,0,0,0,0,0,0,0,0,0,0,0,0,1,0,0,0
401372723,UAB Blazers,T. Lovan,4397726,,False,20.0,2,4,2,4,0,0,0,0,2,3,5,1,0,0,1,1,4
401372723,UAB Blazers,TEAM,TOTAL,TOTAL,False,,32,57,22,36,10,21,13,15,8,26,34,19,7,8,13,17,87
401372723,Louisiana Tech Bulldogs,K. Lofton Jr.,4585610,,True,30.0,8,13,8,13,0,0,4,5,2,8,10,4,1,0,4,4,20
401372723,Louisiana Tech Bulldogs,K. Willis,4593756,,True,34.0,4,11,1,3,3,8,0,0,0,1,1,1,0,0,0,0,11
401372723,Louisiana Tech Bulldogs,C. Williams,4592858,,True,34.0,5,12,4,7,1,5,1,2,0,1,1,3,3,0,1,5,12
401372723,Louisiana Tech Bulldogs,E. Christon,4279006,,True,22.0,1,2,1,1,0,1,0,0,0,0,0,1,0,0,1,1,2
401372723,Louisiana Tech Bulldogs,A. Archibald,4279005,,True,32.0,5,9,5,9,0,0,4,4,1,2,3,3,0,0,1,2,14
401372723,Louisiana Tech Bulldogs,D. Green,4702763,,False,18.0,3,5,2,3,1,2,1,3,0,1,1,0,1,0,1,3,8
401372723,Louisiana Tech Bulldogs,K. Hunter,4432313,,False,10.0,1,2,1,2,0,0,0,0,1,1,2,0,0,0,1,0,2
401372723,Louisiana Tech Bulldogs,K. Stewart,4897498,,False,6.0,1,3,0,0,1,3,0,0,0,0,0,1,0,0,0,0,3
401372723,Louisiana Tech Bulldogs,L. Bradford,4433576,,False,14.0,1,4,1,3,0,1,0,0,0,3,3,1,1,0,0,1,2
401372723,Louisiana Tech Bulldogs,TEAM,TOTAL,TOTAL,False,,29,61,23,41,6,20,10,14,8,18,26,14,6,0,9,16,74
401372722,Old Dominion Monarchs,K. Ezikpe,4397564,,True,22.0,3,7,3,7,0,0,0,0,1,2,3,1,1,1,4,3,6
401372722,Old Dominion Monarchs,A. Trice,4397007,,True,35.0,8,10,8,10,0,0,2,4,2,10,12,1,0,1,2,3,18
401372722,Old Dominion Monarchs,M. Long,4431804,,True,27.0,1,5,1,5,0,0,0,2,3,3,6,0,2,0,2,3,2
401372722,Old Dominion Monarchs,J. Hunter,4592875,,True,36.0,4,8,2,4,2,4,0,0,0,2,2,2,2,1,2,1,10
401372722,Old Dominion Monarchs,C.J. Keyser,4066455,,True,33.0,5,17,4,11,1,6,0,0,1,3,4,3,1,0,1,2,11
401372722,Old Dominion Monarchs,D. Stines,4897542,,False,5.0,0,1,0,0,0,1,0,0,0,1,1,0,0,0,0,2,0
401372722,Old Dominion Monarchs,I. Essien,4897541,,False,6.0,0,1,0,1,0,0,0,0,0,0,0,1,0,0,0,0,0
401372722,Old Dominion Monarchs,A.J. Oliver II,4592878,,False,21.0,0,2,0,1,0,1,1,2,2,1,3,1,1,0,0,2,1
401372722,Old Dominion Monarchs,C. Smith IV,4431798,,False,15.0,2,8,2,3,0,5,0,0,2,2,4,2,0,0,2,0,4
401372722,Old Dominion Monarchs,PJ Gill,4405303,,False,0.0,0,0,0,0,0,0,2,2,0,0,0,0,0,0,0,0,2
401372722,Old Dominion Monarchs,TEAM,TOTAL,TOTAL,False,,23,59,20,42,3,17,5,10,12,28,40,11,7,3,13,16,54
401372722,Louisiana Tech Bulldogs,K. Lofton Jr.,4585610,,True,29.0,3,9,3,9,0,0,1,1,3,6,9,6,0,0,4,3,7
401372722,Louisiana Tech Bulldogs,K. Willis,4593756,,True,32.0,5,11,3,4,2,7,0,1,1,1,2,2,0,0,2,0,12
401372722,Louisiana Tech Bulldogs,C. Williams,4592858,,True,31.0,7,12,2,6,5,6,0,0,0,4,4,1,3,0,3,0,19
401372722,Louisiana Tech Bulldogs,E. Christon,4279006,,True,24.0,2,5,1,2,1,3,0,0,0,1,1,0,0,0,0,0,5
401372722,Louisiana Tech Bulldogs,A. Archibald,4279005,,True,33.0,4,9,2,4,2,5,8,9,1,6,7,1,1,1,0,1,18
401372722,Louisiana Tech Bulldogs,D. Green,4702763,,False,16.0,1,4,1,1,0,3,2,2,0,3,3,0,0,0,0,1,4
401372722,Louisiana Tech Bulldogs,K. Hunter,4432313,,False,5.0,0,1,0,1,0,0,0,0,0,0,0,0,0,0,0,2,0
401372722,Louisiana Tech Bulldogs,S. Thomas,4397515,,False,6.0,0,0,0,0,0,0,0,0,1,2,3,0,0,0,0,1,0
401372722,Louisiana Tech Bulldogs,B. Ponder,4897500,,False,0.0,0,0,0,0,0,0,0,0,0,0,0,0,0,0,0,0,0
401372722,Louisiana Tech Bulldogs,T. Williams,4897499,,False,0.0,0,0,0,0,0,0,0,0,0,0,0,0,0,0,0,0,0
401372722,Louisiana Tech Bulldogs,K. Stewart,4897498,,False,7.0,0,1,0,1,0,0,0,0,1,0,1,0,0,0,0,0,0
401372722,Louisiana Tech Bulldogs,L. Bradford,4433576,,False,17.0,1,6,1,4,0,2,0,0,2,1,3,1,2,0,1,1,2
401372722,Louisiana Tech Bulldogs,TEAM,TOTAL,TOTAL,False,,23,58,13,32,10,26,11,13,9,27,36,11,6,1,11,9,67
401372704,Florida International Panthers,C. Brown,4066229,,True,30.0,9,11,9,10,0,1,2,5,4,4,8,1,1,1,4,3,20
401372704,Florida International Panthers,S. Pinkney,4593362,,True,14.0,2,3,2,3,0,0,0,0,0,6,6,0,0,0,0,4,4
401372704,Florida International Panthers,D. Jones,4897493,,True,35.0,3,8,1,5,2,3,9,10,1,2,3,2,1,0,1,2,17
401372704,Florida International Panthers,E. Lovett,4592851,,True,32.0,1,8,1,4,0,4,1,2,1,4,5,0,2,0,2,4,3
401372704,Florida International Panthers,I. Banks,4278975,,True,10.0,0,2,0,1,0,1,0,0,0,0,0,0,1,0,0,2,0
401372704,Florida International Panthers,M. Sanogo,4897497,,False,10.0,0,0,0,0,0,0,1,2,1,2,3,0,0,1,2,3,1
401372704,Florida International Panthers,V. Hart,4897495,,False,3.0,0,2,0,1,0,1,0,0,0,0,0,0,0,0,1,0,0
401372704,Florida International Panthers,D. Wilcox,4432143,,False,4.0,0,0,0,0,0,0,0,0,1,0,1,1,0,1,1,2,0
401372704,Florida International Panthers,D. Parrish,4897496,,False,2.0,0,0,0,0,0,0,0,0,0,0,0,0,0,0,0,0,0
401372704,Florida International Panthers,P. Krivokapic,4702675,,False,10.0,0,0,0,0,0,0,0,0,0,0,0,0,2,0,0,0,0
401372704,Florida International Panthers,J. Hawkins,4702674,,False,30.0,8,14,3,6,5,8,0,0,0,1,1,3,1,0,4,1,21
401372704,Florida International Panthers,A. Smart,4590400,,False,20.0,2,4,2,3,0,1,6,7,0,1,1,2,0,1,2,1,10
401372704,Florida International Panthers,TEAM,TOTAL,TOTAL,False,,25,52,18,33,7,19,19,26,8,24,32,9,8,4,18,22,76
401372704,Florida Atlantic Owls,B. Baruti,4066634,,True,14.0,1,5,1,2,0,3,1,4,1,1,2,0,3,0,0,0,3
401372704,Florida Atlantic Owls,A. Martin,4702656,,True,33.0,11,17,6,8,5,9,7,8,0,6,6,0,2,0,1,4,34
401372704,Florida Atlantic Owls,B. Greenlee,4592701,,True,30.0,4,6,2,3,2,3,7,8,1,3,4,2,3,0,5,2,17
401372704,Florida Atlantic Owls,M. Forrest,4397485,,True,34.0,2,8,1,3,1,5,2,2,1,2,3,5,0,0,2,3,7
401372704,Florida Atlantic Owls,E. Winchester,4067456,,True,14.0,0,4,0,2,0,2,0,0,0,0,0,0,0,0,0,3,0
401372704,Florida Atlantic Owls,G. Rosado,4585611,,False,23.0,5,7,5,7,0,0,2,4,1,3,4,2,1,0,4,0,12
401372704,Florida Atlantic Owls,M. Niang,4397482,,False,4.0,0,0,0,0,0,0,0,0,0,1,1,0,0,0,0,0,0
401372704,Florida Atlantic Owls,V. Goldin,4700818,,False,15.0,2,2,2,2,0,0,0,1,3,2,5,0,0,1,1,4,4
401372704,Florida Atlantic Owls,B. Weatherspoon,4897476,,False,17.0,1,3,0,1,1,2,0,0,0,0,0,1,0,1,1,2,3
401372704,Florida Atlantic Owls,J. Davis,4702655,,False,16.0,1,5,1,4,0,1,2,2,2,3,5,4,0,0,0,3,4
401372704,Florida Atlantic Owls,TEAM,TOTAL,TOTAL,False,,27,57,18,32,9,25,21,29,11,23,34,14,9,2,14,21,84
401372673,Southern Miss Golden Eagles,D. Pinckney,4703112,,True,35.0,5,8,4,7,1,1,6,10,3,2,5,3,0,1,1,2,17
401372673,Southern Miss Golden Eagles,D. Harris,4593268,,True,30.0,3,4,3,4,0,0,2,2,2,1,3,0,2,0,1,3,8
401372673,Southern Miss Golden Eagles,I. Moore,4397384,,True,36.0,7,16,5,11,2,5,4,7,2,11,13,1,1,1,3,3,20
401372673,Southern Miss Golden Eagles,R. Bolden,4897558,,True,28.0,2,4,2,4,0,0,0,0,0,3,3,3,0,0,2,0,4
401372673,Southern Miss Golden Eagles,W. Napper,4897557,,True,40.0,6,17,4,11,2,6,1,1,0,4,4,4,1,0,2,3,15
401372673,Southern Miss Golden Eagles,T. Morman,4593131,,False,2.0,0,0,0,0,0,0,0,0,0,0,0,0,0,0,0,0,0
401372673,Southern Miss Golden Eagles,M. Jaakson,4703114,,False,4.0,0,2,0,1,0,1,0,0,0,1,1,0,0,0,0,0,0
401372673,Southern Miss Golden Eagles,J. Armstrong,4593269,,False,25.0,1,2,0,0,1,2,0,0,0,1,1,2,0,1,0,2,3
401372673,Southern Miss Golden Eagles,TEAM,TOTAL,TOTAL,False,,24,53,18,38,6,15,13,20,8,24,32,13,4,3,9,13,67
401372673,Charlotte 49ers,A. Khalifa,4702739,,True,26.0,3,7,3,6,0,1,2,2,1,4,5,3,0,0,2,4,8
401372673,Charlotte 49ers,J. Threadgill,4702738,,True,27.0,4,8,2,2,2,6,0,0,0,1,1,2,0,0,2,0,10
401372673,Charlotte 49ers,J. Young,4433133,,True,38.0,8,14,6,9,2,5,3,3,0,7,7,6,1,0,0,2,21
401372673,Charlotte 49ers,A. Butler,4280070,,True,34.0,6,10,3,5,3,5,1,3,0,4,4,2,1,0,2,3,16
401372673,Charlotte 49ers,C. Trapp Jr.,4277833,,True,29.0,2,6,2,4,0,2,0,0,2,6,8,1,1,0,3,3,4
401372673,Charlotte 49ers,J. Garcia,4702740,,False,1.0,0,0,0,0,0,0,0,0,0,0,0,0,0,0,0,0,0
401372673,Charlotte 49ers,R. Braswell,4395675,,False,12.0,2,4,1,1,1,3,0,0,0,0,0,0,0,1,1,3,5
401372673,Charlotte 49ers,P. Francois,4067864,,False,1.0,0,0,0,0,0,0,0,0,0,0,0,0,0,0,0,0,0
401372673,Charlotte 49ers,L. Vasic,4278934,,False,12.0,2,4,2,3,0,1,0,0,1,0,1,1,0,0,0,2,4
401372673,Charlotte 49ers,M. Cannon,4397168,,False,20.0,1,4,1,2,0,2,0,0,0,2,2,0,0,0,0,0,2
401372673,Charlotte 49ers,TEAM,TOTAL,TOTAL,False,,28,57,20,32,8,25,6,8,6,25,31,15,3,1,10,17,70
401372672,Middle Tennessee Blue Raiders,T. Millin,4592866,,True,23.0,2,4,0,1,2,3,0,0,0,1,1,0,0,1,1,5,6
401372672,Middle Tennessee Blue Raiders,D. Dishman,4067165,,True,30.0,2,4,2,4,0,0,2,2,0,8,8,3,3,1,3,2,6
401372672,Middle Tennessee Blue Raiders,J. Bufford,4897508,,True,22.0,0,0,0,0,0,0,0,0,1,2,3,1,0,0,1,1,0
401372672,Middle Tennessee Blue Raiders,E. Lawrence,4432029,,True,32.0,4,16,1,7,3,9,2,2,2,4,6,2,1,0,1,4,13
401372672,Middle Tennessee Blue Raiders,D. Sims,4279080,,True,32.0,3,9,0,2,3,7,1,2,1,4,5,1,1,0,3,1,10
401372672,Middle Tennessee Blue Raiders,C. Fussell,4590357,,False,10.0,0,1,0,0,0,1,0,0,0,1,1,0,0,0,0,0,0
401372672,Middle Tennessee Blue Raiders,C. Weston,4897511,,False,23.0,6,10,5,7,1,3,3,4,0,4,4,2,1,0,3,3,16
401372672,Middle Tennessee Blue Raiders,T. Lenard,4897509,,False,24.0,2,6,1,3,1,3,0,0,2,1,3,0,1,1,2,2,5
401372672,Middle Tennessee Blue Raiders,E. King,4431742,,False,4.0,0,1,0,0,0,1,0,0,0,0,0,0,0,0,0,0,0
401372672,Middle Tennessee Blue Raiders,TEAM,TOTAL,TOTAL,False,,19,51,9,24,10,27,8,10,8,26,34,9,7,3,15,18,56
401372672,Charlotte 49ers,A. Khalifa,4702739,,True,29.0,3,5,2,4,1,1,2,2,0,0,0,1,0,2,1,3,9
401372672,Charlotte 49ers,J. Threadgill,4702738,,True,16.0,0,2,0,0,0,2,0,0,0,1,1,1,0,0,0,1,0
401372672,Charlotte 49ers,J. Young,4433133,,True,39.0,4,15,4,10,0,5,8,8,5,6,11,3,2,0,2,1,16
401372672,Charlotte 49ers,A. Butler,4280070,,True,37.0,2,9,2,7,0,2,8,10,3,3,6,2,3,0,0,1,12
401372672,Charlotte 49ers,C. Trapp Jr.,4277833,,True,36.0,5,13,4,9,1,4,0,1,2,7,9,2,1,0,3,1,11
401372672,Charlotte 49ers,R. Braswell,4395675,,False,12.0,2,6,2,2,0,4,1,1,0,0,0,0,0,2,0,1,5
401372672,Charlotte 49ers,L. Vasic,4278934,,False,11.0,1,1,1,1,0,0,0,0,1,1,2,0,0,0,1,1,2
401372672,Charlotte 49ers,M. Cannon,4397168,,False,20.0,2,3,1,1,1,2,0,0,0,2,2,0,1,0,1,1,5
401372672,Charlotte 49ers,TEAM,TOTAL,TOTAL,False,,19,54,16,34,3,20,19,22,11,23,34,9,7,4,9,10,60
401372623,Weber State Wildcats,D. Jones,4702159,,True,26.0,1,2,1,2,0,0,3,4,0,6,6,2,0,0,4,5,5
401372623,Weber State Wildcats,J. Overton,4593976,,True,32.0,8,15,8,14,0,1,7,7,1,2,3,0,1,0,1,2,23
401372623,Weber State Wildcats,D. Bassett,4066258,,True,16.0,3,6,1,1,2,5,2,2,0,1,1,1,0,1,0,1,10
401372623,Weber State Wildcats,S. Sisoho Jawara,4593773,,True,34.0,5,11,4,6,1,5,0,0,1,2,3,4,2,0,3,2,11
401372623,Weber State Wildcats,K. McEwen,4066755,,True,38.0,6,16,2,6,4,10,1,1,0,7,7,1,2,2,4,4,17
401372623,Weber State Wildcats,D. Koehler,4702350,,False,14.0,0,0,0,0,0,0,0,0,0,1,1,0,0,0,0,0,0
401372623,Weber State Wildcats,M. Kozak,4278674,,False,7.0,0,2,0,1,0,1,0,0,0,1,1,0,0,0,0,1,0
401372623,Weber State Wildcats,A. Tew,4897981,,False,14.0,1,1,1,1,0,0,0,0,1,2,3,0,0,2,1,1,2
401372623,Weber State Wildcats,KJ Cunningham,4592648,,False,1.0,0,0,0,0,0,0,0,0,0,0,0,0,0,0,0,0,0
401372623,Weber State Wildcats,Z. Porter,4405290,,False,18.0,1,2,1,2,0,0,0,0,0,2,2,0,2,0,1,2,2
401372623,Weber State Wildcats,TEAM,TOTAL,TOTAL,False,,25,55,18,33,7,22,13,14,3,24,27,8,7,5,14,18,70
401372623,Southern Utah Thunderbirds,M. Fausett,4397379,,True,27.0,4,11,4,8,0,3,1,2,2,5,7,1,2,0,4,3,9
401372623,Southern Utah Thunderbirds,J. Spurgin,4702155,,True,27.0,4,4,4,4,0,0,3,3,1,6,7,2,0,1,1,3,11
401372623,Southern Utah Thunderbirds,N. Fleming,4702153,,True,40.0,2,6,1,4,1,2,2,3,0,2,2,4,2,0,1,2,7
401372623,Southern Utah Thunderbirds,J. Knight III,4397421,,True,26.0,6,10,6,10,0,0,5,8,1,1,2,4,2,0,2,5,17
401372623,Southern Utah Thunderbirds,A. Moody,4278631,,True,40.0,4,10,0,0,4,10,4,4,0,2,2,1,1,0,1,2,16
401372623,Southern Utah Thunderbirds,D. Barnes,4397973,,False,14.0,1,5,0,2,1,3,0,0,0,2,2,0,0,0,0,0,3
401372623,Southern Utah Thunderbirds,H. Butler,4397380,,False,26.0,7,11,4,7,3,4,0,2,3,7,10,0,1,0,3,2,17
401372623,Southern Utah Thunderbirds,TEAM,TOTAL,TOTAL,False,,28,57,19,35,9,22,15,22,9,27,36,12,8,1,12,17,80
401372543,Northern Colorado Bears,K. Jongkuch,4897945,,True,26.0,2,3,2,3,0,0,1,4,1,5,6,0,0,0,3,4,5
401372543,Northern Colorado Bears,B. Hume,4397311,,True,28.0,5,9,1,3,4,6,0,0,2,3,5,2,0,1,1,4,14
401372543,Northern Colorado Bears,M. Johnson II,4897941,,True,34.0,5,11,3,7,2,4,5,6,0,5,5,0,0,0,2,3,17
401372543,Northern Colorado Bears,D. Kuxhausen,4593774,,True,21.0,0,4,0,0,0,4,0,0,0,1,1,1,1,0,2,3,0
401372543,Northern Colorado Bears,D. Kountz,4397060,,True,39.0,12,19,11,16,1,3,1,1,0,5,5,5,2,0,6,3,26
401372543,Northern Colorado Bears,B. Kennedy,4702085,,False,5.0,1,1,1,1,0,0,2,2,1,0,1,0,0,0,0,1,4
401372543,Northern Colorado Bears,J. Melvin,4702083,,False,10.0,1,1,1,1,0,0,0,0,1,1,2,0,0,0,1,2,2
401372543,Northern Colorado Bears,Z. Bloch,4897944,,False,11.0,2,4,1,2,1,2,2,2,0,2,2,0,1,0,0,2,7
401372543,Northern Colorado Bears,D. Knecht,4897943,,False,26.0,3,5,2,3,1,2,3,4,1,4,5,3,1,0,3,1,10
401372543,Northern Colorado Bears,TEAM,TOTAL,TOTAL,False,,31,57,22,36,9,21,14,19,7,28,35,11,5,1,18,23,85
401372543,Montana State Bobcats,G. Osobor,4897921,,True,27.0,7,9,7,9,0,0,5,7,3,2,5,0,2,2,0,5,19
401372543,Montana State Bobcats,A. Mohamed,4397559,,True,14.0,1,3,1,1,0,2,2,2,1,6,7,1,0,0,0,2,4
401372543,Montana State Bobcats,T. Patterson,4702074,,True,28.0,2,5,1,2,1,3,0,0,0,2,2,0,2,0,1,0,5
401372543,Montana State Bobcats,A. Adamu,4592615,,True,29.0,7,13,6,11,1,2,2,2,1,5,6,4,0,0,3,0,17
401372543,Montana State Bobcats,X. Bishop,4067581,,True,15.0,1,3,1,2,0,1,0,0,0,1,1,3,0,0,3,1,2
401372543,Montana State Bobcats,S. Lecholat,4897926,,False,10.0,0,1,0,0,0,1,2,2,1,0,1,0,0,0,2,3,2
401372543,Montana State Bobcats,B. Fernandez,4592619,,False,3.0,0,0,0,0,0,0,0,0,0,0,0,0,0,0,0,0,0
401372543,Montana State Bobcats,I. Spears,4897925,,False,3.0,0,0,0,0,0,0,0,0,0,0,0,0,0,0,1,0,0
401372543,Montana State Bobcats,P. McMahon,4897923,,False,9.0,1,2,1,2,0,0,0,0,0,0,0,0,0,1,0,3,2
401372543,Montana State Bobcats,K. Tynes,4702078,,False,19.0,2,5,2,4,0,1,1,1,0,1,1,1,1,0,0,1,5
401372543,Montana State Bobcats,N. Gazelas,4702072,,False,22.0,7,12,5,6,2,6,3,3,0,0,0,2,1,0,0,3,19
401372543,Montana State Bobcats,R. Battle,4431726,,False,21.0,4,11,2,5,2,6,2,3,0,4,4,0,0,0,1,1,12
401372543,Montana State Bobcats,TEAM,TOTAL,TOTAL,False,,32,64,26,42,6,22,17,20,6,21,27,11,6,3,11,20,87
401372542,Sacramento State Hornets,J. Komagum,4703542,,True,34.0,1,6,1,6,0,0,0,1,3,5,8,1,3,4,2,4,2
401372542,Sacramento State Hornets,C. Wilbon,4397994,,True,36.0,4,9,4,7,0,2,1,2,0,5,5,1,1,0,1,2,9
401372542,Sacramento State Hornets,W. FitzPatrick,4592634,,True,36.0,5,11,0,1,5,10,0,0,0,3,3,1,1,0,1,3,15
401372542,Sacramento State Hornets,Z. Chappell,4397395,,True,38.0,8,16,5,9,3,7,3,3,0,5,5,3,1,0,2,4,22
401372542,Sacramento State Hornets,B. Fowler,4278663,,True,30.0,7,15,7,15,0,0,1,1,0,3,3,3,0,0,3,4,15
401372542,Sacramento State Hornets,H. Clarkin,4703347,,False,18.0,3,4,3,4,0,0,0,0,0,0,0,0,0,1,0,1,6
401372542,Sacramento State Hornets,R. Barros III,4592632,,False,6.0,0,1,0,0,0,1,0,0,0,1,1,0,0,0,0,0,0
401372542,Sacramento State Hornets,E. McCullough,4397327,,False,2.0,0,0,0,0,0,0,0,0,0,0,0,0,0,0,0,0,0
401372542,Sacramento State Hornets,TEAM,TOTAL,TOTAL,False,,28,62,20,42,8,20,5,7,5,24,29,9,6,5,9,18,69
401372542,Montana State Bobcats,J. Belo,4592617,,True,27.0,2,6,2,6,0,0,7,8,0,5,5,0,1,3,1,2,11
401372542,Montana State Bobcats,A. Mohamed,4397559,,True,27.0,1,4,1,1,0,3,0,0,2,7,9,2,0,0,0,2,2
401372542,Montana State Bobcats,T. Patterson,4702074,,True,10.0,0,4,0,0,0,4,0,0,0,0,0,1,0,0,0,0,0
401372542,Montana State Bobcats,A. Adamu,4592615,,True,31.0,5,8,4,7,1,1,0,0,0,9,9,3,1,0,0,3,11
401372542,Montana State Bobcats,X. Bishop,4067581,,True,39.0,7,14,6,8,1,6,3,4,0,1,1,7,0,0,2,1,18
401372542,Montana State Bobcats,G. Osobor,4897921,,False,25.0,4,8,4,8,0,0,1,3,6,6,12,3,1,0,3,1,9
401372542,Montana State Bobcats,K. Tynes,4702078,,False,1.0,0,0,0,0,0,0,0,0,0,0,0,0,0,0,0,0,0
401372542,Montana State Bobcats,N. Gazelas,4702072,,False,17.0,2,4,2,2,0,2,3,3,0,0,0,0,1,0,1,1,7
401372542,Montana State Bobcats,R. Battle,4431726,,False,23.0,5,10,2,4,3,6,4,4,0,1,1,0,1,0,2,2,17
401372542,Montana State Bobcats,TEAM,TOTAL,TOTAL,False,,26,58,21,36,5,22,18,22,10,31,41,16,5,3,10,12,75
401372522,Sacramento State Hornets,J. Komagum,4703542,,True,29.0,1,2,1,2,0,0,1,2,4,5,9,2,0,1,2,3,3
401372522,Sacramento State Hornets,C. Wilbon,4397994,,True,34.0,4,8,4,8,0,0,2,8,3,8,11,0,1,0,3,2,10
401372522,Sacramento State Hornets,W. FitzPatrick,4592634,,True,33.0,5,11,0,2,5,9,2,3,0,2,2,1,0,0,0,2,17
401372522,Sacramento State Hornets,Z. Chappell,4397395,,True,27.0,1,6,0,3,1,3,0,0,0,3,3,1,1,0,0,2,3
401372522,Sacramento State Hornets,B. Fowler,4278663,,True,39.0,14,25,13,23,1,2,10,10,0,2,2,5,1,0,1,2,39
401372522,Sacramento State Hornets,H. Clarkin,4703347,,False,11.0,0,1,0,1,0,0,0,0,0,0,0,0,0,0,1,2,0
401372522,Sacramento State Hornets,R. Barros III,4592632,,False,20.0,0,0,0,0,0,0,0,0,0,1,1,0,0,0,1,2,0
401372522,Sacramento State Hornets,E. McCullough,4397327,,False,7.0,0,0,0,0,0,0,0,0,0,0,0,0,0,0,0,0,0
401372522,Sacramento State Hornets,TEAM,TOTAL,TOTAL,False,,25,53,18,39,7,14,15,23,9,22,31,9,3,1,8,15,72
401372522,Montana Grizzlies,J. Bannan,4702058,,True,39.0,6,14,5,11,1,3,7,7,3,12,15,3,2,0,3,3,20
401372522,Montana Grizzlies,S. Blakney,4278609,,True,12.0,1,1,1,1,0,0,0,0,0,2,2,0,1,0,0,1,2
401372522,Montana Grizzlies,L. Martin Jr.,4897914,,True,25.0,3,9,1,1,2,8,2,3,0,1,1,1,1,1,0,1,10
401372522,Montana Grizzlies,B. Whitney,4585617,,True,37.0,5,8,5,8,0,0,1,2,0,1,1,1,0,0,0,3,11
401372522,Montana Grizzlies,R. Beasley,4432435,,True,18.0,1,8,1,3,0,5,0,0,0,2,2,2,2,0,0,0,2
401372522,Montana Grizzlies,D. Carter-Hollinger,4592605,,False,22.0,2,3,2,2,0,1,3,4,2,1,3,3,0,1,2,3,7
401372522,Montana Grizzlies,K. Owens,4592602,,False,9.0,1,1,1,1,0,0,0,0,0,0,0,0,0,0,0,1,2
401372522,Montana Grizzlies,J. Vazquez,4592603,,False,13.0,1,2,0,0,1,2,0,0,0,1,1,0,1,0,0,1,3
401372522,Montana Grizzlies,C. Parker,4397999,,False,25.0,5,6,4,4,1,2,3,4,0,3,3,2,0,0,3,1,14
401372522,Montana Grizzlies,TEAM,TOTAL,TOTAL,False,,25,52,20,31,5,21,16,20,6,23,29,12,7,2,8,14,71
401372521,Northern Colorado Bears,K. Jongkuch,4897945,,True,32.0,6,9,6,9,0,0,0,1,4,10,14,1,0,0,3,4,12
401372521,Northern Colorado Bears,B. Hume,4397311,,True,29.0,1,4,1,2,0,2,0,0,0,5,5,4,3,2,2,3,2
401372521,Northern Colorado Bears,M. Johnson II,4897941,,True,37.0,7,13,4,7,3,6,3,4,0,2,2,4,0,0,2,3,20
401372521,Northern Colorado Bears,D. Kuxhausen,4593774,,True,20.0,1,3,0,0,1,3,0,0,0,2,2,0,0,0,0,2,3
401372521,Northern Colorado Bears,D. Kountz,4397060,,True,31.0,8,13,7,10,1,3,12,13,1,3,4,1,1,0,4,3,29
401372521,Northern Colorado Bears,B. Kennedy,4702085,,False,10.0,1,1,1,1,0,0,0,0,1,0,1,0,0,0,0,0,2
401372521,Northern Colorado Bears,J. Melvin,4702083,,False,8.0,0,1,0,1,0,0,0,0,0,1,1,1,0,0,1,2,0
401372521,Northern Colorado Bears,Z. Bloch,4897944,,False,7.0,0,0,0,0,0,0,0,0,0,1,1,0,0,0,0,1,0
401372521,Northern Colorado Bears,D. Knecht,4897943,,False,26.0,3,9,2,6,1,3,0,0,0,4,4,0,0,0,0,1,7
401372521,Northern Colorado Bears,TEAM,TOTAL,TOTAL,False,,27,53,21,36,6,17,15,18,9,28,37,11,4,2,12,19,75
401372521,Montana Grizzlies,J. Bannan,4702058,,True,32.0,3,7,3,7,0,0,6,9,1,8,9,2,1,0,4,2,12
401372521,Montana Grizzlies,S. Blakney,4278609,,True,7.0,1,1,1,1,0,0,0,0,1,1,2,0,0,0,0,1,2
401372521,Montana Grizzlies,L. Martin Jr.,4897914,,True,29.0,1,8,1,6,0,2,0,0,1,1,2,0,0,0,0,4,2
401372521,Montana Grizzlies,B. Whitney,4585617,,True,30.0,2,7,2,6,0,1,3,4,0,3,3,0,1,0,2,3,7
401372521,Montana Grizzlies,R. Beasley,4432435,,True,32.0,5,11,4,8,1,3,4,6,1,1,2,0,0,0,0,2,15
401372521,Montana Grizzlies,D. Carter-Hollinger,4592605,,False,23.0,6,7,4,5,2,2,0,0,1,0,1,0,0,0,0,4,14
401372521,Montana Grizzlies,K. Owens,4592602,,False,13.0,1,1,1,1,0,0,0,0,0,1,1,0,0,0,0,0,2
401372521,Montana Grizzlies,J. Vazquez,4592603,,False,6.0,1,1,0,0,1,1,1,2,0,0,0,1,0,0,1,1,4
401372521,Montana Grizzlies,C. Parker,4397999,,False,28.0,3,9,3,7,0,2,2,3,0,2,2,3,1,0,0,0,8
401372521,Montana Grizzlies,TEAM,TOTAL,TOTAL,False,,23,52,19,41,4,11,16,24,5,18,23,6,3,0,7,17,66
401372503,Southern Utah Thunderbirds,M. Fausett,4397379,,True,33.0,1,4,1,3,0,1,0,0,2,3,5,3,1,0,1,2,2
401372503,Southern Utah Thunderbirds,J. Spurgin,4702155,,True,31.0,7,9,7,7,0,2,4,4,1,4,5,2,2,0,1,2,18
401372503,Southern Utah Thunderbirds,J. Knight III,4397421,,True,37.0,7,13,6,11,1,2,5,9,2,3,5,4,4,0,2,3,20
401372503,Southern Utah Thunderbirds,D. Marin,4278670,,True,8.0,1,1,0,0,1,1,0,0,0,1,1,0,0,0,0,1,3
401372503,Southern Utah Thunderbirds,A. Moody,4278631,,True,38.0,5,7,2,2,3,5,2,2,0,4,4,2,1,0,0,2,15
401372503,Southern Utah Thunderbirds,N. Fleming,4702153,,False,30.0,2,6,0,1,2,5,3,5,0,2,2,2,0,1,4,4,9
401372503,Southern Utah Thunderbirds,D. Barnes,4397973,,False,7.0,1,4,1,1,0,3,0,0,0,0,0,1,0,0,0,0,2
401372503,Southern Utah Thunderbirds,H. Butler,4397380,,False,16.0,3,10,2,7,1,3,3,3,1,2,3,0,0,0,1,2,10
401372503,Southern Utah Thunderbirds,TEAM,TOTAL,TOTAL,False,,27,54,19,32,8,22,17,23,10,20,30,14,8,1,9,16,79
401372503,Idaho State Bengals,M. Porter,4592594,,True,19.0,3,6,3,6,0,0,2,2,0,2,2,1,1,0,1,1,8
401372503,Idaho State Bengals,J. Rodriguez,4278606,,True,30.0,5,9,2,3,3,6,1,1,0,7,7,0,0,0,2,4,14
401372503,Idaho State Bengals,L. Sorensen,4701579,,True,10.0,1,1,1,1,0,0,0,0,0,0,0,0,0,0,1,0,2
401372503,Idaho State Bengals,T. Cool,4592593,,True,39.0,7,14,7,11,0,3,2,2,0,2,2,4,2,0,5,2,16
401372503,Idaho State Bengals,A. Smellie,4397289,,True,29.0,1,1,1,1,0,0,0,0,2,1,3,1,1,0,2,5,2
401372503,Idaho State Bengals,D. Carr,4397362,,False,8.0,0,0,0,0,0,0,0,0,0,0,0,0,0,0,0,1,0
401372503,Idaho State Bengals,B. Parker,4592600,,False,23.0,4,10,4,8,0,2,1,3,0,3,3,4,0,0,2,3,9
401372503,Idaho State Bengals,A. Burgin,4897897,,False,31.0,7,10,2,3,5,7,1,1,2,3,5,2,0,0,1,0,20
401372503,Idaho State Bengals,E. Taylor III,4701580,,False,11.0,0,2,0,0,0,2,0,0,0,2,2,0,0,0,0,1,0
401372503,Idaho State Bengals,TEAM,TOTAL,TOTAL,False,,28,53,20,33,8,20,7,9,7,21,28,12,4,0,14,17,71
401372458,Northern Arizona Lumberjacks,C. Towt,4702120,,True,37.0,2,7,2,7,0,0,1,2,2,4,6,0,1,0,1,5,5
401372458,Northern Arizona Lumberjacks,K. Haymon,4397304,,True,36.0,5,15,3,6,2,9,2,4,0,3,3,4,0,0,0,2,14
401372458,Northern Arizona Lumberjacks,N. Mains,4278643,,True,32.0,2,11,1,3,1,8,0,0,0,3,3,1,2,2,1,2,5
401372458,Northern Arizona Lumberjacks,E. Richards,4397752,,True,17.0,1,2,1,2,0,0,1,2,1,1,2,0,0,1,1,2,3
401372458,Northern Arizona Lumberjacks,J. Cone,4431698,,True,38.0,12,23,9,13,3,10,8,9,0,9,9,2,0,0,4,1,35
401372458,Northern Arizona Lumberjacks,W. Brown,4702119,,False,5.0,0,1,0,0,0,1,0,0,0,0,0,0,0,0,0,2,0
401372458,Northern Arizona Lumberjacks,A. Aguek,4592622,,False,6.0,0,1,0,0,0,1,0,0,0,2,2,0,0,0,0,3,0
401372458,Northern Arizona Lumberjacks,I. Lewis,4592625,,False,19.0,2,3,1,1,1,2,0,0,3,3,6,1,0,0,1,3,5
401372458,Northern Arizona Lumberjacks,M. Stark,4897937,,False,8.0,0,1,0,0,0,1,0,0,0,0,0,0,0,0,0,3,0
401372458,Northern Arizona Lumberjacks,J. Green,4278952,,False,3.0,1,1,1,1,0,0,0,0,0,0,0,0,0,0,1,1,2
401372458,Northern Arizona Lumberjacks,TEAM,TOTAL,TOTAL,False,,25,65,18,33,7,32,12,17,12,25,37,8,3,3,9,24,69
401372458,Idaho Vandals,T. Christensen,4701576,,True,18.0,2,4,2,4,0,0,0,0,0,7,7,0,0,0,1,5,4
401372458,Idaho Vandals,R. Smith,4702028,,True,32.0,4,14,2,5,2,9,0,0,1,3,4,0,0,0,1,1,10
401372458,Idaho Vandals,J. King,4407459,,True,28.0,2,4,1,3,1,1,0,0,0,1,1,2,1,0,0,3,5
401372458,Idaho Vandals,T. Anderson,4397741,,True,32.0,3,9,3,6,0,3,10,12,1,4,5,7,0,0,3,3,16
401372458,Idaho Vandals,M. Dixon,4070682,,True,31.0,9,14,6,8,3,6,6,6,1,5,6,1,1,0,1,1,27
401372458,Idaho Vandals,P. Pepple Jr.,4703383,,False,20.0,2,2,2,2,0,0,1,4,2,1,3,0,0,1,0,1,5
401372458,Idaho Vandals,Y. Salih,4897877,,False,28.0,1,3,0,0,1,3,4,4,0,1,1,0,0,0,0,2,7
401372458,Idaho Vandals,E. Kilgore,4701575,,False,12.0,2,4,2,2,0,2,0,0,0,3,3,0,0,0,0,0,4
401372458,Idaho Vandals,TEAM,TOTAL,TOTAL,False,,25,54,18,30,7,24,21,26,6,30,36,10,2,1,7,16,78
401372457,Portland State Vikings,K. Thomas,4592361,,True,27.0,6,13,5,11,1,2,1,1,1,10,11,3,2,2,2,3,14
401372457,Portland State Vikings,M. Carter III,4897947,,True,25.0,3,6,2,3,1,3,4,6,0,0,0,2,1,1,4,5,11
401372457,Portland State Vikings,E. Alley,4712247,,True,25.0,7,15,6,11,1,4,0,0,1,3,4,2,2,1,0,4,15
401372457,Portland State Vikings,D. Squire,4397579,,True,20.0,4,7,3,4,1,3,0,0,0,1,1,0,3,1,2,2,9
401372457,Portland State Vikings,I. Burke,4395998,,True,34.0,2,4,2,3,0,1,0,0,1,2,3,4,1,0,3,3,4
401372457,Portland State Vikings,J. Eyman,4396000,,False,24.0,1,4,1,4,0,0,1,2,1,1,2,0,0,2,0,1,3
401372457,Portland State Vikings,H. Curtiss,4701202,,False,2.0,0,0,0,0,0,0,0,0,0,0,0,0,0,0,0,0,0
401372457,Portland State Vikings,M. Starks,4702888,,False,15.0,0,4,0,3,0,1,0,0,0,2,2,0,1,0,0,5,0
401372457,Portland State Vikings,P. Dawson,4702138,,False,6.0,1,1,1,1,0,0,2,3,0,1,1,0,0,0,0,1,4
401372457,Portland State Vikings,M. Ruffin,4593785,,False,22.0,7,10,7,9,0,1,5,9,0,0,0,0,1,0,0,1,19
401372457,Portland State Vikings,TEAM,TOTAL,TOTAL,False,,31,64,27,49,4,15,13,21,7,23,30,11,11,7,11,25,79
401372457,Idaho Vandals,T. Christensen,4701576,,True,15.0,1,3,1,3,0,0,0,0,1,6,7,2,0,0,4,4,2
401372457,Idaho Vandals,Y. Salih,4897877,,True,34.0,2,4,0,0,2,4,0,0,0,2,2,1,0,0,1,3,6
401372457,Idaho Vandals,R. Smith,4702028,,True,26.0,2,5,0,1,2,4,0,2,0,2,2,0,0,2,3,4,6
401372457,Idaho Vandals,T. Anderson,4397741,,True,36.0,6,16,5,11,1,5,11,15,1,9,10,3,0,0,8,3,24
401372457,Idaho Vandals,M. Dixon,4070682,,True,32.0,3,15,3,14,0,1,4,4,1,2,3,3,1,0,2,0,10
401372457,Idaho Vandals,P. Pepple Jr.,4703383,,False,24.0,8,10,8,10,0,0,1,1,5,2,7,0,0,2,1,2,17
401372457,Idaho Vandals,E. Kilgore,4701575,,False,12.0,0,0,0,0,0,0,0,0,1,2,3,0,0,0,1,3,0
401372457,Idaho Vandals,J. King,4407459,,False,21.0,1,5,1,4,0,1,1,1,1,2,3,2,1,0,2,3,3
401372457,Idaho Vandals,TEAM,TOTAL,TOTAL,False,,23,58,18,43,5,15,17,23,14,30,44,11,2,4,22,22,68
401372434,Portland State Vikings,K. Thomas,4592361,,True,33.0,7,17,4,11,3,6,7,7,3,8,11,0,1,0,0,4,24
401372434,Portland State Vikings,M. Carter III,4897947,,True,9.0,1,3,1,2,0,1,0,0,0,1,1,0,2,0,1,0,2
401372434,Portland State Vikings,E. Alley,4712247,,True,24.0,5,14,5,8,0,6,1,1,0,2,2,2,0,0,3,3,11
401372434,Portland State Vikings,M. Starks,4702888,,True,32.0,5,10,3,7,2,3,1,2,1,3,4,4,2,0,2,2,13
401372434,Portland State Vikings,I. Burke,4395998,,True,32.0,2,5,2,3,0,2,0,0,2,4,6,2,0,0,2,4,4
401372434,Portland State Vikings,T. Wood,4592629,,False,1.0,0,0,0,0,0,0,0,0,0,0,0,0,0,0,0,0,0
401372434,Portland State Vikings,J. Eyman,4396000,,False,15.0,0,0,0,0,0,0,0,0,1,1,2,0,0,0,0,2,0
401372434,Portland State Vikings,H. Curtiss,4701202,,False,4.0,1,2,0,1,1,1,0,0,2,0,2,0,0,0,0,0,3
401372434,Portland State Vikings,P. Dawson,4702138,,False,20.0,1,4,0,2,1,2,0,0,0,1,1,0,0,0,0,2,3
401372434,Portland State Vikings,M. Ruffin,4593785,,False,30.0,7,15,6,10,1,5,0,1,3,6,9,2,2,0,3,2,15
401372434,Portland State Vikings,TEAM,TOTAL,TOTAL,False,,29,70,21,44,8,26,9,11,12,27,39,10,7,0,11,19,75
401372434,Eastern Washington Eagles,E. Price,4897852,,True,34.0,4,6,3,3,1,3,2,3,1,4,5,0,1,0,4,3,11
401372434,Eastern Washington Eagles,L. Acliese,4609216,,True,36.0,11,16,7,9,4,7,1,2,3,8,11,2,4,0,2,1,27
401372434,Eastern Washington Eagles,A. Allegri,4398233,,True,39.0,9,16,3,7,6,9,3,4,4,9,13,1,0,0,0,1,27
401372434,Eastern Washington Eagles,S. Venters,4592579,,True,31.0,1,8,1,4,0,4,6,7,0,0,0,4,0,2,3,4,8
401372434,Eastern Washington Eagles,R. Bergersen,4280143,,True,36.0,2,6,1,3,1,3,4,8,0,5,5,6,0,0,3,4,9
401372434,Eastern Washington Eagles,C. Jones,4897857,,False,2.0,0,0,0,0,0,0,0,0,0,0,0,0,1,0,1,2,0
401372434,Eastern Washington Eagles,M. Landdeck,4897855,,False,8.0,0,2,0,0,0,2,0,0,0,0,0,2,0,0,0,0,0
401372434,Eastern Washington Eagles,E. Magnuson,4592585,,False,14.0,0,1,0,0,0,1,1,2,0,1,1,3,0,0,1,1,1
401372434,Eastern Washington Eagles,TEAM,TOTAL,TOTAL,False,,27,55,15,26,12,29,17,26,8,29,37,18,6,2,15,16,83
401372433,Northern Arizona Lumberjacks,C. Towt,4702120,,True,36.0,1,3,1,3,0,0,2,3,2,9,11,6,3,0,3,3,4
401372433,Northern Arizona Lumberjacks,K. Haymon,4397304,,True,35.0,8,18,2,6,6,12,2,4,1,2,3,1,1,0,0,2,24
401372433,Northern Arizona Lumberjacks,N. Mains,4278643,,True,35.0,3,8,1,3,2,5,0,0,0,5,5,2,0,1,2,1,8
401372433,Northern Arizona Lumberjacks,E. Richards,4397752,,True,27.0,0,5,0,5,0,0,0,0,3,5,8,0,0,2,0,2,0
401372433,Northern Arizona Lumberjacks,J. Cone,4431698,,True,38.0,7,19,5,10,2,9,4,5,1,0,1,4,1,0,5,0,20
401372433,Northern Arizona Lumberjacks,A. Aguek,4592622,,False,8.0,1,1,1,1,0,0,0,0,0,2,2,0,0,0,0,0,2
401372433,Northern Arizona Lumberjacks,I. Lewis,4592625,,False,14.0,1,2,1,2,0,0,0,0,0,3,3,0,0,0,0,1,2
401372433,Northern Arizona Lumberjacks,M. Stark,4897937,,False,3.0,0,1,0,1,0,0,0,0,0,0,0,0,0,0,1,2,0
401372433,Northern Arizona Lumberjacks,J. Green,4278952,,False,4.0,1,1,1,1,0,0,0,0,0,0,0,0,0,0,1,0,2
401372433,Northern Arizona Lumberjacks,TEAM,TOTAL,TOTAL,False,,22,58,12,32,10,26,8,12,11,28,39,13,5,3,15,11,62
401372433,Eastern Washington Eagles,E. Price,4897852,,True,29.0,5,9,3,6,2,3,1,2,1,5,6,2,1,1,2,2,13
401372433,Eastern Washington Eagles,L. Acliese,4609216,,True,32.0,4,11,2,5,2,6,0,0,0,5,5,1,0,1,1,2,10
401372433,Eastern Washington Eagles,A. Allegri,4398233,,True,33.0,3,11,0,3,3,8,0,0,0,5,5,2,0,0,0,2,9
401372433,Eastern Washington Eagles,S. Venters,4592579,,True,39.0,7,14,4,6,3,8,1,2,2,6,8,3,0,0,4,1,18
401372433,Eastern Washington Eagles,R. Bergersen,4280143,,True,35.0,5,9,4,7,1,2,1,2,1,3,4,4,2,1,0,3,12
401372433,Eastern Washington Eagles,C. Jones,4897857,,False,7.0,0,0,0,0,0,0,0,0,0,1,1,0,0,1,1,0,0
401372433,Eastern Washington Eagles,M. Landdeck,4897855,,False,6.0,2,3,1,1,1,2,0,0,0,0,0,1,1,0,1,1,5
401372433,Eastern Washington Eagles,E. Magnuson,4592585,,False,19.0,1,2,1,2,0,0,0,0,0,0,0,2,2,0,1,0,2
401372433,Eastern Washington Eagles,TEAM,TOTAL,TOTAL,False,,27,59,15,30,12,29,3,6,5,27,32,15,6,4,10,11,69
401371689,SE Louisiana Lions,J. Hinton,4897312,,True,37.0,10,16,10,16,0,0,7,9,4,9,13,3,2,4,2,1,27
401371689,SE Louisiana Lions,G. Okafor,4397641,,True,39.0,4,14,3,8,1,6,2,3,3,4,7,2,2,1,2,3,11
401371689,SE Louisiana Lions,R. Eastmond,4593700,,True,10.0,0,1,0,1,0,0,4,4,0,0,0,0,0,0,2,2,4
401371689,SE Louisiana Lions,R. Burkhardt,4278456,,True,30.0,3,7,1,2,2,5,2,2,1,4,5,2,0,0,1,1,10
401371689,SE Louisiana Lions,K. Clergeot,4066460,,True,30.0,3,6,3,6,0,0,7,7,0,4,4,1,0,0,4,4,13
401371689,SE Louisiana Lions,A. Gordon,4431972,,False,1.0,0,0,0,0,0,0,0,0,0,0,0,0,0,0,0,1,0
401371689,SE Louisiana Lions,R. McFarlane,4897313,,False,19.0,2,4,1,3,1,1,1,2,2,3,5,0,0,0,0,2,6
401371689,SE Louisiana Lions,J. Warren,4703694,,False,3.0,0,0,0,0,0,0,0,0,0,0,0,0,0,0,0,0,0
401371689,SE Louisiana Lions,J. Kasperzyk,4397945,,False,21.0,3,10,1,6,2,4,3,4,1,1,2,5,3,0,5,0,11
401371689,SE Louisiana Lions,M. Strange,4278330,,False,10.0,1,3,0,0,1,3,0,0,0,1,1,0,0,0,1,0,3
401371689,SE Louisiana Lions,TEAM,TOTAL,TOTAL,False,,26,61,19,42,7,19,26,31,12,28,40,13,7,5,17,14,85
401371689,Northwestern State Demons,K. Coleman,4703671,,True,33.0,9,15,9,15,0,0,0,0,6,14,20,1,1,3,4,1,18
401371689,Northwestern State Demons,L. Owens,4278317,,True,24.0,6,7,6,7,0,0,0,0,3,4,7,1,1,0,1,3,12
401371689,Northwestern State Demons,C. Teasett,4703672,,True,31.0,5,16,3,6,2,10,2,2,0,0,0,6,2,0,1,2,14
401371689,Northwestern State Demons,B. White,4398266,,True,16.0,0,1,0,1,0,0,0,0,0,1,1,2,0,0,0,2,0
401371689,Northwestern State Demons,L. Reed,4398265,,True,16.0,2,7,1,2,1,5,8,8,2,0,2,2,1,0,2,2,13
401371689,Northwestern State Demons,Z. Zhgenti,4897320,,False,3.0,0,1,0,1,0,0,0,0,1,0,1,0,0,0,0,2,0
401371689,Northwestern State Demons,S. Riley II,4897317,,False,15.0,1,5,1,5,0,0,0,0,0,3,3,0,1,0,3,1,2
401371689,Northwestern State Demons,R. Chougkaz,4594128,,False,4.0,0,1,0,1,0,0,0,0,0,1,1,1,0,0,0,1,0
401371689,Northwestern State Demons,C. Garrett,4897318,,False,22.0,4,8,1,2,3,6,0,0,2,1,3,2,1,1,2,2,11
401371689,Northwestern State Demons,J. King,4897316,,False,6.0,0,3,0,2,0,1,0,0,0,0,0,0,0,0,0,0,0
401371689,Northwestern State Demons,E. McDonald,4897315,,False,15.0,2,3,1,1,1,2,0,0,0,1,1,0,0,0,1,2,5
401371689,Northwestern State Demons,J. Zelenbaba,4594125,,False,16.0,2,6,1,3,1,3,0,1,1,0,1,1,1,0,1,3,5
401371689,Northwestern State Demons,TEAM,TOTAL,TOTAL,False,,31,73,23,46,8,27,10,11,15,26,41,16,8,4,16,21,80
401371688,Nicholls Colonels,M. Littles,4897327,,True,34.0,6,7,6,7,0,0,2,5,5,8,13,3,1,0,2,3,14
401371688,Nicholls Colonels,R. Lyons,4278303,,True,18.0,1,2,1,2,0,0,0,0,0,0,0,1,0,1,0,4,2
401371688,Nicholls Colonels,L. Jones,4701200,,True,31.0,5,9,3,4,2,5,5,6,0,8,8,3,2,1,3,3,17
401371688,Nicholls Colonels,Ty Gordon,4599257,,True,32.0,12,24,5,7,7,17,5,6,0,2,2,3,1,0,3,5,36
401371688,Nicholls Colonels,D. Carter,4593407,,True,33.0,4,9,4,9,0,0,5,10,0,7,7,3,2,1,5,4,13
401371688,Nicholls Colonels,M. Collins,4897326,,False,2.0,0,0,0,0,0,0,0,0,0,1,1,0,0,1,0,2,0
401371688,Nicholls Colonels,R. Maxwell,4897325,,False,25.0,2,2,2,2,0,0,0,1,1,3,4,0,0,1,0,4,4
401371688,Nicholls Colonels,P. Spencer,4703670,,False,25.0,1,5,0,2,1,3,3,4,0,4,4,1,1,0,4,1,6
401371688,Nicholls Colonels,TEAM,TOTAL,TOTAL,False,,31,58,21,33,10,25,20,32,7,33,40,14,7,5,17,26,92
401371688,New Orleans Privateers,S. Kirkland,4703132,,True,21.0,2,5,2,5,0,0,0,0,1,3,4,0,1,1,2,2,4
401371688,New Orleans Privateers,T. Jackson,4431818,,True,36.0,6,8,6,8,0,0,3,5,3,1,4,0,0,0,0,1,15
401371688,New Orleans Privateers,D. St. Hilaire,4398325,,True,37.0,6,21,5,16,1,5,13,15,1,5,6,2,3,0,3,4,26
401371688,New Orleans Privateers,D. Sackey,4397512,,True,32.0,2,7,0,4,2,3,2,2,1,2,3,1,0,0,2,5,8
401371688,New Orleans Privateers,T. Green,4279181,,True,36.0,7,15,6,11,1,4,6,6,2,8,10,3,6,0,4,5,21
401371688,New Orleans Privateers,D. Bell,4703650,,False,10.0,1,1,1,1,0,0,2,4,0,1,1,1,1,0,1,4,4
401371688,New Orleans Privateers,J. Myers,4398093,,False,10.0,2,3,2,3,0,0,0,0,1,3,4,0,0,0,0,2,4
401371688,New Orleans Privateers,J. Vincent,4897328,,False,0.0,0,0,0,0,0,0,0,0,0,0,0,0,0,0,0,0,0
401371688,New Orleans Privateers,N. Williams,4703645,,False,0.0,0,1,0,0,0,1,0,0,0,0,0,0,0,0,0,0,0
401371688,New Orleans Privateers,R. Carson Jr.,4593813,,False,3.0,0,0,0,0,0,0,0,0,0,0,0,0,0,0,0,3,0
401371688,New Orleans Privateers,K. Doughty,4432969,,False,15.0,1,6,0,2,1,4,0,0,0,1,1,2,0,0,2,1,3
401371688,New Orleans Privateers,TEAM,TOTAL,TOTAL,False,,27,67,22,50,5,17,26,32,11,29,40,9,11,1,15,27,85
401371687,Texas A&M-Corpus Christi Islanders,I. Mushila,4897300,,True,15.0,1,2,1,2,0,0,4,4,0,1,1,0,0,0,2,2,6
401371687,Texas A&M-Corpus Christi Islanders,D. Keys,4703701,,True,29.0,5,7,5,7,0,0,1,2,3,6,9,1,2,0,1,3,11
401371687,Texas A&M-Corpus Christi Islanders,T. Murdix,4897301,,True,28.0,6,8,5,7,1,1,4,7,2,4,6,3,4,0,4,1,17
401371687,Texas A&M-Corpus Christi Islanders,S. Fryer,4703703,,True,21.0,0,3,0,1,0,2,1,2,1,2,3,2,0,0,1,5,1
401371687,Texas A&M-Corpus Christi Islanders,J. Jackson,4592869,,True,25.0,4,6,3,5,1,1,2,2,0,0,0,3,1,1,1,1,11
401371687,Texas A&M-Corpus Christi Islanders,S. Brinson,4278448,,False,10.0,2,4,2,3,0,1,0,0,0,1,1,1,0,0,1,0,4
401371687,Texas A&M-Corpus Christi Islanders,S. Faramade,4897304,,False,7.0,1,1,1,1,0,0,0,2,0,0,0,0,1,0,0,0,2
401371687,Texas A&M-Corpus Christi Islanders,T. Nickelson,4897298,,False,6.0,0,0,0,0,0,0,0,0,1,0,1,0,1,0,2,1,0
401371687,Texas A&M-Corpus Christi Islanders,T. Tennyson,4897296,,False,29.0,5,10,2,3,3,7,6,6,0,1,1,1,0,0,0,1,19
401371687,Texas A&M-Corpus Christi Islanders,E. White,4403714,,False,6.0,0,1,0,1,0,0,0,0,0,2,2,1,0,0,0,0,0
401371687,Texas A&M-Corpus Christi Islanders,M. Smith,4278341,,False,24.0,2,4,0,0,2,4,0,0,0,3,3,1,0,0,0,1,6
401371687,Texas A&M-Corpus Christi Islanders,TEAM,TOTAL,TOTAL,False,,26,46,19,30,7,16,18,25,7,21,28,13,9,1,12,15,77
401371687,Incarnate Word Cardinals,D. Hayman,4897346,,True,28.0,3,5,2,2,1,3,0,0,2,5,7,2,0,1,3,1,7
401371687,Incarnate Word Cardinals,J. Morgan,4703621,,True,38.0,1,9,1,3,0,6,5,7,2,0,2,3,0,0,3,3,7
401371687,Incarnate Word Cardinals,D. Lutz,4593757,,True,34.0,7,12,3,5,4,7,4,5,3,3,6,5,2,1,2,4,22
401371687,Incarnate Word Cardinals,B. Swaby,4398037,,True,26.0,0,2,0,0,0,2,0,0,1,3,4,1,0,0,1,4,0
401371687,Incarnate Word Cardinals,RJ Glasper,4066245,,True,34.0,6,16,3,9,3,7,1,1,1,2,3,3,0,0,2,1,16
401371687,Incarnate Word Cardinals,G. Ezedinma,4703624,,False,4.0,0,1,0,1,0,0,0,0,1,0,1,0,0,0,0,1,0
401371687,Incarnate Word Cardinals,B. Griscti,4897348,,False,22.0,4,5,0,0,4,5,2,2,1,4,5,1,0,0,1,4,14
401371687,Incarnate Word Cardinals,S. Hassan Mobutu,4897344,,False,14.0,1,2,1,1,0,1,0,0,0,2,2,0,0,0,2,2,2
401371687,Incarnate Word Cardinals,TEAM,TOTAL,TOTAL,False,,22,52,10,21,12,31,12,15,11,19,30,15,2,2,14,20,68
401371686,McNeese Cowboys,K. Taylor,4066493,,True,33.0,6,11,5,9,1,2,5,7,3,4,7,3,0,2,1,5,18
401371686,McNeese Cowboys,M. Lewis,4280102,,True,29.0,5,6,5,6,0,0,4,10,3,3,6,1,0,1,0,5,14
401371686,McNeese Cowboys,B. Medley-Bacon,4398113,,True,19.0,5,7,5,7,0,0,4,7,3,2,5,0,1,1,1,5,14
401371686,McNeese Cowboys,J. Massie,4897338,,True,32.0,5,8,5,8,0,0,0,0,2,2,4,2,0,1,2,4,10
401371686,McNeese Cowboys,Z. Scott,4396689,,True,51.0,6,17,3,7,3,10,4,4,0,4,4,0,1,0,3,2,19
401371686,McNeese Cowboys,C. Shumate,4701228,,False,31.0,7,12,7,11,0,1,2,3,1,8,9,2,1,2,0,5,16
401371686,McNeese Cowboys,C. Rawls,4897340,,False,1.0,0,0,0,0,0,0,0,0,0,0,0,0,0,0,0,1,0
401371686,McNeese Cowboys,T. Passmore,4897339,,False,4.0,0,0,0,0,0,0,0,0,0,0,0,1,1,0,0,0,0
401371686,McNeese Cowboys,T. English,4897337,,False,39.0,10,13,10,13,0,0,7,8,0,2,2,4,3,0,3,4,27
401371686,McNeese Cowboys,C. Warren,4593781,,False,35.0,6,13,5,8,1,5,5,6,0,5,5,2,0,0,1,3,18
401371686,McNeese Cowboys,H. Francois,4592723,,False,26.0,3,9,1,2,2,7,0,0,0,4,4,3,1,1,1,5,8
401371686,McNeese Cowboys,TEAM,TOTAL,TOTAL,False,,53,96,46,71,7,25,31,45,13,37,50,18,8,8,12,39,144
401371686,Houston Christian Huskies,Z. Tordoff,4593335,,True,22.0,5,7,5,7,0,0,6,7,1,2,3,0,0,0,1,5,16
401371686,Houston Christian Huskies,S. Hofman,4592901,,True,33.0,4,7,2,3,2,4,0,0,0,4,4,1,1,0,1,5,10
401371686,Houston Christian Huskies,D. Lee,4703615,,True,54.0,16,30,16,27,0,3,20,27,7,11,18,5,3,1,4,2,52
401371686,Houston Christian Huskies,K. Courseault,4593063,,True,56.0,8,25,6,16,2,9,12,17,3,3,6,7,0,2,2,4,30
401371686,Houston Christian Huskies,B. Long,4586322,,True,56.0,5,9,2,2,3,7,1,1,1,4,5,2,1,0,1,3,14
401371686,Houston Christian Huskies,Z. Iyeyemi,4593753,,False,13.0,2,4,2,4,0,0,4,4,1,1,2,0,0,0,2,3,8
401371686,Houston Christian Huskies,T. Moore,4897352,,False,17.0,1,2,1,2,0,0,2,2,0,2,2,1,0,0,0,1,4
401371686,Houston Christian Huskies,J. Thompson,4593751,,False,31.0,2,4,2,4,0,0,3,4,5,6,11,0,1,0,1,3,7
401371686,Houston Christian Huskies,J. Tse,4703613,,False,18.0,3,7,3,7,0,0,2,3,1,1,2,2,0,0,1,5,8
401371686,Houston Christian Huskies,TEAM,TOTAL,TOTAL,False,,46,95,39,72,7,23,50,65,22,36,58,18,6,3,13,31,149
401371685,Texas A&M-Corpus Christi Islanders,I. Mushila,4897300,,True,28.0,5,9,4,8,1,1,2,2,2,4,6,2,1,0,2,2,13
401371685,Texas A&M-Corpus Christi Islanders,D. Keys,4703701,,True,35.0,8,12,8,12,0,0,1,2,3,3,6,2,0,0,3,0,17
401371685,Texas A&M-Corpus Christi Islanders,T. Murdix,4897301,,True,15.0,4,5,3,4,1,1,1,2,1,3,4,4,2,0,6,4,10
401371685,Texas A&M-Corpus Christi Islanders,S. Fryer,4703703,,True,35.0,3,8,2,4,1,4,0,0,2,5,7,1,2,0,1,1,7
401371685,Texas A&M-Corpus Christi Islanders,J. Jackson,4592869,,True,30.0,2,5,2,5,0,0,0,0,2,2,4,6,2,1,3,2,4
401371685,Texas A&M-Corpus Christi Islanders,S. Brinson,4278448,,False,13.0,1,3,1,3,0,0,0,0,1,1,2,1,1,0,0,0,2
401371685,Texas A&M-Corpus Christi Islanders,S. Faramade,4897304,,False,3.0,1,1,1,1,0,0,0,0,0,0,0,0,0,0,0,0,2
401371685,Texas A&M-Corpus Christi Islanders,T. Nickelson,4897298,,False,3.0,1,2,1,1,0,1,0,0,0,1,1,0,0,0,0,0,2
401371685,Texas A&M-Corpus Christi Islanders,T. Tennyson,4897296,,False,19.0,2,8,0,2,2,6,2,2,1,1,2,0,0,0,1,0,8
401371685,Texas A&M-Corpus Christi Islanders,M. Smith,4278341,,False,19.0,3,9,1,4,2,5,2,3,0,2,2,5,0,0,3,2,10
401371685,Texas A&M-Corpus Christi Islanders,TEAM,TOTAL,TOTAL,False,,30,62,23,44,7,18,8,11,12,22,34,21,8,1,19,11,75
401371685,Nicholls Colonels,M. Littles,4897327,,True,25.0,3,5,2,3,1,2,0,0,1,5,6,0,0,0,2,2,7
401371685,Nicholls Colonels,R. Lyons,4278303,,True,30.0,4,6,2,3,2,3,2,2,0,5,5,0,2,1,1,3,12
401371685,Nicholls Colonels,L. Jones,4701200,,True,32.0,8,11,5,6,3,5,0,0,2,2,4,2,3,1,2,2,19
401371685,Nicholls Colonels,Ty Gordon,4599257,,True,39.0,7,18,6,12,1,6,6,6,0,4,4,6,0,0,5,3,21
401371685,Nicholls Colonels,D. Carter,4593407,,True,36.0,7,12,6,7,1,5,0,0,0,2,2,7,3,1,2,2,15
401371685,Nicholls Colonels,M. Collins,4897326,,False,3.0,0,0,0,0,0,0,0,0,2,0,2,1,0,0,1,1,0
401371685,Nicholls Colonels,R. Maxwell,4897325,,False,3.0,0,0,0,0,0,0,0,0,0,0,0,0,0,0,0,0,0
401371685,Nicholls Colonels,P. Spencer,4703670,,False,30.0,4,9,2,3,2,6,2,4,1,2,3,1,2,0,1,2,12
401371685,Nicholls Colonels,J. White,4703532,,False,0.0,0,0,0,0,0,0,0,0,0,0,0,0,0,0,0,0,0
401371685,Nicholls Colonels,T. Terrell,4593810,,False,2.0,0,0,0,0,0,0,0,0,0,0,0,0,0,0,0,0,0
401371685,Nicholls Colonels,TEAM,TOTAL,TOTAL,False,,33,61,23,34,10,27,10,12,7,22,29,17,10,3,14,15,86
401371684,New Orleans Privateers,S. Kirkland,4703132,,True,28.0,3,5,3,5,0,0,1,2,1,3,4,1,2,0,0,2,7
401371684,New Orleans Privateers,T. Jackson,4431818,,True,29.0,5,9,5,9,0,0,0,0,6,2,8,1,1,1,0,0,10
401371684,New Orleans Privateers,D. St. Hilaire,4398325,,True,35.0,5,21,3,13,2,8,4,4,0,5,5,2,1,0,4,3,16
401371684,New Orleans Privateers,D. Sackey,4397512,,True,34.0,0,4,0,2,0,2,0,2,3,5,8,6,0,0,1,0,0
401371684,New Orleans Privateers,T. Green,4279181,,True,37.0,11,15,11,15,0,0,6,6,1,3,4,1,1,0,2,4,28
401371684,New Orleans Privateers,D. Washington,4897329,,False,3.0,0,0,0,0,0,0,0,0,0,2,2,0,0,0,0,0,0
401371684,New Orleans Privateers,J. Myers,4398093,,False,20.0,5,7,5,7,0,0,2,2,0,3,3,2,1,0,1,2,12
401371684,New Orleans Privateers,R. Carson Jr.,4593813,,False,3.0,0,0,0,0,0,0,0,0,0,1,1,0,0,0,0,1,0
401371684,New Orleans Privateers,K. Doughty,4432969,,False,11.0,1,2,1,2,0,0,0,0,1,0,1,0,0,1,0,1,2
401371684,New Orleans Privateers,TEAM,TOTAL,TOTAL,False,,30,63,28,53,2,10,13,16,14,24,38,13,6,2,8,13,75
401371684,Houston Christian Huskies,Z. Tordoff,4593335,,True,29.0,1,3,1,3,0,0,3,4,1,2,3,0,2,1,1,5,5
401371684,Houston Christian Huskies,S. Hofman,4592901,,True,38.0,5,11,0,2,5,9,2,2,1,4,5,1,3,0,0,3,17
401371684,Houston Christian Huskies,D. Lee,4703615,,True,36.0,6,12,5,10,1,2,3,4,2,5,7,7,1,0,4,2,16
401371684,Houston Christian Huskies,K. Courseault,4593063,,True,37.0,6,12,5,8,1,4,2,2,0,4,4,5,1,0,0,2,15
401371684,Houston Christian Huskies,B. Long,4586322,,True,37.0,6,14,1,3,5,11,0,0,0,3,3,4,0,0,1,2,17
401371684,Houston Christian Huskies,Z. Iyeyemi,4593753,,False,9.0,2,3,2,3,0,0,0,0,1,0,1,0,0,0,1,2,4
401371684,Houston Christian Huskies,J. Tse,4703613,,False,14.0,0,2,0,1,0,1,0,0,0,2,2,1,0,0,1,0,0
401371684,Houston Christian Huskies,TEAM,TOTAL,TOTAL,False,,26,57,14,30,12,27,10,12,7,20,27,18,7,1,10,16,74
401371560,Utah Tech Trailblazers,D. Leter,4896875,,True,31.0,5,10,5,10,0,0,4,5,1,5,6,1,1,1,1,0,14
401371560,Utah Tech Trailblazers,H. Schofield,4701250,,True,32.0,2,10,0,6,2,4,4,6,3,8,11,2,0,0,3,4,10
401371560,Utah Tech Trailblazers,F. Staine,4701245,,True,34.0,6,8,3,4,3,4,1,1,1,8,9,1,1,3,3,2,16
401371560,Utah Tech Trailblazers,I. Pope,4701255,,True,31.0,2,8,2,5,0,3,2,3,0,0,0,2,1,0,2,3,6
401371560,Utah Tech Trailblazers,C. Gooden,4701244,,True,33.0,1,11,1,8,0,3,1,2,0,0,0,4,2,0,2,2,3
401371560,Utah Tech Trailblazers,J. Nicolds,4408086,,False,9.0,0,1,0,0,0,1,0,0,1,2,3,0,0,0,0,0,0
401371560,Utah Tech Trailblazers,T. Edmonds,4896871,,False,8.0,1,1,1,1,0,0,0,2,0,1,1,0,0,1,0,1,2
401371560,Utah Tech Trailblazers,A. Mulibea,4701246,,False,7.0,0,0,0,0,0,0,0,2,1,2,3,0,0,1,3,2,0
401371560,Utah Tech Trailblazers,N. Gonsalves,4896874,,False,7.0,0,0,0,0,0,0,0,0,0,0,0,0,0,0,2,2,0
401371560,Utah Tech Trailblazers,M. Hatch,4701253,,False,2.0,0,1,0,1,0,0,0,0,0,0,0,0,0,0,0,0,0
401371560,Utah Tech Trailblazers,E. Elniel,4701248,,False,2.0,0,1,0,0,0,1,1,2,0,0,0,0,0,0,0,0,1
401371560,Utah Tech Trailblazers,B. Gilbert,4701243,,False,4.0,0,0,0,0,0,0,1,2,0,0,0,0,0,0,1,0,1
401371560,Utah Tech Trailblazers,TEAM,TOTAL,TOTAL,False,,17,51,12,35,5,16,14,25,8,31,39,10,5,6,17,16,53
401371560,Grand Canyon Lopes,Y. Ouedraogo,4592706,,True,26.0,3,8,3,8,0,0,2,6,9,5,14,1,1,0,0,2,8
401371560,Grand Canyon Lopes,G. McGlothan,4398356,,True,16.0,3,5,2,3,1,2,1,2,1,2,3,0,1,0,0,5,8
401371560,Grand Canyon Lopes,S. Miller-Moore,4592413,,True,20.0,5,11,5,11,0,0,2,4,1,8,9,1,2,1,0,1,12
401371560,Grand Canyon Lopes,J. Blacksher Jr.,4431826,,True,29.0,2,11,1,5,1,6,0,0,0,2,2,5,2,0,4,3,5
401371560,Grand Canyon Lopes,H. Woods,4278657,,True,34.0,4,13,1,6,3,7,2,2,0,4,4,7,1,1,0,0,13
401371560,Grand Canyon Lopes,A. Igiehon,4431697,,False,12.0,3,5,3,5,0,0,0,0,4,1,5,0,0,0,0,3,6
401371560,Grand Canyon Lopes,R. Gerdes,4398426,,False,2.0,0,4,0,1,0,3,0,0,0,0,0,0,0,0,0,0,0
401371560,Grand Canyon Lopes,D. Zdor,4397390,,False,2.0,0,0,0,0,0,0,0,0,0,1,1,0,0,0,0,0,0
401371560,Grand Canyon Lopes,T. Cherry,4397024,,False,22.0,0,5,0,1,0,4,0,0,0,1,1,1,3,1,0,1,0
401371560,Grand Canyon Lopes,L. Lloyd,4702029,,False,2.0,0,1,0,0,0,1,0,0,0,1,1,0,0,0,0,2,0
401371560,Grand Canyon Lopes,C. McMillian,4702027,,False,23.0,3,7,1,1,2,6,4,4,0,3,3,3,1,0,2,2,12
401371560,Grand Canyon Lopes,J. Blackmon,4683853,,False,3.0,0,0,0,0,0,0,0,0,0,1,1,0,0,0,0,0,0
401371560,Grand Canyon Lopes,J. Stone,4432196,,False,2.0,0,0,0,0,0,0,0,0,0,0,0,0,0,0,0,0,0
401371560,Grand Canyon Lopes,W. Ellis,4397649,,False,7.0,2,3,0,0,2,3,0,0,0,0,0,0,0,0,0,0,6
401371560,Grand Canyon Lopes,TEAM,TOTAL,TOTAL,False,,25,73,16,41,9,32,11,18,18,33,51,18,11,3,7,19,70
401371559,UT Rio Grande Valley Vaqueros,R. Taylor,4896966,,True,21.0,1,2,1,1,0,1,2,2,0,2,2,0,1,4,0,4,4
401371559,UT Rio Grande Valley Vaqueros,M. Nelson,4279122,,True,24.0,3,7,3,5,0,2,0,0,0,0,0,2,2,0,1,5,6
401371559,UT Rio Grande Valley Vaqueros,J. Johnson,4703110,,True,36.0,4,9,4,8,0,1,12,13,2,6,8,4,0,0,6,1,20
401371559,UT Rio Grande Valley Vaqueros,R. Nelson,4278672,,True,32.0,2,6,2,6,0,0,2,4,0,0,0,2,0,0,3,2,6
401371559,UT Rio Grande Valley Vaqueros,M. Adewunmi,4278256,,True,17.0,1,3,1,2,0,1,1,2,1,0,1,0,0,0,1,0,3
401371559,UT Rio Grande Valley Vaqueros,D. Houston Jr.,4896965,,False,20.0,2,6,2,4,0,2,3,6,0,2,2,0,1,0,0,4,7
401371559,UT Rio Grande Valley Vaqueros,X. Johnson,4597988,,False,20.0,2,5,2,4,0,1,2,2,0,1,1,0,1,0,2,0,6
401371559,UT Rio Grande Valley Vaqueros,L. Butler,4594143,,False,8.0,1,3,0,1,1,2,0,0,0,0,0,2,0,0,0,0,3
401371559,UT Rio Grande Valley Vaqueros,Q. Johnson II,4395996,,False,22.0,3,9,1,6,2,3,0,0,1,2,3,1,1,1,1,2,8
401371559,UT Rio Grande Valley Vaqueros,TEAM,TOTAL,TOTAL,False,,19,50,16,37,3,13,22,29,7,18,25,11,6,5,15,18,63
401371559,Stephen F. Austin Lumberjacks,C. Solomon,4594155,,True,29.0,4,13,3,12,1,1,4,8,2,5,7,4,1,0,0,3,13
401371559,Stephen F. Austin Lumberjacks,G. Kensmil,4279493,,True,35.0,13,13,13,13,0,0,7,10,4,5,9,0,0,0,5,2,33
401371559,Stephen F. Austin Lumberjacks,D. Tezeno,4896946,,True,24.0,1,2,1,2,0,0,3,3,2,4,6,2,1,1,0,1,5
401371559,Stephen F. Austin Lumberjacks,L. Jossell,4601284,,True,31.0,4,7,1,2,3,5,0,0,0,3,3,4,2,0,1,3,11
401371559,Stephen F. Austin Lumberjacks,D. Kachelries,4278450,,True,27.0,2,5,2,2,0,3,2,2,0,5,5,8,1,0,2,1,6
401371559,Stephen F. Austin Lumberjacks,S. Hall,4713935,,False,11.0,4,4,4,4,0,0,2,2,2,2,4,1,0,0,1,4,10
401371559,Stephen F. Austin Lumberjacks,N. Antwi-Boasiako,4703693,,False,18.0,1,3,1,3,0,0,2,2,0,2,2,3,1,0,2,3,4
401371559,Stephen F. Austin Lumberjacks,J. Aku,4592830,,False,2.0,1,1,1,1,0,0,0,0,0,1,1,0,0,0,0,0,2
401371559,Stephen F. Austin Lumberjacks,J. Jackson-Posey,4703691,,False,20.0,3,10,0,2,3,8,0,0,0,0,0,3,0,1,2,3,9
401371559,Stephen F. Austin Lumberjacks,N. Hawkins,4397862,,False,0.0,0,0,0,0,0,0,0,0,0,0,0,0,0,0,0,0,0
401371559,Stephen F. Austin Lumberjacks,D. Willis,4396753,,False,3.0,0,1,0,0,0,1,0,0,0,0,0,1,0,0,0,1,0
401371559,Stephen F. Austin Lumberjacks,TEAM,TOTAL,TOTAL,False,,33,59,26,41,7,18,20,27,12,27,39,26,6,2,13,21,93
401371558,Seattle U Redhawks,E. Udenyi,4702013,,True,28.0,1,3,1,3,0,0,2,4,0,4,4,2,0,1,0,2,4
401371558,Seattle U Redhawks,K. Williamson,4702017,,True,22.0,2,4,2,3,0,1,1,2,4,3,7,2,0,3,2,0,5
401371558,Seattle U Redhawks,D. Trammell,4702011,,True,35.0,5,8,3,6,2,2,8,9,0,3,3,2,1,1,2,4,20
401371558,Seattle U Redhawks,C. Tyson,4397285,,True,35.0,6,14,2,4,4,10,2,2,1,4,5,0,0,0,3,2,18
401371558,Seattle U Redhawks,R. Grigsby,4396001,,True,33.0,9,15,7,11,2,4,2,4,0,2,2,0,2,2,0,3,22
401371558,Seattle U Redhawks,V. Rajković,4702014,,False,10.0,0,5,0,5,0,0,0,0,5,3,8,0,0,0,1,0,0
401371558,Seattle U Redhawks,M. Vail,4396004,,False,0.0,0,0,0,0,0,0,0,0,0,0,0,0,0,0,0,0,0
401371558,Seattle U Redhawks,K. Brown,4896942,,False,25.0,1,4,1,3,0,1,0,0,0,1,1,2,0,0,0,1,2
401371558,Seattle U Redhawks,V. Pandža,4702010,,False,13.0,1,3,1,3,0,0,1,2,0,2,2,0,0,0,0,2,3
401371558,Seattle U Redhawks,TEAM,TOTAL,TOTAL,False,,25,56,17,38,8,18,16,23,14,23,37,8,3,7,9,14,74
401371558,Chicago State Cougars,N. Bigirumwami,4396020,,True,16.0,0,2,0,1,0,1,1,2,2,0,2,0,0,1,0,5,1
401371558,Chicago State Cougars,T. Bayi Ba Mandeng,4896865,,True,24.0,1,7,1,7,0,0,0,2,2,2,4,1,2,2,0,3,2
401371558,Chicago State Cougars,F. Chukwukelu,4896867,,True,23.0,0,1,0,0,0,1,0,0,0,0,0,0,0,0,0,0,0
401371558,Chicago State Cougars,B. Betson,4896861,,True,38.0,11,19,6,11,5,8,4,4,1,2,3,2,0,0,4,3,31
401371558,Chicago State Cougars,J. Corbett,4896860,,True,39.0,8,15,8,12,0,3,5,9,6,8,14,2,0,0,1,3,21
401371558,Chicago State Cougars,K. Green,4896864,,False,18.0,0,3,0,2,0,1,0,0,1,1,2,0,2,1,1,4,0
401371558,Chicago State Cougars,B. Johnson,4896859,,False,29.0,4,6,2,3,2,3,1,1,1,4,5,0,0,1,2,1,11
401371558,Chicago State Cougars,J. Harris,4896857,,False,13.0,0,4,0,3,0,1,0,0,0,2,2,1,0,0,0,1,0
401371558,Chicago State Cougars,TEAM,TOTAL,TOTAL,False,,24,57,17,39,7,18,11,18,13,19,32,6,4,5,8,20,66
401371557,Utah Valley Wolverines,F. Aimaq,4398226,,True,34.0,3,11,2,7,1,4,1,3,1,8,9,0,0,0,1,2,8
401371557,Utah Valley Wolverines,T. Fuller,4397392,,True,24.0,4,9,4,9,0,0,0,0,2,3,5,0,0,1,2,0,8
401371557,Utah Valley Wolverines,J. Harmon,4896970,,True,21.0,1,8,1,7,0,1,0,0,1,2,3,0,0,0,2,2,2
401371557,Utah Valley Wolverines,B. Nield,4593745,,True,21.0,0,2,0,2,0,0,0,0,0,0,0,4,0,0,0,1,0
401371557,Utah Valley Wolverines,C. Harding,4397648,,True,29.0,2,4,2,2,0,2,1,1,0,4,4,1,1,0,3,0,5
401371557,Utah Valley Wolverines,A. McCord,4702366,,False,7.0,1,2,1,1,0,1,2,2,0,2,2,0,0,0,0,0,4
401371557,Utah Valley Wolverines,T. Farrer,4702363,,False,22.0,0,2,0,1,0,1,2,2,1,1,2,0,1,0,2,2,2
401371557,Utah Valley Wolverines,J. McClanahan,4702365,,False,19.0,2,3,2,3,0,0,0,0,0,3,3,2,2,0,2,1,4
401371557,Utah Valley Wolverines,L. Darthard,4702362,,False,23.0,4,8,1,2,3,6,2,2,0,0,0,0,1,0,1,2,13
401371557,Utah Valley Wolverines,TEAM,TOTAL,TOTAL,False,,17,49,13,34,4,15,8,10,5,26,31,7,5,1,14,10,46
401371557,New Mexico State Aggies,W. McNair Jr.,4396012,,True,24.0,1,4,1,3,0,1,0,0,2,1,3,1,1,0,2,2,2
401371557,New Mexico State Aggies,J. McCants,4067472,,True,36.0,5,8,4,4,1,4,0,0,2,11,13,4,1,3,1,2,11
401371557,New Mexico State Aggies,C. Henry,4396010,,True,22.0,3,5,2,2,1,3,0,0,0,1,1,0,2,0,1,1,7
401371557,New Mexico State Aggies,J. Rice,4280181,,True,29.0,3,13,3,5,0,8,0,0,0,1,1,0,1,1,1,1,6
401371557,New Mexico State Aggies,T. Allen,4277932,,True,39.0,7,20,3,6,4,14,2,2,0,6,6,5,3,0,1,1,20
401371557,New Mexico State Aggies,M. Peake,4572450,,False,12.0,1,2,1,1,0,1,0,0,2,1,3,0,0,0,0,0,2
401371557,New Mexico State Aggies,Y. Alok,4397070,,False,8.0,3,4,2,2,1,2,0,0,0,0,0,2,0,0,2,0,7
401371557,New Mexico State Aggies,M. McKinney Jr.,4896928,,False,6.0,1,1,0,0,1,1,0,0,0,1,1,0,1,0,1,0,3
401371557,New Mexico State Aggies,N. Pryor,4702460,,False,19.0,2,3,2,2,0,1,0,0,0,3,3,4,1,0,0,3,4
401371557,New Mexico State Aggies,V. Cotton,4279307,,False,5.0,0,0,0,0,0,0,0,0,0,2,2,0,0,0,0,0,0
401371557,New Mexico State Aggies,TEAM,TOTAL,TOTAL,False,,26,60,18,25,8,35,2,2,8,28,36,16,10,4,11,10,62
401371556,Lamar Cardinals,L. Smith,4703630,,True,29.0,6,12,6,12,0,0,3,4,1,3,4,3,1,0,3,2,15
401371556,Lamar Cardinals,D. Reyes,4684465,,True,17.0,0,1,0,1,0,0,1,2,3,1,4,1,0,0,0,1,1
401371556,Lamar Cardinals,B. McClure,4896925,,True,32.0,1,5,1,4,0,1,2,2,2,2,4,1,1,0,1,5,4
401371556,Lamar Cardinals,C.J. Roberts,4702019,,True,28.0,5,13,5,13,0,0,2,3,0,1,1,3,0,0,3,3,12
401371556,Lamar Cardinals,E. Jefferson,4067375,,True,8.0,1,1,1,1,0,0,0,0,0,1,1,0,0,0,0,0,2
401371556,Lamar Cardinals,V. Catt,4896923,,False,20.0,3,4,3,4,0,0,0,0,0,6,6,2,0,1,0,2,6
401371556,Lamar Cardinals,C. Nickerson,4593763,,False,22.0,6,10,6,10,0,0,0,0,3,4,7,0,0,1,1,1,12
401371556,Lamar Cardinals,A. Ledet,4896920,,False,11.0,0,1,0,1,0,0,0,0,0,0,0,1,0,0,1,0,0
401371556,Lamar Cardinals,J. Adams,4432903,,False,33.0,5,12,2,5,3,7,1,3,0,2,2,3,0,1,1,1,14
401371556,Lamar Cardinals,TEAM,TOTAL,TOTAL,False,,27,59,24,51,3,8,9,14,12,23,35,14,2,3,10,15,66
401371556,California Baptist Lancers,D. Akin,4279163,,True,26.0,2,5,2,5,0,0,2,2,0,2,2,1,0,1,2,2,6
401371556,California Baptist Lancers,E. Thomas,4066734,,True,26.0,3,5,3,5,0,0,4,5,0,3,3,2,3,1,0,2,10
401371556,California Baptist Lancers,Ta. Armstrong,4896850,,True,38.0,4,8,2,5,2,3,1,2,1,4,5,7,0,0,1,3,11
401371556,California Baptist Lancers,Tr. Armstrong,4593806,,True,35.0,3,12,0,1,3,11,2,2,1,2,3,3,2,0,3,1,11
401371556,California Baptist Lancers,Ty Rowell,4398423,,True,33.0,8,13,0,0,8,13,1,2,1,6,7,3,1,0,1,3,25
401371556,California Baptist Lancers,J. Stone,4702041,,False,12.0,4,6,4,6,0,0,2,3,3,3,6,1,0,1,2,1,10
401371556,California Baptist Lancers,M. Wade,4702040,,False,2.0,0,0,0,0,0,0,0,0,0,0,0,0,0,0,0,1,0
401371556,California Baptist Lancers,T. Campbell,4702036,,False,5.0,0,1,0,0,0,1,0,0,0,1,1,1,1,0,0,0,0
401371556,California Baptist Lancers,R. Nottage,4593807,,False,23.0,2,4,1,1,1,3,0,0,1,2,3,3,1,0,1,3,5
401371556,California Baptist Lancers,TEAM,TOTAL,TOTAL,False,,26,54,12,23,14,31,12,16,8,25,33,21,8,3,10,16,78
401371555,Tarleton State Texans,N. McDavid,4896949,,True,32.0,0,2,0,2,0,0,0,0,1,2,3,1,0,0,4,4,0
401371555,Tarleton State Texans,S. Bogues,4705380,,True,35.0,1,3,1,2,0,1,0,0,0,3,3,0,0,1,3,4,2
401371555,Tarleton State Texans,F. Hicks,4705373,,True,16.0,4,7,3,4,1,3,4,4,2,1,3,1,0,0,2,5,13
401371555,Tarleton State Texans,M. Gipson,4705372,,True,40.0,5,11,4,7,1,4,6,7,2,7,9,0,1,0,3,1,17
401371555,Tarleton State Texans,T. Small,4593929,,True,32.0,3,9,3,7,0,2,11,12,0,3,3,0,0,0,3,3,17
401371555,Tarleton State Texans,J. Moore,4896960,,False,4.0,0,0,0,0,0,0,0,0,0,1,1,0,0,0,1,0,0
401371555,Tarleton State Texans,J. Hopkins,4705377,,False,10.0,2,3,1,1,1,2,0,0,1,0,1,0,0,0,2,1,5
401371555,Tarleton State Texans,S. Daniel,4397704,,False,31.0,0,1,0,1,0,0,2,2,0,3,3,3,2,0,3,4,2
401371555,Tarleton State Texans,TEAM,TOTAL,TOTAL,False,,15,36,12,24,3,12,23,25,7,21,28,5,3,1,23,22,56
401371555,Abilene Christian Wildcats,A. Simmons,4433077,,True,22.0,3,9,3,5,0,4,2,3,1,4,5,3,0,1,0,3,8
401371555,Abilene Christian Wildcats,C. Mason,4593750,,True,29.0,3,6,3,3,0,3,1,4,3,1,4,0,2,0,2,4,7
401371555,Abilene Christian Wildcats,M. Morris,4593748,,True,28.0,5,10,4,6,1,4,7,8,3,1,4,2,2,0,2,5,18
401371555,Abilene Christian Wildcats,R. Miller,4593747,,True,31.0,1,4,1,2,0,2,0,0,1,1,2,1,1,1,1,4,2
401371555,Abilene Christian Wildcats,T. Cameron,4278255,,True,16.0,1,2,1,2,0,0,3,4,1,1,2,2,2,0,2,5,5
401371555,Abilene Christian Wildcats,F. Cadeaux de Dieu,4896507,,False,1.0,0,0,0,0,0,0,0,0,0,0,0,0,0,0,0,0,0
401371555,Abilene Christian Wildcats,C. Steele,4703600,,False,23.0,0,3,0,1,0,2,6,6,2,3,5,1,0,1,1,1,6
401371555,Abilene Christian Wildcats,Y. Gai,4896508,,False,1.0,0,0,0,0,0,0,0,0,0,0,0,0,0,0,0,0,0
401371555,Abilene Christian Wildcats,S. Smith,4896506,,False,0.0,0,0,0,0,0,0,0,0,0,0,0,0,0,0,0,0,0
401371555,Abilene Christian Wildcats,J. Jackson,4896504,,False,10.0,1,2,0,1,1,1,0,0,0,0,0,0,0,0,0,0,3
401371555,Abilene Christian Wildcats,I. Allen,4593749,,False,12.0,3,5,2,4,1,1,1,1,1,0,1,0,0,0,2,2,8
401371555,Abilene Christian Wildcats,D. Daniels,4397957,,False,27.0,2,10,2,7,0,3,0,0,0,1,1,2,4,0,2,2,4
401371555,Abilene Christian Wildcats,TEAM,TOTAL,TOTAL,False,,19,51,16,31,3,20,20,26,14,14,28,11,11,3,13,26,61
401371553,Utah Valley Wolverines,F. Aimaq,4398226,,True,36.0,6,18,6,16,0,2,7,11,7,12,19,2,0,0,2,5,19
401371553,Utah Valley Wolverines,T. Fuller,4397392,,True,22.0,3,5,3,5,0,0,0,2,3,0,3,2,1,0,0,4,6
401371553,Utah Valley Wolverines,J. Harmon,4896970,,True,33.0,7,15,6,9,1,6,3,5,0,5,5,1,0,0,1,3,18
401371553,Utah Valley Wolverines,B. Nield,4593745,,True,21.0,0,1,0,1,0,0,0,0,0,2,2,1,0,0,3,1,0
401371553,Utah Valley Wolverines,C. Harding,4397648,,True,35.0,5,10,5,9,0,1,2,4,0,4,4,0,1,0,5,1,12
401371553,Utah Valley Wolverines,A. McCord,4702366,,False,14.0,0,2,0,1,0,1,0,0,0,1,1,0,0,1,0,2,0
401371553,Utah Valley Wolverines,T. Farrer,4702363,,False,6.0,0,0,0,0,0,0,0,1,0,1,1,0,0,0,0,4,0
401371553,Utah Valley Wolverines,J. Battle,4896969,,False,2.0,0,0,0,0,0,0,0,0,0,0,0,0,0,0,0,0,0
401371553,Utah Valley Wolverines,J. McClanahan,4702365,,False,10.0,1,2,1,1,0,1,0,0,0,0,0,0,0,0,0,0,2
401371553,Utah Valley Wolverines,L. Darthard,4702362,,False,19.0,0,3,0,1,0,2,0,2,0,0,0,2,0,0,2,2,0
401371553,Utah Valley Wolverines,C. Leifson,4066653,,False,2.0,0,1,0,0,0,1,0,0,0,0,0,0,0,0,0,0,0
401371553,Utah Valley Wolverines,TEAM,TOTAL,TOTAL,False,,22,57,21,43,1,14,12,25,13,29,42,8,2,1,13,22,57
401371553,Grand Canyon Lopes,Y. Ouedraogo,4592706,,True,27.0,0,2,0,2,0,0,1,2,2,2,4,0,1,0,1,4,1
401371553,Grand Canyon Lopes,G. McGlothan,4398356,,True,27.0,3,10,3,6,0,4,4,6,2,10,12,0,2,1,0,1,10
401371553,Grand Canyon Lopes,S. Miller-Moore,4592413,,True,16.0,2,4,2,3,0,1,2,2,0,3,3,1,0,0,1,4,6
401371553,Grand Canyon Lopes,J. Blacksher Jr.,4431826,,True,36.0,5,12,3,8,2,4,3,5,0,4,4,5,1,0,1,0,15
401371553,Grand Canyon Lopes,H. Woods,4278657,,True,31.0,6,10,5,8,1,2,9,12,0,2,2,1,0,0,0,3,22
401371553,Grand Canyon Lopes,A. Igiehon,4431697,,False,8.0,1,2,1,2,0,0,0,0,0,3,3,0,0,0,1,0,2
401371553,Grand Canyon Lopes,T. Cherry,4397024,,False,18.0,1,5,1,3,0,2,2,2,1,2,3,0,0,0,1,3,4
401371553,Grand Canyon Lopes,C. McMillian,4702027,,False,22.0,2,6,2,4,0,2,1,1,2,2,4,1,1,0,0,4,5
401371553,Grand Canyon Lopes,W. Ellis,4397649,,False,15.0,1,1,0,0,1,1,0,0,0,1,1,1,0,1,0,2,3
401371553,Grand Canyon Lopes,TEAM,TOTAL,TOTAL,False,,21,52,17,36,4,16,22,30,7,29,36,9,5,2,6,22,68
401371552,UT Rio Grande Valley Vaqueros,R. Taylor,4896966,,True,14.0,1,3,1,2,0,1,1,2,1,2,3,0,0,1,0,4,3
401371552,UT Rio Grande Valley Vaqueros,M. Nelson,4279122,,True,35.0,4,6,3,4,1,2,3,4,1,4,5,1,3,2,0,3,12
401371552,UT Rio Grande Valley Vaqueros,J. Johnson,4703110,,True,36.0,6,14,5,10,1,4,10,14,1,9,10,2,2,0,2,3,23
401371552,UT Rio Grande Valley Vaqueros,R. Nelson,4278672,,True,35.0,2,6,2,5,0,1,2,2,0,2,2,5,2,0,5,0,6
401371552,UT Rio Grande Valley Vaqueros,M. Adewunmi,4278256,,True,16.0,2,6,2,3,0,3,4,4,1,2,3,0,0,1,0,5,8
401371552,UT Rio Grande Valley Vaqueros,D. Houston Jr.,4896965,,False,14.0,0,2,0,2,0,0,0,0,2,1,3,0,1,0,2,0,0
401371552,UT Rio Grande Valley Vaqueros,X. Johnson,4597988,,False,25.0,5,15,3,5,2,10,3,5,1,4,5,3,0,0,2,3,15
401371552,UT Rio Grande Valley Vaqueros,L. Butler,4594143,,False,5.0,0,0,0,0,0,0,0,0,0,0,0,1,1,0,1,0,0
401371552,UT Rio Grande Valley Vaqueros,Q. Johnson II,4395996,,False,20.0,0,3,0,0,0,3,0,0,0,3,3,0,1,0,1,4,0
401371552,UT Rio Grande Valley Vaqueros,TEAM,TOTAL,TOTAL,False,,20,55,16,31,4,24,23,31,10,30,40,12,10,4,13,22,67
401371552,Lamar Cardinals,L. Smith,4703630,,True,25.0,5,11,4,10,1,1,0,2,0,5,5,1,0,0,0,4,11
401371552,Lamar Cardinals,D. Reyes,4684465,,True,15.0,0,0,0,0,0,0,1,2,1,2,3,0,0,0,0,2,1
401371552,Lamar Cardinals,B. McClure,4896925,,True,36.0,5,11,4,8,1,3,1,2,3,3,6,0,2,0,4,5,12
401371552,Lamar Cardinals,C.J. Roberts,4702019,,True,33.0,4,11,3,9,1,2,2,2,0,0,0,1,1,0,1,3,11
401371552,Lamar Cardinals,J. Adams,4432903,,True,36.0,2,10,2,5,0,5,6,8,0,5,5,5,2,0,4,3,10
401371552,Lamar Cardinals,V. Catt,4896923,,False,11.0,2,3,2,3,0,0,4,4,1,1,2,1,0,0,0,5,8
401371552,Lamar Cardinals,C. Carpenter,4703632,,False,5.0,0,1,0,1,0,0,0,1,1,0,1,0,0,0,0,0,0
401371552,Lamar Cardinals,C. Nickerson,4593763,,False,21.0,1,3,1,3,0,0,2,5,2,6,8,3,0,0,3,1,4
401371552,Lamar Cardinals,A. Ledet,4896920,,False,14.0,2,3,0,0,2,3,0,0,0,5,5,0,0,1,1,1,6
401371552,Lamar Cardinals,E. Jefferson,4067375,,False,4.0,0,1,0,0,0,1,0,0,0,1,1,0,1,0,1,0,0
401371552,Lamar Cardinals,TEAM,TOTAL,TOTAL,False,,21,54,16,39,5,15,16,26,9,30,39,11,6,1,15,24,63
401371551,Tarleton State Texans,N. McDavid,4896949,,True,32.0,3,8,0,2,3,6,0,0,1,1,2,0,1,0,1,3,9
401371551,Tarleton State Texans,S. Bogues,4705380,,True,18.0,2,6,1,4,1,2,0,0,2,0,2,0,1,0,1,0,5
401371551,Tarleton State Texans,F. Hicks,4705373,,True,30.0,5,8,3,5,2,3,1,1,1,4,5,1,2,0,2,0,13
401371551,Tarleton State Texans,M. Gipson,4705372,,True,40.0,3,8,3,5,0,3,0,0,0,2,2,7,3,0,2,0,6
401371551,Tarleton State Texans,T. Small,4593929,,True,35.0,4,12,3,8,1,4,0,0,0,3,3,2,0,0,2,4,9
401371551,Tarleton State Texans,J. Hopkins,4705377,,False,13.0,3,6,3,5,0,1,0,0,1,3,4,0,0,0,0,2,6
401371551,Tarleton State Texans,S. Daniel,4397704,,False,32.0,1,2,1,1,0,1,0,0,0,3,3,2,0,0,4,1,2
401371551,Tarleton State Texans,TEAM,TOTAL,TOTAL,False,,21,50,14,30,7,20,1,1,5,16,21,12,7,0,13,10,50
401371551,Sam Houston Bearkats,T. Ikpe,4703681,,True,32.0,5,6,5,6,0,0,1,1,3,4,7,1,0,1,3,1,11
401371551,Sam Houston Bearkats,J. Ray,4896937,,True,30.0,3,8,2,4,1,4,0,0,1,2,3,5,2,0,2,1,7
401371551,Sam Houston Bearkats,J. May,4703680,,True,25.0,4,7,3,4,1,3,1,1,1,4,5,0,1,1,2,3,10
401371551,Sam Houston Bearkats,D. Lampley,4594132,,True,33.0,4,8,1,1,3,7,0,0,0,3,3,0,1,0,1,0,11
401371551,Sam Houston Bearkats,S. Flagg,4278119,,True,36.0,6,13,3,7,3,6,3,5,1,10,11,5,3,1,4,1,18
401371551,Sam Houston Bearkats,K. Karwowski,4593103,,False,4.0,0,0,0,0,0,0,0,0,0,0,0,0,0,0,0,0,0
401371551,Sam Houston Bearkats,J. Grant,4896935,,False,15.0,1,1,1,1,0,0,0,0,0,0,0,5,0,0,1,0,2
401371551,Sam Houston Bearkats,D. Powers,4703683,,False,25.0,4,6,2,3,2,3,0,0,1,0,1,0,1,0,1,3,10
401371551,Sam Houston Bearkats,TEAM,TOTAL,TOTAL,False,,27,49,17,26,10,23,5,7,8,24,32,16,8,3,15,9,69
401371550,Utah Tech Trailblazers,D. Leter,4896875,,True,22.0,3,8,2,3,1,5,1,1,2,5,7,2,0,0,2,2,8
401371550,Utah Tech Trailblazers,H. Schofield,4701250,,True,21.0,6,11,6,10,0,1,3,6,0,2,2,0,0,0,1,4,15
401371550,Utah Tech Trailblazers,F. Staine,4701245,,True,26.0,2,5,2,3,0,2,2,2,0,2,2,1,2,0,3,3,6
401371550,Utah Tech Trailblazers,I. Pope,4701255,,True,23.0,1,5,0,2,1,3,2,3,0,4,4,3,0,0,4,3,5
401371550,Utah Tech Trailblazers,C. Gooden,4701244,,True,25.0,0,1,0,1,0,0,2,4,2,0,2,4,2,0,0,0,2
401371550,Utah Tech Trailblazers,T. Allfrey,4701249,,False,5.0,1,3,0,1,1,2,0,0,1,1,2,0,0,0,0,0,3
401371550,Utah Tech Trailblazers,J. Nicolds,4408086,,False,18.0,2,3,1,1,1,2,7,9,0,6,6,1,0,0,1,2,12
401371550,Utah Tech Trailblazers,T. Edmonds,4896871,,False,13.0,1,2,1,2,0,0,0,0,0,1,1,0,1,2,2,3,2
401371550,Utah Tech Trailblazers,A. Mulibea,4701246,,False,16.0,1,1,0,0,1,1,0,0,1,2,3,2,0,0,2,2,3
401371550,Utah Tech Trailblazers,N. Gonsalves,4896874,,False,21.0,1,3,0,0,1,3,2,3,0,2,2,0,1,0,5,0,5
401371550,Utah Tech Trailblazers,M. Hatch,4701253,,False,3.0,1,1,1,1,0,0,0,0,0,1,1,0,0,0,0,0,2
401371550,Utah Tech Trailblazers,E. Elniel,4701248,,False,1.0,0,0,0,0,0,0,0,0,0,0,0,1,0,0,0,0,0
401371550,Utah Tech Trailblazers,B. Gilbert,4701243,,False,6.0,0,1,0,0,0,1,1,2,0,0,0,1,1,0,4,0,1
401371550,Utah Tech Trailblazers,TEAM,TOTAL,TOTAL,False,,19,44,13,24,6,20,20,30,8,27,35,15,7,2,25,19,64
401371550,Abilene Christian Wildcats,C. Steele,4703600,,True,23.0,5,9,3,6,2,3,0,0,3,3,6,0,1,0,1,2,12
401371550,Abilene Christian Wildcats,A. Simmons,4433077,,True,19.0,3,10,3,8,0,2,5,6,2,3,5,2,6,1,2,5,11
401371550,Abilene Christian Wildcats,C. Mason,4593750,,True,16.0,0,5,0,2,0,3,5,6,1,0,1,3,0,0,0,2,5
401371550,Abilene Christian Wildcats,M. Morris,4593748,,True,30.0,6,11,4,7,2,4,4,4,1,5,6,3,2,0,2,3,18
401371550,Abilene Christian Wildcats,R. Miller,4593747,,True,27.0,1,2,1,1,0,1,0,1,2,1,3,3,4,0,1,2,2
401371550,Abilene Christian Wildcats,F. Cadeaux de Dieu,4896507,,False,6.0,1,3,1,3,0,0,0,0,0,2,2,0,0,0,1,1,2
401371550,Abilene Christian Wildcats,Y. Gai,4896508,,False,7.0,2,3,2,3,0,0,1,1,0,0,0,1,0,0,0,0,5
401371550,Abilene Christian Wildcats,S. Smith,4896506,,False,3.0,0,0,0,0,0,0,0,0,0,0,0,0,0,0,0,2,0
401371550,Abilene Christian Wildcats,J. Jackson,4896504,,False,15.0,2,6,1,4,1,2,0,0,0,1,1,1,1,0,0,1,5
401371550,Abilene Christian Wildcats,I. Allen,4593749,,False,14.0,4,8,4,7,0,1,2,2,3,1,4,0,1,0,2,4,10
401371550,Abilene Christian Wildcats,D. Daniels,4397957,,False,18.0,3,6,2,5,1,1,0,0,0,2,2,2,2,0,0,2,7
401371550,Abilene Christian Wildcats,T. Cameron,4278255,,False,22.0,1,5,1,3,0,2,1,2,1,1,2,2,1,0,2,2,3
401371550,Abilene Christian Wildcats,TEAM,TOTAL,TOTAL,False,,28,68,22,49,6,19,18,22,15,23,38,17,18,1,11,26,80
401371549,Stephen F. Austin Lumberjacks,C. Solomon,4594155,,True,20.0,2,6,2,6,0,0,4,5,0,1,1,1,2,2,1,5,8
401371549,Stephen F. Austin Lumberjacks,G. Kensmil,4279493,,True,28.0,7,10,7,10,0,0,1,5,2,4,6,3,3,0,2,2,15
401371549,Stephen F. Austin Lumberjacks,D. Tezeno,4896946,,True,17.0,2,6,1,3,1,3,0,0,1,2,3,1,1,0,1,2,5
401371549,Stephen F. Austin Lumberjacks,L. Jossell,4601284,,True,37.0,5,9,2,3,3,6,4,4,1,1,2,1,1,0,1,3,17
401371549,Stephen F. Austin Lumberjacks,D. Kachelries,4278450,,True,32.0,3,7,2,6,1,1,0,0,0,3,3,6,1,0,1,1,7
401371549,Stephen F. Austin Lumberjacks,S. Hall,4713935,,False,22.0,6,10,6,9,0,1,2,3,0,2,2,2,3,0,0,2,14
401371549,Stephen F. Austin Lumberjacks,N. Antwi-Boasiako,4703693,,False,11.0,2,3,1,1,1,2,0,0,1,0,1,0,0,0,1,1,5
401371549,Stephen F. Austin Lumberjacks,J. Jackson-Posey,4703691,,False,17.0,1,5,1,4,0,1,0,0,1,0,1,1,0,0,1,4,2
401371549,Stephen F. Austin Lumberjacks,N. Hawkins,4397862,,False,16.0,0,1,0,0,0,1,0,0,0,2,2,0,0,0,1,4,0
401371549,Stephen F. Austin Lumberjacks,TEAM,TOTAL,TOTAL,False,,28,57,22,42,6,15,11,17,10,16,26,15,11,2,9,24,73
401371549,New Mexico State Aggies,W. McNair Jr.,4396012,,True,27.0,5,6,4,4,1,2,0,2,1,2,3,1,0,1,1,4,11
401371549,New Mexico State Aggies,J. McCants,4067472,,True,37.0,6,8,4,4,2,4,6,11,4,6,10,1,0,6,3,3,20
401371549,New Mexico State Aggies,C. Henry,4396010,,True,24.0,0,2,0,1,0,1,0,0,0,4,4,1,0,0,2,2,0
401371549,New Mexico State Aggies,J. Rice,4280181,,True,36.0,0,6,0,1,0,5,4,4,3,1,4,3,0,0,4,1,4
401371549,New Mexico State Aggies,T. Allen,4277932,,True,23.0,4,8,3,5,1,3,2,2,0,3,3,2,1,0,4,4,11
401371549,New Mexico State Aggies,M. Peake,4572450,,False,10.0,2,4,1,3,1,1,2,2,1,2,3,0,0,0,0,1,7
401371549,New Mexico State Aggies,Y. Alok,4397070,,False,2.0,0,1,0,1,0,0,0,0,0,0,0,0,0,0,0,0,0
401371549,New Mexico State Aggies,D. Tillman,4278536,,False,4.0,0,0,0,0,0,0,0,0,0,1,1,0,0,0,0,0,0
401371549,New Mexico State Aggies,M. McKinney Jr.,4896928,,False,8.0,1,3,1,3,0,0,0,0,1,0,1,3,1,0,1,0,2
401371549,New Mexico State Aggies,N. Pryor,4702460,,False,24.0,2,4,2,4,0,0,0,3,0,1,1,4,0,0,2,2,4
401371549,New Mexico State Aggies,V. Cotton,4279307,,False,5.0,4,4,0,0,4,4,0,1,0,1,1,0,0,0,0,0,12
401371549,New Mexico State Aggies,TEAM,TOTAL,TOTAL,False,,24,46,15,26,9,20,14,25,12,22,34,15,2,7,18,17,71
401370121,Virginia Cavaliers,J. Gardner,4396614,,True,28.0,3,12,3,12,0,0,0,0,1,3,4,1,0,0,1,3,6
401370121,Virginia Cavaliers,F. Caffaro,4395679,,True,13.0,0,1,0,1,0,0,0,0,0,0,0,0,0,0,2,3,0
401370121,Virginia Cavaliers,R. Beekman,4432187,,True,39.0,6,9,3,6,3,3,0,0,0,12,12,5,5,1,1,2,15
401370121,Virginia Cavaliers,A. Franklin,4431744,,True,30.0,3,7,1,3,2,4,5,6,1,3,4,1,0,0,2,3,13
401370121,Virginia Cavaliers,K. Clark,4395677,,True,38.0,2,6,1,3,1,3,1,2,0,1,1,6,0,0,3,0,6
401370121,Virginia Cavaliers,K. Shedrick,4431710,,False,23.0,8,9,8,9,0,0,4,4,5,0,5,0,1,0,1,4,20
401370121,Virginia Cavaliers,K. Stattmann,4395680,,False,29.0,3,5,2,3,1,2,4,6,1,3,4,2,0,0,0,1,11
401370121,Virginia Cavaliers,TEAM,TOTAL,TOTAL,False,,25,49,18,37,7,12,14,18,8,24,32,15,6,1,10,16,71
401370121,Louisville Cardinals,S. Curry,4897146,,True,34.0,9,13,9,13,0,0,6,6,6,8,14,3,0,0,3,3,24
401370121,Louisville Cardinals,M. Williams,4277880,,True,34.0,4,10,2,6,2,4,0,0,2,5,7,1,1,0,0,3,10
401370121,Louisville Cardinals,N. Locke,4395713,,True,30.0,2,8,0,3,2,5,2,2,0,0,0,2,0,1,3,3,8
401370121,Louisville Cardinals,J. West,4279077,,True,31.0,2,8,0,2,2,6,0,0,1,2,3,0,1,0,2,1,6
401370121,Louisville Cardinals,M. Faulkner,4067444,,True,31.0,2,9,1,4,1,5,0,1,0,1,1,7,2,0,1,2,5
401370121,Louisville Cardinals,J. Traynor,4596711,,False,3.0,0,0,0,0,0,0,0,0,0,0,0,0,0,0,0,2,0
401370121,Louisville Cardinals,M. Cross,4433563,,False,4.0,0,0,0,0,0,0,0,0,0,0,0,0,0,0,0,0,0
401370121,Louisville Cardinals,S. Williamson,4431676,,False,3.0,0,0,0,0,0,0,1,2,0,0,0,0,0,0,0,0,1
401370121,Louisville Cardinals,R. Wheeler,4683744,,False,2.0,0,0,0,0,0,0,0,0,0,0,0,0,0,0,0,0,0
401370121,Louisville Cardinals,E. Ellis,4897145,,False,15.0,2,4,1,2,1,2,0,0,0,2,2,0,0,0,1,1,5
401370121,Louisville Cardinals,D. Davis,4701318,,False,13.0,1,3,1,2,0,1,0,1,1,0,1,0,0,0,1,1,2
401370121,Louisville Cardinals,TEAM,TOTAL,TOTAL,False,,22,55,14,32,8,23,9,12,12,18,30,13,4,1,12,16,61
401370072,Wake Forest Demon Deacons,D. Walton,4066353,,True,25.0,8,9,7,8,1,1,3,3,1,11,12,1,0,0,0,0,20
401370072,Wake Forest Demon Deacons,I. Mucius,4395686,,True,34.0,4,10,2,3,2,7,2,2,1,1,2,0,0,1,0,3,12
401370072,Wake Forest Demon Deacons,J. LaRavia,4592691,,True,25.0,2,6,2,4,0,2,4,4,1,1,2,5,0,1,1,4,8
401370072,Wake Forest Demon Deacons,A. Williams,4592216,,True,37.0,7,14,7,9,0,5,3,5,2,4,6,11,1,0,5,2,17
401370072,Wake Forest Demon Deacons,D. Williamson,4398180,,True,37.0,11,14,6,7,5,7,1,1,0,3,3,2,0,0,3,0,28
401370072,Wake Forest Demon Deacons,K. Sy,4065740,,False,15.0,3,6,3,4,0,2,0,0,1,7,8,1,1,1,0,4,6
401370072,Wake Forest Demon Deacons,M. Marsh,4897407,,False,2.0,0,0,0,0,0,0,0,0,0,1,1,0,0,0,0,0,0
401370072,Wake Forest Demon Deacons,A. Mathis Jr.,4701988,,False,1.0,0,1,0,0,0,1,0,0,0,0,0,0,0,0,0,0,0
401370072,Wake Forest Demon Deacons,L. Taylor,4698717,,False,2.0,0,0,0,0,0,0,0,0,0,0,0,0,0,0,0,0,0
401370072,Wake Forest Demon Deacons,C. Hildreth,4696316,,False,4.0,1,1,1,1,0,0,0,0,0,0,0,0,0,0,0,1,2
401370072,Wake Forest Demon Deacons,R. Mccray V,4685802,,False,2.0,1,1,1,1,0,0,0,0,1,0,1,0,0,1,1,0,2
401370072,Wake Forest Demon Deacons,D. Monsanto,4432916,,False,14.0,2,2,0,0,2,2,0,0,1,2,3,0,1,0,0,4,6
401370072,Wake Forest Demon Deacons,M. Lester,4279097,,False,2.0,0,0,0,0,0,0,0,0,0,2,2,0,0,0,0,0,0
401370072,Wake Forest Demon Deacons,TEAM,TOTAL,TOTAL,False,,39,64,29,37,10,27,13,15,9,33,42,20,3,4,10,18,101
401370072,NC State Wolfpack,E. Dowuona,4432447,,True,15.0,2,3,2,3,0,0,0,0,2,0,2,1,0,0,0,5,4
401370072,NC State Wolfpack,J. Hellems,4395661,,True,31.0,5,12,2,5,3,7,5,6,1,5,6,3,1,0,2,3,18
401370072,NC State Wolfpack,T. Smith,4683940,,True,38.0,6,18,1,8,5,10,5,9,1,2,3,4,1,2,2,1,22
401370072,NC State Wolfpack,D. Seabron,4431811,,True,38.0,2,8,2,8,0,0,1,2,1,2,3,1,0,0,0,0,5
401370072,NC State Wolfpack,C. Morsell,4431704,,True,30.0,3,10,1,6,2,4,2,2,4,3,7,0,3,0,1,2,10
401370072,NC State Wolfpack,J. Gibson,4576139,,False,23.0,5,6,5,6,0,0,0,0,0,3,3,0,1,0,0,5,10
401370072,NC State Wolfpack,C. Hayes,4701837,,False,13.0,1,2,0,0,1,2,0,0,0,1,1,0,0,0,3,2,3
401370072,NC State Wolfpack,B. Pass,4697269,,False,11.0,1,1,0,0,1,1,1,2,0,1,1,0,0,0,0,1,4
401370072,NC State Wolfpack,C. Graham,4592326,,False,1.0,0,2,0,1,0,1,0,0,0,0,0,0,0,0,0,0,0
401370072,NC State Wolfpack,TEAM,TOTAL,TOTAL,False,,25,62,13,37,12,25,14,21,10,17,27,9,6,2,8,19,76
401370035,Virginia Tech Hokies,K. Aluma,4280120,,True,26.0,5,9,4,7,1,2,0,0,3,1,4,1,1,2,1,1,11
401370035,Virginia Tech Hokies,J. Mutts,4278693,,True,33.0,5,7,5,6,0,1,4,6,2,8,10,6,0,2,3,1,14
401370035,Virginia Tech Hokies,H. Cattoor,4432954,,True,26.0,3,7,2,2,1,5,0,0,0,4,4,1,1,0,0,1,7
401370035,Virginia Tech Hokies,N. Alleyne,4432934,,True,31.0,3,6,1,2,2,4,1,2,0,3,3,1,4,0,1,3,9
401370035,Virginia Tech Hokies,S. Murphy,4280118,,True,22.0,2,8,0,3,2,5,2,2,1,1,2,2,0,0,1,0,8
401370035,Virginia Tech Hokies,L. Kidd,4701224,,False,1.0,1,1,1,1,0,0,0,0,1,0,1,0,0,0,0,0,2
401370035,Virginia Tech Hokies,J. Ojiako,4592425,,False,5.0,1,2,1,2,0,0,0,0,1,1,2,0,0,0,0,0,2
401370035,Virginia Tech Hokies,D. N'Guessan,4701984,,False,15.0,1,3,1,3,0,0,0,2,2,3,5,1,0,1,0,1,2
401370035,Virginia Tech Hokies,B. Varga,4897406,,False,1.0,0,1,0,0,0,1,0,0,0,0,0,0,0,0,0,1,0
401370035,Virginia Tech Hokies,C. Johnson,4897405,,False,1.0,0,1,0,1,0,0,0,0,0,0,0,0,1,0,0,0,0
401370035,Virginia Tech Hokies,S. Pedulla,4709131,,False,18.0,3,8,0,2,3,6,0,0,0,1,1,0,2,0,0,3,9
401370035,Virginia Tech Hokies,D. Maddox,4432257,,False,21.0,4,7,1,3,3,4,0,0,2,2,4,2,1,0,0,1,11
401370035,Virginia Tech Hokies,TEAM,TOTAL,TOTAL,False,,28,60,16,32,12,28,7,12,12,24,36,14,10,5,8,12,75
401370035,Louisville Cardinals,S. Curry,4897146,,True,33.0,8,12,8,12,0,0,2,5,3,8,11,3,0,1,5,2,18
401370035,Louisville Cardinals,J. Withers,4431740,,True,7.0,0,2,0,1,0,1,0,0,1,0,1,0,0,1,2,1,0
401370035,Louisville Cardinals,D. Davis,4701318,,True,11.0,0,2,0,1,0,1,0,0,0,0,0,0,1,0,4,1,0
401370035,Louisville Cardinals,E. Ellis,4897145,,True,31.0,3,9,0,2,3,7,0,0,0,0,0,1,0,0,2,0,9
401370035,Louisville Cardinals,J. West,4279077,,True,25.0,2,5,0,2,2,3,0,0,0,1,1,4,1,0,0,2,6
401370035,Louisville Cardinals,J. Traynor,4596711,,False,8.0,0,1,0,1,0,0,0,0,0,1,1,0,1,0,1,1,0
401370035,Louisville Cardinals,M. Cross,4433563,,False,22.0,2,7,1,4,1,3,0,0,2,3,5,1,1,1,1,4,5
401370035,Louisville Cardinals,S. Williamson,4431676,,False,10.0,2,2,2,2,0,0,0,0,0,1,1,1,0,0,0,0,4
401370035,Louisville Cardinals,R. Wheeler,4683744,,False,4.0,0,0,0,0,0,0,0,0,0,1,1,0,0,0,0,0,0
401370035,Louisville Cardinals,A. Myles-Devore,4701320,,False,1.0,0,0,0,0,0,0,0,0,0,0,0,0,0,1,1,0,0
401370035,Louisville Cardinals,B. Colbert,4701317,,False,1.0,0,0,0,0,0,0,1,2,0,0,0,0,0,0,0,0,1
401370035,Louisville Cardinals,N. Locke,4395713,,False,29.0,0,3,0,1,0,2,0,0,0,3,3,0,0,0,0,1,0
401370035,Louisville Cardinals,M. Faulkner,4067444,,False,18.0,0,4,0,2,0,2,0,0,0,2,2,1,1,0,1,1,0
401370035,Louisville Cardinals,TEAM,TOTAL,TOTAL,False,,17,47,11,28,6,19,3,7,7,21,28,11,5,4,18,13,43
401370016,Syracuse Orange,C. Swider,4397134,,True,39.0,2,9,0,4,2,5,0,0,1,6,7,3,0,0,4,1,6
401370016,Syracuse Orange,J. Boeheim,4279472,,True,40.0,4,16,4,14,0,2,6,6,4,5,9,2,1,0,0,3,14
401370016,Syracuse Orange,B. Sidibe,4278033,,True,15.0,2,3,2,3,0,0,0,0,2,4,6,0,1,0,1,3,4
401370016,Syracuse Orange,J. Girard III,4431746,,True,40.0,4,14,0,5,4,9,5,6,0,3,3,6,2,0,2,1,17
401370016,Syracuse Orange,B. Boeheim,4395676,,True,40.0,8,17,3,8,5,9,9,9,0,1,1,0,2,0,0,2,30
401370016,Syracuse Orange,J. Ajak,4592369,,False,1.0,0,1,0,1,0,0,0,0,0,0,0,0,0,0,1,2,0
401370016,Syracuse Orange,F. Anselem,4701842,,False,25.0,0,0,0,0,0,0,1,2,4,1,5,1,0,1,2,4,1
401370016,Syracuse Orange,TEAM,TOTAL,TOTAL,False,,20,60,9,35,11,25,21,23,14,22,36,12,6,1,11,16,72
401370016,Miami Hurricanes,S. Waardenburg,4079701,,True,33.0,1,4,1,2,0,2,1,2,0,5,5,4,1,1,2,1,3
401370016,Miami Hurricanes,I. Wong,4431727,,True,32.0,4,8,3,3,1,5,6,8,1,2,3,2,1,2,0,3,15
401370016,Miami Hurricanes,J. Miller,4396818,,True,34.0,10,13,10,13,0,0,5,5,4,9,13,1,2,1,4,2,25
401370016,Miami Hurricanes,C. Moore,4066345,,True,36.0,5,14,4,8,1,6,0,1,0,3,3,8,2,0,1,3,11
401370016,Miami Hurricanes,K. McGusty,4066310,,True,32.0,8,16,7,11,1,5,2,2,0,4,4,3,0,1,2,4,19
401370016,Miami Hurricanes,A. Walker,4592205,,False,12.0,0,0,0,0,0,0,0,0,0,1,1,1,0,1,0,2,0
401370016,Miami Hurricanes,D. Gak,4277891,,False,3.0,0,0,0,0,0,0,0,0,0,1,1,0,0,0,0,0,0
401370016,Miami Hurricanes,W. Poplar,4897397,,False,5.0,0,0,0,0,0,0,0,0,0,1,1,0,0,0,0,0,0
401370016,Miami Hurricanes,B. Joseph,4683753,,False,13.0,1,1,1,1,0,0,0,0,0,1,1,0,1,0,1,0,2
401370016,Miami Hurricanes,TEAM,TOTAL,TOTAL,False,,29,56,26,38,3,18,14,18,6,28,34,19,7,6,10,15,75
401369997,Pittsburgh Panthers,M. Gueye,4592933,,True,36.0,3,9,3,6,0,3,0,0,3,6,9,0,0,3,2,3,6
401369997,Pittsburgh Panthers,J. Hugley,4432897,,True,33.0,8,15,7,12,1,3,2,4,2,4,6,1,0,0,4,1,19
401369997,Pittsburgh Panthers,F. Odukale,4701839,,True,29.0,2,5,1,2,1,3,0,0,0,2,2,4,1,1,1,3,5
401369997,Pittsburgh Panthers,I. Horton,4397401,,True,33.0,3,10,2,7,1,3,0,0,1,0,1,3,1,1,1,0,7
401369997,Pittsburgh Panthers,J. Burton,4396677,,True,29.0,6,9,5,8,1,1,0,0,1,1,2,1,0,0,3,1,13
401369997,Pittsburgh Panthers,C. Payton,4897401,,False,2.0,0,0,0,0,0,0,0,0,0,0,0,1,0,0,0,0,0
401369997,Pittsburgh Panthers,N. Santos,4433585,,False,10.0,0,1,0,0,0,1,0,0,0,0,0,1,0,0,0,1,0
401369997,Pittsburgh Panthers,N. Collier,4432204,,False,7.0,1,2,1,2,0,0,0,0,2,0,2,0,0,0,1,0,2
401369997,Pittsburgh Panthers,W. Jeffress,4701841,,False,10.0,0,4,0,2,0,2,0,0,1,1,2,0,1,0,0,0,0
401369997,Pittsburgh Panthers,O. Ezeakudo,4409403,,False,11.0,1,2,0,0,1,2,1,2,0,1,1,1,1,0,0,0,4
401369997,Pittsburgh Panthers,TEAM,TOTAL,TOTAL,False,,24,57,19,39,5,18,3,6,10,17,27,12,4,5,13,9,56
401369997,Duke Blue Devils,P. Banchero,4432573,,True,33.0,7,10,4,7,3,3,4,6,0,1,1,3,0,0,3,3,21
401369997,Duke Blue Devils,W. Moore Jr.,4592187,,True,27.0,4,6,3,4,1,2,4,4,1,5,6,5,1,0,1,1,13
401369997,Duke Blue Devils,M. Williams,4701232,,True,21.0,1,4,1,4,0,0,0,0,0,2,2,0,0,2,0,1,2
401369997,Duke Blue Devils,AJ Griffin,4432585,,True,26.0,5,7,4,4,1,3,1,1,1,6,7,1,2,1,0,0,12
401369997,Duke Blue Devils,T. Keels,4432645,,True,34.0,10,15,5,7,5,8,2,2,1,2,3,2,1,0,0,0,27
401369997,Duke Blue Devils,K. Worthington,4592189,,False,2.0,0,0,0,0,0,0,0,0,0,0,0,0,0,0,0,0,0
401369997,Duke Blue Devils,T. John,4278569,,False,13.0,1,2,1,2,0,0,0,0,0,3,3,0,1,1,0,4,2
401369997,Duke Blue Devils,B. Jones,4278348,,False,4.0,0,0,0,0,0,0,0,0,0,0,0,0,0,0,1,0,0
401369997,Duke Blue Devils,J. Baker,4395624,,False,10.0,2,3,1,1,1,2,0,0,0,0,0,0,0,0,1,2,5
401369997,Duke Blue Devils,J. Blakes,4683735,,False,4.0,0,1,0,0,0,1,0,0,0,1,1,0,0,0,0,0,0
401369997,Duke Blue Devils,M. Savarino,4592188,,False,2.0,0,0,0,0,0,0,0,0,0,1,1,0,0,0,0,0,0
401369997,Duke Blue Devils,J. Roach,4433135,,False,24.0,2,6,2,3,0,3,0,0,0,1,1,3,0,0,0,1,4
401369997,Duke Blue Devils,TEAM,TOTAL,TOTAL,False,,32,54,21,32,11,22,11,13,5,22,27,14,5,4,6,12,86
401369978,Pittsburgh Panthers,M. Gueye,4592933,,True,30.0,6,12,5,8,1,4,0,0,2,6,8,0,1,3,1,2,13
401369978,Pittsburgh Panthers,J. Hugley,4432897,,True,14.0,5,8,5,8,0,0,3,5,1,2,3,0,1,0,1,2,13
401369978,Pittsburgh Panthers,O. Ezeakudo,4409403,,True,27.0,0,5,0,1,0,4,0,0,2,1,3,3,2,0,1,1,0
401369978,Pittsburgh Panthers,I. Horton,4397401,,True,26.0,2,9,1,3,1,6,0,0,0,1,1,1,0,0,0,2,5
401369978,Pittsburgh Panthers,J. Burton,4396677,,True,27.0,2,9,2,6,0,3,2,2,0,0,0,4,0,0,2,3,6
401369978,Pittsburgh Panthers,A. Fisch,4701840,,False,1.0,0,1,0,1,0,0,0,0,0,0,0,0,0,0,0,1,0
401369978,Pittsburgh Panthers,N. Santos,4433585,,False,21.0,3,6,2,2,1,4,0,0,0,2,2,0,0,0,0,0,7
401369978,Pittsburgh Panthers,N. Collier,4432204,,False,23.0,2,4,2,4,0,0,0,0,1,2,3,0,1,0,0,3,4
401369978,Pittsburgh Panthers,W. Jeffress,4701841,,False,3.0,0,1,0,0,0,1,0,0,0,0,0,0,0,0,0,0,0
401369978,Pittsburgh Panthers,M. Amadasun,4592247,,False,2.0,0,1,0,0,0,1,0,0,1,0,1,0,0,0,0,1,0
401369978,Pittsburgh Panthers,F. Odukale,4701839,,False,26.0,3,8,3,5,0,3,0,0,2,3,5,2,1,0,0,1,6
401369978,Pittsburgh Panthers,TEAM,TOTAL,TOTAL,False,,23,64,20,38,3,26,5,7,9,18,27,10,6,3,5,16,54
401369978,Notre Dame Fighting Irish,N. Laszewski,4395665,,True,29.0,6,7,3,4,3,3,2,2,0,9,9,0,0,1,3,2,17
401369978,Notre Dame Fighting Irish,P. Atkinson Jr.,4279699,,True,25.0,5,6,5,6,0,0,0,0,0,2,2,5,0,0,5,3,10
401369978,Notre Dame Fighting Irish,C. Ryan,4397114,,True,32.0,5,9,0,2,5,7,0,0,1,5,6,3,0,1,0,2,15
401369978,Notre Dame Fighting Irish,D. Goodwin,4395667,,True,32.0,4,9,2,4,2,5,0,0,1,5,6,2,0,0,1,0,10
401369978,Notre Dame Fighting Irish,P. Hubb,4395664,,True,26.0,2,5,1,2,1,3,0,0,0,1,1,6,1,0,2,0,5
401369978,Notre Dame Fighting Irish,M. Zona,4433574,,False,3.0,0,1,0,1,0,0,1,2,1,2,3,0,0,0,0,0,1
401369978,Notre Dame Fighting Irish,T. Sanders Jr.,4701838,,False,3.0,0,1,0,0,0,1,3,4,0,0,0,0,0,0,0,0,3
401369978,Notre Dame Fighting Irish,B. Wesley,4683935,,False,26.0,3,7,2,4,1,3,4,6,0,4,4,4,0,0,0,0,11
401369978,Notre Dame Fighting Irish,E. Morgan,4592343,,False,3.0,0,0,0,0,0,0,0,0,0,0,0,1,1,0,0,0,0
401369978,Notre Dame Fighting Irish,J. Konieczny,4575837,,False,3.0,1,1,0,0,1,1,0,0,0,1,1,0,0,0,0,0,3
401369978,Notre Dame Fighting Irish,T. Wertz,4397753,,False,17.0,1,2,0,1,1,1,0,0,0,1,1,0,0,0,1,2,3
401369978,Notre Dame Fighting Irish,R. Carmody,4395668,,False,0.0,0,0,0,0,0,0,0,0,0,0,0,0,0,0,0,0,0
401369978,Notre Dame Fighting Irish,TEAM,TOTAL,TOTAL,False,,27,48,13,24,14,24,10,14,4,31,35,21,2,2,13,9,78
401369942,Virginia Tech Hokies,K. Aluma,4280120,,True,36.0,3,8,2,5,1,3,0,0,0,8,8,3,1,2,3,2,7
401369942,Virginia Tech Hokies,J. Mutts,4278693,,True,26.0,4,8,3,5,1,3,6,7,4,5,9,1,0,0,5,3,15
401369942,Virginia Tech Hokies,H. Cattoor,4432954,,True,31.0,1,6,0,1,1,5,0,0,0,2,2,2,0,0,1,3,3
401369942,Virginia Tech Hokies,N. Alleyne,4432934,,True,31.0,6,13,1,3,5,10,0,0,1,4,5,0,2,0,0,0,17
401369942,Virginia Tech Hokies,S. Murphy,4280118,,True,17.0,2,4,2,2,0,2,0,0,0,1,1,1,0,0,1,2,4
401369942,Virginia Tech Hokies,D. N'Guessan,4701984,,False,17.0,0,3,0,1,0,2,0,0,2,0,2,1,0,2,1,1,0
401369942,Virginia Tech Hokies,S. Pedulla,4709131,,False,23.0,1,6,1,3,0,3,6,6,0,0,0,1,1,0,1,3,8
401369942,Virginia Tech Hokies,D. Maddox,4432257,,False,19.0,2,3,1,1,1,2,0,0,1,1,2,0,1,0,1,2,5
401369942,Virginia Tech Hokies,TEAM,TOTAL,TOTAL,False,,19,51,10,21,9,30,12,13,9,22,31,9,5,4,13,16,59
401369942,Clemson Tigers,B. Middlebrooks,4684998,,True,15.0,0,1,0,1,0,0,0,0,0,2,2,0,0,0,1,1,0
401369942,Clemson Tigers,H. Tyson,4395620,,True,25.0,2,7,1,4,1,3,0,0,0,4,4,2,1,0,0,1,5
401369942,Clemson Tigers,C. Hunter,4592184,,True,27.0,0,4,0,1,0,3,1,2,0,3,3,2,1,0,2,2,1
401369942,Clemson Tigers,N. Honor,4396810,,True,25.0,1,4,1,1,0,3,4,4,0,2,2,1,2,0,2,3,6
401369942,Clemson Tigers,D. Collins,4278306,,True,30.0,4,5,2,3,2,2,0,0,0,1,1,1,1,0,0,4,10
401369942,Clemson Tigers,I. Schieffelin,4693954,,False,10.0,1,3,1,3,0,0,2,2,2,2,4,4,0,1,1,0,4
401369942,Clemson Tigers,N. Bohannon,4285366,,False,12.0,2,5,2,5,0,0,0,0,0,0,0,0,0,0,0,1,4
401369942,Clemson Tigers,PJ Hall,4701225,,False,14.0,5,9,5,9,0,0,2,2,1,3,4,0,2,0,5,4,12
401369942,Clemson Tigers,A. Hemenway,4433001,,False,16.0,4,4,1,1,3,3,0,1,1,1,2,0,0,0,0,0,11
401369942,Clemson Tigers,A. Dawes,4431730,,False,26.0,2,6,0,0,2,6,4,5,0,3,3,3,1,0,1,0,10
401369942,Clemson Tigers,TEAM,TOTAL,TOTAL,False,,21,48,13,28,8,20,13,16,6,23,29,13,8,1,12,16,63
401369941,Georgia Tech Yellow Jackets,R. Howard,4433010,,True,34.0,4,7,4,7,0,0,3,5,3,1,4,3,0,0,4,3,11
401369941,Georgia Tech Yellow Jackets,J. Usher,4278532,,True,32.0,3,10,2,7,1,3,2,2,0,5,5,2,0,0,4,3,9
401369941,Georgia Tech Yellow Jackets,D. Coleman,4433595,,True,35.0,3,5,2,2,1,3,1,1,0,2,2,1,0,0,0,0,8
401369941,Georgia Tech Yellow Jackets,K. Sturdivant,4431774,,True,37.0,5,13,3,5,2,8,0,0,0,4,4,5,4,0,2,1,12
401369941,Georgia Tech Yellow Jackets,M. Devoe,4395631,,True,38.0,6,10,4,6,2,4,1,2,0,7,7,2,1,0,1,3,15
401369941,Georgia Tech Yellow Jackets,K. Moore,4395632,,False,14.0,2,7,2,5,0,2,1,1,1,1,2,1,0,1,1,2,5
401369941,Georgia Tech Yellow Jackets,M. Kelly,4696317,,False,10.0,2,4,1,2,1,2,0,0,2,3,5,1,0,0,0,0,5
401369941,Georgia Tech Yellow Jackets,TEAM,TOTAL,TOTAL,False,,25,56,18,34,7,22,8,11,7,24,31,15,5,1,12,12,65
401369941,Clemson Tigers,B. Middlebrooks,4684998,,True,15.0,2,3,2,3,0,0,1,2,0,1,1,2,2,2,1,1,5
401369941,Clemson Tigers,I. Schieffelin,4693954,,True,24.0,3,7,3,7,0,0,0,0,1,5,6,1,0,1,3,1,6
401369941,Clemson Tigers,C. Hunter,4592184,,True,32.0,1,5,0,3,1,2,2,2,0,4,4,4,1,1,2,1,5
401369941,Clemson Tigers,N. Honor,4396810,,True,14.0,2,4,1,1,1,3,0,0,0,0,0,1,0,0,0,0,5
401369941,Clemson Tigers,D. Collins,4278306,,True,37.0,8,10,7,7,1,3,2,2,1,6,7,4,2,1,2,1,19
401369941,Clemson Tigers,H. Tyson,4395620,,False,18.0,4,6,4,4,0,2,0,0,0,2,2,0,1,0,1,3,8
401369941,Clemson Tigers,N. Bohannon,4285366,,False,19.0,4,5,4,5,0,0,1,1,0,3,3,1,0,0,2,2,9
401369941,Clemson Tigers,A. Hemenway,4433001,,False,13.0,1,3,0,0,1,3,0,0,0,1,1,0,0,0,0,2,3
401369941,Clemson Tigers,A. Dawes,4431730,,False,28.0,3,10,1,2,2,8,0,0,0,2,2,0,2,0,1,0,8
401369941,Clemson Tigers,TEAM,TOTAL,TOTAL,False,,28,53,22,32,6,21,6,7,2,26,28,13,8,5,13,11,68
401369924,Miami Hurricanes,S. Waardenburg,4079701,,True,33.0,5,7,2,2,3,5,3,3,0,5,5,4,2,0,1,2,16
401369924,Miami Hurricanes,I. Wong,4431727,,True,35.0,9,16,4,7,5,9,4,4,2,5,7,1,2,0,1,1,27
401369924,Miami Hurricanes,J. Miller,4396818,,True,32.0,8,10,8,10,0,0,2,3,3,3,6,1,1,0,0,2,18
401369924,Miami Hurricanes,C. Moore,4066345,,True,34.0,4,8,4,7,0,1,0,0,1,0,1,5,1,0,3,1,8
401369924,Miami Hurricanes,K. McGusty,4066310,,True,27.0,4,9,2,4,2,5,0,0,0,0,0,4,2,0,2,4,10
401369924,Miami Hurricanes,A. Walker,4592205,,False,14.0,0,0,0,0,0,0,0,2,0,0,0,0,1,0,1,1,0
401369924,Miami Hurricanes,R. Miller Jr.,4065671,,False,1.0,0,0,0,0,0,0,0,0,0,0,0,0,0,0,0,0,0
401369924,Miami Hurricanes,W. Poplar,4897397,,False,5.0,0,1,0,1,0,0,0,0,0,0,0,0,0,0,0,0,0
401369924,Miami Hurricanes,B. Joseph,4683753,,False,19.0,1,4,1,3,0,1,0,0,0,6,6,0,0,1,2,1,2
401369924,Miami Hurricanes,TEAM,TOTAL,TOTAL,False,,31,55,21,34,10,21,9,12,7,21,28,15,9,1,10,12,81
401369924,Boston College Eagles,J. Karnik,4280080,,True,31.0,5,6,5,5,0,1,3,4,4,3,7,3,0,0,1,1,13
401369924,Boston College Eagles,Q. Post,4593016,,True,25.0,5,6,5,5,0,1,0,0,2,4,6,1,0,1,2,2,10
401369924,Boston College Eagles,J. Zackery,4896615,,True,29.0,3,8,2,6,1,2,0,0,0,3,3,2,2,0,2,3,7
401369924,Boston College Eagles,D. Langford Jr.,4433165,,True,32.0,2,7,2,7,0,0,2,4,2,2,4,4,0,0,3,0,6
401369924,Boston College Eagles,M. Ashton-Langford,4278574,,True,37.0,8,15,5,9,3,6,2,4,0,4,4,1,2,0,1,2,21
401369924,Boston College Eagles,G. Thompson,4684304,,False,11.0,1,4,1,2,0,2,0,0,1,0,1,0,0,1,1,0,2
401369924,Boston College Eagles,K. Jones,4791225,,False,8.0,0,1,0,1,0,0,0,0,0,1,1,0,0,0,1,0,0
401369924,Boston College Eagles,B. Galloway,4067219,,False,27.0,4,9,2,4,2,5,1,2,0,1,1,3,0,0,1,1,11
401369924,Boston College Eagles,TEAM,TOTAL,TOTAL,False,,28,56,22,39,6,17,8,14,10,18,28,14,4,2,12,9,70
401369908,Georgia Tech Yellow Jackets,R. Howard,4433010,,True,33.0,1,2,1,2,0,0,0,1,1,2,3,3,1,0,3,4,2
401369908,Georgia Tech Yellow Jackets,K. Moore,4395632,,True,28.0,2,3,2,2,0,1,0,2,0,2,2,1,1,0,2,5,4
401369908,Georgia Tech Yellow Jackets,J. Usher,4278532,,True,37.0,12,16,10,12,2,4,4,6,3,5,8,5,1,1,2,2,30
401369908,Georgia Tech Yellow Jackets,K. Sturdivant,4431774,,True,38.0,2,8,1,5,1,3,2,2,1,2,3,3,0,0,2,3,7
401369908,Georgia Tech Yellow Jackets,M. Devoe,4395631,,True,32.0,7,13,5,7,2,6,2,5,0,8,8,2,1,0,3,4,18
401369908,Georgia Tech Yellow Jackets,J. Moore,4701819,,False,6.0,1,1,0,0,1,1,0,0,0,1,1,0,0,0,1,1,3
401369908,Georgia Tech Yellow Jackets,M. Kelly,4696317,,False,34.0,4,8,1,3,3,5,5,6,0,3,3,2,2,1,0,2,16
401369908,Georgia Tech Yellow Jackets,D. Coleman,4433595,,False,17.0,1,2,1,1,0,1,0,0,0,0,0,0,1,0,1,3,2
401369908,Georgia Tech Yellow Jackets,TEAM,TOTAL,TOTAL,False,,30,53,21,32,9,21,13,22,5,26,31,16,7,2,15,24,82
401369908,Boston College Eagles,J. Karnik,4280080,,True,33.0,5,10,5,10,0,0,6,7,2,2,4,1,2,0,3,5,16
401369908,Boston College Eagles,Q. Post,4593016,,True,21.0,3,8,3,8,0,0,0,2,1,2,3,1,0,0,1,0,6
401369908,Boston College Eagles,J. Zackery,4896615,,True,43.0,6,9,3,4,3,5,4,4,1,3,4,3,2,0,2,2,19
401369908,Boston College Eagles,D. Langford Jr.,4433165,,True,43.0,7,13,7,13,0,0,3,3,3,5,8,2,0,1,3,0,17
401369908,Boston College Eagles,M. Ashton-Langford,4278574,,True,43.0,3,9,1,3,2,6,3,4,2,5,7,4,2,2,1,3,11
401369908,Boston College Eagles,T.J. Bickerstaff,4592778,,False,4.0,1,1,1,1,0,0,0,1,0,0,0,0,0,0,1,1,2
401369908,Boston College Eagles,K. Jones,4791225,,False,1.0,0,0,0,0,0,0,1,2,0,0,0,0,0,0,0,2,1
401369908,Boston College Eagles,B. Galloway,4067219,,False,36.0,1,9,0,1,1,8,3,4,0,6,6,7,3,0,2,5,6
401369908,Boston College Eagles,TEAM,TOTAL,TOTAL,False,,26,59,20,40,6,19,20,27,10,23,33,18,9,3,14,18,78
401369888,NC State Wolfpack,E. Dowuona,4432447,,True,12.0,1,2,1,2,0,0,0,0,2,1,3,0,0,0,1,3,2
401369888,NC State Wolfpack,J. Hellems,4395661,,True,40.0,7,14,2,5,5,9,2,2,0,7,7,0,0,2,2,4,21
401369888,NC State Wolfpack,T. Smith,4683940,,True,40.0,11,23,6,13,5,10,3,5,2,1,3,0,0,0,0,2,30
401369888,NC State Wolfpack,D. Seabron,4431811,,True,36.0,3,12,2,10,1,2,10,12,0,4,4,5,1,0,2,0,17
401369888,NC State Wolfpack,C. Morsell,4431704,,True,27.0,0,5,0,1,0,4,2,2,0,2,2,0,2,0,1,3,2
401369888,NC State Wolfpack,J. Gibson,4576139,,False,28.0,1,1,1,1,0,0,1,3,5,3,8,1,0,0,1,3,3
401369888,NC State Wolfpack,C. Hayes,4701837,,False,17.0,0,2,0,2,0,0,1,2,0,1,1,0,0,1,1,0,1
401369888,NC State Wolfpack,TEAM,TOTAL,TOTAL,False,,23,59,12,34,11,25,19,26,11,21,32,6,3,3,8,15,76
401369888,Florida State Seminoles,T. Ngom,4701240,,True,16.0,2,7,2,6,0,1,6,6,4,3,7,0,0,2,2,4,10
401369888,Florida State Seminoles,W. Wilkes,4277855,,True,15.0,3,7,2,2,1,5,0,0,0,2,2,1,0,0,0,0,7
401369888,Florida State Seminoles,R. Evans,4592190,,True,28.0,2,3,1,2,1,1,0,0,0,5,5,10,1,1,2,1,5
401369888,Florida State Seminoles,J. Lindner,4277853,,True,3.0,0,0,0,0,0,0,0,0,0,0,0,0,0,0,0,0,0
401369888,Florida State Seminoles,A. Polite,4277852,,True,26.0,5,11,3,5,2,6,2,4,3,7,10,3,2,0,0,2,14
401369888,Florida State Seminoles,J. Butler,4432588,,False,29.0,3,8,1,3,2,5,3,4,0,3,3,1,0,3,0,3,11
401369888,Florida State Seminoles,H. Prieto,4277856,,False,17.0,3,4,2,3,1,1,0,0,2,3,5,0,0,0,0,3,7
401369888,Florida State Seminoles,Q. Ballard,4683134,,False,3.0,0,0,0,0,0,0,0,0,0,0,0,0,0,0,0,1,0
401369888,Florida State Seminoles,M. Cleveland,4897007,,False,28.0,5,9,5,9,0,0,1,2,0,2,2,1,1,2,2,2,11
401369888,Florida State Seminoles,J. Warley,4683147,,False,17.0,2,5,1,2,1,3,0,0,1,0,1,3,2,1,0,4,5
401369888,Florida State Seminoles,C. Mills,4412211,,False,18.0,7,8,7,8,0,0,5,5,0,3,3,2,0,0,2,0,19
401369888,Florida State Seminoles,TEAM,TOTAL,TOTAL,False,,32,62,24,40,8,22,17,21,10,29,39,21,6,9,8,20,89
401369887,Notre Dame Fighting Irish,P. Atkinson Jr.,4279699,,True,30.0,7,13,7,13,0,0,3,5,6,4,10,1,0,0,1,2,17
401369887,Notre Dame Fighting Irish,B. Wesley,4683935,,True,34.0,10,21,10,18,0,3,1,2,2,4,6,1,2,0,5,4,21
401369887,Notre Dame Fighting Irish,C. Ryan,4397114,,True,29.0,2,5,2,3,0,2,0,0,0,6,6,3,1,0,0,1,4
401369887,Notre Dame Fighting Irish,D. Goodwin,4395667,,True,27.0,3,10,3,8,0,2,0,0,1,3,4,0,0,0,0,1,6
401369887,Notre Dame Fighting Irish,P. Hubb,4395664,,True,34.0,4,12,3,6,1,6,1,2,1,6,7,3,0,0,1,2,10
401369887,Notre Dame Fighting Irish,N. Laszewski,4395665,,False,28.0,3,5,0,1,3,4,0,0,0,1,1,0,0,0,1,0,9
401369887,Notre Dame Fighting Irish,T. Wertz,4397753,,False,18.0,1,3,0,1,1,2,0,0,0,1,1,2,0,0,0,0,3
401369887,Notre Dame Fighting Irish,TEAM,TOTAL,TOTAL,False,,30,69,25,50,5,19,5,9,12,26,38,10,3,0,8,10,70
401369887,Florida State Seminoles,J. Butler,4432588,,True,28.0,6,11,2,6,4,5,0,2,2,6,8,0,1,4,1,1,16
401369887,Florida State Seminoles,T. Ngom,4701240,,True,20.0,5,8,5,6,0,2,2,2,3,2,5,1,1,1,2,2,12
401369887,Florida State Seminoles,W. Wilkes,4277855,,True,25.0,2,7,0,0,2,7,0,0,0,4,4,4,0,2,1,1,6
401369887,Florida State Seminoles,R. Evans,4592190,,True,34.0,4,14,2,10,2,4,2,2,0,7,7,5,2,0,1,0,12
401369887,Florida State Seminoles,A. Polite,4277852,,True,25.0,4,10,2,6,2,4,2,2,1,2,3,2,1,0,0,0,12
401369887,Florida State Seminoles,H. Prieto,4277856,,False,19.0,3,5,2,2,1,3,0,0,0,1,1,0,0,0,0,2,7
401369887,Florida State Seminoles,C. Fletcher,4432182,,False,22.0,4,8,3,6,1,2,0,0,2,3,5,0,0,0,2,2,9
401369887,Florida State Seminoles,J. Warley,4683147,,False,27.0,0,5,0,3,0,2,0,0,1,4,5,4,2,1,2,2,0
401369887,Florida State Seminoles,TEAM,TOTAL,TOTAL,False,,28,68,16,39,12,29,6,8,12,30,42,16,7,8,9,10,74
401369869,North Carolina Tar Heels,A. Bacot,4431674,,True,30.0,10,11,10,11,0,0,3,4,1,6,7,0,2,2,1,2,23
401369869,North Carolina Tar Heels,B. Manek,4277902,,True,40.0,7,16,2,6,5,10,1,2,1,10,11,3,1,1,1,2,20
401369869,North Carolina Tar Heels,L. Black,4395650,,True,38.0,2,6,2,5,0,1,2,2,3,2,5,3,1,0,0,3,6
401369869,North Carolina Tar Heels,R.J. Davis,4433176,,True,40.0,9,16,7,12,2,4,1,2,1,4,5,4,2,1,2,2,21
401369869,North Carolina Tar Heels,C. Love,4433144,,True,38.0,4,17,2,10,2,7,12,12,0,5,5,5,1,0,1,2,22
401369869,North Carolina Tar Heels,J. McKoy,4432058,,False,4.0,0,0,0,0,0,0,0,0,0,0,0,0,0,0,0,0,0
401369869,North Carolina Tar Heels,P. Johnson,4701846,,False,5.0,1,2,1,1,0,1,0,0,0,0,0,0,0,0,0,3,2
401369869,North Carolina Tar Heels,D. Dunn,4683638,,False,1.0,0,0,0,0,0,0,0,0,0,0,0,0,0,0,0,0,0
401369869,North Carolina Tar Heels,D. Styles,4611413,,False,4.0,0,0,0,0,0,0,0,0,0,1,1,0,0,0,0,0,0
401369869,North Carolina Tar Heels,TEAM,TOTAL,TOTAL,False,,33,68,24,45,9,23,19,22,8,29,37,15,7,4,5,14,94
401369869,Duke Blue Devils,P. Banchero,4432573,,True,38.0,11,26,10,21,1,5,0,1,3,2,5,5,0,0,4,2,23
401369869,Duke Blue Devils,W. Moore Jr.,4592187,,True,35.0,3,8,1,5,2,3,0,0,0,5,5,7,1,0,2,2,8
401369869,Duke Blue Devils,M. Williams,4701232,,True,26.0,8,11,8,11,0,0,0,0,3,10,13,0,0,0,1,2,16
401369869,Duke Blue Devils,AJ Griffin,4432585,,True,34.0,2,5,1,2,1,3,0,0,0,3,3,0,1,2,0,1,5
401369869,Duke Blue Devils,T. Keels,4432645,,True,36.0,4,12,2,5,2,7,2,3,0,3,3,2,0,0,0,0,12
401369869,Duke Blue Devils,T. John,4278569,,False,10.0,1,1,1,1,0,0,0,0,0,2,2,1,1,2,0,3,2
401369869,Duke Blue Devils,J. Roach,4433135,,False,21.0,5,6,4,5,1,1,4,4,0,0,0,0,0,0,2,4,15
401369869,Duke Blue Devils,TEAM,TOTAL,TOTAL,False,,34,69,27,50,7,19,6,8,8,26,34,15,3,4,9,14,81
401369776,Princeton Tigers,T. Evbuomwan,4597865,,True,32.0,9,14,9,14,0,0,5,9,1,7,8,7,0,0,0,0,23
401369776,Princeton Tigers,D. Friberg,4398004,,True,35.0,6,10,1,2,5,8,1,1,0,3,3,0,2,0,1,3,18
401369776,Princeton Tigers,M. Allocco,4898232,,True,34.0,5,8,3,5,2,3,0,1,0,2,2,3,0,0,0,0,12
401369776,Princeton Tigers,E. Wright,4398005,,True,23.0,2,5,1,2,1,3,0,0,2,1,3,1,0,1,1,3,5
401369776,Princeton Tigers,J. Llewellyn,4398002,,True,35.0,10,18,6,9,4,9,0,1,0,3,3,1,1,0,0,1,24
401369776,Princeton Tigers,M. Hooks,4898235,,False,1.0,0,0,0,0,0,0,0,0,0,0,0,0,0,0,0,0,0
401369776,Princeton Tigers,K. Kellman,4597867,,False,2.0,1,2,1,2,0,0,0,0,0,1,1,0,0,0,0,0,2
401369776,Princeton Tigers,E. Barnes,4279567,,False,8.0,1,3,1,2,0,1,1,1,1,1,2,0,0,1,0,1,3
401369776,Princeton Tigers,Z. Martini,4898236,,False,2.0,0,0,0,0,0,0,0,0,0,1,1,0,0,0,0,0,0
401369776,Princeton Tigers,B. Peters,4898233,,False,6.0,1,1,1,1,0,0,0,0,1,0,1,0,0,0,0,1,2
401369776,Princeton Tigers,M. Johns,4398003,,False,20.0,2,5,2,4,0,1,0,1,0,4,4,0,1,0,0,2,4
401369776,Princeton Tigers,C. Bagin,4279564,,False,2.0,0,1,0,0,0,1,0,0,0,0,0,1,0,0,0,0,0
401369776,Princeton Tigers,TEAM,TOTAL,TOTAL,False,,37,67,25,41,12,26,7,14,9,24,33,13,4,2,2,11,93
401369776,Pennsylvania Quakers,M. Martz,4593353,,True,35.0,2,8,1,4,1,4,0,0,2,3,5,0,0,0,0,2,5
401369776,Pennsylvania Quakers,J. Dingle,4593351,,True,36.0,14,25,14,17,0,8,3,4,0,1,1,3,0,1,0,0,31
401369776,Pennsylvania Quakers,G. Ryan,4397984,,True,5.0,0,2,0,2,0,0,0,0,0,0,0,0,0,0,0,1,0
401369776,Pennsylvania Quakers,B. Washington,4397982,,True,37.0,4,7,2,4,2,3,0,0,0,2,2,0,0,1,2,2,10
401369776,Pennsylvania Quakers,J. Williams,4279561,,True,0.0,0,0,0,0,0,0,0,0,0,0,0,0,0,0,0,0,0
401369776,Pennsylvania Quakers,M. Moshkovitz,4702956,,False,15.0,3,5,3,5,0,0,0,0,1,5,6,3,1,0,1,5,6
401369776,Pennsylvania Quakers,L. Monroe,4593352,,False,22.0,1,4,1,4,0,0,0,0,5,9,14,3,0,1,2,4,2
401369776,Pennsylvania Quakers,A. Laczkowski,4702957,,False,2.0,1,1,0,0,1,1,0,0,0,1,1,0,0,0,0,0,3
401369776,Pennsylvania Quakers,C. Slajchert,4702954,,False,35.0,6,13,6,11,0,2,0,0,1,4,5,1,1,0,2,2,12
401369776,Pennsylvania Quakers,J. Charles,4593350,,False,13.0,0,1,0,0,0,1,1,2,0,0,0,0,0,0,1,1,1
401369776,Pennsylvania Quakers,TEAM,TOTAL,TOTAL,False,,31,66,27,47,4,19,4,6,12,27,39,10,2,3,8,17,70
401369775,Harvard Crimson,K. Catchings,4397971,,True,27.0,4,8,2,3,2,5,1,2,4,3,7,0,0,0,5,4,11
401369775,Harvard Crimson,M. Forbes,4397970,,True,22.0,1,4,1,4,0,0,3,6,2,1,3,0,0,0,1,4,5
401369775,Harvard Crimson,L. Sakota,4593336,,True,28.0,1,9,1,5,0,4,0,0,0,3,3,1,0,0,0,0,2
401369775,Harvard Crimson,S. Freedman,4397969,,True,14.0,2,7,1,2,1,5,0,0,1,1,2,0,0,0,1,2,5
401369775,Harvard Crimson,N. Kirkwood,4397968,,True,36.0,8,11,5,7,3,4,0,0,1,3,4,3,0,1,6,3,19
401369775,Harvard Crimson,J. Hemmings,4702959,,False,5.0,0,0,0,0,0,0,0,0,1,4,5,0,0,0,1,0,0
401369775,Harvard Crimson,T. O'Neil,4432067,,False,1.0,0,0,0,0,0,0,0,0,0,0,0,0,0,0,0,0,0
401369775,Harvard Crimson,J. Ajogbor,4702962,,False,1.0,0,1,0,1,0,0,2,2,0,0,0,0,0,0,0,0,2
401369775,Harvard Crimson,L. Lesmond,4898222,,False,25.0,2,6,1,1,1,5,0,0,0,2,2,0,0,0,2,2,5
401369775,Harvard Crimson,S. Silverstein,4702961,,False,5.0,0,0,0,0,0,0,0,0,0,0,0,0,0,0,1,2,0
401369775,Harvard Crimson,E. Nelson,4702960,,False,25.0,1,8,1,5,0,3,1,2,0,1,1,1,0,0,1,2,3
401369775,Harvard Crimson,T. Simon,4683939,,False,2.0,0,0,0,0,0,0,0,0,0,2,2,0,0,0,0,0,0
401369775,Harvard Crimson,D. Wojcik,4610138,,False,9.0,1,2,1,2,0,0,0,0,0,0,0,0,0,0,0,1,2
401369775,Harvard Crimson,TEAM,TOTAL,TOTAL,False,,20,56,13,30,7,26,7,12,9,25,34,5,0,1,18,20,54
401369775,Dartmouth Big Green,D. Adelekun,4702963,,True,13.0,5,8,5,8,0,0,2,3,4,4,8,0,0,0,2,4,12
401369775,Dartmouth Big Green,G. Wade,4397962,,True,29.0,3,7,2,4,1,3,0,0,1,3,4,3,1,0,1,3,7
401369775,Dartmouth Big Green,A. Rai,4279554,,True,36.0,5,15,5,14,0,1,3,3,0,13,13,1,3,0,3,3,13
401369775,Dartmouth Big Green,T. Samuels,4397960,,True,28.0,4,6,2,3,2,3,5,6,0,2,2,2,0,1,1,1,15
401369775,Dartmouth Big Green,B. Barry,4066823,,True,39.0,5,10,1,2,4,8,5,5,0,1,1,2,2,0,1,0,19
401369775,Dartmouth Big Green,N. Dmitrijevic,4898193,,False,9.0,0,2,0,2,0,0,2,2,1,1,2,0,0,1,1,1,2
401369775,Dartmouth Big Green,D. Neskovic,4702966,,False,8.0,0,2,0,1,0,1,0,0,0,1,1,0,0,0,1,3,0
401369775,Dartmouth Big Green,R. Myrthil,4898191,,False,7.0,1,2,0,0,1,2,0,0,0,1,1,0,1,0,0,0,3
401369775,Dartmouth Big Green,I. Robinson,4702967,,False,8.0,0,1,0,0,0,1,2,2,0,0,0,0,0,0,1,1,2
401369775,Dartmouth Big Green,J. Johnson,4702964,,False,1.0,0,1,0,0,0,1,0,0,0,0,0,0,0,0,0,0,0
401369775,Dartmouth Big Green,J. Reaves,4432093,,False,2.0,0,0,0,0,0,0,0,0,0,0,0,0,0,0,0,0,0
401369775,Dartmouth Big Green,J. Blaufeld,4431898,,False,1.0,0,1,0,0,0,1,0,0,0,0,0,0,0,0,0,0,0
401369775,Dartmouth Big Green,W. Slajchert,4397961,,False,19.0,0,0,0,0,0,0,3,4,0,2,2,2,0,0,1,0,3
401369775,Dartmouth Big Green,TEAM,TOTAL,TOTAL,False,,23,55,15,34,8,21,22,25,7,30,37,10,7,2,13,16,76
401369774,Cornell Big Red,K. Boothby,4702970,,True,22.0,4,5,1,1,3,4,0,0,0,1,1,0,4,0,0,3,11
401369774,Cornell Big Red,J. Jones,4593310,,True,19.0,1,7,0,2,1,5,2,2,0,0,0,2,1,0,2,1,5
401369774,Cornell Big Red,K. Dickson,4397937,,True,16.0,1,5,1,5,0,0,0,0,2,5,7,1,0,0,3,0,2
401369774,Cornell Big Red,D. Noll,4397941,,True,24.0,4,7,2,3,2,4,2,2,1,4,5,4,1,0,1,1,12
401369774,Cornell Big Red,S. Patel,4280104,,True,18.0,4,9,1,4,3,5,1,2,0,3,3,0,0,0,1,1,12
401369774,Cornell Big Red,C. Cain,4898219,,False,1.0,0,0,0,0,0,0,0,0,0,0,0,0,0,0,0,0,0
401369774,Cornell Big Red,G. Ragland Jr.,4898218,,False,18.0,2,8,0,2,2,6,0,0,2,4,6,1,0,0,1,2,6
401369774,Cornell Big Red,S. Hansen,4702971,,False,7.0,0,0,0,0,0,0,0,0,0,2,2,0,1,0,1,1,0
401369774,Cornell Big Red,E. Williams,4702968,,False,1.0,0,0,0,0,0,0,0,0,0,0,0,0,0,0,1,0,0
401369774,Cornell Big Red,M. Filien,4593307,,False,12.0,2,2,1,1,1,1,0,0,0,2,2,0,0,0,1,0,5
401369774,Cornell Big Red,N. Williams,4898217,,False,15.0,2,4,2,3,0,1,1,1,0,1,1,2,1,0,0,2,5
401369774,Cornell Big Red,I. Gray,4702973,,False,8.0,0,1,0,1,0,0,0,0,0,1,1,1,0,0,1,1,0
401369774,Cornell Big Red,C. Manon,4702972,,False,15.0,3,8,3,8,0,0,2,2,1,3,4,3,1,0,1,3,8
401369774,Cornell Big Red,G. Dolan,4593308,,False,18.0,5,6,3,3,2,3,0,0,2,6,8,4,0,0,1,0,12
401369774,Cornell Big Red,M. Samberg,4397940,,False,6.0,0,0,0,0,0,0,0,0,0,0,0,1,0,0,0,1,0
401369774,Cornell Big Red,TEAM,TOTAL,TOTAL,False,,28,62,14,33,14,29,8,9,9,33,42,19,9,0,14,16,78
401369774,Columbia Lions,R. Stankard,4898214,,True,26.0,1,5,0,0,1,5,1,2,0,1,1,0,2,0,2,1,4
401369774,Columbia Lions,P. Harding,4702977,,True,32.0,4,7,4,7,0,0,4,4,6,11,17,5,0,0,2,1,12
401369774,Columbia Lions,M. Ellis,4397927,,True,4.0,0,0,0,0,0,0,0,0,0,1,1,0,0,0,0,0,0
401369774,Columbia Lions,B. Milstein,4397925,,True,4.0,0,2,0,0,0,2,0,0,0,0,0,0,0,0,1,0,0
401369774,Columbia Lions,L. Bolster,4279465,,True,4.0,1,3,1,2,0,1,0,0,0,0,0,0,0,0,0,2,2
401369774,Columbia Lions,J. Tavroff,4898215,,False,5.0,0,2,0,2,0,0,0,0,0,0,0,0,0,0,0,0,0
401369774,Columbia Lions,N. Robledo,4683745,,False,15.0,1,5,1,2,0,3,0,0,1,1,2,0,0,0,1,0,2
401369774,Columbia Lions,E. Onuama,4593294,,False,2.0,0,0,0,0,0,0,0,0,0,0,0,0,0,0,0,2,0
401369774,Columbia Lions,C. Shockley-Okeke,4593296,,False,33.0,3,9,1,3,2,6,1,5,1,6,7,3,1,0,0,1,9
401369774,Columbia Lions,G. Rubio De La Rosa,4898213,,False,36.0,6,13,4,4,2,9,0,0,0,3,3,0,3,0,3,2,14
401369774,Columbia Lions,J. Cooper,4898212,,False,17.0,4,7,3,3,1,4,0,0,0,0,0,0,1,1,1,4,9
401369774,Columbia Lions,Z. McLean,4702974,,False,22.0,5,11,3,6,2,5,0,0,0,1,1,3,0,0,2,1,12
401369774,Columbia Lions,TEAM,TOTAL,TOTAL,False,,25,64,17,29,8,35,6,11,8,26,34,11,7,1,12,14,64
401369773,Yale Bulldogs,M. Knowling,4898246,,True,26.0,2,5,2,5,0,0,1,2,2,3,5,3,1,0,0,1,5
401369773,Yale Bulldogs,I. Kelly,4398015,,True,25.0,5,8,5,8,0,0,4,5,3,6,9,2,0,0,0,2,14
401369773,Yale Bulldogs,E. Dike,4398011,,True,13.0,2,4,2,3,0,1,0,1,0,1,1,0,1,0,0,4,4
401369773,Yale Bulldogs,A. Swain,4279697,,True,34.0,8,15,5,7,3,8,3,5,0,6,6,1,2,0,2,3,22
401369773,Yale Bulldogs,J. Gabbidon,4279696,,True,29.0,3,7,2,3,1,4,2,2,3,1,4,6,1,0,2,2,9
401369773,Yale Bulldogs,EJ Jarvis,4431872,,False,14.0,3,6,3,6,0,0,1,2,2,3,5,0,0,0,1,4,7
401369773,Yale Bulldogs,J. Alausa,4279698,,False,1.0,0,0,0,0,0,0,0,0,0,0,0,0,0,0,0,0,0
401369773,Yale Bulldogs,T. Rice,4898241,,False,0.0,0,0,0,0,0,0,0,0,0,0,0,0,0,0,0,0,0
401369773,Yale Bulldogs,J. Poulakidas,4898238,,False,3.0,0,2,0,0,0,2,0,0,0,0,0,0,0,0,0,0,0
401369773,Yale Bulldogs,B. Mbeng,4898237,,False,27.0,2,4,1,2,1,2,3,6,0,2,2,2,1,0,0,2,8
401369773,Yale Bulldogs,A. Mahoney,4593361,,False,12.0,2,4,1,2,1,2,0,0,1,1,2,0,0,0,0,1,5
401369773,Yale Bulldogs,M. Feinberg,4398013,,False,1.0,0,0,0,0,0,0,0,0,0,0,0,0,0,0,0,0,0
401369773,Yale Bulldogs,M. Cotton,4398012,,False,15.0,0,4,0,2,0,2,0,2,0,1,1,1,0,0,0,2,0
401369773,Yale Bulldogs,TEAM,TOTAL,TOTAL,False,,27,59,21,38,6,21,14,25,13,24,37,15,6,0,7,21,74
401369773,Brown Bears,J. Gainey,4397913,,True,36.0,9,11,9,11,0,0,2,3,5,13,18,2,0,2,1,1,20
401369773,Brown Bears,T. Choh,4279463,,True,30.0,4,11,4,8,0,3,5,7,0,7,7,2,0,0,4,3,13
401369773,Brown Bears,K. Lilly Jr.,4898208,,True,35.0,3,7,2,4,1,3,3,5,0,1,1,4,0,0,3,5,10
401369773,Brown Bears,D. Friday,4593253,,True,20.0,3,6,3,4,0,2,0,1,0,1,1,2,1,0,3,0,6
401369773,Brown Bears,P. Cowan,4432960,,True,35.0,1,7,1,1,0,6,1,1,0,2,2,0,1,1,2,4,3
401369773,Brown Bears,A. Cooley,4898209,,False,24.0,6,7,6,6,0,1,1,3,0,0,0,1,0,0,0,3,13
401369773,Brown Bears,L. Erold,4898207,,False,0.0,0,0,0,0,0,0,0,0,0,0,0,0,0,0,0,0,0
401369773,Brown Bears,F. Kloman,4702981,,False,3.0,0,0,0,0,0,0,0,0,0,1,1,0,0,0,1,1,0
401369773,Brown Bears,D. Mitchell,4397914,,False,17.0,0,0,0,0,0,0,0,0,0,1,1,0,1,0,0,3,0
401369773,Brown Bears,TEAM,TOTAL,TOTAL,False,,26,49,25,34,1,15,12,20,5,26,31,11,3,3,14,20,65
401369716,Vermont Catamounts,I. Powell,4592945,,True,19.0,1,3,1,3,0,0,0,0,1,4,5,3,0,0,2,0,2
401369716,Vermont Catamounts,R. Davis,4396597,,True,18.0,5,11,5,9,0,2,6,6,3,4,7,2,0,0,0,3,16
401369716,Vermont Catamounts,K. Gibson,4398273,,True,31.0,2,9,1,4,1,5,1,2,1,5,6,2,0,0,0,1,6
401369716,Vermont Catamounts,F. Sullivan,4397759,,True,29.0,1,3,1,1,0,2,1,2,0,5,5,3,0,0,2,0,3
401369716,Vermont Catamounts,B. Shungu,4066789,,True,22.0,6,11,4,5,2,6,0,0,2,2,4,2,1,0,0,0,14
401369716,Vermont Catamounts,G. Lefebvre,4701185,,False,2.0,1,1,1,1,0,0,2,3,0,1,1,0,0,0,0,1,4
401369716,Vermont Catamounts,N. Fiorillo,4592946,,False,20.0,6,12,4,7,2,5,0,0,1,6,7,1,0,0,1,4,14
401369716,Vermont Catamounts,B. Patella,4278246,,False,16.0,0,3,0,2,0,1,0,0,0,2,2,0,0,0,2,1,0
401369716,Vermont Catamounts,A. Deloney,4431940,,False,20.0,5,8,3,4,2,4,2,4,2,1,3,1,0,0,1,2,14
401369716,Vermont Catamounts,R. Duncan,4396594,,False,23.0,1,2,1,2,0,0,0,0,1,1,2,3,0,0,2,1,2
401369716,Vermont Catamounts,TEAM,TOTAL,TOTAL,False,,28,63,21,38,7,25,12,17,13,32,45,17,1,0,11,13,75
401369716,Maine Black Bears,C. Efretuei,4897165,,True,3.0,0,1,0,1,0,0,0,0,0,0,0,0,0,1,1,1,0
401369716,Maine Black Bears,S. Ingo,4395898,,True,17.0,1,2,1,2,0,0,2,2,1,0,1,0,1,6,0,4,4
401369716,Maine Black Bears,V. Masic,4702764,,True,30.0,1,5,0,2,1,3,2,2,2,8,10,5,1,0,2,1,5
401369716,Maine Black Bears,M. Klanjscek,4593967,,True,29.0,3,12,3,8,0,4,0,0,0,5,5,1,2,0,1,2,6
401369716,Maine Black Bears,J. Wright-Mcleish,4432151,,True,24.0,2,8,1,4,1,4,0,0,0,4,4,1,1,1,0,0,5
401369716,Maine Black Bears,P. Filipovity,4897167,,False,28.0,4,8,4,8,0,0,1,2,3,0,3,0,1,0,0,1,9
401369716,Maine Black Bears,M. Nenadic,4897163,,False,8.0,2,5,1,2,1,3,0,0,1,0,1,0,0,0,0,0,5
401369716,Maine Black Bears,K. Feierbergs,4897162,,False,6.0,1,1,1,1,0,0,1,2,0,1,1,0,0,0,0,0,3
401369716,Maine Black Bears,A. Turgut,4592906,,False,10.0,0,3,0,2,0,1,2,2,0,0,0,0,0,0,0,3,2
401369716,Maine Black Bears,S. Ihekwoaba,4897161,,False,13.0,2,5,2,4,0,1,0,0,0,3,3,1,1,0,2,1,4
401369716,Maine Black Bears,B. Ireland,4897160,,False,18.0,2,5,2,3,0,2,3,5,0,1,1,1,0,0,2,1,7
401369716,Maine Black Bears,A. Adetogun,4700996,,False,14.0,2,4,2,4,0,0,2,2,1,1,2,0,0,1,0,5,6
401369716,Maine Black Bears,TEAM,TOTAL,TOTAL,False,,20,59,17,41,3,18,13,17,8,24,32,9,7,9,8,19,56
401369715,Stony Brook Seawolves,J. Sayles,4279310,,True,28.0,5,7,5,7,0,0,1,2,2,8,10,2,0,1,1,2,11
401369715,Stony Brook Seawolves,O. Habwe,4279868,,True,33.0,7,14,5,10,2,4,4,4,3,4,7,1,0,0,1,2,20
401369715,Stony Brook Seawolves,A. Roberts,4701015,,True,32.0,7,17,6,10,1,7,2,2,0,3,3,6,0,0,1,2,17
401369715,Stony Brook Seawolves,T. Stephenson-Moore,4592935,,True,33.0,2,4,1,1,1,3,1,2,0,3,3,1,1,0,0,0,6
401369715,Stony Brook Seawolves,T. Greene,4398108,,True,38.0,10,15,6,11,4,4,3,5,4,8,12,0,0,0,1,2,27
401369715,Stony Brook Seawolves,M. Diallo,4701164,,False,14.0,2,5,2,4,0,1,0,0,1,1,2,3,1,0,0,2,4
401369715,Stony Brook Seawolves,A. Christie,4396587,,False,11.0,1,3,1,2,0,1,0,0,2,0,2,1,0,0,0,3,2
401369715,Stony Brook Seawolves,K. Roberts,4897991,,False,11.0,0,1,0,0,0,1,0,0,0,0,0,2,1,0,1,1,0
401369715,Stony Brook Seawolves,TEAM,TOTAL,TOTAL,False,,34,66,26,45,8,21,11,15,14,28,42,16,3,1,6,14,87
401369715,NJIT Highlanders,M. Coleman,4701159,,True,40.0,6,13,3,7,3,6,4,7,1,5,6,1,1,0,1,1,19
401369715,NJIT Highlanders,D. Faison,4432978,,True,11.0,2,4,2,3,0,1,1,2,2,1,3,0,0,0,0,3,5
401369715,NJIT Highlanders,S. Diakite,4396754,,True,21.0,3,6,3,6,0,0,1,3,1,2,3,2,0,0,0,3,7
401369715,NJIT Highlanders,M. Faw,4280072,,True,26.0,4,10,2,5,2,5,0,0,3,3,6,0,0,1,0,1,10
401369715,NJIT Highlanders,M. Gray,4701160,,True,40.0,8,18,5,9,3,9,0,1,0,3,3,5,1,0,7,1,19
401369715,NJIT Highlanders,E. Nankin,4897183,,False,21.0,0,2,0,0,0,2,2,2,1,1,2,3,2,1,1,1,2
401369715,NJIT Highlanders,K. Mason,4710326,,False,20.0,2,4,2,4,0,0,2,2,1,1,2,2,0,0,1,2,6
401369715,NJIT Highlanders,J. Murphy,4592280,,False,1.0,0,0,0,0,0,0,0,0,1,0,1,0,0,0,0,0,0
401369715,NJIT Highlanders,K. de Graaf,4396755,,False,20.0,0,1,0,0,0,1,0,0,0,3,3,0,0,1,0,1,0
401369715,NJIT Highlanders,C. Sterling,4897180,,False,0.0,0,0,0,0,0,0,0,0,0,0,0,0,0,0,0,0,0
401369715,NJIT Highlanders,TEAM,TOTAL,TOTAL,False,,25,58,17,34,8,24,10,17,10,20,30,13,4,3,11,13,68
401369714,UMass Lowell River Hawks,M. Brooks,4700953,,True,28.0,2,5,2,5,0,0,1,2,0,6,6,0,0,4,1,1,5
401369714,UMass Lowell River Hawks,Al. Blunt,4396569,,True,33.0,0,5,0,4,0,1,0,0,0,2,2,0,1,0,2,1,0
401369714,UMass Lowell River Hawks,Q. Mincey,4567710,,True,14.0,0,1,0,1,0,0,0,0,0,3,3,1,0,0,0,1,0
401369714,UMass Lowell River Hawks,K. Thomas,4592912,,True,27.0,3,7,3,3,0,4,0,0,0,4,4,1,1,0,1,4,6
401369714,UMass Lowell River Hawks,A. Hikim,4431843,,True,37.0,9,17,8,13,1,4,3,4,0,3,3,2,2,0,5,1,22
401369714,UMass Lowell River Hawks,J. Hall,4066996,,False,24.0,3,5,2,3,1,2,0,0,2,3,5,0,0,0,2,1,7
401369714,UMass Lowell River Hawks,An. Blunt,4700954,,False,15.0,1,1,0,0,1,1,3,4,0,2,2,2,0,0,2,0,6
401369714,UMass Lowell River Hawks,E. Hammond,4397833,,False,22.0,0,7,0,5,0,2,2,2,2,1,3,0,1,0,0,0,2
401369714,UMass Lowell River Hawks,TEAM,TOTAL,TOTAL,False,,18,48,15,34,3,14,9,12,4,26,30,6,5,4,13,9,48
401369714,New Hampshire Wildcats,J. Martinez,4396579,,True,35.0,5,8,2,4,3,4,0,0,0,5,5,1,1,1,1,3,13
401369714,New Hampshire Wildcats,N. Guadarrama,4396578,,True,39.0,4,11,2,6,2,5,0,0,2,6,8,3,3,2,3,2,10
401369714,New Hampshire Wildcats,T. Mattos,4397814,,True,15.0,2,4,2,4,0,0,0,0,1,3,4,1,0,0,1,0,4
401369714,New Hampshire Wildcats,B. Tchoukuiegno,4593989,,True,36.0,3,11,3,9,0,2,3,3,0,4,4,3,2,1,1,0,9
401369714,New Hampshire Wildcats,N. Johnson,4593988,,True,34.0,6,14,6,12,0,2,1,2,3,1,4,1,2,0,2,2,13
401369714,New Hampshire Wildcats,C. Lester,4066728,,False,6.0,0,0,0,0,0,0,2,2,1,0,1,0,0,0,0,0,2
401369714,New Hampshire Wildcats,M. Foster,4897193,,False,25.0,4,9,1,4,3,5,2,2,1,6,7,1,1,0,0,3,13
401369714,New Hampshire Wildcats,J. Willeman,4701157,,False,1.0,0,0,0,0,0,0,0,0,0,0,0,0,0,0,0,0,0
401369714,New Hampshire Wildcats,Q. Murphy,4398022,,False,9.0,0,1,0,1,0,0,0,0,0,0,0,2,0,0,1,0,0
401369714,New Hampshire Wildcats,TEAM,TOTAL,TOTAL,False,,24,58,16,40,8,18,8,9,9,27,36,12,9,4,10,10,64
401369713,UAlbany Great Danes,J. Doles,4279195,,True,17.0,2,4,2,4,0,0,0,0,0,2,2,0,1,0,0,1,4
401369713,UAlbany Great Danes,P. Newman,4280043,,True,22.0,1,2,1,2,0,0,1,2,2,3,5,0,1,1,2,0,3
401369713,UAlbany Great Danes,M. Cerruti,4896617,,True,34.0,3,8,2,4,1,4,0,0,0,2,2,2,2,0,0,2,7
401369713,UAlbany Great Danes,J. Horton,4700941,,True,39.0,11,18,9,16,2,2,0,1,1,3,4,1,3,1,3,2,24
401369713,UAlbany Great Danes,C. Champion,4067132,,True,26.0,1,3,1,3,0,0,0,0,0,4,4,2,0,1,4,2,2
401369713,UAlbany Great Danes,A. Reddish,4896621,,False,15.0,1,8,1,4,0,4,0,0,2,1,3,2,1,0,1,0,2
401369713,UAlbany Great Danes,J. Neely,4896620,,False,12.0,2,5,2,5,0,0,0,0,1,2,3,2,1,0,0,0,4
401369713,UAlbany Great Danes,T. Hutcheson,4433012,,False,13.0,1,3,0,0,1,3,0,0,0,1,1,0,0,0,0,2,3
401369713,UAlbany Great Danes,D. Perry,4278335,,False,22.0,2,5,0,3,2,2,0,0,0,2,2,0,1,0,2,2,6
401369713,UAlbany Great Danes,TEAM,TOTAL,TOTAL,False,,24,56,18,41,6,15,1,3,8,21,29,9,10,3,12,11,55
401369713,Hartford Hawks,J. Kimbrough,4397154,,True,33.0,1,3,1,2,0,1,2,2,1,4,5,0,3,3,1,3,4
401369713,Hartford Hawks,D. Shriver,4902627,,True,40.0,8,11,1,2,7,9,2,3,0,5,5,0,0,0,1,0,25
401369713,Hartford Hawks,B. McClain,4702189,,True,26.0,3,7,3,5,0,2,4,4,1,5,6,0,1,0,2,1,10
401369713,Hartford Hawks,D.J. Mitchell,4395893,,True,35.0,2,7,0,3,2,4,2,2,0,3,3,3,0,0,2,0,8
401369713,Hartford Hawks,T. Carter,3906520,,True,34.0,6,19,3,12,3,7,2,2,2,7,9,3,2,1,6,2,17
401369713,Hartford Hawks,T. Webley,4702191,,False,7.0,0,0,0,0,0,0,0,0,0,0,0,1,0,0,1,1,0
401369713,Hartford Hawks,K. Henderson,4902628,,False,6.0,0,0,0,0,0,0,0,0,0,0,0,2,0,0,1,0,0
401369713,Hartford Hawks,M. Hobbs,4395891,,False,19.0,1,2,0,1,1,1,0,0,0,0,0,1,0,0,2,0,3
401369713,Hartford Hawks,TEAM,TOTAL,TOTAL,False,,21,49,8,25,13,24,12,13,8,26,34,10,6,4,17,7,67
401369712,UMBC Retrievers,Y. Obeng-Mensah,4898002,,True,10.0,2,3,2,3,0,0,0,0,0,0,0,0,0,1,0,0,4
401369712,UMBC Retrievers,N. Johnson,4592939,,True,35.0,2,4,0,2,2,2,7,8,1,4,5,3,2,0,2,3,13
401369712,UMBC Retrievers,M. Picarelli,4701172,,True,34.0,3,8,2,3,1,5,0,1,0,2,2,4,0,0,2,4,7
401369712,UMBC Retrievers,L.J. Owens,4397601,,True,38.0,7,16,5,8,2,8,3,3,0,2,2,0,2,0,1,1,19
401369712,UMBC Retrievers,J. Boonyasith,4397587,,True,36.0,8,14,4,6,4,8,0,1,0,2,2,2,0,0,0,0,20
401369712,UMBC Retrievers,S. Wojcik,4397468,,False,23.0,4,6,4,6,0,0,3,4,1,9,10,1,0,1,2,1,11
401369712,UMBC Retrievers,D. Spasojevic,4278250,,False,7.0,1,1,1,1,0,0,0,0,0,2,2,0,0,1,1,2,2
401369712,UMBC Retrievers,K. Sumpter,4898001,,False,0.0,0,0,0,0,0,0,0,0,0,0,0,0,0,0,0,0,0
401369712,UMBC Retrievers,H. Byrd,4590396,,False,17.0,1,1,1,1,0,0,0,0,1,1,2,3,1,0,2,1,2
401369712,UMBC Retrievers,TEAM,TOTAL,TOTAL,False,,28,53,19,30,9,23,13,17,3,28,31,13,5,3,10,12,78
401369712,Binghamton Bearcats,O. Akuwovo,4398164,,True,11.0,6,8,6,8,0,0,0,0,2,1,3,0,0,1,1,2,12
401369712,Binghamton Bearcats,D. Petcash,4592893,,True,36.0,3,8,1,4,2,4,0,0,3,7,10,3,0,0,4,2,8
401369712,Binghamton Bearcats,J. McGriff,4432056,,True,37.0,7,17,6,15,1,2,0,0,0,3,3,4,3,0,3,1,15
401369712,Binghamton Bearcats,C. Hinckson,4398106,,True,36.0,5,14,3,8,2,6,3,4,2,7,9,2,2,0,2,5,15
401369712,Binghamton Bearcats,T. Bertram,4397473,,True,37.0,3,12,1,4,2,8,1,2,0,2,2,3,0,0,1,2,9
401369712,Binghamton Bearcats,B. Beamer,4701165,,False,1.0,1,1,1,1,0,0,0,0,2,0,2,0,0,0,0,1,2
401369712,Binghamton Bearcats,T. White,4432139,,False,15.0,1,1,1,1,0,0,1,3,1,1,2,0,0,1,0,4,3
401369712,Binghamton Bearcats,G. Tinsley,4432126,,False,16.0,1,4,1,3,0,1,0,0,1,2,3,1,0,0,0,0,2
401369712,Binghamton Bearcats,Y. Willis,4592897,,False,6.0,1,1,1,1,0,0,0,0,0,0,0,0,0,0,0,0,2
401369712,Binghamton Bearcats,K. Amos,4701166,,False,5.0,0,0,0,0,0,0,0,0,0,1,1,0,0,0,1,0,0
401369712,Binghamton Bearcats,TEAM,TOTAL,TOTAL,False,,28,66,21,45,7,21,5,9,13,25,38,13,5,2,12,17,68
401368441,West Virginia Mountaineers,J. Bridges,4432946,,True,26.0,3,5,3,3,0,2,4,4,3,2,5,1,2,0,2,1,10
401368441,West Virginia Mountaineers,G. Osabuohien,4278051,,True,25.0,1,3,1,3,0,0,1,2,2,7,9,2,1,0,3,3,3
401368441,West Virginia Mountaineers,T. Sherman,4592307,,True,36.0,9,17,6,11,3,6,4,4,0,3,3,4,0,0,3,2,25
401368441,West Virginia Mountaineers,S. McNeil,4592306,,True,31.0,2,9,2,4,0,5,6,6,0,2,2,1,0,0,0,0,10
401368441,West Virginia Mountaineers,Ke. Johnson,4279756,,True,18.0,1,5,1,3,0,2,3,5,1,1,2,1,1,1,2,3,5
401368441,West Virginia Mountaineers,D. Carrigan,4592849,,False,1.0,0,0,0,0,0,0,0,0,0,0,0,0,0,0,0,0,0
401368441,West Virginia Mountaineers,I. Cottrell,4432201,,False,16.0,1,6,0,3,1,3,0,0,5,2,7,0,2,0,2,1,3
401368441,West Virginia Mountaineers,P. Paulicap,4279706,,False,20.0,2,3,2,3,0,0,0,0,1,2,3,0,0,0,0,3,4
401368441,West Virginia Mountaineers,Ko. Johnson,4686333,,False,5.0,0,0,0,0,0,0,0,0,0,0,0,1,0,1,0,0,0
401368441,West Virginia Mountaineers,M. Curry,4592874,,False,22.0,5,13,5,11,0,2,0,0,1,0,1,3,1,0,1,2,10
401368441,West Virginia Mountaineers,TEAM,TOTAL,TOTAL,False,,24,61,20,41,4,20,18,21,13,19,32,13,7,2,14,15,70
401368441,TCU Horned Frogs,E. Miller,4432872,,True,22.0,1,3,1,3,0,0,0,0,0,3,3,0,0,0,4,5,2
401368441,TCU Horned Frogs,C. O'Bannon Jr.,4278533,,True,25.0,1,6,1,5,0,1,3,5,1,3,4,0,1,0,0,0,5
401368441,TCU Horned Frogs,E. Lampkin,4433191,,True,30.0,3,4,3,4,0,0,0,0,1,4,5,1,2,1,2,2,6
401368441,TCU Horned Frogs,M. Miles,4432550,,True,33.0,7,15,5,7,2,8,1,1,0,2,2,1,0,0,4,4,17
401368441,TCU Horned Frogs,D. Baugh,4431766,,True,35.0,5,11,4,7,1,4,1,1,0,7,7,6,2,0,4,3,12
401368441,TCU Horned Frogs,S. Doumbia,4897753,,False,2.0,0,0,0,0,0,0,0,0,0,0,0,0,0,0,0,0,0
401368441,TCU Horned Frogs,X. Cork,4593722,,False,8.0,0,2,0,2,0,0,0,0,1,0,1,0,0,0,1,2,0
401368441,TCU Horned Frogs,J. Coles,4432282,,False,7.0,1,3,0,1,1,2,4,4,0,1,1,0,0,0,1,1,7
401368441,TCU Horned Frogs,M. Peavy,4432185,,False,24.0,3,7,3,7,0,0,6,7,3,3,6,0,2,2,1,3,12
401368441,TCU Horned Frogs,F. Farabello,4431952,,False,14.0,1,1,0,0,1,1,0,0,1,0,1,1,2,0,1,1,3
401368441,TCU Horned Frogs,TEAM,TOTAL,TOTAL,False,,22,52,17,36,5,16,15,18,7,23,30,9,9,3,18,21,64
401368440,Texas Tech Red Raiders,K. Obanor,4398304,,True,36.0,4,11,1,6,3,5,5,6,3,7,10,0,1,2,2,3,16
401368440,Texas Tech Red Raiders,B. Williams,4066678,,True,24.0,6,13,5,9,1,4,0,0,1,1,2,1,1,0,1,5,13
401368440,Texas Tech Red Raiders,D. Warren,4592666,,True,26.0,3,8,3,6,0,2,0,0,1,3,4,0,1,0,3,0,6
401368440,Texas Tech Red Raiders,T. Shannon Jr.,4432847,,True,35.0,2,8,0,3,2,5,0,0,1,3,4,4,2,0,0,0,6
401368440,Texas Tech Red Raiders,A. Arms,4406489,,True,35.0,3,7,2,4,1,3,0,0,1,5,6,3,1,0,2,1,7
401368440,Texas Tech Red Raiders,KJ Allen,4897776,,False,1.0,0,0,0,0,0,0,0,0,0,0,0,0,0,0,0,0,0
401368440,Texas Tech Red Raiders,D. Batcho,4683631,,False,7.0,0,0,0,0,0,0,0,0,0,0,0,0,0,0,3,1,0
401368440,Texas Tech Red Raiders,M. Santos-Silva,4278420,,False,11.0,0,3,0,3,0,0,1,2,0,3,3,1,1,0,2,1,1
401368440,Texas Tech Red Raiders,C. Agbo,4433197,,False,4.0,1,2,1,1,0,1,0,0,2,0,2,0,0,0,0,0,2
401368440,Texas Tech Red Raiders,M. Wilson,4432902,,False,8.0,0,1,0,1,0,0,0,0,0,1,1,0,0,0,0,0,0
401368440,Texas Tech Red Raiders,C. Nadolny,4431841,,False,13.0,0,1,0,0,0,1,0,2,0,1,1,0,0,0,0,1,0
401368440,Texas Tech Red Raiders,TEAM,TOTAL,TOTAL,False,,19,54,12,33,7,21,6,10,12,25,37,9,7,2,15,12,51
401368440,Oklahoma State Cowboys,T. Smith,4431764,,True,16.0,3,4,3,4,0,0,0,1,3,1,4,0,0,1,0,1,6
401368440,Oklahoma State Cowboys,M. Cisse,4701208,,True,32.0,1,4,1,4,0,0,2,4,6,4,10,1,1,5,2,2,4
401368440,Oklahoma State Cowboys,A. Anderson III,4432851,,True,34.0,3,12,3,8,0,4,3,4,0,4,4,0,2,0,2,3,9
401368440,Oklahoma State Cowboys,B. Thompson,4432200,,True,32.0,5,15,4,10,1,5,0,0,2,2,4,3,0,0,0,0,11
401368440,Oklahoma State Cowboys,I. Likekele,4397045,,True,19.0,2,5,1,4,1,1,0,0,0,4,4,1,0,0,3,2,5
401368440,Oklahoma State Cowboys,M. Moncrieffe,4610395,,False,9.0,0,0,0,0,0,0,0,0,0,0,0,0,0,0,1,0,0
401368440,Oklahoma State Cowboys,Ka. Boone,4432854,,False,5.0,1,2,1,2,0,0,0,0,1,0,1,0,0,1,1,0,2
401368440,Oklahoma State Cowboys,Ke. Boone,4431901,,False,13.0,0,5,0,1,0,4,3,3,1,1,2,0,0,0,3,0,3
401368440,Oklahoma State Cowboys,W. Newton,4601285,,False,1.0,0,0,0,0,0,0,0,0,0,0,0,0,0,0,0,0,0
401368440,Oklahoma State Cowboys,B. Williams,4593018,,False,11.0,0,4,0,1,0,3,0,0,1,1,2,2,0,0,2,3,0
401368440,Oklahoma State Cowboys,R. Walker,4433163,,False,28.0,4,7,1,1,3,6,1,1,1,5,6,1,2,1,1,1,12
401368440,Oklahoma State Cowboys,TEAM,TOTAL,TOTAL,False,,19,58,14,35,5,23,9,13,16,25,41,8,5,8,15,12,52
401368439,Oklahoma Sooners,J. Hill,4592214,,True,34.0,3,5,3,4,0,1,0,2,3,5,8,2,1,0,0,2,6
401368439,Oklahoma Sooners,T. Groves,4278603,,True,29.0,4,7,2,3,2,4,4,6,1,3,4,3,0,1,0,2,14
401368439,Oklahoma Sooners,J. Groves,4592583,,True,26.0,2,8,2,6,0,2,1,1,1,7,8,1,1,0,1,2,5
401368439,Oklahoma Sooners,U. Gibson,4279087,,True,35.0,9,14,2,2,7,12,4,5,0,1,1,1,1,1,4,2,29
401368439,Oklahoma Sooners,J. Goldwire,4277845,,True,24.0,4,9,3,6,1,3,0,0,3,2,5,4,0,0,2,2,9
401368439,Oklahoma Sooners,E. Chargois,4278297,,False,9.0,1,2,0,0,1,2,0,0,1,0,1,1,0,0,2,1,3
401368439,Oklahoma Sooners,C.J. Noland,4694228,,False,8.0,0,1,0,0,0,1,0,0,0,2,2,0,0,0,1,0,0
401368439,Oklahoma Sooners,B. Cortes,4612129,,False,13.0,1,1,1,1,0,0,2,2,0,1,1,2,1,0,2,1,4
401368439,Oklahoma Sooners,M. Johnson,4593466,,False,22.0,4,6,4,6,0,0,0,0,0,7,7,2,0,1,1,1,8
401368439,Oklahoma Sooners,TEAM,TOTAL,TOTAL,False,,28,53,17,28,11,25,11,16,9,28,37,16,4,3,14,13,78
401368439,Kansas State Wildcats,I. Massoud,4431761,,True,33.0,4,9,2,4,2,5,1,2,1,2,3,1,1,0,0,2,11
401368439,Kansas State Wildcats,S. Miguel,4433187,,True,29.0,1,6,1,5,0,1,0,0,0,0,0,4,2,0,1,1,2
401368439,Kansas State Wildcats,N. Pack,4576062,,True,24.0,4,9,2,4,2,5,0,0,0,3,3,0,0,0,2,4,10
401368439,Kansas State Wildcats,M. Smith,4277939,,True,39.0,9,17,7,13,2,4,2,4,3,6,9,3,0,0,4,3,22
401368439,Kansas State Wildcats,M. McGuirl,4277895,,True,39.0,8,16,7,12,1,4,4,5,1,3,4,5,3,0,0,2,21
401368439,Kansas State Wildcats,D. Bradford,4700530,,False,17.0,1,1,1,1,0,0,1,1,0,0,0,0,0,1,0,1,3
401368439,Kansas State Wildcats,L. Kasubke,4432443,,False,19.0,1,1,1,1,0,0,0,0,0,2,2,1,1,0,0,2,2
401368439,Kansas State Wildcats,TEAM,TOTAL,TOTAL,False,,28,59,21,40,7,19,8,12,5,17,22,14,7,1,7,15,71
401368438,Texas Longhorns,T. Allen,4397148,,True,40.0,2,15,2,15,0,0,5,8,2,2,4,4,1,0,3,3,9
401368438,Texas Longhorns,C. Bishop,4397037,,True,20.0,3,4,3,4,0,0,0,0,2,5,7,1,0,1,1,4,6
401368438,Texas Longhorns,C. Ramey,4334018,,True,40.0,6,13,3,8,3,5,3,4,0,7,7,1,0,0,2,1,18
401368438,Texas Longhorns,M. Carr,4278014,,True,29.0,2,6,1,3,1,3,0,0,0,1,1,3,0,0,2,5,5
401368438,Texas Longhorns,A. Jones,4066325,,True,37.0,4,14,3,7,1,7,3,4,0,6,6,1,2,0,0,2,12
401368438,Texas Longhorns,B. Cunningham,4397079,,False,9.0,1,1,0,0,1,1,0,0,0,2,2,1,1,0,1,4,3
401368438,Texas Longhorns,D. Disu,4432866,,False,12.0,2,3,1,1,1,2,2,2,3,2,5,0,0,1,2,2,7
401368438,Texas Longhorns,D. Askew,4702467,,False,22.0,0,3,0,2,0,1,0,1,1,1,2,1,1,2,1,3,0
401368438,Texas Longhorns,J. Febres,4277921,,False,16.0,1,3,0,0,1,3,0,0,0,3,3,0,0,0,0,2,3
401368438,Texas Longhorns,TEAM,TOTAL,TOTAL,False,,21,62,13,40,8,22,13,19,12,30,42,12,5,4,15,26,63
401368438,Kansas Jayhawks,D. McCormack,4397019,,True,36.0,6,13,6,13,0,0,10,10,2,8,10,1,1,1,1,4,22
401368438,Kansas Jayhawks,M. Lightfoot,4066300,,True,9.0,0,2,0,2,0,0,1,2,1,0,1,0,1,1,1,2,1
401368438,Kansas Jayhawks,O. Agbaji,4397018,,True,39.0,1,11,1,6,0,5,6,8,1,5,6,2,2,0,3,3,8
401368438,Kansas Jayhawks,R. Martin,4278133,,True,7.0,1,3,1,3,0,0,0,0,0,0,0,1,0,0,1,0,2
401368438,Kansas Jayhawks,C. Teahan,4277893,,True,2.0,0,0,0,0,0,0,0,0,0,0,0,0,0,0,0,0,0
401368438,Kansas Jayhawks,Z. Clemence,4683146,,False,2.0,0,0,0,0,0,0,0,0,0,0,0,0,0,0,0,1,0
401368438,Kansas Jayhawks,K.J. Adams,4433259,,False,3.0,0,0,0,0,0,0,1,2,1,0,1,0,0,0,0,0,1
401368438,Kansas Jayhawks,J. Wilson,4431714,,False,37.0,5,9,3,4,2,5,5,6,4,9,13,0,2,2,1,2,17
401368438,Kansas Jayhawks,D. Harris,4431983,,False,38.0,1,8,0,6,1,2,0,0,1,1,2,4,1,4,0,3,3
401368438,Kansas Jayhawks,J. Yesufu,4431856,,False,8.0,0,1,0,1,0,0,0,0,0,1,1,0,0,0,0,0,0
401368438,Kansas Jayhawks,C. Braun,4431767,,False,37.0,3,9,1,6,2,3,5,7,1,10,11,1,1,1,4,3,13
401368438,Kansas Jayhawks,J. Coleman-Lands,3911842,,False,7.0,1,2,0,0,1,2,0,1,1,1,2,0,0,0,0,0,3
401368438,Kansas Jayhawks,TEAM,TOTAL,TOTAL,False,,18,58,12,41,6,17,28,36,14,35,49,9,8,9,11,18,70
401368437,Iowa State Cyclones,A. Kunc,4397167,,True,26.0,3,5,1,1,2,4,0,0,0,5,5,1,0,0,0,2,8
401368437,Iowa State Cyclones,G. Conditt IV,4396989,,True,20.0,3,3,3,3,0,0,3,4,1,3,4,1,0,0,1,3,9
401368437,Iowa State Cyclones,T. Hunter,4683751,,True,39.0,1,7,0,3,1,4,0,0,0,2,2,13,1,0,3,4,3
401368437,Iowa State Cyclones,G. Kalscheur,4397214,,True,25.0,8,13,6,7,2,6,0,0,1,1,2,1,0,0,3,4,18
401368437,Iowa State Cyclones,I. Brockington,4278412,,True,38.0,4,13,3,8,1,5,2,3,0,6,6,4,1,0,1,2,11
401368437,Iowa State Cyclones,R. Jones,4593702,,False,18.0,6,8,6,8,0,0,0,0,5,1,6,0,1,0,1,4,12
401368437,Iowa State Cyclones,T. Enaruna,4431734,,False,2.0,0,0,0,0,0,0,0,0,0,0,0,0,0,0,0,0,0
401368437,Iowa State Cyclones,J. Walker,4433024,,False,9.0,0,3,0,2,0,1,0,0,0,0,0,0,1,0,0,1,0
401368437,Iowa State Cyclones,C. Grill,4431973,,False,23.0,3,7,2,2,1,5,0,0,0,2,2,2,1,0,0,2,7
401368437,Iowa State Cyclones,TEAM,TOTAL,TOTAL,False,,28,59,21,34,7,25,5,7,7,20,27,22,5,0,10,22,68
401368437,Baylor Bears,M. Mayer,4395697,,True,25.0,3,11,2,6,1,5,0,0,1,4,5,2,0,2,1,0,7
401368437,Baylor Bears,F. Thamba,4395692,,True,32.0,2,4,2,4,0,0,3,4,5,3,8,0,0,0,1,4,7
401368437,Baylor Bears,K. Brown,4433254,,True,35.0,6,8,5,6,1,2,3,6,4,6,10,2,0,1,3,3,16
401368437,Baylor Bears,A. Flagler,4397654,,True,36.0,3,7,1,3,2,4,5,6,0,0,0,3,0,0,1,1,13
401368437,Baylor Bears,J. Akinjo,4397072,,True,38.0,7,14,4,4,3,10,3,5,0,4,4,6,2,0,3,1,20
401368437,Baylor Bears,J. Sochan,4610139,,False,26.0,5,10,4,7,1,3,1,5,2,4,6,0,2,1,2,2,12
401368437,Baylor Bears,D. Bonner,4601289,,False,8.0,0,1,0,0,0,1,0,0,1,1,2,1,0,0,0,0,0
401368437,Baylor Bears,TEAM,TOTAL,TOTAL,False,,26,55,18,30,8,25,15,26,13,24,37,14,4,4,11,11,75
401368436,Oklahoma State Cowboys,T. Smith,4431764,,True,15.0,2,3,2,3,0,0,0,0,0,2,2,0,1,2,0,2,4
401368436,Oklahoma State Cowboys,M. Cisse,4701208,,True,29.0,3,5,3,5,0,0,2,2,4,8,12,1,0,2,2,2,8
401368436,Oklahoma State Cowboys,A. Anderson III,4432851,,True,28.0,5,10,5,8,0,2,2,3,0,1,1,3,5,1,3,0,12
401368436,Oklahoma State Cowboys,B. Thompson,4432200,,True,12.0,0,6,0,3,0,3,0,0,0,1,1,0,0,0,2,2,0
401368436,Oklahoma State Cowboys,I. Likekele,4397045,,True,29.0,2,4,2,4,0,0,0,0,1,4,5,5,0,0,3,3,4
401368436,Oklahoma State Cowboys,M. Moncrieffe,4610395,,False,10.0,2,4,2,4,0,0,0,2,4,0,4,0,0,0,0,0,4
401368436,Oklahoma State Cowboys,Ka. Boone,4432854,,False,6.0,0,0,0,0,0,0,0,0,1,1,2,0,0,0,3,2,0
401368436,Oklahoma State Cowboys,Ke. Boone,4431901,,False,27.0,2,7,1,2,1,5,0,0,1,5,6,0,3,2,2,0,5
401368436,Oklahoma State Cowboys,B. Williams,4593018,,False,17.0,4,9,3,6,1,3,0,0,0,2,2,2,0,0,4,1,9
401368436,Oklahoma State Cowboys,R. Walker,4433163,,False,27.0,3,4,2,2,1,2,0,0,0,2,2,0,1,0,1,2,7
401368436,Oklahoma State Cowboys,TEAM,TOTAL,TOTAL,False,,23,52,20,37,3,15,4,7,14,31,45,11,10,7,22,14,53
401368436,Iowa State Cyclones,A. Kunc,4397167,,True,31.0,1,9,1,5,0,4,0,0,4,3,7,0,1,1,1,3,2
401368436,Iowa State Cyclones,G. Conditt IV,4396989,,True,18.0,1,2,1,2,0,0,0,0,0,0,0,1,0,1,1,0,2
401368436,Iowa State Cyclones,T. Hunter,4683751,,True,37.0,5,15,3,9,2,6,0,1,1,1,2,3,3,1,2,1,12
401368436,Iowa State Cyclones,G. Kalscheur,4397214,,True,29.0,1,5,1,2,0,3,1,2,0,3,3,3,1,0,3,5,3
401368436,Iowa State Cyclones,I. Brockington,4278412,,True,39.0,5,17,5,15,0,2,3,5,1,2,3,1,3,2,2,2,13
401368436,Iowa State Cyclones,R. Jones,4593702,,False,12.0,2,3,2,3,0,0,0,2,1,1,2,1,1,0,2,1,4
401368436,Iowa State Cyclones,J. Walker,4433024,,False,10.0,0,0,0,0,0,0,0,0,0,0,0,0,1,1,4,2,0
401368436,Iowa State Cyclones,C. Grill,4431973,,False,24.0,0,2,0,0,0,2,0,0,1,6,7,1,2,0,1,1,0
401368436,Iowa State Cyclones,TEAM,TOTAL,TOTAL,False,,15,53,13,36,2,17,4,10,10,17,27,10,12,6,16,15,36
401368435,West Virginia Mountaineers,J. Bridges,4432946,,True,26.0,1,3,0,0,1,3,2,2,2,3,5,0,1,0,3,2,5
401368435,West Virginia Mountaineers,I. Cottrell,4432201,,True,24.0,1,5,0,2,1,3,0,0,2,3,5,0,0,0,2,0,3
401368435,West Virginia Mountaineers,T. Sherman,4592307,,True,37.0,4,11,1,4,3,7,0,0,0,1,1,1,2,0,3,1,11
401368435,West Virginia Mountaineers,S. McNeil,4592306,,True,18.0,1,8,0,4,1,4,2,2,0,0,0,1,1,0,1,0,5
401368435,West Virginia Mountaineers,Ke. Johnson,4279756,,True,9.0,1,2,0,1,1,1,0,0,1,0,1,0,0,0,0,0,3
401368435,West Virginia Mountaineers,D. Carrigan,4592849,,False,9.0,1,1,1,1,0,0,0,0,1,0,1,0,0,0,0,3,2
401368435,West Virginia Mountaineers,P. Paulicap,4279706,,False,20.0,5,8,5,8,0,0,0,0,3,2,5,0,0,2,2,4,10
401368435,West Virginia Mountaineers,G. Osabuohien,4278051,,False,7.0,0,1,0,1,0,0,0,0,0,2,2,0,0,0,1,0,0
401368435,West Virginia Mountaineers,Ko. Johnson,4686333,,False,12.0,1,4,0,2,1,2,0,0,2,0,2,1,0,0,1,1,3
401368435,West Virginia Mountaineers,M. Curry,4592874,,False,29.0,8,15,7,13,1,2,0,0,2,4,6,4,1,0,2,3,17
401368435,West Virginia Mountaineers,S. Wilson,4581445,,False,9.0,0,3,0,2,0,1,0,0,1,1,2,1,2,0,0,0,0
401368435,West Virginia Mountaineers,TEAM,TOTAL,TOTAL,False,,23,61,14,38,9,23,4,4,16,16,32,8,7,2,16,14,59
401368435,Oklahoma Sooners,J. Hill,4592214,,True,31.0,2,3,2,3,0,0,6,8,0,3,3,1,1,1,1,2,10
401368435,Oklahoma Sooners,T. Groves,4278603,,True,31.0,7,11,5,6,2,5,1,1,3,7,10,0,1,0,3,1,17
401368435,Oklahoma Sooners,J. Groves,4592583,,True,32.0,3,5,0,1,3,4,0,0,0,1,1,0,1,0,0,3,9
401368435,Oklahoma Sooners,U. Gibson,4279087,,True,27.0,4,9,4,6,0,3,0,1,0,0,0,0,3,0,2,2,8
401368435,Oklahoma Sooners,J. Goldwire,4277845,,True,30.0,6,10,5,7,1,3,3,3,1,4,5,4,3,0,2,0,16
401368435,Oklahoma Sooners,E. Chargois,4278297,,False,12.0,1,2,0,0,1,2,0,0,0,1,1,2,0,0,1,0,3
401368435,Oklahoma Sooners,C.J. Noland,4694228,,False,17.0,2,4,1,2,1,2,0,0,0,1,1,2,1,0,0,2,5
401368435,Oklahoma Sooners,B. Cortes,4612129,,False,14.0,2,6,2,5,0,1,0,0,1,1,2,3,0,0,1,0,4
401368435,Oklahoma Sooners,M. Johnson,4593466,,False,6.0,0,1,0,1,0,0,0,0,0,2,2,0,0,0,2,1,0
401368435,Oklahoma Sooners,TEAM,TOTAL,TOTAL,False,,27,51,19,31,8,20,10,13,5,20,25,12,10,1,12,11,72
401368434,TCU Horned Frogs,E. Miller,4432872,,True,31.0,5,12,5,11,0,1,1,1,3,4,7,0,0,2,0,1,11
401368434,TCU Horned Frogs,C. O'Bannon Jr.,4278533,,True,21.0,2,10,2,4,0,6,2,3,2,4,6,0,0,1,0,1,6
401368434,TCU Horned Frogs,E. Lampkin,4433191,,True,21.0,1,4,1,4,0,0,0,0,4,5,9,1,1,1,1,4,2
401368434,TCU Horned Frogs,M. Miles,4432550,,True,35.0,6,14,4,12,2,2,5,6,0,1,1,6,2,0,2,0,19
401368434,TCU Horned Frogs,D. Baugh,4431766,,True,28.0,2,11,2,7,0,4,7,8,1,2,3,5,0,0,0,0,11
401368434,TCU Horned Frogs,X. Cork,4593722,,False,18.0,4,5,4,5,0,0,0,0,4,1,5,1,0,1,1,2,8
401368434,TCU Horned Frogs,J. Coles,4432282,,False,4.0,2,2,2,2,0,0,0,0,1,0,1,0,0,0,1,0,4
401368434,TCU Horned Frogs,M. Peavy,4432185,,False,23.0,4,6,4,6,0,0,0,1,3,4,7,1,1,2,1,1,8
401368434,TCU Horned Frogs,F. Farabello,4431952,,False,19.0,2,3,1,1,1,2,0,0,0,4,4,1,0,0,0,3,5
401368434,TCU Horned Frogs,TEAM,TOTAL,TOTAL,False,,28,67,25,52,3,15,15,19,19,28,47,15,4,7,7,12,74
401368434,Kansas Jayhawks,J. Wilson,4431714,,True,34.0,6,11,5,8,1,3,0,1,2,5,7,1,0,0,1,4,13
401368434,Kansas Jayhawks,D. McCormack,4397019,,True,21.0,2,6,2,6,0,0,7,9,6,2,8,0,0,0,1,2,11
401368434,Kansas Jayhawks,D. Harris,4431983,,True,26.0,0,3,0,1,0,2,0,0,0,0,0,7,0,0,0,1,0
401368434,Kansas Jayhawks,C. Braun,4431767,,True,33.0,4,11,2,9,2,2,0,0,1,4,5,1,0,0,1,1,10
401368434,Kansas Jayhawks,O. Agbaji,4397018,,True,37.0,4,17,1,9,3,8,2,2,1,7,8,1,1,2,3,4,13
401368434,Kansas Jayhawks,Z. Clemence,4683146,,False,0.0,0,0,0,0,0,0,0,0,0,1,1,0,0,1,0,0,0
401368434,Kansas Jayhawks,K.J. Adams,4433259,,False,7.0,0,1,0,1,0,0,0,0,0,0,0,1,0,0,0,1,0
401368434,Kansas Jayhawks,M. Lightfoot,4066300,,False,13.0,2,2,2,2,0,0,1,2,0,1,1,1,0,0,0,2,5
401368434,Kansas Jayhawks,J. Yesufu,4431856,,False,10.0,1,2,1,1,0,1,2,2,0,1,1,1,0,0,0,1,4
401368434,Kansas Jayhawks,R. Martin,4278133,,False,12.0,1,2,1,2,0,0,0,0,0,0,0,0,0,0,1,0,2
401368434,Kansas Jayhawks,J. Coleman-Lands,3911842,,False,7.0,2,4,0,1,2,3,0,0,0,2,2,0,0,0,0,1,6
401368434,Kansas Jayhawks,TEAM,TOTAL,TOTAL,False,,22,59,14,40,8,19,12,16,12,23,35,13,1,3,8,17,64
401365879,VCU Rams,H. Ward,4592495,,True,19.0,1,2,1,2,0,0,0,0,2,2,4,0,1,1,3,4,2
401365879,VCU Rams,V. Williams Jr.,4397227,,True,40.0,7,12,4,4,3,8,9,11,1,3,4,0,0,1,5,1,26
401365879,VCU Rams,J. Nunn,4896614,,True,30.0,4,9,4,5,0,4,0,0,2,2,4,2,2,0,1,1,8
401365879,VCU Rams,A. Baldwin Jr.,4433182,,True,38.0,6,14,6,11,0,3,0,0,2,4,6,6,2,0,2,3,12
401365879,VCU Rams,K. Curry,4397228,,True,33.0,4,9,4,8,0,1,0,0,2,3,5,2,3,1,4,3,8
401365879,VCU Rams,M. Brown-Jones,4433224,,False,6.0,0,0,0,0,0,0,2,2,1,1,2,0,0,2,0,1,2
401365879,VCU Rams,J. DeLoach,4432483,,False,9.0,0,2,0,2,0,0,0,0,0,2,2,0,0,0,0,5,0
401365879,VCU Rams,L. Stockard III,4277897,,False,12.0,1,2,1,2,0,0,1,2,0,2,2,0,2,1,1,1,3
401365879,VCU Rams,N. Kern,4684145,,False,9.0,2,3,2,3,0,0,0,0,0,0,0,1,1,0,1,1,4
401365879,VCU Rams,J. Banks,4432402,,False,4.0,0,2,0,1,0,1,0,0,0,0,0,0,0,0,0,0,0
401365879,VCU Rams,TEAM,TOTAL,TOTAL,False,,25,55,22,38,3,17,12,15,10,19,29,11,11,6,17,20,65
401365879,Saint Louis Billikens,M. Linssen,4279174,,True,19.0,2,5,2,5,0,0,2,4,0,6,6,1,0,2,2,1,6
401365879,Saint Louis Billikens,Y. Collins,4432957,,True,36.0,4,7,4,7,0,0,4,5,0,5,5,7,2,0,5,3,12
401365879,Saint Louis Billikens,F. Thatch Jr.,4397199,,True,28.0,1,7,1,5,0,2,7,8,1,3,4,3,0,0,4,4,9
401365879,Saint Louis Billikens,B. Courtney,4397197,,True,1.0,1,1,0,0,1,1,0,0,0,0,0,0,0,0,0,0,3
401365879,Saint Louis Billikens,D. Jones,4278267,,True,38.0,2,6,0,2,2,4,0,0,1,1,2,4,3,0,0,0,6
401365879,Saint Louis Billikens,T. Hargrove Jr.,4592484,,False,15.0,2,5,2,4,0,1,0,0,3,1,4,0,1,0,2,2,4
401365879,Saint Louis Billikens,F. Okoro,4397105,,False,21.0,3,5,3,5,0,0,2,2,2,4,6,0,1,1,1,4,8
401365879,Saint Louis Billikens,J. Nesbitt,4714246,,False,7.0,0,0,0,0,0,0,2,2,0,0,0,0,0,0,2,1,2
401365879,Saint Louis Billikens,G. Jimerson,4432008,,False,35.0,6,10,3,5,3,5,4,4,1,2,3,0,0,0,1,2,19
401365879,Saint Louis Billikens,TEAM,TOTAL,TOTAL,False,,21,46,15,33,6,13,21,25,8,22,30,15,7,3,18,17,69
401365878,Saint Joseph's Hawks,A. Jansson,4701029,,True,14.0,1,1,1,1,0,0,0,2,1,4,5,1,0,0,0,2,2
401365878,Saint Joseph's Hawks,E. Obinna,4278125,,True,27.0,3,8,3,8,0,0,1,2,1,7,8,0,0,0,3,3,7
401365878,Saint Joseph's Hawks,J. Forrest,4701032,,True,14.0,2,5,0,1,2,4,2,2,1,1,2,0,0,0,0,2,8
401365878,Saint Joseph's Hawks,E. Reynolds II,4683952,,True,36.0,10,14,5,6,5,8,2,2,0,1,1,4,2,1,4,4,27
401365878,Saint Joseph's Hawks,C. Brown,4592476,,True,32.0,3,8,0,2,3,6,0,0,0,4,4,5,0,1,3,2,9
401365878,Saint Joseph's Hawks,C. Coleman,4431807,,False,25.0,1,4,1,2,0,2,0,0,1,3,4,1,0,2,2,2,2
401365878,Saint Joseph's Hawks,J. Hall,4701031,,False,34.0,6,10,5,6,1,4,2,2,1,7,8,4,2,0,2,2,15
401365878,Saint Joseph's Hawks,D. Bishop,4701028,,False,18.0,0,1,0,0,0,1,0,0,0,4,4,0,0,1,1,1,0
401365878,Saint Joseph's Hawks,TEAM,TOTAL,TOTAL,False,,26,51,15,26,11,25,7,10,6,32,38,15,4,5,16,18,70
401365878,Rhode Island Rams,A. Walker,4278567,,True,17.0,2,6,2,2,0,4,1,2,1,5,6,0,0,1,0,3,5
401365878,Rhode Island Rams,I. Leggett,4606837,,True,23.0,2,7,1,4,1,3,0,0,4,2,6,3,0,0,2,3,5
401365878,Rhode Island Rams,M. Martin,4397470,,True,28.0,4,6,2,3,2,3,1,2,3,3,6,0,1,0,0,0,11
401365878,Rhode Island Rams,I. El-Amin,4279313,,True,20.0,2,7,0,3,2,4,0,0,2,1,3,1,1,0,1,1,6
401365878,Rhode Island Rams,J. Sheppard,4066445,,True,19.0,1,5,1,2,0,3,1,2,0,0,0,1,2,0,0,0,3
401365878,Rhode Island Rams,Makhel Mitchell,4431777,,False,24.0,4,15,4,14,0,1,0,1,2,0,2,0,2,2,1,2,8
401365878,Rhode Island Rams,Makhi Mitchell,4431708,,False,24.0,2,8,1,5,1,3,3,4,0,2,2,1,2,1,3,3,8
401365878,Rhode Island Rams,J. Carey,4395673,,False,19.0,2,7,0,4,2,3,0,0,0,2,2,3,2,0,1,1,6
401365878,Rhode Island Rams,S. Thomas,4897065,,False,26.0,2,2,2,2,0,0,4,8,1,1,2,3,1,0,1,0,8
401365878,Rhode Island Rams,TEAM,TOTAL,TOTAL,False,,21,63,13,39,8,24,10,19,15,16,31,12,11,4,9,13,60
401365877,Massachusetts Minutemen,M. Steadman,4397393,,True,15.0,2,7,2,7,0,0,0,0,2,2,4,1,1,0,1,0,4
401365877,Massachusetts Minutemen,T. Buttrick,4277981,,True,33.0,3,6,3,5,0,1,3,4,2,6,8,1,0,0,1,4,9
401365877,Massachusetts Minutemen,T.J. Weeks,4433108,,True,21.0,1,4,1,2,0,2,2,2,1,2,3,2,0,0,0,0,4
401365877,Massachusetts Minutemen,N. Fernandes,4431791,,True,40.0,10,19,6,13,4,6,4,6,1,4,5,2,1,0,2,4,28
401365877,Massachusetts Minutemen,R. Kelly,4279741,,True,33.0,6,11,5,7,1,4,7,7,1,3,4,2,0,0,1,3,20
401365877,Massachusetts Minutemen,D. Dominguez,4701126,,False,2.0,0,1,0,1,0,0,0,0,0,0,0,0,0,0,0,1,0
401365877,Massachusetts Minutemen,G. Jones,4279211,,False,34.0,3,9,2,6,1,3,2,3,5,4,9,1,2,4,0,2,9
401365877,Massachusetts Minutemen,J. Garcia,4701125,,False,19.0,0,2,0,1,0,1,0,0,0,2,2,0,0,1,0,3,0
401365877,Massachusetts Minutemen,C.J. Kelly,4398208,,False,28.0,3,9,2,5,1,4,2,2,1,3,4,0,2,0,3,3,9
401365877,Massachusetts Minutemen,TEAM,TOTAL,TOTAL,False,,28,68,21,47,7,21,20,24,17,28,45,9,6,5,9,20,83
401365877,George Mason Patriots,J. Oduro,4432068,,True,40.0,7,15,7,13,0,2,2,4,3,3,6,2,1,3,2,4,16
401365877,George Mason Patriots,B. Buchanan,4395691,,True,8.0,1,2,1,1,0,1,0,0,0,1,1,0,0,0,0,1,2
401365877,George Mason Patriots,J. Hartwell II,4396817,,True,11.0,0,4,0,2,0,2,0,0,0,2,2,0,0,0,0,2,0
401365877,George Mason Patriots,D. Cooper,4279876,,True,37.0,6,9,1,1,5,8,2,3,0,2,2,0,0,0,1,2,19
401365877,George Mason Patriots,D. Schwartz,4278501,,True,42.0,6,15,4,9,2,6,7,8,2,4,6,4,0,0,1,4,21
401365877,George Mason Patriots,B. Jones,4897083,,False,1.0,0,0,0,0,0,0,0,0,0,0,0,0,0,0,0,0,0
401365877,George Mason Patriots,M. Henry,4606836,,False,5.0,1,1,1,1,0,0,1,2,0,0,0,1,1,0,0,0,3
401365877,George Mason Patriots,O. Frazier III,4700882,,False,4.0,0,0,0,0,0,0,0,0,0,1,1,0,1,0,0,0,0
401365877,George Mason Patriots,X. Johnson,4592439,,False,24.0,0,5,0,2,0,3,0,1,2,2,4,5,0,0,2,3,0
401365877,George Mason Patriots,R. Polite III,4567711,,False,21.0,2,6,1,4,1,2,3,4,0,1,1,2,2,0,3,1,8
401365877,George Mason Patriots,D. Gaines,4431961,,False,32.0,3,4,1,1,2,3,3,4,1,5,6,1,0,1,1,2,11
401365877,George Mason Patriots,TEAM,TOTAL,TOTAL,False,,26,61,16,34,10,27,18,26,11,24,35,15,5,4,11,20,80
401365876,George Washington Revolutionaries,H. Dean,4593273,,True,19.0,2,5,2,5,0,0,1,2,0,7,7,1,0,0,1,3,5
401365876,George Washington Revolutionaries,R. Lindo Jr.,4397186,,True,22.0,2,4,2,2,0,2,0,4,1,7,8,3,1,0,0,3,4
401365876,George Washington Revolutionaries,B. Freeman,4613126,,True,36.0,7,14,5,12,2,2,1,3,1,1,2,5,1,0,1,4,17
401365876,George Washington Revolutionaries,J. Bamisile,4432537,,True,36.0,3,9,0,4,3,5,2,4,1,0,1,1,0,1,3,1,11
401365876,George Washington Revolutionaries,J. Bishop,4431770,,True,37.0,3,12,3,8,0,4,2,2,1,2,3,2,1,1,3,2,8
401365876,George Washington Revolutionaries,Q. Samuels,4592251,,False,14.0,3,4,0,1,3,3,0,0,0,3,3,0,1,0,0,2,9
401365876,George Washington Revolutionaries,N. Brown,4700963,,False,5.0,0,0,0,0,0,0,0,0,0,3,3,0,0,0,0,0,0
401365876,George Washington Revolutionaries,A. Harris,4397216,,False,0.0,0,0,0,0,0,0,0,0,0,0,0,0,0,0,0,0,0
401365876,George Washington Revolutionaries,B. Adams,4396612,,False,31.0,4,9,2,6,2,3,2,4,1,5,6,2,0,1,1,4,12
401365876,George Washington Revolutionaries,TEAM,TOTAL,TOTAL,False,,24,57,14,38,10,19,8,19,6,28,34,14,4,3,9,19,66
401365876,Fordham Rams,A. Tsimbila,4702329,,True,8.0,0,1,0,1,0,0,0,0,0,3,3,0,0,0,1,1,0
401365876,Fordham Rams,C. Ohams,4066856,,True,33.0,9,17,9,17,0,0,5,8,3,13,16,5,0,3,2,3,23
401365876,Fordham Rams,J. Navarro,4592316,,True,31.0,4,8,3,5,1,3,4,5,0,3,3,2,0,0,0,1,13
401365876,Fordham Rams,K. Rose,4592315,,True,36.0,2,6,0,1,2,5,1,2,0,3,3,1,3,0,1,2,7
401365876,Fordham Rams,D. Quisenberry,4397790,,True,33.0,6,12,4,7,2,5,4,5,0,1,1,1,2,0,2,1,18
401365876,Fordham Rams,P. Kelly,4432014,,False,3.0,0,1,0,0,0,1,0,0,1,0,1,0,0,0,0,0,0
401365876,Fordham Rams,R. Novitskyi,4897084,,False,11.0,1,2,0,1,1,1,0,0,0,1,1,0,0,3,1,3,3
401365876,Fordham Rams,A. Charlton,4897085,,False,32.0,1,5,1,2,0,3,0,0,0,6,6,6,1,1,2,3,2
401365876,Fordham Rams,K. Cunningham,4705891,,False,2.0,1,2,1,1,0,1,0,0,0,0,0,0,0,0,0,0,2
401365876,Fordham Rams,Z. Riley,4914388,,False,11.0,1,2,1,2,0,0,0,0,0,1,1,0,0,0,0,2,2
401365876,Fordham Rams,TEAM,TOTAL,TOTAL,False,,25,56,19,37,6,19,14,20,8,33,41,15,6,7,12,16,70
401365875,La Salle Explorers,C. Moore,4277945,,True,15.0,3,5,3,5,0,0,0,0,1,3,4,1,0,1,1,1,6
401365875,La Salle Explorers,J. Clark,4397152,,True,37.0,13,19,9,13,4,6,0,1,3,5,8,3,1,0,2,2,30
401365875,La Salle Explorers,J. Brickus,4700970,,True,23.0,4,5,3,3,1,2,0,3,0,1,1,7,0,1,3,3,9
401365875,La Salle Explorers,A. Gill,4700969,,True,25.0,0,1,0,1,0,0,0,0,0,1,1,6,1,0,1,1,0
401365875,La Salle Explorers,C. Ray,4592448,,True,35.0,3,6,1,2,2,4,1,2,2,6,8,1,1,0,2,3,9
401365875,La Salle Explorers,M. Doucoure,4277988,,False,12.0,1,1,1,1,0,0,0,0,1,0,1,0,1,0,1,1,2
401365875,La Salle Explorers,D. Shepherd,4710357,,False,0.0,0,0,0,0,0,0,0,0,0,0,0,0,0,0,0,0,0
401365875,La Salle Explorers,K. Brantley,4709132,,False,26.0,2,8,2,6,0,2,2,2,1,3,4,3,3,0,2,3,6
401365875,La Salle Explorers,J. Nickelberry,4432845,,False,27.0,9,13,4,6,5,7,0,0,1,2,3,0,0,0,1,0,23
401365875,La Salle Explorers,TEAM,TOTAL,TOTAL,False,,35,58,23,37,12,21,3,8,10,22,32,21,7,2,13,14,85
401365875,Duquesne Dukes,M. Hima,4700878,,True,19.0,1,2,1,2,0,0,0,0,3,2,5,0,0,2,0,2,2
401365875,Duquesne Dukes,D. Larson,4897091,,True,31.0,4,5,4,5,0,0,0,0,1,1,2,1,0,0,0,3,8
401365875,Duquesne Dukes,A. Spears,4897090,,True,39.0,12,24,10,19,2,5,8,10,0,3,3,5,3,1,3,2,34
401365875,Duquesne Dukes,T. Okani,4700873,,True,19.0,1,3,1,2,0,1,0,0,2,0,2,2,1,0,2,1,2
401365875,Duquesne Dukes,T. Acuff,4606831,,True,34.0,1,4,1,2,0,2,0,0,1,2,3,2,2,0,0,1,2
401365875,Duquesne Dukes,K. Easley,4398159,,False,30.0,5,8,4,6,1,2,2,2,0,6,6,1,1,1,0,2,13
401365875,Duquesne Dukes,J. Johnson III,4897088,,False,24.0,5,11,0,4,5,7,0,0,0,1,1,1,0,0,4,1,15
401365875,Duquesne Dukes,M. Bekelja,4700874,,False,4.0,0,0,0,0,0,0,0,0,0,1,1,0,0,0,1,0,0
401365875,Duquesne Dukes,TEAM,TOTAL,TOTAL,False,,29,57,21,40,8,17,10,12,7,16,23,12,7,4,10,12,76
401365874,Dayton Flyers,R.J. Blakney,4700864,,True,25.0,2,4,0,2,2,2,2,2,0,3,3,1,0,2,1,2,8
401365874,Dayton Flyers,T. Camara,4431736,,True,19.0,3,4,2,3,1,1,0,0,1,9,10,0,0,0,3,5,7
401365874,Dayton Flyers,D. Holmes II,4433607,,True,37.0,5,7,5,7,0,0,10,13,0,6,6,1,2,0,0,3,20
401365874,Dayton Flyers,C. Wilson,4403456,,True,1.0,0,0,0,0,0,0,0,0,0,0,0,0,0,0,0,0,0
401365874,Dayton Flyers,D. Swerlein,4600089,,True,1.0,0,1,0,1,0,0,0,0,0,0,0,0,0,0,0,1,0
401365874,Dayton Flyers,M. Sissoko,4431824,,False,3.0,0,0,0,0,0,0,0,0,0,1,1,0,0,0,0,1,0
401365874,Dayton Flyers,M. Amzil,4711607,,False,28.0,4,8,3,5,1,3,0,0,1,4,5,1,0,0,0,1,9
401365874,Dayton Flyers,M. Smith,4683861,,False,27.0,3,5,2,4,1,1,2,2,0,1,1,6,0,0,0,4,9
401365874,Dayton Flyers,K. Elvis,4683135,,False,34.0,4,12,3,6,1,6,2,2,1,0,1,6,0,0,0,2,11
401365874,Dayton Flyers,K. Brea,4591259,,False,25.0,7,10,3,4,4,6,0,2,1,2,3,1,0,0,0,0,18
401365874,Dayton Flyers,TEAM,TOTAL,TOTAL,False,,28,51,18,32,10,19,16,21,4,27,31,16,2,2,4,19,82
401365874,Davidson Wildcats,S. Mennenga,4700862,,True,35.0,5,11,4,9,1,2,3,4,0,3,3,1,0,1,1,3,14
401365874,Davidson Wildcats,L. Brajkovic,4396787,,True,17.0,3,5,3,5,0,0,0,0,0,3,3,3,0,1,1,5,6
401365874,Davidson Wildcats,H. Lee,4592308,,True,34.0,7,14,4,6,3,8,0,1,0,7,7,3,0,1,0,2,17
401365874,Davidson Wildcats,G. Huffman,4432522,,True,20.0,1,2,1,2,0,0,0,1,1,3,4,1,0,0,0,1,2
401365874,Davidson Wildcats,M. Jones,4396784,,True,36.0,2,6,0,1,2,5,2,3,2,3,5,1,1,0,0,3,8
401365874,Davidson Wildcats,N. Boachie-Yiadom,4396786,,False,17.0,1,1,1,1,0,0,2,2,0,1,1,2,0,0,1,5,4
401365874,Davidson Wildcats,D. Watson,4897098,,False,6.0,0,1,0,0,0,1,0,0,0,1,1,1,0,0,1,1,0
401365874,Davidson Wildcats,F. Loyer,4397208,,False,35.0,7,13,2,6,5,7,6,7,0,1,1,2,0,0,1,0,25
401365874,Davidson Wildcats,TEAM,TOTAL,TOTAL,False,,26,53,15,30,11,23,13,18,4,22,26,14,1,3,5,20,76
401365873,St. Bonaventure Bonnies,O. Osunniyi,4397224,,True,36.0,8,12,8,12,0,0,0,2,3,3,6,1,2,3,0,1,16
401365873,St. Bonaventure Bonnies,J. Adaway,4279431,,True,40.0,8,13,6,9,2,4,3,3,0,7,7,0,0,1,1,4,21
401365873,St. Bonaventure Bonnies,J. Holmes,4701016,,True,36.0,5,13,5,9,0,4,3,4,0,3,3,2,4,0,1,0,13
401365873,St. Bonaventure Bonnies,D. Welch,4397221,,True,36.0,3,6,2,2,1,4,0,0,1,2,3,1,0,1,3,4,7
401365873,St. Bonaventure Bonnies,K. Lofton,4397220,,True,40.0,6,11,5,10,1,1,2,3,0,4,4,3,0,0,1,1,15
401365873,St. Bonaventure Bonnies,P. Rossi,4897049,,False,0.0,0,0,0,0,0,0,0,0,0,0,0,0,0,0,0,0,0
401365873,St. Bonaventure Bonnies,O. Durosinmi,4684462,,False,0.0,0,0,0,0,0,0,0,0,0,0,0,0,0,0,0,0,0
401365873,St. Bonaventure Bonnies,A. Coulibaly,4432889,,False,4.0,0,0,0,0,0,0,0,0,0,0,0,0,0,0,0,1,0
401365873,St. Bonaventure Bonnies,J. Ndjock-Tadjore,4897048,,False,0.0,0,0,0,0,0,0,0,0,0,0,0,0,0,0,0,0,0
401365873,St. Bonaventure Bonnies,J. Saizonou,4897046,,False,0.0,0,0,0,0,0,0,0,0,0,0,0,0,0,0,0,0,0
401365873,St. Bonaventure Bonnies,Q. Adams,4585591,,False,8.0,0,0,0,0,0,0,0,0,0,0,0,0,0,0,0,0,0
401365873,St. Bonaventure Bonnies,TEAM,TOTAL,TOTAL,False,,30,55,26,42,4,13,8,12,5,22,27,7,6,5,8,11,72
401365873,Richmond Spiders,T. Burton,4431914,,True,34.0,9,13,8,10,1,3,2,4,2,6,8,0,1,0,1,1,21
401365873,Richmond Spiders,N. Cayo,4278380,,True,32.0,5,10,5,10,0,0,1,2,2,5,7,4,2,0,2,1,11
401365873,Richmond Spiders,G. Golden,4066836,,True,28.0,5,10,5,7,0,3,1,2,0,3,3,3,1,0,3,1,11
401365873,Richmond Spiders,A. Gustavson,4397193,,True,24.0,0,5,0,1,0,4,0,0,1,1,2,2,0,0,1,2,0
401365873,Richmond Spiders,J. Gilyard,4278378,,True,40.0,2,7,0,0,2,7,0,0,0,3,3,3,1,0,0,2,6
401365873,Richmond Spiders,M. Grace,4397192,,False,18.0,2,4,0,1,2,3,2,2,2,1,3,1,1,1,1,2,8
401365873,Richmond Spiders,I. Wilson,4700973,,False,9.0,0,3,0,1,0,2,0,0,0,1,1,2,0,0,1,5,0
401365873,Richmond Spiders,C. Crabtree,4396658,,False,5.0,0,0,0,0,0,0,0,0,1,0,1,0,0,0,0,0,0
401365873,Richmond Spiders,N. Sherod,4066832,,False,10.0,2,5,0,0,2,5,2,3,0,2,2,1,0,0,0,0,8
401365873,Richmond Spiders,TEAM,TOTAL,TOTAL,False,,25,57,18,30,7,27,8,13,9,23,32,16,6,1,11,14,65
401365872,Saint Louis Billikens,F. Okoro,4397105,,True,24.0,3,8,3,8,0,0,3,5,1,6,7,1,0,1,2,4,9
401365872,Saint Louis Billikens,J. Nesbitt,4714246,,True,28.0,4,8,4,7,0,1,3,4,2,2,4,2,1,0,0,2,11
401365872,Saint Louis Billikens,Y. Collins,4432957,,True,33.0,4,8,3,6,1,2,1,2,1,4,5,9,5,0,5,3,10
401365872,Saint Louis Billikens,G. Jimerson,4432008,,True,36.0,7,13,2,4,5,9,3,5,0,1,1,0,0,0,0,1,22
401365872,Saint Louis Billikens,F. Thatch Jr.,4397199,,True,38.0,8,17,5,12,3,5,2,4,3,10,13,1,1,1,0,1,21
401365872,Saint Louis Billikens,T. Hargrove Jr.,4592484,,False,15.0,1,4,1,3,0,1,0,0,0,2,2,0,0,0,0,3,2
401365872,Saint Louis Billikens,M. Linssen,4279174,,False,16.0,1,4,1,4,0,0,3,4,3,2,5,0,1,0,2,4,5
401365872,Saint Louis Billikens,D. Jones,4278267,,False,10.0,0,1,0,0,0,1,0,0,0,1,1,2,0,0,0,1,0
401365872,Saint Louis Billikens,TEAM,TOTAL,TOTAL,False,,28,63,19,44,9,19,15,24,12,30,42,15,8,2,9,19,80
401365872,Rhode Island Rams,A. Walker,4278567,,True,14.0,0,3,0,2,0,1,0,1,0,2,2,1,1,0,1,4,0
401365872,Rhode Island Rams,I. Leggett,4606837,,True,25.0,2,7,1,4,1,3,3,5,3,1,4,0,0,0,0,2,8
401365872,Rhode Island Rams,M. Martin,4397470,,True,32.0,2,5,2,2,0,3,1,2,3,2,5,1,0,1,2,0,5
401365872,Rhode Island Rams,I. El-Amin,4279313,,True,12.0,2,3,0,0,2,3,0,0,0,1,1,0,0,0,0,4,6
401365872,Rhode Island Rams,J. Sheppard,4066445,,True,27.0,7,9,5,6,2,3,0,0,0,5,5,1,0,0,0,2,16
401365872,Rhode Island Rams,Makhel Mitchell,4431777,,False,26.0,3,16,3,16,0,0,4,6,2,5,7,2,1,0,1,3,10
401365872,Rhode Island Rams,Makhi Mitchell,4431708,,False,25.0,6,9,6,8,0,1,1,3,3,5,8,3,2,6,6,2,13
401365872,Rhode Island Rams,J. Carey,4395673,,False,17.0,4,6,3,5,1,1,0,3,0,2,2,1,2,0,0,2,9
401365872,Rhode Island Rams,S. Thomas,4897065,,False,22.0,3,5,3,4,0,1,1,2,1,4,5,2,0,0,0,1,7
401365872,Rhode Island Rams,TEAM,TOTAL,TOTAL,False,,29,63,23,47,6,16,10,22,12,29,41,11,6,7,10,20,74
401365871,Saint Joseph's Hawks,T. Funk,4278395,,True,36.0,2,10,0,1,2,9,2,2,0,5,5,1,0,0,1,1,8
401365871,Saint Joseph's Hawks,E. Obinna,4278125,,True,32.0,5,14,5,14,0,0,4,4,7,11,18,0,1,0,2,3,14
401365871,Saint Joseph's Hawks,J. Hall,4701031,,True,38.0,5,14,3,8,2,6,0,0,3,10,13,5,2,0,6,4,12
401365871,Saint Joseph's Hawks,E. Reynolds II,4683952,,True,37.0,4,14,1,7,3,7,0,0,0,3,3,3,1,1,1,2,11
401365871,Saint Joseph's Hawks,C. Brown,4592476,,True,35.0,0,6,0,4,0,2,0,0,2,3,5,1,2,0,0,0,0
401365871,Saint Joseph's Hawks,A. Jansson,4701029,,False,8.0,1,2,1,2,0,0,0,0,0,0,0,0,0,1,0,0,2
401365871,Saint Joseph's Hawks,J. Forrest,4701032,,False,10.0,0,2,0,2,0,0,0,0,0,1,1,0,0,0,0,1,0
401365871,Saint Joseph's Hawks,D. Bishop,4701028,,False,4.0,0,0,0,0,0,0,1,2,0,0,0,0,1,0,0,0,1
401365871,Saint Joseph's Hawks,TEAM,TOTAL,TOTAL,False,,17,62,10,38,7,24,7,8,12,33,45,10,7,2,11,11,48
401365871,La Salle Explorers,C. Moore,4277945,,True,37.0,2,7,2,3,0,4,1,2,0,8,8,3,1,7,3,1,5
401365871,La Salle Explorers,J. Clark,4397152,,True,31.0,3,12,3,8,0,4,0,0,3,3,6,2,1,0,2,3,6
401365871,La Salle Explorers,J. Brickus,4700970,,True,34.0,4,9,2,4,2,5,0,0,0,3,3,1,0,0,0,0,10
401365871,La Salle Explorers,A. Gill,4700969,,True,17.0,2,8,0,2,2,6,0,0,2,2,4,1,0,1,1,1,6
401365871,La Salle Explorers,C. Ray,4592448,,True,34.0,2,5,2,3,0,2,0,0,3,7,10,1,1,0,0,2,4
401365871,La Salle Explorers,D. Shepherd,4710357,,False,2.0,0,0,0,0,0,0,0,0,1,0,1,0,0,0,1,0,0
401365871,La Salle Explorers,K. Brantley,4709132,,False,21.0,4,12,3,8,1,4,2,2,1,4,5,1,2,0,3,3,11
401365871,La Salle Explorers,J. Nickelberry,4432845,,False,24.0,3,8,2,5,1,3,0,1,0,3,3,1,0,0,0,0,7
401365871,La Salle Explorers,TEAM,TOTAL,TOTAL,False,,20,61,14,33,6,28,3,5,10,31,41,10,5,8,10,10,49
401365870,Massachusetts Minutemen,M. Steadman,4397393,,True,10.0,2,4,2,4,0,0,0,2,1,2,3,1,0,0,4,1,4
401365870,Massachusetts Minutemen,G. Jones,4279211,,True,11.0,1,1,0,0,1,1,2,2,0,2,2,0,0,0,0,3,5
401365870,Massachusetts Minutemen,T. Buttrick,4277981,,True,33.0,3,5,1,2,2,3,3,4,0,8,8,1,1,0,1,3,11
401365870,Massachusetts Minutemen,N. Fernandes,4431791,,True,33.0,2,5,2,4,0,1,4,4,0,1,1,6,1,0,5,4,8
401365870,Massachusetts Minutemen,R. Kelly,4279741,,True,32.0,5,11,3,7,2,4,3,4,2,0,2,3,0,0,1,1,15
401365870,Massachusetts Minutemen,D. Dominguez,4701126,,False,9.0,3,7,2,3,1,4,2,2,1,1,2,0,0,0,0,1,9
401365870,Massachusetts Minutemen,J. Kelly,4593279,,False,0.0,0,0,0,0,0,0,0,0,0,0,0,0,0,0,0,0,0
401365870,Massachusetts Minutemen,R. Marcus,4701129,,False,0.0,0,0,0,0,0,0,0,0,0,0,0,0,0,0,0,0,0
401365870,Massachusetts Minutemen,J. Garcia,4701125,,False,19.0,4,10,4,5,0,5,1,3,0,2,2,0,2,0,2,4,9
401365870,Massachusetts Minutemen,T.J. Weeks,4433108,,False,36.0,6,10,5,7,1,3,4,4,5,5,10,0,1,0,2,3,17
401365870,Massachusetts Minutemen,P. Santos,4432104,,False,0.0,0,0,0,0,0,0,0,0,0,0,0,0,0,0,0,0,0
401365870,Massachusetts Minutemen,C.J. Kelly,4398208,,False,17.0,1,4,1,4,0,0,1,3,0,4,4,3,1,0,1,2,3
401365870,Massachusetts Minutemen,TEAM,TOTAL,TOTAL,False,,27,57,20,36,7,21,20,28,12,26,38,14,6,0,16,22,81
401365870,Fordham Rams,A. Tsimbila,4702329,,True,19.0,5,9,5,9,0,0,0,0,5,1,6,0,0,1,2,2,10
401365870,Fordham Rams,C. Ohams,4066856,,True,36.0,4,11,4,11,0,0,6,6,2,10,12,5,1,2,0,3,14
401365870,Fordham Rams,A. Charlton,4897085,,True,21.0,2,7,1,4,1,3,4,4,1,2,3,5,2,0,0,5,9
401365870,Fordham Rams,J. Navarro,4592316,,True,32.0,3,10,0,4,3,6,1,2,1,4,5,1,1,0,3,2,10
401365870,Fordham Rams,K. Rose,4592315,,True,32.0,2,8,1,2,1,6,2,2,3,1,4,1,0,0,1,3,7
401365870,Fordham Rams,P. Kelly,4432014,,False,8.0,0,1,0,0,0,1,0,0,0,0,0,0,0,0,0,0,0
401365870,Fordham Rams,R. Novitskyi,4897084,,False,4.0,0,0,0,0,0,0,0,0,1,0,1,1,0,1,2,3,0
401365870,Fordham Rams,D. Quisenberry,4397790,,False,31.0,4,13,3,5,1,8,6,7,0,3,3,2,2,0,5,3,15
401365870,Fordham Rams,Z. Riley,4914388,,False,17.0,3,4,1,1,2,3,0,0,1,0,1,0,0,0,2,1,8
401365870,Fordham Rams,TEAM,TOTAL,TOTAL,False,,23,63,15,36,8,27,19,21,16,21,37,15,6,4,15,22,73
401365869,George Washington Revolutionaries,M. Gally,4592445,,True,3.0,1,2,0,0,1,2,0,0,0,1,1,0,0,0,0,0,3
401365869,George Washington Revolutionaries,R. Lindo Jr.,4397186,,True,39.0,6,11,6,11,0,0,0,0,1,13,14,1,2,1,4,5,12
401365869,George Washington Revolutionaries,T. Stamoulis,4897076,,True,3.0,0,1,0,1,0,0,0,0,0,1,1,0,0,0,0,0,0
401365869,George Washington Revolutionaries,A. Harris,4397216,,True,3.0,1,1,1,1,0,0,0,0,0,1,1,1,0,0,1,0,2
401365869,George Washington Revolutionaries,B. Knapp,4279473,,True,3.0,0,0,0,0,0,0,0,0,0,1,1,0,0,0,0,0,0
401365869,George Washington Revolutionaries,H. Dean,4593273,,False,39.0,3,5,3,5,0,0,5,8,2,9,11,2,1,0,3,4,11
401365869,George Washington Revolutionaries,Q. Samuels,4592251,,False,14.0,1,3,1,2,0,1,0,0,1,3,4,1,0,0,1,2,2
401365869,George Washington Revolutionaries,N. Brown,4700963,,False,1.0,0,0,0,0,0,0,0,0,0,0,0,0,0,0,0,0,0
401365869,George Washington Revolutionaries,B. Freeman,4613126,,False,45.0,5,14,4,13,1,1,0,0,0,2,2,6,0,0,3,3,11
401365869,George Washington Revolutionaries,J. Bamisile,4432537,,False,49.0,11,19,8,13,3,6,5,6,1,6,7,1,1,1,3,2,30
401365869,George Washington Revolutionaries,J. Bishop,4431770,,False,41.0,6,12,3,7,3,5,8,8,0,2,2,2,0,1,2,2,23
401365869,George Washington Revolutionaries,B. Adams,4396612,,False,35.0,0,3,0,2,0,1,4,4,1,4,5,3,1,0,2,0,4
401365869,George Washington Revolutionaries,TEAM,TOTAL,TOTAL,False,,34,71,26,55,8,16,22,26,8,48,56,17,5,3,19,18,98
401365869,Duquesne Dukes,M. Hima,4700878,,True,22.0,2,4,2,4,0,0,0,0,2,4,6,1,1,2,1,2,4
401365869,Duquesne Dukes,A. Spears,4897090,,True,52.0,11,26,11,22,0,4,3,5,0,2,2,6,2,1,1,2,25
401365869,Duquesne Dukes,M. Bekelja,4700874,,True,18.0,0,3,0,2,0,1,0,0,0,1,1,0,0,0,2,4,0
401365869,Duquesne Dukes,T. Okani,4700873,,True,25.0,2,8,2,6,0,2,1,2,0,1,1,0,1,1,1,3,5
401365869,Duquesne Dukes,T. Acuff,4606831,,True,47.0,7,13,6,7,1,6,0,0,1,4,5,1,2,2,1,2,15
401365869,Duquesne Dukes,K. Easley,4398159,,False,44.0,3,12,3,6,0,6,0,0,5,6,11,0,6,4,1,3,6
401365869,Duquesne Dukes,D. Larson,4897091,,False,29.0,3,5,1,3,2,2,0,0,3,6,9,1,1,0,0,3,8
401365869,Duquesne Dukes,J. Johnson III,4897088,,False,38.0,9,20,5,9,4,11,8,12,0,4,4,2,2,0,1,1,30
401365869,Duquesne Dukes,TEAM,TOTAL,TOTAL,False,,37,91,30,59,7,32,12,19,11,30,41,11,15,10,8,20,93
401365868,George Mason Patriots,J. Oduro,4432068,,True,35.0,4,17,4,16,0,1,3,4,3,6,9,1,2,0,0,1,11
401365868,George Mason Patriots,R. Polite III,4567711,,True,18.0,2,5,1,2,1,3,0,0,0,1,1,3,1,0,3,0,5
401365868,George Mason Patriots,D. Gaines,4431961,,True,32.0,3,7,0,2,3,5,2,3,2,5,7,2,0,0,1,5,11
401365868,George Mason Patriots,D. Cooper,4279876,,True,29.0,3,9,0,2,3,7,2,2,0,2,2,1,0,0,0,2,11
401365868,George Mason Patriots,D. Schwartz,4278501,,True,35.0,4,9,3,4,1,5,2,3,0,0,0,1,0,0,2,5,11
401365868,George Mason Patriots,B. Jones,4897083,,False,16.0,3,3,2,2,1,1,0,0,0,4,4,0,2,0,0,0,7
401365868,George Mason Patriots,O. Frazier III,4700882,,False,3.0,0,0,0,0,0,0,0,0,0,0,0,0,0,0,0,0,0
401365868,George Mason Patriots,B. Buchanan,4395691,,False,2.0,0,0,0,0,0,0,0,0,0,0,0,0,0,0,0,1,0
401365868,George Mason Patriots,X. Johnson,4592439,,False,16.0,0,0,0,0,0,0,0,0,0,2,2,2,0,0,2,1,0
401365868,George Mason Patriots,J. Hartwell II,4396817,,False,14.0,2,5,0,0,2,5,0,0,0,1,1,1,0,0,0,2,6
401365868,George Mason Patriots,TEAM,TOTAL,TOTAL,False,,21,55,10,28,11,27,9,12,6,22,28,11,5,0,9,17,62
401365868,Davidson Wildcats,L. Brajkovic,4396787,,True,35.0,6,10,4,4,2,6,1,2,1,5,6,3,0,1,3,3,15
401365868,Davidson Wildcats,N. Boachie-Yiadom,4396786,,True,20.0,3,6,3,6,0,0,2,2,3,0,3,3,0,1,1,3,8
401365868,Davidson Wildcats,B. Craig,4700863,,True,3.0,0,0,0,0,0,0,0,0,0,0,0,0,0,0,0,0,0
401365868,Davidson Wildcats,D. Dibble,4592309,,True,3.0,0,0,0,0,0,0,0,0,0,2,2,0,0,0,0,0,0
401365868,Davidson Wildcats,M. Jones,4396784,,True,34.0,1,8,1,5,0,3,4,6,1,3,4,0,1,1,1,0,6
401365868,Davidson Wildcats,S. Mennenga,4700862,,False,22.0,4,8,3,7,1,1,0,2,3,3,6,0,1,0,2,1,9
401365868,Davidson Wildcats,D. Kristensen,4432020,,False,0.0,0,0,0,0,0,0,0,0,0,1,1,0,0,0,0,0,0
401365868,Davidson Wildcats,S. Thrastarson,4897100,,False,0.0,0,0,0,0,0,0,0,0,0,0,0,0,0,0,0,0,0
401365868,Davidson Wildcats,D. Watson,4897098,,False,13.0,3,4,3,4,0,0,0,0,1,2,3,1,0,0,0,2,6
401365868,Davidson Wildcats,H. Lee,4592308,,False,33.0,7,12,4,6,3,6,1,4,0,8,8,1,0,0,1,1,18
401365868,Davidson Wildcats,E. Lanier,4567082,,False,3.0,0,0,0,0,0,0,0,0,0,0,0,1,0,0,1,0,0
401365868,Davidson Wildcats,G. Huffman,4432522,,False,34.0,4,7,4,5,0,2,3,4,0,3,3,3,0,0,0,0,11
401365868,Davidson Wildcats,TEAM,TOTAL,TOTAL,False,,28,55,22,37,6,18,11,20,9,27,36,12,2,3,9,10,73
401365867,VCU Rams,H. Ward,4592495,,True,18.0,4,4,4,4,0,0,1,1,1,3,4,2,1,6,3,4,9
401365867,VCU Rams,V. Williams Jr.,4397227,,True,35.0,3,11,2,4,1,7,6,6,0,7,7,6,2,1,3,3,13
401365867,VCU Rams,J. Nunn,4896614,,True,33.0,3,6,1,3,2,3,1,2,0,3,3,5,1,0,3,1,9
401365867,VCU Rams,A. Baldwin Jr.,4433182,,True,37.0,5,11,4,7,1,4,1,2,1,6,7,3,2,1,6,2,12
401365867,VCU Rams,K. Curry,4397228,,True,28.0,5,7,5,5,0,2,4,4,0,6,6,2,1,0,3,2,14
401365867,VCU Rams,M. Brown-Jones,4433224,,False,12.0,3,4,3,4,0,0,2,4,3,2,5,0,1,0,2,1,8
401365867,VCU Rams,J. DeLoach,4432483,,False,16.0,3,4,3,4,0,0,1,1,2,2,4,0,0,0,0,3,7
401365867,VCU Rams,L. Stockard III,4277897,,False,6.0,1,2,1,2,0,0,0,0,0,1,1,0,0,0,0,0,2
401365867,VCU Rams,N. Kern,4684145,,False,9.0,0,2,0,2,0,0,0,0,1,1,2,0,0,0,0,0,0
401365867,VCU Rams,A. Henderson VI,4592494,,False,1.0,0,1,0,1,0,0,0,0,0,0,0,0,0,0,0,0,0
401365867,VCU Rams,J. Banks,4432402,,False,5.0,0,1,0,0,0,1,0,0,0,0,0,0,0,0,0,0,0
401365867,VCU Rams,TEAM,TOTAL,TOTAL,False,,27,53,23,36,4,17,16,20,8,32,40,18,8,8,20,16,74
401365867,St. Bonaventure Bonnies,A. Coulibaly,4432889,,True,17.0,3,8,3,8,0,0,1,2,2,2,4,0,0,0,0,4,7
401365867,St. Bonaventure Bonnies,J. Adaway,4279431,,True,38.0,4,16,4,11,0,5,4,6,0,7,7,2,3,0,1,2,12
401365867,St. Bonaventure Bonnies,J. Holmes,4701016,,True,40.0,3,6,2,4,1,2,3,6,0,1,1,2,1,1,1,1,10
401365867,St. Bonaventure Bonnies,D. Welch,4397221,,True,36.0,3,13,1,6,2,7,2,2,2,5,7,0,4,1,4,0,10
401365867,St. Bonaventure Bonnies,K. Lofton,4397220,,True,38.0,4,11,4,9,0,2,0,0,1,0,1,5,6,0,8,3,8
401365867,St. Bonaventure Bonnies,O. Durosinmi,4684462,,False,22.0,1,1,1,1,0,0,0,2,1,4,5,1,0,2,1,4,2
401365867,St. Bonaventure Bonnies,J. Ndjock-Tadjore,4897048,,False,1.0,0,0,0,0,0,0,0,0,0,0,0,0,0,0,0,0,0
401365867,St. Bonaventure Bonnies,J. Saizonou,4897046,,False,2.0,0,0,0,0,0,0,2,2,0,0,0,0,0,0,0,0,2
401365867,St. Bonaventure Bonnies,Q. Adams,4585591,,False,6.0,0,0,0,0,0,0,0,0,0,0,0,1,0,0,1,0,0
401365867,St. Bonaventure Bonnies,TEAM,TOTAL,TOTAL,False,,18,55,15,39,3,16,12,20,9,20,29,11,14,4,17,14,51
401365866,Richmond Spiders,T. Burton,4431914,,True,23.0,0,5,0,4,0,1,3,4,0,4,4,1,2,1,2,2,3
401365866,Richmond Spiders,N. Cayo,4278380,,True,27.0,4,8,4,8,0,0,1,2,1,1,2,0,1,0,1,4,9
401365866,Richmond Spiders,G. Golden,4066836,,True,30.0,6,13,6,13,0,0,3,3,2,8,10,1,0,2,0,1,15
401365866,Richmond Spiders,A. Gustavson,4397193,,True,39.0,1,4,1,2,0,2,0,0,1,4,5,2,0,0,1,0,2
401365866,Richmond Spiders,J. Gilyard,4278378,,True,40.0,4,12,1,5,3,7,1,2,0,1,1,3,3,3,4,3,12
401365866,Richmond Spiders,M. Grace,4397192,,False,21.0,3,7,3,5,0,2,0,0,0,1,1,1,1,0,0,2,6
401365866,Richmond Spiders,D. Bailey,4700974,,False,7.0,0,0,0,0,0,0,0,0,0,0,0,0,1,0,0,0,0
401365866,Richmond Spiders,I. Wilson,4700973,,False,0.0,0,0,0,0,0,0,0,0,0,0,0,0,0,0,0,0,0
401365866,Richmond Spiders,C. Crabtree,4396658,,False,3.0,1,2,1,1,0,1,1,1,1,0,1,0,0,0,1,0,3
401365866,Richmond Spiders,N. Sherod,4066832,,False,10.0,1,5,0,2,1,3,0,0,0,2,2,0,0,0,0,0,3
401365866,Richmond Spiders,TEAM,TOTAL,TOTAL,False,,20,56,16,40,4,16,9,12,6,23,29,8,8,6,10,12,53
401365866,Dayton Flyers,R.J. Blakney,4700864,,True,35.0,3,11,2,6,1,5,3,6,3,4,7,1,0,0,0,2,10
401365866,Dayton Flyers,T. Camara,4431736,,True,35.0,4,10,3,6,1,4,2,2,3,9,12,1,1,1,2,3,11
401365866,Dayton Flyers,D. Holmes II,4433607,,True,35.0,4,6,4,6,0,0,0,0,0,9,9,2,0,1,2,1,8
401365866,Dayton Flyers,M. Smith,4683861,,True,37.0,4,11,3,8,1,3,1,1,1,2,3,4,2,1,1,3,10
401365866,Dayton Flyers,K. Elvis,4683135,,True,26.0,2,8,0,3,2,5,0,0,0,2,2,2,1,0,3,2,6
401365866,Dayton Flyers,M. Amzil,4711607,,False,10.0,0,1,0,1,0,0,0,0,1,2,3,0,0,0,4,0,0
401365866,Dayton Flyers,K. Brea,4591259,,False,22.0,4,9,2,5,2,4,0,0,0,1,1,1,2,0,2,2,10
401365866,Dayton Flyers,TEAM,TOTAL,TOTAL,False,,21,56,14,35,7,21,6,9,10,29,39,11,6,3,15,13,55
401365406,Saint Peter's Peacocks,O. Diahame,4703529,,True,5.0,0,0,0,0,0,0,1,2,0,0,0,0,2,1,0,0,1
401365406,Saint Peter's Peacocks,H. Drame,4593387,,True,12.0,3,3,2,2,1,1,0,0,1,2,3,0,0,2,0,4,7
401365406,Saint Peter's Peacocks,K. Ndefo,4398386,,True,32.0,4,10,3,7,1,3,5,6,1,6,7,3,2,6,2,3,14
401365406,Saint Peter's Peacocks,M. Lee,4593388,,True,30.0,1,3,1,1,0,2,3,4,0,4,4,5,1,0,2,2,5
401365406,Saint Peter's Peacocks,D. Banks III,4593386,,True,29.0,4,13,3,9,1,4,2,4,2,3,5,2,0,1,1,2,11
401365406,Saint Peter's Peacocks,C. Rupert,4898258,,False,18.0,4,7,4,7,0,0,0,0,0,3,3,0,1,3,1,3,8
401365406,Saint Peter's Peacocks,F. Drame,4432970,,False,21.0,0,2,0,2,0,0,0,0,0,7,7,0,0,0,1,0,0
401365406,Saint Peter's Peacocks,L. Reid,4898255,,False,1.0,0,0,0,0,0,0,0,0,0,1,1,0,0,0,1,1,0
401365406,Saint Peter's Peacocks,M. Silvera,4703527,,False,1.0,0,0,0,0,0,0,0,0,0,0,0,0,0,0,0,0,0
401365406,Saint Peter's Peacocks,I. Dasher,4701199,,False,14.0,1,3,1,3,0,0,0,0,1,1,2,1,0,0,2,0,2
401365406,Saint Peter's Peacocks,J. Murray,4683865,,False,10.0,0,3,0,2,0,1,1,2,0,0,0,1,1,0,1,0,1
401365406,Saint Peter's Peacocks,D. Edert,4432977,,False,27.0,3,6,1,3,2,3,0,0,0,1,1,0,1,0,1,1,8
401365406,Saint Peter's Peacocks,TEAM,TOTAL,TOTAL,False,,20,50,15,36,5,14,12,18,7,29,36,12,8,13,12,16,57
401365406,Fairfield Stags,S. Cook,4702946,,True,25.0,3,8,3,8,0,0,4,6,1,7,8,0,0,2,1,1,10
401365406,Fairfield Stags,J. Wojcik,4397191,,True,30.0,2,7,2,4,0,3,1,2,0,2,2,2,1,0,2,2,5
401365406,Fairfield Stags,C. Green,4280068,,True,35.0,2,10,0,3,2,7,0,0,0,2,2,0,1,0,3,2,6
401365406,Fairfield Stags,J. Cruz,4279488,,True,27.0,5,9,4,7,1,2,0,1,0,5,5,0,0,0,3,5,11
401365406,Fairfield Stags,T. Benning,4279483,,True,34.0,1,11,1,5,0,6,2,2,2,5,7,1,0,2,0,3,4
401365406,Fairfield Stags,J. Brown,4702948,,False,1.0,0,1,0,1,0,0,0,0,0,1,1,0,0,0,0,0,0
401365406,Fairfield Stags,A. Jeanne-Rose,4593277,,False,12.0,0,0,0,0,0,0,0,0,1,0,1,1,0,0,0,1,0
401365406,Fairfield Stags,C. Maidoh,4593276,,False,12.0,1,4,1,4,0,0,0,0,2,1,3,0,1,1,1,0,2
401365406,Fairfield Stags,Z. Crisler,4431936,,False,3.0,0,1,0,0,0,1,0,2,0,0,0,0,0,0,0,0,0
401365406,Fairfield Stags,TJ Long,4896370,,False,18.0,1,7,0,4,1,3,0,1,2,2,4,0,0,0,1,0,3
401365406,Fairfield Stags,C. Cevis,4896369,,False,1.0,0,0,0,0,0,0,0,0,0,0,0,0,1,0,0,1,0
401365406,Fairfield Stags,J. Mullally,4594162,,False,1.0,0,0,0,0,0,0,0,0,0,0,0,0,0,0,0,0,0
401365406,Fairfield Stags,M. Henry,4593278,,False,1.0,0,0,0,0,0,0,0,0,0,0,0,0,0,0,0,0,0
401365406,Fairfield Stags,TEAM,TOTAL,TOTAL,False,,15,58,11,36,4,22,7,14,14,26,40,4,4,5,15,15,41
401365405,Niagara Purple Eagles,G. Kuakumensah,4279739,,True,19.0,1,2,1,1,0,1,0,0,1,4,5,2,2,1,0,3,2
401365405,Niagara Purple Eagles,J. Cintron,4278891,,True,26.0,3,4,3,4,0,0,7,8,2,7,9,2,2,2,2,3,13
401365405,Niagara Purple Eagles,N. Thomasson,4593752,,True,36.0,11,14,9,11,2,3,3,4,1,2,3,3,0,1,0,1,27
401365405,Niagara Purple Eagles,M. Hammond,4398404,,True,35.0,8,16,4,7,4,9,1,1,0,3,3,3,1,0,1,1,21
401365405,Niagara Purple Eagles,J. Roberts,4067403,,True,29.0,2,7,1,2,1,5,0,0,0,2,2,2,0,0,0,2,5
401365405,Niagara Purple Eagles,T. Traore,4703431,,False,8.0,0,1,0,1,0,0,2,2,0,4,4,0,0,0,2,1,2
401365405,Niagara Purple Eagles,S. Iorio,4280029,,False,22.0,4,7,4,7,0,0,0,0,2,3,5,0,2,1,2,1,8
401365405,Niagara Purple Eagles,N. Kratholm,4278489,,False,4.0,1,1,1,1,0,0,0,0,0,1,1,0,0,0,0,0,2
401365405,Niagara Purple Eagles,J. Mackey,4719433,,False,13.0,1,3,0,2,1,1,0,0,0,0,0,2,0,0,1,0,3
401365405,Niagara Purple Eagles,S. Levnaic,4398406,,False,4.0,0,0,0,0,0,0,0,0,1,0,1,1,0,0,0,1,0
401365405,Niagara Purple Eagles,S. Brown,4396836,,False,4.0,0,2,0,1,0,1,0,0,0,0,0,1,0,0,1,1,0
401365405,Niagara Purple Eagles,TEAM,TOTAL,TOTAL,False,,31,57,23,37,8,20,13,15,7,26,33,16,7,5,9,14,83
401365405,Marist Red Foxes,B. Bell,4593334,,True,26.0,3,4,0,1,3,3,0,0,0,3,3,0,1,0,2,3,9
401365405,Marist Red Foxes,V. Enoh,4278286,,True,12.0,1,4,1,4,0,0,0,0,1,0,1,1,0,0,1,3,2
401365405,Marist Red Foxes,J. Ituka,4896378,,True,23.0,6,13,5,10,1,3,6,6,0,1,1,0,1,0,3,2,19
401365405,Marist Red Foxes,R. Wright,4703831,,True,25.0,1,6,1,4,0,2,2,2,1,6,7,0,0,0,4,2,4
401365405,Marist Red Foxes,T. Saint-Furcy,4593333,,True,17.0,1,4,1,3,0,1,0,0,0,2,2,0,2,0,0,0,2
401365405,Marist Red Foxes,J. Cooley,4703833,,False,12.0,1,2,1,1,0,1,1,1,0,1,1,1,1,0,0,1,3
401365405,Marist Red Foxes,R. Belton,4896377,,False,13.0,0,2,0,2,0,0,0,1,0,0,0,1,0,1,0,1,0
401365405,Marist Red Foxes,J. Jones,4067302,,False,15.0,4,7,4,7,0,0,0,0,1,2,3,0,0,0,0,2,8
401365405,Marist Red Foxes,S. Cele,4703202,,False,9.0,1,1,1,1,0,0,0,0,0,1,1,0,0,0,1,0,2
401365405,Marist Red Foxes,N. Harris,4896379,,False,27.0,1,4,0,1,1,3,0,0,0,0,0,1,1,0,0,0,3
401365405,Marist Red Foxes,R. Sullivan,4703830,,False,21.0,0,5,0,5,0,0,0,0,0,2,2,1,1,0,1,1,0
401365405,Marist Red Foxes,TEAM,TOTAL,TOTAL,False,,19,52,14,39,5,13,9,10,3,18,21,5,7,1,12,15,52
401365404,Siena Saints,J. Stormo,4397697,,True,36.0,8,11,8,11,0,0,2,2,2,9,11,4,0,1,3,1,18
401365404,Siena Saints,J. Billups,4898266,,True,33.0,1,3,1,3,0,0,0,0,0,0,0,2,1,2,5,4,2
401365404,Siena Saints,C. Rogers,4592921,,True,35.0,6,7,1,1,5,6,0,0,0,3,3,3,3,1,3,2,17
401365404,Siena Saints,A. Gaines,4277972,,True,34.0,3,9,3,6,0,3,0,1,0,6,6,3,0,0,4,2,6
401365404,Siena Saints,N. Hopkins,4067151,,True,21.0,2,4,0,0,2,4,1,2,0,0,0,0,1,0,2,2,7
401365404,Siena Saints,J. Kellier,4702457,,False,4.0,0,1,0,1,0,0,0,0,0,0,0,0,0,0,0,1,0
401365404,Siena Saints,M. Baer,4397031,,False,10.0,2,4,1,3,1,1,0,0,0,3,3,0,0,0,0,0,5
401365404,Siena Saints,J. McCollum,4898267,,False,27.0,2,7,2,4,0,3,5,6,0,4,4,1,1,0,3,1,9
401365404,Siena Saints,TEAM,TOTAL,TOTAL,False,,24,46,16,29,8,17,8,11,2,28,30,13,6,4,20,13,64
401365404,Canisius Golden Griffins,G. Maslennikov,4702952,,True,14.0,3,6,2,5,1,1,0,0,2,1,3,4,0,0,1,1,7
401365404,Canisius Golden Griffins,J. Fritz,4593148,,True,29.0,4,5,4,5,0,0,1,2,0,2,2,2,0,0,1,0,9
401365404,Canisius Golden Griffins,A. Fofana,4702949,,True,34.0,5,13,2,6,3,7,0,1,0,2,2,4,6,0,2,3,13
401365404,Canisius Golden Griffins,A. Harried,4593149,,True,36.0,4,11,4,9,0,2,3,4,1,5,6,4,3,0,1,1,11
401365404,Canisius Golden Griffins,J. Henderson,4398046,,True,35.0,4,8,3,3,1,5,0,0,0,2,2,3,2,0,3,1,9
401365404,Canisius Golden Griffins,M. Green,4279878,,False,19.0,7,13,7,11,0,2,2,2,1,1,2,0,0,0,0,1,16
401365404,Canisius Golden Griffins,S. Hitchon,4279482,,False,2.0,0,0,0,0,0,0,0,0,0,1,1,0,0,0,1,0,0
401365404,Canisius Golden Griffins,X. Long,4896367,,False,18.0,1,6,1,4,0,2,0,0,6,5,11,1,1,0,1,1,2
401365404,Canisius Golden Griffins,A. Ahemed,4593147,,False,13.0,0,2,0,1,0,1,0,0,0,1,1,1,0,0,2,4,0
401365404,Canisius Golden Griffins,TEAM,TOTAL,TOTAL,False,,28,64,23,44,5,20,6,9,11,21,32,19,12,0,12,12,67
401365403,Quinnipiac Bobcats,J. Rigoni,4279743,,True,27.0,4,9,1,1,3,8,0,0,2,2,4,0,1,0,2,4,11
401365403,Quinnipiac Bobcats,K. Marfo,4066877,,True,23.0,0,1,0,1,0,0,4,4,3,5,8,2,1,1,5,3,4
401365403,Quinnipiac Bobcats,T. Chenery,4703434,,True,29.0,4,10,3,6,1,4,0,0,0,1,1,1,2,0,0,1,9
401365403,Quinnipiac Bobcats,D. Jones,4898242,,True,31.0,3,10,2,6,1,4,6,6,1,1,2,4,2,0,4,2,13
401365403,Quinnipiac Bobcats,M. Balanc,4398397,,True,33.0,5,12,2,2,3,10,0,0,1,3,4,0,1,0,1,0,13
401365403,Quinnipiac Bobcats,E. King,4703436,,False,2.0,0,0,0,0,0,0,0,0,0,0,0,0,0,0,0,0,0
401365403,Quinnipiac Bobcats,J. Riggins,4432089,,False,15.0,2,3,2,3,0,0,2,2,0,1,1,0,1,0,0,2,6
401365403,Quinnipiac Bobcats,Q. Guth,4902535,,False,2.0,0,1,0,1,0,0,0,0,0,0,0,0,0,0,0,0,0
401365403,Quinnipiac Bobcats,B. Blunt,4898243,,False,4.0,0,1,0,0,0,1,0,0,0,0,0,0,0,0,0,0,0
401365403,Quinnipiac Bobcats,L. Kortright,4703435,,False,13.0,0,6,0,4,0,2,1,2,1,2,3,4,1,0,0,0,1
401365403,Quinnipiac Bobcats,B. Martin,4609885,,False,2.0,0,0,0,0,0,0,0,0,0,0,0,0,0,0,0,0,0
401365403,Quinnipiac Bobcats,B. McGuire,4433042,,False,19.0,1,3,1,1,0,2,2,2,0,5,5,1,0,0,1,1,4
401365403,Quinnipiac Bobcats,TEAM,TOTAL,TOTAL,False,,19,56,11,25,8,31,15,16,8,23,31,12,9,1,14,13,61
401365403,Iona Gaels,D. van Eyck,4593320,,True,22.0,3,4,1,2,2,2,2,2,1,3,4,5,0,3,0,0,10
401365403,Iona Gaels,N. Junior Joseph,4703015,,True,32.0,5,9,5,9,0,0,3,5,3,4,7,1,1,0,2,2,13
401365403,Iona Gaels,C. Cashaw,4593318,,True,13.0,0,2,0,2,0,0,0,0,0,0,0,1,1,0,1,0,0
401365403,Iona Gaels,E. Joiner,4278407,,True,26.0,3,11,1,9,2,2,0,0,0,7,7,1,3,0,3,0,8
401365403,Iona Gaels,T. Jolly,4066291,,True,34.0,5,14,5,10,0,4,2,2,4,4,8,2,0,2,2,4,12
401365403,Iona Gaels,O. Shema,4703016,,False,8.0,1,2,1,2,0,0,0,0,1,3,4,0,0,1,2,3,2
401365403,Iona Gaels,Q. Slazinski,4431768,,False,18.0,6,9,4,4,2,5,2,4,0,1,1,4,1,0,0,0,16
401365403,Iona Gaels,O. Rainey,4960804,,False,1.0,0,2,0,0,0,2,0,0,0,0,0,0,0,0,0,0,0
401365403,Iona Gaels,J. Duach,4896373,,False,4.0,1,1,1,1,0,0,0,0,0,0,0,0,0,0,0,0,2
401365403,Iona Gaels,W. Clayton Jr.,4896372,,False,12.0,2,3,1,1,1,2,2,2,0,2,2,1,0,0,1,1,7
401365403,Iona Gaels,R. Myers,4703009,,False,4.0,1,2,1,1,0,1,0,0,0,0,0,0,0,0,1,0,2
401365403,Iona Gaels,B. JeanLouis,4703008,,False,21.0,2,2,2,2,0,0,3,3,1,1,2,1,1,0,0,3,7
401365403,Iona Gaels,P. Weiss,4593317,,False,5.0,0,2,0,0,0,2,0,0,1,0,1,1,0,0,0,0,0
401365403,Iona Gaels,TEAM,TOTAL,TOTAL,False,,29,63,22,43,7,20,14,18,12,27,39,17,7,6,12,13,79
401365402,Rider Broncs,M. James,4592283,,True,32.0,10,12,10,12,0,0,3,4,4,3,7,0,1,0,1,1,23
401365402,Rider Broncs,A. Ogemuno-Johnson,4406151,,True,31.0,3,3,3,3,0,0,6,8,1,6,7,1,1,0,0,2,12
401365402,Rider Broncs,D. Vaughn,4067347,,True,32.0,2,7,1,2,1,5,3,5,0,7,7,2,2,1,3,5,8
401365402,Rider Broncs,A. Powell,4593364,,True,36.0,2,12,0,4,2,8,2,2,1,1,2,4,0,0,3,3,8
401365402,Rider Broncs,D. Murray Jr.,4398029,,True,38.0,4,9,2,4,2,5,6,6,0,5,5,6,0,0,2,0,16
401365402,Rider Broncs,N. Benson,4705270,,False,11.0,1,1,0,0,1,1,0,0,0,0,0,1,0,0,0,4,3
401365402,Rider Broncs,C. McKeithan,4433243,,False,17.0,2,3,2,3,0,0,0,0,1,1,2,0,0,0,0,2,4
401365402,Rider Broncs,S. Altman,4432935,,False,3.0,0,1,0,1,0,0,0,0,0,0,0,1,0,0,0,1,0
401365402,Rider Broncs,TEAM,TOTAL,TOTAL,False,,24,48,18,29,6,19,20,25,8,25,33,15,4,1,11,18,74
401365402,Monmouth Hawks,J. Vaughan,4593338,,True,15.0,0,1,0,0,0,1,0,2,3,1,4,2,0,0,0,3,0
401365402,Monmouth Hawks,W. Miller,4277910,,True,33.0,4,10,4,9,0,1,3,5,3,6,9,1,0,1,1,3,11
401365402,Monmouth Hawks,M. McClary,4279736,,True,25.0,4,7,3,5,1,2,1,2,1,3,4,1,1,0,0,4,10
401365402,Monmouth Hawks,G. Papas,4279735,,True,34.0,3,11,1,1,2,10,3,3,0,3,3,1,0,0,2,2,11
401365402,Monmouth Hawks,S. Reynolds,4278578,,True,27.0,5,11,1,5,4,6,1,2,2,2,4,2,2,0,3,4,15
401365402,Monmouth Hawks,K. Vuga,4703428,,False,5.0,0,0,0,0,0,0,0,0,0,1,1,0,0,0,0,2,0
401365402,Monmouth Hawks,M. Foster,4703425,,False,22.0,3,7,3,7,0,0,0,2,1,3,4,0,0,1,0,1,6
401365402,Monmouth Hawks,M. Ruth,4703427,,False,20.0,1,3,0,1,1,2,1,2,0,0,0,1,1,0,0,2,4
401365402,Monmouth Hawks,S. Chaput,4398409,,False,19.0,3,5,2,4,1,1,1,2,1,2,3,4,0,0,1,2,8
401365402,Monmouth Hawks,TEAM,TOTAL,TOTAL,False,,23,55,14,32,9,23,10,20,11,21,32,12,4,2,9,23,65
401365401,Quinnipiac Bobcats,J. Rigoni,4279743,,True,24.0,1,6,1,2,0,4,0,0,1,2,3,1,0,0,1,1,2
401365401,Quinnipiac Bobcats,K. Marfo,4066877,,True,28.0,3,4,3,4,0,0,2,2,2,5,7,4,1,1,4,2,8
401365401,Quinnipiac Bobcats,T. Chenery,4703434,,True,33.0,2,9,1,6,1,3,3,4,1,1,2,2,1,0,0,1,8
401365401,Quinnipiac Bobcats,D. Jones,4898242,,True,37.0,10,16,6,6,4,10,2,3,0,3,3,2,4,0,4,1,26
401365401,Quinnipiac Bobcats,M. Balanc,4398397,,True,32.0,6,13,4,6,2,7,3,4,0,10,10,0,1,1,0,3,17
401365401,Quinnipiac Bobcats,J. Riggins,4432089,,False,12.0,2,3,2,3,0,0,0,0,2,3,5,1,1,0,1,2,4
401365401,Quinnipiac Bobcats,L. Kortright,4703435,,False,19.0,0,5,0,3,0,2,0,0,1,0,1,2,0,0,2,3,0
401365401,Quinnipiac Bobcats,B. McGuire,4433042,,False,15.0,2,2,1,1,1,1,2,2,0,0,0,0,0,1,1,4,7
401365401,Quinnipiac Bobcats,TEAM,TOTAL,TOTAL,False,,26,58,18,31,8,27,12,15,9,24,33,12,8,3,14,17,72
401365401,Monmouth Hawks,N. Rutty,4398408,,True,1.0,0,0,0,0,0,0,0,0,0,0,0,0,0,0,0,0,0
401365401,Monmouth Hawks,W. Miller,4277910,,True,28.0,3,9,1,6,2,3,2,4,2,4,6,3,1,0,3,3,10
401365401,Monmouth Hawks,M. McClary,4279736,,True,26.0,4,8,4,8,0,0,0,0,2,2,4,0,0,0,0,3,8
401365401,Monmouth Hawks,G. Papas,4279735,,True,36.0,5,13,1,3,4,10,2,3,1,7,8,4,2,1,2,1,16
401365401,Monmouth Hawks,S. Reynolds,4278578,,True,38.0,5,16,4,10,1,6,6,6,2,3,5,6,1,1,1,2,17
401365401,Monmouth Hawks,M. Foster,4703425,,False,11.0,4,4,4,4,0,0,0,1,1,1,2,0,1,0,0,0,8
401365401,Monmouth Hawks,J. Vaughan,4593338,,False,13.0,3,4,2,3,1,1,0,0,2,1,3,1,1,0,1,3,7
401365401,Monmouth Hawks,M. Ruth,4703427,,False,18.0,1,3,1,2,0,1,0,0,0,1,1,0,4,1,1,1,2
401365401,Monmouth Hawks,S. Chaput,4398409,,False,29.0,3,4,2,2,1,2,0,0,0,2,2,3,0,0,4,2,7
401365401,Monmouth Hawks,TEAM,TOTAL,TOTAL,False,,28,61,19,38,9,23,10,14,11,22,33,17,10,3,13,15,75
401365400,Manhattan Jaspers,S. Diallo,4397161,,True,36.0,4,7,3,5,1,2,4,6,2,6,8,2,3,0,1,2,13
401365400,Manhattan Jaspers,W. Williams,4279701,,True,19.0,4,6,4,6,0,0,1,2,4,2,6,1,1,1,2,2,9
401365400,Manhattan Jaspers,M. Watson,4703172,,True,32.0,4,6,1,2,3,4,2,2,0,1,1,0,1,0,2,2,13
401365400,Manhattan Jaspers,R. Reid,4593324,,True,29.0,1,5,0,2,1,3,1,3,0,2,2,0,1,0,0,2,4
401365400,Manhattan Jaspers,J. Perez,4397528,,True,40.0,8,23,7,19,1,4,10,14,2,2,4,6,0,0,4,2,27
401365400,Manhattan Jaspers,J. Roberts,4397122,,False,21.0,4,9,4,9,0,0,0,0,6,1,7,0,1,1,0,2,8
401365400,Manhattan Jaspers,N. Brennen,4703175,,False,4.0,0,0,0,0,0,0,0,0,1,0,1,0,0,0,0,0,0
401365400,Manhattan Jaspers,E. Buchanan,4398103,,False,19.0,0,3,0,2,0,1,0,0,0,2,2,2,2,0,1,1,0
401365400,Manhattan Jaspers,TEAM,TOTAL,TOTAL,False,,25,59,19,45,6,14,18,27,15,17,32,11,9,2,12,13,74
401365400,Iona Gaels,D. van Eyck,4593320,,True,18.0,3,5,3,3,0,2,0,0,0,3,3,0,1,1,2,2,6
401365400,Iona Gaels,N. Junior Joseph,4703015,,True,34.0,7,9,7,9,0,0,4,7,4,8,12,5,2,0,2,3,18
401365400,Iona Gaels,W. Clayton Jr.,4896372,,True,16.0,6,9,5,5,1,4,4,4,0,0,0,2,0,1,1,4,17
401365400,Iona Gaels,E. Joiner,4278407,,True,36.0,3,12,3,9,0,3,0,0,0,1,1,6,1,0,3,2,6
401365400,Iona Gaels,T. Jolly,4066291,,True,29.0,4,10,4,8,0,2,1,1,4,3,7,0,0,1,3,4,9
401365400,Iona Gaels,O. Shema,4703016,,False,6.0,0,1,0,1,0,0,1,2,1,1,2,0,0,0,0,1,1
401365400,Iona Gaels,Q. Slazinski,4431768,,False,22.0,4,6,1,2,3,4,0,0,1,5,6,1,0,0,1,1,11
401365400,Iona Gaels,R. Myers,4703009,,False,14.0,1,4,1,3,0,1,0,0,0,1,1,2,0,0,3,0,2
401365400,Iona Gaels,B. JeanLouis,4703008,,False,22.0,1,2,1,1,0,1,0,0,1,0,1,0,1,0,0,2,2
401365400,Iona Gaels,C. Cashaw,4593318,,False,3.0,0,0,0,0,0,0,0,0,0,0,0,0,0,0,0,0,0
401365400,Iona Gaels,TEAM,TOTAL,TOTAL,False,,29,58,25,41,4,17,10,14,13,22,35,16,5,3,16,19,72
401365399,Siena Saints,J. Stormo,4397697,,True,28.0,2,5,2,5,0,0,1,2,0,2,2,2,0,0,5,3,5
401365399,Siena Saints,J. Billups,4898266,,True,27.0,1,2,1,1,0,1,1,2,0,6,6,2,1,1,0,2,3
401365399,Siena Saints,C. Rogers,4592921,,True,33.0,4,11,3,7,1,4,1,2,0,1,1,0,0,0,0,2,10
401365399,Siena Saints,A. Gaines,4277972,,True,32.0,4,11,4,10,0,1,2,4,2,6,8,2,0,0,5,3,10
401365399,Siena Saints,N. Hopkins,4067151,,True,26.0,0,2,0,0,0,2,2,2,0,0,0,0,1,0,1,2,2
401365399,Siena Saints,S. Lazar,4703517,,False,4.0,0,0,0,0,0,0,0,0,0,0,0,0,0,0,0,0,0
401365399,Siena Saints,J. Kellier,4702457,,False,16.0,2,5,1,2,1,3,3,4,0,2,2,0,0,2,2,2,8
401365399,Siena Saints,M. Tertsea,4607618,,False,4.0,0,1,0,1,0,0,0,0,0,2,2,0,0,0,0,0,0
401365399,Siena Saints,M. Baer,4397031,,False,8.0,0,1,0,0,0,1,0,0,0,0,0,0,0,1,1,1,0
401365399,Siena Saints,J. McCollum,4898267,,False,18.0,5,7,4,6,1,1,2,2,0,0,0,2,0,0,2,0,13
401365399,Siena Saints,R. Mahala,4398389,,False,4.0,0,0,0,0,0,0,1,2,0,1,1,0,1,0,0,0,1
401365399,Siena Saints,TEAM,TOTAL,TOTAL,False,,18,45,15,32,3,13,13,20,2,20,22,8,3,4,16,15,52
401365399,Niagara Purple Eagles,G. Kuakumensah,4279739,,True,25.0,4,8,4,7,0,1,0,0,3,6,9,2,0,1,3,3,8
401365399,Niagara Purple Eagles,J. Cintron,4278891,,True,23.0,1,4,1,3,0,1,0,0,2,4,6,3,3,1,1,2,2
401365399,Niagara Purple Eagles,N. Thomasson,4593752,,True,34.0,5,10,5,9,0,1,1,1,0,3,3,2,1,0,0,2,11
401365399,Niagara Purple Eagles,M. Hammond,4398404,,True,37.0,9,18,7,12,2,6,8,8,1,8,9,2,0,1,1,3,28
401365399,Niagara Purple Eagles,J. Roberts,4067403,,True,30.0,2,3,0,0,2,3,0,0,0,0,0,3,2,0,0,1,6
401365399,Niagara Purple Eagles,T. Traore,4703431,,False,6.0,2,4,2,4,0,0,0,0,2,2,4,0,1,0,1,2,4
401365399,Niagara Purple Eagles,S. Iorio,4280029,,False,24.0,4,8,4,7,0,1,5,7,2,2,4,1,1,1,3,2,13
401365399,Niagara Purple Eagles,N. Kratholm,4278489,,False,2.0,0,0,0,0,0,0,0,0,0,1,1,0,1,0,0,0,0
401365399,Niagara Purple Eagles,J. Mackey,4719433,,False,13.0,1,5,1,3,0,2,0,0,0,0,0,1,0,0,0,1,2
401365399,Niagara Purple Eagles,S. Levnaic,4398406,,False,2.0,0,1,0,0,0,1,0,0,0,0,0,0,0,0,0,0,0
401365399,Niagara Purple Eagles,S. Brown,4396836,,False,4.0,0,0,0,0,0,0,0,0,0,0,0,0,0,0,1,0,0
401365399,Niagara Purple Eagles,TEAM,TOTAL,TOTAL,False,,28,61,24,45,4,16,14,16,10,26,36,14,9,4,10,16,74
401365398,Marist Red Foxes,J. Cooley,4703833,,True,9.0,0,1,0,0,0,1,0,0,1,1,2,0,0,0,0,0,0
401365398,Marist Red Foxes,J. Jones,4067302,,True,13.0,2,5,2,5,0,0,2,2,0,1,1,1,0,1,1,1,6
401365398,Marist Red Foxes,S. Cele,4703202,,True,23.0,5,11,3,7,2,4,1,3,1,1,2,0,0,0,1,3,13
401365398,Marist Red Foxes,J. Ituka,4896378,,True,32.0,6,11,6,9,0,2,7,7,2,5,7,1,0,0,3,2,19
401365398,Marist Red Foxes,R. Wright,4703831,,True,31.0,4,8,3,3,1,5,2,2,0,5,5,4,0,0,3,2,11
401365398,Marist Red Foxes,B. Bell,4593334,,False,17.0,2,6,2,3,0,3,0,0,0,3,3,2,0,0,0,2,4
401365398,Marist Red Foxes,R. Belton,4896377,,False,3.0,0,0,0,0,0,0,0,0,0,0,0,0,0,0,0,0,0
401365398,Marist Red Foxes,V. Enoh,4278286,,False,19.0,2,4,2,4,0,0,0,0,1,7,8,1,1,1,1,3,4
401365398,Marist Red Foxes,N. Harris,4896379,,False,28.0,2,8,0,0,2,8,0,0,0,2,2,0,0,0,2,1,6
401365398,Marist Red Foxes,R. Sullivan,4703830,,False,19.0,1,4,1,2,0,2,0,0,2,3,5,1,0,0,2,2,2
401365398,Marist Red Foxes,T. Saint-Furcy,4593333,,False,6.0,1,2,1,2,0,0,0,0,1,1,2,0,0,0,1,2,2
401365398,Marist Red Foxes,TEAM,TOTAL,TOTAL,False,,25,60,20,35,5,25,12,14,11,31,42,10,1,2,15,18,67
401365398,Canisius Golden Griffins,G. Maslennikov,4702952,,True,15.0,4,5,3,4,1,1,4,4,1,1,2,0,0,3,2,1,13
401365398,Canisius Golden Griffins,J. Fritz,4593148,,True,22.0,1,2,1,1,0,1,1,2,2,2,4,2,0,0,0,1,3
401365398,Canisius Golden Griffins,A. Fofana,4702949,,True,38.0,6,14,3,5,3,9,6,7,1,8,9,2,1,0,1,2,21
401365398,Canisius Golden Griffins,A. Harried,4593149,,True,31.0,2,8,2,6,0,2,0,0,0,2,2,1,2,0,1,2,4
401365398,Canisius Golden Griffins,J. Henderson,4398046,,True,24.0,1,7,0,2,1,5,1,2,0,2,2,3,0,1,1,2,4
401365398,Canisius Golden Griffins,M. Green,4279878,,False,16.0,4,9,3,6,1,3,3,6,0,3,3,1,0,0,0,1,12
401365398,Canisius Golden Griffins,S. Hitchon,4279482,,False,5.0,1,1,1,1,0,0,0,1,0,1,1,1,0,0,0,1,2
401365398,Canisius Golden Griffins,X. Long,4896367,,False,20.0,3,5,3,5,0,0,0,0,1,1,2,2,0,0,0,2,6
401365398,Canisius Golden Griffins,A. Ahemed,4593147,,False,29.0,5,9,2,2,3,7,0,2,0,3,3,2,1,0,0,3,13
401365398,Canisius Golden Griffins,TEAM,TOTAL,TOTAL,False,,27,60,18,32,9,28,15,24,7,26,33,14,4,4,7,15,78
401365397,Rider Broncs,M. James,4592283,,True,28.0,3,6,3,6,0,0,2,2,1,2,3,0,0,2,3,2,8
401365397,Rider Broncs,A. Ogemuno-Johnson,4406151,,True,30.0,4,5,4,5,0,0,0,0,2,6,8,3,0,0,1,1,8
401365397,Rider Broncs,D. Vaughn,4067347,,True,32.0,4,10,3,7,1,3,2,4,2,2,4,0,2,1,3,2,11
401365397,Rider Broncs,A. Powell,4593364,,True,33.0,7,16,4,8,3,8,3,3,0,0,0,4,1,0,4,0,20
401365397,Rider Broncs,D. Murray Jr.,4398029,,True,30.0,4,7,2,3,2,4,0,0,1,7,8,3,1,0,4,1,10
401365397,Rider Broncs,N. Benson,4705270,,False,14.0,0,2,0,1,0,1,0,0,0,2,2,0,2,0,0,2,0
401365397,Rider Broncs,C. McKeithan,4433243,,False,20.0,1,4,1,4,0,0,0,0,0,4,4,2,1,1,2,5,2
401365397,Rider Broncs,S. Altman,4432935,,False,2.0,0,0,0,0,0,0,0,0,0,0,0,0,0,0,0,0,0
401365397,Rider Broncs,J. Pope,4288898,,False,11.0,0,1,0,0,0,1,0,0,0,0,0,1,0,0,0,0,0
401365397,Rider Broncs,TEAM,TOTAL,TOTAL,False,,23,51,17,34,6,17,7,9,8,23,31,13,7,4,17,13,59
401365397,Fairfield Stags,S. Cook,4702946,,True,27.0,2,8,2,7,0,1,0,0,2,10,12,1,0,0,4,0,4
401365397,Fairfield Stags,J. Wojcik,4397191,,True,25.0,1,3,0,2,1,1,2,2,0,3,3,3,0,1,1,1,5
401365397,Fairfield Stags,C. Green,4280068,,True,30.0,2,6,2,5,0,1,2,2,0,1,1,3,1,0,2,2,6
401365397,Fairfield Stags,J. Cruz,4279488,,True,36.0,6,12,5,7,1,5,0,0,1,2,3,2,2,0,1,2,13
401365397,Fairfield Stags,T. Benning,4279483,,True,30.0,2,5,0,3,2,2,0,0,0,1,1,2,1,0,1,2,6
401365397,Fairfield Stags,A. Jeanne-Rose,4593277,,False,12.0,1,3,1,2,0,1,0,0,0,1,1,0,0,0,2,0,2
401365397,Fairfield Stags,C. Maidoh,4593276,,False,12.0,2,4,2,4,0,0,2,2,2,0,2,1,3,0,0,0,6
401365397,Fairfield Stags,Z. Crisler,4431936,,False,3.0,0,2,0,0,0,2,0,0,0,0,0,0,0,0,0,1,0
401365397,Fairfield Stags,TJ Long,4896370,,False,25.0,8,12,1,3,7,9,0,0,1,3,4,0,1,1,0,0,23
401365397,Fairfield Stags,TEAM,TOTAL,TOTAL,False,,24,55,13,33,11,22,6,6,8,21,29,12,8,2,13,8,65
401365198,Ohio Bobcats,B. Roderick,4593447,,True,24.0,0,6,0,2,0,4,0,0,0,3,3,0,1,0,1,1,0
401365198,Ohio Bobcats,B. Vander Plas,4279448,,True,32.0,0,4,0,2,0,2,9,11,0,3,3,1,2,0,1,2,9
401365198,Ohio Bobcats,J. Carter,4067398,,True,29.0,5,12,5,9,0,3,0,1,0,4,4,0,3,2,1,4,10
401365198,Ohio Bobcats,M. Sears,4703530,,True,37.0,5,13,3,8,2,5,7,7,1,7,8,8,0,0,6,2,19
401365198,Ohio Bobcats,M. Brown,4593449,,True,29.0,3,6,0,2,3,4,0,0,0,2,2,0,0,0,0,1,9
401365198,Ohio Bobcats,A. Clayton,4898339,,False,11.0,1,2,1,1,0,1,0,0,3,0,3,1,0,1,0,2,2
401365198,Ohio Bobcats,I. Ezuma,4898338,,False,8.0,0,0,0,0,0,0,0,0,0,0,0,0,0,0,0,0,0
401365198,Ohio Bobcats,O. Adelodun,4898337,,False,4.0,1,1,1,1,0,0,0,0,0,0,0,0,0,0,0,0,2
401365198,Ohio Bobcats,T. Schmock,4407066,,False,26.0,2,7,0,1,2,6,0,0,0,5,5,0,1,0,0,0,6
401365198,Ohio Bobcats,TEAM,TOTAL,TOTAL,False,,17,51,10,26,7,25,16,19,4,25,29,10,7,3,9,12,57
401365198,Northern Illinois Huskies,A. Crump,4397550,,True,21.0,2,3,2,2,0,1,2,4,1,5,6,2,2,0,1,3,6
401365198,Northern Illinois Huskies,A. Makuoi,4703525,,True,16.0,2,4,2,4,0,0,2,2,1,2,3,0,0,0,1,2,6
401365198,Northern Illinois Huskies,Z. Russell,4898334,,True,20.0,1,1,0,0,1,1,0,0,1,2,3,1,0,0,2,4,3
401365198,Northern Illinois Huskies,K. Williams,4602029,,True,36.0,7,15,7,13,0,2,1,1,0,9,9,2,0,0,3,1,15
401365198,Northern Illinois Huskies,T. Hankerson,4397854,,True,40.0,5,11,3,4,2,7,3,4,0,2,2,2,0,2,3,3,15
401365198,Northern Illinois Huskies,Z. Kueth,4703524,,False,19.0,0,3,0,0,0,3,2,2,0,4,4,1,0,1,1,3,2
401365198,Northern Illinois Huskies,C. Kingsley Okanu,4703523,,False,24.0,1,6,1,6,0,0,0,0,2,2,4,1,0,1,2,4,2
401365198,Northern Illinois Huskies,N. Kon,4898332,,False,4.0,1,2,1,2,0,0,0,0,0,1,1,0,0,0,0,1,2
401365198,Northern Illinois Huskies,D. Hunter,4596869,,False,20.0,3,6,3,3,0,3,1,1,1,5,6,1,0,0,1,0,7
401365198,Northern Illinois Huskies,TEAM,TOTAL,TOTAL,False,,22,51,19,34,3,17,11,14,6,32,38,10,2,4,14,21,58
401365197,Miami (OH) RedHawks,K. Williams,4592182,,True,30.0,3,5,2,3,1,2,5,5,1,3,4,1,0,3,0,0,12
401365197,Miami (OH) RedHawks,D. Brown,4279435,,True,33.0,6,12,3,6,3,6,0,1,1,1,2,1,0,0,0,2,15
401365197,Miami (OH) RedHawks,P. Ayah,4067388,,True,26.0,6,6,6,6,0,0,0,1,2,2,4,1,1,1,1,3,12
401365197,Miami (OH) RedHawks,D. Grant,4593444,,True,34.0,8,16,5,7,3,9,0,0,0,5,5,4,1,0,1,1,19
401365197,Miami (OH) RedHawks,M. Lairy,4397850,,True,29.0,3,11,2,5,1,6,2,2,2,1,3,6,2,0,6,0,9
401365197,Miami (OH) RedHawks,C. Harrison IV,4898327,,False,0.0,0,0,0,0,0,0,0,0,0,0,0,0,0,0,0,0,0
401365197,Miami (OH) RedHawks,J. Kenyon,4898324,,False,0.0,0,0,0,0,0,0,0,0,0,0,0,0,0,0,0,0,0
401365197,Miami (OH) RedHawks,L. Eller,4703548,,False,0.0,0,0,0,0,0,0,0,0,0,0,0,0,0,0,0,0,0
401365197,Miami (OH) RedHawks,J. Etzler,4593443,,False,4.0,1,1,1,1,0,0,0,0,0,0,0,0,0,0,0,0,2
401365197,Miami (OH) RedHawks,E. McNamara,4397853,,False,11.0,1,3,1,3,0,0,0,0,2,0,2,1,0,2,1,2,2
401365197,Miami (OH) RedHawks,J. Beck,4279495,,False,6.0,0,2,0,2,0,0,0,0,1,0,1,1,1,0,0,1,0
401365197,Miami (OH) RedHawks,L. Stevens,4898326,,False,0.0,0,0,0,0,0,0,0,0,0,0,0,0,0,0,0,0,0
401365197,Miami (OH) RedHawks,M. Avance,4898325,,False,7.0,1,2,1,2,0,0,0,0,0,1,1,1,0,0,0,0,2
401365197,Miami (OH) RedHawks,I. Coleman-Lands,4279432,,False,20.0,1,3,0,1,1,2,0,0,0,1,1,4,0,0,1,3,3
401365197,Miami (OH) RedHawks,TEAM,TOTAL,TOTAL,False,,30,61,21,36,9,25,7,9,9,18,27,20,5,6,10,12,76
401365197,Eastern Michigan Eagles,C. Golson Jr.,4703512,,True,31.0,6,9,5,7,1,2,2,5,2,3,5,0,0,0,5,2,15
401365197,Eastern Michigan Eagles,M. Njie,4898293,,True,18.0,6,7,6,6,0,1,4,5,2,8,10,1,0,0,5,5,16
401365197,Eastern Michigan Eagles,L. Savicevic,4898292,,True,34.0,1,9,1,5,0,4,0,0,0,1,1,5,1,0,2,0,2
401365197,Eastern Michigan Eagles,K. Rice,4898290,,True,30.0,6,10,4,5,2,5,0,0,0,3,3,0,1,1,1,1,14
401365197,Eastern Michigan Eagles,D. Spottsville,4593425,,True,36.0,1,7,1,6,0,1,1,2,1,2,3,2,1,0,1,3,3
401365197,Eastern Michigan Eagles,Y. Jihad,4593347,,False,14.0,1,4,1,3,0,1,0,0,4,2,6,1,1,0,2,1,2
401365197,Eastern Michigan Eagles,N. Scott,4595437,,False,9.0,2,3,0,0,2,3,1,2,0,2,2,0,0,0,1,2,7
401365197,Eastern Michigan Eagles,A. Okongo,4593012,,False,10.0,1,2,1,2,0,0,0,0,3,1,4,0,0,0,0,0,2
401365197,Eastern Michigan Eagles,D. Ballard Jr.,4283948,,False,1.0,0,0,0,0,0,0,0,0,0,0,0,0,0,0,0,0,0
401365197,Eastern Michigan Eagles,A. Wells,4703078,,False,0.0,0,0,0,0,0,0,0,0,0,0,0,0,0,0,0,0,0
401365197,Eastern Michigan Eagles,M. Scott,4067159,,False,17.0,1,4,1,1,0,3,0,0,0,1,1,1,1,0,0,4,2
401365197,Eastern Michigan Eagles,TEAM,TOTAL,TOTAL,False,,25,55,20,35,5,20,8,14,15,24,39,10,5,1,19,18,63
401365196,Toledo Rockets,J. Shumate,4703541,,True,31.0,8,9,5,6,3,3,3,3,1,5,6,3,0,1,1,2,22
401365196,Toledo Rockets,S. Millner Jr.,4703540,,True,30.0,7,11,4,6,3,5,2,2,0,5,5,2,0,0,1,0,19
401365196,Toledo Rockets,R. Moss,4703538,,True,31.0,6,9,4,6,2,3,1,2,3,7,10,7,1,0,1,1,15
401365196,Toledo Rockets,R. Rollins,4591725,,True,31.0,7,12,6,7,1,5,3,3,0,3,3,3,2,1,1,0,18
401365196,Toledo Rockets,R. Dennis,4431941,,True,30.0,5,7,3,4,2,3,0,0,0,2,2,9,0,0,1,3,12
401365196,Toledo Rockets,M. Carcoana,4898344,,False,8.0,0,1,0,0,0,1,0,0,1,2,3,1,0,1,0,3,0
401365196,Toledo Rockets,K. Jacobi,4898343,,False,10.0,2,3,2,3,0,0,0,2,3,0,3,0,0,0,1,1,4
401365196,Toledo Rockets,J. Burge,4898345,,False,2.0,0,2,0,2,0,0,0,0,0,2,2,0,0,0,1,0,0
401365196,Toledo Rockets,E. Wilson,4898341,,False,5.0,0,0,0,0,0,0,0,0,0,2,2,0,0,0,0,1,0
401365196,Toledo Rockets,J. Hill,4703539,,False,1.0,0,1,0,1,0,0,0,0,0,0,0,0,0,0,0,0,0
401365196,Toledo Rockets,E. Farmer,4683945,,False,8.0,1,5,1,4,0,1,0,0,2,3,5,0,0,0,0,1,2
401365196,Toledo Rockets,K. Saunders,4397880,,False,13.0,1,4,0,1,1,3,1,2,0,2,2,0,0,0,1,0,4
401365196,Toledo Rockets,TEAM,TOTAL,TOTAL,False,,37,64,25,40,12,24,10,14,11,35,46,25,3,3,8,12,96
401365196,Bowling Green Falcons,M. Kulackovskis,4279319,,True,21.0,4,5,4,5,0,0,0,0,1,3,4,1,0,0,3,2,8
401365196,Bowling Green Falcons,T. Diggs,4593401,,True,30.0,3,9,2,3,1,6,0,0,2,2,4,3,0,0,1,2,7
401365196,Bowling Green Falcons,D. Plowden,4279318,,True,32.0,8,17,5,11,3,6,0,0,1,2,3,2,1,2,0,2,19
401365196,Bowling Green Falcons,B. Mills,4592891,,True,27.0,2,7,0,5,2,2,0,0,0,0,0,0,0,0,1,2,6
401365196,Bowling Green Falcons,S. Curtis,4431792,,True,25.0,2,8,1,3,1,5,0,0,1,0,1,1,0,0,2,2,5
401365196,Bowling Green Falcons,C. Turner,4432130,,False,23.0,4,10,4,8,0,2,2,3,2,1,3,2,1,1,1,1,10
401365196,Bowling Green Falcons,C. Young,4703573,,False,17.0,0,2,0,1,0,1,0,2,0,3,3,0,2,1,1,3,0
401365196,Bowling Green Falcons,J. Fulcher,4703571,,False,20.0,0,7,0,5,0,2,1,3,2,3,5,4,0,0,1,2,1
401365196,Bowling Green Falcons,I. Elsasser,4593402,,False,5.0,0,0,0,0,0,0,0,0,0,1,1,0,0,0,0,0,0
401365196,Bowling Green Falcons,TEAM,TOTAL,TOTAL,False,,23,65,16,41,7,24,3,8,11,17,28,13,4,4,10,16,56
401365195,Central Michigan Chippewas,R. Bissainthe,4279247,,True,38.0,5,9,3,4,2,5,2,2,0,7,7,2,1,0,2,4,14
401365195,Central Michigan Chippewas,H. Henderson,4066434,,True,23.0,4,8,4,5,0,3,9,10,3,2,5,2,1,0,3,4,17
401365195,Central Michigan Chippewas,K. Miller,4898283,,True,34.0,5,11,4,9,1,2,0,0,0,2,2,2,0,0,4,3,11
401365195,Central Michigan Chippewas,B. Taylor,4593256,,True,40.0,3,8,3,4,0,4,1,1,1,7,8,1,0,0,2,4,7
401365195,Central Michigan Chippewas,C. Healy,4278203,,True,27.0,2,6,1,3,1,3,0,0,0,3,3,2,1,0,0,3,5
401365195,Central Michigan Chippewas,N. Pavrette,4898285,,False,15.0,0,3,0,3,0,0,0,0,0,2,2,0,0,2,0,0,0
401365195,Central Michigan Chippewas,C. Hodgson,4432924,,False,2.0,0,0,0,0,0,0,0,0,0,0,0,0,0,0,0,0,0
401365195,Central Michigan Chippewas,J. Webb,4898284,,False,10.0,0,1,0,0,0,1,0,0,0,1,1,0,0,0,0,2,0
401365195,Central Michigan Chippewas,D. Jergens,4593411,,False,11.0,1,1,1,1,0,0,0,0,0,0,0,0,1,0,1,0,2
401365195,Central Michigan Chippewas,TEAM,TOTAL,TOTAL,False,,20,47,16,29,4,18,12,13,4,27,31,9,4,2,13,20,56
401365195,Akron Zips,E. Freeman,4592699,,True,23.0,2,4,2,4,0,0,1,2,1,2,3,2,1,0,0,4,5
401365195,Akron Zips,A. Ali,4592700,,True,38.0,4,11,3,8,1,3,3,6,2,2,4,3,1,0,4,1,12
401365195,Akron Zips,M. Dawson,4609661,,True,32.0,1,5,0,1,1,4,2,4,3,5,8,2,1,0,1,1,5
401365195,Akron Zips,G. Clarke,4433221,,True,22.0,1,5,0,1,1,4,0,0,0,2,2,1,1,0,0,0,3
401365195,Akron Zips,X. Castaneda,4396641,,True,38.0,7,16,5,8,2,8,1,2,0,7,7,2,0,0,0,0,17
401365195,Akron Zips,A. Bandaogo,4703576,,False,7.0,1,1,1,1,0,0,0,0,0,1,1,0,0,1,1,1,2
401365195,Akron Zips,M. Wynn,4395689,,False,12.0,2,4,1,1,1,3,0,0,0,1,1,0,2,0,1,4,5
401365195,Akron Zips,G. Tribble,4592697,,False,28.0,1,4,1,4,0,0,6,8,0,3,3,3,2,0,0,2,8
401365195,Akron Zips,TEAM,TOTAL,TOTAL,False,,19,50,13,28,6,22,13,22,6,23,29,13,8,1,8,13,57
401365194,Western Michigan Broncos,D. Kolp,4703546,,True,2.0,0,0,0,0,0,0,0,0,0,0,0,0,0,0,0,0,0
401365194,Western Michigan Broncos,M. McMillan,4279176,,True,21.0,3,11,2,7,1,4,2,2,0,5,5,1,1,0,2,4,9
401365194,Western Michigan Broncos,B. White,4432137,,True,25.0,1,7,1,4,0,3,0,2,0,3,3,4,2,0,4,1,2
401365194,Western Michigan Broncos,A. Martin,4397906,,True,18.0,1,2,0,0,1,2,0,0,1,0,1,0,2,0,0,1,3
401365194,Western Michigan Broncos,M. Smith,4279836,,True,28.0,6,8,3,3,3,5,1,2,1,0,1,0,2,0,1,1,16
401365194,Western Michigan Broncos,M. Hastings,4397025,,False,33.0,4,6,4,5,0,1,5,7,3,9,12,1,1,0,2,2,13
401365194,Western Michigan Broncos,T. Wright,4593454,,False,20.0,2,3,2,3,0,0,0,0,1,2,3,1,0,0,0,3,4
401365194,Western Michigan Broncos,G. Etchison,4898348,,False,6.0,0,0,0,0,0,0,0,0,0,1,1,1,1,0,2,0,0
401365194,Western Michigan Broncos,J. Freeman,4703544,,False,14.0,2,5,0,1,2,4,0,0,0,0,0,1,0,0,1,2,6
401365194,Western Michigan Broncos,L. Norman Jr.,4396803,,False,33.0,4,14,2,4,2,10,0,0,0,4,4,4,0,0,3,2,10
401365194,Western Michigan Broncos,TEAM,TOTAL,TOTAL,False,,23,56,14,27,9,29,8,13,9,25,34,13,9,0,15,16,63
401365194,Ball State Cardinals,M. Thomas,4279796,,True,29.0,3,8,1,1,2,7,2,4,2,6,8,1,4,0,3,3,10
401365194,Ball State Cardinals,P. Sparks,4898008,,True,34.0,5,12,5,12,0,0,3,4,5,5,10,3,1,1,3,1,13
401365194,Ball State Cardinals,L. Bumbalough,4593397,,True,37.0,2,8,1,1,1,7,0,0,0,2,2,3,0,0,2,1,5
401365194,Ball State Cardinals,T. Cochran,4431930,,True,22.0,1,4,1,3,0,1,0,0,0,2,2,2,2,0,5,2,2
401365194,Ball State Cardinals,D. Jacobs,4397198,,True,31.0,4,8,3,4,1,4,4,6,0,8,8,1,0,1,0,4,13
401365194,Ball State Cardinals,B. Jihad,4898009,,False,5.0,0,0,0,0,0,0,0,0,0,1,1,0,1,0,1,1,0
401365194,Ball State Cardinals,M. Pearson,4431796,,False,2.0,0,1,0,1,0,0,0,0,0,0,0,0,0,0,0,0,0
401365194,Ball State Cardinals,L. Brown,4912654,,False,15.0,2,4,1,2,1,2,0,0,0,0,0,1,0,0,0,2,5
401365194,Ball State Cardinals,J. Sellers,4898010,,False,25.0,5,7,3,3,2,4,4,5,2,3,5,1,0,0,1,2,16
401365194,Ball State Cardinals,TEAM,TOTAL,TOTAL,False,,22,52,15,27,7,25,13,19,9,27,36,12,8,2,16,16,64
401365193,Kent State Golden Flashes,V. Davis,4589474,,True,19.0,1,4,1,2,0,2,1,1,1,3,4,0,0,1,1,2,3
401365193,Kent State Golden Flashes,T. Beck,4278950,,True,17.0,2,6,1,2,1,4,1,2,2,0,2,0,0,0,1,3,6
401365193,Kent State Golden Flashes,M. Jacobs,4703551,,True,36.0,7,18,5,15,2,3,0,1,4,5,9,1,5,2,1,2,16
401365193,Kent State Golden Flashes,S. Carry,4396807,,True,39.0,8,17,6,10,2,7,2,3,1,2,3,9,1,0,4,3,20
401365193,Kent State Golden Flashes,A. Garcia,4066768,,True,31.0,3,11,2,10,1,1,0,0,3,2,5,0,4,2,1,2,7
401365193,Kent State Golden Flashes,A. Odusipe,4432496,,False,2.0,0,0,0,0,0,0,0,0,0,0,0,0,0,0,0,0,0
401365193,Kent State Golden Flashes,J. Hamilton,4278334,,False,28.0,3,7,3,6,0,1,0,1,4,2,6,1,0,2,0,1,6
401365193,Kent State Golden Flashes,J. Sullinger,4898316,,False,3.0,0,1,0,1,0,0,0,0,0,0,0,0,0,0,0,0,0
401365193,Kent State Golden Flashes,G. Santiago,4593436,,False,25.0,4,9,0,0,4,9,0,0,1,3,4,2,0,0,0,0,12
401365193,Kent State Golden Flashes,TEAM,TOTAL,TOTAL,False,,28,73,18,46,10,27,4,8,17,21,38,13,10,7,8,13,70
401365193,Buffalo Bulls,D. Skogman,4593409,,True,28.0,2,5,1,2,1,3,0,0,0,3,3,1,0,0,3,1,5
401365193,Buffalo Bulls,J. Williams,4397821,,True,35.0,7,11,5,5,2,6,2,2,1,4,5,5,2,0,3,2,18
401365193,Buffalo Bulls,J. Mballa,4397084,,True,32.0,3,7,2,5,1,2,0,0,1,9,10,2,0,0,4,3,7
401365193,Buffalo Bulls,R. Segu,4397820,,True,39.0,6,15,4,9,2,6,0,0,1,1,2,4,1,1,2,3,14
401365193,Buffalo Bulls,M. Jack,4278495,,True,14.0,1,5,1,3,0,2,0,0,1,0,1,0,0,0,2,3,2
401365193,Buffalo Bulls,T. Fagan,4397823,,False,19.0,2,4,2,3,0,1,0,0,2,4,6,0,0,2,0,0,4
401365193,Buffalo Bulls,L. Hardnett,4396610,,False,16.0,5,7,5,7,0,0,2,3,2,1,3,0,2,0,0,0,12
401365193,Buffalo Bulls,C. Jones,4898369,,False,6.0,0,0,0,0,0,0,0,0,1,0,1,1,0,0,0,0,0
401365193,Buffalo Bulls,K. Brewton,4593881,,False,11.0,1,6,0,1,1,5,0,0,0,4,4,0,2,0,2,1,3
401365193,Buffalo Bulls,TEAM,TOTAL,TOTAL,False,,27,60,20,35,7,25,4,5,10,28,38,13,7,3,17,13,65
401365192,Western Michigan Broncos,M. Hastings,4397025,,True,28.0,1,2,1,1,0,1,1,2,0,5,5,0,1,0,1,2,3
401365192,Western Michigan Broncos,M. McMillan,4279176,,True,18.0,0,4,0,3,0,1,0,0,2,5,7,2,0,0,1,5,0
401365192,Western Michigan Broncos,J. Freeman,4703544,,True,15.0,2,2,1,1,1,1,0,0,0,0,0,0,1,0,0,1,5
401365192,Western Michigan Broncos,B. White,4432137,,True,31.0,6,15,4,8,2,7,0,0,2,5,7,4,2,0,2,1,14
401365192,Western Michigan Broncos,L. Norman Jr.,4396803,,True,36.0,13,20,5,8,8,12,1,1,0,3,3,1,1,0,0,1,35
401365192,Western Michigan Broncos,D. Kolp,4703546,,False,2.0,0,0,0,0,0,0,0,0,0,0,0,0,0,0,0,0,0
401365192,Western Michigan Broncos,T. Wright,4593454,,False,22.0,2,6,2,6,0,0,4,5,0,2,2,0,0,1,1,2,8
401365192,Western Michigan Broncos,G. Etchison,4898348,,False,9.0,0,1,0,1,0,0,0,1,0,0,0,0,0,0,0,0,0
401365192,Western Michigan Broncos,A. Martin,4397906,,False,19.0,0,2,0,0,0,2,2,2,0,3,3,1,1,0,0,1,2
401365192,Western Michigan Broncos,M. Smith,4279836,,False,21.0,2,5,2,3,0,2,0,0,1,3,4,0,0,0,0,3,4
401365192,Western Michigan Broncos,TEAM,TOTAL,TOTAL,False,,26,57,15,31,11,26,8,11,5,29,34,8,6,1,5,16,71
401365192,Eastern Michigan Eagles,T. Binelli,4593429,,True,6.0,0,3,0,1,0,2,0,0,0,1,1,0,0,0,0,0,0
401365192,Eastern Michigan Eagles,A. Okongo,4593012,,True,15.0,0,0,0,0,0,0,1,2,0,3,3,0,0,0,0,1,1
401365192,Eastern Michigan Eagles,D. Spottsville,4593425,,True,31.0,2,5,2,5,0,0,1,4,2,8,10,5,0,0,0,2,5
401365192,Eastern Michigan Eagles,N. Farrakhan,4432203,,True,11.0,4,6,4,5,0,1,1,2,0,2,2,1,0,0,0,0,9
401365192,Eastern Michigan Eagles,M. Scott,4067159,,True,34.0,4,10,2,3,2,7,0,0,0,2,2,1,0,0,1,3,10
401365192,Eastern Michigan Eagles,Y. Jihad,4593347,,False,3.0,1,2,1,2,0,0,0,0,0,0,0,0,0,0,0,0,2
401365192,Eastern Michigan Eagles,C. Golson Jr.,4703512,,False,20.0,2,6,2,5,0,1,1,6,1,2,3,0,0,0,1,3,5
401365192,Eastern Michigan Eagles,N. Scott,4595437,,False,13.0,1,5,1,2,0,3,0,0,2,1,3,0,0,1,0,0,2
401365192,Eastern Michigan Eagles,M. Njie,4898293,,False,23.0,2,3,2,3,0,0,0,0,0,5,5,0,0,0,3,3,4
401365192,Eastern Michigan Eagles,L. Savicevic,4898292,,False,25.0,4,8,2,4,2,4,0,0,0,1,1,3,0,0,2,3,10
401365192,Eastern Michigan Eagles,K. Rice,4898290,,False,19.0,3,7,1,2,2,5,4,4,2,1,3,0,0,0,1,2,12
401365192,Eastern Michigan Eagles,TEAM,TOTAL,TOTAL,False,,23,55,17,32,6,23,8,18,9,28,37,10,0,1,8,17,60
401365191,Ohio Bobcats,B. Roderick,4593447,,True,30.0,5,12,1,4,4,8,0,0,1,0,1,1,0,0,1,2,14
401365191,Ohio Bobcats,B. Vander Plas,4279448,,True,39.0,9,19,4,8,5,11,2,4,5,3,8,1,1,1,1,3,25
401365191,Ohio Bobcats,J. Carter,4067398,,True,27.0,3,9,3,8,0,1,0,0,2,5,7,1,3,1,1,4,6
401365191,Ohio Bobcats,M. Sears,4703530,,True,36.0,5,17,3,9,2,8,10,10,6,7,13,5,1,0,3,4,22
401365191,Ohio Bobcats,M. Brown,4593449,,True,29.0,2,6,1,2,1,4,0,1,0,1,1,3,2,0,1,4,5
401365191,Ohio Bobcats,A. Clayton,4898339,,False,6.0,0,0,0,0,0,0,0,0,1,1,2,1,0,1,0,0,0
401365191,Ohio Bobcats,I. Ezuma,4898338,,False,4.0,1,2,1,2,0,0,0,0,1,0,1,1,0,0,0,1,2
401365191,Ohio Bobcats,T. Schmock,4407066,,False,29.0,1,10,0,1,1,9,0,0,0,3,3,4,3,0,2,1,3
401365191,Ohio Bobcats,TEAM,TOTAL,TOTAL,False,,26,75,13,34,13,41,12,15,20,21,41,17,10,3,10,19,77
401365191,Bowling Green Falcons,M. Kulackovskis,4279319,,True,25.0,7,10,7,8,0,2,4,4,2,5,7,0,0,0,4,2,18
401365191,Bowling Green Falcons,T. Diggs,4593401,,True,31.0,4,8,2,2,2,6,3,4,1,5,6,2,3,1,1,2,13
401365191,Bowling Green Falcons,D. Plowden,4279318,,True,34.0,5,9,3,6,2,3,6,8,1,5,6,3,1,5,2,2,18
401365191,Bowling Green Falcons,B. Mills,4592891,,True,28.0,1,5,1,3,0,2,0,0,1,2,3,0,0,0,1,2,2
401365191,Bowling Green Falcons,S. Curtis,4431792,,True,31.0,4,9,2,3,2,6,6,6,0,6,6,5,0,0,4,2,16
401365191,Bowling Green Falcons,C. Turner,4432130,,False,17.0,1,3,1,2,0,1,0,0,1,1,2,2,0,0,2,1,2
401365191,Bowling Green Falcons,C. Young,4703573,,False,12.0,1,2,0,1,1,1,1,4,0,2,2,0,1,0,1,2,4
401365191,Bowling Green Falcons,J. Fulcher,4703571,,False,22.0,2,4,1,2,1,2,2,3,0,2,2,0,1,0,1,2,7
401365191,Bowling Green Falcons,TEAM,TOTAL,TOTAL,False,,25,50,17,27,8,23,22,29,6,31,37,12,6,6,16,15,80
401365190,Northern Illinois Huskies,A. Crump,4397550,,True,11.0,1,2,0,0,1,2,0,0,0,3,3,0,1,0,0,2,3
401365190,Northern Illinois Huskies,A. Makuoi,4703525,,True,27.0,2,7,2,7,0,0,3,5,2,4,6,0,1,0,0,3,7
401365190,Northern Illinois Huskies,K. Thornton,4703521,,True,7.0,1,3,1,2,0,1,0,0,0,0,0,0,0,0,0,0,2
401365190,Northern Illinois Huskies,K. Williams,4602029,,True,38.0,6,16,5,12,1,4,3,5,1,2,3,1,0,0,2,3,16
401365190,Northern Illinois Huskies,T. Hankerson,4397854,,True,37.0,2,11,2,5,0,6,2,2,0,2,2,3,3,2,4,4,6
401365190,Northern Illinois Huskies,Z. Kueth,4703524,,False,17.0,0,0,0,0,0,0,2,2,1,1,2,0,0,0,0,2,2
401365190,Northern Illinois Huskies,C. Kingsley Okanu,4703523,,False,21.0,5,6,5,6,0,0,4,4,2,2,4,0,0,0,2,4,14
401365190,Northern Illinois Huskies,E. Manuel,4898336,,False,2.0,0,0,0,0,0,0,0,0,0,0,0,0,0,0,0,1,0
401365190,Northern Illinois Huskies,Z. Russell,4898334,,False,10.0,0,1,0,0,0,1,0,0,0,1,1,2,0,0,1,2,0
401365190,Northern Illinois Huskies,N. Kon,4898332,,False,8.0,1,1,1,1,0,0,0,2,1,2,3,0,0,0,3,3,2
401365190,Northern Illinois Huskies,D. Hunter,4596869,,False,22.0,1,4,1,2,0,2,1,2,1,5,6,2,1,0,2,0,3
401365190,Northern Illinois Huskies,TEAM,TOTAL,TOTAL,False,,19,51,17,35,2,16,15,22,9,24,33,8,6,2,14,24,55
401365190,Kent State Golden Flashes,V. Davis,4589474,,True,23.0,1,6,1,5,0,1,1,1,1,4,5,0,1,0,1,0,3
401365190,Kent State Golden Flashes,A. Odusipe,4432496,,True,8.0,0,0,0,0,0,0,0,0,0,0,0,0,0,1,1,2,0
401365190,Kent State Golden Flashes,M. Jacobs,4703551,,True,36.0,4,9,3,6,1,3,3,5,2,7,9,2,1,1,5,3,12
401365190,Kent State Golden Flashes,S. Carry,4396807,,True,36.0,5,12,4,6,1,6,11,15,0,2,2,6,1,0,1,0,22
401365190,Kent State Golden Flashes,A. Garcia,4066768,,True,20.0,2,5,2,4,0,1,0,0,1,2,3,1,4,1,0,4,4
401365190,Kent State Golden Flashes,T. Beck,4278950,,False,24.0,2,4,1,1,1,3,2,2,1,3,4,2,0,1,2,2,7
401365190,Kent State Golden Flashes,J. Hamilton,4278334,,False,18.0,5,6,5,6,0,0,1,3,3,3,6,0,1,0,3,5,11
401365190,Kent State Golden Flashes,J. Sullinger,4898316,,False,0.0,0,0,0,0,0,0,0,0,0,0,0,0,0,0,0,0,0
401365190,Kent State Golden Flashes,G. Santiago,4593436,,False,28.0,1,5,1,1,0,4,2,4,1,2,3,1,1,0,0,0,4
401365190,Kent State Golden Flashes,J. Hernandez,4433007,,False,7.0,0,1,0,1,0,0,0,0,0,0,0,0,1,0,0,3,0
401365190,Kent State Golden Flashes,TEAM,TOTAL,TOTAL,False,,20,48,17,30,3,18,20,30,11,28,39,12,10,4,15,19,63
401365189,Ball State Cardinals,M. Thomas,4279796,,True,34.0,2,11,0,4,2,7,2,3,0,6,6,2,0,0,1,3,8
401365189,Ball State Cardinals,P. Sparks,4898008,,True,28.0,1,7,1,7,0,0,3,4,3,3,6,0,0,0,3,4,5
401365189,Ball State Cardinals,J. Sellers,4898010,,True,19.0,2,2,1,1,1,1,1,2,0,0,0,0,0,0,4,3,6
401365189,Ball State Cardinals,L. Bumbalough,4593397,,True,37.0,3,10,0,2,3,8,0,0,0,1,1,3,0,0,2,1,9
401365189,Ball State Cardinals,D. Jacobs,4397198,,True,26.0,2,5,2,5,0,0,6,6,0,7,7,1,0,1,3,4,10
401365189,Ball State Cardinals,B. Jihad,4898009,,False,4.0,0,2,0,2,0,0,0,0,0,0,0,1,0,0,0,2,0
401365189,Ball State Cardinals,M. Pearson,4431796,,False,3.0,0,0,0,0,0,0,0,0,0,0,0,0,0,0,0,0,0
401365189,Ball State Cardinals,L. Brown,4912654,,False,15.0,1,4,1,2,0,2,2,2,1,0,1,1,0,0,0,0,4
401365189,Ball State Cardinals,T. Cochran,4431930,,False,34.0,7,11,6,10,1,1,3,3,4,6,10,1,1,0,2,1,18
401365189,Ball State Cardinals,TEAM,TOTAL,TOTAL,False,,18,52,11,33,7,19,17,20,10,27,37,9,1,1,15,18,60
401365189,Akron Zips,E. Freeman,4592699,,True,35.0,5,9,5,9,0,0,8,10,5,11,16,4,0,1,0,3,18
401365189,Akron Zips,A. Ali,4592700,,True,37.0,5,13,3,9,2,4,4,5,0,1,1,1,1,0,4,2,16
401365189,Akron Zips,M. Dawson,4609661,,True,34.0,4,9,1,1,3,8,0,0,1,3,4,1,4,0,0,2,11
401365189,Akron Zips,G. Tribble,4592697,,True,28.0,1,6,1,5,0,1,2,2,0,2,2,0,1,0,2,2,4
401365189,Akron Zips,X. Castaneda,4396641,,True,31.0,7,13,2,3,5,10,3,4,0,1,1,3,0,0,0,1,22
401365189,Akron Zips,A. Bandaogo,4703576,,False,6.0,0,0,0,0,0,0,0,0,0,2,2,0,0,1,0,2,0
401365189,Akron Zips,M. Wynn,4395689,,False,11.0,1,2,1,1,0,1,0,0,0,0,0,0,1,1,0,3,2
401365189,Akron Zips,G. Clarke,4433221,,False,18.0,1,3,0,1,1,2,3,4,1,2,3,2,1,0,0,1,6
401365189,Akron Zips,TEAM,TOTAL,TOTAL,False,,24,55,13,29,11,26,20,25,7,24,31,11,8,3,7,16,79
401365188,Toledo Rockets,J. Shumate,4703541,,True,26.0,5,9,3,5,2,4,2,2,3,1,4,2,0,0,0,3,14
401365188,Toledo Rockets,S. Millner Jr.,4703540,,True,38.0,7,11,6,7,1,4,5,6,1,4,5,1,1,0,4,2,20
401365188,Toledo Rockets,R. Moss,4703538,,True,36.0,2,3,1,2,1,1,0,0,2,3,5,2,1,1,0,1,5
401365188,Toledo Rockets,R. Rollins,4591725,,True,36.0,7,18,5,15,2,3,4,6,2,6,8,6,1,0,1,1,20
401365188,Toledo Rockets,R. Dennis,4431941,,True,35.0,7,13,6,11,1,2,4,5,2,4,6,6,1,0,2,1,19
401365188,Toledo Rockets,M. Carcoana,4898344,,False,14.0,2,5,2,4,0,1,0,0,0,4,4,0,1,0,0,0,4
401365188,Toledo Rockets,K. Jacobi,4898343,,False,2.0,0,0,0,0,0,0,0,0,0,0,0,0,0,0,0,0,0
401365188,Toledo Rockets,E. Wilson,4898341,,False,1.0,1,1,1,1,0,0,0,0,1,0,1,0,0,0,0,0,2
401365188,Toledo Rockets,E. Farmer,4683945,,False,3.0,0,0,0,0,0,0,0,0,0,0,0,0,0,0,0,0,0
401365188,Toledo Rockets,K. Saunders,4397880,,False,9.0,3,4,1,2,2,2,0,0,0,0,0,0,0,0,0,2,8
401365188,Toledo Rockets,TEAM,TOTAL,TOTAL,False,,34,64,25,47,9,17,15,19,11,25,36,17,5,1,7,10,92
401365188,Buffalo Bulls,D. Skogman,4593409,,True,19.0,3,4,2,3,1,1,0,0,1,3,4,1,0,2,2,1,7
401365188,Buffalo Bulls,J. Williams,4397821,,True,33.0,8,19,6,15,2,4,0,0,1,1,2,3,2,0,4,3,18
401365188,Buffalo Bulls,J. Mballa,4397084,,True,29.0,5,11,5,11,0,0,1,2,4,6,10,1,1,0,2,3,11
401365188,Buffalo Bulls,R. Segu,4397820,,True,31.0,8,15,5,10,3,5,1,1,3,2,5,5,0,0,1,4,20
401365188,Buffalo Bulls,M. Jack,4278495,,True,30.0,5,11,4,7,1,4,2,3,1,2,3,1,0,2,0,3,13
401365188,Buffalo Bulls,L. Saleh,4703567,,False,1.0,0,0,0,0,0,0,0,0,0,0,0,0,0,0,0,0,0
401365188,Buffalo Bulls,T. Fagan,4397823,,False,11.0,0,1,0,0,0,1,0,0,0,2,2,0,1,0,0,0,0
401365188,Buffalo Bulls,L. Hardnett,4396610,,False,14.0,0,0,0,0,0,0,0,0,3,3,6,0,0,1,1,0,0
401365188,Buffalo Bulls,B. Bertram,4067374,,False,3.0,1,1,1,1,0,0,0,0,1,1,2,0,0,0,0,0,2
401365188,Buffalo Bulls,C. Jones,4898369,,False,16.0,1,4,1,1,0,3,0,0,0,2,2,4,0,0,0,0,2
401365188,Buffalo Bulls,K. Blocker,4898368,,False,1.0,0,0,0,0,0,0,0,0,0,0,0,0,0,0,0,0,0
401365188,Buffalo Bulls,K. Brewton,4593881,,False,11.0,1,5,0,0,1,5,0,0,0,0,0,1,0,0,0,0,3
401365188,Buffalo Bulls,J. Bivens,4397822,,False,1.0,0,1,0,1,0,0,0,0,0,0,0,0,0,0,0,0,0
401365188,Buffalo Bulls,TEAM,TOTAL,TOTAL,False,,32,72,24,49,8,23,4,6,15,22,37,16,4,5,11,14,76
401365187,Miami (OH) RedHawks,K. Williams,4592182,,True,32.0,8,12,4,6,4,6,1,3,2,1,3,1,0,0,0,2,21
401365187,Miami (OH) RedHawks,D. Brown,4279435,,True,23.0,1,6,1,2,0,4,2,2,3,3,6,3,0,1,3,3,4
401365187,Miami (OH) RedHawks,P. Ayah,4067388,,True,22.0,3,3,3,3,0,0,0,1,2,4,6,0,0,0,0,3,6
401365187,Miami (OH) RedHawks,D. Grant,4593444,,True,37.0,4,13,2,7,2,6,9,10,0,3,3,6,1,0,1,1,19
401365187,Miami (OH) RedHawks,M. Lairy,4397850,,True,18.0,2,4,2,4,0,0,0,0,0,4,4,2,1,0,1,4,4
401365187,Miami (OH) RedHawks,J. Etzler,4593443,,False,14.0,2,4,1,1,1,3,0,1,1,2,3,0,0,0,1,2,5
401365187,Miami (OH) RedHawks,E. McNamara,4397853,,False,14.0,3,4,3,4,0,0,0,0,2,2,4,0,0,0,2,3,6
401365187,Miami (OH) RedHawks,J. Beck,4279495,,False,3.0,0,2,0,2,0,0,4,4,0,0,0,0,0,0,1,2,4
401365187,Miami (OH) RedHawks,M. White,4397851,,False,8.0,0,1,0,0,0,1,0,0,0,0,0,1,0,0,0,2,0
401365187,Miami (OH) RedHawks,I. Coleman-Lands,4279432,,False,29.0,2,6,0,1,2,5,0,0,0,7,7,4,1,0,2,0,6
401365187,Miami (OH) RedHawks,TEAM,TOTAL,TOTAL,False,,25,55,16,30,9,25,16,21,10,30,40,17,3,1,12,22,75
401365187,Central Michigan Chippewas,R. Bissainthe,4279247,,True,34.0,0,5,0,2,0,3,1,2,2,2,4,0,0,1,4,3,1
401365187,Central Michigan Chippewas,H. Henderson,4066434,,True,22.0,3,6,2,3,1,3,7,8,2,3,5,1,0,0,1,4,14
401365187,Central Michigan Chippewas,K. Miller,4898283,,True,39.0,7,15,6,11,1,4,4,5,1,5,6,7,1,0,1,2,19
401365187,Central Michigan Chippewas,B. Taylor,4593256,,True,38.0,3,7,3,7,0,0,0,0,1,7,8,0,5,1,1,5,6
401365187,Central Michigan Chippewas,C. Healy,4278203,,True,38.0,5,17,3,5,2,12,5,7,0,1,1,1,0,0,2,2,17
401365187,Central Michigan Chippewas,N. Pavrette,4898285,,False,11.0,1,1,1,1,0,0,0,1,2,1,3,0,0,0,1,2,2
401365187,Central Michigan Chippewas,C. Hodgson,4432924,,False,2.0,1,2,1,1,0,1,0,1,0,0,0,0,0,0,1,1,2
401365187,Central Michigan Chippewas,M. Stafl,4592903,,False,4.0,0,1,0,1,0,0,0,0,0,0,0,0,0,0,1,1,0
401365187,Central Michigan Chippewas,J. Webb,4898284,,False,8.0,0,2,0,0,0,2,0,0,0,1,1,0,0,0,0,2,0
401365187,Central Michigan Chippewas,D. Jergens,4593411,,False,4.0,0,0,0,0,0,0,0,0,0,0,0,0,0,0,0,0,0
401365187,Central Michigan Chippewas,TEAM,TOTAL,TOTAL,False,,20,56,16,31,4,25,17,24,12,21,33,9,6,2,13,22,61
401364972,Tennessee Volunteers,B. Huntley-Hatfield,4432680,,True,18.0,2,6,2,6,0,0,3,5,1,3,4,0,0,0,2,2,7
401364972,Tennessee Volunteers,U. Plavsic,4397023,,True,12.0,2,2,2,2,0,0,2,2,1,2,3,0,0,0,1,4,6
401364972,Tennessee Volunteers,S. Vescovi,4609299,,True,37.0,4,9,1,5,3,4,4,4,0,4,4,4,2,1,4,1,15
401364972,Tennessee Volunteers,K. Chandler,4432646,,True,25.0,5,6,0,0,5,6,0,3,0,2,2,3,0,0,2,4,15
401364972,Tennessee Volunteers,J. James,4431685,,True,36.0,4,8,2,5,2,3,2,2,0,7,7,2,3,1,2,5,12
401364972,Tennessee Volunteers,J. Aidoo,4684682,,False,19.0,0,3,0,3,0,0,3,4,3,2,5,0,1,3,1,3,3
401364972,Tennessee Volunteers,J. Fulkerson,4066215,,False,14.0,1,3,1,3,0,0,3,4,1,0,1,2,0,0,0,4,5
401364972,Tennessee Volunteers,Z. Zeigler,4883573,,False,29.0,4,12,2,7,2,5,3,6,0,5,5,6,1,0,4,1,13
401364972,Tennessee Volunteers,J. Mashack,4683934,,False,1.0,0,0,0,0,0,0,0,0,0,0,0,0,0,0,0,0,0
401364972,Tennessee Volunteers,J. Powell,4432250,,False,8.0,1,1,1,1,0,0,0,0,0,0,0,0,0,0,1,1,2
401364972,Tennessee Volunteers,V. Bailey Jr.,4278512,,False,1.0,0,0,0,0,0,0,0,0,0,1,1,0,0,0,0,0,0
401364972,Tennessee Volunteers,TEAM,TOTAL,TOTAL,False,,23,50,11,32,12,18,20,30,6,27,33,17,7,5,17,25,78
401364972,Arkansas Razorbacks,J. Williams,4432823,,True,30.0,3,8,2,5,1,3,2,2,1,6,7,1,0,0,1,4,9
401364972,Arkansas Razorbacks,T. Wade,4279111,,True,19.0,0,2,0,2,0,0,0,0,3,2,5,1,0,0,1,3,0
401364972,Arkansas Razorbacks,D. Davis,4432197,,True,20.0,2,5,2,4,0,1,0,1,1,0,1,0,0,0,3,4,4
401364972,Arkansas Razorbacks,S. Umude,4279532,,True,36.0,5,13,2,4,3,9,2,4,0,3,3,0,1,0,2,3,15
401364972,Arkansas Razorbacks,JD Notae,4278435,,True,34.0,6,20,4,12,2,8,6,8,1,4,5,4,3,1,2,0,20
401364972,Arkansas Razorbacks,K. Johnson,4397556,,False,24.0,1,3,1,3,0,0,4,8,5,3,8,0,2,1,0,2,6
401364972,Arkansas Razorbacks,J. Robinson,4702528,,False,3.0,1,2,0,0,1,2,0,0,0,0,0,0,0,0,0,0,3
401364972,Arkansas Razorbacks,K. Robinson,4565207,,False,9.0,1,2,1,2,0,0,0,0,0,2,2,2,0,0,3,4,2
401364972,Arkansas Razorbacks,C. Lykes,4277889,,False,25.0,4,7,1,2,3,5,4,4,0,0,0,3,3,0,2,5,15
401364972,Arkansas Razorbacks,TEAM,TOTAL,TOTAL,False,,23,62,13,34,10,28,18,27,16,21,37,11,9,2,15,25,74
401364971,Texas A&M Aggies,H. Coleman III,4432186,,True,33.0,4,9,4,9,0,0,4,6,3,1,4,1,1,0,0,4,12
401364971,Texas A&M Aggies,W. Taylor IV,4683833,,True,24.0,3,8,1,2,2,6,2,3,0,1,1,2,0,0,1,2,10
401364971,Texas A&M Aggies,Q. Jackson,4592829,,True,32.0,6,8,4,5,2,3,4,6,0,3,3,0,4,0,4,1,18
401364971,Texas A&M Aggies,M. Obaseki,4433277,,True,10.0,0,2,0,2,0,0,0,0,0,0,0,0,0,0,1,3,0
401364971,Texas A&M Aggies,T. Radford,4395685,,True,39.0,4,11,4,8,0,3,3,3,2,7,9,1,0,0,1,1,11
401364971,Texas A&M Aggies,E. Henderson,4395706,,False,4.0,0,0,0,0,0,0,0,0,2,0,2,0,0,0,2,0,0
401364971,Texas A&M Aggies,A. Cash,4896467,,False,8.0,0,1,0,1,0,0,0,0,0,2,2,0,0,0,0,0,0
401364971,Texas A&M Aggies,H. Hefner,4433279,,False,23.0,3,8,1,3,2,5,1,2,1,1,2,2,3,1,1,3,9
401364971,Texas A&M Aggies,H. Diarra,4433160,,False,8.0,0,2,0,0,0,2,1,2,0,0,0,3,1,0,2,3,1
401364971,Texas A&M Aggies,A. Gordon,4431779,,False,19.0,2,2,2,2,0,0,2,2,0,5,5,3,0,0,0,1,6
401364971,Texas A&M Aggies,TEAM,TOTAL,TOTAL,False,,22,51,16,32,6,19,17,24,10,20,30,12,9,1,13,18,67
401364971,Mississippi State Bulldogs,D.J. Jeffries,4431682,,True,30.0,1,5,1,4,0,1,5,6,0,3,3,1,1,1,2,4,7
401364971,Mississippi State Bulldogs,T. Smith,4397882,,True,29.0,8,8,8,8,0,0,2,3,2,4,6,2,0,0,4,3,18
401364971,Mississippi State Bulldogs,G. Brooks,4277908,,True,20.0,0,4,0,4,0,0,1,2,3,1,4,0,0,1,1,1,1
401364971,Mississippi State Bulldogs,S. Moore,4602027,,True,17.0,2,4,1,2,1,2,0,0,0,2,2,1,1,0,2,5,5
401364971,Mississippi State Bulldogs,I. Molinar,4432885,,True,37.0,6,17,6,17,0,0,3,4,1,2,3,4,1,1,3,1,15
401364971,Mississippi State Bulldogs,D. Fountain,4702432,,False,8.0,0,2,0,2,0,0,0,0,1,1,2,0,0,0,0,0,0
401364971,Mississippi State Bulldogs,A. Garcia,4702431,,False,26.0,5,9,5,9,0,0,4,7,3,3,6,3,2,0,1,2,14
401364971,Mississippi State Bulldogs,C. Matthews,4432394,,False,23.0,1,2,1,1,0,1,0,0,1,3,4,2,3,2,0,1,2
401364971,Mississippi State Bulldogs,C. Carter,4898380,,False,10.0,1,1,1,1,0,0,0,0,0,0,0,2,0,1,2,3,2
401364971,Mississippi State Bulldogs,TEAM,TOTAL,TOTAL,False,,24,52,23,48,1,4,15,22,12,20,32,15,8,6,15,20,64
401364970,Vanderbilt Commodores,Q. Millora-Brown,4397691,,True,16.0,0,0,0,0,0,0,0,0,1,0,1,1,1,0,1,2,0
401364970,Vanderbilt Commodores,M. Stute,4433340,,True,35.0,3,5,0,0,3,5,0,0,0,6,6,2,1,0,1,1,9
401364970,Vanderbilt Commodores,T. Lawrence,4702530,,True,13.0,0,0,0,0,0,0,0,0,0,3,3,2,0,1,0,1,0
401364970,Vanderbilt Commodores,J. Wright,4432920,,True,31.0,5,9,5,8,0,1,4,5,3,8,11,0,0,0,2,1,14
401364970,Vanderbilt Commodores,S. Pippen Jr.,4431785,,True,38.0,7,18,4,10,3,8,5,7,0,4,4,6,1,0,7,2,22
401364970,Vanderbilt Commodores,T. Frank,4433146,,False,3.0,0,2,0,1,0,1,0,0,0,0,0,0,0,0,0,0,0
401364970,Vanderbilt Commodores,L. Robbins,4397347,,False,26.0,5,10,4,7,1,3,1,2,0,6,6,0,0,1,0,1,12
401364970,Vanderbilt Commodores,T. Thomas,4702531,,False,29.0,2,6,0,2,2,4,0,0,1,1,2,1,1,0,0,1,6
401364970,Vanderbilt Commodores,S. Dezonie,4683732,,False,5.0,0,1,0,0,0,1,0,0,0,0,0,0,0,0,0,1,0
401364970,Vanderbilt Commodores,G. Dorsey,4683639,,False,4.0,0,1,0,0,0,1,0,0,0,0,0,0,0,0,0,0,0
401364970,Vanderbilt Commodores,TEAM,TOTAL,TOTAL,False,,22,52,13,28,9,24,10,14,5,30,35,12,4,2,11,10,63
401364970,Ole Miss Rebels,J. Brakefield,4432169,,True,31.0,1,4,1,2,0,2,0,0,1,6,7,3,1,0,0,0,2
401364970,Ole Miss Rebels,N. Brooks,4066485,,True,27.0,5,9,5,9,0,0,2,2,0,5,5,0,0,1,1,3,12
401364970,Ole Miss Rebels,M. Murrell,4702442,,True,28.0,6,14,4,9,2,5,1,1,2,4,6,0,0,0,2,2,15
401364970,Ole Miss Rebels,J. McBride,4396970,,True,3.0,0,2,0,0,0,2,0,0,0,0,0,0,0,0,0,0,0
401364970,Ole Miss Rebels,J. Joiner,4278729,,True,23.0,1,5,1,2,0,3,0,0,0,2,2,1,0,0,1,5,2
401364970,Ole Miss Rebels,S. Hunter,4433011,,False,13.0,2,2,2,2,0,0,0,0,0,1,1,0,0,0,2,1,4
401364970,Ole Miss Rebels,L. Rodriguez,4396969,,False,19.0,1,3,0,1,1,2,0,0,0,4,4,2,0,0,2,2,3
401364970,Ole Miss Rebels,J. White,4683641,,False,7.0,2,4,1,2,1,2,0,0,0,0,0,0,0,0,0,2,5
401364970,Ole Miss Rebels,A. Crowley,4431758,,False,32.0,6,10,5,7,1,3,2,2,0,3,3,7,3,0,0,2,15
401364970,Ole Miss Rebels,T. Fagan,4395719,,False,17.0,1,6,1,5,0,1,1,2,0,2,2,2,0,0,0,0,3
401364970,Ole Miss Rebels,TEAM,TOTAL,TOTAL,False,,25,59,20,39,5,20,6,7,5,28,33,15,4,1,8,17,61
401364969,South Carolina Gamecocks,W. Leveque,4431805,,True,2.0,0,0,0,0,0,0,0,0,0,0,0,0,0,0,0,1,0
401364969,South Carolina Gamecocks,K. Bryant,4396951,,True,30.0,4,10,3,4,1,6,0,0,1,7,8,2,1,0,4,4,9
401364969,South Carolina Gamecocks,J. Couisnard,4396948,,True,32.0,6,17,5,11,1,6,9,12,0,3,3,4,0,0,2,2,22
401364969,South Carolina Gamecocks,E. Stevenson,4396679,,True,33.0,5,12,2,4,3,8,0,0,1,7,8,4,0,0,4,3,13
401364969,South Carolina Gamecocks,J. Reese V,4279322,,True,36.0,6,10,3,5,3,5,3,4,0,0,0,1,3,0,1,3,18
401364969,South Carolina Gamecocks,T. Woodley,4684446,,False,18.0,1,3,1,3,0,0,0,0,2,4,6,1,1,2,2,4,2
401364969,South Carolina Gamecocks,B. Martin,4397834,,False,8.0,0,1,0,1,0,0,0,0,0,0,0,0,0,0,1,4,0
401364969,South Carolina Gamecocks,A.J. Wilson,4066866,,False,2.0,0,0,0,0,0,0,0,0,1,0,1,0,1,0,0,0,0
401364969,South Carolina Gamecocks,J. Gray,4706679,,False,19.0,3,6,3,6,0,0,1,3,4,2,6,1,2,3,2,2,7
401364969,South Carolina Gamecocks,D. Carter,4433188,,False,20.0,0,5,0,5,0,0,0,0,2,2,4,3,1,0,0,2,0
401364969,South Carolina Gamecocks,TEAM,TOTAL,TOTAL,False,,25,64,17,39,8,25,13,19,12,28,40,16,9,5,16,25,71
401364969,Auburn Tigers,J. Smith,4432639,,True,29.0,5,12,2,9,3,3,8,8,2,4,6,2,1,1,3,1,21
401364969,Auburn Tigers,W. Kessler,4433136,,True,27.0,5,13,4,9,1,4,0,1,1,5,6,0,3,2,1,1,11
401364969,Auburn Tigers,A. Flanigan,4432874,,True,21.0,1,4,0,3,1,1,3,4,1,3,4,1,0,0,2,1,6
401364969,Auburn Tigers,K. Johnson,4432363,,True,32.0,6,15,4,8,2,7,4,5,0,3,3,1,2,0,3,3,18
401364969,Auburn Tigers,Z. Jasper,4311618,,True,24.0,2,5,1,3,1,2,2,3,0,2,2,3,1,0,1,1,7
401364969,Auburn Tigers,C. Moore,4433200,,False,6.0,0,1,0,1,0,0,0,0,2,0,2,0,1,0,2,0,0
401364969,Auburn Tigers,J. Williams,4431776,,False,10.0,1,2,0,0,1,2,0,0,0,2,2,0,0,0,2,0,3
401364969,Auburn Tigers,D. Cambridge,4567588,,False,13.0,0,1,0,0,0,1,0,0,2,2,4,2,0,0,0,1,0
401364969,Auburn Tigers,D. Cardwell,4433174,,False,13.0,3,3,3,3,0,0,0,0,0,5,5,0,0,0,0,3,6
401364969,Auburn Tigers,L. Berman,4592748,,False,2.0,0,0,0,0,0,0,0,0,0,0,0,1,0,0,0,1,0
401364969,Auburn Tigers,W. Green Jr.,4433198,,False,22.0,3,7,2,4,1,3,3,5,1,1,2,7,0,0,0,4,10
401364969,Auburn Tigers,C. Maasdorp,4403231,,False,0.0,0,0,0,0,0,0,0,0,0,0,0,0,0,0,0,0,0
401364969,Auburn Tigers,P. Cook,4403230,,False,1.0,0,0,0,0,0,0,0,0,0,0,0,0,0,0,0,0,0
401364969,Auburn Tigers,TEAM,TOTAL,TOTAL,False,,26,63,16,40,10,23,20,26,10,29,39,17,8,3,14,16,82
401364968,Kentucky Wildcats,T. Washington Jr.,4683749,,True,26.0,1,6,1,4,0,2,4,4,1,3,4,5,1,0,1,0,6
401364968,Kentucky Wildcats,K. Brooks Jr.,4431689,,True,14.0,1,2,1,2,0,0,0,0,0,2,2,0,0,0,1,1,2
401364968,Kentucky Wildcats,O. Tshiebwe,4432827,,True,36.0,11,16,11,16,0,0,5,5,3,11,14,0,3,2,2,3,27
401364968,Kentucky Wildcats,S. Wheeler,4431725,,True,30.0,6,10,5,7,1,3,0,2,0,2,2,5,2,0,3,3,13
401364968,Kentucky Wildcats,K. Grady,4278349,,True,37.0,5,8,4,5,1,3,0,0,0,2,2,3,1,0,0,2,11
401364968,Kentucky Wildcats,J. Toppin,4592461,,False,26.0,1,4,1,4,0,0,0,1,1,6,7,1,0,0,1,0,2
401364968,Kentucky Wildcats,B. Hopkins,4565698,,False,3.0,0,1,0,1,0,0,0,0,0,0,0,0,0,0,0,0,0
401364968,Kentucky Wildcats,L. Ware,4433152,,False,3.0,0,0,0,0,0,0,0,0,0,0,0,0,0,0,0,3,0
401364968,Kentucky Wildcats,D. Mintz,4065766,,False,25.0,3,9,1,2,2,7,2,4,1,2,3,0,0,0,1,2,10
401364968,Kentucky Wildcats,TEAM,TOTAL,TOTAL,False,,28,56,24,41,4,15,11,16,7,28,35,14,7,2,10,14,71
401364968,Florida Gators,K. Johnson,4395714,,True,0.0,0,0,0,0,0,0,0,0,0,0,0,0,0,0,0,0,0
401364968,Florida Gators,C. Castleton,4397204,,True,36.0,11,19,11,19,0,0,1,2,5,6,11,0,2,1,1,1,23
401364968,Florida Gators,M. Jones,4397238,,True,27.0,2,9,1,1,1,8,0,0,0,3,3,0,1,0,1,4,5
401364968,Florida Gators,T. Appleby,4280299,,True,26.0,2,7,1,2,1,5,1,4,0,0,0,0,1,0,4,4,6
401364968,Florida Gators,P. Fleming Jr.,4278688,,True,26.0,0,9,0,5,0,4,7,8,2,4,6,3,0,0,0,3,7
401364968,Florida Gators,CJ Felder,4592180,,False,1.0,0,0,0,0,0,0,0,0,0,0,0,0,0,0,0,0,0
401364968,Florida Gators,A. Duruji,4279008,,False,24.0,4,8,3,6,1,2,1,2,3,2,5,1,0,0,2,3,10
401364968,Florida Gators,K. Reeves,4683757,,False,9.0,0,2,0,0,0,2,0,0,0,0,0,0,0,0,0,0,0
401364968,Florida Gators,N. Lane,4565449,,False,25.0,2,3,2,3,0,0,0,0,1,1,2,0,0,0,0,1,4
401364968,Florida Gators,B. McKissic,4280190,,False,26.0,4,6,4,4,0,2,0,0,0,1,1,4,1,0,0,2,8
401364968,Florida Gators,TEAM,TOTAL,TOTAL,False,,25,63,22,40,3,23,10,16,12,22,34,8,5,1,8,18,63
401364967,LSU Tigers,E. Reid,4433594,,True,11.0,1,2,1,2,0,0,0,0,1,0,1,0,0,0,0,1,2
401364967,LSU Tigers,D. Days,4396978,,True,38.0,8,15,5,8,3,7,5,6,3,4,7,0,3,1,2,3,24
401364967,LSU Tigers,M. Wilkinson,4567590,,True,22.0,1,5,0,2,1,3,0,0,0,2,2,0,0,1,1,0,3
401364967,LSU Tigers,B. Murray,4684166,,True,41.0,7,14,5,8,2,6,1,1,1,5,6,2,3,1,4,1,17
401364967,LSU Tigers,X. Pinson,4396953,,True,39.0,4,10,4,8,0,2,0,1,0,0,0,8,5,0,2,2,8
401364967,LSU Tigers,T. Eason,4433192,,False,33.0,5,10,4,9,1,1,9,13,4,5,9,2,3,1,2,4,20
401364967,LSU Tigers,S. O'Neal,4397130,,False,8.0,0,1,0,1,0,0,0,0,1,1,2,1,0,0,2,2,0
401364967,LSU Tigers,J. Williams,4683676,,False,3.0,0,0,0,0,0,0,0,0,0,0,0,0,0,0,0,0,0
401364967,LSU Tigers,E. Gaines,4682883,,False,30.0,2,4,2,3,0,1,2,2,0,4,4,0,2,0,0,3,6
401364967,LSU Tigers,TEAM,TOTAL,TOTAL,False,,28,61,21,41,7,20,17,23,11,22,33,13,16,4,13,16,80
401364967,Alabama Crimson Tide,N. Gurley,4280015,,True,17.0,1,2,1,1,0,1,2,2,2,2,4,1,0,0,0,1,4
401364967,Alabama Crimson Tide,C. Bediako,4565203,,True,15.0,2,3,2,3,0,0,1,1,3,2,5,1,1,0,1,2,5
401364967,Alabama Crimson Tide,K. Ellis,4702177,,True,36.0,4,10,1,2,3,8,8,8,4,5,9,1,2,0,6,2,19
401364967,Alabama Crimson Tide,J. Shackelford,4432846,,True,34.0,3,14,3,6,0,8,0,0,1,5,6,1,0,0,1,0,6
401364967,Alabama Crimson Tide,Jah. Quinerly,4397132,,True,39.0,5,13,1,2,4,11,2,2,0,3,3,1,0,0,4,3,16
401364967,Alabama Crimson Tide,J. Rojas,4592740,,False,17.0,1,2,1,2,0,0,2,3,0,1,1,0,1,0,0,4,4
401364967,Alabama Crimson Tide,D. Miles,4433561,,False,24.0,3,7,2,3,1,4,2,2,1,2,3,3,2,0,3,2,9
401364967,Alabama Crimson Tide,J. Gary,4431707,,False,6.0,0,1,0,0,0,1,2,2,1,1,2,0,0,0,0,0,2
401364967,Alabama Crimson Tide,JD Davison,4576085,,False,37.0,4,9,1,2,3,7,1,2,2,3,5,4,3,0,4,3,12
401364967,Alabama Crimson Tide,TEAM,TOTAL,TOTAL,False,,23,61,12,21,11,40,20,22,17,25,42,12,9,0,21,17,77
401364966,Missouri Tigers,T. Brazile,4698719,,True,29.0,3,7,2,5,1,2,1,2,5,5,10,0,0,4,1,3,8
401364966,Missouri Tigers,Ko. Brown,4431752,,True,22.0,8,11,7,8,1,3,4,4,2,2,4,2,1,1,0,4,21
401364966,Missouri Tigers,D. Gordon,4432891,,True,20.0,2,5,1,3,1,2,0,0,2,1,3,2,0,1,1,3,5
401364966,Missouri Tigers,J. Coleman,4397811,,True,29.0,4,8,1,2,3,6,1,2,0,3,3,3,0,0,6,1,12
401364966,Missouri Tigers,J. Pickett,4396954,,True,38.0,4,14,4,10,0,4,4,4,2,7,9,3,2,0,3,2,12
401364966,Missouri Tigers,R. DeGray III,4701128,,False,26.0,4,6,2,3,2,3,2,2,1,5,6,2,0,1,2,4,12
401364966,Missouri Tigers,Ka. Brown,4690766,,False,8.0,0,1,0,0,0,1,0,0,1,0,1,1,0,0,1,0,0
401364966,Missouri Tigers,A. Davis,4431937,,False,28.0,4,7,4,7,0,0,1,1,0,4,4,3,0,0,0,4,9
401364966,Missouri Tigers,TEAM,TOTAL,TOTAL,False,,29,59,21,38,8,21,13,15,14,29,43,16,3,7,14,21,79
401364966,Georgia Bulldogs,B. Bridges,4593259,,True,32.0,8,13,8,13,0,0,3,5,2,3,5,1,0,0,3,1,19
401364966,Georgia Bulldogs,J. Etter,4594269,,True,31.0,2,5,1,3,1,2,3,4,1,3,4,1,0,0,0,4,8
401364966,Georgia Bulldogs,C. Wright,4896464,,True,26.0,1,4,1,4,0,0,4,4,1,2,3,1,0,0,2,3,6
401364966,Georgia Bulldogs,K. Oquendo,4896463,,True,33.0,4,9,3,4,1,5,8,15,0,2,2,0,3,0,0,2,17
401364966,Georgia Bulldogs,A. Cook,4067063,,True,38.0,6,11,5,9,1,2,3,5,0,2,2,1,3,0,0,2,16
401364966,Georgia Bulldogs,D. Ridgnal,4896465,,False,12.0,0,2,0,2,0,0,0,0,0,3,3,0,1,1,1,3,0
401364966,Georgia Bulldogs,N. Baumann,4278713,,False,14.0,1,1,0,0,1,1,0,0,0,1,1,0,0,0,1,1,3
401364966,Georgia Bulldogs,J. Abdur-Rahim,4432191,,False,14.0,0,4,0,2,0,2,0,0,1,1,2,0,0,0,1,1,0
401364966,Georgia Bulldogs,TEAM,TOTAL,TOTAL,False,,22,49,18,37,4,12,21,33,6,18,24,4,7,1,8,17,69
401364965,LSU Tigers,E. Reid,4433594,,True,17.0,1,3,1,2,0,1,0,0,3,5,8,0,0,1,2,4,2
401364965,LSU Tigers,D. Days,4396978,,True,33.0,7,12,4,7,3,5,2,2,2,4,6,1,3,0,2,3,19
401364965,LSU Tigers,M. Wilkinson,4567590,,True,37.0,1,2,0,0,1,2,0,0,1,3,4,3,1,0,0,5,3
401364965,LSU Tigers,B. Murray,4684166,,True,36.0,2,11,2,6,0,5,2,3,2,1,3,1,2,0,0,0,6
401364965,LSU Tigers,X. Pinson,4396953,,True,32.0,5,21,5,14,0,7,2,2,3,2,5,5,1,0,3,4,12
401364965,LSU Tigers,T. Eason,4433192,,False,18.0,6,14,4,8,2,6,10,10,4,3,7,1,2,1,2,5,24
401364965,LSU Tigers,S. O'Neal,4397130,,False,7.0,1,3,1,2,0,1,2,2,0,2,2,0,0,1,0,1,4
401364965,LSU Tigers,J. Williams,4683676,,False,1.0,0,0,0,0,0,0,0,0,0,0,0,0,0,0,0,1,0
401364965,LSU Tigers,E. Gaines,4682883,,False,19.0,3,6,3,5,0,1,0,0,1,0,1,2,0,0,0,2,6
401364965,LSU Tigers,TEAM,TOTAL,TOTAL,False,,26,72,20,44,6,28,18,19,22,21,43,13,9,3,10,25,76
401364965,Arkansas Razorbacks,J. Williams,4432823,,True,34.0,6,11,6,9,0,2,7,8,0,10,10,1,2,1,3,5,19
401364965,Arkansas Razorbacks,T. Wade,4279111,,True,9.0,0,1,0,1,0,0,0,0,0,0,0,0,0,0,0,0,0
401364965,Arkansas Razorbacks,A. Toney,4395671,,True,39.0,6,9,6,8,0,1,6,6,4,0,4,1,0,0,1,2,18
401364965,Arkansas Razorbacks,S. Umude,4279532,,True,39.0,8,16,5,8,3,8,4,4,1,4,5,1,1,1,1,1,23
401364965,Arkansas Razorbacks,JD Notae,4278435,,True,39.0,3,12,1,6,2,6,4,4,0,7,7,5,0,1,4,2,12
401364965,Arkansas Razorbacks,K. Johnson,4397556,,False,5.0,0,0,0,0,0,0,1,2,1,0,1,0,0,1,0,2,1
401364965,Arkansas Razorbacks,D. Davis,4432197,,False,31.0,1,4,1,1,0,3,2,4,0,1,1,4,0,0,3,3,4
401364965,Arkansas Razorbacks,C. Lykes,4277889,,False,4.0,0,1,0,0,0,1,0,0,0,1,1,0,0,0,0,0,0
401364965,Arkansas Razorbacks,TEAM,TOTAL,TOTAL,False,,24,54,19,33,5,21,24,28,10,24,34,12,3,4,12,15,77
401364964,Mississippi State Bulldogs,D.J. Jeffries,4431682,,True,35.0,3,7,3,6,0,1,0,0,0,1,1,1,1,0,2,1,6
401364964,Mississippi State Bulldogs,T. Smith,4397882,,True,39.0,9,16,9,16,0,0,4,5,6,6,12,2,2,2,4,3,22
401364964,Mississippi State Bulldogs,G. Brooks,4277908,,True,36.0,3,5,3,3,0,2,4,6,4,4,8,0,1,1,1,3,10
401364964,Mississippi State Bulldogs,S. Moore,4602027,,True,23.0,2,8,2,2,0,6,2,4,0,2,2,4,2,0,3,2,6
401364964,Mississippi State Bulldogs,I. Molinar,4432885,,True,40.0,5,19,5,16,0,3,4,5,1,4,5,3,1,0,5,2,14
401364964,Mississippi State Bulldogs,D. Fountain,4702432,,False,4.0,0,1,0,1,0,0,0,0,0,1,1,0,0,0,0,1,0
401364964,Mississippi State Bulldogs,J. Davis,4592739,,False,4.0,0,1,0,1,0,0,0,0,2,1,3,0,0,0,1,0,0
401364964,Mississippi State Bulldogs,A. Garcia,4702431,,False,28.0,4,6,4,6,0,0,0,0,6,7,13,3,2,0,3,3,8
401364964,Mississippi State Bulldogs,C. Matthews,4432394,,False,13.0,1,2,1,2,0,0,0,0,0,3,3,1,0,1,0,1,2
401364964,Mississippi State Bulldogs,C. Carter,4898380,,False,3.0,0,2,0,1,0,1,0,2,1,0,1,0,0,0,0,0,0
401364964,Mississippi State Bulldogs,TEAM,TOTAL,TOTAL,False,,27,67,27,54,0,13,14,22,21,29,50,14,9,4,20,16,68
401364964,Auburn Tigers,J. Smith,4432639,,True,35.0,9,13,6,8,3,5,6,7,0,10,10,2,0,0,0,4,27
401364964,Auburn Tigers,W. Kessler,4433136,,True,29.0,2,4,2,4,0,0,0,2,2,8,10,1,0,3,0,2,4
401364964,Auburn Tigers,A. Flanigan,4432874,,True,19.0,1,6,1,4,0,2,0,0,0,1,1,0,0,0,4,0,2
401364964,Auburn Tigers,K. Johnson,4432363,,True,31.0,4,8,3,5,1,3,5,5,0,2,2,3,3,0,4,1,14
401364964,Auburn Tigers,Z. Jasper,4311618,,True,35.0,3,6,0,2,3,4,2,2,1,2,3,3,2,1,1,2,11
401364964,Auburn Tigers,J. Williams,4431776,,False,10.0,1,2,0,0,1,2,0,0,0,1,1,0,0,0,1,3,3
401364964,Auburn Tigers,D. Cambridge,4567588,,False,19.0,2,7,1,1,1,6,1,2,1,0,1,1,1,0,0,2,6
401364964,Auburn Tigers,D. Cardwell,4433174,,False,16.0,3,3,3,3,0,0,0,1,1,0,1,2,2,0,0,2,6
401364964,Auburn Tigers,W. Green Jr.,4433198,,False,31.0,3,12,2,8,1,4,1,2,1,1,2,7,5,0,4,1,8
401364964,Auburn Tigers,TEAM,TOTAL,TOTAL,False,,28,61,18,35,10,26,15,21,7,25,32,19,13,4,14,17,81
401364963,Texas A&M Aggies,H. Coleman III,4432186,,True,35.0,8,12,8,12,0,0,2,2,3,8,11,0,2,1,3,3,18
401364963,Texas A&M Aggies,W. Taylor IV,4683833,,True,20.0,3,9,3,4,0,5,2,2,0,1,1,3,1,0,2,2,8
401364963,Texas A&M Aggies,Q. Jackson,4592829,,True,33.0,9,13,8,11,1,2,9,9,0,3,3,3,1,0,2,2,28
401364963,Texas A&M Aggies,M. Obaseki,4433277,,True,12.0,0,2,0,2,0,0,0,0,0,1,1,1,1,0,1,2,0
401364963,Texas A&M Aggies,T. Radford,4395685,,True,31.0,9,15,5,9,4,6,0,0,2,6,8,1,3,0,3,4,22
401364963,Texas A&M Aggies,E. Henderson,4395706,,False,21.0,1,1,1,1,0,0,1,2,0,1,1,2,0,2,0,1,3
401364963,Texas A&M Aggies,J. Brown,4702024,,False,2.0,0,0,0,0,0,0,0,0,0,0,0,0,0,0,0,0,0
401364963,Texas A&M Aggies,A. Cash,4896467,,False,3.0,0,0,0,0,0,0,0,0,0,0,0,0,0,0,0,0,0
401364963,Texas A&M Aggies,H. Hefner,4433279,,False,14.0,1,2,0,1,1,1,0,0,1,0,1,1,1,0,0,0,3
401364963,Texas A&M Aggies,H. Diarra,4433160,,False,20.0,2,4,1,2,1,2,0,0,0,3,3,1,1,0,3,1,5
401364963,Texas A&M Aggies,A. Gordon,4431779,,False,9.0,0,0,0,0,0,0,0,0,0,0,0,1,0,0,1,0,0
401364963,Texas A&M Aggies,TEAM,TOTAL,TOTAL,False,,33,58,26,42,7,16,14,15,8,25,33,13,10,3,16,15,87
401364963,Alabama Crimson Tide,D. Miles,4433561,,True,16.0,0,2,0,0,0,2,2,2,0,2,2,2,0,0,3,3,2
401364963,Alabama Crimson Tide,C. Bediako,4565203,,True,20.0,4,5,4,5,0,0,0,0,1,4,5,2,1,2,0,1,8
401364963,Alabama Crimson Tide,K. Ellis,4702177,,True,25.0,5,8,3,4,2,4,1,1,0,3,3,1,2,0,3,4,13
401364963,Alabama Crimson Tide,JD Davison,4576085,,True,30.0,3,7,3,5,0,2,0,0,1,2,3,6,2,1,3,0,6
401364963,Alabama Crimson Tide,J. Shackelford,4432846,,True,33.0,4,12,0,2,4,10,4,5,0,3,3,1,0,0,2,1,16
401364963,Alabama Crimson Tide,J. Rojas,4592740,,False,18.0,3,4,3,4,0,0,2,4,3,0,3,2,2,1,2,2,8
401364963,Alabama Crimson Tide,J. Gary,4431707,,False,6.0,2,3,2,3,0,0,0,0,0,0,0,0,0,1,0,1,4
401364963,Alabama Crimson Tide,N. Gurley,4280015,,False,16.0,0,2,0,2,0,0,0,0,1,0,1,2,1,0,1,2,0
401364963,Alabama Crimson Tide,J. Holt,4684152,,False,2.0,0,0,0,0,0,0,0,0,0,0,0,0,0,0,0,0,0
401364963,Alabama Crimson Tide,Jah. Quinerly,4397132,,False,34.0,5,11,3,5,2,6,2,3,0,2,2,2,0,0,5,3,14
401364963,Alabama Crimson Tide,TEAM,TOTAL,TOTAL,False,,26,54,18,30,8,24,11,15,6,18,24,18,8,5,19,17,71
401364962,Vanderbilt Commodores,Q. Millora-Brown,4397691,,True,28.0,0,0,0,0,0,0,0,0,3,3,6,1,0,0,0,2,0
401364962,Vanderbilt Commodores,T. Lawrence,4702530,,True,15.0,2,3,1,1,1,2,0,0,0,3,3,1,0,0,2,2,5
401364962,Vanderbilt Commodores,D. Weikert,4598779,,True,5.0,0,0,0,0,0,0,0,0,0,0,0,0,0,0,0,0,0
401364962,Vanderbilt Commodores,J. Wright,4432920,,True,34.0,3,7,3,3,0,4,0,0,2,7,9,3,3,0,5,3,6
401364962,Vanderbilt Commodores,S. Pippen Jr.,4431785,,True,36.0,11,18,6,11,5,7,2,5,0,3,3,7,3,0,3,3,29
401364962,Vanderbilt Commodores,T. Frank,4433146,,False,7.0,1,2,1,2,0,0,0,0,0,1,1,1,0,0,1,0,2
401364962,Vanderbilt Commodores,L. Robbins,4397347,,False,12.0,3,3,2,2,1,1,1,1,0,0,0,0,0,2,1,3,8
401364962,Vanderbilt Commodores,M. Stute,4433340,,False,29.0,3,9,0,1,3,8,0,0,0,4,4,0,0,0,0,2,9
401364962,Vanderbilt Commodores,T. Thomas,4702531,,False,27.0,6,9,1,2,5,7,0,0,0,3,3,2,0,0,2,3,17
401364962,Vanderbilt Commodores,S. Dezonie,4683732,,False,7.0,1,2,1,2,0,0,0,0,0,0,0,1,0,0,1,0,2
401364962,Vanderbilt Commodores,TEAM,TOTAL,TOTAL,False,,30,53,15,24,15,29,3,6,5,25,30,16,6,2,15,18,78
401364962,Florida Gators,CJ Felder,4592180,,True,6.0,1,1,1,1,0,0,0,0,1,1,2,0,0,0,0,1,2
401364962,Florida Gators,C. Castleton,4397204,,True,32.0,6,16,6,16,0,0,7,8,2,6,8,1,1,0,0,0,19
401364962,Florida Gators,M. Jones,4397238,,True,29.0,5,9,2,2,3,7,0,0,0,1,1,1,0,0,1,0,13
401364962,Florida Gators,T. Appleby,4280299,,True,33.0,4,9,1,4,3,5,1,1,0,3,3,2,0,0,3,3,12
401364962,Florida Gators,P. Fleming Jr.,4278688,,True,33.0,5,10,3,6,2,4,4,4,1,3,4,6,3,2,2,2,16
401364962,Florida Gators,T. Gatkek,4896453,,False,8.0,3,3,3,3,0,0,0,0,1,0,1,2,0,0,0,2,6
401364962,Florida Gators,K. Reeves,4683757,,False,13.0,1,3,0,0,1,3,0,0,0,3,3,0,0,0,2,1,3
401364962,Florida Gators,N. Lane,4565449,,False,26.0,3,3,3,3,0,0,0,0,0,1,1,0,1,1,0,2,6
401364962,Florida Gators,B. McKissic,4280190,,False,20.0,2,4,1,2,1,2,0,1,0,0,0,1,1,0,0,1,5
401364962,Florida Gators,TEAM,TOTAL,TOTAL,False,,30,58,20,37,10,21,12,14,5,20,25,13,6,3,8,12,82
401364961,South Carolina Gamecocks,K. Bryant,4396951,,True,30.0,4,10,3,5,1,5,0,1,1,6,7,2,2,1,3,3,9
401364961,South Carolina Gamecocks,A.J. Wilson,4066866,,True,2.0,0,0,0,0,0,0,0,0,0,0,0,0,0,0,0,2,0
401364961,South Carolina Gamecocks,J. Couisnard,4396948,,True,33.0,6,14,5,9,1,5,4,5,1,3,4,7,1,1,1,3,17
401364961,South Carolina Gamecocks,E. Stevenson,4396679,,True,26.0,2,9,1,6,1,3,4,4,0,7,7,2,1,0,1,3,9
401364961,South Carolina Gamecocks,J. Reese V,4279322,,True,32.0,4,7,2,4,2,3,3,3,0,1,1,0,0,0,0,1,13
401364961,South Carolina Gamecocks,T. Woodley,4684446,,False,8.0,0,1,0,1,0,0,0,0,0,1,1,0,0,0,0,3,0
401364961,South Carolina Gamecocks,W. Leveque,4431805,,False,29.0,2,8,2,8,0,0,0,1,3,2,5,1,1,4,1,2,4
401364961,South Carolina Gamecocks,B. Martin,4397834,,False,10.0,2,4,2,4,0,0,0,0,1,0,1,0,1,0,1,1,4
401364961,South Carolina Gamecocks,J. Wright,4683836,,False,7.0,0,2,0,2,0,0,0,0,1,0,1,2,0,0,0,1,0
401364961,South Carolina Gamecocks,D. Carter,4433188,,False,23.0,5,10,4,6,1,4,6,7,1,7,8,0,1,1,2,2,17
401364961,South Carolina Gamecocks,TEAM,TOTAL,TOTAL,False,,25,65,19,45,6,20,17,21,11,29,40,14,7,7,9,21,73
401364961,Missouri Tigers,T. Brazile,4698719,,True,26.0,4,6,4,5,0,1,1,2,1,8,9,0,1,1,0,0,9
401364961,Missouri Tigers,Ko. Brown,4431752,,True,24.0,6,10,4,7,2,3,5,7,1,7,8,1,0,0,4,4,19
401364961,Missouri Tigers,D. Gordon,4432891,,True,27.0,1,7,1,4,0,3,3,4,1,3,4,1,1,1,3,3,5
401364961,Missouri Tigers,J. Coleman,4397811,,True,33.0,0,5,0,2,0,3,0,0,0,4,4,3,1,1,1,5,0
401364961,Missouri Tigers,J. Pickett,4396954,,True,37.0,8,17,6,14,2,3,5,6,4,1,5,2,1,0,3,3,23
401364961,Missouri Tigers,R. DeGray III,4701128,,False,27.0,1,8,1,4,0,4,5,6,1,4,5,3,1,0,1,2,7
401364961,Missouri Tigers,Ka. Brown,4690766,,False,8.0,0,0,0,0,0,0,0,1,0,1,1,0,0,1,2,3,0
401364961,Missouri Tigers,A. Davis,4431937,,False,18.0,3,4,3,3,0,1,0,0,0,2,2,0,0,0,1,4,6
401364961,Missouri Tigers,TEAM,TOTAL,TOTAL,False,,23,57,19,39,4,18,19,26,9,30,39,10,5,4,15,24,69
401364960,Ole Miss Rebels,J. Brakefield,4432169,,True,35.0,3,7,3,7,0,0,1,3,1,7,8,1,1,0,0,1,7
401364960,Ole Miss Rebels,N. Brooks,4066485,,True,35.0,6,10,6,10,0,0,2,2,5,0,5,2,2,0,2,4,14
401364960,Ole Miss Rebels,M. Murrell,4702442,,True,36.0,9,16,4,8,5,8,2,3,0,2,2,4,0,0,1,3,25
401364960,Ole Miss Rebels,L. Rodriguez,4396969,,True,14.0,0,3,0,1,0,2,0,0,1,2,3,0,1,0,0,2,0
401364960,Ole Miss Rebels,J. Joiner,4278729,,True,26.0,3,5,3,5,0,0,2,2,0,1,1,1,1,0,3,2,8
401364960,Ole Miss Rebels,S. Hunter,4433011,,False,7.0,1,3,0,0,1,3,0,0,1,0,1,0,0,0,0,1,3
401364960,Ole Miss Rebels,J. White,4683641,,False,10.0,4,4,4,4,0,0,0,0,0,3,3,0,0,0,2,1,8
401364960,Ole Miss Rebels,A. Crowley,4431758,,False,17.0,2,4,1,1,1,3,0,0,0,0,0,3,0,0,0,0,5
401364960,Ole Miss Rebels,T. Fagan,4395719,,False,20.0,1,6,1,4,0,2,0,0,0,1,1,1,0,0,0,0,2
401364960,Ole Miss Rebels,TEAM,TOTAL,TOTAL,False,,29,58,22,40,7,18,7,10,8,16,24,12,5,0,9,14,72
401364960,Kentucky Wildcats,K. Brooks Jr.,4431689,,True,22.0,4,5,4,5,0,0,2,2,1,4,5,2,1,0,1,3,10
401364960,Kentucky Wildcats,O. Tshiebwe,4432827,,True,34.0,9,12,9,12,0,0,0,0,4,11,15,1,2,0,3,3,18
401364960,Kentucky Wildcats,S. Wheeler,4431725,,True,35.0,6,9,4,6,2,3,2,2,0,3,3,7,0,0,2,1,16
401364960,Kentucky Wildcats,K. Grady,4278349,,True,30.0,3,8,2,4,1,4,2,2,0,0,0,1,0,0,0,0,9
401364960,Kentucky Wildcats,D. Mintz,4065766,,True,24.0,3,5,1,1,2,4,0,0,0,0,0,2,1,0,0,1,8
401364960,Kentucky Wildcats,T. Washington Jr.,4683749,,False,24.0,5,10,4,7,1,3,3,5,1,0,1,4,3,0,1,1,14
401364960,Kentucky Wildcats,D. Collins,4611412,,False,5.0,0,0,0,0,0,0,1,2,0,1,1,0,0,1,1,0,1
401364960,Kentucky Wildcats,J. Toppin,4592461,,False,21.0,3,5,3,5,0,0,1,2,0,1,1,1,0,0,0,1,7
401364960,Kentucky Wildcats,L. Ware,4433152,,False,5.0,0,1,0,1,0,0,0,0,0,1,1,0,0,0,0,1,0
401364960,Kentucky Wildcats,TEAM,TOTAL,TOTAL,False,,33,55,27,41,6,14,11,15,8,22,30,18,7,1,8,11,83
401364959,Tennessee Volunteers,B. Huntley-Hatfield,4432680,,True,17.0,1,5,1,4,0,1,2,2,5,1,6,0,0,2,3,1,4
401364959,Tennessee Volunteers,U. Plavsic,4397023,,True,16.0,1,2,1,2,0,0,0,0,3,7,10,0,1,1,0,0,2
401364959,Tennessee Volunteers,S. Vescovi,4609299,,True,35.0,3,10,0,2,3,8,2,2,0,5,5,3,1,0,2,4,11
401364959,Tennessee Volunteers,K. Chandler,4432646,,True,35.0,6,13,4,8,2,5,2,3,0,1,1,2,4,0,4,0,16
401364959,Tennessee Volunteers,J. James,4431685,,True,29.0,8,12,5,5,3,7,4,5,3,5,8,5,2,2,0,4,23
401364959,Tennessee Volunteers,J. Aidoo,4684682,,False,9.0,2,4,2,4,0,0,1,1,0,2,2,0,0,0,0,3,5
401364959,Tennessee Volunteers,J. Fulkerson,4066215,,False,23.0,5,8,5,8,0,0,2,2,1,2,3,1,0,2,0,1,12
401364959,Tennessee Volunteers,Z. Zeigler,4883573,,False,19.0,1,7,1,3,0,4,0,0,0,1,1,3,0,0,2,0,2
401364959,Tennessee Volunteers,J. Powell,4432250,,False,6.0,0,0,0,0,0,0,0,0,0,1,1,0,0,0,0,0,0
401364959,Tennessee Volunteers,V. Bailey Jr.,4278512,,False,11.0,0,1,0,1,0,0,0,0,1,1,2,0,1,0,1,1,0
401364959,Tennessee Volunteers,TEAM,TOTAL,TOTAL,False,,27,62,19,37,8,25,13,15,13,27,40,14,9,7,12,14,75
401364959,Georgia Bulldogs,B. Bridges,4593259,,True,29.0,6,7,6,7,0,0,0,0,0,1,1,3,0,0,2,2,12
401364959,Georgia Bulldogs,J. Etter,4594269,,True,25.0,3,6,2,4,1,2,0,0,2,3,5,1,0,2,1,2,7
401364959,Georgia Bulldogs,C. Wright,4896464,,True,32.0,0,4,0,2,0,2,3,4,1,3,4,5,1,0,4,2,3
401364959,Georgia Bulldogs,K. Oquendo,4896463,,True,31.0,6,14,3,8,3,6,1,3,0,3,3,0,1,0,1,2,16
401364959,Georgia Bulldogs,A. Cook,4067063,,True,34.0,5,15,3,9,2,6,5,6,1,1,2,4,3,0,3,3,17
401364959,Georgia Bulldogs,D. Ridgnal,4896465,,False,16.0,2,4,2,2,0,2,0,0,1,3,4,2,0,0,0,1,4
401364959,Georgia Bulldogs,N. Baumann,4278713,,False,14.0,0,3,0,0,0,3,0,0,0,0,0,2,1,0,0,0,0
401364959,Georgia Bulldogs,J. Abdur-Rahim,4432191,,False,19.0,4,5,3,3,1,2,0,0,0,4,4,0,1,0,1,1,9
401364959,Georgia Bulldogs,TEAM,TOTAL,TOTAL,False,,26,58,19,35,7,23,9,13,7,21,28,17,7,2,12,13,68
401364807,San Diego State Aztecs,K. Johnson,4431786,,True,29.0,4,6,3,5,1,1,1,2,3,3,6,0,1,3,3,1,10
401364807,San Diego State Aztecs,N. Mensah,4397371,,True,22.0,3,7,3,7,0,0,1,2,2,2,4,1,0,2,0,4,7
401364807,San Diego State Aztecs,T. Pulliam,4593083,,True,31.0,5,10,5,7,0,3,2,4,0,3,3,4,1,0,3,4,12
401364807,San Diego State Aztecs,L. Butler,4433183,,True,27.0,4,7,2,4,2,3,1,2,0,3,3,1,1,0,3,4,11
401364807,San Diego State Aztecs,M. Bradley,4397049,,True,33.0,6,10,5,7,1,3,11,12,0,6,6,1,0,0,4,2,24
401364807,San Diego State Aztecs,T. Diabate,4280209,,False,5.0,0,0,0,0,0,0,0,0,1,1,2,0,0,0,1,0,0
401364807,San Diego State Aztecs,J. Tomaic,4066375,,False,17.0,0,1,0,1,0,0,2,2,1,5,6,0,0,0,0,5,2
401364807,San Diego State Aztecs,C. Baker-Mazara,4897532,,False,10.0,2,4,2,3,0,1,4,4,0,2,2,0,0,0,2,3,8
401364807,San Diego State Aztecs,A. Seiko,4278704,,False,26.0,2,4,1,1,1,3,0,0,1,0,1,2,2,0,2,2,5
401364807,San Diego State Aztecs,TEAM,TOTAL,TOTAL,False,,26,49,21,35,5,14,22,28,8,26,34,9,5,5,19,25,79
401364807,Nevada Wolf Pack,T. Coleman,4433217,,True,14.0,1,1,1,1,0,0,0,0,0,1,1,0,0,0,1,5,2
401364807,Nevada Wolf Pack,W. Washington,4397093,,True,27.0,4,8,4,8,0,0,3,4,4,6,10,2,0,1,0,1,11
401364807,Nevada Wolf Pack,K. Blackshear,4592846,,True,34.0,2,11,1,8,1,3,3,3,1,1,2,0,2,0,0,4,8
401364807,Nevada Wolf Pack,G. Sherfield,4431794,,True,39.0,9,19,6,11,3,8,9,12,0,2,2,7,1,0,4,2,30
401364807,Nevada Wolf Pack,D. Cambridge Jr.,4279462,,True,35.0,3,12,1,5,2,7,4,4,2,4,6,2,4,1,2,4,12
401364807,Nevada Wolf Pack,W. Baker,4431691,,False,17.0,3,7,1,4,2,3,3,5,2,1,3,1,0,0,3,1,11
401364807,Nevada Wolf Pack,K.J. Hymes,4397343,,False,11.0,0,0,0,0,0,0,1,2,2,2,4,0,0,0,0,1,1
401364807,Nevada Wolf Pack,D. Foster,4702876,,False,23.0,1,3,0,2,1,1,0,0,2,1,3,0,0,0,1,4,3
401364807,Nevada Wolf Pack,TEAM,TOTAL,TOTAL,False,,23,61,14,39,9,22,23,30,16,20,36,12,7,2,12,22,78
401364806,UNLV Rebels,V. Iwuakor,4431724,,True,15.0,1,1,1,1,0,0,2,2,1,3,4,0,1,0,0,1,4
401364806,UNLV Rebels,R. Hamm Jr.,4277920,,True,27.0,3,8,3,6,0,2,3,3,1,9,10,0,0,0,2,2,9
401364806,UNLV Rebels,B. Hamilton,4397433,,True,39.0,8,22,5,9,3,13,9,11,1,3,4,0,1,0,1,0,28
401364806,UNLV Rebels,M. Nuga,4397315,,True,6.0,0,1,0,0,0,1,0,0,0,0,0,0,1,0,0,3,0
401364806,UNLV Rebels,J. McCabe,4397100,,True,33.0,1,9,0,4,1,5,0,0,0,3,3,7,4,0,2,3,3
401364806,UNLV Rebels,D. Williams,4592304,,False,13.0,1,2,1,1,0,1,1,2,1,3,4,1,0,0,1,3,3
401364806,UNLV Rebels,D. Muoka,4593762,,False,13.0,1,1,1,1,0,0,0,2,1,3,4,0,0,1,0,0,2
401364806,UNLV Rebels,J. Baker,4897538,,False,17.0,2,4,1,1,1,3,0,0,0,0,0,0,0,0,0,3,5
401364806,UNLV Rebels,K. Gilbert,4585618,,False,5.0,0,1,0,1,0,0,0,0,1,2,3,0,0,0,0,5,0
401364806,UNLV Rebels,J. Webster,4432918,,False,32.0,5,12,3,6,2,6,1,2,1,1,2,1,1,0,2,1,13
401364806,UNLV Rebels,TEAM,TOTAL,TOTAL,False,,22,61,15,30,7,31,16,22,8,28,36,9,8,1,9,21,67
401364806,New Mexico Lobos,J. Allen-Tovar,4897529,,True,5.0,0,1,0,0,0,1,0,0,0,3,3,1,0,0,0,0,0
401364806,New Mexico Lobos,S. Singleton,4703252,,True,26.0,3,5,2,4,1,1,2,2,0,4,4,3,1,1,0,1,9
401364806,New Mexico Lobos,J. Johnson,4683803,,True,33.0,1,3,1,2,0,1,3,4,1,5,6,0,0,0,1,1,5
401364806,New Mexico Lobos,J. Mashburn Jr.,4432408,,True,33.0,8,20,6,16,2,4,3,3,0,1,1,1,0,0,3,3,21
401364806,New Mexico Lobos,J. House,4431763,,True,37.0,7,17,6,14,1,3,12,13,2,4,6,5,3,0,4,1,27
401364806,New Mexico Lobos,J. Arroyo,4397360,,False,19.0,1,4,1,4,0,0,1,2,2,5,7,0,0,2,0,2,3
401364806,New Mexico Lobos,S. Forsling,4897528,,False,16.0,1,1,1,1,0,0,0,0,2,1,3,2,0,0,0,4,2
401364806,New Mexico Lobos,KJ Jenkins,4897526,,False,29.0,4,9,3,4,1,5,0,0,0,4,4,0,1,0,1,2,9
401364806,New Mexico Lobos,T. Todd,4592288,,False,2.0,0,0,0,0,0,0,0,0,0,0,0,0,0,0,0,1,0
401364806,New Mexico Lobos,TEAM,TOTAL,TOTAL,False,,25,60,20,45,5,15,21,24,9,34,43,12,5,3,9,15,76
401364804,Colorado State Rams,A. Thistlewood,4397271,,True,7.0,2,3,2,2,0,1,0,0,0,1,1,1,0,0,0,1,4
401364804,Colorado State Rams,D. Roddy,4593041,,True,32.0,10,17,10,15,0,2,3,3,3,1,4,2,1,1,4,1,23
401364804,Colorado State Rams,C. Jacobs,4897513,,True,20.0,0,2,0,2,0,0,0,0,0,2,2,0,0,2,1,3,0
401364804,Colorado State Rams,I. Stevens,4432117,,True,37.0,4,10,2,6,2,4,2,2,0,1,1,7,2,0,1,1,12
401364804,Colorado State Rams,K. Moore,4397269,,True,32.0,7,9,4,4,3,5,2,3,0,5,5,2,3,0,1,2,19
401364804,Colorado State Rams,D. Thomas,4593040,,False,10.0,0,1,0,0,0,1,0,0,0,1,1,1,0,0,0,2,0
401364804,Colorado State Rams,J. Moors,4593039,,False,17.0,1,2,1,2,0,0,0,0,2,3,5,1,1,0,0,1,2
401364804,Colorado State Rams,J. Lake,4897514,,False,3.0,0,0,0,0,0,0,0,0,0,0,0,0,0,0,0,0,0
401364804,Colorado State Rams,I. Rivera,4703224,,False,15.0,1,2,1,2,0,0,0,0,0,1,1,1,0,0,0,1,2
401364804,Colorado State Rams,J. Tonje,4593043,,False,27.0,3,5,3,4,0,1,3,4,0,3,3,1,0,1,1,3,9
401364804,Colorado State Rams,TEAM,TOTAL,TOTAL,False,,28,51,23,37,5,14,10,12,5,19,24,16,7,4,9,15,71
401364804,Boise State Broncos,T. Degenhart,4898260,,True,31.0,4,6,4,4,0,2,0,0,0,2,2,1,1,0,0,1,8
401364804,Boise State Broncos,M. Armus,4280022,,True,33.0,2,5,2,5,0,0,5,5,2,2,4,1,1,2,3,1,9
401364804,Boise State Broncos,A. Kigab,4278513,,True,36.0,7,11,7,9,0,2,1,1,2,4,6,5,0,1,3,2,15
401364804,Boise State Broncos,M. Shaver Jr.,4280208,,True,29.0,5,12,4,8,1,4,2,3,0,2,2,2,0,0,2,4,13
401364804,Boise State Broncos,E. Akot,4278131,,True,30.0,3,8,3,3,0,5,0,0,0,3,3,2,0,0,1,4,6
401364804,Boise State Broncos,N. Smith,4702873,,False,9.0,0,2,0,1,0,1,0,0,1,1,2,0,0,0,0,1,0
401364804,Boise State Broncos,L. Milner,4702874,,False,4.0,0,0,0,0,0,0,0,0,0,1,1,0,0,0,0,1,0
401364804,Boise State Broncos,P. Kuzmanovic,4702872,,False,7.0,2,2,0,0,2,2,0,0,0,0,0,1,0,0,0,0,6
401364804,Boise State Broncos,M. Rice,4397263,,False,21.0,4,5,1,1,3,4,0,0,0,2,2,1,1,0,1,2,11
401364804,Boise State Broncos,TEAM,TOTAL,TOTAL,False,,27,51,21,31,6,20,8,9,5,17,22,13,3,3,11,16,68
401364803,Wyoming Cowboys,G. Ike,4703396,,True,32.0,6,14,6,14,0,0,4,5,1,7,8,1,2,1,3,5,16
401364803,Wyoming Cowboys,H. Thompson,4280268,,True,23.0,1,2,0,1,1,1,0,0,1,1,2,1,0,0,0,3,3
401364803,Wyoming Cowboys,D. Jeffries,4703397,,True,45.0,1,6,0,0,1,6,1,2,2,2,4,1,1,0,0,1,4
401364803,Wyoming Cowboys,X. DuSell,4703394,,True,39.0,6,17,1,4,5,13,4,4,2,3,5,0,1,0,0,1,21
401364803,Wyoming Cowboys,H. Maldonado,4280267,,True,45.0,3,9,3,8,0,1,4,7,2,4,6,8,3,0,3,2,10
401364803,Wyoming Cowboys,J. Oden,4703399,,False,28.0,5,8,1,1,4,7,0,2,0,2,2,0,0,1,1,3,14
401364803,Wyoming Cowboys,N. Reynolds,4897551,,False,6.0,0,0,0,0,0,0,0,0,0,0,0,0,0,0,1,0,0
401364803,Wyoming Cowboys,B. Wenzel,4433110,,False,7.0,0,0,0,0,0,0,0,0,1,1,2,1,0,0,0,0,0
401364803,Wyoming Cowboys,TEAM,TOTAL,TOTAL,False,,22,56,11,28,11,28,13,20,11,21,32,12,7,2,11,15,68
401364803,Fresno State Bulldogs,O. Robinson,4593049,,True,43.0,10,21,6,14,4,7,10,14,2,7,9,5,1,3,3,2,34
401364803,Fresno State Bulldogs,L. Colimerio,4703241,,True,25.0,2,3,2,3,0,0,0,0,2,2,4,1,0,0,0,2,4
401364803,Fresno State Bulldogs,I. Hill,4593830,,True,40.0,3,7,3,4,0,3,1,2,0,4,4,2,0,0,3,2,7
401364803,Fresno State Bulldogs,A. Holland,4593051,,True,42.0,4,5,1,2,3,3,0,0,0,4,4,0,1,0,2,0,11
401364803,Fresno State Bulldogs,J. Campbell,4397089,,True,27.0,2,7,2,5,0,2,0,0,0,1,1,1,0,1,0,5,4
401364803,Fresno State Bulldogs,B. Meah,4703242,,False,6.0,1,1,1,1,0,0,0,1,1,2,3,0,0,1,0,4,2
401364803,Fresno State Bulldogs,R. Vaihola,4897515,,False,3.0,1,1,1,1,0,0,0,0,1,0,1,0,0,0,2,0,2
401364803,Fresno State Bulldogs,D. Yap,4703386,,False,5.0,0,1,0,0,0,1,0,0,0,0,0,1,0,0,3,0,0
401364803,Fresno State Bulldogs,D. Whitaker,4703240,,False,1.0,0,0,0,0,0,0,0,0,0,0,0,0,0,0,0,1,0
401364803,Fresno State Bulldogs,D. Stroud,4397866,,False,4.0,0,0,0,0,0,0,0,0,0,1,1,0,0,0,2,0,0
401364803,Fresno State Bulldogs,J. Ballard,4397365,,False,29.0,0,2,0,0,0,2,0,0,0,4,4,1,1,0,1,5,0
401364803,Fresno State Bulldogs,TEAM,TOTAL,TOTAL,False,,23,48,16,30,7,18,11,17,7,26,33,11,3,5,17,21,64
401364802,Nevada Wolf Pack,W. Baker,4431691,,True,20.0,5,9,4,7,1,2,2,3,2,1,3,2,0,0,1,1,13
401364802,Nevada Wolf Pack,T. Coleman,4433217,,True,31.0,1,3,1,1,0,2,0,0,1,3,4,0,3,0,2,1,2
401364802,Nevada Wolf Pack,K. Blackshear,4592846,,True,34.0,6,10,4,6,2,4,2,3,1,2,3,0,2,0,3,4,16
401364802,Nevada Wolf Pack,G. Sherfield,4431794,,True,34.0,4,11,4,8,0,3,2,2,0,4,4,6,0,0,6,3,10
401364802,Nevada Wolf Pack,D. Cambridge Jr.,4279462,,True,33.0,4,10,3,4,1,6,0,0,1,3,4,0,0,0,3,1,9
401364802,Nevada Wolf Pack,K.J. Hymes,4397343,,False,11.0,0,1,0,0,0,1,0,0,0,0,0,1,0,0,0,1,0
401364802,Nevada Wolf Pack,W. Washington,4397093,,False,25.0,5,6,5,6,0,0,2,2,1,5,6,0,0,2,2,3,12
401364802,Nevada Wolf Pack,D. Foster,4702876,,False,12.0,1,2,0,0,1,2,2,2,2,3,5,1,0,0,1,3,5
401364802,Nevada Wolf Pack,TEAM,TOTAL,TOTAL,False,,26,52,21,32,5,20,10,12,8,21,29,10,5,2,19,17,67
401364802,Boise State Broncos,T. Degenhart,4898260,,True,34.0,3,7,1,2,2,5,0,0,2,1,3,1,1,0,0,1,8
401364802,Boise State Broncos,M. Armus,4280022,,True,31.0,3,5,3,5,0,0,1,2,3,5,8,0,2,0,2,3,7
401364802,Boise State Broncos,A. Kigab,4278513,,True,39.0,9,12,7,8,2,4,3,4,1,3,4,3,3,0,1,2,23
401364802,Boise State Broncos,M. Shaver Jr.,4280208,,True,36.0,5,14,4,11,1,3,5,6,0,3,3,3,4,0,3,3,16
401364802,Boise State Broncos,E. Akot,4278131,,True,32.0,6,11,3,5,3,6,1,1,0,3,3,3,4,0,6,1,16
401364802,Boise State Broncos,N. Smith,4702873,,False,9.0,1,2,1,1,0,1,1,2,0,2,2,1,0,0,1,2,3
401364802,Boise State Broncos,L. Milner,4702874,,False,4.0,0,0,0,0,0,0,0,0,0,0,0,0,0,0,1,1,0
401364802,Boise State Broncos,M. Rice,4397263,,False,15.0,0,3,0,0,0,3,0,0,0,1,1,0,0,0,0,1,0
401364802,Boise State Broncos,TEAM,TOTAL,TOTAL,False,,27,54,19,32,8,22,11,15,8,18,26,11,14,0,14,14,73
401364801,San José State Spartans,I. Diallo,4592720,,True,22.0,5,10,5,10,0,0,0,2,5,8,13,0,1,2,6,4,10
401364801,San José State Spartans,T. Gorener,4702371,,True,28.0,1,8,0,1,1,7,0,0,0,3,3,0,0,1,0,1,3
401364801,San José State Spartans,T. Anderson,4593007,,True,26.0,0,4,0,1,0,3,0,0,0,3,3,0,0,1,1,5,0
401364801,San José State Spartans,A. Cardenas Torre,4897535,,True,26.0,0,4,0,3,0,1,0,0,0,1,1,1,0,0,0,5,0
401364801,San José State Spartans,O. Moore,4593095,,True,40.0,6,13,4,9,2,4,0,0,3,4,7,0,2,2,8,4,14
401364801,San José State Spartans,S. Robinson,4593017,,False,20.0,4,5,4,5,0,0,1,3,2,4,6,0,3,0,1,0,9
401364801,San José State Spartans,M. Amey Jr.,4897534,,False,29.0,5,12,4,9,1,3,7,8,0,3,3,3,4,0,2,0,18
401364801,San José State Spartans,J. O'Garro,4684167,,False,2.0,0,1,0,0,0,1,0,0,0,1,1,0,0,0,0,0,0
401364801,San José State Spartans,C. Simmons,4278716,,False,7.0,0,0,0,0,0,0,0,0,0,1,1,0,0,0,0,1,0
401364801,San José State Spartans,TEAM,TOTAL,TOTAL,False,,21,57,17,38,4,19,8,13,13,29,42,4,10,6,19,20,54
401364801,Air Force Falcons,A. Kinrade,4397257,,True,4.0,0,1,0,0,0,1,0,0,0,2,2,0,0,0,1,2,0
401364801,Air Force Falcons,E. Taylor,4903265,,True,36.0,1,6,1,4,0,2,3,3,0,5,5,5,0,0,3,0,5
401364801,Air Force Falcons,J. Heidbreder,4903264,,True,40.0,2,3,1,1,1,2,5,7,1,0,1,1,1,0,0,1,10
401364801,Air Force Falcons,J. Octave,4708045,,True,23.0,3,9,3,9,0,0,1,2,1,1,2,0,3,0,1,2,7
401364801,Air Force Falcons,A. Walker,4397255,,True,31.0,5,13,4,10,1,3,4,8,0,4,4,1,0,0,0,2,15
401364801,Air Force Falcons,N. Jackson,4593025,,False,6.0,2,4,2,3,0,1,0,1,0,1,1,0,1,0,2,1,4
401364801,Air Force Falcons,L. Moerman,4903271,,False,30.0,3,7,3,5,0,2,4,5,3,9,12,0,1,4,4,4,10
401364801,Air Force Falcons,J. Mills,4903269,,False,2.0,0,0,0,0,0,0,0,0,0,0,0,0,0,0,0,0,0
401364801,Air Force Falcons,C. Vander Zwaag,4593028,,False,17.0,1,2,0,0,1,2,0,0,0,2,2,1,0,1,1,0,3
401364801,Air Force Falcons,C. Murphy,4432057,,False,11.0,2,3,2,2,0,1,0,0,0,1,1,0,0,0,2,2,4
401364801,Air Force Falcons,TEAM,TOTAL,TOTAL,False,,19,48,16,34,3,14,17,26,5,26,31,8,6,5,15,14,58
401364798,Wyoming Cowboys,J. Oden,4703399,,True,29.0,0,4,0,2,0,2,0,0,0,4,4,0,1,0,2,4,0
401364798,Wyoming Cowboys,G. Ike,4703396,,True,30.0,6,19,6,19,0,0,2,4,0,7,7,0,1,1,1,4,14
401364798,Wyoming Cowboys,D. Jeffries,4703397,,True,40.0,2,6,0,0,2,6,1,1,1,4,5,2,1,0,2,0,7
401364798,Wyoming Cowboys,X. DuSell,4703394,,True,24.0,0,5,0,0,0,5,0,0,0,1,1,0,1,0,0,4,0
401364798,Wyoming Cowboys,H. Maldonado,4280267,,True,32.0,8,12,7,10,1,2,5,7,3,7,10,7,2,0,3,0,22
401364798,Wyoming Cowboys,H. Thompson,4280268,,False,10.0,3,6,0,1,3,5,0,0,1,0,1,0,0,0,0,1,9
401364798,Wyoming Cowboys,N. Reynolds,4897551,,False,13.0,0,3,0,2,0,1,0,0,0,3,3,0,0,0,0,1,0
401364798,Wyoming Cowboys,B. Wenzel,4433110,,False,22.0,2,6,1,1,1,5,0,0,1,1,2,0,0,0,1,0,5
401364798,Wyoming Cowboys,TEAM,TOTAL,TOTAL,False,,21,61,14,35,7,26,8,12,9,27,36,9,6,1,10,14,57
401364798,UNLV Rebels,V. Iwuakor,4431724,,True,21.0,2,4,2,4,0,0,0,0,3,2,5,3,1,0,0,2,4
401364798,UNLV Rebels,R. Hamm Jr.,4277920,,True,27.0,6,11,3,6,3,5,2,2,2,8,10,0,0,0,1,4,17
401364798,UNLV Rebels,B. Hamilton,4397433,,True,36.0,3,15,2,11,1,4,8,8,1,5,6,4,0,0,4,1,15
401364798,UNLV Rebels,M. Nuga,4397315,,True,22.0,1,5,1,3,0,2,0,0,0,3,3,0,1,0,2,0,2
401364798,UNLV Rebels,J. McCabe,4397100,,True,34.0,1,5,0,2,1,3,2,2,0,1,1,2,2,0,2,0,5
401364798,UNLV Rebels,D. Williams,4592304,,False,21.0,1,5,0,2,1,3,2,6,1,7,8,1,0,1,2,4,5
401364798,UNLV Rebels,D. Muoka,4593762,,False,11.0,1,1,1,1,0,0,0,0,1,2,3,0,0,1,0,3,2
401364798,UNLV Rebels,K. Gilbert,4585618,,False,8.0,1,2,0,1,1,1,0,0,0,2,2,2,2,0,2,2,3
401364798,UNLV Rebels,J. Webster,4432918,,False,20.0,5,7,4,4,1,3,0,0,0,0,0,1,1,0,0,0,11
401364798,UNLV Rebels,TEAM,TOTAL,TOTAL,False,,21,55,13,34,8,21,14,18,10,34,44,13,7,2,13,16,64
401364481,Rutgers Scarlet Knights,R. Harper Jr.,4397251,,True,36.0,6,12,5,9,1,3,2,5,1,3,4,2,2,2,0,4,15
401364481,Rutgers Scarlet Knights,C. Omoruyi,4433155,,True,19.0,4,5,4,5,0,0,1,4,2,2,4,0,0,1,1,2,9
401364481,Rutgers Scarlet Knights,P. Mulcahy,4432849,,True,35.0,3,7,2,5,1,2,1,2,1,4,5,6,1,1,3,1,8
401364481,Rutgers Scarlet Knights,C. McConnell,4397249,,True,38.0,2,8,2,5,0,3,2,2,0,6,6,1,0,1,1,1,6
401364481,Rutgers Scarlet Knights,G. Baker,4277986,,True,34.0,2,8,1,4,1,4,1,2,0,1,1,5,1,0,2,3,6
401364481,Rutgers Scarlet Knights,D. Reiber,4581507,,False,16.0,3,6,2,3,1,3,2,2,0,3,3,1,0,0,0,1,9
401364481,Rutgers Scarlet Knights,A. Hyatt,4396975,,False,12.0,2,3,0,1,2,2,0,0,1,1,2,0,2,0,1,0,6
401364481,Rutgers Scarlet Knights,R. Gonzales-Agee,4074930,,False,5.0,0,1,0,1,0,0,0,0,0,1,1,0,0,0,0,0,0
401364481,Rutgers Scarlet Knights,J. Miller,4708076,,False,5.0,0,0,0,0,0,0,0,0,0,0,0,0,0,0,0,1,0
401364481,Rutgers Scarlet Knights,TEAM,TOTAL,TOTAL,False,,22,50,16,33,6,17,9,17,5,23,28,15,6,5,8,13,59
401364481,Penn State Nittany Lions,J. Harrar,4277980,,True,34.0,4,8,4,8,0,0,7,8,6,11,17,1,2,0,2,1,15
401364481,Penn State Nittany Lions,G. Lee,4066811,,True,21.0,0,4,0,2,0,2,0,0,0,4,4,0,0,0,1,2,0
401364481,Penn State Nittany Lions,S. Lundy,4431775,,True,28.0,6,12,4,6,2,6,3,4,2,1,3,1,2,2,3,4,17
401364481,Penn State Nittany Lions,D. Johnson,4433567,,True,10.0,0,4,0,0,0,4,0,0,0,1,1,0,0,0,0,0,0
401364481,Penn State Nittany Lions,J. Pickett,4398390,,True,37.0,3,9,2,6,1,3,0,0,1,5,6,3,1,1,1,3,7
401364481,Penn State Nittany Lions,J. White,4279478,,False,0.0,0,0,0,0,0,0,0,0,0,0,0,0,0,0,0,0,0
401364481,Penn State Nittany Lions,M. Dread,4397239,,False,26.0,2,6,0,1,2,5,0,0,0,1,1,1,0,0,0,3,6
401364481,Penn State Nittany Lions,S. Sessoms,4395880,,False,33.0,3,11,2,9,1,2,6,6,0,2,2,4,2,0,1,3,13
401364481,Penn State Nittany Lions,J. Cornwall,4278690,,False,11.0,0,2,0,0,0,2,0,0,0,1,1,0,0,0,0,1,0
401364481,Penn State Nittany Lions,TEAM,TOTAL,TOTAL,False,,18,56,12,32,6,24,16,18,14,27,41,10,7,3,11,17,58
401364480,Wisconsin Badgers,S. Crowl,4588201,,True,26.0,2,7,2,6,0,1,0,0,2,5,7,1,0,0,4,1,4
401364480,Wisconsin Badgers,T. Wahl,4433105,,True,39.0,4,10,4,9,0,1,5,6,4,3,7,1,5,1,1,4,13
401364480,Wisconsin Badgers,C. Hepburn,4590360,,True,35.0,2,9,2,5,0,4,4,5,0,1,1,3,0,0,1,3,8
401364480,Wisconsin Badgers,Joh. Davis,4432356,,True,11.0,4,4,3,3,1,1,1,2,1,3,4,0,0,1,2,2,10
401364480,Wisconsin Badgers,B. Davison,4277993,,True,38.0,5,15,2,6,3,9,7,9,0,4,4,3,1,0,0,1,20
401364480,Wisconsin Badgers,B. Carlson,4433166,,False,1.0,0,0,0,0,0,0,0,0,0,0,0,0,0,0,0,0,0
401364480,Wisconsin Badgers,C. Vogt,4279252,,False,14.0,5,6,5,6,0,0,3,3,2,1,3,0,1,2,1,4,13
401364480,Wisconsin Badgers,Jor. Davis,4433242,,False,13.0,1,5,0,0,1,5,0,0,1,0,1,0,0,0,0,0,3
401364480,Wisconsin Badgers,J. Neath,4432066,,False,23.0,1,4,1,2,0,2,0,0,1,3,4,1,0,0,0,1,2
401364480,Wisconsin Badgers,TEAM,TOTAL,TOTAL,False,,24,60,19,37,5,23,20,25,13,22,35,9,7,4,9,16,73
401364480,Nebraska Cornhuskers,D. Walker,4278113,,True,31.0,7,11,7,11,0,0,1,2,2,5,7,1,1,0,1,2,15
401364480,Nebraska Cornhuskers,L. Mayen,4277914,,True,29.0,2,4,2,2,0,2,0,0,1,3,4,0,0,0,1,3,4
401364480,Nebraska Cornhuskers,A. Verge Jr.,4592358,,True,31.0,10,16,9,13,1,3,5,6,0,5,5,6,2,0,5,5,26
401364480,Nebraska Cornhuskers,C.J. Wilcher,4432590,,True,37.0,4,7,2,2,2,5,0,1,0,1,1,0,0,0,1,2,10
401364480,Nebraska Cornhuskers,T. McGowens,4395670,,True,16.0,1,2,1,2,0,0,2,2,0,0,0,0,2,0,0,4,4
401364480,Nebraska Cornhuskers,E. Andre,4702281,,False,14.0,2,2,2,2,0,0,0,0,0,1,1,0,1,2,0,0,4
401364480,Nebraska Cornhuskers,K. Tominaga,4897433,,False,12.0,1,7,1,3,0,4,3,3,1,1,2,1,0,0,0,0,5
401364480,Nebraska Cornhuskers,K. Edwards,4711442,,False,1.0,0,0,0,0,0,0,0,0,1,1,2,0,0,0,1,0,0
401364480,Nebraska Cornhuskers,K. Webster,4279535,,False,29.0,2,5,0,1,2,4,0,0,0,2,2,0,0,0,1,3,6
401364480,Nebraska Cornhuskers,TEAM,TOTAL,TOTAL,False,,29,54,24,36,5,18,11,14,5,22,27,8,6,2,11,19,74
401364479,Northwestern Wildcats,P. Nance,4397233,,True,30.0,8,15,5,11,3,4,0,0,2,11,13,3,0,3,1,0,19
401364479,Northwestern Wildcats,E. Williams,4279627,,True,8.0,1,4,0,1,1,3,0,0,0,3,3,0,0,0,0,3,3
401364479,Northwestern Wildcats,J. Roper II,4683949,,True,25.0,1,3,0,1,1,2,4,4,0,5,5,0,0,0,2,2,7
401364479,Northwestern Wildcats,C. Audige,4397602,,True,31.0,2,9,2,6,0,3,1,2,1,3,4,0,1,0,1,3,5
401364479,Northwestern Wildcats,R. Greer,4397230,,True,24.0,1,5,1,4,0,1,2,2,2,3,5,3,0,0,0,1,4
401364479,Northwestern Wildcats,R. Beran,4431737,,False,21.0,4,5,1,1,3,4,4,6,1,6,7,0,0,1,3,2,15
401364479,Northwestern Wildcats,C. Simmons,4432692,,False,4.0,0,0,0,0,0,0,0,0,0,0,0,0,0,0,0,0,0
401364479,Northwestern Wildcats,R. Young,4397232,,False,10.0,3,5,3,5,0,0,3,4,0,1,1,0,0,0,0,1,9
401364479,Northwestern Wildcats,T. Berry,4702288,,False,20.0,1,5,0,1,1,4,0,0,0,3,3,1,0,0,0,0,3
401364479,Northwestern Wildcats,B. Barnhizer,4684208,,False,0.0,0,0,0,0,0,0,0,0,0,0,0,0,0,0,0,0,0
401364479,Northwestern Wildcats,B. Buie,4592712,,False,27.0,4,10,4,8,0,2,2,3,2,1,3,8,2,0,1,1,10
401364479,Northwestern Wildcats,TEAM,TOTAL,TOTAL,False,,25,61,16,38,9,23,16,21,9,39,48,15,3,4,10,13,75
401364479,Minnesota Golden Gophers,J. Battle,4431893,,True,40.0,8,17,7,12,1,5,3,4,0,6,6,2,0,2,0,4,20
401364479,Minnesota Golden Gophers,E. Curry,4066388,,True,25.0,0,5,0,5,0,0,3,4,1,4,5,1,0,1,1,2,3
401364479,Minnesota Golden Gophers,E. Stephens,4280074,,True,37.0,5,13,3,6,2,7,0,0,0,2,2,1,2,0,1,2,12
401364479,Minnesota Golden Gophers,L. Loewe,4279227,,True,34.0,1,4,0,1,1,3,0,0,0,4,4,2,1,0,0,4,3
401364479,Minnesota Golden Gophers,P. Willis,4066230,,True,40.0,7,13,5,8,2,5,0,0,2,6,8,7,0,1,2,2,16
401364479,Minnesota Golden Gophers,T. Thompson,4610141,,False,1.0,0,0,0,0,0,0,0,0,0,0,0,0,0,0,1,1,0
401364479,Minnesota Golden Gophers,C. Daniels,4594154,,False,3.0,0,0,0,0,0,0,0,0,0,0,0,0,0,0,0,0,0
401364479,Minnesota Golden Gophers,A. Thiam,4897426,,False,0.0,0,0,0,0,0,0,0,0,0,0,0,0,0,0,0,2,0
401364479,Minnesota Golden Gophers,S. Sutherlin,4593987,,False,20.0,2,11,1,10,1,1,3,4,0,4,4,0,2,0,1,2,8
401364479,Minnesota Golden Gophers,TEAM,TOTAL,TOTAL,False,,23,63,16,42,7,21,9,12,4,27,31,13,5,4,6,19,62
401364478,Ohio State Buckeyes,E.J. Liddell,4432821,,True,36.0,4,10,3,6,1,4,7,9,2,11,13,2,1,3,2,0,16
401364478,Ohio State Buckeyes,J. Brunk,4065763,,True,25.0,4,6,4,6,0,0,0,0,0,6,6,0,0,0,2,0,8
401364478,Ohio State Buckeyes,J. Ahrens,4397236,,True,33.0,4,9,0,1,4,8,0,0,1,1,2,1,0,0,2,3,12
401364478,Ohio State Buckeyes,M. Branham,4565201,,True,33.0,6,11,5,8,1,3,5,7,0,2,2,1,1,0,3,2,18
401364478,Ohio State Buckeyes,J. Wheeler,4277978,,True,34.0,3,6,0,2,3,4,0,0,0,2,2,3,0,0,1,1,9
401364478,Ohio State Buckeyes,Z. Key,4432401,,False,7.0,2,2,2,2,0,0,0,0,3,1,4,1,0,1,1,1,4
401364478,Ohio State Buckeyes,E. Brown III,4433179,,False,15.0,1,2,1,1,0,1,0,2,1,1,2,1,0,0,1,2,2
401364478,Ohio State Buckeyes,M. Johnson Jr.,4710770,,False,7.0,0,2,0,1,0,1,0,0,0,2,2,0,0,0,1,0,0
401364478,Ohio State Buckeyes,C. Russell,4280257,,False,9.0,0,2,0,1,0,1,0,0,0,1,1,0,0,0,0,1,0
401364478,Ohio State Buckeyes,J. Sotos,4280044,,False,1.0,0,0,0,0,0,0,0,0,0,0,0,0,0,0,0,0,0
401364478,Ohio State Buckeyes,TEAM,TOTAL,TOTAL,False,,24,50,15,28,9,22,12,18,7,27,34,9,2,4,13,10,69
401364478,Michigan Wolverines,M. Diabate,4433249,,True,30.0,7,11,7,11,0,0,0,0,4,3,7,2,1,1,1,3,14
401364478,Michigan Wolverines,B. Johns Jr.,4397206,,True,24.0,0,5,0,3,0,2,2,2,1,2,3,0,1,1,0,3,2
401364478,Michigan Wolverines,C. Houstan,4433623,,True,33.0,0,10,0,7,0,3,0,0,0,2,2,1,2,1,1,1,0
401364478,Michigan Wolverines,D. Jones,4397506,,True,34.0,9,16,6,10,3,6,0,0,0,1,1,9,2,0,2,3,21
401364478,Michigan Wolverines,E. Brooks,4277960,,True,40.0,4,10,3,7,1,3,5,5,2,5,7,2,3,0,0,0,14
401364478,Michigan Wolverines,T. Williams II,4702236,,False,25.0,5,9,2,5,3,4,4,4,1,2,3,0,0,0,0,4,17
401364478,Michigan Wolverines,J. Faulds,4279471,,False,2.0,0,0,0,0,0,0,0,0,0,1,1,0,0,0,0,0,0
401364478,Michigan Wolverines,K. Bufkin,4683736,,False,7.0,1,3,0,1,1,2,0,0,0,1,1,0,1,1,1,0,3
401364478,Michigan Wolverines,F. Collins,4433616,,False,5.0,2,4,2,3,0,1,0,0,1,0,1,0,1,0,0,0,4
401364478,Michigan Wolverines,TEAM,TOTAL,TOTAL,False,,28,68,20,47,8,21,11,11,13,22,35,14,11,4,6,14,75
401364477,Michigan State Spartans,M. Bingham Jr.,4397212,,True,20.0,4,8,1,4,3,4,1,2,3,8,11,0,2,1,2,1,12
401364477,Michigan State Spartans,G. Brown,4397210,,True,32.0,3,7,2,4,1,3,3,3,1,1,2,2,2,0,0,1,10
401364477,Michigan State Spartans,J. Hauser,4295180,,True,26.0,1,5,0,3,1,2,0,0,0,5,5,5,0,0,2,2,3
401364477,Michigan State Spartans,M. Christie,4432582,,True,29.0,2,4,2,3,0,1,2,3,2,3,5,2,0,0,4,0,6
401364477,Michigan State Spartans,T. Walker,4432129,,True,29.0,5,14,4,9,1,5,2,2,0,1,1,5,0,0,0,2,13
401364477,Michigan State Spartans,K. Coleman,4635008,,False,0.0,0,0,0,0,0,0,0,0,0,0,0,0,0,0,0,0,0
401364477,Michigan State Spartans,M. Hall,4592693,,False,22.0,7,11,6,10,1,1,2,2,3,0,3,1,1,0,1,3,17
401364477,Michigan State Spartans,J. Marble II,4433031,,False,10.0,2,3,2,3,0,0,4,6,0,2,2,0,0,1,1,2,8
401364477,Michigan State Spartans,P. Brooks,4683731,,False,2.0,0,0,0,0,0,0,0,1,0,0,0,0,0,0,0,0,0
401364477,Michigan State Spartans,M. Sissoko,4433154,,False,1.0,1,1,1,1,0,0,0,0,0,0,0,0,0,0,0,0,2
401364477,Michigan State Spartans,D. Smith,4702244,,False,0.0,0,0,0,0,0,0,0,0,0,0,0,0,0,0,0,0,0
401364477,Michigan State Spartans,J. Akins,4683730,,False,18.0,0,2,0,0,0,2,2,2,1,3,4,4,2,0,1,3,2
401364477,Michigan State Spartans,S. Izzo,4592692,,False,0.0,0,0,0,0,0,0,0,0,0,0,0,0,1,0,0,0,0
401364477,Michigan State Spartans,A. Hoggard,4432206,,False,11.0,2,2,2,2,0,0,0,0,0,3,3,2,0,0,1,1,4
401364477,Michigan State Spartans,TEAM,TOTAL,TOTAL,False,,27,57,20,39,7,18,16,21,11,28,39,21,8,2,14,15,77
401364477,Maryland Terrapins,Q. Wahab,4431739,,True,17.0,2,5,2,5,0,0,2,2,4,0,4,0,0,1,0,1,6
401364477,Maryland Terrapins,D. Scott,4432852,,True,35.0,5,14,4,7,1,7,2,2,1,4,5,3,2,1,2,1,13
401364477,Maryland Terrapins,H. Hart,4431984,,True,35.0,3,8,3,5,0,3,1,2,1,4,5,3,2,0,0,2,7
401364477,Maryland Terrapins,E. Ayala,4397184,,True,37.0,7,18,2,6,5,12,0,0,1,5,6,2,1,0,2,3,19
401364477,Maryland Terrapins,F. Russell,4278371,,True,38.0,4,11,2,6,2,5,6,6,0,1,1,4,3,0,5,2,16
401364477,Maryland Terrapins,J. Reese,4683742,,False,15.0,2,3,2,2,0,1,0,0,2,5,7,1,0,0,1,4,4
401364477,Maryland Terrapins,S. Wright,4279202,,False,0.0,0,0,0,0,0,0,0,0,0,0,0,0,0,0,0,0,0
401364477,Maryland Terrapins,I. Martinez,4601026,,False,0.0,0,0,0,0,0,0,0,0,0,0,0,0,0,0,0,0,0
401364477,Maryland Terrapins,X. Green,4067031,,False,23.0,1,2,1,1,0,1,0,0,0,1,1,0,0,0,0,3,2
401364477,Maryland Terrapins,TEAM,TOTAL,TOTAL,False,,24,61,16,32,8,29,11,12,9,21,30,13,8,2,10,16,67
401364476,Iowa Hawkeyes,Ke. Murray,4594327,,True,39.0,7,22,5,15,2,7,6,8,1,10,11,1,0,4,1,2,22
401364476,Iowa Hawkeyes,F. Rebraca,4398190,,True,22.0,3,5,3,5,0,0,0,0,3,0,3,0,1,0,2,2,6
401364476,Iowa Hawkeyes,T. Perkins,4433130,,True,34.0,6,13,4,10,2,3,3,7,4,8,12,5,1,0,1,2,17
401364476,Iowa Hawkeyes,C. McCaffery,4277950,,True,24.0,0,1,0,0,0,1,0,0,0,1,1,1,0,0,1,2,0
401364476,Iowa Hawkeyes,J. Bohannon,4066366,,True,14.0,0,2,0,0,0,2,0,0,0,0,0,0,0,0,0,3,0
401364476,Iowa Hawkeyes,Kr. Murray,4594326,,False,19.0,5,10,3,5,2,5,1,7,2,2,4,0,1,0,1,3,13
401364476,Iowa Hawkeyes,P. Sandfort,4697270,,False,15.0,3,3,2,2,1,1,0,0,0,1,1,1,0,0,0,0,7
401364476,Iowa Hawkeyes,J. Toussaint,4432880,,False,20.0,2,4,1,2,1,2,0,0,0,1,1,4,2,0,3,3,5
401364476,Iowa Hawkeyes,A. Ulis,4432454,,False,13.0,1,2,1,2,0,0,0,0,0,1,1,1,0,0,1,2,2
401364476,Iowa Hawkeyes,TEAM,TOTAL,TOTAL,False,,27,62,19,41,8,21,10,22,11,27,38,13,5,4,10,19,72
401364476,Illinois Fighting Illini,K. Cockburn,4432828,,True,34.0,9,17,9,17,0,0,3,6,7,7,14,2,0,3,2,3,21
401364476,Illinois Fighting Illini,C. Hawkins,4432976,,True,37.0,3,5,2,3,1,2,2,2,1,10,11,2,0,2,2,2,9
401364476,Illinois Fighting Illini,A. Plummer,4592434,,True,27.0,5,11,3,5,2,6,3,3,0,1,1,0,0,0,0,1,15
401364476,Illinois Fighting Illini,D. Williams,4277940,,True,19.0,2,3,0,1,2,2,1,2,1,2,3,1,0,0,1,2,7
401364476,Illinois Fighting Illini,T. Frazier,4277936,,True,38.0,1,9,1,4,0,5,0,0,0,2,2,5,1,0,0,3,2
401364476,Illinois Fighting Illini,O. Payne,4432825,,False,4.0,0,1,0,1,0,0,0,0,0,1,1,0,0,0,0,0,0
401364476,Illinois Fighting Illini,L. Goode,4683743,,False,9.0,1,3,0,1,1,2,0,0,1,1,2,0,0,0,1,1,3
401364476,Illinois Fighting Illini,R. Melendez,4683738,,False,8.0,1,1,0,0,1,1,0,0,0,0,0,0,0,0,0,1,3
401364476,Illinois Fighting Illini,B. Podziemski,4709138,,False,2.0,0,0,0,0,0,0,0,0,0,0,0,0,0,0,1,1,0
401364476,Illinois Fighting Illini,A. Curbelo,4432195,,False,22.0,4,12,3,8,1,4,5,5,0,4,4,6,1,0,4,5,14
401364476,Illinois Fighting Illini,TEAM,TOTAL,TOTAL,False,,26,62,18,40,8,22,14,18,12,29,41,16,2,5,12,19,74
401364475,Purdue Boilermakers,M. Gillis,4431753,,True,36.0,3,6,2,3,1,3,0,1,2,5,7,2,0,0,1,2,7
401364475,Purdue Boilermakers,Z. Edey,4600663,,True,21.0,5,11,5,11,0,0,0,3,4,7,11,0,0,4,0,1,10
401364475,Purdue Boilermakers,J. Ivey,4433218,,True,31.0,2,11,0,5,2,6,4,4,2,0,2,1,0,0,3,1,10
401364475,Purdue Boilermakers,E. Hunter Jr.,4397243,,True,37.0,7,12,4,6,3,6,0,0,2,3,5,5,0,0,2,3,17
401364475,Purdue Boilermakers,S. Stefanovic,4277985,,True,38.0,3,9,0,3,3,6,6,7,0,1,1,3,0,0,2,3,15
401364475,Purdue Boilermakers,C. Furst,4433598,,False,4.0,0,1,0,0,0,1,2,2,1,0,1,0,0,0,0,1,2
401364475,Purdue Boilermakers,T. Williams,4397246,,False,19.0,3,5,3,5,0,0,2,4,2,6,8,2,3,1,3,0,8
401364475,Purdue Boilermakers,E. Morton,4433151,,False,10.0,0,2,0,1,0,1,0,0,0,0,0,2,0,0,0,0,0
401364475,Purdue Boilermakers,I. Thompson,4431749,,False,4.0,0,1,0,0,0,1,0,0,0,1,1,0,0,0,0,0,0
401364475,Purdue Boilermakers,TEAM,TOTAL,TOTAL,False,,23,58,14,34,9,24,14,21,14,24,38,15,3,5,11,11,69
401364475,Indiana Hoosiers,T. Jackson-Davis,4431684,,True,32.0,7,12,7,12,0,0,1,1,3,3,6,0,0,2,2,3,15
401364475,Indiana Hoosiers,M. Kopp,4397231,,True,34.0,5,9,1,3,4,6,0,0,0,3,3,1,0,0,3,3,14
401364475,Indiana Hoosiers,R. Thompson,4277947,,True,27.0,4,8,3,4,1,4,0,0,2,8,10,0,1,0,0,3,9
401364475,Indiana Hoosiers,X. Johnson,4395669,,True,34.0,7,15,7,11,0,4,4,4,1,4,5,12,3,0,2,1,18
401364475,Indiana Hoosiers,P. Stewart,4278013,,True,32.0,1,4,1,2,0,2,3,3,0,4,4,2,1,0,1,4,5
401364475,Indiana Hoosiers,M. Durr,4396642,,False,8.0,0,2,0,1,0,1,2,2,1,2,3,2,1,0,0,4,2
401364475,Indiana Hoosiers,J. Geronimo,4432512,,False,13.0,0,1,0,0,0,1,0,0,0,1,1,0,0,1,0,2,0
401364475,Indiana Hoosiers,T. Bates,4683933,,False,6.0,0,2,0,2,0,0,0,0,0,0,0,0,0,0,1,0,0
401364475,Indiana Hoosiers,R. Phinisee,4397010,,False,14.0,2,7,2,5,0,2,0,0,0,0,0,0,0,0,0,1,4
401364475,Indiana Hoosiers,TEAM,TOTAL,TOTAL,False,,26,60,21,40,5,20,10,10,8,26,34,17,6,3,9,21,67
401364474,Penn State Nittany Lions,J. Harrar,4277980,,True,26.0,2,3,2,3,0,0,0,0,0,6,6,0,2,0,1,3,4
401364474,Penn State Nittany Lions,G. Lee,4066811,,True,33.0,4,11,3,7,1,4,0,0,2,3,5,0,0,0,2,2,9
401364474,Penn State Nittany Lions,S. Lundy,4431775,,True,34.0,4,12,1,4,3,8,0,0,1,2,3,0,1,0,1,3,11
401364474,Penn State Nittany Lions,D. Johnson,4433567,,True,28.0,2,5,0,2,2,3,0,0,0,4,4,1,0,0,0,0,6
401364474,Penn State Nittany Lions,J. Pickett,4398390,,True,40.0,8,15,7,12,1,3,1,3,1,4,5,7,1,0,3,5,18
401364474,Penn State Nittany Lions,C. Dorsey,4581505,,False,3.0,1,1,0,0,1,1,0,0,0,0,0,0,0,0,0,0,3
401364474,Penn State Nittany Lions,J. White,4279478,,False,5.0,0,0,0,0,0,0,0,0,0,0,0,0,0,0,0,2,0
401364474,Penn State Nittany Lions,M. Dread,4397239,,False,19.0,0,3,0,0,0,3,0,0,0,2,2,0,0,0,0,2,0
401364474,Penn State Nittany Lions,S. Sessoms,4395880,,False,12.0,2,5,2,2,0,3,0,0,0,2,2,0,0,0,2,0,4
401364474,Penn State Nittany Lions,TEAM,TOTAL,TOTAL,False,,23,55,15,30,8,25,1,3,11,23,34,8,4,0,12,17,55
401364474,Illinois Fighting Illini,K. Cockburn,4432828,,True,34.0,4,7,4,7,0,0,3,4,3,3,6,0,1,1,1,0,11
401364474,Illinois Fighting Illini,J. Grandison,4280073,,True,28.0,3,7,1,3,2,4,0,0,1,4,5,1,1,1,1,0,8
401364474,Illinois Fighting Illini,A. Plummer,4592434,,True,32.0,1,5,0,1,1,4,2,2,0,6,6,1,0,0,1,3,5
401364474,Illinois Fighting Illini,D. Williams,4277940,,True,33.0,4,11,0,1,4,10,2,2,0,3,3,2,2,0,0,1,14
401364474,Illinois Fighting Illini,T. Frazier,4277936,,True,34.0,3,6,1,1,2,5,2,3,1,1,2,4,2,1,2,3,10
401364474,Illinois Fighting Illini,O. Payne,4432825,,False,3.0,1,1,1,1,0,0,0,0,0,2,2,0,0,0,0,0,2
401364474,Illinois Fighting Illini,L. Goode,4683743,,False,7.0,0,2,0,1,0,1,0,0,1,0,1,0,0,0,0,1,0
401364474,Illinois Fighting Illini,C. Hawkins,4432976,,False,12.0,1,6,1,2,0,4,4,4,2,0,2,1,0,0,0,0,6
401364474,Illinois Fighting Illini,A. Curbelo,4432195,,False,17.0,1,5,1,5,0,0,2,2,1,0,1,2,0,0,3,1,4
401364474,Illinois Fighting Illini,TEAM,TOTAL,TOTAL,False,,18,50,9,22,9,28,15,17,9,20,29,11,6,3,8,9,60
401364473,Ohio State Buckeyes,E.J. Liddell,4432821,,True,33.0,6,12,3,6,3,6,4,5,1,7,8,3,0,1,3,2,19
401364473,Ohio State Buckeyes,E. Brown III,4433179,,True,28.0,1,2,1,1,0,1,0,0,0,0,0,0,0,1,1,3,2
401364473,Ohio State Buckeyes,J. Brunk,4065763,,True,32.0,7,10,7,10,0,0,4,5,0,6,6,0,2,0,2,4,18
401364473,Ohio State Buckeyes,M. Branham,4565201,,True,36.0,9,16,8,13,1,3,3,4,2,2,4,4,2,0,0,0,22
401364473,Ohio State Buckeyes,J. Wheeler,4277978,,True,34.0,5,11,1,3,4,8,2,2,0,2,2,1,1,0,1,4,16
401364473,Ohio State Buckeyes,J. Ahrens,4397236,,False,9.0,0,0,0,0,0,0,0,0,0,1,1,0,0,0,0,2,0
401364473,Ohio State Buckeyes,M. Johnson Jr.,4710770,,False,15.0,0,1,0,0,0,1,0,0,0,1,1,1,2,0,2,1,0
401364473,Ohio State Buckeyes,C. Russell,4280257,,False,13.0,1,1,0,0,1,1,0,0,0,1,1,0,0,0,1,1,3
401364473,Ohio State Buckeyes,TEAM,TOTAL,TOTAL,False,,29,53,20,33,9,20,13,16,5,21,26,9,7,2,10,17,80
401364473,Michigan State Spartans,M. Hall,4592693,,True,21.0,1,4,1,2,0,2,2,4,2,1,3,0,0,0,3,0,4
401364473,Michigan State Spartans,J. Marble II,4433031,,True,11.0,1,3,1,3,0,0,1,2,2,1,3,0,1,1,1,2,3
401364473,Michigan State Spartans,G. Brown,4397210,,True,31.0,5,9,2,5,3,4,0,0,1,1,2,2,1,0,2,0,13
401364473,Michigan State Spartans,M. Christie,4432582,,True,28.0,3,8,2,5,1,3,0,0,0,3,3,2,0,0,2,0,7
401364473,Michigan State Spartans,A. Hoggard,4432206,,True,18.0,3,5,3,4,0,1,0,1,1,2,3,1,1,0,2,2,6
401364473,Michigan State Spartans,M. Bingham Jr.,4397212,,False,18.0,4,6,2,4,2,2,1,2,2,3,5,0,0,1,0,3,11
401364473,Michigan State Spartans,J. Hauser,4295180,,False,22.0,3,7,2,4,1,3,2,2,0,3,3,0,0,0,1,3,9
401364473,Michigan State Spartans,P. Brooks,4683731,,False,4.0,1,1,1,1,0,0,1,1,0,0,0,0,0,0,0,0,3
401364473,Michigan State Spartans,M. Sissoko,4433154,,False,3.0,0,0,0,0,0,0,0,0,0,0,0,0,0,0,0,1,0
401364473,Michigan State Spartans,J. Akins,4683730,,False,17.0,1,4,0,2,1,2,3,4,0,2,2,0,0,1,0,1,6
401364473,Michigan State Spartans,T. Walker,4432129,,False,27.0,2,6,1,5,1,1,2,2,0,2,2,6,0,0,2,3,7
401364473,Michigan State Spartans,TEAM,TOTAL,TOTAL,False,,24,53,15,35,9,18,12,18,10,20,30,11,3,3,13,15,69
401364472,Michigan Wolverines,M. Diabate,4433249,,True,31.0,2,9,2,9,0,0,0,1,5,2,7,2,0,1,3,2,4
401364472,Michigan Wolverines,C. Houstan,4433623,,True,38.0,4,12,2,6,2,6,1,2,1,2,3,1,3,1,2,1,11
401364472,Michigan Wolverines,H. Dickinson,4432180,,True,34.0,9,13,9,12,0,1,3,5,3,8,11,4,0,4,3,2,21
401364472,Michigan Wolverines,D. Jones,4397506,,True,33.0,4,7,2,2,2,5,0,0,0,1,1,6,0,0,3,2,10
401364472,Michigan Wolverines,E. Brooks,4277960,,True,40.0,7,11,4,4,3,7,0,0,0,3,3,2,1,0,1,1,17
401364472,Michigan Wolverines,T. Williams II,4702236,,False,9.0,2,2,2,2,0,0,0,0,0,1,1,0,0,0,1,2,4
401364472,Michigan Wolverines,B. Johns Jr.,4397206,,False,6.0,2,3,2,3,0,0,0,0,0,1,1,0,0,0,0,0,4
401364472,Michigan Wolverines,K. Bufkin,4683736,,False,5.0,0,2,0,2,0,0,0,0,0,1,1,0,0,0,0,1,0
401364472,Michigan Wolverines,J. Howard,4611541,,False,0.0,0,0,0,0,0,0,0,0,0,0,0,1,0,0,0,0,0
401364472,Michigan Wolverines,F. Collins,4433616,,False,4.0,0,1,0,1,0,0,0,0,0,0,0,0,0,0,0,0,0
401364472,Michigan Wolverines,TEAM,TOTAL,TOTAL,False,,30,60,23,41,7,19,4,8,12,19,31,16,4,6,13,11,71
401364472,Iowa Hawkeyes,Ke. Murray,4594327,,True,36.0,7,9,3,5,4,4,5,6,0,7,7,3,1,3,1,2,23
401364472,Iowa Hawkeyes,P. McCaffery,4432836,,True,18.0,2,6,2,4,0,2,0,0,0,4,4,1,1,1,0,1,4
401364472,Iowa Hawkeyes,F. Rebraca,4398190,,True,17.0,2,6,2,6,0,0,0,0,0,2,2,0,0,1,0,3,4
401364472,Iowa Hawkeyes,T. Perkins,4433130,,True,27.0,5,10,4,9,1,1,2,2,2,2,4,1,2,0,1,1,13
401364472,Iowa Hawkeyes,J. Bohannon,4066366,,True,34.0,5,8,0,1,5,7,4,4,0,0,0,1,1,0,3,1,19
401364472,Iowa Hawkeyes,Kr. Murray,4594326,,False,27.0,9,11,8,9,1,2,0,0,3,3,6,1,2,1,2,3,19
401364472,Iowa Hawkeyes,J. Toussaint,4432880,,False,8.0,0,4,0,3,0,1,0,0,0,0,0,2,0,0,0,0,0
401364472,Iowa Hawkeyes,A. Ulis,4432454,,False,9.0,0,2,0,1,0,1,0,0,0,1,1,0,2,0,1,0,0
401364472,Iowa Hawkeyes,C. McCaffery,4277950,,False,24.0,0,1,0,0,0,1,0,0,0,1,1,2,1,0,0,2,0
401364472,Iowa Hawkeyes,TEAM,TOTAL,TOTAL,False,,30,57,19,38,11,19,11,12,7,22,29,11,10,6,9,13,82
401364471,Rutgers Scarlet Knights,R. Harper Jr.,4397251,,True,38.0,7,12,2,4,5,8,0,0,1,5,6,4,0,0,1,3,19
401364471,Rutgers Scarlet Knights,C. Omoruyi,4433155,,True,36.0,4,6,4,6,0,0,5,8,0,12,12,0,1,4,0,3,13
401364471,Rutgers Scarlet Knights,P. Mulcahy,4432849,,True,37.0,2,8,2,7,0,1,1,2,1,0,1,3,1,0,5,3,5
401364471,Rutgers Scarlet Knights,C. McConnell,4397249,,True,29.0,4,7,4,5,0,2,0,0,1,4,5,0,2,0,1,4,8
401364471,Rutgers Scarlet Knights,G. Baker,4277986,,True,36.0,4,13,1,6,3,7,2,2,1,1,2,3,2,0,3,1,13
401364471,Rutgers Scarlet Knights,M. Mag,4602948,,False,10.0,1,1,1,1,0,0,0,2,1,0,1,0,0,0,1,0,2
401364471,Rutgers Scarlet Knights,D. Reiber,4581507,,False,4.0,1,1,1,1,0,0,0,0,0,0,0,0,0,0,1,0,2
401364471,Rutgers Scarlet Knights,A. Hyatt,4396975,,False,7.0,1,3,1,3,0,0,2,2,2,2,4,0,0,0,1,0,4
401364471,Rutgers Scarlet Knights,J. Miller,4708076,,False,3.0,0,0,0,0,0,0,0,0,0,0,0,0,0,0,0,0,0
401364471,Rutgers Scarlet Knights,TEAM,TOTAL,TOTAL,False,,24,51,16,33,8,18,10,16,9,24,33,10,6,4,13,14,66
401364471,Indiana Hoosiers,T. Jackson-Davis,4431684,,True,32.0,7,11,7,11,0,0,5,6,3,6,9,1,1,1,2,3,19
401364471,Indiana Hoosiers,M. Kopp,4397231,,True,34.0,1,7,0,2,1,5,2,2,1,3,4,2,1,1,0,3,5
401364471,Indiana Hoosiers,R. Thompson,4277947,,True,31.0,4,7,3,6,1,1,3,5,0,3,3,1,1,0,1,2,12
401364471,Indiana Hoosiers,X. Johnson,4395669,,True,33.0,5,11,3,7,2,4,1,1,1,2,3,2,3,0,4,3,13
401364471,Indiana Hoosiers,P. Stewart,4278013,,True,31.0,2,9,0,0,2,9,0,0,0,3,3,0,0,0,2,1,6
401364471,Indiana Hoosiers,M. Durr,4396642,,False,8.0,0,2,0,2,0,0,0,0,1,1,2,1,0,2,0,1,0
401364471,Indiana Hoosiers,J. Geronimo,4432512,,False,9.0,3,4,3,4,0,0,0,0,1,1,2,0,0,0,0,0,6
401364471,Indiana Hoosiers,T. Bates,4683933,,False,5.0,0,1,0,1,0,0,0,0,0,0,0,0,0,0,0,1,0
401364471,Indiana Hoosiers,R. Phinisee,4397010,,False,17.0,1,4,1,2,0,2,0,0,0,1,1,2,1,0,0,2,2
401364471,Indiana Hoosiers,TEAM,TOTAL,TOTAL,False,,23,56,17,35,6,21,11,14,9,22,31,9,7,4,9,16,63
401364470,Minnesota Golden Gophers,C. Daniels,4594154,,True,14.0,0,1,0,1,0,0,0,0,1,0,1,1,0,1,0,3,0
401364470,Minnesota Golden Gophers,J. Battle,4431893,,True,40.0,14,31,7,15,7,16,4,4,1,3,4,2,1,0,2,0,39
401364470,Minnesota Golden Gophers,E. Stephens,4280074,,True,40.0,2,9,2,6,0,3,0,0,4,4,8,2,1,0,2,3,4
401364470,Minnesota Golden Gophers,L. Loewe,4279227,,True,40.0,1,4,0,1,1,3,2,2,1,1,2,1,1,0,2,2,5
401364470,Minnesota Golden Gophers,P. Willis,4066230,,True,30.0,7,14,4,8,3,6,4,6,1,3,4,1,0,0,1,3,21
401364470,Minnesota Golden Gophers,T. Thompson,4610141,,False,3.0,0,0,0,0,0,0,0,0,0,0,0,0,0,1,0,0,0
401364470,Minnesota Golden Gophers,D. Ogele,4709429,,False,3.0,0,2,0,2,0,0,0,0,0,0,0,0,0,0,0,0,0
401364470,Minnesota Golden Gophers,W. Ramberg,4897430,,False,1.0,0,0,0,0,0,0,0,0,0,0,0,0,0,0,0,0,0
401364470,Minnesota Golden Gophers,S. Sutherlin,4593987,,False,29.0,2,5,2,5,0,0,0,0,2,6,8,0,1,0,0,5,4
401364470,Minnesota Golden Gophers,TEAM,TOTAL,TOTAL,False,,26,66,15,38,11,28,10,12,12,21,33,7,4,2,7,16,73
401364470,Maryland Terrapins,Q. Wahab,4431739,,True,15.0,5,8,5,7,0,1,0,1,2,3,5,0,0,1,0,0,10
401364470,Maryland Terrapins,D. Scott,4432852,,True,34.0,3,7,2,4,1,3,2,2,3,5,8,1,0,1,3,3,9
401364470,Maryland Terrapins,H. Hart,4431984,,True,33.0,5,8,4,5,1,3,8,8,2,5,7,3,2,1,1,3,19
401364470,Maryland Terrapins,E. Ayala,4397184,,True,35.0,6,13,3,6,3,7,0,0,0,9,9,2,0,0,2,1,15
401364470,Maryland Terrapins,F. Russell,4278371,,True,31.0,5,12,5,9,0,3,6,7,0,3,3,4,3,0,1,2,16
401364470,Maryland Terrapins,P. Dziuba,4702377,,False,1.0,0,0,0,0,0,0,0,0,0,0,0,0,0,0,0,0,0
401364470,Maryland Terrapins,J. Reese,4683742,,False,18.0,6,8,6,8,0,0,0,1,4,1,5,0,2,0,2,3,12
401364470,Maryland Terrapins,S. Wright,4279202,,False,2.0,0,0,0,0,0,0,0,0,0,0,0,0,0,0,0,0,0
401364470,Maryland Terrapins,A. McCool,4702228,,False,0.0,0,0,0,0,0,0,0,0,0,0,0,0,0,0,0,0,0
401364470,Maryland Terrapins,I. Martinez,4601026,,False,5.0,0,1,0,1,0,0,0,0,0,0,0,0,0,0,0,0,0
401364470,Maryland Terrapins,X. Green,4067031,,False,26.0,1,3,0,1,1,2,0,0,0,2,2,2,0,0,0,2,3
401364470,Maryland Terrapins,TEAM,TOTAL,TOTAL,False,,31,60,25,41,6,19,16,19,11,29,40,12,7,3,10,14,84
401364469,Wisconsin Badgers,S. Crowl,4588201,,True,24.0,2,6,2,3,0,3,0,0,1,4,5,2,0,1,1,3,4
401364469,Wisconsin Badgers,T. Wahl,4433105,,True,33.0,8,14,7,11,1,3,2,2,1,1,2,2,5,2,1,1,19
401364469,Wisconsin Badgers,C. Hepburn,4590360,,True,32.0,5,13,1,7,4,6,3,3,0,0,0,2,1,0,0,4,17
401364469,Wisconsin Badgers,Joh. Davis,4432356,,True,34.0,5,12,5,11,0,1,6,6,0,8,8,1,0,0,3,3,16
401364469,Wisconsin Badgers,B. Davison,4277993,,True,32.0,3,7,2,4,1,3,0,1,0,4,4,0,0,0,0,2,7
401364469,Wisconsin Badgers,B. Carlson,4433166,,False,7.0,1,2,1,1,0,1,0,0,1,2,3,0,0,0,0,1,2
401364469,Wisconsin Badgers,C. Vogt,4279252,,False,16.0,1,1,1,1,0,0,0,0,3,1,4,2,0,1,1,1,2
401364469,Wisconsin Badgers,Jor. Davis,4433242,,False,6.0,0,2,0,0,0,2,0,0,0,0,0,0,0,0,0,2,0
401364469,Wisconsin Badgers,J. Neath,4432066,,False,16.0,1,4,0,1,1,3,0,0,1,3,4,0,0,0,0,0,3
401364469,Wisconsin Badgers,TEAM,TOTAL,TOTAL,False,,26,61,19,39,7,22,11,12,7,26,33,9,6,4,6,17,70
401364469,Purdue Boilermakers,M. Gillis,4431753,,True,17.0,2,4,1,1,1,3,0,0,0,3,3,0,0,0,1,4,5
401364469,Purdue Boilermakers,Z. Edey,4600663,,True,23.0,6,11,6,11,0,0,5,7,5,4,9,0,0,1,0,3,17
401364469,Purdue Boilermakers,J. Ivey,4433218,,True,37.0,8,15,5,8,3,7,3,9,0,5,5,5,1,0,3,2,22
401364469,Purdue Boilermakers,E. Hunter Jr.,4397243,,True,35.0,2,6,1,4,1,2,1,2,0,5,5,2,2,0,2,3,6
401364469,Purdue Boilermakers,S. Stefanovic,4277985,,True,37.0,4,10,1,3,3,7,0,0,0,2,2,1,0,0,0,0,11
401364469,Purdue Boilermakers,C. Furst,4433598,,False,12.0,0,1,0,1,0,0,0,0,0,2,2,0,0,0,0,0,0
401364469,Purdue Boilermakers,T. Williams,4397246,,False,17.0,2,8,2,7,0,1,2,2,3,2,5,0,0,0,2,1,6
401364469,Purdue Boilermakers,E. Morton,4433151,,False,17.0,0,1,0,0,0,1,0,0,0,3,3,2,1,0,1,2,0
401364469,Purdue Boilermakers,I. Thompson,4431749,,False,5.0,0,0,0,0,0,0,0,0,0,0,0,0,0,0,1,1,0
401364469,Purdue Boilermakers,TEAM,TOTAL,TOTAL,False,,24,56,16,35,8,21,11,20,11,28,39,10,4,1,10,16,67
