game_id,team,player,player_id,position,starter,min,fgm,fga,2pm,2pa,3pm,3pa,ftm,fta,oreb,dreb,reb,ast,stl,blk,to,pf,pts
401426190,Seton Hall Pirates,M. Bembry,4433041,,True,33.0,2,8,2,8,0,0,0,0,2,4,6,1,1,2,1,0,4
401426190,Seton Hall Pirates,S. Cooks,4281245,,True,32.0,10,13,6,9,4,4,4,4,0,7,7,2,0,1,2,4,28
401426190,Seton Hall Pirates,M. Jackson,4595161,,True,30.0,5,10,2,4,3,6,0,0,1,3,4,1,0,0,1,0,13
401426190,Seton Hall Pirates,L. Park-Lane,4433379,,True,40.0,7,17,6,13,1,4,1,1,0,5,5,10,1,2,5,0,16
401426190,Seton Hall Pirates,A. Espinoza-Hunter,4281075,,True,38.0,5,10,3,5,2,5,1,2,2,4,6,3,3,0,2,2,13
401426190,Seton Hall Pirates,A. Wright,4704306,,False,10.0,0,0,0,0,0,0,0,0,0,1,1,1,2,0,0,2,0
401426190,Seton Hall Pirates,C. Dean,4704305,,False,8.0,0,1,0,0,0,1,0,0,0,1,1,1,0,0,0,3,0
401426190,Seton Hall Pirates,K. Armstrong,4068589,,False,9.0,0,2,0,2,0,0,0,0,0,0,0,1,0,0,0,0,0
401426190,Seton Hall Pirates,TEAM,TOTAL,TOTAL,False,,29,61,19,41,10,20,6,7,6,27,33,20,7,5,12,12,74
401426190,Middle Tennessee Blue Raiders,C. Whitson,4595015,,True,40.0,2,11,1,4,1,7,2,2,3,5,8,2,2,0,3,2,7
401426190,Middle Tennessee Blue Raiders,A. Boldyreva,4899372,,True,12.0,5,8,4,7,1,1,1,2,2,3,5,0,0,0,1,2,12
401426190,Middle Tennessee Blue Raiders,J. Gregory,4899375,,True,40.0,4,10,2,3,2,7,0,0,1,2,3,1,2,0,0,2,10
401426190,Middle Tennessee Blue Raiders,Al. Whittington,4399524,,True,26.0,0,2,0,2,0,0,0,0,1,1,2,1,0,0,0,1,0
401426190,Middle Tennessee Blue Raiders,D. Saar,4281152,,True,40.0,6,11,1,2,5,9,2,2,0,6,6,3,1,0,2,0,19
401426190,Middle Tennessee Blue Raiders,K. Malashka,4399493,,False,28.0,8,18,6,11,2,7,7,8,4,5,9,2,1,3,2,1,25
401426190,Middle Tennessee Blue Raiders,C. Blakely,4899371,,False,14.0,0,5,0,3,0,2,0,0,2,3,5,4,1,0,1,2,0
401426190,Middle Tennessee Blue Raiders,TEAM,TOTAL,TOTAL,False,,25,65,14,32,11,33,12,14,13,27,40,13,7,3,11,10,73
401424853,UCLA Bruins,I. Thomas,4281072,,True,31.0,4,9,4,7,0,2,1,2,1,4,5,3,0,0,0,1,9
401424853,UCLA Bruins,C. Osborne,4433293,,True,37.0,8,20,5,11,3,9,12,14,1,9,10,4,3,2,1,3,31
401424853,UCLA Bruins,C. Horvat,4282171,,True,11.0,1,3,1,3,0,0,1,1,0,2,2,1,0,0,2,2,3
401424853,UCLA Bruins,J. Penn,4281259,,True,34.0,6,16,5,8,1,8,4,4,0,3,3,3,2,0,1,2,17
401424853,UCLA Bruins,N. Chou,4066562,,True,21.0,0,5,0,4,0,1,0,0,0,3,3,1,4,0,0,0,0
401424853,UCLA Bruins,I. Anstey,4599500,,False,10.0,1,1,1,1,0,0,0,2,1,2,3,0,0,1,0,1,2
401424853,UCLA Bruins,Dugalic,4433411,,False,28.0,5,8,4,6,1,2,1,2,5,2,7,2,0,0,2,3,12
401424853,UCLA Bruins,D. Darius,4711802,,False,5.0,0,0,0,0,0,0,0,0,0,0,0,0,0,0,0,0,0
401424853,UCLA Bruins,C. Brown,4595911,,False,23.0,0,1,0,1,0,0,0,0,2,0,2,3,1,0,0,3,0
401424853,UCLA Bruins,TEAM,TOTAL,TOTAL,False,,25,63,20,41,5,22,19,25,10,27,37,17,10,3,6,15,74
401424853,Oregon State Beavers,J. Mitrovic,4595897,,True,29.0,8,10,8,10,0,0,0,1,0,5,5,1,0,0,1,2,16
401424853,Oregon State Beavers,T. Corosdale,4282159,,True,38.0,4,6,4,5,0,1,2,3,1,7,8,2,1,0,4,3,10
401424853,Oregon State Beavers,E. Mack,4068241,,True,35.0,4,12,2,7,2,5,3,4,0,2,2,6,1,0,1,1,13
401424853,Oregon State Beavers,T. von Oelhoffen,4713193,,True,30.0,6,12,6,10,0,2,7,7,0,1,1,3,0,0,2,2,19
401424853,Oregon State Beavers,E. Codding,4282102,,True,19.0,0,2,0,1,0,1,0,0,0,4,4,1,0,0,2,5,0
401424853,Oregon State Beavers,K. Brown,4433291,,False,22.0,1,5,1,5,0,0,0,0,1,5,6,2,0,0,2,3,2
401424853,Oregon State Beavers,A. Marotte,4691697,,False,18.0,2,7,2,7,0,0,1,1,0,2,2,2,0,1,2,2,5
401424853,Oregon State Beavers,G. Kampschroeder,4433796,,False,5.0,0,0,0,0,0,0,1,2,0,1,1,0,0,0,0,1,1
401424853,Oregon State Beavers,T. Adams,4281876,,False,4.0,0,1,0,1,0,0,0,0,0,0,0,0,0,0,0,0,0
401424853,Oregon State Beavers,TEAM,TOTAL,TOTAL,False,,25,55,23,46,2,9,14,18,5,30,35,17,2,1,14,19,66
401424851,South Dakota State Jackrabbits,T. Nelson,4595883,,True,25.0,1,7,1,4,0,3,0,0,0,1,1,3,0,1,2,0,2
401424851,South Dakota State Jackrabbits,P. Burckhard,4399649,,True,30.0,5,10,3,6,2,4,2,2,2,8,10,3,1,0,5,2,14
401424851,South Dakota State Jackrabbits,M. Selland,4282531,,True,36.0,6,11,5,6,1,5,0,0,0,7,7,6,2,1,2,0,13
401424851,South Dakota State Jackrabbits,H. Timmer,4899819,,True,30.0,7,11,4,6,3,5,0,0,3,2,5,2,0,2,1,2,17
401424851,South Dakota State Jackrabbits,T. Irwin,4282530,,True,32.0,3,7,1,2,2,5,1,2,0,2,2,4,2,1,3,1,9
401424851,South Dakota State Jackrabbits,K. Theisen,4595882,,False,10.0,3,5,3,4,0,1,2,3,0,3,3,2,0,0,1,0,8
401424851,South Dakota State Jackrabbits,L. Theuninck,4282529,,False,22.0,4,4,0,0,4,4,2,2,1,0,1,0,1,0,0,0,14
401424851,South Dakota State Jackrabbits,H. Greer,4068252,,False,15.0,0,2,0,0,0,2,1,2,1,1,2,1,0,0,1,0,1
401424851,South Dakota State Jackrabbits,TEAM,TOTAL,TOTAL,False,,29,57,17,28,12,29,8,11,9,26,35,21,6,5,15,5,78
401424851,Alabama Crimson Tide,J. Rice,4398624,,True,34.0,6,8,6,8,0,0,0,0,3,3,6,0,1,1,2,1,12
401424851,Alabama Crimson Tide,J. Mingo-Young,4595174,,True,34.0,4,11,3,8,1,3,1,2,1,3,4,1,3,0,2,3,10
401424851,Alabama Crimson Tide,B. Davis,4594178,,True,34.0,11,21,6,11,5,10,1,3,0,4,4,0,4,0,2,2,28
401424851,Alabama Crimson Tide,H. Barber,4398597,,True,36.0,1,3,0,0,1,3,0,0,0,0,0,4,1,0,1,1,3
401424851,Alabama Crimson Tide,M. Abrams,4398595,,True,38.0,6,14,5,11,1,3,1,2,0,3,3,4,3,0,3,2,14
401424851,Alabama Crimson Tide,A. Cruce,4398598,,False,11.0,1,3,0,1,1,2,0,0,0,2,2,0,0,0,1,3,3
401424851,Alabama Crimson Tide,M. Gordon,4433457,,False,2.0,0,0,0,0,0,0,0,0,0,0,0,0,0,0,0,0,0
401424851,Alabama Crimson Tide,T. Sutton,4399523,,False,11.0,1,2,0,0,1,2,0,0,0,0,0,1,0,0,0,1,3
401424851,Alabama Crimson Tide,TEAM,TOTAL,TOTAL,False,,30,62,20,39,10,23,3,7,7,20,27,10,12,1,11,13,73
401424850,Toledo Rockets,J. Cook,4900087,,True,15.0,1,3,1,3,0,0,2,2,0,3,3,0,0,0,1,2,4
401424850,Toledo Rockets,S. Mikonowicz,4705387,,True,45.0,5,11,1,4,4,7,3,5,1,12,13,3,1,0,5,2,17
401424850,Toledo Rockets,K. Goss,4705386,,True,31.0,5,6,3,4,2,2,0,0,0,2,2,0,1,0,2,1,12
401424850,Toledo Rockets,Q. Lockett,4595303,,True,39.0,4,11,4,9,0,2,2,2,1,6,7,2,1,0,7,4,10
401424850,Toledo Rockets,S. Wiard,4595301,,True,43.0,3,6,3,4,0,2,0,0,0,4,4,8,1,0,6,0,6
401424850,Toledo Rockets,H. Noveroske,4594772,,False,18.0,2,5,2,5,0,0,2,2,1,4,5,1,0,1,1,1,6
401424850,Toledo Rockets,J. Jansen,4900086,,False,22.0,4,5,3,4,1,1,3,3,2,1,3,0,2,0,0,2,12
401424850,Toledo Rockets,N. Garcia,4703763,,False,12.0,2,8,2,6,0,2,0,2,1,0,1,1,1,0,0,0,4
401424850,Toledo Rockets,TEAM,TOTAL,TOTAL,False,,26,55,19,39,7,16,12,16,7,33,40,15,7,1,23,12,71
401424850,Middle Tennessee Blue Raiders,C. Whitson,4595015,,True,42.0,6,13,2,4,4,9,2,2,2,5,7,1,1,0,2,5,18
401424850,Middle Tennessee Blue Raiders,A. Boldyreva,4899372,,True,27.0,13,20,12,19,1,1,1,2,0,3,3,0,1,3,2,1,28
401424850,Middle Tennessee Blue Raiders,J. Gregory,4899375,,True,38.0,0,4,0,3,0,1,2,2,0,0,0,0,3,0,2,1,2
401424850,Middle Tennessee Blue Raiders,Al. Whittington,4399524,,True,37.0,1,3,1,3,0,0,0,0,0,2,2,3,3,0,0,3,2
401424850,Middle Tennessee Blue Raiders,D. Saar,4281152,,True,45.0,3,11,1,6,2,5,0,2,0,7,7,6,4,0,4,2,8
401424850,Middle Tennessee Blue Raiders,J. Grannum,4704491,,False,4.0,1,1,1,1,0,0,0,0,1,0,1,0,0,0,0,1,2
401424850,Middle Tennessee Blue Raiders,K. Malashka,4399493,,False,16.0,5,11,5,11,0,0,2,3,2,4,6,0,2,1,3,4,12
401424850,Middle Tennessee Blue Raiders,C. Blakely,4899371,,False,16.0,0,2,0,2,0,0,1,2,1,2,3,1,0,0,2,0,1
401424850,Middle Tennessee Blue Raiders,TEAM,TOTAL,TOTAL,False,,29,65,22,49,7,16,8,13,7,24,31,11,14,4,15,17,73
401424791,Seton Hall Pirates,M. Bembry,4433041,,True,37.0,2,4,2,4,0,0,0,0,2,9,11,2,0,1,0,2,4
401424791,Seton Hall Pirates,S. Cooks,4281245,,True,33.0,7,16,7,13,0,3,2,2,0,5,5,4,2,1,1,0,16
401424791,Seton Hall Pirates,M. Jackson,4595161,,True,30.0,4,4,3,3,1,1,0,0,1,1,2,1,0,0,0,2,9
401424791,Seton Hall Pirates,L. Park-Lane,4433379,,True,40.0,7,18,6,16,1,2,14,14,2,2,4,5,2,0,3,3,29
401424791,Seton Hall Pirates,A. Espinoza-Hunter,4281075,,True,38.0,7,17,5,10,2,7,0,0,0,5,5,3,1,1,3,2,16
401424791,Seton Hall Pirates,A. Wright,4704306,,False,12.0,0,1,0,1,0,0,4,4,0,1,1,2,0,0,0,1,4
401424791,Seton Hall Pirates,C. Dean,4704305,,False,3.0,0,1,0,0,0,1,0,0,0,0,0,0,0,0,0,0,0
401424791,Seton Hall Pirates,K. Armstrong,4068589,,False,7.0,0,0,0,0,0,0,0,0,0,0,0,0,0,0,2,1,0
401424791,Seton Hall Pirates,TEAM,TOTAL,TOTAL,False,,27,61,23,47,4,14,20,20,8,28,36,17,5,3,9,11,78
401424791,Columbia Lions,N. Comesana,4899284,,True,19.0,0,0,0,0,0,0,1,2,3,2,5,1,2,0,1,2,1
401424791,Columbia Lions,K. Davis,4433382,,True,33.0,6,14,5,11,1,3,2,2,3,4,7,3,0,1,2,4,15
401424791,Columbia Lions,K. Henderson,4899283,,True,33.0,7,10,4,5,3,5,1,2,1,4,5,7,1,1,1,3,18
401424791,Columbia Lions,A. Hsu,4594973,,True,38.0,5,15,2,9,3,6,2,2,1,1,2,2,1,0,3,1,15
401424791,Columbia Lions,J. Patrick,4433322,,True,30.0,2,14,2,10,0,4,3,8,1,5,6,5,2,0,1,3,7
401424791,Columbia Lions,H. Pratt,4399165,,False,19.0,4,9,1,2,3,7,0,0,2,8,10,2,0,0,1,0,11
401424791,Columbia Lions,N. Stephens,4705213,,False,9.0,1,1,1,1,0,0,0,0,0,0,0,0,0,0,0,2,2
401424791,Columbia Lions,C. Rivera,4594972,,False,19.0,2,3,0,0,2,3,0,0,0,1,1,1,2,0,2,2,6
401424791,Columbia Lions,TEAM,TOTAL,TOTAL,False,,27,66,15,38,12,28,9,16,13,25,38,21,8,2,11,17,75
401424316,Vanderbilt Commodores,S. Washington,4433999,,True,24.0,5,10,5,10,0,0,2,2,1,7,8,0,0,1,0,4,12
401424316,Vanderbilt Commodores,K. Smith,4433301,,True,29.0,2,7,1,3,1,4,0,0,0,1,1,1,1,0,3,5,5
401424316,Vanderbilt Commodores,I. Moore,4433536,,True,40.0,5,12,3,7,2,5,2,3,0,0,0,1,3,0,4,3,14
401424316,Vanderbilt Commodores,B. LaChance,4433502,,True,26.0,0,2,0,2,0,0,2,2,0,4,4,0,1,0,1,2,2
401424316,Vanderbilt Commodores,J. Cambridge,4398773,,True,39.0,5,9,5,8,0,1,4,7,0,4,4,1,4,1,4,3,14
401424316,Vanderbilt Commodores,Y. Chambers,4433659,,False,19.0,0,2,0,2,0,0,3,4,1,2,3,0,0,1,1,0,3
401424316,Vanderbilt Commodores,D. Flournoy,4683036,,False,15.0,1,2,1,2,0,0,1,2,0,0,0,2,1,0,3,1,3
401424316,Vanderbilt Commodores,D. Washington,4433002,,False,8.0,0,1,0,1,0,0,0,0,0,1,1,0,0,0,0,1,0
401424316,Vanderbilt Commodores,TEAM,TOTAL,TOTAL,False,,18,45,15,35,3,10,14,20,8,20,28,5,10,3,17,19,53
401424316,Middle Tennessee Blue Raiders,C. Whitson,4595015,,True,40.0,4,13,3,5,1,8,0,0,1,0,1,1,2,0,2,3,9
401424316,Middle Tennessee Blue Raiders,A. Boldyreva,4899372,,True,13.0,2,3,2,3,0,0,0,0,2,2,4,1,0,1,2,0,4
401424316,Middle Tennessee Blue Raiders,J. Gregory,4899375,,True,33.0,3,6,1,1,2,5,0,0,1,4,5,3,1,0,2,5,8
401424316,Middle Tennessee Blue Raiders,Al. Whittington,4399524,,True,36.0,3,5,2,2,1,3,0,0,3,3,6,2,3,0,4,3,7
401424316,Middle Tennessee Blue Raiders,D. Saar,4281152,,True,38.0,3,11,0,4,3,7,4,4,0,3,3,2,3,0,3,0,13
401424316,Middle Tennessee Blue Raiders,K. Malashka,4399493,,False,27.0,3,7,3,6,0,1,6,8,1,3,4,2,0,4,3,4,12
401424316,Middle Tennessee Blue Raiders,G. Dodgen,4899374,,False,0.0,0,0,0,0,0,0,0,0,0,0,0,0,0,0,0,0,0
401424316,Middle Tennessee Blue Raiders,C. Blakely,4899371,,False,13.0,1,2,1,2,0,0,0,0,0,1,1,1,0,1,3,1,2
401424316,Middle Tennessee Blue Raiders,TEAM,TOTAL,TOTAL,False,,19,47,12,23,7,24,10,12,10,20,30,12,9,6,19,16,55
401424315,Toledo Rockets,J. Cook,4900087,,True,22.0,3,4,3,4,0,0,0,0,1,1,2,3,1,0,3,4,6
401424315,Toledo Rockets,S. Mikonowicz,4705387,,True,25.0,3,6,2,3,1,3,3,4,1,4,5,2,1,1,1,2,10
401424315,Toledo Rockets,K. Goss,4705386,,True,27.0,3,6,1,2,2,4,1,4,0,1,1,1,1,0,1,4,9
401424315,Toledo Rockets,Q. Lockett,4595303,,True,35.0,12,23,8,16,4,7,9,11,1,5,6,2,2,0,2,3,37
401424315,Toledo Rockets,S. Wiard,4595301,,True,39.0,8,9,6,6,2,3,2,2,0,7,7,6,0,0,1,1,20
401424315,Toledo Rockets,L. Lance,4399357,,False,0.0,0,0,0,0,0,0,0,0,0,0,0,0,0,0,0,0,0
401424315,Toledo Rockets,Y. Curry,4595305,,False,8.0,0,1,0,1,0,0,0,0,1,0,1,0,0,0,0,0,0
401424315,Toledo Rockets,H. Noveroske,4594772,,False,4.0,0,0,0,0,0,0,0,0,0,1,1,0,0,0,1,3,0
401424315,Toledo Rockets,J. Jansen,4900086,,False,22.0,1,1,0,0,1,1,1,2,0,3,3,3,0,0,1,2,4
401424315,Toledo Rockets,N. Garcia,4703763,,False,14.0,2,5,1,3,1,2,1,2,1,4,5,1,0,0,1,0,6
401424315,Toledo Rockets,S. Barnes,4595302,,False,4.0,0,1,0,1,0,0,0,0,0,0,0,0,0,0,0,0,0
401424315,Toledo Rockets,M. Copeland,4282150,,False,0.0,0,0,0,0,0,0,0,0,0,0,0,0,0,0,0,0,0
401424315,Toledo Rockets,TEAM,TOTAL,TOTAL,False,,32,56,21,36,11,20,17,25,5,26,31,18,5,1,11,18,92
401424315,Marquette Golden Eagles,L. Karlen,4703796,,True,25.0,7,9,6,8,1,1,1,2,5,6,11,3,2,2,2,5,16
401424315,Marquette Golden Eagles,C. Marotta,4399360,,True,36.0,11,19,11,19,0,0,6,6,2,3,5,4,0,0,2,2,28
401424315,Marquette Golden Eagles,L. Van Kleunen,4068083,,True,27.0,4,12,4,11,0,1,1,2,4,1,5,3,0,0,2,4,9
401424315,Marquette Golden Eagles,J. King,4595151,,True,30.0,4,11,4,8,0,3,1,1,0,4,4,4,1,0,1,4,9
401424315,Marquette Golden Eagles,K. McLaughlin,4281277,,True,40.0,7,19,5,11,2,8,0,0,0,3,3,8,0,0,0,2,16
401424315,Marquette Golden Eagles,J. Okosun,4703795,,False,1.0,0,1,0,1,0,0,0,0,0,0,0,0,0,0,0,0,0
401424315,Marquette Golden Eagles,R. Nkumu,4599129,,False,23.0,1,2,1,2,0,0,2,2,0,2,2,3,0,0,0,2,4
401424315,Marquette Golden Eagles,N. Lougbo,4595146,,False,2.0,0,0,0,0,0,0,0,0,0,0,0,0,0,0,1,0,0
401424315,Marquette Golden Eagles,A. Walker,4400574,,False,16.0,0,2,0,2,0,0,0,0,3,0,3,0,0,0,0,2,0
401424315,Marquette Golden Eagles,TEAM,TOTAL,TOTAL,False,,34,75,31,62,3,13,11,13,14,20,34,25,3,2,8,21,82
401424313,Houston Cougars,B. Patterson,4433360,,True,34.0,4,9,3,6,1,3,0,0,3,2,5,1,1,0,2,2,9
401424313,Houston Cougars,T. Hill,4399017,,True,16.0,2,9,2,9,0,0,0,0,2,1,3,1,0,2,1,5,4
401424313,Houston Cougars,L. Blair,4433451,,True,37.0,7,18,6,14,1,4,3,4,1,4,5,8,2,0,5,2,18
401424313,Houston Cougars,T. Young,4433298,,True,27.0,3,9,2,7,1,2,3,4,1,3,4,2,0,0,4,3,10
401424313,Houston Cougars,J. Blackshell-Fair,4281088,,True,14.0,1,2,1,2,0,0,0,0,1,3,4,0,1,0,3,2,2
401424313,Houston Cougars,K. Jones,4703658,,False,23.0,2,3,2,3,0,0,0,0,3,2,5,0,1,0,1,1,4
401424313,Houston Cougars,F. Diagne,4281281,,False,7.0,0,1,0,1,0,0,0,0,0,0,0,0,0,1,0,1,0
401424313,Houston Cougars,B. Onyeje,4399029,,False,14.0,2,4,1,1,1,3,0,0,1,3,4,0,0,0,1,4,5
401424313,Houston Cougars,E. Sidney,4398990,,False,28.0,4,7,0,1,4,6,0,0,0,1,1,2,0,0,2,3,12
401424313,Houston Cougars,TEAM,TOTAL,TOTAL,False,,25,62,17,44,8,18,6,8,13,21,34,14,5,3,19,23,64
401424313,Alabama Crimson Tide,J. Rice,4398624,,True,32.0,3,6,3,5,0,1,2,2,3,1,4,1,0,6,2,3,8
401424313,Alabama Crimson Tide,J. Mingo-Young,4595174,,True,38.0,3,7,1,4,2,3,9,12,1,5,6,4,2,0,1,3,17
401424313,Alabama Crimson Tide,B. Davis,4594178,,True,37.0,6,15,3,6,3,9,3,4,0,8,8,0,1,0,6,2,18
401424313,Alabama Crimson Tide,H. Barber,4398597,,True,38.0,2,4,1,1,1,3,3,4,0,5,5,3,2,0,0,1,8
401424313,Alabama Crimson Tide,M. Abrams,4398595,,True,40.0,5,11,3,7,2,4,6,8,0,0,0,2,6,0,3,0,18
401424313,Alabama Crimson Tide,A. Cruce,4398598,,False,9.0,2,2,1,1,1,1,2,2,0,1,1,2,0,0,0,0,7
401424313,Alabama Crimson Tide,M. Gordon,4433457,,False,2.0,0,0,0,0,0,0,0,0,0,1,1,0,0,0,2,1,0
401424313,Alabama Crimson Tide,T. Sutton,4399523,,False,4.0,1,1,0,0,1,1,0,0,0,0,0,0,0,0,0,1,3
401424313,Alabama Crimson Tide,TEAM,TOTAL,TOTAL,False,,22,46,12,24,10,22,25,32,5,24,29,12,11,6,16,11,79
401424312,South Dakota State Jackrabbits,T. Nelson,4595883,,True,31.0,5,9,4,7,1,2,5,6,2,2,4,3,1,0,2,1,16
401424312,South Dakota State Jackrabbits,P. Burckhard,4399649,,True,24.0,9,12,7,8,2,4,0,0,1,1,2,5,4,0,1,2,20
401424312,South Dakota State Jackrabbits,M. Selland,4282531,,True,32.0,7,11,6,7,1,4,6,6,1,6,7,1,5,1,2,0,21
401424312,South Dakota State Jackrabbits,H. Timmer,4899819,,True,26.0,3,7,1,4,2,3,0,2,0,2,2,0,0,0,2,2,8
401424312,South Dakota State Jackrabbits,T. Irwin,4282530,,True,31.0,3,9,2,5,1,4,2,3,0,1,1,6,5,0,2,0,9
401424312,South Dakota State Jackrabbits,M. Byom,4704383,,False,2.0,0,0,0,0,0,0,0,0,0,0,0,0,0,1,0,1,0
401424312,South Dakota State Jackrabbits,M. Vlastuin,4704382,,False,2.0,0,0,0,0,0,0,0,0,0,0,0,0,0,0,0,0,0
401424312,South Dakota State Jackrabbits,K. Theisen,4595882,,False,14.0,2,6,2,6,0,0,0,1,1,3,4,2,2,0,2,3,4
401424312,South Dakota State Jackrabbits,A. Hirschman,4399651,,False,2.0,0,0,0,0,0,0,0,0,0,0,0,1,0,0,0,0,0
401424312,South Dakota State Jackrabbits,R. Nesheim,4595886,,False,2.0,0,1,0,1,0,0,0,0,0,0,0,0,0,0,0,0,0
401424312,South Dakota State Jackrabbits,L. Rongisch,4399647,,False,2.0,1,1,0,0,1,1,0,0,0,1,1,0,0,0,0,0,3
401424312,South Dakota State Jackrabbits,L. Theuninck,4282529,,False,17.0,1,1,0,0,1,1,0,0,1,0,1,1,3,1,1,3,3
401424312,South Dakota State Jackrabbits,H. Greer,4068252,,False,15.0,0,2,0,0,0,2,0,0,0,1,1,2,0,0,0,2,0
401424312,South Dakota State Jackrabbits,TEAM,TOTAL,TOTAL,False,,31,59,22,38,9,21,13,18,9,21,30,21,20,3,14,14,84
401424312,Drake Bulldogs,M. Bair,4595576,,True,20.0,5,10,5,9,0,1,1,2,4,7,11,0,3,3,2,4,11
401424312,Drake Bulldogs,G. Berg,4398741,,True,24.0,3,7,3,6,0,1,1,2,1,5,6,5,0,0,4,2,7
401424312,Drake Bulldogs,K. Dinnebier,4900053,,True,27.0,4,6,3,3,1,3,4,7,0,1,1,5,2,1,3,1,13
401424312,Drake Bulldogs,M. Meyer,4433118,,True,28.0,5,11,1,3,4,8,0,0,0,2,2,2,2,0,3,0,14
401424312,Drake Bulldogs,M. Petersen,4282208,,True,28.0,1,5,0,0,1,5,0,0,0,0,0,2,0,0,1,0,3
401424312,Drake Bulldogs,A. Miller,4900055,,False,18.0,3,6,3,6,0,0,1,2,3,1,4,2,0,1,4,3,7
401424312,Drake Bulldogs,A. Iiams,4900054,,False,2.0,1,2,0,1,1,1,0,0,0,0,0,0,0,0,0,0,3
401424312,Drake Bulldogs,C. Becker,4704842,,False,6.0,0,1,0,0,0,1,0,0,0,0,0,0,0,0,2,3,0
401424312,Drake Bulldogs,A. Wooldridge,4399376,,False,13.0,0,1,0,1,0,0,0,0,1,1,2,1,0,0,4,1,0
401424312,Drake Bulldogs,M. Phipps,4900056,,False,2.0,0,0,0,0,0,0,0,0,0,0,0,0,0,0,0,0,0
401424312,Drake Bulldogs,H. Nilges,4900052,,False,2.0,0,0,0,0,0,0,0,0,0,0,0,1,0,0,0,0,0
401424312,Drake Bulldogs,S. Gueldner,4433721,,False,18.0,2,7,0,1,2,6,0,0,1,2,3,2,0,0,2,2,6
401424312,Drake Bulldogs,H. Fuller,4282209,,False,12.0,1,1,1,1,0,0,0,0,0,1,1,0,2,0,0,1,2
401424312,Drake Bulldogs,TEAM,TOTAL,TOTAL,False,,25,57,16,31,9,26,7,13,13,22,35,20,9,5,25,17,66
401424311,Columbia Lions,N. Comesana,4899284,,True,18.0,1,3,1,3,0,0,0,0,0,4,4,0,1,0,0,4,2
401424311,Columbia Lions,K. Davis,4433382,,True,37.0,8,13,8,11,0,2,5,6,2,4,6,2,3,3,0,0,21
401424311,Columbia Lions,K. Henderson,4899283,,True,36.0,1,4,1,3,0,1,5,8,1,2,3,4,1,0,3,3,7
401424311,Columbia Lions,A. Hsu,4594973,,True,39.0,3,15,3,7,0,8,3,4,0,9,9,2,1,2,3,1,9
401424311,Columbia Lions,J. Patrick,4433322,,True,36.0,7,16,7,13,0,3,1,2,5,8,13,2,1,2,3,2,15
401424311,Columbia Lions,H. Pratt,4399165,,False,14.0,0,4,0,1,0,3,0,0,0,1,1,1,0,1,1,1,0
401424311,Columbia Lions,S. Durr,4399167,,False,3.0,0,1,0,0,0,1,0,0,1,0,1,0,1,0,0,1,0
401424311,Columbia Lions,N. Stephens,4705213,,False,14.0,0,3,0,1,0,2,0,0,2,2,4,0,0,0,2,2,0
401424311,Columbia Lions,C. Rivera,4594972,,False,3.0,0,0,0,0,0,0,0,0,0,1,1,0,0,0,2,1,0
401424311,Columbia Lions,TEAM,TOTAL,TOTAL,False,,20,59,20,39,0,20,14,20,13,32,45,11,8,8,14,15,54
401424311,Boston College Eagles,M. Gakdeng,4898548,,True,28.0,1,3,1,3,0,0,0,0,2,3,5,0,1,4,5,2,2
401424311,Boston College Eagles,A. VanTimmeren,4711798,,True,9.0,0,2,0,1,0,1,0,0,0,0,0,0,0,0,0,1,0
401424311,Boston College Eagles,T. Soule,4398567,,True,36.0,5,18,5,18,0,0,4,4,5,2,7,1,3,0,2,3,14
401424311,Boston College Eagles,C. Swartz,4398758,,True,38.0,7,20,5,12,2,8,8,9,0,7,7,1,0,1,2,2,24
401424311,Boston College Eagles,M. Garraud,4398568,,True,29.0,1,6,1,2,0,4,0,0,0,2,2,2,0,0,2,4,2
401424311,Boston College Eagles,J. Lacey,4702861,,False,1.0,0,0,0,0,0,0,0,0,0,0,0,0,0,0,1,0,0
401424311,Boston College Eagles,C. Ford,4398571,,False,6.0,0,0,0,0,0,0,0,0,0,1,1,0,0,0,0,0,0
401424311,Boston College Eagles,A. Daley,4898550,,False,0.0,0,0,0,0,0,0,0,0,0,0,0,0,0,0,0,0,0
401424311,Boston College Eagles,D. Waggoner,4433482,,False,26.0,4,9,4,9,0,0,1,2,2,9,11,1,3,0,1,2,9
401424311,Boston College Eagles,K. Ivey,4433464,,False,27.0,0,8,0,4,0,4,0,0,0,2,2,0,0,0,1,1,0
401424311,Boston College Eagles,TEAM,TOTAL,TOTAL,False,,18,66,16,49,2,17,13,15,14,28,42,5,7,5,17,15,51
401424310,Seton Hall Pirates,M. Bembry,4433041,,True,24.0,1,3,1,3,0,0,0,0,1,3,4,2,0,0,1,0,2
401424310,Seton Hall Pirates,S. Cooks,4281245,,True,37.0,9,16,9,15,0,1,1,1,1,9,10,1,0,0,5,1,19
401424310,Seton Hall Pirates,M. Jackson,4595161,,True,33.0,4,8,2,3,2,5,2,2,0,2,2,2,2,0,1,1,12
401424310,Seton Hall Pirates,L. Park-Lane,4433379,,True,39.0,9,14,4,6,5,8,6,6,0,1,1,11,3,0,3,3,29
401424310,Seton Hall Pirates,A. Espinoza-Hunter,4281075,,True,39.0,4,10,0,3,4,7,0,0,0,8,8,0,3,1,2,1,12
401424310,Seton Hall Pirates,A. Wright,4704306,,False,8.0,0,0,0,0,0,0,0,0,0,2,2,1,0,0,1,2,0
401424310,Seton Hall Pirates,K. Armstrong,4068589,,False,19.0,1,1,1,1,0,0,2,2,1,1,2,3,1,2,1,1,4
401424310,Seton Hall Pirates,TEAM,TOTAL,TOTAL,False,,28,52,17,31,11,21,11,11,3,26,29,20,9,3,14,9,78
401424310,Drexel Dragons,T. Brugler,4280995,,True,39.0,7,11,7,10,0,1,1,2,4,8,12,1,0,0,2,1,15
401424310,Drexel Dragons,M. Leonard,4068316,,True,28.0,8,12,8,12,0,0,0,0,0,6,6,0,2,0,0,3,16
401424310,Drexel Dragons,M. Hendrixson,4399845,,True,25.0,0,2,0,0,0,2,0,0,0,1,1,3,1,0,1,3,0
401424310,Drexel Dragons,K. Washington,4399843,,True,35.0,4,15,3,8,1,7,2,2,0,3,3,3,0,1,2,4,11
401424310,Drexel Dragons,H. Nihill,4281431,,True,40.0,8,19,4,9,4,10,0,0,1,0,1,4,2,0,4,0,20
401424310,Drexel Dragons,J. Valentine,4704570,,False,25.0,0,1,0,1,0,0,4,4,2,1,3,0,1,0,1,2,4
401424310,Drexel Dragons,H. Saatman,4594714,,False,1.0,0,0,0,0,0,0,0,0,0,0,0,0,0,0,0,0,0
401424310,Drexel Dragons,T. Hyduke,4399080,,False,6.0,1,2,0,1,1,1,2,2,0,0,0,0,0,0,0,0,5
401424310,Drexel Dragons,TEAM,TOTAL,TOTAL,False,,28,62,22,41,6,21,9,10,8,20,28,11,6,1,10,13,71
401424117,Oregon State Beavers,J. Mitrovic,4595897,,True,17.0,6,9,6,9,0,0,1,2,3,8,11,0,0,0,0,2,13
401424117,Oregon State Beavers,T. Corosdale,4282159,,True,30.0,2,8,2,6,0,2,0,0,3,6,9,6,0,1,3,2,4
401424117,Oregon State Beavers,E. Mack,4068241,,True,35.0,9,15,7,9,2,6,2,2,0,5,5,2,0,0,1,2,22
401424117,Oregon State Beavers,T. von Oelhoffen,4713193,,True,34.0,8,17,3,6,5,11,4,4,0,5,5,0,1,0,0,1,25
401424117,Oregon State Beavers,E. Codding,4282102,,True,28.0,3,10,2,7,1,3,0,0,0,7,7,4,0,0,0,1,7
401424117,Oregon State Beavers,K. Brown,4433291,,False,23.0,3,7,3,7,0,0,1,2,3,4,7,3,0,0,1,0,7
401424117,Oregon State Beavers,A. Marotte,4691697,,False,9.0,0,2,0,2,0,0,0,0,0,2,2,0,0,0,2,0,0
401424117,Oregon State Beavers,N. Mannen,4595896,,False,4.0,0,1,0,0,0,1,0,0,0,0,0,1,0,0,0,0,0
401424117,Oregon State Beavers,G. Kampschroeder,4433796,,False,8.0,0,4,0,1,0,3,0,0,0,0,0,0,0,0,0,0,0
401424117,Oregon State Beavers,T. Adams,4281876,,False,12.0,0,1,0,0,0,1,0,0,0,1,1,4,0,0,0,0,0
401424117,Oregon State Beavers,TEAM,TOTAL,TOTAL,False,,31,74,23,47,8,27,8,10,12,38,50,20,1,1,7,8,78
401424117,New Mexico Lobos,S. McGruder,4400149,,True,29.0,7,15,5,9,2,6,0,0,2,1,3,4,1,0,1,3,16
401424117,New Mexico Lobos,A. Anderson,4281834,,True,38.0,4,12,3,6,1,6,0,0,3,4,7,2,1,3,0,3,9
401424117,New Mexico Lobos,Lato. Duff,4704520,,True,37.0,2,7,0,0,2,7,2,2,0,6,6,4,1,1,1,0,8
401424117,New Mexico Lobos,Lata. Duff,4704519,,True,38.0,6,13,1,4,5,9,3,3,0,4,4,2,0,0,1,2,20
401424117,New Mexico Lobos,J. De La Cerda,4281833,,True,36.0,6,15,5,10,1,5,4,4,0,7,7,3,3,1,0,3,17
401424117,New Mexico Lobos,P. Reus,4900583,,False,13.0,1,7,0,3,1,4,0,0,0,4,4,1,0,1,0,0,3
401424117,New Mexico Lobos,A. Augmon,4900581,,False,9.0,0,0,0,0,0,0,0,0,0,0,0,0,0,0,0,2,0
401424117,New Mexico Lobos,TEAM,TOTAL,TOTAL,False,,26,69,14,32,12,37,9,9,5,29,34,16,6,6,4,13,73
401424116,Wyoming Cowgirls,A. Fertig,4900606,,True,42.0,4,10,4,9,0,1,8,15,3,8,11,1,1,1,3,2,16
401424116,Wyoming Cowgirls,M. Bradshaw,4595681,,True,48.0,5,16,3,13,2,3,2,2,2,10,12,3,0,0,2,0,14
401424116,Wyoming Cowgirls,Q. Weidemann,4400207,,True,50.0,9,13,6,8,3,5,0,0,0,6,6,3,1,0,4,3,21
401424116,Wyoming Cowgirls,A. Sanchez Ramos,4400204,,True,48.0,8,13,6,10,2,3,3,4,0,8,8,2,1,1,4,5,21
401424116,Wyoming Cowgirls,T. Olson,4400203,,True,50.0,1,6,0,5,1,1,0,0,0,2,2,2,1,0,5,4,3
401424116,Wyoming Cowgirls,M. Savic,4704660,,False,9.0,1,2,1,2,0,0,0,0,0,1,1,0,0,0,0,1,2
401424116,Wyoming Cowgirls,P. Salazar,4704659,,False,3.0,0,0,0,0,0,0,0,0,0,0,0,0,0,0,0,0,0
401424116,Wyoming Cowgirls,G. Ellis,4704657,,False,8.0,0,1,0,1,0,0,4,4,0,4,4,0,0,0,3,0,4
401424116,Wyoming Cowgirls,E. Mellema,4900607,,False,17.0,0,1,0,1,0,0,0,0,0,2,2,3,0,0,1,0,0
401424116,Wyoming Cowgirls,TEAM,TOTAL,TOTAL,False,,28,62,20,49,8,13,17,25,10,44,54,14,4,2,25,15,81
401424116,UCLA Bruins,I. Thomas,4281072,,True,42.0,8,16,6,11,2,5,0,0,5,5,10,2,1,1,1,5,18
401424116,UCLA Bruins,C. Brown,4595911,,True,28.0,1,3,1,3,0,0,0,0,2,1,3,1,1,0,0,2,2
401424116,UCLA Bruins,C. Osborne,4433293,,True,50.0,7,24,6,19,1,5,5,5,1,8,9,5,1,1,2,0,20
401424116,UCLA Bruins,J. Penn,4281259,,True,48.0,6,18,4,10,2,8,0,0,0,3,3,3,1,0,2,3,14
401424116,UCLA Bruins,N. Chou,4066562,,True,44.0,5,9,3,5,2,4,1,1,0,1,1,1,5,1,0,0,13
401424116,UCLA Bruins,I. Anstey,4599500,,False,10.0,2,6,2,6,0,0,0,0,2,1,3,0,1,0,1,3,4
401424116,UCLA Bruins,Dugalic,4433411,,False,10.0,0,5,0,3,0,2,1,2,0,1,1,1,1,0,1,5,1
401424116,UCLA Bruins,D. Darius,4711802,,False,14.0,1,2,1,2,0,0,0,2,2,5,7,0,0,0,0,1,2
401424116,UCLA Bruins,K. Owens,4282172,,False,3.0,0,0,0,0,0,0,0,0,0,0,0,0,0,0,0,2,0
401424116,UCLA Bruins,C. Horvat,4282171,,False,26.0,3,10,3,9,0,1,2,3,3,2,5,1,1,1,2,3,8
401424116,UCLA Bruins,TEAM,TOTAL,TOTAL,False,,33,93,26,68,7,25,9,13,19,27,46,14,12,4,10,24,82
401423737,UCLA Bruins,I. Thomas,4281072,,True,32.0,8,12,7,11,1,1,0,0,2,4,6,1,0,1,0,0,17
401423737,UCLA Bruins,C. Brown,4595911,,True,21.0,0,0,0,0,0,0,0,0,0,1,1,1,0,2,0,1,0
401423737,UCLA Bruins,C. Osborne,4433293,,True,30.0,5,10,4,7,1,3,2,2,0,6,6,3,2,1,3,1,13
401423737,UCLA Bruins,J. Penn,4281259,,True,21.0,2,6,1,3,1,3,2,2,1,3,4,0,1,0,0,0,7
401423737,UCLA Bruins,N. Chou,4066562,,True,29.0,1,6,1,3,0,3,2,2,1,2,3,4,1,2,1,2,4
401423737,UCLA Bruins,I. Anstey,4599500,,False,14.0,0,2,0,2,0,0,1,2,0,1,1,1,0,0,3,4,1
401423737,UCLA Bruins,Dugalic,4433411,,False,21.0,5,9,4,8,1,1,0,1,0,7,7,1,2,3,3,2,11
401423737,UCLA Bruins,D. Darius,4711802,,False,13.0,0,1,0,1,0,0,0,0,0,3,3,0,1,0,3,4,0
401423737,UCLA Bruins,C. Horvat,4282171,,False,19.0,3,5,3,5,0,0,2,3,4,3,7,0,0,1,1,1,8
401423737,UCLA Bruins,TEAM,TOTAL,TOTAL,False,,24,51,20,40,4,11,9,12,9,30,39,11,7,10,16,15,61
401423737,Air Force Falcons,R. Snyder,4399409,,True,30.0,4,11,3,6,1,5,0,0,1,2,3,1,1,0,2,1,9
401423737,Air Force Falcons,H. Jones,4399403,,True,31.0,5,12,5,12,0,0,0,0,7,5,12,1,2,0,1,3,10
401423737,Air Force Falcons,J. Huntimer,4899763,,True,31.0,3,3,1,1,2,2,0,0,0,2,2,3,0,0,1,3,8
401423737,Air Force Falcons,K. Heath,4595614,,True,26.0,2,7,2,6,0,1,1,2,1,0,1,1,0,0,2,1,5
401423737,Air Force Falcons,C. Winters,4399406,,True,30.0,4,13,4,11,0,2,0,0,0,3,3,2,2,1,2,4,8
401423737,Air Force Falcons,D. MacMillan,4704414,,False,8.0,0,2,0,1,0,1,0,2,0,1,1,0,0,0,0,0,0
401423737,Air Force Falcons,N. McDonald,4595618,,False,12.0,0,5,0,4,0,1,0,0,2,2,4,0,0,0,0,0,0
401423737,Air Force Falcons,L. McDonald,4899761,,False,19.0,1,6,0,0,1,6,2,4,0,0,0,1,0,0,2,0,5
401423737,Air Force Falcons,T. Britt,4704412,,False,9.0,0,4,0,1,0,3,0,0,0,1,1,1,0,0,0,3,0
401423737,Air Force Falcons,K. Pilson,4704411,,False,4.0,0,1,0,1,0,0,0,2,1,0,1,0,0,0,1,2,0
401423737,Air Force Falcons,TEAM,TOTAL,TOTAL,False,,19,64,15,43,4,21,3,10,16,20,36,10,5,1,12,17,45
401423736,Portland Pilots,L. Cochrane,4595872,,True,29.0,3,8,3,8,0,0,0,0,1,4,5,2,0,3,0,2,6
401423736,Portland Pilots,A. Fowler,4595823,,True,23.0,3,10,2,7,1,3,3,3,3,4,7,2,0,1,2,3,10
401423736,Portland Pilots,E. Shearer,4703855,,True,17.0,2,5,2,3,0,2,1,1,2,0,2,3,2,0,0,3,5
401423736,Portland Pilots,M. Muhlheim,4282078,,True,29.0,5,12,1,2,4,10,0,0,1,0,1,2,1,0,0,3,14
401423736,Portland Pilots,R. Pflug,4282065,,True,24.0,4,10,3,7,1,3,0,0,0,0,0,1,3,0,0,0,9
401423736,Portland Pilots,E. Sewell,4899388,,False,3.0,0,0,0,0,0,0,0,0,0,0,0,0,0,0,0,0,0
401423736,Portland Pilots,K. Frawley,4595822,,False,22.0,1,2,0,0,1,2,0,0,0,1,1,1,0,0,1,1,3
401423736,Portland Pilots,L. Kaitu'u,4400493,,False,17.0,1,6,1,5,0,1,0,2,2,1,3,1,0,0,4,1,2
401423736,Portland Pilots,M. Burnham,4704748,,False,18.0,2,7,2,5,0,2,0,0,0,1,1,1,0,0,1,1,4
401423736,Portland Pilots,M. Meek,4703854,,False,18.0,1,3,0,0,1,3,0,0,1,1,2,3,0,0,1,1,3
401423736,Portland Pilots,TEAM,TOTAL,TOTAL,False,,22,63,14,37,8,26,4,6,10,14,24,16,6,4,10,15,56
401423736,Oregon State Beavers,J. Mitrovic,4595897,,True,15.0,4,9,4,9,0,0,3,3,4,9,13,1,1,0,2,2,11
401423736,Oregon State Beavers,T. Corosdale,4282159,,True,34.0,6,8,6,7,0,1,0,0,1,5,6,2,0,1,2,2,12
401423736,Oregon State Beavers,E. Mack,4068241,,True,32.0,4,6,2,3,2,3,1,2,1,4,5,4,1,1,2,1,11
401423736,Oregon State Beavers,T. von Oelhoffen,4713193,,True,21.0,3,6,2,4,1,2,0,0,0,4,4,4,0,0,2,0,7
401423736,Oregon State Beavers,E. Codding,4282102,,True,24.0,1,3,0,1,1,2,0,0,1,3,4,4,1,0,1,2,3
401423736,Oregon State Beavers,K. Brown,4433291,,False,25.0,8,12,8,12,0,0,0,0,1,3,4,4,4,2,0,1,16
401423736,Oregon State Beavers,A. Marotte,4691697,,False,23.0,3,5,2,4,1,1,2,2,0,0,0,1,1,0,1,2,9
401423736,Oregon State Beavers,N. Mannen,4595896,,False,9.0,0,1,0,0,0,1,0,0,0,0,0,1,1,0,0,0,0
401423736,Oregon State Beavers,G. Kampschroeder,4433796,,False,9.0,1,4,0,1,1,3,0,0,0,0,0,2,0,0,0,1,3
401423736,Oregon State Beavers,T. Adams,4281876,,False,8.0,1,1,1,1,0,0,0,0,0,0,0,0,0,0,3,1,2
401423736,Oregon State Beavers,TEAM,TOTAL,TOTAL,False,,31,55,25,42,6,13,6,7,9,30,39,23,9,4,14,12,74
401423735,Quinnipiac Bobcats,A. Free,4399092,,True,16.0,3,4,1,2,2,2,1,2,2,0,2,1,0,0,0,1,9
401423735,Quinnipiac Bobcats,M. Morris,4433677,,True,26.0,3,10,3,10,0,0,0,0,0,3,3,0,1,0,2,2,6
401423735,Quinnipiac Bobcats,S. Bonner,4595390,,True,27.0,1,5,0,0,1,5,0,0,0,2,2,0,1,0,3,2,3
401423735,Quinnipiac Bobcats,R. Caverly,4399294,,True,34.0,8,13,2,5,6,8,4,4,0,2,2,3,0,0,3,3,26
401423735,Quinnipiac Bobcats,M. DeWees,4399091,,True,29.0,5,7,4,6,1,1,4,6,2,2,4,3,1,0,2,0,15
401423735,Quinnipiac Bobcats,G. LaBarge,4899864,,False,14.0,0,2,0,1,0,1,0,0,0,4,4,0,0,0,2,1,0
401423735,Quinnipiac Bobcats,T. White,4704552,,False,3.0,0,2,0,2,0,0,0,0,2,0,2,0,1,1,1,0,0
401423735,Quinnipiac Bobcats,C. Almeida,4595388,,False,2.0,0,0,0,0,0,0,0,0,0,0,0,0,0,0,0,0,0
401423735,Quinnipiac Bobcats,C. Haywood,4595389,,False,19.0,1,2,1,1,0,1,2,2,0,3,3,1,0,3,1,2,4
401423735,Quinnipiac Bobcats,R. Douglas,4899866,,False,6.0,0,1,0,1,0,0,0,0,0,0,0,0,0,0,0,0,0
401423735,Quinnipiac Bobcats,J. Grisdale,4899865,,False,11.0,0,4,0,3,0,1,0,0,1,1,2,2,0,0,0,2,0
401423735,Quinnipiac Bobcats,J. Casey,4704555,,False,2.0,0,0,0,0,0,0,0,0,0,0,0,0,0,0,0,0,0
401423735,Quinnipiac Bobcats,M. Helms,4433084,,False,11.0,1,2,1,2,0,0,3,4,0,1,1,2,0,0,3,3,5
401423735,Quinnipiac Bobcats,TEAM,TOTAL,TOTAL,False,,22,52,12,33,10,19,14,18,8,19,27,12,4,4,17,16,68
401423735,Boston College Eagles,M. Gakdeng,4898548,,True,28.0,3,10,3,10,0,0,0,0,3,2,5,1,1,2,3,2,6
401423735,Boston College Eagles,A. VanTimmeren,4711798,,True,15.0,0,3,0,1,0,2,0,0,0,0,0,0,0,1,1,1,0
401423735,Boston College Eagles,T. Soule,4398567,,True,31.0,14,18,14,18,0,0,5,6,7,9,16,3,3,0,1,1,33
401423735,Boston College Eagles,C. Swartz,4398758,,True,36.0,7,12,4,8,3,4,3,3,3,5,8,2,1,0,0,2,20
401423735,Boston College Eagles,M. Garraud,4398568,,True,28.0,5,9,2,2,3,7,0,0,0,0,0,3,2,0,1,3,13
401423735,Boston College Eagles,J. Lacey,4702861,,False,5.0,0,1,0,1,0,0,3,4,1,0,1,0,0,0,0,0,3
401423735,Boston College Eagles,C. Ford,4398571,,False,7.0,2,3,2,3,0,0,1,2,1,1,2,0,0,1,1,0,5
401423735,Boston College Eagles,A. Daley,4898550,,False,3.0,1,1,1,1,0,0,0,2,0,2,2,0,0,0,0,0,2
401423735,Boston College Eagles,D. Waggoner,4433482,,False,15.0,2,4,2,4,0,0,1,2,0,2,2,1,2,0,0,4,5
401423735,Boston College Eagles,K. Ivey,4433464,,False,24.0,1,5,0,1,1,4,1,2,0,0,0,5,1,0,1,1,4
401423735,Boston College Eagles,M. Dickens,4398566,,False,8.0,1,2,0,0,1,2,0,0,0,1,1,1,0,0,2,0,3
401423735,Boston College Eagles,TEAM,TOTAL,TOTAL,False,,36,68,28,49,8,19,14,21,17,23,40,16,10,4,11,14,94
401423734,VCU Rams,K. Walters,4399303,,True,15.0,1,4,1,4,0,0,0,0,2,0,2,2,1,0,2,3,2
401423734,VCU Rams,S. Te-Biasu,4704160,,True,34.0,3,11,1,5,2,6,4,4,0,2,2,1,3,0,0,2,12
401423734,VCU Rams,J. Griffith-Wallace,4282453,,True,33.0,3,11,1,3,2,8,0,0,1,2,3,3,2,0,0,3,8
401423734,VCU Rams,M. Hattix-Covington,4281906,,True,31.0,6,13,5,8,1,5,1,2,1,6,7,0,1,0,2,3,14
401423734,VCU Rams,T. Robinson,4281905,,True,39.0,11,23,8,12,3,11,2,4,6,8,14,5,2,0,2,1,27
401423734,VCU Rams,C. Bloom,4433657,,False,20.0,1,4,1,4,0,0,2,4,2,0,2,1,0,0,1,1,4
401423734,VCU Rams,Sa. Robinson,4399312,,False,14.0,0,0,0,0,0,0,0,0,0,3,3,0,0,1,1,0,0
401423734,VCU Rams,G. Hutson,4613247,,False,14.0,0,2,0,0,0,2,0,0,0,1,1,1,1,0,1,2,0
401423734,VCU Rams,TEAM,TOTAL,TOTAL,False,,25,68,17,36,8,32,9,14,15,25,40,13,10,1,10,15,67
401423734,Seton Hall Pirates,M. Bembry,4433041,,True,30.0,0,0,0,0,0,0,0,2,2,9,11,1,1,0,2,2,0
401423734,Seton Hall Pirates,S. Cooks,4281245,,True,30.0,9,20,8,16,1,4,0,0,0,7,7,0,2,2,2,3,19
401423734,Seton Hall Pirates,M. Jackson,4595161,,True,28.0,3,6,0,2,3,4,0,0,1,3,4,1,0,0,0,0,9
401423734,Seton Hall Pirates,L. Park-Lane,4433379,,True,40.0,6,14,1,5,5,9,5,7,0,2,2,6,2,0,1,2,22
401423734,Seton Hall Pirates,A. Espinoza-Hunter,4281075,,True,40.0,4,11,4,6,0,5,5,6,3,5,8,3,2,0,4,1,13
401423734,Seton Hall Pirates,A. Wright,4704306,,False,13.0,1,1,1,1,0,0,0,0,0,1,1,3,0,0,1,4,2
401423734,Seton Hall Pirates,C. Dean,4704305,,False,10.0,1,4,0,2,1,2,2,2,1,0,1,0,0,1,2,1,5
401423734,Seton Hall Pirates,K. Armstrong,4068589,,False,9.0,0,1,0,1,0,0,0,0,0,2,2,0,0,0,0,0,0
401423734,Seton Hall Pirates,TEAM,TOTAL,TOTAL,False,,24,57,14,33,10,24,12,17,8,31,39,14,7,3,13,13,70
401423733,Drexel Dragons,T. Brugler,4280995,,True,35.0,2,9,1,7,1,2,0,0,0,7,7,0,0,2,2,4,5
401423733,Drexel Dragons,M. Leonard,4068316,,True,28.0,5,7,5,7,0,0,1,2,2,5,7,1,1,0,0,1,11
401423733,Drexel Dragons,M. Hendrixson,4399845,,True,36.0,1,3,0,2,1,1,0,0,0,4,4,5,1,0,1,3,3
401423733,Drexel Dragons,K. Washington,4399843,,True,34.0,5,17,5,12,0,5,7,7,1,2,3,2,3,0,2,3,17
401423733,Drexel Dragons,H. Nihill,4281431,,True,37.0,6,19,3,13,3,6,3,3,0,2,2,2,4,0,0,2,18
401423733,Drexel Dragons,J. Valentine,4704570,,False,17.0,3,5,3,5,0,0,1,1,2,3,5,0,0,1,0,3,7
401423733,Drexel Dragons,T. Hyduke,4399080,,False,13.0,0,1,0,0,0,1,0,0,1,0,1,0,0,0,1,0,0
401423733,Drexel Dragons,TEAM,TOTAL,TOTAL,False,,22,61,17,46,5,15,12,13,7,23,30,10,9,3,7,16,61
401423733,Bucknell Bison,I. King,4900533,,True,32.0,2,4,0,0,2,4,0,0,0,4,4,1,0,0,1,0,6
401423733,Bucknell Bison,E. Shaffer,4595535,,True,30.0,6,12,6,11,0,1,2,4,3,8,11,3,2,1,0,2,14
401423733,Bucknell Bison,C. Collins,4900532,,True,40.0,10,14,9,11,1,3,2,4,0,4,4,2,0,0,2,1,23
401423733,Bucknell Bison,M. Walls,4400177,,True,40.0,2,8,2,5,0,3,0,0,1,6,7,6,0,0,4,4,4
401423733,Bucknell Bison,T. O'Brien,4400176,,True,25.0,4,7,4,6,0,1,3,4,0,5,5,1,0,0,1,5,11
401423733,Bucknell Bison,K. Reinbeau,4704700,,False,10.0,0,0,0,0,0,0,0,0,1,2,3,0,0,0,4,1,0
401423733,Bucknell Bison,J. Kulesza,4704702,,False,8.0,0,2,0,0,0,2,0,0,0,0,0,0,0,0,0,0,0
401423733,Bucknell Bison,T. Johnson,4595533,,False,15.0,0,3,0,1,0,2,0,0,0,0,0,1,0,0,1,1,0
401423733,Bucknell Bison,C. Dingler,4577540,,False,0.0,0,0,0,0,0,0,0,0,0,0,0,0,0,0,0,1,0
401423733,Bucknell Bison,TEAM,TOTAL,TOTAL,False,,24,50,21,34,3,16,7,12,6,30,36,14,2,1,14,15,58
401423732,Toledo Rockets,J. Cook,4900087,,True,11.0,1,3,1,3,0,0,0,0,1,1,2,0,0,0,1,2,2
401423732,Toledo Rockets,S. Mikonowicz,4705387,,True,37.0,2,6,2,4,0,2,0,0,2,6,8,4,1,0,0,2,4
401423732,Toledo Rockets,K. Goss,4705386,,True,32.0,3,3,2,2,1,1,0,0,2,1,3,3,0,0,2,2,7
401423732,Toledo Rockets,Q. Lockett,4595303,,True,27.0,8,13,6,10,2,3,7,9,2,3,5,3,1,0,5,3,25
401423732,Toledo Rockets,S. Wiard,4595301,,True,38.0,4,9,3,7,1,2,3,3,0,6,6,7,1,2,2,0,12
401423732,Toledo Rockets,L. Lance,4399357,,False,1.0,0,1,0,1,0,0,0,0,0,0,0,0,0,0,0,0,0
401423732,Toledo Rockets,H. Noveroske,4594772,,False,13.0,6,9,6,9,0,0,1,2,3,2,5,0,0,4,2,0,13
401423732,Toledo Rockets,J. Jansen,4900086,,False,22.0,3,5,1,1,2,4,3,4,0,0,0,3,0,0,0,1,11
401423732,Toledo Rockets,E. Doherty,4900085,,False,1.0,0,0,0,0,0,0,0,0,0,0,0,0,0,0,0,0,0
401423732,Toledo Rockets,H. Idowu,4705388,,False,1.0,0,0,0,0,0,0,0,0,0,0,0,0,0,0,0,0,0
401423732,Toledo Rockets,N. Garcia,4703763,,False,13.0,2,3,1,2,1,1,0,0,0,2,2,0,0,0,0,1,5
401423732,Toledo Rockets,S. Barnes,4595302,,False,2.0,0,0,0,0,0,0,0,0,0,1,1,0,2,0,0,0,0
401423732,Toledo Rockets,M. Copeland,4282150,,False,2.0,0,0,0,0,0,0,0,0,0,0,0,0,0,0,0,0,0
401423732,Toledo Rockets,TEAM,TOTAL,TOTAL,False,,29,52,22,39,7,13,14,18,11,28,39,20,5,6,13,11,79
401423732,Kent State Golden Flashes,N. Blackford,4595260,,True,17.0,5,7,5,7,0,0,0,0,3,0,3,0,1,0,1,1,10
401423732,Kent State Golden Flashes,L. Thall,4399327,,True,28.0,4,11,2,5,2,6,1,1,2,1,3,1,1,1,2,2,11
401423732,Kent State Golden Flashes,K. Shumate,4433684,,True,35.0,4,9,3,8,1,1,1,4,1,2,3,2,0,0,1,3,10
401423732,Kent State Golden Flashes,H. Young,4399326,,True,13.0,1,3,0,2,1,1,0,0,1,3,4,0,0,0,0,1,3
401423732,Kent State Golden Flashes,M. Modkins,4399323,,True,23.0,1,9,1,3,0,6,2,2,0,0,0,2,0,0,2,3,4
401423732,Kent State Golden Flashes,B. Dunn,4900064,,False,18.0,1,2,0,0,1,2,0,0,0,4,4,0,2,1,0,1,3
401423732,Kent State Golden Flashes,B. Wallace,4398944,,False,1.0,0,0,0,0,0,0,0,0,0,0,0,0,0,0,1,0,0
401423732,Kent State Golden Flashes,J. Batsch,4900063,,False,13.0,3,5,2,4,1,1,0,0,0,1,1,0,1,0,0,0,7
401423732,Kent State Golden Flashes,C. Santoro,4704895,,False,21.0,2,8,1,6,1,2,2,2,1,1,2,2,0,0,1,1,7
401423732,Kent State Golden Flashes,C. Kelly,4595261,,False,29.0,1,8,1,3,0,5,2,2,2,1,3,1,1,0,1,3,4
401423732,Kent State Golden Flashes,A. Pavlansky,4399321,,False,2.0,0,0,0,0,0,0,0,0,0,0,0,0,0,0,0,0,0
401423732,Kent State Golden Flashes,TEAM,TOTAL,TOTAL,False,,22,62,15,38,7,24,8,11,14,13,27,8,6,2,9,15,59
401423731,Old Dominion Monarchs,B. Jackson,4594387,,True,23.0,5,10,4,9,1,1,0,0,4,6,10,0,0,2,4,3,11
401423731,Old Dominion Monarchs,A. Young,4399540,,True,31.0,6,11,6,11,0,0,0,2,1,5,6,2,3,1,3,2,12
401423731,Old Dominion Monarchs,I. Allen,4704183,,True,38.0,6,15,4,8,2,7,7,8,3,5,8,0,3,0,6,4,21
401423731,Old Dominion Monarchs,A. Hudson,4399534,,True,24.0,1,3,0,1,1,2,3,3,0,2,2,1,0,0,0,0,6
401423731,Old Dominion Monarchs,M. Adams,4399533,,True,31.0,1,4,1,4,0,0,0,3,0,4,4,1,0,0,7,2,2
401423731,Old Dominion Monarchs,A. Moreland,4899400,,False,13.0,0,1,0,1,0,0,0,0,0,1,1,0,0,0,0,1,0
401423731,Old Dominion Monarchs,A. Barnes-Williams,4899395,,False,9.0,0,2,0,2,0,0,0,0,0,2,2,0,0,1,1,2,0
401423731,Old Dominion Monarchs,K. Nelson,4899398,,False,4.0,0,2,0,0,0,2,0,0,0,0,0,0,0,0,0,0,0
401423731,Old Dominion Monarchs,K. Clark,4899396,,False,17.0,3,6,2,3,1,3,0,0,1,3,4,2,4,1,0,1,7
401423731,Old Dominion Monarchs,J. Campbell,4704352,,False,10.0,0,0,0,0,0,0,0,2,0,0,0,1,1,0,1,1,0
401423731,Old Dominion Monarchs,TEAM,TOTAL,TOTAL,False,,22,54,17,39,5,15,10,18,12,31,43,7,11,5,22,16,59
401423731,Columbia Lions,N. Comesana,4899284,,True,23.0,2,4,2,4,0,0,0,0,0,1,1,2,1,0,0,4,4
401423731,Columbia Lions,K. Davis,4433382,,True,34.0,3,12,2,10,1,2,4,6,4,5,9,5,1,0,4,4,11
401423731,Columbia Lions,K. Henderson,4899283,,True,38.0,3,7,3,4,0,3,0,1,1,4,5,3,1,0,5,5,6
401423731,Columbia Lions,A. Hsu,4594973,,True,36.0,7,19,4,10,3,9,0,1,2,2,4,2,2,0,2,0,17
401423731,Columbia Lions,J. Patrick,4433322,,True,35.0,4,12,3,8,1,4,1,2,1,8,9,4,8,0,5,1,10
401423731,Columbia Lions,H. Pratt,4399165,,False,23.0,3,6,0,2,3,4,2,2,2,3,5,0,1,1,2,2,11
401423731,Columbia Lions,N. Stephens,4705213,,False,7.0,1,2,1,2,0,0,1,2,0,0,0,0,1,1,0,0,3
401423731,Columbia Lions,C. Rivera,4594972,,False,4.0,0,0,0,0,0,0,0,0,0,0,0,0,0,0,1,0,0
401423731,Columbia Lions,TEAM,TOTAL,TOTAL,False,,23,62,15,40,8,22,8,14,12,24,36,16,15,2,19,16,62
401423556,Northern Iowa Panthers,G. Boffeli,4704857,,True,30.0,4,12,4,11,0,1,2,2,7,6,13,3,2,1,3,3,10
401423556,Northern Iowa Panthers,B. Gunnels,4282228,,True,22.0,1,3,1,2,0,1,0,0,4,1,5,0,0,2,2,2,2
401423556,Northern Iowa Panthers,K. Finley,4399421,,True,23.0,4,12,3,5,1,7,2,2,1,4,5,3,0,1,3,4,11
401423556,Northern Iowa Panthers,N. Kroeger,4282226,,True,27.0,2,4,2,3,0,1,0,0,1,3,4,0,1,0,1,1,4
401423556,Northern Iowa Panthers,K. Rucker,4282225,,True,31.0,5,18,5,15,0,3,0,0,0,4,4,1,0,1,3,1,10
401423556,Northern Iowa Panthers,S. McCullough,4595605,,False,3.0,0,2,0,2,0,0,0,0,0,0,0,0,0,0,0,0,0
401423556,Northern Iowa Panthers,K. Barney,4399424,,False,1.0,0,2,0,2,0,0,0,0,0,0,0,0,0,0,0,0,0
401423556,Northern Iowa Panthers,C. Wolf,4399423,,False,22.0,4,7,2,2,2,5,0,0,1,2,3,0,0,2,0,0,10
401423556,Northern Iowa Panthers,K. Laube,4704856,,False,11.0,1,1,0,0,1,1,0,0,0,3,3,0,0,0,0,1,3
401423556,Northern Iowa Panthers,E. Green,4704853,,False,18.0,0,5,0,4,0,1,0,0,1,0,1,2,1,0,1,4,0
401423556,Northern Iowa Panthers,M. McDermott,4704852,,False,10.0,1,5,0,2,1,3,2,2,0,0,0,0,2,0,1,1,5
401423556,Northern Iowa Panthers,C. Morgan,4595604,,False,2.0,0,1,0,0,0,1,0,0,0,0,0,0,1,0,1,0,0
401423556,Northern Iowa Panthers,TEAM,TOTAL,TOTAL,False,,22,72,17,48,5,24,6,6,17,24,41,9,7,7,15,17,55
401423556,Drake Bulldogs,M. Bair,4595576,,True,26.0,6,12,5,11,1,1,0,2,1,8,9,2,3,4,0,1,13
401423556,Drake Bulldogs,G. Berg,4398741,,True,27.0,3,9,3,7,0,2,0,0,0,6,6,4,0,2,4,2,6
401423556,Drake Bulldogs,K. Dinnebier,4900053,,True,19.0,0,3,0,2,0,1,0,0,1,3,4,2,1,0,5,1,0
401423556,Drake Bulldogs,M. Meyer,4433118,,True,29.0,4,11,2,6,2,5,0,0,1,5,6,1,0,0,3,1,10
401423556,Drake Bulldogs,M. Petersen,4282208,,True,28.0,1,5,1,5,0,0,11,12,0,1,1,3,1,0,3,0,13
401423556,Drake Bulldogs,A. Miller,4900055,,False,18.0,5,10,5,10,0,0,0,0,7,4,11,3,0,4,1,2,10
401423556,Drake Bulldogs,C. Becker,4704842,,False,9.0,0,1,0,0,0,1,0,0,1,0,1,0,1,0,1,0,0
401423556,Drake Bulldogs,A. Wooldridge,4399376,,False,9.0,0,1,0,0,0,1,2,2,0,1,1,0,0,0,0,0,2
401423556,Drake Bulldogs,S. Gueldner,4433721,,False,22.0,2,5,1,1,1,4,0,0,0,2,2,1,0,2,0,2,5
401423556,Drake Bulldogs,H. Fuller,4282209,,False,13.0,1,3,0,1,1,2,0,0,0,1,1,0,1,0,2,3,3
401423556,Drake Bulldogs,TEAM,TOTAL,TOTAL,False,,22,60,17,43,5,17,13,16,14,32,46,16,7,12,20,12,62
401423555,South Dakota State Jackrabbits,T. Nelson,4595883,,True,29.0,2,8,2,5,0,3,0,0,1,3,4,2,0,2,4,2,4
401423555,South Dakota State Jackrabbits,P. Burckhard,4399649,,True,23.0,4,8,4,8,0,0,0,0,1,5,6,2,1,0,0,1,8
401423555,South Dakota State Jackrabbits,M. Selland,4282531,,True,32.0,5,11,3,6,2,5,6,8,1,6,7,6,1,0,2,1,18
401423555,South Dakota State Jackrabbits,H. Timmer,4899819,,True,33.0,9,15,8,11,1,4,3,4,1,2,3,1,1,1,3,2,22
401423555,South Dakota State Jackrabbits,T. Irwin,4282530,,True,24.0,4,7,3,6,1,1,4,5,2,0,2,3,0,1,4,3,13
401423555,South Dakota State Jackrabbits,M. Byom,4704383,,False,2.0,1,2,0,1,1,1,0,0,0,1,1,0,0,0,0,0,3
401423555,South Dakota State Jackrabbits,M. Vlastuin,4704382,,False,2.0,0,0,0,0,0,0,0,0,0,0,0,0,0,0,0,0,0
401423555,South Dakota State Jackrabbits,K. Theisen,4595882,,False,15.0,2,3,1,2,1,1,0,1,1,7,8,1,0,1,0,0,5
401423555,South Dakota State Jackrabbits,A. Hirschman,4399651,,False,2.0,0,1,0,0,0,1,0,0,0,0,0,0,0,0,0,0,0
401423555,South Dakota State Jackrabbits,R. Nesheim,4595886,,False,2.0,0,0,0,0,0,0,0,0,0,0,0,0,0,0,0,0,0
401423555,South Dakota State Jackrabbits,L. Rongisch,4399647,,False,2.0,0,1,0,1,0,0,0,0,0,0,0,1,0,0,0,0,0
401423555,South Dakota State Jackrabbits,L. Theuninck,4282529,,False,13.0,0,1,0,0,0,1,0,0,0,1,1,0,1,0,1,1,0
401423555,South Dakota State Jackrabbits,H. Greer,4068252,,False,21.0,2,4,1,3,1,1,0,0,2,3,5,1,0,0,0,1,5
401423555,South Dakota State Jackrabbits,TEAM,TOTAL,TOTAL,False,,29,61,22,43,7,18,13,18,15,30,45,17,4,5,15,11,78
401423555,Minnesota Golden Gophers,K. Sissoko,4398731,,True,17.0,3,5,3,5,0,0,3,4,1,2,3,0,0,0,2,4,9
401423555,Minnesota Golden Gophers,L. Bagwell-Katalinich,4068594,,True,28.0,3,11,3,10,0,1,1,2,4,3,7,1,3,1,1,2,7
401423555,Minnesota Golden Gophers,S. Scalia,4433394,,True,37.0,3,14,1,8,2,6,0,0,0,1,1,6,1,0,4,2,8
401423555,Minnesota Golden Gophers,D. Winters,4068126,,True,27.0,4,13,1,9,3,4,0,0,0,0,0,0,2,3,2,3,11
401423555,Minnesota Golden Gophers,G. Hubbard,4068036,,True,34.0,3,7,0,2,3,5,2,2,0,2,2,1,4,0,0,2,11
401423555,Minnesota Golden Gophers,A. Micheaux,4899054,,False,6.0,2,3,2,3,0,0,1,1,0,3,3,0,0,0,1,3,5
401423555,Minnesota Golden Gophers,K. Mershon,4398930,,False,13.0,0,0,0,0,0,0,0,0,1,2,3,1,0,1,0,1,0
401423555,Minnesota Golden Gophers,B. Helgren,4281306,,False,17.0,0,1,0,1,0,0,2,2,1,2,3,0,0,0,1,2,2
401423555,Minnesota Golden Gophers,M. Czinano,4899053,,False,2.0,0,0,0,0,0,0,0,0,0,0,0,0,0,0,0,0,0
401423555,Minnesota Golden Gophers,A. Smith,4433742,,False,19.0,2,5,2,5,0,0,0,0,0,3,3,1,1,0,0,1,4
401423555,Minnesota Golden Gophers,TEAM,TOTAL,TOTAL,False,,20,59,12,43,8,16,9,11,10,20,30,10,11,5,12,20,57
401423554,Wake Forest Demon Deacons,N. Becker,4398862,,True,15.0,0,5,0,4,0,1,1,2,1,0,1,0,0,0,2,1,1
401423554,Wake Forest Demon Deacons,C. Morra,4398747,,True,36.0,7,17,6,14,1,3,3,6,1,5,6,1,0,0,0,0,18
401423554,Wake Forest Demon Deacons,E. Williams,4712103,,True,32.0,3,9,1,5,2,4,5,5,2,3,5,2,3,0,4,4,13
401423554,Wake Forest Demon Deacons,A. Andrews,4683030,,True,28.0,0,7,0,4,0,3,1,2,4,1,5,0,0,0,2,2,1
401423554,Wake Forest Demon Deacons,K. Harrison,4433667,,True,35.0,5,9,5,9,0,0,0,0,0,3,3,4,0,0,1,1,10
401423554,Wake Forest Demon Deacons,D. Hinds,4596343,,False,8.0,1,3,1,3,0,0,1,1,5,1,6,1,0,1,2,1,3
401423554,Wake Forest Demon Deacons,M. Cowles,4433530,,False,5.0,1,1,1,1,0,0,0,0,2,1,3,0,0,0,1,2,2
401423554,Wake Forest Demon Deacons,O. Summiel,4433706,,False,21.0,1,5,0,1,1,4,0,0,1,3,4,0,0,0,2,4,3
401423554,Wake Forest Demon Deacons,R. Conley,4691695,,False,20.0,1,6,0,2,1,4,1,2,2,3,5,0,1,0,3,1,4
401423554,Wake Forest Demon Deacons,TEAM,TOTAL,TOTAL,False,,19,62,14,43,5,19,12,18,20,24,44,8,4,1,17,16,55
401423554,Middle Tennessee Blue Raiders,C. Whitson,4595015,,True,33.0,2,9,0,3,2,6,2,2,2,3,5,4,1,0,2,5,8
401423554,Middle Tennessee Blue Raiders,A. Boldyreva,4899372,,True,21.0,6,8,6,8,0,0,0,1,1,5,6,0,0,4,1,1,12
401423554,Middle Tennessee Blue Raiders,J. Gregory,4899375,,True,28.0,1,4,0,0,1,4,0,0,2,3,5,3,1,0,0,4,3
401423554,Middle Tennessee Blue Raiders,Al. Whittington,4399524,,True,34.0,1,4,0,2,1,2,2,2,0,2,2,1,1,0,1,4,5
401423554,Middle Tennessee Blue Raiders,D. Saar,4281152,,True,35.0,4,9,3,5,1,4,0,0,0,2,2,5,1,0,4,1,9
401423554,Middle Tennessee Blue Raiders,J. Grannum,4704491,,False,4.0,0,0,0,0,0,0,0,0,0,1,1,0,0,0,0,1,0
401423554,Middle Tennessee Blue Raiders,K. Malashka,4399493,,False,22.0,7,15,6,12,1,3,3,6,2,1,3,0,0,2,2,4,18
401423554,Middle Tennessee Blue Raiders,G. Dodgen,4899374,,False,1.0,0,0,0,0,0,0,0,0,0,0,0,0,0,0,0,0,0
401423554,Middle Tennessee Blue Raiders,C. Blakely,4899371,,False,22.0,4,7,4,7,0,0,4,4,0,4,4,2,2,0,1,2,12
401423554,Middle Tennessee Blue Raiders,TEAM,TOTAL,TOTAL,False,,25,56,19,37,6,19,11,15,9,25,34,15,6,6,13,22,67
401423553,Wyoming Cowgirls,A. Fertig,4900606,,True,40.0,9,12,9,12,0,0,4,9,7,11,18,0,0,4,2,4,22
401423553,Wyoming Cowgirls,M. Bradshaw,4595681,,True,39.0,7,19,3,12,4,7,1,2,1,7,8,3,0,0,4,1,19
401423553,Wyoming Cowgirls,Q. Weidemann,4400207,,True,46.0,6,14,2,7,4,7,7,8,1,1,2,2,2,1,1,3,23
401423553,Wyoming Cowgirls,A. Sanchez Ramos,4400204,,True,38.0,7,16,5,10,2,6,3,3,2,4,6,5,0,0,2,5,19
401423553,Wyoming Cowgirls,T. Olson,4400203,,True,53.0,2,4,1,2,1,2,1,2,0,7,7,5,0,0,2,3,6
401423553,Wyoming Cowgirls,P. Salazar,4704659,,False,13.0,2,5,2,5,0,0,2,2,0,2,2,0,0,1,0,0,6
401423553,Wyoming Cowgirls,G. Ellis,4704657,,False,11.0,0,1,0,0,0,1,0,0,0,2,2,0,0,0,1,2,0
401423553,Wyoming Cowgirls,E. Mellema,4900607,,False,35.0,1,7,1,5,0,2,0,0,0,4,4,5,2,0,2,2,2
401423553,Wyoming Cowgirls,TEAM,TOTAL,TOTAL,False,,34,78,23,53,11,25,18,26,14,39,53,20,4,6,14,20,97
401423553,Tulsa Golden Hurricane,T. Poindexter,4898634,,True,49.0,12,23,10,15,2,8,3,4,1,3,4,2,0,3,1,3,29
401423553,Tulsa Golden Hurricane,W. Mayberry,4703707,,True,52.0,8,17,6,14,2,3,0,0,1,5,6,2,0,1,2,2,18
401423553,Tulsa Golden Hurricane,M. Bittle,4399250,,True,54.0,1,5,0,3,1,2,5,6,2,4,6,4,2,0,1,4,8
401423553,Tulsa Golden Hurricane,M. Mayberry,4282492,,True,47.0,7,15,3,6,4,9,3,4,1,5,6,1,3,0,2,4,21
401423553,Tulsa Golden Hurricane,R. Lescay,4281104,,True,46.0,5,14,5,14,0,0,0,0,1,9,10,6,1,0,3,5,10
401423553,Tulsa Golden Hurricane,L. Foutch,4898636,,False,1.0,0,0,0,0,0,0,0,0,0,0,0,0,0,0,0,0,0
401423553,Tulsa Golden Hurricane,J. Evans,4703708,,False,26.0,2,6,2,3,0,3,0,0,1,4,5,2,2,0,1,5,4
401423553,Tulsa Golden Hurricane,TEAM,TOTAL,TOTAL,False,,35,81,26,56,9,25,11,14,9,33,42,17,8,4,11,23,90
401423552,San Diego Toreros,K. Bird,4282108,,True,24.0,4,6,4,6,0,0,3,5,1,8,9,1,0,2,0,1,11
401423552,San Diego Toreros,E. Martinsen,4595849,,True,19.0,2,10,1,4,1,6,4,4,3,1,4,0,0,0,3,5,9
401423552,San Diego Toreros,K. Oakry,4400499,,True,35.0,4,10,1,4,3,6,6,6,1,6,7,2,0,0,5,2,17
401423552,San Diego Toreros,S. Gorman,4400189,,True,34.0,1,8,0,2,1,6,0,0,0,5,5,7,1,0,3,3,3
401423552,San Diego Toreros,S. Hunter,4282109,,True,22.0,3,10,3,10,0,0,0,0,1,1,2,0,0,0,0,0,6
401423552,San Diego Toreros,L. Erikstrup,4703852,,False,9.0,2,4,2,4,0,0,0,2,0,0,0,0,0,0,0,0,4
401423552,San Diego Toreros,C. Wristen,4899402,,False,1.0,0,0,0,0,0,0,0,0,0,0,0,0,0,0,0,0,0
401423552,San Diego Toreros,K. Neubert,4433711,,False,21.0,2,3,2,2,0,1,2,4,2,2,4,1,2,0,1,1,6
401423552,San Diego Toreros,H. Kaur,4899403,,False,3.0,0,0,0,0,0,0,0,0,0,1,1,0,0,0,1,1,0
401423552,San Diego Toreros,K. Horstmeyer,4714247,,False,14.0,0,3,0,2,0,1,1,2,0,1,1,0,0,0,0,1,1
401423552,San Diego Toreros,G. Giuffre,4703853,,False,1.0,0,0,0,0,0,0,0,0,0,0,0,0,0,0,1,0,0
401423552,San Diego Toreros,A. Khalfani,4595847,,False,17.0,6,8,6,8,0,0,0,1,3,0,3,4,1,0,1,1,12
401423552,San Diego Toreros,TEAM,TOTAL,TOTAL,False,,24,62,19,42,5,20,16,24,16,27,43,15,4,2,17,15,69
401423552,New Mexico Lobos,S. McGruder,4400149,,True,34.0,5,11,5,11,0,0,6,6,8,6,14,1,5,1,0,4,16
401423552,New Mexico Lobos,A. Anderson,4281834,,True,29.0,7,12,5,8,2,4,0,0,2,5,7,1,2,2,3,4,16
401423552,New Mexico Lobos,Lato. Duff,4704520,,True,28.0,1,6,0,2,1,4,0,0,0,2,2,4,0,0,4,3,3
401423552,New Mexico Lobos,Lata. Duff,4704519,,True,35.0,6,14,2,4,4,10,0,1,0,0,0,1,1,0,0,3,16
401423552,New Mexico Lobos,J. De La Cerda,4281833,,True,37.0,5,16,4,7,1,9,3,4,0,5,5,6,2,1,4,4,14
401423552,New Mexico Lobos,P. Reus,4900583,,False,9.0,0,2,0,1,0,1,0,0,0,1,1,1,0,0,1,0,0
401423552,New Mexico Lobos,A. Augmon,4900581,,False,20.0,1,2,1,2,0,0,0,0,1,3,4,2,2,0,0,1,2
401423552,New Mexico Lobos,K. van Bennekom,4704522,,False,8.0,3,3,3,3,0,0,0,0,0,0,0,0,0,0,0,0,6
401423552,New Mexico Lobos,TEAM,TOTAL,TOTAL,False,,28,66,20,38,8,28,9,11,12,27,39,16,12,4,14,19,73
401423551,Tulane Green Wave,M. Heide,4399249,,True,25.0,3,6,3,6,0,0,2,2,2,5,7,1,0,3,1,3,8
401423551,Tulane Green Wave,K. Freeman,4281110,,True,32.0,5,10,4,6,1,4,3,4,2,1,3,1,1,1,1,3,14
401423551,Tulane Green Wave,D. Jones,4399247,,True,27.0,2,6,1,2,1,4,2,2,1,2,3,4,0,0,0,5,7
401423551,Tulane Green Wave,A. Clark,4282592,,True,31.0,2,10,2,10,0,0,4,5,0,1,1,9,0,1,2,1,8
401423551,Tulane Green Wave,M. Ursin,4281254,,True,36.0,9,17,5,11,4,6,4,5,6,3,9,2,1,0,2,2,26
401423551,Tulane Green Wave,I. Parau,4594537,,False,6.0,0,0,0,0,0,0,0,0,0,1,1,0,0,0,0,0,0
401423551,Tulane Green Wave,A. Grant,4594536,,False,6.0,1,1,1,1,0,0,0,0,0,0,0,0,0,0,3,2,2
401423551,Tulane Green Wave,Marta Galic,4400505,,False,4.0,0,1,0,1,0,0,0,0,0,0,0,0,1,0,0,0,0
401423551,Tulane Green Wave,S. Cheatham,4281109,,False,21.0,2,5,0,1,2,4,0,0,0,1,1,1,0,0,0,1,6
401423551,Tulane Green Wave,K. Anderson,4281107,,False,12.0,2,5,0,0,2,5,0,0,0,0,0,2,0,0,1,1,6
401423551,Tulane Green Wave,TEAM,TOTAL,TOTAL,False,,26,61,16,38,10,23,15,18,12,15,27,20,3,5,10,18,77
401423551,Alabama Crimson Tide,J. Rice,4398624,,True,22.0,2,3,2,3,0,0,1,2,2,2,4,0,0,0,2,4,5
401423551,Alabama Crimson Tide,J. Mingo-Young,4595174,,True,38.0,7,9,5,7,2,2,5,7,3,3,6,3,0,0,4,4,21
401423551,Alabama Crimson Tide,B. Davis,4594178,,True,39.0,5,12,5,9,0,3,12,12,0,10,10,4,1,0,2,1,22
401423551,Alabama Crimson Tide,H. Barber,4398597,,True,36.0,4,7,0,0,4,7,0,0,1,4,5,1,0,0,0,3,12
401423551,Alabama Crimson Tide,M. Abrams,4398595,,True,40.0,5,14,2,8,3,6,6,6,0,2,2,3,0,0,2,1,19
401423551,Alabama Crimson Tide,K. Wade-Warren,4703569,,False,11.0,1,1,1,1,0,0,0,0,1,0,1,0,0,1,1,1,2
401423551,Alabama Crimson Tide,A. Cruce,4398598,,False,8.0,0,0,0,0,0,0,0,0,0,0,0,1,0,0,1,2,0
401423551,Alabama Crimson Tide,M. Gordon,4433457,,False,2.0,0,0,0,0,0,0,0,0,0,0,0,0,0,0,0,0,0
401423551,Alabama Crimson Tide,T. Sutton,4399523,,False,4.0,0,2,0,1,0,1,0,0,0,0,0,0,1,0,2,0,0
401423551,Alabama Crimson Tide,TEAM,TOTAL,TOTAL,False,,24,48,15,29,9,19,24,27,8,23,31,12,2,1,15,16,81
401423550,Vanderbilt Commodores,S. Washington,4433999,,True,33.0,4,9,4,9,0,0,9,10,4,3,7,0,3,0,2,2,17
401423550,Vanderbilt Commodores,K. Smith,4433301,,True,30.0,0,3,0,2,0,1,0,0,1,4,5,2,0,0,1,1,0
401423550,Vanderbilt Commodores,I. Moore,4433536,,True,37.0,8,14,1,3,7,11,2,2,0,3,3,2,1,0,5,2,25
401423550,Vanderbilt Commodores,B. LaChance,4433502,,True,30.0,1,3,0,1,1,2,4,4,1,1,2,2,3,0,0,2,7
401423550,Vanderbilt Commodores,J. Cambridge,4398773,,True,32.0,6,9,6,8,0,1,3,4,1,0,1,3,4,1,4,3,15
401423550,Vanderbilt Commodores,K. Cheesman,4899544,,False,2.0,0,0,0,0,0,0,0,0,0,0,0,0,0,0,0,0,0
401423550,Vanderbilt Commodores,Y. Chambers,4433659,,False,15.0,0,4,0,4,0,0,1,2,1,1,2,0,0,0,0,1,1
401423550,Vanderbilt Commodores,D. Flournoy,4683036,,False,13.0,2,4,1,2,1,2,1,2,0,0,0,0,1,0,3,0,6
401423550,Vanderbilt Commodores,D. Washington,4433002,,False,8.0,0,1,0,1,0,0,0,0,0,3,3,1,1,0,0,1,0
401423550,Vanderbilt Commodores,TEAM,TOTAL,TOTAL,False,,21,47,12,30,9,17,20,24,10,19,29,10,13,1,15,12,71
401423550,Liberty Flames,B. Rettstatt,4281577,,True,30.0,5,15,5,12,0,3,3,3,5,5,10,1,1,2,2,4,13
401423550,Liberty Flames,M. Berkman,4704261,,True,16.0,3,6,3,6,0,0,0,0,6,4,10,0,0,1,1,2,6
401423550,Liberty Flames,P. Smeenge,4706151,,True,21.0,1,4,1,2,0,2,2,2,1,1,2,0,0,0,3,0,4
401423550,Liberty Flames,D. Brown,4704260,,True,28.0,1,8,1,6,0,2,2,4,4,3,7,3,2,0,2,2,4
401423550,Liberty Flames,K. Williams,4594906,,True,23.0,0,4,0,2,0,2,0,0,0,1,1,3,1,0,3,4,0
401423550,Liberty Flames,A. Markova,4898942,,False,4.0,0,0,0,0,0,0,0,0,1,1,2,1,0,0,0,0,0
401423550,Liberty Flames,J. Bailey,4595227,,False,18.0,0,5,0,3,0,2,1,2,2,2,4,1,0,0,2,4,1
401423550,Liberty Flames,B. Smuda,4433773,,False,12.0,2,4,2,4,0,0,0,0,3,1,4,0,0,1,2,0,4
401423550,Liberty Flames,J. Hodges,4898940,,False,5.0,2,2,1,1,1,1,0,0,1,0,1,0,0,0,0,0,5
401423550,Liberty Flames,E. Hess,4898939,,False,22.0,2,7,0,2,2,5,0,0,0,1,1,1,0,1,2,1,6
401423550,Liberty Flames,N. Lindstrom,4594903,,False,5.0,1,4,1,2,0,2,0,0,0,0,0,0,0,0,0,0,2
401423550,Liberty Flames,A. Iverson,4399422,,False,16.0,0,1,0,0,0,1,0,0,0,0,0,1,0,0,3,3,0
401423550,Liberty Flames,TEAM,TOTAL,TOTAL,False,,17,60,14,40,3,20,8,11,25,19,44,11,4,5,23,20,45
401423530,Tennessee Tech Golden Eagles,A. Walker,4704229,,True,20.0,1,4,0,3,1,1,0,0,1,3,4,2,0,1,2,2,3
401423530,Tennessee Tech Golden Eagles,M. Coleman,4282489,,True,33.0,5,11,4,6,1,5,3,3,1,3,4,1,1,1,2,1,14
401423530,Tennessee Tech Golden Eagles,A. Jones,4649322,,True,38.0,6,14,6,13,0,1,3,4,1,6,7,1,3,0,5,1,15
401423530,Tennessee Tech Golden Eagles,J. Guinn,4595968,,True,36.0,4,8,4,8,0,0,0,0,3,4,7,1,4,0,6,2,8
401423530,Tennessee Tech Golden Eagles,M. Clark,4282483,,True,31.0,2,5,0,0,2,5,0,0,0,0,0,2,2,0,1,3,6
401423530,Tennessee Tech Golden Eagles,P. Carter,4705014,,False,12.0,1,1,0,0,1,1,0,0,0,1,1,0,0,0,0,0,3
401423530,Tennessee Tech Golden Eagles,M. Owens,4595967,,False,12.0,1,3,1,1,0,2,2,2,1,0,1,2,0,0,1,0,4
401423530,Tennessee Tech Golden Eagles,K. Brady,4282486,,False,18.0,0,4,0,3,0,1,2,2,0,2,2,1,1,0,1,2,2
401423530,Tennessee Tech Golden Eagles,TEAM,TOTAL,TOTAL,False,,20,50,15,34,5,16,10,11,10,22,32,10,11,2,23,11,55
401423530,Houston Cougars,B. Patterson,4433360,,True,34.0,2,5,2,4,0,1,1,2,3,1,4,1,1,2,4,3,5
401423530,Houston Cougars,T. Hill,4399017,,True,25.0,7,11,7,11,0,0,0,3,4,3,7,0,0,2,3,3,14
401423530,Houston Cougars,L. Blair,4433451,,True,36.0,6,12,5,7,1,5,3,4,0,1,1,1,2,0,2,2,16
401423530,Houston Cougars,T. Young,4433298,,True,34.0,4,15,4,13,0,2,3,3,4,8,12,4,3,1,3,1,11
401423530,Houston Cougars,J. Blackshell-Fair,4281088,,True,27.0,2,2,2,2,0,0,2,2,1,4,5,2,1,1,2,0,6
401423530,Houston Cougars,K. Jones,4703658,,False,9.0,0,0,0,0,0,0,0,0,0,1,1,0,0,0,0,3,0
401423530,Houston Cougars,F. Diagne,4281281,,False,0.0,0,0,0,0,0,0,0,0,0,0,0,0,0,0,0,0,0
401423530,Houston Cougars,B. Onyeje,4399029,,False,21.0,3,9,1,4,2,5,0,0,1,1,2,0,3,0,2,2,8
401423530,Houston Cougars,E. Sidney,4398990,,False,14.0,1,3,0,0,1,3,0,0,0,0,0,3,0,0,0,0,3
401423530,Houston Cougars,TEAM,TOTAL,TOTAL,False,,25,57,21,41,4,16,9,14,13,21,34,11,10,6,17,14,63
401423310,Purdue Boilermakers,R. Woltman,4433302,,True,26.0,4,7,4,7,0,0,2,2,2,1,3,0,1,0,1,2,10
401423310,Purdue Boilermakers,A. Ellis,4595183,,True,28.0,4,7,4,7,0,0,5,7,1,2,3,2,1,0,2,1,13
401423310,Purdue Boilermakers,J. Terry,4433143,,True,34.0,2,8,2,6,0,2,1,1,0,8,8,2,2,0,4,4,5
401423310,Purdue Boilermakers,C. Hardin,4398945,,True,29.0,2,8,1,3,1,5,0,0,0,1,1,0,0,0,1,3,5
401423310,Purdue Boilermakers,R. Doumbia,4398602,,True,24.0,2,7,2,5,0,2,0,0,4,3,7,3,1,1,2,3,4
401423310,Purdue Boilermakers,A. Learn,4899062,,False,12.0,1,2,1,2,0,0,0,0,3,0,3,0,0,0,0,3,2
401423310,Purdue Boilermakers,J. Smith,4899061,,False,14.0,1,3,1,3,0,0,1,2,0,0,0,0,0,0,0,0,3
401423310,Purdue Boilermakers,B. Moore,4398608,,False,33.0,8,22,5,16,3,6,1,2,0,2,2,1,0,1,2,3,20
401423310,Purdue Boilermakers,TEAM,TOTAL,TOTAL,False,,24,64,20,49,4,15,10,14,12,20,32,8,5,2,12,19,62
401423310,Marquette Golden Eagles,L. Karlen,4703796,,True,24.0,0,4,0,3,0,1,2,2,0,2,2,2,1,0,1,2,2
401423310,Marquette Golden Eagles,C. Marotta,4399360,,True,36.0,1,2,1,2,0,0,1,2,2,7,9,6,1,0,0,2,3
401423310,Marquette Golden Eagles,L. Van Kleunen,4068083,,True,38.0,10,17,10,17,0,0,7,10,4,7,11,6,0,2,0,2,27
401423310,Marquette Golden Eagles,J. King,4595151,,True,32.0,7,17,4,13,3,4,0,0,5,4,9,4,1,3,4,3,17
401423310,Marquette Golden Eagles,K. McLaughlin,4281277,,True,38.0,5,15,2,7,3,8,3,4,0,2,2,0,0,0,1,0,16
401423310,Marquette Golden Eagles,K. Myles,4594770,,False,2.0,0,0,0,0,0,0,0,0,0,1,1,0,0,0,0,0,0
401423310,Marquette Golden Eagles,R. Nkumu,4599129,,False,9.0,1,1,1,1,0,0,0,0,0,1,1,0,1,0,1,1,2
401423310,Marquette Golden Eagles,A. Walker,4400574,,False,21.0,4,7,4,7,0,0,2,4,2,2,4,2,2,1,2,4,10
401423310,Marquette Golden Eagles,TEAM,TOTAL,TOTAL,False,,28,63,22,50,6,13,15,22,15,28,43,20,6,6,10,14,77
401422721,Wake Forest Demon Deacons,N. Becker,4398862,,True,27.0,3,10,3,9,0,1,5,6,0,1,1,2,2,1,0,1,11
401422721,Wake Forest Demon Deacons,C. Morra,4398747,,True,28.0,4,9,4,9,0,0,2,2,0,6,6,1,1,1,2,1,10
401422721,Wake Forest Demon Deacons,E. Williams,4712103,,True,33.0,3,12,2,7,1,5,2,2,0,3,3,4,5,0,2,2,9
401422721,Wake Forest Demon Deacons,A. Andrews,4683030,,True,35.0,7,13,4,9,3,4,1,1,2,1,3,1,2,1,2,0,18
401422721,Wake Forest Demon Deacons,K. Harrison,4433667,,True,26.0,2,7,2,7,0,0,0,0,1,1,2,4,1,0,2,1,4
401422721,Wake Forest Demon Deacons,D. Hinds,4596343,,False,21.0,2,6,2,6,0,0,0,0,8,4,12,2,0,3,4,1,4
401422721,Wake Forest Demon Deacons,M. Cowles,4433530,,False,10.0,1,2,1,2,0,0,2,4,3,2,5,0,1,0,1,3,4
401422721,Wake Forest Demon Deacons,M. Morales,4912216,,False,4.0,0,2,0,1,0,1,0,0,1,0,1,0,0,0,0,0,0
401422721,Wake Forest Demon Deacons,R. Conley,4691695,,False,15.0,4,6,1,1,3,5,0,0,1,2,3,0,1,1,2,3,11
401422721,Wake Forest Demon Deacons,M. Maier,4594399,,False,0.0,0,0,0,0,0,0,0,0,0,0,0,0,0,0,0,0,0
401422721,Wake Forest Demon Deacons,TEAM,TOTAL,TOTAL,False,,26,67,19,51,7,16,12,15,18,22,40,14,13,7,15,12,71
401422721,Akron Zips,R. Bass,4899611,,True,37.0,7,14,7,14,0,0,5,6,7,6,13,0,0,3,2,3,19
401422721,Akron Zips,L. Brewer,4595218,,True,22.0,2,5,2,3,0,2,0,0,1,4,5,1,1,1,3,3,4
401422721,Akron Zips,J. Dawson,4281369,,True,38.0,7,21,5,15,2,6,4,4,2,6,8,4,6,0,8,1,20
401422721,Akron Zips,L. Ferrell,4595221,,True,29.0,1,3,1,2,0,1,0,0,2,2,4,3,0,1,2,2,2
401422721,Akron Zips,K. Miller,4399280,,True,32.0,0,5,0,5,0,0,2,2,0,0,0,5,2,0,0,1,2
401422721,Akron Zips,M. Neitzel,4595220,,False,3.0,0,1,0,1,0,0,0,0,0,0,0,0,0,0,1,0,0
401422721,Akron Zips,Z. Rasheed,4899610,,False,8.0,0,0,0,0,0,0,0,0,0,2,2,0,0,0,2,0,0
401422721,Akron Zips,A. Stewart,4704835,,False,0.0,0,0,0,0,0,0,0,0,0,0,0,0,0,0,0,0,0
401422721,Akron Zips,R. Martindale,4595219,,False,30.0,4,8,0,0,4,8,0,0,0,2,2,0,2,1,1,1,12
401422721,Akron Zips,TEAM,TOTAL,TOTAL,False,,21,57,15,40,6,17,11,12,14,22,36,13,11,6,19,11,59
401422720,Wofford Terriers,L. Hatton,4595426,,True,28.0,3,8,0,2,3,6,0,0,0,0,0,0,0,2,0,4,9
401422720,Wofford Terriers,A. Tomlin,4400641,,True,24.0,3,10,3,10,0,0,6,7,0,8,8,0,0,1,0,4,12
401422720,Wofford Terriers,R. Rapert,4900421,,True,27.0,0,3,0,1,0,2,2,2,0,2,2,5,2,0,4,0,2
401422720,Wofford Terriers,J. Carman,4400643,,True,30.0,4,12,1,4,3,8,2,4,0,2,2,1,1,0,0,0,13
401422720,Wofford Terriers,N. Lutz,4400638,,True,26.0,0,3,0,0,0,3,0,0,0,5,5,3,1,0,1,2,0
401422720,Wofford Terriers,A. Crawford,4704310,,False,9.0,0,1,0,0,0,1,2,2,1,0,1,0,0,0,1,1,2
401422720,Wofford Terriers,S. Richetto,4900420,,False,17.0,4,7,3,4,1,3,0,0,0,1,1,0,1,0,0,0,9
401422720,Wofford Terriers,H. Matthews,4704309,,False,12.0,0,3,0,2,0,1,0,0,0,2,2,0,0,0,3,1,0
401422720,Wofford Terriers,A. Schultz,4704308,,False,14.0,2,4,1,2,1,2,0,0,0,0,0,1,1,0,0,1,5
401422720,Wofford Terriers,J. Smith,4704307,,False,4.0,1,1,1,1,0,0,1,2,0,0,0,1,0,0,0,0,3
401422720,Wofford Terriers,A. Harris,4400644,,False,9.0,0,1,0,1,0,0,1,2,1,1,2,2,0,1,0,1,1
401422720,Wofford Terriers,TEAM,TOTAL,TOTAL,False,,17,53,9,27,8,26,14,19,3,23,26,13,6,4,11,14,56
401422720,Middle Tennessee Blue Raiders,C. Whitson,4595015,,True,36.0,4,12,2,5,2,7,1,1,2,7,9,4,2,0,3,1,11
401422720,Middle Tennessee Blue Raiders,A. Boldyreva,4899372,,True,17.0,6,9,6,8,0,1,3,3,1,5,6,0,0,0,1,4,15
401422720,Middle Tennessee Blue Raiders,J. Gregory,4899375,,True,27.0,5,9,0,2,5,7,0,0,0,1,1,1,0,0,0,3,15
401422720,Middle Tennessee Blue Raiders,Al. Whittington,4399524,,True,30.0,2,4,2,2,0,2,2,2,2,5,7,2,2,1,1,1,6
401422720,Middle Tennessee Blue Raiders,D. Saar,4281152,,True,30.0,6,9,2,3,4,6,0,0,1,4,5,4,1,0,0,0,16
401422720,Middle Tennessee Blue Raiders,A. Latorre Ciria,4704492,,False,4.0,0,0,0,0,0,0,0,2,1,1,2,0,0,0,0,0,0
401422720,Middle Tennessee Blue Raiders,J. Grannum,4704491,,False,9.0,0,1,0,0,0,1,0,0,1,3,4,0,0,0,3,3,0
401422720,Middle Tennessee Blue Raiders,K. Malashka,4399493,,False,14.0,6,11,5,9,1,2,2,4,3,4,7,1,0,0,1,1,15
401422720,Middle Tennessee Blue Raiders,G. Dodgen,4899374,,False,7.0,0,5,0,0,0,5,0,0,0,0,0,0,0,0,0,1,0
401422720,Middle Tennessee Blue Raiders,C. Blakely,4899371,,False,16.0,4,7,4,7,0,0,0,0,0,1,1,4,2,0,2,2,8
401422720,Middle Tennessee Blue Raiders,Am. Whittington,4399525,,False,10.0,0,0,0,0,0,0,0,0,1,1,2,0,0,1,0,0,0
401422720,Middle Tennessee Blue Raiders,TEAM,TOTAL,TOTAL,False,,33,67,21,36,12,31,8,12,13,36,49,16,7,2,11,16,86
401422719,Portland Pilots,L. Cochrane,4595872,,True,30.0,2,3,2,3,0,0,0,0,0,1,1,0,0,1,1,1,4
401422719,Portland Pilots,A. Fowler,4595823,,True,31.0,6,14,6,10,0,4,4,5,3,10,13,6,1,2,2,1,16
401422719,Portland Pilots,E. Shearer,4703855,,True,21.0,1,1,1,1,0,0,0,0,2,2,4,1,3,1,1,4,2
401422719,Portland Pilots,M. Muhlheim,4282078,,True,22.0,0,4,0,1,0,3,0,0,1,0,1,1,0,0,0,1,0
401422719,Portland Pilots,R. Pflug,4282065,,True,28.0,9,16,4,6,5,10,0,0,0,7,7,4,0,0,6,1,23
401422719,Portland Pilots,E. Sewell,4899388,,False,5.0,0,0,0,0,0,0,0,0,0,0,0,1,0,0,0,1,0
401422719,Portland Pilots,K. Frawley,4595822,,False,22.0,4,5,2,2,2,3,2,3,2,3,5,2,0,0,2,0,12
401422719,Portland Pilots,L. Kaitu'u,4400493,,False,12.0,1,2,1,1,0,1,0,0,0,2,2,1,1,0,0,2,2
401422719,Portland Pilots,M. Burnham,4704748,,False,17.0,5,6,5,5,0,1,3,4,2,5,7,3,0,0,3,4,13
401422719,Portland Pilots,M. Meek,4703854,,False,12.0,0,8,0,2,0,6,0,0,0,1,1,2,0,0,2,0,0
401422719,Portland Pilots,TEAM,TOTAL,TOTAL,False,,28,59,21,31,7,28,9,12,12,33,45,21,5,4,19,15,72
401422719,Colorado State Rams,K. Kinzer,4595630,,True,34.0,4,13,0,4,4,9,0,0,0,3,3,3,4,0,0,2,12
401422719,Colorado State Rams,K. Murphy,4068969,,True,22.0,2,8,2,8,0,0,0,0,2,2,4,1,1,0,0,2,4
401422719,Colorado State Rams,S. Mech,4399658,,True,30.0,4,9,3,6,1,3,0,2,1,0,1,1,2,0,1,1,9
401422719,Colorado State Rams,P. Farkas,4704463,,True,21.0,3,8,3,4,0,4,0,0,1,3,4,1,1,0,2,3,6
401422719,Colorado State Rams,M. Hofschild,4595160,,True,38.0,5,13,4,11,1,2,8,9,0,2,2,8,1,0,0,0,19
401422719,Colorado State Rams,C. Gomez,4899769,,False,5.0,1,1,1,1,0,0,0,0,0,0,0,0,0,0,0,1,2
401422719,Colorado State Rams,C. Clark,4704464,,False,18.0,1,3,1,2,0,1,0,0,1,2,3,0,0,0,1,2,2
401422719,Colorado State Rams,A. Prim,4899770,,False,2.0,0,0,0,0,0,0,0,0,0,0,0,0,0,0,1,0,0
401422719,Colorado State Rams,U. Atosu,4594809,,False,30.0,3,11,0,3,3,8,0,0,1,1,2,3,3,0,1,2,9
401422719,Colorado State Rams,TEAM,TOTAL,TOTAL,False,,23,66,14,39,9,27,8,11,8,16,24,17,12,0,7,13,63
401422718,UCLA Bruins,I. Anstey,4599500,,True,11.0,1,6,1,6,0,0,0,0,1,0,1,0,2,0,1,1,2
401422718,UCLA Bruins,C. Brown,4595911,,True,26.0,2,5,2,5,0,0,0,0,4,4,8,0,1,4,2,2,4
401422718,UCLA Bruins,C. Osborne,4433293,,True,35.0,3,12,3,9,0,3,0,0,3,3,6,4,1,0,4,1,6
401422718,UCLA Bruins,J. Penn,4281259,,True,27.0,2,5,1,2,1,3,0,0,0,3,3,1,1,0,1,1,5
401422718,UCLA Bruins,N. Chou,4066562,,True,33.0,6,9,1,2,5,7,2,2,0,3,3,1,0,3,2,0,19
401422718,UCLA Bruins,Dugalic,4433411,,False,17.0,4,6,4,6,0,0,0,0,2,2,4,0,2,1,1,2,8
401422718,UCLA Bruins,I. Thomas,4281072,,False,25.0,4,8,4,7,0,1,5,5,4,8,12,3,2,0,4,3,13
401422718,UCLA Bruins,D. Darius,4711802,,False,15.0,2,4,2,3,0,1,0,1,0,2,2,1,1,1,0,0,4
401422718,UCLA Bruins,K. Owens,4282172,,False,11.0,0,4,0,4,0,0,0,0,0,2,2,1,0,0,0,1,0
401422718,UCLA Bruins,TEAM,TOTAL,TOTAL,False,,24,59,18,44,6,15,7,8,14,28,42,11,10,9,15,11,61
401422718,UC Irvine Anteaters,S. Locandro,4595211,,True,23.0,2,7,1,5,1,2,0,0,1,6,7,0,1,0,5,2,5
401422718,UC Irvine Anteaters,N. Hunt,4281707,,True,31.0,4,14,1,5,3,9,0,0,0,1,1,1,1,0,2,2,11
401422718,UC Irvine Anteaters,N. Tom,4899722,,True,31.0,3,6,3,6,0,0,3,3,2,2,4,1,0,0,0,1,9
401422718,UC Irvine Anteaters,J. Cadee,4595210,,True,17.0,0,4,0,2,0,2,0,0,0,0,0,1,0,0,1,1,0
401422718,UC Irvine Anteaters,K. Williams,4595209,,True,33.0,5,13,2,8,3,5,0,0,1,3,4,4,2,0,2,0,13
401422718,UC Irvine Anteaters,C. Kaupu,4704426,,False,4.0,0,0,0,0,0,0,0,0,0,1,1,0,0,0,0,0,0
401422718,UC Irvine Anteaters,M. Kapinga,4400059,,False,7.0,1,1,1,1,0,0,0,0,1,0,1,0,0,0,0,0,2
401422718,UC Irvine Anteaters,T. Dusharm,3906747,,False,10.0,0,0,0,0,0,0,0,0,1,1,2,0,1,1,2,1,0
401422718,UC Irvine Anteaters,O. Williams,4899726,,False,13.0,2,3,2,3,0,0,0,0,0,2,2,1,1,0,1,0,4
401422718,UC Irvine Anteaters,H. Hernandez,4899725,,False,20.0,0,3,0,2,0,1,2,2,0,3,3,0,0,0,3,4,2
401422718,UC Irvine Anteaters,D. Lee,4899724,,False,11.0,1,4,1,4,0,0,0,1,0,0,0,0,0,0,2,2,2
401422718,UC Irvine Anteaters,TEAM,TOTAL,TOTAL,False,,18,55,11,36,7,19,5,6,10,22,32,8,6,1,18,13,48
401422717,Towson Tigers,A. Kubek,4705046,,True,36.0,9,17,9,15,0,2,3,7,8,8,16,0,0,1,2,0,21
401422717,Towson Tigers,R. Tucker,4594725,,True,23.0,0,0,0,0,0,0,0,0,2,2,4,1,1,2,2,2,0
401422717,Towson Tigers,T. Gary,4705049,,True,38.0,3,12,1,6,2,6,2,2,2,3,5,0,0,0,2,3,10
401422717,Towson Tigers,R. Evans,4433397,,True,28.0,2,3,2,3,0,0,0,0,1,4,5,1,0,0,1,3,4
401422717,Towson Tigers,A. Nelson,4433355,,True,39.0,7,21,5,14,2,7,7,8,3,2,5,6,2,0,3,1,23
401422717,Towson Tigers,N. Dodson,4705048,,False,7.0,0,0,0,0,0,0,0,0,0,3,3,1,0,1,0,2,0
401422717,Towson Tigers,A. Rivera,4433681,,False,20.0,1,6,1,2,0,4,2,4,2,2,4,2,2,0,2,2,4
401422717,Towson Tigers,S. Williams,4705047,,False,4.0,1,2,1,2,0,0,1,1,0,0,0,0,0,0,1,0,3
401422717,Towson Tigers,K. Kornegay-Lucas,4433095,,False,5.0,0,1,0,1,0,0,1,2,0,0,0,0,0,0,2,0,1
401422717,Towson Tigers,TEAM,TOTAL,TOTAL,False,,23,62,19,43,4,19,16,24,19,25,44,11,5,4,15,13,66
401422717,Old Dominion Monarchs,B. Jackson,4594387,,True,35.0,6,12,6,12,0,0,5,6,4,4,8,0,1,2,0,1,17
401422717,Old Dominion Monarchs,A. Young,4399540,,True,16.0,5,9,5,9,0,0,1,2,2,5,7,2,2,0,3,4,11
401422717,Old Dominion Monarchs,I. Allen,4704183,,True,35.0,9,19,5,11,4,8,3,5,0,7,7,1,4,0,2,3,25
401422717,Old Dominion Monarchs,A. Hudson,4399534,,True,26.0,1,5,0,2,1,3,0,0,0,0,0,1,1,0,2,1,3
401422717,Old Dominion Monarchs,M. Adams,4399533,,True,37.0,2,7,1,6,1,1,0,0,0,3,3,6,3,0,0,4,5
401422717,Old Dominion Monarchs,A. Moreland,4899400,,False,1.0,0,0,0,0,0,0,0,0,0,0,0,0,0,0,0,1,0
401422717,Old Dominion Monarchs,A. Barnes-Williams,4899395,,False,17.0,2,9,2,9,0,0,1,2,3,1,4,3,0,1,2,3,5
401422717,Old Dominion Monarchs,K. Nelson,4899398,,False,10.0,1,2,1,1,0,1,0,0,0,1,1,0,1,0,0,0,2
401422717,Old Dominion Monarchs,K. Clark,4899396,,False,20.0,1,1,0,0,1,1,1,2,3,2,5,0,1,0,3,4,4
401422717,Old Dominion Monarchs,J. Campbell,4704352,,False,3.0,0,1,0,0,0,1,0,0,1,0,1,0,0,0,1,1,0
401422717,Old Dominion Monarchs,TEAM,TOTAL,TOTAL,False,,27,65,20,50,7,15,11,17,15,25,40,13,13,3,13,22,72
401422716,Toledo Rockets,J. Cook,4900087,,True,16.0,4,7,4,7,0,0,5,7,1,4,5,0,1,0,1,1,13
401422716,Toledo Rockets,S. Mikonowicz,4705387,,True,37.0,1,4,0,1,1,3,0,2,1,12,13,2,1,0,0,2,3
401422716,Toledo Rockets,K. Goss,4705386,,True,33.0,6,7,6,7,0,0,0,1,2,3,5,1,1,0,0,1,12
401422716,Toledo Rockets,Q. Lockett,4595303,,True,30.0,3,14,2,9,1,5,5,6,0,6,6,3,1,1,1,1,12
401422716,Toledo Rockets,S. Wiard,4595301,,True,37.0,2,8,1,6,1,2,2,2,0,3,3,4,0,0,2,0,7
401422716,Toledo Rockets,L. Lance,4399357,,False,1.0,0,0,0,0,0,0,0,0,0,0,0,0,0,0,0,0,0
401422716,Toledo Rockets,Y. Curry,4595305,,False,2.0,0,0,0,0,0,0,0,0,0,1,1,0,0,0,0,0,0
401422716,Toledo Rockets,H. Noveroske,4594772,,False,6.0,1,4,1,4,0,0,0,2,1,3,4,0,0,0,0,0,2
401422716,Toledo Rockets,J. Jansen,4900086,,False,15.0,0,2,0,1,0,1,0,0,0,0,0,2,0,0,0,1,0
401422716,Toledo Rockets,E. Doherty,4900085,,False,1.0,0,0,0,0,0,0,0,0,0,0,0,0,0,0,0,0,0
401422716,Toledo Rockets,H. Idowu,4705388,,False,1.0,0,0,0,0,0,0,0,0,0,0,0,0,0,0,0,0,0
401422716,Toledo Rockets,N. Garcia,4703763,,False,17.0,5,14,3,8,2,6,0,0,1,1,2,0,2,0,1,1,12
401422716,Toledo Rockets,S. Barnes,4595302,,False,3.0,0,1,0,0,0,1,0,0,0,0,0,0,0,0,0,0,0
401422716,Toledo Rockets,M. Copeland,4282150,,False,1.0,0,0,0,0,0,0,0,0,0,0,0,0,0,0,1,0,0
401422716,Toledo Rockets,TEAM,TOTAL,TOTAL,False,,22,61,17,43,5,18,12,20,10,39,49,12,6,1,6,7,61
401422716,Houston Christian Huskies,A. Sutherland,4595692,,True,36.0,2,6,1,5,1,1,0,0,0,6,6,2,1,3,0,2,5
401422716,Houston Christian Huskies,M. Nzoiwu,4400275,,True,9.0,0,2,0,2,0,0,0,0,1,3,4,1,0,1,0,1,0
401422716,Houston Christian Huskies,T. Jefferson,4595688,,True,37.0,4,14,4,12,0,2,4,7,0,3,3,4,2,0,1,1,12
401422716,Houston Christian Huskies,K. Wilson,4595687,,True,18.0,0,7,0,4,0,3,1,2,0,3,3,0,0,0,0,0,1
401422716,Houston Christian Huskies,J. Vujakovic,4400274,,True,23.0,3,7,2,5,1,2,0,0,0,3,3,1,0,1,1,2,7
401422716,Houston Christian Huskies,A. Cotton,4900423,,False,3.0,1,2,1,2,0,0,0,0,0,0,0,0,0,0,0,2,2
401422716,Houston Christian Huskies,N. Pierce,4704744,,False,4.0,0,0,0,0,0,0,0,0,0,0,0,0,0,0,0,0,0
401422716,Houston Christian Huskies,N. Collins,4595690,,False,29.0,5,9,4,6,1,3,2,2,0,6,6,1,1,0,2,1,13
401422716,Houston Christian Huskies,E. Matadi,4900424,,False,8.0,1,2,1,2,0,0,0,0,0,1,1,0,0,1,0,3,2
401422716,Houston Christian Huskies,E. Maguire,4704741,,False,22.0,3,5,0,0,3,5,0,0,0,1,1,0,0,0,2,0,9
401422716,Houston Christian Huskies,L. Mapusua,4704731,,False,11.0,0,3,0,2,0,1,0,0,1,1,2,0,0,0,0,2,0
401422716,Houston Christian Huskies,TEAM,TOTAL,TOTAL,False,,19,57,13,40,6,17,7,11,2,32,34,9,4,6,6,14,51
401422715,Fordham Rams,M. Jonassen,4399050,,True,28.0,3,7,3,6,0,1,0,2,6,2,8,0,2,1,2,1,6
401422715,Fordham Rams,K. Downey,4399048,,True,30.0,2,11,1,5,1,6,5,7,0,11,11,0,0,2,1,5,10
401422715,Fordham Rams,A. DeWolfe,4594765,,True,36.0,5,18,2,12,3,6,0,0,1,0,1,0,3,0,4,2,13
401422715,Fordham Rams,A. Dingle,4399322,,True,36.0,8,13,8,13,0,0,3,9,1,2,3,6,4,0,3,4,19
401422715,Fordham Rams,K. Heremaia,4281473,,True,30.0,3,14,0,2,3,12,1,2,1,6,7,2,0,0,2,5,10
401422715,Fordham Rams,M. Prior,4898497,,False,9.0,0,0,0,0,0,0,0,0,4,0,4,0,0,2,0,3,0
401422715,Fordham Rams,C. McQuillen,4898500,,False,10.0,1,2,0,0,1,2,0,0,0,0,0,0,0,0,0,1,3
401422715,Fordham Rams,M. Flood,4703743,,False,0.0,0,0,0,0,0,0,0,0,0,0,0,0,0,0,0,0,0
401422715,Fordham Rams,S. Karpell,4594767,,False,21.0,1,2,0,1,1,1,0,0,0,2,2,3,0,0,1,3,3
401422715,Fordham Rams,TEAM,TOTAL,TOTAL,False,,23,67,14,39,9,28,9,20,13,23,36,11,9,5,15,24,64
401422715,Bucknell Bison,I. King,4900533,,True,39.0,3,6,1,1,2,5,0,0,0,6,6,1,0,0,1,3,8
401422715,Bucknell Bison,E. Shaffer,4595535,,True,33.0,3,9,3,9,0,0,3,4,3,9,12,4,0,0,4,3,9
401422715,Bucknell Bison,C. Collins,4900532,,True,39.0,3,6,3,6,0,0,2,5,1,3,4,4,0,0,4,4,8
401422715,Bucknell Bison,M. Walls,4400177,,True,17.0,5,9,4,8,1,1,0,2,0,1,1,1,2,0,2,3,11
401422715,Bucknell Bison,T. O'Brien,4400176,,True,37.0,9,18,7,14,2,4,15,17,0,9,9,2,3,0,4,2,35
401422715,Bucknell Bison,K. Reinbeau,4704700,,False,7.0,1,1,1,1,0,0,0,0,0,1,1,0,0,0,0,3,2
401422715,Bucknell Bison,R. Sisselman,4900531,,False,23.0,0,1,0,0,0,1,0,0,0,1,1,0,0,0,1,1,0
401422715,Bucknell Bison,J. Kulesza,4704702,,False,2.0,0,0,0,0,0,0,0,0,0,0,0,0,0,0,0,0,0
401422715,Bucknell Bison,T. Johnson,4595533,,False,3.0,0,0,0,0,0,0,0,0,0,0,0,0,0,0,1,0,0
401422715,Bucknell Bison,C. Dingler,4577540,,False,0.0,0,0,0,0,0,0,0,0,0,0,0,0,0,0,0,1,0
401422715,Bucknell Bison,TEAM,TOTAL,TOTAL,False,,24,50,19,39,5,11,20,28,4,30,34,12,5,0,20,20,73
401422714,VCU Rams,K. Walters,4399303,,True,16.0,1,5,1,5,0,0,0,0,2,1,3,0,3,0,1,3,2
401422714,VCU Rams,D. Townes,4704161,,True,19.0,1,4,1,3,0,1,0,0,1,1,2,1,0,1,1,3,2
401422714,VCU Rams,J. Griffith-Wallace,4282453,,True,28.0,4,12,4,6,0,6,0,0,0,5,5,0,0,0,1,3,8
401422714,VCU Rams,M. Hattix-Covington,4281906,,True,29.0,1,5,0,2,1,3,2,4,1,2,3,0,2,0,0,0,5
401422714,VCU Rams,T. Robinson,4281905,,True,38.0,8,19,7,14,1,5,3,4,3,6,9,1,1,0,0,4,20
401422714,VCU Rams,C. Bloom,4433657,,False,23.0,2,4,2,4,0,0,5,6,0,3,3,0,0,0,3,1,9
401422714,VCU Rams,Sa. Robinson,4399312,,False,11.0,0,1,0,1,0,0,0,0,1,2,3,0,0,0,0,0,0
401422714,VCU Rams,S. Te-Biasu,4704160,,False,24.0,2,6,1,3,1,3,3,4,0,3,3,2,1,0,2,0,8
401422714,VCU Rams,G. Hutson,4613247,,False,12.0,1,2,1,1,0,1,0,0,2,2,4,0,0,1,2,0,2
401422714,VCU Rams,TEAM,TOTAL,TOTAL,False,,20,58,17,39,3,19,13,18,12,26,38,4,7,2,10,14,56
401422714,Stony Brook Seawolves,L. Wool,4282155,,True,29.0,3,6,2,4,1,2,4,4,0,6,6,0,1,0,4,1,11
401422714,Stony Brook Seawolves,I. Pagan,4281163,,True,30.0,4,7,4,7,0,0,3,4,6,3,9,1,0,1,4,2,11
401422714,Stony Brook Seawolves,K. Corley,4704615,,True,26.0,1,7,1,5,0,2,1,2,0,2,2,1,0,1,2,0,3
401422714,Stony Brook Seawolves,G. Gonzalez,4594370,,True,22.0,0,3,0,3,0,0,0,0,0,1,1,1,1,0,0,2,0
401422714,Stony Brook Seawolves,A. Warren,4399276,,True,35.0,2,16,0,7,2,9,0,0,2,1,3,2,0,0,1,2,6
401422714,Stony Brook Seawolves,N. Vargas-Reyes,4704613,,False,25.0,2,3,2,3,0,0,4,6,2,5,7,3,1,0,2,2,8
401422714,Stony Brook Seawolves,M. Bushee,4281161,,False,19.0,3,4,3,4,0,0,3,4,1,4,5,0,1,2,0,1,9
401422714,Stony Brook Seawolves,E. Turral,4898975,,False,14.0,0,6,0,3,0,3,0,2,1,1,2,3,2,0,1,1,0
401422714,Stony Brook Seawolves,TEAM,TOTAL,TOTAL,False,,15,52,12,36,3,16,15,22,14,26,40,11,6,4,15,11,48
401422713,Rhode Island Rams,M. Foppossi,4281216,,True,38.0,5,16,4,13,1,3,0,0,1,7,8,0,1,1,1,3,11
401422713,Rhode Island Rams,E. Tahane,4280883,,True,38.0,4,9,4,9,0,0,1,4,6,4,10,7,0,2,2,2,9
401422713,Rhode Island Rams,D. Cairns,4898523,,True,37.0,0,9,0,4,0,5,2,2,0,3,3,0,2,0,1,4,2
401422713,Rhode Island Rams,C. Williams,4281345,,True,22.0,2,11,2,6,0,5,3,4,1,2,3,2,0,0,1,5,7
401422713,Rhode Island Rams,D. Elmore,4065876,,True,26.0,3,8,3,8,0,0,3,3,2,4,6,3,2,1,1,3,9
401422713,Rhode Island Rams,M. Toure,4704153,,False,2.0,1,2,1,2,0,0,0,0,2,0,2,0,0,0,0,0,2
401422713,Rhode Island Rams,E. Rinat,4898525,,False,15.0,2,2,1,1,1,1,0,0,0,1,1,1,0,0,3,1,5
401422713,Rhode Island Rams,S. Phillips,4898522,,False,1.0,0,0,0,0,0,0,0,0,0,0,0,0,0,0,0,0,0
401422713,Rhode Island Rams,Y. Hendley,4704152,,False,1.0,0,0,0,0,0,0,0,0,0,0,0,1,0,0,0,0,0
401422713,Rhode Island Rams,R. Demeke,4703735,,False,1.0,0,1,0,1,0,0,0,0,0,0,0,0,0,0,0,0,0
401422713,Rhode Island Rams,M. Vargas,4281857,,False,19.0,2,7,1,1,1,6,0,0,1,2,3,2,0,0,0,0,5
401422713,Rhode Island Rams,TEAM,TOTAL,TOTAL,False,,19,65,16,45,3,20,9,13,16,27,43,16,5,4,9,18,50
401422713,Quinnipiac Bobcats,A. Free,4399092,,True,28.0,3,7,2,4,1,3,1,2,2,6,8,5,1,0,1,3,8
401422713,Quinnipiac Bobcats,M. Morris,4433677,,True,26.0,7,14,7,13,0,1,0,1,3,6,9,1,0,0,2,4,14
401422713,Quinnipiac Bobcats,S. Bonner,4595390,,True,35.0,3,9,2,3,1,6,2,2,3,3,6,0,0,1,3,1,9
401422713,Quinnipiac Bobcats,R. Caverly,4399294,,True,37.0,4,12,1,4,3,8,7,8,0,6,6,3,0,0,0,1,18
401422713,Quinnipiac Bobcats,M. DeWees,4399091,,True,12.0,3,5,3,5,0,0,0,0,1,1,2,0,0,0,1,1,6
401422713,Quinnipiac Bobcats,G. LaBarge,4899864,,False,1.0,0,0,0,0,0,0,0,0,0,0,0,0,0,0,0,0,0
401422713,Quinnipiac Bobcats,T. White,4704552,,False,9.0,0,0,0,0,0,0,0,0,0,0,0,0,0,0,1,2,0
401422713,Quinnipiac Bobcats,C. Haywood,4595389,,False,16.0,0,4,0,1,0,3,2,4,0,4,4,2,1,1,1,0,2
401422713,Quinnipiac Bobcats,R. Douglas,4899866,,False,1.0,0,0,0,0,0,0,0,0,0,0,0,0,0,0,0,0,0
401422713,Quinnipiac Bobcats,J. Grisdale,4899865,,False,20.0,1,2,1,1,0,1,0,0,0,1,1,0,0,0,0,2,2
401422713,Quinnipiac Bobcats,J. Casey,4704555,,False,1.0,0,0,0,0,0,0,0,0,0,0,0,0,0,0,0,0,0
401422713,Quinnipiac Bobcats,M. Helms,4433084,,False,14.0,1,4,1,3,0,1,0,0,0,3,3,0,0,0,0,1,2
401422713,Quinnipiac Bobcats,TEAM,TOTAL,TOTAL,False,,22,57,17,34,5,23,12,17,11,32,43,11,2,2,9,15,61
401422712,Oregon State Beavers,J. Mitrovic,4595897,,True,10.0,6,6,6,6,0,0,2,3,1,2,3,0,0,0,1,0,14
401422712,Oregon State Beavers,T. Corosdale,4282159,,True,25.0,2,4,2,3,0,1,2,2,1,8,9,4,0,1,1,2,6
401422712,Oregon State Beavers,E. Mack,4068241,,True,38.0,5,11,4,8,1,3,0,0,1,3,4,5,1,0,5,0,11
401422712,Oregon State Beavers,T. von Oelhoffen,4713193,,True,17.0,2,6,1,3,1,3,0,0,0,3,3,2,1,0,4,2,5
401422712,Oregon State Beavers,E. Codding,4282102,,True,20.0,0,1,0,1,0,0,0,0,1,3,4,1,0,2,3,1,0
401422712,Oregon State Beavers,K. Brown,4433291,,False,30.0,5,8,5,7,0,1,5,7,2,10,12,1,0,2,2,2,15
401422712,Oregon State Beavers,A. Marotte,4691697,,False,11.0,1,4,1,2,0,2,0,0,0,1,1,2,0,0,0,0,2
401422712,Oregon State Beavers,N. Mannen,4595896,,False,9.0,2,2,1,1,1,1,0,0,0,1,1,1,0,0,1,2,5
401422712,Oregon State Beavers,G. Kampschroeder,4433796,,False,22.0,2,5,2,4,0,1,2,4,0,4,4,2,0,1,2,1,6
401422712,Oregon State Beavers,T. Adams,4281876,,False,18.0,2,2,2,2,0,0,2,4,0,4,4,1,0,0,1,1,6
401422712,Oregon State Beavers,TEAM,TOTAL,TOTAL,False,,27,49,24,37,3,12,13,20,8,42,50,19,2,6,20,11,70
401422712,Long Beach State Beach,M. Utti,4281828,,True,25.0,2,7,1,6,1,1,2,2,3,7,10,0,4,0,0,2,7
401422712,Long Beach State Beach,S. Tucker,4704394,,True,20.0,0,6,0,4,0,2,0,0,2,1,3,0,0,0,0,2,0
401422712,Long Beach State Beach,K. Hamilton-Fisher,4400055,,True,32.0,6,16,1,8,5,8,0,0,2,6,8,1,5,0,0,5,17
401422712,Long Beach State Beach,J. Hardy,4400053,,True,31.0,2,8,2,4,0,4,0,0,0,1,1,1,3,1,0,4,4
401422712,Long Beach State Beach,J. King,4400052,,True,36.0,6,23,4,17,2,6,6,9,0,0,0,4,0,1,0,2,20
401422712,Long Beach State Beach,E. Sullivan,4703791,,False,2.0,0,1,0,0,0,1,0,0,0,0,0,0,0,0,0,1,0
401422712,Long Beach State Beach,L. Green,4400054,,False,8.0,0,1,0,1,0,0,0,0,0,0,0,0,0,0,0,2,0
401422712,Long Beach State Beach,K. Jeskeova,4595201,,False,23.0,3,8,1,3,2,5,1,1,2,4,6,0,2,2,2,4,9
401422712,Long Beach State Beach,M. Berry,4281701,,False,23.0,1,5,1,5,0,0,0,0,0,0,0,2,2,0,1,1,2
401422712,Long Beach State Beach,TEAM,TOTAL,TOTAL,False,,20,75,10,48,10,27,9,12,13,19,32,8,16,4,3,23,59
401422711,San Diego Toreros,K. Bird,4282108,,True,28.0,5,14,5,14,0,0,0,4,3,8,11,0,2,1,3,3,10
401422711,San Diego Toreros,E. Martinsen,4595849,,True,21.0,2,7,1,3,1,4,2,2,2,2,4,1,2,1,2,0,7
401422711,San Diego Toreros,K. Oakry,4400499,,True,30.0,4,7,3,5,1,2,2,3,2,2,4,3,1,0,0,1,11
401422711,San Diego Toreros,S. Gorman,4400189,,True,35.0,6,17,4,11,2,6,8,11,0,3,3,5,9,0,2,1,22
401422711,San Diego Toreros,S. Hunter,4282109,,True,30.0,5,12,5,12,0,0,4,4,1,6,7,1,0,0,3,2,14
401422711,San Diego Toreros,L. Erikstrup,4703852,,False,9.0,2,5,2,4,0,1,0,0,0,1,1,0,0,0,2,1,4
401422711,San Diego Toreros,K. Neubert,4433711,,False,10.0,0,1,0,1,0,0,0,0,2,0,2,1,0,0,0,0,0
401422711,San Diego Toreros,H. Kaur,4899403,,False,3.0,1,1,1,1,0,0,0,0,0,1,1,0,0,0,1,0,2
401422711,San Diego Toreros,K. Horstmeyer,4714247,,False,17.0,1,4,1,4,0,0,2,2,1,0,1,3,0,0,1,0,4
401422711,San Diego Toreros,G. Giuffre,4703853,,False,3.0,0,0,0,0,0,0,0,0,0,1,1,1,0,0,2,1,0
401422711,San Diego Toreros,A. Khalfani,4595847,,False,14.0,1,1,1,1,0,0,0,2,2,2,4,1,0,0,2,4,2
401422711,San Diego Toreros,TEAM,TOTAL,TOTAL,False,,27,69,23,56,4,13,18,28,19,26,45,16,14,2,18,13,76
401422711,California Baptist Lancers,C. Harper,4419354,,True,38.0,8,11,7,8,1,3,2,2,1,8,9,1,1,3,3,2,19
401422711,California Baptist Lancers,T. San Antonio,4900098,,True,28.0,5,12,3,8,2,4,0,0,1,3,4,3,1,1,3,4,12
401422711,California Baptist Lancers,N. Avila-Ambrosi,4703947,,True,24.0,2,5,1,1,1,4,0,0,1,1,2,0,0,0,0,2,5
401422711,California Baptist Lancers,S. Palma,4419349,,True,25.0,1,5,1,4,0,1,1,2,0,6,6,3,3,0,0,4,3
401422711,California Baptist Lancers,A. Olaeta,4419341,,True,33.0,6,10,6,10,0,0,4,6,1,2,3,5,1,1,7,1,16
401422711,California Baptist Lancers,B. Thomas,4419353,,False,13.0,3,4,3,4,0,0,0,0,0,5,5,0,0,1,1,4,6
401422711,California Baptist Lancers,T. Neale,4598110,,False,18.0,0,2,0,0,0,2,1,2,0,1,1,1,1,0,1,2,1
401422711,California Baptist Lancers,G. Dale,4419346,,False,11.0,2,3,1,1,1,2,0,1,0,1,1,2,1,0,3,2,5
401422711,California Baptist Lancers,B. Klaman,4281618,,False,10.0,0,1,0,1,0,0,0,0,0,1,1,3,0,0,3,0,0
401422711,California Baptist Lancers,TEAM,TOTAL,TOTAL,False,,27,53,22,37,5,16,8,13,4,29,33,18,8,6,22,21,67
401422710,Wyoming Cowgirls,A. Fertig,4900606,,True,28.0,6,9,6,9,0,0,2,3,8,3,11,0,1,1,2,0,14
401422710,Wyoming Cowgirls,M. Bradshaw,4595681,,True,33.0,1,10,1,5,0,5,0,0,0,6,6,1,1,0,4,0,2
401422710,Wyoming Cowgirls,Q. Weidemann,4400207,,True,38.0,8,12,7,10,1,2,8,8,1,1,2,2,3,0,3,3,25
401422710,Wyoming Cowgirls,A. Sanchez Ramos,4400204,,True,36.0,5,10,4,9,1,1,3,5,0,3,3,2,0,1,2,5,14
401422710,Wyoming Cowgirls,T. Olson,4400203,,True,38.0,2,6,2,4,0,2,4,4,0,5,5,2,0,0,0,1,8
401422710,Wyoming Cowgirls,P. Salazar,4704659,,False,8.0,0,3,0,2,0,1,1,2,1,0,1,0,0,0,0,0,1
401422710,Wyoming Cowgirls,G. Ellis,4704657,,False,19.0,1,1,1,1,0,0,2,2,0,3,3,0,0,0,2,1,4
401422710,Wyoming Cowgirls,E. Mellema,4900607,,False,25.0,3,7,1,5,2,2,0,0,0,2,2,2,0,0,0,1,8
401422710,Wyoming Cowgirls,TEAM,TOTAL,TOTAL,False,,26,58,22,45,4,13,20,24,11,23,34,9,5,2,14,11,76
401422710,Idaho State Bengals,E. Smith,4281638,,True,13.0,4,7,4,7,0,0,0,0,1,1,2,0,0,0,2,5,8
401422710,Idaho State Bengals,T. Whitman,4594829,,True,39.0,3,6,3,6,0,0,0,0,2,4,6,4,1,0,2,1,6
401422710,Idaho State Bengals,C. Bourne,4399905,,True,38.0,4,8,3,6,1,2,4,4,1,4,5,1,1,0,0,4,13
401422710,Idaho State Bengals,D. Goles,4281636,,True,40.0,8,14,3,7,5,7,3,3,0,2,2,2,0,0,3,3,24
401422710,Idaho State Bengals,E. Ors,4068698,,True,36.0,4,8,3,5,1,3,1,1,0,4,4,5,3,1,3,2,10
401422710,Idaho State Bengals,M. Oltrogge,4399907,,False,34.0,5,14,4,7,1,7,1,2,1,4,5,3,0,0,2,5,12
401422710,Idaho State Bengals,A. Bernard,4899042,,False,4.0,0,0,0,0,0,0,0,0,0,1,1,0,0,0,1,0,0
401422710,Idaho State Bengals,F. Garnett,4704767,,False,17.0,0,2,0,1,0,1,0,0,2,3,5,0,0,0,1,1,0
401422710,Idaho State Bengals,J. Sweeney,4594833,,False,4.0,0,0,0,0,0,0,0,0,0,0,0,0,0,0,0,1,0
401422710,Idaho State Bengals,TEAM,TOTAL,TOTAL,False,,28,59,20,39,8,20,9,10,8,23,31,15,5,1,15,22,73
401422709,Tulsa Golden Hurricane,T. Poindexter,4898634,,True,15.0,4,7,4,5,0,2,1,1,0,4,4,0,3,0,3,4,9
401422709,Tulsa Golden Hurricane,W. Mayberry,4703707,,True,39.0,4,11,3,6,1,5,6,6,1,2,3,4,2,1,2,2,15
401422709,Tulsa Golden Hurricane,M. Bittle,4399250,,True,37.0,6,11,3,4,3,7,8,8,2,5,7,1,0,0,1,3,23
401422709,Tulsa Golden Hurricane,M. Mayberry,4282492,,True,38.0,5,9,4,5,1,4,1,2,1,2,3,3,0,0,0,1,12
401422709,Tulsa Golden Hurricane,R. Lescay,4281104,,True,13.0,0,4,0,4,0,0,0,0,0,2,2,0,0,0,2,4,0
401422709,Tulsa Golden Hurricane,J. Evans,4703708,,False,28.0,2,9,2,6,0,3,0,0,2,7,9,0,2,2,0,4,4
401422709,Tulsa Golden Hurricane,D. Crawford,4898637,,False,30.0,5,7,3,3,2,4,0,0,2,5,7,2,0,0,1,4,12
401422709,Tulsa Golden Hurricane,TEAM,TOTAL,TOTAL,False,,26,58,19,33,7,25,16,17,9,29,38,10,7,3,10,22,75
401422709,North Texas Mean Green,J. Mallard,4596040,,True,29.0,3,5,3,5,0,0,0,0,1,2,3,0,0,0,2,1,6
401422709,North Texas Mean Green,M. Townley,4399531,,True,26.0,1,3,1,3,0,0,2,4,1,4,5,0,0,0,1,1,4
401422709,North Texas Mean Green,J. Jackson,4595018,,True,39.0,1,5,1,4,0,1,1,4,2,1,3,4,0,0,2,3,3
401422709,North Texas Mean Green,Q. Noble,4400145,,True,38.0,6,19,3,12,3,7,0,1,1,7,8,5,0,0,3,1,15
401422709,North Texas Mean Green,A. Gamez,4281826,,True,23.0,2,6,2,4,0,2,0,2,0,7,7,0,2,0,2,4,4
401422709,North Texas Mean Green,E. Villas-Gomis,4594758,,False,2.0,0,0,0,0,0,0,0,0,0,1,1,0,0,0,0,0,0
401422709,North Texas Mean Green,T. Lampkin,4433476,,False,4.0,1,1,1,1,0,0,2,2,0,0,0,0,0,0,0,1,4
401422709,North Texas Mean Green,K. McGruder,4899377,,False,9.0,1,2,0,1,1,1,0,2,0,0,0,0,0,0,0,1,3
401422709,North Texas Mean Green,A. Dixon,4281784,,False,30.0,8,12,8,12,0,0,7,9,0,1,1,0,2,1,0,3,23
401422709,North Texas Mean Green,TEAM,TOTAL,TOTAL,False,,23,53,19,42,4,11,12,24,6,24,30,9,4,1,10,15,62
401422708,Missouri Tigers,H. Frank,4433637,,True,39.0,3,10,1,2,2,8,3,4,0,4,4,4,1,3,0,3,11
401422708,Missouri Tigers,M. Dembele,4704449,,True,41.0,1,3,1,2,0,1,1,1,0,5,5,3,1,0,3,3,3
401422708,Missouri Tigers,L. Hansen,4432951,,True,21.0,2,6,1,3,1,3,0,0,1,3,4,1,1,0,1,1,5
401422708,Missouri Tigers,A. Blackwell,4432833,,True,33.0,9,14,5,9,4,5,5,8,0,10,10,1,3,1,3,4,27
401422708,Missouri Tigers,H. Troup,4280879,,True,34.0,1,7,0,3,1,4,3,4,0,1,1,3,0,1,0,2,6
401422708,Missouri Tigers,L. Williams,4280886,,False,10.0,3,3,3,3,0,0,0,0,1,1,2,0,0,2,3,1,6
401422708,Missouri Tigers,J. Kelly,4433470,,False,6.0,2,3,2,3,0,0,0,0,0,0,0,0,1,0,2,2,4
401422708,Missouri Tigers,S. Smith,4704448,,False,10.0,1,3,1,1,0,2,0,0,0,1,1,0,1,1,0,0,2
401422708,Missouri Tigers,I. Higginbottom,4434013,,False,31.0,6,9,5,7,1,2,1,2,1,2,3,1,0,0,2,1,14
401422708,Missouri Tigers,TEAM,TOTAL,TOTAL,False,,28,58,19,33,9,25,13,19,3,30,33,13,8,8,15,17,78
401422708,Drake Bulldogs,M. Bair,4595576,,True,34.0,6,15,5,11,1,4,2,4,2,5,7,1,1,1,2,5,15
401422708,Drake Bulldogs,G. Berg,4398741,,True,32.0,2,7,2,3,0,4,0,0,0,4,4,7,0,0,3,2,4
401422708,Drake Bulldogs,K. Dinnebier,4900053,,True,25.0,1,5,1,2,0,3,6,6,0,3,3,3,1,0,1,2,8
401422708,Drake Bulldogs,M. Meyer,4433118,,True,33.0,6,13,3,6,3,7,0,0,1,3,4,3,0,0,3,0,15
401422708,Drake Bulldogs,M. Petersen,4282208,,True,33.0,9,12,5,5,4,7,0,0,2,3,5,2,0,0,2,0,22
401422708,Drake Bulldogs,A. Miller,4900055,,False,11.0,1,5,1,3,0,2,0,0,1,3,4,1,0,0,2,2,2
401422708,Drake Bulldogs,C. Becker,4704842,,False,3.0,0,2,0,2,0,0,0,0,0,0,0,0,0,1,0,0,0
401422708,Drake Bulldogs,A. Wooldridge,4399376,,False,10.0,0,0,0,0,0,0,0,0,2,2,4,2,1,0,2,0,0
401422708,Drake Bulldogs,S. Gueldner,4433721,,False,30.0,6,10,1,3,5,7,0,0,0,4,4,2,1,1,0,2,17
401422708,Drake Bulldogs,H. Fuller,4282209,,False,14.0,0,1,0,1,0,0,0,0,1,2,3,2,0,0,0,2,0
401422708,Drake Bulldogs,TEAM,TOTAL,TOTAL,False,,31,70,18,36,13,34,8,10,10,31,41,23,4,3,15,15,83
401422707,Vanderbilt Commodores,S. Washington,4433999,,True,28.0,8,14,8,14,0,0,0,1,3,3,6,0,0,1,0,1,16
401422707,Vanderbilt Commodores,K. Smith,4433301,,True,27.0,2,8,2,8,0,0,0,0,1,1,2,2,0,0,0,3,4
401422707,Vanderbilt Commodores,I. Moore,4433536,,True,36.0,6,12,3,6,3,6,1,2,1,1,2,5,3,1,5,3,16
401422707,Vanderbilt Commodores,B. LaChance,4433502,,True,20.0,1,2,1,2,0,0,1,2,1,0,1,1,1,0,0,3,3
401422707,Vanderbilt Commodores,J. Cambridge,4398773,,True,36.0,9,19,4,10,5,9,1,2,3,6,9,6,5,0,4,3,24
401422707,Vanderbilt Commodores,K. Cheesman,4899544,,False,5.0,0,0,0,0,0,0,0,0,0,0,0,0,0,0,0,2,0
401422707,Vanderbilt Commodores,Y. Chambers,4433659,,False,21.0,3,5,3,5,0,0,1,2,1,4,5,2,2,1,2,2,7
401422707,Vanderbilt Commodores,D. Flournoy,4683036,,False,14.0,1,4,1,1,0,3,1,1,1,1,2,2,3,0,2,1,3
401422707,Vanderbilt Commodores,D. Washington,4433002,,False,13.0,0,2,0,2,0,0,0,0,1,1,2,0,0,0,0,0,0
401422707,Vanderbilt Commodores,TEAM,TOTAL,TOTAL,False,,30,66,22,48,8,18,5,10,14,23,37,18,14,3,13,18,73
401422707,Murray State Racers,K. Young,4705055,,True,34.0,2,7,2,7,0,0,6,6,1,3,4,2,0,1,2,3,10
401422707,Murray State Racers,H. McKay,4705053,,True,35.0,2,6,0,2,2,4,3,4,1,8,9,2,2,0,6,2,9
401422707,Murray State Racers,A. Burpo,4400412,,True,34.0,4,8,4,8,0,0,0,0,1,3,4,1,1,0,2,1,8
401422707,Murray State Racers,M. Turley,4400410,,True,32.0,3,8,0,3,3,5,4,4,0,6,6,1,1,0,6,1,13
401422707,Murray State Racers,L. Mayes,4400409,,True,32.0,1,3,0,0,1,3,0,0,0,2,2,2,2,1,1,0,3
401422707,Murray State Racers,J. Black,4900211,,False,6.0,0,0,0,0,0,0,0,0,1,1,2,0,0,0,1,3,0
401422707,Murray State Racers,C. Settle,4705056,,False,2.0,0,0,0,0,0,0,0,2,0,1,1,0,0,0,0,0,0
401422707,Murray State Racers,C. Conner,4900210,,False,9.0,0,2,0,1,0,1,0,0,0,0,0,0,1,0,0,0,0
401422707,Murray State Racers,B. Sanders-Woods,4705052,,False,12.0,2,4,2,4,0,0,0,0,0,0,0,1,0,1,2,1,4
401422707,Murray State Racers,R. Blackburn,4400406,,False,4.0,0,3,0,0,0,3,0,0,0,0,0,0,0,0,0,0,0
401422707,Murray State Racers,TEAM,TOTAL,TOTAL,False,,14,41,8,25,6,16,13,16,5,26,31,9,7,3,23,12,47
401422706,Minnesota Golden Gophers,K. Sissoko,4398731,,True,37.0,5,17,4,16,1,1,7,9,5,9,14,1,0,0,4,3,18
401422706,Minnesota Golden Gophers,L. Bagwell-Katalinich,4068594,,True,22.0,2,4,2,4,0,0,0,0,1,1,2,1,2,1,0,2,4
401422706,Minnesota Golden Gophers,S. Scalia,4433394,,True,40.0,11,26,7,10,4,16,7,7,2,5,7,5,2,0,1,0,33
401422706,Minnesota Golden Gophers,D. Winters,4068126,,True,22.0,1,4,1,3,0,1,0,0,1,3,4,0,1,1,1,4,2
401422706,Minnesota Golden Gophers,G. Hubbard,4068036,,True,36.0,4,6,1,2,3,4,1,2,1,2,3,3,1,0,1,1,12
401422706,Minnesota Golden Gophers,A. Micheaux,4899054,,False,9.0,0,1,0,1,0,0,0,0,1,0,1,0,0,1,2,1,0
401422706,Minnesota Golden Gophers,B. Helgren,4281306,,False,12.0,0,1,0,1,0,0,0,0,0,2,2,0,0,0,0,0,0
401422706,Minnesota Golden Gophers,A. Smith,4433742,,False,22.0,1,2,1,1,0,1,2,4,0,5,5,1,0,0,3,1,4
401422706,Minnesota Golden Gophers,TEAM,TOTAL,TOTAL,False,,24,61,16,38,8,23,17,22,11,28,39,11,6,3,12,12,73
401422706,Green Bay Phoenix,J. Kondrakiewicz,4705095,,True,22.0,2,9,1,6,1,3,1,2,2,5,7,2,0,0,2,2,6
401422706,Green Bay Phoenix,M. Schreiber,4899149,,True,33.0,4,8,1,4,3,4,2,2,3,2,5,2,0,0,1,2,13
401422706,Green Bay Phoenix,C. Schiltz,4595334,,True,19.0,0,4,0,3,0,1,0,0,0,0,0,1,0,0,1,0,0
401422706,Green Bay Phoenix,H. Oskey,4399705,,True,27.0,5,12,5,7,0,5,3,3,0,3,3,3,0,0,3,5,13
401422706,Green Bay Phoenix,M. Pingel,4068968,,True,30.0,2,6,2,4,0,2,0,0,2,2,4,6,1,1,2,2,4
401422706,Green Bay Phoenix,J. Hartwig,4595335,,False,10.0,1,2,1,2,0,0,0,0,1,3,4,0,1,0,1,1,2
401422706,Green Bay Phoenix,B. Butler,4899147,,False,22.0,1,4,0,2,1,2,0,0,0,1,1,3,1,0,4,2,3
401422706,Green Bay Phoenix,C. Givens,4705092,,False,0.0,0,0,0,0,0,0,0,0,0,0,0,0,0,0,0,0,0
401422706,Green Bay Phoenix,C. Genke,4691702,,False,15.0,2,5,2,3,0,2,0,0,2,3,5,0,0,0,0,1,4
401422706,Green Bay Phoenix,S. Levy,4399718,,False,22.0,8,16,4,7,4,9,0,0,0,5,5,0,0,0,1,5,20
401422706,Green Bay Phoenix,TEAM,TOTAL,TOTAL,False,,25,66,16,38,9,28,6,7,12,24,36,17,3,1,15,20,65
401422705,Tennessee Tech Golden Eagles,A. Walker,4704229,,True,30.0,5,12,4,8,1,4,2,2,4,4,8,4,1,2,0,2,13
401422705,Tennessee Tech Golden Eagles,M. Coleman,4282489,,True,25.0,4,8,2,6,2,2,3,4,2,9,11,1,1,0,0,3,13
401422705,Tennessee Tech Golden Eagles,A. Jones,4649322,,True,34.0,8,14,8,13,0,1,3,5,2,5,7,0,0,1,5,2,19
401422705,Tennessee Tech Golden Eagles,J. Guinn,4595968,,True,35.0,2,6,2,6,0,0,3,5,2,6,8,6,1,2,2,1,7
401422705,Tennessee Tech Golden Eagles,M. Clark,4282483,,True,23.0,2,4,1,1,1,3,1,2,0,1,1,2,0,0,0,1,6
401422705,Tennessee Tech Golden Eagles,P. Carter,4705014,,False,11.0,1,2,0,0,1,2,0,0,0,0,0,1,0,0,0,2,3
401422705,Tennessee Tech Golden Eagles,M. Owens,4595967,,False,19.0,2,8,2,4,0,4,0,0,1,1,2,2,0,0,1,3,4
401422705,Tennessee Tech Golden Eagles,K. Brady,4282486,,False,23.0,2,8,2,6,0,2,4,5,1,2,3,0,1,1,1,1,8
401422705,Tennessee Tech Golden Eagles,TEAM,TOTAL,TOTAL,False,,26,62,21,44,5,18,16,23,13,30,43,16,4,6,13,15,73
401422705,SMU Mustangs,D. Sanderlin,4282048,,True,28.0,1,4,1,4,0,0,1,2,2,4,6,1,0,0,1,1,3
401422705,SMU Mustangs,S. Wilkinson,4281175,,True,37.0,8,20,8,20,0,0,4,4,3,7,10,1,1,1,2,5,20
401422705,SMU Mustangs,K. White,4399236,,True,27.0,5,10,5,10,0,0,6,7,1,2,3,0,0,1,1,4,16
401422705,SMU Mustangs,S. Wiggins,4281805,,True,35.0,4,13,2,7,2,6,0,0,1,4,5,4,1,3,1,4,10
401422705,SMU Mustangs,J. Smith,6961,,True,37.0,4,7,4,4,0,3,1,4,0,3,3,8,1,2,5,0,9
401422705,SMU Mustangs,P. Bayliss,4399232,,False,3.0,0,1,0,1,0,0,0,0,0,0,0,0,0,0,0,0,0
401422705,SMU Mustangs,T. Criswell,4898629,,False,1.0,0,0,0,0,0,0,0,0,1,0,1,0,0,0,0,1,0
401422705,SMU Mustangs,Z. Rufus,4898628,,False,5.0,0,0,0,0,0,0,0,0,0,0,0,0,0,0,1,1,0
401422705,SMU Mustangs,D. Mathis,4594529,,False,4.0,0,0,0,0,0,0,0,0,0,2,2,1,0,0,0,2,0
401422705,SMU Mustangs,R. Bradley,4433337,,False,15.0,2,7,2,4,0,3,0,0,2,0,2,1,0,0,0,2,4
401422705,SMU Mustangs,K. Warthen,4281256,,False,10.0,0,0,0,0,0,0,0,0,0,2,2,1,0,1,0,0,0
401422705,SMU Mustangs,TEAM,TOTAL,TOTAL,False,,24,62,22,50,2,12,12,17,10,25,35,17,3,8,11,20,62
401422704,South Dakota State Jackrabbits,T. Nelson,4595883,,True,31.0,6,12,5,8,1,4,2,4,1,2,3,5,0,1,0,0,15
401422704,South Dakota State Jackrabbits,P. Burckhard,4399649,,True,24.0,7,12,7,9,0,3,2,4,0,0,0,2,1,0,0,3,16
401422704,South Dakota State Jackrabbits,M. Selland,4282531,,True,26.0,3,6,1,2,2,4,2,4,3,9,12,4,2,1,1,0,10
401422704,South Dakota State Jackrabbits,H. Timmer,4899819,,True,30.0,8,11,4,6,4,5,4,5,2,6,8,3,1,0,3,2,24
401422704,South Dakota State Jackrabbits,T. Irwin,4282530,,True,28.0,2,5,1,3,1,2,2,2,2,4,6,1,1,1,2,0,7
401422704,South Dakota State Jackrabbits,M. Byom,4704383,,False,3.0,0,1,0,1,0,0,0,0,1,0,1,0,0,0,0,0,0
401422704,South Dakota State Jackrabbits,M. Vlastuin,4704382,,False,3.0,0,0,0,0,0,0,0,0,0,0,0,0,0,0,1,0,0
401422704,South Dakota State Jackrabbits,K. Theisen,4595882,,False,15.0,4,5,4,5,0,0,2,3,0,3,3,0,0,1,3,1,10
401422704,South Dakota State Jackrabbits,A. Hirschman,4399651,,False,3.0,1,1,1,1,0,0,0,0,0,0,0,0,0,0,0,0,2
401422704,South Dakota State Jackrabbits,L. Rongisch,4399647,,False,3.0,1,2,1,1,0,1,0,0,0,0,0,0,0,0,0,1,2
401422704,South Dakota State Jackrabbits,L. Theuninck,4282529,,False,17.0,0,1,0,0,0,1,1,2,4,2,6,4,1,0,6,4,1
401422704,South Dakota State Jackrabbits,H. Greer,4068252,,False,17.0,0,5,0,0,0,5,0,0,2,3,5,4,1,1,1,2,0
401422704,South Dakota State Jackrabbits,TEAM,TOTAL,TOTAL,False,,32,61,24,36,8,25,15,24,17,33,50,23,7,5,17,13,87
401422704,Ohio Bobcats,G. Burris,4282121,,True,31.0,3,8,2,3,1,5,2,2,2,7,9,0,0,2,1,1,9
401422704,Ohio Bobcats,E. Johnson,4282118,,True,27.0,2,13,1,4,1,9,0,0,0,2,2,2,1,0,4,2,5
401422704,Ohio Bobcats,M. Mace,4613137,,True,20.0,0,4,0,1,0,3,0,0,2,0,2,0,0,0,6,2,0
401422704,Ohio Bobcats,K. Bambule,4282120,,True,19.0,1,4,0,0,1,4,0,0,0,0,0,0,1,0,0,2,3
401422704,Ohio Bobcats,C. Hooks,4282117,,True,33.0,7,20,6,17,1,3,3,3,4,3,7,2,4,0,1,3,18
401422704,Ohio Bobcats,A. Antonova,4399349,,False,6.0,0,1,0,0,0,1,0,0,0,1,1,0,0,0,0,0,0
401422704,Ohio Bobcats,Y. Felder,4900084,,False,21.0,10,14,10,12,0,2,0,3,4,2,6,0,3,0,1,4,20
401422704,Ohio Bobcats,K. Dennis,4710736,,False,14.0,0,1,0,0,0,1,0,0,0,0,0,0,1,0,0,2,0
401422704,Ohio Bobcats,P. Guice,4433665,,False,23.0,1,4,1,2,0,2,0,0,0,0,0,1,0,0,1,4,2
401422704,Ohio Bobcats,H. Rogan,4399347,,False,6.0,0,1,0,1,0,0,0,0,1,0,1,0,0,1,0,1,0
401422704,Ohio Bobcats,TEAM,TOTAL,TOTAL,False,,24,70,20,40,4,30,5,8,15,16,31,5,10,3,15,21,57
401422703,San Francisco Dons,K. Dickie,4594824,,True,18.0,1,4,0,3,1,1,0,0,1,4,5,0,1,0,2,3,3
401422703,San Francisco Dons,L. Kostic,4400509,,True,20.0,0,0,0,0,0,0,2,2,0,6,6,2,0,1,4,1,2
401422703,San Francisco Dons,I. Krimili,4595863,,True,36.0,6,16,3,11,3,5,0,0,1,2,3,2,0,0,4,2,15
401422703,San Francisco Dons,J. Gayles,4594849,,True,40.0,8,14,6,9,2,5,3,7,1,5,6,1,2,0,3,4,21
401422703,San Francisco Dons,J. McDowell-White,4399895,,True,36.0,1,2,1,1,0,1,2,2,0,3,3,4,2,0,2,1,4
401422703,San Francisco Dons,C. Langarita,4899413,,False,22.0,5,11,5,10,0,1,0,2,0,5,5,1,0,1,3,1,10
401422703,San Francisco Dons,M. Klavina,4400506,,False,5.0,1,1,1,1,0,0,0,0,0,1,1,1,0,0,1,1,2
401422703,San Francisco Dons,K. Vaalavirta,4400504,,False,23.0,1,4,1,4,0,0,1,2,0,1,1,1,1,0,1,2,3
401422703,San Francisco Dons,TEAM,TOTAL,TOTAL,False,,23,52,17,39,6,13,8,15,4,31,35,12,6,2,20,15,60
401422703,Air Force Falcons,R. Snyder,4399409,,True,35.0,4,15,3,9,1,6,6,6,0,6,6,2,1,0,3,4,15
401422703,Air Force Falcons,H. Jones,4399403,,True,28.0,1,4,1,4,0,0,0,0,5,4,9,0,1,0,3,3,2
401422703,Air Force Falcons,J. Huntimer,4899763,,True,19.0,0,1,0,1,0,0,0,0,1,0,1,3,1,0,3,2,0
401422703,Air Force Falcons,K. Heath,4595614,,True,27.0,7,13,7,13,0,0,0,0,1,3,4,0,1,0,0,3,14
401422703,Air Force Falcons,C. Winters,4399406,,True,31.0,5,14,5,11,0,3,5,7,0,5,5,4,6,1,4,4,15
401422703,Air Force Falcons,D. MacMillan,4704414,,False,0.0,0,0,0,0,0,0,0,0,0,0,0,0,0,0,0,0,0
401422703,Air Force Falcons,N. McDonald,4595618,,False,15.0,1,3,0,0,1,3,0,0,0,2,2,2,1,0,0,0,3
401422703,Air Force Falcons,L. McDonald,4899761,,False,24.0,4,10,2,6,2,4,0,0,0,4,4,1,0,0,0,0,10
401422703,Air Force Falcons,T. Britt,4704412,,False,4.0,0,2,0,2,0,0,0,0,0,0,0,1,0,0,0,1,0
401422703,Air Force Falcons,K. Pilson,4704411,,False,17.0,2,3,1,2,1,1,0,0,0,1,1,2,1,0,1,3,5
401422703,Air Force Falcons,TEAM,TOTAL,TOTAL,False,,24,65,19,48,5,17,11,13,10,29,39,15,12,1,15,20,64
401422702,Tulane Green Wave,M. Heide,4399249,,True,22.0,2,3,1,2,1,1,0,0,2,6,8,0,1,1,1,1,5
401422702,Tulane Green Wave,K. Freeman,4281110,,True,22.0,5,10,3,8,2,2,2,2,0,5,5,3,1,3,0,1,14
401422702,Tulane Green Wave,D. Jones,4399247,,True,21.0,4,5,3,4,1,1,1,2,0,2,2,4,0,0,2,2,10
401422702,Tulane Green Wave,A. Clark,4282592,,True,22.0,3,5,3,5,0,0,0,0,0,0,0,5,2,0,3,1,6
401422702,Tulane Green Wave,M. Ursin,4281254,,True,22.0,6,7,5,6,1,1,2,2,0,6,6,3,0,0,1,0,15
401422702,Tulane Green Wave,I. Parau,4594537,,False,16.0,1,4,1,4,0,0,0,0,2,6,8,2,0,1,0,0,2
401422702,Tulane Green Wave,A. Grant,4594536,,False,11.0,1,2,1,2,0,0,0,0,1,4,5,1,1,2,1,0,2
401422702,Tulane Green Wave,K. Warmsley,4704536,,False,9.0,0,3,0,2,0,1,0,0,0,1,1,0,1,0,1,1,0
401422702,Tulane Green Wave,Marta Galic,4400505,,False,11.0,2,4,1,2,1,2,1,2,1,1,2,1,0,2,1,0,6
401422702,Tulane Green Wave,K. Middleton,4898649,,False,5.0,0,1,0,0,0,1,0,0,0,0,0,0,0,0,0,0,0
401422702,Tulane Green Wave,C. Grattini,4703697,,False,7.0,0,2,0,2,0,0,0,0,0,1,1,1,0,0,1,0,0
401422702,Tulane Green Wave,M. Carter,4703696,,False,7.0,0,1,0,0,0,1,2,2,0,0,0,0,0,0,0,0,2
401422702,Tulane Green Wave,S. Cheatham,4281109,,False,14.0,3,6,0,2,3,4,0,0,1,1,2,0,1,0,0,0,9
401422702,Tulane Green Wave,K. Anderson,4281107,,False,11.0,3,5,0,1,3,4,0,0,0,0,0,3,0,0,0,0,9
401422702,Tulane Green Wave,TEAM,TOTAL,TOTAL,False,,30,58,18,40,12,18,8,10,9,35,44,23,7,9,11,6,80
401422702,Jacksonville State Gamecocks,K. Griffin,4705593,,True,21.0,1,8,0,0,1,8,0,0,0,5,5,1,1,0,1,1,3
401422702,Jacksonville State Gamecocks,K. Gavin,4281809,,True,22.0,1,5,1,5,0,0,0,0,3,6,9,1,0,0,2,1,2
401422702,Jacksonville State Gamecocks,I. Martin,4705591,,True,25.0,1,11,0,2,1,9,2,2,0,0,0,2,0,0,0,0,5
401422702,Jacksonville State Gamecocks,N. Thompson,4595972,,True,28.0,1,3,0,0,1,3,0,0,0,1,1,4,1,0,4,2,3
401422702,Jacksonville State Gamecocks,K. Johnson,4282440,,True,34.0,7,16,5,12,2,4,2,2,0,0,0,0,0,0,5,1,18
401422702,Jacksonville State Gamecocks,M. McCoy,4898935,,False,25.0,0,3,0,2,0,1,0,0,0,3,3,1,0,0,0,2,0
401422702,Jacksonville State Gamecocks,B. Rhodes,4898934,,False,4.0,0,1,0,1,0,0,0,0,0,0,0,0,0,0,0,2,0
401422702,Jacksonville State Gamecocks,W. Kuimi,4595974,,False,9.0,0,1,0,1,0,0,0,0,0,1,1,0,0,0,0,0,0
401422702,Jacksonville State Gamecocks,K. Burnett,4705592,,False,11.0,1,1,0,0,1,1,0,0,1,0,1,0,0,0,1,1,3
401422702,Jacksonville State Gamecocks,K. Williams,4705590,,False,9.0,0,3,0,1,0,2,0,0,0,0,0,0,0,0,1,0,0
401422702,Jacksonville State Gamecocks,S. Shaw,4400608,,False,12.0,1,6,1,5,0,1,0,0,2,3,5,0,0,0,2,0,2
401422702,Jacksonville State Gamecocks,TEAM,TOTAL,TOTAL,False,,13,58,7,29,6,29,4,4,10,20,30,9,2,0,16,10,36
401422701,Louisiana Tech Lady Techsters,A. Roberson,4595004,,True,25.0,4,9,3,7,1,2,2,4,0,4,4,0,0,0,1,4,11
401422701,Louisiana Tech Lady Techsters,A. Brannon,4899084,,True,34.0,2,7,1,4,1,3,0,0,0,7,7,0,3,0,4,0,5
401422701,Louisiana Tech Lady Techsters,S. Nativi,4899083,,True,18.0,1,1,1,1,0,0,0,0,0,2,2,1,0,0,3,0,2
401422701,Louisiana Tech Lady Techsters,S. Bates,4433173,,True,36.0,4,8,3,6,1,2,1,2,0,1,1,0,0,0,6,0,10
401422701,Louisiana Tech Lady Techsters,K. Walker,4399516,,True,33.0,7,16,7,14,0,2,4,5,1,5,6,2,1,0,1,3,18
401422701,Louisiana Tech Lady Techsters,K. Thompson,4703773,,False,8.0,1,1,1,1,0,0,0,0,0,1,1,0,0,0,1,0,2
401422701,Louisiana Tech Lady Techsters,J. Davis,4281796,,False,3.0,0,0,0,0,0,0,0,0,0,0,0,0,0,0,0,0,0
401422701,Louisiana Tech Lady Techsters,R. Lee,4704199,,False,12.0,1,4,1,4,0,0,2,2,0,2,2,0,0,0,0,3,4
401422701,Louisiana Tech Lady Techsters,L. Sant,4595003,,False,31.0,0,2,0,0,0,2,0,0,1,3,4,2,0,2,0,0,0
401422701,Louisiana Tech Lady Techsters,TEAM,TOTAL,TOTAL,False,,20,48,17,37,3,11,9,13,4,27,31,5,4,2,17,10,52
401422701,Houston Cougars,B. Patterson,4433360,,True,36.0,8,12,7,10,1,2,1,2,3,4,7,1,2,1,0,0,18
401422701,Houston Cougars,T. Hill,4399017,,True,26.0,3,10,3,10,0,0,0,1,3,4,7,1,1,2,0,3,6
401422701,Houston Cougars,L. Blair,4433451,,True,38.0,3,17,2,6,1,11,5,6,0,6,6,2,1,0,2,2,12
401422701,Houston Cougars,T. Young,4433298,,True,39.0,8,17,8,15,0,2,1,4,1,1,2,3,5,0,1,1,17
401422701,Houston Cougars,J. Blackshell-Fair,4281088,,True,30.0,4,5,4,5,0,0,0,0,6,3,9,4,1,1,1,3,8
401422701,Houston Cougars,K. Jones,4703658,,False,18.0,1,4,1,4,0,0,0,0,0,5,5,0,0,0,1,2,2
401422701,Houston Cougars,E. Sidney,4398990,,False,13.0,0,1,0,0,0,1,0,0,0,1,1,0,0,0,3,1,0
401422701,Houston Cougars,TEAM,TOTAL,TOTAL,False,,27,66,25,50,2,16,7,13,14,26,40,11,10,4,9,12,63
401422700,Maine Black Bears,M. Carroll,4281151,,True,35.0,4,16,4,16,0,0,0,0,4,7,11,0,0,1,2,3,8
401422700,Maine Black Bears,C. Bornemann,4704599,,True,33.0,7,13,4,5,3,8,1,1,3,2,5,0,2,0,3,3,18
401422700,Maine Black Bears,P. Gallego,4898963,,True,16.0,0,4,0,2,0,2,0,0,1,5,6,0,1,0,3,1,0
401422700,Maine Black Bears,A. Orois,4704597,,True,37.0,1,6,1,3,0,3,0,0,0,0,0,8,1,0,5,3,2
401422700,Maine Black Bears,A. Simon,4594354,,True,35.0,5,14,2,5,3,9,1,2,2,2,4,1,1,1,1,2,14
401422700,Maine Black Bears,A. Smith,4898966,,False,5.0,1,1,1,1,0,0,0,0,0,0,0,0,0,0,0,3,2
401422700,Maine Black Bears,P. Mathieu-Castillo,4898964,,False,1.0,0,0,0,0,0,0,0,0,0,0,0,0,0,0,0,0,0
401422700,Maine Black Bears,B. Wilborn,4898965,,False,5.0,0,1,0,0,0,1,0,0,0,0,0,0,0,0,0,0,0
401422700,Maine Black Bears,S. Hodgson,4898962,,False,7.0,0,2,0,1,0,1,0,0,0,0,0,0,1,0,0,1,0
401422700,Maine Black Bears,L. Mittelstadt,4704596,,False,3.0,0,0,0,0,0,0,0,0,0,0,0,0,0,0,1,0,0
401422700,Maine Black Bears,O. Rockwood,4704595,,False,23.0,0,6,0,1,0,5,0,0,0,3,3,1,2,0,1,2,0
401422700,Maine Black Bears,TEAM,TOTAL,TOTAL,False,,18,63,12,34,6,29,2,3,13,23,36,10,8,2,17,18,44
401422700,Boston College Eagles,M. Gakdeng,4898548,,True,27.0,5,7,5,7,0,0,3,4,0,4,4,0,0,3,1,1,13
401422700,Boston College Eagles,A. VanTimmeren,4711798,,True,14.0,2,3,2,3,0,0,0,2,1,1,2,0,1,1,0,0,4
401422700,Boston College Eagles,T. Soule,4398567,,True,26.0,9,15,9,14,0,1,3,5,1,4,5,3,2,1,3,0,21
401422700,Boston College Eagles,C. Swartz,4398758,,True,30.0,2,8,1,4,1,4,2,2,0,4,4,3,2,1,3,1,7
401422700,Boston College Eagles,M. Garraud,4398568,,True,29.0,1,4,1,3,0,1,0,0,0,4,4,4,1,0,3,1,2
401422700,Boston College Eagles,J. Lacey,4702861,,False,1.0,0,0,0,0,0,0,0,0,0,0,0,0,0,0,0,0,0
401422700,Boston College Eagles,C. Ford,4398571,,False,7.0,0,0,0,0,0,0,1,2,0,1,1,0,0,0,1,0,1
401422700,Boston College Eagles,A. Daley,4898550,,False,1.0,0,0,0,0,0,0,1,2,0,0,0,0,0,0,0,0,1
401422700,Boston College Eagles,D. Waggoner,4433482,,False,23.0,2,5,2,5,0,0,1,2,3,5,8,0,1,0,1,2,5
401422700,Boston College Eagles,K. Ivey,4433464,,False,24.0,4,6,2,3,2,3,0,2,0,1,1,2,1,0,2,0,10
401422700,Boston College Eagles,M. Dickens,4398566,,False,18.0,2,6,1,1,1,5,0,0,0,5,5,1,1,0,0,0,5
401422700,Boston College Eagles,TEAM,TOTAL,TOTAL,False,,27,54,23,40,4,14,11,21,9,32,41,13,9,6,14,5,69
401422699,Northern Iowa Panthers,G. Boffeli,4704857,,True,19.0,4,6,4,6,0,0,0,1,1,4,5,3,0,0,0,3,8
401422699,Northern Iowa Panthers,B. Gunnels,4282228,,True,28.0,3,8,3,6,0,2,0,0,1,5,6,4,1,1,2,3,6
401422699,Northern Iowa Panthers,K. Finley,4399421,,True,28.0,7,13,3,5,4,8,1,2,1,1,2,3,0,0,1,2,19
401422699,Northern Iowa Panthers,N. Kroeger,4282226,,True,20.0,2,2,1,1,1,1,0,0,1,3,4,0,1,0,1,0,5
401422699,Northern Iowa Panthers,K. Rucker,4282225,,True,28.0,6,11,4,9,2,2,3,3,0,4,4,4,0,0,1,1,17
401422699,Northern Iowa Panthers,S. McCullough,4595605,,False,10.0,0,1,0,1,0,0,0,0,1,1,2,0,0,1,0,2,0
401422699,Northern Iowa Panthers,K. Barney,4399424,,False,2.0,0,1,0,0,0,1,0,0,0,0,0,0,0,0,0,0,0
401422699,Northern Iowa Panthers,C. Wolf,4399423,,False,20.0,1,2,1,1,0,1,0,0,1,5,6,1,1,0,1,0,2
401422699,Northern Iowa Panthers,K. Laube,4704856,,False,4.0,1,1,0,0,1,1,0,0,0,0,0,0,0,0,0,0,3
401422699,Northern Iowa Panthers,E. Green,4704853,,False,23.0,5,10,3,5,2,5,1,1,0,0,0,2,1,0,2,1,13
401422699,Northern Iowa Panthers,M. McDermott,4704852,,False,12.0,1,2,1,2,0,0,0,0,0,3,3,1,0,0,0,0,2
401422699,Northern Iowa Panthers,C. Morgan,4595604,,False,6.0,0,1,0,0,0,1,0,0,0,0,0,0,0,0,1,0,0
401422699,Northern Iowa Panthers,TEAM,TOTAL,TOTAL,False,,30,58,20,36,10,22,5,7,7,28,35,18,4,2,9,12,75
401422699,Kansas City Roos,P. Bradford,4704389,,True,33.0,3,9,2,6,1,3,0,1,2,7,9,1,2,0,0,0,7
401422699,Kansas City Roos,K. Bradley,4606153,,True,36.0,2,3,2,3,0,0,3,3,3,3,6,1,0,0,0,2,7
401422699,Kansas City Roos,B. McDavid,4282041,,True,36.0,6,18,6,18,0,0,5,7,2,2,4,0,1,0,2,1,17
401422699,Kansas City Roos,M. Willems,4595907,,True,32.0,1,5,0,1,1,4,0,0,0,1,1,2,0,0,0,2,3
401422699,Kansas City Roos,N. Alnatas,4595905,,True,35.0,11,18,10,15,1,3,1,1,1,4,5,3,3,0,4,3,24
401422699,Kansas City Roos,D. Winslow,4704873,,False,19.0,0,3,0,3,0,0,0,0,1,2,3,1,1,1,0,1,0
401422699,Kansas City Roos,H. Duft,4899834,,False,5.0,0,1,0,1,0,0,0,0,0,1,1,0,1,0,1,0,0
401422699,Kansas City Roos,S. St. Andre,4704387,,False,4.0,0,2,0,1,0,1,0,0,0,0,0,0,0,0,0,1,0
401422699,Kansas City Roos,TEAM,TOTAL,TOTAL,False,,23,59,20,48,3,11,9,12,9,22,31,8,8,1,8,10,58
401422698,Troy Trojans,F. Koranga,4704066,,True,26.0,3,8,3,8,0,0,4,4,5,7,12,0,2,2,4,1,10
401422698,Troy Trojans,T. Stephens,4594689,,True,28.0,6,9,5,7,1,2,0,0,0,6,6,0,0,0,2,2,13
401422698,Troy Trojans,S. Hartsfield,4704070,,True,24.0,3,6,2,2,1,4,0,2,2,0,2,4,1,0,5,1,7
401422698,Troy Trojans,J. Sandifer,4282612,,True,17.0,2,7,1,4,1,3,0,0,1,2,3,2,1,0,0,3,5
401422698,Troy Trojans,J. Robinson,4282611,,True,27.0,4,13,2,7,2,6,0,0,1,2,3,5,1,0,3,2,10
401422698,Troy Trojans,J. Hollings,4900123,,False,9.0,3,3,3,3,0,0,1,2,2,1,3,1,1,1,0,1,7
401422698,Troy Trojans,A. Leggett,4400397,,False,19.0,4,8,4,7,0,1,0,0,4,4,8,1,3,0,2,1,8
401422698,Troy Trojans,J. Dunlap,4398710,,False,12.0,3,7,3,6,0,1,0,0,1,2,3,1,0,3,2,3,6
401422698,Troy Trojans,G. Cartagena,4900122,,False,6.0,0,2,0,1,0,1,0,0,0,0,0,0,0,0,0,0,0
401422698,Troy Trojans,Z. Downs,4705004,,False,5.0,0,2,0,1,0,1,0,0,0,0,0,0,0,0,0,2,0
401422698,Troy Trojans,T. Johnson,4596285,,False,21.0,5,10,3,3,2,7,1,2,3,5,8,1,0,0,0,2,13
401422698,Troy Trojans,J. Walton,4280894,,False,6.0,0,3,0,0,0,3,0,0,0,0,0,0,0,0,1,1,0
401422698,Troy Trojans,TEAM,TOTAL,TOTAL,False,,33,78,26,49,7,29,6,10,21,32,53,15,9,6,19,19,79
401422698,Alabama Crimson Tide,J. Rice,4398624,,True,34.0,7,14,7,14,0,0,1,1,10,5,15,1,0,2,0,2,15
401422698,Alabama Crimson Tide,J. Mingo-Young,4595174,,True,36.0,8,15,8,12,0,3,0,2,2,3,5,2,2,0,3,3,16
401422698,Alabama Crimson Tide,B. Davis,4594178,,True,38.0,5,18,4,12,1,6,6,7,2,5,7,5,8,0,1,1,17
401422698,Alabama Crimson Tide,H. Barber,4398597,,True,37.0,2,8,0,0,2,8,2,2,0,3,3,3,1,0,2,1,8
401422698,Alabama Crimson Tide,M. Abrams,4398595,,True,40.0,6,17,2,7,4,10,8,8,2,2,4,3,2,0,5,0,24
401422698,Alabama Crimson Tide,A. Cruce,4398598,,False,6.0,0,2,0,2,0,0,0,0,0,0,0,0,0,0,0,0,0
401422698,Alabama Crimson Tide,M. Gordon,4433457,,False,6.0,1,1,1,1,0,0,0,0,0,0,0,1,0,0,0,1,2
401422698,Alabama Crimson Tide,T. Sutton,4399523,,False,3.0,0,0,0,0,0,0,0,0,0,0,0,0,0,0,2,1,0
401422698,Alabama Crimson Tide,TEAM,TOTAL,TOTAL,False,,29,75,22,48,7,27,17,20,16,25,41,15,13,2,14,9,82
401422697,Seton Hall Pirates,M. Bembry,4433041,,True,34.0,3,4,3,4,0,0,0,0,3,8,11,4,3,0,1,3,6
401422697,Seton Hall Pirates,S. Cooks,4281245,,True,37.0,5,14,5,11,0,3,0,2,2,10,12,1,0,2,6,1,10
401422697,Seton Hall Pirates,M. Jackson,4595161,,True,30.0,4,6,3,3,1,3,0,0,0,2,2,1,3,0,0,4,9
401422697,Seton Hall Pirates,L. Park-Lane,4433379,,True,35.0,12,20,9,14,3,6,2,2,0,2,2,3,0,0,4,2,29
401422697,Seton Hall Pirates,A. Espinoza-Hunter,4281075,,True,32.0,3,10,2,3,1,7,0,0,0,3,3,2,2,2,2,0,7
401422697,Seton Hall Pirates,S. Treadwell,4598613,,False,2.0,0,1,0,0,0,1,0,0,0,0,0,0,0,0,0,0,0
401422697,Seton Hall Pirates,K. Harris,4595164,,False,2.0,0,0,0,0,0,0,0,0,0,1,1,0,0,0,0,0,0
401422697,Seton Hall Pirates,A. Wright,4704306,,False,13.0,1,1,1,1,0,0,4,5,0,2,2,1,1,0,2,1,6
401422697,Seton Hall Pirates,C. Dean,4704305,,False,4.0,0,1,0,0,0,1,0,0,0,0,0,1,0,0,0,3,0
401422697,Seton Hall Pirates,D. Robinson,4399386,,False,2.0,0,0,0,0,0,0,0,0,0,0,0,0,0,0,0,0,0
401422697,Seton Hall Pirates,K. Armstrong,4068589,,False,9.0,0,0,0,0,0,0,0,0,0,0,0,1,1,0,0,0,0
401422697,Seton Hall Pirates,TEAM,TOTAL,TOTAL,False,,28,57,23,36,5,21,6,9,6,31,37,14,10,4,15,14,67
401422697,Fairleigh Dickinson Knights,C. Wilson,4704968,,True,35.0,5,14,5,12,0,2,1,4,3,5,8,1,2,0,3,3,11
401422697,Fairleigh Dickinson Knights,M. Stanley,4281968,,True,35.0,1,12,1,9,0,3,1,2,6,5,11,3,0,0,5,2,3
401422697,Fairleigh Dickinson Knights,D. Scott,4704967,,True,36.0,2,5,1,3,1,2,0,0,0,1,1,5,0,0,0,2,5
401422697,Fairleigh Dickinson Knights,A. Bell,4595726,,True,34.0,6,15,3,6,3,9,2,2,1,5,6,1,2,0,1,0,17
401422697,Fairleigh Dickinson Knights,M. Selvaggi,4399552,,True,20.0,0,2,0,1,0,1,2,2,1,3,4,0,0,0,3,1,2
401422697,Fairleigh Dickinson Knights,M. Elebring,4900587,,False,7.0,1,3,1,2,0,1,0,0,1,1,2,0,0,0,1,0,2
401422697,Fairleigh Dickinson Knights,S. DeAngelo,4595727,,False,3.0,0,0,0,0,0,0,0,0,0,1,1,0,1,0,3,0,0
401422697,Fairleigh Dickinson Knights,T. Crystian,4704966,,False,5.0,0,2,0,0,0,2,0,0,0,0,0,0,0,0,0,1,0
401422697,Fairleigh Dickinson Knights,A. Conklin,4704965,,False,2.0,0,0,0,0,0,0,0,0,0,0,0,0,0,0,0,0,0
401422697,Fairleigh Dickinson Knights,D. Forgues,4595763,,False,23.0,2,8,1,3,1,5,0,0,1,3,4,2,1,0,2,1,5
401422697,Fairleigh Dickinson Knights,TEAM,TOTAL,TOTAL,False,,17,61,12,36,5,25,6,10,14,24,38,12,6,0,18,10,45
401422696,Norfolk State Spartans,M. Diawara,4705343,,True,32.0,3,4,2,3,1,1,1,2,4,3,7,0,0,2,1,1,8
401422696,Norfolk State Spartans,M. Williams,4595001,,True,27.0,5,9,5,9,0,0,0,2,3,2,5,0,2,1,1,2,10
401422696,Norfolk State Spartans,N. Fields,4705341,,True,14.0,0,4,0,2,0,2,0,0,0,2,2,0,1,0,1,2,0
401422696,Norfolk State Spartans,D. Francis,4399462,,True,39.0,6,13,6,12,0,1,0,0,1,4,5,1,1,1,4,1,12
401422696,Norfolk State Spartans,C. Downs,4282235,,True,33.0,3,16,3,11,0,5,4,4,2,6,8,4,2,0,2,4,10
401422696,Norfolk State Spartans,L. Savage,4282370,,False,4.0,0,0,0,0,0,0,0,0,0,0,0,0,0,0,0,0,0
401422696,Norfolk State Spartans,J. Turner,4899969,,False,21.0,1,7,0,2,1,5,1,2,0,2,2,0,1,0,2,3,4
401422696,Norfolk State Spartans,C. White,4705327,,False,3.0,0,0,0,0,0,0,0,0,0,0,0,0,0,0,0,0,0
401422696,Norfolk State Spartans,D. Williams,4704326,,False,19.0,1,4,1,3,0,1,1,2,2,2,4,0,0,1,0,0,3
401422696,Norfolk State Spartans,A. Franklin,4282402,,False,8.0,0,3,0,2,0,1,0,0,0,0,0,1,1,0,1,2,0
401422696,Norfolk State Spartans,TEAM,TOTAL,TOTAL,False,,19,60,17,44,2,16,7,12,15,24,39,6,8,5,13,15,47
401422696,Drexel Dragons,K. Connolly,4399844,,True,7.0,0,2,0,0,0,2,2,2,0,1,1,0,0,0,0,0,2
401422696,Drexel Dragons,T. Brugler,4280995,,True,38.0,5,15,5,12,0,3,3,4,2,5,7,2,1,1,6,2,13
401422696,Drexel Dragons,M. Leonard,4068316,,True,30.0,2,6,2,6,0,0,2,2,1,2,3,0,1,1,1,0,6
401422696,Drexel Dragons,K. Washington,4399843,,True,39.0,5,14,3,8,2,6,4,7,0,3,3,1,0,0,1,1,16
401422696,Drexel Dragons,H. Nihill,4281431,,True,38.0,2,8,1,4,1,4,4,4,0,4,4,3,2,0,3,0,9
401422696,Drexel Dragons,J. Valentine,4704570,,False,11.0,1,1,1,1,0,0,0,0,2,2,4,0,0,0,0,0,2
401422696,Drexel Dragons,M. Hendrixson,4399845,,False,37.0,2,8,0,1,2,7,0,0,3,10,13,8,0,1,2,3,6
401422696,Drexel Dragons,TEAM,TOTAL,TOTAL,False,,17,54,12,32,5,22,15,19,14,27,41,14,4,3,15,6,54
401422695,New Mexico Lobos,S. McGruder,4400149,,True,31.0,9,12,9,11,0,1,2,2,5,2,7,2,6,0,1,3,20
401422695,New Mexico Lobos,A. Anderson,4281834,,True,21.0,2,5,0,1,2,4,2,2,3,2,5,2,0,0,2,4,8
401422695,New Mexico Lobos,Lato. Duff,4704520,,True,37.0,2,8,1,4,1,4,3,6,2,7,9,13,1,0,1,0,8
401422695,New Mexico Lobos,Lata. Duff,4704519,,True,34.0,9,15,2,3,7,12,2,2,0,2,2,3,0,0,2,1,27
401422695,New Mexico Lobos,J. De La Cerda,4281833,,True,34.0,9,19,5,12,4,7,0,0,1,3,4,4,1,0,1,1,22
401422695,New Mexico Lobos,P. Reus,4900583,,False,26.0,3,6,3,5,0,1,1,1,1,3,4,1,0,0,1,1,7
401422695,New Mexico Lobos,M. Curtis,4900582,,False,1.0,0,0,0,0,0,0,0,0,0,0,0,0,0,0,0,0,0
401422695,New Mexico Lobos,A. Augmon,4900581,,False,13.0,0,1,0,0,0,1,0,0,0,0,0,2,0,0,1,2,0
401422695,New Mexico Lobos,Z. Seren,4900580,,False,1.0,0,0,0,0,0,0,0,0,0,0,0,0,0,0,0,0,0
401422695,New Mexico Lobos,K. van Bennekom,4704522,,False,2.0,0,0,0,0,0,0,0,0,0,1,1,0,0,0,0,0,0
401422695,New Mexico Lobos,TEAM,TOTAL,TOTAL,False,,34,66,20,36,14,30,10,13,12,23,35,27,8,0,11,12,92
401422695,Grand Canyon Lopes,K. Shorts,4400116,,True,21.0,2,3,2,3,0,0,0,0,0,4,4,0,1,0,2,0,4
401422695,Grand Canyon Lopes,J. Powell-Smith,4899517,,True,19.0,2,2,2,2,0,0,0,0,0,2,2,2,0,0,1,1,4
401422695,Grand Canyon Lopes,C. Akin-Otiko,4705636,,True,11.0,2,2,2,2,0,0,0,0,1,1,2,0,0,0,2,1,4
401422695,Grand Canyon Lopes,Tiar. Brown,4705634,,True,31.0,7,15,6,11,1,4,7,10,0,4,4,3,1,0,5,1,22
401422695,Grand Canyon Lopes,A. Graham,4068788,,True,20.0,2,5,1,2,1,3,0,0,0,1,1,1,0,0,1,1,5
401422695,Grand Canyon Lopes,J. McChristine,4899523,,False,19.0,7,9,7,9,0,0,4,5,1,5,6,0,1,0,1,0,18
401422695,Grand Canyon Lopes,D. Phillips,4899519,,False,20.0,4,10,2,5,2,5,0,0,0,0,0,3,0,0,0,3,10
401422695,Grand Canyon Lopes,N. Evans,4899524,,False,5.0,0,0,0,0,0,0,0,0,0,0,0,0,0,0,1,1,0
401422695,Grand Canyon Lopes,Tian. Brown,4595892,,False,15.0,1,2,0,1,1,1,0,0,0,0,0,4,0,0,1,2,3
401422695,Grand Canyon Lopes,N. Jackson,4068111,,False,9.0,0,2,0,0,0,2,0,0,0,1,1,0,0,0,0,0,0
401422695,Grand Canyon Lopes,K. Flowers,4899522,,False,30.0,1,3,1,1,0,2,0,0,1,3,4,5,2,0,1,1,2
401422695,Grand Canyon Lopes,TEAM,TOTAL,TOTAL,False,,28,53,23,36,5,17,11,15,4,22,26,18,5,0,16,11,72
401422694,Marquette Golden Eagles,L. Karlen,4703796,,True,26.0,4,9,4,9,0,0,2,2,4,6,10,2,1,1,3,2,10
401422694,Marquette Golden Eagles,C. Marotta,4399360,,True,26.0,8,12,8,12,0,0,3,3,7,10,17,4,1,1,3,3,19
401422694,Marquette Golden Eagles,L. Van Kleunen,4068083,,True,27.0,9,13,9,13,0,0,2,2,3,5,8,1,1,1,1,0,20
401422694,Marquette Golden Eagles,J. King,4595151,,True,27.0,1,6,0,4,1,2,0,0,0,4,4,7,1,2,1,2,3
401422694,Marquette Golden Eagles,K. McLaughlin,4281277,,True,34.0,8,17,2,6,6,11,2,2,0,1,1,6,0,0,1,1,24
401422694,Marquette Golden Eagles,J. Okosun,4703795,,False,4.0,1,3,1,3,0,0,1,1,2,1,3,0,0,1,0,2,3
401422694,Marquette Golden Eagles,K. Myles,4594770,,False,7.0,0,0,0,0,0,0,0,0,1,0,1,1,1,0,2,0,0
401422694,Marquette Golden Eagles,M. Williams,4899441,,False,3.0,0,2,0,2,0,0,2,2,0,0,0,0,0,0,1,0,2
401422694,Marquette Golden Eagles,R. Nkumu,4599129,,False,13.0,1,1,1,1,0,0,0,0,0,1,1,1,0,0,0,1,2
401422694,Marquette Golden Eagles,D. Middleton,4598614,,False,13.0,0,5,0,4,0,1,1,4,1,1,2,1,0,1,0,2,1
401422694,Marquette Golden Eagles,A. Walker,4400574,,False,20.0,4,6,4,6,0,0,1,1,1,2,3,1,3,0,1,1,9
401422694,Marquette Golden Eagles,TEAM,TOTAL,TOTAL,False,,36,74,29,60,7,14,14,17,20,31,51,24,8,7,13,14,93
401422694,Ball State Cardinals,M. Kiefer,4900612,,True,23.0,1,5,1,3,0,2,0,0,2,5,7,3,2,0,4,2,2
401422694,Ball State Cardinals,T. Dis Agustsdottir,4399285,,True,28.0,2,6,1,2,1,4,1,1,0,1,1,2,0,0,2,1,6
401422694,Ball State Cardinals,C. Latimer,4281480,,True,19.0,2,5,2,4,0,1,0,0,2,2,4,2,0,0,1,2,4
401422694,Ball State Cardinals,A. Becki,4900609,,True,30.0,10,21,10,15,0,6,2,2,2,2,4,2,1,0,3,3,22
401422694,Ball State Cardinals,S. Freeman,4595285,,True,38.0,5,13,3,7,2,6,3,4,0,3,3,3,2,1,0,0,15
401422694,Ball State Cardinals,A. Rauch,4595288,,False,12.0,2,2,2,2,0,0,0,1,0,0,0,0,0,1,2,3,4
401422694,Ball State Cardinals,J. Turner,4900613,,False,8.0,1,3,1,3,0,0,0,2,1,1,2,0,0,0,0,0,2
401422694,Ball State Cardinals,B. Smith,4399286,,False,9.0,0,2,0,2,0,0,0,0,0,1,1,0,0,0,0,1,0
401422694,Ball State Cardinals,I. Subirats,4705355,,False,20.0,1,3,0,2,1,1,1,4,1,0,1,0,2,0,0,3,4
401422694,Ball State Cardinals,M. Bischoff,4900614,,False,13.0,4,8,2,5,2,3,1,2,1,2,3,0,0,1,0,1,11
401422694,Ball State Cardinals,TEAM,TOTAL,TOTAL,False,,28,68,22,45,6,23,8,16,12,18,30,12,7,3,12,16,70
401422693,Holy Cross Crusaders,J. Allen,4704714,,True,31.0,5,10,5,10,0,0,1,4,3,3,6,5,0,2,4,4,11
401422693,Holy Cross Crusaders,M. Demski,4400187,,True,17.0,2,4,1,2,1,2,1,2,1,0,1,0,0,0,0,1,6
401422693,Holy Cross Crusaders,B. Power-Cassidy,4704715,,True,27.0,4,9,3,5,1,4,0,0,0,4,4,2,0,0,3,4,9
401422693,Holy Cross Crusaders,A. Cross,4595975,,True,36.0,6,10,5,8,1,2,0,0,0,3,3,5,2,0,2,4,13
401422693,Holy Cross Crusaders,A. LaBarbera,4400186,,True,39.0,6,22,5,13,1,9,8,10,3,5,8,4,8,0,4,2,21
401422693,Holy Cross Crusaders,O. Ezemma,4400185,,False,17.0,3,6,3,6,0,0,1,2,2,3,5,1,0,0,0,0,7
401422693,Holy Cross Crusaders,C. McCormack,4704716,,False,22.0,1,4,1,2,0,2,0,0,0,1,1,2,0,0,2,3,2
401422693,Holy Cross Crusaders,K. Petro,4400188,,False,11.0,0,1,0,0,0,1,0,0,0,1,1,0,0,0,0,0,0
401422693,Holy Cross Crusaders,TEAM,TOTAL,TOTAL,False,,27,66,23,46,4,20,11,18,11,22,33,19,10,2,15,18,69
401422693,Columbia Lions,N. Comesana,4899284,,True,18.0,3,4,3,4,0,0,0,0,3,2,5,0,0,0,0,3,6
401422693,Columbia Lions,K. Davis,4433382,,True,24.0,3,8,3,7,0,1,9,9,1,6,7,1,2,0,6,4,15
401422693,Columbia Lions,K. Henderson,4899283,,True,25.0,1,6,1,2,0,4,2,4,0,5,5,3,0,1,3,3,4
401422693,Columbia Lions,A. Hsu,4594973,,True,36.0,8,15,3,6,5,9,3,3,3,3,6,7,1,0,2,1,24
401422693,Columbia Lions,J. Patrick,4433322,,True,33.0,6,13,5,9,1,4,5,8,1,4,5,0,2,1,1,2,18
401422693,Columbia Lions,H. Pratt,4399165,,False,12.0,3,5,1,1,2,4,0,0,1,3,4,0,0,1,3,0,8
401422693,Columbia Lions,S. Durr,4399167,,False,7.0,2,3,2,2,0,1,0,2,0,0,0,1,0,0,1,1,4
401422693,Columbia Lions,N. Stephens,4705213,,False,17.0,0,2,0,1,0,1,0,0,1,3,4,5,0,0,0,1,0
401422693,Columbia Lions,C. Rivera,4594972,,False,26.0,0,1,0,0,0,1,1,2,2,0,2,4,3,0,4,4,1
401422693,Columbia Lions,M. Markham,4399166,,False,2.0,0,0,0,0,0,0,0,0,0,0,0,0,1,0,0,0,0
401422693,Columbia Lions,TEAM,TOTAL,TOTAL,False,,26,57,18,32,8,25,20,28,13,29,42,21,9,3,20,19,80
401422692,Liberty Flames,B. Rettstatt,4281577,,True,37.0,6,13,4,9,2,4,2,2,2,10,12,3,1,2,2,3,16
401422692,Liberty Flames,M. Berkman,4704261,,True,27.0,5,8,5,8,0,0,2,4,3,7,10,0,1,1,2,4,12
401422692,Liberty Flames,P. Smeenge,4706151,,True,32.0,2,9,2,8,0,1,0,0,1,0,1,1,1,0,2,1,4
401422692,Liberty Flames,D. Brown,4704260,,True,33.0,1,4,0,2,1,2,4,4,0,4,4,1,1,0,2,3,7
401422692,Liberty Flames,K. Williams,4594906,,True,31.0,1,3,1,2,0,1,0,0,0,2,2,5,0,0,3,2,2
401422692,Liberty Flames,A. Markova,4898942,,False,1.0,0,0,0,0,0,0,0,0,0,0,0,0,0,0,0,0,0
401422692,Liberty Flames,B. Smuda,4433773,,False,12.0,2,4,2,4,0,0,0,0,3,3,6,1,0,0,4,2,4
401422692,Liberty Flames,E. Hess,4898939,,False,7.0,1,3,0,1,1,2,2,2,0,1,1,0,0,0,2,1,5
401422692,Liberty Flames,N. Lindstrom,4594903,,False,3.0,0,1,0,0,0,1,0,0,0,0,0,0,0,0,0,0,0
401422692,Liberty Flames,A. Iverson,4399422,,False,17.0,0,2,0,1,0,1,0,0,1,0,1,2,0,0,1,2,0
401422692,Liberty Flames,TEAM,TOTAL,TOTAL,False,,18,47,14,35,4,12,10,12,11,28,39,13,4,3,21,18,50
401422692,Campbell Fighting Camels,B. Staves,4594882,,True,26.0,2,7,1,5,1,2,0,2,0,2,2,0,0,0,1,1,5
401422692,Campbell Fighting Camels,T. Bolden,4068145,,True,27.0,7,12,7,12,0,0,0,0,3,6,9,1,3,0,1,4,14
401422692,Campbell Fighting Camels,F. Price,4594881,,True,36.0,3,7,0,0,3,7,1,4,0,1,1,0,2,0,1,2,10
401422692,Campbell Fighting Camels,L. Serranho,4399956,,True,39.0,2,9,2,5,0,4,7,8,1,2,3,2,0,0,5,3,11
401422692,Campbell Fighting Camels,S. Tuelle,4399955,,True,32.0,1,9,1,5,0,4,0,0,1,1,2,2,0,1,0,2,2
401422692,Campbell Fighting Camels,C. Dahlquist,4899211,,False,2.0,0,0,0,0,0,0,0,0,0,0,0,0,0,0,0,1,0
401422692,Campbell Fighting Camels,C. Ezumah,4704805,,False,11.0,0,0,0,0,0,0,0,0,0,2,2,0,0,0,1,1,0
401422692,Campbell Fighting Camels,S. Nurenberg,4594883,,False,26.0,0,2,0,1,0,1,2,2,1,3,4,2,1,0,2,1,2
401422692,Campbell Fighting Camels,T. Carver,4281556,,False,1.0,0,0,0,0,0,0,0,0,0,1,1,0,0,0,0,0,0
401422692,Campbell Fighting Camels,TEAM,TOTAL,TOTAL,False,,15,46,11,28,4,18,10,16,6,19,25,7,6,1,11,15,44
401422691,Southern Illinois Salukis,G. Walker,4399431,,True,28.0,9,17,9,17,0,0,1,3,6,3,9,3,3,1,3,4,19
401422691,Southern Illinois Salukis,A. Brockmeyer,4287036,,True,37.0,5,11,3,7,2,4,5,6,1,8,9,2,2,0,0,2,17
401422691,Southern Illinois Salukis,Q. Love,4704868,,True,36.0,2,7,1,4,1,3,1,2,1,2,3,1,0,0,1,0,6
401422691,Southern Illinois Salukis,C. Link,4399430,,True,22.0,1,4,1,4,0,0,0,0,1,1,2,1,0,0,1,3,2
401422691,Southern Illinois Salukis,M. Silvey,4282270,,True,39.0,5,21,5,15,0,6,0,0,1,4,5,4,4,0,1,2,10
401422691,Southern Illinois Salukis,A. Katcher,4704871,,False,7.0,2,2,2,2,0,0,0,0,0,0,0,0,0,0,0,0,4
401422691,Southern Illinois Salukis,L. Randle,4664773,,False,5.0,0,0,0,0,0,0,0,0,0,0,0,0,0,0,0,0,0
401422691,Southern Illinois Salukis,P. Clubb,4900093,,False,1.0,0,0,0,0,0,0,0,0,0,0,0,0,0,0,0,0,0
401422691,Southern Illinois Salukis,T. Brown,4900092,,False,11.0,1,6,1,3,0,3,0,0,1,0,1,3,0,0,1,0,2
401422691,Southern Illinois Salukis,P. McCallister,4399432,,False,14.0,0,3,0,1,0,2,0,0,0,0,0,0,0,0,2,3,0
401422691,Southern Illinois Salukis,TEAM,TOTAL,TOTAL,False,,25,71,22,53,3,18,7,11,13,18,31,14,9,1,10,14,60
401422691,Purdue Boilermakers,R. Woltman,4433302,,True,15.0,1,4,1,4,0,0,2,2,1,1,2,0,0,2,2,4,4
401422691,Purdue Boilermakers,A. Ellis,4595183,,True,32.0,4,7,4,7,0,0,1,2,1,8,9,3,0,0,3,0,9
401422691,Purdue Boilermakers,J. Terry,4433143,,True,34.0,4,8,4,8,0,0,2,2,2,5,7,8,3,0,2,1,10
401422691,Purdue Boilermakers,C. Hardin,4398945,,True,30.0,2,6,1,2,1,4,1,2,1,1,2,3,0,0,0,3,6
401422691,Purdue Boilermakers,R. Doumbia,4398602,,True,30.0,6,10,6,9,0,1,1,2,1,7,8,4,1,0,1,1,13
401422691,Purdue Boilermakers,N. Gony,4398948,,False,2.0,0,0,0,0,0,0,0,0,0,0,0,1,0,0,1,0,0
401422691,Purdue Boilermakers,A. Learn,4899062,,False,9.0,4,4,4,4,0,0,1,1,1,4,5,0,0,0,3,1,9
401422691,Purdue Boilermakers,J. Smith,4899061,,False,14.0,1,3,1,2,0,1,0,0,0,0,0,1,0,0,1,1,2
401422691,Purdue Boilermakers,A. Stallings,4398946,,False,2.0,1,1,1,1,0,0,0,0,0,0,0,0,0,0,0,0,2
401422691,Purdue Boilermakers,B. Moore,4398608,,False,32.0,10,15,6,7,4,8,3,3,0,4,4,1,1,1,2,1,27
401422691,Purdue Boilermakers,TEAM,TOTAL,TOTAL,False,,33,58,28,44,5,14,11,14,8,34,42,21,5,3,16,12,82
401422690,Youngstown State Penguins,L. Ritz,4899255,,True,33.0,6,16,6,16,0,0,2,3,2,3,5,0,2,0,3,2,14
401422690,Youngstown State Penguins,P. Shy,4595011,,True,36.0,2,7,0,1,2,6,0,0,0,4,4,2,2,0,1,3,6
401422690,Youngstown State Penguins,M. Magestro,4705420,,True,31.0,4,9,2,3,2,6,6,6,0,0,0,1,0,0,2,3,16
401422690,Youngstown State Penguins,M. Aulbach,4595484,,True,30.0,0,0,0,0,0,0,2,2,1,5,6,3,0,0,3,1,2
401422690,Youngstown State Penguins,C. Olson,4282114,,True,13.0,4,8,3,5,1,3,2,2,0,1,1,1,1,0,1,0,11
401422690,Youngstown State Penguins,L. Linard,4703741,,False,3.0,0,0,0,0,0,0,0,0,0,0,0,0,0,0,0,0,0
401422690,Youngstown State Penguins,J. Wendler,4595488,,False,3.0,0,0,0,0,0,0,0,0,0,0,0,0,0,0,0,1,0
401422690,Youngstown State Penguins,H. Thierry,4899253,,False,1.0,0,0,0,0,0,0,0,0,0,1,1,1,1,0,0,0,0
401422690,Youngstown State Penguins,E. Randall,4705421,,False,2.0,0,0,0,0,0,0,0,0,0,0,0,0,0,0,0,0,0
401422690,Youngstown State Penguins,L. Wagner,4595487,,False,2.0,0,0,0,0,0,0,0,0,0,0,0,1,0,0,2,0,0
401422690,Youngstown State Penguins,L. Mack,4399549,,False,15.0,2,3,0,0,2,3,0,0,0,0,0,0,0,0,0,0,6
401422690,Youngstown State Penguins,M. Callahan,4281990,,False,31.0,2,9,2,6,0,3,0,0,0,3,3,1,0,0,0,4,4
401422690,Youngstown State Penguins,TEAM,TOTAL,TOTAL,False,,20,52,13,31,7,21,12,13,4,17,21,10,6,0,12,14,59
401422690,Kent State Golden Flashes,N. Blackford,4595260,,True,11.0,1,7,1,7,0,0,1,2,4,2,6,1,1,0,2,2,3
401422690,Kent State Golden Flashes,L. Thall,4399327,,True,30.0,5,9,4,5,1,4,4,4,0,5,5,0,1,2,3,3,15
401422690,Kent State Golden Flashes,K. Shumate,4433684,,True,25.0,5,8,3,6,2,2,1,3,0,2,2,2,0,0,0,1,13
401422690,Kent State Golden Flashes,H. Young,4399326,,True,15.0,0,0,0,0,0,0,1,2,1,2,3,0,0,0,1,3,1
401422690,Kent State Golden Flashes,M. Modkins,4399323,,True,24.0,3,6,1,1,2,5,1,2,0,3,3,1,0,0,2,1,9
401422690,Kent State Golden Flashes,B. Dunn,4900064,,False,24.0,3,7,2,3,1,4,0,0,1,5,6,0,3,1,0,1,7
401422690,Kent State Golden Flashes,J. Batsch,4900063,,False,20.0,4,5,3,4,1,1,2,2,0,0,0,0,2,0,2,2,11
401422690,Kent State Golden Flashes,C. Santoro,4704895,,False,20.0,1,4,1,1,0,3,0,0,0,0,0,5,1,0,3,1,2
401422690,Kent State Golden Flashes,C. Kelly,4595261,,False,27.0,3,5,2,3,1,2,0,0,1,1,2,5,0,0,2,1,7
401422690,Kent State Golden Flashes,A. Pavlansky,4399321,,False,4.0,0,1,0,1,0,0,0,0,1,0,1,0,0,0,1,0,0
401422690,Kent State Golden Flashes,TEAM,TOTAL,TOTAL,False,,25,52,17,31,8,21,10,15,8,27,35,14,8,3,17,15,68
401418108,Princeton Tigers,E. Mitchell,4594957,,True,35.0,7,8,7,8,0,0,1,1,1,11,12,1,2,1,0,3,15
401418108,Princeton Tigers,K. Chen,4899328,,True,35.0,4,9,4,8,0,1,4,6,1,6,7,4,1,0,4,4,12
401418108,Princeton Tigers,J. Cunningham,4399194,,True,25.0,3,10,2,4,1,6,4,4,1,3,4,1,0,1,2,4,11
401418108,Princeton Tigers,G. Stone,4399190,,True,23.0,1,4,0,2,1,2,0,0,0,2,2,5,1,0,2,2,3
401418108,Princeton Tigers,A. Meyers,4281402,,True,29.0,5,10,2,4,3,6,1,2,0,4,4,1,2,1,2,2,14
401418108,Princeton Tigers,K. Thiers,4899331,,False,2.0,0,0,0,0,0,0,1,2,0,0,0,0,0,0,0,1,1
401418108,Princeton Tigers,P. Hill,4682991,,False,1.0,0,0,0,0,0,0,0,0,0,0,0,0,0,0,0,0,0
401418108,Princeton Tigers,L. Weger,4399195,,False,2.0,1,2,1,1,0,1,0,0,1,1,2,0,0,0,1,1,2
401418108,Princeton Tigers,C. Nweke,4899329,,False,18.0,4,6,4,6,0,0,0,0,0,2,2,1,0,2,0,0,8
401418108,Princeton Tigers,A. Osgood,4899330,,False,2.0,0,0,0,0,0,0,0,0,0,0,0,0,0,0,0,0,0
401418108,Princeton Tigers,M. Plank,4594958,,False,6.0,1,3,1,1,0,2,0,0,2,1,3,0,1,0,0,0,2
401418108,Princeton Tigers,A. Nwokeji,4575702,,False,2.0,0,1,0,1,0,0,0,0,0,0,0,0,0,0,0,0,0
401418108,Princeton Tigers,M. Connolly,4399192,,False,20.0,2,4,1,2,1,2,0,0,0,0,0,2,0,0,2,0,5
401418108,Princeton Tigers,TEAM,TOTAL,TOTAL,False,,28,57,22,37,6,20,11,15,8,34,42,15,7,5,13,17,73
401418108,Harvard Crimson,M. Stuhlreyer,4281409,,True,5.0,0,2,0,1,0,1,0,0,1,0,1,0,0,0,0,1,0
401418108,Harvard Crimson,T. Sussman,4399183,,True,25.0,2,8,1,4,1,4,0,0,3,2,5,2,3,0,1,3,5
401418108,Harvard Crimson,L. Mullaney,4433377,,True,29.0,3,12,3,7,0,5,0,0,0,2,2,0,1,0,2,2,6
401418108,Harvard Crimson,M. McCarthy,4399184,,True,34.0,5,8,3,3,2,5,0,0,2,3,5,2,1,0,1,4,12
401418108,Harvard Crimson,M. Forbes,4398749,,True,26.0,2,12,1,5,1,7,0,0,1,4,5,1,1,1,2,3,5
401418108,Harvard Crimson,S. Coffel,4899317,,False,1.0,0,0,0,0,0,0,0,0,0,1,1,0,0,0,0,0,0
401418108,Harvard Crimson,L. Lawson,4705224,,False,7.0,0,0,0,0,0,0,0,0,3,0,3,0,0,0,0,1,0
401418108,Harvard Crimson,E. Stauffer,4899318,,False,12.0,0,7,0,1,0,6,0,0,0,0,0,0,0,0,0,1,0
401418108,Harvard Crimson,H. Turner,4899316,,False,27.0,5,17,3,10,2,7,3,4,3,3,6,3,0,0,2,4,15
401418108,Harvard Crimson,E. Rodriguez,4899315,,False,9.0,0,1,0,1,0,0,0,0,0,2,2,0,0,0,1,0,0
401418108,Harvard Crimson,A. Stritzel,4594963,,False,21.0,2,6,2,6,0,0,4,4,1,3,4,3,1,2,2,1,8
401418108,Harvard Crimson,G. Donaldson,4594962,,False,3.0,0,0,0,0,0,0,2,2,1,1,2,0,0,0,0,0,2
401418108,Harvard Crimson,S. Park,4594960,,False,1.0,0,0,0,0,0,0,0,0,0,0,0,0,0,0,0,0,0
401418108,Harvard Crimson,TEAM,TOTAL,TOTAL,False,,19,73,13,38,6,35,9,10,18,23,41,11,7,3,11,20,53
401418107,Harvard Crimson,T. Sussman,4399183,,True,28.0,10,13,5,5,5,8,0,0,0,2,2,3,1,1,1,0,25
401418107,Harvard Crimson,H. Turner,4899316,,True,22.0,3,10,2,6,1,4,1,2,1,3,4,0,1,0,1,1,8
401418107,Harvard Crimson,L. Mullaney,4433377,,True,22.0,5,9,2,3,3,6,0,0,1,3,4,2,1,0,0,1,13
401418107,Harvard Crimson,M. McCarthy,4399184,,True,26.0,1,4,0,0,1,4,0,0,3,2,5,3,2,0,0,2,3
401418107,Harvard Crimson,M. Forbes,4398749,,True,26.0,6,14,1,4,5,10,0,0,0,4,4,4,0,0,1,1,17
401418107,Harvard Crimson,S. Coffel,4899317,,False,3.0,0,0,0,0,0,0,0,2,0,2,2,0,0,0,0,0,0
401418107,Harvard Crimson,L. Lawson,4705224,,False,10.0,2,3,2,3,0,0,0,2,0,3,3,0,0,1,0,0,4
401418107,Harvard Crimson,M. Stuhlreyer,4281409,,False,5.0,0,1,0,1,0,0,0,0,0,1,1,1,1,0,0,1,0
401418107,Harvard Crimson,E. Stauffer,4899318,,False,12.0,2,5,2,3,0,2,0,0,0,2,2,1,2,0,0,2,4
401418107,Harvard Crimson,E. Rodriguez,4899315,,False,12.0,0,0,0,0,0,0,1,2,2,1,3,3,1,0,1,0,1
401418107,Harvard Crimson,A. Stritzel,4594963,,False,19.0,4,5,4,4,0,1,0,2,1,1,2,3,4,0,1,0,8
401418107,Harvard Crimson,G. Donaldson,4594962,,False,9.0,1,3,1,1,0,2,0,0,0,1,1,0,0,0,1,0,2
401418107,Harvard Crimson,S. Park,4594960,,False,6.0,0,2,0,0,0,2,0,0,1,0,1,0,0,0,0,0,0
401418107,Harvard Crimson,TEAM,TOTAL,TOTAL,False,,34,69,19,30,15,39,2,10,10,28,38,20,13,2,6,8,85
401418107,Dartmouth Big Green,D. Ariik,4899313,,True,28.0,4,10,4,10,0,0,1,2,5,3,8,0,1,0,0,0,9
401418107,Dartmouth Big Green,E. Koch,4594967,,True,17.0,0,3,0,1,0,2,0,0,1,3,4,0,1,0,0,2,0
401418107,Dartmouth Big Green,M. Boyd,4703759,,True,22.0,3,7,1,3,2,4,2,2,0,2,2,0,0,0,3,0,10
401418107,Dartmouth Big Green,J. Abejon,4399181,,True,27.0,2,11,2,7,0,4,0,0,1,2,3,2,1,0,3,0,4
401418107,Dartmouth Big Green,K. Douglas,4399178,,True,26.0,3,8,1,1,2,7,0,1,0,2,2,0,0,0,2,0,8
401418107,Dartmouth Big Green,G. Niekelski,4899312,,False,13.0,3,6,2,3,1,3,0,0,1,3,4,0,0,0,2,0,7
401418107,Dartmouth Big Green,R. Jennings,4705222,,False,4.0,0,0,0,0,0,0,0,0,0,0,0,0,0,0,0,0,0
401418107,Dartmouth Big Green,C. Washburn,4705221,,False,18.0,1,1,1,1,0,0,1,2,0,6,6,1,1,1,3,3,3
401418107,Dartmouth Big Green,V. Page,4899314,,False,20.0,3,5,3,4,0,1,0,0,1,1,2,4,0,0,3,2,6
401418107,Dartmouth Big Green,M. Curtis,4705219,,False,13.0,1,6,1,2,0,4,0,0,0,2,2,0,0,0,1,0,2
401418107,Dartmouth Big Green,A. Harland,4594965,,False,8.0,1,1,0,0,1,1,0,0,0,0,0,0,0,0,1,1,3
401418107,Dartmouth Big Green,K. Mitchell,4594964,,False,4.0,0,0,0,0,0,0,0,0,0,0,0,0,0,0,1,0,0
401418107,Dartmouth Big Green,TEAM,TOTAL,TOTAL,False,,21,58,15,32,6,26,4,7,10,29,39,7,4,1,21,8,52
401418096,Xavier Musketeers,C. Prenger,4595177,,True,32.0,0,3,0,1,0,2,0,0,1,5,6,1,1,0,2,1,0
401418096,Xavier Musketeers,A. Harris,4899027,,True,32.0,6,12,6,9,0,3,3,3,1,1,2,0,1,0,3,1,15
401418096,Xavier Musketeers,A. Townsend,4399428,,True,31.0,3,9,3,9,0,0,1,3,2,5,7,3,1,2,1,2,7
401418096,Xavier Musketeers,M. Scarlett,4704671,,True,25.0,0,7,0,4,0,3,3,4,0,5,5,4,0,0,1,3,3
401418096,Xavier Musketeers,S. Beeler,4433039,,True,32.0,7,12,7,12,0,0,0,0,0,1,1,4,0,0,2,3,14
401418096,Xavier Musketeers,M. Harkey,4704673,,False,18.0,2,4,2,4,0,0,0,0,1,3,4,0,0,0,1,1,4
401418096,Xavier Musketeers,K. Woods,4899026,,False,30.0,3,9,1,5,2,4,2,2,2,4,6,3,1,1,0,1,10
401418096,Xavier Musketeers,TEAM,TOTAL,TOTAL,False,,21,56,19,44,2,12,9,12,8,25,33,15,4,3,10,12,53
401418096,Seton Hall Pirates,M. Bembry,4433041,,True,29.0,3,5,3,5,0,0,0,2,3,4,7,1,0,0,0,1,6
401418096,Seton Hall Pirates,S. Cooks,4281245,,True,35.0,9,16,9,14,0,2,2,2,1,9,10,4,1,1,2,2,20
401418096,Seton Hall Pirates,M. Jackson,4595161,,True,37.0,7,13,3,5,4,8,2,3,1,4,5,2,3,0,1,1,20
401418096,Seton Hall Pirates,L. Park-Lane,4433379,,True,36.0,2,9,1,5,1,4,2,2,1,2,3,13,2,1,4,2,7
401418096,Seton Hall Pirates,A. Espinoza-Hunter,4281075,,True,36.0,7,15,4,8,3,7,1,1,1,4,5,3,3,1,0,2,18
401418096,Seton Hall Pirates,S. Treadwell,4598613,,False,3.0,0,1,0,0,0,1,0,0,0,0,0,0,0,0,0,0,0
401418096,Seton Hall Pirates,K. Harris,4595164,,False,4.0,0,0,0,0,0,0,1,2,0,1,1,0,0,0,0,0,1
401418096,Seton Hall Pirates,A. Wright,4704306,,False,4.0,0,0,0,0,0,0,0,0,0,1,1,2,0,0,0,0,0
401418096,Seton Hall Pirates,C. Dean,4704305,,False,9.0,1,4,1,2,0,2,0,0,0,2,2,0,0,1,1,2,2
401418096,Seton Hall Pirates,D. Robinson,4399386,,False,3.0,0,2,0,1,0,1,0,0,0,0,0,0,1,0,0,1,0
401418096,Seton Hall Pirates,K. Armstrong,4068589,,False,5.0,0,0,0,0,0,0,0,0,0,0,0,0,0,0,0,1,0
401418096,Seton Hall Pirates,TEAM,TOTAL,TOTAL,False,,29,65,21,40,8,25,8,12,13,29,42,25,10,4,8,12,74
401415990,Nevada Wolf Pack,L. Givens,4704506,,True,13.0,2,4,2,4,0,0,1,2,1,2,3,1,0,0,3,5,5
401415990,Nevada Wolf Pack,A. Jimenez,4595635,,True,32.0,3,5,1,2,2,3,0,0,1,3,4,1,3,0,1,1,8
401415990,Nevada Wolf Pack,A. West,4400134,,True,32.0,2,5,2,3,0,2,0,0,0,3,3,0,0,0,1,4,4
401415990,Nevada Wolf Pack,D. Hamilton,4400132,,True,28.0,5,15,3,8,2,7,3,4,1,6,7,1,2,0,5,0,15
401415990,Nevada Wolf Pack,K. Jimenez,4281683,,True,37.0,5,11,3,8,2,3,0,0,0,4,4,6,6,0,1,2,12
401415990,Nevada Wolf Pack,N. Lathrop,4900576,,False,9.0,0,0,0,0,0,0,0,0,0,0,0,0,0,0,0,1,0
401415990,Nevada Wolf Pack,K. Borden,4900574,,False,18.0,5,6,2,2,3,4,0,0,0,1,1,2,0,0,0,1,13
401415990,Nevada Wolf Pack,A. Roden,4900573,,False,19.0,2,6,2,4,0,2,0,0,0,2,2,1,2,3,3,2,4
401415990,Nevada Wolf Pack,N. Alexander,4068433,,False,12.0,2,3,2,3,0,0,0,0,0,1,1,0,0,0,0,2,4
401415990,Nevada Wolf Pack,TEAM,TOTAL,TOTAL,False,,26,55,17,34,9,21,4,6,4,22,26,12,13,3,14,18,65
401415990,Bowling Green Falcons,K. Hempfling,4399299,,True,31.0,6,8,3,4,3,4,4,5,0,4,4,6,3,0,2,3,19
401415990,Bowling Green Falcons,A. Velasco,4899612,,True,17.0,2,7,1,2,1,5,0,0,1,1,2,0,0,0,3,1,5
401415990,Bowling Green Falcons,N. Hampton,4704864,,True,27.0,1,7,1,4,0,3,0,0,0,4,4,2,2,0,3,3,2
401415990,Bowling Green Falcons,E. Brett,4595223,,True,30.0,3,6,2,4,1,2,5,6,4,5,9,1,3,0,3,3,12
401415990,Bowling Green Falcons,M. Parker,4282037,,True,24.0,3,8,0,0,3,8,0,0,0,0,0,3,0,0,0,0,9
401415990,Bowling Green Falcons,O. Hill,4704865,,False,1.0,0,1,0,0,0,1,0,0,0,0,0,0,0,0,0,0,0
401415990,Bowling Green Falcons,J. Tate,4899613,,False,27.0,4,7,4,7,0,0,1,2,4,7,11,2,2,0,2,1,9
401415990,Bowling Green Falcons,K. Lewis,4704866,,False,27.0,2,2,1,1,1,1,1,2,0,2,2,2,0,0,3,2,6
401415990,Bowling Green Falcons,M. Sharps,4595176,,False,16.0,3,9,0,0,3,9,2,2,0,1,1,1,0,0,0,0,11
401415990,Bowling Green Falcons,M. Dever,4399297,,False,0.0,0,0,0,0,0,0,0,0,0,0,0,0,0,0,0,0,0
401415990,Bowling Green Falcons,TEAM,TOTAL,TOTAL,False,,24,55,12,22,12,33,13,17,12,26,38,17,10,0,17,13,73
401415949,Davidson Wildcats,E. Sutphin,4594389,,True,23.0,4,7,2,5,2,2,0,0,0,5,5,1,0,0,3,2,10
401415949,Davidson Wildcats,I. Morgan,4898417,,True,31.0,3,7,1,4,2,3,3,4,0,3,3,3,1,0,1,4,11
401415949,Davidson Wildcats,C. Gould,4399043,,True,28.0,1,3,0,1,1,2,1,2,0,3,3,1,0,0,2,3,4
401415949,Davidson Wildcats,S. Konstans,4399042,,True,23.0,3,4,2,2,1,2,2,2,1,4,5,0,0,0,0,1,9
401415949,Davidson Wildcats,C. Welch,4399041,,True,36.0,1,3,1,3,0,0,6,8,0,3,3,2,0,0,3,2,8
401415949,Davidson Wildcats,T. Adenupe,4898419,,False,17.0,5,5,4,4,1,1,0,0,0,0,0,0,0,0,1,2,11
401415949,Davidson Wildcats,A. Fuller,4594435,,False,17.0,2,6,2,6,0,0,2,2,1,4,5,0,0,0,1,1,6
401415949,Davidson Wildcats,C. Tabor,4594433,,False,22.0,1,4,0,2,1,2,4,4,1,4,5,2,2,0,0,1,7
401415949,Davidson Wildcats,M. Haines,4433557,,False,3.0,0,0,0,0,0,0,0,0,0,0,0,0,0,0,0,0,0
401415949,Davidson Wildcats,TEAM,TOTAL,TOTAL,False,,20,39,12,27,8,12,18,22,3,26,29,9,3,0,12,16,66
401415949,Austin Peay Governors,D. Booker,4399560,,True,23.0,5,5,5,5,0,0,2,2,1,5,6,0,0,0,0,2,12
401415949,Austin Peay Governors,N. De Leon Negron,4705089,,True,36.0,2,3,2,2,0,1,0,0,2,2,4,2,0,0,0,3,4
401415949,Austin Peay Governors,E. Sawyer,4595701,,True,21.0,0,2,0,1,0,1,0,0,0,2,2,3,1,0,3,4,0
401415949,Austin Peay Governors,K. Kidwell,4399561,,True,11.0,0,2,0,0,0,2,0,0,0,1,1,0,1,0,1,3,0
401415949,Austin Peay Governors,K. Pace,4282394,,True,32.0,6,16,4,7,2,9,1,2,0,0,0,4,2,0,3,2,15
401415949,Austin Peay Governors,K. Ward,4705091,,False,17.0,2,2,2,2,0,0,2,3,1,1,2,0,0,1,1,1,6
401415949,Austin Peay Governors,S. Kirby,4595702,,False,31.0,4,7,1,3,3,4,0,0,0,4,4,2,1,0,0,1,11
401415949,Austin Peay Governors,L. Gibbs,4595233,,False,2.0,0,1,0,1,0,0,0,0,0,0,0,0,0,1,0,3,0
401415949,Austin Peay Governors,Y. Johnson,4399804,,False,27.0,3,13,2,8,1,5,3,5,1,0,1,2,0,0,0,2,10
401415949,Austin Peay Governors,TEAM,TOTAL,TOTAL,False,,22,51,16,29,6,22,8,12,5,18,23,13,5,2,8,21,58
401415948,Northeastern Huskies,L. Õztürk,4705029,,True,20.0,0,2,0,2,0,0,0,0,1,2,3,1,0,0,0,1,0
401415948,Northeastern Huskies,E. Calabrese,4281866,,True,31.0,2,10,2,9,0,1,0,0,2,3,5,1,0,0,1,4,4
401415948,Northeastern Huskies,C. McCartney,4594735,,True,27.0,2,7,2,5,0,2,0,0,0,4,4,2,1,0,0,1,4
401415948,Northeastern Huskies,C. Soriano,4899587,,True,35.0,9,17,3,7,6,10,0,0,1,3,4,3,2,0,4,2,24
401415948,Northeastern Huskies,G. Motema,4899585,,True,37.0,10,15,9,12,1,3,1,1,1,1,2,3,3,0,3,2,22
401415948,Northeastern Huskies,I. Larsen,4705028,,False,21.0,1,5,1,3,0,2,0,0,1,3,4,1,0,0,1,1,2
401415948,Northeastern Huskies,C. Clement,4899583,,False,5.0,0,0,0,0,0,0,0,0,0,0,0,0,0,0,1,1,0
401415948,Northeastern Huskies,A. Sapenter,4710685,,False,24.0,2,5,1,2,1,3,0,0,2,1,3,0,1,0,2,3,5
401415948,Northeastern Huskies,TEAM,TOTAL,TOTAL,False,,26,61,18,40,8,21,1,1,9,19,28,11,7,0,12,15,61
401415948,Furman Paladins,G. van Rij,4400619,,True,29.0,1,1,1,1,0,0,1,3,1,2,3,1,0,0,2,3,3
401415948,Furman Paladins,N. Henley,4900397,,True,7.0,0,0,0,0,0,0,0,0,0,0,0,0,0,0,0,0,0
401415948,Furman Paladins,J. Outten,4900395,,True,4.0,0,0,0,0,0,0,0,0,0,0,0,1,0,0,1,0,0
401415948,Furman Paladins,T. Walters,4704252,,True,35.0,3,12,1,4,2,8,1,2,1,5,6,6,3,0,6,2,9
401415948,Furman Paladins,T. Hodges,4068935,,True,40.0,9,18,9,14,0,4,7,8,4,9,13,2,2,0,2,0,25
401415948,Furman Paladins,K. Whitaker,4900399,,False,2.0,0,0,0,0,0,0,0,0,0,0,0,0,0,0,0,0,0
401415948,Furman Paladins,K. Johnson,4900398,,False,11.0,2,2,2,2,0,0,1,2,1,1,2,0,1,0,1,2,5
401415948,Furman Paladins,S. James,4704257,,False,29.0,4,11,1,6,3,5,2,2,3,4,7,2,0,0,0,1,13
401415948,Furman Paladins,P. Koilia,4704255,,False,3.0,0,0,0,0,0,0,0,0,0,0,0,0,0,0,0,0,0
401415948,Furman Paladins,E. DePetro,4704251,,False,4.0,0,0,0,0,0,0,0,0,0,0,0,1,0,0,0,0,0
401415948,Furman Paladins,G. Boone,4400621,,False,36.0,5,10,1,2,4,8,0,0,0,3,3,1,0,0,1,0,14
401415948,Furman Paladins,TEAM,TOTAL,TOTAL,False,,24,54,15,29,9,25,12,17,14,26,40,14,6,0,13,8,69
401415947,Saint Mary's Gaels,A. Bamberger,4433035,,True,28.0,6,7,6,6,0,1,9,9,4,6,10,3,0,3,0,1,21
401415947,Saint Mary's Gaels,M. Mastora,4899391,,True,20.0,1,4,1,2,0,2,2,3,0,4,4,2,0,0,1,3,4
401415947,Saint Mary's Gaels,T. Dalton,4703841,,True,32.0,3,6,1,1,2,5,1,2,1,4,5,2,0,0,3,4,9
401415947,Saint Mary's Gaels,T. Wedin,4400497,,True,37.0,8,20,1,5,7,15,2,2,1,3,4,1,0,0,1,0,25
401415947,Saint Mary's Gaels,M. Holland,4282100,,True,37.0,7,13,7,13,0,0,1,2,2,3,5,5,3,0,5,3,15
401415947,Saint Mary's Gaels,A. Garrison,4899394,,False,7.0,1,1,1,1,0,0,0,0,0,2,2,0,0,0,1,0,2
401415947,Saint Mary's Gaels,E. Croco,4703842,,False,2.0,0,0,0,0,0,0,0,0,0,0,0,0,0,0,1,0,0
401415947,Saint Mary's Gaels,A. West,4316443,,False,16.0,2,4,2,4,0,0,0,0,2,2,4,1,0,0,2,3,4
401415947,Saint Mary's Gaels,L. Hanafin,4703840,,False,21.0,0,1,0,1,0,0,0,0,0,3,3,5,0,0,1,3,0
401415947,Saint Mary's Gaels,TEAM,TOTAL,TOTAL,False,,28,56,19,33,9,23,15,18,10,32,42,19,3,3,16,17,80
401415947,Cleveland State Vikings,N. Dumas,4281944,,True,25.0,4,11,3,10,1,1,1,2,6,1,7,1,1,0,1,4,10
401415947,Cleveland State Vikings,I. Gradwell,4399213,,True,26.0,0,5,0,0,0,5,0,0,2,4,6,0,1,0,0,2,0
401415947,Cleveland State Vikings,D. Leo,4704139,,True,36.0,10,24,6,11,4,13,8,10,0,2,2,2,1,0,1,0,32
401415947,Cleveland State Vikings,B. Zieniewska,4704138,,True,15.0,0,1,0,1,0,0,0,0,0,0,0,1,1,0,0,0,0
401415947,Cleveland State Vikings,G. Smith,4399287,,True,32.0,5,14,3,6,2,8,4,4,0,4,4,0,0,0,2,2,16
401415947,Cleveland State Vikings,B. Moore,4400437,,False,26.0,2,8,1,5,1,3,4,4,4,3,7,0,4,0,0,0,9
401415947,Cleveland State Vikings,A. Ngwafang,4400001,,False,15.0,1,5,1,5,0,0,0,0,0,1,1,0,0,1,0,1,2
401415947,Cleveland State Vikings,D. Williams,4595191,,False,12.0,1,5,1,2,0,3,0,0,1,0,1,0,1,0,2,2,2
401415947,Cleveland State Vikings,I. Geraci,4399211,,False,13.0,1,3,1,1,0,2,0,0,2,1,3,0,0,0,0,0,2
401415947,Cleveland State Vikings,TEAM,TOTAL,TOTAL,False,,24,76,16,41,8,35,17,20,20,18,38,4,9,1,6,11,73
401415946,Northeastern Huskies,L. Õztürk,4705029,,True,27.0,2,5,2,5,0,0,6,6,2,3,5,0,1,0,0,3,10
401415946,Northeastern Huskies,E. Calabrese,4281866,,True,21.0,1,5,1,5,0,0,0,0,1,0,1,0,0,0,2,2,2
401415946,Northeastern Huskies,C. McCartney,4594735,,True,28.0,0,4,0,2,0,2,4,4,4,7,11,1,0,0,3,4,4
401415946,Northeastern Huskies,C. Soriano,4899587,,True,29.0,3,12,3,6,0,6,2,2,0,3,3,1,3,0,3,2,8
401415946,Northeastern Huskies,G. Motema,4899585,,True,33.0,7,10,7,9,0,1,6,8,1,1,2,1,1,0,5,0,20
401415946,Northeastern Huskies,A. Parker,4899586,,False,13.0,2,4,2,4,0,0,0,1,1,2,3,0,0,0,0,3,4
401415946,Northeastern Huskies,I. Larsen,4705028,,False,9.0,4,6,4,5,0,1,2,2,0,0,0,0,1,0,0,1,10
401415946,Northeastern Huskies,C. Clement,4899583,,False,21.0,1,8,0,3,1,5,1,2,2,3,5,2,0,0,1,0,4
401415946,Northeastern Huskies,A. Sapenter,4710685,,False,19.0,1,4,0,1,1,3,0,0,1,2,3,1,1,0,2,4,3
401415946,Northeastern Huskies,TEAM,TOTAL,TOTAL,False,,21,58,19,40,2,18,21,25,13,22,35,6,7,0,16,19,65
401415946,Davidson Wildcats,E. Sutphin,4594389,,True,22.0,4,7,3,6,1,1,0,0,1,3,4,3,0,2,0,2,9
401415946,Davidson Wildcats,I. Morgan,4898417,,True,26.0,4,9,4,6,0,3,0,0,0,2,2,9,4,0,4,2,8
401415946,Davidson Wildcats,C. Gould,4399043,,True,19.0,3,5,2,2,1,3,0,0,0,1,1,2,1,0,1,2,7
401415946,Davidson Wildcats,S. Konstans,4399042,,True,20.0,2,5,0,2,2,3,1,2,1,4,5,0,0,1,1,2,7
401415946,Davidson Wildcats,C. Welch,4399041,,True,30.0,7,11,4,6,3,5,2,2,0,5,5,1,3,1,5,0,19
401415946,Davidson Wildcats,M. Prather,4898420,,False,2.0,0,1,0,0,0,1,0,0,0,1,1,0,0,0,0,0,0
401415946,Davidson Wildcats,T. Adenupe,4898419,,False,15.0,4,5,4,5,0,0,4,4,0,1,1,0,1,0,0,2,12
401415946,Davidson Wildcats,K. Evans,4712419,,False,5.0,0,0,0,0,0,0,0,0,0,0,0,0,0,0,0,0,0
401415946,Davidson Wildcats,A. Fuller,4594435,,False,13.0,0,1,0,1,0,0,1,2,0,3,3,2,1,0,0,3,1
401415946,Davidson Wildcats,C. Tabor,4594433,,False,23.0,8,12,6,7,2,5,0,0,1,3,4,3,0,0,1,5,18
401415946,Davidson Wildcats,S. Schutz,4433772,,False,12.0,2,3,2,2,0,1,0,0,0,0,0,0,0,0,0,2,4
401415946,Davidson Wildcats,M. Haines,4433557,,False,13.0,1,4,0,0,1,4,2,2,0,2,2,1,1,0,0,2,5
401415946,Davidson Wildcats,TEAM,TOTAL,TOTAL,False,,35,63,25,37,10,26,10,12,7,25,32,21,11,4,12,22,90
401415945,Furman Paladins,G. van Rij,4400619,,True,39.0,4,11,4,11,0,0,3,4,2,1,3,1,0,0,1,3,11
401415945,Furman Paladins,N. Henley,4900397,,True,28.0,3,5,3,3,0,2,0,0,1,2,3,0,0,1,1,3,6
401415945,Furman Paladins,J. Outten,4900395,,True,18.0,2,3,2,3,0,0,0,2,0,3,3,2,0,0,0,0,4
401415945,Furman Paladins,T. Walters,4704252,,True,21.0,2,7,2,2,0,5,3,4,3,1,4,4,2,0,9,4,7
401415945,Furman Paladins,T. Hodges,4068935,,True,39.0,9,17,8,14,1,3,4,5,2,6,8,1,3,0,2,1,23
401415945,Furman Paladins,K. Johnson,4900398,,False,1.0,0,0,0,0,0,0,0,0,0,0,0,0,0,0,0,0,0
401415945,Furman Paladins,J. Session,4900396,,False,1.0,0,0,0,0,0,0,0,0,0,0,0,0,0,0,1,0,0
401415945,Furman Paladins,J. Hill-Mims,4704253,,False,0.0,0,0,0,0,0,0,0,0,0,0,0,0,0,0,0,0,0
401415945,Furman Paladins,S. James,4704257,,False,33.0,4,9,4,5,0,4,0,0,1,2,3,1,0,0,1,1,8
401415945,Furman Paladins,P. Koilia,4704255,,False,6.0,0,0,0,0,0,0,0,0,0,1,1,2,0,0,0,0,0
401415945,Furman Paladins,K. Grier,4704254,,False,0.0,0,0,0,0,0,0,0,0,0,0,0,0,0,0,0,1,0
401415945,Furman Paladins,E. DePetro,4704251,,False,2.0,0,0,0,0,0,0,0,0,0,0,0,0,0,0,1,1,0
401415945,Furman Paladins,G. Boone,4400621,,False,12.0,0,0,0,0,0,0,0,0,1,0,1,2,1,0,0,0,0
401415945,Furman Paladins,TEAM,TOTAL,TOTAL,False,,24,52,23,38,1,14,10,15,12,18,30,13,6,1,16,14,59
401415945,Austin Peay Governors,D. Booker,4399560,,True,25.0,4,9,4,9,0,0,2,2,1,4,5,0,0,0,1,4,10
401415945,Austin Peay Governors,N. De Leon Negron,4705089,,True,18.0,0,1,0,1,0,0,0,0,1,1,2,5,2,0,0,1,0
401415945,Austin Peay Governors,E. Sawyer,4595701,,True,19.0,2,3,2,2,0,1,0,0,1,4,5,0,0,1,1,4,4
401415945,Austin Peay Governors,K. Kidwell,4399561,,True,32.0,2,5,0,0,2,5,5,6,0,0,0,0,0,0,1,3,11
401415945,Austin Peay Governors,K. Pace,4282394,,True,30.0,5,13,3,7,2,6,0,0,0,0,0,5,3,0,2,1,12
401415945,Austin Peay Governors,K. Ward,4705091,,False,14.0,1,1,1,1,0,0,0,0,1,0,1,0,2,0,1,0,2
401415945,Austin Peay Governors,S. Kirby,4595702,,False,11.0,1,3,0,1,1,2,0,0,0,0,0,1,0,0,2,2,3
401415945,Austin Peay Governors,L. Gibbs,4595233,,False,19.0,1,2,1,2,0,0,0,0,1,1,2,3,0,1,2,2,2
401415945,Austin Peay Governors,Y. Johnson,4399804,,False,32.0,9,14,4,6,5,8,6,6,1,5,6,0,0,0,2,1,29
401415945,Austin Peay Governors,TEAM,TOTAL,TOTAL,False,,25,51,15,29,10,22,13,14,8,19,27,14,7,2,14,18,73
401415944,Nevada Wolf Pack,L. Givens,4704506,,True,24.0,3,6,3,6,0,0,0,0,0,5,5,2,2,0,1,2,6
401415944,Nevada Wolf Pack,A. Jimenez,4595635,,True,28.0,2,4,1,2,1,2,2,2,2,2,4,2,1,0,2,3,7
401415944,Nevada Wolf Pack,A. West,4400134,,True,27.0,4,12,3,8,1,4,1,1,0,1,1,2,3,1,4,4,10
401415944,Nevada Wolf Pack,D. Hamilton,4400132,,True,38.0,4,17,3,8,1,9,1,1,0,1,1,8,2,0,4,2,10
401415944,Nevada Wolf Pack,K. Jimenez,4281683,,True,34.0,2,7,0,2,2,5,0,0,0,5,5,0,2,0,0,4,6
401415944,Nevada Wolf Pack,N. Lathrop,4900576,,False,3.0,0,0,0,0,0,0,0,0,0,1,1,0,0,0,1,1,0
401415944,Nevada Wolf Pack,K. Borden,4900574,,False,13.0,1,3,0,0,1,3,0,0,0,0,0,1,1,0,0,1,3
401415944,Nevada Wolf Pack,A. Roden,4900573,,False,9.0,0,2,0,0,0,2,0,0,0,0,0,1,3,0,2,2,0
401415944,Nevada Wolf Pack,G. Rones,4704505,,False,3.0,0,0,0,0,0,0,0,0,0,0,0,0,0,0,0,1,0
401415944,Nevada Wolf Pack,N. Alexander,4068433,,False,21.0,4,8,4,7,0,1,0,0,1,0,1,0,1,0,3,3,8
401415944,Nevada Wolf Pack,TEAM,TOTAL,TOTAL,False,,20,59,14,33,6,26,4,4,5,17,22,16,15,1,18,23,50
401415944,Cleveland State Vikings,N. Dumas,4281944,,True,36.0,1,4,1,4,0,0,4,6,3,4,7,1,1,0,2,2,6
401415944,Cleveland State Vikings,I. Gradwell,4399213,,True,20.0,0,1,0,1,0,0,2,2,1,4,5,1,1,0,3,1,2
401415944,Cleveland State Vikings,D. Leo,4704139,,True,33.0,6,14,3,5,3,9,4,4,0,4,4,1,1,1,10,0,19
401415944,Cleveland State Vikings,B. Zieniewska,4704138,,True,12.0,0,4,0,3,0,1,0,0,2,2,4,2,1,1,3,1,0
401415944,Cleveland State Vikings,G. Smith,4399287,,True,37.0,3,8,2,5,1,3,1,2,1,1,2,1,2,0,1,1,8
401415944,Cleveland State Vikings,B. Moore,4400437,,False,24.0,4,5,3,4,1,1,5,5,2,6,8,0,1,0,4,1,14
401415944,Cleveland State Vikings,A. Ngwafang,4400001,,False,9.0,0,1,0,1,0,0,0,2,1,3,4,0,0,0,3,2,0
401415944,Cleveland State Vikings,D. Williams,4595191,,False,10.0,1,2,1,2,0,0,0,0,0,1,1,0,0,0,0,2,2
401415944,Cleveland State Vikings,I. Geraci,4399211,,False,19.0,3,5,2,3,1,2,0,1,1,4,5,2,1,0,1,0,7
401415944,Cleveland State Vikings,TEAM,TOTAL,TOTAL,False,,18,44,12,28,6,16,16,22,12,34,46,8,8,2,29,10,58
401415943,Saint Mary's Gaels,A. Bamberger,4433035,,True,33.0,6,11,6,9,0,2,6,6,2,7,9,4,0,1,4,1,18
401415943,Saint Mary's Gaels,M. Mastora,4899391,,True,21.0,3,5,1,2,2,3,2,2,0,2,2,1,0,0,3,3,10
401415943,Saint Mary's Gaels,L. Hanafin,4703840,,True,20.0,0,2,0,2,0,0,0,0,0,1,1,4,1,1,1,2,0
401415943,Saint Mary's Gaels,T. Wedin,4400497,,True,35.0,9,17,3,8,6,9,0,0,0,2,2,1,2,1,3,3,24
401415943,Saint Mary's Gaels,M. Holland,4282100,,True,30.0,4,15,2,11,2,4,0,0,4,6,10,5,1,1,1,3,10
401415943,Saint Mary's Gaels,A. Garrison,4899394,,False,6.0,1,1,1,1,0,0,0,0,0,1,1,0,0,0,0,2,2
401415943,Saint Mary's Gaels,E. Croco,4703842,,False,2.0,0,0,0,0,0,0,0,0,0,0,0,0,0,0,1,0,0
401415943,Saint Mary's Gaels,A. West,4316443,,False,22.0,1,2,1,2,0,0,0,0,2,9,11,1,0,2,1,1,2
401415943,Saint Mary's Gaels,T. Dalton,4703841,,False,31.0,4,6,4,5,0,1,2,2,0,1,1,2,0,1,2,3,10
401415943,Saint Mary's Gaels,TEAM,TOTAL,TOTAL,False,,28,59,18,40,10,19,10,10,10,34,44,18,4,7,18,18,76
401415943,Bowling Green Falcons,K. Hempfling,4399299,,True,17.0,3,10,2,8,1,2,0,0,1,3,4,2,1,0,0,3,7
401415943,Bowling Green Falcons,A. Velasco,4899612,,True,34.0,4,14,2,8,2,6,6,6,0,1,1,3,2,0,2,2,16
401415943,Bowling Green Falcons,N. Hampton,4704864,,True,24.0,3,4,2,3,1,1,0,0,0,1,1,2,1,0,2,2,7
401415943,Bowling Green Falcons,E. Brett,4595223,,True,25.0,3,7,2,6,1,1,1,2,1,2,3,2,5,0,2,1,8
401415943,Bowling Green Falcons,M. Parker,4282037,,True,23.0,1,5,0,1,1,4,0,0,0,1,1,1,0,0,1,0,3
401415943,Bowling Green Falcons,O. Hill,4704865,,False,5.0,0,2,0,2,0,0,0,0,1,1,2,0,0,0,1,0,0
401415943,Bowling Green Falcons,S. Dziekan,4704863,,False,10.0,2,2,2,2,0,0,0,0,0,0,0,0,0,0,1,3,4
401415943,Bowling Green Falcons,J. Tate,4899613,,False,19.0,1,4,1,4,0,0,2,6,2,4,6,0,0,0,1,2,4
401415943,Bowling Green Falcons,K. Lewis,4704866,,False,20.0,1,1,1,1,0,0,1,1,0,2,2,2,0,0,0,1,3
401415943,Bowling Green Falcons,M. Sharps,4595176,,False,23.0,6,14,4,10,2,4,1,1,1,4,5,0,1,1,0,1,15
401415943,Bowling Green Falcons,TEAM,TOTAL,TOTAL,False,,24,63,16,45,8,18,11,16,8,21,29,12,10,1,10,15,67
401415942,Nevada Wolf Pack,L. Givens,4704506,,True,27.0,2,6,2,5,0,1,7,8,4,3,7,2,3,1,4,2,11
401415942,Nevada Wolf Pack,A. Jimenez,4595635,,True,28.0,3,7,1,4,2,3,0,0,1,1,2,4,2,0,1,2,8
401415942,Nevada Wolf Pack,A. West,4400134,,True,27.0,3,8,3,7,0,1,3,4,0,3,3,0,1,0,1,2,9
401415942,Nevada Wolf Pack,D. Hamilton,4400132,,True,34.0,6,11,2,4,4,7,2,2,0,2,2,2,1,0,0,1,18
401415942,Nevada Wolf Pack,K. Jimenez,4281683,,True,38.0,5,10,2,3,3,7,4,4,0,2,2,1,1,0,2,2,17
401415942,Nevada Wolf Pack,N. Lathrop,4900576,,False,13.0,0,0,0,0,0,0,0,0,0,2,2,0,0,0,2,0,0
401415942,Nevada Wolf Pack,K. Borden,4900574,,False,6.0,1,1,1,1,0,0,0,0,0,1,1,0,0,0,1,2,2
401415942,Nevada Wolf Pack,A. Roden,4900573,,False,2.0,1,1,1,1,0,0,0,0,0,2,2,0,0,0,2,2,2
401415942,Nevada Wolf Pack,G. Rones,4704505,,False,12.0,1,1,0,0,1,1,0,0,1,0,1,2,0,0,0,1,3
401415942,Nevada Wolf Pack,N. Alexander,4068433,,False,13.0,1,4,1,4,0,0,4,4,1,2,3,1,1,0,1,1,6
401415942,Nevada Wolf Pack,TEAM,TOTAL,TOTAL,False,,23,49,13,29,10,20,20,22,8,24,32,12,9,1,14,15,76
401415942,Davidson Wildcats,E. Sutphin,4594389,,True,31.0,3,8,3,7,0,1,2,2,0,3,3,2,0,0,2,4,8
401415942,Davidson Wildcats,I. Morgan,4898417,,True,30.0,5,12,4,7,1,5,1,1,1,0,1,6,1,0,0,4,12
401415942,Davidson Wildcats,C. Gould,4399043,,True,22.0,4,7,2,2,2,5,0,0,0,2,2,2,1,0,2,1,10
401415942,Davidson Wildcats,S. Konstans,4399042,,True,21.0,0,1,0,0,0,1,1,2,1,1,2,0,2,0,0,3,1
401415942,Davidson Wildcats,C. Welch,4399041,,True,32.0,5,13,2,5,3,8,0,0,1,0,1,1,0,0,6,2,13
401415942,Davidson Wildcats,T. Adenupe,4898419,,False,10.0,2,2,2,2,0,0,0,0,0,1,1,2,0,0,0,1,4
401415942,Davidson Wildcats,K. Evans,4712419,,False,1.0,0,0,0,0,0,0,0,0,0,0,0,0,0,0,0,0,0
401415942,Davidson Wildcats,A. Fuller,4594435,,False,17.0,2,2,1,1,1,1,0,0,0,2,2,0,1,0,1,1,5
401415942,Davidson Wildcats,C. Tabor,4594433,,False,25.0,1,4,1,3,0,1,2,2,0,3,3,2,1,1,3,0,4
401415942,Davidson Wildcats,S. Schutz,4433772,,False,5.0,0,1,0,0,0,1,0,0,0,0,0,0,0,0,0,0,0
401415942,Davidson Wildcats,M. Haines,4433557,,False,6.0,2,3,0,0,2,3,0,0,0,0,0,0,0,0,0,0,6
401415942,Davidson Wildcats,TEAM,TOTAL,TOTAL,False,,24,53,15,27,9,26,6,7,5,18,23,15,6,1,14,16,63
401415941,Northeastern Huskies,L. Õztürk,4705029,,True,27.0,3,5,3,5,0,0,0,0,1,1,2,0,1,1,0,1,6
401415941,Northeastern Huskies,E. Calabrese,4281866,,True,23.0,3,6,3,6,0,0,0,0,0,4,4,2,0,0,1,3,6
401415941,Northeastern Huskies,C. McCartney,4594735,,True,24.0,3,6,3,6,0,0,0,0,2,3,5,2,2,1,2,2,6
401415941,Northeastern Huskies,C. Soriano,4899587,,True,33.0,6,14,3,8,3,6,2,2,1,4,5,1,6,1,5,3,17
401415941,Northeastern Huskies,G. Motema,4899585,,True,33.0,5,11,5,11,0,0,3,3,2,0,2,1,1,0,2,1,13
401415941,Northeastern Huskies,A. Parker,4899586,,False,17.0,0,3,0,3,0,0,0,0,2,2,4,0,1,0,5,0,0
401415941,Northeastern Huskies,I. Larsen,4705028,,False,18.0,0,5,0,5,0,0,0,0,1,2,3,1,3,0,0,3,0
401415941,Northeastern Huskies,C. Clement,4899583,,False,20.0,3,8,0,1,3,7,0,0,1,1,2,1,0,0,0,0,9
401415941,Northeastern Huskies,A. Sapenter,4710685,,False,5.0,1,1,1,1,0,0,1,1,2,0,2,0,0,0,1,1,3
401415941,Northeastern Huskies,TEAM,TOTAL,TOTAL,False,,24,59,18,46,6,13,6,6,13,18,31,8,14,3,17,14,60
401415941,Cleveland State Vikings,N. Dumas,4281944,,True,29.0,2,6,2,6,0,0,1,3,5,3,8,2,2,1,4,3,5
401415941,Cleveland State Vikings,I. Gradwell,4399213,,True,29.0,3,7,2,4,1,3,6,6,2,1,3,3,0,0,1,3,13
401415941,Cleveland State Vikings,D. Leo,4704139,,True,34.0,8,17,2,3,6,14,1,1,0,2,2,1,2,1,3,1,23
401415941,Cleveland State Vikings,B. Zieniewska,4704138,,True,15.0,2,3,1,1,1,2,1,1,1,2,3,2,1,0,2,1,6
401415941,Cleveland State Vikings,G. Smith,4399287,,True,28.0,0,6,0,2,0,4,0,0,0,1,1,1,0,0,1,3,0
401415941,Cleveland State Vikings,B. Moore,4400437,,False,22.0,6,13,3,8,3,5,2,2,5,4,9,2,0,0,2,1,17
401415941,Cleveland State Vikings,A. Ngwafang,4400001,,False,11.0,1,1,1,1,0,0,0,2,1,3,4,0,0,0,2,0,2
401415941,Cleveland State Vikings,D. Williams,4595191,,False,17.0,1,5,0,2,1,3,2,2,0,2,2,1,0,0,3,1,5
401415941,Cleveland State Vikings,I. Geraci,4399211,,False,15.0,1,3,1,2,0,1,0,0,2,1,3,1,2,0,3,0,2
401415941,Cleveland State Vikings,TEAM,TOTAL,TOTAL,False,,24,61,12,29,12,32,13,17,21,22,43,13,7,2,21,13,73
401415940,Saint Mary's Gaels,A. Bamberger,4433035,,True,9.0,2,6,2,6,0,0,1,1,0,1,1,3,0,0,1,1,5
401415940,Saint Mary's Gaels,M. Mastora,4899391,,True,17.0,1,1,0,0,1,1,0,0,1,1,2,0,0,0,5,2,3
401415940,Saint Mary's Gaels,T. Dalton,4703841,,True,31.0,3,7,2,4,1,3,0,0,0,2,2,2,1,0,2,3,7
401415940,Saint Mary's Gaels,T. Wedin,4400497,,True,36.0,6,9,1,3,5,6,2,2,0,0,0,5,1,0,3,1,19
401415940,Saint Mary's Gaels,M. Holland,4282100,,True,36.0,7,10,7,10,0,0,3,3,1,8,9,2,1,0,1,2,17
401415940,Saint Mary's Gaels,A. Garrison,4899394,,False,16.0,5,8,5,8,0,0,1,1,0,2,2,0,1,0,2,5,11
401415940,Saint Mary's Gaels,E. Croco,4703842,,False,12.0,2,3,2,3,0,0,0,0,0,2,2,0,1,0,1,1,4
401415940,Saint Mary's Gaels,A. West,4316443,,False,11.0,2,2,2,2,0,0,0,1,0,2,2,1,0,0,1,0,4
401415940,Saint Mary's Gaels,L. Hanafin,4703840,,False,32.0,3,6,2,5,1,1,0,0,1,3,4,5,3,0,4,3,7
401415940,Saint Mary's Gaels,TEAM,TOTAL,TOTAL,False,,31,52,23,41,8,11,7,8,5,25,30,18,8,0,21,18,77
401415940,Austin Peay Governors,D. Booker,4399560,,True,21.0,5,6,5,6,0,0,3,4,1,4,5,0,1,0,2,2,13
401415940,Austin Peay Governors,N. De Leon Negron,4705089,,True,23.0,1,2,1,2,0,0,0,0,0,0,0,3,1,0,2,1,2
401415940,Austin Peay Governors,E. Sawyer,4595701,,True,33.0,0,4,0,1,0,3,2,2,1,5,6,2,2,0,1,1,2
401415940,Austin Peay Governors,K. Kidwell,4399561,,True,18.0,0,0,0,0,0,0,1,2,0,2,2,1,4,0,0,1,1
401415940,Austin Peay Governors,K. Pace,4282394,,True,33.0,8,15,4,8,4,7,2,2,1,0,1,0,1,0,4,4,22
401415940,Austin Peay Governors,K. Ward,4705091,,False,1.0,0,0,0,0,0,0,2,4,1,0,1,0,0,0,1,1,2
401415940,Austin Peay Governors,S. Kirby,4595702,,False,26.0,3,5,1,2,2,3,0,0,0,1,1,1,1,0,0,2,8
401415940,Austin Peay Governors,L. Gibbs,4595233,,False,15.0,1,3,1,3,0,0,0,2,0,0,0,2,1,0,1,1,2
401415940,Austin Peay Governors,Y. Johnson,4399804,,False,30.0,5,15,4,9,1,6,6,8,1,4,5,0,2,0,2,2,17
401415940,Austin Peay Governors,TEAM,TOTAL,TOTAL,False,,23,50,16,31,7,19,16,24,5,17,22,9,13,0,13,15,69
401415939,Furman Paladins,G. van Rij,4400619,,True,28.0,4,7,4,6,0,1,3,4,2,4,6,3,0,0,4,5,11
401415939,Furman Paladins,N. Henley,4900397,,True,35.0,1,1,0,0,1,1,2,2,0,2,2,0,2,1,2,0,5
401415939,Furman Paladins,J. Outten,4900395,,True,11.0,0,0,0,0,0,0,0,0,0,1,1,0,0,0,0,0,0
401415939,Furman Paladins,T. Walters,4704252,,True,28.0,4,11,1,5,3,6,3,3,1,2,3,7,3,0,5,3,14
401415939,Furman Paladins,T. Hodges,4068935,,True,37.0,6,18,6,16,0,2,1,2,1,9,10,2,4,0,3,4,13
401415939,Furman Paladins,K. Whitaker,4900399,,False,4.0,1,2,1,2,0,0,0,0,0,0,0,0,0,0,0,0,2
401415939,Furman Paladins,K. Johnson,4900398,,False,3.0,1,1,1,1,0,0,1,2,0,0,0,0,0,0,0,0,3
401415939,Furman Paladins,J. Session,4900396,,False,2.0,0,0,0,0,0,0,0,0,0,0,0,0,0,0,0,0,0
401415939,Furman Paladins,A. Irizarry-Perez,4704256,,False,5.0,0,1,0,1,0,0,1,2,0,0,0,1,0,0,0,0,1
401415939,Furman Paladins,J. Hill-Mims,4704253,,False,0.0,0,0,0,0,0,0,0,0,0,0,0,0,0,0,0,0,0
401415939,Furman Paladins,S. James,4704257,,False,27.0,1,9,0,3,1,6,1,2,3,3,6,1,0,0,2,3,4
401415939,Furman Paladins,P. Koilia,4704255,,False,5.0,0,0,0,0,0,0,0,2,0,0,0,1,0,0,2,1,0
401415939,Furman Paladins,E. DePetro,4704251,,False,10.0,3,4,1,2,2,2,0,0,1,0,1,1,0,0,0,0,8
401415939,Furman Paladins,G. Boone,4400621,,False,5.0,0,0,0,0,0,0,0,0,0,1,1,0,0,0,0,1,0
401415939,Furman Paladins,TEAM,TOTAL,TOTAL,False,,21,54,14,36,7,18,12,19,8,25,33,16,9,1,18,17,61
401415939,Bowling Green Falcons,K. Hempfling,4399299,,True,17.0,4,8,3,7,1,1,2,2,0,1,1,0,0,0,1,3,11
401415939,Bowling Green Falcons,A. Velasco,4899612,,True,25.0,4,7,1,3,3,4,0,0,0,6,6,4,3,0,3,3,11
401415939,Bowling Green Falcons,K. Lewis,4704866,,True,26.0,0,0,0,0,0,0,0,0,0,2,2,6,0,0,3,1,0
401415939,Bowling Green Falcons,N. Hampton,4704864,,True,26.0,1,5,0,4,1,1,0,0,0,2,2,4,4,0,0,1,3
401415939,Bowling Green Falcons,E. Brett,4595223,,True,16.0,2,5,1,1,1,4,0,0,2,1,3,3,0,0,4,1,5
401415939,Bowling Green Falcons,O. Hill,4704865,,False,13.0,2,3,2,3,0,0,0,0,1,1,2,1,0,0,0,1,4
401415939,Bowling Green Falcons,S. Dziekan,4704863,,False,8.0,2,3,2,3,0,0,0,0,0,1,1,0,0,0,1,2,4
401415939,Bowling Green Falcons,J. Tate,4899613,,False,22.0,2,3,2,3,0,0,4,5,3,4,7,0,1,0,2,1,8
401415939,Bowling Green Falcons,M. Sharps,4595176,,False,21.0,8,16,2,3,6,13,0,0,0,2,2,0,2,0,0,0,22
401415939,Bowling Green Falcons,M. Dever,4399297,,False,6.0,1,2,1,1,0,1,0,0,0,0,0,0,1,0,1,2,2
401415939,Bowling Green Falcons,M. Parker,4282037,,False,20.0,4,10,0,1,4,9,0,0,0,5,5,2,0,0,1,3,12
401415939,Bowling Green Falcons,TEAM,TOTAL,TOTAL,False,,30,62,14,29,16,33,6,7,8,27,35,20,11,0,16,18,82
401415938,UCLA Bruins,I. Thomas,4281072,,True,34.0,9,13,7,11,2,2,4,6,3,2,5,1,0,0,1,3,24
401415938,UCLA Bruins,C. Osborne,4433293,,True,39.0,3,16,3,10,0,6,5,5,0,4,4,8,4,0,1,2,11
401415938,UCLA Bruins,C. Horvat,4282171,,True,17.0,1,4,1,3,0,1,0,0,3,3,6,1,0,0,2,3,2
401415938,UCLA Bruins,J. Penn,4281259,,True,30.0,3,8,2,4,1,4,0,0,3,1,4,1,0,2,0,3,7
401415938,UCLA Bruins,N. Chou,4066562,,True,25.0,2,7,2,4,0,3,1,2,0,1,1,0,2,0,2,1,5
401415938,UCLA Bruins,I. Anstey,4599500,,False,8.0,0,1,0,1,0,0,0,2,0,1,1,1,1,0,1,1,0
401415938,UCLA Bruins,Dugalic,4433411,,False,12.0,3,7,3,7,0,0,0,3,2,0,2,0,3,1,3,3,6
401415938,UCLA Bruins,D. Darius,4711802,,False,4.0,0,0,0,0,0,0,0,0,0,1,1,0,0,1,0,1,0
401415938,UCLA Bruins,C. Brown,4595911,,False,25.0,2,3,2,3,0,0,0,0,0,2,2,1,3,0,0,4,4
401415938,UCLA Bruins,K. Owens,4282172,,False,6.0,0,1,0,1,0,0,0,0,0,0,0,0,0,1,0,2,0
401415938,UCLA Bruins,TEAM,TOTAL,TOTAL,False,,23,60,20,44,3,16,10,18,12,15,27,13,13,5,11,23,59
401415938,South Dakota State Jackrabbits,T. Nelson,4595883,,True,31.0,1,1,1,1,0,0,5,7,0,4,4,1,1,2,0,1,7
401415938,South Dakota State Jackrabbits,P. Burckhard,4399649,,True,31.0,2,10,2,8,0,2,3,4,1,1,2,0,1,1,0,2,7
401415938,South Dakota State Jackrabbits,M. Selland,4282531,,True,32.0,9,17,9,14,0,3,6,8,2,7,9,1,1,0,5,3,24
401415938,South Dakota State Jackrabbits,H. Timmer,4899819,,True,36.0,7,9,6,8,1,1,0,0,4,3,7,0,0,0,5,0,15
401415938,South Dakota State Jackrabbits,T. Irwin,4282530,,True,34.0,2,11,2,9,0,2,2,3,2,4,6,1,0,0,7,3,6
401415938,South Dakota State Jackrabbits,K. Theisen,4595882,,False,16.0,1,1,1,1,0,0,1,3,2,1,3,1,1,2,2,2,3
401415938,South Dakota State Jackrabbits,L. Theuninck,4282529,,False,11.0,0,0,0,0,0,0,0,0,0,4,4,0,0,0,0,1,0
401415938,South Dakota State Jackrabbits,H. Greer,4068252,,False,9.0,0,2,0,2,0,0,0,0,0,0,0,2,1,0,1,0,0
401415938,South Dakota State Jackrabbits,TEAM,TOTAL,TOTAL,False,,22,51,21,43,1,8,17,25,16,29,45,6,5,5,20,12,62
401415715,UMBC Retrievers,O. Esadah,4898979,,True,23.0,1,5,1,5,0,0,0,0,6,2,8,1,2,0,1,1,2
401415715,UMBC Retrievers,J. Summers,4281135,,True,33.0,2,8,2,6,0,2,1,1,2,8,10,0,0,0,1,0,5
401415715,UMBC Retrievers,A. Nelson,4704642,,True,22.0,1,4,1,4,0,0,0,0,0,1,1,0,0,0,0,0,2
401415715,UMBC Retrievers,J. Settle,4281982,,True,23.0,2,7,2,7,0,0,0,0,0,3,3,1,2,1,3,1,4
401415715,UMBC Retrievers,K. Dixon,4281000,,True,32.0,7,14,4,8,3,6,3,4,0,3,3,0,1,0,2,0,20
401415715,UMBC Retrievers,H. McDonald,4400527,,False,6.0,1,1,0,0,1,1,0,0,0,0,0,0,0,0,0,0,3
401415715,UMBC Retrievers,J. Braswell,4068375,,False,2.0,0,1,0,1,0,0,0,0,0,0,0,0,2,0,1,1,0
401415715,UMBC Retrievers,A. May,4898980,,False,5.0,0,1,0,0,0,1,0,0,0,0,0,0,0,0,0,0,0
401415715,UMBC Retrievers,L. Drake,4898978,,False,20.0,3,9,2,8,1,1,0,0,1,5,6,1,1,0,2,2,7
401415715,UMBC Retrievers,L. Johnson,4400357,,False,6.0,0,1,0,1,0,0,0,2,2,0,2,0,1,0,2,0,0
401415715,UMBC Retrievers,D. Marquez,4281886,,False,28.0,2,10,1,5,1,5,0,0,0,0,0,3,2,0,1,2,5
401415715,UMBC Retrievers,TEAM,TOTAL,TOTAL,False,,19,61,13,45,6,16,4,7,13,22,35,6,11,1,14,7,48
401415715,Binghamton Bearcats,J. Van Dyke,4898954,,True,27.0,3,6,1,2,2,4,0,0,1,6,7,3,0,0,2,1,8
401415715,Binghamton Bearcats,B. Benonysdottir,4598224,,True,34.0,5,15,5,10,0,5,0,0,1,3,4,2,0,4,5,2,10
401415715,Binghamton Bearcats,C. Roberts,4594349,,True,39.0,3,4,3,4,0,0,0,0,0,5,5,6,1,0,4,0,6
401415715,Binghamton Bearcats,D. Bowman,4594345,,True,37.0,8,14,8,14,0,0,2,2,3,2,5,1,3,2,2,0,18
401415715,Binghamton Bearcats,H. Moore,4399026,,True,39.0,4,10,1,2,3,8,0,0,0,4,4,1,2,0,1,1,11
401415715,Binghamton Bearcats,G. Coleman,4898955,,False,6.0,2,2,2,2,0,0,1,1,0,0,0,0,0,0,1,1,5
401415715,Binghamton Bearcats,C. Traeger,4594347,,False,17.0,0,4,0,3,0,1,0,0,2,9,11,1,2,1,1,0,0
401415715,Binghamton Bearcats,C. Kirschenbaum,4898951,,False,1.0,0,0,0,0,0,0,0,0,0,0,0,0,0,0,1,0,0
401415715,Binghamton Bearcats,TEAM,TOTAL,TOTAL,False,,25,55,20,37,5,18,3,3,8,31,39,14,8,7,17,5,58
401414934,UIC Flames,J. McCloud,4704172,,True,39.0,3,7,3,7,0,0,2,2,0,5,5,1,3,1,2,2,8
401414934,UIC Flames,L. Rogers,4704175,,True,18.0,1,4,1,3,0,1,0,0,2,2,4,0,0,0,0,2,2
401414934,UIC Flames,B. Lutes,4899244,,True,25.0,0,3,0,0,0,3,0,0,1,1,2,0,0,0,0,3,0
401414934,UIC Flames,K. Young,4704173,,True,38.0,6,16,5,10,1,6,5,8,4,6,10,4,5,0,5,4,18
401414934,UIC Flames,Keo. Schenck,4704171,,True,40.0,3,8,2,3,1,5,1,1,1,0,1,0,1,0,3,4,8
401414934,UIC Flames,L. Yarbrough,4899245,,False,7.0,0,3,0,3,0,0,0,0,0,0,0,0,0,0,1,0,0
401414934,UIC Flames,K. Dempsey-Toney,4899243,,False,4.0,0,1,0,1,0,0,1,2,0,0,0,0,0,0,0,1,1
401414934,UIC Flames,I. Gonzales,4899246,,False,11.0,2,4,2,4,0,0,0,0,1,1,2,0,0,0,1,2,4
401414934,UIC Flames,J. Gee,4067997,,False,18.0,2,5,2,4,0,1,1,2,2,2,4,0,2,0,0,2,5
401414934,UIC Flames,TEAM,TOTAL,TOTAL,False,,17,51,15,35,2,16,10,15,11,22,33,5,11,1,14,20,46
401414934,Milwaukee Panthers,M. Walstad,4399719,,True,33.0,4,9,4,6,0,3,6,6,3,5,8,2,0,2,3,2,14
401414934,Milwaukee Panthers,E. Wittmershaus,4399717,,True,26.0,2,5,2,5,0,0,2,2,1,4,5,1,1,0,4,4,6
401414934,Milwaukee Panthers,S. Staver,4282009,,True,32.0,3,10,0,3,3,7,2,4,1,2,3,0,1,0,3,2,11
401414934,Milwaukee Panthers,M. Schmelzer,4068976,,True,38.0,2,8,0,3,2,5,3,4,1,5,6,4,0,0,1,0,9
401414934,Milwaukee Panthers,M. Santoro,4068838,,True,31.0,3,7,2,5,1,2,0,0,0,1,1,2,1,1,2,2,7
401414934,Milwaukee Panthers,M. McGlone,4705101,,False,3.0,1,2,1,2,0,0,0,0,0,0,0,0,0,0,0,2,2
401414934,Milwaukee Panthers,G. Crowley,4595441,,False,15.0,0,0,0,0,0,0,0,0,1,4,5,2,0,0,0,1,0
401414934,Milwaukee Panthers,K. Nead,4705100,,False,10.0,1,2,1,2,0,0,0,0,0,1,1,0,0,0,1,1,2
401414934,Milwaukee Panthers,J. Donaldson,4705099,,False,3.0,1,1,1,1,0,0,0,0,0,0,0,0,0,0,0,0,2
401414934,Milwaukee Panthers,A. Cera,4705098,,False,9.0,0,1,0,1,0,0,2,2,0,1,1,0,0,0,2,1,2
401414934,Milwaukee Panthers,TEAM,TOTAL,TOTAL,False,,17,45,11,28,6,17,15,18,8,24,32,11,3,3,16,15,55
401414530,South Dakota Coyotes,H. Sjerven,4068349,,True,27.0,7,11,7,10,0,1,3,4,1,7,8,1,0,0,1,5,17
401414530,South Dakota Coyotes,K. Watson,4704325,,True,38.0,2,12,1,5,1,7,1,2,0,3,3,4,1,0,2,2,6
401414530,South Dakota Coyotes,M. Krull,4433474,,True,32.0,1,4,0,0,1,4,2,4,1,6,7,1,0,0,3,2,5
401414530,South Dakota Coyotes,C. Lamb,4282528,,True,29.0,3,7,3,5,0,2,0,0,1,2,3,2,2,0,2,2,6
401414530,South Dakota Coyotes,L. Korngable,4282526,,True,36.0,3,13,3,10,0,3,0,0,0,0,0,4,1,0,1,2,6
401414530,South Dakota Coyotes,J. Ugofsky,4595855,,False,2.0,0,0,0,0,0,0,0,0,0,0,0,0,0,0,0,1,0
401414530,South Dakota Coyotes,A. Peplowski,4399655,,False,13.0,0,0,0,0,0,0,0,0,2,1,3,0,0,0,0,0,0
401414530,South Dakota Coyotes,G. Larkins,4899816,,False,23.0,3,5,0,2,3,3,0,0,1,0,1,0,1,0,1,2,9
401414530,South Dakota Coyotes,TEAM,TOTAL,TOTAL,False,,19,52,14,32,5,20,6,10,9,23,32,12,5,0,11,16,49
401414530,Michigan Wolverines,E. Kiser,4398919,,True,30.0,2,5,2,3,0,2,0,0,3,6,9,0,0,0,1,4,4
401414530,Michigan Wolverines,N. Hillmon,4398915,,True,38.0,6,12,6,12,0,0,5,5,6,4,10,3,0,1,4,3,17
401414530,Michigan Wolverines,M. Nolan,4594938,,True,25.0,1,10,0,1,1,9,0,0,0,0,0,2,1,0,1,0,3
401414530,Michigan Wolverines,L. Phelia,4433541,,True,23.0,5,7,3,4,2,3,2,4,0,0,0,0,0,0,2,1,14
401414530,Michigan Wolverines,D. Rauch,4398918,,True,25.0,0,2,0,0,0,2,0,0,0,6,6,1,2,0,1,0,0
401414530,Michigan Wolverines,C. Williams,4433415,,False,2.0,0,0,0,0,0,0,0,0,0,0,0,0,0,0,0,1,0
401414530,Michigan Wolverines,E. Stuck,4599502,,False,3.0,0,0,0,0,0,0,0,0,0,1,1,0,0,0,0,1,0
401414530,Michigan Wolverines,I. Varejão,4433687,,False,4.0,0,0,0,0,0,0,0,0,0,1,1,1,0,0,0,1,0
401414530,Michigan Wolverines,L. Brown,4398928,,False,28.0,4,12,4,11,0,1,2,2,0,3,3,2,1,1,3,4,10
401414530,Michigan Wolverines,A. Dilk,4398916,,False,22.0,2,4,2,4,0,0,0,0,2,3,5,1,1,0,0,2,4
401414530,Michigan Wolverines,TEAM,TOTAL,TOTAL,False,,20,52,17,35,3,17,9,11,11,27,38,10,5,2,13,17,52
401414526,Michigan Wolverines,E. Kiser,4398919,,True,34.0,3,7,3,6,0,1,0,1,3,3,6,3,0,0,3,2,6
401414526,Michigan Wolverines,N. Hillmon,4398915,,True,40.0,4,10,4,10,0,0,10,13,5,6,11,1,1,1,4,1,18
401414526,Michigan Wolverines,L. Phelia,4433541,,True,31.0,4,17,4,12,0,5,0,0,0,4,4,1,0,0,3,3,8
401414526,Michigan Wolverines,L. Brown,4398928,,True,20.0,0,3,0,1,0,2,3,4,0,4,4,3,1,0,3,0,3
401414526,Michigan Wolverines,D. Rauch,4398918,,True,31.0,1,1,1,1,0,0,0,0,1,1,2,0,3,0,4,1,2
401414526,Michigan Wolverines,C. Williams,4433415,,False,7.0,1,1,1,1,0,0,2,2,1,1,2,0,0,1,1,1,4
401414526,Michigan Wolverines,M. Nolan,4594938,,False,28.0,3,7,0,1,3,6,0,0,0,4,4,1,1,0,2,4,9
401414526,Michigan Wolverines,A. Dilk,4398916,,False,9.0,0,0,0,0,0,0,0,0,0,1,1,0,0,0,1,0,0
401414526,Michigan Wolverines,TEAM,TOTAL,TOTAL,False,,16,46,13,32,3,14,15,20,11,25,36,9,6,2,22,12,50
401414526,Louisville Cardinals,O. Cochran,4433426,,True,20.0,4,7,4,7,0,0,1,2,1,3,4,1,0,1,3,4,9
401414526,Louisville Cardinals,E. Engstler,4398729,,True,35.0,1,9,1,4,0,5,3,4,2,14,16,4,6,1,1,3,5
401414526,Louisville Cardinals,H. Van Lith,4433412,,True,38.0,9,15,8,13,1,2,3,3,1,2,3,1,2,1,4,2,22
401414526,Louisville Cardinals,K. Smith,4281919,,True,37.0,5,13,4,9,1,4,0,0,1,0,1,1,3,0,2,3,11
401414526,Louisville Cardinals,C. Hall,4280897,,True,36.0,6,10,3,6,3,4,0,0,0,0,0,2,4,0,1,2,15
401414526,Louisville Cardinals,L. Dixon,4398591,,False,14.0,0,3,0,3,0,0,0,0,0,0,0,0,0,1,0,1,0
401414526,Louisville Cardinals,A. Smith,4398835,,False,4.0,0,0,0,0,0,0,0,0,0,0,0,0,0,0,0,0,0
401414526,Louisville Cardinals,M. Robinson,4398604,,False,16.0,0,1,0,1,0,0,0,0,1,1,2,3,0,0,0,2,0
401414526,Louisville Cardinals,TEAM,TOTAL,TOTAL,False,,25,58,20,43,5,15,7,9,9,21,30,12,15,4,12,17,62
401414525,UConn Huskies,A. Edwards,4433408,,True,39.0,4,8,4,8,0,0,2,4,1,5,6,2,2,0,2,5,10
401414525,UConn Huskies,O. Nelson-Ododa,4398966,,True,38.0,3,6,3,6,0,0,0,3,5,2,7,4,0,0,2,4,6
401414525,UConn Huskies,A. Fudd,4433790,,True,49.0,7,16,5,11,2,5,3,4,1,4,5,2,1,1,0,2,19
401414525,UConn Huskies,P. Bueckers,4433730,,True,45.0,10,15,9,12,1,3,6,7,0,6,6,1,0,1,3,1,27
401414525,UConn Huskies,C. Williams,4398965,,True,48.0,9,22,7,14,2,8,1,2,3,2,5,0,0,0,0,2,21
401414525,UConn Huskies,D. Juhász,4398938,,False,3.0,1,2,1,1,0,1,0,0,1,1,2,0,0,0,0,0,2
401414525,UConn Huskies,C. Ducharme,4433534,,False,5.0,0,1,0,0,0,1,0,0,0,1,1,0,0,0,0,1,0
401414525,UConn Huskies,N. Muhl,4433468,,False,8.0,1,1,1,1,0,0,0,0,1,1,2,0,1,0,0,0,2
401414525,UConn Huskies,E. Westbrook,4280890,,False,15.0,2,6,2,3,0,3,0,0,0,1,1,1,1,0,0,1,4
401414525,UConn Huskies,TEAM,TOTAL,TOTAL,False,,37,77,32,56,5,21,12,20,13,26,39,10,5,2,8,16,91
401414525,NC State Wolfpack,K. Jones,4281199,,True,34.0,6,8,6,7,0,1,0,0,1,8,9,2,1,3,3,4,12
401414525,NC State Wolfpack,E. Cunane,4398625,,True,48.0,8,13,8,11,0,2,2,2,2,7,9,2,0,1,5,2,18
401414525,NC State Wolfpack,J. Brown-Turner,4432841,,True,48.0,6,14,4,7,2,7,6,6,1,7,8,5,1,2,1,1,20
401414525,NC State Wolfpack,K. Crutchfield,4281198,,True,42.0,4,10,2,6,2,4,2,3,0,3,3,1,0,1,1,3,12
401414525,NC State Wolfpack,R. Perez,4068715,,True,42.0,1,8,0,3,1,5,0,0,0,4,4,10,1,0,1,2,3
401414525,NC State Wolfpack,J. Boyd,4432859,,False,16.0,4,7,4,6,0,1,6,8,1,1,2,0,0,0,1,1,14
401414525,NC State Wolfpack,C. Hobby,4433005,,False,2.0,0,0,0,0,0,0,0,0,1,0,1,0,0,0,1,2,0
401414525,NC State Wolfpack,D. Johnson,4703768,,False,18.0,3,6,1,3,2,3,0,0,0,0,0,0,1,0,0,1,8
401414525,NC State Wolfpack,TEAM,TOTAL,TOTAL,False,,32,66,25,43,7,23,16,19,8,31,39,20,4,7,14,16,87
401414524,Texas Longhorns,D. Gaston,4433739,,True,13.0,0,2,0,2,0,0,0,0,0,2,2,0,0,1,1,3,0
401414524,Texas Longhorns,L. Ebo,4398943,,True,39.0,0,6,0,6,0,0,2,4,1,2,3,0,1,0,1,4,2
401414524,Texas Longhorns,R. Harmon,4433523,,True,40.0,6,18,5,14,1,4,1,3,0,7,7,6,0,0,1,3,14
401414524,Texas Longhorns,S. Holle,4433449,,True,11.0,0,1,0,1,0,0,0,0,0,1,1,0,0,0,0,0,0
401414524,Texas Longhorns,J. Allen-Taylor,4398984,,True,39.0,5,11,4,8,1,3,4,4,0,2,2,1,1,0,2,5,15
401414524,Texas Longhorns,A. Moore,4433794,,False,10.0,2,3,2,3,0,0,4,5,0,2,2,0,0,0,0,4,8
401414524,Texas Longhorns,L. Lattimore,4433517,,False,6.0,0,0,0,0,0,0,0,4,2,1,3,0,0,0,1,2,0
401414524,Texas Longhorns,A. Matharu,4433638,,False,12.0,0,3,0,1,0,2,0,0,0,2,2,0,1,0,2,2,0
401414524,Texas Longhorns,A. Warren,4398987,,False,30.0,4,8,1,4,3,4,0,0,1,1,2,1,1,0,2,1,11
401414524,Texas Longhorns,TEAM,TOTAL,TOTAL,False,,17,52,12,39,5,13,11,20,6,22,28,8,4,1,10,24,50
401414524,Stanford Cardinal,C. Brink,4433404,,True,22.0,4,9,3,5,1,4,1,1,2,4,6,1,1,6,1,4,10
401414524,Stanford Cardinal,H. Jones,4595910,,True,40.0,4,11,4,10,0,1,10,11,3,9,12,4,1,2,4,2,18
401414524,Stanford Cardinal,La. Hull,4398830,,True,40.0,0,6,0,3,0,3,0,0,0,5,5,4,0,2,3,3,0
401414524,Stanford Cardinal,Le. Hull,4398829,,True,30.0,7,14,5,10,2,4,4,6,1,2,3,2,1,0,3,3,20
401414524,Stanford Cardinal,A. Wilson,4066545,,True,24.0,1,4,1,1,0,3,0,0,1,3,4,1,1,0,1,3,2
401414524,Stanford Cardinal,K. Iriafen,4898384,,False,3.0,0,0,0,0,0,0,2,2,0,0,0,0,0,0,0,0,2
401414524,Stanford Cardinal,A. Prechtel,4433634,,False,7.0,0,1,0,0,0,1,0,0,0,1,1,0,0,0,0,0,0
401414524,Stanford Cardinal,F. Belibi,4432843,,False,25.0,3,5,3,5,0,0,1,2,4,7,11,2,0,0,4,5,7
401414524,Stanford Cardinal,A. Emma-Nnopu,4703591,,False,1.0,0,0,0,0,0,0,0,0,0,0,0,0,0,0,0,1,0
401414524,Stanford Cardinal,H. Jump,4432868,,False,8.0,0,1,0,0,0,1,0,0,0,0,0,0,0,1,1,1,0
401414524,Stanford Cardinal,TEAM,TOTAL,TOTAL,False,,19,51,16,34,3,17,18,22,12,33,45,14,4,11,20,22,59
401414523,South Carolina Gamecocks,A. Boston,4432831,,True,28.0,7,9,7,9,0,0,5,8,1,6,7,1,0,1,1,0,19
401414523,South Carolina Gamecocks,V. Saxton,4398752,,True,21.0,3,6,3,6,0,0,5,6,6,5,11,1,0,1,1,2,11
401414523,South Carolina Gamecocks,B. Beal,4432835,,True,22.0,5,9,5,7,0,2,2,2,0,3,3,2,1,1,0,1,12
401414523,South Carolina Gamecocks,Z. Cooke,4432832,,True,25.0,0,4,0,2,0,2,0,0,0,2,2,1,0,0,1,1,0
401414523,South Carolina Gamecocks,D. Henderson,4398751,,True,29.0,5,9,3,7,2,2,0,0,0,3,3,3,3,0,0,0,12
401414523,South Carolina Gamecocks,S. Feagin,4433795,,False,5.0,0,0,0,0,0,0,1,2,1,1,2,0,0,1,1,0,1
401414523,South Carolina Gamecocks,L. Amihere,4432834,,False,16.0,3,6,3,5,0,1,3,3,1,2,3,1,0,0,2,0,9
401414523,South Carolina Gamecocks,E. Wesolek,4398753,,False,3.0,0,1,0,1,0,0,0,0,0,1,1,0,0,0,0,1,0
401414523,South Carolina Gamecocks,K. Cardoso,4433405,,False,9.0,2,2,2,2,0,0,5,6,1,3,4,0,0,1,0,0,9
401414523,South Carolina Gamecocks,B. Hall,4898383,,False,7.0,0,1,0,1,0,0,0,0,0,0,0,0,0,0,0,3,0
401414523,South Carolina Gamecocks,S. Rivers,4433514,,False,6.0,0,0,0,0,0,0,0,0,0,1,1,0,0,0,1,0,0
401414523,South Carolina Gamecocks,E. Russell,4433441,,False,6.0,2,2,1,1,1,1,0,0,0,0,0,0,0,0,0,0,5
401414523,South Carolina Gamecocks,O. Thompson,4433380,,False,3.0,0,1,0,0,0,1,0,0,0,0,0,0,0,0,0,0,0
401414523,South Carolina Gamecocks,D. Littleton,4281322,,False,8.0,0,0,0,0,0,0,0,0,0,2,2,0,0,0,0,0,0
401414523,South Carolina Gamecocks,L. Grissett,4280887,,False,12.0,1,5,1,5,0,0,0,0,1,1,2,1,1,0,0,2,2
401414523,South Carolina Gamecocks,TEAM,TOTAL,TOTAL,False,,28,55,25,46,3,9,21,27,12,31,43,10,5,5,7,10,80
401414523,Creighton Bluejays,E. Ronsiek,4598617,,True,29.0,1,6,1,4,0,2,0,0,1,1,2,3,0,0,1,0,2
401414523,Creighton Bluejays,L. Jensen,4597505,,True,26.0,5,15,4,11,1,4,1,1,0,1,1,0,0,0,1,2,12
401414523,Creighton Bluejays,C. Bachelor,4594814,,True,17.0,1,2,1,2,0,0,0,0,0,0,0,1,0,0,0,1,2
401414523,Creighton Bluejays,P. Brotzki,4399333,,True,21.0,2,6,1,3,1,3,0,0,0,1,1,2,0,0,2,3,5
401414523,Creighton Bluejays,T. Rembao,4281361,,True,30.0,1,5,1,4,0,1,0,2,1,2,3,6,0,0,3,2,2
401414523,Creighton Bluejays,M. Brake,4703757,,False,12.0,1,2,1,2,0,0,0,0,0,3,3,0,0,0,0,3,2
401414523,Creighton Bluejays,M. Mogensen,4703758,,False,9.0,1,1,1,1,0,0,0,0,0,1,1,3,1,0,1,1,2
401414523,Creighton Bluejays,M. Maly,4599199,,False,22.0,3,7,1,1,2,6,0,0,0,1,1,0,0,0,2,3,8
401414523,Creighton Bluejays,J. Horan,4598615,,False,8.0,3,4,2,2,1,2,0,0,1,0,1,0,2,0,1,1,7
401414523,Creighton Bluejays,C. Dworak,4399332,,False,3.0,0,0,0,0,0,0,0,0,0,0,0,0,0,0,0,0,0
401414523,Creighton Bluejays,R. Saunders,4399331,,False,23.0,3,8,1,5,2,3,0,2,1,3,4,2,0,0,0,4,8
401414523,Creighton Bluejays,TEAM,TOTAL,TOTAL,False,,21,56,14,35,7,21,1,5,6,17,23,17,3,0,11,20,50
401414522,Notre Dame Fighting Irish,M. Westbeld,4433424,,True,37.0,6,12,5,8,1,4,0,0,0,8,8,1,3,0,5,2,13
401414522,Notre Dame Fighting Irish,M. Dodson,4282166,,True,24.0,3,5,3,5,0,0,0,0,2,2,4,0,1,3,0,4,6
401414522,Notre Dame Fighting Irish,O. Miles,4433791,,True,38.0,9,19,6,9,3,10,0,0,0,6,6,6,0,0,4,2,21
401414522,Notre Dame Fighting Irish,S. Citron,4433524,,True,33.0,2,6,2,6,0,0,4,5,0,5,5,0,0,1,2,2,8
401414522,Notre Dame Fighting Irish,D. Mabrey,4398736,,True,32.0,4,7,3,4,1,3,0,0,0,1,1,1,1,0,2,1,9
401414522,Notre Dame Fighting Irish,S. Brunelle,4433631,,False,10.0,0,0,0,0,0,0,0,0,1,0,1,0,0,0,1,0,0
401414522,Notre Dame Fighting Irish,A. Peoples,4432842,,False,18.0,3,4,3,4,0,0,0,0,1,3,4,0,0,2,0,1,6
401414522,Notre Dame Fighting Irish,A. Prohaska,4398717,,False,8.0,0,0,0,0,0,0,0,0,0,0,0,1,0,0,1,2,0
401414522,Notre Dame Fighting Irish,TEAM,TOTAL,TOTAL,False,,27,53,22,36,5,17,4,5,5,26,31,9,5,6,16,14,63
401414522,NC State Wolfpack,K. Jones,4281199,,True,24.0,3,6,2,4,1,2,0,0,2,6,8,1,1,1,3,1,7
401414522,NC State Wolfpack,E. Cunane,4398625,,True,37.0,5,10,5,10,0,0,6,7,3,7,10,0,1,0,1,1,16
401414522,NC State Wolfpack,J. Brown-Turner,4432841,,True,34.0,4,11,4,8,0,3,1,2,2,2,4,1,1,0,2,1,9
401414522,NC State Wolfpack,K. Crutchfield,4281198,,True,40.0,5,10,3,6,2,4,2,3,1,1,2,1,4,0,2,1,14
401414522,NC State Wolfpack,R. Perez,4068715,,True,27.0,2,9,1,5,1,4,2,2,0,1,1,2,4,0,0,1,7
401414522,NC State Wolfpack,J. Boyd,4432859,,False,16.0,4,6,4,6,0,0,0,0,2,0,2,0,0,0,0,0,8
401414522,NC State Wolfpack,C. Hobby,4433005,,False,3.0,0,1,0,1,0,0,0,0,0,0,0,0,0,0,0,0,0
401414522,NC State Wolfpack,D. Johnson,4703768,,False,19.0,2,9,1,4,1,5,0,0,1,1,2,4,1,0,2,0,5
401414522,NC State Wolfpack,TEAM,TOTAL,TOTAL,False,,25,62,20,44,5,18,11,14,13,19,32,9,12,1,10,5,66
401414520,Tennessee Lady Volunteers,A. Dye,4596286,,True,14.0,3,12,3,12,0,0,3,3,1,7,8,0,0,0,3,4,9
401414520,Tennessee Lady Volunteers,T. Key,4433642,,True,33.0,1,5,1,5,0,0,1,4,5,5,10,1,0,1,3,3,3
401414520,Tennessee Lady Volunteers,R. Burrell,4398764,,True,37.0,9,19,7,11,2,8,2,2,2,4,6,1,1,0,2,1,22
401414520,Tennessee Lady Volunteers,T. Darby,4597244,,True,30.0,3,8,0,1,3,7,0,0,0,4,4,1,1,0,1,2,9
401414520,Tennessee Lady Volunteers,J. Walker,4282154,,True,33.0,5,13,5,10,0,3,0,0,1,0,1,4,2,0,5,4,10
401414520,Tennessee Lady Volunteers,K. Striplin,4433810,,False,15.0,2,2,2,2,0,0,3,4,4,2,6,0,0,1,0,1,7
401414520,Tennessee Lady Volunteers,B. Miles,4586299,,False,14.0,0,2,0,1,0,1,0,0,0,1,1,1,0,0,1,0,0
401414520,Tennessee Lady Volunteers,S. Puckett,4434021,,False,16.0,0,4,0,2,0,2,2,2,0,0,0,1,0,0,0,2,2
401414520,Tennessee Lady Volunteers,K. Wynn,4434014,,False,8.0,1,1,1,1,0,0,0,4,0,1,1,0,0,0,2,1,2
401414520,Tennessee Lady Volunteers,TEAM,TOTAL,TOTAL,False,,24,66,19,45,5,21,11,19,23,29,52,9,4,2,18,18,64
401414520,Louisville Cardinals,O. Cochran,4433426,,True,16.0,1,2,1,2,0,0,1,2,3,0,3,1,2,0,0,5,3
401414520,Louisville Cardinals,E. Engstler,4398729,,True,33.0,7,12,4,9,3,3,3,7,6,4,10,1,1,3,1,3,20
401414520,Louisville Cardinals,H. Van Lith,4433412,,True,39.0,7,21,7,16,0,5,9,10,0,3,3,6,1,1,2,2,23
401414520,Louisville Cardinals,K. Smith,4281919,,True,25.0,5,15,3,6,2,9,0,0,0,2,2,0,4,1,2,3,12
401414520,Louisville Cardinals,C. Hall,4280897,,True,27.0,4,8,3,6,1,2,0,0,2,4,6,4,0,0,1,2,9
401414520,Louisville Cardinals,L. Dixon,4398591,,False,23.0,1,3,1,3,0,0,0,0,1,3,4,1,0,3,0,3,2
401414520,Louisville Cardinals,P. Verhulst,4433518,,False,9.0,3,3,2,2,1,1,0,0,1,0,1,0,1,0,0,0,7
401414520,Louisville Cardinals,N. Konno,4433094,,False,5.0,0,2,0,1,0,1,0,0,0,2,2,0,0,0,0,1,0
401414520,Louisville Cardinals,A. Smith,4398835,,False,3.0,0,1,0,1,0,0,0,0,0,0,0,0,0,0,0,0,0
401414520,Louisville Cardinals,M. Robinson,4398604,,False,20.0,0,0,0,0,0,0,0,2,0,0,0,2,2,0,0,1,0
401414520,Louisville Cardinals,TEAM,TOTAL,TOTAL,False,,28,67,21,46,7,21,13,21,14,22,36,15,11,8,7,20,76
401414519,UConn Huskies,A. Edwards,4433408,,True,30.0,4,8,4,8,0,0,1,4,5,5,10,0,1,2,3,3,9
401414519,UConn Huskies,O. Nelson-Ododa,4398966,,True,30.0,5,9,5,9,0,0,0,0,5,9,14,3,2,1,1,3,10
401414519,UConn Huskies,A. Fudd,4433790,,True,35.0,3,11,0,1,3,10,4,4,0,1,1,0,0,0,1,1,13
401414519,UConn Huskies,P. Bueckers,4433730,,True,33.0,7,17,6,12,1,5,0,0,0,1,1,2,1,0,2,4,15
401414519,UConn Huskies,C. Williams,4398965,,True,32.0,7,11,7,8,0,3,1,2,3,3,6,3,1,1,0,1,15
401414519,UConn Huskies,A. Deberry,4433516,,False,0.0,0,0,0,0,0,0,0,0,0,0,0,0,0,0,0,0,0
401414519,UConn Huskies,D. Juhász,4398938,,False,3.0,0,3,0,3,0,0,0,0,0,0,0,1,0,0,0,0,0
401414519,UConn Huskies,C. Ducharme,4433534,,False,8.0,2,3,2,3,0,0,0,0,0,1,1,2,0,0,1,0,4
401414519,UConn Huskies,N. Muhl,4433468,,False,11.0,1,1,0,0,1,1,0,2,0,0,0,0,0,0,0,4,3
401414519,UConn Huskies,E. Westbrook,4280890,,False,18.0,2,4,2,3,0,1,2,2,0,2,2,2,2,0,1,2,6
401414519,UConn Huskies,TEAM,TOTAL,TOTAL,False,,31,67,26,47,5,20,8,14,15,24,39,13,7,4,9,18,75
401414519,Indiana Hoosiers,M. Holmes,4433643,,True,32.0,5,10,5,10,0,0,2,2,0,6,6,2,0,2,1,4,12
401414519,Indiana Hoosiers,A. Gulbe,4398898,,True,37.0,3,9,2,5,1,4,0,0,1,4,5,0,0,0,2,4,7
401414519,Indiana Hoosiers,G. Berger,4398899,,True,36.0,4,11,4,11,0,0,5,7,0,5,5,0,1,0,4,1,13
401414519,Indiana Hoosiers,N. Cardaño-Hillary,4281477,,True,33.0,4,8,4,7,0,1,1,2,1,3,4,0,3,1,4,4,9
401414519,Indiana Hoosiers,A. Patberg,3904578,,True,36.0,7,9,5,6,2,3,0,0,0,2,2,1,0,0,3,3,16
401414519,Indiana Hoosiers,M. Zaric,4898388,,False,0.0,0,0,0,0,0,0,0,0,0,0,0,0,0,0,0,0,0
401414519,Indiana Hoosiers,K. Browne,4703715,,False,4.0,0,0,0,0,0,0,0,0,0,1,1,0,0,0,0,0,0
401414519,Indiana Hoosiers,A. Wisne,4433691,,False,0.0,0,0,0,0,0,0,0,0,0,0,0,0,0,0,0,0,0
401414519,Indiana Hoosiers,C. Moore-McNeil,4703714,,False,20.0,0,1,0,0,0,1,0,0,0,0,0,1,0,0,1,1,0
401414519,Indiana Hoosiers,K. Peterson,4683312,,False,1.0,0,0,0,0,0,0,1,2,0,0,0,0,0,0,0,0,1
401414519,Indiana Hoosiers,G. Waggoner,4594771,,False,1.0,0,0,0,0,0,0,0,0,0,0,0,0,0,0,0,0,0
401414519,Indiana Hoosiers,TEAM,TOTAL,TOTAL,False,,23,48,20,39,3,9,9,13,2,25,27,4,4,3,15,17,58
401414518,Texas Longhorns,D. Gaston,4433739,,True,20.0,3,5,3,5,0,0,2,2,2,3,5,1,0,1,1,0,8
401414518,Texas Longhorns,L. Ebo,4398943,,True,31.0,3,5,3,5,0,0,3,4,3,5,8,0,1,0,2,2,9
401414518,Texas Longhorns,R. Harmon,4433523,,True,22.0,2,4,2,4,0,0,2,2,0,2,2,3,1,0,3,4,6
401414518,Texas Longhorns,S. Holle,4433449,,True,18.0,1,4,1,3,0,1,0,0,0,0,0,0,0,0,0,1,2
401414518,Texas Longhorns,J. Allen-Taylor,4398984,,True,38.0,7,11,7,11,0,0,3,3,1,0,1,3,1,0,3,0,17
401414518,Texas Longhorns,A. Moore,4433794,,False,24.0,3,10,3,10,0,0,2,4,2,2,4,0,2,2,3,2,8
401414518,Texas Longhorns,L. Lattimore,4433517,,False,4.0,0,1,0,1,0,0,0,0,0,2,2,0,0,0,0,0,0
401414518,Texas Longhorns,A. Matharu,4433638,,False,20.0,4,8,2,6,2,2,0,0,1,2,3,2,4,1,3,1,10
401414518,Texas Longhorns,A. Warren,4398987,,False,23.0,3,7,3,6,0,1,0,0,1,2,3,0,3,0,2,2,6
401414518,Texas Longhorns,TEAM,TOTAL,TOTAL,False,,26,55,24,51,2,4,12,15,12,20,32,9,12,4,17,12,66
401414518,Ohio State Buckeyes,R. Mikulasikova,4594942,,True,17.0,1,4,1,3,0,1,1,1,2,1,3,1,0,0,3,3,3
401414518,Ohio State Buckeyes,R. Harris,4433636,,True,27.0,1,6,1,3,0,3,2,2,0,1,1,2,3,0,0,2,4
401414518,Ohio State Buckeyes,J. Sheldon,4432865,,True,38.0,7,16,6,14,1,2,2,2,1,5,6,4,4,0,6,3,17
401414518,Ohio State Buckeyes,T. Mikesell,4398912,,True,40.0,7,12,4,8,3,4,2,2,1,2,3,1,0,1,1,1,19
401414518,Ohio State Buckeyes,B. Miller,4281317,,True,31.0,6,10,6,10,0,0,0,0,1,3,4,0,0,2,5,2,12
401414518,Ohio State Buckeyes,T. Beacham,4068997,,False,23.0,4,9,4,7,0,2,0,0,4,6,10,1,4,1,1,2,8
401414518,Ohio State Buckeyes,T. Thierry,4898400,,False,22.0,0,4,0,4,0,0,0,0,3,0,3,1,0,1,0,2,0
401414518,Ohio State Buckeyes,K. Poole,4433418,,False,2.0,0,0,0,0,0,0,0,0,0,0,0,0,0,0,1,2,0
401414518,Ohio State Buckeyes,TEAM,TOTAL,TOTAL,False,,26,61,22,49,4,12,7,7,13,19,32,10,11,5,17,17,63
401414517,Stanford Cardinal,C. Brink,4433404,,True,19.0,6,7,5,6,1,1,2,2,4,4,8,0,1,5,3,5,15
401414517,Stanford Cardinal,H. Jones,4595910,,True,39.0,7,17,5,13,2,4,1,2,3,7,10,6,1,1,3,1,17
401414517,Stanford Cardinal,La. Hull,4398830,,True,24.0,1,1,0,0,1,1,0,0,0,1,1,1,0,0,2,5,3
401414517,Stanford Cardinal,Le. Hull,4398829,,True,32.0,6,16,5,10,1,6,6,9,3,6,9,3,1,0,3,3,19
401414517,Stanford Cardinal,A. Wilson,4066545,,True,37.0,1,3,1,1,0,2,2,4,0,2,2,2,0,0,2,1,4
401414517,Stanford Cardinal,K. Iriafen,4898384,,False,10.0,1,1,1,1,0,0,2,2,1,4,5,0,0,2,1,3,4
401414517,Stanford Cardinal,A. Prechtel,4433634,,False,3.0,0,1,0,0,0,1,0,0,0,0,0,0,0,0,1,0,0
401414517,Stanford Cardinal,F. Belibi,4432843,,False,19.0,3,4,3,4,0,0,1,2,4,3,7,2,0,2,1,2,7
401414517,Stanford Cardinal,A. Jerome,4282165,,False,0.0,0,0,0,0,0,0,0,0,0,0,0,0,0,0,0,0,0
401414517,Stanford Cardinal,B. Demetre,4433513,,False,0.0,0,0,0,0,0,0,0,0,0,0,0,0,0,0,0,0,0
401414517,Stanford Cardinal,A. Emma-Nnopu,4703591,,False,0.0,0,0,0,0,0,0,0,0,0,0,0,0,0,0,0,0,0
401414517,Stanford Cardinal,H. Jump,4432868,,False,17.0,1,7,0,1,1,6,0,0,0,3,3,1,0,0,2,2,3
401414517,Stanford Cardinal,TEAM,TOTAL,TOTAL,False,,26,57,20,36,6,21,14,21,17,33,50,15,3,10,18,22,72
401414517,Maryland Terrapins,A. Reese,4433402,,True,30.0,7,16,6,15,1,1,10,12,5,4,9,1,3,3,1,4,25
401414517,Maryland Terrapins,C. Bibby,4280877,,True,35.0,4,13,3,6,1,7,1,2,1,2,3,2,1,0,1,3,10
401414517,Maryland Terrapins,D. Miller,4433635,,True,19.0,3,11,2,6,1,5,4,4,0,0,0,0,1,0,2,5,11
401414517,Maryland Terrapins,A. Owusu,4433632,,True,23.0,2,9,2,8,0,1,0,0,3,1,4,1,0,0,1,1,4
401414517,Maryland Terrapins,K. Benzan,4068580,,True,40.0,0,5,0,4,0,1,0,0,1,1,2,2,5,0,1,3,0
401414517,Maryland Terrapins,M. Collins,4398763,,False,24.0,3,7,3,5,0,2,0,0,0,1,1,0,1,0,1,2,6
401414517,Maryland Terrapins,T. Kozlova,4703584,,False,0.0,0,0,0,0,0,0,0,0,0,0,0,0,0,0,0,0,0
401414517,Maryland Terrapins,S. Sellers,4433808,,False,29.0,4,7,4,5,0,2,2,5,0,4,4,2,1,0,0,5,10
401414517,Maryland Terrapins,TEAM,TOTAL,TOTAL,False,,23,68,20,49,3,19,17,23,16,16,32,8,12,3,7,23,66
401414516,Iowa State Cyclones,N. Diew,4599130,,True,36.0,5,11,2,7,3,4,2,4,1,4,5,0,0,1,0,1,15
401414516,Iowa State Cyclones,M. Kane,4398803,,True,9.0,1,1,1,1,0,0,0,0,1,2,3,0,0,0,1,1,2
401414516,Iowa State Cyclones,E. Ryan,4433436,,True,40.0,10,16,8,11,2,5,0,0,1,7,8,6,1,0,3,3,22
401414516,Iowa State Cyclones,L. Donarski,4433409,,True,40.0,4,14,3,8,1,6,2,2,1,2,3,1,1,0,3,1,11
401414516,Iowa State Cyclones,As. Joens,4398802,,True,33.0,3,11,2,7,1,4,7,7,2,2,4,1,1,0,1,3,14
401414516,Iowa State Cyclones,B. Jordao,4399242,,False,8.0,0,3,0,3,0,0,1,2,3,2,5,0,0,3,1,1,1
401414516,Iowa State Cyclones,M. Espenmiller-McGraw,4594688,,False,15.0,1,2,0,0,1,2,0,0,0,2,2,0,0,0,1,4,3
401414516,Iowa State Cyclones,Au. Joens,4433988,,False,19.0,0,5,0,1,0,4,0,0,0,3,3,0,0,0,0,4,0
401414516,Iowa State Cyclones,TEAM,TOTAL,TOTAL,False,,24,63,16,38,8,25,12,15,11,25,36,8,3,4,10,18,68
401414516,Creighton Bluejays,E. Ronsiek,4598617,,True,26.0,1,7,1,6,0,1,0,0,1,3,4,2,0,0,1,2,2
401414516,Creighton Bluejays,C. Bachelor,4594814,,True,12.0,1,5,1,3,0,2,0,0,1,1,2,2,0,0,0,0,2
401414516,Creighton Bluejays,L. Jensen,4597505,,True,39.0,3,8,1,4,2,4,2,2,1,7,8,1,0,0,0,1,10
401414516,Creighton Bluejays,P. Brotzki,4399333,,True,28.0,5,9,3,4,2,5,1,2,0,6,6,1,2,1,3,2,13
401414516,Creighton Bluejays,T. Rembao,4281361,,True,32.0,5,8,2,2,3,6,6,8,0,0,0,4,0,0,2,4,19
401414516,Creighton Bluejays,M. Brake,4703757,,False,2.0,0,0,0,0,0,0,0,0,0,0,0,0,0,0,0,1,0
401414516,Creighton Bluejays,M. Mogensen,4703758,,False,25.0,3,8,2,5,1,3,0,0,0,5,5,4,2,1,1,1,7
401414516,Creighton Bluejays,M. Maly,4599199,,False,24.0,7,10,4,6,3,4,4,4,1,3,4,1,0,0,2,2,21
401414516,Creighton Bluejays,R. Saunders,4399331,,False,12.0,1,3,1,3,0,0,0,0,1,2,3,0,0,0,1,4,2
401414516,Creighton Bluejays,TEAM,TOTAL,TOTAL,False,,26,58,15,33,11,25,13,16,7,29,36,15,4,2,10,17,76
401414515,South Carolina Gamecocks,A. Boston,4432831,,True,0.0,8,13,8,12,0,1,12,13,12,10,22,2,1,1,3,2,28
401414515,South Carolina Gamecocks,V. Saxton,4398752,,True,0.0,2,6,2,6,0,0,2,4,7,7,14,0,1,2,2,1,6
401414515,South Carolina Gamecocks,B. Beal,4432835,,True,0.0,0,6,0,6,0,0,0,0,1,1,2,4,0,0,0,4,0
401414515,South Carolina Gamecocks,Z. Cooke,4432832,,True,0.0,6,16,3,9,3,7,0,1,0,0,0,2,2,0,3,3,15
401414515,South Carolina Gamecocks,D. Henderson,4398751,,True,0.0,5,17,2,7,3,10,0,0,0,1,1,0,1,0,2,3,13
401414515,South Carolina Gamecocks,S. Feagin,4433795,,False,0.0,0,0,0,0,0,0,0,0,0,0,0,0,0,0,0,0,0
401414515,South Carolina Gamecocks,L. Amihere,4432834,,False,0.0,1,6,1,6,0,0,0,0,1,2,3,0,0,0,0,0,2
401414515,South Carolina Gamecocks,K. Cardoso,4433405,,False,0.0,0,1,0,1,0,0,0,0,0,2,2,0,0,0,2,2,0
401414515,South Carolina Gamecocks,B. Hall,4898383,,False,0.0,1,2,0,1,1,1,0,0,0,0,0,0,0,0,0,0,3
401414515,South Carolina Gamecocks,D. Littleton,4281322,,False,0.0,0,0,0,0,0,0,0,0,0,0,0,0,0,0,0,0,0
401414515,South Carolina Gamecocks,L. Grissett,4280887,,False,0.0,0,2,0,2,0,0,2,4,3,0,3,0,0,2,2,2,2
401414515,South Carolina Gamecocks,TEAM,TOTAL,TOTAL,False,,23,69,16,50,7,19,16,22,25,23,48,8,5,5,14,17,69
401414515,North Carolina Tar Heels,A. Poole,4434028,,True,0.0,2,2,2,2,0,0,0,0,0,2,2,0,1,0,0,4,4
401414515,North Carolina Tar Heels,K. Todd-Williams,4433740,,True,0.0,3,5,3,5,0,0,1,2,0,2,2,2,2,0,2,3,7
401414515,North Carolina Tar Heels,A. Ustby,4433489,,True,0.0,2,11,2,9,0,2,0,0,1,7,8,2,0,0,2,4,4
401414515,North Carolina Tar Heels,D. Kelly,4433410,,True,0.0,9,18,8,16,1,2,4,4,0,5,5,3,2,1,4,4,23
401414515,North Carolina Tar Heels,C. Littlefield,4281403,,True,0.0,3,6,1,3,2,3,1,6,1,5,6,3,1,0,3,1,9
401414515,North Carolina Tar Heels,A. Zelaya,4433778,,False,0.0,4,6,4,5,0,1,2,2,1,1,2,0,0,0,1,3,10
401414515,North Carolina Tar Heels,M. Tshitenge,4433300,,False,0.0,0,0,0,0,0,0,0,0,1,0,1,0,0,0,0,0,0
401414515,North Carolina Tar Heels,E. Hodgson,4400235,,False,0.0,1,4,1,1,0,3,2,2,0,0,0,2,0,0,0,0,4
401414515,North Carolina Tar Heels,TEAM,TOTAL,TOTAL,False,,24,52,21,41,3,11,10,16,7,26,33,12,6,2,13,19,61
401414514,UConn Huskies,A. Edwards,4433408,,True,19.0,1,3,1,3,0,0,2,2,2,2,4,1,1,0,1,5,4
401414514,UConn Huskies,O. Nelson-Ododa,4398966,,True,28.0,1,3,1,3,0,0,3,4,2,3,5,1,0,4,2,5,5
401414514,UConn Huskies,A. Fudd,4433790,,True,38.0,4,13,0,3,4,10,4,4,0,2,2,0,3,2,3,2,16
401414514,UConn Huskies,P. Bueckers,4433730,,True,32.0,4,9,4,7,0,2,1,3,0,1,1,2,1,1,2,2,9
401414514,UConn Huskies,C. Williams,4398965,,True,34.0,3,9,2,5,1,4,5,6,2,1,3,0,1,1,1,2,12
401414514,UConn Huskies,D. Juhász,4398938,,False,20.0,0,6,0,6,0,0,3,4,1,4,5,3,0,2,1,1,3
401414514,UConn Huskies,C. Ducharme,4433534,,False,4.0,0,2,0,2,0,0,0,0,0,0,0,0,0,0,0,0,0
401414514,UConn Huskies,N. Muhl,4433468,,False,6.0,1,1,0,0,1,1,0,0,0,1,1,0,1,0,0,2,3
401414514,UConn Huskies,E. Westbrook,4280890,,False,19.0,0,2,0,1,0,1,0,0,0,3,3,1,0,0,0,2,0
401414514,UConn Huskies,TEAM,TOTAL,TOTAL,False,,14,48,8,30,6,18,18,23,8,21,29,8,7,10,13,21,52
401414514,UCF Knights,D. Thomas,4594542,,True,26.0,1,4,1,4,0,0,1,2,1,6,7,0,0,2,3,4,3
401414514,UCF Knights,M. Kaba,4281099,,True,23.0,2,7,2,6,0,1,1,2,2,2,4,3,1,1,5,3,5
401414514,UCF Knights,T. Sanders,4594539,,True,39.0,4,8,2,6,2,2,0,2,2,4,6,2,1,0,4,2,10
401414514,UCF Knights,D. Battles,4399028,,True,40.0,3,11,1,6,2,5,4,5,0,0,0,0,0,0,2,2,12
401414514,UCF Knights,S. Meertens,4281294,,True,13.0,0,3,0,3,0,0,1,2,1,1,2,0,0,0,1,1,1
401414514,UCF Knights,B. Smith,4399030,,False,21.0,4,8,4,8,0,0,3,7,1,4,5,0,0,0,1,4,11
401414514,UCF Knights,N. Luma,4281482,,False,10.0,0,2,0,2,0,0,0,0,0,1,1,0,0,0,0,3,0
401414514,UCF Knights,A. Lewis,4594397,,False,28.0,2,3,1,1,1,2,0,0,0,4,4,4,2,0,1,5,5
401414514,UCF Knights,TEAM,TOTAL,TOTAL,False,,16,46,11,36,5,10,10,20,10,25,35,9,4,3,20,24,47
401414513,Princeton Tigers,E. Mitchell,4594957,,True,40.0,3,6,3,6,0,0,0,0,5,10,15,1,1,1,1,2,6
401414513,Princeton Tigers,K. Chen,4899328,,True,37.0,3,13,3,13,0,0,4,4,3,2,5,2,0,0,4,2,10
401414513,Princeton Tigers,J. Cunningham,4399194,,True,40.0,5,14,4,9,1,5,2,2,1,2,3,2,2,1,1,3,13
401414513,Princeton Tigers,G. Stone,4399190,,True,33.0,5,12,2,7,3,5,0,0,0,1,1,1,1,0,1,3,13
401414513,Princeton Tigers,A. Meyers,4281402,,True,31.0,4,15,3,8,1,7,2,4,1,2,3,1,0,0,1,4,11
401414513,Princeton Tigers,C. Nweke,4899329,,False,8.0,0,0,0,0,0,0,0,0,0,0,0,0,0,0,0,1,0
401414513,Princeton Tigers,M. Connolly,4399192,,False,11.0,1,2,1,2,0,0,0,0,0,0,0,1,1,0,0,0,2
401414513,Princeton Tigers,TEAM,TOTAL,TOTAL,False,,21,62,16,45,5,17,8,10,10,19,29,8,5,2,8,15,55
401414513,Indiana Hoosiers,M. Holmes,4433643,,True,33.0,5,6,5,6,0,0,0,0,1,7,8,2,1,4,2,2,10
401414513,Indiana Hoosiers,A. Gulbe,4398898,,True,38.0,1,7,1,4,0,3,3,4,0,7,7,1,0,0,5,1,5
401414513,Indiana Hoosiers,G. Berger,4398899,,True,39.0,7,14,7,14,0,0,1,2,0,7,7,1,0,0,6,2,15
401414513,Indiana Hoosiers,N. Cardaño-Hillary,4281477,,True,33.0,4,7,3,5,1,2,3,4,0,2,2,4,1,0,0,3,12
401414513,Indiana Hoosiers,A. Patberg,3904578,,True,32.0,2,4,1,1,1,3,1,1,0,1,1,3,1,1,2,2,6
401414513,Indiana Hoosiers,C. Moore-McNeil,4703714,,False,24.0,3,5,1,1,2,4,0,0,0,2,2,0,2,0,1,2,8
401414513,Indiana Hoosiers,G. Waggoner,4594771,,False,1.0,0,0,0,0,0,0,0,0,0,1,1,0,0,0,0,1,0
401414513,Indiana Hoosiers,TEAM,TOTAL,TOTAL,False,,22,43,18,31,4,12,8,11,1,31,32,11,5,5,17,13,56
401414512,Oklahoma Sooners,L. Scott,4594693,,True,17.0,2,8,2,8,0,0,7,12,5,3,8,1,0,4,3,3,11
401414512,Oklahoma Sooners,M. Williams,4398883,,True,18.0,4,8,4,7,0,1,1,2,1,1,2,1,2,1,4,3,9
401414512,Oklahoma Sooners,N. Tot,4594275,,True,32.0,0,3,0,1,0,2,0,0,1,1,2,1,1,0,2,0,0
401414512,Oklahoma Sooners,K. Tucker,4433150,,True,25.0,0,2,0,1,0,1,2,2,1,2,3,4,0,0,5,1,2
401414512,Oklahoma Sooners,T. Robertson,4398884,,True,34.0,5,12,2,2,3,10,6,8,1,3,4,1,2,0,6,1,19
401414512,Oklahoma Sooners,N. Lampkin,4398882,,False,15.0,0,8,0,7,0,1,0,2,1,3,4,0,0,0,2,3,0
401414512,Oklahoma Sooners,S. Vann,4703432,,False,21.0,5,10,4,9,1,1,0,0,1,8,9,2,0,0,1,2,11
401414512,Oklahoma Sooners,K. Perkins,4899000,,False,13.0,2,7,1,3,1,4,0,0,0,0,0,2,1,0,1,1,5
401414512,Oklahoma Sooners,K. Washington,4898998,,False,11.0,2,5,1,4,1,1,0,0,0,0,0,0,1,0,2,1,5
401414512,Oklahoma Sooners,G. Gregory,4594692,,False,14.0,1,2,1,2,0,0,0,0,2,1,3,2,0,0,2,0,2
401414512,Oklahoma Sooners,TEAM,TOTAL,TOTAL,False,,21,65,15,44,6,21,16,26,17,28,45,14,7,5,28,15,64
401414512,Notre Dame Fighting Irish,M. Westbeld,4433424,,True,26.0,6,10,5,7,1,3,0,0,2,7,9,1,3,1,1,4,13
401414512,Notre Dame Fighting Irish,M. Dodson,4282166,,True,17.0,8,11,8,11,0,0,4,6,2,1,3,0,2,3,3,4,20
401414512,Notre Dame Fighting Irish,O. Miles,4433791,,True,34.0,4,9,3,5,1,4,0,2,0,7,7,12,3,0,2,3,9
401414512,Notre Dame Fighting Irish,S. Citron,4433524,,True,31.0,7,13,7,10,0,3,11,11,2,4,6,3,4,0,4,1,25
401414512,Notre Dame Fighting Irish,D. Mabrey,4398736,,True,36.0,11,19,4,7,7,12,0,0,1,5,6,3,1,0,0,0,29
401414512,Notre Dame Fighting Irish,S. Brunelle,4433631,,False,12.0,2,5,1,2,1,3,0,0,0,2,2,0,0,1,2,3,5
401414512,Notre Dame Fighting Irish,S. Cernugel,4898561,,False,1.0,0,0,0,0,0,0,0,0,0,0,0,0,0,0,0,1,0
401414512,Notre Dame Fighting Irish,T. Cha,4898560,,False,1.0,0,0,0,0,0,0,0,0,0,0,0,0,0,0,0,0,0
401414512,Notre Dame Fighting Irish,A. Peoples,4432842,,False,21.0,2,4,2,4,0,0,0,2,1,3,4,3,2,0,0,1,4
401414512,Notre Dame Fighting Irish,A. Prohaska,4398717,,False,21.0,1,5,1,5,0,0,1,2,0,0,0,2,1,0,1,5,3
401414512,Notre Dame Fighting Irish,TEAM,TOTAL,TOTAL,False,,41,76,31,51,10,25,16,23,11,31,42,24,16,5,13,22,108
401414511,NC State Wolfpack,K. Jones,4281199,,True,22.0,8,9,7,8,1,1,1,1,0,5,5,3,1,0,1,1,18
401414511,NC State Wolfpack,E. Cunane,4398625,,True,13.0,2,3,2,3,0,0,0,0,0,2,2,1,1,0,1,2,4
401414511,NC State Wolfpack,J. Brown-Turner,4432841,,True,24.0,4,9,4,5,0,4,1,2,0,1,1,1,1,0,1,2,9
401414511,NC State Wolfpack,K. Crutchfield,4281198,,True,25.0,1,1,1,1,0,0,3,3,1,1,2,3,1,0,0,1,5
401414511,NC State Wolfpack,R. Perez,4068715,,True,34.0,6,11,3,4,3,7,0,0,1,5,6,4,0,0,1,0,15
401414511,NC State Wolfpack,J. Boyd,4432859,,False,13.0,2,3,2,3,0,0,1,1,3,5,8,0,0,1,0,1,5
401414511,NC State Wolfpack,S. Hart,4898385,,False,5.0,1,3,1,3,0,0,0,1,0,0,0,0,0,0,0,0,2
401414511,NC State Wolfpack,C. Hobby,4433005,,False,22.0,3,9,3,9,0,0,2,4,1,0,1,1,0,0,1,4,8
401414511,NC State Wolfpack,D. Johnson,4703768,,False,21.0,5,10,0,5,5,5,0,0,1,0,1,1,2,0,1,0,15
401414511,NC State Wolfpack,J. Timmons,4433811,,False,5.0,1,2,1,1,0,1,0,0,0,1,1,1,0,0,0,0,2
401414511,NC State Wolfpack,A. James,4433807,,False,6.0,1,3,1,2,0,1,0,2,0,1,1,1,2,0,0,0,2
401414511,NC State Wolfpack,G. Bryant,4433450,,False,5.0,1,1,1,1,0,0,0,0,0,0,0,0,0,0,0,0,2
401414511,NC State Wolfpack,M. Hayes,4433413,,False,5.0,0,0,0,0,0,0,2,2,1,1,2,0,1,0,0,2,2
401414511,NC State Wolfpack,TEAM,TOTAL,TOTAL,False,,35,64,26,45,9,19,10,16,12,26,38,16,9,1,6,13,89
401414511,Kansas State Wildcats,A. Lee,4398964,,True,31.0,5,10,5,10,0,0,2,2,2,6,8,2,0,1,4,4,12
401414511,Kansas State Wildcats,B. Glenn,4898995,,True,35.0,2,6,1,2,1,4,3,4,0,1,1,0,4,0,1,3,8
401414511,Kansas State Wildcats,S. Sundell,4898994,,True,35.0,6,14,3,4,3,10,2,2,0,3,3,3,0,0,5,2,17
401414511,Kansas State Wildcats,J. Glenn,4691694,,True,36.0,2,7,1,3,1,4,0,0,0,2,2,0,0,0,2,1,5
401414511,Kansas State Wildcats,E. Ebert,4594690,,True,14.0,1,2,0,0,1,2,0,0,0,2,2,2,0,0,1,0,3
401414511,Kansas State Wildcats,L. Macke,4398962,,False,14.0,1,4,1,2,0,2,2,2,1,3,4,1,1,0,1,0,4
401414511,Kansas State Wildcats,T. Lauterbach,4594273,,False,9.0,0,0,0,0,0,0,2,2,1,1,2,0,0,1,0,1,2
401414511,Kansas State Wildcats,R. Dallinger,4898997,,False,11.0,1,4,0,1,1,3,0,0,0,0,0,0,0,0,0,2,3
401414511,Kansas State Wildcats,J. Moore,4597507,,False,4.0,0,0,0,0,0,0,1,2,0,0,0,0,0,0,0,0,1
401414511,Kansas State Wildcats,C. Goodrich,4281307,,False,11.0,1,2,1,2,0,0,0,0,0,0,0,1,0,0,2,1,2
401414511,Kansas State Wildcats,TEAM,TOTAL,TOTAL,False,,19,49,12,24,7,25,12,14,5,20,25,9,5,2,16,14,57
401414510,Villanova Wildcats,L. Garzon,4704605,,True,38.0,4,14,1,6,3,8,0,0,0,3,3,0,1,1,1,1,11
401414510,Villanova Wildcats,M. Siegrist,4399415,,True,39.0,5,13,5,11,0,2,2,2,1,4,5,2,1,3,2,2,12
401414510,Villanova Wildcats,Bria. Herlihy,4068169,,True,32.0,3,13,1,10,2,3,2,2,1,5,6,0,2,1,2,3,10
401414510,Villanova Wildcats,L. Olsen,4433815,,True,33.0,4,10,3,6,1,4,0,0,0,3,3,2,0,1,2,5,9
401414510,Villanova Wildcats,B. Mullin,4433296,,True,15.0,1,3,1,1,0,2,1,2,1,1,2,1,0,0,3,3,3
401414510,Villanova Wildcats,A. Cauley,4899025,,False,7.0,1,1,1,1,0,0,0,1,2,1,3,0,1,0,0,1,2
401414510,Villanova Wildcats,K. Orihel,4899024,,False,15.0,1,2,1,1,0,1,0,0,1,0,1,1,1,0,1,3,2
401414510,Villanova Wildcats,K. Gardler,4704604,,False,2.0,0,0,0,0,0,0,0,0,0,0,0,0,0,0,0,0,0
401414510,Villanova Wildcats,B. Runyan,4598592,,False,19.0,0,2,0,1,0,1,0,0,0,0,0,2,2,0,1,3,0
401414510,Villanova Wildcats,TEAM,TOTAL,TOTAL,False,,19,58,13,37,6,21,5,7,8,17,25,8,8,6,12,21,49
401414510,Michigan Wolverines,E. Kiser,4398919,,True,24.0,0,3,0,3,0,0,1,2,3,7,10,3,0,0,0,2,1
401414510,Michigan Wolverines,N. Hillmon,4398915,,True,39.0,12,16,12,16,0,0,3,6,7,4,11,0,5,0,4,1,27
401414510,Michigan Wolverines,M. Nolan,4594938,,True,32.0,3,9,1,1,2,8,0,0,0,3,3,2,0,0,1,2,8
401414510,Michigan Wolverines,L. Phelia,4433541,,True,22.0,0,3,0,3,0,0,3,4,3,2,5,1,1,0,3,2,3
401414510,Michigan Wolverines,D. Rauch,4398918,,True,30.0,2,7,2,5,0,2,1,2,2,6,8,1,0,0,3,1,5
401414510,Michigan Wolverines,C. Williams,4433415,,False,1.0,0,0,0,0,0,0,0,0,0,0,0,0,0,0,0,0,0
401414510,Michigan Wolverines,E. Stuck,4599502,,False,5.0,0,0,0,0,0,0,0,0,0,0,0,0,0,0,1,0,0
401414510,Michigan Wolverines,I. Varejão,4433687,,False,2.0,0,1,0,1,0,0,0,0,0,0,0,0,0,0,0,0,0
401414510,Michigan Wolverines,J. Hobbs,4898392,,False,1.0,0,0,0,0,0,0,0,0,0,0,0,0,0,0,0,0,0
401414510,Michigan Wolverines,M. Sidor,4433327,,False,1.0,0,0,0,0,0,0,0,0,0,1,1,0,0,0,0,1,0
401414510,Michigan Wolverines,L. Brown,4398928,,False,28.0,7,15,7,12,0,3,6,7,1,4,5,3,2,1,1,1,20
401414510,Michigan Wolverines,A. Dilk,4398916,,False,15.0,0,3,0,3,0,0,0,0,0,3,3,1,0,0,1,0,0
401414510,Michigan Wolverines,TEAM,TOTAL,TOTAL,False,,24,57,22,44,2,13,14,21,18,31,49,11,8,1,14,10,64
401414509,Tennessee Lady Volunteers,A. Dye,4596286,,True,30.0,10,18,10,18,0,0,0,0,6,5,11,2,0,0,4,1,20
401414509,Tennessee Lady Volunteers,T. Key,4433642,,True,28.0,6,12,6,12,0,0,6,8,1,3,4,0,0,3,1,3,18
401414509,Tennessee Lady Volunteers,R. Burrell,4398764,,True,30.0,2,12,1,6,1,6,0,0,2,3,5,4,1,0,1,4,5
401414509,Tennessee Lady Volunteers,T. Darby,4597244,,True,27.0,1,3,0,0,1,3,0,0,1,2,3,2,0,0,0,0,3
401414509,Tennessee Lady Volunteers,J. Walker,4282154,,True,33.0,3,8,3,6,0,2,0,2,2,5,7,8,1,1,1,1,6
401414509,Tennessee Lady Volunteers,K. Striplin,4433810,,False,3.0,0,0,0,0,0,0,0,0,0,0,0,0,0,0,0,0,0
401414509,Tennessee Lady Volunteers,B. Miles,4586299,,False,13.0,1,3,1,2,0,1,1,1,0,2,2,1,1,0,0,1,3
401414509,Tennessee Lady Volunteers,S. Puckett,4434021,,False,24.0,5,8,4,7,1,1,1,1,1,3,4,1,0,0,2,1,12
401414509,Tennessee Lady Volunteers,K. Wynn,4434014,,False,12.0,1,2,1,2,0,0,1,2,1,4,5,1,0,0,0,3,3
401414509,Tennessee Lady Volunteers,TEAM,TOTAL,TOTAL,False,,29,66,26,53,3,13,9,14,15,28,43,19,3,4,9,14,70
401414509,Belmont Bruins,M. Bartley,4705406,,True,31.0,7,14,5,8,2,6,0,0,2,4,6,1,0,2,1,5,16
401414509,Belmont Bruins,C. Chinn,4282391,,True,25.0,2,9,1,3,1,6,0,0,0,3,3,0,0,0,0,1,5
401414509,Belmont Bruins,T. Jones,4705405,,True,33.0,6,12,4,8,2,4,3,5,3,3,6,4,2,0,1,4,17
401414509,Belmont Bruins,D. Wells,4586267,,True,38.0,9,25,7,18,2,7,2,3,3,3,6,4,2,0,1,1,22
401414509,Belmont Bruins,J. Kinney,4399580,,True,31.0,2,6,1,2,1,4,0,2,0,3,3,2,0,0,1,1,5
401414509,Belmont Bruins,T. Miller,4900197,,False,9.0,0,1,0,1,0,0,0,0,2,2,4,2,1,0,2,4,0
401414509,Belmont Bruins,K. McGuff,4900196,,False,6.0,1,1,1,1,0,0,0,0,2,0,2,0,0,0,1,0,2
401414509,Belmont Bruins,B. Schoenwald,4705408,,False,12.0,0,1,0,0,0,1,0,0,3,1,4,0,1,0,0,0,0
401414509,Belmont Bruins,N. Baird,4595716,,False,15.0,0,4,0,1,0,3,0,0,0,2,2,0,0,0,1,1,0
401414509,Belmont Bruins,TEAM,TOTAL,TOTAL,False,,27,73,19,42,8,31,5,10,18,22,40,13,6,2,8,17,67
401414508,Ohio State Buckeyes,R. Mikulasikova,4594942,,True,20.0,5,9,3,6,2,3,0,0,0,2,2,1,0,0,2,0,12
401414508,Ohio State Buckeyes,R. Harris,4433636,,True,25.0,2,5,1,1,1,4,2,2,2,5,7,1,0,0,3,4,7
401414508,Ohio State Buckeyes,J. Sheldon,4432865,,True,40.0,9,17,7,12,2,5,3,3,0,3,3,8,3,0,6,3,23
401414508,Ohio State Buckeyes,T. Mikesell,4398912,,True,40.0,7,15,3,8,4,7,0,1,0,5,5,2,2,1,3,3,18
401414508,Ohio State Buckeyes,B. Miller,4281317,,True,29.0,1,4,0,2,1,2,3,4,1,8,9,3,0,1,1,4,6
401414508,Ohio State Buckeyes,T. Beacham,4068997,,False,20.0,3,6,3,5,0,1,0,0,3,2,5,0,0,0,3,2,6
401414508,Ohio State Buckeyes,T. Thierry,4898400,,False,15.0,1,2,1,2,0,0,4,4,0,4,4,1,0,2,1,5,6
401414508,Ohio State Buckeyes,K. Poole,4433418,,False,11.0,0,0,0,0,0,0,1,2,0,4,4,0,0,0,0,1,1
401414508,Ohio State Buckeyes,TEAM,TOTAL,TOTAL,False,,28,58,18,36,10,22,13,16,9,34,43,16,5,4,20,22,79
401414508,LSU Tigers,A. Newby,4280898,,True,34.0,2,2,2,2,0,0,1,2,5,5,10,0,4,0,1,2,5
401414508,LSU Tigers,F. Aifuwa,4065738,,True,22.0,1,7,1,7,0,0,0,1,1,5,6,1,1,1,3,1,2
401414508,LSU Tigers,R. Payne,4399220,,True,27.0,2,8,2,7,0,1,4,4,1,2,3,0,1,0,0,4,8
401414508,LSU Tigers,J. Cherry,4280863,,True,40.0,6,14,6,14,0,0,0,0,0,3,3,2,4,1,1,1,12
401414508,LSU Tigers,K. Pointer,4280859,,True,40.0,12,30,11,26,1,4,7,13,2,0,2,4,2,1,2,3,32
401414508,LSU Tigers,A. Petty,4704417,,False,0.0,0,0,0,0,0,0,0,0,0,0,0,0,0,0,0,0,0
401414508,LSU Tigers,E. Ward,4595166,,False,0.0,0,0,0,0,0,0,0,0,0,0,0,0,0,0,0,0,0
401414508,LSU Tigers,A. Trasi,4595165,,False,14.0,1,2,1,1,0,1,0,2,2,1,3,0,0,0,0,3,2
401414508,LSU Tigers,S. Shematsi,4599246,,False,0.0,0,0,0,0,0,0,0,0,0,0,0,0,0,0,0,0,0
401414508,LSU Tigers,H. Gusters,4433732,,False,9.0,0,0,0,0,0,0,0,0,1,1,2,1,0,2,0,0,0
401414508,LSU Tigers,A. Morris,4281251,,False,14.0,1,5,0,3,1,2,0,0,0,1,1,0,1,0,3,0,3
401414508,LSU Tigers,TEAM,TOTAL,TOTAL,False,,25,68,23,60,2,8,12,22,14,22,36,8,13,5,11,14,64
401414507,North Carolina Tar Heels,A. Poole,4434028,,True,28.0,4,5,4,5,0,0,0,0,1,5,6,0,0,1,2,1,8
401414507,North Carolina Tar Heels,K. Todd-Williams,4433740,,True,33.0,7,11,6,9,1,2,4,6,1,6,7,5,3,0,3,1,19
401414507,North Carolina Tar Heels,A. Ustby,4433489,,True,40.0,5,13,5,12,0,1,2,4,3,9,12,4,4,2,3,1,12
401414507,North Carolina Tar Heels,D. Kelly,4433410,,True,36.0,3,10,3,8,0,2,9,10,0,2,2,2,1,0,1,0,15
401414507,North Carolina Tar Heels,C. Littlefield,4281403,,True,35.0,2,7,1,5,1,2,2,2,1,4,5,3,1,0,2,1,7
401414507,North Carolina Tar Heels,A. Zelaya,4433778,,False,4.0,0,3,0,3,0,0,0,0,1,1,2,0,0,0,0,0,0
401414507,North Carolina Tar Heels,E. Hodgson,4400235,,False,24.0,0,2,0,0,0,2,2,2,0,3,3,1,0,0,2,2,2
401414507,North Carolina Tar Heels,TEAM,TOTAL,TOTAL,False,,21,51,19,42,2,9,19,24,9,31,40,15,9,3,15,6,63
401414507,Arizona Wildcats,L. Ware,4433422,,True,27.0,0,3,0,3,0,0,1,2,3,4,7,2,0,1,1,3,1
401414507,Arizona Wildcats,C. Reese,4398698,,True,30.0,3,9,3,4,0,5,0,0,1,4,5,2,0,1,3,2,6
401414507,Arizona Wildcats,S. Thomas,4281914,,True,36.0,6,12,3,4,3,8,0,0,1,1,2,1,2,0,2,4,15
401414507,Arizona Wildcats,S. Pellington,4601922,,True,29.0,1,9,1,8,0,1,1,2,1,3,4,3,2,0,2,3,3
401414507,Arizona Wildcats,B. Yeaney,4281255,,True,30.0,4,7,3,5,1,2,1,1,0,3,3,2,0,0,2,3,10
401414507,Arizona Wildcats,G. Sanchez,4898411,,False,8.0,1,5,0,4,1,1,0,0,1,1,2,0,0,0,0,0,3
401414507,Arizona Wildcats,K. Love,4433326,,False,6.0,0,4,0,4,0,0,0,0,0,3,3,0,1,0,2,0,0
401414507,Arizona Wildcats,A. Copeland,4280704,,False,3.0,0,0,0,0,0,0,0,0,0,1,1,0,0,0,0,0,0
401414507,Arizona Wildcats,M. Conner,4712562,,False,5.0,0,2,0,0,0,2,0,0,1,0,1,0,0,0,0,2,0
401414507,Arizona Wildcats,D. Erdogan,4703579,,False,3.0,0,1,0,0,0,1,0,0,0,0,0,0,0,0,0,0,0
401414507,Arizona Wildcats,H. Pueyo,4598223,,False,8.0,1,1,0,0,1,1,0,0,0,1,1,1,1,1,2,3,3
401414507,Arizona Wildcats,T. Chavez,4398769,,False,15.0,1,6,0,0,1,6,1,2,0,0,0,3,0,0,0,1,4
401414507,Arizona Wildcats,TEAM,TOTAL,TOTAL,False,,17,59,10,32,7,27,4,7,11,23,34,14,6,3,14,21,45
401414506,South Dakota Coyotes,H. Sjerven,4068349,,True,34.0,6,14,4,11,2,3,2,4,1,3,4,0,4,1,3,5,16
401414506,South Dakota Coyotes,K. Watson,4704325,,True,35.0,3,5,2,2,1,3,1,2,0,2,2,1,0,1,2,2,8
401414506,South Dakota Coyotes,M. Krull,4433474,,True,26.0,1,4,1,3,0,1,4,5,0,7,7,2,3,0,2,3,6
401414506,South Dakota Coyotes,C. Lamb,4282528,,True,38.0,4,10,1,4,3,6,4,4,0,4,4,2,2,0,1,3,15
401414506,South Dakota Coyotes,L. Korngable,4282526,,True,37.0,4,11,3,9,1,2,2,2,0,2,2,5,1,0,3,2,11
401414506,South Dakota Coyotes,J. Ugofsky,4595855,,False,5.0,0,0,0,0,0,0,0,0,0,2,2,0,0,0,0,0,0
401414506,South Dakota Coyotes,A. Peplowski,4399655,,False,6.0,0,0,0,0,0,0,0,0,0,1,1,0,0,0,2,1,0
401414506,South Dakota Coyotes,G. Larkins,4899816,,False,15.0,1,6,1,6,0,0,0,0,2,1,3,0,0,0,1,2,2
401414506,South Dakota Coyotes,M. Guebert,4595854,,False,4.0,1,1,0,0,1,1,0,0,0,1,1,0,0,0,0,0,3
401414506,South Dakota Coyotes,TEAM,TOTAL,TOTAL,False,,20,51,12,35,8,16,13,17,6,26,32,10,10,2,14,18,61
401414506,Baylor Bears,N. Smith,4398776,,True,37.0,4,11,4,10,0,1,2,3,1,7,8,2,1,1,3,4,10
401414506,Baylor Bears,Q. Egbo,4398779,,True,24.0,6,7,6,7,0,0,1,3,3,4,7,0,1,0,3,3,13
401414506,Baylor Bears,S. Andrews,4433407,,True,37.0,3,10,1,3,2,7,0,0,1,4,5,5,0,1,4,5,8
401414506,Baylor Bears,J. Asberry,4318562,,True,29.0,1,9,0,1,1,8,2,2,0,5,5,1,2,0,2,2,5
401414506,Baylor Bears,J. Lewis,4065687,,True,36.0,2,12,1,5,1,7,0,0,3,5,8,5,0,0,5,3,5
401414506,Baylor Bears,C. Bickle,4398780,,False,28.0,1,4,0,2,1,2,3,4,1,1,2,2,0,1,1,3,6
401414506,Baylor Bears,J. Owens,4432839,,False,9.0,0,1,0,0,0,1,0,0,0,0,0,0,0,0,1,2,0
401414506,Baylor Bears,TEAM,TOTAL,TOTAL,False,,17,54,12,28,5,26,8,12,12,28,40,15,4,3,19,22,47
401414505,Louisville Cardinals,O. Cochran,4433426,,True,24.0,5,8,5,8,0,0,1,3,4,1,5,3,1,1,0,3,11
401414505,Louisville Cardinals,E. Engstler,4398729,,True,34.0,3,13,3,10,0,3,6,7,5,6,11,3,5,2,1,4,12
401414505,Louisville Cardinals,H. Van Lith,4433412,,True,37.0,8,17,5,11,3,6,2,2,1,5,6,2,0,0,0,1,21
401414505,Louisville Cardinals,K. Smith,4281919,,True,36.0,5,11,3,5,2,6,0,0,0,1,1,2,0,1,1,3,12
401414505,Louisville Cardinals,C. Hall,4280897,,True,34.0,3,8,2,4,1,4,1,1,0,1,1,2,1,0,0,0,8
401414505,Louisville Cardinals,L. Dixon,4398591,,False,10.0,0,1,0,1,0,0,0,0,1,1,2,0,2,0,2,2,0
401414505,Louisville Cardinals,P. Verhulst,4433518,,False,6.0,0,2,0,0,0,2,0,0,1,0,1,0,0,0,1,1,0
401414505,Louisville Cardinals,A. Smith,4398835,,False,1.0,0,1,0,1,0,0,0,0,0,0,0,0,0,0,0,1,0
401414505,Louisville Cardinals,M. Robinson,4398604,,False,18.0,2,3,2,3,0,0,0,0,0,2,2,1,1,1,3,3,4
401414505,Louisville Cardinals,TEAM,TOTAL,TOTAL,False,,26,64,20,43,6,21,10,13,14,17,31,13,10,5,8,18,68
401414505,Gonzaga Bulldogs,M. Kempton,4400478,,True,36.0,4,10,4,10,0,0,5,5,4,2,6,2,1,1,2,3,13
401414505,Gonzaga Bulldogs,A. Virjoghe,4400477,,True,19.0,1,3,1,3,0,0,0,0,1,4,5,0,1,1,3,2,2
401414505,Gonzaga Bulldogs,A. O'Connor,4282263,,True,23.0,0,4,0,2,0,2,1,2,2,3,5,0,1,0,1,2,1
401414505,Gonzaga Bulldogs,Kayle. Truong,4433148,,True,35.0,5,11,5,8,0,3,4,5,1,3,4,2,1,0,6,2,14
401414505,Gonzaga Bulldogs,C. Walker,4065787,,True,29.0,2,7,0,0,2,7,4,4,1,5,6,2,0,0,2,1,10
401414505,Gonzaga Bulldogs,Y. Ejim,4703874,,False,24.0,3,5,3,5,0,0,2,2,3,2,5,2,0,0,1,3,8
401414505,Gonzaga Bulldogs,E. Hollingsworth,4595767,,False,1.0,0,0,0,0,0,0,0,0,0,0,0,0,0,0,0,0,0
401414505,Gonzaga Bulldogs,M. Williams,4433490,,False,9.0,1,2,1,1,0,1,0,0,0,1,1,1,0,0,0,0,2
401414505,Gonzaga Bulldogs,Kayly. Truong,4433365,,False,24.0,3,8,1,1,2,7,1,2,0,2,2,1,1,1,2,2,9
401414505,Gonzaga Bulldogs,TEAM,TOTAL,TOTAL,False,,19,50,15,30,4,20,17,20,15,25,40,10,5,3,18,15,59
401414504,Utah Utes,J. Johnson,4898900,,True,27.0,6,9,6,7,0,2,2,2,1,0,1,1,1,1,2,3,14
401414504,Utah Utes,K. Rees,4703603,,True,31.0,4,5,4,4,0,1,0,0,0,2,2,2,1,0,1,3,8
401414504,Utah Utes,K. McQueen,4898901,,True,28.0,6,10,2,3,4,7,2,2,0,4,4,0,2,0,3,2,18
401414504,Utah Utes,G. Kneepkens,4898898,,True,24.0,2,7,2,5,0,2,0,0,0,0,0,2,0,0,2,0,4
401414504,Utah Utes,D. Gylten,4282178,,True,28.0,1,3,1,3,0,0,0,0,0,2,2,5,0,0,4,2,2
401414504,Utah Utes,D. Young,4595931,,False,22.0,0,3,0,1,0,2,0,0,0,2,2,0,0,1,1,1,0
401414504,Utah Utes,I. Vieira,4898897,,False,12.0,2,2,1,1,1,1,0,0,0,2,2,1,0,0,3,2,5
401414504,Utah Utes,I. Palmer,4594751,,False,17.0,1,3,1,1,0,2,0,0,0,1,1,2,0,0,1,0,2
401414504,Utah Utes,B. Maxwell,4433675,,False,11.0,1,3,0,0,1,3,0,0,0,0,0,0,0,0,1,0,3
401414504,Utah Utes,TEAM,TOTAL,TOTAL,False,,23,45,17,25,6,20,4,4,2,16,18,13,4,2,19,13,56
401414504,Texas Longhorns,D. Gaston,4433739,,True,12.0,0,0,0,0,0,0,0,0,0,0,0,0,0,1,0,0,0
401414504,Texas Longhorns,L. Ebo,4398943,,True,25.0,2,4,2,4,0,0,1,4,1,4,5,1,0,0,1,2,5
401414504,Texas Longhorns,R. Harmon,4433523,,True,34.0,5,11,4,9,1,2,0,0,1,3,4,8,2,0,2,0,11
401414504,Texas Longhorns,S. Holle,4433449,,True,10.0,3,5,3,4,0,1,0,0,0,0,0,0,0,0,0,1,6
401414504,Texas Longhorns,J. Allen-Taylor,4398984,,True,40.0,6,13,6,12,0,1,0,0,0,2,2,1,2,0,0,0,12
401414504,Texas Longhorns,A. Moore,4433794,,False,21.0,9,10,9,10,0,0,3,4,2,3,5,0,0,0,1,3,21
401414504,Texas Longhorns,L. Lattimore,4433517,,False,4.0,2,2,2,2,0,0,0,0,0,0,0,0,0,0,2,1,4
401414504,Texas Longhorns,F. Masudi,4898409,,False,1.0,0,0,0,0,0,0,0,0,0,0,0,0,0,0,0,0,0
401414504,Texas Longhorns,K. Hunter,4433806,,False,6.0,0,0,0,0,0,0,0,0,0,0,0,0,0,0,0,0,0
401414504,Texas Longhorns,A. Matharu,4433638,,False,28.0,6,7,4,5,2,2,0,0,0,5,5,2,3,1,1,0,14
401414504,Texas Longhorns,A. Warren,4398987,,False,19.0,2,3,2,3,0,0,1,2,2,2,4,4,2,1,4,2,5
401414504,Texas Longhorns,TEAM,TOTAL,TOTAL,False,,35,55,32,49,3,6,5,10,6,20,26,16,9,3,12,9,78
401414503,Maryland Terrapins,A. Reese,4433402,,True,22.0,5,6,5,6,0,0,11,14,3,6,9,2,1,1,3,3,21
401414503,Maryland Terrapins,C. Bibby,4280877,,True,33.0,2,7,1,5,1,2,0,0,0,4,4,0,1,0,1,1,5
401414503,Maryland Terrapins,D. Miller,4433635,,True,28.0,9,17,6,9,3,8,3,4,1,8,9,3,3,1,3,2,24
401414503,Maryland Terrapins,A. Owusu,4433632,,True,33.0,8,14,6,12,2,2,2,3,0,1,1,1,0,0,1,1,20
401414503,Maryland Terrapins,K. Benzan,4068580,,True,35.0,1,2,0,0,1,2,2,2,0,3,3,4,2,0,0,2,5
401414503,Maryland Terrapins,E. Chardon,4705475,,False,2.0,0,0,0,0,0,0,0,0,0,0,0,0,0,0,1,0,0
401414503,Maryland Terrapins,M. Collins,4398763,,False,20.0,2,5,2,5,0,0,0,0,2,1,3,0,0,0,0,2,4
401414503,Maryland Terrapins,T. Kozlova,4703584,,False,2.0,1,2,1,2,0,0,0,0,0,1,1,0,0,0,0,0,2
401414503,Maryland Terrapins,S. Sellers,4433808,,False,25.0,2,6,2,4,0,2,4,7,1,5,6,2,1,0,1,3,8
401414503,Maryland Terrapins,TEAM,TOTAL,TOTAL,False,,30,59,23,43,7,16,22,30,8,32,40,12,8,2,10,14,89
401414503,Florida Gulf Coast Eagles,T. Morehouse,4704575,,True,31.0,3,12,2,8,1,4,1,2,1,4,5,6,1,0,8,1,8
401414503,Florida Gulf Coast Eagles,K. Bell,4433633,,True,28.0,6,20,4,7,2,13,0,0,1,4,5,0,3,1,1,2,14
401414503,Florida Gulf Coast Eagles,E. List,4281132,,True,24.0,0,2,0,2,0,0,0,0,1,2,3,4,0,0,1,4,0
401414503,Florida Gulf Coast Eagles,K. Phills,4069354,,True,25.0,3,6,1,1,2,5,0,0,2,0,2,2,0,0,0,2,8
401414503,Florida Gulf Coast Eagles,K. Spray,4069207,,True,25.0,5,9,0,1,5,8,2,2,0,8,8,0,0,0,3,4,17
401414503,Florida Gulf Coast Eagles,K. Adams,4594400,,False,2.0,0,0,0,0,0,0,1,2,0,0,0,0,0,0,0,0,1
401414503,Florida Gulf Coast Eagles,S. Hackley,4704577,,False,3.0,0,1,0,1,0,0,0,0,0,0,0,0,0,0,0,0,0
401414503,Florida Gulf Coast Eagles,M. Antenucci,4704576,,False,2.0,0,1,0,0,0,1,0,0,0,0,0,0,0,0,0,0,0
401414503,Florida Gulf Coast Eagles,M. Schimmel,4703636,,False,2.0,0,0,0,0,0,0,0,0,0,0,0,0,0,0,0,0,0
401414503,Florida Gulf Coast Eagles,T. Bryant,4399860,,False,2.0,0,0,0,0,0,0,0,0,0,1,1,0,0,0,0,0,0
401414503,Florida Gulf Coast Eagles,K. Webb,4399370,,False,7.0,1,4,1,1,0,3,0,0,1,1,2,0,0,0,0,0,2
401414503,Florida Gulf Coast Eagles,K. Seay,4398689,,False,22.0,3,6,2,5,1,1,0,0,2,3,5,1,0,0,1,3,7
401414503,Florida Gulf Coast Eagles,T. Cox,4281494,,False,10.0,0,0,0,0,0,0,0,0,0,0,0,0,2,0,0,1,0
401414503,Florida Gulf Coast Eagles,A. Cecil,4068826,,False,17.0,4,4,4,4,0,0,0,0,0,0,0,1,0,0,1,4,8
401414503,Florida Gulf Coast Eagles,TEAM,TOTAL,TOTAL,False,,25,65,14,30,11,35,4,6,8,24,32,14,6,1,15,21,65
401414502,Stanford Cardinal,C. Brink,4433404,,True,30.0,5,11,4,9,1,2,2,2,3,9,12,4,2,2,2,0,13
401414502,Stanford Cardinal,H. Jones,4595910,,True,28.0,3,5,3,5,0,0,1,2,1,0,1,4,0,2,3,3,7
401414502,Stanford Cardinal,La. Hull,4398830,,True,16.0,2,4,1,1,1,3,2,2,0,1,1,0,0,0,2,3,7
401414502,Stanford Cardinal,Le. Hull,4398829,,True,36.0,14,21,8,10,6,11,2,2,1,5,6,3,6,0,2,0,36
401414502,Stanford Cardinal,A. Wilson,4066545,,True,17.0,1,3,0,1,1,2,0,0,1,1,2,2,1,0,1,2,3
401414502,Stanford Cardinal,K. Iriafen,4898384,,False,5.0,1,2,1,2,0,0,0,0,0,0,0,0,0,1,0,1,2
401414502,Stanford Cardinal,A. Prechtel,4433634,,False,9.0,1,2,1,1,0,1,0,0,1,1,2,0,1,0,1,1,2
401414502,Stanford Cardinal,F. Belibi,4432843,,False,19.0,2,3,2,3,0,0,1,1,2,3,5,2,1,0,0,2,5
401414502,Stanford Cardinal,A. Jerome,4282165,,False,2.0,0,0,0,0,0,0,0,0,0,0,0,0,0,0,0,0,0
401414502,Stanford Cardinal,B. Demetre,4433513,,False,3.0,1,1,0,0,1,1,0,0,0,0,0,0,0,0,0,0,3
401414502,Stanford Cardinal,E. Bosgana,4705410,,False,3.0,0,0,0,0,0,0,0,0,0,1,1,1,0,0,0,0,0
401414502,Stanford Cardinal,A. Emma-Nnopu,4703591,,False,4.0,1,2,1,2,0,0,0,0,0,0,0,0,0,0,0,1,2
401414502,Stanford Cardinal,J. Van Gytenbeek,4433434,,False,5.0,0,1,0,0,0,1,2,2,0,0,0,3,0,0,0,0,2
401414502,Stanford Cardinal,H. Jump,4432868,,False,17.0,3,5,0,0,3,5,0,0,0,2,2,0,0,0,0,0,9
401414502,Stanford Cardinal,J. Hamilton,4281239,,False,6.0,0,0,0,0,0,0,0,0,0,0,0,0,0,0,3,0,0
401414502,Stanford Cardinal,TEAM,TOTAL,TOTAL,False,,34,60,21,34,13,26,10,11,9,27,36,19,11,5,14,13,91
401414502,Kansas Jayhawks,I. Chatzileonti,4600665,,True,37.0,4,8,3,7,1,1,2,2,0,4,4,2,0,1,1,2,11
401414502,Kansas Jayhawks,T. Jackson,4898989,,True,31.0,4,5,4,5,0,0,0,0,3,3,6,0,0,3,4,4,8
401414502,Kansas Jayhawks,H. Kersgieter,4433703,,True,27.0,2,4,2,4,0,0,3,5,0,1,1,1,0,0,4,1,7
401414502,Kansas Jayhawks,Z. Franklin,4432983,,True,36.0,6,16,6,13,0,3,1,1,0,5,5,4,0,0,4,2,13
401414502,Kansas Jayhawks,J. Brosseau,4066590,,True,16.0,2,5,0,2,2,3,0,0,0,0,0,1,1,0,0,1,6
401414502,Kansas Jayhawks,K. Jessen,4600607,,False,3.0,0,0,0,0,0,0,0,0,0,1,1,0,0,0,0,0,0
401414502,Kansas Jayhawks,N. Eltayeb,4898993,,False,3.0,0,1,0,1,0,0,0,0,0,1,1,0,0,0,0,1,0
401414502,Kansas Jayhawks,D. Papadopoulou,4898992,,False,6.0,0,1,0,1,0,0,0,0,0,1,1,0,0,0,2,4,0
401414502,Kansas Jayhawks,S. Strom,4898991,,False,3.0,0,0,0,0,0,0,0,0,0,0,0,1,0,0,0,0,0
401414502,Kansas Jayhawks,M. Vuksic,4600667,,False,3.0,2,2,0,0,2,2,0,0,0,0,0,0,0,0,0,0,6
401414502,Kansas Jayhawks,C. Prater,4433140,,False,19.0,3,9,3,8,0,1,2,2,1,1,2,0,1,0,2,1,8
401414502,Kansas Jayhawks,A. Thomas,4398826,,False,16.0,3,7,3,6,0,1,0,0,1,0,1,1,1,0,1,2,6
401414502,Kansas Jayhawks,TEAM,TOTAL,TOTAL,False,,26,58,21,47,5,11,8,10,7,17,24,10,3,4,19,18,65
401414501,Iowa Hawkeyes,M. Czinano,4398909,,True,31.0,12,20,12,20,0,0,3,4,1,5,6,2,0,0,1,2,27
401414501,Iowa Hawkeyes,M. Warnock,4433652,,True,36.0,3,9,3,7,0,2,0,0,4,3,7,4,2,1,1,1,6
401414501,Iowa Hawkeyes,C. Clark,4433403,,True,40.0,4,19,1,9,3,10,4,4,0,8,8,11,1,2,1,3,15
401414501,Iowa Hawkeyes,G. Marshall,4433113,,True,33.0,2,7,0,1,2,6,0,0,0,4,4,0,1,1,0,2,6
401414501,Iowa Hawkeyes,K. Martin,4398907,,True,35.0,2,9,2,5,0,4,0,0,1,3,4,1,2,0,1,1,4
401414501,Iowa Hawkeyes,A. O'Grady,4433538,,False,8.0,0,2,0,2,0,0,0,0,1,0,1,0,0,1,0,0,0
401414501,Iowa Hawkeyes,K. Feuerbach,4433985,,False,5.0,1,1,1,1,0,0,0,0,0,0,0,0,1,0,0,0,2
401414501,Iowa Hawkeyes,T. Taiwo,4398906,,False,12.0,1,3,1,3,0,0,0,0,0,2,2,0,2,0,1,1,2
401414501,Iowa Hawkeyes,TEAM,TOTAL,TOTAL,False,,25,70,20,48,5,22,7,8,8,29,37,18,9,5,6,10,62
401414501,Creighton Bluejays,E. Ronsiek,4598617,,True,35.0,5,14,4,8,1,6,2,4,3,7,10,4,0,2,2,2,13
401414501,Creighton Bluejays,L. Jensen,4597505,,True,36.0,8,15,5,8,3,7,0,0,2,5,7,0,1,1,3,0,19
401414501,Creighton Bluejays,C. Bachelor,4594814,,True,12.0,1,3,1,1,0,2,0,0,1,3,4,0,0,0,1,0,2
401414501,Creighton Bluejays,P. Brotzki,4399333,,True,22.0,4,12,1,4,3,8,2,2,2,0,2,1,0,0,2,2,13
401414501,Creighton Bluejays,T. Rembao,4281361,,True,27.0,1,3,1,3,0,0,0,0,1,1,2,5,0,0,1,3,2
401414501,Creighton Bluejays,M. Brake,4703757,,False,3.0,0,0,0,0,0,0,0,0,0,0,0,1,0,1,0,0,0
401414501,Creighton Bluejays,M. Mogensen,4703758,,False,28.0,3,8,2,5,1,3,0,2,1,7,8,2,1,0,3,2,7
401414501,Creighton Bluejays,M. Maly,4599199,,False,26.0,2,8,0,2,2,6,2,2,5,8,13,0,0,1,2,0,8
401414501,Creighton Bluejays,R. Saunders,4399331,,False,11.0,0,4,0,2,0,2,0,0,0,1,1,2,1,1,0,3,0
401414501,Creighton Bluejays,TEAM,TOTAL,TOTAL,False,,24,67,14,33,10,34,6,10,15,37,52,15,3,6,14,12,64
401414500,Iowa State Cyclones,N. Diew,4599130,,True,19.0,1,3,0,1,1,2,2,3,0,3,3,2,0,1,1,1,5
401414500,Iowa State Cyclones,M. Kane,4398803,,True,21.0,4,11,4,10,0,1,2,3,3,3,6,0,1,0,1,1,10
401414500,Iowa State Cyclones,E. Ryan,4433436,,True,38.0,5,13,3,10,2,3,3,4,1,5,6,9,3,1,4,1,15
401414500,Iowa State Cyclones,L. Donarski,4433409,,True,38.0,5,13,1,4,4,9,6,6,0,3,3,1,1,1,2,3,20
401414500,Iowa State Cyclones,As. Joens,4398802,,True,39.0,5,14,3,8,2,6,0,0,1,9,10,1,3,0,1,1,12
401414500,Iowa State Cyclones,M. Vick,4898397,,False,1.0,0,0,0,0,0,0,0,0,0,0,0,0,0,0,0,0,0
401414500,Iowa State Cyclones,I. Zingaro,4712646,,False,11.0,1,3,1,3,0,0,0,0,0,7,7,0,0,0,1,0,2
401414500,Iowa State Cyclones,B. Jordao,4399242,,False,8.0,0,0,0,0,0,0,1,2,1,1,2,0,0,0,1,1,1
401414500,Iowa State Cyclones,M. Espenmiller-McGraw,4594688,,False,14.0,0,1,0,0,0,1,0,0,0,0,0,0,0,0,1,0,0
401414500,Iowa State Cyclones,Au. Joens,4433988,,False,9.0,0,1,0,0,0,1,0,0,1,0,1,0,0,0,0,0,0
401414500,Iowa State Cyclones,M. Frederick,4398801,,False,2.0,1,1,1,1,0,0,0,2,0,0,0,0,0,0,0,0,2
401414500,Iowa State Cyclones,TEAM,TOTAL,TOTAL,False,,22,60,13,37,9,23,14,20,13,32,45,13,8,3,12,8,67
401414500,Georgia Lady Bulldogs,J. Nicholson,4432863,,True,3.0,0,0,0,0,0,0,0,0,0,0,0,0,0,0,2,0,0
401414500,Georgia Lady Bulldogs,J. Staiti,4065782,,True,28.0,8,17,8,15,0,2,0,0,1,8,9,0,0,5,3,2,16
401414500,Georgia Lady Bulldogs,S. Barker,4703794,,True,25.0,1,7,0,1,1,6,0,0,1,3,4,2,2,0,2,1,3
401414500,Georgia Lady Bulldogs,M. Coombs,4281074,,True,21.0,1,7,1,7,0,0,0,0,2,0,2,1,0,1,1,2,2
401414500,Georgia Lady Bulldogs,Q. Morrison,4280851,,True,34.0,3,13,1,8,2,5,2,2,0,3,3,2,2,0,2,2,10
401414500,Georgia Lady Bulldogs,J. Hollingshead,4433535,,False,8.0,0,2,0,2,0,0,0,0,0,1,1,0,0,1,1,0,0
401414500,Georgia Lady Bulldogs,J. Isaacs,4433351,,False,25.0,1,1,1,1,0,0,0,0,3,1,4,0,1,2,2,2,2
401414500,Georgia Lady Bulldogs,M. Bates,4280852,,False,13.0,2,5,2,5,0,0,0,0,1,5,6,0,0,3,0,1,4
401414500,Georgia Lady Bulldogs,T. Hylton,4913560,,False,7.0,0,0,0,0,0,0,0,0,0,0,0,3,1,0,0,3,0
401414500,Georgia Lady Bulldogs,R. Richardson,4433543,,False,18.0,2,6,1,4,1,2,0,0,1,1,2,1,1,0,0,3,5
401414500,Georgia Lady Bulldogs,C. Chapman,4433306,,False,18.0,1,4,1,3,0,1,0,0,0,3,3,4,0,1,2,2,2
401414500,Georgia Lady Bulldogs,TEAM,TOTAL,TOTAL,False,,19,62,15,46,4,16,2,2,11,27,38,13,7,13,15,18,44
401414499,South Carolina Gamecocks,A. Boston,4432831,,True,35.0,4,15,4,13,0,2,2,6,4,12,16,4,1,0,2,1,10
401414499,South Carolina Gamecocks,V. Saxton,4398752,,True,19.0,0,4,0,4,0,0,0,0,5,3,8,0,1,2,0,0,0
401414499,South Carolina Gamecocks,B. Beal,4432835,,True,27.0,2,6,2,4,0,2,2,3,0,0,0,1,1,0,0,2,6
401414499,South Carolina Gamecocks,Z. Cooke,4432832,,True,21.0,3,9,1,6,2,3,0,0,1,2,3,0,2,0,4,4,8
401414499,South Carolina Gamecocks,D. Henderson,4398751,,True,38.0,3,12,2,6,1,6,2,2,2,3,5,0,0,1,4,1,9
401414499,South Carolina Gamecocks,S. Feagin,4433795,,False,1.0,1,1,1,1,0,0,0,0,1,0,1,0,0,0,0,0,2
401414499,South Carolina Gamecocks,L. Amihere,4432834,,False,3.0,0,0,0,0,0,0,0,0,0,0,0,2,0,0,1,1,0
401414499,South Carolina Gamecocks,E. Wesolek,4398753,,False,0.0,0,0,0,0,0,0,0,0,0,0,0,0,0,0,0,0,0
401414499,South Carolina Gamecocks,K. Cardoso,4433405,,False,22.0,4,9,4,9,0,0,3,5,5,3,8,1,0,4,2,0,11
401414499,South Carolina Gamecocks,B. Hall,4898383,,False,4.0,0,1,0,0,0,1,0,0,0,1,1,0,0,0,0,1,0
401414499,South Carolina Gamecocks,O. Thompson,4433380,,False,0.0,0,0,0,0,0,0,0,0,0,0,0,0,0,0,0,0,0
401414499,South Carolina Gamecocks,D. Littleton,4281322,,False,12.0,1,4,0,0,1,4,0,0,0,2,2,0,0,0,1,0,3
401414499,South Carolina Gamecocks,L. Grissett,4280887,,False,18.0,0,0,0,0,0,0,0,0,0,0,0,1,0,1,0,0,0
401414499,South Carolina Gamecocks,TEAM,TOTAL,TOTAL,False,,18,61,14,43,4,18,9,16,19,30,49,9,5,8,16,10,49
401414499,Miami Hurricanes,L. Pendande,4398863,,True,9.0,0,2,0,1,0,1,0,0,0,0,0,0,0,0,0,2,0
401414499,Miami Hurricanes,D. Harden,4281329,,True,22.0,2,9,2,7,0,2,0,0,1,1,2,0,1,0,2,2,4
401414499,Miami Hurricanes,J. Williams,4898556,,True,22.0,1,5,1,5,0,0,0,0,2,2,4,1,0,0,4,1,2
401414499,Miami Hurricanes,K. Erjavec,4400202,,True,20.0,0,2,0,1,0,1,0,0,0,1,1,0,0,0,4,0,0
401414499,Miami Hurricanes,K. Marshall,4281196,,True,37.0,2,10,2,7,0,3,2,4,0,4,4,2,1,1,2,3,6
401414499,Miami Hurricanes,N. Mbandu,4703227,,False,21.0,1,2,1,1,0,1,0,0,0,3,3,0,2,0,1,2,2
401414499,Miami Hurricanes,P. Fraile Ruiz,4703226,,False,0.0,0,0,0,0,0,0,0,0,0,0,0,0,0,0,0,0,0
401414499,Miami Hurricanes,M. Djaldi-Tabdi,4281214,,False,31.0,5,11,0,0,5,11,0,0,0,3,3,1,0,3,3,4,15
401414499,Miami Hurricanes,J. Roberts,4898555,,False,0.0,0,0,0,0,0,0,0,0,0,0,0,0,0,0,0,0,0
401414499,Miami Hurricanes,L. Dwyer,4683033,,False,10.0,0,3,0,3,0,0,0,0,0,1,1,0,1,0,0,1,0
401414499,Miami Hurricanes,M. Johnson Sidi Baba,4594386,,False,17.0,0,1,0,1,0,0,4,4,0,5,5,0,0,0,1,0,4
401414499,Miami Hurricanes,M. Gray,4281194,,False,11.0,0,1,0,1,0,0,0,0,0,0,0,2,1,0,1,0,0
401414499,Miami Hurricanes,TEAM,TOTAL,TOTAL,False,,11,46,6,27,5,19,6,8,6,25,31,6,6,4,19,15,33
401414498,Stephen F. Austin Ladyjacks,Ai. Johnson,4400451,,True,34.0,5,13,5,13,0,0,1,2,6,3,9,4,0,1,2,3,11
401414498,Stephen F. Austin Ladyjacks,Z. Nugent,4595808,,True,29.0,7,17,2,7,5,10,7,9,1,4,5,3,0,0,3,6,26
401414498,Stephen F. Austin Ladyjacks,S. Visscher,4400450,,True,29.0,3,6,2,4,1,2,2,2,2,2,4,1,1,0,4,3,9
401414498,Stephen F. Austin Ladyjacks,B. Mitchell,4400448,,True,35.0,0,6,0,3,0,3,0,0,1,2,3,2,3,0,2,3,0
401414498,Stephen F. Austin Ladyjacks,T. Robinson,4281818,,True,23.0,3,7,1,1,2,6,0,0,0,1,1,1,2,0,1,4,8
401414498,Stephen F. Austin Ladyjacks,B. Scott,4705020,,False,1.0,0,1,0,0,0,1,0,0,0,0,0,0,0,0,0,0,0
401414498,Stephen F. Austin Ladyjacks,A. Brittingham,4705019,,False,10.0,3,7,3,7,0,0,3,3,5,5,10,0,1,0,0,2,9
401414498,Stephen F. Austin Ladyjacks,Z. Nelson,4899455,,False,1.0,0,0,0,0,0,0,0,0,0,0,0,0,0,0,0,0,0
401414498,Stephen F. Austin Ladyjacks,Aa. Johnson,4400452,,False,8.0,1,3,0,1,1,2,0,0,0,0,0,0,0,0,0,0,3
401414498,Stephen F. Austin Ladyjacks,A. Scott,4899456,,False,21.0,0,3,0,0,0,3,0,0,0,1,1,0,0,0,0,2,0
401414498,Stephen F. Austin Ladyjacks,F. Prinz,4705021,,False,1.0,0,0,0,0,0,0,0,0,0,0,0,0,0,0,0,0,0
401414498,Stephen F. Austin Ladyjacks,R. Crane,4705018,,False,1.0,0,0,0,0,0,0,0,0,0,0,0,0,0,0,0,0,0
401414498,Stephen F. Austin Ladyjacks,T. McCliment-Call,4703856,,False,6.0,0,2,0,0,0,2,0,0,0,0,0,1,0,0,0,0,0
401414498,Stephen F. Austin Ladyjacks,D. Lombard,4597501,,False,1.0,0,0,0,0,0,0,0,0,0,1,1,0,0,0,0,0,0
401414498,Stephen F. Austin Ladyjacks,TEAM,TOTAL,TOTAL,False,,22,65,13,36,9,29,13,16,16,20,36,12,7,1,13,23,66
401414498,North Carolina Tar Heels,A. Poole,4434028,,True,11.0,0,0,0,0,0,0,0,0,0,1,1,1,0,0,0,3,0
401414498,North Carolina Tar Heels,K. Todd-Williams,4433740,,True,28.0,6,12,5,8,1,4,2,4,2,3,5,2,2,2,1,4,15
401414498,North Carolina Tar Heels,A. Ustby,4433489,,True,36.0,5,11,5,9,0,2,3,3,2,6,8,0,1,0,5,5,13
401414498,North Carolina Tar Heels,D. Kelly,4433410,,True,38.0,8,15,4,8,4,7,8,8,1,4,5,4,0,0,4,1,28
401414498,North Carolina Tar Heels,C. Littlefield,4281403,,True,38.0,4,7,2,3,2,4,3,4,0,9,9,4,1,1,2,0,13
401414498,North Carolina Tar Heels,A. Zelaya,4433778,,False,19.0,0,1,0,1,0,0,0,2,2,0,2,1,0,0,0,0,0
401414498,North Carolina Tar Heels,D. Adams,4433528,,False,1.0,0,0,0,0,0,0,0,0,0,1,1,0,0,0,0,0,0
401414498,North Carolina Tar Heels,E. Hodgson,4400235,,False,29.0,3,10,1,4,2,6,2,2,2,1,3,4,1,0,3,3,10
401414498,North Carolina Tar Heels,TEAM,TOTAL,TOTAL,False,,26,56,17,33,9,23,18,23,10,28,38,16,5,3,16,16,79
401414497,NC State Wolfpack,K. Jones,4281199,,True,17.0,2,6,2,6,0,0,2,5,1,2,3,2,2,0,2,2,6
401414497,NC State Wolfpack,E. Cunane,4398625,,True,20.0,3,5,3,5,0,0,7,8,3,4,7,2,0,1,3,3,13
401414497,NC State Wolfpack,J. Brown-Turner,4432841,,True,27.0,5,9,2,2,3,7,2,3,5,2,7,2,0,0,0,1,15
401414497,NC State Wolfpack,K. Crutchfield,4281198,,True,27.0,0,3,0,1,0,2,0,0,0,4,4,5,3,1,0,2,0
401414497,NC State Wolfpack,R. Perez,4068715,,True,26.0,7,8,5,5,2,3,0,0,0,4,4,1,1,0,1,0,16
401414497,NC State Wolfpack,J. Boyd,4432859,,False,20.0,6,11,6,10,0,1,0,0,3,1,4,0,0,1,2,2,12
401414497,NC State Wolfpack,S. Hart,4898385,,False,3.0,0,1,0,1,0,0,0,0,0,1,1,1,0,0,0,1,0
401414497,NC State Wolfpack,C. Hobby,4433005,,False,13.0,3,6,3,6,0,0,2,2,0,3,3,1,0,0,1,0,8
401414497,NC State Wolfpack,D. Johnson,4703768,,False,17.0,5,8,3,3,2,5,0,0,0,2,2,1,0,0,3,2,12
401414497,NC State Wolfpack,J. Timmons,4433811,,False,6.0,1,4,1,3,0,1,0,0,0,0,0,0,0,0,0,2,2
401414497,NC State Wolfpack,A. James,4433807,,False,13.0,2,7,2,4,0,3,2,2,3,1,4,0,2,1,0,3,6
401414497,NC State Wolfpack,G. Bryant,4433450,,False,4.0,1,3,0,0,1,3,0,0,0,2,2,0,0,0,0,0,3
401414497,NC State Wolfpack,M. Hayes,4433413,,False,7.0,1,1,1,1,0,0,1,2,3,0,3,0,1,1,0,1,3
401414497,NC State Wolfpack,TEAM,TOTAL,TOTAL,False,,36,72,28,47,8,25,16,22,19,31,50,15,9,5,12,19,96
401414497,Longwood Lancers,A. Smith,4399978,,True,37.0,4,14,4,14,0,0,2,4,1,6,7,2,1,1,2,2,10
401414497,Longwood Lancers,T. Smith,4594910,,True,38.0,8,20,3,7,5,13,4,4,0,3,3,6,2,0,4,2,25
401414497,Longwood Lancers,B. Johns,4704970,,True,20.0,2,6,0,0,2,6,1,2,1,1,2,0,0,1,0,3,7
401414497,Longwood Lancers,K. McMakin,4594907,,True,36.0,7,20,5,9,2,11,3,3,2,3,5,1,1,0,4,3,19
401414497,Longwood Lancers,K. Calhoun,4900634,,True,23.0,0,2,0,1,0,1,0,0,4,0,4,0,0,0,2,2,0
401414497,Longwood Lancers,B. Anya,4704849,,False,12.0,0,0,0,0,0,0,0,0,0,4,4,0,0,0,0,2,0
401414497,Longwood Lancers,A. LeRoy,4594913,,False,15.0,1,4,1,4,0,0,2,2,1,4,5,0,0,0,2,2,4
401414497,Longwood Lancers,A. Shipp,4594908,,False,17.0,1,3,1,2,0,1,1,1,5,0,5,0,0,0,0,2,3
401414497,Longwood Lancers,M. Vennema,4399977,,False,2.0,0,0,0,0,0,0,0,0,1,0,1,0,0,0,0,0,0
401414497,Longwood Lancers,TEAM,TOTAL,TOTAL,False,,23,69,14,37,9,32,13,16,16,22,38,9,4,2,14,18,68
401414496,Indiana Hoosiers,M. Holmes,4433643,,True,25.0,9,15,9,14,0,1,1,1,2,6,8,1,1,0,1,3,19
401414496,Indiana Hoosiers,A. Gulbe,4398898,,True,32.0,6,12,4,7,2,5,1,1,1,6,7,2,3,0,0,0,15
401414496,Indiana Hoosiers,G. Berger,4398899,,True,33.0,7,13,7,13,0,0,4,6,0,6,6,6,2,0,2,0,18
401414496,Indiana Hoosiers,N. Cardaño-Hillary,4281477,,True,30.0,3,8,3,5,0,3,5,6,0,3,3,5,1,0,1,1,11
401414496,Indiana Hoosiers,A. Patberg,3904578,,True,32.0,3,6,2,4,1,2,0,0,0,2,2,4,0,0,1,1,7
401414496,Indiana Hoosiers,M. Zaric,4898388,,False,3.0,1,1,1,1,0,0,0,0,0,0,0,1,0,0,0,1,2
401414496,Indiana Hoosiers,K. Browne,4703715,,False,6.0,1,1,1,1,0,0,0,0,1,2,3,0,0,0,0,1,2
401414496,Indiana Hoosiers,A. Wisne,4433691,,False,3.0,0,0,0,0,0,0,0,0,0,1,1,0,0,0,0,1,0
401414496,Indiana Hoosiers,C. Moore-McNeil,4703714,,False,24.0,3,6,2,3,1,3,0,0,0,4,4,4,0,0,0,1,7
401414496,Indiana Hoosiers,K. Peterson,4683312,,False,7.0,1,1,1,1,0,0,0,0,0,0,0,0,1,0,0,2,2
401414496,Indiana Hoosiers,G. Waggoner,4594771,,False,5.0,1,1,1,1,0,0,0,1,1,1,2,0,0,1,1,0,2
401414496,Indiana Hoosiers,TEAM,TOTAL,TOTAL,False,,35,64,31,50,4,14,11,15,5,32,37,23,8,1,6,11,85
401414496,Charlotte 49ers,M. Williams,4704501,,True,20.0,1,4,0,3,1,1,1,2,1,3,4,0,0,0,2,3,4
401414496,Charlotte 49ers,K. McKinney,4280854,,True,37.0,0,4,0,3,0,1,0,0,0,7,7,2,0,0,1,3,0
401414496,Charlotte 49ers,J. McMillian,4399489,,True,36.0,4,9,4,9,0,0,0,0,0,0,0,2,1,0,6,1,8
401414496,Charlotte 49ers,O. Jett-Wilson,4399487,,True,34.0,7,14,7,12,0,2,5,6,0,1,1,1,1,0,2,2,19
401414496,Charlotte 49ers,M. Boykin,4281177,,True,30.0,4,15,4,11,0,4,1,1,0,7,7,2,0,1,2,1,9
401414496,Charlotte 49ers,M. McGraw,4899072,,False,2.0,0,0,0,0,0,0,0,0,0,0,0,0,0,0,0,0,0
401414496,Charlotte 49ers,A. Middleton,4594982,,False,7.0,1,2,1,2,0,0,1,2,0,2,2,0,0,0,0,1,3
401414496,Charlotte 49ers,A. Wade,4899071,,False,2.0,0,0,0,0,0,0,1,4,0,1,1,0,0,0,0,0,1
401414496,Charlotte 49ers,J. Busick,4704499,,False,14.0,0,1,0,1,0,0,0,0,2,2,4,0,0,0,0,2,0
401414496,Charlotte 49ers,D. Lawrence,4594980,,False,16.0,3,5,3,5,0,0,1,2,1,1,2,0,0,0,1,2,7
401414496,Charlotte 49ers,K. Roach,4280856,,False,2.0,0,0,0,0,0,0,0,0,0,0,0,0,0,0,0,1,0
401414496,Charlotte 49ers,TEAM,TOTAL,TOTAL,False,,20,54,19,46,1,8,10,17,6,26,32,7,2,1,14,16,51
401414495,LSU Tigers,A. Newby,4280898,,True,24.0,0,3,0,3,0,0,0,0,1,5,6,1,2,0,2,3,0
401414495,LSU Tigers,F. Aifuwa,4065738,,True,36.0,7,15,7,15,0,0,3,6,5,9,14,0,1,7,1,3,17
401414495,LSU Tigers,R. Payne,4399220,,True,23.0,2,8,2,6,0,2,0,1,0,0,0,5,1,0,1,5,4
401414495,LSU Tigers,J. Cherry,4280863,,True,40.0,12,23,12,22,0,1,0,0,1,2,3,2,1,2,1,2,24
401414495,LSU Tigers,K. Pointer,4280859,,True,38.0,8,20,6,15,2,5,8,13,1,8,9,8,4,0,3,4,26
401414495,LSU Tigers,A. Trasi,4595165,,False,15.0,1,1,1,1,0,0,2,2,1,3,4,0,1,0,1,2,4
401414495,LSU Tigers,H. Gusters,4433732,,False,5.0,0,0,0,0,0,0,0,0,0,0,0,0,0,0,0,0,0
401414495,LSU Tigers,A. Morris,4281251,,False,19.0,0,4,0,3,0,1,8,9,0,1,1,2,0,0,2,1,8
401414495,LSU Tigers,TEAM,TOTAL,TOTAL,False,,30,74,28,65,2,9,21,31,14,28,42,18,10,9,11,20,83
401414495,Jackson State Lady Tigers,L. Sims,4704560,,True,24.0,2,3,2,3,0,0,0,0,1,5,6,0,0,0,0,1,4
401414495,Jackson State Lady Tigers,A. Williams-Holliday,4065745,,True,33.0,4,13,4,13,0,0,7,10,3,9,12,0,1,2,4,4,15
401414495,Jackson State Lady Tigers,M. Crump,4900475,,True,29.0,5,11,1,5,4,6,7,11,1,4,5,2,1,1,2,3,21
401414495,Jackson State Lady Tigers,D. Rogan,4595999,,True,31.0,2,12,0,8,2,4,3,4,0,2,2,4,0,0,1,1,9
401414495,Jackson State Lady Tigers,K. Luckett,4595995,,True,24.0,2,9,1,7,1,2,2,4,3,2,5,2,1,0,4,5,7
401414495,Jackson State Lady Tigers,D. Woodard,4900474,,False,21.0,3,4,3,4,0,0,0,0,2,4,6,0,1,1,1,5,6
401414495,Jackson State Lady Tigers,A. Hunter,4900477,,False,2.0,0,1,0,0,0,1,0,0,0,0,0,1,0,0,0,0,0
401414495,Jackson State Lady Tigers,J. Covington,4704112,,False,24.0,4,11,3,9,1,2,0,0,1,2,3,2,0,0,3,3,9
401414495,Jackson State Lady Tigers,T. Boler,4704111,,False,12.0,3,4,3,4,0,0,0,0,1,0,1,0,1,0,0,1,6
401414495,Jackson State Lady Tigers,TEAM,TOTAL,TOTAL,False,,25,68,17,53,8,15,19,29,15,31,46,11,5,4,15,23,77
401414494,Oregon Ducks,N. Sabally,4398768,,True,48.0,12,24,12,23,0,1,7,8,4,8,12,3,3,7,2,3,31
401414494,Oregon Ducks,S. Prince,4398986,,True,36.0,4,10,4,9,0,1,1,2,4,5,9,2,0,1,2,2,9
401414494,Oregon Ducks,E. Rogers,4433640,,True,43.0,2,8,2,6,0,2,2,4,1,5,6,5,1,0,2,4,6
401414494,Oregon Ducks,T. Paopao,4433431,,True,42.0,8,17,6,9,2,8,0,0,2,4,6,2,2,1,5,3,18
401414494,Oregon Ducks,S. Parrish,4433414,,True,13.0,0,4,0,2,0,2,0,0,2,1,3,0,0,0,0,0,0
401414494,Oregon Ducks,C. Pinto,4898390,,False,4.0,0,0,0,0,0,0,0,0,0,1,1,0,0,0,0,0,0
401414494,Oregon Ducks,K. Watson,4433735,,False,15.0,0,1,0,1,0,0,0,0,1,4,5,0,0,3,2,2,0
401414494,Oregon Ducks,M. Scherr,4433420,,False,40.0,1,6,0,3,1,3,0,0,1,4,5,3,1,0,2,3,3
401414494,Oregon Ducks,A. Hurst,4400147,,False,9.0,1,4,0,0,1,4,0,0,0,2,2,0,0,0,2,1,3
401414494,Oregon Ducks,TEAM,TOTAL,TOTAL,False,,28,74,24,53,4,21,10,14,17,36,53,15,7,12,17,18,70
401414494,Belmont Bruins,M. Bartley,4705406,,True,25.0,3,10,1,4,2,6,0,0,2,5,7,2,0,1,0,4,8
401414494,Belmont Bruins,C. Chinn,4282391,,True,35.0,4,12,2,5,2,7,0,0,0,1,1,1,1,0,1,1,10
401414494,Belmont Bruins,T. Jones,4705405,,True,44.0,8,11,4,7,4,4,2,4,3,3,6,1,4,0,2,1,22
401414494,Belmont Bruins,D. Wells,4586267,,True,43.0,4,14,4,11,0,3,8,9,0,4,4,7,2,0,1,2,16
401414494,Belmont Bruins,J. Kinney,4399580,,True,39.0,2,6,0,0,2,6,0,0,0,5,5,3,1,0,2,0,6
401414494,Belmont Bruins,T. Miller,4900197,,False,26.0,1,5,1,5,0,0,0,2,0,5,5,0,1,0,0,4,2
401414494,Belmont Bruins,K. McGuff,4900196,,False,6.0,0,0,0,0,0,0,0,0,0,1,1,1,1,0,2,0,0
401414494,Belmont Bruins,B. Schoenwald,4705408,,False,16.0,1,5,0,0,1,5,0,0,0,4,4,0,1,0,1,0,3
401414494,Belmont Bruins,N. Baird,4595716,,False,16.0,2,8,1,3,1,5,1,2,2,1,3,2,0,0,0,1,6
401414494,Belmont Bruins,TEAM,TOTAL,TOTAL,False,,25,71,13,35,12,36,11,17,12,30,42,17,11,1,12,13,73
401414493,Tennessee Lady Volunteers,A. Dye,4596286,,True,31.0,6,12,6,12,0,0,6,8,5,6,11,2,1,0,2,1,18
401414493,Tennessee Lady Volunteers,T. Key,4433642,,True,32.0,6,12,6,12,0,0,4,4,8,3,11,1,1,0,5,3,16
401414493,Tennessee Lady Volunteers,T. Darby,4597244,,True,18.0,0,5,0,2,0,3,0,0,1,2,3,1,0,0,0,0,0
401414493,Tennessee Lady Volunteers,R. Burrell,4398764,,True,34.0,7,18,5,13,2,5,3,4,1,5,6,3,3,0,4,0,19
401414493,Tennessee Lady Volunteers,J. Walker,4282154,,True,33.0,4,12,4,8,0,4,5,6,2,5,7,4,1,0,1,4,13
401414493,Tennessee Lady Volunteers,K. Striplin,4433810,,False,5.0,1,2,1,2,0,0,0,0,1,1,2,0,1,0,1,0,2
401414493,Tennessee Lady Volunteers,J. Rennie,4595179,,False,0.0,0,0,0,0,0,0,0,0,0,0,0,0,0,0,0,0,0
401414493,Tennessee Lady Volunteers,B. Miles,4586299,,False,22.0,1,1,1,1,0,0,3,6,2,1,3,1,1,0,4,2,5
401414493,Tennessee Lady Volunteers,S. Puckett,4434021,,False,16.0,3,4,2,3,1,1,0,1,1,3,4,1,0,0,0,1,7
401414493,Tennessee Lady Volunteers,K. Wynn,4434014,,False,9.0,0,2,0,2,0,0,0,0,1,2,3,2,0,0,2,2,0
401414493,Tennessee Lady Volunteers,TEAM,TOTAL,TOTAL,False,,28,68,25,55,3,13,21,29,24,31,55,15,8,0,19,13,80
401414493,Buffalo Bulls,L. Christie,4595235,,True,18.0,1,2,1,1,0,1,0,0,0,4,4,0,0,1,2,2,2
401414493,Buffalo Bulls,G. Woolley,4899639,,True,39.0,6,20,3,12,3,8,0,0,1,2,3,3,7,0,7,4,15
401414493,Buffalo Bulls,D. Camp,4704065,,True,37.0,4,12,3,8,1,4,0,0,0,1,1,2,1,0,3,1,9
401414493,Buffalo Bulls,D. Fair,4595236,,True,39.0,10,28,5,15,5,13,0,2,1,4,5,7,2,0,2,0,25
401414493,Buffalo Bulls,S. Hemphill,4068803,,True,40.0,3,10,3,9,0,1,2,2,8,2,10,2,3,0,2,4,8
401414493,Buffalo Bulls,S. Wilson,4433553,,False,7.0,1,2,1,2,0,0,4,4,2,1,3,1,0,0,0,3,6
401414493,Buffalo Bulls,A. Adeyeye,4399304,,False,8.0,0,0,0,0,0,0,0,2,3,1,4,0,0,0,0,5,0
401414493,Buffalo Bulls,E. Gaba,4595238,,False,7.0,1,1,1,1,0,0,0,0,0,0,0,0,0,0,0,3,2
401414493,Buffalo Bulls,J. Young,4400441,,False,5.0,0,0,0,0,0,0,0,0,0,1,1,1,0,0,0,1,0
401414493,Buffalo Bulls,TEAM,TOTAL,TOTAL,False,,26,75,17,48,9,27,6,10,17,21,38,16,13,1,16,23,67
401414492,Michigan Wolverines,E. Kiser,4398919,,True,28.0,5,8,4,6,1,2,2,2,1,6,7,1,2,1,0,2,13
401414492,Michigan Wolverines,N. Hillmon,4398915,,True,25.0,11,14,11,14,0,0,2,6,5,6,11,1,3,0,2,0,24
401414492,Michigan Wolverines,M. Nolan,4594938,,True,26.0,2,7,0,2,2,5,0,0,2,5,7,4,2,1,1,1,6
401414492,Michigan Wolverines,L. Phelia,4433541,,True,21.0,4,9,4,6,0,3,0,0,0,1,1,2,2,0,2,1,8
401414492,Michigan Wolverines,D. Rauch,4398918,,True,25.0,0,3,0,1,0,2,0,0,0,0,0,2,0,0,0,0,0
401414492,Michigan Wolverines,W. Sollom,4433480,,False,3.0,0,1,0,1,0,0,0,0,1,1,2,1,0,0,0,1,0
401414492,Michigan Wolverines,C. Williams,4433415,,False,10.0,1,2,1,2,0,0,0,0,1,1,2,0,0,0,4,2,2
401414492,Michigan Wolverines,E. Stuck,4599502,,False,9.0,2,2,2,2,0,0,0,0,0,1,1,1,0,0,0,0,4
401414492,Michigan Wolverines,I. Varejão,4433687,,False,8.0,1,4,1,4,0,0,0,0,1,1,2,0,0,0,0,0,2
401414492,Michigan Wolverines,J. Hobbs,4898392,,False,7.0,0,1,0,0,0,1,0,0,0,0,0,1,0,0,0,0,0
401414492,Michigan Wolverines,M. Sidor,4433327,,False,5.0,1,2,1,1,0,1,0,0,0,1,1,0,0,0,0,0,2
401414492,Michigan Wolverines,L. Brown,4398928,,False,12.0,4,11,2,8,2,3,1,1,0,0,0,6,2,0,1,1,11
401414492,Michigan Wolverines,A. Dilk,4398916,,False,21.0,1,2,1,2,0,0,0,2,0,5,5,2,0,0,1,1,2
401414492,Michigan Wolverines,TEAM,TOTAL,TOTAL,False,,32,66,27,49,5,17,5,11,11,30,41,21,11,2,11,9,74
401414492,American University Eagles,L. Stack,4595455,,True,20.0,4,5,4,5,0,0,2,3,0,1,1,0,0,0,2,5,10
401414492,American University Eagles,T. Brown,4400157,,True,35.0,3,13,2,6,1,7,1,1,1,4,5,3,2,0,4,1,8
401414492,American University Eagles,I. Bales,4704685,,True,28.0,1,8,1,5,0,3,0,0,3,4,7,0,0,1,1,0,2
401414492,American University Eagles,J. Edwards,4400156,,True,38.0,3,7,3,5,0,2,1,1,0,3,3,1,0,0,2,3,7
401414492,American University Eagles,E. Fisher,4400155,,True,36.0,3,8,3,5,0,3,0,0,0,6,6,3,2,1,9,2,6
401414492,American University Eagles,E. Johns,4704688,,False,19.0,3,8,3,6,0,2,0,0,0,2,2,1,0,0,2,3,6
401414492,American University Eagles,K. Vres,4595454,,False,5.0,0,2,0,0,0,2,0,0,1,0,1,0,0,0,0,1,0
401414492,American University Eagles,K. Henning,4704686,,False,4.0,0,2,0,2,0,0,0,0,0,2,2,0,0,0,0,1,0
401414492,American University Eagles,R. DeRubbo,4703746,,False,6.0,0,2,0,1,0,1,0,0,0,1,1,0,0,0,0,0,0
401414492,American University Eagles,L. Graytok,4400159,,False,5.0,0,0,0,0,0,0,0,0,1,0,1,1,1,0,0,0,0
401414492,American University Eagles,M. Doring,4400158,,False,4.0,0,2,0,1,0,1,0,0,0,0,0,1,0,0,0,1,0
401414492,American University Eagles,TEAM,TOTAL,TOTAL,False,,17,57,16,36,1,21,4,5,11,24,35,10,5,2,21,17,39
401414491,Ohio State Buckeyes,R. Mikulasikova,4594942,,True,18.0,2,7,1,4,1,3,1,2,1,2,3,1,0,1,1,3,6
401414491,Ohio State Buckeyes,R. Harris,4433636,,True,17.0,1,4,0,0,1,4,1,2,1,1,2,0,0,0,0,3,4
401414491,Ohio State Buckeyes,J. Sheldon,4432865,,True,40.0,7,12,6,8,1,4,10,12,2,4,6,5,5,1,3,2,25
401414491,Ohio State Buckeyes,T. Mikesell,4398912,,True,40.0,5,13,3,9,2,4,2,2,0,3,3,3,1,2,1,2,14
401414491,Ohio State Buckeyes,B. Miller,4281317,,True,32.0,0,9,0,4,0,5,1,2,2,1,3,1,4,2,2,3,1
401414491,Ohio State Buckeyes,T. Beacham,4068997,,False,22.0,3,9,3,9,0,0,2,4,2,3,5,1,1,1,0,3,8
401414491,Ohio State Buckeyes,T. Thierry,4898400,,False,26.0,1,2,1,2,0,0,3,4,2,3,5,0,2,0,2,2,5
401414491,Ohio State Buckeyes,K. Poole,4433418,,False,5.0,0,0,0,0,0,0,0,2,0,0,0,0,0,0,1,0,0
401414491,Ohio State Buckeyes,TEAM,TOTAL,TOTAL,False,,19,56,14,36,5,20,20,30,11,22,33,11,13,7,10,18,63
401414491,Missouri State Lady Bears,J. Ezeh,4433647,,True,24.0,2,4,2,4,0,0,0,0,2,0,2,0,0,0,3,2,4
401414491,Missouri State Lady Bears,A. Jackson,4280839,,True,26.0,5,12,5,12,0,0,1,2,2,6,8,1,1,4,1,4,11
401414491,Missouri State Lady Bears,M. Bhinhar,4399417,,True,39.0,0,6,0,4,0,2,0,0,2,2,4,3,0,1,3,3,0
401414491,Missouri State Lady Bears,S. Wilson,4399416,,True,26.0,2,6,2,6,0,0,2,2,3,2,5,1,0,0,4,2,6
401414491,Missouri State Lady Bears,B. Calip,4068634,,True,32.0,5,13,5,13,0,0,5,6,2,3,5,3,3,0,4,2,15
401414491,Missouri State Lady Bears,I. Nwachukwu,4900080,,False,30.0,3,5,3,5,0,0,3,5,5,12,17,1,1,1,2,5,9
401414491,Missouri State Lady Bears,P. Rocca,4704874,,False,4.0,2,3,1,2,1,1,0,0,1,1,2,0,0,0,1,0,5
401414491,Missouri State Lady Bears,M. White,4281945,,False,19.0,2,14,1,13,1,1,1,2,1,2,3,1,0,0,3,2,6
401414491,Missouri State Lady Bears,TEAM,TOTAL,TOTAL,False,,21,63,19,59,2,4,12,17,22,29,51,10,5,6,22,20,56
401414490,UNLV Lady Rebels,K. Rooks,4282188,,True,35.0,2,4,2,3,0,1,1,2,1,6,7,0,0,0,2,3,5
401414490,UNLV Lady Rebels,D. Young,4704625,,True,23.0,7,10,7,10,0,0,2,4,1,10,11,2,0,0,2,5,16
401414490,UNLV Lady Rebels,A. Durazo-Frescas,4683009,,True,31.0,3,6,0,1,3,5,2,2,0,2,2,0,1,0,1,0,11
401414490,UNLV Lady Rebels,J. Ethridge,4400144,,True,23.0,2,4,1,2,1,2,0,0,1,0,1,1,0,1,3,0,5
401414490,UNLV Lady Rebels,E. Booker,4400133,,True,34.0,4,10,3,5,1,5,3,4,0,5,5,5,0,0,5,3,12
401414490,UNLV Lady Rebels,N. Obiazor,4705419,,False,20.0,6,10,6,10,0,0,1,3,0,2,2,0,0,0,3,2,13
401414490,UNLV Lady Rebels,A. Brown,4683001,,False,1.0,1,1,1,1,0,0,1,1,0,0,0,0,0,0,0,0,3
401414490,UNLV Lady Rebels,K. Wilfred,4595641,,False,1.0,0,0,0,0,0,0,0,0,0,0,0,0,0,0,0,0,0
401414490,UNLV Lady Rebels,K. Jackson,4900597,,False,29.0,1,4,1,4,0,0,0,0,1,3,4,2,0,0,0,4,2
401414490,UNLV Lady Rebels,K. Winfrey,4900596,,False,1.0,0,0,0,0,0,0,0,0,0,0,0,0,0,0,0,0,0
401414490,UNLV Lady Rebels,T. Smith,4900595,,False,1.0,0,0,0,0,0,0,0,0,0,0,0,1,0,0,0,0,0
401414490,UNLV Lady Rebels,J. Thomas,4704624,,False,1.0,0,0,0,0,0,0,0,0,0,0,0,0,0,0,0,0,0
401414490,UNLV Lady Rebels,TEAM,TOTAL,TOTAL,False,,26,49,21,36,5,13,10,16,5,31,36,11,1,1,19,18,67
401414490,Arizona Wildcats,L. Ware,4433422,,True,32.0,3,6,3,5,0,1,3,4,0,7,7,2,1,1,0,3,9
401414490,Arizona Wildcats,C. Reese,4398698,,True,20.0,6,12,5,10,1,2,3,5,1,2,3,1,1,0,2,3,16
401414490,Arizona Wildcats,S. Thomas,4281914,,True,35.0,1,2,1,1,0,1,0,0,0,1,1,2,4,2,1,3,2
401414490,Arizona Wildcats,S. Pellington,4601922,,True,32.0,10,19,8,13,2,6,8,13,0,3,3,4,4,0,0,2,30
401414490,Arizona Wildcats,B. Yeaney,4281255,,True,23.0,1,5,1,4,0,1,2,4,0,1,1,1,1,0,1,5,4
401414490,Arizona Wildcats,G. Sanchez,4898411,,False,2.0,0,0,0,0,0,0,0,0,0,0,0,0,0,0,0,1,0
401414490,Arizona Wildcats,K. Love,4433326,,False,14.0,1,4,1,3,0,1,0,0,1,4,5,0,0,0,1,1,2
401414490,Arizona Wildcats,A. Copeland,4280704,,False,4.0,0,0,0,0,0,0,0,0,0,0,0,0,0,0,1,1,0
401414490,Arizona Wildcats,A. Vonleh,4433519,,False,3.0,0,0,0,0,0,0,0,0,0,0,0,0,0,0,0,2,0
401414490,Arizona Wildcats,M. Conner,4712562,,False,19.0,1,2,0,0,1,2,2,2,0,1,1,0,0,0,1,0,5
401414490,Arizona Wildcats,D. Erdogan,4703579,,False,5.0,2,3,2,2,0,1,0,0,0,0,0,0,0,0,0,0,4
401414490,Arizona Wildcats,H. Pueyo,4598223,,False,4.0,0,1,0,0,0,1,0,0,0,0,0,0,0,0,0,0,0
401414490,Arizona Wildcats,T. Chavez,4398769,,False,7.0,0,2,0,2,0,0,0,0,0,0,0,0,0,0,0,0,0
401414490,Arizona Wildcats,TEAM,TOTAL,TOTAL,False,,25,56,21,40,4,16,18,28,3,19,22,10,11,3,7,21,72
401414489,Villanova Wildcats,L. Garzon,4704605,,True,20.0,1,4,0,1,1,3,0,0,0,2,2,0,0,0,1,2,3
401414489,Villanova Wildcats,M. Siegrist,4399415,,True,38.0,10,22,9,16,1,6,4,6,5,2,7,3,1,2,1,2,25
401414489,Villanova Wildcats,Bria. Herlihy,4068169,,True,27.0,1,5,1,3,0,2,3,7,0,9,9,3,1,0,2,2,5
401414489,Villanova Wildcats,L. Olsen,4433815,,True,40.0,4,12,3,7,1,5,0,0,0,3,3,3,6,0,1,4,9
401414489,Villanova Wildcats,B. Mullin,4433296,,True,23.0,1,4,0,0,1,4,0,0,1,4,5,2,0,1,1,1,3
401414489,Villanova Wildcats,A. Cauley,4899025,,False,2.0,0,0,0,0,0,0,0,0,0,0,0,0,0,0,0,1,0
401414489,Villanova Wildcats,K. Orihel,4899024,,False,20.0,3,6,3,5,0,1,4,4,2,2,4,0,1,0,1,0,10
401414489,Villanova Wildcats,K. Gardler,4704604,,False,2.0,0,2,0,0,0,2,0,0,0,0,0,0,0,0,0,0,0
401414489,Villanova Wildcats,B. Runyan,4598592,,False,28.0,2,4,0,1,2,3,0,0,1,0,1,3,0,1,1,3,6
401414489,Villanova Wildcats,TEAM,TOTAL,TOTAL,False,,22,59,16,33,6,26,11,17,10,25,35,14,9,4,9,15,61
401414489,BYU Cougars,L. Gustin,4595746,,True,36.0,4,8,4,8,0,0,0,0,4,9,13,0,1,0,1,2,8
401414489,BYU Cougars,S. Gonzales,4400473,,True,39.0,3,14,2,11,1,3,1,2,1,5,6,8,3,0,5,2,8
401414489,BYU Cougars,P. Harding,4281977,,True,40.0,6,17,5,12,1,5,8,8,0,4,4,3,1,0,3,2,21
401414489,BYU Cougars,M. Albiero,4281974,,True,33.0,2,2,1,1,1,1,0,0,1,2,3,0,0,0,2,3,5
401414489,BYU Cougars,T. Graham,4068250,,True,33.0,4,8,1,1,3,7,0,2,0,8,8,2,0,0,3,4,11
401414489,BYU Cougars,S. Hamson,4281976,,False,11.0,1,3,1,3,0,0,0,0,1,1,2,0,1,1,1,0,2
401414489,BYU Cougars,N. Falatea,4898429,,False,4.0,0,1,0,0,0,1,0,0,0,0,0,1,0,0,0,2,0
401414489,BYU Cougars,K. Smiler,4400474,,False,4.0,1,1,1,1,0,0,0,0,0,0,0,0,0,0,1,0,2
401414489,BYU Cougars,TEAM,TOTAL,TOTAL,False,,21,54,15,37,6,17,9,12,7,30,37,14,6,1,16,15,57
401414488,UCF Knights,D. Thomas,4594542,,True,17.0,0,0,0,0,0,0,0,0,1,6,7,0,1,3,0,4,0
401414488,UCF Knights,M. Kaba,4281099,,True,37.0,6,13,6,13,0,0,2,4,1,5,6,1,1,5,1,4,14
401414488,UCF Knights,T. Sanders,4594539,,True,33.0,1,9,1,9,0,0,2,2,1,2,3,6,1,0,1,1,4
401414488,UCF Knights,D. Battles,4399028,,True,40.0,7,15,5,10,2,5,2,3,1,3,4,7,0,1,1,2,18
401414488,UCF Knights,S. Meertens,4281294,,True,25.0,3,5,3,5,0,0,0,0,1,3,4,4,0,0,1,0,6
401414488,UCF Knights,B. Smith,4399030,,False,25.0,11,15,11,15,0,0,4,6,2,4,6,0,1,0,0,3,26
401414488,UCF Knights,N. Luma,4281482,,False,1.0,0,0,0,0,0,0,0,0,0,0,0,0,0,0,0,0,0
401414488,UCF Knights,A. Lewis,4594397,,False,22.0,0,5,0,1,0,4,1,2,0,1,1,1,3,0,1,4,1
401414488,UCF Knights,TEAM,TOTAL,TOTAL,False,,28,62,26,53,2,9,11,17,9,27,36,19,7,9,6,18,69
401414488,Florida Gators,F. Dut,4433702,,True,16.0,2,6,2,6,0,0,0,0,1,1,2,0,0,1,2,0,4
401414488,Florida Gators,E. de Oliveira,4398630,,True,25.0,1,3,0,2,1,1,2,2,0,3,3,1,0,0,0,5,5
401414488,Florida Gators,N. Rickards,4595152,,True,40.0,7,13,7,11,0,2,3,4,1,3,4,0,1,0,3,1,17
401414488,Florida Gators,Z. Broughton,4398949,,True,37.0,5,15,3,7,2,8,0,0,0,8,8,6,1,1,5,3,12
401414488,Florida Gators,K. Moore,4398631,,True,23.0,0,10,0,6,0,4,5,6,3,1,4,3,0,0,1,4,5
401414488,Florida Gators,F. Toonders,4703792,,False,20.0,1,4,1,4,0,0,1,4,4,3,7,0,0,1,0,4,3
401414488,Florida Gators,Tat. Wyche,4682739,,False,2.0,0,0,0,0,0,0,0,0,0,0,0,0,0,0,0,0,0
401414488,Florida Gators,Tal. Wyche,4682738,,False,15.0,0,2,0,2,0,0,1,2,3,1,4,0,0,0,2,2,1
401414488,Florida Gators,J. Warren,4898611,,False,6.0,0,1,0,0,0,1,0,0,0,0,0,0,1,0,1,1,0
401414488,Florida Gators,A. Rimdal,4898610,,False,16.0,2,6,1,2,1,4,0,0,2,1,3,0,0,0,2,1,5
401414488,Florida Gators,TEAM,TOTAL,TOTAL,False,,18,60,14,40,4,20,12,18,18,26,44,10,3,3,16,21,52
401414487,UConn Huskies,A. Edwards,4433408,,True,24.0,3,6,3,6,0,0,1,2,2,4,6,2,2,0,2,3,7
401414487,UConn Huskies,O. Nelson-Ododa,4398966,,True,20.0,2,6,2,6,0,0,2,2,4,4,8,2,1,1,3,1,6
401414487,UConn Huskies,A. Fudd,4433790,,True,19.0,3,4,0,1,3,3,0,0,1,1,2,0,1,0,1,2,9
401414487,UConn Huskies,P. Bueckers,4433730,,True,24.0,5,7,3,5,2,2,0,0,1,3,4,5,2,1,1,1,12
401414487,UConn Huskies,C. Williams,4398965,,True,28.0,5,14,3,6,2,8,1,2,2,3,5,3,4,0,2,3,13
401414487,UConn Huskies,A. Deberry,4433516,,False,3.0,0,2,0,2,0,0,0,0,1,0,1,1,0,0,0,0,0
401414487,UConn Huskies,D. Juhász,4398938,,False,17.0,2,7,2,6,0,1,6,9,2,8,10,0,0,0,1,0,10
401414487,UConn Huskies,P. Gabriel,4433455,,False,3.0,2,3,2,3,0,0,0,0,1,1,2,0,0,0,0,0,4
401414487,UConn Huskies,C. Ducharme,4433534,,False,18.0,4,10,2,4,2,6,0,0,3,3,6,1,3,0,2,0,10
401414487,UConn Huskies,N. Muhl,4433468,,False,22.0,1,3,0,0,1,3,0,0,1,3,4,5,1,0,1,3,3
401414487,UConn Huskies,E. Westbrook,4280890,,False,22.0,3,5,1,1,2,4,1,4,0,2,2,0,0,0,2,2,9
401414487,UConn Huskies,TEAM,TOTAL,TOTAL,False,,30,67,18,40,12,27,11,19,20,33,53,19,14,2,16,15,83
401414487,Mercer Bears,A. Thayne,4704265,,True,27.0,0,1,0,1,0,0,2,2,2,0,2,0,0,0,0,2,2
401414487,Mercer Bears,J. Dougherty,4404201,,True,25.0,1,10,0,7,1,3,0,0,0,1,1,1,1,0,5,2,3
401414487,Mercer Bears,E. Houpt,4900401,,True,32.0,3,6,2,2,1,4,1,2,0,2,2,0,0,0,1,2,8
401414487,Mercer Bears,A. Neal-Tysor,4400623,,True,13.0,2,10,2,7,0,3,0,0,0,0,0,0,0,0,1,0,4
401414487,Mercer Bears,S. Titus,4281050,,True,32.0,3,14,3,14,0,0,6,8,3,2,5,0,5,0,2,3,12
401414487,Mercer Bears,A. Locke,4900404,,False,4.0,1,2,1,2,0,0,0,0,0,1,1,1,0,0,0,0,2
401414487,Mercer Bears,N. Harkless,4900403,,False,11.0,1,4,1,4,0,0,0,0,0,3,3,0,0,0,2,5,2
401414487,Mercer Bears,L. McNamara-Clement,4281558,,False,7.0,0,2,0,2,0,0,0,0,1,2,3,2,0,1,0,0,0
401414487,Mercer Bears,S. Votaw,4281224,,False,15.0,0,2,0,2,0,0,0,2,0,2,2,0,2,1,2,3,0
401414487,Mercer Bears,K. Jones,4900402,,False,5.0,1,1,1,1,0,0,0,0,0,0,0,0,0,0,0,0,2
401414487,Mercer Bears,K. Fisher,4900400,,False,4.0,1,1,0,0,1,1,0,0,0,0,0,0,0,0,1,0,3
401414487,Mercer Bears,S. Boykin,4704263,,False,4.0,0,0,0,0,0,0,0,0,0,0,0,0,0,0,0,0,0
401414487,Mercer Bears,E. Banks,4281193,,False,21.0,0,3,0,2,0,1,0,0,2,7,9,0,0,0,4,1,0
401414487,Mercer Bears,TEAM,TOTAL,TOTAL,False,,13,56,10,44,3,12,9,14,10,20,30,4,8,2,21,18,38
401414486,Princeton Tigers,E. Mitchell,4594957,,True,34.0,3,4,3,4,0,0,0,2,1,7,8,1,3,0,1,4,6
401414486,Princeton Tigers,K. Chen,4899328,,True,40.0,8,15,8,15,0,0,1,2,0,4,4,2,2,0,3,2,17
401414486,Princeton Tigers,J. Cunningham,4399194,,True,37.0,3,6,2,5,1,1,0,0,0,3,3,2,0,2,4,3,7
401414486,Princeton Tigers,G. Stone,4399190,,True,32.0,2,5,2,3,0,2,3,3,0,6,6,1,0,0,6,3,7
401414486,Princeton Tigers,A. Meyers,4281402,,True,39.0,9,21,7,14,2,7,9,11,0,5,5,1,1,0,4,4,29
401414486,Princeton Tigers,C. Nweke,4899329,,False,14.0,1,2,1,2,0,0,1,2,3,1,4,1,0,0,0,1,3
401414486,Princeton Tigers,M. Connolly,4399192,,False,4.0,0,0,0,0,0,0,0,0,0,0,0,1,0,0,0,0,0
401414486,Princeton Tigers,TEAM,TOTAL,TOTAL,False,,26,53,23,43,3,10,14,20,6,31,37,9,6,2,19,17,69
401414486,Kentucky Wildcats,N. Leveretter,4433471,,True,13.0,1,1,1,1,0,0,0,2,0,0,0,0,0,0,2,2,2
401414486,Kentucky Wildcats,J. Walker,4433800,,True,37.0,4,8,3,5,1,3,2,2,1,1,2,3,6,1,3,2,11
401414486,Kentucky Wildcats,T. Hunt,4433430,,True,24.0,0,4,0,2,0,2,5,7,0,2,2,1,0,0,0,2,5
401414486,Kentucky Wildcats,J. Massengill,4398765,,True,34.0,3,7,3,7,0,0,0,0,1,3,4,3,0,0,4,5,6
401414486,Kentucky Wildcats,R. Howard,4398674,,True,31.0,4,14,2,8,2,6,7,7,1,7,8,1,0,0,1,4,17
401414486,Kentucky Wildcats,D. Edwards,4398865,,False,32.0,6,15,6,14,0,1,4,6,5,7,12,1,1,0,5,4,16
401414486,Kentucky Wildcats,E. King,4433376,,False,4.0,0,1,0,1,0,0,0,0,0,0,0,0,0,0,0,0,0
401414486,Kentucky Wildcats,R. Benton,4398607,,False,25.0,2,6,1,3,1,3,0,0,0,0,0,1,1,0,0,1,5
401414486,Kentucky Wildcats,TEAM,TOTAL,TOTAL,False,,20,56,16,41,4,15,18,24,8,22,30,10,8,1,15,20,62
401414485,Notre Dame Fighting Irish,M. Westbeld,4433424,,True,35.0,8,11,7,8,1,3,2,2,2,3,5,1,1,1,0,1,19
401414485,Notre Dame Fighting Irish,M. Dodson,4282166,,True,29.0,6,11,6,11,0,0,6,8,2,4,6,0,0,2,3,2,18
401414485,Notre Dame Fighting Irish,O. Miles,4433791,,True,35.0,5,9,5,7,0,2,2,3,1,10,11,11,0,0,6,1,12
401414485,Notre Dame Fighting Irish,S. Citron,4433524,,True,31.0,4,7,3,5,1,2,0,0,1,4,5,2,1,0,1,2,9
401414485,Notre Dame Fighting Irish,D. Mabrey,4398736,,True,34.0,6,9,1,1,5,8,1,2,0,1,1,2,1,0,1,1,18
401414485,Notre Dame Fighting Irish,S. Brunelle,4433631,,False,11.0,1,4,1,2,0,2,0,0,0,1,1,2,0,0,0,2,2
401414485,Notre Dame Fighting Irish,A. Peoples,4432842,,False,13.0,2,4,2,4,0,0,1,2,4,0,4,0,0,0,0,1,5
401414485,Notre Dame Fighting Irish,A. Prohaska,4398717,,False,12.0,2,4,2,4,0,0,2,2,2,0,2,0,3,0,2,2,6
401414485,Notre Dame Fighting Irish,TEAM,TOTAL,TOTAL,False,,34,59,27,42,7,17,14,19,13,24,37,18,6,3,14,12,89
401414485,Massachusetts Minutewomen,A. Ngalakulondi,4594788,,True,21.0,2,2,2,2,0,0,0,1,0,1,1,2,1,0,0,2,4
401414485,Massachusetts Minutewomen,S. Breen,4281234,,True,40.0,12,19,9,15,3,4,4,4,1,3,4,1,2,0,0,3,31
401414485,Massachusetts Minutewomen,B. Mayo,4704146,,True,40.0,4,14,4,11,0,3,4,4,3,2,5,1,5,0,0,3,12
401414485,Massachusetts Minutewomen,S. Taylor,4594786,,True,40.0,7,15,3,7,4,8,3,3,0,2,2,5,1,0,2,2,21
401414485,Massachusetts Minutewomen,D. Philoxy,4399441,,True,34.0,1,7,1,6,0,1,2,2,1,3,4,6,1,0,7,3,4
401414485,Massachusetts Minutewomen,M. White,4704145,,False,19.0,3,7,3,7,0,0,0,0,2,1,3,0,0,0,0,3,6
401414485,Massachusetts Minutewomen,A. Brooks,4898542,,False,6.0,0,0,0,0,0,0,0,0,1,0,1,0,0,0,0,1,0
401414485,Massachusetts Minutewomen,TEAM,TOTAL,TOTAL,False,,29,64,22,48,7,16,13,14,10,12,22,15,10,0,9,17,78
401414484,Oklahoma Sooners,L. Scott,4594693,,True,10.0,2,7,2,4,0,3,2,2,3,2,5,1,0,1,0,5,6
401414484,Oklahoma Sooners,M. Williams,4398883,,True,28.0,9,14,9,14,0,0,3,5,0,6,6,2,0,0,2,2,21
401414484,Oklahoma Sooners,N. Tot,4594275,,True,30.0,4,7,2,4,2,3,0,0,0,8,8,1,1,0,0,2,10
401414484,Oklahoma Sooners,K. Tucker,4433150,,True,33.0,0,3,0,2,0,1,0,2,2,2,4,3,3,1,1,1,0
401414484,Oklahoma Sooners,T. Robertson,4398884,,True,33.0,5,11,1,1,4,10,8,9,0,4,4,4,0,2,0,1,22
401414484,Oklahoma Sooners,N. Lampkin,4398882,,False,23.0,2,7,1,5,1,2,0,0,1,2,3,2,0,0,2,1,5
401414484,Oklahoma Sooners,S. Vann,4703432,,False,20.0,5,11,4,7,1,4,2,4,2,3,5,1,2,0,0,2,13
401414484,Oklahoma Sooners,K. Perkins,4899000,,False,3.0,0,0,0,0,0,0,0,0,0,0,0,0,0,0,0,0,0
401414484,Oklahoma Sooners,K. Washington,4898998,,False,14.0,0,3,0,3,0,0,1,2,0,5,5,2,1,0,5,0,1
401414484,Oklahoma Sooners,G. Gregory,4594692,,False,6.0,0,0,0,0,0,0,0,0,0,0,0,0,0,0,0,1,0
401414484,Oklahoma Sooners,TEAM,TOTAL,TOTAL,False,,27,63,19,40,8,23,16,24,9,33,42,16,7,4,10,15,78
401414484,IU Indianapolis Jaguars,R. Kent,4433383,,True,38.0,3,12,1,1,2,11,0,0,0,3,3,1,2,1,1,5,8
401414484,IU Indianapolis Jaguars,R. McLimore,4281358,,True,31.0,4,13,2,7,2,6,8,8,2,3,5,1,0,1,4,3,18
401414484,IU Indianapolis Jaguars,M. Wise,4281261,,True,27.0,2,8,2,6,0,2,0,0,2,0,2,1,1,0,2,2,4
401414484,IU Indianapolis Jaguars,M. Williams,4281963,,True,31.0,6,15,6,15,0,0,5,8,8,5,13,6,2,1,1,2,17
401414484,IU Indianapolis Jaguars,D. Perkins,4281995,,True,34.0,1,6,0,1,1,5,0,0,0,5,5,3,0,0,1,1,3
401414484,IU Indianapolis Jaguars,M. Allen,4281962,,False,9.0,2,2,2,2,0,0,0,0,0,3,3,0,0,0,0,0,4
401414484,IU Indianapolis Jaguars,A. Mortag,4704178,,False,13.0,6,11,4,5,2,6,0,0,0,4,4,0,0,1,0,2,14
401414484,IU Indianapolis Jaguars,N. Andersen,4595440,,False,17.0,2,5,2,2,0,3,0,0,0,2,2,1,0,1,0,1,4
401414484,IU Indianapolis Jaguars,TEAM,TOTAL,TOTAL,False,,26,72,19,39,7,33,13,16,15,30,45,13,5,5,9,16,72
401414483,Washington State Cougars,U. Motuga,4398889,,True,35.0,1,3,1,2,0,1,3,4,3,11,14,2,0,1,2,2,5
401414483,Washington State Cougars,B. Murekatete,4433392,,True,13.0,0,4,0,4,0,0,0,0,0,3,3,0,0,0,2,4,0
401414483,Washington State Cougars,J. Teder,4703611,,True,32.0,0,10,0,3,0,7,0,0,0,4,4,1,1,0,3,4,0
401414483,Washington State Cougars,C. Leger-Walker,4703609,,True,40.0,7,18,6,11,1,7,5,6,1,3,4,1,1,1,3,2,20
401414483,Washington State Cougars,K. Leger-Walker,4068719,,True,33.0,4,11,3,7,1,4,0,2,0,5,5,0,0,0,4,4,9
401414483,Washington State Cougars,J. Clarke,4600595,,False,13.0,1,4,1,4,0,0,0,0,1,1,2,0,0,0,2,4,2
401414483,Washington State Cougars,T. Wallack,4899070,,False,22.0,1,5,0,2,1,3,0,0,0,1,1,0,0,0,1,2,3
401414483,Washington State Cougars,G. Sarver,4595924,,False,6.0,0,0,0,0,0,0,0,0,0,1,1,1,0,0,0,1,0
401414483,Washington State Cougars,M. Jones,4398887,,False,6.0,0,1,0,1,0,0,1,2,3,2,5,0,0,0,0,0,1
401414483,Washington State Cougars,TEAM,TOTAL,TOTAL,False,,14,56,11,34,3,22,9,14,12,32,44,5,2,2,18,23,40
401414483,Kansas State Wildcats,A. Lee,4398964,,True,39.0,5,11,5,11,0,0,10,12,2,13,15,1,1,1,1,4,20
401414483,Kansas State Wildcats,B. Glenn,4898995,,True,34.0,3,11,2,7,1,4,7,8,1,3,4,1,0,1,1,1,14
401414483,Kansas State Wildcats,S. Sundell,4898994,,True,39.0,2,7,1,4,1,3,0,0,1,3,4,2,1,0,2,1,5
401414483,Kansas State Wildcats,J. Glenn,4691694,,True,34.0,0,5,0,3,0,2,0,0,0,4,4,1,1,1,2,2,0
401414483,Kansas State Wildcats,E. Ebert,4594690,,True,14.0,2,7,1,5,1,2,0,0,0,2,2,0,1,0,2,0,5
401414483,Kansas State Wildcats,L. Macke,4398962,,False,5.0,0,3,0,3,0,0,0,0,0,1,1,0,1,0,2,1,0
401414483,Kansas State Wildcats,R. Dallinger,4898997,,False,30.0,1,7,1,4,0,3,2,2,1,3,4,1,1,0,1,1,4
401414483,Kansas State Wildcats,C. Goodrich,4281307,,False,5.0,1,2,1,2,0,0,0,0,1,1,2,1,0,0,0,1,2
401414483,Kansas State Wildcats,TEAM,TOTAL,TOTAL,False,,14,53,11,39,3,14,19,22,9,31,40,7,6,3,12,11,50
401414482,South Carolina Gamecocks,A. Boston,4432831,,True,18.0,4,7,4,6,0,1,2,2,4,8,12,1,3,3,1,0,10
401414482,South Carolina Gamecocks,V. Saxton,4398752,,True,21.0,2,4,2,4,0,0,4,5,7,6,13,1,1,0,1,0,8
401414482,South Carolina Gamecocks,B. Beal,4432835,,True,13.0,2,7,2,5,0,2,3,3,5,1,6,1,1,1,1,0,7
401414482,South Carolina Gamecocks,Z. Cooke,4432832,,True,19.0,2,15,1,5,1,10,0,0,0,1,1,1,0,0,0,1,5
401414482,South Carolina Gamecocks,D. Henderson,4398751,,True,19.0,2,9,0,2,2,7,0,0,0,1,1,2,0,0,1,0,6
401414482,South Carolina Gamecocks,S. Feagin,4433795,,False,14.0,3,3,3,3,0,0,4,6,1,6,7,1,1,0,2,0,10
401414482,South Carolina Gamecocks,L. Amihere,4432834,,False,12.0,1,3,1,2,0,1,2,4,2,2,4,2,1,0,1,1,4
401414482,South Carolina Gamecocks,E. Wesolek,4398753,,False,10.0,1,2,1,1,0,1,0,0,0,1,1,0,0,0,1,0,2
401414482,South Carolina Gamecocks,K. Cardoso,4433405,,False,8.0,0,1,0,1,0,0,0,0,2,2,4,0,0,1,2,0,0
401414482,South Carolina Gamecocks,B. Hall,4898383,,False,10.0,3,7,1,2,2,5,0,1,0,0,0,0,2,0,0,1,8
401414482,South Carolina Gamecocks,E. Russell,4433441,,False,12.0,1,4,1,3,0,1,0,0,2,0,2,4,0,0,1,1,2
401414482,South Carolina Gamecocks,O. Thompson,4433380,,False,10.0,2,5,0,0,2,5,0,0,0,0,0,0,0,0,0,0,6
401414482,South Carolina Gamecocks,D. Littleton,4281322,,False,18.0,1,5,0,0,1,5,0,0,1,4,5,3,2,0,2,0,3
401414482,South Carolina Gamecocks,L. Grissett,4280887,,False,16.0,4,7,4,7,0,0,0,0,2,1,3,4,1,0,1,2,8
401414482,South Carolina Gamecocks,TEAM,TOTAL,TOTAL,False,,28,79,20,41,8,38,15,21,30,39,69,20,12,5,14,6,79
401414482,Howard Bison,B. Fort-Davis,4705321,,True,31.0,2,10,2,9,0,1,0,0,0,4,4,0,1,0,4,2,4
401414482,Howard Bison,K. Marsh,4400350,,True,19.0,0,2,0,2,0,0,0,0,2,1,3,0,0,1,1,1,0
401414482,Howard Bison,K. Harris,4705322,,True,15.0,0,1,0,1,0,0,0,0,0,1,1,0,0,0,1,2,0
401414482,Howard Bison,D. Howell,4705316,,True,24.0,1,11,1,8,0,3,0,0,1,3,4,0,1,0,3,1,2
401414482,Howard Bison,I. Warren,4595524,,True,38.0,2,13,2,12,0,1,4,4,1,4,5,1,1,0,4,1,8
401414482,Howard Bison,M. Steel,4901382,,False,15.0,0,1,0,1,0,0,0,0,0,1,1,0,1,0,0,2,0
401414482,Howard Bison,N. Nelson,4899956,,False,6.0,0,1,0,1,0,0,0,0,0,0,0,1,0,0,2,0,0
401414482,Howard Bison,K. Creek,4705320,,False,10.0,1,3,0,2,1,1,0,0,0,1,1,0,1,1,1,2,3
401414482,Howard Bison,A. Hutton,4705315,,False,8.0,0,2,0,2,0,0,0,0,0,1,1,0,0,0,1,1,0
401414482,Howard Bison,V. Udoji,4070243,,False,12.0,0,2,0,1,0,1,0,0,0,1,1,0,2,0,1,2,0
401414482,Howard Bison,N. Cooper,4899955,,False,5.0,1,2,1,1,0,1,0,0,0,0,0,0,0,0,0,0,2
401414482,Howard Bison,A. Wilson,4705319,,False,8.0,1,2,1,1,0,1,0,0,0,1,1,0,0,0,2,0,2
401414482,Howard Bison,G. Thorpe,4400349,,False,9.0,0,4,0,4,0,0,0,0,0,2,2,0,0,1,0,1,0
401414482,Howard Bison,TEAM,TOTAL,TOTAL,False,,8,54,7,45,1,9,4,4,6,22,28,2,7,3,20,15,21
401414481,Stanford Cardinal,C. Brink,4433404,,True,16.0,4,7,4,7,0,0,3,7,7,4,11,3,1,4,1,1,11
401414481,Stanford Cardinal,H. Jones,4595910,,True,19.0,2,9,2,9,0,0,0,0,2,4,6,1,0,1,3,1,4
401414481,Stanford Cardinal,La. Hull,4398830,,True,17.0,0,0,0,0,0,0,0,0,0,4,4,3,4,0,1,1,0
401414481,Stanford Cardinal,Le. Hull,4398829,,True,21.0,6,12,5,9,1,3,0,0,0,3,3,5,3,0,1,1,13
401414481,Stanford Cardinal,A. Wilson,4066545,,True,20.0,1,2,0,0,1,2,0,0,0,5,5,4,0,0,1,0,3
401414481,Stanford Cardinal,K. Iriafen,4898384,,False,8.0,2,3,2,3,0,0,2,2,0,4,4,1,1,0,0,2,6
401414481,Stanford Cardinal,A. Prechtel,4433634,,False,8.0,0,0,0,0,0,0,2,2,0,0,0,0,0,1,0,0,2
401414481,Stanford Cardinal,F. Belibi,4432843,,False,15.0,4,6,4,6,0,0,4,6,6,7,13,2,1,2,4,2,12
401414481,Stanford Cardinal,A. Jerome,4282165,,False,7.0,0,1,0,0,0,1,0,0,0,1,1,0,0,0,1,1,0
401414481,Stanford Cardinal,B. Demetre,4433513,,False,7.0,1,4,1,3,0,1,0,0,0,0,0,0,0,0,1,1,2
401414481,Stanford Cardinal,E. Bosgana,4705410,,False,7.0,1,3,1,2,0,1,0,0,0,0,0,0,1,0,0,0,2
401414481,Stanford Cardinal,A. Emma-Nnopu,4703591,,False,11.0,0,2,0,2,0,0,0,0,0,0,0,0,0,0,1,0,0
401414481,Stanford Cardinal,J. Van Gytenbeek,4433434,,False,11.0,1,2,0,0,1,2,0,0,0,0,0,0,0,0,0,0,3
401414481,Stanford Cardinal,H. Jump,4432868,,False,19.0,5,11,0,0,5,11,0,0,0,0,0,0,0,0,1,0,15
401414481,Stanford Cardinal,J. Hamilton,4281239,,False,14.0,2,3,1,2,1,1,0,0,0,3,3,1,1,0,0,0,5
401414481,Stanford Cardinal,TEAM,TOTAL,TOTAL,False,,29,65,20,43,9,22,11,17,15,41,56,20,12,8,16,10,78
401414481,Montana State Bobcats,K. Bad Bear,4594836,,True,20.0,2,9,2,9,0,0,1,2,3,0,3,0,2,0,1,2,5
401414481,Montana State Bobcats,G. Mocchi,4399914,,True,20.0,1,10,0,4,1,6,0,0,1,2,3,0,0,0,0,2,3
401414481,Montana State Bobcats,K. Limardo,4705201,,True,28.0,1,4,0,0,1,4,0,0,0,1,1,1,1,1,2,1,3
401414481,Montana State Bobcats,L. Beattie,4705202,,True,24.0,1,6,1,5,0,1,0,0,1,4,5,2,3,0,1,2,2
401414481,Montana State Bobcats,D. White,4594835,,True,28.0,2,10,2,9,0,1,2,2,1,3,4,1,0,0,6,0,6
401414481,Montana State Bobcats,T. Janssen,4705204,,False,22.0,5,10,3,3,2,7,0,0,0,3,3,0,1,0,1,3,12
401414481,Montana State Bobcats,L. Deden,4705203,,False,18.0,2,9,2,8,0,1,0,0,2,5,7,0,1,0,1,2,4
401414481,Montana State Bobcats,A. Ranson,4705200,,False,12.0,0,3,0,0,0,3,0,0,0,1,1,1,0,0,1,1,0
401414481,Montana State Bobcats,M. Jackson,4594837,,False,16.0,0,1,0,1,0,0,0,0,0,0,0,1,1,0,0,1,0
401414481,Montana State Bobcats,A. Van Sickle,4281659,,False,12.0,1,3,1,2,0,1,0,0,0,2,2,3,1,0,2,0,2
401414481,Montana State Bobcats,TEAM,TOTAL,TOTAL,False,,15,65,11,41,4,24,3,4,9,24,33,9,10,1,17,14,37
401414480,UAlbany Great Danes,H. Haegerstrand,4594341,,True,27.0,2,5,2,3,0,2,1,1,0,2,2,2,0,0,1,1,5
401414480,UAlbany Great Danes,L. Phillips,4898946,,True,23.0,1,2,1,2,0,0,2,2,0,0,0,0,0,0,5,1,4
401414480,UAlbany Great Danes,K. Cooper,4704377,,True,31.0,5,10,5,10,0,0,4,4,3,3,6,4,2,0,2,2,14
401414480,UAlbany Great Danes,G. Heeps,4594787,,True,26.0,1,4,0,1,1,3,0,0,0,2,2,0,1,0,1,1,3
401414480,UAlbany Great Danes,E. Hahne,4398744,,True,29.0,5,12,4,8,1,4,0,0,0,6,6,2,2,0,5,1,11
401414480,UAlbany Great Danes,K. Sims,4898948,,False,14.0,3,5,3,5,0,0,0,0,0,2,2,1,0,0,0,1,6
401414480,UAlbany Great Danes,A. Robinson,4594344,,False,3.0,0,0,0,0,0,0,0,0,0,0,0,0,0,0,0,1,0
401414480,UAlbany Great Danes,T. Hanner,4594342,,False,5.0,0,0,0,0,0,0,0,0,0,1,1,0,0,0,0,2,0
401414480,UAlbany Great Danes,A. Ray,4898949,,False,3.0,0,0,0,0,0,0,0,0,0,1,1,0,0,0,1,0,0
401414480,UAlbany Great Danes,F. Werth,4898947,,False,17.0,0,1,0,0,0,1,0,0,1,0,1,0,2,1,1,0,0
401414480,UAlbany Great Danes,F. Lee,4595154,,False,8.0,0,4,0,1,0,3,0,0,0,1,1,0,0,1,1,0,0
401414480,UAlbany Great Danes,M. Haney,4594340,,False,14.0,3,6,1,3,2,3,0,0,0,3,3,0,0,0,5,4,8
401414480,UAlbany Great Danes,TEAM,TOTAL,TOTAL,False,,20,49,16,33,4,16,7,7,7,21,28,9,7,2,26,14,51
401414480,Louisville Cardinals,O. Cochran,4433426,,True,15.0,4,4,4,4,0,0,2,6,3,1,4,1,1,0,1,0,10
401414480,Louisville Cardinals,E. Engstler,4398729,,True,23.0,6,11,6,9,0,2,5,5,1,6,7,2,7,2,1,2,17
401414480,Louisville Cardinals,H. Van Lith,4433412,,True,24.0,8,15,7,13,1,2,3,3,3,1,4,0,3,0,1,1,20
401414480,Louisville Cardinals,K. Smith,4281919,,True,23.0,6,10,3,4,3,6,0,0,1,1,2,5,1,1,1,0,15
401414480,Louisville Cardinals,C. Hall,4280897,,True,25.0,3,5,3,4,0,1,0,0,0,3,3,0,0,0,1,1,6
401414480,Louisville Cardinals,S. Schetnan,4683008,,False,2.0,0,0,0,0,0,0,0,0,0,0,0,0,0,0,0,0,0
401414480,Louisville Cardinals,R. Parker,4433358,,False,2.0,1,1,0,0,1,1,0,0,0,0,0,0,0,0,0,0,3
401414480,Louisville Cardinals,L. Dixon,4398591,,False,17.0,2,3,2,3,0,0,1,2,2,2,4,1,1,0,1,2,5
401414480,Louisville Cardinals,M. Russell,4703213,,False,5.0,1,2,0,1,1,1,0,0,0,0,0,0,1,0,0,0,3
401414480,Louisville Cardinals,P. Verhulst,4433518,,False,18.0,1,6,1,4,0,2,0,0,1,2,3,1,3,1,1,1,2
401414480,Louisville Cardinals,N. Konno,4433094,,False,11.0,0,3,0,2,0,1,0,0,0,1,1,0,1,0,3,0,0
401414480,Louisville Cardinals,A. Smith,4398835,,False,14.0,1,2,1,2,0,0,0,0,0,0,0,1,0,0,0,1,2
401414480,Louisville Cardinals,M. Robinson,4398604,,False,21.0,0,1,0,1,0,0,0,0,0,4,4,2,0,0,0,1,0
401414480,Louisville Cardinals,TEAM,TOTAL,TOTAL,False,,33,63,27,47,6,16,11,16,11,22,33,13,18,4,10,9,83
401414479,Nebraska Cornhuskers,I. Bourne,4594941,,True,32.0,2,4,1,2,1,2,1,4,3,2,5,1,1,1,0,3,6
401414479,Nebraska Cornhuskers,A. Markowski,4899057,,True,27.0,3,10,2,8,1,2,3,6,5,4,9,0,0,2,0,4,10
401414479,Nebraska Cornhuskers,A. Weidner,4683053,,True,29.0,1,7,1,6,0,1,0,0,1,5,6,3,1,0,2,0,2
401414479,Nebraska Cornhuskers,J. Shelley,4433363,,True,31.0,4,11,1,3,3,8,0,0,0,1,1,4,0,0,2,4,11
401414479,Nebraska Cornhuskers,S. Haiby,4398929,,True,35.0,6,15,4,11,2,4,6,7,1,5,6,1,3,0,2,0,20
401414479,Nebraska Cornhuskers,A. Stewart,4601003,,False,2.0,0,1,0,0,0,1,0,0,0,0,0,0,0,0,0,0,0
401414479,Nebraska Cornhuskers,B. Cravens,4399897,,False,19.0,0,3,0,3,0,0,0,0,0,1,1,1,1,0,0,1,0
401414479,Nebraska Cornhuskers,K. Moriarty,4899055,,False,9.0,1,1,0,0,1,1,0,0,0,0,0,0,0,0,2,1,3
401414479,Nebraska Cornhuskers,M. Cayton,4066525,,False,16.0,1,4,0,1,1,3,0,0,1,1,2,0,0,0,2,1,3
401414479,Nebraska Cornhuskers,TEAM,TOTAL,TOTAL,False,,18,56,9,34,9,22,10,17,12,21,33,10,6,3,11,14,55
401414479,Gonzaga Bulldogs,M. Kempton,4400478,,True,32.0,7,12,7,12,0,0,0,0,4,4,8,0,3,1,1,2,14
401414479,Gonzaga Bulldogs,A. Virjoghe,4400477,,True,19.0,4,5,4,5,0,0,2,3,0,3,3,1,0,2,0,1,10
401414479,Gonzaga Bulldogs,Kayle. Truong,4433148,,True,28.0,8,15,6,10,2,5,2,2,0,5,5,4,1,0,4,2,20
401414479,Gonzaga Bulldogs,A. O'Connor,4282263,,True,29.0,1,3,0,2,1,1,0,0,2,4,6,1,1,1,1,3,3
401414479,Gonzaga Bulldogs,C. Walker,4065787,,True,31.0,1,7,0,1,1,6,1,2,0,3,3,1,0,0,1,2,4
401414479,Gonzaga Bulldogs,Y. Ejim,4703874,,False,24.0,4,5,4,5,0,0,6,7,1,5,6,1,0,0,3,2,14
401414479,Gonzaga Bulldogs,E. Hollingsworth,4595767,,False,4.0,1,2,0,0,1,2,0,0,0,1,1,0,0,0,0,1,3
401414479,Gonzaga Bulldogs,M. Williams,4433490,,False,7.0,0,2,0,2,0,0,0,0,0,0,0,0,0,0,0,0,0
401414479,Gonzaga Bulldogs,Kayly. Truong,4433365,,False,26.0,0,5,0,2,0,3,0,0,1,2,3,6,2,0,3,3,0
401414479,Gonzaga Bulldogs,TEAM,TOTAL,TOTAL,False,,26,56,21,39,5,17,11,14,11,29,40,14,7,4,14,16,68
401414478,Maryland Terrapins,A. Reese,4433402,,True,27.0,5,12,5,12,0,0,5,5,3,6,9,1,0,1,1,2,15
401414478,Maryland Terrapins,C. Bibby,4280877,,True,22.0,4,6,1,2,3,4,0,0,1,3,4,2,1,0,0,3,11
401414478,Maryland Terrapins,D. Miller,4433635,,True,29.0,8,12,6,7,2,5,5,5,1,4,5,3,3,1,3,2,23
401414478,Maryland Terrapins,A. Owusu,4433632,,True,32.0,10,14,10,13,0,1,4,5,1,2,3,6,0,0,1,0,24
401414478,Maryland Terrapins,K. Benzan,4068580,,True,24.0,5,8,0,1,5,7,2,2,0,2,2,2,1,0,1,1,17
401414478,Maryland Terrapins,E. Chardon,4705475,,False,3.0,1,1,1,1,0,0,0,0,0,0,0,0,0,0,0,0,2
401414478,Maryland Terrapins,M. Collins,4398763,,False,28.0,3,6,3,4,0,2,0,0,2,5,7,0,1,1,0,0,6
401414478,Maryland Terrapins,T. Kozlova,4703584,,False,9.0,0,0,0,0,0,0,0,0,0,1,1,1,0,0,1,1,0
401414478,Maryland Terrapins,S. Sellers,4433808,,False,26.0,2,5,2,4,0,1,0,0,2,4,6,4,1,0,3,1,4
401414478,Maryland Terrapins,TEAM,TOTAL,TOTAL,False,,38,64,28,44,10,20,16,17,10,30,40,19,7,3,11,10,102
401414478,Delaware Blue Hens,Ty Battle,4282255,,True,31.0,2,7,2,6,0,1,0,0,2,2,4,2,1,0,0,1,4
401414478,Delaware Blue Hens,L. Oleary,4281427,,True,24.0,1,1,1,1,0,0,0,0,2,0,2,0,1,1,0,2,2
401414478,Delaware Blue Hens,T. Skinner,4704510,,True,25.0,3,8,1,3,2,5,2,2,0,0,0,4,0,0,3,3,10
401414478,Delaware Blue Hens,J. Dickey,4399842,,True,38.0,12,32,11,28,1,4,6,7,5,5,10,0,1,0,1,0,31
401414478,Delaware Blue Hens,P. McBride,4399841,,True,26.0,2,11,2,6,0,5,0,0,1,2,3,5,3,0,2,4,4
401414478,Delaware Blue Hens,M. Sims,4068903,,False,3.0,0,0,0,0,0,0,0,0,0,0,0,0,0,0,0,0,0
401414478,Delaware Blue Hens,M. Pippin,4703429,,False,22.0,3,7,2,5,1,2,0,0,2,2,4,0,0,1,2,4,7
401414478,Delaware Blue Hens,M. Tejedor,4704513,,False,2.0,0,0,0,0,0,0,0,0,0,0,0,0,0,0,0,0,0
401414478,Delaware Blue Hens,T. Johnson,4704512,,False,8.0,3,5,2,3,1,2,0,0,1,2,3,0,0,0,2,1,7
401414478,Delaware Blue Hens,T. Cousins,4704511,,False,2.0,0,1,0,0,0,1,0,0,0,0,0,0,0,0,0,0,0
401414478,Delaware Blue Hens,J. Smalls,4400634,,False,19.0,2,6,0,1,2,5,0,0,0,2,2,0,0,0,0,0,6
401414478,Delaware Blue Hens,TEAM,TOTAL,TOTAL,False,,28,78,21,53,7,25,8,9,20,16,36,11,6,2,10,15,71
401414477,Hawai'i Rainbow Wahine,K. Spiller,4282329,,True,18.0,4,10,2,6,2,4,0,0,3,4,7,1,0,1,2,2,10
401414477,Hawai'i Rainbow Wahine,A. Atwell,4068885,,True,36.0,8,20,2,5,6,15,7,7,2,11,13,1,0,0,2,2,29
401414477,Hawai'i Rainbow Wahine,K. Imai,4704370,,True,15.0,1,4,1,3,0,1,0,0,1,1,2,2,1,0,3,2,2
401414477,Hawai'i Rainbow Wahine,D. Phillips,4704369,,True,30.0,1,8,1,6,0,2,0,0,2,2,4,3,1,0,1,3,2
401414477,Hawai'i Rainbow Wahine,O. Davies,4595197,,True,31.0,0,12,0,6,0,6,0,0,0,1,1,1,1,1,0,3,0
401414477,Hawai'i Rainbow Wahine,J. David,4899662,,False,13.0,0,5,0,3,0,2,0,0,0,1,1,0,0,0,0,0,0
401414477,Hawai'i Rainbow Wahine,N. Orji,4704372,,False,21.0,2,8,2,6,0,2,2,3,1,0,1,0,0,0,0,0,6
401414477,Hawai'i Rainbow Wahine,M. McBee,4704375,,False,9.0,0,1,0,0,0,1,0,0,2,0,2,1,1,0,1,0,0
401414477,Hawai'i Rainbow Wahine,N. Calhoun,4595198,,False,15.0,0,2,0,2,0,0,0,0,0,0,0,0,1,0,0,2,0
401414477,Hawai'i Rainbow Wahine,A. Thoms,4399949,,False,12.0,0,2,0,1,0,1,0,0,0,2,2,0,0,0,0,0,0
401414477,Hawai'i Rainbow Wahine,TEAM,TOTAL,TOTAL,False,,16,72,8,38,8,34,9,10,13,22,35,9,5,2,9,14,49
401414477,Baylor Bears,N. Smith,4398776,,True,23.0,9,13,8,12,1,1,2,2,3,11,14,2,0,0,2,2,21
401414477,Baylor Bears,Q. Egbo,4398779,,True,30.0,4,10,4,10,0,0,2,4,4,10,14,2,0,2,2,1,10
401414477,Baylor Bears,S. Andrews,4433407,,True,33.0,7,12,5,6,2,6,0,0,1,6,7,6,0,0,1,0,16
401414477,Baylor Bears,J. Asberry,4318562,,True,31.0,2,10,0,2,2,8,0,0,0,4,4,3,1,0,1,1,6
401414477,Baylor Bears,J. Lewis,4065687,,True,27.0,7,8,5,5,2,3,7,11,2,6,8,5,0,0,1,0,23
401414477,Baylor Bears,K. Gillispie,4434027,,False,10.0,1,3,1,3,0,0,0,0,1,2,3,1,0,0,0,2,2
401414477,Baylor Bears,C. Bickle,4398780,,False,17.0,3,6,3,5,0,1,1,2,1,2,3,0,1,1,1,4,7
401414477,Baylor Bears,A. Katramados,4900792,,False,2.0,0,0,0,0,0,0,0,0,0,0,0,1,0,0,1,0,0
401414477,Baylor Bears,J. Owens,4432839,,False,27.0,2,4,2,2,0,2,0,0,0,2,2,1,3,0,1,0,4
401414477,Baylor Bears,TEAM,TOTAL,TOTAL,False,,35,66,28,45,7,21,12,19,13,43,56,21,5,3,10,10,89
401414476,Texas Longhorns,L. Ebo,4398943,,True,17.0,4,6,4,6,0,0,2,2,2,5,7,0,0,0,1,3,10
401414476,Texas Longhorns,R. Harmon,4433523,,True,33.0,4,9,4,7,0,2,2,7,0,1,1,11,2,0,2,3,10
401414476,Texas Longhorns,S. Holle,4433449,,True,17.0,0,4,0,3,0,1,0,0,0,1,1,0,0,0,2,2,0
401414476,Texas Longhorns,A. Warren,4398987,,True,32.0,4,6,4,6,0,0,0,2,1,4,5,1,4,0,2,3,8
401414476,Texas Longhorns,J. Allen-Taylor,4398984,,True,28.0,3,6,2,5,1,1,0,0,0,1,1,1,1,0,0,3,7
401414476,Texas Longhorns,A. Moore,4433794,,False,20.0,4,7,4,7,0,0,10,10,6,4,10,1,1,0,0,2,18
401414476,Texas Longhorns,D. Gaston,4433739,,False,9.0,1,5,1,5,0,0,0,0,1,0,1,0,0,0,1,2,2
401414476,Texas Longhorns,L. Lattimore,4433517,,False,13.0,2,7,2,7,0,0,1,3,3,3,6,0,0,1,2,1,5
401414476,Texas Longhorns,F. Masudi,4898409,,False,0.0,0,0,0,0,0,0,0,0,0,0,0,0,0,0,0,0,0
401414476,Texas Longhorns,K. Hunter,4433806,,False,8.0,1,2,0,0,1,2,0,0,0,2,2,0,0,0,1,1,3
401414476,Texas Longhorns,A. Matharu,4433638,,False,23.0,2,6,0,2,2,4,1,2,1,1,2,2,3,1,2,1,7
401414476,Texas Longhorns,TEAM,TOTAL,TOTAL,False,,25,58,21,48,4,10,16,26,15,23,38,16,11,2,14,21,70
401414476,Fairfield Stags,A. Hernangomez,4399117,,True,33.0,2,9,2,7,0,2,1,2,1,3,4,1,5,0,2,3,5
401414476,Fairfield Stags,L. Lopez-Senechal,4399114,,True,30.0,5,10,3,8,2,2,5,6,0,5,5,0,2,0,2,4,17
401414476,Fairfield Stags,C. Cavanaugh,4281780,,True,40.0,3,8,3,7,0,1,4,4,1,3,4,0,0,0,2,3,10
401414476,Fairfield Stags,S. Lowery,4281189,,True,34.0,0,2,0,1,0,1,2,2,0,4,4,1,2,0,5,2,2
401414476,Fairfield Stags,R. Hakes,4399115,,True,34.0,2,4,2,4,0,0,6,7,1,3,4,5,1,0,9,5,10
401414476,Fairfield Stags,M. Daleba,4704430,,False,0.0,0,0,0,0,0,0,0,0,0,0,0,0,0,0,0,0,0
401414476,Fairfield Stags,J. Brown,4704429,,False,12.0,2,4,1,3,1,1,1,2,0,2,2,2,1,0,0,2,6
401414476,Fairfield Stags,M. Rubino,4704428,,False,0.0,0,0,0,0,0,0,0,0,0,0,0,0,0,0,0,0,0
401414476,Fairfield Stags,J. Polansky,4595673,,False,0.0,0,0,0,0,0,0,0,0,0,0,0,0,0,0,0,0,0
401414476,Fairfield Stags,M. Martin,4595363,,False,2.0,0,0,0,0,0,0,0,0,0,0,0,0,0,0,0,0,0
401414476,Fairfield Stags,S. Lewis,4282062,,False,15.0,1,5,1,3,0,2,0,0,0,1,1,0,0,0,0,0,2
401414476,Fairfield Stags,TEAM,TOTAL,TOTAL,False,,15,42,12,33,3,9,19,23,6,22,28,9,11,0,22,19,52
401414475,Iowa Hawkeyes,M. Czinano,4398909,,True,22.0,6,6,6,6,0,0,6,6,0,7,7,1,0,0,1,4,18
401414475,Iowa Hawkeyes,M. Warnock,4433652,,True,23.0,3,8,2,3,1,5,0,0,1,2,3,3,1,1,2,2,7
401414475,Iowa Hawkeyes,C. Clark,4433403,,True,33.0,9,15,7,9,2,6,7,7,0,6,6,10,3,0,4,3,27
401414475,Iowa Hawkeyes,G. Marshall,4433113,,True,30.0,4,7,1,1,3,6,2,2,0,1,1,5,3,0,0,1,13
401414475,Iowa Hawkeyes,K. Martin,4398907,,True,33.0,2,4,1,2,1,2,0,0,0,7,7,4,1,3,1,2,5
401414475,Iowa Hawkeyes,A. Ediger,4585713,,False,4.0,0,1,0,1,0,0,0,0,0,1,1,0,0,0,0,0,0
401414475,Iowa Hawkeyes,A. O'Grady,4433538,,False,14.0,3,5,3,5,0,0,1,2,0,2,2,0,1,0,0,2,7
401414475,Iowa Hawkeyes,L. Cook,4398908,,False,4.0,0,0,0,0,0,0,0,0,0,2,2,1,0,0,0,0,0
401414475,Iowa Hawkeyes,S. Affolter,4898389,,False,8.0,1,2,0,1,1,1,2,2,0,1,1,0,0,0,1,1,5
401414475,Iowa Hawkeyes,K. Feuerbach,4433985,,False,11.0,1,2,0,0,1,2,0,0,0,0,0,1,0,0,1,2,3
401414475,Iowa Hawkeyes,T. Taiwo,4398906,,False,18.0,4,5,1,1,3,4,2,2,0,2,2,0,1,0,1,1,13
401414475,Iowa Hawkeyes,TEAM,TOTAL,TOTAL,False,,33,55,21,29,12,26,20,21,3,35,38,25,10,4,11,18,98
401414475,Illinois State Redbirds,K. Bullman,4704825,,True,31.0,2,10,1,3,1,7,0,0,2,3,5,2,2,0,2,2,5
401414475,Illinois State Redbirds,D. Wilson,4704824,,True,22.0,3,7,3,7,0,0,0,2,5,3,8,0,0,1,2,4,6
401414475,Illinois State Redbirds,J. Redmond,4595585,,True,34.0,10,21,9,18,1,3,4,5,3,0,3,3,1,0,1,3,25
401414475,Illinois State Redbirds,M. Wong,4595584,,True,35.0,1,10,1,3,0,7,4,4,0,4,4,2,1,0,2,0,6
401414475,Illinois State Redbirds,M. Crompton,4399389,,True,33.0,4,12,1,1,3,11,0,0,2,4,6,2,0,0,0,0,11
401414475,Illinois State Redbirds,L. Boles,4900068,,False,3.0,0,0,0,0,0,0,0,0,1,0,1,0,0,0,0,0,0
401414475,Illinois State Redbirds,C. Van Zeeland,4900067,,False,5.0,0,0,0,0,0,0,0,0,2,1,3,0,0,0,0,2,0
401414475,Illinois State Redbirds,J. McGinnis-Taylor,4704823,,False,7.0,0,0,0,0,0,0,2,2,0,1,1,0,1,0,1,3,2
401414475,Illinois State Redbirds,H. Kelle,4595586,,False,2.0,0,1,0,1,0,0,0,0,0,0,0,0,0,0,0,1,0
401414475,Illinois State Redbirds,L. Koudelka,4399391,,False,3.0,0,0,0,0,0,0,0,0,0,1,1,0,0,0,1,1,0
401414475,Illinois State Redbirds,K. Bowers,4900066,,False,7.0,0,2,0,0,0,2,0,0,0,0,0,0,0,0,2,0,0
401414475,Illinois State Redbirds,L. Cohen,4900065,,False,1.0,0,2,0,0,0,2,0,0,0,0,0,0,0,0,0,0,0
401414475,Illinois State Redbirds,K. Newland,4399394,,False,17.0,1,6,0,2,1,4,0,0,0,2,2,1,0,0,1,2,3
401414475,Illinois State Redbirds,TEAM,TOTAL,TOTAL,False,,21,71,15,35,6,36,10,13,17,20,37,10,5,1,13,18,58
401414474,South Dakota Coyotes,H. Sjerven,4068349,,True,27.0,7,7,6,6,1,1,5,8,1,6,7,1,3,1,3,3,20
401414474,South Dakota Coyotes,K. Watson,4704325,,True,38.0,4,10,4,6,0,4,0,0,0,4,4,3,1,1,2,2,8
401414474,South Dakota Coyotes,M. Krull,4433474,,True,40.0,5,12,4,9,1,3,2,3,0,3,3,4,1,0,0,1,13
401414474,South Dakota Coyotes,C. Lamb,4282528,,True,39.0,7,14,5,10,2,4,4,4,0,6,6,4,2,0,2,2,20
401414474,South Dakota Coyotes,L. Korngable,4282526,,True,38.0,4,7,2,5,2,2,0,0,0,2,2,7,2,0,2,3,10
401414474,South Dakota Coyotes,J. Ugofsky,4595855,,False,2.0,0,0,0,0,0,0,0,0,0,1,1,0,0,0,0,0,0
401414474,South Dakota Coyotes,A. Peplowski,4399655,,False,13.0,2,2,2,2,0,0,0,0,1,3,4,0,0,0,1,1,4
401414474,South Dakota Coyotes,G. Larkins,4899816,,False,2.0,0,0,0,0,0,0,0,0,0,0,0,0,0,0,0,2,0
401414474,South Dakota Coyotes,M. Guebert,4595854,,False,1.0,0,0,0,0,0,0,0,0,0,0,0,0,0,0,0,0,0
401414474,South Dakota Coyotes,TEAM,TOTAL,TOTAL,False,,29,52,23,38,6,14,11,15,3,28,31,19,9,2,10,14,75
401414474,Ole Miss Rebels,S. Collins,4704453,,True,24.0,2,3,0,1,2,2,0,0,0,2,2,0,1,0,1,2,6
401414474,Ole Miss Rebels,S. Austin,4398911,,True,35.0,3,16,3,16,0,0,3,4,5,6,11,4,0,3,1,3,9
401414474,Ole Miss Rebels,M. Scott,4433416,,True,29.0,1,3,1,3,0,0,1,2,2,4,6,1,0,0,3,4,3
401414474,Ole Miss Rebels,M. Reid,4398709,,True,27.0,2,4,1,3,1,1,0,1,1,0,1,6,0,0,1,1,5
401414474,Ole Miss Rebels,L. Monk,4281079,,True,22.0,3,8,3,8,0,0,0,0,0,2,2,1,1,0,2,4,6
401414474,Ole Miss Rebels,C. McGee,4433465,,False,14.0,2,2,2,2,0,0,0,0,0,2,2,2,0,1,0,2,4
401414474,Ole Miss Rebels,T. Douglas,4704455,,False,11.0,2,4,1,1,1,3,0,0,0,1,1,0,0,1,0,0,5
401414474,Ole Miss Rebels,D. Salary,4433770,,False,2.0,0,0,0,0,0,0,0,0,0,0,0,0,0,0,1,0,0
401414474,Ole Miss Rebels,A. Baker,4399736,,False,36.0,8,19,6,15,2,4,5,6,0,2,2,2,2,0,2,3,23
401414474,Ole Miss Rebels,TEAM,TOTAL,TOTAL,False,,23,59,17,49,6,10,9,13,10,22,32,16,4,5,11,19,61
401414473,Utah Utes,J. Johnson,4898900,,True,24.0,4,10,4,8,0,2,4,6,1,1,2,0,0,0,3,3,12
401414473,Utah Utes,K. Rees,4703603,,True,28.0,4,6,4,6,0,0,3,4,3,7,10,0,0,0,0,0,11
401414473,Utah Utes,K. McQueen,4898901,,True,21.0,6,9,0,0,6,9,2,2,2,4,6,4,1,0,1,1,20
401414473,Utah Utes,G. Kneepkens,4898898,,True,21.0,6,9,3,6,3,3,1,2,2,5,7,0,0,0,1,1,16
401414473,Utah Utes,D. Gylten,4282178,,True,27.0,2,2,2,2,0,0,2,2,0,5,5,11,0,0,6,4,6
401414473,Utah Utes,D. Young,4595931,,False,26.0,2,6,0,1,2,5,1,4,2,5,7,4,0,0,1,1,7
401414473,Utah Utes,I. Vieira,4898897,,False,13.0,1,2,0,1,1,1,0,0,0,2,2,0,0,0,1,3,3
401414473,Utah Utes,M. Jackson,4594756,,False,2.0,0,0,0,0,0,0,0,0,0,0,0,0,0,0,1,0,0
401414473,Utah Utes,I. Palmer,4594751,,False,19.0,4,8,3,6,1,2,0,0,0,3,3,1,1,0,1,2,9
401414473,Utah Utes,B. Maxwell,4433675,,False,19.0,3,10,1,1,2,9,0,0,1,6,7,0,0,1,2,1,8
401414473,Utah Utes,TEAM,TOTAL,TOTAL,False,,32,62,17,31,15,31,13,20,13,39,52,20,2,1,19,16,92
401414473,Arkansas Razorbacks,J. Wolfenbarger,4433799,,True,12.0,0,1,0,1,0,0,0,0,1,3,4,0,0,1,0,1,0
401414473,Arkansas Razorbacks,S. Spencer,4705414,,True,36.0,7,15,6,12,1,3,3,4,0,5,5,3,2,1,2,2,18
401414473,Arkansas Razorbacks,S. Goforth,4433736,,True,32.0,2,8,1,5,1,3,0,0,1,1,2,1,1,2,0,2,5
401414473,Arkansas Razorbacks,M. Daniels,4433047,,True,30.0,7,15,7,11,0,4,4,7,2,1,3,0,1,0,2,4,18
401414473,Arkansas Razorbacks,A. Ramirez,4068136,,True,40.0,10,28,8,16,2,12,2,4,0,1,1,0,2,0,1,1,24
401414473,Arkansas Razorbacks,E. Ellis,4705411,,False,7.0,0,1,0,1,0,0,0,0,1,0,1,1,0,0,0,0,0
401414473,Arkansas Razorbacks,E. Barnum,4595144,,False,21.0,1,9,1,9,0,0,0,0,6,6,12,0,1,1,0,1,2
401414473,Arkansas Razorbacks,R. Langerman,4703778,,False,22.0,1,2,1,1,0,1,0,0,2,1,3,0,2,1,1,4,2
401414473,Arkansas Razorbacks,TEAM,TOTAL,TOTAL,False,,28,79,24,56,4,23,9,15,15,20,35,5,9,6,6,15,69
401414472,Virginia Tech Hokies,A. Baines,4432945,,True,13.0,2,3,2,3,0,0,2,2,0,3,3,0,0,0,1,1,6
401414472,Virginia Tech Hokies,E. Kitley,4433309,,True,33.0,16,27,16,27,0,0,10,14,5,3,8,1,0,1,1,2,42
401414472,Virginia Tech Hokies,G. Amoore,4704180,,True,38.0,4,8,2,4,2,4,2,2,0,3,3,5,1,0,3,4,12
401414472,Virginia Tech Hokies,K. Traylor,4398947,,True,32.0,2,5,2,4,0,1,1,2,0,3,3,2,0,0,1,2,5
401414472,Virginia Tech Hokies,A. Sheppard,4281223,,True,34.0,3,9,0,1,3,8,0,0,2,3,5,3,0,0,2,3,9
401414472,Virginia Tech Hokies,D. Gregg,4398592,,False,24.0,3,4,2,3,1,1,0,0,0,11,11,1,0,0,0,1,7
401414472,Virginia Tech Hokies,C. King,4433089,,False,14.0,0,2,0,0,0,2,0,0,0,1,1,1,0,0,1,0,0
401414472,Virginia Tech Hokies,E. Lytle,4069122,,False,12.0,0,2,0,1,0,1,0,0,0,1,1,0,0,0,1,0,0
401414472,Virginia Tech Hokies,TEAM,TOTAL,TOTAL,False,,30,60,24,43,6,17,15,20,7,33,40,13,1,1,10,13,81
401414472,Florida Gulf Coast Eagles,T. Morehouse,4704575,,True,37.0,6,10,6,9,0,1,1,1,0,2,2,9,3,0,1,1,13
401414472,Florida Gulf Coast Eagles,K. Bell,4433633,,True,33.0,8,18,6,10,2,8,4,6,1,7,8,2,3,1,0,4,22
401414472,Florida Gulf Coast Eagles,E. List,4281132,,True,21.0,3,9,0,0,3,9,0,0,0,2,2,2,0,0,0,3,9
401414472,Florida Gulf Coast Eagles,K. Phills,4069354,,True,26.0,4,6,1,1,3,5,0,0,0,5,5,0,0,0,0,5,11
401414472,Florida Gulf Coast Eagles,K. Spray,4069207,,True,35.0,2,4,1,1,1,3,4,4,0,3,3,2,0,0,0,3,9
401414472,Florida Gulf Coast Eagles,K. Adams,4594400,,False,0.0,0,0,0,0,0,0,0,0,0,0,0,0,0,0,0,0,0
401414472,Florida Gulf Coast Eagles,S. Hackley,4704577,,False,4.0,0,1,0,1,0,0,0,0,0,0,0,0,0,0,0,0,0
401414472,Florida Gulf Coast Eagles,K. Webb,4399370,,False,4.0,0,0,0,0,0,0,0,0,0,0,0,2,0,0,0,0,0
401414472,Florida Gulf Coast Eagles,K. Seay,4398689,,False,17.0,4,9,0,2,4,7,0,0,1,1,2,0,1,0,1,1,12
401414472,Florida Gulf Coast Eagles,T. Cox,4281494,,False,4.0,0,3,0,0,0,3,0,0,0,0,0,1,0,0,1,0,0
401414472,Florida Gulf Coast Eagles,A. Cecil,4068826,,False,21.0,3,4,1,2,2,2,0,0,0,5,5,1,0,0,0,1,8
401414472,Florida Gulf Coast Eagles,TEAM,TOTAL,TOTAL,False,,30,64,15,26,15,38,9,11,2,27,29,19,7,1,3,18,84
401414471,Kansas Jayhawks,I. Chatzileonti,4600665,,True,37.0,6,11,5,10,1,1,2,4,4,6,10,1,1,1,0,1,15
401414471,Kansas Jayhawks,T. Jackson,4898989,,True,24.0,7,10,7,10,0,0,0,0,3,4,7,1,0,2,3,3,14
401414471,Kansas Jayhawks,H. Kersgieter,4433703,,True,32.0,6,13,3,9,3,4,4,5,1,4,5,2,2,1,2,2,19
401414471,Kansas Jayhawks,Z. Franklin,4432983,,True,32.0,3,9,2,7,1,2,1,2,1,3,4,3,0,0,1,2,8
401414471,Kansas Jayhawks,J. Brosseau,4066590,,True,14.0,1,5,1,3,0,2,0,0,0,1,1,1,0,0,0,0,2
401414471,Kansas Jayhawks,K. Jessen,4600607,,False,3.0,0,0,0,0,0,0,0,0,0,0,0,0,0,0,0,1,0
401414471,Kansas Jayhawks,N. Eltayeb,4898993,,False,3.0,0,0,0,0,0,0,0,0,0,1,1,0,0,0,0,0,0
401414471,Kansas Jayhawks,D. Papadopoulou,4898992,,False,14.0,1,1,1,1,0,0,0,0,0,2,2,0,1,1,0,3,2
401414471,Kansas Jayhawks,C. Prater,4433140,,False,19.0,5,6,5,6,0,0,2,2,0,5,5,4,1,1,3,2,12
401414471,Kansas Jayhawks,A. Thomas,4398826,,False,22.0,1,7,1,2,0,5,3,4,0,2,2,1,0,0,0,1,5
401414471,Kansas Jayhawks,TEAM,TOTAL,TOTAL,False,,30,62,25,48,5,14,12,17,9,31,40,13,5,6,10,15,77
401414471,Georgia Tech Yellow Jackets,D. Strautmane,4281221,,True,39.0,8,11,6,7,2,4,0,0,3,3,6,1,4,2,3,2,18
401414471,Georgia Tech Yellow Jackets,L. Cubaj,4281183,,True,36.0,4,9,4,8,0,1,0,0,1,10,11,3,0,1,2,2,8
401414471,Georgia Tech Yellow Jackets,N. Hermosa,4433347,,True,39.0,3,12,3,12,0,0,1,2,0,3,3,0,0,3,1,1,7
401414471,Georgia Tech Yellow Jackets,E. Love,4433461,,True,20.0,2,9,1,6,1,3,2,4,0,3,3,1,0,0,4,4,7
401414471,Georgia Tech Yellow Jackets,L. Lahtinen,4398593,,True,31.0,3,12,2,6,1,6,0,0,0,2,2,4,1,0,2,3,7
401414471,Georgia Tech Yellow Jackets,A. Wone Aranaz,4433369,,False,3.0,0,0,0,0,0,0,0,0,0,0,0,0,0,0,0,0,0
401414471,Georgia Tech Yellow Jackets,E. Bulane,4898402,,False,2.0,0,0,0,0,0,0,0,0,0,0,0,0,0,0,0,0,0
401414471,Georgia Tech Yellow Jackets,A. Carter,4433754,,False,14.0,2,4,1,2,1,2,0,0,2,0,2,1,0,0,1,1,5
401414471,Georgia Tech Yellow Jackets,S. Bates,4281728,,False,16.0,2,5,0,0,2,5,0,0,0,0,0,1,0,0,0,1,6
401414471,Georgia Tech Yellow Jackets,TEAM,TOTAL,TOTAL,False,,24,62,17,41,7,21,3,6,9,25,34,11,5,6,13,14,58
401414470,Creighton Bluejays,E. Ronsiek,4598617,,True,36.0,4,10,3,6,1,4,1,1,0,2,2,3,2,1,3,4,10
401414470,Creighton Bluejays,C. Bachelor,4594814,,True,15.0,1,1,1,1,0,0,0,0,2,1,3,0,0,0,1,0,2
401414470,Creighton Bluejays,L. Jensen,4597505,,True,33.0,5,11,5,8,0,3,6,6,0,3,3,3,0,0,2,0,16
401414470,Creighton Bluejays,P. Brotzki,4399333,,True,16.0,3,4,1,2,2,2,0,0,0,3,3,3,0,0,2,0,8
401414470,Creighton Bluejays,T. Rembao,4281361,,True,33.0,2,3,1,1,1,2,2,2,0,5,5,2,0,0,5,3,7
401414470,Creighton Bluejays,M. Brake,4703757,,False,4.0,0,1,0,1,0,0,0,0,0,0,0,0,0,0,0,0,0
401414470,Creighton Bluejays,M. Mogensen,4703758,,False,25.0,6,11,4,8,2,3,2,2,0,1,1,2,0,0,0,1,16
401414470,Creighton Bluejays,M. Maly,4599199,,False,25.0,7,15,5,10,2,5,4,4,5,3,8,2,0,0,1,2,20
401414470,Creighton Bluejays,J. Horan,4598615,,False,0.0,0,0,0,0,0,0,0,0,0,0,0,0,0,0,0,0,0
401414470,Creighton Bluejays,C. Dworak,4399332,,False,0.0,0,0,0,0,0,0,0,0,0,0,0,0,0,0,0,0,0
401414470,Creighton Bluejays,R. Saunders,4399331,,False,13.0,1,1,1,1,0,0,3,5,0,5,5,0,1,1,1,1,5
401414470,Creighton Bluejays,TEAM,TOTAL,TOTAL,False,,29,57,21,38,8,19,18,20,8,27,35,15,3,2,15,11,84
401414470,Colorado Buffaloes,P. Tuitele,4595865,,True,26.0,3,6,3,5,0,1,2,2,4,5,9,3,1,0,1,2,8
401414470,Colorado Buffaloes,M. Hollingshed,4281923,,True,31.0,6,17,4,11,2,6,1,2,2,3,5,1,0,2,1,3,15
401414470,Colorado Buffaloes,F. Formann,4703586,,True,32.0,1,6,1,4,0,2,0,0,0,2,2,4,1,0,0,4,2
401414470,Colorado Buffaloes,J. Sherrod,4433386,,True,34.0,11,15,9,11,2,4,3,5,0,5,5,5,2,0,2,4,27
401414470,Colorado Buffaloes,L. Finau,4398760,,True,26.0,1,3,1,3,0,0,0,0,1,2,3,0,0,1,1,0,2
401414470,Colorado Buffaloes,Q. Miller,4433122,,False,22.0,4,7,4,6,0,1,4,4,3,2,5,1,1,1,2,3,12
401414470,Colorado Buffaloes,K. Blacksten,4703587,,False,1.0,0,0,0,0,0,0,0,0,0,0,0,0,0,0,0,1,0
401414470,Colorado Buffaloes,K. Wetta,4691704,,False,26.0,4,14,4,9,0,5,0,0,1,1,2,2,3,0,1,3,8
401414470,Colorado Buffaloes,T. Jones,4399353,,False,2.0,0,0,0,0,0,0,0,0,0,0,0,0,0,0,0,0,0
401414470,Colorado Buffaloes,TEAM,TOTAL,TOTAL,False,,30,68,26,49,4,19,10,13,11,21,32,16,8,4,8,20,74
401414469,Georgia Lady Bulldogs,J. Nicholson,4432863,,True,14.0,0,3,0,3,0,0,2,2,2,3,5,1,0,0,0,0,2
401414469,Georgia Lady Bulldogs,J. Staiti,4065782,,True,25.0,8,14,8,14,0,0,3,4,2,6,8,1,0,3,2,2,19
401414469,Georgia Lady Bulldogs,S. Barker,4703794,,True,28.0,1,5,1,2,0,3,2,2,1,5,6,6,2,0,3,1,4
401414469,Georgia Lady Bulldogs,M. Coombs,4281074,,True,31.0,0,3,0,3,0,0,0,0,1,1,2,1,2,1,1,1,0
401414469,Georgia Lady Bulldogs,Q. Morrison,4280851,,True,35.0,6,11,5,9,1,2,3,4,0,8,8,7,2,1,3,1,16
401414469,Georgia Lady Bulldogs,J. Hollingshead,4433535,,False,15.0,7,13,7,13,0,0,1,2,2,0,2,0,0,0,0,0,15
401414469,Georgia Lady Bulldogs,J. Isaacs,4433351,,False,15.0,0,3,0,3,0,0,4,8,4,2,6,0,0,0,2,1,4
401414469,Georgia Lady Bulldogs,M. Bates,4280852,,False,11.0,1,4,1,4,0,0,3,4,3,1,4,0,0,0,1,1,5
401414469,Georgia Lady Bulldogs,R. Richardson,4433543,,False,12.0,0,3,0,2,0,1,2,2,0,0,0,0,1,1,2,0,2
401414469,Georgia Lady Bulldogs,C. Chapman,4433306,,False,14.0,1,1,1,1,0,0,1,2,0,3,3,1,0,0,1,0,3
401414469,Georgia Lady Bulldogs,TEAM,TOTAL,TOTAL,False,,24,60,23,54,1,6,21,30,18,30,48,17,7,6,15,7,70
401414469,Dayton Flyers,M. Perez,4594754,,True,20.0,1,3,1,3,0,0,0,0,2,3,5,0,1,2,0,3,2
401414469,Dayton Flyers,K. Whitehead,4399307,,True,27.0,4,8,3,7,1,1,0,0,0,3,3,2,1,0,1,2,9
401414469,Dayton Flyers,M. Cook,4682764,,True,40.0,9,20,7,18,2,2,1,2,2,2,4,4,0,0,4,1,21
401414469,Dayton Flyers,E. Whalen,4065788,,True,33.0,1,8,0,3,1,5,0,0,1,3,4,2,0,0,5,4,3
401414469,Dayton Flyers,A. Bradshaw,4065758,,True,20.0,1,3,1,3,0,0,0,0,0,5,5,3,0,0,0,2,2
401414469,Dayton Flyers,B. Shoup-Hill,4898494,,False,19.0,0,7,0,4,0,3,1,2,2,2,4,2,0,1,1,4,1
401414469,Dayton Flyers,D. Bohanon,4594755,,False,1.0,0,0,0,0,0,0,0,0,0,1,1,0,0,0,0,0,0
401414469,Dayton Flyers,M. Perry,4433361,,False,8.0,0,2,0,1,0,1,0,0,0,0,0,0,1,1,0,2,0
401414469,Dayton Flyers,J. Giacone,4068133,,False,32.0,7,13,5,7,2,6,0,0,0,1,1,1,3,0,3,1,16
401414469,Dayton Flyers,TEAM,TOTAL,TOTAL,False,,23,64,17,46,6,18,2,4,11,20,31,14,6,4,14,19,54
401414456,South Florida Bulls,B. Mununga,4594533,,True,36.0,3,11,3,10,0,1,0,0,3,5,8,1,2,0,4,4,6
401414456,South Florida Bulls,S. Leverett,4068149,,True,18.0,0,1,0,1,0,0,0,0,0,1,1,1,2,0,0,2,0
401414456,South Florida Bulls,E. Tsineke,4594531,,True,38.0,7,16,5,11,2,5,5,6,2,0,2,3,0,0,3,2,21
401414456,South Florida Bulls,E. Pinzan,4399238,,True,38.0,7,16,4,7,3,9,2,2,0,7,7,3,2,0,2,3,19
401414456,South Florida Bulls,S. Harvey,4399237,,True,36.0,3,7,0,1,3,6,2,2,0,0,0,1,1,0,3,2,11
401414456,South Florida Bulls,P. Williams,4898406,,False,4.0,0,1,0,1,0,0,0,0,0,0,0,0,2,0,0,0,0
401414456,South Florida Bulls,D. Fankam Mendjiadeu,4594527,,False,22.0,3,4,3,4,0,0,0,1,3,5,8,1,1,0,1,1,6
401414456,South Florida Bulls,A. Wilson,4433388,,False,2.0,1,2,0,1,1,1,0,0,0,0,0,0,0,0,0,0,3
401414456,South Florida Bulls,C. Bermejo,4594532,,False,2.0,0,1,0,1,0,0,0,0,1,0,1,1,0,0,0,0,0
401414456,South Florida Bulls,S. Guerreiro,4703675,,False,4.0,0,0,0,0,0,0,0,0,0,0,0,0,0,0,0,0,0
401414456,South Florida Bulls,TEAM,TOTAL,TOTAL,False,,24,59,15,37,9,22,9,11,10,20,30,11,10,0,13,14,66
401414456,Miami Hurricanes,L. Pendande,4398863,,True,24.0,4,8,4,8,0,0,3,3,0,5,5,0,0,0,3,1,11
401414456,Miami Hurricanes,D. Harden,4281329,,True,13.0,1,4,1,2,0,2,0,0,1,2,3,1,2,0,1,2,2
401414456,Miami Hurricanes,J. Williams,4898556,,True,30.0,4,7,4,6,0,1,2,3,0,1,1,3,2,0,1,1,10
401414456,Miami Hurricanes,K. Erjavec,4400202,,True,33.0,5,10,3,6,2,4,2,2,0,5,5,3,0,0,1,1,14
401414456,Miami Hurricanes,K. Marshall,4281196,,True,31.0,4,10,1,2,3,8,1,1,0,2,2,1,0,0,2,2,12
401414456,Miami Hurricanes,N. Mbandu,4703227,,False,20.0,1,2,1,1,0,1,2,2,0,4,4,2,1,0,1,0,4
401414456,Miami Hurricanes,P. Fraile Ruiz,4703226,,False,1.0,0,0,0,0,0,0,0,0,0,1,1,0,0,0,0,0,0
401414456,Miami Hurricanes,M. Djaldi-Tabdi,4281214,,False,16.0,4,6,2,2,2,4,0,0,1,1,2,0,0,2,0,0,10
401414456,Miami Hurricanes,J. Roberts,4898555,,False,1.0,0,0,0,0,0,0,0,0,0,0,0,0,0,0,1,0,0
401414456,Miami Hurricanes,L. Dwyer,4683033,,False,14.0,4,5,4,4,0,1,0,0,1,1,2,0,2,1,1,3,8
401414456,Miami Hurricanes,M. Johnson Sidi Baba,4594386,,False,9.0,1,2,1,2,0,0,0,0,1,0,1,0,0,0,0,1,2
401414456,Miami Hurricanes,M. Gray,4281194,,False,8.0,2,2,1,1,1,1,0,0,0,0,0,1,0,0,1,0,5
401414456,Miami Hurricanes,TEAM,TOTAL,TOTAL,False,,30,56,22,34,8,22,10,11,5,25,30,11,7,3,12,11,78
401414363,Missouri State Lady Bears,J. Ezeh,4433647,,True,23.0,2,4,2,4,0,0,0,2,4,3,7,0,0,0,0,4,4
401414363,Missouri State Lady Bears,A. Jackson,4280839,,True,24.0,3,7,3,7,0,0,0,0,2,2,4,0,1,3,1,5,6
401414363,Missouri State Lady Bears,M. Bhinhar,4399417,,True,30.0,5,11,3,8,2,3,0,0,2,4,6,0,0,1,2,3,12
401414363,Missouri State Lady Bears,S. Wilson,4399416,,True,28.0,3,7,3,5,0,2,5,6,0,6,6,1,1,1,2,2,11
401414363,Missouri State Lady Bears,B. Calip,4068634,,True,36.0,3,14,3,11,0,3,1,4,2,5,7,3,2,0,2,1,7
401414363,Missouri State Lady Bears,I. Nwachukwu,4900080,,False,28.0,3,4,3,4,0,0,4,4,5,2,7,0,1,2,2,4,10
401414363,Missouri State Lady Bears,I. Delarue,4900081,,False,0.0,0,0,0,0,0,0,0,0,0,0,0,0,0,0,1,0,0
401414363,Missouri State Lady Bears,P. Rocca,4704874,,False,6.0,0,1,0,0,0,1,0,0,0,0,0,1,1,0,0,1,0
401414363,Missouri State Lady Bears,M. White,4281945,,False,25.0,4,15,4,15,0,0,3,4,1,2,3,1,5,1,2,3,11
401414363,Missouri State Lady Bears,TEAM,TOTAL,TOTAL,False,,23,63,21,54,2,9,13,20,19,26,45,6,11,8,13,23,61
401414363,Florida State Seminoles,E. Howard,4398609,,True,20.0,0,5,0,3,0,2,0,0,1,1,2,0,0,0,0,1,0
401414363,Florida State Seminoles,R. Baldwin,4433304,,True,21.0,2,8,2,8,0,0,2,4,5,3,8,1,0,1,2,1,6
401414363,Florida State Seminoles,O. Gordon,4433520,,True,23.0,3,8,3,8,0,0,6,6,2,0,2,5,0,0,3,2,12
401414363,Florida State Seminoles,S. Puisis,4432862,,True,17.0,1,3,0,1,1,2,0,0,0,5,5,0,0,0,0,0,3
401414363,Florida State Seminoles,M. Jones,2984250,,True,25.0,1,8,1,7,0,1,2,2,0,4,4,0,1,0,0,3,4
401414363,Florida State Seminoles,M. Timpson,4433546,,False,20.0,3,4,3,4,0,0,2,4,3,3,6,0,0,0,2,3,8
401414363,Florida State Seminoles,V. Myers,4398583,,False,19.0,2,7,2,7,0,0,0,0,1,4,5,1,1,1,3,4,4
401414363,Florida State Seminoles,S. Bejedi,4595844,,False,17.0,2,5,1,3,1,2,2,4,1,0,1,0,0,1,5,0,7
401414363,Florida State Seminoles,K. Weber,4398582,,False,18.0,1,2,1,2,0,0,2,2,0,1,1,0,1,2,1,1,4
401414363,Florida State Seminoles,B. Jackson,4280885,,False,20.0,0,5,0,2,0,3,2,2,0,2,2,2,1,1,1,3,2
401414363,Florida State Seminoles,TEAM,TOTAL,TOTAL,False,,15,55,13,45,2,10,18,24,16,25,41,9,4,6,17,18,50
401414342,Mount St. Mary's Mountaineers,I. Hunt,4704996,,True,18.0,0,2,0,2,0,0,2,2,1,3,4,0,0,0,1,4,2
401414342,Mount St. Mary's Mountaineers,J. Tomasetti,4704999,,True,33.0,4,6,3,5,1,1,4,4,3,4,7,2,0,0,2,2,13
401414342,Mount St. Mary's Mountaineers,M. Harrison,4399572,,True,34.0,4,11,2,4,2,7,3,3,0,1,1,0,3,0,0,2,13
401414342,Mount St. Mary's Mountaineers,K. Agentowicz,4069294,,True,35.0,5,12,4,6,1,6,0,0,1,1,2,0,0,0,2,3,11
401414342,Mount St. Mary's Mountaineers,K. Bresee,4068556,,True,38.0,6,13,3,7,3,6,5,6,1,2,3,4,1,0,3,5,20
401414342,Mount St. Mary's Mountaineers,T. Borgosz,4281491,,False,23.0,2,6,1,1,1,5,0,0,0,1,1,0,0,0,3,3,5
401414342,Mount St. Mary's Mountaineers,J. Lee,4704997,,False,19.0,2,3,2,2,0,1,2,3,4,1,5,4,1,0,4,2,6
401414342,Mount St. Mary's Mountaineers,TEAM,TOTAL,TOTAL,False,,23,53,15,27,8,26,16,18,10,19,29,10,5,0,15,21,70
401414342,Longwood Lancers,A. Smith,4399978,,True,33.0,12,21,12,21,0,0,8,10,8,5,13,1,0,2,2,1,32
401414342,Longwood Lancers,T. Smith,4594910,,True,39.0,3,11,3,10,0,1,5,6,0,2,2,6,1,0,4,4,11
401414342,Longwood Lancers,K. Calhoun,4900634,,True,32.0,2,4,2,4,0,0,1,3,2,3,5,2,0,0,2,2,5
401414342,Longwood Lancers,B. Johns,4704970,,True,27.0,1,6,1,3,0,3,0,0,1,3,4,2,0,1,1,2,2
401414342,Longwood Lancers,K. McMakin,4594907,,True,37.0,7,16,3,11,4,5,0,0,2,1,3,2,1,0,2,1,18
401414342,Longwood Lancers,B. Anya,4704849,,False,12.0,0,1,0,0,0,1,2,2,2,2,4,0,0,0,3,3,2
401414342,Longwood Lancers,A. LeRoy,4594913,,False,7.0,0,1,0,0,0,1,1,2,0,0,0,0,0,0,0,4,1
401414342,Longwood Lancers,A. Shipp,4594908,,False,5.0,1,2,0,0,1,2,0,0,0,2,2,0,0,0,0,0,3
401414342,Longwood Lancers,M. Vennema,4399977,,False,8.0,0,0,0,0,0,0,0,0,0,0,0,0,1,0,0,1,0
401414342,Longwood Lancers,TEAM,TOTAL,TOTAL,False,,26,62,21,49,5,13,17,23,19,21,40,13,3,3,14,18,74
401414332,DePaul Blue Demons,A. Morrow,4684384,,True,37.0,9,25,8,20,1,5,9,14,7,10,17,1,2,4,2,4,28
401414332,DePaul Blue Demons,D. Rogers,4433475,,True,36.0,2,7,1,4,1,3,0,0,2,0,2,2,0,1,0,1,5
401414332,DePaul Blue Demons,S. Morris,4399343,,True,27.0,3,11,2,10,1,1,0,0,2,2,4,2,0,1,3,5,7
401414332,DePaul Blue Demons,L. Held,4399342,,True,35.0,2,9,0,2,2,7,3,3,0,3,3,2,2,1,2,4,9
401414332,DePaul Blue Demons,D. Church,4281244,,True,35.0,3,15,3,13,0,2,2,3,2,4,6,2,0,2,3,4,8
401414332,DePaul Blue Demons,K. Rimmer,4594817,,False,3.0,0,1,0,0,0,1,0,0,0,0,0,0,0,0,0,0,0
401414332,DePaul Blue Demons,K. Holmes,4599133,,False,11.0,0,1,0,1,0,0,0,0,0,0,0,0,0,0,0,1,0
401414332,DePaul Blue Demons,D. Bekelja,4281356,,False,16.0,0,1,0,0,0,1,0,0,0,2,2,2,1,1,0,1,0
401414332,DePaul Blue Demons,TEAM,TOTAL,TOTAL,False,,19,70,14,50,5,20,14,20,19,23,42,11,5,10,11,20,57
401414332,Dayton Flyers,K. Whitehead,4399307,,True,31.0,0,1,0,1,0,0,4,4,1,7,8,2,0,0,1,1,4
401414332,Dayton Flyers,T. Magassa,4703739,,True,24.0,4,10,4,10,0,0,0,2,4,10,14,1,0,7,0,4,8
401414332,Dayton Flyers,M. Cook,4682764,,True,29.0,5,11,3,8,2,3,4,4,0,5,5,4,0,0,3,2,16
401414332,Dayton Flyers,E. Whalen,4065788,,True,33.0,10,17,3,5,7,12,1,1,0,1,1,2,1,0,1,2,28
401414332,Dayton Flyers,A. Bradshaw,4065758,,True,28.0,2,4,2,4,0,0,3,5,0,2,2,7,2,0,0,2,7
401414332,Dayton Flyers,B. Shoup-Hill,4898494,,False,2.0,1,2,1,1,0,1,0,0,0,1,1,0,0,0,0,1,2
401414332,Dayton Flyers,S. Wheeler,4898493,,False,1.0,0,1,0,1,0,0,0,0,1,1,2,0,0,0,0,0,0
401414332,Dayton Flyers,M. Perez,4594754,,False,7.0,0,1,0,1,0,0,0,0,2,2,4,0,0,2,0,1,0
401414332,Dayton Flyers,A. Davidson,4399308,,False,1.0,0,0,0,0,0,0,0,0,0,0,0,0,0,0,0,0,0
401414332,Dayton Flyers,A. LeMaster,4703737,,False,1.0,0,0,0,0,0,0,0,0,0,0,0,0,0,0,0,0,0
401414332,Dayton Flyers,D. Bohanon,4594755,,False,3.0,0,0,0,0,0,0,0,0,0,0,0,0,0,1,0,0,0
401414332,Dayton Flyers,C. Brown,4433750,,False,5.0,0,2,0,2,0,0,0,0,3,1,4,0,0,0,0,0,0
401414332,Dayton Flyers,M. Perry,4433361,,False,9.0,1,3,1,2,0,1,0,0,0,2,2,1,0,0,0,1,2
401414332,Dayton Flyers,J. Giacone,4068133,,False,26.0,6,13,2,7,4,6,5,5,0,3,3,1,0,5,3,0,21
401414332,Dayton Flyers,TEAM,TOTAL,TOTAL,False,,29,65,16,42,13,23,17,21,13,35,48,18,3,15,9,14,88
401414330,Incarnate Word Cardinals,J. Means,4400572,,True,14.0,1,3,1,3,0,0,0,0,0,2,2,1,0,2,1,2,2
401414330,Incarnate Word Cardinals,M. Bell,4704788,,True,15.0,0,2,0,1,0,1,0,0,0,2,2,0,0,0,0,0,0
401414330,Incarnate Word Cardinals,D. Terrell,4704787,,True,37.0,3,8,3,8,0,0,3,4,1,6,7,2,1,0,2,4,9
401414330,Incarnate Word Cardinals,J. Moore,4704786,,True,38.0,5,17,3,10,2,7,2,2,1,4,5,1,0,0,2,2,14
401414330,Incarnate Word Cardinals,D. Jenkins,4595693,,True,35.0,1,5,0,0,1,5,0,0,0,4,4,0,2,0,0,2,3
401414330,Incarnate Word Cardinals,T. Gardner,4704792,,False,26.0,5,10,5,10,0,0,6,6,0,6,6,3,0,1,5,4,16
401414330,Incarnate Word Cardinals,C. Storer,4704789,,False,18.0,2,3,1,2,1,1,0,0,0,0,0,0,1,0,0,0,5
401414330,Incarnate Word Cardinals,K. Gibson,4704784,,False,15.0,1,4,1,3,0,1,0,0,0,1,1,0,0,0,2,2,2
401414330,Incarnate Word Cardinals,H. Wheeler,4704783,,False,2.0,0,0,0,0,0,0,0,0,0,1,1,0,0,0,0,1,0
401414330,Incarnate Word Cardinals,TEAM,TOTAL,TOTAL,False,,18,52,14,37,4,15,11,12,2,31,33,7,4,3,13,17,51
401414330,Howard Bison,B. Fort-Davis,4705321,,True,37.0,6,17,6,17,0,0,3,6,6,5,11,0,1,0,1,2,15
401414330,Howard Bison,K. Marsh,4400350,,True,30.0,6,10,6,10,0,0,2,7,6,10,16,1,2,2,1,2,14
401414330,Howard Bison,K. Harris,4705322,,True,32.0,0,1,0,0,0,1,5,6,0,6,6,1,1,0,2,1,5
401414330,Howard Bison,D. Howell,4705316,,True,28.0,4,17,3,7,1,10,2,2,3,1,4,2,2,0,3,3,11
401414330,Howard Bison,I. Warren,4595524,,True,27.0,4,8,4,7,0,1,0,2,3,2,5,4,0,0,2,3,8
401414330,Howard Bison,K. Creek,4705320,,False,8.0,0,3,0,2,0,1,0,0,1,0,1,0,1,0,0,0,0
401414330,Howard Bison,A. Hutton,4705315,,False,10.0,0,3,0,3,0,0,0,0,1,1,2,0,0,0,0,1,0
401414330,Howard Bison,V. Udoji,4070243,,False,9.0,0,4,0,1,0,3,0,0,1,2,3,0,0,0,0,0,0
401414330,Howard Bison,N. Cooper,4899955,,False,1.0,0,1,0,0,0,1,0,0,0,0,0,0,0,0,0,0,0
401414330,Howard Bison,A. Wilson,4705319,,False,4.0,0,1,0,0,0,1,0,0,0,0,0,0,0,0,1,0,0
401414330,Howard Bison,G. Thorpe,4400349,,False,14.0,1,3,1,3,0,0,0,2,0,0,0,0,0,1,0,0,2
401414330,Howard Bison,TEAM,TOTAL,TOTAL,False,,21,68,20,50,1,18,12,25,22,31,53,8,7,3,10,12,55
401412964,UT Arlington Mavericks,S. Jacobs,4900111,,True,35.0,6,15,6,15,0,0,7,11,1,5,6,3,2,0,4,5,19
401412964,UT Arlington Mavericks,S. Smith,4399040,,True,29.0,4,6,3,5,1,1,0,2,3,5,8,2,0,0,0,3,9
401412964,UT Arlington Mavericks,K. Ferrell,4400592,,True,31.0,2,7,0,2,2,5,0,0,0,7,7,1,3,2,1,3,6
401412964,UT Arlington Mavericks,T. Milton,4400590,,True,36.0,5,15,5,14,0,1,1,1,3,3,6,4,1,0,2,2,11
401412964,UT Arlington Mavericks,C. Chastain,4400589,,True,27.0,4,9,3,6,1,3,0,0,0,1,1,1,0,2,2,5,9
401412964,UT Arlington Mavericks,J. Turner,4900114,,False,0.0,0,0,0,0,0,0,0,0,0,1,1,0,0,0,0,0,0
401412964,UT Arlington Mavericks,C. Hawkins,4400591,,False,12.0,1,2,0,0,1,2,0,0,0,0,0,0,0,0,0,2,3
401412964,UT Arlington Mavericks,D. Benjamin,4398599,,False,30.0,5,8,3,4,2,4,2,2,0,4,4,0,0,1,0,0,14
401412964,UT Arlington Mavericks,TEAM,TOTAL,TOTAL,False,,27,62,20,46,7,16,10,16,9,27,36,11,6,5,9,20,71
401412964,Iowa State Cyclones,N. Diew,4599130,,True,28.0,2,4,2,4,0,0,2,4,1,3,4,0,0,3,0,4,6
401412964,Iowa State Cyclones,M. Kane,4398803,,True,9.0,1,1,1,1,0,0,0,0,2,2,4,0,0,0,1,2,2
401412964,Iowa State Cyclones,E. Ryan,4433436,,True,40.0,7,14,5,10,2,4,4,7,0,3,3,6,1,0,3,1,20
401412964,Iowa State Cyclones,L. Donarski,4433409,,True,40.0,5,13,4,9,1,4,3,3,1,3,4,0,1,2,0,2,14
401412964,Iowa State Cyclones,As. Joens,4398802,,True,40.0,13,28,9,20,4,8,6,12,5,10,15,0,0,0,1,0,36
401412964,Iowa State Cyclones,B. Jordao,4399242,,False,10.0,0,1,0,1,0,0,0,0,1,1,2,0,0,0,1,4,0
401412964,Iowa State Cyclones,M. Espenmiller-McGraw,4594688,,False,12.0,0,2,0,0,0,2,0,0,0,0,0,0,0,0,1,1,0
401412964,Iowa State Cyclones,Au. Joens,4433988,,False,21.0,0,2,0,0,0,2,0,0,1,5,6,0,0,1,0,0,0
401412964,Iowa State Cyclones,TEAM,TOTAL,TOTAL,False,,28,65,21,45,7,20,15,26,15,28,43,6,2,6,7,14,78
401411772,Sacred Heart Pioneers,K. Wood,4705033,,True,15.0,3,7,3,7,0,0,0,0,3,3,6,0,1,0,1,3,6
401411772,Sacred Heart Pioneers,S. Smith,4595781,,True,33.0,1,9,1,7,0,2,4,4,0,1,1,6,2,1,2,1,6
401411772,Sacred Heart Pioneers,O. Tucker,4594799,,True,23.0,2,9,2,4,0,5,0,0,0,1,1,1,0,0,1,1,4
401411772,Sacred Heart Pioneers,A. Hagood,4282006,,True,31.0,4,16,4,12,0,4,0,0,2,3,5,0,0,0,3,4,8
401411772,Sacred Heart Pioneers,A. McCray,4282005,,True,30.0,2,7,2,6,0,1,2,3,4,5,9,0,4,0,0,1,6
401411772,Sacred Heart Pioneers,M. Bergdorf,4900507,,False,19.0,1,3,1,2,0,1,5,6,2,1,3,0,1,0,2,3,7
401411772,Sacred Heart Pioneers,C. Stroemel,4595782,,False,15.0,4,4,4,4,0,0,1,1,0,3,3,1,0,0,1,1,9
401411772,Sacred Heart Pioneers,W. Jackson,4399144,,False,9.0,2,3,1,2,1,1,2,2,1,1,2,0,0,0,0,1,7
401411772,Sacred Heart Pioneers,N. Johnson,4068964,,False,25.0,2,4,1,2,1,2,4,6,0,3,3,1,0,0,1,4,9
401411772,Sacred Heart Pioneers,TEAM,TOTAL,TOTAL,False,,21,62,19,46,2,16,18,22,17,26,43,9,8,1,12,19,62
401411772,Central Connecticut Blue Devils,C. Sutherland-Case,4595721,,True,32.0,3,5,1,3,2,2,3,4,1,4,5,2,0,1,1,1,11
401411772,Central Connecticut Blue Devils,E. Nibbelink,4282061,,True,31.0,6,9,3,4,3,5,0,0,3,8,11,0,0,2,1,5,15
401411772,Central Connecticut Blue Devils,A. Berube,4281958,,True,31.0,6,12,6,9,0,3,1,2,2,6,8,2,0,2,3,2,13
401411772,Central Connecticut Blue Devils,D. Jenkins,4595718,,True,30.0,2,9,1,5,1,4,0,0,0,2,2,2,1,0,1,1,5
401411772,Central Connecticut Blue Devils,F. Toppin,4399543,,True,30.0,0,5,0,4,0,1,1,2,0,4,4,0,1,1,3,4,1
401411772,Central Connecticut Blue Devils,M. Kenefick,4704142,,False,7.0,0,2,0,1,0,1,0,0,1,0,1,1,1,0,0,1,0
401411772,Central Connecticut Blue Devils,C. Reynolds,4399542,,False,9.0,2,4,2,4,0,0,0,0,1,1,2,0,0,0,0,1,4
401411772,Central Connecticut Blue Devils,N. Davy,4900600,,False,3.0,0,0,0,0,0,0,0,0,0,0,0,1,0,1,0,0,0
401411772,Central Connecticut Blue Devils,B. Lanpher,4704961,,False,27.0,2,11,1,7,1,4,4,6,0,0,0,5,0,0,3,4,9
401411772,Central Connecticut Blue Devils,TEAM,TOTAL,TOTAL,False,,21,57,14,37,7,20,9,14,10,27,37,13,3,7,12,19,58
401409418,Jackson State Lady Tigers,L. Sims,4704560,,True,24.0,4,6,3,5,1,1,2,2,0,5,5,0,0,0,2,1,11
401409418,Jackson State Lady Tigers,A. Williams-Holliday,4065745,,True,21.0,5,5,5,5,0,0,4,4,2,7,9,1,1,2,2,4,14
401409418,Jackson State Lady Tigers,M. Crump,4900475,,True,31.0,8,11,8,9,0,2,6,7,1,2,3,3,5,0,1,1,22
401409418,Jackson State Lady Tigers,D. Rogan,4595999,,True,29.0,6,11,3,5,3,6,2,2,1,2,3,5,4,0,1,1,17
401409418,Jackson State Lady Tigers,K. Luckett,4595995,,True,28.0,4,6,3,5,1,1,2,4,0,1,1,4,0,0,3,2,11
401409418,Jackson State Lady Tigers,K. Ransom,4900480,,False,2.0,0,0,0,0,0,0,1,2,2,0,2,0,0,0,1,0,1
401409418,Jackson State Lady Tigers,J. Hickmon,4900478,,False,9.0,0,1,0,1,0,0,0,2,1,0,1,0,2,0,0,2,0
401409418,Jackson State Lady Tigers,D. Woodard,4900474,,False,19.0,4,8,4,8,0,0,0,0,2,4,6,0,1,1,0,2,8
401409418,Jackson State Lady Tigers,A. Roberts,4900479,,False,2.0,0,0,0,0,0,0,1,2,0,2,2,0,0,0,0,1,1
401409418,Jackson State Lady Tigers,A. Hunter,4900477,,False,2.0,0,0,0,0,0,0,2,4,0,0,0,0,0,0,0,0,2
401409418,Jackson State Lady Tigers,A. Mosley,4900476,,False,2.0,0,1,0,0,0,1,0,0,0,0,0,0,0,0,0,0,0
401409418,Jackson State Lady Tigers,J. Covington,4704112,,False,21.0,4,8,3,7,1,1,2,4,0,0,0,4,1,0,0,2,11
401409418,Jackson State Lady Tigers,T. Boler,4704111,,False,10.0,1,5,0,2,1,3,0,0,0,0,0,0,0,0,0,2,3
401409418,Jackson State Lady Tigers,TEAM,TOTAL,TOTAL,False,,36,62,29,47,7,15,22,33,11,25,36,17,14,3,10,18,101
401409418,Alabama State Lady Hornets,T. Stallings,4594404,,True,9.0,0,1,0,1,0,0,0,0,0,2,2,2,0,0,1,3,0
401409418,Alabama State Lady Hornets,S. Ward,4400468,,True,28.0,6,12,6,12,0,0,2,4,3,4,7,2,0,1,3,3,14
401409418,Alabama State Lady Hornets,D. Sanders,4704005,,True,10.0,0,1,0,0,0,1,0,0,0,0,0,1,1,0,0,2,0
401409418,Alabama State Lady Hornets,J. Crawford,4400465,,True,34.0,8,14,4,6,4,8,2,2,1,1,2,3,0,0,1,3,22
401409418,Alabama State Lady Hornets,A. Emmanuel,4400462,,True,34.0,8,15,4,7,4,8,6,7,1,3,4,1,1,0,5,4,26
401409418,Alabama State Lady Hornets,F. Pearson,4704009,,False,22.0,1,3,1,1,0,2,0,0,0,0,0,2,0,1,2,2,2
401409418,Alabama State Lady Hornets,J. Nneji,4282073,,False,10.0,4,5,4,5,0,0,0,1,1,2,3,0,0,0,0,3,8
401409418,Alabama State Lady Hornets,T. Thomas,4704008,,False,5.0,0,1,0,1,0,0,0,0,0,2,2,0,0,1,0,2,0
401409418,Alabama State Lady Hornets,B. Watkins,4900452,,False,2.0,0,2,0,2,0,0,0,0,0,0,0,0,0,0,0,0,0
401409418,Alabama State Lady Hornets,T. Ashley,4704007,,False,3.0,0,1,0,1,0,0,0,0,1,0,1,0,0,0,0,0,0
401409418,Alabama State Lady Hornets,H. White,4596194,,False,23.0,2,5,2,5,0,0,4,5,0,1,1,1,0,0,4,1,8
401409418,Alabama State Lady Hornets,K. Jackson,4595512,,False,20.0,0,0,0,0,0,0,0,0,2,3,5,3,0,0,2,2,0
401409418,Alabama State Lady Hornets,TEAM,TOTAL,TOTAL,False,,29,60,21,41,8,19,14,19,10,19,29,15,2,3,19,25,80
401409417,Grambling Lady Tigers,J. Forte,4400552,,True,9.0,2,3,2,3,0,0,0,0,2,1,3,0,0,1,3,4,4
401409417,Grambling Lady Tigers,A. Holt,4596275,,True,40.0,7,20,5,10,2,10,8,10,2,4,6,5,1,0,2,1,24
401409417,Grambling Lady Tigers,J. Coleman,4282676,,True,37.0,5,13,3,7,2,6,0,0,1,3,4,1,0,0,6,4,12
401409417,Grambling Lady Tigers,A. Williams,4282675,,True,38.0,2,9,2,7,0,2,5,6,0,3,3,1,1,0,1,4,9
401409417,Grambling Lady Tigers,L. Morrow,4282016,,True,28.0,1,6,1,5,0,1,1,2,2,3,5,1,1,0,2,2,3
401409417,Grambling Lady Tigers,D. Johnson,4704667,,False,3.0,0,0,0,0,0,0,0,0,0,0,0,0,0,0,0,1,0
401409417,Grambling Lady Tigers,T. Totten,4287046,,False,16.0,1,6,1,4,0,2,0,0,1,2,3,2,1,0,1,0,2
401409417,Grambling Lady Tigers,D. Alexander,4399518,,False,14.0,2,3,2,3,0,0,0,0,3,2,5,0,2,1,0,3,4
401409417,Grambling Lady Tigers,C. Maples,4900469,,False,7.0,0,1,0,1,0,0,1,2,0,1,1,1,0,0,2,3,1
401409417,Grambling Lady Tigers,P. Allen,4900468,,False,1.0,0,1,0,1,0,0,0,0,0,0,0,0,0,0,0,0,0
401409417,Grambling Lady Tigers,K. Chairs,4704665,,False,7.0,0,1,0,1,0,0,0,0,0,0,0,0,0,0,0,0,0
401409417,Grambling Lady Tigers,TEAM,TOTAL,TOTAL,False,,20,63,16,42,4,21,15,20,15,20,35,11,6,2,17,22,59
401409417,Alabama State Lady Hornets,S. Ward,4400468,,True,30.0,7,13,7,13,0,0,6,8,2,7,9,1,0,1,2,1,20
401409417,Alabama State Lady Hornets,J. Nneji,4282073,,True,7.0,0,3,0,3,0,0,0,0,1,2,3,1,1,2,0,3,0
401409417,Alabama State Lady Hornets,D. Sanders,4704005,,True,23.0,1,3,0,2,1,1,0,0,0,2,2,3,1,0,0,3,3
401409417,Alabama State Lady Hornets,J. Crawford,4400465,,True,31.0,7,11,5,7,2,4,6,7,0,5,5,2,1,1,0,3,22
401409417,Alabama State Lady Hornets,A. Emmanuel,4400462,,True,34.0,7,15,7,14,0,1,4,4,6,4,10,2,2,0,3,4,18
401409417,Alabama State Lady Hornets,F. Pearson,4704009,,False,24.0,4,9,4,8,0,1,0,0,4,3,7,1,0,0,4,2,8
401409417,Alabama State Lady Hornets,T. Stallings,4594404,,False,4.0,1,3,1,3,0,0,1,2,0,0,0,0,0,0,1,2,3
401409417,Alabama State Lady Hornets,T. Thomas,4704008,,False,5.0,0,1,0,1,0,0,0,0,0,1,1,0,0,1,0,1,0
401409417,Alabama State Lady Hornets,B. Watkins,4900452,,False,2.0,0,1,0,1,0,0,0,0,0,0,0,0,0,0,1,0,0
401409417,Alabama State Lady Hornets,T. Ashley,4704007,,False,9.0,0,2,0,1,0,1,0,0,1,2,3,0,1,0,0,2,0
401409417,Alabama State Lady Hornets,H. White,4596194,,False,18.0,0,0,0,0,0,0,0,0,0,0,0,4,0,0,1,2,0
401409417,Alabama State Lady Hornets,K. Jackson,4595512,,False,13.0,0,0,0,0,0,0,0,0,0,2,2,0,2,0,1,0,0
401409417,Alabama State Lady Hornets,TEAM,TOTAL,TOTAL,False,,27,61,24,53,3,8,17,21,14,30,44,14,8,5,14,23,74
401409416,Southern Jaguars,R. White,4595966,,True,25.0,1,2,1,2,0,0,0,0,1,1,2,0,0,0,1,5,2
401409416,Southern Jaguars,T. Metcalf,4704148,,True,28.0,1,3,1,3,0,0,0,0,0,2,2,2,1,0,1,0,2
401409416,Southern Jaguars,G. Johnson,4595965,,True,21.0,4,13,4,10,0,3,0,0,2,2,4,1,2,0,1,5,8
401409416,Southern Jaguars,N. Kincey,4595962,,True,29.0,3,7,2,3,1,4,1,2,1,0,1,0,2,0,0,1,8
401409416,Southern Jaguars,A. Mcwain,4400584,,True,34.0,3,12,2,5,1,7,0,0,2,3,5,0,1,0,0,2,7
401409416,Southern Jaguars,T. Moore,4400585,,False,16.0,2,4,2,4,0,0,1,2,3,1,4,0,1,1,0,0,5
401409416,Southern Jaguars,X. Harrison,4900564,,False,10.0,1,1,1,1,0,0,0,0,0,0,0,0,0,0,1,5,2
401409416,Southern Jaguars,T. Lidge,4900563,,False,3.0,0,0,0,0,0,0,0,0,0,1,1,0,0,0,0,1,0
401409416,Southern Jaguars,A. Fontenot,4900560,,False,2.0,0,1,0,0,0,1,0,0,0,0,0,0,0,0,0,0,0
401409416,Southern Jaguars,D. Hunter,4705035,,False,13.0,3,11,2,8,1,3,1,2,0,4,4,0,2,0,0,0,8
401409416,Southern Jaguars,C. Fleming,4595963,,False,9.0,1,2,1,2,0,0,0,0,0,0,0,1,0,0,0,1,2
401409416,Southern Jaguars,K. Watson,4595961,,False,10.0,1,3,1,3,0,0,0,1,1,0,1,0,1,0,2,2,2
401409416,Southern Jaguars,TEAM,TOTAL,TOTAL,False,,20,59,17,41,3,18,3,7,11,17,28,4,10,1,8,22,46
401409416,Jackson State Lady Tigers,L. Sims,4704560,,True,21.0,5,6,5,6,0,0,0,0,2,1,3,0,0,0,1,1,10
401409416,Jackson State Lady Tigers,A. Williams-Holliday,4065745,,True,37.0,8,11,8,11,0,0,4,9,7,6,13,1,0,3,3,2,20
401409416,Jackson State Lady Tigers,M. Crump,4900475,,True,23.0,0,5,0,1,0,4,1,2,0,3,3,0,0,0,2,2,1
401409416,Jackson State Lady Tigers,D. Rogan,4595999,,True,26.0,1,6,1,4,0,2,1,2,0,3,3,4,0,0,2,1,3
401409416,Jackson State Lady Tigers,K. Luckett,4595995,,True,33.0,4,11,4,6,0,5,5,6,0,4,4,6,0,0,3,0,13
401409416,Jackson State Lady Tigers,D. Woodard,4900474,,False,22.0,2,7,2,7,0,0,0,0,5,5,10,0,0,1,3,1,4
401409416,Jackson State Lady Tigers,J. Covington,4704112,,False,25.0,2,6,0,3,2,3,0,0,0,0,0,2,1,0,2,2,6
401409416,Jackson State Lady Tigers,T. Boler,4704111,,False,13.0,1,1,1,1,0,0,0,0,2,1,3,1,0,0,1,2,2
401409416,Jackson State Lady Tigers,TEAM,TOTAL,TOTAL,False,,23,53,21,39,2,14,11,19,18,30,48,14,1,4,17,11,59
401409415,Prairie View A&M Lady Panthers,J. Soders,4900559,,True,22.0,0,4,0,1,0,3,0,0,2,2,4,1,0,0,1,4,0
401409415,Prairie View A&M Lady Panthers,K. Paul,4595982,,True,32.0,4,16,3,9,1,7,3,4,3,5,8,0,3,0,2,4,12
401409415,Prairie View A&M Lady Panthers,K. Heard,4595980,,True,30.0,0,6,0,2,0,4,2,2,1,3,4,2,6,0,2,2,2
401409415,Prairie View A&M Lady Panthers,E. Rosario,4596283,,True,14.0,0,4,0,3,0,1,0,0,0,0,0,1,0,0,2,0,0
401409415,Prairie View A&M Lady Panthers,D. Rosenthal,4595979,,True,37.0,7,15,5,10,2,5,13,17,1,3,4,1,1,0,1,3,29
401409415,Prairie View A&M Lady Panthers,J. Charles,4900557,,False,1.0,0,1,0,1,0,0,0,0,0,0,0,0,0,0,0,1,0
401409415,Prairie View A&M Lady Panthers,T. Simon,4900556,,False,1.0,0,0,0,0,0,0,0,0,0,0,0,0,0,0,0,0,0
401409415,Prairie View A&M Lady Panthers,G. Smith,4704127,,False,22.0,1,5,1,4,0,1,0,0,1,2,3,1,1,1,2,3,2
401409415,Prairie View A&M Lady Panthers,T. Hudson,4704128,,False,10.0,0,0,0,0,0,0,0,0,1,0,1,1,1,2,1,2,0
401409415,Prairie View A&M Lady Panthers,S. Patton,4704919,,False,3.0,0,0,0,0,0,0,0,0,0,1,1,0,0,0,1,1,0
401409415,Prairie View A&M Lady Panthers,K. Clark,4400518,,False,28.0,4,11,3,9,1,2,4,4,1,2,3,0,0,0,2,3,13
401409415,Prairie View A&M Lady Panthers,TEAM,TOTAL,TOTAL,False,,16,62,12,39,4,23,22,27,13,20,33,7,12,3,15,23,58
401409415,Alabama State Lady Hornets,S. Ward,4400468,,True,25.0,7,11,7,11,0,0,1,1,3,4,7,4,0,2,6,2,15
401409415,Alabama State Lady Hornets,J. Nneji,4282073,,True,11.0,1,1,1,1,0,0,1,2,1,1,2,1,0,0,3,1,3
401409415,Alabama State Lady Hornets,D. Sanders,4704005,,True,30.0,1,4,1,4,0,0,2,2,0,4,4,2,2,0,1,3,4
401409415,Alabama State Lady Hornets,J. Crawford,4400465,,True,29.0,2,8,1,2,1,6,0,0,0,0,0,3,1,0,2,3,5
401409415,Alabama State Lady Hornets,A. Emmanuel,4400462,,True,36.0,3,11,3,7,0,4,6,10,3,6,9,2,0,0,4,2,12
401409415,Alabama State Lady Hornets,F. Pearson,4704009,,False,27.0,4,8,3,7,1,1,3,6,1,6,7,2,0,0,2,3,12
401409415,Alabama State Lady Hornets,T. Stallings,4594404,,False,2.0,0,2,0,2,0,0,0,0,1,0,1,0,0,0,2,0,0
401409415,Alabama State Lady Hornets,T. Thomas,4704008,,False,2.0,1,1,1,1,0,0,0,0,0,0,0,0,0,0,0,0,2
401409415,Alabama State Lady Hornets,T. Ashley,4704007,,False,12.0,1,3,1,2,0,1,0,0,0,1,1,2,1,1,1,1,2
401409415,Alabama State Lady Hornets,H. White,4596194,,False,11.0,1,2,1,2,0,0,1,2,0,3,3,0,0,0,2,2,3
401409415,Alabama State Lady Hornets,K. Jackson,4595512,,False,14.0,1,4,1,4,0,0,0,0,0,2,2,0,1,0,0,3,2
401409415,Alabama State Lady Hornets,TEAM,TOTAL,TOTAL,False,,22,55,20,43,2,12,14,23,15,35,50,16,5,3,25,20,60
401409414,Texas Southern Tigers,J. Perry,4594405,,True,36.0,4,7,4,7,0,0,3,6,2,9,11,0,4,2,2,4,11
401409414,Texas Southern Tigers,A. Taylor,4399621,,True,29.0,2,4,1,1,1,3,0,0,0,5,5,0,0,0,1,3,5
401409414,Texas Southern Tigers,A. Bridges,4595954,,True,45.0,5,14,5,13,0,1,6,7,1,2,3,4,8,0,9,3,16
401409414,Texas Southern Tigers,A. Avent,4595645,,True,26.0,3,12,3,9,0,3,6,6,2,4,6,0,0,2,4,4,12
401409414,Texas Southern Tigers,T. White,4400597,,True,36.0,0,2,0,1,0,1,4,4,0,3,3,1,0,0,1,1,4
401409414,Texas Southern Tigers,S. Green,4400007,,False,5.0,0,0,0,0,0,0,0,0,0,1,1,1,0,0,1,0,0
401409414,Texas Southern Tigers,J. Compton,4900568,,False,1.0,0,1,0,0,0,1,0,0,0,0,0,0,0,0,0,0,0
401409414,Texas Southern Tigers,J. Buster,4400582,,False,19.0,1,6,1,6,0,0,0,0,2,3,5,0,0,1,2,2,2
401409414,Texas Southern Tigers,A. Austin,4400105,,False,28.0,6,11,3,5,3,6,2,4,1,4,5,1,1,1,5,3,17
401409414,Texas Southern Tigers,TEAM,TOTAL,TOTAL,False,,21,57,17,42,4,15,21,27,9,33,42,7,13,6,27,20,67
401409414,Southern Jaguars,R. White,4595966,,True,19.0,0,2,0,2,0,0,2,2,2,3,5,0,0,0,2,3,2
401409414,Southern Jaguars,T. Metcalf,4704148,,True,28.0,2,7,2,7,0,0,2,2,0,1,1,1,0,0,5,5,6
401409414,Southern Jaguars,G. Johnson,4595965,,True,37.0,10,24,10,24,0,0,6,12,4,9,13,2,2,0,4,3,26
401409414,Southern Jaguars,N. Kincey,4595962,,True,37.0,9,15,9,12,0,3,1,1,3,1,4,0,2,0,1,1,19
401409414,Southern Jaguars,A. Mcwain,4400584,,True,39.0,2,12,2,9,0,3,0,2,3,4,7,0,2,0,1,1,4
401409414,Southern Jaguars,T. Moore,4400585,,False,33.0,1,5,1,5,0,0,0,0,3,7,10,1,2,0,2,3,2
401409414,Southern Jaguars,A. Fontenot,4900560,,False,1.0,0,0,0,0,0,0,0,0,0,0,0,0,0,0,0,0,0
401409414,Southern Jaguars,D. Hunter,4705035,,False,3.0,0,0,0,0,0,0,0,0,0,0,0,0,0,0,0,0,0
401409414,Southern Jaguars,C. Fleming,4595963,,False,16.0,1,4,1,3,0,1,1,2,1,1,2,1,2,0,7,1,3
401409414,Southern Jaguars,K. Watson,4595961,,False,12.0,3,6,3,6,0,0,0,0,0,1,1,0,0,1,0,4,6
401409414,Southern Jaguars,TEAM,TOTAL,TOTAL,False,,28,75,28,68,0,7,12,21,19,32,51,5,10,1,23,21,68
401409413,Grambling Lady Tigers,J. Forte,4400552,,True,21.0,1,6,1,6,0,0,0,0,2,1,3,0,0,1,0,3,2
401409413,Grambling Lady Tigers,A. Holt,4596275,,True,38.0,4,11,3,7,1,4,6,6,2,4,6,5,2,0,0,2,15
401409413,Grambling Lady Tigers,J. Coleman,4282676,,True,39.0,7,17,5,10,2,7,3,8,1,6,7,1,1,0,4,2,19
401409413,Grambling Lady Tigers,A. Williams,4282675,,True,38.0,4,8,2,5,2,3,3,4,0,3,3,3,2,0,3,2,13
401409413,Grambling Lady Tigers,L. Morrow,4282016,,True,33.0,4,10,3,7,1,3,4,7,4,4,8,1,2,0,0,2,13
401409413,Grambling Lady Tigers,D. Johnson,4704667,,False,2.0,0,1,0,1,0,0,0,0,0,0,0,0,0,0,1,1,0
401409413,Grambling Lady Tigers,T. Totten,4287046,,False,8.0,0,1,0,1,0,0,0,0,0,0,0,0,0,0,1,1,0
401409413,Grambling Lady Tigers,D. Alexander,4399518,,False,16.0,0,1,0,1,0,0,0,0,1,5,6,0,0,0,0,4,0
401409413,Grambling Lady Tigers,C. Maples,4900469,,False,2.0,0,0,0,0,0,0,0,0,0,0,0,0,0,0,0,0,0
401409413,Grambling Lady Tigers,K. Chairs,4704665,,False,3.0,0,1,0,0,0,1,0,0,0,0,0,0,0,0,0,0,0
401409413,Grambling Lady Tigers,TEAM,TOTAL,TOTAL,False,,20,56,14,38,6,18,16,25,13,24,37,10,7,1,11,17,62
401409413,Alabama A&M Bulldogs,J. Clowers,4704645,,True,26.0,1,2,1,2,0,0,3,4,2,4,6,2,1,4,3,3,5
401409413,Alabama A&M Bulldogs,D. Lewis,4399418,,True,38.0,13,19,13,19,0,0,6,7,5,5,10,1,2,2,2,3,32
401409413,Alabama A&M Bulldogs,D. Burgin,4703971,,True,28.0,0,6,0,3,0,3,4,4,0,8,8,2,0,0,2,4,4
401409413,Alabama A&M Bulldogs,J. Harris,4595412,,True,38.0,3,7,2,5,1,2,0,0,1,0,1,1,0,1,2,2,7
401409413,Alabama A&M Bulldogs,N. Jones,4282633,,True,37.0,0,8,0,5,0,3,0,2,0,4,4,2,2,0,4,4,0
401409413,Alabama A&M Bulldogs,T. Jeter,4900451,,False,5.0,0,1,0,1,0,0,0,0,1,0,1,0,0,0,1,1,0
401409413,Alabama A&M Bulldogs,K. Johnson-Graham,4068445,,False,15.0,2,9,2,9,0,0,2,3,2,0,2,2,0,1,0,1,6
401409413,Alabama A&M Bulldogs,J. Alexander,4900445,,False,13.0,0,0,0,0,0,0,0,0,0,2,2,0,0,0,2,0,0
401409413,Alabama A&M Bulldogs,TEAM,TOTAL,TOTAL,False,,19,52,18,44,1,8,15,20,12,27,39,10,5,8,17,18,54
401409412,Jackson State Lady Tigers,L. Sims,4704560,,True,21.0,1,4,1,4,0,0,1,2,1,4,5,0,0,0,1,2,3
401409412,Jackson State Lady Tigers,A. Williams-Holliday,4065745,,True,35.0,8,12,8,12,0,0,1,3,3,9,12,1,0,3,1,4,17
401409412,Jackson State Lady Tigers,M. Crump,4900475,,True,35.0,5,13,4,11,1,2,1,5,3,8,11,0,1,1,3,1,12
401409412,Jackson State Lady Tigers,D. Rogan,4595999,,True,24.0,3,9,3,6,0,3,0,0,1,1,2,3,1,0,1,2,6
401409412,Jackson State Lady Tigers,K. Luckett,4595995,,True,21.0,1,6,1,3,0,3,6,8,0,3,3,7,1,0,3,2,8
401409412,Jackson State Lady Tigers,D. Woodard,4900474,,False,24.0,3,11,3,10,0,1,2,3,5,2,7,0,0,0,1,3,8
401409412,Jackson State Lady Tigers,A. Hunter,4900477,,False,2.0,0,1,0,1,0,0,0,0,0,1,1,0,0,0,0,0,0
401409412,Jackson State Lady Tigers,J. Covington,4704112,,False,26.0,3,10,3,8,0,2,5,6,0,2,2,0,0,0,0,2,11
401409412,Jackson State Lady Tigers,T. Boler,4704111,,False,12.0,4,5,3,4,1,1,4,4,2,1,3,0,1,0,2,1,13
401409412,Jackson State Lady Tigers,TEAM,TOTAL,TOTAL,False,,28,71,26,59,2,12,20,31,19,39,58,11,4,4,15,17,78
401409412,Arkansas-Pine Bluff Golden Lions,S. Rachel,4594402,,True,12.0,1,2,1,2,0,0,0,0,0,1,1,0,1,0,1,5,2
401409412,Arkansas-Pine Bluff Golden Lions,M. Peat,4704064,,True,32.0,2,3,2,3,0,0,0,0,0,8,8,0,0,0,2,4,4
401409412,Arkansas-Pine Bluff Golden Lions,T. Juhan,4710602,,True,30.0,4,11,3,4,1,7,5,7,2,1,3,2,2,0,0,3,14
401409412,Arkansas-Pine Bluff Golden Lions,Z. Green,4398766,,True,36.0,8,24,7,21,1,3,4,5,2,17,19,1,1,1,0,3,21
401409412,Arkansas-Pine Bluff Golden Lions,J. Kennerson,3946659,,True,37.0,7,21,6,15,1,6,6,8,0,2,2,3,1,0,2,4,21
401409412,Arkansas-Pine Bluff Golden Lions,S. Okowi,4704062,,False,6.0,0,1,0,1,0,0,0,0,1,1,2,0,0,0,1,0,0
401409412,Arkansas-Pine Bluff Golden Lions,M. Christian,4400550,,False,3.0,0,0,0,0,0,0,0,0,0,0,0,0,0,0,0,0,0
401409412,Arkansas-Pine Bluff Golden Lions,K. Walker,4704060,,False,12.0,1,2,1,1,0,1,0,0,0,0,0,1,1,0,3,3,2
401409412,Arkansas-Pine Bluff Golden Lions,T. Busby,4704059,,False,8.0,1,2,0,0,1,2,0,0,0,0,0,0,0,1,0,1,3
401409412,Arkansas-Pine Bluff Golden Lions,S. Orr,4596267,,False,6.0,0,0,0,0,0,0,0,0,0,0,0,0,0,0,0,0,0
401409412,Arkansas-Pine Bluff Golden Lions,S. Hudson,4400435,,False,18.0,0,2,0,1,0,1,0,0,0,0,0,0,0,0,0,2,0
401409412,Arkansas-Pine Bluff Golden Lions,TEAM,TOTAL,TOTAL,False,,24,68,20,48,4,20,15,20,7,31,38,7,6,2,9,25,67
401409294,UNLV Lady Rebels,K. Rooks,4282188,,True,32.0,2,4,1,3,1,1,3,4,1,7,8,2,0,0,0,2,8
401409294,UNLV Lady Rebels,D. Young,4704625,,True,28.0,7,8,7,8,0,0,0,0,1,6,7,3,0,0,3,0,14
401409294,UNLV Lady Rebels,A. Durazo-Frescas,4683009,,True,25.0,2,6,0,2,2,4,0,0,0,5,5,2,1,0,0,0,6
401409294,UNLV Lady Rebels,J. Ethridge,4400144,,True,34.0,4,11,4,7,0,4,1,1,2,2,4,4,1,1,1,3,9
401409294,UNLV Lady Rebels,E. Booker,4400133,,True,38.0,10,25,6,18,4,7,1,2,1,4,5,5,0,2,2,1,25
401409294,UNLV Lady Rebels,N. Obiazor,4705419,,False,20.0,4,6,3,5,1,1,0,0,1,5,6,2,1,0,0,2,9
401409294,UNLV Lady Rebels,K. Jackson,4900597,,False,21.0,1,4,1,2,0,2,2,2,0,1,1,4,1,0,1,2,4
401409294,UNLV Lady Rebels,J. Thomas,4704624,,False,2.0,0,0,0,0,0,0,0,0,0,0,0,0,0,0,0,0,0
401409294,UNLV Lady Rebels,TEAM,TOTAL,TOTAL,False,,30,64,22,45,8,19,7,9,9,31,40,22,4,3,7,10,75
401409294,Colorado State Rams,K. Kinzer,4595630,,True,40.0,3,10,1,4,2,6,0,0,0,3,3,0,0,1,1,1,8
401409294,Colorado State Rams,K. Murphy,4068969,,True,29.0,6,11,6,11,0,0,0,0,5,5,10,0,2,0,1,2,12
401409294,Colorado State Rams,M. Hofschild,4595160,,True,40.0,10,22,9,21,1,1,6,7,1,5,6,6,0,0,2,2,27
401409294,Colorado State Rams,U. Atosu,4594809,,True,32.0,3,12,1,6,2,6,2,2,0,1,1,2,0,0,1,4,10
401409294,Colorado State Rams,S. Mech,4399658,,True,36.0,2,9,0,4,2,5,0,0,2,3,5,0,0,0,0,1,6
401409294,Colorado State Rams,C. Clark,4704464,,False,11.0,0,2,0,2,0,0,0,0,2,5,7,0,0,0,1,1,0
401409294,Colorado State Rams,P. Farkas,4704463,,False,12.0,1,2,1,2,0,0,0,0,0,1,1,0,1,0,0,0,2
401409294,Colorado State Rams,TEAM,TOTAL,TOTAL,False,,25,68,18,50,7,18,8,9,12,25,37,8,3,1,6,11,65
401409293,New Mexico Lobos,S. McGruder,4400149,,True,25.0,3,8,2,5,1,3,7,7,3,4,7,2,1,2,0,4,14
401409293,New Mexico Lobos,A. Anderson,4281834,,True,24.0,0,3,0,1,0,2,0,0,2,4,6,0,0,1,1,3,0
401409293,New Mexico Lobos,Lato. Duff,4704520,,True,37.0,8,25,2,6,6,19,0,0,1,3,4,5,1,0,2,5,22
401409293,New Mexico Lobos,Lata. Duff,4704519,,True,35.0,3,10,0,2,3,8,2,3,1,3,4,2,0,1,1,2,11
401409293,New Mexico Lobos,J. De La Cerda,4281833,,True,38.0,4,15,3,10,1,5,1,1,0,3,3,5,0,1,3,3,10
401409293,New Mexico Lobos,P. Reus,4900583,,False,27.0,3,7,3,6,0,1,1,2,1,5,6,2,0,0,0,2,7
401409293,New Mexico Lobos,M. Curtis,4900582,,False,0.0,0,0,0,0,0,0,0,0,0,0,0,0,0,0,0,0,0
401409293,New Mexico Lobos,A. Augmon,4900581,,False,10.0,2,2,2,2,0,0,0,1,0,0,0,2,0,0,1,2,4
401409293,New Mexico Lobos,Z. Seren,4900580,,False,0.0,0,0,0,0,0,0,0,0,0,0,0,0,0,0,0,0,0
401409293,New Mexico Lobos,K. van Bennekom,4704522,,False,4.0,1,1,0,0,1,1,0,0,0,0,0,1,0,0,0,1,3
401409293,New Mexico Lobos,TEAM,TOTAL,TOTAL,False,,24,71,12,32,12,39,11,14,11,24,35,19,2,5,8,22,71
401409293,Colorado State Rams,K. Kinzer,4595630,,True,38.0,2,9,0,2,2,7,0,0,0,11,11,6,0,1,1,1,6
401409293,Colorado State Rams,K. Murphy,4068969,,True,32.0,10,15,10,15,0,0,0,0,4,6,10,3,1,0,1,4,20
401409293,Colorado State Rams,S. Mech,4399658,,True,37.0,6,8,6,7,0,1,0,0,0,2,2,0,0,1,1,3,12
401409293,Colorado State Rams,M. Hofschild,4595160,,True,39.0,5,11,4,9,1,2,7,11,0,6,6,5,0,0,1,1,18
401409293,Colorado State Rams,U. Atosu,4594809,,True,36.0,7,18,4,8,3,10,6,7,2,4,6,3,1,0,4,4,23
401409293,Colorado State Rams,C. Gomez,4899769,,False,1.0,0,0,0,0,0,0,0,0,0,0,0,0,0,0,1,2,0
401409293,Colorado State Rams,C. Clark,4704464,,False,8.0,1,2,1,1,0,1,0,0,0,3,3,0,0,0,0,0,2
401409293,Colorado State Rams,P. Farkas,4704463,,False,9.0,0,0,0,0,0,0,1,2,0,5,5,1,0,0,0,0,1
401409293,Colorado State Rams,TEAM,TOTAL,TOTAL,False,,31,63,25,42,6,21,14,20,9,38,47,18,2,2,10,15,82
401409292,UNLV Lady Rebels,K. Rooks,4282188,,True,37.0,2,2,1,1,1,1,1,3,0,6,6,1,0,1,3,0,6
401409292,UNLV Lady Rebels,D. Young,4704625,,True,24.0,5,5,5,5,0,0,6,8,3,9,12,1,0,2,6,4,16
401409292,UNLV Lady Rebels,A. Durazo-Frescas,4683009,,True,22.0,1,3,1,2,0,1,0,0,0,2,2,1,0,1,1,2,2
401409292,UNLV Lady Rebels,J. Ethridge,4400144,,True,35.0,3,8,3,5,0,3,0,0,1,2,3,2,0,1,2,2,6
401409292,UNLV Lady Rebels,E. Booker,4400133,,True,31.0,6,13,5,10,1,3,4,5,0,2,2,4,0,1,4,2,17
401409292,UNLV Lady Rebels,N. Obiazor,4705419,,False,19.0,3,7,3,7,0,0,4,4,0,7,7,0,0,0,2,1,10
401409292,UNLV Lady Rebels,K. Jackson,4900597,,False,31.0,1,5,1,3,0,2,2,2,0,6,6,3,1,0,3,1,4
401409292,UNLV Lady Rebels,K. Winfrey,4900596,,False,1.0,0,0,0,0,0,0,0,0,1,0,1,0,0,0,0,0,0
401409292,UNLV Lady Rebels,TEAM,TOTAL,TOTAL,False,,21,43,19,33,2,10,17,22,5,36,41,12,1,6,21,12,61
401409292,Air Force Falcons,R. Snyder,4399409,,True,34.0,7,13,4,8,3,5,2,2,0,3,3,2,3,0,0,2,19
401409292,Air Force Falcons,H. Jones,4399403,,True,28.0,0,6,0,5,0,1,3,4,1,2,3,2,3,2,0,4,3
401409292,Air Force Falcons,J. Huntimer,4899763,,True,33.0,0,3,0,1,0,2,0,0,1,2,3,4,3,0,0,4,0
401409292,Air Force Falcons,K. Heath,4595614,,True,28.0,6,13,6,13,0,0,0,0,0,0,0,2,1,0,1,2,12
401409292,Air Force Falcons,C. Winters,4399406,,True,17.0,3,11,3,8,0,3,2,3,0,3,3,0,0,0,1,4,8
401409292,Air Force Falcons,D. MacMillan,4704414,,False,10.0,0,5,0,2,0,3,0,0,1,1,2,0,1,0,1,0,0
401409292,Air Force Falcons,N. McDonald,4595618,,False,8.0,0,0,0,0,0,0,0,0,1,0,1,1,0,0,2,3,0
401409292,Air Force Falcons,L. McDonald,4899761,,False,12.0,0,3,0,1,0,2,0,0,0,1,1,0,0,0,0,0,0
401409292,Air Force Falcons,K. Pilson,4704411,,False,13.0,0,2,0,2,0,0,0,0,1,2,3,1,0,0,1,0,0
401409292,Air Force Falcons,B. Autrey-Thompson,4399404,,False,17.0,4,14,4,13,0,1,0,0,3,1,4,1,1,0,1,3,8
401409292,Air Force Falcons,TEAM,TOTAL,TOTAL,False,,20,70,17,53,3,17,7,9,14,19,33,13,12,2,8,22,50
401409291,Wyoming Cowgirls,A. Fertig,4900606,,True,22.0,1,5,1,4,0,1,0,0,3,8,11,1,0,0,0,2,2
401409291,Wyoming Cowgirls,M. Bradshaw,4595681,,True,35.0,4,15,3,10,1,5,0,0,1,4,5,2,0,0,0,1,9
401409291,Wyoming Cowgirls,Q. Weidemann,4400207,,True,38.0,1,5,1,4,0,1,0,0,0,2,2,4,0,1,2,2,2
401409291,Wyoming Cowgirls,A. Sanchez Ramos,4400204,,True,35.0,2,7,2,7,0,0,2,2,2,10,12,1,1,0,2,2,6
401409291,Wyoming Cowgirls,T. Olson,4400203,,True,29.0,4,15,2,7,2,8,0,0,0,1,1,3,1,0,3,2,10
401409291,Wyoming Cowgirls,G. Ellis,4704657,,False,18.0,1,4,1,3,0,1,0,0,3,4,7,0,1,1,1,4,2
401409291,Wyoming Cowgirls,E. Mellema,4900607,,False,17.0,2,8,1,5,1,3,2,2,2,0,2,0,0,0,0,0,7
401409291,Wyoming Cowgirls,T. Barnes,4900605,,False,6.0,0,1,0,0,0,1,0,0,0,1,1,0,0,0,1,2,0
401409291,Wyoming Cowgirls,TEAM,TOTAL,TOTAL,False,,15,60,11,40,4,20,4,4,14,30,44,11,3,2,12,15,38
401409291,Colorado State Rams,K. Kinzer,4595630,,True,40.0,2,3,0,0,2,3,0,0,0,6,6,0,2,1,0,1,6
401409291,Colorado State Rams,K. Murphy,4068969,,True,29.0,4,9,4,9,0,0,2,4,1,6,7,1,0,0,0,1,10
401409291,Colorado State Rams,S. Mech,4399658,,True,36.0,0,4,0,3,0,1,3,4,0,4,4,1,0,3,1,1,3
401409291,Colorado State Rams,M. Hofschild,4595160,,True,39.0,6,15,6,14,0,1,4,4,0,3,3,4,1,0,2,2,16
401409291,Colorado State Rams,U. Atosu,4594809,,True,33.0,5,14,2,9,3,5,1,2,0,2,2,1,1,0,2,2,14
401409291,Colorado State Rams,C. Clark,4704464,,False,11.0,1,2,1,2,0,0,0,0,0,5,5,0,0,0,0,1,2
401409291,Colorado State Rams,P. Farkas,4704463,,False,12.0,0,1,0,0,0,1,0,0,0,2,2,1,3,0,0,1,0
401409291,Colorado State Rams,TEAM,TOTAL,TOTAL,False,,18,48,13,37,5,11,10,14,2,31,33,8,7,4,5,9,51
401409290,San Diego State Aztecs,M. Adams,4400169,,True,35.0,4,16,1,5,3,11,0,0,3,6,9,0,1,0,2,2,11
401409290,San Diego State Aztecs,K. Pepe,4691705,,True,20.0,0,4,0,4,0,0,2,2,4,2,6,1,0,0,0,1,2
401409290,San Diego State Aztecs,A. Avinger,4433748,,True,18.0,3,8,3,8,0,0,1,4,1,6,7,4,2,0,0,4,7
401409290,San Diego State Aztecs,S. Ramos,4400168,,True,40.0,8,19,6,14,2,5,0,0,0,4,4,3,2,0,4,2,18
401409290,San Diego State Aztecs,M. Staples,4398925,,True,39.0,5,14,4,7,1,7,1,2,0,5,5,1,1,0,2,4,12
401409290,San Diego State Aztecs,K. Villalobos,4704565,,False,22.0,3,5,3,5,0,0,2,2,3,7,10,0,2,0,1,2,8
401409290,San Diego State Aztecs,I. Hernandez,4595647,,False,16.0,0,2,0,1,0,1,0,0,0,1,1,0,0,0,0,0,0
401409290,San Diego State Aztecs,B. Chynoweth,4704562,,False,5.0,0,2,0,0,0,2,0,0,0,0,0,1,0,0,0,0,0
401409290,San Diego State Aztecs,M. Fiso,4433986,,False,5.0,1,1,1,1,0,0,0,0,0,0,0,0,0,0,0,0,2
401409290,San Diego State Aztecs,TEAM,TOTAL,TOTAL,False,,24,71,18,45,6,26,6,10,12,34,46,10,8,0,9,15,60
401409290,New Mexico Lobos,S. McGruder,4400149,,True,24.0,2,3,1,2,1,1,1,3,1,9,10,0,1,1,1,3,6
401409290,New Mexico Lobos,A. Anderson,4281834,,True,36.0,2,9,2,4,0,5,2,2,3,6,9,3,1,1,1,3,6
401409290,New Mexico Lobos,Lato. Duff,4704520,,True,35.0,4,13,2,8,2,5,5,5,0,4,4,3,1,0,4,0,15
401409290,New Mexico Lobos,Lata. Duff,4704519,,True,39.0,1,9,0,2,1,7,0,0,0,6,6,4,0,0,0,0,3
401409290,New Mexico Lobos,J. De La Cerda,4281833,,True,39.0,9,17,5,7,4,10,4,6,0,4,4,2,0,0,5,3,26
401409290,New Mexico Lobos,P. Reus,4900583,,False,19.0,2,6,2,3,0,3,1,1,1,6,7,1,0,0,3,0,5
401409290,New Mexico Lobos,A. Augmon,4900581,,False,8.0,1,2,1,1,0,1,0,0,1,0,1,0,2,0,0,0,2
401409290,New Mexico Lobos,TEAM,TOTAL,TOTAL,False,,21,59,13,27,8,32,13,17,6,37,43,13,5,2,14,9,63
401409269,Nevada Wolf Pack,L. Givens,4704506,,True,26.0,2,3,2,3,0,0,2,2,0,3,3,0,0,2,2,3,6
401409269,Nevada Wolf Pack,A. Jimenez,4595635,,True,11.0,0,2,0,2,0,0,0,0,0,0,0,0,0,0,1,0,0
401409269,Nevada Wolf Pack,A. West,4400134,,True,35.0,7,12,6,9,1,3,0,1,5,2,7,0,1,0,2,3,15
401409269,Nevada Wolf Pack,D. Hamilton,4400132,,True,31.0,7,23,4,17,3,6,6,7,1,1,2,1,1,0,3,2,23
401409269,Nevada Wolf Pack,K. Jimenez,4281683,,True,36.0,4,9,4,7,0,2,0,0,0,7,7,4,1,2,1,2,8
401409269,Nevada Wolf Pack,N. Lathrop,4900576,,False,14.0,1,2,1,2,0,0,0,0,1,1,2,0,0,0,0,1,2
401409269,Nevada Wolf Pack,K. Borden,4900574,,False,9.0,0,2,0,1,0,1,0,0,0,1,1,1,0,0,0,0,0
401409269,Nevada Wolf Pack,A. Roden,4900573,,False,12.0,2,3,2,2,0,1,0,0,1,4,5,0,0,0,1,2,4
401409269,Nevada Wolf Pack,K. Holt,4704503,,False,26.0,1,3,1,3,0,0,0,0,2,1,3,1,0,0,2,2,2
401409269,Nevada Wolf Pack,TEAM,TOTAL,TOTAL,False,,24,59,20,46,4,13,8,10,12,20,32,7,3,4,12,15,60
401409269,Air Force Falcons,R. Snyder,4399409,,True,34.0,6,10,3,5,3,5,2,2,0,0,0,3,1,0,1,0,17
401409269,Air Force Falcons,H. Jones,4399403,,True,22.0,2,4,2,4,0,0,3,4,0,6,6,1,0,0,0,3,7
401409269,Air Force Falcons,J. Huntimer,4899763,,True,32.0,1,2,1,1,0,1,0,0,0,3,3,5,2,0,1,2,2
401409269,Air Force Falcons,K. Heath,4595614,,True,23.0,5,11,5,11,0,0,1,1,2,2,4,2,0,0,1,1,11
401409269,Air Force Falcons,C. Winters,4399406,,True,33.0,7,16,6,13,1,3,2,2,2,8,10,3,2,1,3,3,17
401409269,Air Force Falcons,N. McDonald,4595618,,False,19.0,4,4,1,1,3,3,0,0,0,2,2,0,0,0,0,1,11
401409269,Air Force Falcons,L. McDonald,4899761,,False,16.0,1,3,0,1,1,2,0,0,0,3,3,1,0,0,1,1,3
401409269,Air Force Falcons,K. Pilson,4704411,,False,7.0,0,0,0,0,0,0,0,0,1,1,2,1,0,0,0,2,0
401409269,Air Force Falcons,B. Autrey-Thompson,4399404,,False,14.0,2,5,1,3,1,2,2,2,0,0,0,3,0,0,2,1,7
401409269,Air Force Falcons,TEAM,TOTAL,TOTAL,False,,28,55,19,39,9,16,10,11,8,25,33,19,5,1,11,14,75
401409268,Utah State Aggies,A. Quezada,4595256,,True,31.0,10,15,9,13,1,2,5,7,3,3,6,1,1,1,0,3,26
401409268,Utah State Aggies,E. Stafford,4400222,,True,33.0,6,17,5,8,1,9,0,0,2,6,8,4,0,2,2,3,13
401409268,Utah State Aggies,K. Randhawa,4400486,,True,30.0,0,6,0,4,0,2,0,0,3,2,5,2,0,0,3,2,0
401409268,Utah State Aggies,S. Latone,4399209,,True,32.0,3,11,1,5,2,6,0,0,1,4,5,5,2,0,2,0,8
401409268,Utah State Aggies,E. Harris,4281891,,True,37.0,2,9,0,1,2,8,2,2,0,1,1,1,1,0,4,2,8
401409268,Utah State Aggies,L. Hawthorne,4282342,,False,12.0,1,5,1,5,0,0,0,0,0,4,4,1,1,1,3,2,2
401409268,Utah State Aggies,T. Franson,4281892,,False,4.0,0,0,0,0,0,0,0,0,2,1,3,0,0,0,0,0,0
401409268,Utah State Aggies,O. Wikstrom,4705488,,False,2.0,0,0,0,0,0,0,0,0,0,0,0,0,0,0,0,0,0
401409268,Utah State Aggies,M. Mensah,4705051,,False,15.0,2,4,2,3,0,1,2,2,3,1,4,1,0,0,1,0,6
401409268,Utah State Aggies,K. Falslev,4704648,,False,3.0,2,2,0,0,2,2,0,0,0,0,0,0,0,0,0,0,6
401409268,Utah State Aggies,K. Kamakawiwo'ole,4595670,,False,1.0,0,0,0,0,0,0,0,0,0,0,0,0,0,0,0,0,0
401409268,Utah State Aggies,TEAM,TOTAL,TOTAL,False,,26,69,18,39,8,30,9,11,18,23,41,15,5,4,15,12,69
401409268,UNLV Lady Rebels,K. Rooks,4282188,,True,30.0,5,8,4,5,1,3,0,0,0,4,4,3,0,1,2,1,11
401409268,UNLV Lady Rebels,D. Young,4704625,,True,26.0,4,10,4,10,0,0,4,6,3,5,8,5,0,3,5,4,12
401409268,UNLV Lady Rebels,A. Durazo-Frescas,4683009,,True,20.0,3,8,0,1,3,7,0,0,1,1,2,0,0,0,1,1,9
401409268,UNLV Lady Rebels,J. Ethridge,4400144,,True,33.0,4,11,4,9,0,2,3,3,2,2,4,2,0,0,0,0,11
401409268,UNLV Lady Rebels,E. Booker,4400133,,True,33.0,5,11,5,10,0,1,0,1,0,5,5,5,2,1,1,4,10
401409268,UNLV Lady Rebels,N. Obiazor,4705419,,False,24.0,8,13,8,13,0,0,4,4,7,2,9,1,2,1,2,3,20
401409268,UNLV Lady Rebels,K. Jackson,4900597,,False,27.0,4,8,3,7,1,1,0,1,0,3,3,3,2,0,1,0,9
401409268,UNLV Lady Rebels,K. Winfrey,4900596,,False,7.0,0,0,0,0,0,0,0,0,0,1,1,2,0,0,0,1,0
401409268,UNLV Lady Rebels,TEAM,TOTAL,TOTAL,False,,33,69,28,55,5,14,11,15,17,26,43,21,6,6,12,14,82
401409267,San José State Spartans,C. Lewis,4281885,,True,32.0,4,11,2,9,2,2,0,0,0,6,6,1,1,0,0,0,10
401409267,San José State Spartans,D. Ross,4281364,,True,26.0,1,5,1,2,0,3,0,0,0,2,2,0,0,0,1,2,2
401409267,San José State Spartans,M. Oberg,4068575,,True,38.0,1,7,1,4,0,3,0,0,5,4,9,3,2,0,3,0,2
401409267,San José State Spartans,E. Ogier,4595792,,True,26.0,6,18,5,11,1,7,3,3,2,3,5,2,0,0,0,1,16
401409267,San José State Spartans,A. Gaulden,4065829,,True,28.0,0,7,0,5,0,2,1,2,0,6,6,2,2,0,0,2,1
401409267,San José State Spartans,S. Torres,4900594,,False,21.0,1,5,1,2,0,3,3,3,2,1,3,0,1,0,2,1,5
401409267,San José State Spartans,S. Richards,4900590,,False,13.0,1,6,1,4,0,2,0,0,2,1,3,1,0,0,2,2,2
401409267,San José State Spartans,A. Mendez,4704578,,False,10.0,1,4,0,1,1,3,0,0,2,0,2,0,0,0,1,2,3
401409267,San José State Spartans,S. Jones,4433780,,False,6.0,1,4,1,2,0,2,0,2,0,1,1,0,1,0,1,0,2
401409267,San José State Spartans,TEAM,TOTAL,TOTAL,False,,16,67,12,40,4,27,7,10,15,24,39,9,7,0,14,10,43
401409267,Colorado State Rams,K. Kinzer,4595630,,True,31.0,4,6,1,1,3,5,0,0,0,6,6,2,0,2,2,1,11
401409267,Colorado State Rams,K. Murphy,4068969,,True,23.0,4,6,4,6,0,0,0,0,0,7,7,0,2,0,0,1,8
401409267,Colorado State Rams,S. Mech,4399658,,True,29.0,6,9,4,6,2,3,0,0,2,2,4,0,0,2,0,0,14
401409267,Colorado State Rams,M. Hofschild,4595160,,True,31.0,6,12,6,11,0,1,4,4,0,6,6,8,0,0,4,0,16
401409267,Colorado State Rams,U. Atosu,4594809,,True,31.0,5,12,2,7,3,5,4,4,0,3,3,3,1,1,1,3,17
401409267,Colorado State Rams,C. Gomez,4899769,,False,8.0,0,1,0,1,0,0,0,0,1,2,3,1,0,0,0,1,0
401409267,Colorado State Rams,J. Moors,4899768,,False,4.0,0,0,0,0,0,0,0,0,0,2,2,0,0,0,0,0,0
401409267,Colorado State Rams,C. Clark,4704464,,False,14.0,2,3,2,3,0,0,1,2,1,4,5,1,0,1,2,2,5
401409267,Colorado State Rams,A. Prim,4899770,,False,9.0,1,3,1,2,0,1,2,2,0,2,2,2,1,0,0,0,4
401409267,Colorado State Rams,M. Hemingway,4704465,,False,4.0,0,1,0,1,0,0,0,0,0,1,1,0,0,0,0,0,0
401409267,Colorado State Rams,P. Farkas,4704463,,False,12.0,2,5,1,1,1,4,2,2,0,1,1,2,2,0,0,0,7
401409267,Colorado State Rams,B. Alper,4595629,,False,4.0,0,1,0,1,0,0,0,0,0,0,0,0,0,0,0,0,0
401409267,Colorado State Rams,TEAM,TOTAL,TOTAL,False,,30,59,21,40,9,19,13,14,5,37,42,19,6,6,10,8,82
401409266,San Diego State Aztecs,M. Adams,4400169,,True,37.0,4,12,2,6,2,6,2,2,0,6,6,0,0,0,0,1,12
401409266,San Diego State Aztecs,K. Pepe,4691705,,True,17.0,2,4,2,4,0,0,1,1,3,1,4,0,2,0,0,1,5
401409266,San Diego State Aztecs,A. Avinger,4433748,,True,36.0,7,13,7,13,0,0,4,10,0,1,1,5,2,0,2,2,18
401409266,San Diego State Aztecs,S. Ramos,4400168,,True,38.0,3,10,3,7,0,3,5,6,1,9,10,6,2,0,6,4,11
401409266,San Diego State Aztecs,M. Staples,4398925,,True,37.0,4,9,2,6,2,3,1,4,0,6,6,1,2,0,1,1,11
401409266,San Diego State Aztecs,K. Villalobos,4704565,,False,19.0,3,6,3,6,0,0,0,0,2,2,4,1,1,0,1,4,6
401409266,San Diego State Aztecs,K. Edwards,4281879,,False,6.0,1,3,1,3,0,0,0,0,1,0,1,0,0,0,1,1,2
401409266,San Diego State Aztecs,I. Hernandez,4595647,,False,5.0,0,0,0,0,0,0,0,0,0,0,0,0,0,0,0,0,0
401409266,San Diego State Aztecs,A. Crain,4399223,,False,3.0,0,0,0,0,0,0,0,0,0,0,0,0,0,0,2,0,0
401409266,San Diego State Aztecs,TEAM,TOTAL,TOTAL,False,,24,57,20,45,4,12,13,23,9,28,37,13,9,0,14,14,65
401409266,Boise State Broncos,E. Lalotte,4705630,,True,25.0,4,8,4,8,0,0,2,6,1,10,11,0,0,0,4,3,10
401409266,Boise State Broncos,A. Muse,4583056,,True,29.0,2,6,2,6,0,0,0,0,0,8,8,2,0,2,2,3,4
401409266,Boise State Broncos,A. Ostlie,4705626,,True,32.0,5,10,2,2,3,8,2,3,1,1,2,2,1,0,2,4,15
401409266,Boise State Broncos,M. Naro,4705625,,True,32.0,5,13,4,8,1,5,0,0,0,4,4,3,0,0,3,1,11
401409266,Boise State Broncos,D. Leonidas,4281393,,True,31.0,3,9,3,8,0,1,2,3,2,3,5,3,1,0,1,3,8
401409266,Boise State Broncos,T. Hull,4899757,,False,17.0,1,2,1,2,0,0,0,0,0,2,2,0,1,2,1,3,2
401409266,Boise State Broncos,R. Bowers,4400536,,False,9.0,0,3,0,1,0,2,1,2,1,0,1,1,0,1,2,1,1
401409266,Boise State Broncos,J. Clark,4899758,,False,12.0,1,2,1,1,0,1,0,0,0,1,1,1,3,0,0,0,2
401409266,Boise State Broncos,L. Lovrovich,4899753,,False,11.0,1,2,1,2,0,0,1,2,1,1,2,0,0,0,1,0,3
401409266,Boise State Broncos,TEAM,TOTAL,TOTAL,False,,22,55,18,38,4,17,8,16,7,30,37,12,6,5,17,18,56
401409265,Utah State Aggies,A. Quezada,4595256,,True,29.0,8,16,8,15,0,1,0,0,3,3,6,0,3,0,3,3,16
401409265,Utah State Aggies,E. Stafford,4400222,,True,32.0,4,9,4,6,0,3,0,0,2,11,13,3,0,0,1,4,8
401409265,Utah State Aggies,K. Randhawa,4400486,,True,33.0,3,13,1,7,2,6,7,7,5,5,10,6,0,0,2,3,15
401409265,Utah State Aggies,S. Latone,4399209,,True,32.0,7,14,1,3,6,11,6,6,4,4,8,4,0,0,2,1,26
401409265,Utah State Aggies,E. Harris,4281891,,True,35.0,0,6,0,1,0,5,2,2,0,1,1,7,0,0,1,4,2
401409265,Utah State Aggies,L. Hawthorne,4282342,,False,18.0,3,7,3,7,0,0,7,7,0,2,2,0,1,2,0,2,13
401409265,Utah State Aggies,T. Franson,4281892,,False,1.0,0,1,0,1,0,0,0,0,1,0,1,0,0,0,0,0,0
401409265,Utah State Aggies,M. Mensah,4705051,,False,20.0,0,4,0,4,0,0,0,0,1,0,1,0,0,0,0,1,0
401409265,Utah State Aggies,TEAM,TOTAL,TOTAL,False,,25,70,17,44,8,26,22,22,18,28,46,20,4,2,9,18,80
401409265,Fresno State Bulldogs,W. Motta,4595631,,True,25.0,3,9,3,9,0,0,2,8,3,6,9,0,1,0,3,5,8
401409265,Fresno State Bulldogs,I. Lacy,4400136,,True,28.0,6,13,6,10,0,3,2,3,1,5,6,1,0,1,0,3,14
401409265,Fresno State Bulldogs,A. Book,4400031,,True,37.0,2,7,0,1,2,6,1,2,0,2,2,1,2,0,0,0,7
401409265,Fresno State Bulldogs,Hal. Cavinder,4433658,,True,40.0,7,19,3,12,4,7,3,3,2,5,7,6,2,0,2,3,21
401409265,Fresno State Bulldogs,Han. Cavinder,4433372,,True,31.0,5,11,4,9,1,2,3,3,0,1,1,5,0,0,3,5,14
401409265,Fresno State Bulldogs,T. Stricklin,4900571,,False,7.0,1,1,0,0,1,1,0,0,0,1,1,0,0,0,0,0,3
401409265,Fresno State Bulldogs,S. Dethman,4900569,,False,0.0,0,0,0,0,0,0,0,0,0,0,0,0,0,0,1,0,0
401409265,Fresno State Bulldogs,J. Peterson,4900570,,False,19.0,4,6,4,6,0,0,0,0,3,2,5,1,0,0,2,5,8
401409265,Fresno State Bulldogs,D. Dunn,4433511,,False,13.0,0,0,0,0,0,0,0,0,0,0,0,0,0,0,0,0,0
401409265,Fresno State Bulldogs,TEAM,TOTAL,TOTAL,False,,28,66,20,47,8,19,11,19,14,27,41,14,5,1,11,22,75
401409264,Buffalo Bulls,L. Christie,4595235,,True,14.0,0,0,0,0,0,0,1,2,1,2,3,0,0,0,1,1,1
401409264,Buffalo Bulls,S. Hemphill,4068803,,True,37.0,2,7,2,7,0,0,3,4,5,8,13,0,1,2,1,2,7
401409264,Buffalo Bulls,G. Woolley,4899639,,True,34.0,11,17,8,12,3,5,4,4,0,4,4,0,1,0,4,3,29
401409264,Buffalo Bulls,D. Camp,4704065,,True,35.0,2,7,2,5,0,2,0,0,0,0,0,5,2,0,2,0,4
401409264,Buffalo Bulls,D. Fair,4595236,,True,40.0,9,21,5,12,4,9,8,8,0,2,2,6,3,0,2,0,30
401409264,Buffalo Bulls,A. Adeyeye,4399304,,False,29.0,1,6,1,6,0,0,0,0,5,7,12,0,3,0,0,3,2
401409264,Buffalo Bulls,J. Young,4400441,,False,11.0,2,5,1,4,1,1,1,1,0,4,4,0,0,0,0,1,6
401409264,Buffalo Bulls,TEAM,TOTAL,TOTAL,False,,27,63,19,46,8,17,17,19,13,29,42,11,10,2,11,10,79
401409264,Ball State Cardinals,M. Kiefer,4900612,,True,20.0,1,7,1,3,0,4,0,0,1,5,6,1,1,2,2,1,2
401409264,Ball State Cardinals,T. Dis Agustsdottir,4399285,,True,40.0,7,17,1,2,6,15,0,0,0,0,0,3,1,0,1,1,20
401409264,Ball State Cardinals,C. Latimer,4281480,,True,27.0,3,6,3,6,0,0,0,0,2,1,3,2,1,0,1,4,6
401409264,Ball State Cardinals,A. Becki,4900609,,True,37.0,5,12,2,4,3,8,7,8,3,6,9,7,2,1,2,4,20
401409264,Ball State Cardinals,S. Freeman,4595285,,True,37.0,5,13,4,10,1,3,0,0,1,2,3,4,1,0,6,3,11
401409264,Ball State Cardinals,A. Rauch,4595288,,False,20.0,5,9,5,9,0,0,2,3,1,5,6,0,0,0,0,3,12
401409264,Ball State Cardinals,I. Subirats,4705355,,False,15.0,0,2,0,2,0,0,1,2,0,0,0,1,0,0,0,1,1
401409264,Ball State Cardinals,M. Bischoff,4900614,,False,4.0,1,1,0,0,1,1,0,0,0,0,0,0,0,0,0,1,3
401409264,Ball State Cardinals,TEAM,TOTAL,TOTAL,False,,27,67,16,36,11,31,10,13,11,23,34,18,6,3,12,18,75
401409263,Toledo Rockets,J. Cook,4900087,,True,18.0,1,5,1,5,0,0,2,2,2,2,4,0,1,0,1,2,4
401409263,Toledo Rockets,S. Mikonowicz,4705387,,True,38.0,3,10,3,9,0,1,3,4,1,2,3,1,2,1,1,4,9
401409263,Toledo Rockets,K. Goss,4705386,,True,27.0,4,6,3,3,1,3,0,0,1,2,3,1,0,0,0,2,9
401409263,Toledo Rockets,Q. Lockett,4595303,,True,39.0,6,16,6,13,0,3,2,8,2,3,5,4,1,0,5,2,14
401409263,Toledo Rockets,S. Wiard,4595301,,True,40.0,5,13,3,10,2,3,4,5,0,7,7,2,2,0,3,4,16
401409263,Toledo Rockets,Y. Curry,4595305,,False,1.0,0,0,0,0,0,0,0,0,0,0,0,0,0,0,0,1,0
401409263,Toledo Rockets,H. Noveroske,4594772,,False,5.0,1,1,1,1,0,0,0,0,2,1,3,0,0,0,1,1,2
401409263,Toledo Rockets,J. Jansen,4900086,,False,16.0,1,3,0,1,1,2,0,0,0,0,0,0,0,0,0,2,3
401409263,Toledo Rockets,N. Garcia,4703763,,False,16.0,3,5,2,2,1,3,2,2,1,4,5,0,1,0,1,1,9
401409263,Toledo Rockets,TEAM,TOTAL,TOTAL,False,,24,59,19,44,5,15,13,21,11,27,38,8,7,1,13,19,66
401409263,Ball State Cardinals,M. Kiefer,4900612,,True,17.0,5,8,4,7,1,1,1,1,0,3,3,0,1,1,0,4,12
401409263,Ball State Cardinals,T. Dis Agustsdottir,4399285,,True,40.0,1,7,1,4,0,3,0,0,0,4,4,1,1,2,3,0,2
401409263,Ball State Cardinals,C. Latimer,4281480,,True,28.0,2,3,2,3,0,0,4,6,0,3,3,0,0,0,3,3,8
401409263,Ball State Cardinals,A. Becki,4900609,,True,29.0,4,6,3,3,1,3,3,4,0,6,6,6,2,0,2,4,12
401409263,Ball State Cardinals,S. Freeman,4595285,,True,38.0,7,16,5,10,2,6,3,4,0,2,2,4,1,0,1,1,19
401409263,Ball State Cardinals,A. Rauch,4595288,,False,22.0,2,5,2,5,0,0,4,5,2,4,6,0,0,0,0,2,8
401409263,Ball State Cardinals,J. Turner,4900613,,False,1.0,0,0,0,0,0,0,0,0,0,0,0,0,0,0,0,0,0
401409263,Ball State Cardinals,I. Subirats,4705355,,False,12.0,2,3,2,3,0,0,1,1,0,0,0,0,0,0,0,4,5
401409263,Ball State Cardinals,E. Puiggros,4595287,,False,13.0,2,5,1,3,1,2,0,0,0,2,2,1,2,0,1,1,5
401409263,Ball State Cardinals,TEAM,TOTAL,TOTAL,False,,25,53,20,38,5,15,16,21,3,27,30,12,7,3,12,19,71
401409262,Buffalo Bulls,L. Christie,4595235,,True,19.0,0,2,0,2,0,0,0,0,1,5,6,1,0,1,2,3,0
401409262,Buffalo Bulls,S. Hemphill,4068803,,True,32.0,1,6,1,6,0,0,3,4,6,6,12,3,3,3,3,1,5
401409262,Buffalo Bulls,G. Woolley,4899639,,True,33.0,8,15,7,11,1,4,3,3,2,1,3,1,2,0,3,0,20
401409262,Buffalo Bulls,D. Camp,4704065,,True,29.0,2,7,0,5,2,2,0,0,1,1,2,1,1,0,3,0,6
401409262,Buffalo Bulls,D. Fair,4595236,,True,35.0,12,20,8,12,4,8,0,0,0,5,5,6,4,0,1,0,28
401409262,Buffalo Bulls,S. Wilson,4433553,,False,6.0,1,2,1,2,0,0,2,2,0,0,0,0,0,0,1,0,4
401409262,Buffalo Bulls,A. Adeyeye,4399304,,False,22.0,5,5,5,5,0,0,3,4,1,7,8,0,2,1,0,3,13
401409262,Buffalo Bulls,N. Jordan,4595728,,False,3.0,0,2,0,2,0,0,0,0,0,0,0,0,0,0,0,0,0
401409262,Buffalo Bulls,E. Gaba,4595238,,False,3.0,0,0,0,0,0,0,0,0,0,1,1,0,0,0,1,0,0
401409262,Buffalo Bulls,C. Valenti-Paea,4711744,,False,5.0,0,0,0,0,0,0,0,0,1,0,1,0,1,0,0,0,0
401409262,Buffalo Bulls,J. Young,4400441,,False,13.0,3,4,3,4,0,0,0,0,1,1,2,0,1,0,0,0,6
401409262,Buffalo Bulls,TEAM,TOTAL,TOTAL,False,,32,63,25,49,7,14,11,13,15,29,44,12,14,5,15,7,82
401409262,Akron Zips,R. Bass,4899611,,True,28.0,4,8,4,8,0,0,4,4,2,4,6,0,0,1,5,2,12
401409262,Akron Zips,L. Brewer,4595218,,True,18.0,1,4,1,3,0,1,2,2,2,2,4,0,1,1,2,2,4
401409262,Akron Zips,J. Dawson,4281369,,True,29.0,6,15,5,13,1,2,2,2,1,4,5,2,3,0,3,3,15
401409262,Akron Zips,A. Corcoran,4595282,,True,14.0,0,2,0,1,0,1,0,0,0,1,1,0,1,0,1,2,0
401409262,Akron Zips,L. Ferrell,4595221,,True,27.0,0,8,0,2,0,6,0,0,2,1,3,2,2,0,1,2,0
401409262,Akron Zips,C. Neitzel,4399282,,False,3.0,0,1,0,0,0,1,0,0,0,0,0,0,0,0,1,0,0
401409262,Akron Zips,M. Neitzel,4595220,,False,14.0,3,5,3,5,0,0,0,0,1,1,2,0,0,0,0,2,6
401409262,Akron Zips,Z. Rasheed,4899610,,False,8.0,0,2,0,0,0,2,0,0,1,0,1,0,0,0,2,0,0
401409262,Akron Zips,Al. Carter,4704834,,False,17.0,0,2,0,2,0,0,0,2,4,0,4,0,0,0,2,0,0
401409262,Akron Zips,R. Martindale,4595219,,False,16.0,1,5,1,1,0,4,2,2,0,0,0,0,0,0,1,1,4
401409262,Akron Zips,E. Tecca,4595217,,False,3.0,0,2,0,1,0,1,0,0,1,1,2,0,0,0,0,0,0
401409262,Akron Zips,K. Miller,4399280,,False,23.0,1,8,1,7,0,1,0,0,0,0,0,2,0,0,0,0,2
401409262,Akron Zips,TEAM,TOTAL,TOTAL,False,,16,62,15,43,1,19,10,12,18,15,33,6,7,2,18,14,43
401409261,Toledo Rockets,J. Cook,4900087,,True,28.0,4,7,4,7,0,0,0,0,1,9,10,0,1,1,0,1,8
401409261,Toledo Rockets,S. Mikonowicz,4705387,,True,38.0,3,9,1,4,2,5,3,4,3,6,9,1,0,1,1,2,11
401409261,Toledo Rockets,K. Goss,4705386,,True,31.0,4,7,2,3,2,4,0,0,2,1,3,4,0,1,2,3,10
401409261,Toledo Rockets,Q. Lockett,4595303,,True,27.0,6,13,6,9,0,4,7,9,1,4,5,1,1,0,2,3,19
401409261,Toledo Rockets,S. Wiard,4595301,,True,40.0,7,12,6,10,1,2,4,6,2,7,9,10,0,0,1,1,19
401409261,Toledo Rockets,Y. Curry,4595305,,False,2.0,0,2,0,2,0,0,0,0,1,0,1,0,0,0,0,0,0
401409261,Toledo Rockets,J. Jansen,4900086,,False,25.0,3,6,1,1,2,5,1,2,0,0,0,1,1,1,0,4,9
401409261,Toledo Rockets,N. Garcia,4703763,,False,9.0,2,4,2,4,0,0,0,0,1,2,3,0,0,1,0,2,4
401409261,Toledo Rockets,TEAM,TOTAL,TOTAL,False,,29,60,22,40,7,20,15,21,12,34,46,17,3,5,8,16,80
401409261,Ohio Bobcats,G. Burris,4282121,,True,38.0,5,13,2,5,3,8,0,0,1,4,5,0,0,0,0,2,13
401409261,Ohio Bobcats,E. Johnson,4282118,,True,38.0,8,22,4,10,4,12,5,6,2,6,8,1,0,0,0,2,25
401409261,Ohio Bobcats,M. Mace,4613137,,True,25.0,2,3,2,2,0,1,1,2,0,2,2,0,0,0,2,5,5
401409261,Ohio Bobcats,K. Bambule,4282120,,True,26.0,0,2,0,0,0,2,0,0,0,0,0,0,0,0,0,2,0
401409261,Ohio Bobcats,C. Hooks,4282117,,True,39.0,9,25,9,24,0,1,4,10,6,5,11,2,3,0,5,4,22
401409261,Ohio Bobcats,Y. Felder,4900084,,False,14.0,0,2,0,2,0,0,0,0,0,1,1,0,0,0,0,2,0
401409261,Ohio Bobcats,K. Dennis,4710736,,False,1.0,0,0,0,0,0,0,0,0,0,0,0,0,0,0,0,0,0
401409261,Ohio Bobcats,P. Guice,4433665,,False,19.0,1,1,1,1,0,0,0,0,1,1,2,1,0,1,1,1,2
401409261,Ohio Bobcats,TEAM,TOTAL,TOTAL,False,,25,68,18,44,7,24,10,18,15,22,37,4,3,1,8,18,67
401409260,Northern Illinois Huskies,A. Davis,4595300,,True,38.0,6,7,6,7,0,0,5,6,2,9,11,4,1,1,6,1,17
401409260,Northern Illinois Huskies,M. Brandon,4399339,,True,33.0,1,3,1,1,0,2,0,0,0,6,6,0,0,1,5,4,2
401409260,Northern Illinois Huskies,J. Marable,4705368,,True,33.0,6,14,5,13,1,1,1,1,0,4,4,0,0,0,3,5,14
401409260,Northern Illinois Huskies,N. Ahart,4280999,,True,36.0,2,8,0,3,2,5,0,0,1,4,5,0,0,0,1,2,6
401409260,Northern Illinois Huskies,J. Poisson,4069124,,True,40.0,5,16,2,6,3,10,0,0,2,3,5,1,1,0,2,0,13
401409260,Northern Illinois Huskies,E. Meinert,4705369,,False,9.0,0,0,0,0,0,0,0,0,0,0,0,1,0,0,1,2,0
401409260,Northern Illinois Huskies,S. McCrea,4705367,,False,8.0,1,3,1,1,0,2,0,0,0,1,1,0,1,0,1,0,2
401409260,Northern Illinois Huskies,E. Hodges,4282143,,False,2.0,0,0,0,0,0,0,0,0,0,0,0,0,0,0,0,0,0
401409260,Northern Illinois Huskies,P. Castro,4069126,,False,1.0,0,0,0,0,0,0,0,0,0,0,0,0,0,0,0,0,0
401409260,Northern Illinois Huskies,TEAM,TOTAL,TOTAL,False,,21,51,15,31,6,20,6,7,8,30,38,6,3,2,19,14,54
401409260,Ball State Cardinals,M. Kiefer,4900612,,True,18.0,1,1,1,1,0,0,0,0,1,4,5,0,0,0,1,2,2
401409260,Ball State Cardinals,T. Dis Agustsdottir,4399285,,True,40.0,3,13,0,1,3,12,1,2,2,1,3,2,2,0,1,1,10
401409260,Ball State Cardinals,C. Latimer,4281480,,True,17.0,3,6,3,5,0,1,3,4,0,4,4,2,0,0,3,3,9
401409260,Ball State Cardinals,A. Becki,4900609,,True,38.0,4,7,1,1,3,6,4,4,2,3,5,2,4,1,1,1,15
401409260,Ball State Cardinals,S. Freeman,4595285,,True,33.0,4,10,2,5,2,5,0,0,0,3,3,5,3,1,1,3,10
401409260,Ball State Cardinals,A. Rauch,4595288,,False,21.0,0,7,0,7,0,0,2,2,3,3,6,0,2,0,1,2,2
401409260,Ball State Cardinals,I. Subirats,4705355,,False,9.0,0,2,0,1,0,1,0,0,0,1,1,0,0,0,2,1,0
401409260,Ball State Cardinals,E. Puiggros,4595287,,False,24.0,5,11,3,5,2,6,0,0,0,3,3,1,2,1,0,1,12
401409260,Ball State Cardinals,TEAM,TOTAL,TOTAL,False,,20,57,10,26,10,31,10,12,9,22,31,12,13,3,10,14,60
401409259,Western Michigan Broncos,T. Williams,4595309,,True,23.0,4,12,4,11,0,1,5,6,2,8,10,0,1,0,2,2,13
401409259,Western Michigan Broncos,R. Jacobson,4069024,,True,28.0,3,10,3,8,0,2,1,3,3,7,10,1,1,1,0,2,7
401409259,Western Michigan Broncos,L. Ross,4705393,,True,22.0,0,9,0,6,0,3,2,2,0,5,5,0,0,0,1,2,2
401409259,Western Michigan Broncos,M. Wagner,4705392,,True,23.0,2,6,1,1,1,5,0,0,0,2,2,1,1,0,4,2,5
401409259,Western Michigan Broncos,H. Spitzley,4705390,,True,25.0,2,3,2,2,0,1,0,0,0,2,2,1,1,2,1,1,4
401409259,Western Michigan Broncos,H. Douglas,4407901,,False,1.0,0,1,0,0,0,1,3,4,1,0,1,0,0,0,0,0,3
401409259,Western Michigan Broncos,A. Voss,4399498,,False,11.0,0,0,0,0,0,0,0,0,0,0,0,1,1,0,1,1,0
401409259,Western Michigan Broncos,L. Audino,4712323,,False,3.0,1,1,1,1,0,0,0,0,1,1,2,0,0,0,0,0,2
401409259,Western Michigan Broncos,G. Saxman,4705391,,False,17.0,1,4,1,3,0,1,0,0,0,0,0,0,0,0,1,1,2
401409259,Western Michigan Broncos,S. Shafer,4595307,,False,23.0,3,8,1,4,2,4,0,0,0,1,1,0,2,0,3,2,8
401409259,Western Michigan Broncos,M. Watters,4399362,,False,21.0,1,5,0,0,1,5,0,0,0,1,1,0,0,0,1,1,3
401409259,Western Michigan Broncos,K. Brooks,4282152,,False,3.0,0,1,0,0,0,1,0,0,1,0,1,0,1,0,0,0,0
401409259,Western Michigan Broncos,TEAM,TOTAL,TOTAL,False,,17,60,13,36,4,24,11,15,10,28,38,4,8,3,18,14,49
401409259,Buffalo Bulls,L. Christie,4595235,,True,21.0,4,8,3,7,1,1,0,0,1,5,6,0,0,0,0,3,9
401409259,Buffalo Bulls,S. Hemphill,4068803,,True,31.0,2,7,2,7,0,0,1,2,6,7,13,0,0,0,4,2,5
401409259,Buffalo Bulls,G. Woolley,4899639,,True,36.0,3,10,3,10,0,0,0,0,0,2,2,2,0,0,4,1,6
401409259,Buffalo Bulls,D. Camp,4704065,,True,22.0,4,11,3,8,1,3,1,2,1,1,2,1,1,0,2,1,10
401409259,Buffalo Bulls,D. Fair,4595236,,True,35.0,9,17,8,13,1,4,0,0,1,5,6,5,3,0,0,0,19
401409259,Buffalo Bulls,S. Wilson,4433553,,False,10.0,1,2,1,2,0,0,0,0,2,5,7,0,0,0,1,1,2
401409259,Buffalo Bulls,A. Adeyeye,4399304,,False,12.0,0,2,0,2,0,0,0,0,1,3,4,0,1,0,0,5,0
401409259,Buffalo Bulls,N. Jordan,4595728,,False,3.0,0,0,0,0,0,0,0,0,0,0,0,0,0,0,1,0,0
401409259,Buffalo Bulls,E. Gaba,4595238,,False,5.0,1,3,1,3,0,0,0,0,0,1,1,0,0,0,2,2,2
401409259,Buffalo Bulls,C. Valenti-Paea,4711744,,False,3.0,0,0,0,0,0,0,0,0,0,1,1,0,1,0,1,0,0
401409259,Buffalo Bulls,J. Young,4400441,,False,22.0,5,8,5,7,0,1,0,1,0,1,1,1,4,0,1,2,10
401409259,Buffalo Bulls,TEAM,TOTAL,TOTAL,False,,29,68,26,59,3,9,2,5,13,33,46,9,10,0,16,17,63
401409258,Bowling Green Falcons,K. Hempfling,4399299,,True,25.0,5,7,2,3,3,4,2,2,0,3,3,2,4,0,4,5,15
401409258,Bowling Green Falcons,A. Velasco,4899612,,True,35.0,7,15,4,10,3,5,2,4,0,5,5,0,1,1,2,3,19
401409258,Bowling Green Falcons,K. Lewis,4704866,,True,27.0,1,3,1,3,0,0,2,2,2,3,5,1,1,0,2,0,4
401409258,Bowling Green Falcons,N. Hampton,4704864,,True,36.0,2,8,2,7,0,1,1,1,1,1,2,4,1,0,1,1,5
401409258,Bowling Green Falcons,E. Brett,4595223,,True,32.0,5,15,3,8,2,7,3,4,0,5,5,3,2,0,3,3,15
401409258,Bowling Green Falcons,O. Hill,4704865,,False,2.0,0,0,0,0,0,0,1,2,0,0,0,0,0,0,0,1,1
401409258,Bowling Green Falcons,S. Dziekan,4704863,,False,7.0,1,1,1,1,0,0,0,0,1,0,1,0,0,0,1,3,2
401409258,Bowling Green Falcons,J. Tate,4899613,,False,14.0,0,2,0,2,0,0,0,0,1,2,3,2,1,0,2,2,0
401409258,Bowling Green Falcons,M. Sharps,4595176,,False,5.0,1,1,1,1,0,0,0,0,0,0,0,0,0,0,0,1,2
401409258,Bowling Green Falcons,M. Parker,4282037,,False,17.0,1,3,1,1,0,2,2,2,0,1,1,0,0,0,0,2,4
401409258,Bowling Green Falcons,TEAM,TOTAL,TOTAL,False,,23,55,15,36,8,19,13,17,7,21,28,12,10,1,17,21,67
401409258,Akron Zips,R. Bass,4899611,,True,28.0,6,7,6,7,0,0,4,7,1,2,3,1,0,1,3,2,16
401409258,Akron Zips,L. Brewer,4595218,,True,23.0,4,11,4,10,0,1,3,4,3,5,8,2,0,1,1,3,11
401409258,Akron Zips,J. Dawson,4281369,,True,40.0,9,22,7,18,2,4,2,2,2,5,7,4,6,1,1,2,22
401409258,Akron Zips,A. Corcoran,4595282,,True,15.0,0,1,0,0,0,1,0,0,0,2,2,1,0,0,5,2,0
401409258,Akron Zips,L. Ferrell,4595221,,True,36.0,4,5,2,3,2,2,4,5,0,4,4,1,1,1,2,1,14
401409258,Akron Zips,R. Martindale,4595219,,False,24.0,2,5,1,3,1,2,4,6,1,5,6,0,1,0,1,2,9
401409258,Akron Zips,K. Miller,4399280,,False,34.0,4,5,4,5,0,0,1,1,1,3,4,1,0,0,1,1,9
401409258,Akron Zips,TEAM,TOTAL,TOTAL,False,,29,56,24,46,5,10,18,25,10,26,36,10,8,4,15,13,81
401409257,Louisiana Tech Lady Techsters,A. Roberson,4595004,,True,35.0,8,16,8,16,0,0,1,2,2,9,11,1,1,1,3,2,17
401409257,Louisiana Tech Lady Techsters,A. Brannon,4899084,,True,37.0,3,5,2,3,1,2,1,2,0,2,2,0,1,0,0,4,8
401409257,Louisiana Tech Lady Techsters,S. Nativi,4899083,,True,15.0,0,2,0,1,0,1,0,0,0,1,1,1,0,0,3,1,0
401409257,Louisiana Tech Lady Techsters,S. Bates,4433173,,True,39.0,4,8,3,6,1,2,1,1,0,1,1,1,1,0,2,3,10
401409257,Louisiana Tech Lady Techsters,K. Walker,4399516,,True,33.0,7,18,7,17,0,1,9,12,1,3,4,3,1,0,3,4,23
401409257,Louisiana Tech Lady Techsters,K. Thompson,4703773,,False,4.0,1,1,0,0,1,1,0,0,0,0,0,1,0,0,0,1,3
401409257,Louisiana Tech Lady Techsters,J. Davis,4281796,,False,1.0,0,0,0,0,0,0,0,0,0,0,0,0,0,0,1,1,0
401409257,Louisiana Tech Lady Techsters,A. Smith,4899081,,False,0.0,0,0,0,0,0,0,0,0,0,0,0,0,0,0,0,1,0
401409257,Louisiana Tech Lady Techsters,R. Lee,4704199,,False,14.0,0,0,0,0,0,0,0,0,0,1,1,1,0,0,0,5,0
401409257,Louisiana Tech Lady Techsters,L. Sant,4595003,,False,22.0,0,0,0,0,0,0,2,3,0,0,0,1,0,0,0,1,2
401409257,Louisiana Tech Lady Techsters,TEAM,TOTAL,TOTAL,False,,23,50,20,43,3,7,14,20,5,20,25,9,4,1,12,23,63
401409257,Charlotte 49ers,M. Williams,4704501,,True,25.0,0,2,0,1,0,1,2,4,2,5,7,1,2,1,1,3,2
401409257,Charlotte 49ers,K. McKinney,4280854,,True,37.0,1,3,1,2,0,1,1,2,2,5,7,1,0,1,2,3,3
401409257,Charlotte 49ers,J. McMillian,4399489,,True,39.0,6,15,6,14,0,1,6,9,1,5,6,1,0,0,2,4,18
401409257,Charlotte 49ers,O. Jett-Wilson,4399487,,True,37.0,8,11,5,7,3,4,12,13,1,3,4,0,3,0,2,4,31
401409257,Charlotte 49ers,M. Boykin,4281177,,True,37.0,3,12,2,9,1,3,1,2,2,3,5,4,3,1,2,2,8
401409257,Charlotte 49ers,A. Middleton,4594982,,False,4.0,1,2,1,2,0,0,0,2,2,0,2,0,0,0,0,0,2
401409257,Charlotte 49ers,J. Busick,4704499,,False,15.0,1,3,1,2,0,1,0,0,1,2,3,0,0,0,1,1,2
401409257,Charlotte 49ers,D. Lawrence,4594980,,False,6.0,1,2,1,2,0,0,0,0,1,0,1,0,0,0,1,0,2
401409257,Charlotte 49ers,TEAM,TOTAL,TOTAL,False,,21,50,17,39,4,11,22,32,13,25,38,7,8,3,14,17,68
401409256,Middle Tennessee Blue Raiders,C. Whitson,4595015,,True,39.0,5,12,0,3,5,9,2,2,0,4,4,3,0,0,0,5,17
401409256,Middle Tennessee Blue Raiders,A. Boldyreva,4899372,,True,9.0,1,2,1,2,0,0,1,2,1,0,1,1,0,0,1,0,3
401409256,Middle Tennessee Blue Raiders,J. Gregory,4899375,,True,40.0,4,13,2,2,2,11,0,0,0,4,4,0,2,0,1,4,10
401409256,Middle Tennessee Blue Raiders,Al. Whittington,4399524,,True,40.0,1,7,0,0,1,7,0,0,2,4,6,4,1,1,1,2,3
401409256,Middle Tennessee Blue Raiders,D. Saar,4281152,,True,38.0,7,11,1,3,6,8,0,0,0,3,3,4,1,0,3,3,20
401409256,Middle Tennessee Blue Raiders,K. Malashka,4399493,,False,31.0,7,14,6,12,1,2,0,0,2,3,5,1,0,2,0,5,15
401409256,Middle Tennessee Blue Raiders,C. Blakely,4899371,,False,3.0,2,2,2,2,0,0,0,0,0,0,0,0,0,0,0,0,4
401409256,Middle Tennessee Blue Raiders,Am. Whittington,4399525,,False,0.0,0,1,0,0,0,1,0,0,0,0,0,0,0,0,0,0,0
401409256,Middle Tennessee Blue Raiders,TEAM,TOTAL,TOTAL,False,,27,62,12,24,15,38,3,4,6,21,27,13,4,3,7,19,72
401409256,Louisiana Tech Lady Techsters,A. Roberson,4595004,,True,29.0,7,11,7,10,0,1,9,11,0,9,9,1,3,0,2,2,23
401409256,Louisiana Tech Lady Techsters,A. Brannon,4899084,,True,31.0,4,7,2,5,2,2,2,2,1,5,6,0,0,0,0,0,12
401409256,Louisiana Tech Lady Techsters,S. Nativi,4899083,,True,24.0,1,1,1,1,0,0,0,0,2,2,4,3,0,0,0,0,2
401409256,Louisiana Tech Lady Techsters,S. Bates,4433173,,True,35.0,5,7,3,5,2,2,0,0,0,2,2,4,0,0,3,1,12
401409256,Louisiana Tech Lady Techsters,K. Walker,4399516,,True,29.0,7,11,7,11,0,0,10,12,1,5,6,0,0,0,1,2,24
401409256,Louisiana Tech Lady Techsters,K. Thompson,4703773,,False,9.0,1,4,1,4,0,0,0,0,0,1,1,0,0,0,0,0,2
401409256,Louisiana Tech Lady Techsters,J. Davis,4281796,,False,2.0,0,1,0,1,0,0,0,0,0,0,0,1,0,0,0,0,0
401409256,Louisiana Tech Lady Techsters,R. Lee,4704199,,False,11.0,0,3,0,2,0,1,2,4,0,1,1,0,0,0,0,0,2
401409256,Louisiana Tech Lady Techsters,L. Sant,4595003,,False,30.0,1,4,0,0,1,4,0,0,0,3,3,0,1,1,1,1,3
401409256,Louisiana Tech Lady Techsters,TEAM,TOTAL,TOTAL,False,,26,49,21,39,5,10,23,29,4,29,33,9,4,1,7,6,80
401409255,North Texas Mean Green,J. Mallard,4596040,,True,31.0,4,6,4,6,0,0,2,3,2,1,3,1,1,0,1,3,10
401409255,North Texas Mean Green,M. Townley,4399531,,True,24.0,3,9,3,9,0,0,0,2,4,3,7,0,2,0,0,0,6
401409255,North Texas Mean Green,J. Jackson,4595018,,True,40.0,3,9,3,6,0,3,1,2,1,6,7,1,2,1,3,2,7
401409255,North Texas Mean Green,Q. Noble,4400145,,True,37.0,6,16,3,10,3,6,0,0,2,2,4,1,1,0,2,3,15
401409255,North Texas Mean Green,A. Gamez,4281826,,True,32.0,5,12,5,10,0,2,5,7,2,4,6,1,1,0,1,5,15
401409255,North Texas Mean Green,T. Lampkin,4433476,,False,9.0,0,1,0,1,0,0,3,4,2,3,5,0,0,0,0,0,3
401409255,North Texas Mean Green,K. McGruder,4899377,,False,9.0,1,2,1,1,0,1,0,0,0,1,1,0,1,0,1,3,2
401409255,North Texas Mean Green,A. Dixon,4281784,,False,18.0,0,4,0,3,0,1,5,6,0,3,3,1,0,1,2,4,5
401409255,North Texas Mean Green,TEAM,TOTAL,TOTAL,False,,22,59,19,46,3,13,16,24,14,26,40,5,8,2,11,20,63
401409255,Charlotte 49ers,M. Williams,4704501,,True,33.0,2,5,1,3,1,2,3,7,1,4,5,1,0,0,1,3,8
401409255,Charlotte 49ers,K. McKinney,4280854,,True,30.0,0,4,0,3,0,1,0,0,2,6,8,2,0,2,2,2,0
401409255,Charlotte 49ers,J. McMillian,4399489,,True,33.0,5,13,5,13,0,0,3,5,0,1,1,1,0,0,2,4,13
401409255,Charlotte 49ers,O. Jett-Wilson,4399487,,True,37.0,9,16,8,11,1,5,9,9,2,4,6,1,1,1,2,1,28
401409255,Charlotte 49ers,M. Boykin,4281177,,True,35.0,6,12,4,8,2,4,1,1,1,4,5,1,5,1,3,3,15
401409255,Charlotte 49ers,A. Middleton,4594982,,False,5.0,1,4,1,4,0,0,0,0,0,1,1,0,0,0,0,1,2
401409255,Charlotte 49ers,J. Busick,4704499,,False,12.0,0,1,0,0,0,1,0,0,0,1,1,1,0,0,0,2,0
401409255,Charlotte 49ers,D. Lawrence,4594980,,False,9.0,0,0,0,0,0,0,0,0,0,0,0,0,1,0,2,2,0
401409255,Charlotte 49ers,K. Roach,4280856,,False,7.0,0,1,0,1,0,0,0,0,1,0,1,0,0,0,1,1,0
401409255,Charlotte 49ers,TEAM,TOTAL,TOTAL,False,,23,56,19,43,4,13,16,22,10,26,36,7,7,4,13,19,66
401409254,Southern Miss Lady Eagles,K. Jones,4281810,,True,29.0,5,7,5,7,0,0,3,4,3,2,5,2,0,1,1,3,13
401409254,Southern Miss Lady Eagles,B. Gray,4704534,,True,34.0,3,8,2,4,1,4,1,2,1,6,7,0,0,0,0,1,8
401409254,Southern Miss Lady Eagles,D. Davis,4432949,,True,38.0,3,11,2,8,1,3,7,7,0,6,6,3,1,0,3,0,14
401409254,Southern Miss Lady Eagles,D. Almond,4399612,,True,28.0,0,7,0,7,0,0,0,0,1,2,3,4,1,0,1,1,0
401409254,Southern Miss Lady Eagles,D. Smith,4399611,,True,25.0,2,10,2,10,0,0,1,3,0,7,7,0,1,0,1,1,5
401409254,Southern Miss Lady Eagles,F. Hawkins,4704535,,False,2.0,0,0,0,0,0,0,0,0,0,0,0,0,0,0,0,0,0
401409254,Southern Miss Lady Eagles,M. Grayson,4704539,,False,9.0,1,1,1,1,0,0,0,1,0,0,0,0,0,1,3,3,2
401409254,Southern Miss Lady Eagles,R. Warren,4704538,,False,17.0,2,7,1,3,1,4,0,1,1,1,2,0,0,0,1,2,5
401409254,Southern Miss Lady Eagles,L. Gross,4399881,,False,18.0,1,1,0,0,1,1,0,0,0,2,2,1,1,0,1,2,3
401409254,Southern Miss Lady Eagles,TEAM,TOTAL,TOTAL,False,,17,52,13,40,4,12,12,18,8,27,35,10,4,2,11,13,50
401409254,Middle Tennessee Blue Raiders,C. Whitson,4595015,,True,40.0,2,11,0,1,2,10,1,2,1,4,5,3,1,0,0,4,7
401409254,Middle Tennessee Blue Raiders,A. Boldyreva,4899372,,True,8.0,0,1,0,0,0,1,0,0,0,1,1,0,0,1,2,2,0
401409254,Middle Tennessee Blue Raiders,J. Gregory,4899375,,True,39.0,5,11,2,3,3,8,5,5,1,2,3,1,0,1,1,1,18
401409254,Middle Tennessee Blue Raiders,Al. Whittington,4399524,,True,40.0,4,7,2,2,2,5,2,2,2,5,7,0,3,0,1,3,12
401409254,Middle Tennessee Blue Raiders,D. Saar,4281152,,True,39.0,4,14,2,4,2,10,0,0,2,5,7,7,0,0,3,0,10
401409254,Middle Tennessee Blue Raiders,J. Grannum,4704491,,False,3.0,0,0,0,0,0,0,0,0,1,1,2,0,0,0,1,2,0
401409254,Middle Tennessee Blue Raiders,K. Malashka,4399493,,False,29.0,9,17,6,9,3,8,2,3,2,9,11,0,1,4,0,3,23
401409254,Middle Tennessee Blue Raiders,C. Blakely,4899371,,False,1.0,0,0,0,0,0,0,0,0,0,0,0,0,0,0,0,0,0
401409254,Middle Tennessee Blue Raiders,Am. Whittington,4399525,,False,1.0,0,0,0,0,0,0,0,0,0,0,0,0,0,0,0,0,0
401409254,Middle Tennessee Blue Raiders,TEAM,TOTAL,TOTAL,False,,24,61,12,19,12,42,10,12,11,31,42,11,5,6,8,15,70
401409253,UAB Blazers,Z. Weathersby,4595243,,True,27.0,8,11,8,11,0,0,3,3,3,5,8,1,0,0,4,3,19
401409253,UAB Blazers,M. Roters,4595725,,True,27.0,2,3,2,3,0,0,3,3,1,2,3,2,1,0,2,3,7
401409253,UAB Blazers,E. Klaczek,4704558,,True,33.0,2,7,0,3,2,4,0,0,0,4,4,3,1,0,1,4,6
401409253,UAB Blazers,C. Armato,4399943,,True,16.0,0,2,0,1,0,1,0,0,1,0,1,0,0,0,0,1,0
401409253,UAB Blazers,M. Whitley,4399613,,True,36.0,5,16,3,7,2,9,2,2,1,1,2,1,1,0,0,0,14
401409253,UAB Blazers,D. McGhee,4433446,,False,13.0,3,7,3,5,0,2,4,4,3,4,7,1,0,1,1,4,10
401409253,UAB Blazers,S. Rosenfeldt,4399615,,False,2.0,0,0,0,0,0,0,0,0,0,0,0,0,0,0,0,0,0
401409253,UAB Blazers,K. Schneringer,4704559,,False,32.0,3,8,2,5,1,3,2,2,0,3,3,0,0,0,2,3,9
401409253,UAB Blazers,C. Daniels,4704556,,False,4.0,0,0,0,0,0,0,0,0,0,1,1,0,0,0,0,0,0
401409253,UAB Blazers,A. Jordan,4399616,,False,10.0,0,3,0,2,0,1,0,0,0,2,2,0,0,0,1,4,0
401409253,UAB Blazers,TEAM,TOTAL,TOTAL,False,,23,57,18,37,5,20,14,14,11,25,36,8,3,1,12,22,65
401409253,Louisiana Tech Lady Techsters,A. Roberson,4595004,,True,31.0,3,11,3,11,0,0,0,0,0,10,10,0,1,1,1,1,6
401409253,Louisiana Tech Lady Techsters,A. Brannon,4899084,,True,31.0,3,3,2,2,1,1,4,4,2,2,4,0,0,1,1,3,11
401409253,Louisiana Tech Lady Techsters,S. Nativi,4899083,,True,13.0,0,1,0,1,0,0,0,0,2,0,2,2,2,0,0,1,0
401409253,Louisiana Tech Lady Techsters,S. Bates,4433173,,True,34.0,4,9,4,6,0,3,2,3,0,3,3,1,1,0,2,2,10
401409253,Louisiana Tech Lady Techsters,K. Walker,4399516,,True,37.0,11,20,11,20,0,0,7,10,0,3,3,1,1,0,3,2,29
401409253,Louisiana Tech Lady Techsters,K. Thompson,4703773,,False,10.0,1,2,1,2,0,0,1,2,0,1,1,0,0,1,0,0,3
401409253,Louisiana Tech Lady Techsters,R. Lee,4704199,,False,30.0,2,4,1,3,1,1,4,6,0,2,2,0,0,0,0,0,9
401409253,Louisiana Tech Lady Techsters,L. Sant,4595003,,False,14.0,1,1,0,0,1,1,0,0,0,0,0,0,0,0,0,3,3
401409253,Louisiana Tech Lady Techsters,TEAM,TOTAL,TOTAL,False,,25,51,22,45,3,6,18,25,6,23,29,4,5,3,7,12,71
401409252,Old Dominion Monarchs,B. Jackson,4594387,,True,19.0,0,2,0,2,0,0,2,3,2,2,4,0,0,1,3,3,2
401409252,Old Dominion Monarchs,A. Young,4399540,,True,31.0,8,10,8,10,0,0,1,8,5,3,8,0,2,0,0,3,17
401409252,Old Dominion Monarchs,I. Allen,4704183,,True,39.0,8,24,7,16,1,8,3,4,1,2,3,1,4,0,3,3,20
401409252,Old Dominion Monarchs,A. Hudson,4399534,,True,32.0,1,3,1,1,0,2,0,0,0,1,1,1,0,0,0,4,2
401409252,Old Dominion Monarchs,M. Adams,4399533,,True,40.0,5,10,4,6,1,4,1,1,0,2,2,7,2,0,5,3,12
401409252,Old Dominion Monarchs,A. Moreland,4899400,,False,1.0,0,0,0,0,0,0,0,0,0,0,0,0,1,0,1,1,0
401409252,Old Dominion Monarchs,A. Barnes-Williams,4899395,,False,6.0,2,2,2,2,0,0,1,2,1,1,2,1,0,0,0,2,5
401409252,Old Dominion Monarchs,K. Nelson,4899398,,False,4.0,0,1,0,1,0,0,0,0,0,1,1,1,0,0,0,1,0
401409252,Old Dominion Monarchs,K. Clark,4899396,,False,16.0,0,1,0,1,0,0,0,0,0,0,0,2,2,0,1,2,0
401409252,Old Dominion Monarchs,J. Campbell,4704352,,False,0.0,0,0,0,0,0,0,0,0,0,0,0,0,0,0,0,0,0
401409252,Old Dominion Monarchs,A. Wayne,4399539,,False,12.0,0,0,0,0,0,0,0,0,0,2,2,0,1,0,0,2,0
401409252,Old Dominion Monarchs,TEAM,TOTAL,TOTAL,False,,24,53,22,39,2,14,8,18,9,16,25,13,12,1,13,24,58
401409252,North Texas Mean Green,J. Mallard,4596040,,True,21.0,2,2,2,2,0,0,1,2,0,1,1,0,1,0,1,5,5
401409252,North Texas Mean Green,M. Townley,4399531,,True,24.0,0,4,0,4,0,0,1,2,6,6,12,1,0,0,2,4,1
401409252,North Texas Mean Green,J. Jackson,4595018,,True,31.0,1,6,1,5,0,1,0,0,2,2,4,3,1,0,3,0,2
401409252,North Texas Mean Green,Q. Noble,4400145,,True,33.0,2,7,1,4,1,3,4,4,0,2,2,4,1,1,3,2,9
401409252,North Texas Mean Green,A. Gamez,4281826,,True,40.0,9,11,2,4,7,7,4,6,1,5,6,3,2,1,5,2,29
401409252,North Texas Mean Green,E. Villas-Gomis,4594758,,False,10.0,0,5,0,4,0,1,0,0,0,0,0,0,0,0,1,1,0
401409252,North Texas Mean Green,T. Lampkin,4433476,,False,5.0,2,2,2,2,0,0,0,0,0,0,0,1,0,0,0,2,4
401409252,North Texas Mean Green,K. McGruder,4899377,,False,5.0,0,1,0,0,0,1,0,0,0,1,1,2,0,0,1,0,0
401409252,North Texas Mean Green,A. Dixon,4281784,,False,31.0,6,10,6,9,0,1,3,4,1,4,5,1,2,0,2,1,15
401409252,North Texas Mean Green,TEAM,TOTAL,TOTAL,False,,22,48,14,34,8,14,13,18,11,22,33,15,7,2,18,17,65
401409251,Rice Owls,M. Fisher,4899404,,True,30.0,4,11,3,9,1,2,3,4,3,1,4,0,2,0,3,3,12
401409251,Rice Owls,A. Austin,4433262,,True,36.0,5,15,3,9,2,6,1,2,3,2,5,2,1,0,2,3,13
401409251,Rice Owls,M. Bokunewicz,4704533,,True,38.0,2,7,0,0,2,7,0,0,1,3,4,0,2,0,2,2,6
401409251,Rice Owls,T. Gooden,4899405,,True,20.0,0,4,0,3,0,1,0,0,0,3,3,0,1,0,1,2,0
401409251,Rice Owls,D. Jackson,4595231,,True,36.0,5,11,3,5,2,6,2,3,1,5,6,4,4,0,3,3,14
401409251,Rice Owls,I. Bellamy,4433709,,False,14.0,0,2,0,2,0,0,0,0,1,2,3,1,0,0,1,2,0
401409251,Rice Owls,H. Swayze,4399608,,False,26.0,3,9,3,7,0,2,2,2,4,3,7,1,0,1,1,3,8
401409251,Rice Owls,TEAM,TOTAL,TOTAL,False,,19,59,12,35,7,24,8,11,15,22,37,8,10,1,14,18,53
401409251,Charlotte 49ers,M. Williams,4704501,,True,32.0,2,10,2,9,0,1,1,2,2,3,5,0,0,1,1,1,5
401409251,Charlotte 49ers,K. McKinney,4280854,,True,35.0,1,2,0,1,1,1,2,2,1,8,9,2,1,4,2,3,5
401409251,Charlotte 49ers,J. McMillian,4399489,,True,33.0,3,5,3,5,0,0,0,2,2,2,4,1,1,1,2,3,6
401409251,Charlotte 49ers,O. Jett-Wilson,4399487,,True,36.0,3,12,2,7,1,5,9,9,1,3,4,0,2,0,4,1,16
401409251,Charlotte 49ers,M. Boykin,4281177,,True,35.0,6,12,4,8,2,4,6,6,1,4,5,2,1,1,2,3,20
401409251,Charlotte 49ers,J. Busick,4704499,,False,13.0,0,1,0,0,0,1,2,2,0,0,0,0,0,0,1,1,2
401409251,Charlotte 49ers,D. Lawrence,4594980,,False,16.0,2,5,2,4,0,1,1,2,1,0,1,0,0,0,3,1,5
401409251,Charlotte 49ers,TEAM,TOTAL,TOTAL,False,,17,47,13,34,4,13,21,25,10,27,37,5,5,7,15,13,59
401409250,Southern Miss Lady Eagles,K. Jones,4281810,,True,28.0,9,13,9,13,0,0,6,6,7,5,12,2,3,2,2,3,24
401409250,Southern Miss Lady Eagles,B. Gray,4704534,,True,31.0,4,8,3,5,1,3,1,1,2,5,7,2,1,0,5,1,10
401409250,Southern Miss Lady Eagles,D. Davis,4432949,,True,30.0,2,5,1,4,1,1,2,2,0,1,1,6,1,0,3,3,7
401409250,Southern Miss Lady Eagles,D. Almond,4399612,,True,36.0,3,6,3,6,0,0,2,2,0,3,3,8,3,1,2,2,8
401409250,Southern Miss Lady Eagles,D. Smith,4399611,,True,23.0,4,11,4,11,0,0,0,0,0,6,6,3,1,0,0,0,8
401409250,Southern Miss Lady Eagles,A. Leake,4899410,,False,1.0,1,2,1,2,0,0,0,0,2,0,2,0,0,1,0,0,2
401409250,Southern Miss Lady Eagles,A. Broughton,4899408,,False,2.0,0,0,0,0,0,0,0,0,0,0,0,0,0,0,0,3,0
401409250,Southern Miss Lady Eagles,F. Hawkins,4704535,,False,2.0,0,1,0,1,0,0,0,0,0,0,0,0,0,0,1,0,0
401409250,Southern Miss Lady Eagles,M. Grayson,4704539,,False,10.0,3,6,3,6,0,0,0,0,1,1,2,1,0,1,2,0,6
401409250,Southern Miss Lady Eagles,M. Dillard,4899409,,False,2.0,0,1,0,1,0,0,0,0,0,1,1,0,0,0,0,1,0
401409250,Southern Miss Lady Eagles,E. Wallhoff,4899407,,False,2.0,1,1,1,1,0,0,0,0,0,0,0,1,0,0,0,0,2
401409250,Southern Miss Lady Eagles,R. Warren,4704538,,False,8.0,2,3,2,3,0,0,0,0,1,0,1,1,0,0,1,3,4
401409250,Southern Miss Lady Eagles,L. Gross,4399881,,False,25.0,3,6,3,4,0,2,1,2,0,0,0,2,0,0,0,2,7
401409250,Southern Miss Lady Eagles,TEAM,TOTAL,TOTAL,False,,32,63,30,57,2,6,12,13,14,25,39,26,9,5,18,18,78
401409250,Florida International Panthers,M. Torres,4704466,,True,6.0,0,0,0,0,0,0,2,2,0,2,2,0,0,1,1,3,2
401409250,Florida International Panthers,K. Nelson,4281210,,True,36.0,3,11,2,4,1,7,2,2,1,1,2,2,0,0,2,3,9
401409250,Florida International Panthers,T. Hayes,4899077,,True,17.0,2,11,2,10,0,1,6,6,1,0,1,3,1,0,3,4,10
401409250,Florida International Panthers,Z. Gonzalez,4899076,,True,21.0,2,3,1,2,1,1,4,4,1,0,1,0,1,1,3,0,9
401409250,Florida International Panthers,R. Ferrer-Bernad,4704184,,True,24.0,2,5,0,1,2,4,0,0,1,1,2,2,1,0,0,1,6
401409250,Florida International Panthers,H. Butera,4899079,,False,27.0,0,1,0,1,0,0,2,2,0,4,4,1,2,2,0,2,2
401409250,Florida International Panthers,E. Ekpiteta,4282163,,False,32.0,5,8,5,8,0,0,1,4,3,3,6,0,3,0,1,0,11
401409250,Florida International Panthers,O. Trice,4595222,,False,21.0,2,6,2,3,0,3,0,1,2,0,2,2,0,0,2,1,4
401409250,Florida International Panthers,G. Hunter,4899078,,False,16.0,2,6,2,4,0,2,3,4,1,2,3,4,0,1,3,0,7
401409250,Florida International Panthers,TEAM,TOTAL,TOTAL,False,,18,51,14,33,4,18,20,25,11,16,27,14,8,5,17,14,60
401409249,Western Kentucky Lady Toppers,J. Foster,4899600,,True,33.0,6,13,4,8,2,5,2,5,2,5,7,1,0,0,0,2,16
401409249,Western Kentucky Lady Toppers,M. Blevins,4899602,,True,28.0,1,6,1,2,0,4,0,0,0,2,2,0,0,0,0,2,2
401409249,Western Kentucky Lady Toppers,T. Faustino,4899601,,True,27.0,1,3,0,1,1,2,0,0,3,2,5,0,1,0,2,3,3
401409249,Western Kentucky Lady Toppers,A. Mead,4899598,,True,36.0,7,16,6,11,1,5,3,4,4,4,8,2,1,0,2,2,18
401409249,Western Kentucky Lady Toppers,M. Abdelgawad,4399629,,True,27.0,4,12,4,8,0,4,4,8,0,3,3,0,0,0,1,2,12
401409249,Western Kentucky Lady Toppers,T. Hunter,4595265,,False,3.0,0,1,0,1,0,0,0,0,0,0,0,0,0,0,0,0,0
401409249,Western Kentucky Lady Toppers,G. McBride,4433116,,False,6.0,0,0,0,0,0,0,0,0,0,1,1,0,1,0,0,2,0
401409249,Western Kentucky Lady Toppers,S. Kulo,4704582,,False,3.0,0,0,0,0,0,0,0,0,0,1,1,0,0,0,0,0,0
401409249,Western Kentucky Lady Toppers,J. Walker,4899603,,False,8.0,0,1,0,0,0,1,0,0,0,1,1,1,0,0,1,1,0
401409249,Western Kentucky Lady Toppers,J. Smith,4704585,,False,0.0,0,0,0,0,0,0,0,0,0,0,0,0,0,0,0,0,0
401409249,Western Kentucky Lady Toppers,H. Sivori,4704584,,False,29.0,3,7,2,4,1,3,4,7,0,1,1,1,0,0,0,4,11
401409249,Western Kentucky Lady Toppers,TEAM,TOTAL,TOTAL,False,,22,59,17,35,5,24,13,24,12,22,34,5,3,0,7,18,62
401409249,UAB Blazers,Z. Weathersby,4595243,,True,23.0,5,6,5,6,0,0,0,0,2,5,7,0,0,1,0,4,10
401409249,UAB Blazers,M. Roters,4595725,,True,34.0,1,7,1,6,0,1,2,2,0,7,7,3,2,1,2,2,4
401409249,UAB Blazers,E. Klaczek,4704558,,True,19.0,2,3,1,2,1,1,0,0,1,0,1,4,0,0,1,4,5
401409249,UAB Blazers,C. Armato,4399943,,True,32.0,2,4,2,3,0,1,1,2,2,0,2,2,0,0,1,2,5
401409249,UAB Blazers,M. Whitley,4399613,,True,35.0,5,15,1,6,4,9,2,4,0,3,3,0,1,0,1,2,16
401409249,UAB Blazers,D. McGhee,4433446,,False,17.0,6,8,6,7,0,1,3,6,2,6,8,0,1,1,2,4,15
401409249,UAB Blazers,S. Rosenfeldt,4399615,,False,6.0,0,1,0,1,0,0,0,0,0,1,1,0,0,0,1,1,0
401409249,UAB Blazers,K. Schneringer,4704559,,False,26.0,7,11,5,8,2,3,1,1,0,4,4,1,0,0,1,0,17
401409249,UAB Blazers,A. Jordan,4399616,,False,8.0,1,1,1,1,0,0,0,1,0,0,0,2,0,0,1,0,2
401409249,UAB Blazers,TEAM,TOTAL,TOTAL,False,,29,56,22,40,7,16,9,16,9,30,39,12,4,3,11,19,74
401409248,UTSA Roadrunners,E. Coleman,4597330,,True,24.0,1,8,1,8,0,0,0,0,1,2,3,0,0,1,2,3,2
401409248,UTSA Roadrunners,Q. Ulabo,4899595,,True,18.0,0,2,0,2,0,0,2,4,1,7,8,1,3,0,3,4,2
401409248,UTSA Roadrunners,L. Johnson,4595634,,True,35.0,8,13,7,10,1,3,4,4,2,2,4,1,1,0,3,2,21
401409248,UTSA Roadrunners,C. Govan,4595184,,True,11.0,1,2,1,1,0,1,0,0,0,0,0,1,0,0,2,0,2
401409248,UTSA Roadrunners,J. Pimentel,4282351,,True,35.0,0,6,0,5,0,1,1,2,0,7,7,5,2,0,9,2,1
401409248,UTSA Roadrunners,Y. Valcheva,4704551,,False,7.0,1,4,1,4,0,0,0,0,1,0,1,0,0,0,0,0,2
401409248,UTSA Roadrunners,E. Blanding,4595250,,False,13.0,1,2,1,2,0,0,0,2,2,2,4,0,0,0,1,0,2
401409248,UTSA Roadrunners,D. Nwakamma,4899596,,False,15.0,2,5,2,3,0,2,0,0,0,2,2,0,1,0,1,3,4
401409248,UTSA Roadrunners,H. Atwood,4899594,,False,11.0,1,2,1,1,0,1,0,0,0,0,0,0,0,0,2,1,2
401409248,UTSA Roadrunners,Ch. Mass,4595253,,False,31.0,2,7,1,3,1,4,2,2,1,4,5,2,1,0,1,2,7
401409248,UTSA Roadrunners,TEAM,TOTAL,TOTAL,False,,17,51,15,39,2,12,9,14,12,29,41,10,8,1,25,17,45
401409248,Old Dominion Monarchs,B. Jackson,4594387,,True,25.0,1,6,1,6,0,0,0,0,3,3,6,0,1,1,2,4,2
401409248,Old Dominion Monarchs,A. Young,4399540,,True,30.0,7,12,7,12,0,0,2,8,0,5,5,4,6,0,2,3,16
401409248,Old Dominion Monarchs,I. Allen,4704183,,True,28.0,5,16,4,12,1,4,1,2,0,5,5,1,2,0,1,2,12
401409248,Old Dominion Monarchs,A. Hudson,4399534,,True,32.0,5,9,1,2,4,7,0,1,0,0,0,0,1,0,1,1,14
401409248,Old Dominion Monarchs,M. Adams,4399533,,True,34.0,4,6,4,6,0,0,2,2,0,3,3,8,2,1,2,0,10
401409248,Old Dominion Monarchs,A. Moreland,4899400,,False,4.0,2,3,2,3,0,0,0,0,1,0,1,0,0,0,2,0,4
401409248,Old Dominion Monarchs,A. Barnes-Williams,4899395,,False,12.0,1,3,1,3,0,0,1,2,2,1,3,0,0,0,3,1,3
401409248,Old Dominion Monarchs,A. Rouse,4899399,,False,1.0,0,0,0,0,0,0,0,0,0,1,1,1,0,0,0,0,0
401409248,Old Dominion Monarchs,K. Nelson,4899398,,False,10.0,0,2,0,0,0,2,0,0,1,3,4,0,0,1,2,1,0
401409248,Old Dominion Monarchs,E. Sample,4899397,,False,1.0,0,1,0,1,0,0,0,0,0,1,1,0,0,0,0,0,0
401409248,Old Dominion Monarchs,K. Clark,4899396,,False,17.0,1,3,1,2,0,1,0,0,2,0,2,0,2,0,0,3,2
401409248,Old Dominion Monarchs,J. Campbell,4704352,,False,6.0,1,1,1,1,0,0,0,0,0,0,0,2,1,0,0,0,2
401409248,Old Dominion Monarchs,TEAM,TOTAL,TOTAL,False,,27,62,22,48,5,14,6,15,11,23,34,16,15,3,16,15,65
401409247,Rice Owls,M. Fisher,4899404,,True,32.0,8,15,8,15,0,0,1,1,5,11,16,4,2,0,4,1,17
401409247,Rice Owls,A. Austin,4433262,,True,22.0,5,10,4,5,1,5,8,8,0,3,3,3,0,0,3,3,19
401409247,Rice Owls,M. Bokunewicz,4704533,,True,38.0,4,11,1,3,3,8,2,2,1,9,10,1,0,2,0,2,13
401409247,Rice Owls,T. Gooden,4899405,,True,25.0,2,5,1,2,1,3,8,9,0,4,4,1,1,0,2,1,13
401409247,Rice Owls,D. Jackson,4595231,,True,37.0,0,2,0,0,0,2,2,2,2,1,3,2,0,0,6,1,2
401409247,Rice Owls,I. Bellamy,4433709,,False,22.0,3,5,3,5,0,0,4,5,1,1,2,0,0,1,0,2,10
401409247,Rice Owls,A. McCurry,4399609,,False,4.0,0,0,0,0,0,0,0,0,0,0,0,0,0,0,0,1,0
401409247,Rice Owls,H. Swayze,4399608,,False,20.0,2,3,0,0,2,3,0,0,0,1,1,1,0,1,0,1,6
401409247,Rice Owls,TEAM,TOTAL,TOTAL,False,,24,51,17,30,7,21,25,27,12,31,43,12,3,4,16,12,80
401409247,Marshall Thundering Herd,L. Roper,4399522,,True,21.0,0,0,0,0,0,0,0,0,1,2,3,0,0,1,1,4,0
401409247,Marshall Thundering Herd,K. Colclough,4068712,,True,29.0,2,9,2,5,0,4,3,6,3,2,5,0,3,1,1,5,7
401409247,Marshall Thundering Herd,S. Wheeler,4595007,,True,39.0,9,20,4,9,5,11,4,4,1,0,1,4,1,0,3,3,27
401409247,Marshall Thundering Herd,Bri. Ferby,4282387,,True,31.0,3,9,2,4,1,5,1,2,1,3,4,1,1,0,5,1,8
401409247,Marshall Thundering Herd,A. Dunham,4281365,,True,39.0,8,14,4,6,4,8,0,1,1,2,3,2,2,0,0,2,20
401409247,Marshall Thundering Herd,A. Redman,4704482,,False,2.0,0,1,0,0,0,1,0,0,0,0,0,0,0,0,0,0,0
401409247,Marshall Thundering Herd,A. Johnson,4595009,,False,6.0,0,3,0,1,0,2,0,0,0,1,1,0,0,0,0,2,0
401409247,Marshall Thundering Herd,S. Liberatore,4704481,,False,1.0,0,0,0,0,0,0,0,0,0,0,0,0,0,0,0,0,0
401409247,Marshall Thundering Herd,CC Mays,4704479,,False,13.0,0,3,0,1,0,2,0,0,0,1,1,0,0,0,1,1,0
401409247,Marshall Thundering Herd,C. McLean,4597886,,False,3.0,0,1,0,0,0,1,0,0,0,0,0,0,0,0,0,0,0
401409247,Marshall Thundering Herd,K. Sivils,4399519,,False,16.0,0,0,0,0,0,0,0,2,3,3,6,1,0,0,0,2,0
401409247,Marshall Thundering Herd,TEAM,TOTAL,TOTAL,False,,22,60,12,26,10,34,8,15,11,15,26,8,7,2,11,20,62
401409246,Florida International Panthers,K. Nelson,4281210,,True,40.0,8,16,4,7,4,9,3,4,5,2,7,2,0,1,3,2,23
401409246,Florida International Panthers,M. Torres,4704466,,True,23.0,4,7,4,7,0,0,0,1,2,5,7,0,0,4,2,4,8
401409246,Florida International Panthers,T. Hayes,4899077,,True,31.0,6,16,6,16,0,0,2,3,0,3,3,7,3,1,3,2,14
401409246,Florida International Panthers,Z. Gonzalez,4899076,,True,13.0,0,3,0,2,0,1,0,0,0,1,1,1,0,0,1,1,0
401409246,Florida International Panthers,R. Ferrer-Bernad,4704184,,True,24.0,1,5,0,1,1,4,1,2,0,1,1,1,0,0,3,0,4
401409246,Florida International Panthers,H. Butera,4899079,,False,13.0,1,1,1,1,0,0,0,0,1,3,4,1,0,1,0,4,2
401409246,Florida International Panthers,E. Ekpiteta,4282163,,False,27.0,0,5,0,5,0,0,3,6,3,2,5,1,2,0,0,2,3
401409246,Florida International Panthers,O. Trice,4595222,,False,15.0,1,2,1,1,0,1,2,2,0,0,0,0,0,0,0,1,4
401409246,Florida International Panthers,G. Hunter,4899078,,False,14.0,5,7,5,6,0,1,0,0,0,0,0,0,1,0,2,2,10
401409246,Florida International Panthers,TEAM,TOTAL,TOTAL,False,,26,62,21,46,5,16,11,18,16,23,39,13,6,7,15,18,68
401409246,Florida Atlantic Owls,A. Gaston,4399501,,True,17.0,4,7,4,7,0,0,0,0,2,3,5,1,0,0,3,4,8
401409246,Florida Atlantic Owls,J. Rozentale,4399241,,True,35.0,3,10,3,10,0,0,8,12,9,9,18,2,3,4,3,4,14
401409246,Florida Atlantic Owls,R. Pleskevich,4595919,,True,37.0,7,15,7,12,0,3,2,2,1,1,2,4,2,0,2,0,16
401409246,Florida Atlantic Owls,N. Ozola,4594988,,True,29.0,2,4,2,2,0,2,0,0,0,0,0,1,1,0,4,1,4
401409246,Florida Atlantic Owls,B. Beck,4399987,,True,6.0,0,1,0,0,0,1,0,0,0,0,0,1,0,0,0,0,0
401409246,Florida Atlantic Owls,S. Galeron,4400535,,False,17.0,1,3,0,0,1,3,0,0,0,1,1,1,0,1,1,3,3
401409246,Florida Atlantic Owls,K. Kuykendoll,4899075,,False,21.0,0,4,0,4,0,0,2,2,0,1,1,1,2,1,1,2,2
401409246,Florida Atlantic Owls,S. Henshaw,4899074,,False,7.0,0,0,0,0,0,0,0,0,0,0,0,0,0,1,0,2,0
401409246,Florida Atlantic Owls,A. Zaph,4594993,,False,31.0,5,14,3,8,2,6,1,1,0,4,4,1,1,0,1,1,13
401409246,Florida Atlantic Owls,TEAM,TOTAL,TOTAL,False,,22,58,19,43,3,15,13,17,15,21,36,12,9,7,15,17,60
401409245,UTSA Roadrunners,E. Coleman,4597330,,True,43.0,10,18,10,16,0,2,1,2,3,8,11,0,0,2,2,4,21
401409245,UTSA Roadrunners,Q. Ulabo,4899595,,True,25.0,2,5,2,5,0,0,0,0,4,1,5,1,1,0,1,2,4
401409245,UTSA Roadrunners,L. Johnson,4595634,,True,24.0,0,2,0,2,0,0,4,4,0,0,0,0,0,0,2,2,4
401409245,UTSA Roadrunners,C. Govan,4595184,,True,28.0,1,4,1,3,0,1,0,2,0,0,0,4,1,0,0,3,2
401409245,UTSA Roadrunners,J. Pimentel,4282351,,True,40.0,4,13,2,10,2,3,4,6,0,6,6,1,6,1,4,3,14
401409245,UTSA Roadrunners,Y. Valcheva,4704551,,False,6.0,0,1,0,1,0,0,0,0,1,0,1,0,0,0,0,1,0
401409245,UTSA Roadrunners,E. Blanding,4595250,,False,2.0,0,1,0,1,0,0,0,0,0,0,0,0,0,0,0,0,0
401409245,UTSA Roadrunners,D. Nwakamma,4899596,,False,17.0,2,8,1,3,1,5,0,0,0,2,2,0,0,0,1,2,5
401409245,UTSA Roadrunners,H. Atwood,4899594,,False,29.0,1,3,1,2,0,1,2,2,1,4,5,2,0,0,1,1,4
401409245,UTSA Roadrunners,Ch. Mass,4595253,,False,11.0,1,4,0,1,1,3,1,2,0,2,2,0,0,0,1,2,4
401409245,UTSA Roadrunners,TEAM,TOTAL,TOTAL,False,,21,59,17,44,4,15,12,18,11,26,37,8,8,3,12,20,58
401409245,UTEP Miners,E. Arike,4704572,,True,17.0,0,3,0,3,0,0,2,2,3,2,5,1,0,0,2,1,2
401409245,UTEP Miners,T. Battle,4282598,,True,25.0,3,4,3,4,0,0,1,2,2,3,5,0,0,0,1,3,7
401409245,UTEP Miners,D. Thurman,4704574,,True,43.0,8,19,4,11,4,8,3,3,2,5,7,0,1,0,2,0,23
401409245,UTEP Miners,A. Crouse,4595247,,True,28.0,1,4,0,1,1,3,4,4,2,3,5,0,3,1,2,4,7
401409245,UTEP Miners,K. Gallegos,4595246,,True,38.0,3,12,3,12,0,0,2,2,0,1,1,3,1,1,2,2,8
401409245,UTEP Miners,B. Fontana,4704573,,False,17.0,0,2,0,0,0,2,0,0,1,3,4,0,0,0,1,2,0
401409245,UTEP Miners,M. Petree,4595572,,False,33.0,2,9,0,4,2,5,1,2,3,5,8,1,0,0,2,2,7
401409245,UTEP Miners,E. Wilson,4399863,,False,17.0,0,3,0,1,0,2,0,2,2,3,5,1,1,0,3,3,0
401409245,UTEP Miners,E. Cabral,4399620,,False,7.0,1,2,1,1,0,1,1,2,0,0,0,1,1,0,2,0,3
401409245,UTEP Miners,TEAM,TOTAL,TOTAL,False,,18,58,11,37,7,21,14,19,17,28,45,7,7,2,19,17,57
401408531,South Dakota State Jackrabbits,T. Nelson,4595883,,True,34.0,1,5,1,4,0,1,2,2,2,4,6,2,0,1,2,2,4
401408531,South Dakota State Jackrabbits,P. Burckhard,4399649,,True,34.0,5,15,1,5,4,10,0,0,4,2,6,2,1,1,4,4,14
401408531,South Dakota State Jackrabbits,M. Selland,4282531,,True,30.0,0,10,0,6,0,4,5,7,3,7,10,4,0,0,4,3,5
401408531,South Dakota State Jackrabbits,T. Irwin,4282530,,True,23.0,6,11,3,8,3,3,0,0,0,2,2,0,2,0,2,4,15
401408531,South Dakota State Jackrabbits,L. Theuninck,4282529,,True,24.0,0,2,0,0,0,2,0,0,0,2,2,0,0,0,0,1,0
401408531,South Dakota State Jackrabbits,K. Theisen,4595882,,False,13.0,0,3,0,3,0,0,0,0,2,3,5,0,1,0,0,3,0
401408531,South Dakota State Jackrabbits,H. Timmer,4899819,,False,24.0,1,5,1,3,0,2,2,2,2,1,3,0,0,0,2,2,4
401408531,South Dakota State Jackrabbits,H. Greer,4068252,,False,18.0,1,6,0,5,1,1,0,0,0,2,2,3,0,0,1,2,3
401408531,South Dakota State Jackrabbits,TEAM,TOTAL,TOTAL,False,,14,57,6,34,8,23,9,11,15,24,39,11,4,2,15,21,45
401408531,South Dakota Coyotes,H. Sjerven,4068349,,True,34.0,6,14,6,13,0,1,7,8,2,8,10,0,2,4,1,2,19
401408531,South Dakota Coyotes,K. Watson,4704325,,True,25.0,0,3,0,0,0,3,0,0,0,4,4,2,1,1,3,3,0
401408531,South Dakota Coyotes,M. Krull,4433474,,True,36.0,0,3,0,3,0,0,2,4,2,4,6,1,0,0,2,4,2
401408531,South Dakota Coyotes,C. Lamb,4282528,,True,39.0,5,13,2,8,3,5,4,5,0,3,3,3,1,0,1,1,17
401408531,South Dakota Coyotes,L. Korngable,4282526,,True,33.0,4,8,2,5,2,3,1,2,0,2,2,3,0,0,1,3,11
401408531,South Dakota Coyotes,J. Ugofsky,4595855,,False,9.0,0,1,0,1,0,0,1,2,0,1,1,0,0,0,0,1,1
401408531,South Dakota Coyotes,A. Peplowski,4399655,,False,6.0,0,0,0,0,0,0,0,0,1,1,2,0,0,0,0,1,0
401408531,South Dakota Coyotes,G. Larkins,4899816,,False,16.0,3,5,3,5,0,0,0,0,1,0,1,0,1,0,2,0,6
401408531,South Dakota Coyotes,M. Guebert,4595854,,False,2.0,0,0,0,0,0,0,0,0,0,0,0,0,0,0,0,0,0
401408531,South Dakota Coyotes,TEAM,TOTAL,TOTAL,False,,18,47,13,35,5,12,15,21,8,25,33,9,5,5,11,15,56
401408530,South Dakota Coyotes,H. Sjerven,4068349,,True,25.0,8,11,7,10,1,1,7,10,2,7,9,0,1,0,1,4,24
401408530,South Dakota Coyotes,K. Watson,4704325,,True,36.0,1,6,1,2,0,4,0,0,1,3,4,4,1,0,1,3,2
401408530,South Dakota Coyotes,M. Krull,4433474,,True,28.0,2,5,1,3,1,2,0,0,0,2,2,2,0,0,1,4,5
401408530,South Dakota Coyotes,C. Lamb,4282528,,True,34.0,12,16,7,10,5,6,4,4,0,1,1,4,0,0,1,3,33
401408530,South Dakota Coyotes,L. Korngable,4282526,,True,38.0,4,6,2,4,2,2,0,0,1,1,2,5,1,1,1,1,10
401408530,South Dakota Coyotes,M. Hansen,4704323,,False,1.0,0,1,0,1,0,0,0,0,1,0,1,0,0,0,0,0,0
401408530,South Dakota Coyotes,J. Ugofsky,4595855,,False,10.0,0,1,0,0,0,1,2,2,0,2,2,0,0,0,0,2,2
401408530,South Dakota Coyotes,A. Peplowski,4399655,,False,7.0,0,0,0,0,0,0,0,0,0,0,0,0,0,0,0,0,0
401408530,South Dakota Coyotes,R. Sankey,4399653,,False,0.0,0,0,0,0,0,0,0,0,0,0,0,0,0,0,0,0,0
401408530,South Dakota Coyotes,A. Williston,4398885,,False,0.0,0,0,0,0,0,0,0,0,0,0,0,0,0,0,0,0,0
401408530,South Dakota Coyotes,G. Larkins,4899816,,False,10.0,1,3,1,2,0,1,1,2,1,3,4,1,0,0,3,2,3
401408530,South Dakota Coyotes,M. Guebert,4595854,,False,11.0,1,3,1,1,0,2,0,0,0,0,0,2,0,0,1,1,2
401408530,South Dakota Coyotes,TEAM,TOTAL,TOTAL,False,,29,52,20,33,9,19,14,18,7,23,30,18,3,1,9,20,81
401408530,Kansas City Roos,P. Bradford,4704389,,True,33.0,0,7,0,5,0,2,4,4,2,5,7,3,0,0,1,3,4
401408530,Kansas City Roos,K. Bradley,4606153,,True,40.0,2,11,0,5,2,6,1,2,5,5,10,2,1,0,0,3,7
401408530,Kansas City Roos,B. McDavid,4282041,,True,26.0,6,10,6,10,0,0,4,4,3,0,3,0,2,0,4,5,16
401408530,Kansas City Roos,M. Willems,4595907,,True,40.0,4,10,0,0,4,10,2,3,0,1,1,0,0,0,0,2,14
401408530,Kansas City Roos,N. Alnatas,4595905,,True,40.0,6,12,6,9,0,3,9,9,0,3,3,6,1,0,5,1,21
401408530,Kansas City Roos,D. Winslow,4704873,,False,14.0,1,3,1,3,0,0,0,0,1,1,2,0,0,1,1,1,2
401408530,Kansas City Roos,J. Mickens,4595909,,False,6.0,0,1,0,0,0,1,0,0,0,0,0,0,0,0,0,3,0
401408530,Kansas City Roos,L. Williams,4899837,,False,1.0,1,1,0,0,1,1,0,0,0,0,0,0,0,0,0,0,3
401408530,Kansas City Roos,TEAM,TOTAL,TOTAL,False,,20,55,13,32,7,23,20,22,12,17,29,11,4,1,11,18,67
401408529,South Dakota State Jackrabbits,T. Nelson,4595883,,True,23.0,4,9,2,5,2,4,1,1,2,5,7,3,0,1,1,3,11
401408529,South Dakota State Jackrabbits,P. Burckhard,4399649,,True,26.0,5,7,1,3,4,4,2,2,0,8,8,1,0,0,2,1,16
401408529,South Dakota State Jackrabbits,M. Selland,4282531,,True,30.0,7,13,6,8,1,5,1,2,0,4,4,6,0,0,2,1,16
401408529,South Dakota State Jackrabbits,T. Irwin,4282530,,True,28.0,3,6,3,5,0,1,3,4,2,2,4,2,0,0,1,0,9
401408529,South Dakota State Jackrabbits,L. Theuninck,4282529,,True,23.0,0,4,0,1,0,3,0,0,0,2,2,3,1,0,1,1,0
401408529,South Dakota State Jackrabbits,M. Byom,4704383,,False,4.0,0,2,0,1,0,1,2,2,0,0,0,0,0,0,0,1,2
401408529,South Dakota State Jackrabbits,M. Vlastuin,4704382,,False,3.0,0,0,0,0,0,0,0,0,0,0,0,0,0,0,0,1,0
401408529,South Dakota State Jackrabbits,K. Theisen,4595882,,False,14.0,2,5,2,5,0,0,2,2,0,7,7,1,0,2,0,2,6
401408529,South Dakota State Jackrabbits,A. Hirschman,4399651,,False,3.0,0,1,0,1,0,0,0,0,0,1,1,0,0,0,0,0,0
401408529,South Dakota State Jackrabbits,H. Timmer,4899819,,False,24.0,5,9,3,6,2,3,0,0,1,1,2,3,2,0,0,1,12
401408529,South Dakota State Jackrabbits,R. Nesheim,4595886,,False,4.0,0,0,0,0,0,0,0,2,1,0,1,0,0,0,0,0,0
401408529,South Dakota State Jackrabbits,L. Rongisch,4399647,,False,3.0,0,1,0,0,0,1,0,0,0,0,0,0,0,0,0,0,0
401408529,South Dakota State Jackrabbits,H. Greer,4068252,,False,15.0,0,3,0,0,0,3,0,0,0,0,0,1,0,1,0,1,0
401408529,South Dakota State Jackrabbits,TEAM,TOTAL,TOTAL,False,,26,60,17,35,9,25,11,15,7,32,39,20,3,4,7,12,72
401408529,Oral Roberts Golden Eagles,Ti. Moore,4899814,,True,28.0,7,13,7,13,0,0,3,4,1,6,7,0,1,1,1,3,17
401408529,Oral Roberts Golden Eagles,K. Scott,4705635,,True,21.0,2,6,2,6,0,0,4,4,1,7,8,0,2,0,0,5,8
401408529,Oral Roberts Golden Eagles,R. Schumacher,4282493,,True,30.0,1,9,1,9,0,0,1,2,0,8,8,0,0,2,0,2,3
401408529,Oral Roberts Golden Eagles,H. Cooper,4599556,,True,29.0,0,4,0,4,0,0,1,2,0,3,3,3,0,0,2,1,1
401408529,Oral Roberts Golden Eagles,K. Lippe,4282496,,True,27.0,1,4,0,2,1,2,2,4,0,2,2,2,0,0,2,3,5
401408529,Oral Roberts Golden Eagles,Tr. Moore,4899813,,False,19.0,4,12,4,11,0,1,0,0,4,1,5,1,0,0,1,2,8
401408529,Oral Roberts Golden Eagles,F. Paramore,4704319,,False,16.0,1,3,1,2,0,1,0,0,0,0,0,2,0,0,0,0,2
401408529,Oral Roberts Golden Eagles,H. Giddey,4704314,,False,1.0,0,0,0,0,0,0,0,0,0,0,0,0,0,0,0,0,0
401408529,Oral Roberts Golden Eagles,D. Nix,4899811,,False,21.0,3,7,0,1,3,6,0,0,0,0,0,1,0,0,2,1,9
401408529,Oral Roberts Golden Eagles,A. Walker,4704317,,False,8.0,0,0,0,0,0,0,0,0,0,0,0,1,0,0,0,0,0
401408529,Oral Roberts Golden Eagles,TEAM,TOTAL,TOTAL,False,,19,58,15,48,4,10,11,16,7,29,36,10,3,3,10,17,53
401408528,North Dakota State Bison,E. Dietz,4282507,,True,26.0,6,7,6,7,0,0,2,5,3,2,5,1,0,0,0,5,14
401408528,North Dakota State Bison,A. Schulte,4704286,,True,34.0,6,11,4,9,2,2,7,8,0,2,2,3,1,0,3,3,21
401408528,North Dakota State Bison,R. Hopkins,4704283,,True,22.0,3,10,2,6,1,4,0,0,0,6,6,1,0,1,2,5,7
401408528,North Dakota State Bison,R. Cobbins,4595759,,True,35.0,3,8,2,7,1,1,2,4,1,2,3,1,0,1,1,4,9
401408528,North Dakota State Bison,H. Hamling,4400449,,True,34.0,6,16,4,12,2,4,2,2,1,7,8,7,0,0,1,3,16
401408528,North Dakota State Bison,K. Hildebrand,4899796,,False,23.0,3,7,2,2,1,5,0,0,1,3,4,1,1,0,1,2,7
401408528,North Dakota State Bison,E. Behnke,4595761,,False,14.0,0,2,0,2,0,0,0,4,3,3,6,0,1,2,0,2,0
401408528,North Dakota State Bison,S. Olson,4899795,,False,3.0,0,0,0,0,0,0,0,0,0,0,0,0,0,0,0,0,0
401408528,North Dakota State Bison,R. Novak,4704285,,False,6.0,0,0,0,0,0,0,0,2,0,0,0,0,0,0,0,0,0
401408528,North Dakota State Bison,O. Skibiel,4595762,,False,3.0,0,1,0,0,0,1,0,0,0,0,0,0,0,0,0,0,0
401408528,North Dakota State Bison,TEAM,TOTAL,TOTAL,False,,27,62,20,45,7,17,13,25,11,28,39,14,3,4,8,24,74
401408528,Kansas City Roos,P. Bradford,4704389,,True,32.0,4,14,2,7,2,7,2,2,3,7,10,1,0,3,1,4,12
401408528,Kansas City Roos,K. Bradley,4606153,,True,40.0,3,5,1,2,2,3,4,4,3,9,12,1,0,0,0,2,12
401408528,Kansas City Roos,B. McDavid,4282041,,True,31.0,5,14,5,14,0,0,3,5,1,8,9,0,0,2,1,4,13
401408528,Kansas City Roos,M. Willems,4595907,,True,34.0,1,4,0,1,1,3,8,8,0,1,1,4,0,0,1,3,11
401408528,Kansas City Roos,N. Alnatas,4595905,,True,40.0,12,24,8,14,4,10,4,5,1,4,5,6,1,0,6,2,32
401408528,Kansas City Roos,D. Winslow,4704873,,False,17.0,0,0,0,0,0,0,1,2,1,1,2,1,0,3,0,2,1
401408528,Kansas City Roos,S. St. Andre,4704387,,False,6.0,0,2,0,1,0,1,0,0,0,0,0,0,0,0,0,0,0
401408528,Kansas City Roos,TEAM,TOTAL,TOTAL,False,,25,63,16,39,9,24,22,26,10,31,41,13,1,8,9,17,81
401408527,Oral Roberts Golden Eagles,Ti. Moore,4899814,,True,25.0,1,7,1,7,0,0,7,8,1,6,7,2,1,6,0,1,9
401408527,Oral Roberts Golden Eagles,K. Scott,4705635,,True,25.0,5,12,5,11,0,1,1,3,0,2,2,2,1,1,1,2,11
401408527,Oral Roberts Golden Eagles,A. Walker,4704317,,True,32.0,1,7,0,2,1,5,0,0,2,2,4,2,2,0,1,2,3
401408527,Oral Roberts Golden Eagles,H. Cooper,4599556,,True,29.0,1,6,1,4,0,2,6,8,0,2,2,2,3,0,2,2,8
401408527,Oral Roberts Golden Eagles,K. Lippe,4282496,,True,31.0,8,15,4,10,4,5,2,2,3,3,6,1,3,0,3,0,22
401408527,Oral Roberts Golden Eagles,Tr. Moore,4899813,,False,14.0,2,6,2,6,0,0,2,2,1,3,4,0,0,0,0,1,6
401408527,Oral Roberts Golden Eagles,F. Paramore,4704319,,False,8.0,0,1,0,0,0,1,0,0,0,1,1,1,0,0,0,0,0
401408527,Oral Roberts Golden Eagles,R. Schumacher,4282493,,False,17.0,1,3,1,3,0,0,0,0,0,5,5,0,0,0,0,0,2
401408527,Oral Roberts Golden Eagles,D. Nix,4899811,,False,19.0,0,2,0,0,0,2,0,0,0,1,1,1,2,0,2,2,0
401408527,Oral Roberts Golden Eagles,TEAM,TOTAL,TOTAL,False,,19,59,14,43,5,16,18,23,9,28,37,11,12,7,9,10,61
401408527,North Dakota Fighting Hawks,O. Lane,4594844,,True,38.0,4,14,4,14,0,0,0,0,5,7,12,0,0,0,2,2,8
401408527,North Dakota Fighting Hawks,M. Leet,4281665,,True,36.0,5,12,5,10,0,2,3,3,2,6,8,1,2,3,1,3,13
401408527,North Dakota Fighting Hawks,K. Borowicz,4594840,,True,38.0,4,13,4,11,0,2,5,6,1,8,9,4,2,0,7,0,13
401408527,North Dakota Fighting Hawks,M. Manson,4594839,,True,18.0,1,9,0,2,1,7,0,0,1,2,3,1,0,1,0,5,3
401408527,North Dakota Fighting Hawks,C. Orth,4399919,,True,32.0,2,8,2,6,0,2,0,1,2,5,7,1,1,1,2,4,4
401408527,North Dakota Fighting Hawks,S. Hoskin,4704157,,False,4.0,0,1,0,1,0,0,0,0,1,0,1,1,0,0,0,0,0
401408527,North Dakota Fighting Hawks,D. Davis,4899785,,False,10.0,1,2,1,1,0,1,0,0,0,1,1,0,0,0,1,2,2
401408527,North Dakota Fighting Hawks,J. Daninger,4281357,,False,24.0,4,9,2,4,2,5,1,1,0,7,7,2,0,0,0,1,11
401408527,North Dakota Fighting Hawks,TEAM,TOTAL,TOTAL,False,,21,68,18,49,3,19,9,11,18,36,54,10,5,5,16,17,54
401408526,Western Illinois Leathernecks,E. Zars,4399483,,True,27.0,5,8,5,8,0,0,0,0,2,3,5,0,1,1,2,4,10
401408526,Western Illinois Leathernecks,J. Thorpe,4433305,,True,28.0,2,8,1,4,1,4,1,2,0,1,1,1,0,0,3,3,6
401408526,Western Illinois Leathernecks,E. Lutz,4400611,,True,31.0,2,8,2,4,0,4,0,1,1,4,5,5,2,0,4,4,4
401408526,Western Illinois Leathernecks,D. Nichols,4282521,,True,30.0,6,13,5,10,1,3,4,6,0,3,3,1,0,0,6,1,17
401408526,Western Illinois Leathernecks,S. Pryor,4069106,,True,18.0,0,0,0,0,0,0,0,0,0,1,1,1,0,0,3,0,0
401408526,Western Illinois Leathernecks,K. Flanagan,4597809,,False,15.0,3,3,2,2,1,1,0,0,1,3,4,2,0,0,2,0,7
401408526,Western Illinois Leathernecks,A. Dins,4597808,,False,15.0,0,1,0,0,0,1,0,0,1,2,3,0,1,0,1,4,0
401408526,Western Illinois Leathernecks,A. Deets,4704393,,False,27.0,1,2,1,1,0,1,3,3,0,0,0,0,0,0,2,0,5
401408526,Western Illinois Leathernecks,M. McDermott,4704391,,False,9.0,0,2,0,0,0,2,0,2,0,0,0,0,0,0,1,0,0
401408526,Western Illinois Leathernecks,TEAM,TOTAL,TOTAL,False,,19,45,16,29,3,16,8,14,5,21,26,10,4,1,24,16,49
401408526,South Dakota Coyotes,H. Sjerven,4068349,,True,13.0,3,6,3,6,0,0,5,6,4,4,8,0,3,0,1,4,11
401408526,South Dakota Coyotes,K. Watson,4704325,,True,29.0,2,10,0,4,2,6,0,0,0,5,5,1,4,1,1,2,6
401408526,South Dakota Coyotes,M. Krull,4433474,,True,27.0,3,7,3,5,0,2,0,0,3,1,4,2,1,0,2,2,6
401408526,South Dakota Coyotes,C. Lamb,4282528,,True,28.0,2,8,0,3,2,5,0,0,0,7,7,2,1,0,1,1,6
401408526,South Dakota Coyotes,L. Korngable,4282526,,True,20.0,4,7,3,4,1,3,1,1,0,1,1,4,0,0,1,3,10
401408526,South Dakota Coyotes,M. Hansen,4704323,,False,1.0,0,1,0,1,0,0,0,0,0,0,0,0,0,0,0,0,0
401408526,South Dakota Coyotes,J. Ugofsky,4595855,,False,10.0,1,2,1,1,0,1,0,0,2,2,4,0,3,0,0,2,2
401408526,South Dakota Coyotes,A. Peplowski,4399655,,False,22.0,3,3,3,3,0,0,0,0,3,2,5,1,2,0,4,4,6
401408526,South Dakota Coyotes,R. Sankey,4399653,,False,3.0,0,0,0,0,0,0,0,0,0,0,0,0,0,0,0,1,0
401408526,South Dakota Coyotes,A. Williston,4398885,,False,1.0,1,2,1,2,0,0,1,1,0,0,0,0,0,0,0,0,3
401408526,South Dakota Coyotes,G. Larkins,4899816,,False,28.0,9,18,8,13,1,5,4,4,1,1,2,2,4,0,2,1,23
401408526,South Dakota Coyotes,M. Guebert,4595854,,False,18.0,0,4,0,1,0,3,2,2,1,0,1,1,0,0,0,0,2
401408526,South Dakota Coyotes,TEAM,TOTAL,TOTAL,False,,28,68,22,43,6,25,13,14,16,24,40,13,18,1,12,20,75
401408525,South Dakota State Jackrabbits,T. Nelson,4595883,,True,21.0,6,8,4,6,2,2,1,2,1,1,2,2,2,2,0,3,15
401408525,South Dakota State Jackrabbits,P. Burckhard,4399649,,True,25.0,8,13,7,10,1,3,1,1,1,7,8,4,0,2,1,2,18
401408525,South Dakota State Jackrabbits,M. Selland,4282531,,True,25.0,10,14,6,8,4,6,2,3,0,5,5,2,0,0,1,1,26
401408525,South Dakota State Jackrabbits,T. Irwin,4282530,,True,25.0,2,4,2,3,0,1,3,3,1,1,2,3,0,0,1,1,7
401408525,South Dakota State Jackrabbits,L. Theuninck,4282529,,True,22.0,0,3,0,1,0,2,0,0,3,4,7,2,0,0,1,2,0
401408525,South Dakota State Jackrabbits,M. Byom,4704383,,False,4.0,0,2,0,1,0,1,0,0,1,1,2,0,0,0,0,1,0
401408525,South Dakota State Jackrabbits,M. Vlastuin,4704382,,False,4.0,0,2,0,0,0,2,0,0,0,0,0,1,0,0,0,0,0
401408525,South Dakota State Jackrabbits,K. Theisen,4595882,,False,19.0,4,7,4,7,0,0,0,0,2,4,6,1,1,4,0,0,8
401408525,South Dakota State Jackrabbits,A. Hirschman,4399651,,False,3.0,0,0,0,0,0,0,0,2,0,1,1,0,0,0,0,1,0
401408525,South Dakota State Jackrabbits,H. Timmer,4899819,,False,23.0,1,8,0,3,1,5,2,2,1,1,2,2,0,0,0,0,5
401408525,South Dakota State Jackrabbits,R. Nesheim,4595886,,False,7.0,1,3,1,2,0,1,0,0,1,0,1,1,0,0,1,0,2
401408525,South Dakota State Jackrabbits,L. Rongisch,4399647,,False,4.0,1,1,0,0,1,1,0,0,0,0,0,0,0,0,0,0,3
401408525,South Dakota State Jackrabbits,H. Greer,4068252,,False,18.0,1,3,1,3,0,0,0,0,0,3,3,4,0,0,2,0,2
401408525,South Dakota State Jackrabbits,TEAM,TOTAL,TOTAL,False,,34,68,25,44,9,24,9,13,13,31,44,22,3,8,7,11,86
401408525,Denver Pioneers,U. Ezeudu,4595918,,True,32.0,9,19,8,17,1,2,6,7,3,2,5,1,1,3,2,1,25
401408525,Denver Pioneers,M. Minett,4595525,,True,20.0,1,8,1,8,0,0,0,0,0,4,4,1,0,2,0,1,2
401408525,Denver Pioneers,T. Santos,4281590,,True,25.0,3,9,3,6,0,3,0,0,0,2,2,2,0,0,0,1,6
401408525,Denver Pioneers,A. Jackson,4399656,,True,34.0,2,6,0,1,2,5,2,2,1,6,7,1,1,0,1,2,8
401408525,Denver Pioneers,I. Sanders,4280986,,True,33.0,5,7,5,6,0,1,0,0,0,2,2,2,1,0,4,2,10
401408525,Denver Pioneers,C. Forney,4704228,,False,11.0,1,3,1,3,0,0,0,0,2,0,2,1,0,0,0,2,2
401408525,Denver Pioneers,M. Wilson,4899766,,False,4.0,0,0,0,0,0,0,0,0,0,0,0,0,0,0,0,0,0
401408525,Denver Pioneers,E. Counsel,4704225,,False,13.0,2,5,2,4,0,1,2,3,0,1,1,2,0,0,0,2,6
401408525,Denver Pioneers,M. Boyd,4595914,,False,28.0,0,5,0,1,0,4,0,0,0,3,3,0,0,0,1,2,0
401408525,Denver Pioneers,TEAM,TOTAL,TOTAL,False,,23,62,20,46,3,16,10,12,8,22,30,10,3,5,9,13,59
401408524,Drexel Dragons,K. Connolly,4399844,,True,19.0,1,3,1,1,0,2,0,0,0,2,2,0,0,0,1,0,2
401408524,Drexel Dragons,T. Brugler,4280995,,True,37.0,5,9,5,6,0,3,7,7,4,4,8,1,1,0,2,2,17
401408524,Drexel Dragons,M. Leonard,4068316,,True,25.0,1,3,1,3,0,0,0,0,1,3,4,2,1,0,1,3,2
401408524,Drexel Dragons,K. Washington,4399843,,True,39.0,8,26,6,17,2,9,4,6,0,2,2,1,1,0,1,3,22
401408524,Drexel Dragons,H. Nihill,4281431,,True,40.0,4,17,3,11,1,6,4,4,2,1,3,2,2,0,2,5,13
401408524,Drexel Dragons,J. Valentine,4704570,,False,11.0,0,1,0,1,0,0,0,0,2,1,3,1,1,0,1,2,0
401408524,Drexel Dragons,H. Saatman,4594714,,False,1.0,0,0,0,0,0,0,0,0,0,0,0,0,0,0,0,0,0
401408524,Drexel Dragons,M. Hendrixson,4399845,,False,28.0,1,4,0,1,1,3,0,0,1,6,7,5,0,0,1,3,3
401408524,Drexel Dragons,TEAM,TOTAL,TOTAL,False,,20,63,16,40,4,23,15,17,14,20,34,12,6,0,9,18,59
401408524,Delaware Blue Hens,Ty Battle,4282255,,True,40.0,4,7,4,7,0,0,0,0,4,8,12,0,1,1,3,3,8
401408524,Delaware Blue Hens,L. Oleary,4281427,,True,40.0,3,3,3,3,0,0,1,2,3,4,7,5,0,1,1,3,7
401408524,Delaware Blue Hens,T. Skinner,4704510,,True,35.0,3,11,0,5,3,6,1,2,0,3,3,2,1,0,7,5,10
401408524,Delaware Blue Hens,J. Dickey,4399842,,True,40.0,9,22,6,18,3,4,6,9,9,9,18,3,2,0,3,3,27
401408524,Delaware Blue Hens,P. McBride,4399841,,True,31.0,2,5,1,2,1,3,2,2,1,0,1,3,2,0,3,2,7
401408524,Delaware Blue Hens,T. Johnson,4704512,,False,5.0,0,2,0,2,0,0,0,2,0,1,1,0,0,0,1,3,0
401408524,Delaware Blue Hens,J. Smalls,4400634,,False,9.0,1,5,0,1,1,4,1,2,0,1,1,0,0,0,1,0,4
401408524,Delaware Blue Hens,TEAM,TOTAL,TOTAL,False,,22,55,14,38,8,17,11,19,17,30,47,13,6,2,20,19,63
401408523,Towson Tigers,A. Kubek,4705046,,True,39.0,4,9,1,2,3,7,1,2,4,6,10,2,0,1,3,1,12
401408523,Towson Tigers,R. Tucker,4594725,,True,24.0,0,2,0,2,0,0,0,0,1,0,1,0,0,1,2,1,0
401408523,Towson Tigers,T. Gary,4705049,,True,38.0,6,15,3,10,3,5,0,0,0,2,2,1,1,0,2,2,15
401408523,Towson Tigers,R. Evans,4433397,,True,25.0,3,5,3,4,0,1,0,1,1,3,4,0,2,0,0,2,6
401408523,Towson Tigers,A. Nelson,4433355,,True,34.0,1,13,1,6,0,7,3,3,2,2,4,5,1,0,1,1,5
401408523,Towson Tigers,N. Dodson,4705048,,False,0.0,0,0,0,0,0,0,0,0,0,0,0,0,0,0,0,0,0
401408523,Towson Tigers,A. Rivera,4433681,,False,17.0,1,5,1,4,0,1,0,0,2,1,3,1,0,1,0,1,2
401408523,Towson Tigers,S. Williams,4705047,,False,3.0,0,0,0,0,0,0,0,0,0,0,0,0,0,0,0,1,0
401408523,Towson Tigers,K. Kornegay-Lucas,4433095,,False,20.0,7,16,7,14,0,2,1,1,2,6,8,2,3,2,4,4,15
401408523,Towson Tigers,TEAM,TOTAL,TOTAL,False,,22,65,16,42,6,23,5,7,13,21,34,11,7,5,14,13,55
401408523,Delaware Blue Hens,Ty Battle,4282255,,True,40.0,5,8,5,8,0,0,1,2,3,10,13,0,2,0,4,2,11
401408523,Delaware Blue Hens,L. Oleary,4281427,,True,36.0,2,8,2,8,0,0,0,0,3,4,7,2,2,1,2,1,4
401408523,Delaware Blue Hens,T. Skinner,4704510,,True,35.0,3,11,1,7,2,4,2,2,0,1,1,3,1,0,4,3,10
401408523,Delaware Blue Hens,J. Dickey,4399842,,True,40.0,8,21,8,21,0,0,6,10,5,11,16,3,0,0,3,2,22
401408523,Delaware Blue Hens,P. McBride,4399841,,True,40.0,4,10,3,5,1,5,0,0,2,0,2,3,1,0,3,2,9
401408523,Delaware Blue Hens,M. Pippin,4703429,,False,4.0,0,0,0,0,0,0,0,0,0,0,0,0,0,0,1,1,0
401408523,Delaware Blue Hens,T. Johnson,4704512,,False,5.0,0,0,0,0,0,0,0,0,0,0,0,0,0,0,0,4,0
401408523,Delaware Blue Hens,J. Smalls,4400634,,False,0.0,0,1,0,0,0,1,0,0,0,0,0,0,0,0,0,0,0
401408523,Delaware Blue Hens,TEAM,TOTAL,TOTAL,False,,22,59,19,49,3,10,9,14,15,29,44,11,6,1,17,15,56
401408522,Drexel Dragons,K. Connolly,4399844,,True,24.0,0,0,0,0,0,0,2,2,1,1,2,1,0,0,1,1,2
401408522,Drexel Dragons,T. Brugler,4280995,,True,34.0,10,16,10,15,0,1,2,5,4,12,16,5,2,3,1,1,22
401408522,Drexel Dragons,M. Leonard,4068316,,True,33.0,3,7,3,7,0,0,1,1,6,4,10,2,1,0,0,1,7
401408522,Drexel Dragons,K. Washington,4399843,,True,30.0,11,21,8,14,3,7,0,1,0,1,1,5,2,0,2,4,25
401408522,Drexel Dragons,H. Nihill,4281431,,True,32.0,5,16,5,11,0,5,0,0,1,4,5,6,1,0,3,4,10
401408522,Drexel Dragons,J. Valentine,4704570,,False,9.0,1,2,1,2,0,0,0,0,1,2,3,0,0,0,0,0,2
401408522,Drexel Dragons,B. Borcky,4594717,,False,1.0,0,0,0,0,0,0,0,0,1,0,1,0,0,0,0,0,0
401408522,Drexel Dragons,H. Saatman,4594714,,False,1.0,0,1,0,1,0,0,0,0,0,0,0,0,0,0,0,0,0
401408522,Drexel Dragons,M. Hendrixson,4399845,,False,31.0,1,7,0,0,1,7,0,0,0,1,1,9,1,0,1,2,3
401408522,Drexel Dragons,T. Hyduke,4399080,,False,5.0,0,2,0,1,0,1,0,0,0,1,1,0,0,0,0,2,0
401408522,Drexel Dragons,TEAM,TOTAL,TOTAL,False,,31,72,27,51,4,21,5,9,14,28,42,28,7,3,10,15,71
401408522,Charleston Cougars,A. Eady,4399831,,True,25.0,5,7,5,7,0,0,1,2,1,9,10,0,0,1,3,4,11
401408522,Charleston Cougars,A. McGarity,4704471,,True,37.0,3,6,1,1,2,5,0,0,1,2,3,0,1,1,0,1,8
401408522,Charleston Cougars,L. Perkins,4399830,,True,24.0,3,7,2,5,1,2,2,2,1,1,2,2,0,0,2,3,9
401408522,Charleston Cougars,M. Taylor,4399829,,True,11.0,1,3,0,0,1,3,0,0,0,1,1,2,0,0,0,1,3
401408522,Charleston Cougars,J. Annecchiarico,4399317,,True,38.0,8,18,8,16,0,2,8,9,1,6,7,5,1,0,3,3,24
401408522,Charleston Cougars,Z. McCrary,4433463,,False,22.0,0,4,0,4,0,0,0,0,3,5,8,1,0,0,1,0,0
401408522,Charleston Cougars,B. McClure,4899573,,False,2.0,0,3,0,1,0,2,0,0,0,0,0,0,0,0,0,0,0
401408522,Charleston Cougars,G. Abercrombie,4899572,,False,21.0,0,3,0,1,0,2,3,3,0,2,2,0,0,0,3,1,3
401408522,Charleston Cougars,N. Covington,4594709,,False,3.0,0,0,0,0,0,0,0,0,0,1,1,0,0,0,0,0,0
401408522,Charleston Cougars,T. Collins,4399832,,False,17.0,2,9,1,5,1,4,2,2,1,1,2,1,0,0,1,0,7
401408522,Charleston Cougars,TEAM,TOTAL,TOTAL,False,,22,60,17,40,5,20,16,18,9,30,39,11,2,2,13,13,65
401408521,Towson Tigers,A. Kubek,4705046,,True,30.0,2,9,1,6,1,3,3,8,3,5,8,2,0,2,0,1,8
401408521,Towson Tigers,A. Rivera,4433681,,True,25.0,4,7,3,6,1,1,2,4,2,6,8,0,0,0,3,3,11
401408521,Towson Tigers,T. Gary,4705049,,True,29.0,4,9,2,4,2,5,0,0,1,2,3,1,0,0,0,1,10
401408521,Towson Tigers,S. Williams,4705047,,True,18.0,0,4,0,1,0,3,2,2,4,1,5,0,0,1,0,1,2
401408521,Towson Tigers,A. Nelson,4433355,,True,39.0,3,19,2,15,1,4,7,8,1,4,5,3,0,0,1,2,14
401408521,Towson Tigers,N. Dodson,4705048,,False,6.0,0,0,0,0,0,0,0,0,0,1,1,0,0,0,0,0,0
401408521,Towson Tigers,R. Tucker,4594725,,False,20.0,1,5,1,5,0,0,0,0,2,5,7,0,1,0,1,0,2
401408521,Towson Tigers,R. Evans,4433397,,False,9.0,0,2,0,1,0,1,0,0,0,1,1,0,0,0,0,3,0
401408521,Towson Tigers,K. Kornegay-Lucas,4433095,,False,24.0,3,9,3,9,0,0,5,6,1,4,5,2,5,0,3,4,11
401408521,Towson Tigers,TEAM,TOTAL,TOTAL,False,,17,64,12,47,5,17,19,28,15,30,45,8,6,3,8,15,58
401408521,Northeastern Huskies,E. Calabrese,4281866,,True,28.0,4,10,4,10,0,0,0,0,3,6,9,3,0,0,4,3,8
401408521,Northeastern Huskies,C. Soriano,4899587,,True,26.0,1,11,1,6,0,5,0,0,1,0,1,3,3,0,2,5,2
401408521,Northeastern Huskies,G. Motema,4899585,,True,29.0,2,4,2,3,0,1,1,4,1,1,2,0,0,1,0,3,5
401408521,Northeastern Huskies,K. May,4400228,,True,39.0,7,14,3,7,4,7,0,0,0,3,3,1,1,1,1,2,18
401408521,Northeastern Huskies,K. Currence,4400226,,True,36.0,2,13,1,10,1,3,7,8,1,7,8,1,0,0,3,2,12
401408521,Northeastern Huskies,A. Parker,4899586,,False,2.0,0,0,0,0,0,0,0,0,0,0,0,0,0,0,0,2,0
401408521,Northeastern Huskies,L. Õztürk,4705029,,False,9.0,0,1,0,1,0,0,0,0,0,1,1,0,0,1,0,3,0
401408521,Northeastern Huskies,I. Larsen,4705028,,False,6.0,1,4,1,1,0,3,0,0,0,1,1,0,0,0,1,2,2
401408521,Northeastern Huskies,C. McCartney,4594735,,False,18.0,0,1,0,1,0,0,2,4,3,4,7,0,0,0,2,1,2
401408521,Northeastern Huskies,C. Clement,4899583,,False,7.0,0,2,0,0,0,2,0,0,0,0,0,0,0,0,0,1,0
401408521,Northeastern Huskies,TEAM,TOTAL,TOTAL,False,,17,60,12,39,5,21,10,16,13,29,42,8,4,3,14,24,49
401408520,William & Mary Tribe,D. McTeer,4899591,,True,22.0,0,3,0,3,0,0,0,0,0,3,3,1,1,0,1,1,0
401408520,William & Mary Tribe,B. Bellamy,4594744,,True,31.0,0,3,0,3,0,0,1,4,0,6,6,2,2,0,2,3,1
401408520,William & Mary Tribe,K. Sramac,4281413,,True,28.0,3,5,3,3,0,2,0,0,1,3,4,2,0,0,4,3,6
401408520,William & Mary Tribe,R. Casey,4281390,,True,37.0,5,15,2,6,3,9,2,3,0,3,3,0,1,0,5,1,15
401408520,William & Mary Tribe,S. Wagner,4281291,,True,36.0,1,13,1,8,0,5,5,6,0,4,4,3,0,0,3,0,7
401408520,William & Mary Tribe,R. Frisby-Smith,4705066,,False,6.0,0,0,0,0,0,0,0,0,0,1,1,0,0,1,1,0,0
401408520,William & Mary Tribe,K. Beckwith,4705064,,False,25.0,3,6,3,6,0,0,0,0,0,6,6,0,2,1,1,4,6
401408520,William & Mary Tribe,R. Montella,4899592,,False,13.0,0,1,0,1,0,0,0,0,0,0,0,0,0,0,0,0,0
401408520,William & Mary Tribe,L. Brown,4705065,,False,1.0,0,0,0,0,0,0,0,0,0,0,0,0,1,0,0,0,0
401408520,William & Mary Tribe,A. Stevenson,4589980,,False,1.0,0,1,0,1,0,0,0,0,0,0,0,0,0,0,0,0,0
401408520,William & Mary Tribe,TEAM,TOTAL,TOTAL,False,,12,47,9,31,3,16,8,13,3,28,31,8,7,2,21,12,35
401408520,Delaware Blue Hens,Ty Battle,4282255,,True,31.0,6,11,6,10,0,1,4,9,4,7,11,0,2,1,1,1,16
401408520,Delaware Blue Hens,L. Oleary,4281427,,True,26.0,0,5,0,4,0,1,1,2,4,11,15,1,2,2,1,2,1
401408520,Delaware Blue Hens,T. Skinner,4704510,,True,31.0,3,13,1,6,2,7,0,0,0,0,0,3,0,0,3,1,8
401408520,Delaware Blue Hens,J. Dickey,4399842,,True,37.0,12,20,12,19,0,1,5,5,6,4,10,0,6,1,5,1,29
401408520,Delaware Blue Hens,P. McBride,4399841,,True,33.0,2,7,2,4,0,3,0,1,0,3,3,5,2,0,4,2,4
401408520,Delaware Blue Hens,M. Sims,4068903,,False,14.0,0,1,0,1,0,0,0,0,2,3,5,0,1,1,0,1,0
401408520,Delaware Blue Hens,M. Pippin,4703429,,False,9.0,1,1,0,0,1,1,0,0,1,1,2,0,0,0,1,2,3
401408520,Delaware Blue Hens,M. Tejedor,4704513,,False,2.0,0,1,0,1,0,0,0,0,0,0,0,0,0,0,0,0,0
401408520,Delaware Blue Hens,T. Johnson,4704512,,False,4.0,0,2,0,2,0,0,0,0,0,1,1,0,0,0,0,0,0
401408520,Delaware Blue Hens,T. Cousins,4704511,,False,7.0,0,1,0,1,0,0,0,0,0,2,2,0,0,0,0,0,0
401408520,Delaware Blue Hens,J. Smalls,4400634,,False,6.0,0,4,0,1,0,3,0,0,2,1,3,0,0,0,0,0,0
401408520,Delaware Blue Hens,TEAM,TOTAL,TOTAL,False,,24,66,21,49,3,17,10,17,19,35,54,9,13,5,16,10,61
401408519,Elon Phoenix,E. McGill,4400005,,True,25.0,9,15,9,15,0,0,1,2,4,6,10,0,0,2,1,4,19
401408519,Elon Phoenix,B. Perpignan,4399846,,True,38.0,4,11,2,7,2,4,3,3,1,7,8,7,1,0,5,2,13
401408519,Elon Phoenix,V. Taylor,4594719,,True,27.0,2,4,2,3,0,1,0,0,0,3,3,2,1,0,0,3,4
401408519,Elon Phoenix,K. Liles,4399847,,True,32.0,3,12,1,3,2,9,2,2,1,4,5,3,0,1,5,2,10
401408519,Elon Phoenix,A. Nance,4281438,,True,29.0,2,6,2,3,0,3,2,3,1,3,4,2,0,0,3,3,6
401408519,Elon Phoenix,A. James,4704635,,False,20.0,0,5,0,2,0,3,0,0,1,5,6,3,1,1,2,1,0
401408519,Elon Phoenix,M. Johnson,4594720,,False,4.0,0,1,0,1,0,0,0,0,0,1,1,0,0,2,0,0,0
401408519,Elon Phoenix,T. Traore,4399850,,False,11.0,1,1,1,1,0,0,3,4,2,2,4,0,0,1,0,0,5
401408519,Elon Phoenix,B. Harmon,4433666,,False,8.0,0,0,0,0,0,0,0,0,0,0,0,0,0,0,0,0,0
401408519,Elon Phoenix,P. Carter,4281922,,False,6.0,1,2,1,1,0,1,0,0,0,0,0,0,0,0,0,0,2
401408519,Elon Phoenix,TEAM,TOTAL,TOTAL,False,,22,57,18,36,4,21,11,14,13,31,44,17,3,7,20,15,59
401408519,Charleston Cougars,A. Eady,4399831,,True,40.0,7,10,7,10,0,0,4,6,5,7,12,2,1,1,1,1,18
401408519,Charleston Cougars,A. McGarity,4704471,,True,35.0,3,9,0,3,3,6,0,0,2,2,4,1,1,0,1,4,9
401408519,Charleston Cougars,L. Perkins,4399830,,True,36.0,7,19,7,15,0,4,0,1,1,2,3,1,2,0,0,1,14
401408519,Charleston Cougars,M. Taylor,4399829,,True,13.0,0,1,0,0,0,1,0,0,0,3,3,0,0,0,0,3,0
401408519,Charleston Cougars,J. Annecchiarico,4399317,,True,34.0,3,15,3,11,0,4,5,5,1,5,6,8,4,1,3,0,11
401408519,Charleston Cougars,G. Abercrombie,4899572,,False,18.0,1,5,0,1,1,4,0,0,1,2,3,1,0,1,1,0,3
401408519,Charleston Cougars,T. Collins,4399832,,False,24.0,5,13,3,8,2,5,3,4,1,2,3,1,0,0,1,3,15
401408519,Charleston Cougars,TEAM,TOTAL,TOTAL,False,,26,72,20,48,6,24,12,16,15,23,38,14,8,3,7,12,70
401408518,Hofstra Pride,J. Hines,4281440,,True,36.0,5,9,5,9,0,0,2,4,3,4,7,2,2,1,2,3,12
401408518,Hofstra Pride,J. Henry,4281212,,True,29.0,2,6,2,6,0,0,0,0,0,2,2,1,0,0,3,3,4
401408518,Hofstra Pride,S. Markisic,4433992,,True,24.0,4,9,3,3,1,6,0,0,0,0,0,1,1,0,3,1,9
401408518,Hofstra Pride,R. Nicholson,4399892,,True,34.0,1,7,0,4,1,3,0,2,2,5,7,1,1,1,4,3,3
401408518,Hofstra Pride,J. Knight,4398719,,True,33.0,2,7,2,5,0,2,0,0,2,2,4,3,1,0,3,3,4
401408518,Hofstra Pride,C. Reynolds,4399852,,False,7.0,0,0,0,0,0,0,0,0,0,0,0,1,0,0,0,0,0
401408518,Hofstra Pride,M. Custis,4703651,,False,11.0,1,3,1,1,0,2,0,0,0,1,1,0,0,0,0,1,2
401408518,Hofstra Pride,S. Ineza,4594722,,False,21.0,2,6,1,2,1,4,0,0,1,0,1,1,1,0,3,0,5
401408518,Hofstra Pride,J. Peacock,4399031,,False,5.0,0,0,0,0,0,0,0,0,0,0,0,0,0,0,1,0,0
401408518,Hofstra Pride,TEAM,TOTAL,TOTAL,False,,17,47,14,30,3,17,2,6,10,17,27,10,6,2,19,14,39
401408518,Drexel Dragons,K. Connolly,4399844,,True,22.0,0,3,0,1,0,2,0,0,0,0,0,0,2,2,1,1,0
401408518,Drexel Dragons,T. Brugler,4280995,,True,37.0,5,11,5,10,0,1,0,0,2,8,10,3,5,2,1,1,10
401408518,Drexel Dragons,M. Leonard,4068316,,True,34.0,2,7,2,7,0,0,4,4,3,3,6,3,0,0,2,1,8
401408518,Drexel Dragons,K. Washington,4399843,,True,34.0,8,15,5,9,3,6,2,2,1,2,3,1,1,0,2,2,21
401408518,Drexel Dragons,H. Nihill,4281431,,True,30.0,4,11,3,7,1,4,2,2,1,1,2,4,2,0,4,2,11
401408518,Drexel Dragons,J. Valentine,4704570,,False,7.0,1,1,1,1,0,0,0,0,0,2,2,0,0,0,0,1,2
401408518,Drexel Dragons,B. Borcky,4594717,,False,1.0,0,0,0,0,0,0,0,0,0,0,0,0,0,0,0,0,0
401408518,Drexel Dragons,H. Saatman,4594714,,False,4.0,1,1,1,1,0,0,0,0,0,0,0,0,0,0,0,1,2
401408518,Drexel Dragons,M. LaClair,4899567,,False,1.0,0,0,0,0,0,0,0,0,0,0,0,0,0,0,0,0,0
401408518,Drexel Dragons,M. Hendrixson,4399845,,False,24.0,1,4,1,1,0,3,2,2,0,2,2,6,3,0,0,1,4
401408518,Drexel Dragons,T. Hyduke,4399080,,False,6.0,0,2,0,1,0,1,2,2,0,1,1,0,0,0,1,1,2
401408518,Drexel Dragons,TEAM,TOTAL,TOTAL,False,,22,55,18,38,4,17,12,12,14,21,35,17,13,4,11,11,60
401408517,UNC Wilmington Seahawks,M. Hoggatt,4281484,,True,26.0,1,3,1,3,0,0,0,0,1,4,5,0,2,1,2,2,2
401408517,UNC Wilmington Seahawks,A. Henderson,4281098,,True,11.0,2,2,2,2,0,0,0,0,1,1,2,0,0,0,3,2,4
401408517,UNC Wilmington Seahawks,M. McMillan,4705002,,True,23.0,2,8,1,3,1,5,0,0,1,1,2,2,1,0,1,1,5
401408517,UNC Wilmington Seahawks,C. Gross,4399427,,True,20.0,1,4,1,4,0,0,0,0,0,0,0,5,0,0,3,4,2
401408517,UNC Wilmington Seahawks,S. DaCosta,4066581,,True,35.0,5,12,5,7,0,5,1,3,1,2,3,3,1,0,2,3,11
401408517,UNC Wilmington Seahawks,D. Carter,4281802,,False,17.0,2,4,2,4,0,0,0,0,2,4,6,2,0,1,0,1,4
401408517,UNC Wilmington Seahawks,J. Gamble,4899588,,False,6.0,0,2,0,2,0,0,0,0,0,0,0,0,0,0,0,0,0
401408517,UNC Wilmington Seahawks,E. Miller,4705005,,False,26.0,1,5,1,4,0,1,1,2,2,3,5,1,3,0,0,1,3
401408517,UNC Wilmington Seahawks,A. Best,4282146,,False,36.0,5,11,1,2,4,9,0,0,1,2,3,0,0,0,2,1,14
401408517,UNC Wilmington Seahawks,TEAM,TOTAL,TOTAL,False,,19,51,14,31,5,20,2,5,11,19,30,13,7,2,14,15,45
401408517,Hofstra Pride,J. Hines,4281440,,True,37.0,7,17,7,17,0,0,8,10,6,5,11,1,0,0,4,2,22
401408517,Hofstra Pride,J. Henry,4281212,,True,33.0,1,7,1,7,0,0,0,2,6,3,9,5,1,0,3,4,2
401408517,Hofstra Pride,S. Markisic,4433992,,True,23.0,1,5,0,2,1,3,1,2,0,0,0,0,1,0,2,0,4
401408517,Hofstra Pride,R. Nicholson,4399892,,True,35.0,3,8,3,6,0,2,0,0,0,1,1,0,3,0,3,1,6
401408517,Hofstra Pride,J. Knight,4398719,,True,38.0,1,4,0,2,1,2,1,2,0,4,4,3,4,1,4,4,4
401408517,Hofstra Pride,C. Reynolds,4399852,,False,3.0,0,0,0,0,0,0,0,0,0,1,1,0,0,0,0,0,0
401408517,Hofstra Pride,Z. Swint,4704976,,False,7.0,0,0,0,0,0,0,0,0,0,3,3,0,0,0,0,0,0
401408517,Hofstra Pride,M. Custis,4703651,,False,3.0,0,0,0,0,0,0,0,0,0,0,0,0,0,0,0,0,0
401408517,Hofstra Pride,S. Ineza,4594722,,False,19.0,2,6,0,1,2,5,2,2,0,1,1,0,1,0,0,0,8
401408517,Hofstra Pride,J. Peacock,4399031,,False,2.0,0,0,0,0,0,0,0,0,0,0,0,0,0,0,0,0,0
401408517,Hofstra Pride,TEAM,TOTAL,TOTAL,False,,15,47,11,35,4,12,12,18,14,21,35,9,10,1,17,11,46
401408513,UAlbany Great Danes,H. Haegerstrand,4594341,,True,37.0,1,6,0,3,1,3,5,6,2,2,4,1,3,1,1,3,8
401408513,UAlbany Great Danes,L. Phillips,4898946,,True,17.0,0,2,0,1,0,1,0,0,0,0,0,2,0,0,3,2,0
401408513,UAlbany Great Danes,K. Cooper,4704377,,True,35.0,3,8,3,8,0,0,2,2,2,10,12,5,1,0,2,2,8
401408513,UAlbany Great Danes,G. Heeps,4594787,,True,26.0,2,3,2,2,0,1,0,0,0,2,2,1,0,0,3,3,4
401408513,UAlbany Great Danes,E. Hahne,4398744,,True,35.0,4,7,2,4,2,3,3,6,0,9,9,1,0,0,2,1,13
401408513,UAlbany Great Danes,T. Hanner,4594342,,False,7.0,0,0,0,0,0,0,0,0,0,0,0,1,0,0,1,1,0
401408513,UAlbany Great Danes,F. Werth,4898947,,False,16.0,1,1,0,0,1,1,0,0,2,1,3,0,0,0,1,1,3
401408513,UAlbany Great Danes,M. Haney,4594340,,False,27.0,6,14,2,9,4,5,4,6,1,2,3,1,1,0,1,1,20
401408513,UAlbany Great Danes,TEAM,TOTAL,TOTAL,False,,17,41,9,27,8,14,14,20,7,27,34,12,5,1,18,14,56
401408513,Maine Black Bears,M. Carroll,4281151,,True,38.0,3,14,3,14,0,0,3,4,5,4,9,2,3,3,3,3,9
401408513,Maine Black Bears,C. Bornemann,4704599,,True,37.0,5,11,5,9,0,2,3,4,1,5,6,0,1,2,1,4,13
401408513,Maine Black Bears,P. Gallego,4898963,,True,14.0,0,1,0,1,0,0,0,0,0,0,0,2,1,0,0,3,0
401408513,Maine Black Bears,A. Orois,4704597,,True,40.0,3,9,3,8,0,1,1,3,0,1,1,4,2,0,7,3,7
401408513,Maine Black Bears,A. Simon,4594354,,True,40.0,6,14,4,7,2,7,1,2,1,5,6,1,2,0,0,2,15
401408513,Maine Black Bears,A. Smith,4898966,,False,2.0,0,1,0,1,0,0,0,0,0,1,1,0,0,0,0,0,0
401408513,Maine Black Bears,O. Rockwood,4704595,,False,29.0,1,3,0,0,1,3,0,0,2,1,3,1,1,0,0,3,3
401408513,Maine Black Bears,TEAM,TOTAL,TOTAL,False,,18,53,15,40,3,13,8,13,10,17,27,10,10,5,11,18,47
401408512,NJIT Highlanders,M. Fux,4594416,,True,13.0,0,1,0,1,0,0,0,0,1,2,3,1,0,0,1,0,0
401408512,NJIT Highlanders,K. Evans,4281378,,True,26.0,6,9,6,8,0,1,0,0,0,3,3,1,0,2,2,0,12
401408512,NJIT Highlanders,K. Squier,4594414,,True,31.0,4,8,3,7,1,1,1,2,1,2,3,4,0,0,0,0,10
401408512,NJIT Highlanders,E. Stoll,4281343,,True,39.0,2,9,1,5,1,4,1,2,0,3,3,3,0,0,4,0,6
401408512,NJIT Highlanders,M. Martin,4281339,,True,24.0,1,1,0,0,1,1,0,0,0,0,0,3,0,0,1,1,3
401408512,NJIT Highlanders,T. Williams,4898967,,False,2.0,0,0,0,0,0,0,0,0,0,1,1,0,0,1,2,0,0
401408512,NJIT Highlanders,L. Anderson,4704170,,False,17.0,2,5,1,3,1,2,0,0,1,3,4,4,0,0,1,3,5
401408512,NJIT Highlanders,K. Brereton,4704168,,False,4.0,0,0,0,0,0,0,0,0,0,0,0,0,0,0,0,0,0
401408512,NJIT Highlanders,L. Syrek,4704165,,False,0.0,0,0,0,0,0,0,0,0,0,0,0,0,0,0,0,0,0
401408512,NJIT Highlanders,R. Vaughan,4898968,,False,0.0,0,0,0,0,0,0,0,0,0,0,0,0,0,0,0,0,0
401408512,NJIT Highlanders,A. Myers,4704167,,False,24.0,5,7,3,5,2,2,0,0,0,1,1,1,0,1,3,2,12
401408512,NJIT Highlanders,G. Plummer,4704166,,False,6.0,0,0,0,0,0,0,0,0,0,1,1,0,0,0,0,0,0
401408512,NJIT Highlanders,K. Dalrymple,4594418,,False,10.0,0,2,0,1,0,1,0,0,0,1,1,0,0,0,0,1,0
401408512,NJIT Highlanders,K. Cash,4594415,,False,1.0,0,1,0,1,0,0,0,0,1,0,1,0,0,0,0,0,0
401408512,NJIT Highlanders,S. Schultz,4399876,,False,3.0,0,0,0,0,0,0,0,0,0,0,0,0,0,0,0,0,0
401408512,NJIT Highlanders,TEAM,TOTAL,TOTAL,False,,20,43,14,31,6,12,2,4,5,22,27,17,0,4,19,7,48
401408512,Maine Black Bears,M. Carroll,4281151,,True,37.0,8,17,8,17,0,0,0,0,6,4,10,7,3,1,0,1,16
401408512,Maine Black Bears,C. Bornemann,4704599,,True,37.0,2,4,0,2,2,2,6,6,1,4,5,1,1,0,0,1,12
401408512,Maine Black Bears,P. Gallego,4898963,,True,19.0,1,8,1,4,0,4,0,0,2,0,2,2,1,0,1,0,2
401408512,Maine Black Bears,A. Orois,4704597,,True,40.0,9,12,8,9,1,3,1,2,0,3,3,7,2,1,0,1,20
401408512,Maine Black Bears,A. Simon,4594354,,True,39.0,5,14,4,9,1,5,0,0,1,2,3,5,1,0,1,1,11
401408512,Maine Black Bears,A. Smith,4898966,,False,3.0,1,2,1,2,0,0,0,0,0,1,1,0,0,0,1,2,2
401408512,Maine Black Bears,B. Wilborn,4898965,,False,1.0,0,0,0,0,0,0,0,0,0,0,0,1,0,0,0,0,0
401408512,Maine Black Bears,L. Mittelstadt,4704596,,False,1.0,0,1,0,0,0,1,0,0,0,1,1,0,0,0,0,0,0
401408512,Maine Black Bears,O. Rockwood,4704595,,False,23.0,3,5,0,0,3,5,0,0,0,0,0,1,1,1,1,3,9
401408512,Maine Black Bears,TEAM,TOTAL,TOTAL,False,,29,63,22,43,7,20,7,8,12,18,30,24,9,3,5,9,72
401408511,Vermont Catamounts,A. Olson,4704725,,True,27.0,4,9,4,9,0,0,5,5,3,3,6,0,1,1,3,4,13
401408511,Vermont Catamounts,D. Richason,4594379,,True,31.0,4,10,1,3,3,7,0,0,0,3,3,0,0,1,3,4,11
401408511,Vermont Catamounts,C. Gilwee,4898987,,True,30.0,2,7,1,4,1,3,0,0,0,3,3,2,1,0,1,0,5
401408511,Vermont Catamounts,E. Utterback,4594378,,True,40.0,6,14,6,13,0,1,4,6,0,4,4,7,1,0,4,3,16
401408511,Vermont Catamounts,J. Larkins,4281142,,True,37.0,2,8,1,1,1,7,0,0,0,0,0,2,2,0,0,2,5
401408511,Vermont Catamounts,M. Myklebust,4898988,,False,9.0,0,0,0,0,0,0,0,0,0,0,0,0,0,0,0,0,0
401408511,Vermont Catamounts,A. Dizon,4898985,,False,4.0,0,1,0,1,0,0,0,0,2,2,4,0,0,1,1,0,0
401408511,Vermont Catamounts,S. Wells,4399291,,False,22.0,2,5,2,4,0,1,0,0,2,3,5,0,1,1,0,3,4
401408511,Vermont Catamounts,TEAM,TOTAL,TOTAL,False,,20,54,15,35,5,19,9,11,7,20,27,11,6,4,14,16,54
401408511,UAlbany Great Danes,H. Haegerstrand,4594341,,True,31.0,6,9,2,4,4,5,2,3,1,2,3,1,0,3,2,4,18
401408511,UAlbany Great Danes,L. Decortes,4399024,,True,2.0,0,0,0,0,0,0,0,0,0,0,0,0,0,0,1,0,0
401408511,UAlbany Great Danes,L. Phillips,4898946,,True,14.0,0,3,0,2,0,1,0,0,1,1,2,1,1,0,0,0,0
401408511,UAlbany Great Danes,K. Cooper,4704377,,True,30.0,4,8,4,8,0,0,3,7,3,9,12,4,1,0,1,1,11
401408511,UAlbany Great Danes,G. Heeps,4594787,,True,22.0,0,2,0,1,0,1,0,0,0,1,1,1,1,0,2,2,0
401408511,UAlbany Great Danes,K. Sims,4898948,,False,5.0,1,2,1,2,0,0,0,0,0,0,0,0,0,0,0,1,2
401408511,UAlbany Great Danes,T. Hanner,4594342,,False,6.0,0,1,0,1,0,0,0,0,0,0,0,1,0,0,2,1,0
401408511,UAlbany Great Danes,F. Werth,4898947,,False,25.0,3,7,1,3,2,4,0,0,4,2,6,2,0,0,1,2,8
401408511,UAlbany Great Danes,F. Lee,4595154,,False,6.0,2,2,1,1,1,1,0,0,0,0,0,0,0,0,0,0,5
401408511,UAlbany Great Danes,M. Haney,4594340,,False,29.0,2,9,2,7,0,2,2,2,1,3,4,3,2,0,4,0,6
401408511,UAlbany Great Danes,E. Hahne,4398744,,False,30.0,7,13,5,9,2,4,1,2,2,5,7,2,2,0,1,1,17
401408511,UAlbany Great Danes,TEAM,TOTAL,TOTAL,False,,25,56,16,38,9,18,8,14,13,26,39,15,7,3,15,12,67
401408510,Maine Black Bears,M. Carroll,4281151,,True,34.0,6,12,6,12,0,0,2,2,2,5,7,4,2,1,4,3,14
401408510,Maine Black Bears,C. Bornemann,4704599,,True,39.0,8,13,6,7,2,6,3,3,1,2,3,2,2,1,2,3,21
401408510,Maine Black Bears,P. Gallego,4898963,,True,35.0,1,4,1,3,0,1,1,2,3,4,7,2,1,0,1,1,3
401408510,Maine Black Bears,A. Orois,4704597,,True,39.0,2,10,1,4,1,6,0,0,0,2,2,6,2,0,6,2,5
401408510,Maine Black Bears,A. Simon,4594354,,True,39.0,6,16,5,8,1,8,4,4,3,9,12,1,3,0,1,1,17
401408510,Maine Black Bears,A. Smith,4898966,,False,6.0,1,2,1,2,0,0,0,0,1,0,1,2,0,0,0,1,2
401408510,Maine Black Bears,B. Wilborn,4898965,,False,1.0,0,0,0,0,0,0,1,2,0,0,0,0,0,0,0,0,1
401408510,Maine Black Bears,S. Hodgson,4898962,,False,1.0,0,0,0,0,0,0,0,0,0,0,0,0,0,0,0,0,0
401408510,Maine Black Bears,L. Mittelstadt,4704596,,False,1.0,0,0,0,0,0,0,0,0,0,0,0,0,0,0,0,0,0
401408510,Maine Black Bears,O. Rockwood,4704595,,False,5.0,0,0,0,0,0,0,0,0,0,0,0,0,0,0,0,0,0
401408510,Maine Black Bears,TEAM,TOTAL,TOTAL,False,,24,57,20,36,4,21,11,13,12,24,36,17,10,2,14,11,63
401408510,Hartford Hawks,P. Maurina,4704589,,True,37.0,4,15,3,9,1,6,1,2,1,5,6,3,0,0,3,3,10
401408510,Hartford Hawks,L. Farcy,4704150,,True,38.0,2,7,1,5,1,2,0,0,1,1,2,5,2,0,4,2,5
401408510,Hartford Hawks,C. Villalobos,4594351,,True,40.0,4,7,3,6,1,1,4,4,1,8,9,1,4,0,2,2,13
401408510,Hartford Hawks,J. Ingram,4399198,,True,37.0,4,12,3,11,1,1,0,0,0,4,4,3,0,1,6,5,9
401408510,Hartford Hawks,A. Streeter,4281859,,True,33.0,1,3,0,0,1,3,2,2,0,2,2,0,0,0,1,1,5
401408510,Hartford Hawks,N. Cecunjanin,4898960,,False,8.0,1,1,1,1,0,0,0,0,0,0,0,0,0,0,1,0,2
401408510,Hartford Hawks,B. Williams,4898958,,False,3.0,1,1,0,0,1,1,0,0,0,0,0,0,0,0,0,0,3
401408510,Hartford Hawks,M. Lee,4704592,,False,0.0,0,0,0,0,0,0,0,0,0,0,0,0,0,0,0,0,0
401408510,Hartford Hawks,S. Smith,4399200,,False,2.0,1,1,1,1,0,0,0,0,1,0,1,0,0,0,0,0,2
401408510,Hartford Hawks,S. Benharouga,4704591,,False,0.0,0,0,0,0,0,0,0,0,0,0,0,0,0,0,0,0,0
401408510,Hartford Hawks,N. Dowding,4898959,,False,0.0,0,0,0,0,0,0,0,0,0,0,0,0,0,0,0,0,0
401408510,Hartford Hawks,I. Primo,4594352,,False,2.0,0,0,0,0,0,0,0,0,0,0,0,1,0,0,0,0,0
401408510,Hartford Hawks,TEAM,TOTAL,TOTAL,False,,18,47,12,33,6,14,7,8,5,22,27,13,6,1,20,13,49
401408449,UMass Lowell River Hawks,D. Solis,4594361,,True,30.0,0,3,0,3,0,0,0,0,1,1,2,0,3,0,5,2,0
401408449,UMass Lowell River Hawks,J. Edmonds,4704207,,True,17.0,3,9,3,8,0,1,3,4,1,3,4,0,1,0,2,0,9
401408449,UMass Lowell River Hawks,B. Teal,4703745,,True,25.0,3,9,3,5,0,4,2,2,0,1,1,0,2,0,3,3,8
401408449,UMass Lowell River Hawks,K. Banwareesingh,4594359,,True,18.0,1,3,1,2,0,1,1,2,2,4,6,1,0,0,0,3,3
401408449,UMass Lowell River Hawks,K. Idom,4399260,,True,30.0,1,6,1,6,0,0,1,2,0,3,3,4,2,0,2,3,3
401408449,UMass Lowell River Hawks,A. Dowdy,4898981,,False,17.0,0,2,0,2,0,0,0,0,2,4,6,0,0,1,2,3,0
401408449,UMass Lowell River Hawks,S. Coombs,4704206,,False,5.0,0,0,0,0,0,0,0,0,0,0,0,0,0,0,0,0,0
401408449,UMass Lowell River Hawks,I. Finley,4898983,,False,31.0,2,9,1,4,1,5,1,2,1,3,4,0,1,0,2,2,6
401408449,UMass Lowell River Hawks,L. Rodriguez,4704204,,False,17.0,0,0,0,0,0,0,0,0,0,2,2,0,0,0,3,0,0
401408449,UMass Lowell River Hawks,S. Price,4594362,,False,10.0,2,5,2,4,0,1,0,0,0,0,0,0,0,0,0,0,4
401408449,UMass Lowell River Hawks,TEAM,TOTAL,TOTAL,False,,12,46,11,34,1,12,8,12,10,21,31,5,9,1,19,17,33
401408449,NJIT Highlanders,M. Fux,4594416,,True,22.0,3,7,1,3,2,4,0,0,0,3,3,0,1,0,0,3,8
401408449,NJIT Highlanders,K. Evans,4281378,,True,14.0,0,3,0,3,0,0,0,0,0,1,1,0,0,2,0,2,0
401408449,NJIT Highlanders,K. Squier,4594414,,True,22.0,7,12,7,11,0,1,0,0,2,2,4,1,4,1,3,0,14
401408449,NJIT Highlanders,E. Stoll,4281343,,True,34.0,6,13,6,10,0,3,1,2,0,4,4,1,1,0,3,3,13
401408449,NJIT Highlanders,M. Martin,4281339,,True,34.0,0,2,0,1,0,1,3,4,1,4,5,2,0,0,3,1,3
401408449,NJIT Highlanders,T. Williams,4898967,,False,6.0,0,1,0,0,0,1,0,0,0,2,2,0,0,0,1,1,0
401408449,NJIT Highlanders,L. Anderson,4704170,,False,18.0,2,4,2,3,0,1,0,0,2,3,5,3,0,0,1,0,4
401408449,NJIT Highlanders,K. Brereton,4704168,,False,20.0,1,3,1,2,0,1,0,3,3,1,4,1,1,2,0,1,2
401408449,NJIT Highlanders,A. Myers,4704167,,False,25.0,1,5,0,1,1,4,0,0,1,2,3,0,1,0,3,1,3
401408449,NJIT Highlanders,G. Plummer,4704166,,False,5.0,0,0,0,0,0,0,0,0,0,1,1,1,0,1,1,0,0
401408449,NJIT Highlanders,TEAM,TOTAL,TOTAL,False,,20,50,17,34,3,16,4,9,10,25,35,9,8,6,18,12,47
401408448,Vermont Catamounts,A. Olson,4704725,,True,29.0,9,15,9,15,0,0,4,7,6,3,9,1,0,1,1,4,22
401408448,Vermont Catamounts,D. Richason,4594379,,True,38.0,3,9,2,2,1,7,2,2,0,2,2,1,0,2,1,1,9
401408448,Vermont Catamounts,C. Gilwee,4898987,,True,37.0,3,10,3,4,0,6,2,4,0,2,2,4,0,0,0,2,8
401408448,Vermont Catamounts,E. Utterback,4594378,,True,39.0,8,20,8,20,0,0,3,4,0,3,3,4,4,0,2,1,19
401408448,Vermont Catamounts,J. Larkins,4281142,,True,25.0,1,4,0,0,1,4,2,2,0,3,3,0,2,0,2,1,5
401408448,Vermont Catamounts,M. Myklebust,4898988,,False,3.0,0,0,0,0,0,0,0,0,0,0,0,0,0,0,0,0,0
401408448,Vermont Catamounts,A. Dizon,4898985,,False,5.0,1,1,1,1,0,0,0,0,1,2,3,1,0,0,0,1,2
401408448,Vermont Catamounts,S. Wells,4399291,,False,24.0,0,0,0,0,0,0,6,6,2,2,4,0,1,0,1,4,6
401408448,Vermont Catamounts,TEAM,TOTAL,TOTAL,False,,25,59,23,42,2,17,19,25,12,19,31,11,7,3,7,14,71
401408448,Binghamton Bearcats,J. Van Dyke,4898954,,True,27.0,6,10,6,7,0,3,4,4,2,1,3,0,1,0,3,3,16
401408448,Binghamton Bearcats,B. Benonysdottir,4598224,,True,21.0,2,5,2,3,0,2,1,1,0,5,5,2,1,0,6,5,5
401408448,Binghamton Bearcats,C. Roberts,4594349,,True,40.0,2,5,2,5,0,0,0,0,1,0,1,1,1,0,3,3,4
401408448,Binghamton Bearcats,D. Bowman,4594345,,True,38.0,8,15,8,14,0,1,2,3,1,6,7,5,2,1,4,2,18
401408448,Binghamton Bearcats,H. Moore,4399026,,True,35.0,3,6,1,3,2,3,2,2,0,3,3,1,0,0,1,4,10
401408448,Binghamton Bearcats,G. Coleman,4898955,,False,18.0,0,2,0,2,0,0,2,2,1,2,3,1,0,0,2,3,2
401408448,Binghamton Bearcats,C. Traeger,4594347,,False,21.0,4,10,4,7,0,3,0,0,3,8,11,0,0,1,1,3,8
401408448,Binghamton Bearcats,C. Kirschenbaum,4898951,,False,0.0,0,0,0,0,0,0,0,0,0,0,0,0,0,0,0,0,0
401408448,Binghamton Bearcats,TEAM,TOTAL,TOTAL,False,,25,53,23,41,2,12,11,12,9,26,35,10,5,2,20,23,63
401408447,UAlbany Great Danes,H. Haegerstrand,4594341,,True,29.0,1,4,1,3,0,1,1,2,2,2,4,1,0,2,2,3,3
401408447,UAlbany Great Danes,L. Decortes,4399024,,True,19.0,2,5,2,5,0,0,0,2,3,1,4,2,1,1,1,2,4
401408447,UAlbany Great Danes,L. Phillips,4898946,,True,20.0,1,4,1,3,0,1,0,0,0,1,1,2,2,1,4,1,2
401408447,UAlbany Great Danes,K. Cooper,4704377,,True,29.0,7,11,7,11,0,0,0,1,2,3,5,2,0,0,1,2,14
401408447,UAlbany Great Danes,G. Heeps,4594787,,True,26.0,0,5,0,2,0,3,0,0,0,4,4,2,2,0,1,1,0
401408447,UAlbany Great Danes,K. Sims,4898948,,False,1.0,0,1,0,1,0,0,0,0,2,1,3,0,0,0,0,0,0
401408447,UAlbany Great Danes,T. Hanner,4594342,,False,5.0,0,0,0,0,0,0,0,0,0,0,0,0,1,0,0,0,0
401408447,UAlbany Great Danes,A. Ray,4898949,,False,3.0,0,0,0,0,0,0,0,0,0,0,0,0,0,0,0,1,0
401408447,UAlbany Great Danes,F. Werth,4898947,,False,14.0,4,4,0,0,4,4,0,0,1,1,2,0,0,0,0,2,12
401408447,UAlbany Great Danes,F. Lee,4595154,,False,3.0,0,1,0,0,0,1,0,0,0,0,0,0,0,0,0,1,0
401408447,UAlbany Great Danes,M. Haney,4594340,,False,25.0,2,9,2,7,0,2,4,6,0,3,3,3,3,0,3,4,8
401408447,UAlbany Great Danes,E. Hahne,4398744,,False,26.0,3,5,3,4,0,1,0,0,0,6,6,2,0,0,3,2,6
401408447,UAlbany Great Danes,TEAM,TOTAL,TOTAL,False,,20,49,16,36,4,13,5,11,11,25,36,14,9,4,16,19,49
401408447,New Hampshire Wildcats,I. Gogolin,4399269,,True,30.0,3,7,3,7,0,0,3,5,5,3,8,2,2,2,3,1,9
401408447,New Hampshire Wildcats,B. Stuart,4704606,,True,29.0,3,11,3,7,0,4,0,0,0,3,3,0,0,0,3,4,6
401408447,New Hampshire Wildcats,B. Kane,4594367,,True,25.0,2,5,1,1,1,4,0,0,0,3,3,0,2,2,1,0,5
401408447,New Hampshire Wildcats,H. Delaruelle,4594365,,True,27.0,2,6,2,3,0,3,0,0,1,3,4,4,1,0,3,4,4
401408447,New Hampshire Wildcats,A. Torres,4281156,,True,36.0,5,13,5,12,0,1,6,9,1,0,1,2,3,0,0,1,16
401408447,New Hampshire Wildcats,T. Davis,4898970,,False,7.0,0,1,0,1,0,0,1,4,0,0,0,0,0,0,1,1,1
401408447,New Hampshire Wildcats,K. Matulonis,4898971,,False,14.0,0,0,0,0,0,0,0,2,1,2,3,1,0,0,1,2,0
401408447,New Hampshire Wildcats,A. Groman,4704607,,False,24.0,1,3,0,1,1,2,0,0,0,1,1,0,0,0,1,3,3
401408447,New Hampshire Wildcats,S. Widmeyer,4399372,,False,8.0,0,1,0,0,0,1,0,0,0,1,1,0,1,0,2,0,0
401408447,New Hampshire Wildcats,S. Serbascewicz,4399270,,False,0.0,0,0,0,0,0,0,0,0,0,0,0,0,0,0,0,0,0
401408447,New Hampshire Wildcats,TEAM,TOTAL,TOTAL,False,,16,47,14,32,2,15,10,20,11,19,30,9,9,4,15,16,44
401404496,Mount St. Mary's Mountaineers,I. Hunt,4704996,,True,24.0,2,4,2,4,0,0,3,4,4,2,6,2,1,0,1,2,7
401404496,Mount St. Mary's Mountaineers,J. Tomasetti,4704999,,True,36.0,2,6,1,3,1,3,2,2,0,3,3,1,1,1,1,2,7
401404496,Mount St. Mary's Mountaineers,M. Harrison,4399572,,True,34.0,6,16,3,3,3,13,2,2,0,1,1,1,2,0,2,0,17
401404496,Mount St. Mary's Mountaineers,K. Agentowicz,4069294,,True,32.0,4,7,3,5,1,2,0,0,1,1,2,3,3,0,1,3,9
401404496,Mount St. Mary's Mountaineers,K. Bresee,4068556,,True,33.0,5,11,5,7,0,4,3,4,1,4,5,1,1,0,4,2,13
401404496,Mount St. Mary's Mountaineers,T. Borgosz,4281491,,False,19.0,1,4,0,2,1,2,0,0,0,4,4,0,2,0,1,1,3
401404496,Mount St. Mary's Mountaineers,J. Lee,4704997,,False,22.0,2,3,2,3,0,0,0,0,4,0,4,2,1,0,4,2,4
401404496,Mount St. Mary's Mountaineers,TEAM,TOTAL,TOTAL,False,,22,51,16,27,6,24,10,12,12,20,32,10,11,1,15,12,60
401404496,Bryant Bulldogs,M. Planes Fortuny,4705424,,True,20.0,1,8,1,8,0,0,0,0,2,0,2,2,0,0,2,3,2
401404496,Bryant Bulldogs,B. Bjelko,4281950,,True,35.0,8,11,8,11,0,0,0,1,2,2,4,0,0,1,3,3,16
401404496,Bryant Bulldogs,F. Jallow,4705425,,True,32.0,0,4,0,2,0,2,0,0,0,4,4,3,0,0,4,2,0
401404496,Bryant Bulldogs,L. Castagne,4705423,,True,28.0,1,5,0,2,1,3,0,0,0,0,0,0,1,0,2,2,3
401404496,Bryant Bulldogs,N. Gallagher,4595707,,True,39.0,3,7,2,3,1,4,1,1,1,4,5,5,3,0,3,3,8
401404496,Bryant Bulldogs,D. Kiefer,4900604,,False,1.0,0,0,0,0,0,0,0,0,0,0,0,0,0,0,0,0,0
401404496,Bryant Bulldogs,J. Golden,4705426,,False,1.0,0,0,0,0,0,0,0,0,0,1,1,0,0,0,0,0,0
401404496,Bryant Bulldogs,B. Chasco,4595705,,False,1.0,1,1,1,1,0,0,0,0,0,0,0,0,0,0,0,0,2
401404496,Bryant Bulldogs,M. Neira Martinez,4900602,,False,1.0,0,0,0,0,0,0,0,0,0,0,0,0,0,0,0,0,0
401404496,Bryant Bulldogs,K. Reynolds,4705227,,False,11.0,1,2,1,1,0,1,3,3,0,1,1,1,0,0,0,1,5
401404496,Bryant Bulldogs,M. Bodziony,4703744,,False,1.0,0,0,0,0,0,0,0,0,0,0,0,0,0,0,0,0,0
401404496,Bryant Bulldogs,S. O'Connor,4595708,,False,11.0,1,3,0,0,1,3,0,0,0,2,2,2,0,0,1,0,3
401404496,Bryant Bulldogs,A. Perkins,4595703,,False,19.0,1,4,0,0,1,4,0,0,0,2,2,0,1,0,3,1,3
401404496,Bryant Bulldogs,TEAM,TOTAL,TOTAL,False,,17,45,13,28,4,17,4,5,8,17,25,13,5,1,20,15,42
401404495,Fairleigh Dickinson Knights,C. Wilson,4704968,,True,36.0,6,18,6,18,0,0,1,4,5,8,13,1,6,0,2,2,13
401404495,Fairleigh Dickinson Knights,M. Stanley,4281968,,True,29.0,2,6,1,4,1,2,0,0,0,3,3,0,1,2,3,2,5
401404495,Fairleigh Dickinson Knights,D. Scott,4704967,,True,22.0,0,5,0,5,0,0,1,2,1,3,4,1,0,1,1,1,1
401404495,Fairleigh Dickinson Knights,A. Bell,4595726,,True,26.0,1,5,1,3,0,2,4,6,0,3,3,0,1,0,1,3,6
401404495,Fairleigh Dickinson Knights,M. Selvaggi,4399552,,True,26.0,1,6,1,5,0,1,1,2,0,4,4,1,1,0,1,2,3
401404495,Fairleigh Dickinson Knights,S. DeAngelo,4595727,,False,15.0,1,2,0,0,1,2,0,0,0,3,3,0,1,0,0,0,3
401404495,Fairleigh Dickinson Knights,D. Forgues,4595763,,False,18.0,2,6,2,4,0,2,0,0,1,1,2,1,0,0,2,2,4
401404495,Fairleigh Dickinson Knights,C. Carbonell,4595723,,False,7.0,0,1,0,0,0,1,0,0,0,1,1,0,0,0,1,0,0
401404495,Fairleigh Dickinson Knights,R. Niles,4399550,,False,21.0,1,9,0,3,1,6,0,0,0,0,0,1,2,0,0,1,3
401404495,Fairleigh Dickinson Knights,TEAM,TOTAL,TOTAL,False,,14,58,11,42,3,16,7,14,8,27,35,5,12,3,11,13,38
401404495,Bryant Bulldogs,M. Planes Fortuny,4705424,,True,38.0,4,11,4,10,0,1,0,0,0,6,6,2,0,1,4,2,8
401404495,Bryant Bulldogs,B. Bjelko,4281950,,True,33.0,5,12,5,12,0,0,2,2,1,5,6,1,0,0,3,0,12
401404495,Bryant Bulldogs,F. Jallow,4705425,,True,35.0,3,9,2,8,1,1,2,2,1,6,7,0,2,1,3,3,9
401404495,Bryant Bulldogs,L. Castagne,4705423,,True,39.0,1,6,1,5,0,1,0,0,1,5,6,1,1,0,4,3,2
401404495,Bryant Bulldogs,N. Gallagher,4595707,,True,30.0,4,6,3,4,1,2,2,3,1,8,9,1,0,1,2,4,11
401404495,Bryant Bulldogs,J. Golden,4705426,,False,5.0,0,1,0,1,0,0,0,0,0,0,0,0,1,0,1,1,0
401404495,Bryant Bulldogs,K. Reynolds,4705227,,False,5.0,0,0,0,0,0,0,0,0,0,0,0,0,0,0,0,0,0
401404495,Bryant Bulldogs,S. O'Connor,4595708,,False,8.0,1,1,1,1,0,0,0,0,0,1,1,1,0,0,1,0,2
401404495,Bryant Bulldogs,A. Perkins,4595703,,False,7.0,0,2,0,0,0,2,0,0,0,1,1,0,0,0,2,0,0
401404495,Bryant Bulldogs,TEAM,TOTAL,TOTAL,False,,18,48,16,41,2,7,6,7,4,35,39,6,4,3,20,13,44
401404494,Wagner Seahawks,K. Nwabudu,4400017,,True,22.0,1,8,1,8,0,0,0,2,1,6,7,0,0,0,3,2,2
401404494,Wagner Seahawks,E. Grava,4399598,,True,31.0,2,6,1,5,1,1,2,2,2,4,6,1,1,1,1,3,7
401404494,Wagner Seahawks,D. Heyward,4595838,,True,28.0,1,7,1,6,0,1,2,2,0,3,3,1,2,0,2,4,4
401404494,Wagner Seahawks,A. Cowan,4595837,,True,31.0,2,10,0,5,2,5,6,6,0,5,5,1,1,0,3,1,12
401404494,Wagner Seahawks,Z. Thybulle,4400086,,True,40.0,5,18,2,10,3,8,0,0,0,2,2,4,2,0,1,3,13
401404494,Wagner Seahawks,K. Jackson,4595840,,False,19.0,2,2,2,2,0,0,0,0,2,2,4,0,1,1,1,3,4
401404494,Wagner Seahawks,L. Loceniece,4900500,,False,14.0,1,3,1,2,0,1,0,0,1,1,2,0,0,0,0,0,2
401404494,Wagner Seahawks,M. Sanchez-Henry,4705398,,False,13.0,3,4,3,3,0,1,0,0,1,0,1,0,0,0,0,1,6
401404494,Wagner Seahawks,R. Pitt,4399600,,False,2.0,0,0,0,0,0,0,0,0,0,0,0,0,0,0,0,0,0
401404494,Wagner Seahawks,TEAM,TOTAL,TOTAL,False,,17,58,11,41,6,17,10,12,8,26,34,7,7,2,11,17,50
401404494,Mount St. Mary's Mountaineers,I. Hunt,4704996,,True,27.0,2,4,1,3,1,1,2,2,1,7,8,2,1,0,1,3,7
401404494,Mount St. Mary's Mountaineers,J. Tomasetti,4704999,,True,17.0,3,4,2,2,1,2,2,2,0,5,5,0,0,0,1,3,9
401404494,Mount St. Mary's Mountaineers,M. Harrison,4399572,,True,37.0,7,11,4,5,3,6,2,2,1,1,2,0,0,0,2,2,19
401404494,Mount St. Mary's Mountaineers,K. Agentowicz,4069294,,True,25.0,4,8,2,4,2,4,0,0,0,3,3,2,1,0,2,2,10
401404494,Mount St. Mary's Mountaineers,K. Bresee,4068556,,True,39.0,3,9,1,4,2,5,5,7,0,9,9,4,3,2,3,2,13
401404494,Mount St. Mary's Mountaineers,T. Borgosz,4281491,,False,10.0,0,3,0,3,0,0,1,2,0,4,4,0,0,1,0,1,1
401404494,Mount St. Mary's Mountaineers,J. Lee,4704997,,False,19.0,0,2,0,0,0,2,0,0,1,2,3,1,0,0,3,1,0
401404494,Mount St. Mary's Mountaineers,A. Taylor,4281983,,False,26.0,1,8,0,1,1,7,0,0,0,2,2,1,0,0,4,3,3
401404494,Mount St. Mary's Mountaineers,TEAM,TOTAL,TOTAL,False,,20,49,10,22,10,27,12,15,4,34,38,10,5,3,16,17,62
401404493,Sacred Heart Pioneers,M. Bergdorf,4900507,,True,30.0,6,8,6,8,0,0,1,2,3,5,8,0,0,0,1,4,13
401404493,Sacred Heart Pioneers,S. Smith,4595781,,True,32.0,5,12,5,10,0,2,1,3,1,2,3,4,1,0,1,3,11
401404493,Sacred Heart Pioneers,O. Tucker,4594799,,True,36.0,3,11,1,4,2,7,1,1,1,2,3,4,0,0,2,2,9
401404493,Sacred Heart Pioneers,A. Hagood,4282006,,True,33.0,2,11,1,5,1,6,1,2,0,2,2,1,0,0,2,0,6
401404493,Sacred Heart Pioneers,A. McCray,4282005,,True,32.0,4,6,4,5,0,1,1,2,2,4,6,1,1,0,1,2,9
401404493,Sacred Heart Pioneers,K. Wood,4705033,,False,4.0,1,1,1,1,0,0,0,0,0,1,1,0,0,0,0,0,2
401404493,Sacred Heart Pioneers,C. Stroemel,4595782,,False,6.0,0,0,0,0,0,0,1,2,0,2,2,0,0,0,0,2,1
401404493,Sacred Heart Pioneers,W. Jackson,4399144,,False,12.0,2,3,1,1,1,2,0,0,0,1,1,1,0,1,0,2,5
401404493,Sacred Heart Pioneers,N. Johnson,4068964,,False,15.0,1,3,1,3,0,0,0,0,1,2,3,1,1,0,5,4,2
401404493,Sacred Heart Pioneers,TEAM,TOTAL,TOTAL,False,,24,55,20,37,4,18,6,12,11,24,35,12,3,1,13,19,58
401404493,Fairleigh Dickinson Knights,C. Wilson,4704968,,True,26.0,7,16,6,15,1,1,0,0,3,4,7,0,1,0,1,4,15
401404493,Fairleigh Dickinson Knights,M. Stanley,4281968,,True,31.0,7,11,7,10,0,1,5,8,0,2,2,2,0,3,0,3,19
401404493,Fairleigh Dickinson Knights,D. Scott,4704967,,True,25.0,1,3,1,2,0,1,0,0,1,2,3,3,0,0,1,3,2
401404493,Fairleigh Dickinson Knights,A. Bell,4595726,,True,34.0,6,10,2,4,4,6,4,5,4,4,8,1,0,0,1,2,20
401404493,Fairleigh Dickinson Knights,M. Selvaggi,4399552,,True,32.0,1,4,1,2,0,2,0,0,2,2,4,5,2,0,2,2,2
401404493,Fairleigh Dickinson Knights,S. DeAngelo,4595727,,False,9.0,1,3,1,2,0,1,0,0,1,0,1,0,0,0,0,2,2
401404493,Fairleigh Dickinson Knights,D. Forgues,4595763,,False,28.0,2,7,1,1,1,6,0,0,0,5,5,4,1,0,1,0,5
401404493,Fairleigh Dickinson Knights,C. Carbonell,4595723,,False,2.0,0,0,0,0,0,0,0,0,0,0,0,0,0,0,0,0,0
401404493,Fairleigh Dickinson Knights,R. Niles,4399550,,False,13.0,0,4,0,1,0,3,1,2,0,1,1,0,0,0,1,0,1
401404493,Fairleigh Dickinson Knights,TEAM,TOTAL,TOTAL,False,,25,58,19,37,6,21,10,15,12,23,35,15,4,3,9,16,66
401404492,Wagner Seahawks,K. Nwabudu,4400017,,True,25.0,5,13,5,13,0,0,1,2,3,5,8,2,3,0,1,2,11
401404492,Wagner Seahawks,E. Grava,4399598,,True,31.0,5,12,5,10,0,2,5,6,4,6,10,1,1,0,1,3,15
401404492,Wagner Seahawks,D. Heyward,4595838,,True,25.0,4,7,4,6,0,1,3,3,2,0,2,5,4,1,3,4,11
401404492,Wagner Seahawks,A. Cowan,4595837,,True,31.0,3,5,2,4,1,1,5,7,1,3,4,3,0,0,1,0,12
401404492,Wagner Seahawks,Z. Thybulle,4400086,,True,40.0,3,14,1,10,2,4,3,6,1,3,4,4,2,0,2,1,11
401404492,Wagner Seahawks,K. Jackson,4595840,,False,14.0,1,1,1,1,0,0,0,0,0,3,3,0,0,0,3,5,2
401404492,Wagner Seahawks,L. Loceniece,4900500,,False,21.0,1,7,1,1,0,6,2,2,0,2,2,1,0,0,1,1,4
401404492,Wagner Seahawks,M. Sanchez-Henry,4705398,,False,7.0,0,0,0,0,0,0,0,0,0,1,1,0,2,0,2,1,0
401404492,Wagner Seahawks,R. Pitt,4399600,,False,6.0,0,0,0,0,0,0,0,0,0,0,0,1,0,0,0,0,0
401404492,Wagner Seahawks,TEAM,TOTAL,TOTAL,False,,22,59,19,45,3,14,19,26,12,25,37,17,12,1,14,17,66
401404492,Long Island University Sharks,A. Flynn,4400230,,True,22.0,4,8,3,5,1,3,0,0,0,2,2,1,0,1,1,3,9
401404492,Long Island University Sharks,E. O'Brien,4900516,,True,36.0,5,14,4,7,1,7,1,2,1,1,2,2,1,0,5,3,12
401404492,Long Island University Sharks,Z. Hache,4705108,,True,8.0,1,2,1,2,0,0,0,0,0,2,2,0,0,0,2,0,2
401404492,Long Island University Sharks,B. Thomas,4399567,,True,36.0,5,14,3,7,2,7,6,7,1,9,10,1,0,0,5,4,18
401404492,Long Island University Sharks,K. Taylor,4399337,,True,32.0,3,5,3,5,0,0,1,1,2,3,5,3,1,0,4,4,7
401404492,Long Island University Sharks,M. Perkins,4595744,,False,3.0,0,0,0,0,0,0,0,0,0,0,0,0,0,0,0,0,0
401404492,Long Island University Sharks,K. Bell,4399563,,False,15.0,0,6,0,6,0,0,1,2,6,0,6,1,0,0,2,2,1
401404492,Long Island University Sharks,T. Eke,4900521,,False,11.0,0,0,0,0,0,0,0,0,0,4,4,0,0,2,0,0,0
401404492,Long Island University Sharks,D. Grim,4900518,,False,26.0,2,6,1,2,1,4,1,2,0,6,6,2,1,1,2,3,6
401404492,Long Island University Sharks,C. Gray,4399564,,False,11.0,0,0,0,0,0,0,0,0,0,1,1,0,3,0,1,2,0
401404492,Long Island University Sharks,TEAM,TOTAL,TOTAL,False,,20,55,15,34,5,21,10,14,12,30,42,10,6,4,24,21,55
401404491,St. Francis (PA) Red Flash,J. Dapaa,4399593,,True,35.0,4,8,4,8,0,0,5,6,4,10,14,1,2,1,3,4,13
401404491,St. Francis (PA) Red Flash,S. Miller,4595816,,True,29.0,2,5,2,5,0,0,1,2,0,3,3,0,0,0,2,2,5
401404491,St. Francis (PA) Red Flash,K. Maxwell,4705076,,True,31.0,2,8,1,6,1,2,0,0,1,0,1,0,2,0,1,1,5
401404491,St. Francis (PA) Red Flash,L. Benzel,4399592,,True,24.0,2,5,1,2,1,3,0,0,0,1,1,0,0,0,1,2,5
401404491,St. Francis (PA) Red Flash,J. McLemore,4399196,,True,28.0,2,7,2,7,0,0,2,4,0,2,2,1,1,0,5,0,6
401404491,St. Francis (PA) Red Flash,A. Moore,4705077,,False,16.0,0,1,0,1,0,0,1,2,1,2,3,0,0,0,0,3,1
401404491,St. Francis (PA) Red Flash,K. Kovac,4399594,,False,1.0,0,0,0,0,0,0,0,0,0,0,0,0,0,0,0,0,0
401404491,St. Francis (PA) Red Flash,D. Allen,4705074,,False,6.0,0,0,0,0,0,0,0,0,0,0,0,2,0,0,1,1,0
401404491,St. Francis (PA) Red Flash,H. Murphy,4595814,,False,1.0,0,0,0,0,0,0,0,0,0,0,0,0,0,0,0,0,0
401404491,St. Francis (PA) Red Flash,J. Mastellone,4282018,,False,29.0,6,10,5,8,1,2,5,6,0,2,2,2,0,0,2,4,18
401404491,St. Francis (PA) Red Flash,TEAM,TOTAL,TOTAL,False,,18,44,15,37,3,7,14,20,7,21,28,6,5,1,16,17,53
401404491,Mount St. Mary's Mountaineers,I. Hunt,4704996,,True,22.0,2,4,2,4,0,0,0,0,0,5,5,3,1,1,1,3,4
401404491,Mount St. Mary's Mountaineers,J. Tomasetti,4704999,,True,28.0,2,4,2,4,0,0,1,1,4,3,7,2,1,0,0,1,5
401404491,Mount St. Mary's Mountaineers,M. Harrison,4399572,,True,34.0,8,15,5,8,3,7,4,4,0,2,2,0,2,0,1,1,23
401404491,Mount St. Mary's Mountaineers,K. Agentowicz,4069294,,True,26.0,3,6,1,3,2,3,3,4,1,1,2,2,1,0,1,5,11
401404491,Mount St. Mary's Mountaineers,K. Bresee,4068556,,True,37.0,1,6,1,2,0,4,5,6,0,4,4,4,1,2,2,1,7
401404491,Mount St. Mary's Mountaineers,T. Borgosz,4281491,,False,15.0,4,8,3,6,1,2,0,0,1,3,4,0,1,0,0,0,9
401404491,Mount St. Mary's Mountaineers,J. Lee,4704997,,False,17.0,0,2,0,2,0,0,0,0,2,1,3,1,1,0,3,3,0
401404491,Mount St. Mary's Mountaineers,A. Taylor,4281983,,False,21.0,4,7,2,3,2,4,0,0,0,2,2,1,1,0,1,3,10
401404491,Mount St. Mary's Mountaineers,TEAM,TOTAL,TOTAL,False,,24,52,16,32,8,20,13,15,8,22,30,13,9,3,9,17,69
401404490,St. Francis Brooklyn Terriers,A. Lassen,4282034,,True,32.0,4,11,4,10,0,1,0,2,2,4,6,1,2,0,1,3,8
401404490,St. Francis Brooklyn Terriers,F. Horvath,4705057,,True,29.0,2,10,1,7,1,3,0,0,1,1,2,1,0,1,2,2,5
401404490,St. Francis Brooklyn Terriers,A. Fisher,4595797,,True,35.0,3,7,3,3,0,4,5,6,0,2,2,2,2,0,1,2,11
401404490,St. Francis Brooklyn Terriers,N. Dimitrijevic,4595796,,True,34.0,7,14,4,8,3,6,4,5,0,4,4,3,2,0,0,1,21
401404490,St. Francis Brooklyn Terriers,K. Edwards,4399597,,True,36.0,3,8,1,2,2,6,0,0,1,3,4,2,0,0,2,2,8
401404490,St. Francis Brooklyn Terriers,S. Bandoma,4900504,,False,0.0,0,0,0,0,0,0,0,0,0,0,0,0,0,0,0,0,0
401404490,St. Francis Brooklyn Terriers,Z. Hutchinson,4705058,,False,9.0,2,3,2,3,0,0,2,3,1,1,2,0,0,0,0,2,6
401404490,St. Francis Brooklyn Terriers,E. Varga,4705060,,False,3.0,0,1,0,1,0,0,0,0,0,0,0,0,0,0,0,1,0
401404490,St. Francis Brooklyn Terriers,J. McMillan,4595800,,False,1.0,0,0,0,0,0,0,0,0,0,0,0,0,0,0,0,0,0
401404490,St. Francis Brooklyn Terriers,I. Posset,4399577,,False,21.0,0,2,0,1,0,1,4,4,0,2,2,2,1,0,2,1,4
401404490,St. Francis Brooklyn Terriers,TEAM,TOTAL,TOTAL,False,,21,56,15,35,6,21,15,20,5,20,25,11,7,1,8,14,63
401404490,Bryant Bulldogs,M. Planes Fortuny,4705424,,True,28.0,7,14,7,14,0,0,3,3,3,4,7,3,0,0,2,3,17
401404490,Bryant Bulldogs,B. Bjelko,4281950,,True,37.0,6,6,6,6,0,0,2,4,2,6,8,2,0,2,3,2,14
401404490,Bryant Bulldogs,F. Jallow,4705425,,True,26.0,1,5,1,3,0,2,3,3,1,2,3,0,1,0,3,4,5
401404490,Bryant Bulldogs,L. Castagne,4705423,,True,34.0,3,9,3,5,0,4,0,0,0,2,2,2,2,0,1,5,6
401404490,Bryant Bulldogs,N. Gallagher,4595707,,True,38.0,6,10,3,4,3,6,4,4,2,10,12,3,1,0,2,2,19
401404490,Bryant Bulldogs,J. Golden,4705426,,False,8.0,0,1,0,1,0,0,0,0,0,1,1,0,0,0,0,1,0
401404490,Bryant Bulldogs,K. Reynolds,4705227,,False,9.0,1,5,1,4,0,1,2,2,0,3,3,1,0,0,0,1,4
401404490,Bryant Bulldogs,M. Bodziony,4703744,,False,5.0,0,2,0,2,0,0,0,0,0,1,1,1,0,0,0,0,0
401404490,Bryant Bulldogs,A. Perkins,4595703,,False,15.0,0,3,0,2,0,1,0,0,0,2,2,0,1,0,2,0,0
401404490,Bryant Bulldogs,TEAM,TOTAL,TOTAL,False,,24,55,21,41,3,14,14,16,9,32,41,12,5,2,15,18,65
401404465,Gonzaga Bulldogs,M. Kempton,4400478,,True,30.0,6,11,6,11,0,0,3,4,0,4,4,3,1,0,1,5,15
401404465,Gonzaga Bulldogs,A. Virjoghe,4400477,,True,24.0,3,7,3,7,0,0,0,0,0,6,6,2,0,4,1,0,6
401404465,Gonzaga Bulldogs,Kayle. Truong,4433148,,True,33.0,5,7,4,5,1,2,1,2,0,2,2,4,0,0,0,0,12
401404465,Gonzaga Bulldogs,A. O'Connor,4282263,,True,28.0,2,5,1,4,1,1,1,2,4,6,10,2,3,0,1,3,6
401404465,Gonzaga Bulldogs,C. Walker,4065787,,True,29.0,1,5,0,0,1,5,4,4,0,2,2,1,0,0,0,0,7
401404465,Gonzaga Bulldogs,Y. Ejim,4703874,,False,25.0,4,7,4,7,0,0,3,4,1,2,3,0,0,2,6,3,11
401404465,Gonzaga Bulldogs,M. Williams,4433490,,False,8.0,0,0,0,0,0,0,0,0,0,1,1,1,2,0,0,0,0
401404465,Gonzaga Bulldogs,Kayly. Truong,4433365,,False,23.0,3,7,1,3,2,4,6,6,0,4,4,0,0,0,2,2,14
401404465,Gonzaga Bulldogs,TEAM,TOTAL,TOTAL,False,,24,49,19,37,5,12,18,22,8,29,37,13,6,6,12,13,71
401404465,BYU Cougars,L. Gustin,4595746,,True,36.0,4,13,4,12,0,1,2,2,5,3,8,2,1,0,1,1,10
401404465,BYU Cougars,S. Gonzales,4400473,,True,40.0,7,18,7,16,0,2,2,2,5,7,12,4,2,0,4,3,16
401404465,BYU Cougars,P. Harding,4281977,,True,40.0,3,15,0,7,3,8,5,5,1,5,6,1,1,0,1,3,14
401404465,BYU Cougars,M. Albiero,4281974,,True,18.0,2,6,1,2,1,4,0,0,0,0,0,1,0,0,0,2,5
401404465,BYU Cougars,T. Graham,4068250,,True,37.0,1,7,0,1,1,6,2,2,0,1,1,6,1,0,1,1,5
401404465,BYU Cougars,S. Hamson,4281976,,False,15.0,2,2,2,2,0,0,1,1,0,1,1,0,1,1,1,2,5
401404465,BYU Cougars,N. Falatea,4898429,,False,6.0,1,2,1,1,0,1,0,0,0,0,0,0,1,0,1,3,2
401404465,BYU Cougars,K. Smiler,4400474,,False,7.0,1,2,1,1,0,1,0,0,0,0,0,0,0,0,1,0,2
401404465,BYU Cougars,TEAM,TOTAL,TOTAL,False,,21,65,16,42,5,23,12,12,15,18,33,14,7,1,12,15,59
401404464,San Francisco Dons,K. Dickie,4594824,,True,30.0,2,10,1,5,1,5,3,4,3,4,7,0,0,0,2,2,8
401404464,San Francisco Dons,L. Kostic,4400509,,True,28.0,3,6,3,6,0,0,3,3,0,6,6,3,1,1,1,4,9
401404464,San Francisco Dons,I. Krimili,4595863,,True,40.0,6,21,4,14,2,7,6,7,0,2,2,2,0,2,1,4,20
401404464,San Francisco Dons,A. Langer,4400507,,True,30.0,3,6,1,2,2,4,1,1,0,1,1,1,0,0,0,4,9
401404464,San Francisco Dons,J. McDowell-White,4399895,,True,25.0,1,4,0,1,1,3,0,0,1,1,2,2,0,2,0,1,3
401404464,San Francisco Dons,C. Langarita,4899413,,False,25.0,2,7,2,5,0,2,0,0,0,3,3,0,0,2,2,3,4
401404464,San Francisco Dons,J. Gayles,4594849,,False,16.0,1,7,1,5,0,2,0,0,1,1,2,1,0,0,1,1,2
401404464,San Francisco Dons,K. Vaalavirta,4400504,,False,6.0,0,1,0,1,0,0,0,0,0,0,0,1,0,0,0,1,0
401404464,San Francisco Dons,TEAM,TOTAL,TOTAL,False,,18,62,12,39,6,23,13,15,11,24,35,10,1,7,7,20,55
401404464,Gonzaga Bulldogs,M. Kempton,4400478,,True,19.0,3,7,3,7,0,0,1,1,2,1,3,0,0,1,3,5,7
401404464,Gonzaga Bulldogs,A. Virjoghe,4400477,,True,24.0,4,10,4,10,0,0,0,0,2,7,9,1,1,1,0,1,8
401404464,Gonzaga Bulldogs,A. O'Connor,4282263,,True,28.0,4,7,1,1,3,6,0,0,1,4,5,0,0,0,0,5,11
401404464,Gonzaga Bulldogs,Kayle. Truong,4433148,,True,33.0,1,9,1,4,0,5,5,6,1,3,4,7,0,0,1,1,7
401404464,Gonzaga Bulldogs,C. Walker,4065787,,True,22.0,2,6,2,5,0,1,2,2,1,3,4,2,1,0,0,0,6
401404464,Gonzaga Bulldogs,Y. Ejim,4703874,,False,28.0,6,14,6,14,0,0,0,0,5,9,14,1,0,2,0,1,12
401404464,Gonzaga Bulldogs,M. Huijbens,4682956,,False,6.0,0,1,0,1,0,0,0,0,0,0,0,1,0,0,0,1,0
401404464,Gonzaga Bulldogs,E. Hollingsworth,4595767,,False,3.0,0,1,0,1,0,0,0,0,0,0,0,0,0,1,0,2,0
401404464,Gonzaga Bulldogs,M. Williams,4433490,,False,10.0,1,2,1,1,0,1,0,0,1,1,2,2,0,0,1,1,2
401404464,Gonzaga Bulldogs,Kayly. Truong,4433365,,False,27.0,3,7,2,5,1,2,9,9,1,2,3,1,1,1,0,3,16
401404464,Gonzaga Bulldogs,TEAM,TOTAL,TOTAL,False,,24,64,20,49,4,15,17,18,16,33,49,15,3,6,6,20,69
401404463,Portland Pilots,L. Cochrane,4595872,,True,39.0,5,10,5,10,0,0,2,2,2,5,7,1,0,8,2,3,12
401404463,Portland Pilots,A. Fowler,4595823,,True,33.0,5,17,3,10,2,7,1,2,2,9,11,6,1,0,0,1,13
401404463,Portland Pilots,E. Shearer,4703855,,True,14.0,1,3,1,2,0,1,0,0,0,0,0,1,0,0,1,4,2
401404463,Portland Pilots,M. Muhlheim,4282078,,True,19.0,1,3,0,0,1,3,0,0,1,2,3,0,2,0,1,3,3
401404463,Portland Pilots,R. Pflug,4282065,,True,33.0,2,9,1,5,1,4,0,0,1,4,5,3,0,0,2,1,5
401404463,Portland Pilots,K. Frawley,4595822,,False,23.0,0,1,0,0,0,1,0,0,2,0,2,0,0,0,1,2,0
401404463,Portland Pilots,L. Kaitu'u,4400493,,False,8.0,0,4,0,4,0,0,0,0,0,2,2,0,0,0,0,1,0
401404463,Portland Pilots,M. Burnham,4704748,,False,24.0,4,9,4,9,0,0,9,12,0,0,0,2,0,0,0,3,17
401404463,Portland Pilots,M. Meek,4703854,,False,7.0,0,1,0,0,0,1,0,0,0,2,2,0,1,0,0,0,0
401404463,Portland Pilots,TEAM,TOTAL,TOTAL,False,,18,57,14,40,4,17,12,16,11,25,36,13,4,8,8,18,52
401404463,BYU Cougars,L. Gustin,4595746,,True,34.0,1,7,1,7,0,0,0,0,2,8,10,1,0,0,0,0,2
401404463,BYU Cougars,S. Gonzales,4400473,,True,36.0,8,17,8,12,0,5,4,6,3,3,6,2,1,0,4,1,20
401404463,BYU Cougars,P. Harding,4281977,,True,38.0,4,14,2,9,2,5,4,4,3,2,5,2,1,1,0,3,14
401404463,BYU Cougars,M. Albiero,4281974,,True,32.0,3,4,2,2,1,2,0,0,1,2,3,3,1,0,2,1,7
401404463,BYU Cougars,T. Graham,4068250,,True,36.0,3,11,1,3,2,8,3,4,1,10,11,6,1,2,3,3,11
401404463,BYU Cougars,S. Hamson,4281976,,False,16.0,1,5,1,5,0,0,0,0,3,2,5,3,0,2,0,3,2
401404463,BYU Cougars,K. Smiler,4400474,,False,8.0,1,2,0,0,1,2,0,0,0,0,0,0,1,0,0,2,3
401404463,BYU Cougars,TEAM,TOTAL,TOTAL,False,,21,60,15,38,6,22,11,14,17,30,47,17,5,5,12,13,59
401404462,Santa Clara Broncos,D. Stafford,4703848,,True,18.0,1,3,1,2,0,1,0,0,4,6,10,0,1,0,1,1,2
401404462,Santa Clara Broncos,M. Wiehl,4595873,,True,40.0,4,14,2,6,2,8,2,2,2,6,8,2,2,0,1,0,12
401404462,Santa Clara Broncos,A. Johnson,4703847,,True,24.0,5,13,3,7,2,6,0,0,0,3,3,1,0,0,2,4,12
401404462,Santa Clara Broncos,L. Hollingsworth,4595876,,True,37.0,6,18,4,12,2,6,0,1,3,5,8,6,1,0,3,2,14
401404462,Santa Clara Broncos,A. Hiraki,4433989,,True,36.0,7,16,4,8,3,8,0,0,3,4,7,1,1,0,4,5,17
401404462,Santa Clara Broncos,S. Harris,4595874,,False,5.0,0,0,0,0,0,0,0,0,0,1,1,0,0,0,0,0,0
401404462,Santa Clara Broncos,L. Edmanson,4703844,,False,23.0,1,3,0,1,1,2,0,0,1,2,3,3,0,1,4,3,3
401404462,Santa Clara Broncos,B. Nixon,4398697,,False,17.0,1,3,0,0,1,3,0,0,0,0,0,0,0,1,1,1,3
401404462,Santa Clara Broncos,TEAM,TOTAL,TOTAL,False,,25,70,14,36,11,34,2,3,17,29,46,13,5,2,17,16,63
401404462,San Francisco Dons,K. Dickie,4594824,,True,25.0,5,9,5,5,0,4,2,5,1,6,7,1,0,1,2,2,12
401404462,San Francisco Dons,L. Kostic,4400509,,True,27.0,1,2,1,2,0,0,0,0,1,3,4,2,3,1,1,2,2
401404462,San Francisco Dons,I. Krimili,4595863,,True,39.0,5,12,5,8,0,4,8,10,0,6,6,7,3,0,3,2,18
401404462,San Francisco Dons,A. Langer,4400507,,True,29.0,4,9,3,4,1,5,2,2,0,1,1,0,1,0,0,3,11
401404462,San Francisco Dons,J. McDowell-White,4399895,,True,33.0,3,7,2,5,1,2,1,2,1,5,6,4,1,0,1,2,8
401404462,San Francisco Dons,C. Langarita,4899413,,False,28.0,7,12,6,9,1,3,1,2,0,2,2,0,0,1,1,1,16
401404462,San Francisco Dons,J. Gayles,4594849,,False,8.0,1,2,0,0,1,2,2,2,0,2,2,1,0,0,1,0,5
401404462,San Francisco Dons,K. Vaalavirta,4400504,,False,11.0,0,1,0,0,0,1,0,0,0,0,0,0,0,1,0,0,0
401404462,San Francisco Dons,TEAM,TOTAL,TOTAL,False,,26,54,22,33,4,21,16,23,3,29,32,15,8,4,9,12,72
401404461,Portland Pilots,L. Cochrane,4595872,,True,27.0,4,6,4,6,0,0,0,0,2,5,7,3,2,2,1,1,8
401404461,Portland Pilots,A. Fowler,4595823,,True,23.0,4,10,4,9,0,1,9,12,3,4,7,0,0,0,2,2,17
401404461,Portland Pilots,E. Shearer,4703855,,True,14.0,0,3,0,1,0,2,0,0,0,0,0,0,1,0,3,2,0
401404461,Portland Pilots,M. Muhlheim,4282078,,True,20.0,1,4,0,1,1,3,2,2,1,2,3,1,1,0,1,2,5
401404461,Portland Pilots,R. Pflug,4282065,,True,29.0,3,4,3,4,0,0,0,2,1,2,3,3,1,0,2,1,6
401404461,Portland Pilots,E. Sewell,4899388,,False,8.0,0,1,0,1,0,0,0,0,0,0,0,1,0,0,1,0,0
401404461,Portland Pilots,K. Frawley,4595822,,False,27.0,1,4,0,1,1,3,0,0,1,4,5,3,3,0,3,0,3
401404461,Portland Pilots,L. Kaitu'u,4400493,,False,17.0,2,6,2,4,0,2,4,6,1,2,3,1,2,0,0,2,8
401404461,Portland Pilots,M. Burnham,4704748,,False,19.0,7,12,7,12,0,0,4,7,1,2,3,2,2,0,1,3,18
401404461,Portland Pilots,M. Meek,4703854,,False,16.0,1,2,1,1,0,1,2,2,0,0,0,2,1,0,0,2,4
401404461,Portland Pilots,TEAM,TOTAL,TOTAL,False,,23,52,21,40,2,12,21,31,16,25,41,16,13,2,15,15,69
401404461,Loyola Marymount Lions,A. Mark,4606930,,True,36.0,5,14,5,14,0,0,2,4,5,6,11,2,0,0,2,2,12
401404461,Loyola Marymount Lions,J. Jones,4282013,,True,27.0,3,7,3,4,0,3,0,0,3,3,6,1,1,1,0,3,6
401404461,Loyola Marymount Lions,N. Rodriguez,4703866,,True,33.0,1,8,0,3,1,5,2,2,2,0,2,2,1,1,5,3,5
401404461,Loyola Marymount Lions,C. Gordon,4399350,,True,34.0,1,6,1,5,0,1,0,0,0,3,3,3,0,0,2,2,2
401404461,Loyola Marymount Lions,A. Johnson,4398632,,True,27.0,4,9,4,7,0,2,2,2,2,1,3,0,1,0,8,4,10
401404461,Loyola Marymount Lions,A. Toone,4898438,,False,7.0,1,5,0,3,1,2,0,0,1,0,1,0,0,0,0,0,3
401404461,Loyola Marymount Lions,K. Clark,4595789,,False,22.0,3,10,3,10,0,0,0,1,5,2,7,0,2,1,0,3,6
401404461,Loyola Marymount Lions,M. Mandel,4068084,,False,6.0,0,2,0,2,0,0,0,0,0,0,0,0,0,0,1,2,0
401404461,Loyola Marymount Lions,A. Adams,4595786,,False,6.0,0,0,0,0,0,0,0,0,0,0,0,1,0,0,1,0,0
401404461,Loyola Marymount Lions,H. Herdman,4400480,,False,2.0,0,0,0,0,0,0,0,0,0,0,0,1,0,0,0,2,0
401404461,Loyola Marymount Lions,TEAM,TOTAL,TOTAL,False,,18,61,16,48,2,13,6,9,19,17,36,10,5,3,20,21,44
401404460,Santa Clara Broncos,D. Stafford,4703848,,True,17.0,0,2,0,2,0,0,0,0,1,2,3,0,1,1,0,5,0
401404460,Santa Clara Broncos,M. Wiehl,4595873,,True,39.0,6,15,3,4,3,11,6,8,1,12,13,1,1,0,1,3,21
401404460,Santa Clara Broncos,L. Hollingsworth,4595876,,True,28.0,5,9,5,7,0,2,3,3,3,1,4,1,0,1,3,5,13
401404460,Santa Clara Broncos,A. Hiraki,4433989,,True,31.0,4,10,3,7,1,3,13,17,1,0,1,2,3,0,3,5,22
401404460,Santa Clara Broncos,L. VanAllen,4400514,,True,15.0,3,7,2,4,1,3,5,6,0,2,2,1,0,0,2,2,12
401404460,Santa Clara Broncos,S. Harris,4595874,,False,8.0,0,1,0,1,0,0,0,0,0,1,1,0,0,1,1,2,0
401404460,Santa Clara Broncos,L. Edmanson,4703844,,False,18.0,2,3,1,2,1,1,1,2,2,2,4,0,1,1,0,1,6
401404460,Santa Clara Broncos,A. Johnson,4703847,,False,20.0,2,3,2,3,0,0,8,9,2,3,5,1,3,0,3,2,12
401404460,Santa Clara Broncos,B. Nixon,4398697,,False,24.0,0,2,0,1,0,1,0,0,0,1,1,1,0,0,6,4,0
401404460,Santa Clara Broncos,TEAM,TOTAL,TOTAL,False,,22,52,16,31,6,21,36,45,11,27,38,7,9,4,20,29,86
401404460,San Diego Toreros,K. Bird,4282108,,True,10.0,1,2,1,2,0,0,0,0,0,3,3,0,0,1,1,2,2
401404460,San Diego Toreros,K. Oakry,4400499,,True,17.0,0,2,0,1,0,1,3,4,1,2,3,0,0,0,0,5,3
401404460,San Diego Toreros,S. Gorman,4400189,,True,37.0,2,7,1,2,1,5,4,4,0,3,3,4,4,0,1,4,9
401404460,San Diego Toreros,S. Hunter,4282109,,True,35.0,8,16,8,16,0,0,4,6,2,5,7,2,2,0,3,2,20
401404460,San Diego Toreros,J. Edwards,4068245,,True,15.0,2,2,2,2,0,0,2,2,1,0,1,2,1,0,7,5,6
401404460,San Diego Toreros,L. Erikstrup,4703852,,False,21.0,4,9,3,8,1,1,3,6,0,1,1,0,1,0,0,3,12
401404460,San Diego Toreros,K. Neubert,4433711,,False,12.0,1,2,1,2,0,0,3,4,1,2,3,0,1,0,0,1,5
401404460,San Diego Toreros,H. Kaur,4899403,,False,2.0,0,0,0,0,0,0,0,0,0,0,0,0,0,0,0,2,0
401404460,San Diego Toreros,K. Horstmeyer,4714247,,False,19.0,2,3,2,3,0,0,0,0,1,2,3,1,1,0,0,0,4
401404460,San Diego Toreros,G. Giuffre,4703853,,False,0.0,0,0,0,0,0,0,0,0,0,0,0,0,0,0,0,1,0
401404460,San Diego Toreros,E. Martinsen,4595849,,False,20.0,2,11,2,4,0,7,12,17,5,2,7,2,5,1,0,4,16
401404460,San Diego Toreros,A. Khalfani,4595847,,False,12.0,1,3,1,3,0,0,0,0,0,0,0,2,0,0,2,2,2
401404460,San Diego Toreros,TEAM,TOTAL,TOTAL,False,,23,57,21,43,2,14,31,43,13,23,36,13,15,2,15,31,79
401404459,Saint Mary's Gaels,A. Bamberger,4433035,,True,35.0,4,15,4,14,0,1,0,0,5,9,14,2,2,0,4,4,8
401404459,Saint Mary's Gaels,M. Mastora,4899391,,True,15.0,2,4,1,2,1,2,0,1,2,0,2,1,0,0,3,0,5
401404459,Saint Mary's Gaels,T. Dalton,4703841,,True,34.0,4,14,3,5,1,9,1,1,4,2,6,1,1,1,1,5,10
401404459,Saint Mary's Gaels,T. Wedin,4400497,,True,38.0,5,12,1,3,4,9,4,4,0,5,5,2,1,0,1,2,18
401404459,Saint Mary's Gaels,M. Holland,4282100,,True,36.0,7,12,7,12,0,0,1,4,3,5,8,3,0,0,2,4,15
401404459,Saint Mary's Gaels,A. West,4316443,,False,12.0,0,1,0,1,0,0,0,0,1,4,5,1,0,0,0,2,0
401404459,Saint Mary's Gaels,H. Rapp,4712115,,False,1.0,0,0,0,0,0,0,0,0,0,0,0,0,0,0,2,0,0
401404459,Saint Mary's Gaels,L. Hanafin,4703840,,False,29.0,4,7,4,5,0,2,0,0,0,2,2,4,3,0,3,1,8
401404459,Saint Mary's Gaels,TEAM,TOTAL,TOTAL,False,,26,65,20,42,6,23,6,10,16,30,46,14,7,1,16,18,64
401404459,Loyola Marymount Lions,A. Mark,4606930,,True,37.0,5,9,5,9,0,0,5,8,2,4,6,2,2,2,0,1,15
401404459,Loyola Marymount Lions,J. Jones,4282013,,True,28.0,5,12,4,9,1,3,1,3,2,4,6,2,2,0,1,2,12
401404459,Loyola Marymount Lions,N. Rodriguez,4703866,,True,38.0,3,8,2,4,1,4,4,6,0,4,4,1,1,1,2,2,11
401404459,Loyola Marymount Lions,C. Gordon,4399350,,True,37.0,6,12,5,9,1,3,0,0,1,3,4,2,1,0,0,3,13
401404459,Loyola Marymount Lions,A. Johnson,4398632,,True,30.0,4,9,4,9,0,0,6,8,0,6,6,4,2,0,2,5,14
401404459,Loyola Marymount Lions,K. Clark,4595789,,False,13.0,0,1,0,1,0,0,0,0,1,2,3,2,1,1,4,0,0
401404459,Loyola Marymount Lions,A. Adams,4595786,,False,17.0,2,5,0,1,2,4,0,0,0,0,0,1,0,0,0,1,6
401404459,Loyola Marymount Lions,H. Herdman,4400480,,False,0.0,0,0,0,0,0,0,0,0,0,0,0,0,0,0,0,0,0
401404459,Loyola Marymount Lions,TEAM,TOTAL,TOTAL,False,,25,56,20,42,5,14,16,25,6,25,31,14,9,4,10,14,71
401404458,Santa Clara Broncos,D. Stafford,4703848,,True,16.0,1,3,0,2,1,1,0,0,3,4,7,1,0,0,1,2,3
401404458,Santa Clara Broncos,M. Wiehl,4595873,,True,30.0,8,16,6,10,2,6,2,2,1,9,10,3,1,0,0,3,20
401404458,Santa Clara Broncos,L. Hollingsworth,4595876,,True,14.0,4,6,4,5,0,1,2,2,1,0,1,1,1,0,2,4,10
401404458,Santa Clara Broncos,A. Hiraki,4433989,,True,29.0,2,7,1,5,1,2,2,4,2,1,3,7,0,1,1,2,7
401404458,Santa Clara Broncos,L. VanAllen,4400514,,True,31.0,10,20,6,13,4,7,7,9,1,3,4,1,2,0,3,1,31
401404458,Santa Clara Broncos,K. Harris,4703846,,False,1.0,0,0,0,0,0,0,0,0,0,0,0,0,0,0,0,1,0
401404458,Santa Clara Broncos,S. Harris,4595874,,False,14.0,4,5,4,5,0,0,0,1,1,2,3,2,0,1,0,2,8
401404458,Santa Clara Broncos,L. Edmanson,4703844,,False,14.0,2,2,1,1,1,1,0,0,3,1,4,1,1,0,0,5,5
401404458,Santa Clara Broncos,E. Ellinghouse,4703845,,False,5.0,0,0,0,0,0,0,0,0,0,1,1,0,0,0,0,2,0
401404458,Santa Clara Broncos,R. Stergaki,4899421,,False,2.0,0,1,0,1,0,0,0,0,0,0,0,0,0,0,1,1,0
401404458,Santa Clara Broncos,S. Bevington,4899420,,False,1.0,0,0,0,0,0,0,0,0,0,0,0,0,0,0,1,0,0
401404458,Santa Clara Broncos,A. Johnson,4703847,,False,18.0,2,2,1,1,1,1,0,0,1,3,4,2,0,0,0,1,5
401404458,Santa Clara Broncos,B. Nixon,4398697,,False,25.0,2,11,2,7,0,4,0,0,0,7,7,4,2,0,2,1,4
401404458,Santa Clara Broncos,TEAM,TOTAL,TOTAL,False,,35,73,25,50,10,23,13,18,15,33,48,22,7,2,11,25,93
401404458,Pacific Tigers,C. Holmberg,4595157,,True,18.0,4,5,2,3,2,2,1,2,0,1,1,1,1,0,2,2,11
401404458,Pacific Tigers,E. Elliott,4898442,,True,19.0,3,6,3,6,0,0,9,13,0,3,3,2,0,0,3,4,15
401404458,Pacific Tigers,A. James,4898440,,True,31.0,6,13,6,9,0,4,0,0,1,5,6,2,0,0,2,2,12
401404458,Pacific Tigers,S. Ashby,4595810,,True,23.0,3,11,2,4,1,7,2,4,0,3,3,1,0,0,3,3,9
401404458,Pacific Tigers,J. Cruz,4282175,,True,7.0,0,0,0,0,0,0,0,0,0,0,0,1,0,0,1,3,0
401404458,Pacific Tigers,E. Jarrell,4704653,,False,2.0,0,1,0,1,0,0,3,4,0,1,1,0,0,1,0,0,3
401404458,Pacific Tigers,M. Ennis,4595811,,False,9.0,0,1,0,1,0,0,0,0,0,2,2,0,0,0,0,1,0
401404458,Pacific Tigers,C. Johnson,4400485,,False,16.0,2,6,2,6,0,0,2,2,1,2,3,1,0,0,0,1,6
401404458,Pacific Tigers,D. Richardson,4898441,,False,23.0,0,2,0,2,0,0,0,0,1,1,2,1,2,0,0,2,0
401404458,Pacific Tigers,L. Smith,4703865,,False,25.0,1,3,0,2,1,1,3,6,0,4,4,3,0,0,2,2,6
401404458,Pacific Tigers,E. Adams,4703864,,False,12.0,1,2,0,1,1,1,1,2,0,0,0,0,2,0,0,0,4
401404458,Pacific Tigers,J. Millard,4400484,,False,15.0,1,1,0,0,1,1,0,0,1,2,3,1,0,0,2,1,3
401404458,Pacific Tigers,TEAM,TOTAL,TOTAL,False,,21,51,15,35,6,16,21,33,4,26,30,13,5,1,15,21,69
401404457,Pepperdine Waves,M. Amosa,4898444,,True,30.0,4,9,4,8,0,1,1,1,2,3,5,1,1,2,3,1,9
401404457,Pepperdine Waves,B. Obinma,4399221,,True,20.0,1,3,1,3,0,0,1,2,1,4,5,3,2,0,3,4,3
401404457,Pepperdine Waves,K. Carson,4703862,,True,32.0,0,2,0,0,0,2,0,0,0,4,4,2,0,0,2,3,0
401404457,Pepperdine Waves,A. Stedman,4898445,,True,27.0,2,13,2,5,0,8,0,0,1,1,2,1,0,0,2,4,4
401404457,Pepperdine Waves,M. Bambrick,4400488,,True,40.0,8,18,4,9,4,9,0,0,0,3,3,2,4,0,1,2,20
401404457,Pepperdine Waves,J. Nwaba,4703860,,False,16.0,2,2,2,2,0,0,1,2,1,6,7,0,0,1,0,2,5
401404457,Pepperdine Waves,R. Odebunmi,4703858,,False,2.0,0,0,0,0,0,0,0,0,0,1,1,0,0,0,0,1,0
401404457,Pepperdine Waves,E. Braslis,4399973,,False,11.0,0,1,0,1,0,0,1,2,1,0,1,1,0,0,0,0,1
401404457,Pepperdine Waves,C. Givens,4595813,,False,22.0,4,10,3,6,1,4,3,3,1,2,3,3,0,0,4,1,12
401404457,Pepperdine Waves,TEAM,TOTAL,TOTAL,False,,21,58,16,34,5,24,7,10,9,27,36,13,7,3,16,18,54
401404457,Loyola Marymount Lions,A. Mark,4606930,,True,39.0,8,15,8,14,0,1,4,6,3,6,9,4,1,1,4,3,20
401404457,Loyola Marymount Lions,J. Jones,4282013,,True,28.0,3,12,3,10,0,2,0,2,5,7,12,2,2,0,1,2,6
401404457,Loyola Marymount Lions,N. Rodriguez,4703866,,True,38.0,2,8,1,4,1,4,1,2,0,4,4,4,3,0,3,0,6
401404457,Loyola Marymount Lions,C. Gordon,4399350,,True,35.0,3,4,2,3,1,1,2,2,0,3,3,1,0,1,2,2,9
401404457,Loyola Marymount Lions,A. Johnson,4398632,,True,34.0,6,11,6,10,0,1,6,8,0,4,4,3,3,0,1,2,18
401404457,Loyola Marymount Lions,A. Toone,4898438,,False,3.0,0,0,0,0,0,0,0,0,0,1,1,0,0,0,0,0,0
401404457,Loyola Marymount Lions,K. Clark,4595789,,False,12.0,2,5,2,5,0,0,1,2,0,0,0,0,0,0,0,2,5
401404457,Loyola Marymount Lions,A. Adams,4595786,,False,11.0,0,2,0,0,0,2,0,0,0,1,1,0,0,0,0,2,0
401404457,Loyola Marymount Lions,TEAM,TOTAL,TOTAL,False,,24,57,22,46,2,11,14,22,9,29,38,14,9,2,11,13,64
401404456,Stephen F. Austin Ladyjacks,Ai. Johnson,4400451,,True,21.0,1,2,1,2,0,0,0,0,0,1,1,0,0,1,3,3,2
401404456,Stephen F. Austin Ladyjacks,Z. Nugent,4595808,,True,40.0,5,11,4,8,1,3,9,14,2,10,12,6,1,0,5,2,20
401404456,Stephen F. Austin Ladyjacks,S. Visscher,4400450,,True,40.0,4,6,1,1,3,5,4,4,1,3,4,5,0,0,4,2,15
401404456,Stephen F. Austin Ladyjacks,B. Mitchell,4400448,,True,28.0,3,9,2,7,1,2,1,1,1,2,3,3,1,0,5,4,8
401404456,Stephen F. Austin Ladyjacks,T. Robinson,4281818,,True,38.0,7,9,2,2,5,7,0,0,1,3,4,0,2,1,2,3,19
401404456,Stephen F. Austin Ladyjacks,Aa. Johnson,4400452,,False,19.0,2,5,1,2,1,3,0,0,0,0,0,0,0,0,2,2,5
401404456,Stephen F. Austin Ladyjacks,A. Scott,4899456,,False,14.0,1,1,0,0,1,1,2,2,0,0,0,2,1,0,1,2,5
401404456,Stephen F. Austin Ladyjacks,TEAM,TOTAL,TOTAL,False,,23,43,11,22,12,21,16,21,8,22,30,16,5,2,24,18,74
401404456,Grand Canyon Lopes,K. Shorts,4400116,,True,18.0,1,1,1,1,0,0,0,0,1,0,1,0,0,0,0,2,2
401404456,Grand Canyon Lopes,J. Powell-Smith,4899517,,True,28.0,5,9,4,7,1,2,3,5,2,3,5,3,5,0,0,5,14
401404456,Grand Canyon Lopes,C. Akin-Otiko,4705636,,True,5.0,0,1,0,1,0,0,1,2,0,1,1,0,0,0,1,1,1
401404456,Grand Canyon Lopes,Tiar. Brown,4705634,,True,24.0,1,7,1,6,0,1,2,2,0,2,2,0,1,1,2,4,4
401404456,Grand Canyon Lopes,A. Graham,4068788,,True,27.0,0,2,0,1,0,1,4,4,0,0,0,0,0,0,2,0,4
401404456,Grand Canyon Lopes,J. McChristine,4899523,,False,21.0,4,6,4,6,0,0,4,4,3,0,3,0,2,1,3,1,12
401404456,Grand Canyon Lopes,D. Phillips,4899519,,False,13.0,2,7,2,5,0,2,0,0,0,0,0,2,0,2,2,2,4
401404456,Grand Canyon Lopes,N. Evans,4899524,,False,6.0,1,2,1,1,0,1,0,0,0,1,1,0,0,0,0,0,2
401404456,Grand Canyon Lopes,Tian. Brown,4595892,,False,27.0,1,8,0,2,1,6,1,2,1,1,2,1,0,0,1,1,4
401404456,Grand Canyon Lopes,N. Jackson,4068111,,False,2.0,0,0,0,0,0,0,0,0,0,0,0,0,0,0,0,0,0
401404456,Grand Canyon Lopes,K. Flowers,4899522,,False,27.0,4,11,2,4,2,7,0,0,4,3,7,2,5,0,4,4,10
401404456,Grand Canyon Lopes,TEAM,TOTAL,TOTAL,False,,19,54,15,34,4,20,15,19,14,13,27,8,13,4,18,20,57
401404455,Grand Canyon Lopes,K. Shorts,4400116,,True,22.0,2,3,2,3,0,0,1,2,0,4,4,1,3,0,1,3,5
401404455,Grand Canyon Lopes,J. Powell-Smith,4899517,,True,24.0,1,7,1,5,0,2,1,2,0,0,0,1,0,0,0,3,3
401404455,Grand Canyon Lopes,C. Akin-Otiko,4705636,,True,8.0,2,4,2,4,0,0,0,0,2,0,2,0,0,0,0,1,4
401404455,Grand Canyon Lopes,Tiar. Brown,4705634,,True,34.0,9,18,9,17,0,1,4,6,2,4,6,3,5,0,1,1,22
401404455,Grand Canyon Lopes,A. Graham,4068788,,True,36.0,6,10,4,6,2,4,8,9,0,4,4,1,1,0,2,0,22
401404455,Grand Canyon Lopes,J. McChristine,4899523,,False,17.0,2,5,2,5,0,0,0,0,4,0,4,1,1,1,1,2,4
401404455,Grand Canyon Lopes,D. Phillips,4899519,,False,10.0,0,6,0,4,0,2,2,4,2,5,7,0,0,0,2,2,2
401404455,Grand Canyon Lopes,N. Evans,4899524,,False,6.0,0,1,0,0,0,1,0,0,1,0,1,0,0,0,1,0,0
401404455,Grand Canyon Lopes,Tian. Brown,4595892,,False,21.0,0,3,0,3,0,0,2,4,1,2,3,0,1,0,1,4,2
401404455,Grand Canyon Lopes,K. Flowers,4899522,,False,22.0,0,4,0,2,0,2,0,0,1,1,2,0,0,0,2,2,0
401404455,Grand Canyon Lopes,TEAM,TOTAL,TOTAL,False,,22,61,20,49,2,12,18,27,15,22,37,7,11,1,11,18,64
401404455,California Baptist Lancers,C. Harper,4419354,,True,30.0,0,4,0,4,0,0,2,2,1,3,4,3,0,1,1,1,2
401404455,California Baptist Lancers,T. San Antonio,4900098,,True,22.0,1,3,0,1,1,2,0,0,1,3,4,1,2,1,1,5,3
401404455,California Baptist Lancers,N. Avila-Ambrosi,4703947,,True,34.0,6,13,3,5,3,8,2,2,3,1,4,2,1,0,0,3,17
401404455,California Baptist Lancers,S. Palma,4419349,,True,15.0,0,2,0,0,0,2,0,0,0,0,0,0,0,0,2,2,0
401404455,California Baptist Lancers,A. Olaeta,4419341,,True,38.0,6,12,6,7,0,5,4,4,0,5,5,3,3,0,10,4,16
401404455,California Baptist Lancers,B. Thomas,4419353,,False,24.0,4,6,4,6,0,0,6,7,2,8,10,1,0,0,2,3,14
401404455,California Baptist Lancers,T. Neale,4598110,,False,17.0,2,3,0,0,2,3,0,0,0,4,4,1,1,0,1,2,6
401404455,California Baptist Lancers,G. Dale,4419346,,False,7.0,1,4,1,1,0,3,0,0,0,0,0,1,1,0,0,0,2
401404455,California Baptist Lancers,N. Yim,4400481,,False,0.0,0,0,0,0,0,0,0,0,0,0,0,0,0,0,0,0,0
401404455,California Baptist Lancers,B. Klaman,4281618,,False,13.0,0,3,0,0,0,3,0,0,0,0,0,0,0,1,0,0,0
401404455,California Baptist Lancers,TEAM,TOTAL,TOTAL,False,,20,50,14,24,6,26,14,15,10,26,36,12,8,3,18,20,60
401404454,Utah Valley Wolverines,J. Williams,4399976,,True,38.0,5,6,5,6,0,0,2,2,4,11,15,2,0,0,5,2,12
401404454,Utah Valley Wolverines,A. Blackham,4899426,,True,26.0,1,6,1,3,0,3,0,0,2,0,2,0,0,0,2,0,2
401404454,Utah Valley Wolverines,K. Anderson,4703918,,True,30.0,2,5,0,1,2,4,0,0,0,3,3,0,0,0,4,1,6
401404454,Utah Valley Wolverines,M. Grange,4399975,,True,21.0,2,5,1,4,1,1,2,3,0,1,1,1,0,0,2,0,7
401404454,Utah Valley Wolverines,M. Carvalho,4399972,,True,40.0,3,9,2,7,1,2,0,0,1,5,6,2,1,0,5,1,7
401404454,Utah Valley Wolverines,E. Tausinga,4703917,,False,1.0,0,0,0,0,0,0,0,0,0,0,0,0,0,0,0,0,0
401404454,Utah Valley Wolverines,M. Jensen,4594439,,False,30.0,4,9,4,9,0,0,0,1,1,2,3,3,1,0,3,1,8
401404454,Utah Valley Wolverines,E. Martin,4899429,,False,4.0,0,0,0,0,0,0,0,0,0,0,0,0,0,0,0,0,0
401404454,Utah Valley Wolverines,A. Conlee,4899428,,False,1.0,0,0,0,0,0,0,0,0,0,0,0,0,0,0,1,0,0
401404454,Utah Valley Wolverines,E. Tafisi,4703919,,False,9.0,0,0,0,0,0,0,0,0,0,0,0,0,0,0,1,1,0
401404454,Utah Valley Wolverines,TEAM,TOTAL,TOTAL,False,,17,40,13,30,4,10,4,6,8,26,34,8,2,0,26,6,42
401404454,Stephen F. Austin Ladyjacks,Ai. Johnson,4400451,,True,25.0,3,11,3,11,0,0,2,2,3,3,6,2,2,0,1,0,8
401404454,Stephen F. Austin Ladyjacks,Z. Nugent,4595808,,True,34.0,9,14,5,9,4,5,0,0,1,4,5,5,4,0,0,2,22
401404454,Stephen F. Austin Ladyjacks,S. Visscher,4400450,,True,38.0,6,16,4,8,2,8,0,0,1,2,3,1,3,1,2,1,14
401404454,Stephen F. Austin Ladyjacks,B. Mitchell,4400448,,True,31.0,5,10,3,5,2,5,2,2,0,1,1,5,5,0,1,2,14
401404454,Stephen F. Austin Ladyjacks,T. Robinson,4281818,,True,32.0,2,7,1,2,1,5,0,0,3,1,4,2,1,0,0,0,5
401404454,Stephen F. Austin Ladyjacks,A. Brittingham,4705019,,False,4.0,0,0,0,0,0,0,0,0,0,0,0,0,0,0,0,1,0
401404454,Stephen F. Austin Ladyjacks,Aa. Johnson,4400452,,False,15.0,1,4,1,3,0,1,0,0,1,1,2,2,1,0,1,0,2
401404454,Stephen F. Austin Ladyjacks,A. Scott,4899456,,False,17.0,1,5,0,0,1,5,0,0,0,1,1,0,1,0,0,1,3
401404454,Stephen F. Austin Ladyjacks,T. McCliment-Call,4703856,,False,2.0,0,0,0,0,0,0,0,0,1,0,1,0,0,0,0,0,0
401404454,Stephen F. Austin Ladyjacks,D. Lombard,4597501,,False,2.0,0,0,0,0,0,0,0,0,1,1,2,0,0,0,0,0,0
401404454,Stephen F. Austin Ladyjacks,TEAM,TOTAL,TOTAL,False,,27,67,17,38,10,29,4,4,14,16,30,17,17,1,5,7,68
401404453,Sam Houston Bearkats,M. Batista,4595756,,True,15.0,4,8,4,8,0,0,0,0,4,3,7,0,2,1,0,5,8
401404453,Sam Houston Bearkats,C. Cleveland,4595754,,True,38.0,5,18,3,15,2,3,3,6,6,2,8,2,3,0,3,3,15
401404453,Sam Houston Bearkats,K. Jefferson,4418429,,True,40.0,8,15,5,10,3,5,0,0,6,4,10,5,3,1,1,2,19
401404453,Sam Houston Bearkats,S. Kemp,4595751,,True,11.0,0,0,0,0,0,0,0,0,0,0,0,0,0,0,2,2,0
401404453,Sam Houston Bearkats,F. Cook,4069133,,True,40.0,5,24,2,8,3,16,7,8,1,1,2,5,3,0,6,2,20
401404453,Sam Houston Bearkats,D. Wilson,4399315,,False,3.0,0,0,0,0,0,0,0,0,0,0,0,0,0,0,0,2,0
401404453,Sam Houston Bearkats,L. Echi,4595590,,False,13.0,1,2,1,2,0,0,0,1,0,2,2,0,0,0,0,1,2
401404453,Sam Houston Bearkats,R. Smith,4433705,,False,19.0,0,1,0,1,0,0,0,0,3,1,4,2,1,0,4,1,0
401404453,Sam Houston Bearkats,D. Telemaque,4400581,,False,21.0,7,12,7,12,0,0,0,0,6,3,9,2,0,0,3,3,14
401404453,Sam Houston Bearkats,TEAM,TOTAL,TOTAL,False,,30,80,22,56,8,24,10,15,27,17,44,16,12,2,20,21,78
401404453,California Baptist Lancers,C. Harper,4419354,,True,32.0,7,11,6,8,1,3,10,12,1,4,5,0,2,1,1,3,25
401404453,California Baptist Lancers,T. San Antonio,4900098,,True,30.0,1,4,0,1,1,3,2,2,1,6,7,2,3,0,5,3,5
401404453,California Baptist Lancers,N. Avila-Ambrosi,4703947,,True,30.0,5,9,4,6,1,3,0,0,2,0,2,2,2,2,3,2,11
401404453,California Baptist Lancers,S. Palma,4419349,,True,29.0,2,3,1,1,1,2,2,3,0,3,3,3,1,0,2,3,7
401404453,California Baptist Lancers,A. Olaeta,4419341,,True,37.0,11,17,11,15,0,2,1,2,0,7,7,10,7,1,2,4,23
401404453,California Baptist Lancers,B. Thomas,4419353,,False,10.0,4,5,4,5,0,0,1,2,0,3,3,0,1,1,1,0,9
401404453,California Baptist Lancers,O. Robin,4703950,,False,2.0,0,0,0,0,0,0,0,0,0,0,0,0,0,0,0,0,0
401404453,California Baptist Lancers,T. Neale,4598110,,False,8.0,1,3,1,2,0,1,0,0,0,1,1,0,0,0,2,1,2
401404453,California Baptist Lancers,G. Dale,4419346,,False,9.0,0,0,0,0,0,0,0,0,0,0,0,0,0,0,1,1,0
401404453,California Baptist Lancers,B. Klaman,4281618,,False,13.0,1,3,0,0,1,3,0,0,1,2,3,0,0,1,1,0,3
401404453,California Baptist Lancers,TEAM,TOTAL,TOTAL,False,,32,55,27,38,5,17,16,21,6,26,32,17,16,6,19,17,85
401404452,Utah Valley Wolverines,J. Williams,4399976,,True,33.0,10,17,10,16,0,1,2,3,5,10,15,3,0,0,3,1,22
401404452,Utah Valley Wolverines,A. Blackham,4899426,,True,25.0,1,5,0,1,1,4,0,0,1,2,3,2,0,0,0,3,3
401404452,Utah Valley Wolverines,K. Anderson,4703918,,True,25.0,0,2,0,0,0,2,0,0,0,3,3,3,0,0,2,4,0
401404452,Utah Valley Wolverines,M. Grange,4399975,,True,38.0,2,8,2,7,0,1,2,2,1,4,5,2,0,1,1,2,6
401404452,Utah Valley Wolverines,M. Carvalho,4399972,,True,37.0,7,15,1,5,6,10,1,1,0,4,4,0,1,0,2,1,21
401404452,Utah Valley Wolverines,M. Jensen,4594439,,False,23.0,7,10,7,10,0,0,2,2,4,7,11,3,1,0,0,0,16
401404452,Utah Valley Wolverines,E. Martin,4899429,,False,1.0,1,1,1,1,0,0,0,0,0,0,0,0,0,0,0,0,2
401404452,Utah Valley Wolverines,A. Conlee,4899428,,False,9.0,0,0,0,0,0,0,2,2,0,2,2,0,0,0,0,2,2
401404452,Utah Valley Wolverines,E. Tafisi,4703919,,False,9.0,0,2,0,2,0,0,0,0,0,0,0,0,0,0,1,1,0
401404452,Utah Valley Wolverines,TEAM,TOTAL,TOTAL,False,,28,60,21,42,7,18,9,10,12,35,47,13,2,1,9,14,72
401404452,UT Rio Grande Valley Vaqueros,T. Muff,4899433,,True,29.0,6,12,6,7,0,5,0,0,3,3,6,0,1,0,3,4,12
401404452,UT Rio Grande Valley Vaqueros,S. Bershers,4595667,,True,30.0,5,13,3,7,2,6,0,0,1,3,4,2,2,0,0,4,12
401404452,UT Rio Grande Valley Vaqueros,B. Soysal,4595662,,True,18.0,2,6,2,5,0,1,2,2,0,1,1,1,1,0,0,1,6
401404452,UT Rio Grande Valley Vaqueros,K. Kyle,4899435,,True,25.0,2,8,0,0,2,8,2,2,1,3,4,3,0,0,0,0,8
401404452,UT Rio Grande Valley Vaqueros,J. Williams,4433167,,True,28.0,1,7,1,2,0,5,0,0,0,2,2,0,1,0,0,1,2
401404452,UT Rio Grande Valley Vaqueros,B. Jessen,4899436,,False,7.0,0,3,0,2,0,1,0,0,1,1,2,0,0,0,0,2,0
401404452,UT Rio Grande Valley Vaqueros,J. Martino,4703926,,False,3.0,1,1,0,0,1,1,0,0,0,0,0,0,0,0,0,0,3
401404452,UT Rio Grande Valley Vaqueros,I. Belosevic,4595657,,False,8.0,0,2,0,2,0,0,0,0,1,0,1,0,0,1,0,0,0
401404452,UT Rio Grande Valley Vaqueros,M. Llorente,4899434,,False,8.0,0,1,0,1,0,0,2,2,0,1,1,2,1,0,2,1,2
401404452,UT Rio Grande Valley Vaqueros,A. Sturdivant,4703927,,False,19.0,3,7,0,0,3,7,3,3,0,3,3,2,1,0,0,0,12
401404452,UT Rio Grande Valley Vaqueros,H. Jones,4595665,,False,16.0,0,5,0,3,0,2,0,0,1,2,3,0,0,0,0,0,0
401404452,UT Rio Grande Valley Vaqueros,T. McGarity,4595656,,False,9.0,0,1,0,0,0,1,0,0,3,1,4,1,0,0,0,0,0
401404452,UT Rio Grande Valley Vaqueros,TEAM,TOTAL,TOTAL,False,,20,66,12,29,8,37,9,9,11,21,32,11,7,1,5,13,57
401404451,Sam Houston Bearkats,M. Batista,4595756,,True,15.0,2,3,2,3,0,0,0,0,0,2,2,1,0,0,1,5,4
401404451,Sam Houston Bearkats,C. Cleveland,4595754,,True,29.0,4,13,4,13,0,0,0,1,3,3,6,1,4,0,2,4,8
401404451,Sam Houston Bearkats,K. Jefferson,4418429,,True,35.0,4,12,2,9,2,3,0,0,2,3,5,2,0,0,2,2,10
401404451,Sam Houston Bearkats,S. Kemp,4595751,,True,8.0,1,1,0,0,1,1,0,0,0,1,1,1,0,0,2,1,3
401404451,Sam Houston Bearkats,F. Cook,4069133,,True,35.0,5,12,1,5,4,7,9,10,1,0,1,1,0,0,1,3,23
401404451,Sam Houston Bearkats,S. Rodgers,4899506,,False,3.0,0,0,0,0,0,0,0,0,1,0,1,0,0,0,1,0,0
401404451,Sam Houston Bearkats,L. Echi,4595590,,False,11.0,1,3,1,3,0,0,0,0,2,2,4,1,0,0,1,2,2
401404451,Sam Houston Bearkats,R. Smith,4433705,,False,25.0,2,4,2,4,0,0,2,3,1,5,6,1,1,1,0,3,6
401404451,Sam Houston Bearkats,D. Telemaque,4400581,,False,39.0,8,16,8,15,0,1,1,2,2,3,5,5,5,1,2,4,17
401404451,Sam Houston Bearkats,TEAM,TOTAL,TOTAL,False,,27,64,20,52,7,12,12,16,13,20,33,13,10,2,14,24,73
401404451,Lamar Cardinals,A. Davis,4899516,,True,18.0,5,7,5,7,0,0,2,4,0,5,5,0,0,1,4,3,12
401404451,Lamar Cardinals,A. Gibbs,4704878,,True,25.0,3,5,0,1,3,4,0,0,0,4,4,1,0,0,3,2,9
401404451,Lamar Cardinals,S. Dean,4704875,,True,40.0,7,13,4,9,3,4,4,7,2,6,8,7,3,0,2,2,21
401404451,Lamar Cardinals,K. Mitchell,4595698,,True,11.0,0,1,0,1,0,0,0,0,0,0,0,1,0,0,1,5,0
401404451,Lamar Cardinals,A. Hastings,4400297,,True,29.0,2,8,1,3,1,5,11,12,0,3,3,2,0,0,0,1,16
401404451,Lamar Cardinals,N. Weems,4899515,,False,15.0,0,0,0,0,0,0,0,0,0,0,0,0,1,1,1,0,0
401404451,Lamar Cardinals,E. Imevbore,4704877,,False,22.0,3,5,3,5,0,0,1,2,2,2,4,0,0,0,3,3,7
401404451,Lamar Cardinals,P. Adams,4899513,,False,8.0,0,3,0,3,0,0,0,0,0,0,0,2,0,0,1,2,0
401404451,Lamar Cardinals,H. LeMelle,4899512,,False,32.0,2,4,2,4,0,0,0,0,1,1,2,1,1,1,1,2,4
401404451,Lamar Cardinals,TEAM,TOTAL,TOTAL,False,,22,46,15,33,7,13,18,25,7,24,31,14,5,3,16,20,69
401404450,UT Rio Grande Valley Vaqueros,T. Muff,4899433,,True,36.0,5,8,5,6,0,2,1,2,1,5,6,0,1,0,3,2,11
401404450,UT Rio Grande Valley Vaqueros,S. Bershers,4595667,,True,29.0,5,10,2,5,3,5,0,0,0,5,5,0,1,0,4,4,13
401404450,UT Rio Grande Valley Vaqueros,B. Soysal,4595662,,True,7.0,0,3,0,3,0,0,0,0,0,1,1,0,0,0,0,0,0
401404450,UT Rio Grande Valley Vaqueros,K. Kyle,4899435,,True,17.0,3,9,1,3,2,6,0,0,0,0,0,1,0,0,1,2,8
401404450,UT Rio Grande Valley Vaqueros,J. Williams,4433167,,True,33.0,5,7,5,7,0,0,4,4,0,4,4,3,2,2,3,0,14
401404450,UT Rio Grande Valley Vaqueros,B. Jessen,4899436,,False,24.0,5,7,2,4,3,3,1,1,2,7,9,2,0,2,2,2,14
401404450,UT Rio Grande Valley Vaqueros,J. Martino,4703926,,False,5.0,2,2,2,2,0,0,0,0,1,1,2,1,1,0,2,1,4
401404450,UT Rio Grande Valley Vaqueros,I. Belosevic,4595657,,False,1.0,0,0,0,0,0,0,0,0,0,0,0,0,0,0,1,0,0
401404450,UT Rio Grande Valley Vaqueros,A. Sturdivant,4703927,,False,9.0,1,3,0,0,1,3,0,0,0,0,0,2,0,0,1,0,3
401404450,UT Rio Grande Valley Vaqueros,H. Jones,4595665,,False,25.0,3,9,3,5,0,4,0,2,2,3,5,1,0,0,0,2,6
401404450,UT Rio Grande Valley Vaqueros,T. McGarity,4595656,,False,14.0,0,1,0,0,0,1,0,0,1,1,2,0,0,0,1,0,0
401404450,UT Rio Grande Valley Vaqueros,TEAM,TOTAL,TOTAL,False,,29,59,20,35,9,24,6,9,8,34,42,10,5,4,18,13,73
401404450,Abilene Christian Wildcats,J. Bonnarens,4400102,,True,35.0,7,17,4,8,3,9,2,2,4,2,6,2,0,0,0,2,19
401404450,Abilene Christian Wildcats,S. Griswold,4704712,,True,17.0,1,3,1,3,0,0,3,4,0,2,2,0,0,0,2,1,5
401404450,Abilene Christian Wildcats,M. Miller,4400267,,True,33.0,5,11,3,5,2,6,2,2,1,4,5,2,1,1,2,1,14
401404450,Abilene Christian Wildcats,K. Mraz,4400264,,True,36.0,2,11,0,2,2,9,0,0,0,5,5,4,2,0,1,1,6
401404450,Abilene Christian Wildcats,T. Barber,4282564,,True,27.0,2,5,0,1,2,4,7,8,2,2,4,2,3,0,3,3,13
401404450,Abilene Christian Wildcats,N. Johnson,4899862,,False,3.0,0,0,0,0,0,0,0,0,0,0,0,0,0,0,0,0,0
401404450,Abilene Christian Wildcats,E. Middleton,4899859,,False,19.0,1,5,1,5,0,0,4,4,2,1,3,0,2,1,0,1,6
401404450,Abilene Christian Wildcats,N. Cramer,4899863,,False,6.0,1,2,0,1,1,1,0,0,0,0,0,0,0,0,0,0,3
401404450,Abilene Christian Wildcats,B. Earle,4899858,,False,20.0,2,12,2,9,0,3,0,0,3,3,6,1,0,0,2,1,4
401404450,Abilene Christian Wildcats,T. Morgan,4704710,,False,4.0,0,1,0,0,0,1,0,0,0,0,0,0,0,0,0,0,0
401404450,Abilene Christian Wildcats,TEAM,TOTAL,TOTAL,False,,21,67,11,34,10,33,18,20,12,23,35,11,8,2,10,10,70
401404449,New Mexico State Aggies,B. Sarr,4594697,,True,23.0,6,11,6,11,0,0,1,4,6,5,11,1,0,0,2,0,13
401404449,New Mexico State Aggies,J. Bradley,4703938,,True,15.0,3,5,3,5,0,0,1,5,2,0,2,0,0,0,0,1,7
401404449,New Mexico State Aggies,S. Inoussa,4595894,,True,36.0,3,9,3,7,0,2,2,2,1,1,2,0,0,0,0,1,8
401404449,New Mexico State Aggies,T. Grays,4400010,,True,18.0,0,7,0,6,0,1,0,0,6,2,8,0,0,0,2,2,0
401404449,New Mexico State Aggies,A. Henderson,4068799,,True,21.0,0,7,0,5,0,2,0,0,1,1,2,1,2,0,2,3,0
401404449,New Mexico State Aggies,S. Harper,4595893,,False,10.0,2,3,2,3,0,0,1,2,1,2,3,0,1,0,0,1,5
401404449,New Mexico State Aggies,D. Terrell,4281799,,False,14.0,0,4,0,3,0,1,0,0,2,1,3,0,1,1,0,1,0
401404449,New Mexico State Aggies,F. Thiam,4899510,,False,2.0,0,2,0,0,0,2,0,0,1,0,1,0,0,0,0,0,0
401404449,New Mexico State Aggies,S. Peterson,4899509,,False,7.0,0,2,0,1,0,1,1,2,0,1,1,0,0,0,0,1,1
401404449,New Mexico State Aggies,M. Shida,4899508,,False,5.0,0,3,0,3,0,0,0,0,0,0,0,0,0,0,0,0,0
401404449,New Mexico State Aggies,T. Donaldson,4703939,,False,18.0,2,5,2,5,0,0,0,0,1,3,4,1,0,0,2,4,4
401404449,New Mexico State Aggies,M. Kaiser,4703937,,False,20.0,3,7,3,7,0,0,1,2,0,1,1,0,0,0,0,4,7
401404449,New Mexico State Aggies,M. Isbell,4433669,,False,9.0,1,3,0,1,1,2,0,0,0,0,0,1,0,0,1,3,3
401404449,New Mexico State Aggies,G. Colaivalu,4068246,,False,2.0,3,3,3,3,0,0,0,0,0,0,0,0,0,0,0,0,6
401404449,New Mexico State Aggies,TEAM,TOTAL,TOTAL,False,,23,71,22,60,1,11,7,17,24,17,41,4,4,1,9,21,54
401404449,Lamar Cardinals,A. Davis,4899516,,True,29.0,2,6,2,6,0,0,2,2,4,5,9,3,1,0,2,3,6
401404449,Lamar Cardinals,A. Gibbs,4704878,,True,29.0,2,7,0,3,2,4,2,2,0,7,7,1,1,0,2,2,8
401404449,Lamar Cardinals,S. Dean,4704875,,True,30.0,2,9,2,7,0,2,0,0,1,2,3,2,0,1,1,2,4
401404449,Lamar Cardinals,K. Mitchell,4595698,,True,25.0,2,4,2,2,0,2,2,2,0,0,0,1,0,0,1,2,6
401404449,Lamar Cardinals,A. Hastings,4400297,,True,26.0,7,12,3,6,4,6,7,7,2,1,3,0,1,0,3,2,25
401404449,Lamar Cardinals,N. Weems,4899515,,False,11.0,1,2,1,2,0,0,0,0,0,1,1,0,0,0,1,0,2
401404449,Lamar Cardinals,B. Galloway,4704880,,False,1.0,0,0,0,0,0,0,0,0,0,0,0,0,0,0,0,0,0
401404449,Lamar Cardinals,E. Imevbore,4704877,,False,8.0,0,2,0,2,0,0,0,0,2,4,6,0,1,1,1,3,0
401404449,Lamar Cardinals,P. Adams,4899513,,False,27.0,3,10,3,9,0,1,8,9,2,4,6,1,0,0,0,3,14
401404449,Lamar Cardinals,H. LeMelle,4899512,,False,8.0,0,1,0,0,0,1,0,0,1,2,3,0,0,0,0,0,0
401404449,Lamar Cardinals,B. Mitchell,4398828,,False,6.0,0,0,0,0,0,0,0,0,0,0,0,0,0,0,1,1,0
401404449,Lamar Cardinals,TEAM,TOTAL,TOTAL,False,,19,53,13,37,6,16,21,22,15,28,43,8,4,2,14,18,65
401404448,UT Rio Grande Valley Vaqueros,T. Muff,4899433,,True,38.0,4,15,3,10,1,5,1,1,2,7,9,4,0,0,6,2,10
401404448,UT Rio Grande Valley Vaqueros,S. Bershers,4595667,,True,37.0,6,16,1,4,5,12,7,8,1,4,5,4,2,2,0,2,24
401404448,UT Rio Grande Valley Vaqueros,B. Soysal,4595662,,True,14.0,2,5,2,5,0,0,0,0,1,2,3,0,0,0,0,1,4
401404448,UT Rio Grande Valley Vaqueros,K. Kyle,4899435,,True,21.0,1,4,1,2,0,2,0,0,0,1,1,1,1,0,1,3,2
401404448,UT Rio Grande Valley Vaqueros,J. Williams,4433167,,True,31.0,3,4,2,2,1,2,0,0,0,1,1,3,0,0,1,0,7
401404448,UT Rio Grande Valley Vaqueros,B. Jessen,4899436,,False,10.0,1,5,1,4,0,1,1,2,2,3,5,1,0,0,0,0,3
401404448,UT Rio Grande Valley Vaqueros,I. Belosevic,4595657,,False,3.0,0,2,0,1,0,1,0,0,1,0,1,0,0,0,0,0,0
401404448,UT Rio Grande Valley Vaqueros,M. Llorente,4899434,,False,2.0,0,0,0,0,0,0,0,0,0,0,0,0,0,0,0,1,0
401404448,UT Rio Grande Valley Vaqueros,A. Sturdivant,4703927,,False,15.0,3,6,0,1,3,5,2,2,0,1,1,0,1,0,0,0,11
401404448,UT Rio Grande Valley Vaqueros,H. Jones,4595665,,False,28.0,3,8,0,0,3,8,1,2,1,9,10,0,2,0,0,2,10
401404448,UT Rio Grande Valley Vaqueros,T. McGarity,4595656,,False,1.0,0,0,0,0,0,0,0,0,0,0,0,0,0,0,1,0,0
401404448,UT Rio Grande Valley Vaqueros,TEAM,TOTAL,TOTAL,False,,23,65,10,29,13,36,12,15,9,32,41,13,6,2,9,11,71
401404448,Seattle U Redhawks,H. Vice-Neat,4281746,,True,34.0,1,6,1,2,0,4,0,0,0,3,3,0,0,0,2,1,2
401404448,Seattle U Redhawks,B. Rangel,4595199,,True,16.0,2,3,2,3,0,0,0,0,2,5,7,0,1,0,1,0,4
401404448,Seattle U Redhawks,T. Clark,4899489,,True,26.0,4,7,1,4,3,3,0,0,0,5,5,2,1,0,1,0,11
401404448,Seattle U Redhawks,P. Howard,4703932,,True,26.0,2,5,2,5,0,0,4,5,1,3,4,1,1,0,1,5,8
401404448,Seattle U Redhawks,C. Murphy,4400002,,True,34.0,3,14,2,5,1,9,0,0,5,5,10,1,0,0,1,3,7
401404448,Seattle U Redhawks,I. Korolenko,4703935,,False,19.0,3,7,2,5,1,2,0,0,1,3,4,0,0,0,1,3,7
401404448,Seattle U Redhawks,M. Phillips,4595650,,False,14.0,1,2,0,0,1,2,0,0,0,2,2,1,0,0,0,1,3
401404448,Seattle U Redhawks,B. Calhoun,4703934,,False,32.0,6,21,5,13,1,8,4,4,2,3,5,6,3,0,4,2,17
401404448,Seattle U Redhawks,TEAM,TOTAL,TOTAL,False,,23,66,16,38,7,28,8,9,11,34,45,11,6,0,11,15,61
401404447,UT Arlington Mavericks,S. Jacobs,4900111,,True,38.0,10,21,10,21,0,0,8,11,5,6,11,2,3,1,2,3,28
401404447,UT Arlington Mavericks,S. Smith,4399040,,True,27.0,2,5,2,5,0,0,2,4,2,2,4,0,3,0,3,2,6
401404447,UT Arlington Mavericks,K. Ferrell,4400592,,True,21.0,3,7,1,2,2,5,1,2,0,6,6,2,1,0,3,5,9
401404447,UT Arlington Mavericks,T. Milton,4400590,,True,40.0,5,13,5,12,0,1,2,2,3,5,8,6,1,0,6,2,12
401404447,UT Arlington Mavericks,C. Chastain,4400589,,True,38.0,1,7,1,5,0,2,2,2,4,6,10,1,1,0,4,3,4
401404447,UT Arlington Mavericks,C. Hawkins,4400591,,False,8.0,1,3,0,0,1,3,0,0,0,0,0,0,1,0,0,0,3
401404447,UT Arlington Mavericks,D. Benjamin,4398599,,False,28.0,5,11,2,5,3,6,1,2,1,5,6,1,2,1,4,1,14
401404447,UT Arlington Mavericks,TEAM,TOTAL,TOTAL,False,,27,67,21,50,6,17,16,23,18,33,51,12,12,2,23,16,76
401404447,Troy Trojans,F. Koranga,4704066,,True,34.0,5,13,5,13,0,0,3,6,4,7,11,0,0,0,3,0,13
401404447,Troy Trojans,T. Stephens,4594689,,True,31.0,2,9,2,9,0,0,6,6,7,7,14,1,5,1,5,2,10
401404447,Troy Trojans,A. Leggett,4400397,,True,25.0,3,10,3,9,0,1,0,0,1,4,5,1,1,0,4,5,6
401404447,Troy Trojans,J. Sandifer,4282612,,True,26.0,2,8,1,3,1,5,4,4,2,0,2,0,2,0,2,2,9
401404447,Troy Trojans,J. Robinson,4282611,,True,25.0,2,13,2,10,0,3,0,0,0,2,2,1,1,0,2,2,4
401404447,Troy Trojans,J. Hollings,4900123,,False,2.0,0,0,0,0,0,0,0,0,0,0,0,0,1,0,1,0,0
401404447,Troy Trojans,J. Dunlap,4398710,,False,10.0,4,5,4,5,0,0,0,0,1,2,3,0,0,3,1,3,8
401404447,Troy Trojans,S. Hartsfield,4704070,,False,19.0,0,2,0,2,0,0,0,2,1,1,2,3,3,0,1,3,0
401404447,Troy Trojans,G. Cartagena,4900122,,False,1.0,0,1,0,0,0,1,0,0,0,0,0,0,0,0,0,0,0
401404447,Troy Trojans,Z. Downs,4705004,,False,6.0,0,1,0,0,0,1,0,0,0,0,0,0,0,0,0,2,0
401404447,Troy Trojans,T. Johnson,4596285,,False,21.0,3,10,1,5,2,5,3,4,2,1,3,1,1,0,0,5,11
401404447,Troy Trojans,TEAM,TOTAL,TOTAL,False,,21,72,18,56,3,16,16,22,20,26,46,7,14,4,19,24,61
401404446,UT Arlington Mavericks,S. Jacobs,4900111,,True,40.0,12,21,12,21,0,0,4,6,3,7,10,3,1,3,3,3,28
401404446,UT Arlington Mavericks,S. Smith,4399040,,True,26.0,2,4,2,4,0,0,3,4,0,0,0,0,1,1,0,0,7
401404446,UT Arlington Mavericks,K. Ferrell,4400592,,True,31.0,1,5,0,1,1,4,0,0,1,6,7,9,0,0,2,3,3
401404446,UT Arlington Mavericks,T. Milton,4400590,,True,39.0,4,7,4,7,0,0,2,2,1,4,5,5,0,0,1,3,10
401404446,UT Arlington Mavericks,C. Chastain,4400589,,True,29.0,6,10,3,6,3,4,0,0,2,4,6,2,1,1,4,3,15
401404446,UT Arlington Mavericks,C. Hawkins,4400591,,False,13.0,2,5,1,2,1,3,1,1,0,1,1,1,0,0,0,1,6
401404446,UT Arlington Mavericks,D. Benjamin,4398599,,False,22.0,2,6,0,3,2,3,0,0,0,4,4,2,0,1,2,3,6
401404446,UT Arlington Mavericks,TEAM,TOTAL,TOTAL,False,,29,58,22,44,7,14,10,13,9,28,37,22,3,6,12,16,75
401404446,Louisiana Ragin' Cajuns,T. Johnson,4704032,,True,37.0,4,11,4,10,0,1,2,3,2,3,5,2,1,2,2,1,10
401404446,Louisiana Ragin' Cajuns,T. Doucet,4282582,,True,37.0,4,8,4,8,0,0,0,2,1,6,7,0,2,1,4,3,8
401404446,Louisiana Ragin' Cajuns,L. Wheaton,4704518,,True,40.0,9,19,7,14,2,5,4,4,0,6,6,0,0,0,0,2,24
401404446,Louisiana Ragin' Cajuns,M. Hallmon,4596016,,True,32.0,3,11,1,6,2,5,0,0,1,3,4,1,1,0,2,4,8
401404446,Louisiana Ragin' Cajuns,D. Rice,4433333,,True,40.0,3,8,3,6,0,2,5,5,0,0,0,1,3,1,1,1,11
401404446,Louisiana Ragin' Cajuns,A. Jones,4900375,,False,8.0,1,3,1,3,0,0,0,0,1,1,2,0,0,0,0,0,2
401404446,Louisiana Ragin' Cajuns,C. Wren,4596017,,False,6.0,0,0,0,0,0,0,2,2,2,1,3,0,0,0,0,2,2
401404446,Louisiana Ragin' Cajuns,TEAM,TOTAL,TOTAL,False,,24,60,20,47,4,13,13,16,10,21,31,4,7,4,10,13,65
401404445,Troy Trojans,F. Koranga,4704066,,True,24.0,2,7,2,7,0,0,0,0,1,6,7,1,3,0,5,1,4
401404445,Troy Trojans,T. Stephens,4594689,,True,31.0,1,4,1,3,0,1,5,7,1,9,10,3,1,0,4,4,7
401404445,Troy Trojans,A. Leggett,4400397,,True,31.0,6,10,5,8,1,2,0,0,3,4,7,1,2,0,3,3,13
401404445,Troy Trojans,J. Sandifer,4282612,,True,32.0,2,6,2,3,0,3,3,4,1,3,4,1,0,0,1,1,7
401404445,Troy Trojans,J. Robinson,4282611,,True,23.0,4,8,4,7,0,1,1,2,2,1,3,1,0,0,3,1,9
401404445,Troy Trojans,J. Hollings,4900123,,False,4.0,0,2,0,2,0,0,0,0,1,1,2,0,0,0,0,0,0
401404445,Troy Trojans,B. Harris,4399517,,False,1.0,0,0,0,0,0,0,0,0,0,0,0,0,0,0,0,0,0
401404445,Troy Trojans,J. Dunlap,4398710,,False,20.0,7,11,6,10,1,1,3,4,1,2,3,0,2,1,1,2,18
401404445,Troy Trojans,S. Hartsfield,4704070,,False,18.0,1,3,1,2,0,1,0,0,0,1,1,3,2,0,3,0,2
401404445,Troy Trojans,Z. Downs,4705004,,False,7.0,1,3,1,1,0,2,0,0,0,0,0,0,0,0,0,0,2
401404445,Troy Trojans,T. Johnson,4596285,,False,9.0,0,0,0,0,0,0,0,0,0,0,0,0,1,0,1,1,0
401404445,Troy Trojans,TEAM,TOTAL,TOTAL,False,,24,54,22,43,2,11,12,17,12,29,41,10,11,1,22,13,62
401404445,Little Rock Trojans,S. Kourouma,4899942,,True,30.0,10,20,6,13,4,7,3,3,3,3,6,0,3,0,4,3,27
401404445,Little Rock Trojans,D. Johnson,4703992,,True,40.0,3,9,2,8,1,1,0,0,2,4,6,1,1,2,1,2,7
401404445,Little Rock Trojans,A. Francis,4596035,,True,32.0,2,2,2,2,0,0,0,0,2,5,7,0,1,0,1,2,4
401404445,Little Rock Trojans,M. Caicedo,4703994,,True,40.0,2,12,1,6,1,6,0,0,0,2,2,8,4,0,7,4,5
401404445,Little Rock Trojans,R. Potter,4400182,,True,28.0,6,15,5,12,1,3,1,1,2,2,4,2,2,0,2,3,14
401404445,Little Rock Trojans,A. Robinson,4432993,,False,12.0,1,1,1,1,0,0,0,0,1,1,2,0,0,1,2,4,2
401404445,Little Rock Trojans,T. Harvey,4703991,,False,18.0,0,5,0,5,0,0,0,0,0,1,1,2,1,0,0,0,0
401404445,Little Rock Trojans,TEAM,TOTAL,TOTAL,False,,24,64,17,47,7,17,4,4,11,19,30,13,12,3,17,18,59
401404444,UT Arlington Mavericks,S. Jacobs,4900111,,True,37.0,9,17,9,17,0,0,10,14,5,4,9,0,2,1,5,1,28
401404444,UT Arlington Mavericks,S. Smith,4399040,,True,25.0,0,3,0,3,0,0,8,10,1,6,7,1,1,0,0,2,8
401404444,UT Arlington Mavericks,K. Ferrell,4400592,,True,27.0,3,6,1,1,2,5,3,5,1,5,6,5,1,1,0,4,11
401404444,UT Arlington Mavericks,T. Milton,4400590,,True,37.0,6,14,6,14,0,0,3,3,1,4,5,4,1,0,2,3,15
401404444,UT Arlington Mavericks,C. Chastain,4400589,,True,34.0,4,11,1,6,3,5,3,4,1,0,1,2,0,2,0,3,14
401404444,UT Arlington Mavericks,J. Turner,4900114,,False,4.0,0,2,0,0,0,2,0,0,0,1,1,0,0,0,0,1,0
401404444,UT Arlington Mavericks,O. Chaney,4900109,,False,1.0,0,0,0,0,0,0,0,0,0,0,0,0,0,0,0,0,0
401404444,UT Arlington Mavericks,C. Hawkins,4400591,,False,10.0,0,1,0,0,0,1,0,0,0,2,2,0,0,0,2,1,0
401404444,UT Arlington Mavericks,D. Benjamin,4398599,,False,25.0,2,8,1,5,1,3,4,4,2,2,4,0,1,1,0,2,9
401404444,UT Arlington Mavericks,TEAM,TOTAL,TOTAL,False,,24,62,18,46,6,16,31,40,13,26,39,12,6,5,10,17,85
401404444,Georgia Southern Eagles,M. Banks,4281229,,True,14.0,0,1,0,1,0,0,2,2,2,0,2,0,0,1,1,4,2
401404444,Georgia Southern Eagles,S. James,4704028,,True,18.0,4,6,4,5,0,1,0,0,2,1,3,0,0,1,1,2,8
401404444,Georgia Southern Eagles,T. Ward,4704025,,True,27.0,5,17,5,12,0,5,3,4,0,7,7,1,1,1,3,2,13
401404444,Georgia Southern Eagles,J. Love-Hill,4595903,,True,13.0,0,4,0,4,0,0,0,0,0,2,2,1,0,0,1,2,0
401404444,Georgia Southern Eagles,M. Burns,4595901,,True,22.0,3,9,3,7,0,2,1,2,2,2,4,0,0,0,1,2,7
401404444,Georgia Southern Eagles,T. Gibson,4899935,,False,24.0,5,13,5,13,0,0,6,6,6,4,10,2,0,0,3,3,16
401404444,Georgia Southern Eagles,E. Johnson,4594766,,False,18.0,1,4,1,2,0,2,0,0,0,2,2,0,1,1,1,1,2
401404444,Georgia Southern Eagles,T. Nisbet,4400540,,False,8.0,1,4,1,3,0,1,1,2,2,1,3,0,1,0,0,1,3
401404444,Georgia Southern Eagles,L. Freeman,4704029,,False,9.0,4,4,4,4,0,0,0,0,1,2,3,0,0,1,0,2,8
401404444,Georgia Southern Eagles,D. Holmes,4704024,,False,11.0,2,6,0,0,2,6,0,0,0,1,1,1,1,0,0,2,6
401404444,Georgia Southern Eagles,C. Thomas,4703760,,False,22.0,0,1,0,1,0,0,2,2,2,2,4,5,1,0,0,3,2
401404444,Georgia Southern Eagles,R. Johnson,4703710,,False,14.0,3,7,2,6,1,1,2,3,0,1,1,1,1,0,1,2,9
401404444,Georgia Southern Eagles,TEAM,TOTAL,TOTAL,False,,28,76,25,58,3,18,17,21,21,25,46,11,6,5,13,26,76
401404443,Texas State Bobcats,D. Hood,4400606,,True,31.0,4,12,4,10,0,2,3,3,2,3,5,0,1,1,3,5,11
401404443,Texas State Bobcats,L. Thompson,4399494,,True,10.0,0,3,0,3,0,0,0,0,0,1,1,0,0,0,1,0,0
401404443,Texas State Bobcats,S. Dickson,4704055,,True,28.0,1,5,0,4,1,1,2,2,1,2,3,1,0,0,1,2,5
401404443,Texas State Bobcats,J. Bowie,4400604,,True,17.0,0,2,0,2,0,0,0,0,1,3,4,1,0,0,1,4,0
401404443,Texas State Bobcats,K. Taylor,4400603,,True,36.0,4,8,2,4,2,4,2,2,0,2,2,3,2,0,3,1,12
401404443,Texas State Bobcats,N. Leff,4704056,,False,3.0,0,1,0,1,0,0,0,0,0,1,1,0,0,0,0,0,0
401404443,Texas State Bobcats,G. Standifer,4400128,,False,19.0,2,5,1,2,1,3,2,2,1,1,2,1,1,0,0,1,7
401404443,Texas State Bobcats,J. Reed,4400607,,False,21.0,1,3,1,3,0,0,0,0,2,2,4,0,0,0,3,3,2
401404443,Texas State Bobcats,P. Bennett,4704054,,False,4.0,0,0,0,0,0,0,0,0,0,0,0,0,0,0,0,0,0
401404443,Texas State Bobcats,J. Johnson,4594757,,False,16.0,3,8,0,1,3,7,0,0,0,2,2,0,0,0,1,0,9
401404443,Texas State Bobcats,T. Eaton,4281720,,False,15.0,0,2,0,2,0,0,0,0,0,1,1,2,0,0,3,1,0
401404443,Texas State Bobcats,TEAM,TOTAL,TOTAL,False,,15,49,8,32,7,17,9,9,7,18,25,8,4,1,16,17,46
401404443,Louisiana Ragin' Cajuns,T. Johnson,4704032,,True,34.0,2,8,2,5,0,3,0,0,0,5,5,2,3,2,1,4,4
401404443,Louisiana Ragin' Cajuns,T. Doucet,4282582,,True,34.0,2,5,2,5,0,0,1,2,1,5,6,1,3,1,3,0,5
401404443,Louisiana Ragin' Cajuns,L. Wheaton,4704518,,True,35.0,8,11,7,9,1,2,1,2,0,2,2,1,0,0,1,3,18
401404443,Louisiana Ragin' Cajuns,M. Hallmon,4596016,,True,31.0,7,13,4,9,3,4,2,2,0,3,3,0,1,0,1,1,19
401404443,Louisiana Ragin' Cajuns,D. Rice,4433333,,True,36.0,2,6,2,4,0,2,5,5,0,5,5,1,1,0,2,2,9
401404443,Louisiana Ragin' Cajuns,A. Jones,4900375,,False,16.0,4,6,4,6,0,0,0,0,2,0,2,4,0,0,1,1,8
401404443,Louisiana Ragin' Cajuns,L. Green,4704034,,False,3.0,0,0,0,0,0,0,0,0,0,1,1,0,0,0,0,0,0
401404443,Louisiana Ragin' Cajuns,C. Wren,4596017,,False,7.0,4,4,4,4,0,0,0,2,1,2,3,0,0,0,0,1,8
401404443,Louisiana Ragin' Cajuns,S. Christmas,4900377,,False,4.0,0,0,0,0,0,0,0,0,0,1,1,0,0,0,0,1,0
401404443,Louisiana Ragin' Cajuns,TEAM,TOTAL,TOTAL,False,,29,53,25,42,4,11,9,13,6,27,33,9,8,3,12,13,71
401404442,Little Rock Trojans,S. Kourouma,4899942,,True,36.0,9,20,8,17,1,3,5,6,3,5,8,1,1,1,0,1,24
401404442,Little Rock Trojans,D. Johnson,4703992,,True,39.0,4,8,4,8,0,0,2,3,4,11,15,3,2,1,5,2,10
401404442,Little Rock Trojans,A. Francis,4596035,,True,37.0,4,6,4,6,0,0,2,4,6,5,11,0,0,0,1,3,10
401404442,Little Rock Trojans,M. Caicedo,4703994,,True,27.0,1,4,1,4,0,0,5,6,0,2,2,3,2,0,1,4,7
401404442,Little Rock Trojans,R. Potter,4400182,,True,38.0,4,15,4,12,0,3,2,4,3,4,7,7,2,1,3,0,10
401404442,Little Rock Trojans,A. Robinson,4432993,,False,0.0,0,0,0,0,0,0,0,0,0,0,0,0,0,0,0,0,0
401404442,Little Rock Trojans,T. Harvey,4703991,,False,23.0,4,10,3,7,1,3,0,0,1,1,2,0,1,0,3,1,9
401404442,Little Rock Trojans,TEAM,TOTAL,TOTAL,False,,26,63,24,54,2,9,16,23,18,30,48,14,8,3,14,11,70
401404442,App State Mountaineers,A. Allesch,4281848,,True,33.0,1,3,1,2,0,1,2,2,0,9,9,0,3,2,0,1,4
401404442,App State Mountaineers,E. Carver,4899901,,True,31.0,2,8,1,4,1,4,0,0,0,0,0,1,1,0,0,4,5
401404442,App State Mountaineers,F. Alston,4703986,,True,37.0,10,17,7,10,3,7,1,1,2,1,3,3,0,0,4,4,24
401404442,App State Mountaineers,J. Sanders,4399438,,True,34.0,9,16,9,16,0,0,0,2,0,6,6,1,0,0,5,0,18
401404442,App State Mountaineers,M. Porter,4281070,,True,24.0,2,6,1,5,1,1,2,2,0,0,0,0,0,1,2,3,7
401404442,App State Mountaineers,A. Gilbert,4400522,,False,6.0,0,0,0,0,0,0,0,0,0,1,1,0,0,0,0,5,0
401404442,App State Mountaineers,M. Frazier,4899899,,False,8.0,0,1,0,0,0,1,0,0,0,1,1,0,1,0,1,2,0
401404442,App State Mountaineers,D. Bertolina,4703985,,False,11.0,0,1,0,0,0,1,0,0,0,1,1,0,0,0,0,3,0
401404442,App State Mountaineers,T. Lewis,4595012,,False,1.0,0,0,0,0,0,0,0,0,0,0,0,0,0,0,0,1,0
401404442,App State Mountaineers,B. Bigott,4400525,,False,15.0,0,5,0,2,0,3,0,0,0,3,3,2,0,0,1,1,0
401404442,App State Mountaineers,TEAM,TOTAL,TOTAL,False,,24,57,19,39,5,18,5,7,3,22,25,7,5,3,13,24,58
401404441,Troy Trojans,F. Koranga,4704066,,True,26.0,5,11,5,11,0,0,1,2,3,9,12,0,2,1,3,0,11
401404441,Troy Trojans,T. Stephens,4594689,,True,21.0,4,6,3,4,1,2,5,5,2,2,4,2,1,0,3,2,14
401404441,Troy Trojans,A. Leggett,4400397,,True,15.0,4,4,3,3,1,1,0,0,2,1,3,0,1,0,4,3,9
401404441,Troy Trojans,J. Sandifer,4282612,,True,28.0,2,6,0,1,2,5,5,6,1,2,3,6,0,0,0,0,11
401404441,Troy Trojans,J. Robinson,4282611,,True,18.0,2,7,2,5,0,2,3,3,0,1,1,4,0,0,3,3,7
401404441,Troy Trojans,J. Hollings,4900123,,False,14.0,2,4,2,4,0,0,2,3,2,3,5,1,0,1,0,3,6
401404441,Troy Trojans,B. Harris,4399517,,False,6.0,0,1,0,1,0,0,0,0,0,1,1,0,0,0,1,2,0
401404441,Troy Trojans,J. Dunlap,4398710,,False,13.0,9,12,8,10,1,2,1,2,3,1,4,1,3,1,2,5,20
401404441,Troy Trojans,S. Hartsfield,4704070,,False,13.0,0,1,0,1,0,0,2,2,0,2,2,1,1,0,1,4,2
401404441,Troy Trojans,G. Cartagena,4900122,,False,1.0,0,0,0,0,0,0,0,0,0,0,0,0,0,0,1,1,0
401404441,Troy Trojans,Z. Downs,4705004,,False,22.0,2,9,1,5,1,4,4,5,0,3,3,1,2,0,0,1,9
401404441,Troy Trojans,J. Reese,4704071,,False,1.0,1,2,1,2,0,0,0,0,0,0,0,0,0,0,0,1,2
401404441,Troy Trojans,T. Johnson,4596285,,False,17.0,1,5,0,1,1,4,1,2,0,1,1,1,0,0,4,2,4
401404441,Troy Trojans,J. Walton,4280894,,False,5.0,1,2,0,0,1,2,1,4,2,1,3,1,0,0,1,1,4
401404441,Troy Trojans,TEAM,TOTAL,TOTAL,False,,33,70,25,48,8,22,25,34,16,29,45,18,10,3,24,28,99
401404441,Coastal Carolina Chanticleers,Jane. Camp,4595884,,True,15.0,5,11,5,11,0,0,2,4,2,2,4,2,0,0,1,5,12
401404441,Coastal Carolina Chanticleers,A. Blount,4400533,,True,36.0,5,9,5,7,0,2,12,16,2,4,6,1,0,0,1,2,22
401404441,Coastal Carolina Chanticleers,A. Freeman,4899926,,True,24.0,5,15,5,12,0,3,3,4,0,0,0,2,2,0,2,4,13
401404441,Coastal Carolina Chanticleers,J. Newsome,4899925,,True,11.0,0,2,0,1,0,1,0,0,0,2,2,1,0,0,0,1,0
401404441,Coastal Carolina Chanticleers,T. Brown,4704013,,True,35.0,2,10,1,4,1,6,3,5,0,4,4,4,0,0,5,0,8
401404441,Coastal Carolina Chanticleers,A. Belinga,4899930,,False,6.0,0,0,0,0,0,0,2,2,0,1,1,0,0,0,1,3,2
401404441,Coastal Carolina Chanticleers,Janae Camp,4282560,,False,23.0,0,2,0,2,0,0,0,0,4,4,8,1,2,2,2,4,0
401404441,Coastal Carolina Chanticleers,B. Lundu,4899931,,False,1.0,0,0,0,0,0,0,0,0,1,0,1,0,0,0,0,0,0
401404441,Coastal Carolina Chanticleers,K. Buggs,4899929,,False,1.0,0,0,0,0,0,0,0,0,0,0,0,0,0,0,1,1,0
401404441,Coastal Carolina Chanticleers,A. Juste-Jean,4899927,,False,13.0,3,6,3,5,0,1,0,0,0,1,1,0,1,0,3,4,6
401404441,Coastal Carolina Chanticleers,B. Shultz,4899924,,False,6.0,0,1,0,0,0,1,0,0,0,2,2,0,1,0,3,1,0
401404441,Coastal Carolina Chanticleers,B. Simmons,4704011,,False,1.0,0,1,0,0,0,1,0,0,0,0,0,0,0,0,0,0,0
401404441,Coastal Carolina Chanticleers,D. Richardson,4595946,,False,28.0,6,10,5,8,1,2,1,2,4,1,5,2,1,0,1,2,14
401404441,Coastal Carolina Chanticleers,TEAM,TOTAL,TOTAL,False,,26,67,24,50,2,17,23,33,14,25,39,13,7,2,20,27,77
401404440,Georgia State Panthers,A. Gitchenko,4899940,,True,18.0,2,4,2,3,0,1,4,4,1,1,2,0,0,0,0,1,8
401404440,Georgia State Panthers,D. Merrill,4433645,,True,24.0,4,7,4,7,0,0,2,2,0,4,4,2,3,1,4,5,10
401404440,Georgia State Panthers,K. Dziak,4595937,,True,20.0,1,4,0,2,1,2,0,0,0,1,1,0,0,0,0,0,3
401404440,Georgia State Panthers,A. Foster,4400632,,True,26.0,4,8,3,6,1,2,1,2,0,3,3,1,3,0,2,4,10
401404440,Georgia State Panthers,T. Lyons,4398721,,True,18.0,1,5,1,5,0,0,0,0,0,0,0,1,1,0,0,2,2
401404440,Georgia State Panthers,A. Phillip,4899939,,False,15.0,5,6,3,4,2,2,0,0,2,1,3,0,1,0,0,3,12
401404440,Georgia State Panthers,E. Bell,4704031,,False,8.0,1,3,1,3,0,0,0,0,0,3,3,0,0,0,0,2,2
401404440,Georgia State Panthers,N. Jean,4899938,,False,25.0,4,11,3,7,1,4,2,6,0,2,2,5,1,2,0,2,11
401404440,Georgia State Panthers,M. Tolivert,4899937,,False,21.0,3,4,3,4,0,0,0,0,0,0,0,2,1,0,1,3,6
401404440,Georgia State Panthers,M. Taylor,4595933,,False,2.0,0,0,0,0,0,0,0,0,0,0,0,1,0,0,0,0,0
401404440,Georgia State Panthers,T. Worth,4398594,,False,23.0,5,11,3,6,2,5,3,5,2,1,3,0,0,0,1,2,15
401404440,Georgia State Panthers,TEAM,TOTAL,TOTAL,False,,30,63,23,47,7,16,12,19,6,18,24,12,10,3,10,24,79
401404440,Georgia Southern Eagles,M. Banks,4281229,,True,23.0,1,4,1,4,0,0,2,2,0,4,4,0,1,3,1,2,4
401404440,Georgia Southern Eagles,S. James,4704028,,True,18.0,1,4,0,2,1,2,0,2,1,1,2,1,0,0,2,2,3
401404440,Georgia Southern Eagles,T. Ward,4704025,,True,32.0,6,11,4,7,2,4,3,4,2,6,8,2,1,2,3,4,17
401404440,Georgia Southern Eagles,J. Love-Hill,4595903,,True,34.0,4,9,4,8,0,1,6,7,2,6,8,6,1,0,3,2,14
401404440,Georgia Southern Eagles,M. Burns,4595901,,True,35.0,5,9,2,4,3,5,7,8,1,4,5,1,1,0,2,0,20
401404440,Georgia Southern Eagles,T. Gibson,4899935,,False,18.0,6,11,5,9,1,2,6,6,5,3,8,0,0,0,2,2,19
401404440,Georgia Southern Eagles,E. Johnson,4594766,,False,14.0,2,2,1,1,1,1,0,0,1,2,3,0,0,0,0,2,5
401404440,Georgia Southern Eagles,T. Nisbet,4400540,,False,1.0,0,1,0,1,0,0,0,0,0,0,0,0,0,0,0,1,0
401404440,Georgia Southern Eagles,L. Freeman,4704029,,False,6.0,1,3,1,3,0,0,0,0,0,3,3,0,0,0,1,3,2
401404440,Georgia Southern Eagles,D. Holmes,4704024,,False,5.0,0,1,0,0,0,1,0,0,0,0,0,0,0,0,0,1,0
401404440,Georgia Southern Eagles,C. Thomas,4703760,,False,6.0,2,4,2,4,0,0,0,0,0,0,0,1,1,0,1,1,4
401404440,Georgia Southern Eagles,R. Johnson,4703710,,False,8.0,0,0,0,0,0,0,0,0,1,0,1,1,0,0,1,0,0
401404440,Georgia Southern Eagles,TEAM,TOTAL,TOTAL,False,,28,59,20,43,8,16,24,29,16,30,46,12,5,5,17,20,88
401404439,Texas State Bobcats,D. Hood,4400606,,True,35.0,14,24,13,19,1,5,4,6,3,10,13,1,1,0,1,2,33
401404439,Texas State Bobcats,L. Thompson,4399494,,True,21.0,3,5,3,4,0,1,0,0,1,1,2,1,0,0,0,3,6
401404439,Texas State Bobcats,S. Dickson,4704055,,True,34.0,3,6,2,3,1,3,2,2,1,2,3,3,0,0,1,4,9
401404439,Texas State Bobcats,J. Bowie,4400604,,True,32.0,3,8,1,4,2,4,0,0,0,1,1,2,0,0,1,1,8
401404439,Texas State Bobcats,K. Taylor,4400603,,True,40.0,4,9,1,3,3,6,2,2,0,5,5,8,5,0,3,3,13
401404439,Texas State Bobcats,G. Standifer,4400128,,False,10.0,0,1,0,0,0,1,0,0,0,1,1,1,1,0,0,0,0
401404439,Texas State Bobcats,J. Reed,4400607,,False,18.0,2,5,2,5,0,0,2,2,3,2,5,3,0,0,2,2,6
401404439,Texas State Bobcats,T. Eaton,4281720,,False,10.0,2,3,1,2,1,1,0,0,0,1,1,0,1,0,1,1,5
401404439,Texas State Bobcats,TEAM,TOTAL,TOTAL,False,,31,61,23,40,8,21,10,12,12,23,35,19,8,0,9,16,80
401404439,South Alabama Jaguars,K. Anderson,4900382,,True,24.0,4,4,4,4,0,0,1,4,1,3,4,0,1,0,1,1,9
401404439,South Alabama Jaguars,J. Powell,4281436,,True,33.0,7,11,2,5,5,6,0,2,3,2,5,2,1,0,4,4,19
401404439,South Alabama Jaguars,N. Howard,4900381,,True,28.0,2,5,1,4,1,1,1,2,1,1,2,0,0,0,0,2,6
401404439,South Alabama Jaguars,D. Haymer,4703634,,True,35.0,5,13,5,10,0,3,1,2,0,2,2,2,1,0,2,3,11
401404439,South Alabama Jaguars,M. Vaught,4400579,,True,32.0,4,9,3,7,1,2,1,2,0,2,2,4,1,0,2,2,10
401404439,South Alabama Jaguars,C. Ferguson,4282601,,False,18.0,1,3,0,0,1,3,0,0,1,2,3,1,1,0,1,1,3
401404439,South Alabama Jaguars,T. Williams,4900380,,False,22.0,1,3,1,2,0,1,2,3,0,3,3,2,0,0,2,2,4
401404439,South Alabama Jaguars,J. Jones,4704053,,False,8.0,1,2,1,2,0,0,2,2,2,0,2,0,0,0,0,1,4
401404439,South Alabama Jaguars,TEAM,TOTAL,TOTAL,False,,25,50,17,34,8,16,8,17,8,19,27,11,5,0,13,16,66
401404438,UL Monroe Warhawks,T. McDowell,4704039,,True,40.0,0,2,0,2,0,0,0,0,3,4,7,0,1,0,2,3,0
401404438,UL Monroe Warhawks,K. Crockett,4596025,,True,31.0,1,4,1,4,0,0,1,5,2,8,10,1,0,0,2,5,3
401404438,UL Monroe Warhawks,A. Ford,4900119,,True,30.0,6,8,6,8,0,0,3,4,2,3,5,2,2,0,2,2,15
401404438,UL Monroe Warhawks,G. Williams,4704037,,True,15.0,2,2,2,2,0,0,0,0,0,4,4,1,0,0,1,0,4
401404438,UL Monroe Warhawks,K. Whittington,4704035,,True,32.0,9,22,6,16,3,6,5,8,2,4,6,2,0,0,4,3,26
401404438,UL Monroe Warhawks,K. Manuel,4900121,,False,5.0,0,0,0,0,0,0,0,0,0,0,0,0,0,0,1,1,0
401404438,UL Monroe Warhawks,A. Sam,4900116,,False,12.0,1,5,0,4,1,1,0,0,1,1,2,0,0,0,1,1,3
401404438,UL Monroe Warhawks,B. Sutton,4900115,,False,21.0,2,3,2,3,0,0,0,0,1,0,1,0,1,0,3,5,4
401404438,UL Monroe Warhawks,K. Brimzy,4704040,,False,4.0,0,2,0,2,0,0,1,2,0,1,1,0,0,0,2,0,1
401404438,UL Monroe Warhawks,L. van Schaik,4596024,,False,4.0,0,0,0,0,0,0,0,0,0,0,0,0,0,0,0,0,0
401404438,UL Monroe Warhawks,G. Self,4596023,,False,6.0,0,1,0,1,0,0,0,0,0,0,0,0,0,0,0,0,0
401404438,UL Monroe Warhawks,TEAM,TOTAL,TOTAL,False,,21,49,17,42,4,7,10,19,12,26,38,6,4,0,19,20,56
401404438,Little Rock Trojans,S. Kourouma,4899942,,True,31.0,7,15,7,11,0,4,7,8,1,3,4,0,0,0,2,3,21
401404438,Little Rock Trojans,D. Johnson,4703992,,True,40.0,2,5,2,4,0,1,0,0,5,5,10,1,0,2,0,4,4
401404438,Little Rock Trojans,A. Francis,4596035,,True,28.0,1,2,1,2,0,0,0,0,3,3,6,1,2,1,1,3,2
401404438,Little Rock Trojans,M. Caicedo,4703994,,True,40.0,3,11,2,7,1,4,6,6,0,5,5,5,4,0,3,1,13
401404438,Little Rock Trojans,R. Potter,4400182,,True,38.0,7,20,6,13,1,7,4,5,0,0,0,0,2,0,2,1,19
401404438,Little Rock Trojans,A. Robinson,4432993,,False,3.0,0,1,0,1,0,0,0,0,1,0,1,0,0,0,0,1,0
401404438,Little Rock Trojans,T. Harvey,4703991,,False,20.0,1,3,1,3,0,0,0,0,0,2,2,1,1,0,0,5,2
401404438,Little Rock Trojans,TEAM,TOTAL,TOTAL,False,,21,57,19,41,2,16,17,19,10,19,29,8,9,3,8,18,61
401404437,Coastal Carolina Chanticleers,Jane. Camp,4595884,,True,23.0,1,5,1,5,0,0,0,0,4,9,13,0,1,3,3,4,2
401404437,Coastal Carolina Chanticleers,A. Blount,4400533,,True,40.0,14,18,10,13,4,5,9,12,3,5,8,4,1,0,4,2,41
401404437,Coastal Carolina Chanticleers,A. Freeman,4899926,,True,32.0,2,6,0,3,2,3,4,4,2,7,9,6,0,0,4,5,10
401404437,Coastal Carolina Chanticleers,B. Shultz,4899924,,True,33.0,2,8,2,4,0,4,4,6,0,1,1,1,1,0,4,3,8
401404437,Coastal Carolina Chanticleers,T. Brown,4704013,,True,24.0,4,7,3,4,1,3,8,9,0,0,0,1,1,0,1,2,17
401404437,Coastal Carolina Chanticleers,S. Dews,4899928,,False,0.0,0,0,0,0,0,0,0,0,0,0,0,0,0,0,0,1,0
401404437,Coastal Carolina Chanticleers,Janae Camp,4282560,,False,16.0,2,3,2,3,0,0,2,3,2,5,7,0,0,0,1,0,6
401404437,Coastal Carolina Chanticleers,K. Buggs,4899929,,False,5.0,0,0,0,0,0,0,0,0,0,0,0,0,0,0,1,1,0
401404437,Coastal Carolina Chanticleers,A. Juste-Jean,4899927,,False,2.0,0,0,0,0,0,0,0,0,0,0,0,0,0,0,1,0,0
401404437,Coastal Carolina Chanticleers,J. Newsome,4899925,,False,17.0,2,3,2,2,0,1,0,0,0,0,0,1,0,0,4,2,4
401404437,Coastal Carolina Chanticleers,D. Richardson,4595946,,False,8.0,1,1,0,0,1,1,0,0,0,1,1,1,0,0,2,1,3
401404437,Coastal Carolina Chanticleers,TEAM,TOTAL,TOTAL,False,,28,51,20,34,8,17,27,34,12,37,49,14,4,3,25,21,91
401404437,Arkansas State Red Wolves,T. Jackson,4400530,,True,15.0,2,4,2,4,0,0,2,2,0,1,1,0,0,1,4,1,6
401404437,Arkansas State Red Wolves,L. Pendleton,4899922,,True,36.0,5,17,5,13,0,4,4,4,2,2,4,2,5,0,0,4,14
401404437,Arkansas State Red Wolves,M. Wilkerson,4899920,,True,22.0,0,5,0,2,0,3,0,0,0,0,0,0,1,0,0,3,0
401404437,Arkansas State Red Wolves,J. Washington,4400528,,True,36.0,7,15,7,14,0,1,16,21,3,4,7,2,5,0,2,4,30
401404437,Arkansas State Red Wolves,M. Wallace,4282567,,True,36.0,5,11,2,5,3,6,0,0,2,5,7,1,5,0,3,4,13
401404437,Arkansas State Red Wolves,K. Ellis,4899923,,False,24.0,0,2,0,2,0,0,0,0,1,0,1,0,2,1,0,2,0
401404437,Arkansas State Red Wolves,J. Upshaw,4899918,,False,16.0,0,5,0,1,0,4,0,0,1,0,1,2,1,0,0,3,0
401404437,Arkansas State Red Wolves,M. Love,4595851,,False,15.0,5,10,4,8,1,2,2,2,1,0,1,0,2,0,2,5,13
401404437,Arkansas State Red Wolves,TEAM,TOTAL,TOTAL,False,,24,69,20,49,4,20,24,29,12,13,25,7,21,2,11,26,76
401404436,SE Louisiana Lady Lions,C. Williams,4281056,,True,33.0,4,14,4,14,0,0,1,3,4,4,8,0,1,1,2,4,9
401404436,SE Louisiana Lady Lions,C. Brown,4705010,,True,31.0,0,3,0,2,0,1,0,0,3,4,7,1,1,0,1,5,0
401404436,SE Louisiana Lady Lions,C. Cunningham,4705008,,True,9.0,0,0,0,0,0,0,1,2,0,0,0,1,3,0,1,0,1
401404436,SE Louisiana Lady Lions,H. Giaratano,4595778,,True,43.0,5,13,2,5,3,8,2,3,0,1,1,2,4,1,4,1,15
401404436,SE Louisiana Lady Lions,A. Horne,4595776,,True,35.0,3,7,2,5,1,2,2,5,0,3,3,2,0,0,5,3,9
401404436,SE Louisiana Lady Lions,N. Kelly,4398610,,False,6.0,0,1,0,1,0,0,0,0,1,1,2,0,0,1,0,1,0
401404436,SE Louisiana Lady Lions,M. Davis,4900441,,False,13.0,2,2,2,2,0,0,2,2,1,3,4,0,0,0,0,2,6
401404436,SE Louisiana Lady Lions,T. Bell,4900439,,False,32.0,3,7,2,5,1,2,0,0,1,4,5,2,1,0,2,1,7
401404436,SE Louisiana Lady Lions,B. Ducksworth,4595775,,False,13.0,1,4,1,4,0,0,2,3,1,0,1,2,1,0,0,2,4
401404436,SE Louisiana Lady Lions,D. Harvey,4595774,,False,6.0,0,1,0,0,0,1,1,2,1,1,2,1,0,0,0,0,1
401404436,SE Louisiana Lady Lions,M. Carrier,4281053,,False,4.0,0,4,0,2,0,2,0,0,0,0,0,0,0,0,0,1,0
401404436,SE Louisiana Lady Lions,TEAM,TOTAL,TOTAL,False,,18,56,13,40,5,16,11,20,13,22,35,11,11,3,16,20,52
401404436,Incarnate Word Cardinals,J. Means,4400572,,True,16.0,3,4,3,4,0,0,1,1,1,2,3,0,2,2,2,0,7
401404436,Incarnate Word Cardinals,M. Bell,4704788,,True,30.0,2,6,2,5,0,1,0,2,1,2,3,3,1,0,2,2,4
401404436,Incarnate Word Cardinals,D. Terrell,4704787,,True,27.0,1,2,1,2,0,0,2,4,1,6,7,0,0,0,1,4,4
401404436,Incarnate Word Cardinals,J. Moore,4704786,,True,42.0,3,12,3,8,0,4,0,0,1,2,3,2,0,0,2,4,6
401404436,Incarnate Word Cardinals,H. Wheeler,4704783,,True,6.0,0,0,0,0,0,0,0,0,0,0,0,0,0,0,1,1,0
401404436,Incarnate Word Cardinals,T. Gardner,4704792,,False,29.0,5,10,5,10,0,0,12,13,3,9,12,0,5,0,7,4,22
401404436,Incarnate Word Cardinals,C. Storer,4704789,,False,23.0,1,1,1,1,0,0,0,0,1,1,2,1,0,0,0,0,2
401404436,Incarnate Word Cardinals,K. Gibson,4704784,,False,16.0,1,3,1,3,0,0,0,1,0,1,1,1,0,1,3,1,2
401404436,Incarnate Word Cardinals,D. Jenkins,4595693,,False,36.0,3,8,0,0,3,8,0,0,0,3,3,1,2,0,3,3,9
401404436,Incarnate Word Cardinals,TEAM,TOTAL,TOTAL,False,,19,46,16,33,3,13,15,21,8,28,36,8,10,3,22,19,56
401404435,Texas A&M-Corpus Christi Islanders,D. Wraggs,4595988,,True,37.0,2,4,2,4,0,0,0,0,2,5,7,1,4,1,6,1,4
401404435,Texas A&M-Corpus Christi Islanders,A. Westbrook,4595820,,True,37.0,2,3,2,2,0,1,9,10,0,9,9,2,0,1,3,2,13
401404435,Texas A&M-Corpus Christi Islanders,P. Allen,4704985,,True,41.0,1,5,0,4,1,1,2,2,2,4,6,1,0,0,2,4,5
401404435,Texas A&M-Corpus Christi Islanders,V. Verano,4595574,,True,39.0,1,6,1,4,0,2,1,2,1,1,2,10,0,0,4,3,3
401404435,Texas A&M-Corpus Christi Islanders,M. Serrata,4400456,,True,33.0,10,16,8,13,2,3,3,4,0,4,4,0,0,0,3,3,25
401404435,Texas A&M-Corpus Christi Islanders,N. McGill,4704987,,False,11.0,0,1,0,1,0,0,0,0,0,3,3,0,0,2,2,1,0
401404435,Texas A&M-Corpus Christi Islanders,M. Ellis,4900443,,False,5.0,0,3,0,3,0,0,0,0,0,0,0,0,0,0,0,0,0
401404435,Texas A&M-Corpus Christi Islanders,A. Powell,4900442,,False,3.0,0,2,0,2,0,0,0,0,0,0,0,0,0,0,0,0,0
401404435,Texas A&M-Corpus Christi Islanders,M. Aguado,4704986,,False,12.0,0,1,0,1,0,0,2,2,0,2,2,0,0,0,2,2,2
401404435,Texas A&M-Corpus Christi Islanders,H. Campbell,4595817,,False,7.0,1,3,1,2,0,1,0,0,2,0,2,0,1,0,0,0,2
401404435,Texas A&M-Corpus Christi Islanders,TEAM,TOTAL,TOTAL,False,,17,44,14,36,3,8,17,20,8,31,39,14,5,4,22,16,54
401404435,SE Louisiana Lady Lions,C. Williams,4281056,,True,22.0,4,8,4,8,0,0,0,0,1,4,5,1,1,0,1,5,8
401404435,SE Louisiana Lady Lions,C. Brown,4705010,,True,28.0,1,6,0,3,1,3,0,0,2,3,5,2,0,0,1,0,3
401404435,SE Louisiana Lady Lions,C. Cunningham,4705008,,True,5.0,0,0,0,0,0,0,0,0,0,0,0,1,1,0,0,1,0
401404435,SE Louisiana Lady Lions,H. Giaratano,4595778,,True,37.0,6,11,3,7,3,4,0,0,2,2,4,3,1,0,2,2,15
401404435,SE Louisiana Lady Lions,A. Horne,4595776,,True,43.0,6,15,4,10,2,5,3,4,0,5,5,5,2,0,2,1,17
401404435,SE Louisiana Lady Lions,N. Kelly,4398610,,False,17.0,0,3,0,3,0,0,0,0,3,0,3,0,1,2,1,1,0
401404435,SE Louisiana Lady Lions,M. Davis,4900441,,False,11.0,2,6,2,6,0,0,0,0,3,2,5,0,0,0,0,4,4
401404435,SE Louisiana Lady Lions,T. Bell,4900439,,False,21.0,4,8,4,7,0,1,0,0,1,0,1,0,1,0,0,1,8
401404435,SE Louisiana Lady Lions,B. Ducksworth,4595775,,False,37.0,2,9,2,9,0,0,0,0,0,1,1,2,3,0,2,0,4
401404435,SE Louisiana Lady Lions,D. Harvey,4595774,,False,4.0,0,2,0,0,0,2,0,0,0,0,0,0,1,0,0,0,0
401404435,SE Louisiana Lady Lions,TEAM,TOTAL,TOTAL,False,,25,68,19,53,6,15,3,4,12,20,32,14,11,2,10,15,59
401404434,Incarnate Word Cardinals,J. Means,4400572,,True,16.0,2,5,2,5,0,0,1,1,1,2,3,1,1,2,2,0,5
401404434,Incarnate Word Cardinals,M. Bell,4704788,,True,23.0,1,2,1,2,0,0,0,0,0,5,5,2,0,2,0,0,2
401404434,Incarnate Word Cardinals,D. Terrell,4704787,,True,35.0,3,9,3,9,0,0,4,4,2,9,11,0,0,0,1,1,10
401404434,Incarnate Word Cardinals,J. Moore,4704786,,True,35.0,7,16,6,13,1,3,3,5,1,3,4,1,1,1,1,1,18
401404434,Incarnate Word Cardinals,H. Wheeler,4704783,,True,18.0,0,0,0,0,0,0,0,0,0,1,1,0,0,0,0,1,0
401404434,Incarnate Word Cardinals,T. Gardner,4704792,,False,22.0,6,13,6,13,0,0,0,0,4,3,7,1,1,0,4,3,12
401404434,Incarnate Word Cardinals,C. Storer,4704789,,False,20.0,0,4,0,4,0,0,0,0,4,3,7,1,0,0,0,1,0
401404434,Incarnate Word Cardinals,S. Omozee,4400296,,False,2.0,0,0,0,0,0,0,0,0,0,0,0,0,0,0,0,0,0
401404434,Incarnate Word Cardinals,Z. Price,4704791,,False,2.0,0,0,0,0,0,0,0,0,0,2,2,0,0,0,0,0,0
401404434,Incarnate Word Cardinals,K. Gibson,4704784,,False,5.0,0,0,0,0,0,0,0,0,0,0,0,0,0,0,0,0,0
401404434,Incarnate Word Cardinals,D. Jenkins,4595693,,False,22.0,2,2,1,1,1,1,2,2,0,4,4,2,1,0,0,0,7
401404434,Incarnate Word Cardinals,TEAM,TOTAL,TOTAL,False,,21,51,19,47,2,4,10,12,12,33,45,8,4,5,12,7,54
401404434,Houston Christian Huskies,A. Sutherland,4595692,,True,31.0,1,6,1,5,0,1,2,2,4,1,5,0,0,3,0,2,4
401404434,Houston Christian Huskies,M. Nzoiwu,4400275,,True,23.0,0,6,0,6,0,0,0,0,1,8,9,0,0,3,1,3,0
401404434,Houston Christian Huskies,T. Jefferson,4595688,,True,29.0,8,18,4,8,4,10,0,0,1,2,3,0,1,0,4,4,20
401404434,Houston Christian Huskies,K. Wilson,4595687,,True,33.0,0,6,0,4,0,2,3,4,3,3,6,2,0,0,0,3,3
401404434,Houston Christian Huskies,J. Vujakovic,4400274,,True,31.0,0,9,0,3,0,6,0,0,2,2,4,0,1,1,2,0,0
401404434,Houston Christian Huskies,A. Cotton,4900423,,False,3.0,0,1,0,0,0,1,0,0,0,0,0,0,0,0,0,0,0
401404434,Houston Christian Huskies,N. Pierce,4704744,,False,4.0,0,0,0,0,0,0,0,0,1,0,1,0,0,1,1,0,0
401404434,Houston Christian Huskies,N. Collins,4595690,,False,19.0,0,1,0,1,0,0,2,2,0,2,2,1,0,0,0,0,2
401404434,Houston Christian Huskies,E. Maguire,4704741,,False,16.0,1,6,0,2,1,4,0,0,0,0,0,0,0,0,1,1,3
401404434,Houston Christian Huskies,L. Mapusua,4704731,,False,11.0,0,2,0,0,0,2,1,2,0,0,0,0,0,0,1,2,1
401404434,Houston Christian Huskies,TEAM,TOTAL,TOTAL,False,,10,55,5,29,5,26,8,10,14,20,34,3,2,8,11,15,33
401404433,SE Louisiana Lady Lions,C. Williams,4281056,,True,21.0,4,6,4,5,0,1,2,2,0,3,3,3,0,0,2,1,10
401404433,SE Louisiana Lady Lions,C. Brown,4705010,,True,27.0,0,2,0,0,0,2,2,2,0,2,2,3,0,0,1,0,2
401404433,SE Louisiana Lady Lions,C. Cunningham,4705008,,True,12.0,1,2,0,1,1,1,1,2,1,0,1,2,1,0,1,1,4
401404433,SE Louisiana Lady Lions,H. Giaratano,4595778,,True,22.0,3,4,3,4,0,0,2,3,1,6,7,2,0,0,1,2,8
401404433,SE Louisiana Lady Lions,A. Horne,4595776,,True,27.0,1,5,0,2,1,3,1,4,1,3,4,3,2,0,2,0,4
401404433,SE Louisiana Lady Lions,K. Bradford,4705009,,False,1.0,0,0,0,0,0,0,0,0,0,0,0,0,0,0,0,0,0
401404433,SE Louisiana Lady Lions,N. Kelly,4398610,,False,17.0,3,5,3,5,0,0,4,6,3,5,8,1,2,1,2,1,10
401404433,SE Louisiana Lady Lions,M. Davis,4900441,,False,14.0,5,7,5,7,0,0,0,0,0,1,1,0,1,1,0,0,10
401404433,SE Louisiana Lady Lions,T. Bell,4900439,,False,20.0,4,5,4,5,0,0,5,7,0,7,7,1,2,1,3,3,13
401404433,SE Louisiana Lady Lions,J. Brumfield,4900438,,False,1.0,0,0,0,0,0,0,0,0,0,0,0,0,0,0,1,2,0
401404433,SE Louisiana Lady Lions,D. Flowers,4704879,,False,1.0,0,0,0,0,0,0,1,2,0,1,1,0,0,0,1,2,1
401404433,SE Louisiana Lady Lions,B. Ducksworth,4595775,,False,24.0,5,8,5,7,0,1,2,4,0,2,2,4,2,1,1,2,12
401404433,SE Louisiana Lady Lions,D. Harvey,4595774,,False,8.0,1,2,0,0,1,2,0,0,0,1,1,0,0,0,1,1,3
401404433,SE Louisiana Lady Lions,J. Huderson,4595773,,False,1.0,0,0,0,0,0,0,0,0,0,0,0,0,0,0,0,0,0
401404433,SE Louisiana Lady Lions,M. Carrier,4281053,,False,4.0,1,3,1,2,0,1,1,1,0,1,1,0,0,0,1,1,3
401404433,SE Louisiana Lady Lions,TEAM,TOTAL,TOTAL,False,,28,49,25,38,3,11,21,33,7,33,40,19,10,4,17,16,80
401404433,New Orleans Privateers,N. Scott,4900429,,True,21.0,2,7,2,7,0,0,2,2,1,3,4,1,0,1,3,5,6
401404433,New Orleans Privateers,Z. Cooper,4705282,,True,26.0,1,2,1,2,0,0,0,0,2,2,4,0,1,0,1,1,2
401404433,New Orleans Privateers,T. Gipson,4705277,,True,21.0,2,5,0,0,2,5,1,2,0,0,0,0,0,0,1,2,7
401404433,New Orleans Privateers,D. Pryor,4703756,,True,40.0,6,15,5,10,1,5,4,4,1,3,4,0,3,0,0,4,17
401404433,New Orleans Privateers,J. Mathis,4282583,,True,31.0,4,13,4,10,0,3,9,10,2,2,4,4,6,0,3,4,17
401404433,New Orleans Privateers,Z. Cordis,4705285,,False,12.0,1,1,1,1,0,0,0,0,0,3,3,0,0,0,0,2,2
401404433,New Orleans Privateers,J. Ross,4433299,,False,17.0,2,7,2,6,0,1,1,2,0,3,3,0,1,0,2,2,5
401404433,New Orleans Privateers,T. Thompson,4900430,,False,18.0,1,6,1,6,0,0,5,6,1,0,1,1,1,0,1,1,7
401404433,New Orleans Privateers,K. Davis,4705280,,False,13.0,1,4,0,1,1,3,0,0,0,0,0,0,0,1,1,5,3
401404433,New Orleans Privateers,J. Dianis,4705276,,False,1.0,0,0,0,0,0,0,0,0,0,0,0,0,0,0,0,0,0
401404433,New Orleans Privateers,TEAM,TOTAL,TOTAL,False,,20,60,16,43,4,17,22,26,9,19,28,6,12,2,12,26,66
401404432,McNeese Cowgirls,D. Tanks,4400305,,True,17.0,3,4,3,4,0,0,3,4,3,4,7,1,2,0,2,2,9
401404432,McNeese Cowgirls,K. Chamberlin,4900425,,True,20.0,4,10,2,4,2,6,0,0,2,0,2,1,0,0,1,3,10
401404432,McNeese Cowgirls,L. Stubblefield,4705271,,True,25.0,3,7,2,4,1,3,8,9,2,4,6,0,0,1,2,4,15
401404432,McNeese Cowgirls,Z. Kulinska,4595864,,True,22.0,2,8,2,7,0,1,2,3,1,0,1,3,0,0,3,2,6
401404432,McNeese Cowgirls,D. Hansen,4399933,,True,25.0,3,5,3,4,0,1,1,1,1,3,4,3,0,0,1,5,7
401404432,McNeese Cowgirls,E. Taylor,4900426,,False,1.0,0,1,0,1,0,0,0,0,0,0,0,0,0,0,0,0,0
401404432,McNeese Cowgirls,L. Skripkina,4595540,,False,13.0,0,4,0,4,0,0,2,2,1,3,4,0,0,0,2,5,2
401404432,McNeese Cowgirls,T. Wilkins,4900428,,False,10.0,0,7,0,4,0,3,0,0,1,0,1,2,0,1,1,1,0
401404432,McNeese Cowgirls,M. Yespes,4900427,,False,12.0,2,3,2,3,0,0,0,0,1,3,4,1,0,0,1,4,4
401404432,McNeese Cowgirls,C. Gil,4705627,,False,22.0,3,11,2,3,1,8,0,0,2,3,5,1,4,0,3,2,7
401404432,McNeese Cowgirls,C. Rosini,4705071,,False,13.0,0,2,0,0,0,2,0,0,2,0,2,0,0,0,1,2,0
401404432,McNeese Cowgirls,K. Hamilton,4595710,,False,20.0,0,4,0,0,0,4,3,4,3,1,4,3,0,0,2,2,3
401404432,McNeese Cowgirls,TEAM,TOTAL,TOTAL,False,,20,66,16,38,4,28,19,23,19,23,42,15,6,2,20,33,63
401404432,Incarnate Word Cardinals,J. Means,4400572,,True,24.0,2,3,2,3,0,0,2,2,1,5,6,0,0,1,1,3,6
401404432,Incarnate Word Cardinals,M. Bell,4704788,,True,18.0,1,4,1,4,0,0,0,0,1,2,3,1,1,0,0,2,2
401404432,Incarnate Word Cardinals,D. Terrell,4704787,,True,33.0,9,11,9,11,0,0,6,10,9,10,19,1,2,0,5,1,24
401404432,Incarnate Word Cardinals,J. Moore,4704786,,True,34.0,4,18,3,10,1,8,5,7,0,2,2,2,4,1,2,3,14
401404432,Incarnate Word Cardinals,H. Wheeler,4704783,,True,18.0,2,3,1,1,1,2,1,2,0,1,1,3,0,0,1,2,6
401404432,Incarnate Word Cardinals,T. Gardner,4704792,,False,15.0,4,6,4,6,0,0,2,4,5,2,7,0,2,1,1,2,10
401404432,Incarnate Word Cardinals,C. Storer,4704789,,False,23.0,4,11,4,11,0,0,4,4,2,2,4,4,3,0,1,2,12
401404432,Incarnate Word Cardinals,S. Omozee,4400296,,False,1.0,1,1,1,1,0,0,1,3,0,1,1,0,0,0,0,0,3
401404432,Incarnate Word Cardinals,Z. Price,4704791,,False,1.0,0,1,0,0,0,1,0,0,0,1,1,0,0,0,0,1,0
401404432,Incarnate Word Cardinals,K. Gibson,4704784,,False,12.0,3,4,3,4,0,0,1,1,0,1,1,0,1,0,2,1,7
401404432,Incarnate Word Cardinals,D. Jenkins,4595693,,False,21.0,0,3,0,0,0,3,6,6,0,2,2,0,1,0,0,3,6
401404432,Incarnate Word Cardinals,TEAM,TOTAL,TOTAL,False,,30,65,28,51,2,14,28,39,18,29,47,11,14,3,13,20,90
401404431,Northwestern State Lady Demons,J. Todd,4900436,,True,25.0,0,3,0,3,0,0,1,2,3,4,7,1,1,2,4,2,1
401404431,Northwestern State Lady Demons,S. Ayres,4595167,,True,25.0,4,10,3,4,1,6,0,0,1,3,4,2,1,1,4,0,9
401404431,Northwestern State Lady Demons,M. Bolden,4595002,,True,28.0,2,6,2,5,0,1,2,2,0,2,2,2,4,0,5,3,6
401404431,Northwestern State Lady Demons,A. Whyte,4594850,,True,18.0,2,3,2,3,0,0,0,0,1,3,4,0,2,0,3,2,4
401404431,Northwestern State Lady Demons,C. Parramore,4400554,,True,36.0,6,15,6,13,0,2,1,2,1,1,2,2,4,0,2,1,13
401404431,Northwestern State Lady Demons,J. Dixon,4704126,,False,14.0,2,2,2,2,0,0,0,2,1,3,4,1,1,3,0,1,4
401404431,Northwestern State Lady Demons,J. Fleischmann,4900435,,False,2.0,0,0,0,0,0,0,0,0,0,0,0,0,0,0,0,0,0
401404431,Northwestern State Lady Demons,J. McLemore,4900434,,False,0.0,0,0,0,0,0,0,0,0,0,0,0,0,0,0,0,1,0
401404431,Northwestern State Lady Demons,J. Woodson,4900432,,False,20.0,1,6,1,4,0,2,3,7,1,0,1,2,1,0,1,1,5
401404431,Northwestern State Lady Demons,O. Cummings,4705043,,False,2.0,0,0,0,0,0,0,0,0,0,0,0,0,0,0,0,0,0
401404431,Northwestern State Lady Demons,E. Harris,4705040,,False,2.0,0,0,0,0,0,0,0,0,0,0,0,0,0,0,1,0,0
401404431,Northwestern State Lady Demons,J. Braxton,4399212,,False,28.0,2,10,0,1,2,9,0,0,1,3,4,1,1,0,2,2,6
401404431,Northwestern State Lady Demons,TEAM,TOTAL,TOTAL,False,,19,55,16,35,3,20,7,15,12,20,32,11,15,6,22,13,48
401404431,New Orleans Privateers,N. Scott,4900429,,True,20.0,0,5,0,4,0,1,2,2,2,5,7,0,1,2,5,5,2
401404431,New Orleans Privateers,Z. Cooper,4705282,,True,33.0,3,4,3,4,0,0,0,0,0,3,3,2,3,0,3,1,6
401404431,New Orleans Privateers,T. Gipson,4705277,,True,18.0,2,4,1,2,1,2,0,0,0,1,1,1,3,0,2,2,5
401404431,New Orleans Privateers,D. Pryor,4703756,,True,31.0,4,11,3,6,1,5,0,0,3,4,7,3,1,0,4,3,9
401404431,New Orleans Privateers,J. Mathis,4282583,,True,36.0,5,9,3,6,2,3,5,6,2,2,4,6,5,0,2,2,17
401404431,New Orleans Privateers,Z. Cordis,4705285,,False,14.0,2,4,2,4,0,0,0,0,3,4,7,0,0,3,4,4,4
401404431,New Orleans Privateers,J. Ross,4433299,,False,8.0,0,2,0,1,0,1,1,2,0,0,0,0,0,0,2,2,1
401404431,New Orleans Privateers,T. Thompson,4900430,,False,24.0,5,11,5,11,0,0,0,0,3,2,5,1,1,0,1,0,10
401404431,New Orleans Privateers,K. Davis,4705280,,False,14.0,1,6,0,0,1,6,0,0,0,2,2,0,2,0,0,0,3
401404431,New Orleans Privateers,J. Dianis,4705276,,False,2.0,0,0,0,0,0,0,0,0,0,0,0,0,0,0,0,0,0
401404431,New Orleans Privateers,TEAM,TOTAL,TOTAL,False,,22,56,17,38,5,18,8,10,15,26,41,13,16,5,25,19,57
401404430,Nicholls Colonels,L. Bowie,4282360,,True,38.0,3,5,3,4,0,1,2,3,3,5,8,3,1,1,1,1,8
401404430,Nicholls Colonels,B. Washington,4282363,,True,26.0,5,13,5,13,0,0,0,0,2,5,7,3,0,0,1,3,10
401404430,Nicholls Colonels,K. Green,4705290,,True,35.0,3,10,1,2,2,8,5,6,1,1,2,2,3,0,3,3,13
401404430,Nicholls Colonels,C. Allen,4705289,,True,40.0,10,16,6,10,4,6,6,10,1,5,6,3,2,1,5,3,30
401404430,Nicholls Colonels,A. Sandie,4705286,,True,25.0,1,2,1,2,0,0,2,2,1,0,1,4,1,0,1,4,4
401404430,Nicholls Colonels,K. Manley,4705291,,False,24.0,4,4,4,4,0,0,0,0,0,3,3,1,1,2,2,1,8
401404430,Nicholls Colonels,J. Womack,4400562,,False,12.0,0,3,0,2,0,1,0,0,1,1,2,1,0,0,0,2,0
401404430,Nicholls Colonels,TEAM,TOTAL,TOTAL,False,,26,53,20,37,6,16,15,21,11,23,34,17,8,4,14,17,73
401404430,Incarnate Word Cardinals,J. Means,4400572,,True,17.0,0,2,0,2,0,0,0,0,3,2,5,2,0,0,0,4,0
401404430,Incarnate Word Cardinals,M. Bell,4704788,,True,26.0,1,5,1,5,0,0,0,0,0,2,2,0,1,2,0,2,2
401404430,Incarnate Word Cardinals,D. Terrell,4704787,,True,24.0,4,10,4,10,0,0,2,3,3,2,5,3,0,0,3,3,10
401404430,Incarnate Word Cardinals,J. Moore,4704786,,True,40.0,10,20,6,13,4,7,5,6,1,2,3,5,3,1,1,1,29
401404430,Incarnate Word Cardinals,H. Wheeler,4704783,,True,13.0,0,3,0,1,0,2,0,0,0,0,0,0,0,0,1,1,0
401404430,Incarnate Word Cardinals,T. Gardner,4704792,,False,23.0,5,11,5,11,0,0,9,12,2,6,8,1,2,0,2,5,19
401404430,Incarnate Word Cardinals,C. Storer,4704789,,False,26.0,3,3,3,3,0,0,0,0,3,1,4,2,1,0,5,2,6
401404430,Incarnate Word Cardinals,S. Omozee,4400296,,False,3.0,0,0,0,0,0,0,0,0,0,0,0,1,0,0,0,0,0
401404430,Incarnate Word Cardinals,K. Gibson,4704784,,False,2.0,0,1,0,1,0,0,0,0,0,0,0,0,0,0,0,0,0
401404430,Incarnate Word Cardinals,D. Jenkins,4595693,,False,27.0,3,7,1,1,2,6,0,0,0,3,3,1,1,0,0,1,8
401404430,Incarnate Word Cardinals,TEAM,TOTAL,TOTAL,False,,26,62,20,47,6,15,16,21,15,19,34,15,8,3,12,19,74
401404419,Mercer Bears,A. Thayne,4704265,,True,19.0,1,1,1,1,0,0,0,0,1,1,2,0,0,0,0,4,2
401404419,Mercer Bears,J. Dougherty,4404201,,True,35.0,6,11,5,10,1,1,0,0,0,3,3,0,1,0,0,1,13
401404419,Mercer Bears,E. Houpt,4900401,,True,33.0,5,8,3,4,2,4,0,0,0,5,5,2,0,0,1,2,12
401404419,Mercer Bears,A. Neal-Tysor,4400623,,True,38.0,8,15,7,10,1,5,9,9,0,1,1,6,1,0,5,4,26
401404419,Mercer Bears,S. Titus,4281050,,True,39.0,6,14,6,14,0,0,3,3,1,3,4,4,1,1,3,1,15
401404419,Mercer Bears,N. Harkless,4900403,,False,14.0,1,2,1,2,0,0,1,1,0,5,5,0,0,1,0,3,3
401404419,Mercer Bears,L. McNamara-Clement,4281558,,False,11.0,0,0,0,0,0,0,0,0,0,2,2,0,0,1,0,3,0
401404419,Mercer Bears,K. Fisher,4900400,,False,1.0,0,1,0,0,0,1,0,0,0,0,0,0,0,0,0,0,0
401404419,Mercer Bears,S. Boykin,4704263,,False,0.0,0,0,0,0,0,0,0,0,1,0,1,0,0,0,0,0,0
401404419,Mercer Bears,E. Banks,4281193,,False,8.0,1,1,1,1,0,0,0,0,2,1,3,0,1,0,0,0,2
401404419,Mercer Bears,TEAM,TOTAL,TOTAL,False,,28,53,24,42,4,11,13,13,6,25,31,12,4,3,10,18,73
401404419,Furman Paladins,G. van Rij,4400619,,True,39.0,3,9,2,8,1,1,5,8,2,3,5,1,3,1,1,2,12
401404419,Furman Paladins,T. Hodges,4068935,,True,30.0,4,12,3,7,1,5,2,2,3,5,8,1,0,0,4,4,11
401404419,Furman Paladins,N. Henley,4900397,,True,20.0,1,2,1,2,0,0,1,2,4,3,7,1,1,0,1,1,3
401404419,Furman Paladins,J. Outten,4900395,,True,19.0,2,5,2,5,0,0,1,2,0,2,2,1,0,0,0,2,5
401404419,Furman Paladins,T. Walters,4704252,,True,36.0,7,14,4,8,3,6,3,4,2,1,3,3,0,0,4,4,20
401404419,Furman Paladins,K. Johnson,4900398,,False,1.0,0,1,0,1,0,0,0,0,0,0,0,0,0,0,0,0,0
401404419,Furman Paladins,J. Session,4900396,,False,3.0,0,1,0,1,0,0,0,0,0,0,0,0,0,0,1,0,0
401404419,Furman Paladins,S. James,4704257,,False,31.0,1,8,1,5,0,3,1,2,0,3,3,0,1,0,1,4,3
401404419,Furman Paladins,P. Koilia,4704255,,False,1.0,0,0,0,0,0,0,0,0,0,0,0,0,0,0,0,0,0
401404419,Furman Paladins,K. Grier,4704254,,False,1.0,0,0,0,0,0,0,0,0,0,0,0,0,0,0,0,0,0
401404419,Furman Paladins,E. DePetro,4704251,,False,1.0,0,0,0,0,0,0,0,0,0,0,0,0,0,0,0,0,0
401404419,Furman Paladins,G. Boone,4400621,,False,18.0,0,0,0,0,0,0,0,0,1,1,2,0,0,0,0,0,0
401404419,Furman Paladins,TEAM,TOTAL,TOTAL,False,,18,52,13,37,5,15,13,20,12,19,31,7,5,1,13,17,54
401404418,Wofford Terriers,L. Hatton,4595426,,True,35.0,5,10,4,7,1,3,0,0,4,8,12,1,2,4,0,3,11
401404418,Wofford Terriers,A. Tomlin,4400641,,True,27.0,7,9,7,9,0,0,0,0,3,2,5,0,3,1,5,3,14
401404418,Wofford Terriers,R. Rapert,4900421,,True,36.0,5,16,5,13,0,3,3,6,0,1,1,4,2,0,3,1,13
401404418,Wofford Terriers,J. Carman,4400643,,True,31.0,3,8,1,2,2,6,0,1,0,2,2,1,0,0,1,3,8
401404418,Wofford Terriers,N. Lutz,4400638,,True,37.0,1,8,0,4,1,4,1,2,0,4,4,1,2,0,2,0,4
401404418,Wofford Terriers,A. Crawford,4704310,,False,2.0,1,1,1,1,0,0,0,0,0,0,0,0,0,0,0,0,2
401404418,Wofford Terriers,H. Matthews,4704309,,False,11.0,0,2,0,1,0,1,0,0,1,1,2,0,0,1,2,2,0
401404418,Wofford Terriers,A. Schultz,4704308,,False,22.0,3,10,2,3,1,7,0,0,0,1,1,2,0,0,0,2,7
401404418,Wofford Terriers,TEAM,TOTAL,TOTAL,False,,25,64,20,40,5,24,4,9,10,20,30,9,9,6,14,14,59
401404418,Furman Paladins,G. van Rij,4400619,,True,27.0,3,7,3,7,0,0,1,2,1,2,3,0,0,0,1,4,7
401404418,Furman Paladins,T. Hodges,4068935,,True,40.0,8,18,7,14,1,4,3,4,4,8,12,1,1,0,5,1,20
401404418,Furman Paladins,N. Henley,4900397,,True,27.0,3,10,0,2,3,8,0,0,1,1,2,1,0,0,1,1,9
401404418,Furman Paladins,J. Outten,4900395,,True,12.0,0,1,0,1,0,0,0,0,0,3,3,1,0,2,2,1,0
401404418,Furman Paladins,T. Walters,4704252,,True,37.0,3,8,1,3,2,5,4,4,2,4,6,8,1,1,6,4,12
401404418,Furman Paladins,K. Johnson,4900398,,False,5.0,0,1,0,1,0,0,0,0,1,0,1,0,0,0,0,0,0
401404418,Furman Paladins,J. Session,4900396,,False,3.0,0,0,0,0,0,0,0,0,0,1,1,0,0,0,1,1,0
401404418,Furman Paladins,S. James,4704257,,False,25.0,5,9,2,4,3,5,2,4,2,6,8,0,0,1,3,2,15
401404418,Furman Paladins,P. Koilia,4704255,,False,1.0,0,0,0,0,0,0,0,0,0,0,0,1,0,0,0,0,0
401404418,Furman Paladins,G. Boone,4400621,,False,23.0,0,3,0,0,0,3,1,2,2,3,5,1,1,0,0,1,1
401404418,Furman Paladins,TEAM,TOTAL,TOTAL,False,,22,57,13,32,9,25,11,16,17,30,47,13,3,4,19,15,64
401404417,Samford Bulldogs,A. Ramil,4399025,,True,26.0,1,3,1,3,0,0,1,2,0,7,7,1,1,0,3,3,3
401404417,Samford Bulldogs,S. Ngulefac,4900408,,True,22.0,1,2,1,2,0,0,0,6,1,2,3,0,0,0,5,2,2
401404417,Samford Bulldogs,A. Leipold,4400631,,True,16.0,1,5,1,5,0,0,1,2,0,1,1,0,1,0,0,2,3
401404417,Samford Bulldogs,A. Cournoyer,4400560,,True,25.0,3,12,2,7,1,5,2,2,0,1,1,1,4,0,2,0,9
401404417,Samford Bulldogs,S. Battle,4281037,,True,26.0,1,4,0,2,1,2,3,4,0,1,1,0,1,0,2,1,6
401404417,Samford Bulldogs,K. Nelson,4704291,,False,7.0,2,4,2,4,0,0,0,0,1,1,2,0,0,0,0,1,4
401404417,Samford Bulldogs,K. Wheeler,4595420,,False,25.0,0,2,0,1,0,1,2,2,1,2,3,1,1,0,1,2,2
401404417,Samford Bulldogs,S. Redmond,4900407,,False,21.0,0,6,0,5,0,1,6,6,0,1,1,0,0,0,3,1,6
401404417,Samford Bulldogs,J. Langford,4704289,,False,3.0,0,1,0,1,0,0,0,0,0,1,1,0,0,0,0,0,0
401404417,Samford Bulldogs,M. Hampton,4704288,,False,19.0,0,3,0,3,0,0,0,0,0,2,2,0,1,0,2,1,0
401404417,Samford Bulldogs,M. Hatcher,4704002,,False,10.0,0,2,0,0,0,2,0,0,0,1,1,0,0,0,0,0,0
401404417,Samford Bulldogs,TEAM,TOTAL,TOTAL,False,,9,44,7,33,2,11,15,24,4,22,26,3,9,0,18,13,35
401404417,Mercer Bears,A. Thayne,4704265,,True,18.0,1,1,1,1,0,0,0,0,0,4,4,1,1,1,2,1,2
401404417,Mercer Bears,J. Dougherty,4404201,,True,30.0,6,11,6,11,0,0,0,0,1,3,4,0,1,1,2,2,12
401404417,Mercer Bears,E. Houpt,4900401,,True,23.0,0,3,0,1,0,2,0,0,2,0,2,1,0,0,1,2,0
401404417,Mercer Bears,A. Neal-Tysor,4400623,,True,34.0,9,14,7,10,2,4,0,0,0,12,12,1,2,0,2,3,20
401404417,Mercer Bears,S. Titus,4281050,,True,28.0,7,13,7,13,0,0,4,4,1,2,3,2,1,1,1,1,18
401404417,Mercer Bears,A. Locke,4900404,,False,3.0,0,1,0,1,0,0,0,0,0,0,0,0,2,0,1,0,0
401404417,Mercer Bears,N. Harkless,4900403,,False,10.0,1,5,1,5,0,0,1,2,1,3,4,1,1,0,1,4,3
401404417,Mercer Bears,L. McNamara-Clement,4281558,,False,5.0,1,1,1,1,0,0,0,0,0,0,0,0,0,0,0,1,2
401404417,Mercer Bears,S. Votaw,4281224,,False,14.0,1,1,1,1,0,0,0,2,0,1,1,0,1,0,0,1,2
401404417,Mercer Bears,K. Jones,4900402,,False,3.0,0,1,0,0,0,1,0,0,0,1,1,1,0,0,0,0,0
401404417,Mercer Bears,K. Fisher,4900400,,False,7.0,0,1,0,0,0,1,0,0,0,0,0,0,0,0,0,0,0
401404417,Mercer Bears,S. Boykin,4704263,,False,6.0,0,0,0,0,0,0,0,0,0,0,0,0,0,0,0,0,0
401404417,Mercer Bears,E. Banks,4281193,,False,19.0,3,6,3,6,0,0,0,0,1,5,6,2,2,0,4,1,6
401404417,Mercer Bears,TEAM,TOTAL,TOTAL,False,,29,58,27,50,2,8,5,8,8,33,41,9,11,3,14,16,65
401404416,Furman Paladins,G. van Rij,4400619,,True,41.0,5,9,5,9,0,0,4,4,2,4,6,1,1,1,2,4,14
401404416,Furman Paladins,T. Hodges,4068935,,True,45.0,6,16,5,12,1,4,7,8,10,10,20,1,2,0,3,3,20
401404416,Furman Paladins,N. Henley,4900397,,True,15.0,0,5,0,2,0,3,0,0,2,1,3,1,0,0,0,0,0
401404416,Furman Paladins,J. Outten,4900395,,True,5.0,0,1,0,1,0,0,0,0,0,0,0,0,0,0,0,0,0
401404416,Furman Paladins,T. Walters,4704252,,True,45.0,8,20,3,9,5,11,5,6,0,4,4,4,2,0,7,3,26
401404416,Furman Paladins,J. Session,4900396,,False,4.0,0,0,0,0,0,0,0,0,0,1,1,0,0,0,0,0,0
401404416,Furman Paladins,S. James,4704257,,False,39.0,3,10,2,4,1,6,0,0,1,2,3,3,1,3,1,2,7
401404416,Furman Paladins,G. Boone,4400621,,False,31.0,1,6,0,0,1,6,0,0,2,2,4,1,0,0,0,2,3
401404416,Furman Paladins,TEAM,TOTAL,TOTAL,False,,23,67,15,37,8,30,16,18,20,24,44,11,6,4,13,14,70
401404416,Chattanooga Mocs,A. Cornelius,4400218,,True,34.0,11,15,11,14,0,1,4,4,4,5,9,1,0,2,1,3,26
401404416,Chattanooga Mocs,A. Porter,4900390,,True,35.0,3,6,3,5,0,1,1,2,3,7,10,0,0,0,3,4,7
401404416,Chattanooga Mocs,A. Pugh,4704231,,True,24.0,1,3,0,2,1,1,3,4,0,1,1,3,0,1,5,3,6
401404416,Chattanooga Mocs,S. Olafsdottir,4704230,,True,39.0,4,10,4,7,0,3,0,1,2,3,5,7,1,0,4,3,8
401404416,Chattanooga Mocs,D. Jarrells,4595392,,True,33.0,1,7,0,2,1,5,0,0,0,2,2,1,2,0,3,3,3
401404416,Chattanooga Mocs,K. Murphy,4704800,,False,22.0,1,2,0,1,1,1,0,0,0,3,3,0,0,2,0,1,3
401404416,Chattanooga Mocs,D. McClendon,4900387,,False,5.0,0,5,0,4,0,1,0,0,0,0,0,0,0,0,1,0,0
401404416,Chattanooga Mocs,B. Hampel,4399990,,False,33.0,4,11,2,6,2,5,0,0,1,3,4,0,1,0,3,4,10
401404416,Chattanooga Mocs,TEAM,TOTAL,TOTAL,False,,25,59,20,41,5,18,8,11,11,25,36,12,4,5,21,21,63
401404415,Wofford Terriers,L. Hatton,4595426,,True,29.0,1,5,1,4,0,1,0,0,0,7,7,1,1,0,2,2,2
401404415,Wofford Terriers,A. Tomlin,4400641,,True,33.0,7,10,7,10,0,0,6,7,4,7,11,2,4,4,4,2,20
401404415,Wofford Terriers,R. Rapert,4900421,,True,34.0,3,11,1,5,2,6,3,3,2,6,8,4,0,0,4,1,11
401404415,Wofford Terriers,J. Carman,4400643,,True,35.0,5,12,3,4,2,8,7,8,1,3,4,0,1,0,1,4,19
401404415,Wofford Terriers,N. Lutz,4400638,,True,30.0,2,3,1,1,1,2,2,2,1,7,8,1,1,0,2,1,7
401404415,Wofford Terriers,H. Matthews,4704309,,False,21.0,1,8,1,6,0,2,2,2,3,3,6,1,1,0,7,4,4
401404415,Wofford Terriers,A. Schultz,4704308,,False,17.0,1,7,0,2,1,5,0,0,1,0,1,1,3,0,0,1,3
401404415,Wofford Terriers,A. Harris,4400644,,False,1.0,0,0,0,0,0,0,0,0,0,0,0,0,0,0,0,0,0
401404415,Wofford Terriers,TEAM,TOTAL,TOTAL,False,,20,56,14,32,6,24,20,22,14,34,48,10,11,4,20,15,66
401404415,East Tennessee State Bucs,J. Davis,4704245,,True,19.0,2,6,1,4,1,2,0,0,2,4,6,0,0,1,1,2,5
401404415,East Tennessee State Bucs,S. Thompson,4900393,,True,33.0,2,6,0,3,2,3,1,2,0,1,1,1,0,1,3,1,7
401404415,East Tennessee State Bucs,A. Vananda,4900392,,True,23.0,3,8,2,5,1,3,0,0,2,3,5,1,2,0,1,1,7
401404415,East Tennessee State Bucs,C. Moore,4704244,,True,35.0,1,6,0,2,1,4,2,2,0,2,2,5,2,0,5,5,5
401404415,East Tennessee State Bucs,A. Adams,4400221,,True,28.0,2,6,2,4,0,2,1,4,0,4,4,0,1,0,0,3,5
401404415,East Tennessee State Bucs,D. Burdick,4282468,,False,18.0,1,8,1,8,0,0,0,0,0,1,1,2,3,0,0,1,2
401404415,East Tennessee State Bucs,J. Ryce,4900394,,False,4.0,0,2,0,2,0,0,0,0,0,0,0,0,0,0,0,0,0
401404415,East Tennessee State Bucs,M. Kirtner,4900391,,False,3.0,0,0,0,0,0,0,0,0,0,0,0,0,0,0,0,0,0
401404415,East Tennessee State Bucs,A. Carrington,4704243,,False,9.0,1,2,0,0,1,2,0,0,0,1,1,0,1,0,0,1,3
401404415,East Tennessee State Bucs,C. Hooks,4704240,,False,28.0,7,15,4,10,3,5,3,6,0,6,6,1,2,0,4,5,20
401404415,East Tennessee State Bucs,TEAM,TOTAL,TOTAL,False,,19,59,10,38,9,21,7,14,8,23,31,10,11,2,14,19,54
401404414,UNC Greensboro Spartans,K. Cain,4704267,,True,16.0,1,5,1,5,0,0,0,2,2,3,5,0,1,1,4,2,2
401404414,UNC Greensboro Spartans,A. Boyd,4069285,,True,30.0,6,11,6,11,0,0,1,4,1,2,3,1,3,2,3,3,13
401404414,UNC Greensboro Spartans,I. Grady,4900412,,True,36.0,3,8,2,7,1,1,0,0,1,8,9,1,2,0,3,2,7
401404414,UNC Greensboro Spartans,E. Greer,4595417,,True,10.0,1,2,1,1,0,1,0,0,0,1,1,0,0,0,2,0,2
401404414,UNC Greensboro Spartans,C. Crudup,4281032,,True,23.0,2,7,2,5,0,2,0,0,1,0,1,2,3,1,4,1,4
401404414,UNC Greensboro Spartans,J. Hastings,4704270,,False,5.0,0,1,0,1,0,0,0,0,0,2,2,0,0,0,0,0,0
401404414,UNC Greensboro Spartans,P. Sorensen,4595419,,False,23.0,0,3,0,0,0,3,0,0,0,2,2,0,1,0,1,1,0
401404414,UNC Greensboro Spartans,N. Howard,4900414,,False,2.0,0,0,0,0,0,0,0,0,0,1,1,0,0,0,0,0,0
401404414,UNC Greensboro Spartans,N. Amar,4900411,,False,15.0,0,2,0,2,0,0,0,0,1,0,1,0,0,0,1,0,0
401404414,UNC Greensboro Spartans,N. Powell,4900409,,False,19.0,3,4,3,4,0,0,0,1,1,0,1,0,0,0,1,0,6
401404414,UNC Greensboro Spartans,A. Redmond,4595418,,False,8.0,0,2,0,2,0,0,0,0,0,0,0,0,0,0,0,1,0
401404414,UNC Greensboro Spartans,J. Releford,4595416,,False,13.0,1,5,1,3,0,2,4,7,1,3,4,0,0,0,0,1,6
401404414,UNC Greensboro Spartans,TEAM,TOTAL,TOTAL,False,,17,50,16,41,1,9,5,14,8,23,31,4,10,4,19,11,40
401404414,Samford Bulldogs,A. Ramil,4399025,,True,24.0,3,8,3,8,0,0,0,0,2,5,7,3,0,0,3,0,6
401404414,Samford Bulldogs,S. Ngulefac,4900408,,True,29.0,5,7,5,7,0,0,0,0,2,2,4,0,0,0,1,0,10
401404414,Samford Bulldogs,A. Leipold,4400631,,True,19.0,2,3,2,3,0,0,0,0,0,2,2,2,1,0,2,2,4
401404414,Samford Bulldogs,A. Cournoyer,4400560,,True,30.0,6,13,5,11,1,2,2,3,0,3,3,0,4,0,6,1,15
401404414,Samford Bulldogs,S. Battle,4281037,,True,14.0,0,4,0,1,0,3,0,0,0,3,3,0,0,0,1,1,0
401404414,Samford Bulldogs,K. Nelson,4704291,,False,1.0,1,1,1,1,0,0,0,0,0,0,0,0,0,0,0,0,2
401404414,Samford Bulldogs,K. Wheeler,4595420,,False,22.0,2,3,1,1,1,2,0,0,1,2,3,2,1,0,1,0,5
401404414,Samford Bulldogs,O. Ramil,4068080,,False,4.0,0,1,0,1,0,0,0,0,0,0,0,0,0,0,0,1,0
401404414,Samford Bulldogs,S. Redmond,4900407,,False,27.0,3,5,3,5,0,0,1,2,0,3,3,1,0,0,1,3,7
401404414,Samford Bulldogs,J. Langford,4704289,,False,1.0,0,0,0,0,0,0,0,0,0,0,0,0,0,1,0,0,0
401404414,Samford Bulldogs,M. Hampton,4704288,,False,28.0,3,7,2,5,1,2,3,4,0,4,4,1,2,0,1,1,10
401404414,Samford Bulldogs,M. Hatcher,4704002,,False,1.0,0,0,0,0,0,0,0,0,0,1,1,0,0,0,0,0,0
401404414,Samford Bulldogs,TEAM,TOTAL,TOTAL,False,,25,52,22,43,3,9,6,9,6,28,34,9,8,1,18,9,59
401404413,Western Carolina Catamounts,A. Meyers,4704303,,True,24.0,0,5,0,5,0,0,0,0,2,1,3,0,1,1,1,2,0
401404413,Western Carolina Catamounts,E. Holliday,4900419,,True,15.0,1,4,1,4,0,0,2,2,1,4,5,0,0,0,3,1,4
401404413,Western Carolina Catamounts,Z. Cruz,4704301,,True,35.0,5,12,3,6,2,6,3,4,0,2,2,2,0,1,3,4,15
401404413,Western Carolina Catamounts,J. Reid,4704300,,True,19.0,0,1,0,1,0,0,0,0,3,1,4,2,0,0,4,5,0
401404413,Western Carolina Catamounts,A. Martin Ruiz,4595423,,True,14.0,1,6,1,6,0,0,0,0,0,1,1,0,1,0,1,1,2
401404413,Western Carolina Catamounts,M. Pack,4281392,,False,18.0,3,6,3,5,0,1,0,0,1,1,2,0,1,0,1,1,6
401404413,Western Carolina Catamounts,J. Justice,4900418,,False,11.0,1,1,1,1,0,0,0,0,0,0,0,0,0,0,1,0,2
401404413,Western Carolina Catamounts,N. Marshall,4704302,,False,24.0,3,5,3,5,0,0,2,4,3,4,7,0,1,0,1,1,8
401404413,Western Carolina Catamounts,S. Singer,4704299,,False,1.0,0,0,0,0,0,0,0,0,0,0,0,0,0,0,0,0,0
401404413,Western Carolina Catamounts,M. Davis,4704298,,False,3.0,0,1,0,1,0,0,0,0,0,1,1,0,0,0,1,1,0
401404413,Western Carolina Catamounts,B. Trumm,4703988,,False,11.0,1,2,0,0,1,2,0,0,0,2,2,0,0,0,0,0,3
401404413,Western Carolina Catamounts,T. Moates,4068966,,False,25.0,3,11,3,10,0,1,0,0,2,2,4,1,0,1,3,2,6
401404413,Western Carolina Catamounts,TEAM,TOTAL,TOTAL,False,,18,54,15,44,3,10,7,10,12,22,34,5,4,3,19,18,46
401404413,Mercer Bears,A. Thayne,4704265,,True,22.0,1,1,1,1,0,0,0,0,3,4,7,1,0,0,0,0,2
401404413,Mercer Bears,J. Dougherty,4404201,,True,25.0,4,11,4,11,0,0,2,2,2,5,7,1,0,2,2,1,10
401404413,Mercer Bears,E. Houpt,4900401,,True,29.0,5,9,3,4,2,5,2,2,1,2,3,1,0,0,0,0,14
401404413,Mercer Bears,A. Neal-Tysor,4400623,,True,29.0,12,20,6,13,6,7,4,4,0,2,2,1,3,0,0,1,34
401404413,Mercer Bears,S. Titus,4281050,,True,24.0,2,8,2,8,0,0,4,4,1,2,3,3,0,0,0,2,8
401404413,Mercer Bears,A. Locke,4900404,,False,7.0,1,2,1,2,0,0,2,2,0,3,3,0,0,0,1,0,4
401404413,Mercer Bears,N. Harkless,4900403,,False,12.0,2,3,2,3,0,0,0,0,1,0,1,1,1,0,1,3,4
401404413,Mercer Bears,L. McNamara-Clement,4281558,,False,5.0,1,1,1,1,0,0,0,0,0,1,1,0,0,1,1,1,2
401404413,Mercer Bears,S. Votaw,4281224,,False,9.0,1,2,1,2,0,0,0,0,0,0,0,0,0,0,0,0,2
401404413,Mercer Bears,K. Jones,4900402,,False,6.0,1,2,1,2,0,0,0,0,0,0,0,0,0,0,0,1,2
401404413,Mercer Bears,K. Fisher,4900400,,False,8.0,0,3,0,2,0,1,0,0,0,0,0,0,0,0,0,0,0
401404413,Mercer Bears,S. Boykin,4704263,,False,8.0,1,2,1,2,0,0,0,0,0,1,1,2,0,0,0,2,2
401404413,Mercer Bears,E. Banks,4281193,,False,16.0,0,0,0,0,0,0,1,2,2,4,6,2,0,1,3,1,1
401404413,Mercer Bears,TEAM,TOTAL,TOTAL,False,,31,64,23,51,8,13,15,16,12,25,37,12,4,4,8,12,85
401402711,South Carolina Gamecocks,A. Boston,4432831,,True,34.0,9,18,9,17,0,1,3,4,5,6,11,3,0,2,3,2,21
401402711,South Carolina Gamecocks,V. Saxton,4398752,,True,23.0,1,4,1,3,0,1,2,2,3,1,4,2,1,1,1,0,4
401402711,South Carolina Gamecocks,B. Beal,4432835,,True,29.0,0,4,0,3,0,1,3,6,4,4,8,2,0,0,0,3,3
401402711,South Carolina Gamecocks,Z. Cooke,4432832,,True,34.0,5,16,2,9,3,7,2,6,2,3,5,2,0,0,2,2,15
401402711,South Carolina Gamecocks,D. Henderson,4398751,,True,35.0,3,11,0,6,3,5,0,0,0,0,0,5,1,0,0,3,9
401402711,South Carolina Gamecocks,L. Amihere,4432834,,False,14.0,2,8,2,8,0,0,2,2,4,3,7,0,0,0,3,1,6
401402711,South Carolina Gamecocks,K. Cardoso,4433405,,False,14.0,1,1,1,1,0,0,0,0,1,4,5,1,0,2,3,0,2
401402711,South Carolina Gamecocks,B. Hall,4898383,,False,8.0,1,3,1,3,0,0,0,0,0,0,0,0,0,0,0,1,2
401402711,South Carolina Gamecocks,L. Grissett,4280887,,False,9.0,0,1,0,1,0,0,0,0,0,0,0,1,0,0,0,0,0
401402711,South Carolina Gamecocks,TEAM,TOTAL,TOTAL,False,,22,66,16,51,6,15,12,20,22,22,44,16,2,5,13,12,62
401402711,Kentucky Wildcats,N. Leveretter,4433471,,True,13.0,0,0,0,0,0,0,0,0,0,1,1,0,0,1,1,1,0
401402711,Kentucky Wildcats,J. Walker,4433800,,True,21.0,0,4,0,3,0,1,0,0,1,1,2,2,1,0,2,2,0
401402711,Kentucky Wildcats,T. Hunt,4433430,,True,20.0,2,3,1,1,1,2,0,0,0,1,1,3,0,0,1,4,5
401402711,Kentucky Wildcats,J. Massengill,4398765,,True,34.0,3,8,3,8,0,0,1,1,1,2,3,6,1,0,0,3,7
401402711,Kentucky Wildcats,R. Howard,4398674,,True,40.0,5,14,4,10,1,4,7,10,0,4,4,2,2,2,2,3,18
401402711,Kentucky Wildcats,O. Owens,4398914,,False,14.0,1,3,1,3,0,0,0,0,1,2,3,0,0,1,0,1,2
401402711,Kentucky Wildcats,D. Edwards,4398865,,False,33.0,11,21,8,16,3,5,2,2,2,7,9,1,0,1,3,4,27
401402711,Kentucky Wildcats,R. Benton,4398607,,False,25.0,2,4,1,2,1,2,0,0,2,1,3,2,0,1,0,2,5
401402711,Kentucky Wildcats,TEAM,TOTAL,TOTAL,False,,24,57,18,43,6,14,10,13,9,23,32,16,4,6,10,20,64
401402710,Tennessee Lady Volunteers,A. Dye,4596286,,True,35.0,12,18,12,18,0,0,2,3,1,9,10,1,0,2,1,1,26
401402710,Tennessee Lady Volunteers,T. Key,4433642,,True,22.0,2,4,2,4,0,0,1,3,2,2,4,2,0,2,1,4,5
401402710,Tennessee Lady Volunteers,T. Darby,4597244,,True,21.0,1,4,0,2,1,2,0,0,1,2,3,2,1,0,0,1,3
401402710,Tennessee Lady Volunteers,R. Burrell,4398764,,True,38.0,6,15,4,11,2,4,2,2,2,6,8,1,0,2,3,0,16
401402710,Tennessee Lady Volunteers,J. Walker,4282154,,True,26.0,2,7,2,7,0,0,2,4,1,1,2,10,1,0,2,2,6
401402710,Tennessee Lady Volunteers,K. Striplin,4433810,,False,12.0,3,6,3,5,0,1,1,2,2,0,2,1,1,1,0,3,7
401402710,Tennessee Lady Volunteers,B. Miles,4586299,,False,22.0,2,4,2,3,0,1,0,0,1,3,4,4,0,0,3,2,4
401402710,Tennessee Lady Volunteers,S. Puckett,4434021,,False,7.0,2,5,2,5,0,0,0,0,1,2,3,0,0,0,0,1,4
401402710,Tennessee Lady Volunteers,K. Wynn,4434014,,False,17.0,1,3,1,3,0,0,1,2,5,1,6,1,0,0,2,3,3
401402710,Tennessee Lady Volunteers,TEAM,TOTAL,TOTAL,False,,31,66,28,58,3,8,9,16,17,26,43,22,3,7,13,17,74
401402710,Kentucky Wildcats,N. Leveretter,4433471,,True,15.0,0,1,0,1,0,0,0,0,1,1,2,0,0,0,1,1,0
401402710,Kentucky Wildcats,J. Walker,4433800,,True,32.0,6,16,4,11,2,5,2,2,2,4,6,2,1,1,2,1,16
401402710,Kentucky Wildcats,T. Hunt,4433430,,True,34.0,4,11,1,4,3,7,0,2,2,2,4,0,0,1,0,2,11
401402710,Kentucky Wildcats,J. Massengill,4398765,,True,33.0,4,10,4,9,0,1,0,0,1,2,3,5,2,1,0,1,8
401402710,Kentucky Wildcats,R. Howard,4398674,,True,37.0,7,12,5,9,2,3,8,11,6,3,9,7,0,1,1,3,24
401402710,Kentucky Wildcats,O. Owens,4398914,,False,2.0,0,1,0,1,0,0,0,0,0,0,0,0,0,0,0,0,0
401402710,Kentucky Wildcats,D. Edwards,4398865,,False,19.0,3,5,2,4,1,1,1,4,1,6,7,1,2,1,2,4,8
401402710,Kentucky Wildcats,R. Benton,4398607,,False,28.0,6,14,2,7,4,7,0,0,1,1,2,1,0,0,1,3,16
401402710,Kentucky Wildcats,TEAM,TOTAL,TOTAL,False,,30,70,18,46,12,24,11,19,17,21,38,16,5,5,7,15,83
401402709,South Carolina Gamecocks,A. Boston,4432831,,True,34.0,4,7,4,7,0,0,7,9,3,9,12,2,3,3,1,1,15
401402709,South Carolina Gamecocks,V. Saxton,4398752,,True,24.0,4,6,4,6,0,0,0,0,0,1,1,0,4,1,2,2,8
401402709,South Carolina Gamecocks,B. Beal,4432835,,True,27.0,3,5,3,3,0,2,0,0,1,4,5,0,0,0,1,0,6
401402709,South Carolina Gamecocks,Z. Cooke,4432832,,True,24.0,1,8,1,5,0,3,1,1,0,4,4,2,1,0,3,0,3
401402709,South Carolina Gamecocks,D. Henderson,4398751,,True,38.0,2,8,1,5,1,3,3,4,1,3,4,5,1,0,4,2,8
401402709,South Carolina Gamecocks,L. Amihere,4432834,,False,24.0,4,6,4,6,0,0,0,0,2,1,3,2,0,1,4,1,8
401402709,South Carolina Gamecocks,K. Cardoso,4433405,,False,15.0,2,2,2,2,0,0,4,6,3,3,6,2,0,0,2,4,8
401402709,South Carolina Gamecocks,B. Hall,4898383,,False,6.0,1,4,0,2,1,2,2,2,0,0,0,0,0,0,1,1,5
401402709,South Carolina Gamecocks,S. Rivers,4433514,,False,4.0,0,2,0,1,0,1,0,0,0,0,0,0,0,0,1,2,0
401402709,South Carolina Gamecocks,L. Grissett,4280887,,False,4.0,0,1,0,1,0,0,0,0,0,0,0,1,0,0,0,0,0
401402709,South Carolina Gamecocks,TEAM,TOTAL,TOTAL,False,,21,49,19,38,2,11,17,22,13,31,44,14,9,5,22,13,61
401402709,Ole Miss Rebels,S. Austin,4398911,,True,33.0,6,17,5,14,1,3,3,5,2,4,6,1,1,3,2,3,16
401402709,Ole Miss Rebels,S. Collins,4704453,,True,15.0,1,1,0,0,1,1,3,6,0,2,2,0,0,1,0,2,6
401402709,Ole Miss Rebels,M. Scott,4433416,,True,29.0,1,4,1,4,0,0,0,1,4,2,6,3,1,1,3,3,2
401402709,Ole Miss Rebels,M. Reid,4398709,,True,24.0,1,6,1,4,0,2,1,2,0,0,0,3,1,0,1,2,3
401402709,Ole Miss Rebels,L. Monk,4281079,,True,24.0,2,13,2,12,0,1,0,0,3,2,5,2,2,0,4,3,4
401402709,Ole Miss Rebels,C. McGee,4433465,,False,10.0,0,2,0,2,0,0,0,0,0,0,0,1,1,0,0,2,0
401402709,Ole Miss Rebels,I. Kitchens,4398714,,False,3.0,0,0,0,0,0,0,0,0,0,0,0,0,0,0,0,0,0
401402709,Ole Miss Rebels,A. Puckett,4281073,,False,6.0,0,1,0,0,0,1,0,0,0,0,0,0,0,0,2,2,0
401402709,Ole Miss Rebels,T. Douglas,4704455,,False,25.0,0,0,0,0,0,0,0,0,0,0,0,0,1,0,0,0,0
401402709,Ole Miss Rebels,A. Baker,4399736,,False,31.0,9,15,7,11,2,4,0,0,0,1,1,0,0,0,3,1,20
401402709,Ole Miss Rebels,TEAM,TOTAL,TOTAL,False,,20,59,16,47,4,12,7,14,10,18,28,10,7,5,15,18,51
401402708,Tennessee Lady Volunteers,A. Dye,4596286,,True,29.0,8,15,8,15,0,0,0,1,7,7,14,2,0,2,2,2,16
401402708,Tennessee Lady Volunteers,T. Key,4433642,,True,21.0,3,3,3,3,0,0,2,2,1,2,3,0,0,5,2,3,8
401402708,Tennessee Lady Volunteers,T. Darby,4597244,,True,32.0,4,8,2,3,2,5,2,2,0,2,2,1,1,0,2,1,12
401402708,Tennessee Lady Volunteers,R. Burrell,4398764,,True,30.0,5,13,2,8,3,5,8,9,1,2,3,7,0,0,3,3,21
401402708,Tennessee Lady Volunteers,J. Walker,4282154,,True,15.0,1,4,1,1,0,3,0,0,0,6,6,3,0,0,3,4,2
401402708,Tennessee Lady Volunteers,E. Saunders,4433142,,False,1.0,0,0,0,0,0,0,0,0,0,0,0,0,0,0,0,0,0
401402708,Tennessee Lady Volunteers,K. Striplin,4433810,,False,11.0,1,2,1,1,0,1,0,0,0,0,0,0,0,1,2,1,2
401402708,Tennessee Lady Volunteers,J. Rennie,4595179,,False,3.0,0,0,0,0,0,0,1,2,0,0,0,0,0,0,0,0,1
401402708,Tennessee Lady Volunteers,B. Miles,4586299,,False,26.0,2,3,1,1,1,2,0,0,0,4,4,4,0,1,3,2,5
401402708,Tennessee Lady Volunteers,S. Puckett,4434021,,False,17.0,1,5,1,2,0,3,1,2,1,2,3,0,0,0,2,2,3
401402708,Tennessee Lady Volunteers,K. Wynn,4434014,,False,15.0,1,3,1,3,0,0,2,4,0,2,2,0,2,0,2,0,4
401402708,Tennessee Lady Volunteers,TEAM,TOTAL,TOTAL,False,,26,56,20,37,6,19,16,22,12,31,43,17,3,9,23,18,74
401402708,Alabama Crimson Tide,A. Cruce,4398598,,True,24.0,4,9,3,4,1,5,3,3,1,2,3,1,2,0,1,4,12
401402708,Alabama Crimson Tide,J. Mingo-Young,4595174,,True,35.0,4,11,4,9,0,2,1,2,3,3,6,2,3,0,2,3,9
401402708,Alabama Crimson Tide,B. Davis,4594178,,True,35.0,2,15,2,8,0,7,0,0,2,3,5,3,1,1,1,1,4
401402708,Alabama Crimson Tide,H. Barber,4398597,,True,36.0,2,7,0,0,2,7,0,0,2,2,4,4,1,0,3,2,6
401402708,Alabama Crimson Tide,M. Abrams,4398595,,True,37.0,5,11,4,7,1,4,8,10,0,4,4,1,0,0,2,2,19
401402708,Alabama Crimson Tide,J. Rice,4398624,,False,16.0,1,2,1,2,0,0,1,4,2,1,3,0,1,1,0,2,3
401402708,Alabama Crimson Tide,M. Gordon,4433457,,False,6.0,0,1,0,0,0,1,0,0,0,0,0,1,0,0,0,2,0
401402708,Alabama Crimson Tide,T. Sutton,4399523,,False,11.0,1,4,0,3,1,1,3,4,0,1,1,0,1,0,1,1,6
401402708,Alabama Crimson Tide,TEAM,TOTAL,TOTAL,False,,19,60,14,33,5,27,16,23,11,19,30,12,9,2,13,17,59
401402707,LSU Tigers,A. Newby,4280898,,True,36.0,2,5,2,5,0,0,0,0,5,3,8,1,1,0,1,3,4
401402707,LSU Tigers,F. Aifuwa,4065738,,True,34.0,2,8,2,8,0,0,0,0,1,7,8,0,0,1,3,2,4
401402707,LSU Tigers,R. Payne,4399220,,True,35.0,6,9,5,8,1,1,0,0,0,0,0,3,1,0,1,1,13
401402707,LSU Tigers,J. Cherry,4280863,,True,29.0,4,10,4,10,0,0,0,0,0,1,1,3,0,1,0,1,8
401402707,LSU Tigers,K. Pointer,4280859,,True,40.0,9,26,8,20,1,6,8,9,0,7,7,7,0,0,6,3,27
401402707,LSU Tigers,A. Petty,4704417,,False,1.0,0,0,0,0,0,0,0,0,0,0,0,0,0,0,0,0,0
401402707,LSU Tigers,A. Trasi,4595165,,False,13.0,1,3,1,2,0,1,0,0,3,3,6,0,0,1,0,1,2
401402707,LSU Tigers,S. Shematsi,4599246,,False,4.0,1,3,0,1,1,2,0,0,0,0,0,0,0,0,0,0,3
401402707,LSU Tigers,H. Gusters,4433732,,False,5.0,1,2,1,2,0,0,0,0,0,2,2,1,0,0,0,2,2
401402707,LSU Tigers,T. Ware,4433812,,False,3.0,0,0,0,0,0,0,0,0,0,1,1,0,0,0,1,0,0
401402707,LSU Tigers,TEAM,TOTAL,TOTAL,False,,26,66,23,56,3,10,8,9,11,24,35,15,2,3,13,13,63
401402707,Kentucky Wildcats,N. Leveretter,4433471,,True,11.0,0,0,0,0,0,0,2,2,1,2,3,0,0,0,0,2,2
401402707,Kentucky Wildcats,J. Walker,4433800,,True,23.0,2,6,2,4,0,2,0,0,0,4,4,2,0,0,2,0,4
401402707,Kentucky Wildcats,T. Hunt,4433430,,True,31.0,5,14,3,8,2,6,1,2,1,6,7,3,1,1,0,1,13
401402707,Kentucky Wildcats,J. Massengill,4398765,,True,32.0,1,6,1,6,0,0,0,0,0,2,2,8,0,3,1,0,2
401402707,Kentucky Wildcats,R. Howard,4398674,,True,35.0,11,18,5,10,6,8,4,4,0,3,3,3,0,2,2,3,32
401402707,Kentucky Wildcats,O. Owens,4398914,,False,9.0,0,1,0,1,0,0,1,2,0,1,1,2,0,0,2,2,1
401402707,Kentucky Wildcats,D. Edwards,4398865,,False,29.0,6,12,6,11,0,1,1,2,4,6,10,1,2,0,1,4,13
401402707,Kentucky Wildcats,E. King,4433376,,False,3.0,0,0,0,0,0,0,0,0,0,0,0,1,0,0,0,0,0
401402707,Kentucky Wildcats,R. Benton,4398607,,False,27.0,4,8,3,6,1,2,2,2,2,1,3,0,2,2,0,1,11
401402707,Kentucky Wildcats,TEAM,TOTAL,TOTAL,False,,29,65,20,46,9,19,11,14,11,28,39,20,5,8,11,13,78
401402706,Ole Miss Rebels,S. Austin,4398911,,True,34.0,10,16,10,16,0,0,7,10,4,9,13,4,0,6,2,2,27
401402706,Ole Miss Rebels,S. Collins,4704453,,True,27.0,2,13,1,1,1,12,0,0,0,2,2,0,0,0,0,2,5
401402706,Ole Miss Rebels,M. Scott,4433416,,True,32.0,2,4,2,4,0,0,4,4,5,4,9,0,1,1,2,1,8
401402706,Ole Miss Rebels,M. Reid,4398709,,True,31.0,0,3,0,1,0,2,2,2,1,2,3,6,0,0,2,1,2
401402706,Ole Miss Rebels,L. Monk,4281079,,True,23.0,4,9,4,9,0,0,3,4,1,3,4,3,1,1,2,3,11
401402706,Ole Miss Rebels,C. McGee,4433465,,False,9.0,0,0,0,0,0,0,2,2,0,0,0,0,0,3,0,0,2
401402706,Ole Miss Rebels,I. Kitchens,4398714,,False,2.0,0,0,0,0,0,0,0,0,0,0,0,0,0,0,0,1,0
401402706,Ole Miss Rebels,A. Puckett,4281073,,False,3.0,0,1,0,0,0,1,0,0,1,1,2,0,0,0,0,0,0
401402706,Ole Miss Rebels,J. Harris-Smith,4899450,,False,5.0,0,0,0,0,0,0,0,0,0,0,0,0,0,0,0,2,0
401402706,Ole Miss Rebels,D. Salary,4433770,,False,3.0,0,0,0,0,0,0,0,0,0,1,1,0,0,0,0,1,0
401402706,Ole Miss Rebels,J. Bracey,4433443,,False,1.0,0,0,0,0,0,0,0,0,0,0,0,0,0,0,0,0,0
401402706,Ole Miss Rebels,A. Baker,4399736,,False,30.0,6,14,5,11,1,3,2,4,1,2,3,2,0,0,3,3,15
401402706,Ole Miss Rebels,TEAM,TOTAL,TOTAL,False,,24,60,22,42,2,18,20,26,13,28,41,15,2,11,11,16,70
401402706,Florida Gators,F. Dut,4433702,,True,10.0,0,1,0,1,0,0,0,0,0,0,0,0,1,0,1,2,0
401402706,Florida Gators,J. Merritt,4433421,,True,3.0,0,1,0,1,0,0,0,0,0,0,0,0,0,0,1,0,0
401402706,Florida Gators,N. Rickards,4595152,,True,33.0,2,14,2,13,0,1,0,0,2,6,8,5,0,0,2,2,4
401402706,Florida Gators,Z. Broughton,4398949,,True,37.0,9,22,3,12,6,10,2,2,1,6,7,1,2,0,6,4,26
401402706,Florida Gators,K. Moore,4398631,,True,23.0,4,10,3,6,1,4,2,3,1,3,4,1,0,0,1,2,11
401402706,Florida Gators,F. Toonders,4703792,,False,18.0,0,0,0,0,0,0,0,0,0,3,3,0,0,1,0,2,0
401402706,Florida Gators,Tat. Wyche,4682739,,False,2.0,0,0,0,0,0,0,0,0,0,0,0,0,0,0,0,0,0
401402706,Florida Gators,Tal. Wyche,4682738,,False,10.0,0,2,0,2,0,0,0,0,1,0,1,0,1,0,0,2,0
401402706,Florida Gators,E. de Oliveira,4398630,,False,25.0,3,7,3,5,0,2,3,3,0,0,0,1,1,0,1,3,9
401402706,Florida Gators,J. Warren,4898611,,False,20.0,1,4,1,2,0,2,4,4,2,3,5,0,1,0,0,2,6
401402706,Florida Gators,A. Rimdal,4898610,,False,19.0,2,2,2,2,0,0,0,0,0,2,2,1,0,0,0,0,4
401402706,Florida Gators,TEAM,TOTAL,TOTAL,False,,21,63,14,44,7,19,11,12,12,26,38,9,6,1,14,19,60
401402705,South Carolina Gamecocks,A. Boston,4432831,,True,28.0,6,10,6,8,0,2,5,5,5,9,14,5,5,2,2,1,17
401402705,South Carolina Gamecocks,V. Saxton,4398752,,True,18.0,2,7,2,7,0,0,0,0,3,8,11,1,0,0,2,2,4
401402705,South Carolina Gamecocks,B. Beal,4432835,,True,21.0,1,4,1,3,0,1,5,6,3,0,3,0,1,0,1,2,7
401402705,South Carolina Gamecocks,Z. Cooke,4432832,,True,19.0,3,9,2,7,1,2,1,1,0,2,2,2,0,0,2,1,8
401402705,South Carolina Gamecocks,D. Henderson,4398751,,True,32.0,2,9,1,6,1,3,1,2,1,1,2,3,2,0,2,0,6
401402705,South Carolina Gamecocks,S. Feagin,4433795,,False,4.0,1,1,1,1,0,0,1,1,0,1,1,0,0,3,0,1,3
401402705,South Carolina Gamecocks,L. Amihere,4432834,,False,19.0,7,13,7,13,0,0,2,2,4,2,6,4,0,0,2,2,16
401402705,South Carolina Gamecocks,K. Cardoso,4433405,,False,10.0,0,5,0,5,0,0,5,6,2,5,7,0,1,2,2,3,5
401402705,South Carolina Gamecocks,B. Hall,4898383,,False,15.0,2,4,1,3,1,1,1,3,0,4,4,0,0,0,0,2,6
401402705,South Carolina Gamecocks,S. Rivers,4433514,,False,11.0,0,3,0,3,0,0,0,0,0,1,1,1,0,0,0,1,0
401402705,South Carolina Gamecocks,D. Littleton,4281322,,False,8.0,0,1,0,0,0,1,0,0,0,0,0,0,0,0,1,0,0
401402705,South Carolina Gamecocks,L. Grissett,4280887,,False,15.0,1,1,1,1,0,0,2,2,1,0,1,0,0,1,2,0,4
401402705,South Carolina Gamecocks,TEAM,TOTAL,TOTAL,False,,25,67,22,57,3,10,23,28,20,34,54,16,9,8,17,15,76
401402705,Arkansas Razorbacks,J. Wolfenbarger,4433799,,True,23.0,1,8,1,3,0,5,0,0,0,1,1,2,0,3,1,4,2
401402705,Arkansas Razorbacks,S. Spencer,4705414,,True,30.0,3,9,3,5,0,4,4,6,2,6,8,2,1,0,6,1,10
401402705,Arkansas Razorbacks,S. Goforth,4433736,,True,32.0,3,11,2,6,1,5,1,2,1,1,2,0,1,4,2,4,8
401402705,Arkansas Razorbacks,M. Daniels,4433047,,True,31.0,3,13,1,4,2,9,1,2,4,5,9,2,2,1,1,2,9
401402705,Arkansas Razorbacks,A. Ramirez,4068136,,True,35.0,3,7,3,5,0,2,2,3,0,3,3,3,1,1,4,2,8
401402705,Arkansas Razorbacks,E. Ellis,4705411,,False,1.0,0,0,0,0,0,0,0,0,0,1,1,0,0,0,0,1,0
401402705,Arkansas Razorbacks,E. Barnum,4595144,,False,16.0,3,6,3,5,0,1,1,2,0,4,4,2,1,2,0,2,7
401402705,Arkansas Razorbacks,D. Oberg,4433678,,False,1.0,0,0,0,0,0,0,0,0,0,0,0,1,0,0,0,0,0
401402705,Arkansas Razorbacks,A. Sage,4705412,,False,2.0,1,2,1,2,0,0,0,0,0,0,0,0,0,0,0,0,2
401402705,Arkansas Razorbacks,R. Langerman,4703778,,False,17.0,3,6,1,2,2,4,0,0,0,3,3,0,0,0,0,4,8
401402705,Arkansas Razorbacks,A. Hughes,4595145,,False,1.0,0,0,0,0,0,0,0,0,0,0,0,0,0,0,0,0,0
401402705,Arkansas Razorbacks,E. Eaton,4433439,,False,11.0,0,2,0,1,0,1,0,0,0,1,1,0,0,0,0,1,0
401402705,Arkansas Razorbacks,TEAM,TOTAL,TOTAL,False,,20,64,15,33,5,31,9,15,12,25,37,12,6,11,17,21,54
401402704,Georgia Lady Bulldogs,J. Staiti,4065782,,True,21.0,5,7,4,6,1,1,3,4,1,4,5,0,0,1,2,1,14
401402704,Georgia Lady Bulldogs,S. Barker,4703794,,True,13.0,0,3,0,0,0,3,0,0,1,1,2,0,0,0,2,0,0
401402704,Georgia Lady Bulldogs,C. Chapman,4433306,,True,13.0,1,2,1,2,0,0,0,0,1,1,2,3,1,0,2,1,2
401402704,Georgia Lady Bulldogs,M. Coombs,4281074,,True,29.0,1,4,1,4,0,0,1,2,1,1,2,7,0,1,3,2,3
401402704,Georgia Lady Bulldogs,Q. Morrison,4280851,,True,36.0,6,16,4,12,2,4,4,4,0,2,2,2,1,0,4,5,18
401402704,Georgia Lady Bulldogs,J. Isaacs,4433351,,False,12.0,0,1,0,1,0,0,0,0,1,2,3,0,1,0,0,4,0
401402704,Georgia Lady Bulldogs,J. Nicholson,4432863,,False,16.0,1,2,1,2,0,0,4,7,3,6,9,1,0,3,1,0,6
401402704,Georgia Lady Bulldogs,M. Bates,4280852,,False,21.0,2,5,2,5,0,0,0,0,0,2,2,1,0,2,2,1,4
401402704,Georgia Lady Bulldogs,Z. Smith,4597016,,False,2.0,0,0,0,0,0,0,0,0,0,0,0,0,0,0,0,0,0
401402704,Georgia Lady Bulldogs,T. Hylton,4913560,,False,8.0,1,2,0,1,1,1,0,0,0,0,0,0,0,0,1,0,3
401402704,Georgia Lady Bulldogs,R. Richardson,4433543,,False,29.0,4,10,3,7,1,3,3,4,1,1,2,0,0,1,1,2,12
401402704,Georgia Lady Bulldogs,TEAM,TOTAL,TOTAL,False,,21,52,16,40,5,12,15,21,12,20,32,14,3,8,18,16,62
401402704,Alabama Crimson Tide,A. Cruce,4398598,,True,24.0,4,6,2,3,2,3,0,0,3,3,6,0,0,0,1,4,10
401402704,Alabama Crimson Tide,J. Mingo-Young,4595174,,True,35.0,2,7,2,6,0,1,1,2,2,3,5,3,1,0,0,2,5
401402704,Alabama Crimson Tide,B. Davis,4594178,,True,39.0,9,16,4,10,5,6,3,4,0,5,5,0,5,0,2,3,26
401402704,Alabama Crimson Tide,H. Barber,4398597,,True,33.0,0,4,0,2,0,2,0,0,0,1,1,5,1,0,1,2,0
401402704,Alabama Crimson Tide,M. Abrams,4398595,,True,37.0,7,16,6,12,1,4,9,12,2,5,7,1,0,0,5,1,24
401402704,Alabama Crimson Tide,J. Rice,4398624,,False,16.0,1,2,1,2,0,0,0,0,1,1,2,0,2,1,1,4,2
401402704,Alabama Crimson Tide,M. Gordon,4433457,,False,1.0,0,0,0,0,0,0,0,0,0,0,0,0,0,0,0,0,0
401402704,Alabama Crimson Tide,T. Sutton,4399523,,False,15.0,3,4,2,2,1,2,0,1,0,1,1,2,0,0,1,1,7
401402704,Alabama Crimson Tide,TEAM,TOTAL,TOTAL,False,,26,55,17,37,9,18,13,19,11,21,32,11,9,1,13,17,74
401402703,Mississippi State Bulldogs,C. Kohl,4704433,,True,30.0,3,4,3,4,0,0,0,2,2,2,4,0,0,2,0,0,6
401402703,Mississippi State Bulldogs,J. Jordan,4433741,,True,32.0,8,17,6,12,2,5,3,5,1,3,4,1,4,0,2,0,21
401402703,Mississippi State Bulldogs,An. Hayes,4280889,,True,39.0,5,13,5,13,0,0,3,5,1,2,3,3,2,1,4,3,13
401402703,Mississippi State Bulldogs,M. Taylor,4280874,,True,37.0,3,11,3,9,0,2,0,0,0,2,2,7,2,0,3,4,6
401402703,Mississippi State Bulldogs,C. Thompson,4068827,,True,38.0,7,14,6,12,1,2,4,4,1,7,8,2,0,0,1,3,19
401402703,Mississippi State Bulldogs,Ai. Hayes,4433345,,False,23.0,1,4,1,3,0,1,0,0,0,3,3,2,2,0,2,1,2
401402703,Mississippi State Bulldogs,A. Jones,12038,,False,1.0,0,0,0,0,0,0,0,0,0,0,0,0,0,0,1,0,0
401402703,Mississippi State Bulldogs,TEAM,TOTAL,TOTAL,False,,27,63,24,53,3,10,10,16,5,20,25,15,10,3,14,11,67
401402703,Kentucky Wildcats,N. Leveretter,4433471,,True,20.0,2,3,2,3,0,0,0,2,0,5,5,1,0,0,1,4,4
401402703,Kentucky Wildcats,J. Walker,4433800,,True,33.0,7,12,6,7,1,5,6,6,2,6,8,2,0,0,1,2,21
401402703,Kentucky Wildcats,T. Hunt,4433430,,True,15.0,1,3,1,3,0,0,0,0,1,3,4,0,0,0,1,1,2
401402703,Kentucky Wildcats,J. Massengill,4398765,,True,36.0,6,11,6,10,0,1,0,0,1,5,6,7,0,2,3,2,12
401402703,Kentucky Wildcats,R. Howard,4398674,,True,33.0,6,16,5,11,1,5,1,1,0,3,3,4,2,0,3,3,14
401402703,Kentucky Wildcats,D. Edwards,4398865,,False,23.0,8,13,8,13,0,0,2,3,6,8,14,2,1,0,3,4,18
401402703,Kentucky Wildcats,E. King,4433376,,False,8.0,0,0,0,0,0,0,0,0,0,1,1,2,0,0,2,0,0
401402703,Kentucky Wildcats,R. Benton,4398607,,False,32.0,6,10,6,9,0,1,0,0,2,2,4,2,1,2,4,2,12
401402703,Kentucky Wildcats,TEAM,TOTAL,TOTAL,False,,36,68,34,56,2,12,9,12,12,35,47,20,4,4,18,18,83
401402702,Vanderbilt Commodores,S. Washington,4433999,,True,36.0,3,6,3,6,0,0,0,4,3,10,13,3,2,3,1,3,6
401402702,Vanderbilt Commodores,K. Smith,4433301,,True,32.0,2,6,2,5,0,1,0,0,1,4,5,0,1,0,1,2,4
401402702,Vanderbilt Commodores,B. Alexander,4398774,,True,35.0,6,16,5,9,1,7,5,5,2,1,3,1,4,0,1,0,18
401402702,Vanderbilt Commodores,I. Moore,4433536,,True,35.0,6,14,2,7,4,7,0,0,0,4,4,3,1,1,3,3,16
401402702,Vanderbilt Commodores,J. Cambridge,4398773,,True,38.0,1,11,1,11,0,0,2,3,2,0,2,4,4,0,2,4,4
401402702,Vanderbilt Commodores,Y. Chambers,4433659,,False,8.0,1,1,1,1,0,0,2,2,0,2,2,0,0,0,0,1,4
401402702,Vanderbilt Commodores,D. Flournoy,4683036,,False,10.0,0,7,0,3,0,4,0,0,0,0,0,0,1,0,1,0,0
401402702,Vanderbilt Commodores,B. LaChance,4433502,,False,2.0,0,1,0,1,0,0,0,0,0,0,0,0,0,0,1,0,0
401402702,Vanderbilt Commodores,D. Washington,4433002,,False,4.0,0,1,0,1,0,0,0,0,1,0,1,0,0,0,0,1,0
401402702,Vanderbilt Commodores,TEAM,TOTAL,TOTAL,False,,19,63,14,44,5,19,9,14,13,23,36,11,13,4,13,14,52
401402702,Florida Gators,F. Dut,4433702,,True,16.0,0,2,0,2,0,0,0,0,1,1,2,0,0,2,0,2,0
401402702,Florida Gators,J. Merritt,4433421,,True,29.0,2,7,1,5,1,2,2,2,2,4,6,2,1,3,3,3,7
401402702,Florida Gators,N. Rickards,4595152,,True,34.0,6,11,5,8,1,3,2,2,3,5,8,1,1,0,4,1,15
401402702,Florida Gators,Z. Broughton,4398949,,True,30.0,5,10,4,8,1,2,3,6,1,3,4,1,1,0,4,2,14
401402702,Florida Gators,K. Smith,4398629,,True,36.0,3,13,3,12,0,1,1,2,0,5,5,5,1,0,6,2,7
401402702,Florida Gators,Tal. Wyche,4682738,,False,14.0,3,3,3,3,0,0,0,0,1,3,4,0,0,0,2,1,6
401402702,Florida Gators,E. de Oliveira,4398630,,False,18.0,2,3,2,3,0,0,0,0,2,3,5,1,0,0,1,1,4
401402702,Florida Gators,J. Warren,4898611,,False,2.0,0,1,0,0,0,1,0,0,0,0,0,0,0,0,0,0,0
401402702,Florida Gators,A. Rimdal,4898610,,False,18.0,0,5,0,0,0,5,0,0,1,3,4,0,1,1,0,2,0
401402702,Florida Gators,K. Moore,4398631,,False,3.0,0,0,0,0,0,0,0,0,0,0,0,0,0,0,0,1,0
401402702,Florida Gators,TEAM,TOTAL,TOTAL,False,,21,55,18,41,3,14,8,12,13,29,42,10,5,6,21,15,53
401402701,Missouri Tigers,H. Frank,4433637,,True,40.0,2,8,1,5,1,3,0,0,1,12,13,3,1,1,2,3,5
401402701,Missouri Tigers,L. Williams,4280886,,True,34.0,6,11,6,11,0,0,2,2,0,13,13,1,0,2,2,3,14
401402701,Missouri Tigers,M. Dembele,4704449,,True,37.0,1,10,1,8,0,2,0,0,1,0,1,2,0,0,1,3,2
401402701,Missouri Tigers,L. Hansen,4432951,,True,34.0,1,8,0,5,1,3,2,2,0,3,3,1,1,0,4,4,5
401402701,Missouri Tigers,H. Troup,4280879,,True,43.0,8,19,5,12,3,7,2,2,2,4,6,3,0,0,1,5,21
401402701,Missouri Tigers,J. Kelly,4433470,,False,3.0,0,0,0,0,0,0,0,0,0,1,1,0,0,0,0,1,0
401402701,Missouri Tigers,S. Smith,4704448,,False,3.0,0,3,0,2,0,1,0,0,1,0,1,0,0,0,0,0,0
401402701,Missouri Tigers,I. Higginbottom,4434013,,False,20.0,0,3,0,2,0,1,0,0,0,1,1,1,0,0,1,3,0
401402701,Missouri Tigers,A. Blackwell,4432833,,False,11.0,2,5,2,3,0,2,1,2,2,6,8,0,0,0,1,0,5
401402701,Missouri Tigers,TEAM,TOTAL,TOTAL,False,,20,67,15,48,5,19,7,8,7,40,47,11,2,3,14,22,52
401402701,Arkansas Razorbacks,J. Wolfenbarger,4433799,,True,29.0,1,3,1,2,0,1,3,4,2,7,9,3,3,2,1,4,5
401402701,Arkansas Razorbacks,S. Spencer,4705414,,True,33.0,4,16,3,11,1,5,2,3,0,2,2,2,2,0,2,2,11
401402701,Arkansas Razorbacks,S. Goforth,4433736,,True,45.0,3,10,0,4,3,6,2,4,0,4,4,1,0,5,1,1,11
401402701,Arkansas Razorbacks,M. Daniels,4433047,,True,43.0,3,17,2,13,1,4,6,8,3,11,14,5,1,1,1,3,13
401402701,Arkansas Razorbacks,A. Ramirez,4068136,,True,45.0,6,15,3,12,3,3,2,2,0,7,7,1,0,0,1,1,17
401402701,Arkansas Razorbacks,E. Barnum,4595144,,False,16.0,1,3,1,2,0,1,2,4,2,1,3,0,0,0,1,1,4
401402701,Arkansas Razorbacks,R. Langerman,4703778,,False,14.0,0,2,0,0,0,2,0,0,1,3,4,1,0,2,1,2,0
401402701,Arkansas Razorbacks,TEAM,TOTAL,TOTAL,False,,18,66,10,44,8,22,17,25,11,37,48,13,6,10,8,14,61
401402700,Auburn Tigers,P. Johnson,4597503,,True,16.0,2,6,2,6,0,0,2,6,2,4,6,0,3,1,3,3,6
401402700,Auburn Tigers,M. Bostic,4898608,,True,18.0,2,4,2,4,0,0,1,1,0,2,2,3,1,1,3,2,5
401402700,Auburn Tigers,A. Coulibaly,4433433,,True,38.0,4,14,4,12,0,2,2,3,2,3,5,3,2,1,4,1,10
401402700,Auburn Tigers,A. Hughes,4433349,,True,33.0,4,9,1,2,3,7,1,2,1,2,3,1,1,0,0,3,12
401402700,Auburn Tigers,H. Scott-Grayson,4398777,,True,23.0,5,11,5,11,0,0,3,6,1,4,5,2,2,0,3,4,13
401402700,Auburn Tigers,J. Jordan,4398994,,False,15.0,3,8,3,6,0,2,2,4,2,1,3,1,0,1,1,2,8
401402700,Auburn Tigers,A. Graves,4898607,,False,7.0,0,0,0,0,0,0,0,0,0,1,1,0,0,0,0,1,0
401402700,Auburn Tigers,S. Wells,4433367,,False,28.0,4,6,4,5,0,1,2,4,1,1,2,4,0,0,0,4,10
401402700,Auburn Tigers,X. Wiggins,4398727,,False,22.0,1,3,0,2,1,1,1,2,1,0,1,1,0,0,0,0,4
401402700,Auburn Tigers,TEAM,TOTAL,TOTAL,False,,25,61,21,48,4,13,14,28,12,21,33,15,9,4,14,20,68
401402700,Alabama Crimson Tide,A. Cruce,4398598,,True,23.0,5,8,1,2,4,6,0,0,1,2,3,0,1,0,0,4,14
401402700,Alabama Crimson Tide,J. Mingo-Young,4595174,,True,40.0,5,9,5,9,0,0,4,6,5,10,15,1,4,0,4,2,14
401402700,Alabama Crimson Tide,B. Davis,4594178,,True,40.0,5,11,3,4,2,7,3,5,1,10,11,2,1,0,6,3,15
401402700,Alabama Crimson Tide,H. Barber,4398597,,True,22.0,1,3,1,1,0,2,1,2,0,1,1,2,0,0,3,4,3
401402700,Alabama Crimson Tide,M. Abrams,4398595,,True,40.0,8,15,8,14,0,1,9,11,0,2,2,5,1,0,6,1,25
401402700,Alabama Crimson Tide,J. Rice,4398624,,False,18.0,2,4,2,4,0,0,0,0,1,3,4,0,1,1,0,5,4
401402700,Alabama Crimson Tide,M. Gordon,4433457,,False,14.0,0,0,0,0,0,0,0,0,1,1,2,1,0,0,2,0,0
401402700,Alabama Crimson Tide,T. Sutton,4399523,,False,3.0,0,3,0,2,0,1,0,0,0,0,0,0,0,0,1,3,0
401402700,Alabama Crimson Tide,TEAM,TOTAL,TOTAL,False,,26,53,20,36,6,17,17,24,10,32,42,11,8,1,22,22,75
401402699,Vanderbilt Commodores,S. Washington,4433999,,True,30.0,4,11,4,11,0,0,4,5,5,5,10,0,2,2,1,3,12
401402699,Vanderbilt Commodores,K. Smith,4433301,,True,20.0,2,3,2,3,0,0,0,0,0,1,1,2,0,0,0,3,4
401402699,Vanderbilt Commodores,B. Alexander,4398774,,True,39.0,8,19,3,10,5,9,2,2,2,1,3,6,4,1,2,3,23
401402699,Vanderbilt Commodores,I. Moore,4433536,,True,40.0,5,12,2,4,3,8,5,5,2,4,6,4,0,1,5,3,18
401402699,Vanderbilt Commodores,J. Cambridge,4398773,,True,39.0,5,11,5,10,0,1,3,4,6,9,15,10,4,0,7,2,13
401402699,Vanderbilt Commodores,Y. Chambers,4433659,,False,14.0,1,2,1,2,0,0,1,1,2,2,4,1,1,1,1,5,3
401402699,Vanderbilt Commodores,D. Flournoy,4683036,,False,2.0,0,2,0,1,0,1,0,0,1,0,1,0,0,0,2,0,0
401402699,Vanderbilt Commodores,D. Washington,4433002,,False,16.0,6,11,6,11,0,0,0,0,3,2,5,0,0,0,2,2,12
401402699,Vanderbilt Commodores,TEAM,TOTAL,TOTAL,False,,31,71,23,52,8,19,15,17,24,25,49,23,11,5,21,21,85
401402699,Texas A&M Aggies,A. Patty,4398939,,True,26.0,5,8,5,8,0,0,0,0,4,5,9,0,0,2,1,3,10
401402699,Texas A&M Aggies,S. Roby,4433325,,True,15.0,2,5,2,5,0,0,4,5,1,1,2,0,0,2,1,4,8
401402699,Texas A&M Aggies,J. Nixon,4398715,,True,30.0,0,10,0,5,0,5,0,0,0,3,3,6,3,0,4,3,0
401402699,Texas A&M Aggies,Q. Hoppie,4281375,,True,37.0,1,7,1,5,0,2,2,4,0,1,1,5,1,0,4,2,4
401402699,Texas A&M Aggies,K. Wells,4280893,,True,27.0,7,11,7,9,0,2,6,6,1,0,1,2,0,0,1,2,20
401402699,Texas A&M Aggies,M. Johnson,4571937,,False,7.0,0,2,0,2,0,0,1,2,1,1,2,0,0,0,0,1,1
401402699,Texas A&M Aggies,J. Malone,4433526,,False,3.0,0,0,0,0,0,0,0,0,1,0,1,0,0,0,1,0,0
401402699,Texas A&M Aggies,E. Kindred,4682637,,False,1.0,0,1,0,1,0,0,0,0,0,1,1,1,0,0,0,0,0
401402699,Texas A&M Aggies,K. Green,4704601,,False,1.0,0,0,0,0,0,0,0,0,0,0,0,0,0,0,1,0,0
401402699,Texas A&M Aggies,S. Jones,4433759,,False,7.0,1,2,1,2,0,0,0,0,0,0,0,0,0,0,0,1,2
401402699,Texas A&M Aggies,M. Green,4432985,,False,11.0,0,2,0,2,0,0,0,0,0,0,0,2,1,0,3,1,0
401402699,Texas A&M Aggies,D. Pitts,4285010,,False,35.0,6,11,2,3,4,8,8,8,2,2,4,1,0,1,0,4,24
401402699,Texas A&M Aggies,TEAM,TOTAL,TOTAL,False,,22,59,18,42,4,17,21,25,14,16,30,17,5,5,18,21,69
401402698,Bucknell Bison,I. King,4900533,,True,36.0,1,4,0,1,1,3,0,0,0,2,2,1,1,0,0,2,3
401402698,Bucknell Bison,E. Shaffer,4595535,,True,28.0,4,7,4,7,0,0,4,5,6,6,12,1,0,1,2,1,12
401402698,Bucknell Bison,C. Collins,4900532,,True,40.0,3,8,3,6,0,2,1,2,0,2,2,1,0,1,0,3,7
401402698,Bucknell Bison,M. Walls,4400177,,True,39.0,5,13,5,12,0,1,0,0,3,4,7,2,3,0,3,3,10
401402698,Bucknell Bison,T. O'Brien,4400176,,True,37.0,7,21,6,15,1,6,5,6,0,3,3,0,3,2,4,4,20
401402698,Bucknell Bison,C. Krsul,4595534,,False,12.0,1,5,1,5,0,0,0,0,0,1,1,0,0,0,0,1,2
401402698,Bucknell Bison,R. Sisselman,4900531,,False,0.0,0,0,0,0,0,0,0,0,0,0,0,0,0,0,0,0,0
401402698,Bucknell Bison,J. Kulesza,4704702,,False,4.0,0,0,0,0,0,0,0,0,0,0,0,1,0,0,0,0,0
401402698,Bucknell Bison,T. Johnson,4595533,,False,3.0,0,0,0,0,0,0,0,0,0,0,0,0,0,0,0,0,0
401402698,Bucknell Bison,TEAM,TOTAL,TOTAL,False,,21,58,19,46,2,12,10,13,10,19,29,6,7,4,10,14,54
401402698,American University Eagles,L. Stack,4595455,,True,10.0,0,3,0,3,0,0,0,0,1,0,1,0,1,0,0,2,0
401402698,American University Eagles,T. Brown,4400157,,True,36.0,6,8,5,7,1,1,5,5,2,4,6,3,2,1,0,2,18
401402698,American University Eagles,I. Bales,4704685,,True,36.0,4,14,4,13,0,1,3,3,1,6,7,2,1,2,2,2,11
401402698,American University Eagles,J. Edwards,4400156,,True,39.0,8,12,7,9,1,3,4,4,0,4,4,4,0,2,5,2,21
401402698,American University Eagles,E. Fisher,4400155,,True,40.0,4,10,4,9,0,1,0,0,0,7,7,4,1,0,3,0,8
401402698,American University Eagles,E. Johns,4704688,,False,12.0,2,5,1,3,1,2,0,0,1,1,2,0,0,1,1,3,5
401402698,American University Eagles,R. DeRubbo,4703746,,False,15.0,1,2,1,2,0,0,0,0,2,1,3,0,0,0,0,0,2
401402698,American University Eagles,L. Graytok,4400159,,False,0.0,0,0,0,0,0,0,0,0,0,0,0,0,0,0,0,0,0
401402698,American University Eagles,M. Doring,4400158,,False,11.0,0,1,0,0,0,1,0,0,1,0,1,0,0,0,1,0,0
401402698,American University Eagles,TEAM,TOTAL,TOTAL,False,,25,55,22,46,3,9,12,12,9,27,36,13,5,6,15,11,65
401402697,Navy Midshipmen,C. Hertelendy,4400214,,True,23.0,2,4,2,4,0,0,0,2,2,3,5,2,0,0,1,2,4
401402697,Navy Midshipmen,L. Llewellyn,4595625,,True,31.0,1,6,0,3,1,3,2,2,0,4,4,1,2,1,2,3,5
401402697,Navy Midshipmen,S. Watts,4704782,,True,31.0,1,9,1,8,0,1,0,0,0,1,1,0,0,1,0,1,2
401402697,Navy Midshipmen,M. Schrader,4595622,,True,26.0,2,5,2,4,0,1,0,0,0,1,1,0,0,0,1,1,4
401402697,Navy Midshipmen,J. Coleman,4400211,,True,40.0,11,29,11,25,0,4,5,8,4,4,8,2,3,0,2,4,27
401402697,Navy Midshipmen,S. Lewis,4900553,,False,3.0,0,0,0,0,0,0,0,0,0,2,2,0,0,0,0,1,0
401402697,Navy Midshipmen,M. Andrews,4704780,,False,21.0,0,3,0,3,0,0,0,0,2,1,3,0,1,0,3,0,0
401402697,Navy Midshipmen,S. Schofield,4704779,,False,11.0,0,1,0,1,0,0,0,0,1,1,2,0,0,0,0,1,0
401402697,Navy Midshipmen,D. Langford,4400212,,False,14.0,0,0,0,0,0,0,2,2,0,0,0,0,3,2,0,2,2
401402697,Navy Midshipmen,TEAM,TOTAL,TOTAL,False,,17,57,16,48,1,9,9,14,10,18,28,5,9,4,10,15,44
401402697,Bucknell Bison,I. King,4900533,,True,22.0,3,6,0,1,3,5,0,0,1,2,3,0,0,0,2,1,9
401402697,Bucknell Bison,E. Shaffer,4595535,,True,13.0,2,4,2,4,0,0,2,2,1,5,6,1,1,0,1,1,6
401402697,Bucknell Bison,C. Collins,4900532,,True,37.0,2,5,1,3,1,2,0,0,1,7,8,8,1,0,2,0,5
401402697,Bucknell Bison,M. Walls,4400177,,True,28.0,2,7,2,5,0,2,4,4,1,5,6,3,0,0,2,4,8
401402697,Bucknell Bison,T. O'Brien,4400176,,True,33.0,7,17,5,11,2,6,5,5,0,3,3,0,3,0,2,1,21
401402697,Bucknell Bison,K. Reinbeau,4704700,,False,2.0,0,0,0,0,0,0,0,0,0,1,1,0,0,0,0,0,0
401402697,Bucknell Bison,C. Krsul,4595534,,False,25.0,2,7,2,7,0,0,2,3,4,6,10,4,1,1,0,3,6
401402697,Bucknell Bison,R. Sisselman,4900531,,False,11.0,1,2,1,2,0,0,0,0,0,1,1,1,0,0,3,0,2
401402697,Bucknell Bison,J. Kulesza,4704702,,False,18.0,1,4,0,0,1,4,0,0,1,0,1,0,0,0,0,1,3
401402697,Bucknell Bison,T. Johnson,4595533,,False,7.0,2,2,2,2,0,0,0,0,0,0,0,0,0,0,1,0,4
401402697,Bucknell Bison,C. Dingler,4577540,,False,4.0,0,0,0,0,0,0,0,0,0,1,1,0,0,1,1,0,0
401402697,Bucknell Bison,TEAM,TOTAL,TOTAL,False,,22,54,15,35,7,19,13,14,13,32,45,17,6,2,17,11,64
401402696,Boston University Terriers,C. Weimar,4704495,,True,25.0,4,9,4,9,0,0,0,2,4,3,7,1,0,2,5,2,8
401402696,Boston University Terriers,M. Durant,4599732,,True,31.0,4,5,4,5,0,0,4,6,5,3,8,0,0,1,4,3,12
401402696,Boston University Terriers,A. Giannaros,4899717,,True,25.0,2,4,1,2,1,2,0,0,0,2,2,2,0,0,7,5,5
401402696,Boston University Terriers,S. Johnson,4599729,,True,30.0,4,14,4,13,0,1,5,5,0,3,3,2,2,0,1,5,13
401402696,Boston University Terriers,L. Shean,4599727,,True,24.0,0,4,0,1,0,3,0,0,0,2,2,1,0,1,0,2,0
401402696,Boston University Terriers,R. Childs,4400174,,False,19.0,0,3,0,2,0,1,1,2,0,4,4,0,2,1,2,5,1
401402696,Boston University Terriers,C. Tibbitt,4400172,,False,6.0,0,1,0,0,0,1,0,0,0,1,1,0,0,0,0,0,0
401402696,Boston University Terriers,S. Beneventine,4704699,,False,20.0,1,2,0,1,1,1,0,0,0,2,2,1,1,0,1,0,3
401402696,Boston University Terriers,M. Pina,4599731,,False,20.0,2,6,1,2,1,4,1,2,0,1,1,0,0,0,1,1,6
401402696,Boston University Terriers,TEAM,TOTAL,TOTAL,False,,17,48,14,35,3,13,11,17,10,25,35,7,5,5,21,23,48
401402696,American University Eagles,L. Stack,4595455,,True,13.0,1,3,1,2,0,1,0,0,3,1,4,0,2,0,1,5,2
401402696,American University Eagles,T. Brown,4400157,,True,37.0,4,8,4,5,0,3,1,2,0,1,1,3,4,0,2,3,9
401402696,American University Eagles,I. Bales,4704685,,True,25.0,1,4,1,3,0,1,0,0,0,3,3,2,1,1,3,4,2
401402696,American University Eagles,J. Edwards,4400156,,True,28.0,2,5,2,4,0,1,3,3,0,4,4,3,0,1,1,4,7
401402696,American University Eagles,E. Fisher,4400155,,True,33.0,6,10,4,5,2,5,11,14,2,3,5,4,1,0,3,1,25
401402696,American University Eagles,E. Johns,4704688,,False,12.0,4,6,4,6,0,0,0,2,1,1,2,0,1,0,0,3,8
401402696,American University Eagles,K. Vres,4595454,,False,12.0,1,8,0,3,1,5,0,0,0,2,2,1,0,0,0,1,3
401402696,American University Eagles,K. Henning,4704686,,False,7.0,1,6,0,5,1,1,2,2,0,1,1,0,0,0,0,0,5
401402696,American University Eagles,R. DeRubbo,4703746,,False,22.0,2,5,0,2,2,3,0,0,0,2,2,3,0,0,0,1,6
401402696,American University Eagles,L. Graytok,4400159,,False,1.0,0,0,0,0,0,0,0,0,0,0,0,0,0,0,0,0,0
401402696,American University Eagles,M. Doring,4400158,,False,10.0,1,1,0,0,1,1,0,0,1,0,1,0,0,0,0,2,3
401402696,American University Eagles,TEAM,TOTAL,TOTAL,False,,23,56,16,35,7,21,17,23,10,22,32,16,9,2,12,24,70
401402695,Lehigh Mountain Hawks,F. Hottinger,4595613,,True,20.0,5,7,4,6,1,1,0,0,1,4,5,0,0,0,5,5,11
401402695,Lehigh Mountain Hawks,E. Grothaus,4400201,,True,32.0,4,10,1,5,3,5,2,2,0,13,13,2,2,2,3,1,13
401402695,Lehigh Mountain Hawks,M. Kramer,4704762,,True,37.0,4,17,4,11,0,6,0,0,0,2,2,3,0,0,2,2,8
401402695,Lehigh Mountain Hawks,M. Walker,4400200,,True,26.0,2,7,2,4,0,3,1,2,0,5,5,4,0,0,1,3,5
401402695,Lehigh Mountain Hawks,C. Steele,4400198,,True,34.0,2,3,1,2,1,1,0,2,0,2,2,1,1,0,2,2,5
401402695,Lehigh Mountain Hawks,M. O'Brien,4900547,,False,19.0,2,6,2,4,0,2,1,2,3,6,9,0,0,1,2,0,5
401402695,Lehigh Mountain Hawks,J. Vargas-Bines,4900546,,False,0.0,0,0,0,0,0,0,0,0,0,0,0,0,0,0,0,0,0
401402695,Lehigh Mountain Hawks,K. Van Eps,4900545,,False,12.0,0,0,0,0,0,0,0,0,0,2,2,0,0,0,0,0,0
401402695,Lehigh Mountain Hawks,E. Stemmer,4900544,,False,1.0,0,1,0,1,0,0,0,0,0,0,0,0,0,0,0,1,0
401402695,Lehigh Mountain Hawks,M. Albrecht,4704763,,False,2.0,0,0,0,0,0,0,0,0,0,0,0,0,0,1,1,0,0
401402695,Lehigh Mountain Hawks,A. Harvey,4595612,,False,6.0,1,2,0,0,1,2,0,0,0,1,1,2,0,0,1,0,3
401402695,Lehigh Mountain Hawks,J. Behar,4433782,,False,11.0,1,4,0,0,1,4,0,0,0,2,2,0,0,2,0,1,3
401402695,Lehigh Mountain Hawks,TEAM,TOTAL,TOTAL,False,,21,57,14,33,7,24,4,8,6,38,44,12,3,6,17,15,53
401402695,Bucknell Bison,I. King,4900533,,True,32.0,7,11,2,2,5,9,0,0,0,4,4,0,1,0,0,1,19
401402695,Bucknell Bison,E. Shaffer,4595535,,True,12.0,2,5,2,5,0,0,1,2,2,1,3,1,1,0,1,0,5
401402695,Bucknell Bison,C. Collins,4900532,,True,38.0,3,8,1,3,2,5,2,4,1,5,6,4,0,1,2,2,10
401402695,Bucknell Bison,M. Walls,4400177,,True,38.0,0,7,0,5,0,2,0,2,1,5,6,1,2,1,3,3,0
401402695,Bucknell Bison,T. O'Brien,4400176,,True,40.0,3,17,3,15,0,2,3,4,1,7,8,2,4,2,1,2,9
401402695,Bucknell Bison,C. Krsul,4595534,,False,28.0,4,10,4,10,0,0,2,4,1,6,7,3,2,3,2,1,10
401402695,Bucknell Bison,R. Sisselman,4900531,,False,4.0,1,2,0,0,1,2,0,0,0,0,0,0,0,0,0,0,3
401402695,Bucknell Bison,J. Kulesza,4704702,,False,4.0,0,1,0,0,0,1,0,0,0,0,0,0,1,0,0,0,0
401402695,Bucknell Bison,T. Johnson,4595533,,False,4.0,0,2,0,0,0,2,0,0,1,0,1,0,0,0,0,0,0
401402695,Bucknell Bison,TEAM,TOTAL,TOTAL,False,,20,63,12,40,8,23,8,16,8,31,39,11,11,7,9,9,56
401402694,Navy Midshipmen,C. Hertelendy,4400214,,True,20.0,0,4,0,4,0,0,0,0,0,3,3,1,0,1,2,4,0
401402694,Navy Midshipmen,L. Llewellyn,4595625,,True,40.0,0,4,0,4,0,0,0,0,1,3,4,0,1,0,3,2,0
401402694,Navy Midshipmen,S. Watts,4704782,,True,32.0,5,13,3,6,2,7,1,2,1,2,3,2,1,0,1,1,13
401402694,Navy Midshipmen,K. Donza,4704781,,True,19.0,1,3,1,1,0,2,0,0,2,1,3,0,0,0,0,2,2
401402694,Navy Midshipmen,J. Coleman,4400211,,True,39.0,10,27,4,14,6,13,1,2,2,11,13,3,3,0,7,4,27
401402694,Navy Midshipmen,M. Andrews,4704780,,False,20.0,1,4,1,4,0,0,0,0,3,1,4,0,1,0,1,1,2
401402694,Navy Midshipmen,M. Schrader,4595622,,False,22.0,1,2,1,1,0,1,0,0,1,0,1,2,2,0,3,1,2
401402694,Navy Midshipmen,D. Langford,4400212,,False,8.0,2,3,2,3,0,0,0,0,0,1,1,0,1,0,1,0,4
401402694,Navy Midshipmen,TEAM,TOTAL,TOTAL,False,,20,60,12,37,8,23,2,4,12,24,36,8,9,1,19,15,50
401402694,Holy Cross Crusaders,J. Allen,4704714,,True,20.0,3,6,3,6,0,0,3,4,2,2,4,0,0,0,1,0,9
401402694,Holy Cross Crusaders,M. Demski,4400187,,True,27.0,2,5,2,3,0,2,0,2,2,2,4,0,1,0,3,2,4
401402694,Holy Cross Crusaders,B. Power-Cassidy,4704715,,True,30.0,2,3,2,2,0,1,2,4,3,4,7,3,1,0,3,2,6
401402694,Holy Cross Crusaders,A. Cross,4595975,,True,27.0,3,7,2,5,1,2,0,0,2,0,2,4,2,1,0,3,7
401402694,Holy Cross Crusaders,A. LaBarbera,4400186,,True,39.0,6,20,5,12,1,8,3,4,2,11,13,0,3,0,2,1,16
401402694,Holy Cross Crusaders,O. Ezemma,4400185,,False,22.0,3,6,3,6,0,0,0,1,2,3,5,0,2,0,3,1,6
401402694,Holy Cross Crusaders,G. Munt,4900537,,False,8.0,0,0,0,0,0,0,1,2,0,1,1,0,0,0,1,2,1
401402694,Holy Cross Crusaders,C. McCormack,4704716,,False,25.0,0,5,0,2,0,3,0,0,0,1,1,3,1,0,5,0,0
401402694,Holy Cross Crusaders,K. Petro,4400188,,False,2.0,0,0,0,0,0,0,0,0,0,0,0,0,0,0,1,1,0
401402694,Holy Cross Crusaders,TEAM,TOTAL,TOTAL,False,,19,52,17,36,2,16,9,17,13,28,41,10,10,1,19,12,49
401402693,Lafayette Leopards,N. Ganpo,4400195,,True,29.0,8,11,8,11,0,0,0,0,2,4,6,0,0,4,3,4,16
401402693,Lafayette Leopards,A. Antognoli,4900540,,True,39.0,6,15,5,12,1,3,0,0,1,4,5,3,2,0,0,0,13
401402693,Lafayette Leopards,M. Andrews,4704756,,True,28.0,2,12,2,10,0,2,1,1,1,2,3,0,2,1,1,5,5
401402693,Lafayette Leopards,J. Booth,4433381,,True,31.0,1,13,1,11,0,2,0,0,1,0,1,5,1,0,1,1,2
401402693,Lafayette Leopards,M. Wilson,4400197,,True,36.0,3,4,3,4,0,0,2,2,5,10,15,1,0,1,3,0,8
401402693,Lafayette Leopards,A. Evans,4704757,,False,10.0,0,1,0,1,0,0,0,0,1,2,3,0,0,0,0,0,0
401402693,Lafayette Leopards,K. Drummond,4704754,,False,1.0,0,0,0,0,0,0,0,0,0,0,0,0,0,0,0,2,0
401402693,Lafayette Leopards,C. Gallagher,4900542,,False,20.0,1,6,1,3,0,3,0,0,1,1,2,3,2,0,1,0,2
401402693,Lafayette Leopards,K. Favours,4900541,,False,6.0,1,1,1,1,0,0,0,0,0,0,0,0,0,0,1,0,2
401402693,Lafayette Leopards,TEAM,TOTAL,TOTAL,False,,22,63,21,53,1,10,3,3,13,24,37,12,7,6,10,12,48
401402693,American University Eagles,L. Stack,4595455,,True,13.0,2,4,2,4,0,0,0,0,1,2,3,0,0,1,0,1,4
401402693,American University Eagles,T. Brown,4400157,,True,33.0,2,7,2,6,0,1,0,0,2,1,3,5,1,1,2,0,4
401402693,American University Eagles,I. Bales,4704685,,True,20.0,0,2,0,2,0,0,0,0,1,3,4,4,1,1,3,0,0
401402693,American University Eagles,J. Edwards,4400156,,True,35.0,3,12,2,9,1,3,3,4,0,9,9,6,0,2,3,4,10
401402693,American University Eagles,E. Fisher,4400155,,True,37.0,4,7,3,4,1,3,1,1,1,7,8,2,1,0,2,3,10
401402693,American University Eagles,E. Johns,4704688,,False,21.0,6,12,6,11,0,1,2,3,3,2,5,0,1,0,1,0,14
401402693,American University Eagles,K. Vres,4595454,,False,5.0,0,1,0,0,0,1,0,0,0,0,0,0,0,0,0,0,0
401402693,American University Eagles,K. Henning,4704686,,False,3.0,0,0,0,0,0,0,0,0,0,1,1,0,0,0,0,1,0
401402693,American University Eagles,R. DeRubbo,4703746,,False,15.0,1,3,0,1,1,2,0,0,0,3,3,0,1,0,0,0,3
401402693,American University Eagles,M. Doring,4400158,,False,18.0,3,7,0,0,3,7,0,0,1,0,1,0,0,0,0,1,9
401402693,American University Eagles,TEAM,TOTAL,TOTAL,False,,21,55,15,37,6,18,6,8,10,28,38,17,5,5,12,10,54
401402692,Boston University Terriers,C. Weimar,4704495,,True,30.0,7,7,7,7,0,0,7,10,5,8,13,4,3,1,0,1,21
401402692,Boston University Terriers,M. Durant,4599732,,True,21.0,3,3,3,3,0,0,0,0,0,5,5,0,1,2,0,2,6
401402692,Boston University Terriers,A. Giannaros,4899717,,True,30.0,4,8,3,5,1,3,0,0,1,2,3,6,1,1,6,5,9
401402692,Boston University Terriers,S. Johnson,4599729,,True,35.0,3,12,3,9,0,3,4,4,0,1,1,3,3,0,2,4,10
401402692,Boston University Terriers,L. Shean,4599727,,True,28.0,5,13,0,2,5,11,0,0,0,2,2,2,0,0,0,3,15
401402692,Boston University Terriers,R. Childs,4400174,,False,22.0,4,8,2,4,2,4,0,0,0,6,6,2,0,2,3,0,10
401402692,Boston University Terriers,C. Tibbitt,4400172,,False,7.0,0,2,0,0,0,2,0,0,0,1,1,0,1,0,0,1,0
401402692,Boston University Terriers,S. Beneventine,4704699,,False,4.0,0,0,0,0,0,0,0,0,0,0,0,0,0,0,0,1,0
401402692,Boston University Terriers,M. Pina,4599731,,False,23.0,3,6,0,1,3,5,0,0,0,0,0,1,0,0,3,0,9
401402692,Boston University Terriers,TEAM,TOTAL,TOTAL,False,,29,59,18,31,11,28,11,14,6,26,32,18,9,6,14,17,80
401402692,Army Black Knights,S. Hunter,4595466,,True,25.0,4,10,4,10,0,0,2,4,6,5,11,2,1,0,1,5,10
401402692,Army Black Knights,L. Scamman,4400162,,True,12.0,0,4,0,2,0,2,2,2,0,2,2,0,1,0,1,3,2
401402692,Army Black Knights,S. McNaughton,4704694,,True,26.0,1,6,1,5,0,1,0,0,0,4,4,1,0,0,4,0,2
401402692,Army Black Knights,H. Brown,4595467,,True,30.0,2,7,2,6,0,1,2,6,4,1,5,2,2,0,1,1,6
401402692,Army Black Knights,A. Fallon,4400167,,True,39.0,14,21,11,15,3,6,6,7,1,7,8,2,0,0,2,3,37
401402692,Army Black Knights,K. Hall,4595465,,False,19.0,0,5,0,3,0,2,0,0,1,0,1,2,2,1,0,2,0
401402692,Army Black Knights,T. Sullivan,4400165,,False,11.0,3,3,3,3,0,0,0,0,0,1,1,0,0,0,1,1,6
401402692,Army Black Knights,K. Murray,4400163,,False,26.0,4,11,1,3,3,8,0,0,0,4,4,0,1,0,0,2,11
401402692,Army Black Knights,L. Lithgow,4704696,,False,9.0,0,0,0,0,0,0,0,0,0,0,0,0,0,0,1,2,0
401402692,Army Black Knights,N. Rhine,4595464,,False,3.0,0,1,0,0,0,1,0,0,0,0,0,0,1,0,0,0,0
401402692,Army Black Knights,TEAM,TOTAL,TOTAL,False,,28,68,22,47,6,21,12,19,12,24,36,9,8,1,11,19,74
401402691,Navy Midshipmen,C. Hertelendy,4400214,,True,23.0,0,4,0,4,0,0,3,4,2,1,3,2,1,0,0,5,3
401402691,Navy Midshipmen,L. Llewellyn,4595625,,True,29.0,4,10,3,7,1,3,1,2,1,4,5,0,0,1,1,5,10
401402691,Navy Midshipmen,S. Watts,4704782,,True,38.0,4,9,2,5,2,4,0,0,4,0,4,0,1,1,0,0,10
401402691,Navy Midshipmen,K. Donza,4704781,,True,28.0,2,6,1,2,1,4,1,2,3,4,7,0,0,0,0,1,6
401402691,Navy Midshipmen,J. Coleman,4400211,,True,40.0,10,21,8,17,2,4,7,10,2,7,9,8,2,0,3,3,29
401402691,Navy Midshipmen,M. Andrews,4704780,,False,10.0,1,1,1,1,0,0,0,0,0,0,0,0,1,0,2,3,2
401402691,Navy Midshipmen,M. Schrader,4595622,,False,23.0,0,5,0,4,0,1,0,0,2,1,3,1,0,0,1,1,0
401402691,Navy Midshipmen,D. Langford,4400212,,False,9.0,0,2,0,2,0,0,0,0,0,1,1,1,1,0,0,0,0
401402691,Navy Midshipmen,TEAM,TOTAL,TOTAL,False,,21,58,15,42,6,16,12,18,17,18,35,12,6,2,8,18,60
401402691,Colgate Raiders,T. McMillan,4704704,,True,32.0,2,5,2,5,0,0,0,0,3,3,6,3,0,2,1,3,4
401402691,Colgate Raiders,T. Golembiewski,4900535,,True,29.0,5,10,4,8,1,2,1,2,1,0,1,1,1,0,3,4,12
401402691,Colgate Raiders,M. McMahon,4900534,,True,30.0,2,8,2,4,0,4,1,1,1,4,5,0,0,0,2,2,5
401402691,Colgate Raiders,A. Brodie,4595550,,True,34.0,1,5,1,4,0,1,2,4,0,3,3,7,1,0,1,2,4
401402691,Colgate Raiders,T. Langan,4400179,,True,26.0,3,6,2,4,1,2,1,1,3,0,3,1,0,1,3,3,8
401402691,Colgate Raiders,S. Diehl,4900536,,False,31.0,8,10,5,6,3,4,3,3,0,12,12,0,0,0,0,3,22
401402691,Colgate Raiders,A. Naessens,4400181,,False,3.0,0,0,0,0,0,0,0,0,1,1,2,0,0,0,1,0,0
401402691,Colgate Raiders,J. Paul,4595552,,False,15.0,0,3,0,1,0,2,0,0,0,1,1,0,0,0,1,1,0
401402691,Colgate Raiders,TEAM,TOTAL,TOTAL,False,,21,47,16,32,5,15,8,11,10,25,35,12,2,3,14,18,55
401402690,Loyola Maryland Greyhounds,C. Roberts,4704777,,True,24.0,3,7,3,7,0,0,0,0,3,1,4,0,0,0,1,0,6
401402690,Loyola Maryland Greyhounds,B. Rozzi,4596306,,True,36.0,6,11,3,5,3,6,1,1,1,4,5,4,0,0,0,3,16
401402690,Loyola Maryland Greyhounds,T. Dixon,4400209,,True,33.0,2,12,2,5,0,7,3,4,0,2,2,1,1,0,1,4,7
401402690,Loyola Maryland Greyhounds,L. Edwards,4400208,,True,25.0,0,4,0,2,0,2,1,2,2,1,3,2,0,0,2,3,1
401402690,Loyola Maryland Greyhounds,D. Newman,4399474,,True,30.0,5,11,4,8,1,3,2,2,1,4,5,2,1,1,2,1,13
401402690,Loyola Maryland Greyhounds,E. McAteer,4596305,,False,18.0,1,3,0,2,1,1,1,2,0,1,1,0,1,0,0,2,4
401402690,Loyola Maryland Greyhounds,E. Glezen,4596304,,False,8.0,1,2,1,2,0,0,0,0,0,0,0,0,1,0,0,2,2
401402690,Loyola Maryland Greyhounds,K. Douglas,4900551,,False,14.0,0,1,0,0,0,1,0,0,0,0,0,1,1,0,2,1,0
401402690,Loyola Maryland Greyhounds,B. Steidle,4704776,,False,0.0,0,0,0,0,0,0,0,0,0,0,0,0,0,0,0,0,0
401402690,Loyola Maryland Greyhounds,C. Tanedo,4704774,,False,12.0,0,1,0,0,0,1,0,0,0,1,1,1,1,0,1,1,0
401402690,Loyola Maryland Greyhounds,TEAM,TOTAL,TOTAL,False,,18,52,13,31,5,21,8,11,8,15,23,11,6,1,11,17,49
401402690,Lafayette Leopards,N. Ganpo,4400195,,True,33.0,4,7,4,7,0,0,0,0,3,6,9,1,0,0,2,3,8
401402690,Lafayette Leopards,A. Antognoli,4900540,,True,34.0,9,11,7,8,2,3,2,4,0,3,3,3,3,0,2,0,22
401402690,Lafayette Leopards,M. Andrews,4704756,,True,32.0,3,9,2,7,1,2,0,0,1,3,4,0,1,0,4,3,7
401402690,Lafayette Leopards,J. Booth,4433381,,True,27.0,2,7,2,6,0,1,1,2,0,2,2,6,1,1,3,2,5
401402690,Lafayette Leopards,M. Wilson,4400197,,True,32.0,2,3,2,3,0,0,0,2,2,5,7,0,0,2,4,3,4
401402690,Lafayette Leopards,A. Evans,4704757,,False,4.0,0,0,0,0,0,0,0,0,1,1,2,0,0,0,0,0,0
401402690,Lafayette Leopards,K. Drummond,4704754,,False,0.0,0,0,0,0,0,0,0,0,0,0,0,0,0,0,0,0,0
401402690,Lafayette Leopards,C. Gallagher,4900542,,False,29.0,4,4,1,1,3,3,1,2,1,1,2,0,1,0,0,1,12
401402690,Lafayette Leopards,K. Favours,4900541,,False,9.0,0,3,0,0,0,3,0,0,0,1,1,0,0,0,0,0,0
401402690,Lafayette Leopards,TEAM,TOTAL,TOTAL,False,,24,44,18,32,6,12,4,10,8,26,34,10,6,3,17,12,58
401402661,Utah Utes,J. Johnson,4898900,,True,17.0,1,9,1,6,0,3,0,0,1,2,3,1,0,0,1,2,2
401402661,Utah Utes,K. Rees,4703603,,True,33.0,3,8,3,7,0,1,2,4,2,8,10,1,0,0,1,3,8
401402661,Utah Utes,K. McQueen,4898901,,True,27.0,2,5,2,2,0,3,0,0,0,2,2,0,0,0,1,0,4
401402661,Utah Utes,G. Kneepkens,4898898,,True,24.0,1,6,0,3,1,3,0,0,1,4,5,1,0,0,3,2,3
401402661,Utah Utes,D. Gylten,4282178,,True,32.0,2,5,0,2,2,3,0,0,0,1,1,5,0,2,2,1,6
401402661,Utah Utes,D. Young,4595931,,False,30.0,2,7,0,2,2,5,3,4,0,1,1,1,0,0,3,2,9
401402661,Utah Utes,I. Vieira,4898897,,False,8.0,0,1,0,1,0,0,0,0,1,0,1,0,0,0,0,0,0
401402661,Utah Utes,I. Palmer,4594751,,False,2.0,0,0,0,0,0,0,0,0,0,0,0,0,0,0,0,0,0
401402661,Utah Utes,B. Maxwell,4433675,,False,27.0,6,12,3,6,3,6,1,1,0,0,0,0,0,1,0,1,16
401402661,Utah Utes,TEAM,TOTAL,TOTAL,False,,17,53,9,29,8,24,6,9,7,23,30,9,0,3,12,11,48
401402661,Stanford Cardinal,C. Brink,4433404,,True,18.0,8,12,8,10,0,2,0,0,0,4,4,0,1,4,2,4,16
401402661,Stanford Cardinal,H. Jones,4595910,,True,33.0,6,15,3,11,3,4,4,4,0,6,6,4,2,2,3,3,19
401402661,Stanford Cardinal,La. Hull,4398830,,True,31.0,2,5,0,0,2,5,0,0,2,4,6,4,0,0,1,3,6
401402661,Stanford Cardinal,Le. Hull,4398829,,True,32.0,6,12,4,9,2,3,1,1,2,3,5,3,1,0,0,1,15
401402661,Stanford Cardinal,A. Wilson,4066545,,True,38.0,2,5,2,3,0,2,1,2,0,4,4,3,0,1,0,1,5
401402661,Stanford Cardinal,K. Iriafen,4898384,,False,4.0,0,1,0,1,0,0,0,0,0,1,1,1,0,0,0,1,0
401402661,Stanford Cardinal,A. Prechtel,4433634,,False,3.0,0,0,0,0,0,0,0,0,0,1,1,1,0,0,0,0,0
401402661,Stanford Cardinal,F. Belibi,4432843,,False,14.0,4,6,4,6,0,0,1,3,3,4,7,2,0,1,0,0,9
401402661,Stanford Cardinal,A. Jerome,4282165,,False,2.0,0,0,0,0,0,0,0,0,0,0,0,0,0,0,0,0,0
401402661,Stanford Cardinal,B. Demetre,4433513,,False,2.0,0,1,0,1,0,0,0,0,0,1,1,0,0,0,0,0,0
401402661,Stanford Cardinal,E. Bosgana,4705410,,False,2.0,0,0,0,0,0,0,0,0,0,0,0,0,0,0,0,0,0
401402661,Stanford Cardinal,A. Emma-Nnopu,4703591,,False,4.0,0,2,0,1,0,1,0,0,1,0,1,0,1,0,0,0,0
401402661,Stanford Cardinal,J. Van Gytenbeek,4433434,,False,2.0,0,1,0,1,0,0,0,0,0,0,0,0,0,0,0,1,0
401402661,Stanford Cardinal,H. Jump,4432868,,False,15.0,1,3,0,1,1,2,0,0,1,0,1,0,0,0,0,1,3
401402661,Stanford Cardinal,TEAM,TOTAL,TOTAL,False,,29,63,21,44,8,19,7,10,11,30,41,18,5,8,6,15,73
401402660,Utah Utes,J. Johnson,4898900,,True,26.0,5,11,4,9,1,2,2,2,2,2,4,1,0,2,4,5,13
401402660,Utah Utes,K. Rees,4703603,,True,31.0,4,7,4,7,0,0,6,8,4,4,8,0,0,1,0,2,14
401402660,Utah Utes,K. McQueen,4898901,,True,33.0,3,10,1,1,2,9,5,7,2,9,11,3,0,1,2,2,13
401402660,Utah Utes,G. Kneepkens,4898898,,True,29.0,6,15,3,8,3,7,9,10,1,6,7,5,1,0,1,2,24
401402660,Utah Utes,D. Gylten,4282178,,True,30.0,1,4,1,3,0,1,1,1,1,2,3,5,2,0,0,2,3
401402660,Utah Utes,D. Young,4595931,,False,22.0,2,5,1,2,1,3,0,0,3,0,3,2,1,0,2,2,5
401402660,Utah Utes,I. Vieira,4898897,,False,11.0,1,3,1,2,0,1,0,0,2,0,2,1,0,0,0,1,2
401402660,Utah Utes,I. Palmer,4594751,,False,3.0,0,1,0,0,0,1,0,0,0,0,0,0,0,0,0,0,0
401402660,Utah Utes,B. Maxwell,4433675,,False,15.0,2,7,0,0,2,7,0,0,0,1,1,0,0,0,2,1,6
401402660,Utah Utes,TEAM,TOTAL,TOTAL,False,,24,63,15,32,9,31,23,28,16,28,44,17,4,4,12,17,80
401402660,Oregon Ducks,N. Sabally,4398768,,True,17.0,3,8,3,8,0,0,6,8,5,7,12,0,1,3,3,5,12
401402660,Oregon Ducks,S. Prince,4398986,,True,28.0,6,11,6,11,0,0,0,0,4,1,5,1,1,2,1,2,12
401402660,Oregon Ducks,E. Rogers,4433640,,True,35.0,5,16,3,11,2,5,3,4,0,2,2,3,2,1,1,4,15
401402660,Oregon Ducks,T. Paopao,4433431,,True,35.0,7,18,6,15,1,3,2,2,0,4,4,4,0,0,1,3,17
401402660,Oregon Ducks,S. Parrish,4433414,,True,31.0,3,9,1,3,2,6,0,0,1,2,3,2,0,1,1,4,8
401402660,Oregon Ducks,C. Pinto,4898390,,False,1.0,0,0,0,0,0,0,0,0,0,0,0,0,0,0,0,2,0
401402660,Oregon Ducks,K. Watson,4433735,,False,21.0,3,4,3,4,0,0,0,0,3,3,6,2,0,0,1,1,6
401402660,Oregon Ducks,T. Hosendove,4398574,,False,0.0,0,0,0,0,0,0,0,0,0,0,0,0,0,0,0,0,0
401402660,Oregon Ducks,S. Dufficy,4068417,,False,0.0,0,0,0,0,0,0,0,0,0,0,0,0,0,0,0,0,0
401402660,Oregon Ducks,P. Kyei,4898391,,False,3.0,0,0,0,0,0,0,0,2,1,0,1,0,0,1,0,0,0
401402660,Oregon Ducks,M. Scherr,4433420,,False,24.0,0,2,0,1,0,1,0,0,1,4,5,3,2,0,0,1,0
401402660,Oregon Ducks,A. Hurst,4400147,,False,5.0,1,3,0,1,1,2,0,0,0,0,0,0,0,0,0,0,3
401402660,Oregon Ducks,TEAM,TOTAL,TOTAL,False,,28,71,22,54,6,17,11,16,18,25,43,15,6,8,8,22,73
401402659,Stanford Cardinal,C. Brink,4433404,,True,28.0,6,10,5,9,1,1,1,1,2,7,9,0,4,2,0,4,14
401402659,Stanford Cardinal,H. Jones,4595910,,True,34.0,6,14,5,13,1,1,4,4,3,1,4,3,0,1,5,1,17
401402659,Stanford Cardinal,La. Hull,4398830,,True,31.0,1,6,1,4,0,2,2,2,2,3,5,5,2,2,1,3,4
401402659,Stanford Cardinal,Le. Hull,4398829,,True,26.0,4,8,3,6,1,2,0,0,0,1,1,2,2,0,3,4,9
401402659,Stanford Cardinal,A. Wilson,4066545,,True,25.0,4,6,2,2,2,4,2,2,0,2,2,0,1,1,3,2,12
401402659,Stanford Cardinal,K. Iriafen,4898384,,False,7.0,1,2,1,2,0,0,0,0,0,1,1,0,0,0,0,0,2
401402659,Stanford Cardinal,A. Prechtel,4433634,,False,16.0,2,3,0,0,2,3,0,0,0,4,4,0,0,1,0,1,6
401402659,Stanford Cardinal,F. Belibi,4432843,,False,11.0,2,5,2,5,0,0,0,0,1,2,3,1,0,1,2,0,4
401402659,Stanford Cardinal,A. Jerome,4282165,,False,1.0,0,0,0,0,0,0,0,0,0,0,0,0,0,0,0,0,0
401402659,Stanford Cardinal,B. Demetre,4433513,,False,2.0,0,0,0,0,0,0,0,0,0,0,0,0,0,0,0,0,0
401402659,Stanford Cardinal,E. Bosgana,4705410,,False,2.0,1,1,1,1,0,0,1,2,0,0,0,1,2,0,0,0,3
401402659,Stanford Cardinal,A. Emma-Nnopu,4703591,,False,6.0,0,0,0,0,0,0,0,0,0,0,0,0,0,0,0,1,0
401402659,Stanford Cardinal,J. Van Gytenbeek,4433434,,False,5.0,0,0,0,0,0,0,0,0,0,0,0,0,0,0,0,0,0
401402659,Stanford Cardinal,H. Jump,4432868,,False,6.0,0,1,0,1,0,0,0,0,0,0,0,0,0,0,0,0,0
401402659,Stanford Cardinal,TEAM,TOTAL,TOTAL,False,,27,56,20,43,7,13,10,11,10,22,32,12,11,8,14,16,71
401402659,Colorado Buffaloes,P. Tuitele,4595865,,True,22.0,1,5,1,3,0,2,0,0,4,2,6,0,1,0,1,2,2
401402659,Colorado Buffaloes,M. Hollingshed,4281923,,True,38.0,3,5,2,2,1,3,0,1,4,6,10,2,2,0,5,2,7
401402659,Colorado Buffaloes,F. Formann,4703586,,True,32.0,3,10,2,4,1,6,0,0,1,1,2,2,0,1,2,2,7
401402659,Colorado Buffaloes,J. Sherrod,4433386,,True,30.0,1,5,1,4,0,1,8,10,0,3,3,1,0,0,5,4,10
401402659,Colorado Buffaloes,L. Finau,4398760,,True,11.0,1,4,1,3,0,1,0,0,0,0,0,0,1,0,0,0,2
401402659,Colorado Buffaloes,Q. Miller,4433122,,False,18.0,0,4,0,2,0,2,2,2,1,1,2,2,4,2,4,1,2
401402659,Colorado Buffaloes,K. Blacksten,4703587,,False,5.0,0,2,0,1,0,1,0,0,1,0,1,0,0,0,1,0,0
401402659,Colorado Buffaloes,K. Wetta,4691704,,False,32.0,5,10,4,6,1,4,1,2,0,4,4,0,1,0,1,4,12
401402659,Colorado Buffaloes,T. Jones,4399353,,False,12.0,1,4,0,3,1,1,0,0,0,1,1,0,0,0,2,1,3
401402659,Colorado Buffaloes,TEAM,TOTAL,TOTAL,False,,15,49,11,28,4,21,11,15,14,19,33,7,9,3,22,16,45
401402658,Washington State Cougars,B. Murekatete,4433392,,True,25.0,7,13,7,13,0,0,4,4,3,2,5,1,1,2,0,3,18
401402658,Washington State Cougars,T. Wallack,4899070,,True,34.0,6,10,4,7,2,3,2,2,2,4,6,2,0,2,0,1,16
401402658,Washington State Cougars,J. Teder,4703611,,True,29.0,2,8,1,2,1,6,0,0,0,1,1,4,1,0,4,3,5
401402658,Washington State Cougars,C. Leger-Walker,4703609,,True,37.0,2,12,2,7,0,5,2,2,0,2,2,7,0,1,2,1,6
401402658,Washington State Cougars,K. Leger-Walker,4068719,,True,39.0,2,12,2,7,0,5,0,0,0,2,2,3,4,0,1,0,4
401402658,Washington State Cougars,J. Clarke,4600595,,False,11.0,2,4,2,4,0,0,0,0,0,2,2,0,0,0,1,3,4
401402658,Washington State Cougars,K. Woods,4912696,,False,0.0,0,0,0,0,0,0,0,0,0,0,0,0,0,0,0,0,0
401402658,Washington State Cougars,G. Sarver,4595924,,False,12.0,0,0,0,0,0,0,0,0,0,3,3,0,0,0,0,0,0
401402658,Washington State Cougars,M. Jones,4398887,,False,13.0,2,3,0,0,2,3,0,0,1,1,2,0,1,0,0,2,6
401402658,Washington State Cougars,TEAM,TOTAL,TOTAL,False,,23,62,18,40,5,22,8,8,10,22,32,17,7,5,8,13,59
401402658,Utah Utes,J. Johnson,4898900,,True,22.0,7,11,5,7,2,4,3,4,1,2,3,1,1,1,0,2,19
401402658,Utah Utes,K. Rees,4703603,,True,30.0,4,4,4,4,0,0,0,0,2,6,8,2,0,2,2,3,8
401402658,Utah Utes,K. McQueen,4898901,,True,22.0,3,8,1,3,2,5,0,0,1,3,4,0,0,1,0,1,8
401402658,Utah Utes,G. Kneepkens,4898898,,True,21.0,3,5,2,4,1,1,2,2,2,4,6,0,0,1,0,0,9
401402658,Utah Utes,D. Gylten,4282178,,True,18.0,0,1,0,0,0,1,0,0,0,2,2,2,0,0,4,0,0
401402658,Utah Utes,D. Young,4595931,,False,23.0,0,5,0,2,0,3,0,0,1,3,4,1,1,0,1,1,0
401402658,Utah Utes,P. McFarland,4582913,,False,5.0,1,2,1,2,0,0,0,0,0,0,0,1,0,0,0,0,2
401402658,Utah Utes,I. Vieira,4898897,,False,22.0,1,5,0,3,1,2,0,0,1,0,1,2,1,0,1,3,3
401402658,Utah Utes,I. Palmer,4594751,,False,17.0,2,6,0,2,2,4,4,4,0,2,2,0,0,0,3,1,10
401402658,Utah Utes,B. Maxwell,4433675,,False,20.0,3,10,2,5,1,5,4,4,0,4,4,2,1,0,0,0,11
401402658,Utah Utes,TEAM,TOTAL,TOTAL,False,,24,57,15,32,9,25,13,14,12,29,41,11,4,5,14,11,70
401402657,UCLA Bruins,I. Thomas,4281072,,True,34.0,8,15,6,11,2,4,0,1,2,3,5,0,1,0,0,2,18
401402657,UCLA Bruins,C. Osborne,4433293,,True,39.0,2,13,1,8,1,5,0,0,2,5,7,8,0,0,4,2,5
401402657,UCLA Bruins,C. Horvat,4282171,,True,25.0,1,2,0,1,1,1,0,0,1,3,4,1,2,0,0,2,3
401402657,UCLA Bruins,J. Penn,4281259,,True,35.0,7,17,3,10,4,7,0,0,0,2,2,0,1,0,0,1,18
401402657,UCLA Bruins,N. Chou,4066562,,True,22.0,2,9,0,3,2,6,0,0,0,0,0,1,1,0,0,2,6
401402657,UCLA Bruins,I. Anstey,4599500,,False,6.0,1,3,1,3,0,0,0,0,0,1,1,0,0,0,0,2,2
401402657,UCLA Bruins,Dugalic,4433411,,False,23.0,2,5,2,4,0,1,2,3,1,3,4,4,0,0,0,0,6
401402657,UCLA Bruins,C. Brown,4595911,,False,11.0,0,1,0,1,0,0,0,0,3,1,4,2,0,0,0,1,0
401402657,UCLA Bruins,K. Owens,4282172,,False,5.0,1,2,1,2,0,0,0,0,3,2,5,0,0,0,1,2,2
401402657,UCLA Bruins,TEAM,TOTAL,TOTAL,False,,24,67,14,43,10,24,2,4,13,22,35,16,5,0,5,14,60
401402657,Oregon Ducks,N. Sabally,4398768,,True,38.0,6,9,6,9,0,0,3,6,1,14,15,2,0,3,1,2,15
401402657,Oregon Ducks,S. Prince,4398986,,True,33.0,5,11,5,11,0,0,2,2,6,6,12,2,2,1,0,0,12
401402657,Oregon Ducks,E. Rogers,4433640,,True,37.0,4,13,2,8,2,5,6,6,0,4,4,6,1,0,2,1,16
401402657,Oregon Ducks,T. Paopao,4433431,,True,35.0,4,13,3,9,1,4,0,0,0,3,3,5,2,0,2,1,9
401402657,Oregon Ducks,S. Parrish,4433414,,True,30.0,2,7,0,1,2,6,0,0,0,4,4,1,0,0,1,2,6
401402657,Oregon Ducks,C. Pinto,4898390,,False,4.0,0,1,0,0,0,1,1,2,1,1,2,0,0,0,0,0,1
401402657,Oregon Ducks,K. Watson,4433735,,False,8.0,0,0,0,0,0,0,1,2,0,0,0,0,0,0,0,2,1
401402657,Oregon Ducks,P. Kyei,4898391,,False,2.0,0,0,0,0,0,0,0,0,0,0,0,0,0,0,0,0,0
401402657,Oregon Ducks,M. Scherr,4433420,,False,7.0,0,0,0,0,0,0,0,0,0,0,0,0,0,0,0,1,0
401402657,Oregon Ducks,A. Hurst,4400147,,False,6.0,1,1,0,0,1,1,0,0,0,0,0,0,0,0,0,0,3
401402657,Oregon Ducks,TEAM,TOTAL,TOTAL,False,,22,55,16,38,6,17,13,18,13,32,45,16,5,4,7,9,63
401402656,Stanford Cardinal,C. Brink,4433404,,True,23.0,4,8,2,6,2,2,0,2,1,5,6,1,1,2,0,1,10
401402656,Stanford Cardinal,H. Jones,4595910,,True,32.0,9,21,9,21,0,0,2,2,1,13,14,6,0,1,1,0,20
401402656,Stanford Cardinal,La. Hull,4398830,,True,27.0,0,0,0,0,0,0,1,2,1,1,2,2,0,0,1,3,1
401402656,Stanford Cardinal,Le. Hull,4398829,,True,32.0,2,7,0,4,2,3,0,0,1,4,5,2,1,0,0,4,6
401402656,Stanford Cardinal,A. Wilson,4066545,,True,37.0,4,9,1,3,3,6,0,0,0,2,2,0,3,2,0,1,11
401402656,Stanford Cardinal,K. Iriafen,4898384,,False,6.0,2,3,2,3,0,0,0,0,0,0,0,2,0,0,1,0,4
401402656,Stanford Cardinal,A. Prechtel,4433634,,False,4.0,0,2,0,1,0,1,0,0,0,1,1,0,0,0,0,0,0
401402656,Stanford Cardinal,F. Belibi,4432843,,False,8.0,1,3,1,3,0,0,0,2,2,1,3,1,1,0,0,0,2
401402656,Stanford Cardinal,A. Jerome,4282165,,False,5.0,0,0,0,0,0,0,0,0,0,0,0,0,0,0,0,1,0
401402656,Stanford Cardinal,B. Demetre,4433513,,False,3.0,0,2,0,0,0,2,0,0,0,1,1,0,0,0,0,1,0
401402656,Stanford Cardinal,A. Emma-Nnopu,4703591,,False,10.0,0,1,0,1,0,0,0,0,2,1,3,0,0,0,0,1,0
401402656,Stanford Cardinal,J. Van Gytenbeek,4433434,,False,2.0,0,1,0,0,0,1,0,0,0,0,0,0,0,0,0,0,0
401402656,Stanford Cardinal,H. Jump,4432868,,False,10.0,1,4,0,1,1,3,0,0,0,0,0,0,0,0,0,1,3
401402656,Stanford Cardinal,J. Hamilton,4281239,,False,1.0,0,0,0,0,0,0,0,0,0,0,0,0,0,0,0,0,0
401402656,Stanford Cardinal,TEAM,TOTAL,TOTAL,False,,23,61,15,43,8,18,3,8,10,29,39,14,6,5,3,13,57
401402656,Oregon State Beavers,T. Corosdale,4282159,,True,23.0,0,1,0,0,0,1,1,2,3,7,10,1,0,1,2,1,1
401402656,Oregon State Beavers,K. Brown,4433291,,True,27.0,1,7,1,6,0,1,0,0,0,3,3,4,0,0,1,1,2
401402656,Oregon State Beavers,T. von Oelhoffen,4713193,,True,30.0,3,15,1,10,2,5,2,2,1,2,3,2,0,0,2,1,10
401402656,Oregon State Beavers,G. Kampschroeder,4433796,,True,30.0,1,6,1,4,0,2,0,0,0,1,1,1,0,0,0,0,2
401402656,Oregon State Beavers,E. Codding,4282102,,True,27.0,5,8,2,5,3,3,0,0,0,3,3,0,1,0,1,0,13
401402656,Oregon State Beavers,J. Mitrovic,4595897,,False,6.0,0,2,0,1,0,1,0,0,0,3,3,0,0,1,1,0,0
401402656,Oregon State Beavers,E. Mack,4068241,,False,31.0,5,11,4,7,1,4,2,2,1,8,9,1,0,3,1,2,13
401402656,Oregon State Beavers,A. Marotte,4691697,,False,11.0,0,0,0,0,0,0,0,0,1,0,1,0,0,0,1,1,0
401402656,Oregon State Beavers,N. Mannen,4595896,,False,8.0,1,3,0,0,1,3,0,0,0,0,0,0,0,0,0,2,3
401402656,Oregon State Beavers,T. Adams,4281876,,False,7.0,0,1,0,1,0,0,0,0,0,1,1,0,0,0,0,0,0
401402656,Oregon State Beavers,TEAM,TOTAL,TOTAL,False,,16,54,9,34,7,20,5,6,10,31,41,9,1,5,12,8,44
401402655,Colorado Buffaloes,P. Tuitele,4595865,,True,32.0,1,7,1,5,0,2,4,4,3,2,5,0,0,2,3,3,6
401402655,Colorado Buffaloes,M. Hollingshed,4281923,,True,36.0,5,10,3,6,2,4,0,0,3,6,9,0,0,2,1,4,12
401402655,Colorado Buffaloes,F. Formann,4703586,,True,21.0,3,6,1,3,2,3,0,0,1,0,1,1,0,0,3,3,8
401402655,Colorado Buffaloes,J. Sherrod,4433386,,True,29.0,3,7,2,4,1,3,1,4,0,1,1,3,2,0,5,2,8
401402655,Colorado Buffaloes,L. Finau,4398760,,True,28.0,0,2,0,1,0,1,2,2,1,0,1,1,1,0,2,1,2
401402655,Colorado Buffaloes,Q. Miller,4433122,,False,12.0,1,3,1,2,0,1,1,2,1,2,3,1,1,0,0,1,3
401402655,Colorado Buffaloes,K. Wetta,4691704,,False,30.0,2,8,2,5,0,3,2,2,0,8,8,4,3,0,3,4,6
401402655,Colorado Buffaloes,T. Jones,4399353,,False,12.0,0,3,0,3,0,0,0,0,0,2,2,0,0,0,1,1,0
401402655,Colorado Buffaloes,TEAM,TOTAL,TOTAL,False,,15,46,10,29,5,17,10,14,14,24,38,10,7,4,21,19,45
401402655,Arizona Wildcats,L. Ware,4433422,,True,35.0,3,7,3,7,0,0,9,10,3,5,8,1,1,2,6,4,15
401402655,Arizona Wildcats,S. Thomas,4281914,,True,37.0,1,8,0,0,1,8,0,0,0,1,1,1,0,2,3,1,3
401402655,Arizona Wildcats,S. Pellington,4601922,,True,28.0,3,8,2,3,1,5,2,2,0,1,1,0,2,0,0,4,9
401402655,Arizona Wildcats,H. Pueyo,4598223,,True,30.0,1,6,1,3,0,3,0,0,1,2,3,3,1,1,3,2,2
401402655,Arizona Wildcats,B. Yeaney,4281255,,True,23.0,1,3,1,3,0,0,2,2,0,3,3,0,0,0,0,1,4
401402655,Arizona Wildcats,K. Love,4433326,,False,15.0,2,7,2,6,0,1,0,0,3,1,4,0,0,0,0,4,4
401402655,Arizona Wildcats,A. Vonleh,4433519,,False,3.0,1,1,1,1,0,0,0,0,0,0,0,0,1,0,0,0,2
401402655,Arizona Wildcats,M. Conner,4712562,,False,12.0,0,4,0,1,0,3,2,2,0,1,1,0,1,0,1,0,2
401402655,Arizona Wildcats,T. Chavez,4398769,,False,17.0,0,4,0,0,0,4,2,2,1,0,1,2,3,0,1,1,2
401402655,Arizona Wildcats,TEAM,TOTAL,TOTAL,False,,12,48,10,24,2,24,17,18,12,19,31,7,9,5,15,17,43
401402654,Utah Utes,J. Johnson,4898900,,True,20.0,7,12,6,9,1,3,3,7,1,2,3,3,0,1,1,4,18
401402654,Utah Utes,K. Rees,4703603,,True,20.0,1,6,1,6,0,0,0,0,3,2,5,0,0,1,1,2,2
401402654,Utah Utes,K. McQueen,4898901,,True,34.0,4,10,3,6,1,4,2,4,1,3,4,1,1,0,0,1,11
401402654,Utah Utes,G. Kneepkens,4898898,,True,31.0,9,13,7,8,2,5,0,0,0,5,5,1,1,1,2,2,20
401402654,Utah Utes,D. Gylten,4282178,,True,29.0,0,3,0,3,0,0,0,0,0,1,1,6,0,1,1,0,0
401402654,Utah Utes,D. Young,4595931,,False,21.0,1,3,0,1,1,2,1,2,1,0,1,3,0,0,2,3,4
401402654,Utah Utes,P. McFarland,4582913,,False,19.0,3,5,3,5,0,0,0,0,2,2,4,0,2,0,0,2,6
401402654,Utah Utes,I. Vieira,4898897,,False,11.0,0,1,0,1,0,0,2,2,0,0,0,2,0,0,2,2,2
401402654,Utah Utes,I. Palmer,4594751,,False,3.0,0,2,0,1,0,1,0,0,0,0,0,0,1,0,1,1,0
401402654,Utah Utes,B. Maxwell,4433675,,False,12.0,1,3,0,0,1,3,0,0,0,0,0,1,0,0,0,1,3
401402654,Utah Utes,TEAM,TOTAL,TOTAL,False,,26,58,20,40,6,18,8,15,13,20,33,17,5,4,11,18,66
401402654,California Golden Bears,E. Lutje Schipholt,4595859,,True,26.0,3,6,3,6,0,0,5,6,1,3,4,1,2,2,2,4,11
401402654,California Golden Bears,D. Daniels,4433417,,True,21.0,4,5,4,5,0,0,0,0,0,2,2,1,0,1,2,4,8
401402654,California Golden Bears,J. Curry,4899068,,True,39.0,6,18,6,15,0,3,4,4,1,6,7,3,2,0,4,4,16
401402654,California Golden Bears,J. Green,4595858,,True,18.0,2,5,1,2,1,3,2,2,0,1,1,2,0,1,1,0,7
401402654,California Golden Bears,L. McIntosh,4595857,,True,35.0,0,5,0,4,0,1,0,0,1,0,1,3,1,0,2,4,0
401402654,California Golden Bears,U. Onyiah,4433744,,False,23.0,6,7,6,7,0,0,2,2,1,7,8,1,0,2,1,3,14
401402654,California Golden Bears,F. Samb,4433477,,False,2.0,0,0,0,0,0,0,0,0,0,0,0,0,0,1,2,0,0
401402654,California Golden Bears,M. Mastrov,4714650,,False,14.0,1,1,0,0,1,1,0,0,0,0,0,1,0,0,0,1,3
401402654,California Golden Bears,A. Elsnitz,4682954,,False,0.0,0,0,0,0,0,0,0,0,0,0,0,0,0,0,0,0,0
401402654,California Golden Bears,C. Crocker,4433341,,False,22.0,0,2,0,1,0,1,1,2,2,0,2,1,2,0,0,0,1
401402654,California Golden Bears,TEAM,TOTAL,TOTAL,False,,22,49,20,40,2,9,14,16,7,22,29,13,7,7,14,20,60
401402653,USC Trojans,J. Jenkins,4433437,,True,22.0,0,6,0,6,0,0,5,6,0,5,5,1,2,0,4,5,5
401402653,USC Trojans,J. Sanders,4281718,,True,34.0,6,13,5,8,1,5,5,8,0,5,5,0,1,0,0,3,18
401402653,USC Trojans,R. Marshall,4433792,,True,34.0,6,15,6,14,0,1,5,6,2,8,10,1,2,1,2,2,17
401402653,USC Trojans,D. Caldwell,4398823,,True,34.0,0,3,0,2,0,1,0,0,0,1,1,4,3,0,3,4,0
401402653,USC Trojans,T. Reed,4281909,,True,23.0,2,3,0,0,2,3,1,2,1,1,2,2,0,0,1,2,7
401402653,USC Trojans,A. Pili,5105752,,False,19.0,1,5,1,3,0,2,4,4,1,2,3,0,0,0,0,3,6
401402653,USC Trojans,C. Uche Akunwafo,4898896,,False,4.0,0,1,0,1,0,0,0,0,0,1,1,0,0,0,1,0,0
401402653,USC Trojans,B. Perkins,4898895,,False,1.0,0,0,0,0,0,0,0,0,0,0,0,1,0,0,0,0,0
401402653,USC Trojans,A. Miura,4595899,,False,22.0,3,4,2,3,1,1,0,0,0,0,0,0,0,0,4,1,7
401402653,USC Trojans,A. Oliver,4433486,,False,1.0,0,0,0,0,0,0,0,0,0,0,0,0,0,0,0,0,0
401402653,USC Trojans,K. White,4433033,,False,6.0,0,0,0,0,0,0,0,0,0,0,0,0,0,0,0,1,0
401402653,USC Trojans,TEAM,TOTAL,TOTAL,False,,18,50,14,37,4,13,20,26,6,25,31,9,8,1,15,21,60
401402653,UCLA Bruins,I. Thomas,4281072,,True,30.0,8,14,8,12,0,2,2,2,2,0,2,1,0,1,1,4,18
401402653,UCLA Bruins,C. Osborne,4433293,,True,34.0,4,14,4,10,0,4,6,7,1,4,5,3,1,0,5,2,14
401402653,UCLA Bruins,C. Horvat,4282171,,True,25.0,1,3,1,2,0,1,6,6,4,6,10,0,0,0,1,2,8
401402653,UCLA Bruins,J. Penn,4281259,,True,30.0,5,13,4,8,1,5,0,0,1,6,7,2,0,0,2,1,11
401402653,UCLA Bruins,N. Chou,4066562,,True,31.0,2,6,2,4,0,2,5,5,0,3,3,0,2,0,3,3,9
401402653,UCLA Bruins,I. Anstey,4599500,,False,8.0,0,1,0,1,0,0,0,0,0,1,1,0,1,0,1,1,0
401402653,UCLA Bruins,Dugalic,4433411,,False,21.0,5,10,3,8,2,2,1,2,4,8,12,1,1,1,1,5,13
401402653,UCLA Bruins,E. Sigal,4398838,,False,1.0,0,0,0,0,0,0,0,0,0,0,0,0,0,0,0,0,0
401402653,UCLA Bruins,C. Brown,4595911,,False,14.0,0,1,0,1,0,0,0,0,1,1,2,0,0,0,0,3,0
401402653,UCLA Bruins,K. Owens,4282172,,False,6.0,0,1,0,1,0,0,0,0,0,0,0,1,0,0,0,0,0
401402653,UCLA Bruins,TEAM,TOTAL,TOTAL,False,,25,63,22,47,3,16,20,22,14,31,45,8,5,2,14,21,73
401402652,Oregon State Beavers,T. Corosdale,4282159,,True,28.0,1,1,1,1,0,0,0,0,0,2,2,0,0,0,0,3,2
401402652,Oregon State Beavers,K. Brown,4433291,,True,24.0,3,8,3,8,0,0,1,2,1,3,4,1,2,1,2,4,7
401402652,Oregon State Beavers,T. von Oelhoffen,4713193,,True,26.0,3,9,0,3,3,6,4,4,0,5,5,6,1,0,3,2,13
401402652,Oregon State Beavers,G. Kampschroeder,4433796,,True,26.0,3,9,3,5,0,4,1,1,0,2,2,2,0,0,1,3,7
401402652,Oregon State Beavers,E. Codding,4282102,,True,30.0,2,3,1,1,1,2,1,2,0,5,5,3,0,1,0,1,6
401402652,Oregon State Beavers,J. Mitrovic,4595897,,False,16.0,1,3,1,3,0,0,2,2,2,3,5,0,1,0,1,0,4
401402652,Oregon State Beavers,E. Mack,4068241,,False,26.0,5,10,3,7,2,3,2,3,1,3,4,2,1,0,4,2,14
401402652,Oregon State Beavers,A. Marotte,4691697,,False,14.0,2,6,1,3,1,3,0,0,0,3,3,0,0,0,1,0,5
401402652,Oregon State Beavers,T. Adams,4281876,,False,10.0,0,0,0,0,0,0,1,4,0,3,3,0,0,0,1,1,1
401402652,Oregon State Beavers,TEAM,TOTAL,TOTAL,False,,20,49,13,31,7,18,12,18,5,33,38,14,5,2,14,16,59
401402652,Arizona State Sun Devils,K. Levings,4433458,,True,27.0,1,7,1,4,0,3,2,2,3,2,5,1,0,0,2,5,4
401402652,Arizona State Sun Devils,M. Gilles,4281275,,True,27.0,4,7,2,5,2,2,4,5,4,5,9,1,1,0,3,3,14
401402652,Arizona State Sun Devils,J. Simmons,4595338,,True,29.0,1,6,0,3,1,3,2,4,2,0,2,3,3,0,0,2,5
401402652,Arizona State Sun Devils,J. Loville,4400537,,True,31.0,3,20,2,17,1,3,2,2,1,3,4,3,1,0,1,2,9
401402652,Arizona State Sun Devils,T. Hanson,4398722,,True,32.0,6,17,1,4,5,13,1,2,2,7,9,1,1,0,1,3,18
401402652,Arizona State Sun Devils,I. Greenslade,4703583,,False,12.0,1,1,1,1,0,0,0,0,0,3,3,0,0,1,1,3,2
401402652,Arizona State Sun Devils,I. Sousa,4899066,,False,9.0,0,2,0,0,0,2,0,0,0,1,1,0,0,0,0,1,0
401402652,Arizona State Sun Devils,G. Bosquez,4703582,,False,13.0,0,2,0,1,0,1,0,0,0,0,0,0,0,0,1,0,0
401402652,Arizona State Sun Devils,S. Erikstrup,4597599,,False,8.0,0,0,0,0,0,0,0,0,1,2,3,1,0,0,0,0,0
401402652,Arizona State Sun Devils,A. Basallo,4281446,,False,12.0,1,3,1,1,0,2,0,0,1,0,1,0,0,0,2,0,2
401402652,Arizona State Sun Devils,TEAM,TOTAL,TOTAL,False,,17,65,8,36,9,29,11,15,16,27,43,10,6,1,11,19,54
401402651,Washington Huskies,L. Schwartz,4595232,,True,37.0,4,16,3,11,1,5,2,3,1,1,2,2,1,1,2,2,11
401402651,Washington Huskies,H. Van Dyke,4398875,,True,34.0,3,10,1,7,2,3,0,0,1,2,3,3,0,0,2,3,8
401402651,Washington Huskies,N. Mulkey,4068109,,True,28.0,3,7,2,4,1,3,4,4,0,7,7,1,2,4,1,1,11
401402651,Washington Huskies,J. Noble,4433765,,True,25.0,1,2,1,2,0,0,0,0,1,4,5,1,0,0,2,1,2
401402651,Washington Huskies,T. Oliver,4281252,,True,37.0,3,7,2,5,1,2,0,2,3,4,7,3,2,0,3,3,7
401402651,Washington Huskies,D. Rees,4398877,,False,12.0,1,6,1,4,0,2,0,0,0,0,0,1,0,0,0,0,2
401402651,Washington Huskies,T.T. Watkins,4398876,,False,16.0,1,2,0,1,1,1,0,0,0,1,1,0,0,0,0,1,3
401402651,Washington Huskies,M. Peterson,4282190,,False,11.0,3,3,1,1,2,2,0,0,0,0,0,0,0,0,1,2,8
401402651,Washington Huskies,TEAM,TOTAL,TOTAL,False,,19,53,11,35,8,18,6,9,9,21,30,11,5,5,13,13,52
401402651,Colorado Buffaloes,P. Tuitele,4595865,,True,29.0,6,9,5,8,1,1,3,7,4,4,8,3,1,2,2,0,16
401402651,Colorado Buffaloes,M. Hollingshed,4281923,,True,33.0,4,15,1,10,3,5,4,4,6,6,12,4,0,1,3,2,15
401402651,Colorado Buffaloes,T. Sadler,4595340,,True,18.0,3,6,2,3,1,3,0,0,1,1,2,2,1,0,0,0,7
401402651,Colorado Buffaloes,J. Sherrod,4433386,,True,31.0,2,4,1,3,1,1,1,2,0,3,3,2,2,1,2,3,6
401402651,Colorado Buffaloes,L. Finau,4398760,,True,18.0,0,5,0,3,0,2,0,0,0,0,0,0,0,0,0,2,0
401402651,Colorado Buffaloes,Q. Miller,4433122,,False,18.0,3,8,1,3,2,5,1,1,3,4,7,1,1,0,1,2,9
401402651,Colorado Buffaloes,F. Formann,4703586,,False,23.0,1,5,0,0,1,5,0,0,1,1,2,1,0,1,1,1,3
401402651,Colorado Buffaloes,K. Wetta,4691704,,False,20.0,4,10,4,8,0,2,0,0,2,2,4,2,2,0,2,3,8
401402651,Colorado Buffaloes,T. Jones,4399353,,False,10.0,0,2,0,2,0,0,0,0,1,1,2,1,0,1,0,3,0
401402651,Colorado Buffaloes,TEAM,TOTAL,TOTAL,False,,23,64,14,40,9,24,9,14,22,25,47,16,7,6,12,16,64
401402650,Tennessee Tech Golden Eagles,A. Walker,4704229,,True,27.0,1,8,1,6,0,2,0,0,3,4,7,1,1,1,1,3,2
401402650,Tennessee Tech Golden Eagles,M. Coleman,4282489,,True,32.0,2,10,1,9,1,1,2,2,4,4,8,0,0,3,1,3,7
401402650,Tennessee Tech Golden Eagles,A. Jones,4649322,,True,34.0,1,9,1,7,0,2,3,4,3,7,10,2,2,0,5,2,5
401402650,Tennessee Tech Golden Eagles,J. Guinn,4595968,,True,38.0,1,7,1,6,0,1,0,0,3,4,7,2,1,1,4,1,2
401402650,Tennessee Tech Golden Eagles,M. Clark,4282483,,True,27.0,2,6,1,2,1,4,1,1,0,2,2,0,0,0,2,1,6
401402650,Tennessee Tech Golden Eagles,P. Carter,4705014,,False,3.0,0,0,0,0,0,0,0,0,0,0,0,0,0,0,0,0,0
401402650,Tennessee Tech Golden Eagles,A. Hall,4705013,,False,1.0,0,0,0,0,0,0,0,2,0,0,0,1,1,0,0,0,0
401402650,Tennessee Tech Golden Eagles,M. Owens,4595967,,False,19.0,2,8,1,3,1,5,0,0,2,0,2,0,0,0,2,1,5
401402650,Tennessee Tech Golden Eagles,G. Pelphrey,4398600,,False,1.0,0,0,0,0,0,0,0,0,0,0,0,0,0,0,0,0,0
401402650,Tennessee Tech Golden Eagles,K. Brady,4282486,,False,18.0,0,4,0,1,0,3,2,2,0,1,1,0,0,0,0,0,2
401402650,Tennessee Tech Golden Eagles,TEAM,TOTAL,TOTAL,False,,9,52,6,34,3,18,8,11,19,23,42,6,5,5,17,11,29
401402650,Belmont Bruins,M. Bartley,4705406,,True,22.0,3,8,3,6,0,2,0,1,5,4,9,0,1,1,1,4,6
401402650,Belmont Bruins,C. Chinn,4282391,,True,23.0,1,3,1,3,0,0,0,0,2,3,5,0,0,1,0,1,2
401402650,Belmont Bruins,T. Jones,4705405,,True,35.0,1,8,1,5,0,3,1,2,4,4,8,4,2,0,1,3,3
401402650,Belmont Bruins,D. Wells,4586267,,True,31.0,10,23,8,16,2,7,0,0,0,1,1,2,0,0,3,2,22
401402650,Belmont Bruins,J. Kinney,4399580,,True,30.0,2,4,1,1,1,3,0,0,0,3,3,2,2,1,0,0,5
401402650,Belmont Bruins,T. Miller,4900197,,False,19.0,2,3,2,3,0,0,0,0,0,4,4,0,0,2,1,2,4
401402650,Belmont Bruins,K. McGuff,4900196,,False,5.0,0,0,0,0,0,0,0,0,0,0,0,1,1,0,2,2,0
401402650,Belmont Bruins,B. Schoenwald,4705408,,False,16.0,2,4,0,0,2,4,0,0,0,1,1,0,0,0,1,2,6
401402650,Belmont Bruins,N. Baird,4595716,,False,19.0,1,3,0,1,1,2,0,0,0,3,3,2,0,3,1,1,3
401402650,Belmont Bruins,TEAM,TOTAL,TOTAL,False,,22,56,16,35,6,21,1,3,12,26,38,11,6,8,10,17,51
401402649,Tennessee Tech Golden Eagles,A. Walker,4704229,,True,35.0,7,11,5,7,2,4,3,3,2,7,9,2,1,2,3,2,19
401402649,Tennessee Tech Golden Eagles,M. Coleman,4282489,,True,23.0,1,9,1,9,0,0,0,0,2,4,6,1,1,0,0,3,2
401402649,Tennessee Tech Golden Eagles,A. Jones,4649322,,True,40.0,7,11,7,10,0,1,1,4,1,4,5,2,4,0,1,1,15
401402649,Tennessee Tech Golden Eagles,J. Guinn,4595968,,True,40.0,5,11,5,11,0,0,2,4,3,3,6,7,1,2,0,4,12
401402649,Tennessee Tech Golden Eagles,M. Clark,4282483,,True,34.0,4,8,3,5,1,3,0,0,0,0,0,0,0,0,0,0,9
401402649,Tennessee Tech Golden Eagles,A. Hall,4705013,,False,1.0,0,0,0,0,0,0,0,0,0,0,0,0,0,0,1,0,0
401402649,Tennessee Tech Golden Eagles,M. Owens,4595967,,False,17.0,2,4,1,1,1,3,0,0,0,0,0,1,0,0,0,0,5
401402649,Tennessee Tech Golden Eagles,K. Brady,4282486,,False,10.0,2,7,2,4,0,3,2,2,1,1,2,0,0,0,0,1,6
401402649,Tennessee Tech Golden Eagles,TEAM,TOTAL,TOTAL,False,,28,61,24,47,4,14,8,13,11,21,32,13,7,4,5,11,68
401402649,Murray State Racers,K. Young,4705055,,True,35.0,9,18,9,17,0,1,4,4,5,5,10,1,0,2,4,3,22
401402649,Murray State Racers,H. McKay,4705053,,True,40.0,3,5,2,3,1,2,0,0,1,4,5,2,1,0,2,2,7
401402649,Murray State Racers,A. Burpo,4400412,,True,40.0,4,8,4,8,0,0,2,2,5,11,16,1,0,2,4,3,10
401402649,Murray State Racers,M. Turley,4400410,,True,34.0,5,17,4,10,1,7,1,1,2,3,5,2,1,0,1,4,12
401402649,Murray State Racers,L. Mayes,4400409,,True,37.0,3,9,2,2,1,7,0,0,0,1,1,0,0,0,0,2,7
401402649,Murray State Racers,C. Conner,4900210,,False,2.0,0,0,0,0,0,0,0,0,0,0,0,1,0,0,1,1,0
401402649,Murray State Racers,B. Sanders-Woods,4705052,,False,12.0,1,3,1,1,0,2,2,3,0,0,0,2,0,0,0,1,4
401402649,Murray State Racers,TEAM,TOTAL,TOTAL,False,,25,60,22,41,3,19,9,10,14,26,40,9,2,4,12,16,62
401402648,Belmont Bruins,M. Bartley,4705406,,True,25.0,9,13,8,11,1,2,1,2,2,3,5,0,1,1,1,4,20
401402648,Belmont Bruins,C. Chinn,4282391,,True,23.0,0,1,0,0,0,1,0,0,2,5,7,0,1,1,0,3,0
401402648,Belmont Bruins,T. Jones,4705405,,True,36.0,2,9,1,3,1,6,0,0,1,4,5,3,2,0,1,2,5
401402648,Belmont Bruins,D. Wells,4586267,,True,36.0,6,10,6,9,0,1,8,8,0,1,1,2,0,0,2,1,20
401402648,Belmont Bruins,J. Kinney,4399580,,True,32.0,2,7,2,3,0,4,2,2,0,2,2,2,3,0,0,1,6
401402648,Belmont Bruins,T. Miller,4900197,,False,15.0,1,2,1,2,0,0,2,4,0,1,1,1,1,0,1,1,4
401402648,Belmont Bruins,K. McGuff,4900196,,False,6.0,0,0,0,0,0,0,0,0,0,1,1,1,0,0,1,1,0
401402648,Belmont Bruins,B. Schoenwald,4705408,,False,12.0,1,2,0,0,1,2,0,0,0,0,0,0,0,0,1,0,3
401402648,Belmont Bruins,N. Baird,4595716,,False,15.0,2,2,1,1,1,1,0,0,1,0,1,0,0,0,1,0,5
401402648,Belmont Bruins,TEAM,TOTAL,TOTAL,False,,23,46,19,29,4,17,13,16,6,17,23,9,8,2,8,13,63
401402648,Austin Peay Governors,L. Cole,4900194,,True,18.0,1,3,1,3,0,0,1,2,1,3,4,0,2,2,1,3,3
401402648,Austin Peay Governors,N. De Leon Negron,4705089,,True,22.0,1,3,0,2,1,1,0,0,0,3,3,3,0,0,2,0,3
401402648,Austin Peay Governors,S. Kirby,4595702,,True,23.0,3,3,0,0,3,3,2,2,0,1,1,0,1,0,2,2,11
401402648,Austin Peay Governors,E. Sawyer,4595701,,True,35.0,2,6,0,2,2,4,0,0,0,2,2,2,0,0,4,2,6
401402648,Austin Peay Governors,K. Pace,4282394,,True,35.0,4,7,2,4,2,3,0,0,0,0,0,4,0,1,1,0,10
401402648,Austin Peay Governors,K. Ward,4705091,,False,1.0,0,0,0,0,0,0,0,0,0,0,0,0,0,0,0,1,0
401402648,Austin Peay Governors,D. Booker,4399560,,False,19.0,5,7,5,7,0,0,0,1,1,4,5,1,0,0,1,3,10
401402648,Austin Peay Governors,L. Gibbs,4595233,,False,3.0,0,0,0,0,0,0,0,0,0,0,0,0,0,0,0,0,0
401402648,Austin Peay Governors,Y. Johnson,4399804,,False,30.0,3,7,3,7,0,0,2,4,0,4,4,1,0,0,2,1,8
401402648,Austin Peay Governors,K. Kidwell,4399561,,False,14.0,0,1,0,1,0,0,0,0,0,0,0,2,0,0,1,3,0
401402648,Austin Peay Governors,TEAM,TOTAL,TOTAL,False,,19,37,11,26,8,11,5,9,2,17,19,13,3,3,14,15,51
401402647,SIU Edwardsville Cougars,P. Chellis,4705022,,True,28.0,2,3,2,2,0,1,4,4,3,7,10,2,3,0,2,3,8
401402647,SIU Edwardsville Cougars,M. Kinnard,4595880,,True,29.0,11,25,10,23,1,2,1,1,3,2,5,1,2,1,3,4,24
401402647,SIU Edwardsville Cougars,M. Keith,4400414,,True,21.0,2,5,0,0,2,5,0,0,0,1,1,3,1,0,1,4,6
401402647,SIU Edwardsville Cougars,A. Troeckler,4282462,,True,35.0,2,11,2,10,0,1,0,0,2,1,3,2,4,2,1,2,4
401402647,SIU Edwardsville Cougars,G. Nikitinaite,4282144,,True,33.0,8,16,7,13,1,3,2,4,2,5,7,0,0,0,1,5,19
401402647,SIU Edwardsville Cougars,A. Thatha,4433707,,False,14.0,0,2,0,1,0,1,4,4,1,1,2,0,2,0,1,2,4
401402647,SIU Edwardsville Cougars,K. Williams,4400420,,False,4.0,1,3,1,3,0,0,0,0,0,0,0,1,0,0,0,0,2
401402647,SIU Edwardsville Cougars,S. Lowis,4900214,,False,4.0,0,2,0,2,0,0,0,0,1,0,1,1,1,1,1,0,0
401402647,SIU Edwardsville Cougars,M. McWilliams,4705024,,False,21.0,1,3,0,0,1,3,0,0,0,0,0,2,0,0,0,1,3
401402647,SIU Edwardsville Cougars,M. Hall,4400419,,False,11.0,2,2,2,2,0,0,2,2,0,1,1,2,2,1,2,1,6
401402647,SIU Edwardsville Cougars,TEAM,TOTAL,TOTAL,False,,29,72,24,56,5,16,13,15,15,18,33,14,15,5,12,22,76
401402647,Murray State Racers,K. Young,4705055,,True,37.0,9,13,8,10,1,3,6,6,0,9,9,5,1,1,1,1,25
401402647,Murray State Racers,H. McKay,4705053,,True,39.0,6,13,4,9,2,4,7,7,3,7,10,3,1,0,4,4,21
401402647,Murray State Racers,A. Burpo,4400412,,True,39.0,4,7,4,7,0,0,4,5,4,7,11,4,1,2,5,2,12
401402647,Murray State Racers,M. Turley,4400410,,True,28.0,4,13,4,10,0,3,2,2,0,3,3,4,1,1,2,0,10
401402647,Murray State Racers,L. Mayes,4400409,,True,28.0,2,4,1,2,1,2,0,0,1,0,1,3,1,0,1,5,5
401402647,Murray State Racers,J. Black,4900211,,False,1.0,0,0,0,0,0,0,0,0,0,0,0,0,0,0,0,0,0
401402647,Murray State Racers,C. Settle,4705056,,False,1.0,0,0,0,0,0,0,0,0,0,0,0,0,1,0,0,0,0
401402647,Murray State Racers,I. West,4900212,,False,1.0,0,0,0,0,0,0,0,0,0,0,0,0,0,0,0,0,0
401402647,Murray State Racers,C. Conner,4900210,,False,17.0,5,6,4,5,1,1,0,0,0,0,0,2,1,0,0,1,11
401402647,Murray State Racers,C. McGowan,4900209,,False,1.0,0,0,0,0,0,0,0,0,0,0,0,0,0,0,2,0,0
401402647,Murray State Racers,B. Sanders-Woods,4705052,,False,7.0,0,3,0,2,0,1,0,0,0,0,0,1,0,0,3,2,0
401402647,Murray State Racers,R. Blackburn,4400406,,False,1.0,0,0,0,0,0,0,0,0,0,0,0,0,0,0,0,0,0
401402647,Murray State Racers,TEAM,TOTAL,TOTAL,False,,30,59,25,45,5,14,19,20,12,28,40,22,7,4,19,15,84
401402646,Tennessee State Lady Tigers,S. McCullough,4594981,,True,34.0,2,4,2,4,0,0,3,3,3,2,5,2,0,3,3,4,7
401402646,Tennessee State Lady Tigers,G. Adams,4900624,,True,35.0,5,15,2,9,3,6,2,4,1,2,3,1,2,0,3,2,15
401402646,Tennessee State Lady Tigers,S. Parker,4900623,,True,20.0,1,3,1,3,0,0,0,0,0,1,1,1,0,0,1,5,2
401402646,Tennessee State Lady Tigers,A. Pierce,4900621,,True,32.0,1,6,0,3,1,3,3,4,0,1,1,1,0,0,2,1,6
401402646,Tennessee State Lady Tigers,T. Davis,4282149,,True,37.0,6,15,6,11,0,4,5,5,0,0,0,1,2,0,2,1,17
401402646,Tennessee State Lady Tigers,K. Westbrook,4900622,,False,3.0,0,0,0,0,0,0,0,0,0,0,0,0,0,0,1,0,0
401402646,Tennessee State Lady Tigers,K. Davis,4705337,,False,7.0,0,0,0,0,0,0,0,0,0,2,2,0,0,0,0,0,0
401402646,Tennessee State Lady Tigers,E. Harden,4704293,,False,11.0,2,6,2,6,0,0,0,2,0,2,2,0,0,0,0,1,4
401402646,Tennessee State Lady Tigers,N. Hicks,4903393,,False,6.0,0,0,0,0,0,0,0,0,0,0,0,0,0,0,0,1,0
401402646,Tennessee State Lady Tigers,L. Robins,4704026,,False,16.0,1,1,1,1,0,0,0,0,1,3,4,1,1,1,1,4,2
401402646,Tennessee State Lady Tigers,TEAM,TOTAL,TOTAL,False,,18,50,14,37,4,13,13,18,8,15,23,7,5,4,13,19,53
401402646,Austin Peay Governors,L. Cole,4900194,,True,17.0,2,2,2,2,0,0,2,2,2,2,4,0,1,1,1,2,6
401402646,Austin Peay Governors,N. De Leon Negron,4705089,,True,29.0,3,4,3,4,0,0,3,4,0,3,3,1,1,0,6,2,9
401402646,Austin Peay Governors,S. Kirby,4595702,,True,24.0,1,5,0,1,1,4,2,3,2,0,2,1,1,0,0,2,5
401402646,Austin Peay Governors,E. Sawyer,4595701,,True,30.0,0,4,0,0,0,4,0,2,2,5,7,2,2,0,2,2,0
401402646,Austin Peay Governors,K. Pace,4282394,,True,29.0,3,9,2,5,1,4,7,8,0,4,4,2,2,1,1,2,14
401402646,Austin Peay Governors,K. Ward,4705091,,False,4.0,1,1,1,1,0,0,0,0,0,2,2,0,0,0,0,2,2
401402646,Austin Peay Governors,D. Booker,4399560,,False,19.0,6,9,6,9,0,0,1,1,2,8,10,0,0,0,0,2,13
401402646,Austin Peay Governors,L. Gibbs,4595233,,False,16.0,0,0,0,0,0,0,1,2,1,2,3,1,0,0,4,4,1
401402646,Austin Peay Governors,Y. Johnson,4399804,,False,21.0,5,10,3,7,2,3,5,6,1,0,1,1,1,0,0,0,17
401402646,Austin Peay Governors,K. Kidwell,4399561,,False,10.0,0,1,0,1,0,0,0,0,0,0,0,3,0,0,1,1,0
401402646,Austin Peay Governors,TEAM,TOTAL,TOTAL,False,,21,45,17,30,4,15,21,28,12,26,38,11,8,2,20,19,67
401402645,UT Martin Skyhawks,E. Thompson,4900491,,True,18.0,2,4,1,2,1,2,0,0,1,3,4,1,0,0,2,2,5
401402645,UT Martin Skyhawks,H. Forbes,4595766,,True,27.0,6,8,6,8,0,0,4,5,3,4,7,0,0,3,3,5,16
401402645,UT Martin Skyhawks,S. Littleford,4900492,,True,37.0,5,11,5,8,0,3,8,12,1,2,3,2,2,0,4,4,18
401402645,UT Martin Skyhawks,K. Grant,4400440,,True,20.0,1,6,1,3,0,3,0,0,0,0,0,1,3,0,0,3,2
401402645,UT Martin Skyhawks,P. Pipkin,4282472,,True,25.0,2,9,2,8,0,1,1,2,1,6,7,2,5,0,3,5,5
401402645,UT Martin Skyhawks,S. Simpson-Whiteley,4900495,,False,7.0,1,2,1,2,0,0,1,2,1,1,2,0,0,0,1,1,3
401402645,UT Martin Skyhawks,R. Johnson,4595930,,False,2.0,0,1,0,1,0,0,0,0,0,1,1,0,0,0,1,0,0
401402645,UT Martin Skyhawks,G. Melby,4900496,,False,3.0,0,0,0,0,0,0,0,0,0,0,0,1,0,0,0,0,0
401402645,UT Martin Skyhawks,H. Harrison,4595932,,False,21.0,3,7,0,2,3,5,0,0,3,2,5,2,1,1,4,5,9
401402645,UT Martin Skyhawks,E. Davis,4400434,,False,6.0,0,1,0,0,0,1,0,0,0,1,1,3,0,0,0,1,0
401402645,UT Martin Skyhawks,S. Robins,4398603,,False,34.0,7,15,1,3,6,12,6,6,0,2,2,6,1,0,2,0,26
401402645,UT Martin Skyhawks,TEAM,TOTAL,TOTAL,False,,27,64,17,37,10,27,20,27,15,24,39,18,12,4,21,26,84
401402645,SIU Edwardsville Cougars,P. Chellis,4705022,,True,17.0,2,5,2,5,0,0,0,1,3,6,9,1,1,1,3,4,4
401402645,SIU Edwardsville Cougars,M. Kinnard,4595880,,True,36.0,5,17,5,16,0,1,4,4,3,1,4,7,1,3,6,2,14
401402645,SIU Edwardsville Cougars,M. Keith,4400414,,True,23.0,1,3,0,0,1,3,1,2,0,2,2,2,4,0,6,4,4
401402645,SIU Edwardsville Cougars,A. Troeckler,4282462,,True,36.0,7,9,7,9,0,0,3,5,1,9,10,1,3,2,2,1,17
401402645,SIU Edwardsville Cougars,G. Nikitinaite,4282144,,True,32.0,9,14,6,7,3,7,3,4,1,2,3,7,1,1,2,5,24
401402645,SIU Edwardsville Cougars,A. Thatha,4433707,,False,15.0,1,2,1,1,0,1,1,2,2,3,5,1,0,0,1,2,3
401402645,SIU Edwardsville Cougars,S. Lowis,4900214,,False,6.0,1,4,0,1,1,3,0,0,0,0,0,0,0,0,0,0,3
401402645,SIU Edwardsville Cougars,M. McWilliams,4705024,,False,27.0,4,8,1,4,3,4,3,5,2,0,2,2,0,0,1,3,14
401402645,SIU Edwardsville Cougars,M. Hall,4400419,,False,8.0,1,3,0,2,1,1,0,0,1,1,2,0,1,0,2,1,3
401402645,SIU Edwardsville Cougars,TEAM,TOTAL,TOTAL,False,,31,65,22,45,9,20,15,23,16,24,40,21,11,7,23,22,86
401402644,Tennessee State Lady Tigers,S. McCullough,4594981,,True,25.0,2,5,2,5,0,0,4,6,2,7,9,1,3,0,2,3,8
401402644,Tennessee State Lady Tigers,G. Adams,4900624,,True,38.0,6,14,4,10,2,4,5,7,0,2,2,4,3,0,7,3,19
401402644,Tennessee State Lady Tigers,S. Parker,4900623,,True,30.0,2,6,1,4,1,2,1,2,0,5,5,1,2,0,5,1,6
401402644,Tennessee State Lady Tigers,A. Pierce,4900621,,True,29.0,2,2,1,1,1,1,2,2,0,3,3,0,1,1,2,1,7
401402644,Tennessee State Lady Tigers,T. Davis,4282149,,True,29.0,7,11,6,9,1,2,4,6,0,1,1,1,4,1,6,2,19
401402644,Tennessee State Lady Tigers,K. Westbrook,4900622,,False,12.0,1,1,1,1,0,0,0,0,2,0,2,0,2,1,0,1,2
401402644,Tennessee State Lady Tigers,K. Davis,4705337,,False,6.0,0,1,0,1,0,0,0,0,0,0,0,0,0,0,0,0,0
401402644,Tennessee State Lady Tigers,E. Harden,4704293,,False,10.0,3,7,3,7,0,0,0,0,3,0,3,0,3,0,1,1,6
401402644,Tennessee State Lady Tigers,N. Hicks,4903393,,False,3.0,0,1,0,1,0,0,0,0,0,0,0,0,0,0,0,0,0
401402644,Tennessee State Lady Tigers,L. Robins,4704026,,False,18.0,2,2,1,1,1,1,0,0,0,0,0,2,4,0,1,3,5
401402644,Tennessee State Lady Tigers,TEAM,TOTAL,TOTAL,False,,25,50,19,40,6,10,16,23,8,21,29,9,22,3,25,15,72
401402644,Eastern Illinois Panthers,M. Litwiller,4595733,,True,32.0,3,11,3,5,0,6,0,0,1,2,3,0,2,0,3,3,6
401402644,Eastern Illinois Panthers,A. Wahl,4399589,,True,32.0,4,10,4,10,0,0,2,2,6,3,9,1,0,2,1,5,10
401402644,Eastern Illinois Panthers,L. Washington,4595732,,True,36.0,6,16,5,12,1,4,4,5,2,5,7,2,2,0,7,3,17
401402644,Eastern Illinois Panthers,J. Hughes,4399587,,True,22.0,3,8,2,3,1,5,0,0,0,4,4,6,3,0,1,2,7
401402644,Eastern Illinois Panthers,K. Arthofer,4399586,,True,39.0,4,5,4,5,0,0,2,2,1,1,2,5,8,0,11,5,10
401402644,Eastern Illinois Panthers,T. Thornton,4900201,,False,10.0,0,1,0,1,0,0,1,2,1,2,3,0,0,1,2,2,1
401402644,Eastern Illinois Panthers,P. Stafford,4705084,,False,7.0,1,1,1,1,0,0,0,0,0,0,0,1,0,0,0,1,2
401402644,Eastern Illinois Panthers,J. Bengston,4900200,,False,13.0,2,5,1,1,1,4,3,3,0,2,2,1,1,0,1,1,8
401402644,Eastern Illinois Panthers,M. Monahan,4900198,,False,9.0,0,0,0,0,0,0,0,0,0,0,0,0,0,0,1,0,0
401402644,Eastern Illinois Panthers,TEAM,TOTAL,TOTAL,False,,23,57,20,38,3,19,12,14,15,21,36,16,16,3,29,22,61
401402641,Northern Iowa Panthers,G. Boffeli,4704857,,True,16.0,2,7,2,6,0,1,0,0,0,4,4,0,0,0,2,4,4
401402641,Northern Iowa Panthers,B. Gunnels,4282228,,True,36.0,2,3,2,2,0,1,2,4,2,6,8,1,0,2,2,2,6
401402641,Northern Iowa Panthers,K. Finley,4399421,,True,34.0,3,10,2,8,1,2,0,0,2,1,3,2,1,0,0,1,7
401402641,Northern Iowa Panthers,N. Kroeger,4282226,,True,15.0,0,2,0,0,0,2,0,0,0,2,2,0,0,0,0,1,0
401402641,Northern Iowa Panthers,K. Rucker,4282225,,True,35.0,6,14,6,12,0,2,4,4,1,3,4,4,0,0,1,1,16
401402641,Northern Iowa Panthers,S. McCullough,4595605,,False,7.0,0,2,0,0,0,2,0,0,0,1,1,0,0,0,0,1,0
401402641,Northern Iowa Panthers,C. Wolf,4399423,,False,21.0,2,7,2,3,0,4,0,0,1,5,6,1,0,2,0,0,4
401402641,Northern Iowa Panthers,K. Laube,4704856,,False,6.0,0,1,0,0,0,1,2,2,0,2,2,0,0,0,0,1,2
401402641,Northern Iowa Panthers,E. Green,4704853,,False,25.0,3,9,0,5,3,4,0,0,2,1,3,2,0,1,1,3,9
401402641,Northern Iowa Panthers,M. McDermott,4704852,,False,5.0,0,0,0,0,0,0,0,0,0,0,0,0,0,0,0,0,0
401402641,Northern Iowa Panthers,TEAM,TOTAL,TOTAL,False,,18,55,14,36,4,19,8,10,8,26,34,10,1,5,6,14,48
401402641,Illinois State Redbirds,K. Bullman,4704825,,True,40.0,2,6,2,5,0,1,0,0,1,8,9,2,0,1,1,2,4
401402641,Illinois State Redbirds,D. Wilson,4704824,,True,26.0,2,10,2,10,0,0,1,2,2,5,7,0,0,0,2,4,5
401402641,Illinois State Redbirds,J. Redmond,4595585,,True,38.0,8,19,8,19,0,0,5,8,2,2,4,0,1,0,0,1,21
401402641,Illinois State Redbirds,M. Wong,4595584,,True,38.0,6,11,5,7,1,4,2,2,0,4,4,4,0,0,0,0,15
401402641,Illinois State Redbirds,M. Crompton,4399389,,True,22.0,1,1,0,0,1,1,0,0,0,4,4,0,0,0,0,0,3
401402641,Illinois State Redbirds,C. Van Zeeland,4900067,,False,7.0,0,1,0,0,0,1,0,0,0,2,2,0,0,0,2,1,0
401402641,Illinois State Redbirds,J. McGinnis-Taylor,4704823,,False,2.0,1,1,1,1,0,0,0,0,0,0,0,0,0,0,1,3,2
401402641,Illinois State Redbirds,K. Bowers,4900066,,False,12.0,0,2,0,1,0,1,0,0,1,2,3,0,0,1,0,0,0
401402641,Illinois State Redbirds,K. Newland,4399394,,False,15.0,0,1,0,0,0,1,0,0,0,0,0,0,1,0,0,2,0
401402641,Illinois State Redbirds,TEAM,TOTAL,TOTAL,False,,20,52,18,43,2,9,8,12,7,29,36,6,2,2,6,13,50
401402640,Northern Iowa Panthers,G. Boffeli,4704857,,True,27.0,5,9,5,9,0,0,4,6,2,7,9,1,1,2,1,3,14
401402640,Northern Iowa Panthers,B. Gunnels,4282228,,True,38.0,4,10,3,7,1,3,4,5,2,6,8,1,3,3,1,0,13
401402640,Northern Iowa Panthers,K. Finley,4399421,,True,32.0,3,8,2,5,1,3,6,6,0,0,0,1,1,0,3,4,13
401402640,Northern Iowa Panthers,N. Kroeger,4282226,,True,28.0,0,3,0,2,0,1,0,0,0,0,0,1,1,0,0,0,0
401402640,Northern Iowa Panthers,K. Rucker,4282225,,True,39.0,9,16,9,14,0,2,0,0,0,4,4,5,0,0,3,2,18
401402640,Northern Iowa Panthers,S. McCullough,4595605,,False,1.0,0,0,0,0,0,0,0,0,0,0,0,0,0,0,0,0,0
401402640,Northern Iowa Panthers,C. Wolf,4399423,,False,14.0,1,2,0,0,1,2,0,0,1,2,3,1,0,0,3,2,3
401402640,Northern Iowa Panthers,K. Laube,4704856,,False,2.0,0,0,0,0,0,0,0,0,0,0,0,1,0,0,0,0,0
401402640,Northern Iowa Panthers,E. Green,4704853,,False,15.0,0,1,0,1,0,0,2,2,0,1,1,0,0,0,1,2,2
401402640,Northern Iowa Panthers,M. McDermott,4704852,,False,1.0,0,0,0,0,0,0,0,0,0,0,0,0,0,0,0,0,0
401402640,Northern Iowa Panthers,C. Morgan,4595604,,False,3.0,0,0,0,0,0,0,0,0,0,0,0,0,0,0,0,0,0
401402640,Northern Iowa Panthers,TEAM,TOTAL,TOTAL,False,,22,49,19,38,3,11,16,19,9,21,30,11,6,5,12,13,63
401402640,Missouri State Lady Bears,J. Ezeh,4433647,,True,21.0,2,5,2,5,0,0,0,0,5,2,7,1,0,0,1,2,4
401402640,Missouri State Lady Bears,A. Jackson,4280839,,True,35.0,8,12,8,12,0,0,3,3,0,6,6,0,0,3,0,4,19
401402640,Missouri State Lady Bears,M. Bhinhar,4399417,,True,36.0,5,17,3,12,2,5,0,0,1,2,3,3,1,0,5,1,12
401402640,Missouri State Lady Bears,S. Wilson,4399416,,True,36.0,2,8,2,5,0,3,0,0,3,3,6,4,1,0,2,3,4
401402640,Missouri State Lady Bears,B. Calip,4068634,,True,34.0,3,12,3,7,0,5,4,4,1,4,5,3,2,0,1,4,10
401402640,Missouri State Lady Bears,I. Nwachukwu,4900080,,False,21.0,2,3,2,3,0,0,1,2,6,2,8,1,1,1,1,3,5
401402640,Missouri State Lady Bears,P. Rocca,4704874,,False,3.0,0,1,0,1,0,0,0,0,0,0,0,0,0,0,0,0,0
401402640,Missouri State Lady Bears,M. White,4281945,,False,14.0,1,5,1,5,0,0,1,3,0,1,1,1,2,0,2,2,3
401402640,Missouri State Lady Bears,TEAM,TOTAL,TOTAL,False,,23,63,21,50,2,13,9,12,19,20,39,13,7,4,13,19,57
401402639,Southern Illinois Salukis,G. Walker,4399431,,True,25.0,4,7,4,7,0,0,0,2,1,4,5,2,0,0,2,4,8
401402639,Southern Illinois Salukis,A. Brockmeyer,4287036,,True,38.0,5,13,5,10,0,3,1,3,4,3,7,2,1,1,4,1,11
401402639,Southern Illinois Salukis,Q. Love,4704868,,True,39.0,0,5,0,3,0,2,0,0,1,0,1,1,2,0,1,1,0
401402639,Southern Illinois Salukis,C. Link,4399430,,True,23.0,2,10,1,4,1,6,0,0,0,2,2,1,2,0,2,3,5
401402639,Southern Illinois Salukis,M. Silvey,4282270,,True,37.0,4,15,2,10,2,5,2,4,2,4,6,0,4,0,3,3,12
401402639,Southern Illinois Salukis,A. Katcher,4704871,,False,6.0,1,1,1,1,0,0,0,0,2,2,4,0,0,0,0,0,2
401402639,Southern Illinois Salukis,L. Randle,4664773,,False,13.0,2,5,2,5,0,0,0,0,3,2,5,0,0,0,0,0,4
401402639,Southern Illinois Salukis,T. Brown,4900092,,False,9.0,0,1,0,0,0,1,0,0,0,1,1,2,0,0,2,3,0
401402639,Southern Illinois Salukis,P. McCallister,4399432,,False,9.0,0,2,0,0,0,2,0,0,0,0,0,0,0,0,1,0,0
401402639,Southern Illinois Salukis,TEAM,TOTAL,TOTAL,False,,18,59,15,40,3,19,3,9,16,19,35,8,9,1,18,15,42
401402639,Illinois State Redbirds,K. Bullman,4704825,,True,38.0,2,7,2,3,0,4,0,0,2,9,11,1,1,2,1,3,4
401402639,Illinois State Redbirds,D. Wilson,4704824,,True,36.0,5,6,5,6,0,0,2,4,1,9,10,1,1,1,8,2,12
401402639,Illinois State Redbirds,J. Redmond,4595585,,True,39.0,7,13,7,13,0,0,4,5,0,1,1,4,4,0,3,3,18
401402639,Illinois State Redbirds,M. Wong,4595584,,True,35.0,1,4,1,1,0,3,4,5,0,1,1,3,1,0,3,4,6
401402639,Illinois State Redbirds,M. Crompton,4399389,,True,27.0,2,7,0,0,2,7,0,0,0,1,1,0,1,0,1,2,6
401402639,Illinois State Redbirds,C. Van Zeeland,4900067,,False,2.0,0,0,0,0,0,0,0,0,0,0,0,0,0,0,1,0,0
401402639,Illinois State Redbirds,J. McGinnis-Taylor,4704823,,False,4.0,2,2,2,2,0,0,0,0,0,0,0,0,0,0,1,2,4
401402639,Illinois State Redbirds,K. Bowers,4900066,,False,6.0,0,0,0,0,0,0,0,0,0,0,0,1,0,0,0,0,0
401402639,Illinois State Redbirds,K. Newland,4399394,,False,13.0,0,1,0,0,0,1,0,0,0,2,2,0,0,0,0,1,0
401402639,Illinois State Redbirds,TEAM,TOTAL,TOTAL,False,,19,40,17,25,2,15,10,14,3,26,29,10,8,3,18,17,50
401402638,Valparaiso Beacons,C. Morrison,4069010,,True,18.0,1,5,0,1,1,4,0,0,0,2,2,0,0,0,0,1,3
401402638,Valparaiso Beacons,O. Brown,4594796,,True,25.0,0,2,0,2,0,0,0,0,0,3,3,1,0,0,0,2,0
401402638,Valparaiso Beacons,S. Frederick,4399435,,True,33.0,2,8,1,5,1,3,3,4,0,3,3,3,0,0,2,1,8
401402638,Valparaiso Beacons,G. White,4282520,,True,23.0,0,6,0,4,0,2,0,0,2,1,3,0,0,0,1,4,0
401402638,Valparaiso Beacons,C. Weinman,4282518,,True,28.0,4,11,4,11,0,0,1,2,1,3,4,0,4,0,1,1,9
401402638,Valparaiso Beacons,K. Beyer,4713884,,False,3.0,0,0,0,0,0,0,0,0,0,1,1,0,0,0,0,0,0
401402638,Valparaiso Beacons,J. Johnston,4705622,,False,6.0,1,3,1,3,0,0,1,2,0,1,1,0,0,0,0,1,3
401402638,Valparaiso Beacons,C. VanKempen,4595610,,False,12.0,0,1,0,1,0,0,0,0,0,1,1,0,0,1,0,1,0
401402638,Valparaiso Beacons,L. Earnest,4705620,,False,16.0,3,4,2,3,1,1,0,0,0,6,6,0,0,0,3,3,7
401402638,Valparaiso Beacons,A. Interrante,4705618,,False,9.0,1,1,1,1,0,0,2,2,0,2,2,2,1,0,0,1,4
401402638,Valparaiso Beacons,I. Pitts,4399434,,False,8.0,0,1,0,0,0,1,0,0,0,1,1,0,0,0,3,0,0
401402638,Valparaiso Beacons,M. Dunson,4399402,,False,19.0,2,7,1,4,1,3,0,2,0,0,0,0,0,0,1,1,5
401402638,Valparaiso Beacons,TEAM,TOTAL,TOTAL,False,,14,49,10,35,4,14,7,12,3,25,28,6,5,1,14,16,39
401402638,Northern Iowa Panthers,G. Boffeli,4704857,,True,23.0,3,5,3,5,0,0,4,5,7,7,14,0,2,0,0,2,10
401402638,Northern Iowa Panthers,B. Gunnels,4282228,,True,28.0,1,3,1,3,0,0,4,4,2,13,15,1,0,1,2,0,6
401402638,Northern Iowa Panthers,K. Finley,4399421,,True,24.0,6,17,6,10,0,7,4,4,0,0,0,1,0,0,1,3,16
401402638,Northern Iowa Panthers,N. Kroeger,4282226,,True,32.0,1,5,1,2,0,3,1,2,1,2,3,2,1,0,0,1,3
401402638,Northern Iowa Panthers,K. Rucker,4282225,,True,18.0,3,9,3,7,0,2,0,0,0,3,3,3,0,0,0,2,6
401402638,Northern Iowa Panthers,S. McCullough,4595605,,False,5.0,1,1,0,0,1,1,0,0,0,0,0,1,0,0,0,0,3
401402638,Northern Iowa Panthers,K. Barney,4399424,,False,1.0,0,1,0,1,0,0,0,0,0,0,0,0,0,0,0,0,0
401402638,Northern Iowa Panthers,C. Wolf,4399423,,False,9.0,2,2,2,2,0,0,0,0,0,1,1,0,1,0,2,1,4
401402638,Northern Iowa Panthers,K. Laube,4704856,,False,10.0,2,3,1,1,1,2,0,0,0,1,1,0,1,0,0,0,5
401402638,Northern Iowa Panthers,E. Green,4704853,,False,15.0,0,4,0,3,0,1,2,2,0,1,1,1,0,2,1,2,2
401402638,Northern Iowa Panthers,M. McDermott,4704852,,False,20.0,2,7,1,2,1,5,0,0,0,2,2,1,1,0,2,2,5
401402638,Northern Iowa Panthers,C. Morgan,4595604,,False,15.0,1,4,0,0,1,4,0,0,2,0,2,2,1,0,0,0,3
401402638,Northern Iowa Panthers,TEAM,TOTAL,TOTAL,False,,22,61,18,36,4,25,15,17,13,32,45,12,7,3,10,13,63
401402637,Missouri State Lady Bears,A. Jackson,4280839,,True,28.0,6,12,6,11,0,1,0,0,3,6,9,0,0,5,1,4,12
401402637,Missouri State Lady Bears,M. Bhinhar,4399417,,True,33.0,3,10,3,6,0,4,0,0,0,2,2,7,2,0,5,4,6
401402637,Missouri State Lady Bears,S. Wilson,4399416,,True,37.0,3,11,2,8,1,3,10,10,5,8,13,0,0,0,0,2,17
401402637,Missouri State Lady Bears,M. White,4281945,,True,33.0,6,17,6,16,0,1,0,0,2,2,4,1,2,0,1,3,12
401402637,Missouri State Lady Bears,B. Calip,4068634,,True,34.0,3,13,2,11,1,2,4,6,2,8,10,2,0,1,1,1,11
401402637,Missouri State Lady Bears,I. Nwachukwu,4900080,,False,17.0,1,1,1,1,0,0,0,0,1,7,8,0,1,0,3,2,2
401402637,Missouri State Lady Bears,J. Ezeh,4433647,,False,7.0,0,3,0,3,0,0,0,0,2,1,3,0,0,1,0,1,0
401402637,Missouri State Lady Bears,I. Delarue,4900081,,False,5.0,1,2,0,0,1,2,0,0,0,0,0,0,0,0,0,0,3
401402637,Missouri State Lady Bears,P. Rocca,4704874,,False,6.0,0,2,0,1,0,1,0,0,0,0,0,0,0,0,1,1,0
401402637,Missouri State Lady Bears,TEAM,TOTAL,TOTAL,False,,23,71,20,57,3,14,14,16,20,37,57,10,5,7,12,18,63
401402637,Drake Bulldogs,M. Bair,4595576,,True,27.0,4,13,3,11,1,2,0,0,1,5,6,1,1,4,2,4,9
401402637,Drake Bulldogs,G. Berg,4398741,,True,30.0,4,11,4,10,0,1,1,1,1,3,4,2,0,0,1,4,9
401402637,Drake Bulldogs,K. Dinnebier,4900053,,True,28.0,2,10,2,7,0,3,7,9,0,2,2,2,0,0,1,2,11
401402637,Drake Bulldogs,M. Meyer,4433118,,True,28.0,2,10,1,1,1,9,1,1,0,4,4,2,2,1,2,5,6
401402637,Drake Bulldogs,M. Petersen,4282208,,True,33.0,3,6,1,1,2,5,0,0,0,0,0,0,0,0,2,1,8
401402637,Drake Bulldogs,A. Miller,4900055,,False,13.0,0,6,0,5,0,1,3,4,3,1,4,0,1,3,4,0,3
401402637,Drake Bulldogs,C. Becker,4704842,,False,8.0,0,0,0,0,0,0,0,0,0,2,2,1,0,0,1,1,0
401402637,Drake Bulldogs,A. Wooldridge,4399376,,False,8.0,0,0,0,0,0,0,0,0,1,0,1,0,0,0,0,0,0
401402637,Drake Bulldogs,S. Gueldner,4433721,,False,13.0,1,4,0,0,1,4,0,0,0,3,3,0,0,1,0,0,3
401402637,Drake Bulldogs,H. Fuller,4282209,,False,12.0,0,0,0,0,0,0,0,0,0,5,5,2,0,0,0,2,0
401402637,Drake Bulldogs,TEAM,TOTAL,TOTAL,False,,16,60,11,35,5,25,12,15,9,29,38,10,4,9,13,19,49
401402636,Loyola Chicago Ramblers,J. Hoefling,4595602,,True,22.0,2,5,2,5,0,0,0,0,1,5,6,3,0,0,2,4,4
401402636,Loyola Chicago Ramblers,A. Day,4399400,,True,31.0,3,10,3,7,0,3,1,2,3,9,12,2,0,0,3,3,7
401402636,Loyola Chicago Ramblers,M. Chandler,4704844,,True,23.0,4,11,2,5,2,6,2,2,0,1,1,1,1,0,0,3,12
401402636,Loyola Chicago Ramblers,S. Galanopoulos,4595599,,True,34.0,2,10,1,7,1,3,2,2,0,1,1,1,0,0,0,1,7
401402636,Loyola Chicago Ramblers,B. Hampton-Bey,4281849,,True,22.0,2,9,2,6,0,3,2,4,1,2,3,5,2,0,0,4,6
401402636,Loyola Chicago Ramblers,S. Tanin,4704845,,False,8.0,0,1,0,1,0,0,0,0,0,1,1,0,0,0,0,1,0
401402636,Loyola Chicago Ramblers,R. Blackwell,4282145,,False,21.0,3,6,3,4,0,2,2,2,0,2,2,0,0,0,0,0,8
401402636,Loyola Chicago Ramblers,A. Brown,4595601,,False,19.0,1,2,0,0,1,2,0,0,0,4,4,1,0,0,0,1,3
401402636,Loyola Chicago Ramblers,J. Johnson,4595598,,False,15.0,1,1,1,1,0,0,0,0,0,1,1,1,1,0,1,1,2
401402636,Loyola Chicago Ramblers,J. Gonzales,4399399,,False,5.0,1,3,0,0,1,3,0,0,0,0,0,0,0,0,0,0,3
401402636,Loyola Chicago Ramblers,TEAM,TOTAL,TOTAL,False,,19,58,14,36,5,22,9,12,6,27,33,14,4,0,6,18,52
401402636,Illinois State Redbirds,K. Bullman,4704825,,True,37.0,2,4,1,3,1,1,2,2,0,4,4,2,0,1,0,4,7
401402636,Illinois State Redbirds,D. Wilson,4704824,,True,28.0,4,8,4,8,0,0,3,5,1,9,10,0,0,1,2,3,11
401402636,Illinois State Redbirds,J. Redmond,4595585,,True,35.0,12,25,10,23,2,2,3,5,3,4,7,1,0,0,1,1,29
401402636,Illinois State Redbirds,M. Wong,4595584,,True,20.0,0,1,0,1,0,0,7,8,0,0,0,3,0,0,1,4,7
401402636,Illinois State Redbirds,M. Crompton,4399389,,True,35.0,2,6,1,3,1,3,1,1,0,1,1,2,0,0,2,2,6
401402636,Illinois State Redbirds,C. Van Zeeland,4900067,,False,3.0,1,1,0,0,1,1,0,0,0,0,0,0,0,0,0,0,3
401402636,Illinois State Redbirds,J. McGinnis-Taylor,4704823,,False,4.0,0,0,0,0,0,0,0,0,0,1,1,0,0,0,0,0,0
401402636,Illinois State Redbirds,K. Bowers,4900066,,False,18.0,0,3,0,1,0,2,0,0,0,4,4,0,0,0,2,1,0
401402636,Illinois State Redbirds,K. Newland,4399394,,False,20.0,1,2,0,0,1,2,2,2,0,3,3,0,0,0,0,1,5
401402636,Illinois State Redbirds,TEAM,TOTAL,TOTAL,False,,22,50,16,39,6,11,18,23,5,32,37,8,0,2,10,16,68
401402635,Southern Illinois Salukis,G. Walker,4399431,,True,30.0,7,12,7,12,0,0,6,6,3,5,8,0,0,1,2,4,20
401402635,Southern Illinois Salukis,A. Brockmeyer,4287036,,True,30.0,6,10,5,8,1,2,5,6,4,6,10,0,1,0,1,1,18
401402635,Southern Illinois Salukis,Q. Love,4704868,,True,34.0,2,8,2,5,0,3,4,4,0,2,2,1,4,0,2,0,8
401402635,Southern Illinois Salukis,C. Link,4399430,,True,24.0,2,3,0,1,2,2,0,0,0,1,1,5,1,0,1,3,6
401402635,Southern Illinois Salukis,M. Silvey,4282270,,True,35.0,6,13,5,9,1,4,1,1,3,4,7,2,0,0,3,2,14
401402635,Southern Illinois Salukis,A. Katcher,4704871,,False,8.0,1,2,1,2,0,0,0,0,0,0,0,1,0,0,0,0,2
401402635,Southern Illinois Salukis,L. Randle,4664773,,False,13.0,1,2,1,2,0,0,2,2,1,2,3,0,1,0,1,0,4
401402635,Southern Illinois Salukis,T. Brown,4900092,,False,8.0,1,3,1,3,0,0,0,0,2,0,2,0,2,0,0,1,2
401402635,Southern Illinois Salukis,P. McCallister,4399432,,False,18.0,1,5,0,1,1,4,0,0,0,1,1,3,0,0,1,1,3
401402635,Southern Illinois Salukis,TEAM,TOTAL,TOTAL,False,,27,58,22,43,5,15,18,19,14,22,36,12,9,1,11,12,77
401402635,Indiana State Sycamores,A. Smith,4900073,,True,19.0,2,4,2,3,0,1,1,2,1,0,1,1,0,0,0,3,5
401402635,Indiana State Sycamores,M. Glanton,4595587,,True,24.0,2,5,2,5,0,0,0,0,0,3,3,2,0,1,1,5,4
401402635,Indiana State Sycamores,N. Lalic,4704827,,True,29.0,4,8,2,4,2,4,0,0,0,2,2,4,1,0,1,1,10
401402635,Indiana State Sycamores,D. Williams,4595597,,True,35.0,3,11,1,6,2,5,0,0,0,4,4,4,2,0,3,3,8
401402635,Indiana State Sycamores,M. Hunter,4595588,,True,28.0,7,10,6,9,1,1,0,1,1,2,3,2,2,1,3,2,15
401402635,Indiana State Sycamores,A. McKendree,4705287,,False,12.0,2,3,1,2,1,1,1,2,1,0,1,0,1,0,0,0,6
401402635,Indiana State Sycamores,C. Anderson,4595596,,False,24.0,1,4,1,4,0,0,1,2,0,1,1,0,2,0,1,4,3
401402635,Indiana State Sycamores,T. Curry,4281864,,False,29.0,5,5,5,5,0,0,0,0,0,4,4,1,0,0,3,3,10
401402635,Indiana State Sycamores,TEAM,TOTAL,TOTAL,False,,26,50,20,38,6,12,3,7,3,17,20,14,8,2,13,21,61
401402634,Drake Bulldogs,M. Bair,4595576,,True,21.0,6,12,6,10,0,2,5,8,2,3,5,2,0,0,3,2,17
401402634,Drake Bulldogs,G. Berg,4398741,,True,25.0,4,7,4,7,0,0,1,2,1,3,4,1,1,0,2,3,9
401402634,Drake Bulldogs,K. Dinnebier,4900053,,True,25.0,3,9,3,5,0,4,3,3,0,5,5,4,3,1,1,0,9
401402634,Drake Bulldogs,M. Meyer,4433118,,True,25.0,4,7,3,3,1,4,0,0,0,5,5,2,1,0,2,4,9
401402634,Drake Bulldogs,M. Petersen,4282208,,True,26.0,2,2,0,0,2,2,0,0,0,1,1,2,0,0,0,0,6
401402634,Drake Bulldogs,A. Miller,4900055,,False,16.0,4,6,3,4,1,2,1,2,0,4,4,3,0,1,2,0,10
401402634,Drake Bulldogs,A. Iiams,4900054,,False,2.0,0,1,0,0,0,1,0,0,0,0,0,0,0,0,0,0,0
401402634,Drake Bulldogs,C. Becker,4704842,,False,10.0,2,4,2,4,0,0,0,1,1,3,4,0,0,0,3,0,4
401402634,Drake Bulldogs,A. Wooldridge,4399376,,False,11.0,0,1,0,1,0,0,1,2,4,2,6,1,1,0,0,0,1
401402634,Drake Bulldogs,M. Phipps,4900056,,False,2.0,0,1,0,0,0,1,0,0,0,0,0,0,0,0,0,0,0
401402634,Drake Bulldogs,H. Nilges,4900052,,False,1.0,0,0,0,0,0,0,0,0,0,0,0,0,0,0,0,0,0
401402634,Drake Bulldogs,S. Gueldner,4433721,,False,19.0,1,4,0,0,1,4,0,0,0,2,2,2,0,0,1,3,3
401402634,Drake Bulldogs,H. Fuller,4282209,,False,17.0,1,2,0,0,1,2,0,0,1,1,2,1,1,0,0,1,3
401402634,Drake Bulldogs,TEAM,TOTAL,TOTAL,False,,27,56,21,34,6,22,11,18,13,30,43,18,7,2,15,13,71
401402634,Bradley Braves,I. Fitch,4704808,,True,32.0,7,11,7,10,0,1,0,0,1,6,7,0,1,0,0,2,14
401402634,Bradley Braves,T. Danso,4704806,,True,23.0,0,2,0,2,0,0,0,0,2,2,4,1,0,0,1,2,0
401402634,Bradley Braves,C. Waite,4900043,,True,36.0,4,12,1,4,3,8,1,2,1,1,2,2,2,0,0,2,12
401402634,Bradley Braves,C. Rice,4399479,,True,16.0,0,3,0,2,0,1,2,2,0,2,2,0,0,0,1,2,2
401402634,Bradley Braves,T. Koenig,4399368,,True,37.0,4,12,2,6,2,6,0,0,1,3,4,2,5,0,3,1,10
401402634,Bradley Braves,C. Ziebell,4900047,,False,6.0,2,5,2,5,0,0,0,0,2,1,3,0,0,0,0,1,4
401402634,Bradley Braves,A. Draper,4900045,,False,28.0,3,7,3,5,0,2,1,2,0,0,0,0,1,2,3,1,7
401402634,Bradley Braves,S. Morrow,4900041,,False,14.0,1,4,1,3,0,1,2,4,0,2,2,1,0,0,0,4,4
401402634,Bradley Braves,V. Roberts,4595573,,False,2.0,0,0,0,0,0,0,0,0,0,0,0,0,0,0,1,1,0
401402634,Bradley Braves,K. Wade,4913494,,False,1.0,0,0,0,0,0,0,0,0,0,0,0,0,0,0,0,0,0
401402634,Bradley Braves,S. Koenig,4900046,,False,2.0,1,2,0,1,1,1,0,0,0,0,0,0,0,0,0,0,3
401402634,Bradley Braves,A. Interrante,4399365,,False,3.0,0,0,0,0,0,0,0,0,0,0,0,0,0,0,0,0,0
401402634,Bradley Braves,TEAM,TOTAL,TOTAL,False,,22,58,16,38,6,20,6,10,8,21,29,6,9,2,11,16,56
401402633,Indiana State Sycamores,A. Smith,4900073,,True,27.0,6,8,6,7,0,1,5,7,3,3,6,4,2,0,1,3,17
401402633,Indiana State Sycamores,M. Glanton,4595587,,True,35.0,12,24,12,24,0,0,2,2,7,5,12,1,1,0,1,2,26
401402633,Indiana State Sycamores,N. Lalic,4704827,,True,22.0,1,4,1,4,0,0,0,0,0,7,7,0,1,0,0,2,2
401402633,Indiana State Sycamores,D. Williams,4595597,,True,24.0,5,7,2,3,3,4,0,0,0,1,1,4,1,1,3,4,13
401402633,Indiana State Sycamores,M. Hunter,4595588,,True,37.0,9,12,8,10,1,2,4,4,0,2,2,2,0,0,1,1,23
401402633,Indiana State Sycamores,A. McKendree,4705287,,False,12.0,0,4,0,0,0,4,0,0,0,0,0,1,1,0,1,4,0
401402633,Indiana State Sycamores,C. Anderson,4595596,,False,27.0,1,5,1,4,0,1,4,4,1,3,4,3,1,1,1,4,6
401402633,Indiana State Sycamores,T. Curry,4281864,,False,16.0,1,3,1,3,0,0,0,3,1,3,4,0,0,0,0,2,2
401402633,Indiana State Sycamores,TEAM,TOTAL,TOTAL,False,,35,67,31,55,4,12,15,20,13,26,39,15,7,2,8,22,89
401402633,Evansville Purple Aces,C. Dupont,4595646,,True,20.0,0,1,0,1,0,0,1,2,0,6,6,0,0,1,0,2,1
401402633,Evansville Purple Aces,A. Feit,4595579,,True,35.0,10,13,7,7,3,6,0,1,5,5,10,0,2,0,1,4,23
401402633,Evansville Purple Aces,J. Davis,4595941,,True,34.0,3,12,2,5,1,7,2,4,0,2,2,1,0,0,0,4,9
401402633,Evansville Purple Aces,M. Clark,4399481,,True,25.0,2,8,2,5,0,3,5,6,1,0,1,2,0,0,3,3,9
401402633,Evansville Purple Aces,A. Newman,4399380,,True,34.0,5,8,3,5,2,3,5,9,1,2,3,5,1,0,2,2,17
401402633,Evansville Purple Aces,K. Myszka,4900059,,False,1.0,0,0,0,0,0,0,0,0,0,0,0,0,0,0,0,0,0
401402633,Evansville Purple Aces,J. Hudson,4595580,,False,21.0,0,1,0,1,0,0,4,4,1,4,5,1,1,1,0,2,4
401402633,Evansville Purple Aces,N. Partee,4595577,,False,2.0,0,0,0,0,0,0,2,2,0,0,0,0,0,0,0,0,2
401402633,Evansville Purple Aces,E. Morgan,4900058,,False,8.0,0,2,0,2,0,0,2,2,0,0,0,0,0,0,0,1,2
401402633,Evansville Purple Aces,A. Griffin,4399385,,False,20.0,3,11,3,9,0,2,2,2,0,2,2,0,0,0,3,2,8
401402633,Evansville Purple Aces,TEAM,TOTAL,TOTAL,False,,23,56,17,35,6,21,23,32,10,21,31,9,4,2,9,20,75
401402631,Norfolk State Spartans,M. Diawara,4705343,,True,33.0,5,15,5,13,0,2,1,2,6,7,13,0,2,1,0,4,11
401402631,Norfolk State Spartans,M. Williams,4595001,,True,11.0,1,1,1,1,0,0,0,0,0,0,0,0,0,0,3,2,2
401402631,Norfolk State Spartans,N. Fields,4705341,,True,28.0,0,4,0,1,0,3,1,2,1,1,2,1,0,0,1,3,1
401402631,Norfolk State Spartans,D. Francis,4399462,,True,36.0,2,18,2,16,0,2,5,6,4,0,4,3,1,0,1,2,9
401402631,Norfolk State Spartans,C. Downs,4282235,,True,31.0,2,7,1,4,1,3,5,6,4,2,6,2,2,3,4,5,10
401402631,Norfolk State Spartans,L. Savage,4282370,,False,4.0,0,0,0,0,0,0,0,0,1,0,1,0,0,0,0,2,0
401402631,Norfolk State Spartans,J. Turner,4899969,,False,11.0,1,6,1,2,0,4,0,0,0,0,0,0,0,0,0,1,2
401402631,Norfolk State Spartans,C. White,4705327,,False,7.0,0,4,0,0,0,4,0,0,0,1,1,0,0,0,0,1,0
401402631,Norfolk State Spartans,D. Williams,4704326,,False,17.0,2,5,1,1,1,4,0,0,0,0,0,0,1,0,0,0,5
401402631,Norfolk State Spartans,A. Franklin,4282402,,False,22.0,2,5,2,3,0,2,0,0,0,0,0,1,0,0,3,2,4
401402631,Norfolk State Spartans,TEAM,TOTAL,TOTAL,False,,15,65,13,41,2,24,12,16,18,12,30,7,6,4,14,22,44
401402631,Howard Bison,B. Fort-Davis,4705321,,True,29.0,4,10,4,10,0,0,0,0,2,9,11,1,1,0,1,3,8
401402631,Howard Bison,K. Marsh,4400350,,True,22.0,2,3,2,3,0,0,4,4,3,3,6,1,0,0,2,3,8
401402631,Howard Bison,K. Harris,4705322,,True,35.0,1,1,0,0,1,1,2,2,0,5,5,3,0,2,3,4,5
401402631,Howard Bison,D. Howell,4705316,,True,40.0,7,17,4,7,3,10,8,8,2,4,6,2,2,1,6,2,25
401402631,Howard Bison,I. Warren,4595524,,True,27.0,0,5,0,3,0,2,5,6,2,2,4,4,2,0,6,2,5
401402631,Howard Bison,K. Creek,4705320,,False,0.0,0,0,0,0,0,0,0,0,0,0,0,0,0,0,0,0,0
401402631,Howard Bison,A. Hutton,4705315,,False,29.0,3,5,3,5,0,0,0,0,1,5,6,1,0,0,1,2,6
401402631,Howard Bison,V. Udoji,4070243,,False,5.0,0,2,0,1,0,1,0,0,1,2,3,0,0,0,1,0,0
401402631,Howard Bison,G. Thorpe,4400349,,False,13.0,2,6,2,6,0,0,0,0,2,1,3,0,0,0,4,0,4
401402631,Howard Bison,TEAM,TOTAL,TOTAL,False,,19,49,15,35,4,14,19,20,15,33,48,12,5,3,25,16,61
401402630,Norfolk State Spartans,M. Diawara,4705343,,True,34.0,6,8,5,7,1,1,1,2,3,7,10,1,1,1,5,3,14
401402630,Norfolk State Spartans,M. Williams,4595001,,True,27.0,1,7,1,6,0,1,0,0,2,2,4,1,0,3,1,4,2
401402630,Norfolk State Spartans,N. Fields,4705341,,True,28.0,0,6,0,4,0,2,0,0,0,1,1,3,3,1,2,1,0
401402630,Norfolk State Spartans,D. Francis,4399462,,True,40.0,5,8,5,8,0,0,9,11,1,1,2,4,1,0,2,3,19
401402630,Norfolk State Spartans,C. Downs,4282235,,True,28.0,5,16,5,12,0,4,4,5,3,3,6,0,4,0,3,3,14
401402630,Norfolk State Spartans,L. Savage,4282370,,False,2.0,0,0,0,0,0,0,0,0,0,0,0,0,0,0,0,0,0
401402630,Norfolk State Spartans,J. Turner,4899969,,False,10.0,1,1,1,1,0,0,0,0,0,1,1,0,0,0,0,1,2
401402630,Norfolk State Spartans,C. White,4705327,,False,7.0,0,1,0,0,0,1,0,0,0,0,0,0,0,0,1,0,0
401402630,Norfolk State Spartans,D. Williams,4704326,,False,14.0,1,2,1,2,0,0,0,2,1,3,4,0,0,0,2,2,2
401402630,Norfolk State Spartans,A. Franklin,4282402,,False,10.0,0,2,0,1,0,1,0,0,1,1,2,0,0,0,0,0,0
401402630,Norfolk State Spartans,TEAM,TOTAL,TOTAL,False,,19,51,18,41,1,10,14,20,13,19,32,9,9,5,17,17,53
401402630,Morgan State Lady Bears,T. Addison,4399569,,True,23.0,0,2,0,1,0,1,0,0,2,0,2,0,0,0,1,1,0
401402630,Morgan State Lady Bears,C. Shepherd,4399530,,True,32.0,5,9,3,7,2,2,1,2,3,5,8,2,0,0,4,4,13
401402630,Morgan State Lady Bears,J. Henson,4595536,,True,26.0,4,13,4,8,0,5,1,2,0,3,3,1,1,0,2,1,9
401402630,Morgan State Lady Bears,A. Brisker,4595384,,True,32.0,1,5,1,1,0,4,0,0,0,2,2,2,1,0,0,1,2
401402630,Morgan State Lady Bears,A. McCalla,4406561,,True,27.0,2,7,0,0,2,7,3,5,1,3,4,2,1,0,4,3,9
401402630,Morgan State Lady Bears,K. Ponder,4899963,,False,3.0,0,1,0,1,0,0,0,0,1,0,1,0,0,0,0,1,0
401402630,Morgan State Lady Bears,D. Redd,4595541,,False,26.0,2,6,2,6,0,0,2,4,5,3,8,0,1,1,2,2,6
401402630,Morgan State Lady Bears,S. McCrae,4594729,,False,7.0,2,3,2,3,0,0,0,0,2,2,4,1,0,1,0,2,4
401402630,Morgan State Lady Bears,J. Atmore,4596266,,False,24.0,3,9,3,7,0,2,2,2,0,3,3,1,0,0,4,2,8
401402630,Morgan State Lady Bears,TEAM,TOTAL,TOTAL,False,,19,55,15,34,4,21,9,15,16,23,39,9,4,2,19,17,51
401402609,Maryland Eastern Shore Hawks,L. Thomas,4899959,,True,21.0,3,5,3,5,0,0,0,0,3,1,4,0,3,0,1,5,6
401402609,Maryland Eastern Shore Hawks,B. Gill-Miles,4282288,,True,22.0,1,4,1,4,0,0,0,0,2,5,7,0,2,0,3,2,2
401402609,Maryland Eastern Shore Hawks,Z. Haynes,4705351,,True,32.0,6,17,4,10,2,7,4,8,0,2,2,4,0,0,3,1,18
401402609,Maryland Eastern Shore Hawks,C. Wilson,4705350,,True,7.0,0,0,0,0,0,0,1,2,0,1,1,1,0,0,0,1,1
401402609,Maryland Eastern Shore Hawks,A. Taylor,4282289,,True,24.0,2,6,1,2,1,4,0,0,1,7,8,2,0,0,2,4,5
401402609,Maryland Eastern Shore Hawks,M. Lester,4595527,,False,5.0,0,3,0,3,0,0,0,0,5,0,5,0,0,0,1,3,0
401402609,Maryland Eastern Shore Hawks,A. Pearly,4705352,,False,5.0,0,0,0,0,0,0,0,1,0,0,0,0,0,0,0,0,0
401402609,Maryland Eastern Shore Hawks,J. Grady,4705353,,False,10.0,0,2,0,2,0,0,1,2,2,0,2,0,0,0,0,0,1
401402609,Maryland Eastern Shore Hawks,M. Thomas,4595528,,False,26.0,2,8,2,4,0,4,0,0,1,2,3,6,1,0,1,4,4
401402609,Maryland Eastern Shore Hawks,J. Blanks,4595529,,False,1.0,0,0,0,0,0,0,0,0,0,0,0,0,0,0,0,0,0
401402609,Maryland Eastern Shore Hawks,B. Bailey,4400351,,False,18.0,1,12,0,5,1,7,1,2,0,1,1,1,0,0,3,3,4
401402609,Maryland Eastern Shore Hawks,A. Carney,4282292,,False,29.0,4,14,1,5,3,9,2,3,0,4,4,0,1,0,0,2,13
401402609,Maryland Eastern Shore Hawks,TEAM,TOTAL,TOTAL,False,,19,71,12,40,7,31,9,18,16,25,41,14,7,0,14,25,54
401402609,Howard Bison,B. Fort-Davis,4705321,,True,31.0,3,10,3,10,0,0,4,5,4,5,9,1,3,1,4,5,10
401402609,Howard Bison,K. Marsh,4400350,,True,24.0,3,6,3,6,0,0,0,3,5,9,14,0,0,2,1,2,6
401402609,Howard Bison,K. Harris,4705322,,True,30.0,2,5,2,3,0,2,4,4,0,6,6,4,1,0,1,3,8
401402609,Howard Bison,D. Howell,4705316,,True,30.0,2,13,1,6,1,7,1,3,0,2,2,1,2,0,5,5,6
401402609,Howard Bison,I. Warren,4595524,,True,34.0,6,17,4,14,2,3,7,9,0,6,6,1,0,0,4,2,21
401402609,Howard Bison,M. Steel,4901382,,False,1.0,0,0,0,0,0,0,0,0,0,0,0,0,0,0,0,0,0
401402609,Howard Bison,N. Nelson,4899956,,False,1.0,0,0,0,0,0,0,0,0,0,0,0,0,0,0,0,0,0
401402609,Howard Bison,K. Creek,4705320,,False,4.0,0,0,0,0,0,0,0,0,0,0,0,0,0,0,1,0,0
401402609,Howard Bison,A. Hutton,4705315,,False,18.0,2,2,2,2,0,0,6,8,3,4,7,2,1,2,3,4,10
401402609,Howard Bison,V. Udoji,4070243,,False,8.0,1,4,1,1,0,3,0,0,1,2,3,1,1,0,1,0,2
401402609,Howard Bison,N. Cooper,4899955,,False,2.0,1,1,0,0,1,1,0,0,0,0,0,0,0,0,0,0,3
401402609,Howard Bison,A. Wilson,4705319,,False,1.0,0,1,0,1,0,0,0,0,0,1,1,0,0,0,0,0,0
401402609,Howard Bison,G. Thorpe,4400349,,False,16.0,1,3,1,2,0,1,0,1,1,0,1,0,0,0,0,1,2
401402609,Howard Bison,TEAM,TOTAL,TOTAL,False,,21,62,17,45,4,17,22,33,17,39,56,10,8,5,20,22,68
401402608,South Carolina State Lady Bulldogs,B. Thompson,4900034,,True,21.0,2,2,2,2,0,0,1,2,1,4,5,0,0,0,1,2,5
401402608,South Carolina State Lady Bulldogs,R. Reid,4900036,,True,26.0,2,6,2,6,0,0,0,0,1,4,5,3,0,1,3,3,4
401402608,South Carolina State Lady Bulldogs,J. Hicks,4595567,,True,31.0,6,12,4,7,2,5,2,2,3,5,8,1,1,0,3,1,16
401402608,South Carolina State Lady Bulldogs,N. Gwynn,4900040,,True,19.0,1,11,0,6,1,5,0,0,0,1,1,0,1,1,4,3,3
401402608,South Carolina State Lady Bulldogs,M. Lumpkin,4900035,,True,27.0,0,5,0,4,0,1,0,0,0,4,4,4,0,0,5,3,0
401402608,South Carolina State Lady Bulldogs,T. Klock,4705349,,False,23.0,5,12,5,8,0,4,1,1,3,2,5,0,2,1,2,0,11
401402608,South Carolina State Lady Bulldogs,S. Wright,4705348,,False,7.0,0,0,0,0,0,0,0,0,0,0,0,1,0,0,1,0,0
401402608,South Carolina State Lady Bulldogs,L. Sonnier,4900033,,False,15.0,2,3,2,2,0,1,1,1,2,4,6,1,1,0,6,3,5
401402608,South Carolina State Lady Bulldogs,T. Walls,4705967,,False,8.0,2,4,2,4,0,0,0,0,2,0,2,0,2,0,0,0,4
401402608,South Carolina State Lady Bulldogs,N. Reese,4705345,,False,23.0,1,4,0,2,1,2,2,2,0,1,1,2,0,0,4,3,5
401402608,South Carolina State Lady Bulldogs,TEAM,TOTAL,TOTAL,False,,21,59,17,41,4,18,7,8,16,27,43,12,7,3,29,18,53
401402608,Morgan State Lady Bears,T. Addison,4399569,,True,27.0,1,6,0,3,1,3,0,0,3,2,5,1,2,0,1,1,3
401402608,Morgan State Lady Bears,C. Shepherd,4399530,,True,31.0,6,12,6,11,0,1,0,1,2,3,5,2,2,0,1,2,12
401402608,Morgan State Lady Bears,J. Henson,4595536,,True,30.0,3,10,2,8,1,2,6,10,0,2,2,1,1,0,2,0,13
401402608,Morgan State Lady Bears,A. Brisker,4595384,,True,23.0,2,5,1,4,1,1,1,2,2,2,4,0,1,1,1,3,6
401402608,Morgan State Lady Bears,A. McCalla,4406561,,True,28.0,4,8,3,5,1,3,0,0,2,6,8,0,0,1,1,2,9
401402608,Morgan State Lady Bears,F. Black,4899964,,False,2.0,0,0,0,0,0,0,0,0,0,0,0,0,0,0,0,0,0
401402608,Morgan State Lady Bears,K. Ponder,4899963,,False,4.0,0,1,0,1,0,0,0,0,0,0,0,0,0,0,3,0,0
401402608,Morgan State Lady Bears,D. Redd,4595541,,False,16.0,3,5,3,5,0,0,1,1,0,3,3,1,0,0,3,2,7
401402608,Morgan State Lady Bears,S. McCrae,4594729,,False,7.0,0,0,0,0,0,0,0,0,0,0,0,0,1,0,0,1,0
401402608,Morgan State Lady Bears,A. Payne,4899962,,False,5.0,0,0,0,0,0,0,1,2,0,0,0,1,1,1,1,1,1
401402608,Morgan State Lady Bears,E. Jones,4899961,,False,2.0,0,0,0,0,0,0,0,0,0,0,0,1,0,0,4,0,0
401402608,Morgan State Lady Bears,K. Hines,4705324,,False,4.0,1,1,1,1,0,0,1,2,0,0,0,0,1,0,0,2,3
401402608,Morgan State Lady Bears,J. Atmore,4596266,,False,19.0,5,10,5,10,0,0,2,4,3,0,3,1,5,0,1,1,12
401402608,Morgan State Lady Bears,M. Bumbray,4595538,,False,2.0,0,0,0,0,0,0,0,0,0,0,0,0,0,0,1,0,0
401402608,Morgan State Lady Bears,TEAM,TOTAL,TOTAL,False,,25,58,21,48,4,10,12,22,13,22,35,8,14,3,20,15,66
401402607,Maryland Eastern Shore Hawks,L. Thomas,4899959,,True,19.0,1,1,1,1,0,0,0,0,1,4,5,0,0,0,1,4,2
401402607,Maryland Eastern Shore Hawks,B. Gill-Miles,4282288,,True,28.0,6,10,6,10,0,0,0,2,1,8,9,0,2,1,2,0,12
401402607,Maryland Eastern Shore Hawks,Z. Haynes,4705351,,True,26.0,9,18,9,16,0,2,7,9,4,4,8,1,0,0,3,5,25
401402607,Maryland Eastern Shore Hawks,C. Wilson,4705350,,True,8.0,0,2,0,2,0,0,1,2,0,0,0,0,0,0,1,0,1
401402607,Maryland Eastern Shore Hawks,A. Taylor,4282289,,True,23.0,0,2,0,0,0,2,0,0,1,2,3,2,0,1,0,4,0
401402607,Maryland Eastern Shore Hawks,M. Lester,4595527,,False,11.0,1,3,1,3,0,0,2,2,2,0,2,1,0,0,1,4,4
401402607,Maryland Eastern Shore Hawks,J. Grady,4705353,,False,3.0,0,2,0,2,0,0,0,0,0,0,0,0,0,0,0,0,0
401402607,Maryland Eastern Shore Hawks,M. Thomas,4595528,,False,29.0,3,6,1,2,2,4,2,2,0,2,2,2,0,0,0,2,10
401402607,Maryland Eastern Shore Hawks,B. Bailey,4400351,,False,24.0,4,10,3,7,1,3,2,2,1,2,3,0,0,0,4,3,11
401402607,Maryland Eastern Shore Hawks,A. Carney,4282292,,False,29.0,4,10,4,7,0,3,0,0,0,2,2,2,1,0,2,3,8
401402607,Maryland Eastern Shore Hawks,TEAM,TOTAL,TOTAL,False,,28,64,25,50,3,14,14,19,11,25,36,8,3,2,15,25,73
401402607,Coppin State Eagles,J. Salley,4400318,,True,14.0,0,5,0,5,0,0,4,6,2,4,6,0,0,2,1,4,4
401402607,Coppin State Eagles,A. Lawson,4595496,,True,37.0,1,13,1,1,0,12,1,1,0,4,4,3,2,0,3,3,3
401402607,Coppin State Eagles,A. Hamilton,4595495,,True,15.0,0,1,0,1,0,0,0,0,0,2,2,0,0,0,2,2,0
401402607,Coppin State Eagles,M. Staples,4594734,,True,32.0,1,6,0,2,1,4,5,6,3,4,7,0,1,0,1,2,8
401402607,Coppin State Eagles,J. Alexander,4065807,,True,31.0,14,22,13,19,1,3,4,6,1,2,3,1,2,0,5,4,33
401402607,Coppin State Eagles,K. Jenkins,4899916,,False,2.0,0,0,0,0,0,0,0,0,0,0,0,0,0,0,0,1,0
401402607,Coppin State Eagles,C. Bucknor,4703653,,False,22.0,3,6,3,6,0,0,4,4,4,1,5,0,0,0,1,3,10
401402607,Coppin State Eagles,J. Watkins,4899915,,False,22.0,1,4,1,1,0,3,0,0,1,3,4,0,0,0,2,2,2
401402607,Coppin State Eagles,H. Evans,4705293,,False,25.0,1,3,1,2,0,1,3,4,1,2,3,0,2,0,2,0,5
401402607,Coppin State Eagles,TEAM,TOTAL,TOTAL,False,,21,60,19,37,2,23,21,27,13,25,38,4,7,2,18,21,65
401402606,North Carolina Central Eagles,T. Carter,4595642,,True,18.0,2,4,2,4,0,0,0,2,0,3,3,0,0,0,3,3,4
401402606,North Carolina Central Eagles,A. Lockard,4400384,,True,34.0,1,5,1,5,0,0,2,2,4,4,8,0,0,2,3,3,4
401402606,North Carolina Central Eagles,D. Thomas,4899971,,True,30.0,4,15,3,7,1,8,2,3,1,5,6,1,1,0,2,1,11
401402606,North Carolina Central Eagles,K. Lowery,4703786,,True,30.0,1,3,1,3,0,0,1,2,1,3,4,2,0,0,4,1,3
401402606,North Carolina Central Eagles,T. Williams,4594708,,True,26.0,3,8,2,6,1,2,2,2,1,1,2,1,3,0,5,2,9
401402606,North Carolina Central Eagles,S. Edmundson,4604717,,False,8.0,0,0,0,0,0,0,0,0,0,1,1,0,0,0,1,0,0
401402606,North Carolina Central Eagles,N. Ford,4899972,,False,25.0,3,10,0,3,3,7,0,0,2,2,4,1,1,1,0,3,9
401402606,North Carolina Central Eagles,P. McBride,4705331,,False,26.0,4,9,3,6,1,3,3,5,0,2,2,3,4,0,3,3,12
401402606,North Carolina Central Eagles,M. Anderson,4595556,,False,3.0,0,1,0,1,0,0,0,0,0,0,0,0,1,0,1,0,0
401402606,North Carolina Central Eagles,TEAM,TOTAL,TOTAL,False,,18,55,12,35,6,20,10,16,11,23,34,8,10,3,22,16,52
401402606,Norfolk State Spartans,M. Williams,4595001,,True,30.0,5,10,5,10,0,0,2,4,2,3,5,2,5,5,5,3,12
401402606,Norfolk State Spartans,L. Savage,4282370,,True,6.0,0,1,0,1,0,0,0,0,0,0,0,0,0,0,1,0,0
401402606,Norfolk State Spartans,N. Fields,4705341,,True,31.0,1,4,1,3,0,1,0,0,1,5,6,4,2,0,2,3,2
401402606,Norfolk State Spartans,D. Francis,4399462,,True,32.0,4,10,4,10,0,0,2,5,0,4,4,5,2,0,5,4,10
401402606,Norfolk State Spartans,C. Downs,4282235,,True,21.0,3,11,0,5,3,6,0,0,3,4,7,1,1,1,1,2,9
401402606,Norfolk State Spartans,M. Diawara,4705343,,False,27.0,1,6,1,5,0,1,2,4,3,4,7,0,1,0,2,2,4
401402606,Norfolk State Spartans,J. Turner,4899969,,False,10.0,0,3,0,0,0,3,0,0,1,0,1,1,0,0,2,1,0
401402606,Norfolk State Spartans,C. White,4705327,,False,19.0,4,8,1,1,3,7,0,0,0,3,3,0,2,0,0,0,11
401402606,Norfolk State Spartans,D. Williams,4704326,,False,17.0,1,3,1,2,0,1,3,4,3,4,7,0,1,0,2,1,5
401402606,Norfolk State Spartans,A. Franklin,4282402,,False,7.0,2,3,2,3,0,0,1,1,0,1,1,0,0,0,1,3,5
401402606,Norfolk State Spartans,TEAM,TOTAL,TOTAL,False,,21,59,15,40,6,19,10,18,15,29,44,13,14,6,21,19,58
401402605,Howard Bison,B. Fort-Davis,4705321,,True,23.0,4,11,4,11,0,0,0,2,4,2,6,1,2,0,0,3,8
401402605,Howard Bison,K. Marsh,4400350,,True,20.0,4,6,4,6,0,0,0,0,4,7,11,1,1,4,1,1,8
401402605,Howard Bison,K. Harris,4705322,,True,22.0,2,4,2,4,0,0,2,2,3,2,5,5,4,0,0,0,6
401402605,Howard Bison,D. Howell,4705316,,True,20.0,7,17,5,8,2,9,0,0,0,0,0,1,3,0,1,1,16
401402605,Howard Bison,I. Warren,4595524,,True,19.0,1,5,1,4,0,1,0,0,0,1,1,5,0,0,0,2,2
401402605,Howard Bison,M. Steel,4901382,,False,6.0,1,1,1,1,0,0,0,0,1,0,1,0,0,0,1,3,2
401402605,Howard Bison,N. Nelson,4899956,,False,8.0,0,1,0,1,0,0,0,0,1,1,2,0,0,0,1,1,0
401402605,Howard Bison,K. Creek,4705320,,False,14.0,1,5,1,5,0,0,0,0,1,1,2,2,0,1,1,0,2
401402605,Howard Bison,A. Hutton,4705315,,False,17.0,4,8,4,7,0,1,3,4,3,6,9,1,0,0,1,1,11
401402605,Howard Bison,V. Udoji,4070243,,False,19.0,3,11,2,4,1,7,1,2,0,2,2,0,0,1,0,2,8
401402605,Howard Bison,N. Cooper,4899955,,False,8.0,2,4,1,1,1,3,1,2,0,0,0,0,1,0,1,0,6
401402605,Howard Bison,A. Wilson,4705319,,False,12.0,4,8,0,4,4,4,0,0,4,0,4,1,0,1,1,0,12
401402605,Howard Bison,G. Thorpe,4400349,,False,12.0,2,4,2,3,0,1,2,2,3,1,4,0,1,0,0,1,6
401402605,Howard Bison,TEAM,TOTAL,TOTAL,False,,35,85,27,59,8,26,9,14,24,25,49,17,12,7,8,15,87
401402605,Delaware State Hornets,B. Robinson,4899949,,True,32.0,4,9,4,9,0,0,1,2,2,0,2,0,0,0,0,1,9
401402605,Delaware State Hornets,U. Miller,4899954,,True,30.0,3,8,3,8,0,0,5,6,2,6,8,1,0,2,3,4,11
401402605,Delaware State Hornets,R. Twine,4902392,,True,40.0,1,4,1,1,0,3,0,0,0,2,2,1,1,0,4,0,2
401402605,Delaware State Hornets,A. Moragne,4595506,,True,31.0,1,13,1,10,0,3,3,4,1,2,3,1,0,1,6,3,5
401402605,Delaware State Hornets,J. Law,4595504,,True,35.0,7,14,5,9,2,5,2,2,3,8,11,4,1,0,10,4,18
401402605,Delaware State Hornets,D. Jackson,4917388,,False,19.0,0,0,0,0,0,0,0,0,0,7,7,0,0,0,0,1,0
401402605,Delaware State Hornets,M. Johnson,4917389,,False,13.0,1,2,1,2,0,0,4,5,0,0,0,0,1,0,1,0,6
401402605,Delaware State Hornets,TEAM,TOTAL,TOTAL,False,,17,50,15,39,2,11,15,19,10,28,38,7,3,3,26,13,51
401402604,Manhattan Jaspers,P. Juric,4899848,,True,26.0,4,6,4,6,0,0,0,1,2,2,4,2,0,0,1,3,8
401402604,Manhattan Jaspers,J. Blagrove,4703674,,True,24.0,1,3,1,3,0,0,2,2,2,3,5,1,0,1,2,2,4
401402604,Manhattan Jaspers,B. Harvey-Carr,4594792,,True,38.0,2,11,1,6,1,5,1,2,1,5,6,4,1,0,2,3,6
401402604,Manhattan Jaspers,C. Warley,4282141,,True,39.0,4,9,4,9,0,0,4,4,5,8,13,3,0,0,3,3,12
401402604,Manhattan Jaspers,D. Davis,4399126,,True,39.0,13,23,5,11,8,12,1,4,0,0,0,2,2,0,2,3,35
401402604,Manhattan Jaspers,J. Jordan,4595803,,False,10.0,0,0,0,0,0,0,0,0,1,0,1,0,0,0,1,1,0
401402604,Manhattan Jaspers,C. Katsamouri,4595370,,False,0.0,0,1,0,1,0,0,0,0,0,0,0,0,0,0,0,1,0
401402604,Manhattan Jaspers,B. Nascimento,4899844,,False,1.0,0,0,0,0,0,0,0,0,0,0,0,0,0,0,0,1,0
401402604,Manhattan Jaspers,S. Watkins,4399127,,False,7.0,1,3,0,1,1,2,0,0,0,1,1,0,0,0,0,0,3
401402604,Manhattan Jaspers,S. Mäkelä,4282138,,False,16.0,0,1,0,0,0,1,0,0,0,2,2,0,1,0,2,0,0
401402604,Manhattan Jaspers,TEAM,TOTAL,TOTAL,False,,25,57,15,37,10,20,8,13,11,26,37,12,4,1,13,17,68
401402604,Fairfield Stags,A. Hernangomez,4399117,,True,34.0,4,10,4,8,0,2,0,0,1,5,6,2,2,0,3,2,8
401402604,Fairfield Stags,L. Lopez-Senechal,4399114,,True,40.0,10,28,6,19,4,9,0,0,0,6,6,1,1,2,1,1,24
401402604,Fairfield Stags,C. Cavanaugh,4281780,,True,36.0,4,8,4,8,0,0,1,2,4,3,7,2,0,1,0,3,9
401402604,Fairfield Stags,S. Lowery,4281189,,True,36.0,6,9,2,5,4,4,2,4,4,3,7,2,3,0,1,1,18
401402604,Fairfield Stags,R. Hakes,4399115,,True,38.0,1,4,1,2,0,2,5,6,2,3,5,11,2,0,2,1,7
401402604,Fairfield Stags,J. Brown,4704429,,False,6.0,0,1,0,0,0,1,0,0,0,0,0,0,0,0,0,1,0
401402604,Fairfield Stags,S. Lewis,4282062,,False,10.0,2,3,1,1,1,2,2,2,0,0,0,0,1,0,1,0,7
401402604,Fairfield Stags,TEAM,TOTAL,TOTAL,False,,27,63,18,43,9,20,10,14,13,23,36,18,9,3,8,9,73
401402603,Quinnipiac Bobcats,A. Free,4399092,,True,15.0,2,6,2,3,0,3,0,0,0,3,3,0,0,0,0,0,4
401402603,Quinnipiac Bobcats,M. Morris,4433677,,True,29.0,2,9,2,8,0,1,6,9,0,7,7,2,0,1,3,2,10
401402603,Quinnipiac Bobcats,S. Bonner,4595390,,True,38.0,2,7,0,1,2,6,2,2,0,4,4,2,0,0,0,3,8
401402603,Quinnipiac Bobcats,R. Caverly,4399294,,True,37.0,1,3,0,2,1,1,1,2,1,0,1,6,0,1,3,4,4
401402603,Quinnipiac Bobcats,M. DeWees,4399091,,True,37.0,3,10,3,9,0,1,3,4,0,6,6,6,2,0,2,5,9
401402603,Quinnipiac Bobcats,T. White,4704552,,False,9.0,3,4,3,4,0,0,0,0,0,1,1,0,0,0,1,1,6
401402603,Quinnipiac Bobcats,C. Haywood,4595389,,False,27.0,5,7,3,3,2,4,4,4,2,4,6,0,0,0,2,5,16
401402603,Quinnipiac Bobcats,J. Grisdale,4899865,,False,7.0,1,3,1,2,0,1,0,0,0,0,0,0,0,0,0,2,2
401402603,Quinnipiac Bobcats,M. Helms,4433084,,False,1.0,0,0,0,0,0,0,0,0,0,0,0,0,0,0,0,0,0
401402603,Quinnipiac Bobcats,TEAM,TOTAL,TOTAL,False,,19,49,14,32,5,17,16,21,4,25,29,16,2,2,11,22,59
401402603,Manhattan Jaspers,P. Juric,4899848,,True,13.0,1,1,1,1,0,0,0,0,2,3,5,0,1,1,1,3,2
401402603,Manhattan Jaspers,J. Blagrove,4703674,,True,16.0,1,4,1,4,0,0,1,1,1,3,4,1,0,0,0,4,3
401402603,Manhattan Jaspers,B. Harvey-Carr,4594792,,True,33.0,7,14,5,9,2,5,6,6,2,7,9,4,2,0,3,2,22
401402603,Manhattan Jaspers,C. Warley,4282141,,True,38.0,4,12,4,12,0,0,5,8,4,7,11,1,0,1,1,2,13
401402603,Manhattan Jaspers,D. Davis,4399126,,True,31.0,7,18,7,14,0,4,7,11,0,5,5,4,2,0,1,2,21
401402603,Manhattan Jaspers,J. Jordan,4595803,,False,34.0,3,4,3,4,0,0,0,0,2,3,5,1,0,0,1,4,6
401402603,Manhattan Jaspers,C. Katsamouri,4595370,,False,0.0,0,0,0,0,0,0,0,0,0,0,0,0,0,0,0,0,0
401402603,Manhattan Jaspers,B. Wilson,4705296,,False,1.0,0,0,0,0,0,0,0,0,0,0,0,0,0,0,0,0,0
401402603,Manhattan Jaspers,B. Nascimento,4899844,,False,10.0,1,4,1,3,0,1,0,0,0,0,0,0,1,0,0,0,2
401402603,Manhattan Jaspers,S. Watkins,4399127,,False,5.0,0,1,0,0,0,1,0,0,0,0,0,0,0,0,0,0,0
401402603,Manhattan Jaspers,S. Mäkelä,4282138,,False,19.0,1,2,0,1,1,1,0,0,0,0,0,0,0,0,0,2,3
401402603,Manhattan Jaspers,TEAM,TOTAL,TOTAL,False,,25,60,22,48,3,12,19,26,13,29,42,11,6,2,7,19,72
401402602,Niagara Purple Eagles,Aa. Parker,4899856,,True,29.0,2,9,2,9,0,0,0,0,1,2,3,1,0,0,6,3,4
401402602,Niagara Purple Eagles,An. Parker,4595385,,True,32.0,2,12,1,3,1,9,0,0,0,4,4,3,0,0,4,2,5
401402602,Niagara Purple Eagles,K. Grimshaw,4399136,,True,25.0,3,9,2,7,1,2,2,8,2,4,6,1,0,0,2,0,9
401402602,Niagara Purple Eagles,A. Haar,4399135,,True,30.0,2,8,0,1,2,7,2,2,1,2,3,0,0,0,0,0,8
401402602,Niagara Purple Eagles,M. Yelle,4399133,,True,21.0,1,1,0,0,1,1,0,0,0,0,0,1,1,0,2,4,3
401402602,Niagara Purple Eagles,A. Johnson,4715967,,False,6.0,1,1,1,1,0,0,1,1,0,0,0,0,0,0,1,0,3
401402602,Niagara Purple Eagles,S. Glover,4704528,,False,14.0,0,0,0,0,0,0,0,0,0,0,0,0,0,0,0,2,0
401402602,Niagara Purple Eagles,S. Faulcon,4595386,,False,7.0,0,0,0,0,0,0,0,0,0,1,1,0,0,0,0,0,0
401402602,Niagara Purple Eagles,L. Roe,4899855,,False,6.0,0,2,0,0,0,2,2,2,0,1,1,0,1,0,1,0,2
401402602,Niagara Purple Eagles,M. Freeman,4899854,,False,5.0,0,2,0,1,0,1,1,2,0,1,1,0,0,0,0,0,1
401402602,Niagara Purple Eagles,L. Porter,4704527,,False,14.0,1,3,0,0,1,3,0,0,1,3,4,0,0,0,1,1,3
401402602,Niagara Purple Eagles,B. Jones,4704525,,False,12.0,0,1,0,1,0,0,0,0,0,1,1,0,1,0,0,0,0
401402602,Niagara Purple Eagles,TEAM,TOTAL,TOTAL,False,,12,48,6,23,6,25,8,15,9,22,31,6,3,0,19,12,38
401402602,Fairfield Stags,A. Hernangomez,4399117,,True,30.0,4,9,4,8,0,1,0,0,1,9,10,0,0,0,1,2,8
401402602,Fairfield Stags,L. Lopez-Senechal,4399114,,True,30.0,5,11,1,4,4,7,0,0,0,3,3,0,2,0,0,1,14
401402602,Fairfield Stags,C. Cavanaugh,4281780,,True,29.0,5,9,5,9,0,0,2,3,1,5,6,2,1,2,0,2,12
401402602,Fairfield Stags,S. Lowery,4281189,,True,26.0,4,9,1,3,3,6,3,3,2,0,2,0,1,0,0,3,14
401402602,Fairfield Stags,R. Hakes,4399115,,True,31.0,3,7,1,4,2,3,0,0,1,3,4,12,0,0,3,0,8
401402602,Fairfield Stags,D. Tirado,4704431,,False,2.0,0,0,0,0,0,0,0,0,0,0,0,0,0,0,0,2,0
401402602,Fairfield Stags,M. Daleba,4704430,,False,4.0,0,2,0,2,0,0,0,0,2,1,3,1,1,0,1,2,0
401402602,Fairfield Stags,J. Carter,4399116,,False,3.0,1,2,1,2,0,0,0,0,0,1,1,0,0,0,0,0,2
401402602,Fairfield Stags,B. Tatarian,4899783,,False,3.0,0,1,0,1,0,0,0,0,0,0,0,0,0,0,0,0,0
401402602,Fairfield Stags,J. Brown,4704429,,False,11.0,2,4,2,3,0,1,0,0,0,1,1,2,2,0,1,1,4
401402602,Fairfield Stags,M. Rubino,4704428,,False,8.0,2,2,2,2,0,0,0,0,0,0,0,3,1,0,2,1,4
401402602,Fairfield Stags,J. Polansky,4595673,,False,3.0,0,0,0,0,0,0,0,0,0,0,0,1,0,0,1,1,0
401402602,Fairfield Stags,M. Martin,4595363,,False,5.0,0,1,0,1,0,0,0,0,1,1,2,0,0,0,0,1,0
401402602,Fairfield Stags,S. Lewis,4282062,,False,15.0,3,3,0,0,3,3,0,0,0,1,1,1,2,0,1,0,9
401402602,Fairfield Stags,TEAM,TOTAL,TOTAL,False,,29,60,17,39,12,21,5,6,8,29,37,22,10,2,11,16,75
401402601,Siena Saints,S. Philoxy,4281380,,True,36.0,7,13,7,13,0,0,5,6,5,3,8,1,4,2,2,3,19
401402601,Siena Saints,A. Jackson,4704629,,True,27.0,1,6,0,1,1,5,0,0,0,4,4,2,0,1,5,5,3
401402601,Siena Saints,V. Fontenelle-Posson,4433552,,True,36.0,2,6,1,2,1,4,7,10,1,5,6,1,2,0,2,3,12
401402601,Siena Saints,D. Winston,4282198,,True,19.0,0,1,0,0,0,1,0,0,0,0,0,1,1,0,4,0,0
401402601,Siena Saints,R. Brown,4281840,,True,34.0,7,11,7,10,0,1,1,2,1,3,4,4,0,0,6,3,15
401402601,Siena Saints,E. Selimovic,4899878,,False,2.0,1,3,1,3,0,0,1,2,1,0,1,0,0,0,0,1,3
401402601,Siena Saints,A. Brown,4899879,,False,2.0,0,0,0,0,0,0,0,0,0,1,1,0,0,0,0,0,0
401402601,Siena Saints,A. Knoflach,4899877,,False,20.0,0,2,0,1,0,1,0,0,1,4,5,1,0,0,1,2,0
401402601,Siena Saints,I. Harris,4899875,,False,2.0,0,0,0,0,0,0,0,0,0,0,0,0,1,0,0,0,0
401402601,Siena Saints,M. Peterson,4399151,,False,22.0,2,7,1,1,1,6,2,2,0,5,5,0,0,0,3,4,7
401402601,Siena Saints,TEAM,TOTAL,TOTAL,False,,20,49,17,31,3,18,16,22,12,28,40,10,8,3,23,21,59
401402601,Niagara Purple Eagles,O. Mason,4399134,,True,21.0,3,5,3,5,0,0,0,0,3,2,5,0,1,0,2,1,6
401402601,Niagara Purple Eagles,Aa. Parker,4899856,,True,34.0,5,15,5,9,0,6,3,5,3,4,7,3,5,0,2,3,13
401402601,Niagara Purple Eagles,An. Parker,4595385,,True,21.0,6,13,3,5,3,8,1,5,0,2,2,1,3,0,4,5,16
401402601,Niagara Purple Eagles,A. Haar,4399135,,True,34.0,2,7,1,2,1,5,3,4,0,2,2,2,0,0,2,0,8
401402601,Niagara Purple Eagles,M. Yelle,4399133,,True,25.0,1,4,1,2,0,2,1,2,3,0,3,0,1,0,2,4,3
401402601,Niagara Purple Eagles,S. Glover,4704528,,False,10.0,0,1,0,1,0,0,0,0,1,2,3,0,1,0,1,1,0
401402601,Niagara Purple Eagles,L. Porter,4704527,,False,21.0,1,9,1,4,0,5,0,0,0,1,1,1,1,0,1,3,2
401402601,Niagara Purple Eagles,B. Jones,4704525,,False,19.0,2,3,2,2,0,1,0,0,2,1,3,1,0,0,1,2,4
401402601,Niagara Purple Eagles,K. Grimshaw,4399136,,False,15.0,2,5,1,3,1,2,3,6,0,0,0,0,1,0,0,1,8
401402601,Niagara Purple Eagles,TEAM,TOTAL,TOTAL,False,,22,62,17,33,5,29,11,22,15,17,32,8,13,0,16,20,60
401402600,Manhattan Jaspers,P. Juric,4899848,,True,26.0,5,7,5,7,0,0,0,0,3,5,8,0,0,2,1,1,10
401402600,Manhattan Jaspers,J. Blagrove,4703674,,True,25.0,1,5,1,5,0,0,0,0,0,2,2,0,2,1,1,2,2
401402600,Manhattan Jaspers,B. Harvey-Carr,4594792,,True,31.0,4,13,1,4,3,9,0,0,3,6,9,4,2,0,3,0,11
401402600,Manhattan Jaspers,C. Warley,4282141,,True,34.0,4,11,4,11,0,0,2,2,3,4,7,2,1,0,2,2,10
401402600,Manhattan Jaspers,D. Davis,4399126,,True,30.0,7,16,5,12,2,4,2,3,2,4,6,6,2,0,4,2,18
401402600,Manhattan Jaspers,J. Jordan,4595803,,False,21.0,2,5,2,4,0,1,0,0,5,4,9,2,0,1,1,2,4
401402600,Manhattan Jaspers,B. Nascimento,4899844,,False,2.0,0,0,0,0,0,0,0,0,0,0,0,0,0,0,0,0,0
401402600,Manhattan Jaspers,E. LaPointe,4595368,,False,20.0,1,6,1,2,0,4,0,0,2,2,4,1,2,0,3,0,2
401402600,Manhattan Jaspers,S. Watkins,4399127,,False,3.0,0,2,0,1,0,1,0,0,0,0,0,0,0,0,0,0,0
401402600,Manhattan Jaspers,S. Mäkelä,4282138,,False,8.0,2,4,2,3,0,1,0,0,0,0,0,0,1,0,0,0,4
401402600,Manhattan Jaspers,TEAM,TOTAL,TOTAL,False,,26,69,21,49,5,20,4,5,20,30,50,15,10,4,15,9,61
401402600,Canisius Golden Griffins,K. Jackson,4399265,,True,20.0,1,3,1,3,0,0,0,0,4,6,10,3,2,0,0,3,2
401402600,Canisius Golden Griffins,A. Lexa,4899743,,True,31.0,5,10,2,4,3,6,1,1,0,2,2,0,0,0,3,0,14
401402600,Canisius Golden Griffins,D. Haskell,4704422,,True,36.0,4,17,2,6,2,11,1,1,0,4,4,3,3,0,5,2,11
401402600,Canisius Golden Griffins,S. Brown,4595357,,True,25.0,0,7,0,3,0,4,0,0,1,1,2,1,0,0,4,0,0
401402600,Canisius Golden Griffins,E. Joseph,4399161,,True,35.0,5,13,2,6,3,7,2,3,1,1,2,0,0,0,1,2,15
401402600,Canisius Golden Griffins,R. Porter,4899747,,False,20.0,3,4,3,4,0,0,1,1,5,6,11,0,1,2,0,1,7
401402600,Canisius Golden Griffins,E. Vaatanen,4281971,,False,11.0,0,2,0,2,0,0,0,0,0,0,0,0,0,2,0,1,0
401402600,Canisius Golden Griffins,C. Stubbs,4899746,,False,16.0,0,3,0,1,0,2,0,0,0,1,1,2,1,0,0,1,0
401402600,Canisius Golden Griffins,L. Gattozzi,4899741,,False,6.0,0,2,0,2,0,0,0,0,1,0,1,0,0,0,2,0,0
401402600,Canisius Golden Griffins,TEAM,TOTAL,TOTAL,False,,18,61,10,31,8,30,5,6,13,23,36,9,7,4,15,10,49
401402599,Saint Peter's Peacocks,K. Dawkins,4899871,,True,28.0,2,6,2,6,0,0,2,2,2,7,9,1,0,0,1,2,6
401402599,Saint Peter's Peacocks,S. Castro,4704637,,True,23.0,1,4,1,4,0,0,0,2,4,3,7,0,1,0,1,4,2
401402599,Saint Peter's Peacocks,N. O'Neil,4704633,,True,30.0,5,12,4,8,1,4,0,0,0,2,2,2,0,0,2,2,11
401402599,Saint Peter's Peacocks,K. Crane,4400113,,True,23.0,0,6,0,5,0,1,5,6,1,2,3,1,2,0,1,4,5
401402599,Saint Peter's Peacocks,K. Williams,4399147,,True,33.0,5,10,2,6,3,4,3,6,2,0,2,0,3,0,1,4,16
401402599,Saint Peter's Peacocks,V. Ikenasio,4704638,,False,12.0,0,4,0,4,0,0,0,2,3,0,3,0,0,0,2,3,0
401402599,Saint Peter's Peacocks,T. Abraham,4704636,,False,15.0,0,5,0,5,0,0,0,0,2,0,2,0,0,0,1,0,0
401402599,Saint Peter's Peacocks,I. Felix,4899873,,False,2.0,0,0,0,0,0,0,0,0,0,0,0,0,1,0,1,0,0
401402599,Saint Peter's Peacocks,A. Mills,4899872,,False,2.0,1,1,1,1,0,0,0,0,0,0,0,0,0,0,0,0,2
401402599,Saint Peter's Peacocks,R. Kuhl,4704634,,False,10.0,0,5,0,3,0,2,0,0,0,1,1,0,0,0,1,2,0
401402599,Saint Peter's Peacocks,B. Salawu,4704632,,False,9.0,0,2,0,2,0,0,0,0,0,1,1,1,1,0,2,1,0
401402599,Saint Peter's Peacocks,T. McQueen,4399140,,False,13.0,0,5,0,2,0,3,0,0,0,0,0,0,0,0,2,2,0
401402599,Saint Peter's Peacocks,TEAM,TOTAL,TOTAL,False,,14,60,10,46,4,14,10,18,16,20,36,5,8,0,15,24,42
401402599,Quinnipiac Bobcats,A. Free,4399092,,True,18.0,0,7,0,3,0,4,2,2,0,2,2,2,0,0,1,0,2
401402599,Quinnipiac Bobcats,M. Morris,4433677,,True,28.0,6,11,5,9,1,2,0,0,2,6,8,0,0,2,3,2,13
401402599,Quinnipiac Bobcats,S. Bonner,4595390,,True,31.0,2,2,0,0,2,2,1,2,2,2,4,1,1,1,0,2,7
401402599,Quinnipiac Bobcats,R. Caverly,4399294,,True,36.0,2,6,2,5,0,1,1,3,0,4,4,7,2,0,1,2,5
401402599,Quinnipiac Bobcats,M. DeWees,4399091,,True,15.0,2,3,2,3,0,0,11,12,2,3,5,1,2,0,2,2,15
401402599,Quinnipiac Bobcats,G. LaBarge,4899864,,False,2.0,0,1,0,0,0,1,2,2,0,0,0,0,0,0,1,1,2
401402599,Quinnipiac Bobcats,T. White,4704552,,False,11.0,4,7,4,7,0,0,0,0,1,4,5,1,1,1,1,1,8
401402599,Quinnipiac Bobcats,C. Almeida,4595388,,False,1.0,0,0,0,0,0,0,0,0,0,1,1,0,0,0,0,0,0
401402599,Quinnipiac Bobcats,C. Haywood,4595389,,False,19.0,1,5,1,3,0,2,2,4,0,3,3,1,0,1,1,3,4
401402599,Quinnipiac Bobcats,R. Douglas,4899866,,False,2.0,0,0,0,0,0,0,0,0,0,0,0,0,1,0,2,0,0
401402599,Quinnipiac Bobcats,J. Grisdale,4899865,,False,25.0,1,3,1,3,0,0,4,4,0,1,1,0,0,0,2,2,6
401402599,Quinnipiac Bobcats,J. Casey,4704555,,False,1.0,0,0,0,0,0,0,0,0,0,0,0,0,0,0,0,0,0
401402599,Quinnipiac Bobcats,H. Smith,4704553,,False,4.0,0,0,0,0,0,0,0,0,0,0,0,0,0,0,0,1,0
401402599,Quinnipiac Bobcats,M. Helms,4433084,,False,7.0,0,0,0,0,0,0,1,2,0,0,0,1,0,0,2,2,1
401402599,Quinnipiac Bobcats,TEAM,TOTAL,TOTAL,False,,18,45,15,33,3,12,24,31,9,30,39,14,7,5,16,18,63
401402598,Iona Gaels,K. Athias,4707986,,True,32.0,3,9,3,9,0,0,0,2,4,6,10,4,3,0,2,3,6
401402598,Iona Gaels,M. Cenis,4899841,,True,10.0,0,0,0,0,0,0,0,0,0,0,0,1,0,0,0,3,0
401402598,Iona Gaels,O. Vezaldenos,4704437,,True,40.0,5,13,0,1,5,12,0,0,0,4,4,0,0,0,1,0,15
401402598,Iona Gaels,J. Camilion,4399121,,True,27.0,7,16,6,10,1,6,3,3,1,6,7,5,0,0,0,5,18
401402598,Iona Gaels,S. Mwai,4399119,,True,28.0,2,6,2,2,0,4,0,0,0,2,2,2,0,0,3,4,4
401402598,Iona Gaels,I. Lipinski,4899839,,False,16.0,1,3,1,3,0,0,0,0,1,1,2,0,1,0,1,0,2
401402598,Iona Gaels,J. Gomez,4899840,,False,22.0,4,5,1,1,3,4,0,0,1,1,2,1,0,0,0,2,11
401402598,Iona Gaels,T. Hodge-Carr,4704438,,False,17.0,0,4,0,3,0,1,0,0,1,1,2,1,0,0,3,1,0
401402598,Iona Gaels,J. Benn,4601643,,False,8.0,0,1,0,1,0,0,0,0,0,0,0,1,0,0,1,1,0
401402598,Iona Gaels,TEAM,TOTAL,TOTAL,False,,22,57,13,30,9,27,3,5,9,23,32,15,4,0,11,19,56
401402598,Fairfield Stags,A. Hernangomez,4399117,,True,40.0,2,6,2,4,0,2,1,2,1,9,10,2,0,0,2,0,5
401402598,Fairfield Stags,L. Lopez-Senechal,4399114,,True,23.0,6,10,5,9,1,1,5,5,0,2,2,2,1,0,2,2,18
401402598,Fairfield Stags,C. Cavanaugh,4281780,,True,31.0,1,6,1,5,0,1,0,0,0,3,3,1,0,2,2,4,2
401402598,Fairfield Stags,S. Lowery,4281189,,True,30.0,0,5,0,4,0,1,0,0,2,3,5,1,1,0,2,1,0
401402598,Fairfield Stags,R. Hakes,4399115,,True,39.0,8,14,4,6,4,8,6,6,2,4,6,5,1,0,0,1,26
401402598,Fairfield Stags,J. Brown,4704429,,False,16.0,1,4,1,3,0,1,4,4,0,1,1,3,3,0,0,1,6
401402598,Fairfield Stags,M. Rubino,4704428,,False,1.0,0,0,0,0,0,0,0,0,0,0,0,0,0,0,0,0,0
401402598,Fairfield Stags,M. Martin,4595363,,False,0.0,0,0,0,0,0,0,0,0,0,1,1,0,0,0,0,0,0
401402598,Fairfield Stags,S. Lewis,4282062,,False,20.0,3,6,1,1,2,5,4,4,1,1,2,1,1,0,0,0,12
401402598,Fairfield Stags,TEAM,TOTAL,TOTAL,False,,21,51,14,32,7,19,20,21,6,26,32,15,7,2,8,9,69
401402597,Monmouth Hawks,B. Kranbuhl,4704490,,True,10.0,1,2,1,2,0,0,0,0,0,1,1,0,0,1,3,2,2
401402597,Monmouth Hawks,J. Hall,4704487,,True,20.0,0,2,0,1,0,1,0,0,1,3,4,2,0,1,2,1,0
401402597,Monmouth Hawks,S. Clark,4281487,,True,36.0,8,19,7,13,1,6,2,2,2,2,4,6,0,0,1,4,19
401402597,Monmouth Hawks,J. Louro,4281169,,True,23.0,4,12,2,5,2,7,0,2,2,1,3,0,1,0,1,2,10
401402597,Monmouth Hawks,B. Livingston,4281071,,True,22.0,4,9,4,8,0,1,2,4,2,3,5,0,0,0,2,3,10
401402597,Monmouth Hawks,Z. Chevre,4704488,,False,8.0,0,0,0,0,0,0,0,0,0,0,0,1,0,0,1,0,0
401402597,Monmouth Hawks,L. Thomas,4399177,,False,23.0,7,10,7,9,0,1,2,3,2,4,6,1,0,0,2,1,16
401402597,Monmouth Hawks,A. Panayides,4899852,,False,27.0,1,2,0,1,1,1,0,0,1,0,1,3,0,1,1,1,3
401402597,Monmouth Hawks,K. Donovan,4596543,,False,20.0,2,7,2,3,0,4,1,2,1,0,1,0,1,1,0,0,5
401402597,Monmouth Hawks,A. Wallace,4399173,,False,11.0,0,0,0,0,0,0,0,0,1,2,3,1,0,0,1,2,0
401402597,Monmouth Hawks,TEAM,TOTAL,TOTAL,False,,27,63,23,42,4,21,7,13,16,17,33,14,2,4,15,16,65
401402597,Canisius Golden Griffins,K. Jackson,4399265,,True,21.0,4,4,4,4,0,0,0,0,0,7,7,0,2,1,0,5,8
401402597,Canisius Golden Griffins,A. Lexa,4899743,,True,35.0,4,12,2,9,2,3,0,0,0,2,2,3,0,0,0,0,10
401402597,Canisius Golden Griffins,D. Haskell,4704422,,True,37.0,10,17,8,13,2,4,4,4,1,4,5,6,0,0,4,2,26
401402597,Canisius Golden Griffins,S. Brown,4595357,,True,35.0,5,9,2,4,3,5,1,2,3,2,5,3,2,0,2,2,14
401402597,Canisius Golden Griffins,E. Joseph,4399161,,True,32.0,2,5,2,4,0,1,1,1,0,1,1,0,0,0,4,2,5
401402597,Canisius Golden Griffins,R. Porter,4899747,,False,9.0,0,1,0,1,0,0,0,0,2,3,5,0,0,1,1,4,0
401402597,Canisius Golden Griffins,E. Vaatanen,4281971,,False,11.0,1,1,1,1,0,0,0,0,1,0,1,0,1,1,2,1,2
401402597,Canisius Golden Griffins,C. Stubbs,4899746,,False,16.0,2,8,0,2,2,6,0,0,0,0,0,1,1,0,1,2,6
401402597,Canisius Golden Griffins,L. Gattozzi,4899741,,False,4.0,0,1,0,0,0,1,0,0,0,0,0,0,0,0,1,0,0
401402597,Canisius Golden Griffins,TEAM,TOTAL,TOTAL,False,,28,58,19,38,9,20,6,7,13,19,32,13,6,3,17,18,71
401402596,Saint Peter's Peacocks,K. Dawkins,4899871,,True,25.0,4,9,3,7,1,2,1,2,2,3,5,2,0,0,1,3,10
401402596,Saint Peter's Peacocks,S. Castro,4704637,,True,36.0,4,8,4,7,0,1,1,2,5,14,19,1,0,0,2,2,9
401402596,Saint Peter's Peacocks,N. O'Neil,4704633,,True,27.0,2,8,2,8,0,0,0,0,2,2,4,1,5,1,1,2,4
401402596,Saint Peter's Peacocks,K. Crane,4400113,,True,33.0,4,13,4,11,0,2,0,0,1,5,6,3,1,0,3,2,8
401402596,Saint Peter's Peacocks,K. Williams,4399147,,True,32.0,4,13,2,9,2,4,0,0,3,3,6,2,3,0,4,3,10
401402596,Saint Peter's Peacocks,V. Ikenasio,4704638,,False,14.0,2,3,2,3,0,0,0,0,1,1,2,0,0,0,2,1,4
401402596,Saint Peter's Peacocks,T. Abraham,4704636,,False,4.0,0,0,0,0,0,0,0,0,0,0,0,0,0,0,1,0,0
401402596,Saint Peter's Peacocks,I. Felix,4899873,,False,1.0,0,0,0,0,0,0,1,2,0,0,0,0,1,0,0,0,1
401402596,Saint Peter's Peacocks,R. Kuhl,4704634,,False,7.0,0,1,0,0,0,1,0,0,0,0,0,0,0,0,0,0,0
401402596,Saint Peter's Peacocks,B. Salawu,4704632,,False,10.0,0,2,0,1,0,1,0,0,0,0,0,0,0,0,1,1,0
401402596,Saint Peter's Peacocks,T. McQueen,4399140,,False,11.0,1,3,0,0,1,3,0,0,0,0,0,3,1,0,0,1,3
401402596,Saint Peter's Peacocks,TEAM,TOTAL,TOTAL,False,,21,60,17,46,4,14,3,6,16,30,46,12,11,1,16,15,49
401402596,Marist Red Foxes,Z. DeMember-Shazer,4704497,,True,32.0,2,10,2,10,0,0,0,0,2,5,7,1,1,1,2,0,4
401402596,Marist Red Foxes,S. Bailey,4595377,,True,26.0,2,6,2,2,0,4,1,1,0,4,4,0,2,0,1,0,5
401402596,Marist Red Foxes,S. Boylan,4899850,,True,23.0,1,4,1,2,0,2,0,0,0,1,1,1,2,0,3,3,2
401402596,Marist Red Foxes,A. Ellison,4704498,,True,23.0,0,6,0,2,0,4,4,4,1,2,3,1,0,0,5,4,4
401402596,Marist Red Foxes,K. Krick,4399130,,True,35.0,4,12,4,8,0,4,2,3,1,1,2,0,1,0,2,2,10
401402596,Marist Red Foxes,M. Rife,4899851,,False,1.0,0,0,0,0,0,0,0,0,1,0,1,0,0,0,0,1,0
401402596,Marist Red Foxes,E. Fox,4704496,,False,13.0,1,3,0,1,1,2,1,2,2,2,4,0,0,1,0,1,4
401402596,Marist Red Foxes,C. Cunningham,4899849,,False,8.0,0,0,0,0,0,0,0,0,0,1,1,0,0,0,0,0,0
401402596,Marist Red Foxes,E. Wax,4704494,,False,17.0,0,5,0,2,0,3,0,0,0,2,2,0,1,0,2,1,0
401402596,Marist Red Foxes,J. Bonilla,4595376,,False,22.0,0,6,0,3,0,3,0,0,1,4,5,1,1,0,3,0,0
401402596,Marist Red Foxes,TEAM,TOTAL,TOTAL,False,,10,52,9,30,1,22,8,10,11,25,36,4,8,2,18,12,29
401402595,Rider Broncs,A. Ekerstedt,4704619,,True,32.0,2,4,1,2,1,2,0,0,2,6,8,2,2,1,1,1,5
401402595,Rider Broncs,R. Toussaint,4704617,,True,37.0,3,7,3,6,0,1,2,3,4,5,9,1,1,2,6,3,8
401402595,Rider Broncs,M. Firebaugh,4704621,,True,34.0,5,11,2,5,3,6,0,0,0,1,1,1,1,0,3,4,13
401402595,Rider Broncs,L. Evans,4704620,,True,32.0,1,10,1,9,0,1,5,6,3,1,4,4,2,0,2,1,7
401402595,Rider Broncs,J. Schiffer,4595239,,True,40.0,7,11,2,4,5,7,0,0,0,1,1,3,1,0,3,1,19
401402595,Rider Broncs,V. Toomey,4595396,,False,10.0,1,2,1,2,0,0,0,0,0,1,1,0,0,0,1,0,2
401402595,Rider Broncs,M. Lynch,4704616,,False,2.0,0,1,0,1,0,0,0,0,0,0,0,0,0,0,0,0,0
401402595,Rider Broncs,A. Mobley,4399137,,False,13.0,1,3,1,2,0,1,2,2,0,2,2,2,1,0,2,2,4
401402595,Rider Broncs,TEAM,TOTAL,TOTAL,False,,20,49,11,31,9,18,9,11,10,17,27,13,8,3,18,12,58
401402595,Iona Gaels,K. Athias,4707986,,True,38.0,6,11,6,11,0,0,0,0,9,7,16,4,0,1,4,1,12
401402595,Iona Gaels,M. Cenis,4899841,,True,5.0,0,0,0,0,0,0,0,0,0,0,0,1,1,0,0,0,0
401402595,Iona Gaels,O. Vezaldenos,4704437,,True,23.0,3,11,2,6,1,5,0,0,1,0,1,0,2,0,0,2,7
401402595,Iona Gaels,J. Camilion,4399121,,True,38.0,8,15,5,10,3,5,2,2,1,6,7,7,4,0,2,4,21
401402595,Iona Gaels,S. Mwai,4399119,,True,34.0,6,12,2,6,4,6,0,0,0,1,1,1,1,0,2,0,16
401402595,Iona Gaels,I. Lipinski,4899839,,False,4.0,0,1,0,1,0,0,2,2,0,2,2,0,0,0,2,0,2
401402595,Iona Gaels,P. Weekes,4399122,,False,2.0,0,0,0,0,0,0,0,0,0,0,0,0,0,0,0,0,0
401402595,Iona Gaels,J. Gomez,4899840,,False,18.0,3,7,0,1,3,6,0,0,0,0,0,0,0,0,0,1,9
401402595,Iona Gaels,T. Hodge-Carr,4704438,,False,32.0,3,5,3,5,0,0,1,2,1,0,1,7,2,0,2,0,7
401402595,Iona Gaels,J. Benn,4601643,,False,2.0,0,0,0,0,0,0,0,0,0,0,0,0,0,0,0,0,0
401402595,Iona Gaels,L. Becerra Perez,4595364,,False,2.0,0,0,0,0,0,0,0,2,0,1,1,0,0,0,0,0,0
401402595,Iona Gaels,J. Rogers,4281860,,False,2.0,0,0,0,0,0,0,0,0,0,0,0,0,0,1,0,0,0
401402595,Iona Gaels,TEAM,TOTAL,TOTAL,False,,29,62,18,40,11,22,5,8,17,20,37,20,10,2,12,8,74
401402594,Princeton Tigers,E. Mitchell,4594957,,True,38.0,0,4,0,4,0,0,0,2,1,9,10,2,4,0,2,4,0
401402594,Princeton Tigers,K. Chen,4899328,,True,37.0,9,13,8,12,1,1,11,14,0,3,3,3,0,0,1,3,30
401402594,Princeton Tigers,J. Cunningham,4399194,,True,37.0,5,13,4,10,1,3,5,6,0,3,3,0,2,2,0,0,16
401402594,Princeton Tigers,G. Stone,4399190,,True,29.0,5,8,3,4,2,4,0,0,0,1,1,1,1,2,3,5,12
401402594,Princeton Tigers,A. Meyers,4281402,,True,35.0,4,11,2,6,2,5,6,6,0,2,2,0,1,1,0,1,16
401402594,Princeton Tigers,C. Nweke,4899329,,False,13.0,1,1,1,1,0,0,1,2,1,3,4,0,0,1,1,0,3
401402594,Princeton Tigers,M. Plank,4594958,,False,0.0,0,0,0,0,0,0,0,0,0,0,0,0,0,0,0,0,0
401402594,Princeton Tigers,M. Connolly,4399192,,False,11.0,0,0,0,0,0,0,0,0,0,1,1,1,1,0,1,1,0
401402594,Princeton Tigers,TEAM,TOTAL,TOTAL,False,,24,50,18,37,6,13,23,30,4,23,27,7,9,6,8,14,77
401402594,Columbia Lions,N. Comesana,4899284,,True,28.0,2,3,2,3,0,0,0,0,1,5,6,0,0,1,4,4,4
401402594,Columbia Lions,K. Davis,4433382,,True,34.0,5,10,5,9,0,1,0,0,1,8,9,1,0,0,3,3,10
401402594,Columbia Lions,K. Henderson,4899283,,True,40.0,4,6,3,5,1,1,2,2,1,1,2,3,0,0,3,2,11
401402594,Columbia Lions,A. Hsu,4594973,,True,40.0,5,19,3,11,2,8,4,6,0,3,3,0,2,0,3,4,16
401402594,Columbia Lions,J. Patrick,4433322,,True,25.0,5,8,4,7,1,1,2,3,0,1,1,1,1,0,4,4,13
401402594,Columbia Lions,H. Pratt,4399165,,False,11.0,1,3,0,1,1,2,0,0,1,3,4,1,0,0,2,1,3
401402594,Columbia Lions,S. Durr,4399167,,False,3.0,0,2,0,1,0,1,0,0,0,0,0,0,0,0,1,0,0
401402594,Columbia Lions,N. Stephens,4705213,,False,14.0,0,1,0,1,0,0,2,2,0,2,2,1,1,0,0,4,2
401402594,Columbia Lions,C. Rivera,4594972,,False,5.0,0,0,0,0,0,0,0,0,0,0,0,0,0,0,0,0,0
401402594,Columbia Lions,TEAM,TOTAL,TOTAL,False,,22,52,17,38,5,14,10,13,7,25,32,7,4,1,20,22,59
401402593,Yale Bulldogs,C. Emsbo,4399201,,True,35.0,3,9,3,9,0,0,3,6,3,12,15,0,1,1,2,1,9
401402593,Yale Bulldogs,A. Cade,4281399,,True,28.0,4,10,4,10,0,0,0,1,5,2,7,1,1,0,1,2,8
401402593,Yale Bulldogs,C. McCann,4899332,,True,15.0,0,1,0,0,0,1,0,0,0,0,0,1,0,0,1,2,0
401402593,Yale Bulldogs,K. Astrom,4594955,,True,22.0,1,9,1,7,0,2,0,0,1,2,3,1,1,1,4,1,2
401402593,Yale Bulldogs,J. Clark,4594954,,True,27.0,0,8,0,1,0,7,0,0,0,3,3,2,0,0,2,4,0
401402593,Yale Bulldogs,B. McDonald,4899337,,False,2.0,0,0,0,0,0,0,0,0,0,0,0,0,0,0,0,1,0
401402593,Yale Bulldogs,G. Thybulle,4899336,,False,3.0,1,2,1,2,0,0,0,0,1,1,2,0,0,0,1,1,2
401402593,Yale Bulldogs,M. Egger,4899338,,False,10.0,3,4,2,3,1,1,2,2,0,1,1,0,0,0,2,1,9
401402593,Yale Bulldogs,N. McGill,4899339,,False,7.0,0,0,0,0,0,0,0,0,0,1,1,1,1,0,0,1,0
401402593,Yale Bulldogs,E. van der Maas,4899335,,False,11.0,0,4,0,0,0,4,0,0,0,2,2,0,1,0,0,1,0
401402593,Yale Bulldogs,A. Lee,4899333,,False,22.0,2,9,1,5,1,4,0,0,0,2,2,0,0,0,2,2,5
401402593,Yale Bulldogs,R. Nesbitt,4399205,,False,3.0,0,0,0,0,0,0,0,0,0,1,1,0,0,0,0,0,0
401402593,Yale Bulldogs,R. Gallagher,4399203,,False,15.0,1,4,1,4,0,0,1,2,0,1,1,1,0,0,0,1,3
401402593,Yale Bulldogs,TEAM,TOTAL,TOTAL,False,,15,60,13,41,2,19,6,11,10,29,39,7,5,2,16,18,38
401402593,Columbia Lions,N. Comesana,4899284,,True,24.0,1,2,1,2,0,0,0,0,0,4,4,0,0,0,1,3,2
401402593,Columbia Lions,K. Davis,4433382,,True,23.0,4,7,3,4,1,3,0,1,0,5,5,5,3,0,3,2,9
401402593,Columbia Lions,K. Henderson,4899283,,True,25.0,2,4,2,3,0,1,0,0,3,2,5,5,0,0,1,1,4
401402593,Columbia Lions,A. Hsu,4594973,,True,26.0,6,17,2,6,4,11,2,4,0,3,3,2,2,0,1,1,18
401402593,Columbia Lions,J. Patrick,4433322,,True,26.0,11,13,10,12,1,1,0,1,1,5,6,1,0,0,1,1,23
401402593,Columbia Lions,M. Lobon,4705212,,False,2.0,0,0,0,0,0,0,0,0,0,0,0,0,0,0,0,0,0
401402593,Columbia Lions,H. Pratt,4399165,,False,12.0,2,5,2,2,0,3,0,0,0,4,4,1,0,0,1,2,4
401402593,Columbia Lions,P. Lauder,4433491,,False,5.0,0,1,0,1,0,0,4,6,1,1,2,0,1,0,0,1,4
401402593,Columbia Lions,S. Durr,4399167,,False,11.0,1,4,1,1,0,3,0,0,1,1,2,0,0,1,1,1,2
401402593,Columbia Lions,N. Stephens,4705213,,False,7.0,0,0,0,0,0,0,1,4,0,1,1,0,1,0,1,0,1
401402593,Columbia Lions,E. Gainer,4705211,,False,3.0,0,0,0,0,0,0,0,0,0,1,1,0,0,0,1,0,0
401402593,Columbia Lions,C. Rivera,4594972,,False,16.0,0,2,0,1,0,1,0,0,1,3,4,3,0,0,1,0,0
401402593,Columbia Lions,L. Kennedy,4399168,,False,2.0,0,0,0,0,0,0,0,0,0,0,0,0,0,0,1,0,0
401402593,Columbia Lions,M. Markham,4399166,,False,10.0,0,1,0,0,0,1,0,0,0,2,2,0,0,0,0,0,0
401402593,Columbia Lions,M. Hardy,4399163,,False,8.0,0,3,0,0,0,3,0,0,0,0,0,1,2,0,1,1,0
401402593,Columbia Lions,TEAM,TOTAL,TOTAL,False,,27,59,21,32,6,27,7,16,8,36,44,18,9,1,14,13,67
401402592,Princeton Tigers,E. Mitchell,4594957,,True,35.0,5,6,5,6,0,0,1,2,5,11,16,1,3,0,2,3,11
401402592,Princeton Tigers,K. Chen,4899328,,True,38.0,6,15,6,11,0,4,6,7,1,3,4,2,2,0,6,2,18
401402592,Princeton Tigers,J. Cunningham,4399194,,True,37.0,5,14,5,8,0,6,2,2,2,2,4,4,2,1,1,3,12
401402592,Princeton Tigers,G. Stone,4399190,,True,34.0,2,9,1,6,1,3,2,2,2,1,3,1,2,0,2,4,7
401402592,Princeton Tigers,A. Meyers,4281402,,True,35.0,9,18,5,8,4,10,0,0,2,5,7,1,2,1,0,1,22
401402592,Princeton Tigers,C. Nweke,4899329,,False,11.0,1,1,1,1,0,0,0,0,0,1,1,0,0,0,1,1,2
401402592,Princeton Tigers,M. Connolly,4399192,,False,10.0,0,1,0,0,0,1,0,0,0,0,0,1,0,0,1,0,0
401402592,Princeton Tigers,TEAM,TOTAL,TOTAL,False,,28,64,23,40,5,24,11,13,14,27,41,10,11,2,13,14,72
401402592,Harvard Crimson,T. Sussman,4399183,,True,30.0,0,2,0,0,0,2,0,0,1,3,4,0,0,0,1,1,0
401402592,Harvard Crimson,H. Turner,4899316,,True,32.0,8,20,5,14,3,6,0,2,1,3,4,1,1,0,3,2,19
401402592,Harvard Crimson,L. Mullaney,4433377,,True,32.0,5,12,3,6,2,6,3,3,2,1,3,2,0,0,2,1,15
401402592,Harvard Crimson,M. McCarthy,4399184,,True,31.0,3,3,2,2,1,1,0,0,3,4,7,1,1,1,4,4,7
401402592,Harvard Crimson,M. Forbes,4398749,,True,35.0,6,19,3,12,3,7,7,8,1,6,7,3,2,2,2,2,22
401402592,Harvard Crimson,E. Stauffer,4899318,,False,8.0,0,0,0,0,0,0,0,0,0,0,0,0,1,0,1,2,0
401402592,Harvard Crimson,E. Rodriguez,4899315,,False,2.0,0,0,0,0,0,0,0,0,0,0,0,0,0,0,0,0,0
401402592,Harvard Crimson,A. Stritzel,4594963,,False,30.0,2,6,2,6,0,0,0,0,1,2,3,2,2,0,0,4,4
401402592,Harvard Crimson,TEAM,TOTAL,TOTAL,False,,24,62,15,40,9,22,10,13,12,21,33,9,7,3,14,16,67
401402591,IU Indianapolis Jaguars,R. Kent,4433383,,True,38.0,2,8,0,3,2,5,1,2,0,3,3,2,2,1,2,2,7
401402591,IU Indianapolis Jaguars,R. McLimore,4281358,,True,34.0,4,13,3,6,1,7,2,3,1,0,1,1,1,1,5,3,11
401402591,IU Indianapolis Jaguars,M. Wise,4281261,,True,32.0,4,7,3,4,1,3,0,0,1,3,4,3,0,1,5,2,9
401402591,IU Indianapolis Jaguars,M. Williams,4281963,,True,36.0,8,12,8,12,0,0,3,3,4,14,18,1,2,0,2,3,19
401402591,IU Indianapolis Jaguars,D. Perkins,4281995,,True,34.0,3,7,1,2,2,5,7,7,3,0,3,3,2,1,2,1,15
401402591,IU Indianapolis Jaguars,M. Allen,4281962,,False,4.0,0,0,0,0,0,0,0,0,0,0,0,0,0,0,1,1,0
401402591,IU Indianapolis Jaguars,A. Mortag,4704178,,False,8.0,0,5,0,4,0,1,0,0,2,1,3,0,0,0,1,1,0
401402591,IU Indianapolis Jaguars,N. Andersen,4595440,,False,14.0,0,1,0,0,0,1,0,0,0,0,0,1,0,0,0,1,0
401402591,IU Indianapolis Jaguars,TEAM,TOTAL,TOTAL,False,,21,53,15,31,6,22,13,15,13,23,36,11,7,4,20,14,61
401402591,Cleveland State Vikings,N. Dumas,4281944,,True,13.0,2,7,2,7,0,0,0,0,0,0,0,0,0,0,3,2,4
401402591,Cleveland State Vikings,I. Gradwell,4399213,,True,10.0,1,3,1,2,0,1,0,0,0,1,1,0,0,0,2,0,2
401402591,Cleveland State Vikings,D. Leo,4704139,,True,39.0,6,15,4,9,2,6,0,0,0,3,3,2,1,0,4,2,14
401402591,Cleveland State Vikings,B. Zieniewska,4704138,,True,16.0,0,0,0,0,0,0,0,0,0,0,0,0,0,0,1,0,0
401402591,Cleveland State Vikings,G. Smith,4399287,,True,29.0,5,8,3,4,2,4,2,2,1,1,2,3,4,0,1,3,14
401402591,Cleveland State Vikings,B. Moore,4400437,,False,24.0,1,3,1,3,0,0,2,2,0,7,7,0,3,0,1,3,4
401402591,Cleveland State Vikings,A. Ngwafang,4400001,,False,30.0,1,4,1,4,0,0,3,10,2,3,5,2,4,0,2,4,5
401402591,Cleveland State Vikings,D. Williams,4595191,,False,15.0,1,4,0,0,1,4,0,0,0,0,0,0,0,0,0,0,3
401402591,Cleveland State Vikings,I. Geraci,4399211,,False,24.0,3,5,1,2,2,3,0,0,2,1,3,3,1,0,4,2,8
401402591,Cleveland State Vikings,TEAM,TOTAL,TOTAL,False,,20,49,13,31,7,18,7,14,9,18,27,10,13,0,19,16,54
401402590,Green Bay Phoenix,K. Renard,4705094,,True,17.0,1,6,1,4,0,2,0,0,1,2,3,1,0,1,1,1,2
401402590,Green Bay Phoenix,M. Schreiber,4899149,,True,26.0,3,6,2,2,1,4,0,0,0,1,1,1,1,1,0,2,7
401402590,Green Bay Phoenix,C. Schiltz,4595334,,True,25.0,3,9,2,5,1,4,0,0,2,3,5,1,0,1,0,0,7
401402590,Green Bay Phoenix,H. Oskey,4399705,,True,27.0,1,9,1,5,0,4,4,4,0,1,1,1,0,0,0,3,6
401402590,Green Bay Phoenix,M. Pingel,4068968,,True,21.0,0,4,0,0,0,4,0,0,0,3,3,4,0,1,4,1,0
401402590,Green Bay Phoenix,J. Kondrakiewicz,4705095,,False,8.0,2,4,2,4,0,0,0,0,1,0,1,1,0,0,3,4,4
401402590,Green Bay Phoenix,B. Butler,4899147,,False,21.0,0,4,0,0,0,4,0,0,0,0,0,0,0,0,1,1,0
401402590,Green Bay Phoenix,C. Givens,4705092,,False,3.0,1,1,1,1,0,0,0,1,0,0,0,0,1,0,0,0,2
401402590,Green Bay Phoenix,C. Genke,4691702,,False,25.0,3,3,3,3,0,0,0,0,0,4,4,1,0,0,1,0,6
401402590,Green Bay Phoenix,S. Levy,4399718,,False,27.0,3,12,1,1,2,11,0,0,0,2,2,3,1,0,2,2,8
401402590,Green Bay Phoenix,TEAM,TOTAL,TOTAL,False,,17,58,13,25,4,33,4,5,6,18,24,13,3,4,14,14,42
401402590,Cleveland State Vikings,N. Dumas,4281944,,True,24.0,5,10,5,10,0,0,2,2,3,3,6,0,0,0,3,2,12
401402590,Cleveland State Vikings,I. Gradwell,4399213,,True,30.0,4,7,2,3,2,4,2,2,2,5,7,4,3,0,2,0,12
401402590,Cleveland State Vikings,D. Leo,4704139,,True,32.0,2,6,2,5,0,1,1,1,0,2,2,4,0,0,4,2,5
401402590,Cleveland State Vikings,B. Zieniewska,4704138,,True,30.0,2,4,0,1,2,3,2,4,1,12,13,3,1,2,0,3,8
401402590,Cleveland State Vikings,G. Smith,4399287,,True,29.0,4,10,1,3,3,7,0,0,0,2,2,3,1,0,0,3,11
401402590,Cleveland State Vikings,B. Moore,4400437,,False,7.0,1,1,0,0,1,1,0,0,0,1,1,1,0,0,1,0,3
401402590,Cleveland State Vikings,A. Ngwafang,4400001,,False,16.0,3,7,3,7,0,0,0,0,1,2,3,0,1,0,2,2,6
401402590,Cleveland State Vikings,R. Harris,4704144,,False,2.0,0,0,0,0,0,0,0,0,0,1,1,0,0,0,0,0,0
401402590,Cleveland State Vikings,D. Williams,4595191,,False,18.0,3,5,1,2,2,3,0,0,0,1,1,2,0,0,0,0,8
401402590,Cleveland State Vikings,I. Geraci,4399211,,False,12.0,2,4,2,3,0,1,0,0,1,2,3,1,3,0,3,1,4
401402590,Cleveland State Vikings,TEAM,TOTAL,TOTAL,False,,26,54,16,34,10,20,7,9,9,31,40,18,9,2,17,13,69
401402589,Oakland Golden Grizzlies,K. Luchenbach,4399729,,True,18.0,4,6,4,4,0,2,0,0,1,1,2,1,0,0,1,3,8
401402589,Oakland Golden Grizzlies,K. Folley,4899217,,True,17.0,1,6,1,4,0,2,0,0,0,0,0,1,0,0,0,1,2
401402589,Oakland Golden Grizzlies,B. Beatty,4595449,,True,29.0,4,12,2,6,2,6,0,0,5,4,9,1,2,0,0,2,10
401402589,Oakland Golden Grizzlies,S. Gouard,4595448,,True,18.0,3,5,3,5,0,0,0,0,2,1,3,0,0,0,1,1,6
401402589,Oakland Golden Grizzlies,B. Breedy,4399728,,True,34.0,1,8,1,8,0,0,0,2,1,0,1,1,0,0,0,1,2
401402589,Oakland Golden Grizzlies,H. Staley,4899218,,False,3.0,0,0,0,0,0,0,0,0,0,1,1,0,0,0,0,0,0
401402589,Oakland Golden Grizzlies,C. Maholmes,4595450,,False,2.0,0,1,0,0,0,1,0,0,0,0,0,0,0,1,0,0,0
401402589,Oakland Golden Grizzlies,B. Perry,4595447,,False,21.0,5,9,4,5,1,4,0,0,1,0,1,1,0,0,0,3,11
401402589,Oakland Golden Grizzlies,K. Montue,4899221,,False,4.0,0,1,0,0,0,1,0,0,0,0,0,0,0,0,0,1,0
401402589,Oakland Golden Grizzlies,L. Williams,4705087,,False,16.0,0,2,0,1,0,1,0,0,0,0,0,2,0,1,0,1,0
401402589,Oakland Golden Grizzlies,A. McQueen,4597504,,False,8.0,0,1,0,0,0,1,0,0,1,0,1,0,0,0,2,0,0
401402589,Oakland Golden Grizzlies,K. Dean,4399727,,False,30.0,7,17,6,13,1,4,9,11,1,4,5,5,1,0,3,3,24
401402589,Oakland Golden Grizzlies,TEAM,TOTAL,TOTAL,False,,25,68,21,46,4,22,9,13,15,13,28,12,3,2,7,16,63
401402589,IU Indianapolis Jaguars,R. Kent,4433383,,True,35.0,4,8,2,3,2,5,3,4,0,7,7,1,2,0,1,1,13
401402589,IU Indianapolis Jaguars,R. McLimore,4281358,,True,27.0,6,13,5,12,1,1,0,0,2,1,3,2,0,0,1,4,13
401402589,IU Indianapolis Jaguars,M. Wise,4281261,,True,24.0,2,4,1,3,1,1,2,2,2,1,3,4,0,1,1,1,7
401402589,IU Indianapolis Jaguars,M. Williams,4281963,,True,27.0,13,14,13,14,0,0,1,3,5,10,15,2,1,1,2,1,27
401402589,IU Indianapolis Jaguars,D. Perkins,4281995,,True,28.0,1,6,0,1,1,5,2,2,0,3,3,5,0,0,3,1,5
401402589,IU Indianapolis Jaguars,M. Allen,4281962,,False,13.0,2,2,2,2,0,0,3,4,1,2,3,0,0,1,0,1,7
401402589,IU Indianapolis Jaguars,A. Berg,4595439,,False,4.0,1,3,0,1,1,2,0,0,0,0,0,0,0,0,0,0,3
401402589,IU Indianapolis Jaguars,L. Lewis,4899151,,False,3.0,0,0,0,0,0,0,0,0,0,0,0,0,0,0,0,1,0
401402589,IU Indianapolis Jaguars,A. Mortag,4704178,,False,16.0,2,3,2,2,0,1,2,4,0,2,2,4,0,0,1,1,6
401402589,IU Indianapolis Jaguars,J. Jones,4704177,,False,3.0,0,0,0,0,0,0,0,0,0,0,0,0,0,0,0,0,0
401402589,IU Indianapolis Jaguars,N. Andersen,4595440,,False,20.0,2,3,1,2,1,1,0,0,0,1,1,2,1,0,1,1,5
401402589,IU Indianapolis Jaguars,TEAM,TOTAL,TOTAL,False,,33,56,26,40,7,16,13,19,11,29,40,20,4,3,11,12,86
401402588,Northern Kentucky Norse,G. Rose,4282026,,True,34.0,3,8,1,5,2,3,0,0,4,6,10,1,1,4,2,3,8
401402588,Northern Kentucky Norse,E. Souder,4399723,,True,31.0,2,5,2,5,0,0,1,3,2,3,5,0,0,2,0,3,5
401402588,Northern Kentucky Norse,K. Mitchell-Steen,4899215,,True,13.0,0,6,0,6,0,0,0,0,2,1,3,1,1,0,1,3,0
401402588,Northern Kentucky Norse,I. Turner,4595443,,True,38.0,3,15,2,11,1,4,0,0,4,2,6,8,2,0,4,2,7
401402588,Northern Kentucky Norse,L. Duvall,4281191,,True,40.0,4,13,1,4,3,9,0,0,1,7,8,0,4,1,4,2,11
401402588,Northern Kentucky Norse,T. Thompson,4899216,,False,11.0,4,8,4,8,0,0,0,2,2,3,5,0,0,1,0,2,8
401402588,Northern Kentucky Norse,K. Davis,4899213,,False,6.0,0,1,0,0,0,1,0,0,0,0,0,0,0,0,2,0,0
401402588,Northern Kentucky Norse,K. Igo,4705415,,False,27.0,4,8,3,4,1,4,3,4,0,1,1,1,3,0,5,4,12
401402588,Northern Kentucky Norse,TEAM,TOTAL,TOTAL,False,,20,64,13,43,7,21,4,9,18,26,44,11,11,8,18,19,51
401402588,Cleveland State Vikings,N. Dumas,4281944,,True,22.0,4,9,4,9,0,0,0,0,0,2,2,1,0,3,5,3,8
401402588,Cleveland State Vikings,I. Gradwell,4399213,,True,26.0,4,8,3,3,1,5,2,5,0,7,7,1,1,0,1,1,11
401402588,Cleveland State Vikings,D. Leo,4704139,,True,37.0,6,16,2,7,4,9,2,2,0,3,3,2,1,0,2,2,18
401402588,Cleveland State Vikings,B. Zieniewska,4704138,,True,38.0,1,5,0,1,1,4,0,0,2,3,5,3,0,2,2,2,3
401402588,Cleveland State Vikings,G. Smith,4399287,,True,34.0,5,10,4,5,1,5,0,0,2,1,3,2,5,1,1,2,11
401402588,Cleveland State Vikings,B. Moore,4400437,,False,11.0,1,3,1,3,0,0,0,0,1,4,5,1,2,0,1,2,2
401402588,Cleveland State Vikings,A. Ngwafang,4400001,,False,18.0,1,6,1,6,0,0,1,7,6,3,9,2,1,2,2,1,3
401402588,Cleveland State Vikings,R. Harris,4704144,,False,0.0,0,0,0,0,0,0,0,0,0,0,0,0,0,0,0,0,0
401402588,Cleveland State Vikings,D. Williams,4595191,,False,9.0,1,2,0,1,1,1,0,0,0,0,0,1,0,0,0,1,3
401402588,Cleveland State Vikings,I. Geraci,4399211,,False,5.0,0,0,0,0,0,0,0,0,0,2,2,0,0,0,2,2,0
401402588,Cleveland State Vikings,TEAM,TOTAL,TOTAL,False,,23,59,15,35,8,24,5,14,14,28,42,13,10,8,18,16,59
401402587,Robert Morris Colonials,S. Castro,4705117,,True,25.0,4,8,4,7,0,1,0,0,1,5,6,0,1,0,0,5,8
401402587,Robert Morris Colonials,N. Villaflor,4399578,,True,37.0,2,11,2,6,0,5,1,2,3,2,5,1,1,0,0,0,5
401402587,Robert Morris Colonials,A. Mastral,4899241,,True,17.0,1,3,0,0,1,3,0,0,1,1,2,0,1,0,1,0,3
401402587,Robert Morris Colonials,E. Castedo,4399574,,True,35.0,4,12,4,8,0,4,0,0,0,2,2,5,1,0,1,1,8
401402587,Robert Morris Colonials,N. Augustin,4281989,,True,30.0,2,6,1,3,1,3,0,0,1,2,3,1,1,0,1,2,5
401402587,Robert Morris Colonials,D. Vuletich,4899235,,False,6.0,1,1,1,1,0,0,0,0,1,0,1,0,0,0,0,3,2
401402587,Robert Morris Colonials,P. Gedeon,4899238,,False,12.0,0,6,0,6,0,0,1,4,2,1,3,0,1,0,0,2,1
401402587,Robert Morris Colonials,S. Morris,4899239,,False,16.0,2,5,2,3,0,2,1,2,0,2,2,0,0,1,0,2,5
401402587,Robert Morris Colonials,J. DeShields,4899236,,False,2.0,0,0,0,0,0,0,0,0,0,0,0,0,0,0,0,0,0
401402587,Robert Morris Colonials,J. Scott,4899234,,False,3.0,1,2,1,1,0,1,2,3,1,0,1,0,0,0,0,0,4
401402587,Robert Morris Colonials,M. Amalia,4705114,,False,17.0,0,3,0,1,0,2,0,0,1,3,4,0,0,0,2,2,0
401402587,Robert Morris Colonials,TEAM,TOTAL,TOTAL,False,,17,57,15,36,2,21,5,11,12,19,31,7,6,1,9,17,41
401402587,IU Indianapolis Jaguars,R. Kent,4433383,,True,31.0,2,8,1,2,1,6,0,0,1,5,6,2,2,0,1,2,5
401402587,IU Indianapolis Jaguars,R. McLimore,4281358,,True,30.0,5,10,3,8,2,2,2,3,0,1,1,2,0,1,2,0,14
401402587,IU Indianapolis Jaguars,M. Wise,4281261,,True,21.0,1,1,1,1,0,0,0,0,1,4,5,2,0,0,1,1,2
401402587,IU Indianapolis Jaguars,M. Williams,4281963,,True,26.0,11,16,11,16,0,0,3,3,4,8,12,3,1,0,0,0,25
401402587,IU Indianapolis Jaguars,D. Perkins,4281995,,True,29.0,3,5,2,2,1,3,0,0,0,4,4,3,0,0,3,2,7
401402587,IU Indianapolis Jaguars,J. Bronaugh,4899153,,False,2.0,1,2,1,2,0,0,1,1,0,1,1,0,0,0,1,0,3
401402587,IU Indianapolis Jaguars,M. Allen,4281962,,False,11.0,3,4,3,4,0,0,1,1,1,0,1,0,0,1,0,1,7
401402587,IU Indianapolis Jaguars,A. Berg,4595439,,False,4.0,0,0,0,0,0,0,0,2,1,1,2,1,0,0,0,0,0
401402587,IU Indianapolis Jaguars,L. Lewis,4899151,,False,3.0,0,0,0,0,0,0,0,0,0,0,0,0,0,1,0,0,0
401402587,IU Indianapolis Jaguars,A. Mortag,4704178,,False,19.0,2,4,1,2,1,2,4,5,1,0,1,2,0,0,1,4,9
401402587,IU Indianapolis Jaguars,J. Jones,4704177,,False,5.0,0,0,0,0,0,0,0,0,0,0,0,0,0,0,0,1,0
401402587,IU Indianapolis Jaguars,N. Andersen,4595440,,False,19.0,0,4,0,3,0,1,0,0,0,4,4,1,0,0,0,0,0
401402587,IU Indianapolis Jaguars,TEAM,TOTAL,TOTAL,False,,28,54,23,40,5,14,11,15,10,31,41,16,3,3,10,11,72
401402586,Youngstown State Penguins,L. Ritz,4899255,,True,35.0,10,20,10,19,0,1,2,5,3,9,12,1,1,1,1,0,22
401402586,Youngstown State Penguins,P. Shy,4595011,,True,31.0,2,6,0,0,2,6,0,0,0,3,3,2,1,0,0,4,6
401402586,Youngstown State Penguins,M. Aulbach,4595484,,True,35.0,0,2,0,0,0,2,0,0,1,6,7,1,0,0,1,4,0
401402586,Youngstown State Penguins,C. Olson,4282114,,True,39.0,6,11,5,8,1,3,5,7,0,6,6,5,0,2,4,4,18
401402586,Youngstown State Penguins,M. Callahan,4281990,,True,32.0,1,9,0,5,1,4,0,0,0,3,3,2,0,0,4,0,3
401402586,Youngstown State Penguins,L. Linard,4703741,,False,4.0,0,0,0,0,0,0,0,0,0,0,0,0,0,0,0,0,0
401402586,Youngstown State Penguins,J. Wendler,4595488,,False,0.0,0,0,0,0,0,0,0,0,0,0,0,0,0,0,1,0,0
401402586,Youngstown State Penguins,H. Thierry,4899253,,False,9.0,0,0,0,0,0,0,0,2,1,0,1,1,1,1,0,4,0
401402586,Youngstown State Penguins,L. Wagner,4595487,,False,13.0,1,4,0,0,1,4,0,0,1,0,1,0,0,0,1,0,3
401402586,Youngstown State Penguins,L. Mack,4399549,,False,2.0,0,0,0,0,0,0,0,0,0,0,0,0,0,0,0,2,0
401402586,Youngstown State Penguins,TEAM,TOTAL,TOTAL,False,,20,52,15,32,5,20,7,14,7,30,37,12,3,4,13,18,52
401402586,Oakland Golden Grizzlies,K. Luchenbach,4399729,,True,14.0,2,2,2,2,0,0,0,0,2,0,2,0,0,0,0,2,4
401402586,Oakland Golden Grizzlies,K. Folley,4899217,,True,19.0,1,6,1,5,0,1,0,1,0,3,3,0,0,0,1,1,2
401402586,Oakland Golden Grizzlies,B. Beatty,4595449,,True,33.0,5,10,2,3,3,7,1,2,2,5,7,1,0,0,0,1,14
401402586,Oakland Golden Grizzlies,S. Gouard,4595448,,True,17.0,1,3,1,3,0,0,2,2,2,2,4,1,1,0,0,1,4
401402586,Oakland Golden Grizzlies,B. Breedy,4399728,,True,30.0,3,9,1,7,2,2,2,2,1,0,1,6,0,0,2,4,10
401402586,Oakland Golden Grizzlies,H. Staley,4899218,,False,4.0,0,0,0,0,0,0,0,0,0,1,1,0,0,0,0,0,0
401402586,Oakland Golden Grizzlies,B. Perry,4595447,,False,21.0,1,2,1,2,0,0,0,2,2,7,9,0,1,0,1,4,2
401402586,Oakland Golden Grizzlies,K. Montue,4899221,,False,3.0,1,1,0,0,1,1,0,0,0,0,0,0,0,0,0,0,3
401402586,Oakland Golden Grizzlies,L. Williams,4705087,,False,30.0,2,9,2,8,0,1,2,4,0,2,2,2,1,0,1,2,6
401402586,Oakland Golden Grizzlies,A. McQueen,4597504,,False,2.0,0,1,0,1,0,0,0,0,0,0,0,0,0,0,0,0,0
401402586,Oakland Golden Grizzlies,K. Dean,4399727,,False,27.0,4,12,2,7,2,5,8,11,0,5,5,0,2,0,0,3,18
401402586,Oakland Golden Grizzlies,TEAM,TOTAL,TOTAL,False,,20,55,12,38,8,17,15,24,9,27,36,10,5,0,6,18,63
401402585,Milwaukee Panthers,M. Walstad,4399719,,True,31.0,2,5,1,3,1,2,0,0,3,5,8,2,1,0,2,1,5
401402585,Milwaukee Panthers,E. Wittmershaus,4399717,,True,29.0,2,5,0,2,2,3,0,0,1,4,5,1,0,1,4,0,6
401402585,Milwaukee Panthers,S. Staver,4282009,,True,27.0,4,10,4,6,0,4,1,2,0,0,0,1,2,0,1,3,9
401402585,Milwaukee Panthers,M. Schmelzer,4068976,,True,29.0,2,9,0,4,2,5,0,0,0,3,3,4,2,0,2,2,6
401402585,Milwaukee Panthers,M. Santoro,4068838,,True,24.0,2,5,1,3,1,2,1,2,0,2,2,0,0,1,3,4,6
401402585,Milwaukee Panthers,M. McGlone,4705101,,False,5.0,1,2,1,2,0,0,0,0,1,1,2,0,0,0,0,0,2
401402585,Milwaukee Panthers,L. Halevi,4595502,,False,2.0,1,1,1,1,0,0,0,0,0,1,1,0,0,0,0,1,2
401402585,Milwaukee Panthers,G. Crowley,4595441,,False,13.0,1,3,1,3,0,0,0,0,0,3,3,0,0,2,1,0,2
401402585,Milwaukee Panthers,K. Nead,4705100,,False,13.0,0,6,0,3,0,3,0,0,0,0,0,1,1,1,0,0,0
401402585,Milwaukee Panthers,J. Donaldson,4705099,,False,11.0,1,2,1,2,0,0,0,0,0,1,1,0,0,0,1,0,2
401402585,Milwaukee Panthers,A. Cera,4705098,,False,13.0,0,1,0,0,0,1,0,0,0,0,0,2,0,0,0,0,0
401402585,Milwaukee Panthers,AL. Moore,4282008,,False,3.0,1,1,1,1,0,0,0,0,0,0,0,0,0,0,0,0,2
401402585,Milwaukee Panthers,TEAM,TOTAL,TOTAL,False,,17,50,11,30,6,20,2,4,5,24,29,11,6,5,14,11,42
401402585,Green Bay Phoenix,J. Hartwig,4595335,,True,22.0,5,7,5,7,0,0,1,1,1,2,3,3,1,0,0,1,11
401402585,Green Bay Phoenix,M. Schreiber,4899149,,True,23.0,2,6,0,2,2,4,0,0,2,4,6,1,0,2,0,1,6
401402585,Green Bay Phoenix,C. Schiltz,4595334,,True,30.0,6,11,4,6,2,5,0,0,0,7,7,0,1,0,2,1,14
401402585,Green Bay Phoenix,H. Oskey,4399705,,True,33.0,2,9,2,8,0,1,1,2,1,2,3,4,1,1,0,0,5
401402585,Green Bay Phoenix,M. Pingel,4068968,,True,22.0,2,5,2,4,0,1,0,1,1,1,2,1,1,0,3,1,4
401402585,Green Bay Phoenix,J. Kondrakiewicz,4705095,,False,15.0,1,4,1,4,0,0,0,0,0,1,1,2,1,0,1,1,2
401402585,Green Bay Phoenix,B. Butler,4899147,,False,21.0,3,5,2,3,1,2,2,3,1,3,4,2,1,1,2,1,9
401402585,Green Bay Phoenix,C. Genke,4691702,,False,11.0,0,3,0,2,0,1,0,0,1,1,2,1,0,0,0,0,0
401402585,Green Bay Phoenix,S. Levy,4399718,,False,23.0,2,7,0,4,2,3,0,0,1,5,6,2,1,0,2,1,6
401402585,Green Bay Phoenix,TEAM,TOTAL,TOTAL,False,,23,57,16,40,7,17,4,7,8,29,37,16,7,4,11,7,57
401402584,Wright State Raiders,J. Wright,4594764,,True,29.0,5,12,5,12,0,0,1,1,4,5,9,1,3,3,1,3,11
401402584,Wright State Raiders,J. Stanley,4912144,,True,25.0,0,1,0,0,0,1,0,0,0,1,1,0,0,0,1,0,0
401402584,Wright State Raiders,C. Chappell,4705122,,True,34.0,2,7,2,4,0,3,0,0,0,4,4,3,1,0,4,1,4
401402584,Wright State Raiders,KK White,4705119,,True,40.0,5,9,5,5,0,4,2,6,1,5,6,1,1,0,3,1,12
401402584,Wright State Raiders,J. Roberson,4595482,,True,31.0,5,20,3,13,2,7,2,4,2,2,4,1,1,0,4,3,14
401402584,Wright State Raiders,D. Stokes,4705121,,False,13.0,2,3,2,3,0,0,0,0,0,3,3,0,2,0,1,3,4
401402584,Wright State Raiders,M. Webster,4899250,,False,28.0,0,2,0,0,0,2,0,0,0,1,1,0,0,0,1,2,0
401402584,Wright State Raiders,TEAM,TOTAL,TOTAL,False,,19,54,17,37,2,17,5,11,9,24,33,6,8,3,16,13,45
401402584,Oakland Golden Grizzlies,K. Luchenbach,4399729,,True,16.0,1,6,1,5,0,1,2,3,0,5,5,1,1,1,2,0,4
401402584,Oakland Golden Grizzlies,K. Folley,4899217,,True,19.0,3,6,2,5,1,1,0,2,1,2,3,0,1,0,2,2,7
401402584,Oakland Golden Grizzlies,B. Beatty,4595449,,True,33.0,5,9,4,4,1,5,0,0,1,6,7,5,1,0,3,2,11
401402584,Oakland Golden Grizzlies,S. Gouard,4595448,,True,23.0,2,4,2,3,0,1,0,0,2,2,4,1,1,0,1,0,4
401402584,Oakland Golden Grizzlies,B. Breedy,4399728,,True,35.0,2,5,2,4,0,1,0,0,0,2,2,2,0,0,1,1,4
401402584,Oakland Golden Grizzlies,H. Staley,4899218,,False,4.0,0,1,0,1,0,0,0,0,1,1,2,0,0,0,0,3,0
401402584,Oakland Golden Grizzlies,C. Maholmes,4595450,,False,6.0,0,0,0,0,0,0,0,0,0,0,0,0,0,0,1,1,0
401402584,Oakland Golden Grizzlies,B. Perry,4595447,,False,16.0,2,9,2,6,0,3,1,2,2,3,5,0,0,0,1,2,5
401402584,Oakland Golden Grizzlies,P. Mungo,4899219,,False,2.0,0,0,0,0,0,0,0,0,0,0,0,0,0,0,0,0,0
401402584,Oakland Golden Grizzlies,K. Montue,4899221,,False,7.0,0,3,0,1,0,2,0,0,3,0,3,0,1,0,0,0,0
401402584,Oakland Golden Grizzlies,L. Williams,4705087,,False,30.0,7,14,7,12,0,2,2,3,4,6,10,1,3,0,2,0,16
401402584,Oakland Golden Grizzlies,A. McQueen,4597504,,False,7.0,1,7,0,3,1,4,0,0,1,2,3,0,0,0,0,0,3
401402584,Oakland Golden Grizzlies,TEAM,TOTAL,TOTAL,False,,23,64,20,44,3,20,5,10,18,30,48,10,8,1,15,11,54
401402583,Northern Kentucky Norse,G. Rose,4282026,,True,28.0,3,6,1,2,2,4,1,1,1,5,6,2,1,3,2,2,9
401402583,Northern Kentucky Norse,E. Souder,4399723,,True,26.0,5,7,5,7,0,0,2,3,4,2,6,1,2,0,0,2,12
401402583,Northern Kentucky Norse,K. Mitchell-Steen,4899215,,True,19.0,3,6,3,6,0,0,2,2,1,3,4,1,4,0,7,2,8
401402583,Northern Kentucky Norse,I. Turner,4595443,,True,27.0,3,8,1,4,2,4,2,2,0,2,2,2,2,0,3,0,10
401402583,Northern Kentucky Norse,L. Duvall,4281191,,True,25.0,4,19,2,7,2,12,0,0,2,3,5,3,1,0,0,1,10
401402583,Northern Kentucky Norse,T. Thompson,4899216,,False,12.0,4,5,4,5,0,0,0,2,4,5,9,1,2,1,2,3,8
401402583,Northern Kentucky Norse,P. Hodgson,4899214,,False,1.0,0,0,0,0,0,0,0,0,0,0,0,0,0,0,0,0,0
401402583,Northern Kentucky Norse,J. Johnson,4595935,,False,10.0,1,3,1,2,0,1,0,0,0,2,2,0,0,0,0,2,2
401402583,Northern Kentucky Norse,T. Irvin,4595445,,False,8.0,1,2,1,2,0,0,0,0,0,2,2,0,0,0,0,2,2
401402583,Northern Kentucky Norse,E. Taylor,4705417,,False,5.0,0,1,0,0,0,1,0,0,0,0,0,0,0,0,1,1,0
401402583,Northern Kentucky Norse,K. Davis,4899213,,False,16.0,2,3,2,2,0,1,0,0,0,3,3,2,0,0,1,2,4
401402583,Northern Kentucky Norse,K. Igo,4705415,,False,23.0,3,6,1,3,2,3,0,0,0,0,0,3,0,0,1,0,8
401402583,Northern Kentucky Norse,TEAM,TOTAL,TOTAL,False,,29,66,21,40,8,26,7,10,12,28,40,15,12,4,17,17,73
401402583,Detroit Mercy Titans,I. Murua,4704201,,True,35.0,4,12,4,12,0,0,2,2,2,5,7,1,5,0,4,2,10
401402583,Detroit Mercy Titans,L. Fleta Robles,4899145,,True,22.0,5,11,5,9,0,2,0,0,0,0,0,0,1,0,4,2,10
401402583,Detroit Mercy Titans,I. McNeal,4899139,,True,18.0,0,1,0,1,0,0,0,0,1,0,1,0,1,0,3,2,0
401402583,Detroit Mercy Titans,M. Pruitt,4704651,,True,1.0,0,1,0,1,0,0,0,0,0,0,0,0,0,0,1,0,0
401402583,Detroit Mercy Titans,T. Powell,4400629,,True,35.0,1,7,1,4,0,3,3,4,1,2,3,5,0,0,1,1,5
401402583,Detroit Mercy Titans,J. Lewis,4595446,,False,15.0,0,3,0,2,0,1,4,6,0,1,1,1,1,1,2,2,4
401402583,Detroit Mercy Titans,D. Moses,4282182,,False,29.0,3,5,3,5,0,0,3,6,0,4,4,1,1,1,1,3,9
401402583,Detroit Mercy Titans,S. Pereda,4899142,,False,12.0,0,0,0,0,0,0,0,0,0,2,2,1,1,0,1,1,0
401402583,Detroit Mercy Titans,B. Washington,4596277,,False,33.0,3,10,3,7,0,3,6,7,0,10,10,0,2,0,3,2,12
401402583,Detroit Mercy Titans,TEAM,TOTAL,TOTAL,False,,16,50,16,41,0,9,18,25,7,26,33,9,12,2,21,15,50
401402582,Robert Morris Colonials,S. Castro,4705117,,True,38.0,7,15,7,15,0,0,2,3,3,7,10,1,0,2,2,3,16
401402582,Robert Morris Colonials,N. Villaflor,4399578,,True,26.0,2,7,2,6,0,1,0,0,2,4,6,1,2,0,0,2,4
401402582,Robert Morris Colonials,A. Mastral,4899241,,True,17.0,1,4,0,0,1,4,0,0,0,1,1,1,0,0,0,3,3
401402582,Robert Morris Colonials,E. Castedo,4399574,,True,38.0,6,13,4,8,2,5,0,0,0,4,4,9,2,0,1,2,14
401402582,Robert Morris Colonials,N. Augustin,4281989,,True,21.0,0,4,0,1,0,3,1,2,1,0,1,1,0,1,2,0,1
401402582,Robert Morris Colonials,P. Gedeon,4899238,,False,16.0,3,7,3,7,0,0,0,0,3,2,5,0,2,0,2,4,6
401402582,Robert Morris Colonials,S. Morris,4899239,,False,21.0,4,10,1,4,3,6,0,0,3,1,4,2,1,2,1,0,11
401402582,Robert Morris Colonials,M. Amalia,4705114,,False,23.0,5,6,1,1,4,5,1,1,1,3,4,3,1,1,1,0,15
401402582,Robert Morris Colonials,TEAM,TOTAL,TOTAL,False,,28,66,18,42,10,24,4,6,17,24,41,18,8,6,10,14,70
401402582,Purdue Fort Wayne Mastodons,Ry. Ott,4899223,,True,38.0,5,13,2,8,3,5,0,0,1,1,2,3,0,1,1,2,13
401402582,Purdue Fort Wayne Mastodons,A. Bromenschenkel,4711724,,True,36.0,3,9,1,4,2,5,2,2,1,4,5,0,0,0,0,3,10
401402582,Purdue Fort Wayne Mastodons,A. Stupp,4705107,,True,28.0,1,5,0,1,1,4,1,2,2,8,10,2,2,0,5,2,4
401402582,Purdue Fort Wayne Mastodons,S. Sellers,4596447,,True,38.0,4,12,2,5,2,7,6,6,1,2,3,2,1,1,4,2,16
401402582,Purdue Fort Wayne Mastodons,S. Starks,4595281,,True,24.0,1,6,1,2,0,4,6,6,0,2,2,0,0,0,1,3,8
401402582,Purdue Fort Wayne Mastodons,A. Stephens,4899225,,False,4.0,0,0,0,0,0,0,0,0,0,0,0,0,1,0,0,1,0
401402582,Purdue Fort Wayne Mastodons,A. Emmerson,4899224,,False,23.0,2,5,1,2,1,3,0,0,0,4,4,5,0,0,1,1,5
401402582,Purdue Fort Wayne Mastodons,S. Johnson,4281695,,False,8.0,0,1,0,1,0,0,0,0,2,0,2,0,0,0,0,0,0
401402582,Purdue Fort Wayne Mastodons,TEAM,TOTAL,TOTAL,False,,16,51,7,23,9,28,15,16,10,23,33,12,4,2,13,14,56
401402580,UC Irvine Anteaters,S. Locandro,4595211,,True,31.0,3,7,3,6,0,1,3,4,1,6,7,0,0,3,1,3,9
401402580,UC Irvine Anteaters,N. Hunt,4281707,,True,17.0,2,6,0,2,2,4,0,0,2,2,4,1,0,0,0,2,6
401402580,UC Irvine Anteaters,N. Tom,4899722,,True,30.0,2,4,0,0,2,4,0,0,2,2,4,2,2,0,0,3,6
401402580,UC Irvine Anteaters,J. Cadee,4595210,,True,28.0,4,12,1,3,3,9,0,0,1,2,3,2,0,0,0,4,11
401402580,UC Irvine Anteaters,K. Williams,4595209,,True,40.0,4,18,2,8,2,10,1,4,2,2,4,3,2,0,6,3,11
401402580,UC Irvine Anteaters,C. Kaupu,4704426,,False,3.0,0,1,0,1,0,0,0,0,2,0,2,0,0,0,0,1,0
401402580,UC Irvine Anteaters,T. Dusharm,3906747,,False,5.0,0,1,0,1,0,0,0,2,1,1,2,0,0,0,0,2,0
401402580,UC Irvine Anteaters,O. Williams,4899726,,False,3.0,0,2,0,2,0,0,0,0,0,2,2,0,0,0,0,0,0
401402580,UC Irvine Anteaters,H. Hernandez,4899725,,False,17.0,0,0,0,0,0,0,0,0,0,0,0,0,0,0,2,2,0
401402580,UC Irvine Anteaters,D. Lee,4899724,,False,2.0,0,0,0,0,0,0,0,0,0,0,0,0,0,0,1,0,0
401402580,UC Irvine Anteaters,C. Webb,4595208,,False,24.0,1,8,1,4,0,4,3,4,4,2,6,2,1,0,1,3,5
401402580,UC Irvine Anteaters,TEAM,TOTAL,TOTAL,False,,16,59,7,27,9,32,7,14,15,19,34,10,5,3,11,23,48
401402580,Hawai'i Rainbow Wahine,K. Spiller,4282329,,True,23.0,4,9,4,7,0,2,0,0,2,3,5,1,1,0,1,3,8
401402580,Hawai'i Rainbow Wahine,A. Atwell,4068885,,True,37.0,3,8,2,4,1,4,6,7,0,5,5,1,1,0,0,1,13
401402580,Hawai'i Rainbow Wahine,O. Davies,4595197,,True,36.0,2,4,1,2,1,2,9,9,1,4,5,0,0,0,2,2,14
401402580,Hawai'i Rainbow Wahine,K. Imai,4704370,,True,17.0,0,8,0,3,0,5,0,0,1,2,3,2,0,0,1,1,0
401402580,Hawai'i Rainbow Wahine,D. Phillips,4704369,,True,31.0,2,6,2,5,0,1,4,6,6,4,10,5,1,0,1,3,8
401402580,Hawai'i Rainbow Wahine,J. David,4899662,,False,4.0,0,1,0,0,0,1,0,0,0,0,0,1,0,0,0,1,0
401402580,Hawai'i Rainbow Wahine,N. Orji,4704372,,False,16.0,3,4,3,4,0,0,5,6,1,3,4,0,0,0,1,1,11
401402580,Hawai'i Rainbow Wahine,M. McBee,4704375,,False,3.0,0,2,0,1,0,1,0,0,0,0,0,0,0,0,0,0,0
401402580,Hawai'i Rainbow Wahine,N. Calhoun,4595198,,False,23.0,1,4,1,2,0,2,3,4,0,4,4,0,2,0,1,3,5
401402580,Hawai'i Rainbow Wahine,A. Thoms,4399949,,False,10.0,0,2,0,0,0,2,0,0,0,2,2,1,1,0,0,1,0
401402580,Hawai'i Rainbow Wahine,TEAM,TOTAL,TOTAL,False,,15,48,13,28,2,20,27,32,14,27,41,11,6,0,9,16,59
401402579,UC Irvine Anteaters,S. Locandro,4595211,,True,33.0,3,4,2,3,1,1,2,2,2,4,6,0,1,1,1,3,9
401402579,UC Irvine Anteaters,N. Hunt,4281707,,True,27.0,3,7,0,3,3,4,2,4,0,4,4,1,1,1,1,3,11
401402579,UC Irvine Anteaters,N. Tom,4899722,,True,27.0,2,5,1,3,1,2,1,1,0,5,5,0,2,0,0,3,6
401402579,UC Irvine Anteaters,J. Cadee,4595210,,True,23.0,1,4,1,1,0,3,7,9,2,3,5,1,0,0,0,0,9
401402579,UC Irvine Anteaters,K. Williams,4595209,,True,42.0,8,18,7,12,1,6,5,6,1,3,4,4,2,0,3,2,22
401402579,UC Irvine Anteaters,C. Kaupu,4704426,,False,1.0,0,0,0,0,0,0,0,0,0,0,0,0,0,0,0,0,0
401402579,UC Irvine Anteaters,T. Dusharm,3906747,,False,10.0,2,2,2,2,0,0,3,4,0,0,0,1,0,0,1,1,7
401402579,UC Irvine Anteaters,O. Williams,4899726,,False,16.0,2,4,2,2,0,2,0,0,0,0,0,1,0,0,0,0,4
401402579,UC Irvine Anteaters,H. Hernandez,4899725,,False,22.0,1,3,1,3,0,0,0,0,0,5,5,2,1,1,0,2,2
401402579,UC Irvine Anteaters,D. Lee,4899724,,False,1.0,0,0,0,0,0,0,0,0,0,0,0,0,0,0,0,0,0
401402579,UC Irvine Anteaters,C. Webb,4595208,,False,23.0,5,12,4,8,1,4,3,4,0,1,1,0,2,0,2,5,14
401402579,UC Irvine Anteaters,TEAM,TOTAL,TOTAL,False,,27,59,20,37,7,22,23,30,6,30,36,10,9,3,9,19,84
401402579,UC Davis Aggies,C. Hall,4281712,,True,44.0,8,19,8,16,0,3,4,5,3,11,14,1,0,1,3,3,20
401402579,UC Davis Aggies,K. Konrad,4281711,,True,41.0,2,8,2,6,0,2,0,0,0,5,5,3,1,1,0,5,4
401402579,UC Davis Aggies,S. Stobbart,4281710,,True,35.0,6,13,6,10,0,3,3,5,4,6,10,3,0,1,4,4,15
401402579,UC Davis Aggies,S. Burns,4899719,,True,32.0,3,7,3,5,0,2,0,0,1,2,3,4,3,2,2,4,6
401402579,UC Davis Aggies,E. Turner,4595205,,True,44.0,8,19,4,4,4,15,2,2,1,0,1,2,0,0,2,3,22
401402579,UC Davis Aggies,M. Harris,4704336,,False,6.0,0,0,0,0,0,0,0,0,0,1,1,0,0,0,1,2,0
401402579,UC Davis Aggies,L. Svanholm,4281822,,False,10.0,2,3,0,0,2,3,0,0,0,0,0,0,0,0,1,0,6
401402579,UC Davis Aggies,C. Gray,4595204,,False,13.0,0,0,0,0,0,0,2,2,0,0,0,2,0,0,1,0,2
401402579,UC Davis Aggies,TEAM,TOTAL,TOTAL,False,,29,69,23,41,6,28,11,14,12,29,41,15,4,5,14,21,75
401402578,UC Riverside Highlanders,A. Blount,4595640,,True,10.0,1,3,1,3,0,0,0,0,0,0,0,0,0,0,0,1,2
401402578,UC Riverside Highlanders,M. Finau,4594847,,True,33.0,2,7,2,5,0,2,3,3,0,1,1,0,0,1,1,2,7
401402578,UC Riverside Highlanders,J. Holland,4595890,,True,40.0,5,12,4,10,1,2,4,7,0,4,4,5,3,0,3,1,15
401402578,UC Riverside Highlanders,K. Cooper,4281721,,True,18.0,2,8,2,7,0,1,0,0,1,4,5,0,2,0,3,0,4
401402578,UC Riverside Highlanders,O. West,4068416,,True,40.0,2,9,2,4,0,5,8,8,0,1,1,1,1,0,2,2,12
401402578,UC Riverside Highlanders,E. Matarranz,4899727,,False,3.0,0,0,0,0,0,0,0,0,1,0,1,0,0,0,2,0,0
401402578,UC Riverside Highlanders,M. Bryant,4595889,,False,18.0,2,4,2,4,0,0,3,4,1,6,7,0,0,1,0,3,7
401402578,UC Riverside Highlanders,D. Gnago,4281723,,False,4.0,0,0,0,0,0,0,0,0,1,0,1,0,0,0,0,0,0
401402578,UC Riverside Highlanders,J. Webster,4704350,,False,26.0,2,4,0,0,2,4,2,2,1,0,1,0,1,0,0,3,8
401402578,UC Riverside Highlanders,R. Walters,4433366,,False,8.0,0,4,0,2,0,2,0,0,0,0,0,0,0,1,1,1,0
401402578,UC Riverside Highlanders,TEAM,TOTAL,TOTAL,False,,16,51,13,35,3,16,20,24,8,19,27,6,7,3,13,13,55
401402578,Hawai'i Rainbow Wahine,K. Spiller,4282329,,True,21.0,5,9,4,6,1,3,0,1,1,4,5,2,0,1,1,3,11
401402578,Hawai'i Rainbow Wahine,A. Atwell,4068885,,True,35.0,8,15,2,7,6,8,0,0,1,12,13,1,4,1,3,1,22
401402578,Hawai'i Rainbow Wahine,O. Davies,4595197,,True,28.0,3,8,2,5,1,3,3,4,0,4,4,4,1,0,2,0,10
401402578,Hawai'i Rainbow Wahine,K. Imai,4704370,,True,20.0,1,5,1,4,0,1,0,0,0,3,3,2,0,0,1,3,2
401402578,Hawai'i Rainbow Wahine,D. Phillips,4704369,,True,21.0,1,5,1,5,0,0,0,0,4,2,6,0,1,0,2,4,2
401402578,Hawai'i Rainbow Wahine,J. David,4899662,,False,5.0,1,3,0,1,1,2,0,0,1,0,1,0,0,0,0,0,3
401402578,Hawai'i Rainbow Wahine,N. Orji,4704372,,False,15.0,1,3,1,3,0,0,4,4,1,1,2,1,3,0,2,4,6
401402578,Hawai'i Rainbow Wahine,M. McBee,4704375,,False,5.0,0,0,0,0,0,0,0,0,0,0,0,0,0,0,2,4,0
401402578,Hawai'i Rainbow Wahine,N. Calhoun,4595198,,False,22.0,2,3,2,3,0,0,1,2,0,1,1,2,0,0,1,2,5
401402578,Hawai'i Rainbow Wahine,A. Thoms,4399949,,False,28.0,2,4,0,0,2,4,2,2,0,0,0,2,0,1,1,2,8
401402578,Hawai'i Rainbow Wahine,TEAM,TOTAL,TOTAL,False,,24,55,13,34,11,21,10,13,15,29,44,14,9,3,19,23,69
401402577,UC Davis Aggies,C. Hall,4281712,,True,39.0,4,13,3,9,1,4,5,8,1,7,8,2,3,1,5,3,14
401402577,UC Davis Aggies,K. Konrad,4281711,,True,29.0,2,5,2,3,0,2,0,0,2,5,7,2,0,0,1,3,4
401402577,UC Davis Aggies,S. Stobbart,4281710,,True,32.0,4,9,3,8,1,1,0,0,2,4,6,1,0,2,3,2,9
401402577,UC Davis Aggies,S. Burns,4899719,,True,35.0,1,4,1,2,0,2,7,8,2,10,12,3,1,0,4,5,9
401402577,UC Davis Aggies,E. Turner,4595205,,True,39.0,6,14,1,4,5,10,2,2,0,3,3,2,2,0,6,2,19
401402577,UC Davis Aggies,M. Harris,4704336,,False,8.0,0,0,0,0,0,0,0,0,1,0,1,1,0,0,0,3,0
401402577,UC Davis Aggies,L. Svanholm,4281822,,False,6.0,0,2,0,1,0,1,0,0,0,2,2,1,0,0,0,1,0
401402577,UC Davis Aggies,C. Gray,4595204,,False,10.0,0,0,0,0,0,0,0,0,0,0,0,1,0,0,2,0,0
401402577,UC Davis Aggies,M. Sanders,4400058,,False,2.0,0,0,0,0,0,0,0,0,0,0,0,0,0,0,1,0,0
401402577,UC Davis Aggies,TEAM,TOTAL,TOTAL,False,,17,47,10,27,7,20,14,18,8,31,39,13,6,3,22,19,55
401402577,Long Beach State Beach,M. Utti,4281828,,True,40.0,7,16,7,13,0,3,0,2,2,7,9,3,3,0,3,2,14
401402577,Long Beach State Beach,K. Hamilton-Fisher,4400055,,True,29.0,1,6,0,3,1,3,0,0,1,2,3,1,2,0,1,5,3
401402577,Long Beach State Beach,J. Hardy,4400053,,True,29.0,2,8,1,3,1,5,0,0,2,2,4,2,1,0,1,3,5
401402577,Long Beach State Beach,J. King,4400052,,True,40.0,4,12,4,9,0,3,4,8,0,4,4,2,0,0,0,2,12
401402577,Long Beach State Beach,M. Berry,4281701,,True,25.0,2,4,1,2,1,2,0,0,0,0,0,0,2,2,2,2,5
401402577,Long Beach State Beach,L. Green,4400054,,False,6.0,0,3,0,3,0,0,0,0,2,0,2,0,0,0,1,2,0
401402577,Long Beach State Beach,P. Chung,4704395,,False,4.0,1,3,1,2,0,1,0,0,0,0,0,0,0,0,0,0,2
401402577,Long Beach State Beach,S. Tucker,4704394,,False,13.0,0,3,0,2,0,1,0,2,0,0,0,0,0,1,2,3,0
401402577,Long Beach State Beach,K. Jeskeova,4595201,,False,14.0,0,2,0,1,0,1,4,4,0,2,2,0,2,0,2,1,4
401402577,Long Beach State Beach,TEAM,TOTAL,TOTAL,False,,17,57,14,38,3,19,8,16,7,17,24,8,10,3,12,20,45
401402576,UC Irvine Anteaters,S. Locandro,4595211,,True,24.0,4,7,4,7,0,0,0,0,3,5,8,1,2,0,2,2,8
401402576,UC Irvine Anteaters,N. Hunt,4281707,,True,16.0,3,9,2,5,1,4,1,2,1,0,1,0,0,0,1,3,8
401402576,UC Irvine Anteaters,N. Tom,4899722,,True,26.0,1,3,1,1,0,2,2,2,2,0,2,3,2,0,2,2,4
401402576,UC Irvine Anteaters,J. Cadee,4595210,,True,23.0,1,8,0,3,1,5,4,4,1,1,2,1,0,0,1,2,7
401402576,UC Irvine Anteaters,K. Williams,4595209,,True,35.0,6,16,4,9,2,7,8,10,0,7,7,4,2,0,2,1,22
401402576,UC Irvine Anteaters,C. Kaupu,4704426,,False,4.0,1,1,1,1,0,0,2,2,0,0,0,1,0,0,0,0,4
401402576,UC Irvine Anteaters,M. Kapinga,4400059,,False,1.0,0,0,0,0,0,0,0,0,0,0,0,0,0,0,0,0,0
401402576,UC Irvine Anteaters,T. Dusharm,3906747,,False,15.0,1,3,1,3,0,0,2,2,3,1,4,0,1,0,0,2,4
401402576,UC Irvine Anteaters,O. Williams,4899726,,False,14.0,1,3,1,1,0,2,0,0,0,1,1,0,1,0,1,1,2
401402576,UC Irvine Anteaters,H. Hernandez,4899725,,False,20.0,4,4,2,2,2,2,5,5,3,4,7,1,0,0,0,3,15
401402576,UC Irvine Anteaters,D. Lee,4899724,,False,6.0,0,0,0,0,0,0,0,0,0,0,0,0,0,0,0,1,0
401402576,UC Irvine Anteaters,C. Webb,4595208,,False,16.0,3,7,3,7,0,0,0,0,4,6,10,1,0,0,1,0,6
401402576,UC Irvine Anteaters,TEAM,TOTAL,TOTAL,False,,25,61,19,39,6,22,24,27,19,28,47,12,8,0,11,17,80
401402576,Cal State Fullerton Titans,K. Neff,4595189,,True,18.0,0,2,0,0,0,2,0,0,0,0,0,1,0,0,1,0,0
401402576,Cal State Fullerton Titans,C. Gill,4281455,,True,29.0,5,9,5,8,0,1,3,5,2,2,4,2,2,0,1,4,13
401402576,Cal State Fullerton Titans,A. Lewis,4704361,,True,30.0,3,12,3,12,0,0,5,6,5,4,9,0,1,1,2,3,11
401402576,Cal State Fullerton Titans,L. Wahinekapu,4902813,,True,35.0,7,18,5,9,2,9,10,11,0,7,7,4,1,0,4,2,26
401402576,Cal State Fullerton Titans,G. Vidmar,4704360,,True,36.0,2,8,0,3,2,5,0,0,1,3,4,2,0,0,2,3,6
401402576,Cal State Fullerton Titans,A. Hernandez,4902816,,False,12.0,3,8,3,8,0,0,0,0,1,0,1,0,0,0,0,0,6
401402576,Cal State Fullerton Titans,R. MacDonald,4902815,,False,7.0,0,0,0,0,0,0,0,0,2,0,2,0,0,0,1,1,0
401402576,Cal State Fullerton Titans,B. Furch,4902817,,False,15.0,0,3,0,0,0,3,0,0,0,0,0,4,0,0,0,2,0
401402576,Cal State Fullerton Titans,E. De Vera,4902814,,False,0.0,0,0,0,0,0,0,0,0,0,0,0,0,0,0,0,2,0
401402576,Cal State Fullerton Titans,U. Jovanovic,4902811,,False,10.0,0,1,0,0,0,1,0,0,0,1,1,0,0,0,1,1,0
401402576,Cal State Fullerton Titans,C. Rodarte,4400029,,False,8.0,0,0,0,0,0,0,6,6,0,0,0,0,1,0,0,5,6
401402576,Cal State Fullerton Titans,TEAM,TOTAL,TOTAL,False,,20,61,16,40,4,21,24,28,16,18,34,13,5,1,13,23,68
401402575,UC Santa Barbara Gauchos,M. Anderson,4281881,,True,13.0,1,2,0,0,1,2,0,0,0,3,3,0,0,0,2,0,3
401402575,UC Santa Barbara Gauchos,I. Lane,4595216,,True,25.0,4,10,4,10,0,0,0,0,1,4,5,0,0,1,4,3,8
401402575,UC Santa Barbara Gauchos,J. Gonzalez,4433343,,True,19.0,0,2,0,2,0,0,0,0,0,0,0,2,0,0,0,2,0
401402575,UC Santa Barbara Gauchos,A. Tucker,4432947,,True,38.0,6,13,5,11,1,2,1,1,1,11,12,0,2,0,4,3,14
401402575,UC Santa Barbara Gauchos,D. Miller,4281726,,True,40.0,3,11,3,9,0,2,3,4,2,3,5,5,0,0,4,0,9
401402575,UC Santa Barbara Gauchos,T. Mole,4400101,,False,27.0,2,6,1,3,1,3,0,0,1,4,5,0,3,2,0,1,5
401402575,UC Santa Barbara Gauchos,K. Johnson,4899739,,False,0.0,0,0,0,0,0,0,0,0,0,0,0,0,0,0,0,1,0
401402575,UC Santa Barbara Gauchos,A. Marin,4704398,,False,4.0,0,1,0,1,0,0,0,0,0,0,0,0,0,0,1,3,0
401402575,UC Santa Barbara Gauchos,A. Choice,4704397,,False,17.0,1,4,1,3,0,1,0,0,1,0,1,0,1,0,2,3,2
401402575,UC Santa Barbara Gauchos,L. Lee,4400069,,False,17.0,0,0,0,0,0,0,1,2,1,1,2,0,0,0,1,3,1
401402575,UC Santa Barbara Gauchos,TEAM,TOTAL,TOTAL,False,,17,49,14,39,3,10,5,7,9,28,37,7,6,3,20,19,42
401402575,UC Riverside Highlanders,A. Blount,4595640,,True,24.0,2,11,2,11,0,0,6,6,5,1,6,1,0,1,2,1,10
401402575,UC Riverside Highlanders,M. Finau,4594847,,True,22.0,1,3,0,1,1,2,0,0,1,4,5,1,0,0,1,1,3
401402575,UC Riverside Highlanders,J. Holland,4595890,,True,35.0,4,14,4,13,0,1,4,4,0,3,3,3,2,2,5,1,12
401402575,UC Riverside Highlanders,K. Cooper,4281721,,True,22.0,2,8,2,7,0,1,0,0,0,3,3,0,1,0,2,4,4
401402575,UC Riverside Highlanders,O. West,4068416,,True,40.0,3,7,2,5,1,2,2,3,0,2,2,1,1,0,0,1,9
401402575,UC Riverside Highlanders,E. Matarranz,4899727,,False,2.0,0,0,0,0,0,0,0,0,0,0,0,0,0,0,0,0,0
401402575,UC Riverside Highlanders,M. Bryant,4595889,,False,3.0,0,1,0,1,0,0,0,0,0,0,0,0,0,0,1,0,0
401402575,UC Riverside Highlanders,D. Gnago,4281723,,False,10.0,1,3,1,3,0,0,0,0,1,1,2,0,1,0,0,2,2
401402575,UC Riverside Highlanders,J. Webster,4704350,,False,28.0,2,3,0,0,2,3,0,0,0,4,4,0,0,1,3,2,6
401402575,UC Riverside Highlanders,R. Walters,4433366,,False,14.0,0,2,0,2,0,0,0,0,0,1,1,0,3,0,1,2,0
401402575,UC Riverside Highlanders,TEAM,TOTAL,TOTAL,False,,15,52,11,43,4,9,12,13,9,24,33,6,8,4,15,14,46
401402574,Hawai'i Rainbow Wahine,K. Spiller,4282329,,True,7.0,1,2,0,1,1,1,0,0,1,1,2,0,1,1,2,2,3
401402574,Hawai'i Rainbow Wahine,A. Atwell,4068885,,True,36.0,1,7,1,4,0,3,2,2,0,6,6,1,2,0,2,0,4
401402574,Hawai'i Rainbow Wahine,O. Davies,4595197,,True,34.0,2,7,2,6,0,1,7,10,0,4,4,3,0,0,0,2,11
401402574,Hawai'i Rainbow Wahine,K. Imai,4704370,,True,11.0,1,2,1,2,0,0,0,0,0,1,1,2,0,0,0,1,2
401402574,Hawai'i Rainbow Wahine,D. Phillips,4704369,,True,26.0,4,10,3,7,1,3,0,0,3,2,5,1,1,0,4,2,9
401402574,Hawai'i Rainbow Wahine,J. David,4899662,,False,23.0,2,7,2,4,0,3,2,2,3,4,7,0,0,0,1,3,6
401402574,Hawai'i Rainbow Wahine,N. Orji,4704372,,False,10.0,0,2,0,2,0,0,0,0,0,1,1,0,1,0,1,2,0
401402574,Hawai'i Rainbow Wahine,M. McBee,4704375,,False,21.0,2,6,0,1,2,5,0,0,1,0,1,0,0,0,0,3,6
401402574,Hawai'i Rainbow Wahine,N. Calhoun,4595198,,False,14.0,3,5,2,4,1,1,0,1,0,0,0,0,2,0,2,2,7
401402574,Hawai'i Rainbow Wahine,A. Thoms,4399949,,False,18.0,0,2,0,0,0,2,0,2,0,2,2,0,2,0,2,0,0
401402574,Hawai'i Rainbow Wahine,TEAM,TOTAL,TOTAL,False,,16,50,11,31,5,19,11,17,10,25,35,7,9,1,14,17,48
401402574,Cal State Bakersfield Roadrunners,H. van Schaik,4899644,,True,7.0,0,1,0,1,0,0,0,0,0,2,2,0,0,0,1,1,0
401402574,Cal State Bakersfield Roadrunners,J. Eggleston,4282084,,True,40.0,7,18,5,12,2,6,2,3,2,5,7,3,3,0,2,2,18
401402574,Cal State Bakersfield Roadrunners,S. Johnson,4899642,,True,2.0,0,1,0,0,0,1,0,0,0,0,0,0,1,0,2,0,0
401402574,Cal State Bakersfield Roadrunners,S. Bridges-Bey,4704359,,True,2.0,0,0,0,0,0,0,0,0,0,0,0,0,0,0,0,0,0
401402574,Cal State Bakersfield Roadrunners,J. Dixon,4282302,,True,11.0,0,0,0,0,0,0,0,0,0,1,1,1,0,0,1,0,0
401402574,Cal State Bakersfield Roadrunners,V. Austin,4282306,,False,33.0,3,7,3,7,0,0,4,4,3,6,9,0,1,2,3,3,10
401402574,Cal State Bakersfield Roadrunners,S. Herrera,4704358,,False,0.0,0,0,0,0,0,0,0,0,0,0,0,0,0,0,0,1,0
401402574,Cal State Bakersfield Roadrunners,M. Saxon,4400107,,False,29.0,2,6,2,3,0,3,2,2,0,6,6,0,2,0,1,5,6
401402574,Cal State Bakersfield Roadrunners,A. Easley,3911834,,False,33.0,2,11,0,1,2,10,0,0,1,3,4,1,2,0,2,2,6
401402574,Cal State Bakersfield Roadrunners,T. Clayburne,4899643,,False,27.0,0,3,0,1,0,2,5,6,1,3,4,3,1,0,1,2,5
401402574,Cal State Bakersfield Roadrunners,L. Green,4595878,,False,16.0,1,3,1,2,0,1,0,0,0,2,2,0,1,0,1,1,2
401402574,Cal State Bakersfield Roadrunners,TEAM,TOTAL,TOTAL,False,,15,50,11,27,4,23,13,15,9,28,37,8,11,2,14,17,47
401402573,Cal State Fullerton Titans,K. Neff,4595189,,True,25.0,2,4,1,1,1,3,0,2,0,4,4,1,2,3,0,2,5
401402573,Cal State Fullerton Titans,C. Gill,4281455,,True,32.0,6,12,6,8,0,4,4,4,1,3,4,2,2,1,4,1,16
401402573,Cal State Fullerton Titans,A. Lewis,4704361,,True,23.0,3,8,3,8,0,0,3,4,4,5,9,0,0,0,0,2,9
401402573,Cal State Fullerton Titans,L. Wahinekapu,4902813,,True,22.0,2,5,2,4,0,1,6,6,0,2,2,2,1,0,3,3,10
401402573,Cal State Fullerton Titans,G. Vidmar,4704360,,True,30.0,4,7,1,1,3,6,3,4,0,3,3,3,1,0,0,0,14
401402573,Cal State Fullerton Titans,A. Hernandez,4902816,,False,15.0,3,6,3,6,0,0,2,2,0,2,2,1,1,1,2,2,8
401402573,Cal State Fullerton Titans,R. MacDonald,4902815,,False,17.0,1,2,1,1,0,1,0,0,1,0,1,1,1,1,0,1,2
401402573,Cal State Fullerton Titans,B. Furch,4902817,,False,20.0,1,2,0,0,1,2,1,2,0,2,2,3,0,0,2,1,4
401402573,Cal State Fullerton Titans,U. Jovanovic,4902811,,False,16.0,1,1,1,1,0,0,0,0,0,1,1,1,1,0,1,0,2
401402573,Cal State Fullerton Titans,TEAM,TOTAL,TOTAL,False,,23,47,18,30,5,17,19,24,8,24,32,14,9,6,13,12,70
401402573,Cal Poly Mustangs,J. Nielacna,4400510,,True,30.0,8,16,6,11,2,5,1,2,2,3,5,0,1,0,3,4,19
401402573,Cal Poly Mustangs,S. Bourland,4899654,,True,17.0,0,1,0,1,0,0,0,0,1,1,2,0,1,0,1,3,0
401402573,Cal Poly Mustangs,J. Anousinh,4899653,,True,11.0,0,4,0,4,0,0,0,0,0,0,0,2,0,0,2,2,0
401402573,Cal Poly Mustangs,M. Willett,4400024,,True,40.0,5,8,2,3,3,5,0,0,0,1,1,4,1,0,1,3,13
401402573,Cal Poly Mustangs,M. Vick,4400018,,True,39.0,5,12,5,10,0,2,4,5,0,1,1,6,2,0,2,1,14
401402573,Cal Poly Mustangs,Z. Stachowski,4704343,,False,4.0,0,1,0,1,0,0,0,0,0,2,2,0,1,0,0,2,0
401402573,Cal Poly Mustangs,H. Scanlan,4281948,,False,21.0,3,3,3,3,0,0,2,4,4,3,7,0,0,0,0,2,8
401402573,Cal Poly Mustangs,J. Dickson,4704339,,False,21.0,2,7,0,1,2,6,2,2,0,3,3,0,0,0,3,4,8
401402573,Cal Poly Mustangs,S. Dumitrescu,4433701,,False,12.0,0,1,0,1,0,0,2,2,0,2,2,1,0,0,0,0,2
401402573,Cal Poly Mustangs,A. Shah,4899652,,False,5.0,0,3,0,0,0,3,0,0,0,0,0,1,0,0,0,0,0
401402573,Cal Poly Mustangs,TEAM,TOTAL,TOTAL,False,,23,56,16,35,7,21,11,15,11,18,29,14,6,0,12,21,64
401402572,Cal State Northridge Matadors,K. Spriggs,4899651,,True,21.0,1,3,1,3,0,0,1,2,3,5,8,1,1,0,4,5,3
401402572,Cal State Northridge Matadors,T. Amundsen,4281747,,True,43.0,9,16,5,8,4,8,2,2,2,5,7,0,0,1,0,1,24
401402572,Cal State Northridge Matadors,A. Tu'ua,4704366,,True,34.0,3,8,2,6,1,2,0,0,1,2,3,4,0,0,0,2,7
401402572,Cal State Northridge Matadors,J. Jackson,4400035,,True,42.0,7,17,4,12,3,5,2,2,0,2,2,2,0,0,6,2,19
401402572,Cal State Northridge Matadors,M. Henderson,4281463,,True,30.0,1,6,1,3,0,3,0,0,2,2,4,3,1,0,1,3,2
401402572,Cal State Northridge Matadors,M. Duchemin,4899647,,False,18.0,2,8,2,8,0,0,0,0,2,2,4,0,0,1,0,0,4
401402572,Cal State Northridge Matadors,O. Smith,4595193,,False,12.0,0,2,0,2,0,0,0,0,1,1,2,0,0,1,1,2,0
401402572,Cal State Northridge Matadors,A. Hawkins,4899650,,False,5.0,0,0,0,0,0,0,0,0,1,0,1,2,0,0,1,2,0
401402572,Cal State Northridge Matadors,M. Smith,4899649,,False,15.0,1,4,0,3,1,1,0,0,0,2,2,2,1,0,0,1,3
401402572,Cal State Northridge Matadors,R. Harvey,4704364,,False,5.0,0,0,0,0,0,0,0,0,0,1,1,0,0,0,0,0,0
401402572,Cal State Northridge Matadors,TEAM,TOTAL,TOTAL,False,,24,64,15,45,9,19,5,6,13,27,40,14,3,3,13,18,62
401402572,Cal State Bakersfield Roadrunners,H. van Schaik,4899644,,True,11.0,0,6,0,6,0,0,0,0,1,1,2,0,1,1,2,2,0
401402572,Cal State Bakersfield Roadrunners,J. Eggleston,4282084,,True,45.0,10,19,7,14,3,5,6,6,2,4,6,1,0,0,3,0,29
401402572,Cal State Bakersfield Roadrunners,S. Johnson,4899642,,True,4.0,0,0,0,0,0,0,0,0,0,0,0,0,0,0,0,1,0
401402572,Cal State Bakersfield Roadrunners,S. Bridges-Bey,4704359,,True,3.0,0,1,0,1,0,0,0,0,0,0,0,0,0,0,0,0,0
401402572,Cal State Bakersfield Roadrunners,J. Dixon,4282302,,True,9.0,0,1,0,0,0,1,0,0,0,2,2,0,0,0,1,0,0
401402572,Cal State Bakersfield Roadrunners,V. Austin,4282306,,False,26.0,6,12,6,12,0,0,4,5,3,8,11,1,0,0,3,3,16
401402572,Cal State Bakersfield Roadrunners,S. Herrera,4704358,,False,8.0,0,1,0,1,0,0,0,0,1,2,3,1,0,1,0,0,0
401402572,Cal State Bakersfield Roadrunners,M. Saxon,4400107,,False,35.0,3,8,1,3,2,5,0,0,0,4,4,1,1,0,4,5,8
401402572,Cal State Bakersfield Roadrunners,A. Easley,3911834,,False,38.0,2,9,1,3,1,6,0,0,3,1,4,5,1,0,1,0,5
401402572,Cal State Bakersfield Roadrunners,T. Clayburne,4899643,,False,25.0,1,2,0,0,1,2,0,0,1,2,3,0,0,2,0,2,3
401402572,Cal State Bakersfield Roadrunners,L. Green,4595878,,False,21.0,1,6,1,3,0,3,0,0,1,1,2,3,1,0,1,0,2
401402572,Cal State Bakersfield Roadrunners,TEAM,TOTAL,TOTAL,False,,23,65,16,43,7,22,10,11,16,27,43,12,4,4,15,13,63
401402571,Iowa Hawkeyes,M. Czinano,4398909,,True,32.0,13,18,13,18,0,0,4,6,3,7,10,2,0,1,0,3,30
401402571,Iowa Hawkeyes,M. Warnock,4433652,,True,36.0,3,5,3,3,0,2,2,2,0,6,6,5,2,0,2,3,8
401402571,Iowa Hawkeyes,C. Clark,4433403,,True,39.0,6,17,5,10,1,7,5,5,0,7,7,2,0,1,5,4,18
401402571,Iowa Hawkeyes,G. Marshall,4433113,,True,38.0,0,2,0,1,0,1,0,0,0,1,1,2,2,1,0,0,0
401402571,Iowa Hawkeyes,K. Martin,4398907,,True,34.0,6,13,5,9,1,4,1,2,0,4,4,8,0,2,2,1,14
401402571,Iowa Hawkeyes,A. O'Grady,4433538,,False,8.0,1,3,1,3,0,0,0,0,1,1,2,1,0,1,1,1,2
401402571,Iowa Hawkeyes,K. Feuerbach,4433985,,False,3.0,0,0,0,0,0,0,0,0,0,0,0,0,0,0,0,0,0
401402571,Iowa Hawkeyes,T. Taiwo,4398906,,False,10.0,0,0,0,0,0,0,2,2,0,1,1,1,1,0,0,0,2
401402571,Iowa Hawkeyes,TEAM,TOTAL,TOTAL,False,,29,58,27,44,2,14,14,17,6,28,34,21,5,6,11,12,74
401402571,Indiana Hoosiers,M. Holmes,4433643,,True,29.0,3,4,2,3,1,1,4,5,3,4,7,1,1,2,1,4,11
401402571,Indiana Hoosiers,A. Gulbe,4398898,,True,34.0,3,10,2,8,1,2,4,4,3,3,6,0,0,0,1,2,11
401402571,Indiana Hoosiers,G. Berger,4398899,,True,37.0,10,21,10,19,0,2,0,0,1,6,7,4,1,1,3,5,20
401402571,Indiana Hoosiers,N. Cardaño-Hillary,4281477,,True,39.0,7,20,5,12,2,8,3,4,3,4,7,3,4,2,2,1,19
401402571,Indiana Hoosiers,A. Patberg,3904578,,True,37.0,3,12,3,7,0,5,0,0,1,3,4,5,0,0,1,0,6
401402571,Indiana Hoosiers,M. Zaric,4898388,,False,0.0,0,0,0,0,0,0,0,0,0,0,0,0,0,0,0,0,0
401402571,Indiana Hoosiers,K. Browne,4703715,,False,2.0,0,0,0,0,0,0,0,0,0,0,0,0,0,0,0,0,0
401402571,Indiana Hoosiers,A. Wisne,4433691,,False,3.0,0,0,0,0,0,0,0,0,1,0,1,0,0,0,1,1,0
401402571,Indiana Hoosiers,C. Moore-McNeil,4703714,,False,19.0,0,2,0,1,0,1,0,0,0,2,2,1,0,0,1,2,0
401402571,Indiana Hoosiers,K. Peterson,4683312,,False,0.0,0,0,0,0,0,0,0,0,0,0,0,0,0,0,0,0,0
401402571,Indiana Hoosiers,G. Waggoner,4594771,,False,0.0,0,0,0,0,0,0,0,0,0,0,0,0,0,0,0,1,0
401402571,Indiana Hoosiers,TEAM,TOTAL,TOTAL,False,,26,69,22,50,4,19,11,13,14,22,36,14,6,5,10,16,67
401402570,Nebraska Cornhuskers,I. Bourne,4594941,,True,34.0,6,12,6,9,0,3,4,5,1,1,2,1,0,0,1,3,16
401402570,Nebraska Cornhuskers,A. Markowski,4899057,,True,26.0,2,9,2,7,0,2,3,4,2,7,9,1,3,1,1,3,7
401402570,Nebraska Cornhuskers,A. Weidner,4683053,,True,28.0,3,8,3,5,0,3,0,0,2,1,3,1,1,0,0,2,6
401402570,Nebraska Cornhuskers,J. Shelley,4433363,,True,38.0,5,15,2,6,3,9,2,3,1,1,2,5,2,0,4,0,15
401402570,Nebraska Cornhuskers,S. Haiby,4398929,,True,33.0,7,18,7,14,0,4,1,1,2,6,8,3,1,0,2,2,15
401402570,Nebraska Cornhuskers,A. Stewart,4601003,,False,6.0,0,1,0,0,0,1,0,0,0,0,0,0,0,0,0,1,0
401402570,Nebraska Cornhuskers,B. Cravens,4399897,,False,14.0,1,3,1,3,0,0,0,0,0,4,4,0,0,1,1,4,2
401402570,Nebraska Cornhuskers,K. Moriarty,4899055,,False,3.0,0,1,0,0,0,1,0,0,0,0,0,0,1,0,0,0,0
401402570,Nebraska Cornhuskers,R. Porter,4703719,,False,2.0,0,1,0,1,0,0,0,0,0,1,1,1,1,0,0,0,0
401402570,Nebraska Cornhuskers,W. Brown,4597331,,False,3.0,0,0,0,0,0,0,0,0,0,0,0,0,0,0,0,1,0
401402570,Nebraska Cornhuskers,M. Cayton,4066525,,False,13.0,2,6,2,3,0,3,1,2,1,1,2,1,1,0,0,2,5
401402570,Nebraska Cornhuskers,TEAM,TOTAL,TOTAL,False,,26,74,23,48,3,26,11,15,13,24,37,13,10,2,9,18,66
401402570,Iowa Hawkeyes,M. Czinano,4398909,,True,27.0,9,11,9,11,0,0,4,4,1,1,2,1,0,0,1,3,22
401402570,Iowa Hawkeyes,M. Warnock,4433652,,True,21.0,1,3,1,1,0,2,0,0,1,2,3,6,2,0,1,3,2
401402570,Iowa Hawkeyes,C. Clark,4433403,,True,40.0,13,27,8,14,5,13,10,12,1,8,9,3,2,1,9,1,41
401402570,Iowa Hawkeyes,G. Marshall,4433113,,True,34.0,0,3,0,2,0,1,1,2,0,2,2,3,1,0,1,1,1
401402570,Iowa Hawkeyes,K. Martin,4398907,,True,35.0,4,7,4,5,0,2,0,0,1,10,11,5,1,2,1,4,8
401402570,Iowa Hawkeyes,A. Ediger,4585713,,False,1.0,1,1,1,1,0,0,0,0,0,0,0,0,0,0,0,0,2
401402570,Iowa Hawkeyes,A. O'Grady,4433538,,False,12.0,1,4,1,4,0,0,0,2,1,2,3,0,0,4,0,1,2
401402570,Iowa Hawkeyes,L. Cook,4398908,,False,1.0,0,0,0,0,0,0,0,0,0,0,0,0,0,0,0,0,0
401402570,Iowa Hawkeyes,S. Affolter,4898389,,False,1.0,0,1,0,1,0,0,0,0,0,1,1,0,0,0,0,0,0
401402570,Iowa Hawkeyes,K. Feuerbach,4433985,,False,11.0,1,1,1,1,0,0,0,0,0,1,1,1,0,1,0,2,2
401402570,Iowa Hawkeyes,T. Taiwo,4398906,,False,17.0,1,2,0,0,1,2,0,0,1,3,4,0,0,1,0,1,3
401402570,Iowa Hawkeyes,TEAM,TOTAL,TOTAL,False,,31,60,25,40,6,20,15,20,7,36,43,19,6,9,13,16,83
401402569,Ohio State Buckeyes,R. Mikulasikova,4594942,,True,24.0,3,7,3,4,0,3,0,0,0,4,4,3,1,0,3,4,6
401402569,Ohio State Buckeyes,R. Harris,4433636,,True,23.0,2,3,2,2,0,1,0,0,0,6,6,2,2,1,0,0,4
401402569,Ohio State Buckeyes,J. Sheldon,4432865,,True,40.0,10,19,10,14,0,5,2,2,1,3,4,4,0,1,1,2,22
401402569,Ohio State Buckeyes,T. Mikesell,4398912,,True,40.0,5,16,3,9,2,7,0,0,1,3,4,1,0,0,1,1,12
401402569,Ohio State Buckeyes,B. Miller,4281317,,True,34.0,4,8,2,4,2,4,2,2,1,2,3,1,2,1,1,2,12
401402569,Ohio State Buckeyes,T. Beacham,4068997,,False,15.0,1,5,1,5,0,0,0,0,1,2,3,0,0,1,1,5,2
401402569,Ohio State Buckeyes,T. Thierry,4898400,,False,7.0,0,0,0,0,0,0,0,0,0,0,0,0,1,1,0,2,0
401402569,Ohio State Buckeyes,K. Poole,4433418,,False,17.0,2,6,2,5,0,1,0,0,1,5,6,3,1,0,2,4,4
401402569,Ohio State Buckeyes,TEAM,TOTAL,TOTAL,False,,27,64,23,43,4,21,4,4,5,25,30,14,7,5,10,20,62
401402569,Indiana Hoosiers,M. Holmes,4433643,,True,28.0,5,10,5,10,0,0,2,2,0,3,3,2,0,1,0,0,12
401402569,Indiana Hoosiers,C. Moore-McNeil,4703714,,True,38.0,3,5,2,4,1,1,4,6,0,3,3,2,0,0,4,3,11
401402569,Indiana Hoosiers,G. Berger,4398899,,True,39.0,3,10,3,10,0,0,4,6,0,6,6,7,0,0,2,2,10
401402569,Indiana Hoosiers,N. Cardaño-Hillary,4281477,,True,37.0,5,12,4,10,1,2,5,7,3,8,11,5,1,0,2,2,16
401402569,Indiana Hoosiers,A. Patberg,3904578,,True,38.0,6,12,3,5,3,7,0,0,1,2,3,3,1,1,2,1,15
401402569,Indiana Hoosiers,A. Gulbe,4398898,,False,14.0,2,4,2,4,0,0,2,2,0,0,0,1,0,0,0,0,6
401402569,Indiana Hoosiers,A. Wisne,4433691,,False,5.0,0,0,0,0,0,0,0,0,0,2,2,0,0,1,0,0,0
401402569,Indiana Hoosiers,G. Waggoner,4594771,,False,1.0,0,0,0,0,0,0,0,0,0,1,1,0,0,0,0,1,0
401402569,Indiana Hoosiers,TEAM,TOTAL,TOTAL,False,,24,53,19,43,5,10,17,23,7,30,37,20,2,3,11,9,70
401402568,Nebraska Cornhuskers,I. Bourne,4594941,,True,18.0,2,2,1,1,1,1,0,0,1,0,1,0,0,0,1,4,5
401402568,Nebraska Cornhuskers,A. Markowski,4899057,,True,30.0,0,3,0,3,0,0,4,4,1,8,9,2,3,0,4,4,4
401402568,Nebraska Cornhuskers,A. Weidner,4683053,,True,34.0,6,14,4,9,2,5,2,2,0,3,3,3,2,0,2,2,16
401402568,Nebraska Cornhuskers,J. Shelley,4433363,,True,37.0,3,7,1,2,2,5,4,4,0,2,2,4,2,0,3,3,12
401402568,Nebraska Cornhuskers,S. Haiby,4398929,,True,34.0,6,13,6,11,0,2,4,5,0,4,4,4,1,0,4,2,16
401402568,Nebraska Cornhuskers,A. Stewart,4601003,,False,10.0,5,6,3,3,2,3,0,0,0,3,3,0,1,0,0,2,12
401402568,Nebraska Cornhuskers,B. Cravens,4399897,,False,22.0,2,3,2,3,0,0,2,3,2,0,2,2,1,1,1,2,6
401402568,Nebraska Cornhuskers,K. Moriarty,4899055,,False,3.0,0,0,0,0,0,0,0,0,0,0,0,0,0,0,0,0,0
401402568,Nebraska Cornhuskers,W. Brown,4597331,,False,1.0,0,0,0,0,0,0,0,0,0,0,0,0,0,0,0,0,0
401402568,Nebraska Cornhuskers,M. Cayton,4066525,,False,11.0,1,1,0,0,1,1,2,4,0,1,1,1,0,0,1,1,5
401402568,Nebraska Cornhuskers,TEAM,TOTAL,TOTAL,False,,25,49,17,32,8,17,18,22,4,23,27,16,10,1,17,20,76
401402568,Michigan Wolverines,E. Kiser,4398919,,True,32.0,4,9,3,7,1,2,0,0,2,3,5,2,0,0,0,3,9
401402568,Michigan Wolverines,N. Hillmon,4398915,,True,37.0,5,14,5,14,0,0,8,9,6,6,12,5,2,2,5,3,18
401402568,Michigan Wolverines,M. Nolan,4594938,,True,24.0,2,6,2,2,0,4,1,1,0,4,4,1,0,0,0,3,5
401402568,Michigan Wolverines,L. Phelia,4433541,,True,30.0,6,12,4,8,2,4,5,6,0,1,1,0,2,0,1,1,19
401402568,Michigan Wolverines,D. Rauch,4398918,,True,39.0,1,3,1,2,0,1,0,0,0,4,4,6,2,0,2,3,2
401402568,Michigan Wolverines,C. Williams,4433415,,False,9.0,2,2,2,2,0,0,0,0,0,0,0,0,3,0,0,3,4
401402568,Michigan Wolverines,E. Stuck,4599502,,False,1.0,0,1,0,1,0,0,0,0,0,0,0,0,0,0,0,0,0
401402568,Michigan Wolverines,I. Varejão,4433687,,False,1.0,0,0,0,0,0,0,0,0,0,0,0,0,0,0,0,0,0
401402568,Michigan Wolverines,L. Brown,4398928,,False,26.0,6,14,6,13,0,1,4,4,0,3,3,2,1,0,5,3,16
401402568,Michigan Wolverines,A. Dilk,4398916,,False,1.0,0,0,0,0,0,0,0,0,0,0,0,0,0,0,0,0,0
401402568,Michigan Wolverines,TEAM,TOTAL,TOTAL,False,,26,61,23,49,3,12,18,20,10,22,32,16,10,2,13,19,73
401402567,Northwestern Wildcats,C. Shaw,4398936,,True,33.0,1,4,1,4,0,0,1,2,7,5,12,1,1,3,1,4,3
401402567,Northwestern Wildcats,J. Brown,4683032,,True,36.0,2,10,0,5,2,5,0,0,1,2,3,1,0,0,2,2,6
401402567,Northwestern Wildcats,L. Hartman,4433082,,True,35.0,3,10,2,5,1,5,0,0,1,0,1,1,0,0,1,0,7
401402567,Northwestern Wildcats,V. Burton,4398935,,True,39.0,9,24,7,19,2,5,5,7,7,4,11,4,3,2,1,3,25
401402567,Northwestern Wildcats,L. Satterwhite,4281236,,True,29.0,4,14,1,5,3,9,1,2,0,2,2,2,0,0,1,3,12
401402567,Northwestern Wildcats,M. Ademusayo,4899058,,False,1.0,0,0,0,0,0,0,0,0,0,0,0,0,0,0,0,0,0
401402567,Northwestern Wildcats,C. Walsh,4691693,,False,6.0,0,4,0,2,0,2,0,0,0,3,3,0,0,0,1,1,0
401402567,Northwestern Wildcats,P. Mott,4594900,,False,6.0,1,2,1,2,0,0,0,0,0,0,0,1,1,1,0,0,2
401402567,Northwestern Wildcats,M. Daley,4899059,,False,14.0,1,6,1,5,0,1,2,2,0,0,0,0,0,0,1,0,4
401402567,Northwestern Wildcats,K. Rainey,4433362,,False,1.0,0,0,0,0,0,0,0,0,0,0,0,0,0,0,0,0,0
401402567,Northwestern Wildcats,TEAM,TOTAL,TOTAL,False,,21,74,13,47,8,27,9,13,22,18,40,10,5,6,8,13,59
401402567,Iowa Hawkeyes,M. Czinano,4398909,,True,30.0,9,12,9,12,0,0,3,4,2,6,8,0,0,0,0,0,21
401402567,Iowa Hawkeyes,M. Warnock,4433652,,True,37.0,1,8,1,6,0,2,0,0,0,5,5,6,1,0,2,2,2
401402567,Iowa Hawkeyes,C. Clark,4433403,,True,38.0,7,16,2,8,5,8,0,0,1,11,12,6,0,3,7,2,19
401402567,Iowa Hawkeyes,G. Marshall,4433113,,True,36.0,2,6,1,1,1,5,0,0,0,1,1,2,4,1,0,2,5
401402567,Iowa Hawkeyes,K. Martin,4398907,,True,31.0,5,7,5,7,0,0,5,5,2,3,5,6,2,1,0,1,15
401402567,Iowa Hawkeyes,A. O'Grady,4433538,,False,10.0,3,6,3,6,0,0,0,0,2,2,4,0,0,2,1,1,6
401402567,Iowa Hawkeyes,S. Affolter,4898389,,False,1.0,0,0,0,0,0,0,1,2,0,0,0,0,0,0,0,0,1
401402567,Iowa Hawkeyes,K. Feuerbach,4433985,,False,5.0,0,1,0,0,0,1,0,0,0,1,1,0,0,0,1,3,0
401402567,Iowa Hawkeyes,T. Taiwo,4398906,,False,12.0,1,2,0,1,1,1,0,0,0,2,2,0,0,0,1,1,3
401402567,Iowa Hawkeyes,TEAM,TOTAL,TOTAL,False,,28,58,21,41,7,17,9,11,12,32,44,20,7,7,13,12,72
401402566,Ohio State Buckeyes,R. Mikulasikova,4594942,,True,16.0,2,6,2,5,0,1,0,0,1,4,5,1,0,0,0,1,4
401402566,Ohio State Buckeyes,R. Harris,4433636,,True,31.0,5,13,2,5,3,8,1,1,4,3,7,5,2,0,0,1,14
401402566,Ohio State Buckeyes,J. Sheldon,4432865,,True,37.0,5,13,5,11,0,2,9,9,0,2,2,4,1,2,7,3,19
401402566,Ohio State Buckeyes,T. Mikesell,4398912,,True,40.0,7,15,3,7,4,8,0,0,1,5,6,3,3,1,0,1,18
401402566,Ohio State Buckeyes,B. Miller,4281317,,True,31.0,1,9,0,5,1,4,1,4,0,0,0,5,4,0,1,0,4
401402566,Ohio State Buckeyes,T. Beacham,4068997,,False,24.0,5,6,5,6,0,0,5,6,2,6,8,1,0,1,3,3,15
401402566,Ohio State Buckeyes,T. Thierry,4898400,,False,16.0,0,0,0,0,0,0,0,0,1,4,5,0,0,0,0,4,0
401402566,Ohio State Buckeyes,K. Poole,4433418,,False,5.0,0,0,0,0,0,0,0,0,0,0,0,0,0,0,0,1,0
401402566,Ohio State Buckeyes,TEAM,TOTAL,TOTAL,False,,25,62,17,39,8,23,16,20,10,28,38,19,10,4,11,14,74
401402566,Michigan State Spartans,A. Smith,4281232,,True,25.0,4,10,4,10,0,0,0,0,2,5,7,0,1,0,2,4,8
401402566,Michigan State Spartans,T. Farquhar,4281280,,True,35.0,3,6,3,6,0,0,0,0,0,6,6,2,1,0,4,2,6
401402566,Michigan State Spartans,M. Ekh,4899050,,True,37.0,7,13,2,2,5,11,2,2,0,7,7,1,0,1,2,2,21
401402566,Michigan State Spartans,D. Hagemann,4433804,,True,29.0,3,8,1,3,2,5,1,4,0,1,1,2,1,0,1,3,9
401402566,Michigan State Spartans,N. Clouden,4398921,,True,39.0,3,11,3,11,0,0,1,2,1,5,6,8,1,1,3,2,7
401402566,Michigan State Spartans,I. Alexander,4899051,,False,3.0,1,1,1,1,0,0,0,2,1,0,1,0,0,0,0,1,2
401402566,Michigan State Spartans,T. Parks,4433335,,False,22.0,2,7,2,7,0,0,1,2,3,5,8,1,1,0,1,1,5
401402566,Michigan State Spartans,J. James,4433670,,False,10.0,0,2,0,2,0,0,0,0,0,0,0,2,0,0,1,2,0
401402566,Michigan State Spartans,TEAM,TOTAL,TOTAL,False,,23,58,16,42,7,16,5,12,8,29,37,16,5,2,17,17,58
401402565,Maryland Terrapins,A. Reese,4433402,,True,28.0,5,11,5,10,0,1,4,5,5,8,13,3,4,0,4,5,14
401402565,Maryland Terrapins,C. Bibby,4280877,,True,33.0,2,11,2,7,0,4,0,0,1,4,5,0,1,0,0,2,4
401402565,Maryland Terrapins,S. Sellers,4433808,,True,24.0,2,9,2,6,0,3,0,0,1,3,4,0,1,0,1,2,4
401402565,Maryland Terrapins,D. Miller,4433635,,True,35.0,2,11,2,10,0,1,0,0,1,0,1,0,0,2,2,3,4
401402565,Maryland Terrapins,K. Benzan,4068580,,True,38.0,0,5,0,3,0,2,0,0,2,2,4,5,1,0,2,4,0
401402565,Maryland Terrapins,M. Collins,4398763,,False,15.0,2,6,2,6,0,0,0,0,2,3,5,0,0,0,1,3,4
401402565,Maryland Terrapins,A. Owusu,4433632,,False,27.0,9,17,9,16,0,1,3,4,2,2,4,1,0,0,4,3,21
401402565,Maryland Terrapins,TEAM,TOTAL,TOTAL,False,,22,70,22,58,0,12,7,9,15,24,39,9,7,2,14,22,51
401402565,Indiana Hoosiers,M. Holmes,4433643,,True,30.0,7,10,7,10,0,0,3,3,2,3,5,0,0,1,1,1,17
401402565,Indiana Hoosiers,A. Gulbe,4398898,,True,40.0,2,6,2,5,0,1,3,4,3,8,11,3,0,3,6,2,7
401402565,Indiana Hoosiers,G. Berger,4398899,,True,35.0,5,14,5,14,0,0,6,8,1,10,11,4,0,0,4,1,16
401402565,Indiana Hoosiers,N. Cardaño-Hillary,4281477,,True,35.0,4,13,3,11,1,2,0,0,2,6,8,3,4,0,2,2,9
401402565,Indiana Hoosiers,A. Patberg,3904578,,True,33.0,1,7,1,4,0,3,4,5,0,2,2,4,1,0,4,1,6
401402565,Indiana Hoosiers,K. Browne,4703715,,False,0.0,0,0,0,0,0,0,0,0,0,0,0,0,0,0,0,1,0
401402565,Indiana Hoosiers,A. Wisne,4433691,,False,4.0,0,0,0,0,0,0,0,0,0,0,0,0,0,0,0,1,0
401402565,Indiana Hoosiers,C. Moore-McNeil,4703714,,False,22.0,3,5,2,4,1,1,0,0,0,0,0,0,2,0,0,2,7
401402565,Indiana Hoosiers,K. Peterson,4683312,,False,0.0,0,0,0,0,0,0,0,0,0,0,0,0,0,0,0,0,0
401402565,Indiana Hoosiers,G. Waggoner,4594771,,False,1.0,0,0,0,0,0,0,0,0,0,0,0,0,0,0,0,1,0
401402565,Indiana Hoosiers,TEAM,TOTAL,TOTAL,False,,22,55,20,48,2,7,16,20,10,32,42,14,7,4,18,12,62
401402564,Nebraska Cornhuskers,I. Bourne,4594941,,True,26.0,6,10,4,7,2,3,1,2,1,3,4,4,0,0,0,2,15
401402564,Nebraska Cornhuskers,A. Markowski,4899057,,True,26.0,7,17,4,11,3,6,5,7,5,4,9,1,1,3,1,1,22
401402564,Nebraska Cornhuskers,A. Weidner,4683053,,True,24.0,3,7,3,5,0,2,0,0,1,3,4,3,0,0,2,1,6
401402564,Nebraska Cornhuskers,J. Shelley,4433363,,True,29.0,11,16,2,3,9,13,1,1,1,4,5,7,2,0,2,1,32
401402564,Nebraska Cornhuskers,S. Haiby,4398929,,True,24.0,3,7,2,4,1,3,3,4,1,2,3,6,0,0,0,3,10
401402564,Nebraska Cornhuskers,K. Coley,4713398,,False,5.0,0,0,0,0,0,0,0,0,1,0,1,0,0,0,0,0,0
401402564,Nebraska Cornhuskers,A. Stewart,4601003,,False,5.0,1,4,1,2,0,2,0,0,0,1,1,0,0,0,0,1,2
401402564,Nebraska Cornhuskers,B. Cravens,4399897,,False,18.0,2,3,2,2,0,1,1,1,2,5,7,0,0,0,2,1,5
401402564,Nebraska Cornhuskers,K. Moriarty,4899055,,False,12.0,0,1,0,1,0,0,0,0,0,0,0,1,0,1,0,1,0
401402564,Nebraska Cornhuskers,R. Porter,4703719,,False,6.0,0,1,0,1,0,0,0,0,0,0,0,1,0,0,1,1,0
401402564,Nebraska Cornhuskers,W. Brown,4597331,,False,9.0,0,1,0,0,0,1,0,0,1,0,1,0,0,0,1,1,0
401402564,Nebraska Cornhuskers,M. Cayton,4066525,,False,16.0,0,2,0,1,0,1,0,0,0,4,4,1,0,0,0,1,0
401402564,Nebraska Cornhuskers,TEAM,TOTAL,TOTAL,False,,33,69,18,37,15,32,11,15,16,27,43,24,3,4,10,14,92
401402564,Illinois Fighting Illini,E. Porter,4703565,,True,17.0,2,7,2,7,0,0,3,4,2,1,3,0,0,1,1,4,7
401402564,Illinois Fighting Illini,K. Bostic,4433746,,True,27.0,3,6,3,5,0,1,0,0,3,3,6,2,1,2,1,1,6
401402564,Illinois Fighting Illini,A. Mckenzie,4691696,,True,30.0,7,17,7,17,0,0,4,5,2,3,5,0,0,0,2,1,18
401402564,Illinois Fighting Illini,A. Nye,4597509,,True,30.0,6,9,4,4,2,5,0,0,0,2,2,1,0,2,0,1,14
401402564,Illinois Fighting Illini,J. Peebles,4594768,,True,23.0,1,3,1,2,0,1,1,2,0,1,1,1,1,0,0,1,3
401402564,Illinois Fighting Illini,G. Lopes,4703564,,False,8.0,0,0,0,0,0,0,2,2,1,1,2,1,0,1,1,1,2
401402564,Illinois Fighting Illini,S. Amusan,4703563,,False,7.0,1,3,0,1,1,2,1,2,1,1,2,0,0,0,0,0,4
401402564,Illinois Fighting Illini,E. Rubin,4281898,,False,6.0,1,1,1,1,0,0,0,0,0,0,0,0,0,0,1,2,2
401402564,Illinois Fighting Illini,D. Brown,4595263,,False,14.0,1,4,1,3,0,1,0,0,0,2,2,1,0,0,0,0,2
401402564,Illinois Fighting Illini,J. Oden,4433814,,False,21.0,4,6,2,4,2,2,4,4,0,4,4,7,0,0,1,2,14
401402564,Illinois Fighting Illini,S. Anastasieska,3944235,,False,17.0,1,6,1,5,0,1,0,2,0,3,3,3,2,1,0,3,2
401402564,Illinois Fighting Illini,TEAM,TOTAL,TOTAL,False,,27,62,22,49,5,13,15,21,11,21,32,16,4,7,7,16,74
401402562,Northwestern Wildcats,C. Shaw,4398936,,True,31.0,5,6,5,6,0,0,1,1,4,7,11,0,1,0,0,4,11
401402562,Northwestern Wildcats,J. Brown,4683032,,True,37.0,5,10,4,4,1,6,0,2,0,9,9,4,0,1,1,4,11
401402562,Northwestern Wildcats,L. Hartman,4433082,,True,37.0,2,7,0,3,2,4,0,2,0,1,1,1,1,1,2,2,6
401402562,Northwestern Wildcats,V. Burton,4398935,,True,38.0,4,15,4,10,0,5,10,10,2,6,8,8,3,0,0,1,18
401402562,Northwestern Wildcats,L. Satterwhite,4281236,,True,33.0,5,14,5,8,0,6,5,11,5,2,7,1,2,1,2,3,15
401402562,Northwestern Wildcats,C. Walsh,4691693,,False,11.0,2,7,2,5,0,2,0,2,2,1,3,0,0,0,1,0,4
401402562,Northwestern Wildcats,P. Mott,4594900,,False,2.0,0,1,0,1,0,0,0,0,0,0,0,0,0,0,0,0,0
401402562,Northwestern Wildcats,A. Morris,4433743,,False,0.0,0,0,0,0,0,0,0,0,0,0,0,0,0,0,0,0,0
401402562,Northwestern Wildcats,M. Daley,4899059,,False,8.0,0,3,0,3,0,0,0,0,0,0,0,0,2,0,0,0,0
401402562,Northwestern Wildcats,K. Rainey,4433362,,False,3.0,0,0,0,0,0,0,0,0,0,0,0,0,0,0,1,1,0
401402562,Northwestern Wildcats,TEAM,TOTAL,TOTAL,False,,23,63,20,40,3,23,16,28,14,29,43,14,9,3,8,15,65
401402562,Minnesota Golden Gophers,K. Sissoko,4398731,,True,39.0,7,18,7,16,0,2,4,10,3,7,10,2,0,0,2,5,18
401402562,Minnesota Golden Gophers,L. Bagwell-Katalinich,4068594,,True,17.0,3,6,3,6,0,0,0,0,2,0,2,4,0,0,0,2,6
401402562,Minnesota Golden Gophers,S. Scalia,4433394,,True,40.0,7,19,3,9,4,10,0,0,1,6,7,1,0,0,2,3,18
401402562,Minnesota Golden Gophers,D. Winters,4068126,,True,32.0,4,10,2,6,2,4,0,0,1,4,5,1,1,1,2,5,10
401402562,Minnesota Golden Gophers,G. Hubbard,4068036,,True,32.0,2,7,2,4,0,3,2,2,0,3,3,4,0,0,2,3,6
401402562,Minnesota Golden Gophers,A. Micheaux,4899054,,False,2.0,0,0,0,0,0,0,0,0,0,1,1,0,0,0,0,0,0
401402562,Minnesota Golden Gophers,K. Mershon,4398930,,False,3.0,0,0,0,0,0,0,0,0,0,0,0,0,0,0,0,0,0
401402562,Minnesota Golden Gophers,B. Helgren,4281306,,False,19.0,0,0,0,0,0,0,0,0,1,2,3,1,0,1,2,4,0
401402562,Minnesota Golden Gophers,A. Smith,4433742,,False,16.0,1,2,1,1,0,1,0,0,2,5,7,4,0,1,4,1,2
401402562,Minnesota Golden Gophers,TEAM,TOTAL,TOTAL,False,,24,62,18,42,6,20,6,12,10,31,41,17,1,3,14,23,60
401402561,Purdue Boilermakers,R. Woltman,4433302,,True,26.0,3,10,3,10,0,0,1,2,1,0,1,1,1,0,3,3,7
401402561,Purdue Boilermakers,A. Ellis,4595183,,True,35.0,5,10,3,7,2,3,5,6,0,5,5,3,1,0,1,3,17
401402561,Purdue Boilermakers,M. Layden,4433438,,True,40.0,5,11,2,4,3,7,4,4,0,5,5,4,0,1,1,3,17
401402561,Purdue Boilermakers,J. Terry,4433143,,True,34.0,5,8,3,5,2,3,2,2,1,7,8,7,1,1,4,3,14
401402561,Purdue Boilermakers,C. Hardin,4398945,,True,33.0,3,9,0,0,3,9,0,0,0,4,4,2,0,0,4,5,9
401402561,Purdue Boilermakers,A. Learn,4899062,,False,5.0,1,2,1,2,0,0,1,1,1,0,1,0,0,0,1,5,3
401402561,Purdue Boilermakers,J. Smith,4899061,,False,2.0,1,3,1,2,0,1,0,0,0,1,1,0,0,0,0,1,2
401402561,Purdue Boilermakers,B. Moore,4398608,,False,16.0,0,8,0,5,0,3,0,0,1,2,3,1,0,0,1,1,0
401402561,Purdue Boilermakers,R. Doumbia,4398602,,False,9.0,0,2,0,1,0,1,0,0,0,2,2,0,0,0,0,0,0
401402561,Purdue Boilermakers,TEAM,TOTAL,TOTAL,False,,23,63,13,36,10,27,13,15,9,27,36,18,3,2,15,24,69
401402561,Michigan State Spartans,A. Smith,4281232,,True,21.0,7,14,7,14,0,0,1,2,0,4,4,1,0,0,1,4,15
401402561,Michigan State Spartans,T. Farquhar,4281280,,True,26.0,3,7,3,7,0,0,3,3,4,5,9,2,1,1,1,4,9
401402561,Michigan State Spartans,M. Ekh,4899050,,True,40.0,4,9,2,3,2,6,0,0,0,4,4,3,1,0,1,2,10
401402561,Michigan State Spartans,D. Hagemann,4433804,,True,40.0,1,6,0,1,1,5,0,0,0,4,4,7,2,0,4,1,3
401402561,Michigan State Spartans,N. Clouden,4398921,,True,32.0,6,17,5,10,1,7,10,11,0,4,4,4,1,0,3,4,23
401402561,Michigan State Spartans,I. Alexander,4899051,,False,9.0,0,2,0,2,0,0,1,2,0,1,1,1,0,0,1,0,1
401402561,Michigan State Spartans,T. Parks,4433335,,False,23.0,4,5,4,5,0,0,4,8,3,6,9,0,1,1,1,3,12
401402561,Michigan State Spartans,J. James,4433670,,False,9.0,0,1,0,1,0,0,0,0,0,1,1,1,0,0,1,0,0
401402561,Michigan State Spartans,TEAM,TOTAL,TOTAL,False,,25,61,21,43,4,18,19,26,8,30,38,19,6,2,14,19,73
401402560,Rutgers Scarlet Knights,T. Singleton,4398951,,True,20.0,2,4,2,4,0,0,0,0,2,4,6,0,0,0,2,2,4
401402560,Rutgers Scarlet Knights,O. Brown,4282023,,True,38.0,5,12,5,12,0,0,2,6,5,5,10,3,0,1,2,1,12
401402560,Rutgers Scarlet Knights,L. Petree,4399366,,True,29.0,2,10,2,8,0,2,1,1,1,1,2,0,0,0,0,4,5
401402560,Rutgers Scarlet Knights,S. Dickson,4068184,,True,19.0,4,11,4,8,0,3,0,0,1,1,2,0,0,0,2,0,8
401402560,Rutgers Scarlet Knights,J. Mason,4065694,,True,35.0,2,8,1,5,1,3,0,0,0,1,1,0,1,0,1,2,5
401402560,Rutgers Scarlet Knights,C. Cornwell,4433980,,False,8.0,2,2,2,2,0,0,0,0,2,4,6,0,0,0,2,1,4
401402560,Rutgers Scarlet Knights,A. Sidibe,4899063,,False,19.0,1,3,1,3,0,0,2,2,2,0,2,0,2,1,1,1,4
401402560,Rutgers Scarlet Knights,V. Morris,4281804,,False,9.0,0,4,0,4,0,0,0,0,0,3,3,0,0,0,2,2,0
401402560,Rutgers Scarlet Knights,S. Lassiter,4281174,,False,23.0,5,9,4,7,1,2,1,2,1,1,2,0,1,1,3,4,12
401402560,Rutgers Scarlet Knights,TEAM,TOTAL,TOTAL,False,,23,63,21,53,2,10,6,11,15,20,35,3,4,3,16,17,54
401402560,Indiana Hoosiers,M. Holmes,4433643,,True,30.0,4,8,4,8,0,0,3,3,2,3,5,1,0,2,3,3,11
401402560,Indiana Hoosiers,A. Gulbe,4398898,,True,23.0,2,8,2,5,0,3,2,6,1,4,5,0,1,2,4,5,6
401402560,Indiana Hoosiers,G. Berger,4398899,,True,39.0,7,14,7,14,0,0,3,4,1,5,6,6,2,0,1,0,17
401402560,Indiana Hoosiers,N. Cardaño-Hillary,4281477,,True,37.0,2,5,1,1,1,4,4,4,0,2,2,2,5,0,5,3,9
401402560,Indiana Hoosiers,A. Patberg,3904578,,True,35.0,6,10,1,3,5,7,2,2,0,5,5,6,0,0,1,0,19
401402560,Indiana Hoosiers,A. Wisne,4433691,,False,5.0,0,0,0,0,0,0,0,0,0,0,0,0,0,0,0,0,0
401402560,Indiana Hoosiers,C. Moore-McNeil,4703714,,False,28.0,1,2,1,2,0,0,2,2,1,4,5,3,1,0,1,1,4
401402560,Indiana Hoosiers,K. Peterson,4683312,,False,0.0,0,0,0,0,0,0,0,0,0,0,0,0,0,0,0,0,0
401402560,Indiana Hoosiers,G. Waggoner,4594771,,False,3.0,0,1,0,0,0,1,0,0,0,0,0,0,1,0,0,2,0
401402560,Indiana Hoosiers,TEAM,TOTAL,TOTAL,False,,22,48,16,33,6,15,16,21,5,25,30,18,10,4,16,14,66
401402559,Wisconsin Badgers,K. Ellew,4899064,,True,34.0,3,8,2,4,1,4,0,0,0,2,2,1,0,0,0,1,7
401402559,Wisconsin Badgers,J. Pospisilova,4595387,,True,36.0,7,12,4,5,3,7,0,1,1,2,3,1,1,0,1,4,17
401402559,Wisconsin Badgers,H. Douglass,4433979,,True,40.0,7,9,6,7,1,2,0,0,2,6,8,3,1,0,1,1,15
401402559,Wisconsin Badgers,B. Schramek,4433771,,True,36.0,0,15,0,10,0,5,0,0,2,2,4,4,1,2,2,3,0
401402559,Wisconsin Badgers,K. Nelson,4280992,,True,40.0,11,21,9,12,2,9,3,4,1,4,5,8,3,0,4,2,27
401402559,Wisconsin Badgers,T. Stauffacher,4433686,,False,11.0,0,2,0,0,0,2,0,0,0,2,2,0,0,0,0,2,0
401402559,Wisconsin Badgers,N. Leuzinger,4703772,,False,3.0,0,0,0,0,0,0,0,0,0,0,0,0,0,0,0,0,0
401402559,Wisconsin Badgers,TEAM,TOTAL,TOTAL,False,,28,67,21,38,7,29,3,5,9,21,30,17,6,2,8,13,66
401402559,Illinois Fighting Illini,E. Porter,4703565,,True,34.0,7,11,7,11,0,0,1,2,0,3,3,1,2,4,3,3,15
401402559,Illinois Fighting Illini,K. Bostic,4433746,,True,37.0,5,10,5,10,0,0,2,2,5,11,16,6,1,0,2,2,12
401402559,Illinois Fighting Illini,A. Mckenzie,4691696,,True,32.0,5,12,5,12,0,0,4,4,0,5,5,7,0,0,0,2,14
401402559,Illinois Fighting Illini,A. Nye,4597509,,True,32.0,5,9,0,3,5,6,2,2,1,4,5,2,0,0,1,1,17
401402559,Illinois Fighting Illini,J. Peebles,4594768,,True,35.0,4,9,0,4,4,5,0,0,0,1,1,1,0,0,0,1,12
401402559,Illinois Fighting Illini,E. Rubin,4281898,,False,6.0,1,2,1,2,0,0,0,0,0,0,0,0,0,0,2,1,2
401402559,Illinois Fighting Illini,D. Brown,4595263,,False,8.0,0,1,0,1,0,0,0,2,0,1,1,1,0,0,0,1,0
401402559,Illinois Fighting Illini,J. Oden,4433814,,False,13.0,0,3,0,2,0,1,3,4,0,4,4,1,1,0,1,1,3
401402559,Illinois Fighting Illini,S. Anastasieska,3944235,,False,3.0,0,0,0,0,0,0,0,0,0,0,0,0,0,0,2,1,0
401402559,Illinois Fighting Illini,TEAM,TOTAL,TOTAL,False,,27,57,18,45,9,12,12,16,9,32,41,19,4,4,11,13,75
401402558,Rutgers Scarlet Knights,T. Singleton,4398951,,True,21.0,4,10,4,10,0,0,2,4,5,2,7,0,0,0,2,3,10
401402558,Rutgers Scarlet Knights,O. Brown,4282023,,True,31.0,8,11,8,11,0,0,2,3,5,8,13,3,1,0,3,2,18
401402558,Rutgers Scarlet Knights,L. Petree,4399366,,True,20.0,3,5,3,4,0,1,0,0,0,3,3,0,1,0,2,1,6
401402558,Rutgers Scarlet Knights,S. Dickson,4068184,,True,30.0,5,14,4,13,1,1,3,3,3,4,7,9,0,1,6,3,14
401402558,Rutgers Scarlet Knights,J. Mason,4065694,,True,31.0,1,5,0,0,1,5,0,0,0,6,6,3,1,0,0,1,3
401402558,Rutgers Scarlet Knights,C. Cornwell,4433980,,False,4.0,2,3,2,3,0,0,0,1,0,1,1,0,0,0,0,1,4
401402558,Rutgers Scarlet Knights,A. Sidibe,4899063,,False,18.0,0,3,0,3,0,0,0,0,2,4,6,2,1,2,1,2,0
401402558,Rutgers Scarlet Knights,E. Lafayette,4703769,,False,2.0,0,1,0,1,0,0,2,2,0,0,0,0,0,0,0,1,2
401402558,Rutgers Scarlet Knights,K. Sanderlin,4673346,,False,2.0,0,1,0,1,0,0,0,0,1,0,1,0,0,0,0,0,0
401402558,Rutgers Scarlet Knights,J. Maddox,4433672,,False,2.0,0,1,0,0,0,1,0,0,0,1,1,0,0,0,0,1,0
401402558,Rutgers Scarlet Knights,V. Morris,4281804,,False,19.0,3,7,2,5,1,2,0,0,0,1,1,0,0,0,1,0,7
401402558,Rutgers Scarlet Knights,S. Guihon,4281580,,False,4.0,0,0,0,0,0,0,0,0,0,0,0,1,0,0,0,0,0
401402558,Rutgers Scarlet Knights,D. Marshall,4281424,,False,4.0,1,1,1,1,0,0,0,0,0,2,2,0,1,0,0,1,2
401402558,Rutgers Scarlet Knights,S. Lassiter,4281174,,False,12.0,3,7,2,4,1,3,2,2,0,1,1,0,0,1,0,2,9
401402558,Rutgers Scarlet Knights,TEAM,TOTAL,TOTAL,False,,30,69,26,56,4,13,11,15,19,35,54,18,5,4,15,18,75
401402558,Penn State Lady Lions,A. Camden,4433339,,True,18.0,0,3,0,2,0,1,2,2,2,0,2,0,0,1,1,3,2
401402558,Penn State Lady Lions,L. Kapinus,4433733,,True,37.0,3,14,2,9,1,5,9,11,5,8,13,1,3,1,2,2,16
401402558,Penn State Lady Lions,M. Marisa,4432938,,True,38.0,5,19,5,16,0,3,5,8,0,7,7,5,3,1,3,1,15
401402558,Penn State Lady Lions,N. Beverley,4281273,,True,34.0,2,9,1,3,1,6,0,0,0,2,2,0,0,0,0,1,5
401402558,Penn State Lady Lions,K. Jekot,4068171,,True,11.0,0,1,0,0,0,1,0,0,0,1,1,0,0,0,1,1,0
401402558,Penn State Lady Lions,A. Brigham,4703751,,False,6.0,1,1,1,1,0,0,0,0,0,0,0,1,0,0,2,4,2
401402558,Penn State Lady Lions,K. Thomas,4618076,,False,7.0,0,0,0,0,0,0,1,2,2,2,4,0,0,1,0,0,1
401402558,Penn State Lady Lions,T. Sabel,4703761,,False,17.0,1,5,0,1,1,4,1,2,0,0,0,0,1,0,1,3,4
401402558,Penn State Lady Lions,S. Hagans,4594943,,False,20.0,1,5,0,3,1,2,0,0,1,0,1,0,0,0,0,0,3
401402558,Penn State Lady Lions,M. Burke,4433452,,False,11.0,1,2,1,1,0,1,0,0,0,1,1,1,1,0,0,4,2
401402558,Penn State Lady Lions,TEAM,TOTAL,TOTAL,False,,14,59,10,36,4,23,18,25,10,22,32,8,8,4,10,19,50
401402557,Longwood Lancers,A. Smith,4399978,,True,32.0,6,8,6,8,0,0,0,0,2,4,6,2,0,0,2,2,12
401402557,Longwood Lancers,T. Smith,4594910,,True,28.0,7,9,2,4,5,5,2,2,0,0,0,4,1,0,4,2,21
401402557,Longwood Lancers,K. Calhoun,4900634,,True,28.0,3,4,2,3,1,1,4,6,0,1,1,0,1,0,3,2,11
401402557,Longwood Lancers,B. Johns,4704970,,True,25.0,3,6,0,2,3,4,0,0,0,8,8,0,1,3,0,3,9
401402557,Longwood Lancers,K. McMakin,4594907,,True,29.0,7,10,6,8,1,2,7,8,0,5,5,0,6,1,1,1,22
401402557,Longwood Lancers,B. Anya,4704849,,False,15.0,1,2,1,1,0,1,1,2,2,2,4,0,1,0,0,1,3
401402557,Longwood Lancers,H. Osaro,4704850,,False,2.0,0,2,0,2,0,0,0,0,0,0,0,0,0,0,0,0,0
401402557,Longwood Lancers,G. Germano,4399944,,False,2.0,0,0,0,0,0,0,0,0,0,0,0,0,0,1,0,0,0
401402557,Longwood Lancers,J. Hall,4900636,,False,2.0,0,1,0,1,0,0,0,0,0,2,2,0,0,0,0,0,0
401402557,Longwood Lancers,A. LeRoy,4594913,,False,19.0,1,4,1,3,0,1,2,7,0,4,4,0,0,0,2,1,4
401402557,Longwood Lancers,A. Shipp,4594908,,False,11.0,1,3,1,1,0,2,0,0,1,1,2,0,0,0,1,1,2
401402557,Longwood Lancers,M. Vennema,4399977,,False,7.0,1,1,1,1,0,0,0,0,0,0,0,0,0,0,0,1,2
401402557,Longwood Lancers,TEAM,TOTAL,TOTAL,False,,30,50,20,34,10,16,16,25,6,27,33,6,10,5,13,14,86
401402557,Campbell Fighting Camels,S. Nurenberg,4594883,,True,16.0,0,2,0,1,0,1,2,2,1,2,3,0,0,0,3,1,2
401402557,Campbell Fighting Camels,B. Staves,4594882,,True,34.0,4,7,4,5,0,2,1,1,5,3,8,2,2,0,3,4,9
401402557,Campbell Fighting Camels,T. Bolden,4068145,,True,20.0,1,7,1,7,0,0,0,0,1,3,4,0,0,0,4,3,2
401402557,Campbell Fighting Camels,F. Price,4594881,,True,29.0,5,13,2,4,3,9,0,0,0,1,1,0,0,1,2,2,13
401402557,Campbell Fighting Camels,L. Serranho,4399956,,True,31.0,1,10,1,6,0,4,2,2,1,1,2,3,2,0,3,4,4
401402557,Campbell Fighting Camels,C. Dahlquist,4899211,,False,4.0,1,3,1,1,0,2,0,0,1,2,3,0,0,0,0,0,2
401402557,Campbell Fighting Camels,C. Ezumah,4704805,,False,4.0,0,0,0,0,0,0,0,2,0,1,1,0,0,0,2,2,0
401402557,Campbell Fighting Camels,S. Hammack Fitzgerald,4704804,,False,4.0,0,0,0,0,0,0,0,0,0,0,0,0,0,0,0,0,0
401402557,Campbell Fighting Camels,A. Fuller,4899212,,False,15.0,0,4,0,2,0,2,0,0,0,3,3,2,0,1,0,0,0
401402557,Campbell Fighting Camels,R. Anderson,4704803,,False,4.0,1,2,1,2,0,0,2,2,0,0,0,0,0,0,0,0,4
401402557,Campbell Fighting Camels,S. Tuelle,4399955,,False,26.0,4,8,1,2,3,6,0,0,0,2,2,1,1,0,1,4,11
401402557,Campbell Fighting Camels,T. Carver,4281556,,False,6.0,0,1,0,0,0,1,0,0,0,0,0,0,0,0,2,0,0
401402557,Campbell Fighting Camels,M. Coleman,4281554,,False,7.0,0,0,0,0,0,0,0,2,0,0,0,0,0,0,0,0,0
401402557,Campbell Fighting Camels,TEAM,TOTAL,TOTAL,False,,17,57,11,30,6,27,7,11,14,18,32,8,5,2,21,20,47
401402556,Gardner-Webb Runnin' Bulldogs,A. Smith,4704831,,True,38.0,4,7,4,7,0,0,2,4,2,6,8,1,4,2,5,3,10
401402556,Gardner-Webb Runnin' Bulldogs,L. Deans,4281772,,True,19.0,1,4,1,4,0,0,0,0,1,5,6,0,0,1,1,1,2
401402556,Gardner-Webb Runnin' Bulldogs,L. Bevis,4594891,,True,34.0,1,4,0,2,1,2,2,3,0,2,2,3,0,0,4,3,5
401402556,Gardner-Webb Runnin' Bulldogs,K. Cain,4594890,,True,37.0,2,9,1,5,1,4,6,8,0,2,2,2,2,0,4,4,11
401402556,Gardner-Webb Runnin' Bulldogs,J. Williams,4399960,,True,35.0,5,12,5,9,0,3,0,2,2,5,7,1,2,0,3,4,10
401402556,Gardner-Webb Runnin' Bulldogs,L. Cox,4899232,,False,8.0,2,4,2,4,0,0,0,0,2,2,4,0,1,0,0,2,4
401402556,Gardner-Webb Runnin' Bulldogs,E. Capps,4704833,,False,17.0,3,6,1,3,2,3,0,0,1,1,2,1,1,0,1,0,8
401402556,Gardner-Webb Runnin' Bulldogs,L. Littlejohn,4899230,,False,6.0,0,1,0,0,0,1,0,0,0,1,1,0,0,0,0,1,0
401402556,Gardner-Webb Runnin' Bulldogs,E. Gillis,4704832,,False,1.0,0,1,0,0,0,1,0,0,0,0,0,0,0,0,0,0,0
401402556,Gardner-Webb Runnin' Bulldogs,M. Funderburk,4704829,,False,5.0,0,1,0,0,0,1,0,0,0,1,1,0,0,0,1,1,0
401402556,Gardner-Webb Runnin' Bulldogs,TEAM,TOTAL,TOTAL,False,,18,49,14,34,4,15,10,17,9,26,35,8,10,3,19,19,50
401402556,Campbell Fighting Camels,S. Nurenberg,4594883,,True,34.0,2,6,2,4,0,2,0,0,2,0,2,1,4,1,4,4,4
401402556,Campbell Fighting Camels,B. Staves,4594882,,True,25.0,2,9,2,4,0,5,0,0,0,0,0,1,0,0,2,4,4
401402556,Campbell Fighting Camels,T. Bolden,4068145,,True,33.0,4,13,4,13,0,0,0,2,3,13,16,2,3,1,5,2,8
401402556,Campbell Fighting Camels,F. Price,4594881,,True,31.0,3,10,1,4,2,6,3,3,1,0,1,0,0,0,1,2,11
401402556,Campbell Fighting Camels,L. Serranho,4399956,,True,40.0,8,13,8,11,0,2,4,6,0,6,6,5,1,1,1,1,20
401402556,Campbell Fighting Camels,C. Dahlquist,4899211,,False,1.0,0,0,0,0,0,0,0,0,0,0,0,0,0,0,0,0,0
401402556,Campbell Fighting Camels,C. Ezumah,4704805,,False,2.0,0,0,0,0,0,0,0,0,0,0,0,0,1,0,0,0,0
401402556,Campbell Fighting Camels,A. Fuller,4899212,,False,22.0,0,1,0,1,0,0,2,2,2,1,3,1,2,0,1,2,2
401402556,Campbell Fighting Camels,S. Tuelle,4399955,,False,12.0,1,4,1,1,0,3,0,0,0,0,0,0,0,1,1,0,2
401402556,Campbell Fighting Camels,TEAM,TOTAL,TOTAL,False,,20,56,18,38,2,18,9,13,11,22,33,10,11,4,16,15,51
401402555,UNC Asheville Bulldogs,A. Blake,4704861,,True,16.0,0,1,0,1,0,0,0,0,2,1,3,0,0,0,2,1,0
401402555,UNC Asheville Bulldogs,J. Ivie,4899631,,True,37.0,3,10,2,6,1,4,3,4,0,3,3,0,3,0,2,2,10
401402555,UNC Asheville Bulldogs,K. Carter,4594931,,True,29.0,4,12,2,6,2,6,2,2,1,5,6,0,2,1,3,2,12
401402555,UNC Asheville Bulldogs,F. Adams,4594930,,True,19.0,0,4,0,1,0,3,0,0,0,1,1,1,1,0,3,3,0
401402555,UNC Asheville Bulldogs,N. Evans,4281596,,True,35.0,7,17,7,17,0,0,8,14,2,4,6,1,1,0,5,3,22
401402555,UNC Asheville Bulldogs,A. Sellers,4899632,,False,5.0,2,3,2,3,0,0,0,0,3,1,4,0,0,0,2,3,4
401402555,UNC Asheville Bulldogs,A. Wilson,4704862,,False,15.0,1,2,1,2,0,0,0,0,1,1,2,0,0,0,3,2,2
401402555,UNC Asheville Bulldogs,M. Bruce,4899630,,False,15.0,2,5,2,3,0,2,0,0,1,1,2,1,0,0,1,0,4
401402555,UNC Asheville Bulldogs,J. Shears,4899629,,False,1.0,0,0,0,0,0,0,2,2,1,0,1,0,0,0,0,0,2
401402555,UNC Asheville Bulldogs,C. Fahey,4899628,,False,11.0,0,1,0,0,0,1,0,0,0,2,2,0,1,1,0,1,0
401402555,UNC Asheville Bulldogs,J. Blake,4704859,,False,12.0,0,2,0,1,0,1,0,0,0,1,1,0,0,1,0,0,0
401402555,UNC Asheville Bulldogs,M. Brooks-Sumpter,4704771,,False,0.0,0,0,0,0,0,0,0,0,0,0,0,0,0,0,0,0,0
401402555,UNC Asheville Bulldogs,M. Lockett,4594927,,False,5.0,0,2,0,2,0,0,0,0,0,1,1,0,0,0,0,0,0
401402555,UNC Asheville Bulldogs,TEAM,TOTAL,TOTAL,False,,19,59,16,42,3,17,15,22,14,22,36,3,8,3,22,17,56
401402555,Longwood Lancers,A. Smith,4399978,,True,28.0,4,8,4,8,0,0,1,2,2,7,9,3,1,2,3,1,9
401402555,Longwood Lancers,T. Smith,4594910,,True,23.0,5,9,2,4,3,5,1,2,0,2,2,6,0,0,3,0,14
401402555,Longwood Lancers,K. Calhoun,4900634,,True,31.0,2,6,2,5,0,1,2,4,0,4,4,4,6,0,4,5,6
401402555,Longwood Lancers,B. Johns,4704970,,True,29.0,4,10,3,5,1,5,0,0,3,5,8,2,1,2,0,1,9
401402555,Longwood Lancers,K. McMakin,4594907,,True,28.0,8,12,5,8,3,4,3,3,2,2,4,1,5,0,0,2,22
401402555,Longwood Lancers,B. Anya,4704849,,False,16.0,1,3,1,3,0,0,0,0,1,1,2,0,1,0,1,3,2
401402555,Longwood Lancers,H. Osaro,4704850,,False,2.0,0,0,0,0,0,0,0,0,0,0,0,0,0,0,1,1,0
401402555,Longwood Lancers,G. Germano,4399944,,False,2.0,0,0,0,0,0,0,0,0,0,0,0,0,0,0,0,0,0
401402555,Longwood Lancers,J. Hall,4900636,,False,1.0,0,0,0,0,0,0,0,0,0,0,0,0,0,0,0,0,0
401402555,Longwood Lancers,A. LeRoy,4594913,,False,23.0,5,8,4,4,1,4,3,4,0,1,1,1,0,0,4,2,14
401402555,Longwood Lancers,A. Shipp,4594908,,False,12.0,2,9,1,6,1,3,0,0,4,1,5,0,1,0,2,3,5
401402555,Longwood Lancers,M. Vennema,4399977,,False,5.0,0,1,0,1,0,0,0,0,0,1,1,0,0,0,1,0,0
401402555,Longwood Lancers,TEAM,TOTAL,TOTAL,False,,31,66,22,44,9,22,10,15,13,28,41,17,15,4,21,18,81
401402554,Presbyterian Blue Hose,J. Compton,4594919,,True,39.0,8,15,5,10,3,5,0,0,2,5,7,0,1,0,3,2,19
401402554,Presbyterian Blue Hose,T. Carter,4594918,,True,29.0,3,8,3,7,0,1,2,3,3,3,6,0,3,2,6,5,8
401402554,Presbyterian Blue Hose,P. Kindseth,4899607,,True,34.0,0,7,0,6,0,1,0,0,1,2,3,1,2,0,1,0,0
401402554,Presbyterian Blue Hose,N. Willis,4704892,,True,38.0,1,2,1,2,0,0,4,6,1,4,5,3,1,0,3,2,6
401402554,Presbyterian Blue Hose,M. Bracone,4704888,,True,41.0,7,12,6,9,1,3,1,1,0,7,7,2,5,0,8,2,16
401402554,Presbyterian Blue Hose,J. Stevens,4899604,,False,2.0,0,0,0,0,0,0,0,0,0,0,0,0,0,0,1,0,0
401402554,Presbyterian Blue Hose,B. Brady,4400065,,False,15.0,2,3,2,3,0,0,0,0,0,0,0,0,0,0,2,2,4
401402554,Presbyterian Blue Hose,J. Raflo,4899606,,False,6.0,0,0,0,0,0,0,0,0,0,0,0,1,0,0,1,2,0
401402554,Presbyterian Blue Hose,A. Barker,4899605,,False,21.0,1,3,1,3,0,0,1,2,0,1,1,1,3,0,1,1,3
401402554,Presbyterian Blue Hose,TEAM,TOTAL,TOTAL,False,,22,50,18,40,4,10,8,12,7,24,31,8,15,2,26,16,56
401402554,Campbell Fighting Camels,S. Nurenberg,4594883,,True,36.0,0,1,0,1,0,0,2,2,1,5,6,4,2,1,4,0,2
401402554,Campbell Fighting Camels,B. Staves,4594882,,True,27.0,1,3,0,1,1,2,3,4,3,4,7,2,1,0,2,2,6
401402554,Campbell Fighting Camels,T. Bolden,4068145,,True,38.0,7,18,7,18,0,0,3,3,1,9,10,1,2,0,1,2,17
401402554,Campbell Fighting Camels,F. Price,4594881,,True,40.0,3,8,3,3,0,5,0,0,0,0,0,0,1,0,1,1,6
401402554,Campbell Fighting Camels,L. Serranho,4399956,,True,38.0,8,11,6,8,2,3,2,2,0,1,1,2,1,0,6,2,20
401402554,Campbell Fighting Camels,C. Ezumah,4704805,,False,4.0,0,0,0,0,0,0,0,0,0,0,0,0,0,0,1,1,0
401402554,Campbell Fighting Camels,A. Fuller,4899212,,False,12.0,1,2,0,0,1,2,0,0,0,1,1,1,1,0,2,0,3
401402554,Campbell Fighting Camels,S. Tuelle,4399955,,False,23.0,2,8,1,1,1,7,0,0,0,2,2,2,1,0,2,2,5
401402554,Campbell Fighting Camels,T. Carver,4281556,,False,5.0,0,1,0,0,0,1,0,0,0,0,0,1,0,0,2,0,0
401402554,Campbell Fighting Camels,M. Coleman,4281554,,False,2.0,0,0,0,0,0,0,0,0,0,0,0,0,0,0,0,0,0
401402554,Campbell Fighting Camels,TEAM,TOTAL,TOTAL,False,,22,52,17,32,5,20,10,11,5,23,28,13,9,1,21,10,59
401402553,High Point Panthers,C. Wyatt,4704847,,True,31.0,0,5,0,2,0,3,1,2,1,3,4,2,3,0,0,0,1
401402553,High Point Panthers,C. Scheier,4594894,,True,16.0,0,3,0,1,0,2,0,2,0,1,1,0,0,0,0,1,0
401402553,High Point Panthers,C. Johnson,4594893,,True,25.0,0,3,0,2,0,1,0,2,2,1,3,2,0,0,5,4,0
401402553,High Point Panthers,Je. Edwards,4399964,,True,38.0,8,14,5,7,3,7,2,3,1,5,6,1,2,0,3,3,21
401402553,High Point Panthers,Jo. Edwards,4399132,,True,36.0,2,4,2,4,0,0,2,2,0,1,1,3,0,0,5,2,6
401402553,High Point Panthers,J. Wrightsell,4282477,,False,24.0,2,7,1,4,1,3,1,3,3,5,8,2,2,0,4,3,6
401402553,High Point Panthers,N. Terrell,4899154,,False,30.0,7,16,7,11,0,5,5,5,0,4,4,0,0,0,3,2,19
401402553,High Point Panthers,TEAM,TOTAL,TOTAL,False,,19,52,15,31,4,21,11,19,9,25,34,10,7,0,20,15,53
401402553,Gardner-Webb Runnin' Bulldogs,A. Smith,4704831,,True,40.0,5,14,5,12,0,2,6,8,5,8,13,1,2,4,4,2,16
401402553,Gardner-Webb Runnin' Bulldogs,L. Deans,4281772,,True,17.0,3,6,3,6,0,0,0,0,1,1,2,0,0,0,2,1,6
401402553,Gardner-Webb Runnin' Bulldogs,L. Bevis,4594891,,True,35.0,3,11,3,8,0,3,0,0,0,2,2,4,1,0,4,5,6
401402553,Gardner-Webb Runnin' Bulldogs,K. Cain,4594890,,True,37.0,1,6,1,4,0,2,0,0,2,1,3,1,3,0,4,2,2
401402553,Gardner-Webb Runnin' Bulldogs,J. Williams,4399960,,True,38.0,8,10,8,9,0,1,1,3,2,4,6,1,3,1,1,3,17
401402553,Gardner-Webb Runnin' Bulldogs,L. Cox,4899232,,False,11.0,2,4,2,4,0,0,0,0,0,5,5,1,0,0,0,1,4
401402553,Gardner-Webb Runnin' Bulldogs,E. Capps,4704833,,False,12.0,0,4,0,2,0,2,1,2,1,1,2,0,0,0,1,2,1
401402553,Gardner-Webb Runnin' Bulldogs,L. Littlejohn,4899230,,False,3.0,1,1,0,0,1,1,0,0,0,1,1,0,0,0,1,1,3
401402553,Gardner-Webb Runnin' Bulldogs,M. Funderburk,4704829,,False,7.0,0,2,0,0,0,2,0,0,0,1,1,0,0,0,0,0,0
401402553,Gardner-Webb Runnin' Bulldogs,TEAM,TOTAL,TOTAL,False,,23,58,22,45,1,13,8,13,12,27,39,8,9,5,18,17,55
401402552,Longwood Lancers,A. Smith,4399978,,True,34.0,9,11,9,11,0,0,10,12,2,17,19,2,1,2,2,1,28
401402552,Longwood Lancers,T. Smith,4594910,,True,35.0,3,9,1,4,2,5,5,6,0,3,3,2,0,0,5,2,13
401402552,Longwood Lancers,K. Calhoun,4900634,,True,26.0,3,8,2,4,1,4,0,0,0,5,5,2,3,1,2,4,7
401402552,Longwood Lancers,B. Johns,4704970,,True,25.0,1,6,0,2,1,4,0,0,3,1,4,1,1,3,1,2,3
401402552,Longwood Lancers,K. McMakin,4594907,,True,28.0,3,13,2,7,1,6,2,2,4,1,5,2,0,1,2,1,9
401402552,Longwood Lancers,B. Anya,4704849,,False,21.0,0,1,0,1,0,0,1,2,3,9,12,1,1,0,3,1,1
401402552,Longwood Lancers,A. LeRoy,4594913,,False,11.0,2,5,0,2,2,3,1,1,0,0,0,1,0,0,2,1,7
401402552,Longwood Lancers,A. Shipp,4594908,,False,7.0,0,2,0,1,0,1,0,0,0,1,1,0,0,0,2,0,0
401402552,Longwood Lancers,M. Vennema,4399977,,False,13.0,1,4,1,2,0,2,0,0,1,0,1,1,0,1,1,1,2
401402552,Longwood Lancers,TEAM,TOTAL,TOTAL,False,,22,59,15,34,7,25,19,23,15,39,54,12,6,8,21,13,70
401402552,Hampton Lady Pirates,N. Young,4595522,,True,29.0,5,12,5,12,0,0,6,7,1,6,7,0,1,0,2,5,16
401402552,Hampton Lady Pirates,S. Mills,4399854,,True,9.0,1,2,1,2,0,0,0,0,0,0,0,0,0,0,0,0,2
401402552,Hampton Lady Pirates,J. Mapp,4704839,,True,40.0,8,19,7,15,1,4,0,0,3,3,6,0,3,1,1,1,17
401402552,Hampton Lady Pirates,V. Mason,4704838,,True,35.0,4,9,4,7,0,2,4,6,0,4,4,6,4,0,6,4,12
401402552,Hampton Lady Pirates,M. Buford,4703585,,True,27.0,1,11,0,6,1,5,1,2,0,3,3,2,0,1,1,4,4
401402552,Hampton Lady Pirates,A. Wooden,4399573,,False,30.0,1,3,1,3,0,0,2,2,1,3,4,0,0,0,0,3,4
401402552,Hampton Lady Pirates,D. Chakolis,4595523,,False,2.0,0,1,0,1,0,0,0,0,0,0,0,0,1,0,0,0,0
401402552,Hampton Lady Pirates,A. Reaves,4899248,,False,28.0,2,12,0,5,2,7,0,0,2,2,4,1,2,0,1,3,6
401402552,Hampton Lady Pirates,TEAM,TOTAL,TOTAL,False,,22,69,18,51,4,18,13,17,11,23,34,9,11,2,11,20,61
401402551,UNC Asheville Bulldogs,A. Wilson,4704862,,True,22.0,1,4,1,4,0,0,0,0,2,0,2,0,0,0,0,2,2
401402551,UNC Asheville Bulldogs,J. Ivie,4899631,,True,37.0,1,6,0,3,1,3,0,0,1,3,4,2,5,0,3,3,3
401402551,UNC Asheville Bulldogs,K. Carter,4594931,,True,34.0,9,17,6,13,3,4,2,4,1,6,7,1,1,0,1,2,23
401402551,UNC Asheville Bulldogs,F. Adams,4594930,,True,33.0,1,5,0,1,1,4,0,0,0,1,1,1,2,0,1,0,3
401402551,UNC Asheville Bulldogs,N. Evans,4281596,,True,39.0,6,17,6,16,0,1,5,7,1,6,7,4,0,0,1,1,17
401402551,UNC Asheville Bulldogs,A. Sellers,4899632,,False,1.0,0,0,0,0,0,0,0,0,0,1,1,0,0,0,0,0,0
401402551,UNC Asheville Bulldogs,A. Blake,4704861,,False,17.0,2,5,2,5,0,0,0,0,3,2,5,0,1,0,0,2,4
401402551,UNC Asheville Bulldogs,M. Bruce,4899630,,False,6.0,1,1,1,1,0,0,0,0,1,1,2,0,0,0,1,1,2
401402551,UNC Asheville Bulldogs,J. Blake,4704859,,False,7.0,2,2,0,0,2,2,0,0,0,0,0,1,0,0,0,0,6
401402551,UNC Asheville Bulldogs,M. Lockett,4594927,,False,4.0,1,1,1,1,0,0,0,0,0,0,0,0,0,0,1,0,2
401402551,UNC Asheville Bulldogs,TEAM,TOTAL,TOTAL,False,,24,58,17,44,7,14,7,11,9,22,31,9,9,0,9,11,62
401402551,South Carolina Upstate Spartans,M. Coleman,4704773,,True,40.0,5,6,5,6,0,0,0,0,1,4,5,1,1,0,2,2,10
401402551,South Carolina Upstate Spartans,T. Harness,4899624,,True,36.0,2,7,0,0,2,7,0,0,0,2,2,0,1,0,1,1,6
401402551,South Carolina Upstate Spartans,R. Rose,4899622,,True,40.0,10,14,10,13,0,1,5,5,2,5,7,5,0,0,4,4,25
401402551,South Carolina Upstate Spartans,C. Watson,4594522,,True,39.0,5,17,3,10,2,7,0,0,3,5,8,0,0,0,6,2,12
401402551,South Carolina Upstate Spartans,J. Logan,4594422,,True,36.0,2,7,2,6,0,1,0,2,2,9,11,2,0,0,1,3,4
401402551,South Carolina Upstate Spartans,AC Markham,4899627,,False,2.0,0,1,0,0,0,1,0,0,0,1,1,0,0,0,0,0,0
401402551,South Carolina Upstate Spartans,H. Roberts,4899626,,False,0.0,0,0,0,0,0,0,0,0,0,0,0,0,0,0,0,0,0
401402551,South Carolina Upstate Spartans,D. Wilson,4704769,,False,7.0,0,1,0,1,0,0,0,0,0,0,0,1,0,0,1,0,0
401402551,South Carolina Upstate Spartans,TEAM,TOTAL,TOTAL,False,,24,53,20,36,4,17,5,7,8,28,36,9,2,0,16,12,57
401402550,Winthrop Eagles,C. De Klauman,4899637,,True,12.0,0,5,0,5,0,0,0,0,2,0,2,0,0,0,1,3,0
401402550,Winthrop Eagles,Sy. Hunter,4594935,,True,24.0,2,5,2,5,0,0,0,0,0,2,2,0,1,0,0,1,4
401402550,Winthrop Eagles,L. Paisana,4899636,,True,27.0,1,2,1,1,0,1,0,0,3,2,5,4,0,1,4,4,2
401402550,Winthrop Eagles,J. Ingram,4704821,,True,25.0,6,14,6,13,0,1,3,4,0,9,9,2,2,0,3,3,15
401402550,Winthrop Eagles,M. Strickland,4594934,,True,30.0,5,12,3,9,2,3,1,2,0,0,0,1,1,0,2,4,13
401402550,Winthrop Eagles,Si. Hunter,4594936,,False,21.0,2,3,2,3,0,0,2,2,0,1,1,1,0,0,0,3,6
401402550,Winthrop Eagles,L. Malinka,4899633,,False,29.0,5,9,1,2,4,7,1,1,0,1,1,1,1,0,5,1,15
401402550,Winthrop Eagles,A. Alexe,4704819,,False,19.0,1,2,0,1,1,1,2,2,1,2,3,0,0,0,2,0,5
401402550,Winthrop Eagles,T. Hall,4594937,,False,13.0,0,1,0,1,0,0,0,0,0,1,1,1,0,0,0,1,0
401402550,Winthrop Eagles,TEAM,TOTAL,TOTAL,False,,22,53,15,40,7,13,9,11,11,19,30,10,5,1,18,20,60
401402550,Presbyterian Blue Hose,J. Compton,4594919,,True,28.0,8,15,6,11,2,4,6,7,2,5,7,1,0,2,0,0,24
401402550,Presbyterian Blue Hose,T. Carter,4594918,,True,18.0,4,8,4,8,0,0,2,6,5,1,6,1,1,1,1,3,10
401402550,Presbyterian Blue Hose,P. Kindseth,4899607,,True,35.0,7,9,6,8,1,1,6,8,1,3,4,2,2,0,1,2,21
401402550,Presbyterian Blue Hose,N. Willis,4704892,,True,17.0,0,3,0,2,0,1,0,0,0,3,3,2,0,0,3,2,0
401402550,Presbyterian Blue Hose,M. Bracone,4704888,,True,29.0,0,6,0,2,0,4,0,0,0,4,4,1,2,0,2,1,0
401402550,Presbyterian Blue Hose,B. Brady,4400065,,False,22.0,3,4,3,4,0,0,2,2,0,0,0,0,1,0,0,1,8
401402550,Presbyterian Blue Hose,J. Raflo,4899606,,False,20.0,0,3,0,2,0,1,0,0,0,0,0,1,1,0,1,0,0
401402550,Presbyterian Blue Hose,A. Barker,4899605,,False,31.0,1,2,1,2,0,0,0,0,1,4,5,3,2,0,5,3,2
401402550,Presbyterian Blue Hose,TEAM,TOTAL,TOTAL,False,,23,50,20,39,3,11,16,23,11,20,31,11,9,3,13,12,65
401402549,High Point Panthers,C. Wyatt,4704847,,True,23.0,3,5,2,2,1,3,2,2,0,5,5,2,1,2,2,1,9
401402549,High Point Panthers,C. Scheier,4594894,,True,30.0,4,11,3,3,1,8,1,2,0,2,2,0,1,0,0,2,10
401402549,High Point Panthers,C. Johnson,4594893,,True,35.0,1,2,1,1,0,1,0,0,1,5,6,2,0,0,3,1,2
401402549,High Point Panthers,Je. Edwards,4399964,,True,35.0,5,11,4,6,1,5,0,2,0,14,14,4,2,0,3,1,11
401402549,High Point Panthers,Jo. Edwards,4399132,,True,24.0,0,3,0,0,0,3,0,0,0,2,2,1,1,0,3,1,0
401402549,High Point Panthers,J. Wrightsell,4282477,,False,20.0,3,10,3,7,0,3,3,3,3,3,6,3,0,0,0,4,9
401402549,High Point Panthers,S. Baskerville,4899155,,False,2.0,0,1,0,1,0,0,0,0,0,0,0,0,0,0,0,0,0
401402549,High Point Panthers,N. Terrell,4899154,,False,29.0,5,11,2,3,3,8,0,0,0,3,3,2,4,0,2,1,13
401402549,High Point Panthers,L. Simmons,4704846,,False,2.0,0,0,0,0,0,0,0,0,1,1,2,0,0,0,0,0,0
401402549,High Point Panthers,TEAM,TOTAL,TOTAL,False,,21,54,15,23,6,31,6,9,5,37,42,14,9,2,14,11,54
401402549,Charleston Southern Buccaneers,A. Faye,4281096,,True,23.0,3,9,2,6,1,3,0,1,0,6,6,1,0,0,4,2,7
401402549,Charleston Southern Buccaneers,S. Godfrey,4399958,,True,30.0,1,9,1,6,0,3,0,0,1,4,5,3,1,2,2,2,2
401402549,Charleston Southern Buccaneers,J. Fargo,4704811,,True,40.0,3,12,1,4,2,8,3,7,0,4,4,2,1,0,4,3,11
401402549,Charleston Southern Buccaneers,T. Gittens,4594888,,True,38.0,2,7,0,2,2,5,0,0,1,5,6,0,1,0,1,1,6
401402549,Charleston Southern Buccaneers,S. Leigh,4594886,,True,40.0,2,7,0,1,2,6,2,2,0,3,3,0,1,0,1,0,8
401402549,Charleston Southern Buccaneers,M. Winans,4704812,,False,3.0,0,0,0,0,0,0,0,0,0,0,0,0,0,0,0,0,0
401402549,Charleston Southern Buccaneers,S. Baltezegar,4899227,,False,9.0,0,5,0,5,0,0,0,0,0,4,4,0,1,0,3,1,0
401402549,Charleston Southern Buccaneers,M. Adamson,4899229,,False,17.0,0,3,0,1,0,2,0,0,2,2,4,1,0,0,2,4,0
401402549,Charleston Southern Buccaneers,TEAM,TOTAL,TOTAL,False,,11,52,4,25,7,27,5,10,5,30,35,7,5,2,19,13,34
401402548,Radford Highlanders,R. LaLonde,4594921,,True,36.0,3,6,3,5,0,1,1,2,3,12,15,2,2,1,2,4,7
401402548,Radford Highlanders,J. Christ,4595846,,True,9.0,1,2,1,2,0,0,0,0,1,1,2,0,0,0,1,4,2
401402548,Radford Highlanders,D. Marshall,4704881,,True,29.0,2,10,2,5,0,5,0,1,0,4,4,1,0,0,3,4,4
401402548,Radford Highlanders,B. McClean,4399998,,True,23.0,2,6,1,4,1,2,0,0,2,3,5,0,0,1,3,2,5
401402548,Radford Highlanders,B. Birkhead,4281981,,True,30.0,1,10,1,1,0,9,0,0,0,7,7,4,0,1,6,3,2
401402548,Radford Highlanders,V. Blake,4899617,,False,1.0,0,0,0,0,0,0,0,0,0,0,0,0,0,0,0,1,0
401402548,Radford Highlanders,T. Johnson,4594925,,False,8.0,0,0,0,0,0,0,1,2,0,1,1,0,0,0,1,2,1
401402548,Radford Highlanders,K. Morgan,4704884,,False,27.0,4,6,2,4,2,2,0,0,0,5,5,1,0,1,1,1,10
401402548,Radford Highlanders,A. Tudor,4704883,,False,25.0,6,11,5,8,1,3,4,7,2,1,3,0,0,3,4,4,17
401402548,Radford Highlanders,D. Montelbano,4704882,,False,10.0,0,1,0,1,0,0,1,2,0,0,0,0,0,0,3,2,1
401402548,Radford Highlanders,TEAM,TOTAL,TOTAL,False,,19,52,15,30,4,22,7,14,10,37,47,8,2,7,25,27,49
401402548,Hampton Lady Pirates,N. Young,4595522,,True,29.0,5,16,5,16,0,0,10,12,3,5,8,1,1,0,0,4,20
401402548,Hampton Lady Pirates,S. Mills,4399854,,True,16.0,1,3,1,3,0,0,0,0,0,0,0,0,0,0,2,2,2
401402548,Hampton Lady Pirates,J. Mapp,4704839,,True,38.0,3,8,3,7,0,1,0,2,0,1,1,1,2,0,1,2,6
401402548,Hampton Lady Pirates,V. Mason,4704838,,True,39.0,4,16,4,14,0,2,4,5,1,4,5,1,3,0,2,1,12
401402548,Hampton Lady Pirates,M. Buford,4703585,,True,24.0,0,6,0,5,0,1,2,2,1,8,9,0,0,0,3,2,2
401402548,Hampton Lady Pirates,A. Wooden,4399573,,False,11.0,0,1,0,1,0,0,4,4,0,1,1,0,1,0,0,2,4
401402548,Hampton Lady Pirates,D. Chakolis,4595523,,False,6.0,0,1,0,1,0,0,0,0,0,1,1,0,0,0,0,1,0
401402548,Hampton Lady Pirates,A. Reaves,4899248,,False,37.0,3,6,3,6,0,0,3,4,0,2,2,2,5,0,0,2,9
401402548,Hampton Lady Pirates,TEAM,TOTAL,TOTAL,False,,16,57,16,53,0,4,23,29,7,26,33,5,12,0,8,16,55
401402547,UNC Asheville Bulldogs,A. Wilson,4704862,,True,16.0,4,5,4,5,0,0,1,2,2,0,2,0,1,0,1,2,9
401402547,UNC Asheville Bulldogs,J. Ivie,4899631,,True,37.0,7,11,3,5,4,6,2,2,1,1,2,3,5,0,1,1,20
401402547,UNC Asheville Bulldogs,K. Carter,4594931,,True,32.0,4,11,3,10,1,1,0,0,0,3,3,0,2,0,2,4,9
401402547,UNC Asheville Bulldogs,F. Adams,4594930,,True,36.0,0,1,0,0,0,1,2,4,0,2,2,3,1,0,2,0,2
401402547,UNC Asheville Bulldogs,N. Evans,4281596,,True,38.0,7,16,7,15,0,1,6,8,0,4,4,3,2,0,1,3,20
401402547,UNC Asheville Bulldogs,A. Sellers,4899632,,False,3.0,0,0,0,0,0,0,0,0,0,1,1,0,0,0,0,1,0
401402547,UNC Asheville Bulldogs,A. Blake,4704861,,False,20.0,3,5,3,5,0,0,0,0,1,4,5,1,1,0,2,4,6
401402547,UNC Asheville Bulldogs,M. Bruce,4899630,,False,8.0,0,1,0,0,0,1,0,0,0,1,1,1,0,0,0,0,0
401402547,UNC Asheville Bulldogs,J. Blake,4704859,,False,4.0,0,0,0,0,0,0,0,0,0,1,1,0,0,0,0,0,0
401402547,UNC Asheville Bulldogs,M. Lockett,4594927,,False,6.0,1,2,1,2,0,0,0,0,0,0,0,0,0,0,1,1,2
401402547,UNC Asheville Bulldogs,TEAM,TOTAL,TOTAL,False,,26,52,21,42,5,10,11,16,5,19,24,11,12,0,12,16,68
401402547,North Carolina A&T Aggies,K. Adderton,4282090,,True,32.0,3,9,3,7,0,2,0,2,1,3,4,2,0,1,3,1,6
401402547,North Carolina A&T Aggies,J. Dorsey,4899555,,True,25.0,3,7,2,5,1,2,0,0,1,4,5,5,0,0,5,4,7
401402547,North Carolina A&T Aggies,S. McNeill,4899553,,True,29.0,3,10,2,7,1,3,0,0,1,2,3,1,0,0,3,4,7
401402547,North Carolina A&T Aggies,D. Tucker,4705328,,True,11.0,2,2,2,2,0,0,0,0,1,1,2,1,0,0,0,0,4
401402547,North Carolina A&T Aggies,C. Scott,4065844,,True,40.0,9,11,8,8,1,3,3,4,2,8,10,3,0,2,2,2,22
401402547,North Carolina A&T Aggies,J. Harris,4399490,,False,25.0,4,11,4,10,0,1,2,2,2,3,5,0,0,0,2,2,10
401402547,North Carolina A&T Aggies,F. Blackstone,4433448,,False,14.0,1,4,1,1,0,3,1,1,0,0,0,0,2,0,2,1,3
401402547,North Carolina A&T Aggies,J. Walton,4400374,,False,16.0,0,0,0,0,0,0,0,0,0,1,1,1,0,0,3,2,0
401402547,North Carolina A&T Aggies,K. Boyd,4398612,,False,8.0,0,0,0,0,0,0,0,0,0,0,0,1,0,0,0,0,0
401402547,North Carolina A&T Aggies,TEAM,TOTAL,TOTAL,False,,25,54,22,40,3,14,6,9,11,23,34,14,2,3,20,16,59
401402546,Northern Arizona Lumberjacks,K. Rasheed,4281671,,True,32.0,4,6,4,6,0,0,1,2,0,3,3,0,0,0,0,4,9
401402546,Northern Arizona Lumberjacks,E. Rodabaugh,4594845,,True,31.0,5,17,1,4,4,13,2,2,3,8,11,1,0,0,2,1,16
401402546,Northern Arizona Lumberjacks,R. Schenck,4399923,,True,39.0,5,10,5,9,0,1,2,2,1,8,9,4,3,0,0,4,12
401402546,Northern Arizona Lumberjacks,N. Radford,4281730,,True,25.0,1,11,0,0,1,11,0,0,1,0,1,2,1,1,3,1,3
401402546,Northern Arizona Lumberjacks,L. Orndoff,4281672,,True,11.0,1,2,1,1,0,1,0,0,0,1,1,0,0,0,2,0,2
401402546,Northern Arizona Lumberjacks,F. Jaiteh,4899311,,False,8.0,2,4,2,4,0,0,0,0,4,0,4,0,1,0,1,2,4
401402546,Northern Arizona Lumberjacks,O. Moran,4704921,,False,17.0,2,7,2,5,0,2,0,0,3,4,7,0,1,0,4,0,4
401402546,Northern Arizona Lumberjacks,N. Moran,4704920,,False,5.0,0,1,0,1,0,0,0,0,1,2,3,1,0,0,2,2,0
401402546,Northern Arizona Lumberjacks,M. Maio,4595636,,False,32.0,6,13,6,12,0,1,2,2,0,2,2,2,0,0,3,1,14
401402546,Northern Arizona Lumberjacks,TEAM,TOTAL,TOTAL,False,,26,71,21,42,5,29,7,8,17,30,47,10,6,1,17,15,64
401402546,Montana State Bobcats,K. Bad Bear,4594836,,True,29.0,6,10,6,9,0,1,1,2,0,3,3,2,2,2,0,3,13
401402546,Montana State Bobcats,G. Mocchi,4399914,,True,19.0,1,6,1,4,0,2,0,0,1,2,3,0,0,1,0,1,2
401402546,Montana State Bobcats,K. Limardo,4705201,,True,28.0,2,5,0,0,2,5,2,2,0,3,3,1,0,1,0,3,8
401402546,Montana State Bobcats,L. Beattie,4705202,,True,28.0,5,12,2,3,3,9,3,4,1,3,4,0,3,0,4,0,16
401402546,Montana State Bobcats,D. White,4594835,,True,32.0,6,10,6,9,0,1,5,5,0,3,3,5,0,0,1,0,17
401402546,Montana State Bobcats,T. Janssen,4705204,,False,11.0,0,1,0,1,0,0,0,0,0,2,2,1,0,1,1,1,0
401402546,Montana State Bobcats,L. Deden,4705203,,False,19.0,3,6,3,6,0,0,0,0,2,2,4,2,2,1,1,2,6
401402546,Montana State Bobcats,A. Ranson,4705200,,False,14.0,3,7,2,3,1,4,1,2,0,0,0,2,2,0,1,0,8
401402546,Montana State Bobcats,M. Jackson,4594837,,False,12.0,1,2,0,1,1,1,2,2,0,2,2,0,0,0,0,3,5
401402546,Montana State Bobcats,A. Van Sickle,4281659,,False,8.0,0,1,0,1,0,0,0,0,0,1,1,0,0,0,1,0,0
401402546,Montana State Bobcats,TEAM,TOTAL,TOTAL,False,,27,60,20,37,7,23,14,17,5,24,29,13,9,6,9,13,75
401402545,Montana State Bobcats,K. Bad Bear,4594836,,True,25.0,5,12,4,11,1,1,4,6,2,1,3,1,4,0,1,3,15
401402545,Montana State Bobcats,G. Mocchi,4399914,,True,32.0,3,11,2,8,1,3,0,0,3,5,8,2,0,0,1,1,7
401402545,Montana State Bobcats,K. Limardo,4705201,,True,32.0,5,8,1,2,4,6,3,4,0,3,3,1,3,1,1,0,17
401402545,Montana State Bobcats,L. Beattie,4705202,,True,32.0,5,9,3,5,2,4,4,6,2,3,5,2,1,0,0,3,16
401402545,Montana State Bobcats,D. White,4594835,,True,36.0,7,19,6,17,1,2,1,1,2,3,5,4,2,0,1,1,16
401402545,Montana State Bobcats,T. Janssen,4705204,,False,12.0,0,5,0,1,0,4,0,0,1,2,3,0,0,0,0,4,0
401402545,Montana State Bobcats,L. Deden,4705203,,False,11.0,1,4,1,4,0,0,0,0,2,4,6,0,2,1,1,1,2
401402545,Montana State Bobcats,A. Ranson,4705200,,False,7.0,0,0,0,0,0,0,0,0,0,0,0,0,0,0,1,0,0
401402545,Montana State Bobcats,M. Jackson,4594837,,False,7.0,0,2,0,0,0,2,0,0,0,1,1,0,0,0,0,0,0
401402545,Montana State Bobcats,A. Van Sickle,4281659,,False,6.0,0,1,0,0,0,1,0,0,0,2,2,0,0,0,0,0,0
401402545,Montana State Bobcats,TEAM,TOTAL,TOTAL,False,,26,71,17,48,9,23,12,17,13,26,39,10,12,2,6,13,73
401402545,Idaho Vandals,B. Bea,4594826,,True,40.0,10,21,10,19,0,2,2,3,3,9,12,2,2,0,5,3,22
401402545,Idaho Vandals,A. Wallace,4899034,,True,19.0,2,2,0,0,2,2,0,0,0,0,0,0,1,0,2,0,6
401402545,Idaho Vandals,S. Gandy,4704760,,True,35.0,3,11,0,2,3,9,0,2,0,1,1,3,0,0,4,2,9
401402545,Idaho Vandals,T. Johnson,4281684,,True,35.0,3,10,1,4,2,6,0,0,0,6,6,2,0,0,3,4,8
401402545,Idaho Vandals,A. Kirby,4281627,,True,38.0,3,7,2,4,1,3,1,2,3,13,16,6,1,0,6,1,8
401402545,Idaho Vandals,P. Atchley,4704758,,False,13.0,1,2,0,0,1,2,1,2,0,1,1,0,0,0,0,3,4
401402545,Idaho Vandals,L. Forsyth,4281998,,False,20.0,4,7,2,4,2,3,0,2,0,2,2,1,0,1,1,1,10
401402545,Idaho Vandals,TEAM,TOTAL,TOTAL,False,,26,60,15,33,11,27,4,11,10,33,43,14,4,1,21,14,67
401402544,Northern Colorado Bears,K. Harden,4594852,,True,27.0,5,10,5,10,0,0,4,4,4,5,9,0,0,0,2,1,14
401402544,Northern Colorado Bears,A. Downing,4708502,,True,28.0,1,7,0,2,1,5,0,0,0,2,2,2,1,0,2,3,3
401402544,Northern Colorado Bears,H. Simental,4705487,,True,37.0,8,18,3,7,5,11,6,6,1,4,5,2,1,0,1,0,27
401402544,Northern Colorado Bears,M. Isenbart,4399928,,True,14.0,2,6,1,3,1,3,0,0,1,0,1,2,1,0,0,1,5
401402544,Northern Colorado Bears,A. Chapman,4281679,,True,33.0,3,11,3,8,0,3,0,1,3,3,6,3,0,0,2,4,6
401402544,Northern Colorado Bears,C. Boyles,4703967,,False,8.0,2,4,2,4,0,0,1,1,1,0,1,0,1,0,0,1,5
401402544,Northern Colorado Bears,Z. Campbell,4899530,,False,6.0,0,0,0,0,0,0,0,0,0,0,0,0,0,0,0,1,0
401402544,Northern Colorado Bears,J. Galloway,4705490,,False,18.0,0,2,0,2,0,0,0,0,0,0,0,1,0,0,1,2,0
401402544,Northern Colorado Bears,S. Stensgard,4705199,,False,5.0,0,0,0,0,0,0,0,0,0,1,1,0,0,0,2,0,0
401402544,Northern Colorado Bears,B. Evans,4399927,,False,0.0,0,0,0,0,0,0,0,0,0,0,0,0,0,0,0,0,0
401402544,Northern Colorado Bears,S. Lipe,4399618,,False,21.0,1,5,1,4,0,1,5,6,4,6,10,1,2,0,3,2,7
401402544,Northern Colorado Bears,J. Gorzeman,4282077,,False,3.0,0,0,0,0,0,0,0,0,0,0,0,0,0,0,0,0,0
401402544,Northern Colorado Bears,TEAM,TOTAL,TOTAL,False,,22,63,15,40,7,23,16,18,16,22,38,11,6,0,14,15,67
401402544,Northern Arizona Lumberjacks,K. Rasheed,4281671,,True,25.0,8,13,8,13,0,0,0,2,1,6,7,2,0,0,0,3,16
401402544,Northern Arizona Lumberjacks,N. Radford,4281730,,True,24.0,2,3,1,2,1,1,0,0,0,3,3,3,1,0,1,0,5
401402544,Northern Arizona Lumberjacks,E. Rodabaugh,4594845,,True,19.0,1,3,0,1,1,2,0,0,0,3,3,0,0,3,1,0,3
401402544,Northern Arizona Lumberjacks,R. Schenck,4399923,,True,36.0,4,10,2,4,2,6,2,2,1,3,4,10,0,0,5,5,12
401402544,Northern Arizona Lumberjacks,L. Orndoff,4281672,,True,24.0,1,6,1,4,0,2,0,0,0,0,0,0,0,0,2,2,2
401402544,Northern Arizona Lumberjacks,F. Jaiteh,4899311,,False,16.0,3,6,3,6,0,0,3,4,1,3,4,1,0,0,0,1,9
401402544,Northern Arizona Lumberjacks,O. Moran,4704921,,False,19.0,3,3,2,2,1,1,1,2,0,1,1,0,0,0,1,3,8
401402544,Northern Arizona Lumberjacks,N. Moran,4704920,,False,11.0,2,4,1,2,1,2,0,0,0,0,0,1,2,1,0,2,5
401402544,Northern Arizona Lumberjacks,M. Maio,4595636,,False,26.0,4,8,4,8,0,0,4,4,3,2,5,2,4,0,2,0,12
401402544,Northern Arizona Lumberjacks,TEAM,TOTAL,TOTAL,False,,28,56,22,42,6,14,10,14,7,24,31,19,7,4,12,16,72
401402542,Southern Utah Thunderbirds,D. Dotson,4899551,,True,35.0,6,12,6,12,0,0,3,4,4,7,11,0,0,0,2,3,15
401402542,Southern Utah Thunderbirds,L. Williamson,4704907,,True,24.0,2,8,2,8,0,0,0,0,2,4,6,0,2,2,2,2,4
401402542,Southern Utah Thunderbirds,S. Johnston,4704906,,True,27.0,2,6,2,4,0,2,2,2,0,6,6,0,0,0,1,2,6
401402542,Southern Utah Thunderbirds,D. Ballena,4704905,,True,30.0,3,8,3,8,0,0,2,3,0,1,1,3,0,0,2,4,8
401402542,Southern Utah Thunderbirds,C. Daugherty,4704902,,True,29.0,4,13,4,13,0,0,8,10,1,7,8,3,0,1,3,4,16
401402542,Southern Utah Thunderbirds,N. Otkhmezuri,4899550,,False,23.0,2,5,1,3,1,2,0,0,0,5,5,0,0,0,0,2,5
401402542,Southern Utah Thunderbirds,A. Lord,4594868,,False,8.0,0,2,0,1,0,1,1,2,1,1,2,0,0,0,0,0,1
401402542,Southern Utah Thunderbirds,M. Satini,4594867,,False,2.0,1,1,1,1,0,0,0,0,0,0,0,0,0,0,0,0,2
401402542,Southern Utah Thunderbirds,M. Eaton,4594866,,False,22.0,2,5,2,4,0,1,3,5,0,1,1,0,1,0,3,3,7
401402542,Southern Utah Thunderbirds,TEAM,TOTAL,TOTAL,False,,22,60,21,54,1,6,19,26,12,33,45,6,3,3,13,20,64
401402542,Idaho Vandals,B. Bea,4594826,,True,19.0,6,10,6,9,0,1,4,4,1,5,6,2,0,1,1,4,16
401402542,Idaho Vandals,A. Wallace,4899034,,True,25.0,4,7,3,4,1,3,0,0,0,2,2,2,1,0,1,1,9
401402542,Idaho Vandals,S. Gandy,4704760,,True,40.0,7,10,2,3,5,7,3,5,0,1,1,3,0,0,3,0,22
401402542,Idaho Vandals,T. Johnson,4281684,,True,35.0,2,10,1,5,1,5,1,2,1,7,8,0,3,1,0,5,6
401402542,Idaho Vandals,A. Kirby,4281627,,True,38.0,2,7,2,4,0,3,8,10,2,5,7,4,0,0,2,3,12
401402542,Idaho Vandals,P. Atchley,4704758,,False,17.0,0,1,0,1,0,0,2,2,0,1,1,0,0,0,1,1,2
401402542,Idaho Vandals,L. Forsyth,4281998,,False,26.0,4,14,4,12,0,2,2,2,0,4,4,0,0,1,0,5,10
401402542,Idaho Vandals,TEAM,TOTAL,TOTAL,False,,25,59,18,38,7,21,20,25,4,28,32,11,4,3,9,19,77
401402541,Weber State Wildcats,J. Matthews,4594879,,True,32.0,2,6,2,6,0,0,1,2,5,3,8,3,0,0,0,1,5
401402541,Weber State Wildcats,D. Hickok,4594877,,True,29.0,3,8,3,8,0,0,4,6,4,4,8,0,1,0,3,3,10
401402541,Weber State Wildcats,E. Torbert,4400135,,True,33.0,4,9,4,6,0,3,1,2,2,7,9,2,1,1,2,2,9
401402541,Weber State Wildcats,A. Solovi,4594878,,True,31.0,1,8,1,7,0,1,1,2,2,1,3,2,2,0,6,0,3
401402541,Weber State Wildcats,K. Pentzer,4399951,,True,32.0,7,12,6,7,1,5,2,3,0,4,4,1,0,0,3,3,17
401402541,Weber State Wildcats,V. Parra,4594876,,False,7.0,0,0,0,0,0,0,2,2,0,1,1,1,0,0,1,0,2
401402541,Weber State Wildcats,N. Johnson,4899562,,False,3.0,0,2,0,0,0,2,0,0,0,0,0,0,0,0,1,0,0
401402541,Weber State Wildcats,K. Lesane,4899560,,False,5.0,1,1,1,1,0,0,0,0,0,1,1,0,0,0,0,4,2
401402541,Weber State Wildcats,E. Lovell,4899559,,False,4.0,0,0,0,0,0,0,1,2,0,3,3,2,0,0,1,0,1
401402541,Weber State Wildcats,A. Ellis,4899558,,False,2.0,0,1,0,1,0,0,1,2,1,0,1,0,0,0,0,1,1
401402541,Weber State Wildcats,L. Taylor,4899557,,False,15.0,3,7,1,3,2,4,0,0,0,2,2,0,0,0,2,2,8
401402541,Weber State Wildcats,A. Williams,4400178,,False,7.0,1,1,1,1,0,0,0,0,0,0,0,0,0,0,2,0,2
401402541,Weber State Wildcats,TEAM,TOTAL,TOTAL,False,,22,55,19,40,3,15,13,21,16,28,44,11,4,1,22,16,60
401402541,Montana State Bobcats,K. Bad Bear,4594836,,True,19.0,8,9,5,6,3,3,4,5,1,1,2,0,2,1,1,3,23
401402541,Montana State Bobcats,G. Mocchi,4399914,,True,26.0,1,4,1,1,0,3,0,0,1,2,3,1,0,1,0,1,2
401402541,Montana State Bobcats,K. Limardo,4705201,,True,22.0,2,4,0,1,2,3,0,0,0,3,3,1,4,0,1,2,6
401402541,Montana State Bobcats,L. Beattie,4705202,,True,23.0,2,6,1,3,1,3,0,0,0,4,4,1,0,0,0,1,5
401402541,Montana State Bobcats,D. White,4594835,,True,28.0,8,17,8,16,0,1,6,8,0,0,0,6,4,0,2,0,22
401402541,Montana State Bobcats,M. Hughes,4899306,,False,2.0,0,0,0,0,0,0,0,0,0,0,0,0,0,0,0,0,0
401402541,Montana State Bobcats,T. Janssen,4705204,,False,21.0,6,12,4,7,2,5,0,0,3,2,5,0,1,1,1,1,14
401402541,Montana State Bobcats,L. Deden,4705203,,False,12.0,0,2,0,2,0,0,1,2,0,2,2,0,0,1,1,2,1
401402541,Montana State Bobcats,K. Stumne,4594838,,False,2.0,0,0,0,0,0,0,0,0,0,0,0,0,0,0,0,0,0
401402541,Montana State Bobcats,A. Ranson,4705200,,False,17.0,1,2,1,2,0,0,2,2,0,0,0,0,2,0,2,1,4
401402541,Montana State Bobcats,M. Jackson,4594837,,False,15.0,1,2,1,2,0,0,0,0,1,1,2,0,1,0,0,2,2
401402541,Montana State Bobcats,A. Van Sickle,4281659,,False,13.0,0,3,0,1,0,2,2,4,1,2,3,1,1,0,1,0,2
401402541,Montana State Bobcats,TEAM,TOTAL,TOTAL,False,,29,61,21,41,8,20,15,21,7,18,25,10,15,4,10,13,81
401402540,Northern Arizona Lumberjacks,K. Rasheed,4281671,,True,32.0,4,10,3,8,1,2,8,10,2,8,10,3,2,3,1,3,17
401402540,Northern Arizona Lumberjacks,N. Radford,4281730,,True,14.0,0,3,0,3,0,0,0,0,1,4,5,0,1,0,1,2,0
401402540,Northern Arizona Lumberjacks,E. Rodabaugh,4594845,,True,22.0,2,6,0,1,2,5,0,0,0,2,2,0,0,0,2,1,6
401402540,Northern Arizona Lumberjacks,R. Schenck,4399923,,True,31.0,1,6,1,5,0,1,2,2,0,4,4,2,0,0,2,4,4
401402540,Northern Arizona Lumberjacks,L. Orndoff,4281672,,True,34.0,7,12,4,7,3,5,1,2,0,1,1,1,4,0,3,1,18
401402540,Northern Arizona Lumberjacks,F. Jaiteh,4899311,,False,10.0,2,3,2,3,0,0,0,0,1,1,2,0,0,0,0,3,4
401402540,Northern Arizona Lumberjacks,S. Ramesh,4594846,,False,1.0,0,0,0,0,0,0,0,0,0,0,0,0,0,0,0,0,0
401402540,Northern Arizona Lumberjacks,S. Bryant,4399926,,False,1.0,0,1,0,1,0,0,0,0,1,0,1,0,0,0,0,0,0
401402540,Northern Arizona Lumberjacks,O. Moran,4704921,,False,20.0,4,9,3,7,1,2,3,3,1,2,3,2,1,0,0,2,12
401402540,Northern Arizona Lumberjacks,N. Moran,4704920,,False,6.0,0,1,0,1,0,0,0,0,0,0,0,1,0,0,1,1,0
401402540,Northern Arizona Lumberjacks,M. Maio,4595636,,False,29.0,6,11,6,11,0,0,2,5,0,2,2,2,2,1,3,2,14
401402540,Northern Arizona Lumberjacks,TEAM,TOTAL,TOTAL,False,,26,62,19,47,7,15,16,22,9,26,35,11,10,4,14,19,75
401402540,Montana Lady Griz,C. Gfeller,4399911,,True,35.0,5,13,4,11,1,2,3,4,1,4,5,1,0,0,2,3,14
401402540,Montana Lady Griz,A. Anderson,4281646,,True,36.0,3,4,3,4,0,0,3,4,2,9,11,1,3,4,6,3,9
401402540,Montana Lady Griz,H. Huard,4899302,,True,22.0,0,4,0,0,0,4,0,0,0,0,0,0,1,0,1,1,0
401402540,Montana Lady Griz,N. Morris-Nelson,4704794,,True,21.0,0,2,0,0,0,2,0,0,0,2,2,1,0,0,2,2,0
401402540,Montana Lady Griz,S. Stiles,4281645,,True,36.0,7,20,6,17,1,3,6,8,3,7,10,1,2,0,2,2,21
401402540,Montana Lady Griz,D. Bartsch,4899304,,False,4.0,0,0,0,0,0,0,2,2,0,1,1,0,0,0,0,0,2
401402540,Montana Lady Griz,K. Frohlich,4399910,,False,5.0,0,1,0,1,0,0,0,0,1,0,1,0,1,0,0,1,0
401402540,Montana Lady Griz,K. Keller,4704796,,False,8.0,0,1,0,1,0,0,0,0,0,1,1,0,0,0,2,0,0
401402540,Montana Lady Griz,K. Tsineke,4595927,,False,12.0,1,3,0,1,1,2,0,0,0,0,0,0,1,0,4,4,3
401402540,Montana Lady Griz,S. Fatkin,4281911,,False,20.0,2,7,2,7,0,0,4,5,1,2,3,3,0,0,2,2,8
401402540,Montana Lady Griz,TEAM,TOTAL,TOTAL,False,,18,55,15,42,3,13,18,23,11,26,37,7,8,4,22,18,57
401402539,Northern Colorado Bears,K. Harden,4594852,,True,31.0,10,16,10,16,0,0,3,5,1,8,9,1,0,0,2,1,23
401402539,Northern Colorado Bears,A. Downing,4708502,,True,31.0,2,7,1,4,1,3,2,2,2,4,6,2,0,0,2,1,7
401402539,Northern Colorado Bears,H. Simental,4705487,,True,32.0,4,9,2,5,2,4,4,4,0,3,3,1,0,0,3,3,14
401402539,Northern Colorado Bears,M. Isenbart,4399928,,True,24.0,2,3,2,3,0,0,3,4,3,3,6,1,0,0,1,1,7
401402539,Northern Colorado Bears,A. Chapman,4281679,,True,27.0,4,6,2,3,2,3,1,2,0,0,0,3,0,1,2,2,11
401402539,Northern Colorado Bears,Z. Campbell,4899530,,False,9.0,0,1,0,1,0,0,0,0,0,2,2,0,0,0,2,1,0
401402539,Northern Colorado Bears,J. Galloway,4705490,,False,7.0,0,0,0,0,0,0,0,0,0,0,0,0,1,0,0,0,0
401402539,Northern Colorado Bears,S. Stensgard,4705199,,False,14.0,1,1,0,0,1,1,0,0,0,2,2,1,0,0,2,1,3
401402539,Northern Colorado Bears,S. Lipe,4399618,,False,21.0,0,2,0,2,0,0,7,7,1,9,10,2,1,0,1,2,7
401402539,Northern Colorado Bears,J. Gorzeman,4282077,,False,4.0,0,0,0,0,0,0,0,0,0,0,0,0,0,0,0,1,0
401402539,Northern Colorado Bears,TEAM,TOTAL,TOTAL,False,,23,45,17,34,6,11,20,24,7,34,41,11,2,1,16,13,72
401402539,Idaho State Bengals,E. Smith,4281638,,True,19.0,4,6,4,6,0,0,0,0,1,0,1,2,0,0,0,5,8
401402539,Idaho State Bengals,T. Whitman,4594829,,True,33.0,3,12,1,5,2,7,0,2,3,2,5,0,0,1,2,0,8
401402539,Idaho State Bengals,D. Konate,4410113,,True,29.0,2,9,2,6,0,3,2,4,1,1,2,5,3,0,2,1,6
401402539,Idaho State Bengals,C. Bourne,4399905,,True,32.0,1,7,1,6,0,1,2,2,3,4,7,2,0,1,3,3,4
401402539,Idaho State Bengals,E. Ors,4068698,,True,29.0,3,10,2,6,1,4,0,0,2,4,6,2,2,0,1,4,7
401402539,Idaho State Bengals,K. Salmons,4899039,,False,0.0,0,0,0,0,0,0,0,0,0,0,0,0,1,0,0,0,0
401402539,Idaho State Bengals,M. Oltrogge,4399907,,False,24.0,3,11,3,9,0,2,1,1,2,3,5,1,1,0,0,2,7
401402539,Idaho State Bengals,F. Garnett,4704767,,False,14.0,4,6,3,5,1,1,2,2,0,1,1,0,1,0,0,2,11
401402539,Idaho State Bengals,D. Goles,4281636,,False,18.0,1,4,0,1,1,3,0,0,0,3,3,1,1,0,0,0,3
401402539,Idaho State Bengals,TEAM,TOTAL,TOTAL,False,,21,65,16,44,5,21,7,11,12,18,30,13,9,2,8,17,54
401402538,Portland State Vikings,S. Dhaliwal,4281681,,True,20.0,3,9,3,7,0,2,0,0,2,3,5,1,1,0,2,4,6
401402538,Portland State Vikings,R. Ogele,4899534,,True,22.0,9,12,9,12,0,0,5,7,3,6,9,1,1,0,2,3,23
401402538,Portland State Vikings,A. Fitzgerald,4899531,,True,21.0,0,7,0,4,0,3,0,0,0,4,4,1,0,1,1,0,0
401402538,Portland State Vikings,E. Morales,4899533,,True,31.0,3,10,2,6,1,4,4,4,1,1,2,1,1,0,1,2,11
401402538,Portland State Vikings,J. Lewis,4594856,,True,17.0,2,5,2,3,0,2,0,0,0,0,0,0,0,0,1,2,4
401402538,Portland State Vikings,M. Baird,4704918,,False,17.0,0,2,0,1,0,1,1,4,2,4,6,0,1,0,2,1,1
401402538,Portland State Vikings,R. Kelty,4704915,,False,3.0,0,0,0,0,0,0,0,0,0,2,2,0,0,1,0,0,0
401402538,Portland State Vikings,S. Schultz,4594857,,False,11.0,0,3,0,3,0,0,0,0,1,2,3,0,0,0,0,2,0
401402538,Portland State Vikings,M. Canzobre,4594854,,False,4.0,0,2,0,2,0,0,0,0,0,0,0,0,0,0,0,0,0
401402538,Portland State Vikings,J. Kilty,4704914,,False,14.0,0,2,0,1,0,1,0,0,0,1,1,1,1,0,1,0,0
401402538,Portland State Vikings,M. 'Uhila,4899532,,False,31.0,1,8,1,5,0,3,2,4,2,6,8,1,1,0,3,0,4
401402538,Portland State Vikings,I. Ugarte,4704916,,False,9.0,1,1,0,0,1,1,0,0,0,1,1,0,2,0,0,0,3
401402538,Portland State Vikings,TEAM,TOTAL,TOTAL,False,,19,61,17,44,2,17,12,19,11,31,42,6,8,2,15,14,52
401402538,Idaho Vandals,B. Bea,4594826,,True,29.0,5,11,5,11,0,0,2,4,3,13,16,2,1,2,2,1,12
401402538,Idaho Vandals,A. Wallace,4899034,,True,28.0,1,7,1,2,0,5,1,2,0,1,1,2,3,0,1,2,3
401402538,Idaho Vandals,S. Gandy,4704760,,True,23.0,2,5,0,0,2,5,0,0,0,0,0,2,0,0,1,2,6
401402538,Idaho Vandals,T. Johnson,4281684,,True,29.0,9,16,9,14,0,2,0,0,3,3,6,1,1,1,0,1,18
401402538,Idaho Vandals,A. Kirby,4281627,,True,29.0,4,8,0,1,4,7,2,2,1,3,4,7,0,0,0,2,14
401402538,Idaho Vandals,S. Bea,4899036,,False,2.0,0,1,0,1,0,0,0,2,2,0,2,0,0,0,0,0,0
401402538,Idaho Vandals,M. Rubino,4899035,,False,3.0,1,2,1,2,0,0,0,0,0,1,1,0,1,1,0,1,2
401402538,Idaho Vandals,J. Allred,4899037,,False,10.0,0,3,0,0,0,3,0,0,0,3,3,1,0,0,3,0,0
401402538,Idaho Vandals,R. Alexander,4704759,,False,4.0,0,1,0,0,0,1,0,0,0,0,0,1,0,0,0,0,0
401402538,Idaho Vandals,P. Atchley,4704758,,False,14.0,0,0,0,0,0,0,0,0,0,3,3,0,0,0,1,2,0
401402538,Idaho Vandals,C. Milne,4399904,,False,5.0,0,1,0,0,0,1,0,0,0,1,1,1,0,0,1,1,0
401402538,Idaho Vandals,L. Forsyth,4281998,,False,24.0,7,15,5,11,2,4,4,5,2,1,3,1,0,0,0,2,20
401402538,Idaho Vandals,TEAM,TOTAL,TOTAL,False,,29,70,21,42,8,28,9,15,12,30,42,18,6,4,9,14,75
401402537,Weber State Wildcats,J. Matthews,4594879,,True,37.0,2,7,2,7,0,0,1,2,8,5,13,2,0,0,1,4,5
401402537,Weber State Wildcats,D. Hickok,4594877,,True,33.0,4,6,4,6,0,0,11,12,2,1,3,2,1,0,2,3,19
401402537,Weber State Wildcats,E. Torbert,4400135,,True,39.0,7,22,6,18,1,4,0,0,4,8,12,4,3,1,2,0,15
401402537,Weber State Wildcats,A. Solovi,4594878,,True,33.0,6,12,3,5,3,7,5,6,0,1,1,6,2,0,0,3,20
401402537,Weber State Wildcats,K. Pentzer,4399951,,True,40.0,5,12,2,7,3,5,2,2,1,2,3,0,0,1,0,0,15
401402537,Weber State Wildcats,V. Parra,4594876,,False,1.0,0,0,0,0,0,0,0,0,0,0,0,0,0,0,0,0,0
401402537,Weber State Wildcats,K. Lesane,4899560,,False,5.0,0,1,0,1,0,0,0,0,0,1,1,0,1,0,0,0,0
401402537,Weber State Wildcats,E. Lovell,4899559,,False,2.0,0,1,0,0,0,1,0,0,0,0,0,0,0,0,0,0,0
401402537,Weber State Wildcats,L. Taylor,4899557,,False,7.0,0,1,0,0,0,1,0,0,0,0,0,0,1,0,0,1,0
401402537,Weber State Wildcats,A. Williams,4400178,,False,3.0,0,0,0,0,0,0,0,0,0,1,1,0,0,0,0,0,0
401402537,Weber State Wildcats,TEAM,TOTAL,TOTAL,False,,24,62,17,44,7,18,19,22,18,20,38,14,8,2,5,11,74
401402537,Sacramento State Hornets,I. Natabou,4899543,,True,24.0,5,6,5,6,0,0,0,0,3,3,6,0,0,1,2,3,10
401402537,Sacramento State Hornets,K. Peneueta,4899542,,True,34.0,3,5,0,0,3,5,2,2,0,5,5,0,0,2,1,3,11
401402537,Sacramento State Hornets,J. Carrasco,4704909,,True,35.0,2,8,0,4,2,4,0,0,0,0,0,3,2,0,2,3,6
401402537,Sacramento State Hornets,S. Menke,4399937,,True,39.0,3,7,3,5,0,2,4,4,0,5,5,3,1,0,1,2,10
401402537,Sacramento State Hornets,L. Tillman,4282044,,True,40.0,10,25,10,18,0,7,3,3,1,0,1,4,1,1,3,0,23
401402537,Sacramento State Hornets,N. Munguia,4704913,,False,12.0,0,0,0,0,0,0,0,0,0,2,2,1,0,0,0,0,0
401402537,Sacramento State Hornets,J. Olivares,4594861,,False,13.0,0,0,0,0,0,0,1,2,0,2,2,0,1,0,1,4,1
401402537,Sacramento State Hornets,E. Enochs,4399939,,False,3.0,1,1,0,0,1,1,0,0,0,0,0,0,0,0,0,0,3
401402537,Sacramento State Hornets,TEAM,TOTAL,TOTAL,False,,24,52,18,33,6,19,10,11,7,18,25,11,5,4,10,15,64
401402536,Northern Colorado Bears,K. Harden,4594852,,True,28.0,4,9,4,9,0,0,5,8,3,10,13,2,0,3,2,1,13
401402536,Northern Colorado Bears,A. Downing,4708502,,True,29.0,5,7,1,2,4,5,0,0,4,3,7,0,1,1,2,0,14
401402536,Northern Colorado Bears,H. Simental,4705487,,True,27.0,3,6,1,4,2,2,3,4,0,3,3,1,1,0,2,0,11
401402536,Northern Colorado Bears,M. Isenbart,4399928,,True,23.0,1,6,1,5,0,1,2,2,2,7,9,2,0,1,2,1,4
401402536,Northern Colorado Bears,A. Chapman,4281679,,True,25.0,5,10,4,8,1,2,0,0,1,1,2,1,1,0,0,2,11
401402536,Northern Colorado Bears,C. Boyles,4703967,,False,2.0,0,0,0,0,0,0,0,0,0,0,0,0,0,0,0,0,0
401402536,Northern Colorado Bears,Z. Campbell,4899530,,False,12.0,2,4,2,3,0,1,2,2,2,1,3,0,0,0,3,0,6
401402536,Northern Colorado Bears,J. Galloway,4705490,,False,14.0,0,1,0,1,0,0,0,0,1,1,2,0,1,0,1,2,0
401402536,Northern Colorado Bears,S. Stensgard,4705199,,False,7.0,1,1,1,1,0,0,0,0,0,2,2,0,0,0,2,0,2
401402536,Northern Colorado Bears,S. Lipe,4399618,,False,20.0,0,4,0,4,0,0,0,0,0,4,4,3,0,0,1,3,0
401402536,Northern Colorado Bears,J. Gorzeman,4282077,,False,13.0,1,2,0,0,1,2,0,0,0,1,1,1,0,0,0,1,3
401402536,Northern Colorado Bears,TEAM,TOTAL,TOTAL,False,,22,50,14,37,8,13,12,16,14,34,48,10,4,5,18,10,64
401402536,Eastern Washington Eagles,M. Knowles,4399898,,True,33.0,4,8,4,8,0,0,0,0,2,2,4,4,0,0,0,3,8
401402536,Eastern Washington Eagles,J. Martin,4899031,,True,32.0,4,13,2,9,2,4,4,6,0,3,3,0,1,0,3,3,14
401402536,Eastern Washington Eagles,A. Zylak,4899029,,True,18.0,0,6,0,4,0,2,0,0,0,1,1,1,0,1,1,1,0
401402536,Eastern Washington Eagles,J. Lawrence,4899032,,True,24.0,2,7,1,4,1,3,0,0,1,0,1,0,0,0,0,1,5
401402536,Eastern Washington Eagles,J. Buckley,4595639,,True,35.0,5,12,5,10,0,2,2,2,5,3,8,3,4,1,2,0,12
401402536,Eastern Washington Eagles,N. Cunill,4704747,,False,1.0,0,0,0,0,0,0,0,0,0,0,0,0,0,0,0,0,0
401402536,Eastern Washington Eagles,J. Boesel,4282101,,False,19.0,0,6,0,0,0,6,0,0,0,2,2,1,0,0,0,2,0
401402536,Eastern Washington Eagles,B. Rice,4066514,,False,17.0,1,4,1,2,0,2,0,0,1,1,2,2,1,0,0,3,2
401402536,Eastern Washington Eagles,A. Pettis,4899028,,False,21.0,2,10,2,8,0,2,0,0,0,1,1,1,0,0,1,0,4
401402536,Eastern Washington Eagles,TEAM,TOTAL,TOTAL,False,,18,66,15,45,3,21,6,8,14,13,27,12,6,2,7,13,45
401402535,Villanova Wildcats,L. Garzon,4704605,,True,34.0,1,11,0,5,1,6,0,0,1,1,2,1,0,0,4,0,3
401402535,Villanova Wildcats,M. Siegrist,4399415,,True,40.0,7,17,6,11,1,6,1,2,1,0,1,2,2,1,4,3,16
401402535,Villanova Wildcats,Bria. Herlihy,4068169,,True,31.0,3,9,1,5,2,4,0,0,1,4,5,3,0,1,2,2,8
401402535,Villanova Wildcats,L. Olsen,4433815,,True,30.0,2,5,1,3,1,2,0,0,0,0,0,0,0,0,2,1,5
401402535,Villanova Wildcats,B. Mullin,4433296,,True,24.0,1,4,1,2,0,2,0,0,2,1,3,1,2,0,3,3,2
401402535,Villanova Wildcats,A. Cauley,4899025,,False,6.0,0,1,0,1,0,0,0,0,0,0,0,0,0,0,0,1,0
401402535,Villanova Wildcats,K. Orihel,4899024,,False,13.0,1,2,0,0,1,2,0,0,0,2,2,0,0,1,1,2,3
401402535,Villanova Wildcats,B. Runyan,4598592,,False,22.0,1,1,0,0,1,1,0,0,0,2,2,1,1,0,1,0,3
401402535,Villanova Wildcats,TEAM,TOTAL,TOTAL,False,,16,50,9,27,7,23,1,2,6,11,17,8,5,3,18,12,40
401402535,UConn Huskies,A. Edwards,4433408,,True,31.0,5,9,5,9,0,0,2,4,5,1,6,2,2,0,5,4,12
401402535,UConn Huskies,O. Nelson-Ododa,4398966,,True,23.0,4,4,4,4,0,0,3,3,1,4,5,4,1,1,2,2,11
401402535,UConn Huskies,A. Fudd,4433790,,True,36.0,4,5,4,4,0,1,1,2,1,0,1,2,3,0,1,0,9
401402535,UConn Huskies,N. Muhl,4433468,,True,19.0,0,1,0,0,0,1,1,2,0,2,2,1,3,0,2,1,1
401402535,UConn Huskies,C. Williams,4398965,,True,29.0,4,9,3,7,1,2,0,0,0,3,3,0,1,1,2,1,9
401402535,UConn Huskies,D. Juhász,4398938,,False,17.0,1,3,1,2,0,1,2,2,1,4,5,2,0,0,1,1,4
401402535,UConn Huskies,P. Bueckers,4433730,,False,9.0,1,4,1,3,0,1,0,0,0,1,1,1,0,0,1,0,2
401402535,UConn Huskies,C. Ducharme,4433534,,False,16.0,4,6,3,5,1,1,0,0,1,4,5,0,0,0,1,0,9
401402535,UConn Huskies,E. Westbrook,4280890,,False,20.0,6,11,5,6,1,5,0,0,0,4,4,3,0,0,1,0,13
401402535,UConn Huskies,TEAM,TOTAL,TOTAL,False,,29,52,26,40,3,12,9,13,11,28,39,15,10,2,17,9,70
401402534,Villanova Wildcats,L. Garzon,4704605,,True,38.0,4,11,2,5,2,6,3,6,2,2,4,1,2,0,4,1,13
401402534,Villanova Wildcats,M. Siegrist,4399415,,True,39.0,10,20,7,13,3,7,1,2,3,11,14,2,4,2,3,1,24
401402534,Villanova Wildcats,Bria. Herlihy,4068169,,True,38.0,7,14,4,7,3,7,0,0,1,7,8,3,1,1,3,2,17
401402534,Villanova Wildcats,L. Olsen,4433815,,True,35.0,2,4,1,2,1,2,5,6,0,3,3,4,1,0,2,1,10
401402534,Villanova Wildcats,B. Mullin,4433296,,True,30.0,0,2,0,0,0,2,0,0,1,2,3,2,0,0,3,4,0
401402534,Villanova Wildcats,K. Orihel,4899024,,False,8.0,0,1,0,0,0,1,0,0,0,1,1,0,1,0,0,2,0
401402534,Villanova Wildcats,B. Runyan,4598592,,False,12.0,0,0,0,0,0,0,0,0,1,1,2,0,0,0,0,0,0
401402534,Villanova Wildcats,TEAM,TOTAL,TOTAL,False,,23,52,14,27,9,25,9,14,9,30,39,12,9,3,18,11,64
401402534,Seton Hall Pirates,M. Bembry,4433041,,True,33.0,0,3,0,3,0,0,0,0,1,6,7,0,4,0,4,1,0
401402534,Seton Hall Pirates,S. Cooks,4281245,,True,34.0,8,17,7,15,1,2,2,3,0,7,7,0,0,1,5,4,19
401402534,Seton Hall Pirates,M. Jackson,4595161,,True,33.0,0,6,0,2,0,4,0,0,2,1,3,3,1,0,1,3,0
401402534,Seton Hall Pirates,L. Park-Lane,4433379,,True,40.0,7,14,6,9,1,5,9,10,0,3,3,3,0,0,2,2,24
401402534,Seton Hall Pirates,A. Espinoza-Hunter,4281075,,True,36.0,5,12,4,6,1,6,1,2,0,2,2,1,3,0,1,1,12
401402534,Seton Hall Pirates,A. Wright,4704306,,False,11.0,0,0,0,0,0,0,0,0,0,0,0,0,0,0,0,2,0
401402534,Seton Hall Pirates,C. Dean,4704305,,False,8.0,0,3,0,2,0,1,0,0,0,2,2,0,1,0,0,1,0
401402534,Seton Hall Pirates,K. Armstrong,4068589,,False,5.0,0,1,0,1,0,0,0,0,1,0,1,0,0,0,0,0,0
401402534,Seton Hall Pirates,TEAM,TOTAL,TOTAL,False,,20,56,17,38,3,18,12,15,7,22,29,7,9,1,13,14,55
401402533,UConn Huskies,A. Edwards,4433408,,True,30.0,4,9,4,9,0,0,0,0,4,7,11,0,1,0,2,2,8
401402533,UConn Huskies,O. Nelson-Ododa,4398966,,True,22.0,4,7,4,7,0,0,0,0,1,6,7,2,0,0,2,3,8
401402533,UConn Huskies,A. Fudd,4433790,,True,28.0,1,9,1,4,0,5,2,2,0,2,2,3,1,1,1,1,4
401402533,UConn Huskies,N. Muhl,4433468,,True,22.0,3,3,2,2,1,1,0,0,1,3,4,1,0,0,0,3,7
401402533,UConn Huskies,C. Williams,4398965,,True,27.0,6,9,6,7,0,2,1,2,0,2,2,2,0,0,1,1,13
401402533,UConn Huskies,D. Juhász,4398938,,False,19.0,4,5,1,1,3,4,2,4,0,4,4,3,1,0,2,2,13
401402533,UConn Huskies,P. Bueckers,4433730,,False,18.0,1,4,1,4,0,0,0,0,0,2,2,2,1,1,3,0,2
401402533,UConn Huskies,C. Ducharme,4433534,,False,15.0,1,3,1,1,0,2,0,0,0,3,3,2,0,0,0,1,2
401402533,UConn Huskies,E. Westbrook,4280890,,False,19.0,5,9,2,5,3,4,1,1,1,3,4,2,1,0,3,0,14
401402533,UConn Huskies,TEAM,TOTAL,TOTAL,False,,29,58,22,40,7,18,6,9,8,33,41,17,5,2,14,13,71
401402533,Marquette Golden Eagles,L. Karlen,4703796,,True,31.0,1,11,1,10,0,1,2,2,1,5,6,1,1,0,1,3,4
401402533,Marquette Golden Eagles,C. Marotta,4399360,,True,28.0,2,5,2,5,0,0,0,0,3,2,5,0,0,0,2,3,4
401402533,Marquette Golden Eagles,L. Van Kleunen,4068083,,True,35.0,4,16,3,14,1,2,0,0,2,4,6,0,1,0,3,1,9
401402533,Marquette Golden Eagles,J. King,4595151,,True,31.0,5,10,5,9,0,1,2,2,1,2,3,2,0,0,2,3,12
401402533,Marquette Golden Eagles,K. McLaughlin,4281277,,True,40.0,5,16,2,5,3,11,2,2,0,1,1,2,1,0,1,0,15
401402533,Marquette Golden Eagles,J. Okosun,4703795,,False,3.0,0,0,0,0,0,0,0,0,0,0,0,0,0,0,0,0,0
401402533,Marquette Golden Eagles,K. Myles,4594770,,False,6.0,0,0,0,0,0,0,0,0,1,1,2,1,0,0,1,2,0
401402533,Marquette Golden Eagles,R. Nkumu,4599129,,False,4.0,0,1,0,1,0,0,0,0,0,3,3,0,0,0,0,1,0
401402533,Marquette Golden Eagles,D. Middleton,4598614,,False,10.0,1,3,1,2,0,1,0,0,0,1,1,0,1,0,0,2,2
401402533,Marquette Golden Eagles,A. Walker,4400574,,False,12.0,2,2,1,1,1,1,0,0,1,1,2,1,0,0,1,0,5
401402533,Marquette Golden Eagles,TEAM,TOTAL,TOTAL,False,,20,64,15,47,5,17,6,6,10,23,33,7,4,0,11,15,51
401402532,Seton Hall Pirates,M. Bembry,4433041,,True,40.0,6,8,6,8,0,0,0,0,4,6,10,2,1,1,1,4,12
401402532,Seton Hall Pirates,S. Cooks,4281245,,True,35.0,10,20,10,18,0,2,0,0,1,7,8,2,0,3,0,1,20
401402532,Seton Hall Pirates,M. Jackson,4595161,,True,40.0,2,4,1,1,1,3,0,0,3,3,6,2,0,0,2,1,5
401402532,Seton Hall Pirates,L. Park-Lane,4433379,,True,40.0,6,16,5,10,1,6,1,1,1,1,2,8,0,0,5,3,14
401402532,Seton Hall Pirates,A. Espinoza-Hunter,4281075,,True,40.0,4,14,0,7,4,7,1,2,0,8,8,1,2,0,2,1,13
401402532,Seton Hall Pirates,C. Dean,4704305,,False,2.0,0,1,0,0,0,1,0,0,0,0,0,0,0,0,0,0,0
401402532,Seton Hall Pirates,K. Armstrong,4068589,,False,3.0,1,1,1,1,0,0,0,0,0,0,0,0,0,0,1,0,2
401402532,Seton Hall Pirates,TEAM,TOTAL,TOTAL,False,,29,64,23,45,6,19,2,3,9,29,38,15,3,4,11,10,66
401402532,Creighton Bluejays,E. Ronsiek,4598617,,True,33.0,6,13,6,10,0,3,1,3,1,2,3,6,1,0,1,0,13
401402532,Creighton Bluejays,C. Bachelor,4594814,,True,17.0,4,9,3,5,1,4,0,0,0,2,2,1,2,0,0,1,9
401402532,Creighton Bluejays,L. Jensen,4597505,,True,30.0,5,11,3,5,2,6,0,0,0,7,7,1,0,0,3,0,12
401402532,Creighton Bluejays,P. Brotzki,4399333,,True,18.0,2,4,0,1,2,3,2,2,0,3,3,2,1,0,2,2,8
401402532,Creighton Bluejays,T. Rembao,4281361,,True,35.0,5,11,3,8,2,3,0,0,2,1,3,4,2,0,1,3,12
401402532,Creighton Bluejays,M. Brake,4703757,,False,4.0,0,0,0,0,0,0,0,0,0,0,0,0,0,0,0,0,0
401402532,Creighton Bluejays,M. Mogensen,4703758,,False,14.0,0,4,0,4,0,0,0,0,2,2,4,2,0,0,1,0,0
401402532,Creighton Bluejays,M. Maly,4599199,,False,26.0,3,10,2,5,1,5,2,2,1,3,4,0,0,0,0,0,9
401402532,Creighton Bluejays,R. Saunders,4399331,,False,23.0,1,4,1,3,0,1,0,0,3,3,6,3,1,0,2,4,2
401402532,Creighton Bluejays,TEAM,TOTAL,TOTAL,False,,26,66,18,41,8,25,5,7,12,25,37,19,7,0,10,10,65
401402531,Villanova Wildcats,L. Garzon,4704605,,True,31.0,6,14,4,6,2,8,1,2,0,3,3,1,1,0,1,1,15
401402531,Villanova Wildcats,M. Siegrist,4399415,,True,35.0,10,19,9,14,1,5,3,4,2,6,8,1,1,0,0,2,24
401402531,Villanova Wildcats,Bria. Herlihy,4068169,,True,29.0,5,10,3,7,2,3,4,6,5,12,17,6,1,0,0,2,16
401402531,Villanova Wildcats,L. Olsen,4433815,,True,31.0,4,17,0,8,4,9,1,2,0,1,1,4,1,0,0,2,13
401402531,Villanova Wildcats,B. Mullin,4433296,,True,30.0,0,0,0,0,0,0,0,0,2,2,4,2,1,2,1,2,0
401402531,Villanova Wildcats,C. Dalce,4618079,,False,1.0,1,1,1,1,0,0,0,0,0,0,0,0,0,0,1,1,2
401402531,Villanova Wildcats,A. Cauley,4899025,,False,1.0,0,0,0,0,0,0,0,0,0,0,0,0,0,0,0,0,0
401402531,Villanova Wildcats,K. Orihel,4899024,,False,10.0,0,0,0,0,0,0,0,0,0,0,0,1,0,0,0,2,0
401402531,Villanova Wildcats,Z. Jones,4899023,,False,1.0,0,0,0,0,0,0,0,0,0,0,0,0,0,0,0,0,0
401402531,Villanova Wildcats,K. Gardler,4704604,,False,4.0,0,0,0,0,0,0,0,0,0,0,0,0,0,0,1,0,0
401402531,Villanova Wildcats,B. Runyan,4598592,,False,27.0,1,2,1,1,0,1,4,4,2,0,2,2,1,0,1,1,6
401402531,Villanova Wildcats,TEAM,TOTAL,TOTAL,False,,27,63,18,37,9,26,13,18,15,26,41,17,6,2,5,13,76
401402531,St. John's Red Storm,R. Peeples,4400372,,True,24.0,2,2,2,2,0,0,0,0,1,8,9,0,0,0,0,3,4
401402531,St. John's Red Storm,D. Cosgrove,4398718,,True,25.0,1,8,1,3,0,5,0,0,0,2,2,0,1,1,1,3,2
401402531,St. John's Red Storm,L. Correa,4595156,,True,36.0,6,18,4,14,2,4,1,2,1,5,6,1,0,0,0,2,15
401402531,St. John's Red Storm,U. Drake,4433332,,True,30.0,2,8,2,7,0,1,0,0,0,0,0,2,0,0,2,1,4
401402531,St. John's Red Storm,C. Clegg,4398573,,True,17.0,0,1,0,1,0,0,0,0,0,0,0,0,0,0,2,0,0
401402531,St. John's Red Storm,E. Nolan,4595159,,False,8.0,0,2,0,1,0,1,0,0,1,1,2,0,0,0,1,4,0
401402531,St. John's Red Storm,D. Patterson,4281207,,False,23.0,3,5,3,5,0,0,0,0,1,3,4,0,0,1,2,1,6
401402531,St. John's Red Storm,K. Burton,4899021,,False,1.0,0,0,0,0,0,0,0,0,0,0,0,0,0,0,0,0,0
401402531,St. John's Red Storm,S. Zabrecky,4704327,,False,1.0,1,1,1,1,0,0,0,0,0,0,0,0,0,0,0,0,2
401402531,St. John's Red Storm,K. Bailey,4399378,,False,35.0,8,13,7,10,1,3,2,3,2,1,3,1,1,2,1,0,19
401402531,St. John's Red Storm,TEAM,TOTAL,TOTAL,False,,23,58,20,44,3,14,3,5,9,22,31,4,2,4,9,14,52
401402530,Marquette Golden Eagles,L. Karlen,4703796,,True,35.0,12,15,12,15,0,0,2,4,5,9,14,2,1,1,4,1,26
401402530,Marquette Golden Eagles,C. Marotta,4399360,,True,35.0,5,5,5,5,0,0,2,2,1,7,8,4,0,0,2,5,12
401402530,Marquette Golden Eagles,L. Van Kleunen,4068083,,True,36.0,9,14,9,13,0,1,2,3,3,3,6,5,0,0,1,2,20
401402530,Marquette Golden Eagles,J. King,4595151,,True,37.0,9,12,9,12,0,0,3,3,0,6,6,4,2,1,7,0,21
401402530,Marquette Golden Eagles,K. McLaughlin,4281277,,True,36.0,5,13,1,4,4,9,4,4,0,4,4,4,0,0,1,0,18
401402530,Marquette Golden Eagles,J. Okosun,4703795,,False,1.0,0,0,0,0,0,0,0,0,0,0,0,0,0,0,1,0,0
401402530,Marquette Golden Eagles,K. Myles,4594770,,False,1.0,1,1,1,1,0,0,0,0,0,0,0,0,0,0,0,0,2
401402530,Marquette Golden Eagles,R. Nkumu,4599129,,False,7.0,0,1,0,1,0,0,0,0,0,1,1,2,1,0,0,0,0
401402530,Marquette Golden Eagles,D. Middleton,4598614,,False,1.0,0,0,0,0,0,0,0,0,0,0,0,0,0,0,0,0,0
401402530,Marquette Golden Eagles,A. Walker,4400574,,False,11.0,3,6,3,6,0,0,0,0,1,3,4,0,0,0,2,0,6
401402530,Marquette Golden Eagles,TEAM,TOTAL,TOTAL,False,,44,67,40,57,4,10,13,16,11,38,49,21,4,2,19,8,105
401402530,DePaul Blue Demons,A. Morrow,4684384,,True,37.0,10,20,8,15,2,5,7,10,2,4,6,1,5,0,0,2,29
401402530,DePaul Blue Demons,D. Rogers,4433475,,True,22.0,1,6,1,3,0,3,0,0,1,1,2,0,0,0,1,2,2
401402530,DePaul Blue Demons,S. Morris,4399343,,True,35.0,8,19,7,15,1,4,0,0,0,2,2,1,2,0,4,1,17
401402530,DePaul Blue Demons,L. Held,4399342,,True,37.0,6,11,5,7,1,4,0,0,1,1,2,2,2,0,0,3,13
401402530,DePaul Blue Demons,D. Church,4281244,,True,37.0,7,13,6,11,1,2,0,0,0,5,5,4,3,0,0,3,15
401402530,DePaul Blue Demons,K. Collier,4282186,,False,27.0,3,6,3,4,0,2,1,1,0,0,0,0,2,0,1,2,7
401402530,DePaul Blue Demons,D. Bekelja,4281356,,False,5.0,1,1,1,1,0,0,0,0,0,0,0,0,0,0,0,0,2
401402530,DePaul Blue Demons,TEAM,TOTAL,TOTAL,False,,36,76,31,56,5,20,8,11,4,13,17,8,14,0,6,13,85
401402529,UConn Huskies,A. Edwards,4433408,,True,25.0,6,7,6,7,0,0,2,2,3,4,7,3,2,0,1,1,14
401402529,UConn Huskies,O. Nelson-Ododa,4398966,,True,20.0,1,1,1,1,0,0,2,4,2,3,5,2,1,1,3,2,4
401402529,UConn Huskies,A. Fudd,4433790,,True,25.0,4,13,1,3,3,10,0,0,1,1,2,2,1,0,0,0,11
401402529,UConn Huskies,N. Muhl,4433468,,True,20.0,1,4,1,2,0,2,0,0,0,3,3,6,1,0,2,2,2
401402529,UConn Huskies,C. Williams,4398965,,True,29.0,6,11,3,4,3,7,0,1,1,4,5,1,5,0,2,2,15
401402529,UConn Huskies,A. Deberry,4433516,,False,2.0,2,3,2,3,0,0,0,0,0,0,0,0,0,0,1,0,4
401402529,UConn Huskies,D. Juhász,4398938,,False,16.0,2,4,2,4,0,0,3,4,3,4,7,1,1,0,0,0,7
401402529,UConn Huskies,P. Gabriel,4433455,,False,2.0,0,0,0,0,0,0,0,0,0,0,0,1,0,0,0,0,0
401402529,UConn Huskies,P. Bueckers,4433730,,False,18.0,6,9,2,4,4,5,0,1,0,5,5,4,1,0,2,0,16
401402529,UConn Huskies,C. Ducharme,4433534,,False,22.0,2,8,1,4,1,4,1,2,1,2,3,1,0,2,0,1,6
401402529,UConn Huskies,E. Westbrook,4280890,,False,21.0,2,4,1,2,1,2,0,0,1,1,2,3,1,0,1,1,5
401402529,UConn Huskies,TEAM,TOTAL,TOTAL,False,,32,64,20,34,12,30,8,14,15,29,44,24,13,3,13,9,84
401402529,Georgetown Hoyas,B. Scott,4899012,,True,20.0,1,3,1,2,0,1,0,0,1,0,1,1,2,0,0,0,2
401402529,Georgetown Hoyas,J. Archer,4398822,,True,15.0,1,4,1,4,0,0,0,0,3,3,6,0,0,0,1,0,2
401402529,Georgetown Hoyas,A. Jenkins,4899013,,True,12.0,1,4,0,1,1,3,0,0,0,0,0,0,1,0,2,1,3
401402529,Georgetown Hoyas,M. Bolden-Morris,4281188,,True,31.0,3,16,1,3,2,13,0,0,0,3,3,1,1,0,3,1,8
401402529,Georgetown Hoyas,K. West,4282559,,True,36.0,2,11,1,5,1,6,0,0,0,3,3,3,1,0,6,1,5
401402529,Georgetown Hoyas,K. Myricks,4899014,,False,1.0,0,0,0,0,0,0,0,0,0,0,0,0,0,0,0,0,0
401402529,Georgetown Hoyas,G. Bennett,4595143,,False,20.0,1,2,0,1,1,1,1,2,0,1,1,0,0,2,3,2,4
401402529,Georgetown Hoyas,S. Wright,4399352,,False,12.0,0,2,0,2,0,0,0,0,0,1,1,0,0,0,0,4,0
401402529,Georgetown Hoyas,A. Kelava,4066593,,False,16.0,0,0,0,0,0,0,0,0,1,0,1,0,0,0,0,1,0
401402529,Georgetown Hoyas,N. Jasper,4899011,,False,1.0,1,1,0,0,1,1,0,0,0,0,0,0,0,0,1,0,3
401402529,Georgetown Hoyas,T. Flaherty,4433784,,False,8.0,0,0,0,0,0,0,1,3,0,0,0,0,0,0,0,0,1
401402529,Georgetown Hoyas,Y. Ott,4433768,,False,3.0,0,0,0,0,0,0,0,0,0,0,0,0,0,0,2,0,0
401402529,Georgetown Hoyas,M. Clougherty,4281010,,False,25.0,4,8,2,3,2,5,0,0,0,4,4,2,1,0,3,2,10
401402529,Georgetown Hoyas,TEAM,TOTAL,TOTAL,False,,14,51,6,21,8,30,2,5,7,20,27,7,6,2,23,12,38
401402528,Seton Hall Pirates,M. Bembry,4433041,,True,35.0,6,15,6,15,0,0,0,0,5,3,8,1,1,0,0,0,12
401402528,Seton Hall Pirates,S. Cooks,4281245,,True,37.0,6,16,5,11,1,5,0,0,1,7,8,3,3,0,0,1,13
401402528,Seton Hall Pirates,M. Jackson,4595161,,True,36.0,1,4,1,3,0,1,1,2,3,7,10,3,0,1,2,1,3
401402528,Seton Hall Pirates,L. Park-Lane,4433379,,True,38.0,8,17,5,12,3,5,2,2,0,3,3,0,2,0,2,0,21
401402528,Seton Hall Pirates,A. Espinoza-Hunter,4281075,,True,36.0,3,14,3,8,0,6,1,2,4,2,6,5,4,1,2,1,7
401402528,Seton Hall Pirates,S. Treadwell,4598613,,False,2.0,0,0,0,0,0,0,0,0,0,0,0,0,1,0,0,0,0
401402528,Seton Hall Pirates,K. Harris,4595164,,False,1.0,0,0,0,0,0,0,0,0,0,0,0,0,0,0,0,0,0
401402528,Seton Hall Pirates,A. Wright,4704306,,False,2.0,0,0,0,0,0,0,0,0,0,0,0,1,0,0,0,0,0
401402528,Seton Hall Pirates,C. Dean,4704305,,False,5.0,0,0,0,0,0,0,0,0,0,0,0,0,0,0,0,1,0
401402528,Seton Hall Pirates,D. Robinson,4399386,,False,1.0,0,0,0,0,0,0,0,0,0,0,0,0,0,0,0,0,0
401402528,Seton Hall Pirates,K. Armstrong,4068589,,False,7.0,1,1,1,1,0,0,0,0,0,0,0,0,0,1,0,1,2
401402528,Seton Hall Pirates,TEAM,TOTAL,TOTAL,False,,25,67,21,50,4,17,4,6,15,24,39,13,11,3,6,5,58
401402528,Butler Bulldogs,S. Jaynes,4899006,,True,29.0,4,10,3,7,1,3,1,5,0,5,5,1,0,1,3,0,10
401402528,Butler Bulldogs,C. Taborn,4281029,,True,28.0,3,8,3,8,0,0,0,0,2,5,7,0,0,1,1,2,6
401402528,Butler Bulldogs,T. White,4899003,,True,28.0,2,9,2,7,0,2,0,0,3,3,6,0,0,0,5,0,4
401402528,Butler Bulldogs,T. Dowell,4594807,,True,18.0,0,4,0,1,0,3,0,0,1,4,5,1,0,0,3,2,0
401402528,Butler Bulldogs,E. Sexton,4399329,,True,33.0,3,6,1,3,2,3,0,0,1,2,3,0,0,0,1,1,8
401402528,Butler Bulldogs,K. Tanner,4899007,,False,16.0,1,2,1,2,0,0,0,0,1,0,1,0,1,0,1,1,2
401402528,Butler Bulldogs,E. Ross,4399330,,False,7.0,0,0,0,0,0,0,0,0,0,0,0,0,0,0,0,1,0
401402528,Butler Bulldogs,Z. Jackson,4899004,,False,23.0,2,6,0,1,2,5,0,0,1,4,5,5,0,0,2,1,6
401402528,Butler Bulldogs,K. Wingler,4705073,,False,18.0,1,3,0,2,1,1,0,0,1,0,1,1,0,0,3,1,3
401402528,Butler Bulldogs,TEAM,TOTAL,TOTAL,False,,16,48,10,31,6,17,1,5,10,27,37,8,1,2,20,9,39
401402527,Xavier Musketeers,C. Prenger,4595177,,True,38.0,3,6,3,5,0,1,0,0,1,6,7,0,0,1,0,4,6
401402527,Xavier Musketeers,A. Harris,4899027,,True,27.0,5,8,5,8,0,0,0,0,0,3,3,1,1,0,1,4,10
401402527,Xavier Musketeers,A. Townsend,4399428,,True,32.0,8,14,8,14,0,0,2,2,4,6,10,0,0,1,1,4,18
401402527,Xavier Musketeers,M. Scarlett,4704671,,True,34.0,5,15,2,6,3,9,2,2,0,4,4,1,2,1,1,5,15
401402527,Xavier Musketeers,S. Beeler,4433039,,True,35.0,7,13,7,12,0,1,2,2,0,3,3,9,1,0,2,2,16
401402527,Xavier Musketeers,K. Woods,4899026,,False,10.0,0,4,0,1,0,3,0,0,0,2,2,0,0,0,0,0,0
401402527,Xavier Musketeers,S. Calhoun,4433753,,False,24.0,2,6,2,5,0,1,0,0,0,1,1,2,0,0,1,1,4
401402527,Xavier Musketeers,TEAM,TOTAL,TOTAL,False,,30,66,27,51,3,15,6,6,8,26,34,13,4,3,7,20,69
401402527,St. John's Red Storm,R. Peeples,4400372,,True,34.0,7,10,7,10,0,0,2,4,5,6,11,1,2,1,2,2,16
401402527,St. John's Red Storm,D. Cosgrove,4398718,,True,20.0,3,5,2,3,1,2,0,0,1,3,4,0,0,0,2,2,7
401402527,St. John's Red Storm,L. Correa,4595156,,True,37.0,3,12,3,9,0,3,6,6,1,8,9,2,0,0,1,0,12
401402527,St. John's Red Storm,K. Bailey,4399378,,True,34.0,5,12,3,8,2,4,5,5,2,4,6,2,2,2,1,2,17
401402527,St. John's Red Storm,C. Clegg,4398573,,True,25.0,1,7,1,2,0,5,0,0,0,0,0,4,0,0,1,2,2
401402527,St. John's Red Storm,E. Nolan,4595159,,False,3.0,1,2,1,2,0,0,1,1,1,2,3,1,0,0,0,0,3
401402527,St. John's Red Storm,D. Patterson,4281207,,False,23.0,4,7,3,5,1,2,1,2,0,1,1,0,0,1,0,1,10
401402527,St. John's Red Storm,S. Zabrecky,4704327,,False,3.0,0,0,0,0,0,0,0,0,0,0,0,0,0,0,0,0,0
401402527,St. John's Red Storm,U. Drake,4433332,,False,21.0,2,7,1,5,1,2,4,4,0,0,0,2,0,0,1,3,9
401402527,St. John's Red Storm,TEAM,TOTAL,TOTAL,False,,26,62,21,44,5,18,19,22,12,27,39,12,4,4,8,12,76
401402526,Providence Friars,A. Geary,4399375,,True,17.0,1,4,1,1,0,3,0,0,0,2,2,2,1,0,3,1,2
401402526,Providence Friars,M. Baskerville,4399373,,True,18.0,0,2,0,2,0,0,2,2,0,2,2,1,1,1,1,0,2
401402526,Providence Friars,K. Sheppard,4899015,,True,24.0,2,8,2,4,0,4,1,1,1,1,2,1,0,0,2,2,5
401402526,Providence Friars,G. Efosa-Aguebor,4704266,,True,30.0,1,2,1,2,0,0,1,2,1,4,5,3,2,0,4,1,3
401402526,Providence Friars,J. Crooms,4398937,,True,38.0,6,16,4,8,2,8,4,5,2,3,5,5,2,1,2,1,18
401402526,Providence Friars,E. Archibald,4899020,,False,23.0,7,9,1,1,6,8,1,2,1,2,3,1,1,0,1,3,21
401402526,Providence Friars,O. Olsen,4899019,,False,22.0,1,2,1,2,0,0,0,0,0,6,6,0,1,1,2,2,2
401402526,Providence Friars,L. Sampson,4595155,,False,6.0,0,2,0,0,0,2,0,0,0,0,0,0,0,0,2,0,0
401402526,Providence Friars,A. Koch,4899018,,False,8.0,0,0,0,0,0,0,0,0,1,0,1,1,0,0,1,3,0
401402526,Providence Friars,N. Scott,4899017,,False,14.0,1,6,1,3,0,3,0,0,2,1,3,1,0,0,2,2,2
401402526,Providence Friars,TEAM,TOTAL,TOTAL,False,,19,51,11,23,8,28,9,12,8,24,32,15,8,3,23,15,55
401402526,Georgetown Hoyas,B. Scott,4899012,,True,28.0,4,7,2,2,2,5,2,2,2,4,6,1,4,2,0,3,12
401402526,Georgetown Hoyas,A. Jenkins,4899013,,True,7.0,1,2,1,2,0,0,0,0,0,0,0,0,0,1,4,1,2
401402526,Georgetown Hoyas,M. Bolden-Morris,4281188,,True,38.0,7,19,4,9,3,10,1,1,0,1,1,0,2,0,2,3,18
401402526,Georgetown Hoyas,K. Ransom,4433769,,True,27.0,4,10,4,9,0,1,2,6,3,3,6,4,2,0,1,1,10
401402526,Georgetown Hoyas,K. West,4282559,,True,35.0,3,6,3,6,0,0,1,2,2,2,4,5,0,0,2,2,7
401402526,Georgetown Hoyas,G. Bennett,4595143,,False,25.0,3,7,1,4,2,3,5,6,3,4,7,0,0,0,4,4,13
401402526,Georgetown Hoyas,S. Wright,4399352,,False,9.0,2,3,2,3,0,0,0,0,1,1,2,0,0,2,0,0,4
401402526,Georgetown Hoyas,J. Archer,4398822,,False,12.0,0,1,0,1,0,0,0,0,1,3,4,0,0,0,0,3,0
401402526,Georgetown Hoyas,M. Clougherty,4281010,,False,19.0,1,6,1,1,0,5,0,2,1,2,3,0,1,0,2,1,2
401402526,Georgetown Hoyas,TEAM,TOTAL,TOTAL,False,,25,61,18,37,7,24,11,19,16,24,40,10,9,5,15,18,68
401402525,Texas Longhorns,D. Gaston,4433739,,True,20.0,1,3,1,3,0,0,0,0,1,3,4,0,0,2,1,3,2
401402525,Texas Longhorns,L. Ebo,4398943,,True,23.0,1,4,1,4,0,0,2,4,0,1,1,0,1,0,1,4,4
401402525,Texas Longhorns,R. Harmon,4433523,,True,40.0,8,10,8,10,0,0,4,4,0,5,5,5,1,0,0,1,20
401402525,Texas Longhorns,S. Holle,4433449,,True,18.0,3,5,3,4,0,1,1,2,3,3,6,0,0,0,3,1,7
401402525,Texas Longhorns,J. Allen-Taylor,4398984,,True,40.0,5,12,5,11,0,1,4,4,0,0,0,1,3,0,0,2,14
401402525,Texas Longhorns,A. Moore,4433794,,False,21.0,4,8,4,8,0,0,4,4,3,2,5,0,1,0,1,2,12
401402525,Texas Longhorns,L. Lattimore,4433517,,False,3.0,0,1,0,1,0,0,1,2,0,1,1,0,1,0,1,0,1
401402525,Texas Longhorns,A. Matharu,4433638,,False,22.0,1,8,0,4,1,4,2,2,0,2,2,2,1,0,2,3,5
401402525,Texas Longhorns,A. Warren,4398987,,False,13.0,1,1,1,1,0,0,0,0,0,3,3,2,1,1,0,1,2
401402525,Texas Longhorns,TEAM,TOTAL,TOTAL,False,,24,52,23,46,1,6,18,22,8,22,30,10,9,3,9,17,67
401402525,Baylor Bears,N. Smith,4398776,,True,33.0,7,13,7,10,0,3,7,9,1,9,10,0,0,1,3,3,21
401402525,Baylor Bears,Q. Egbo,4398779,,True,24.0,2,3,2,3,0,0,0,2,0,2,2,0,0,0,2,4,4
401402525,Baylor Bears,S. Andrews,4433407,,True,30.0,1,8,1,5,0,3,1,2,0,1,1,2,1,0,3,1,3
401402525,Baylor Bears,J. Asberry,4318562,,True,31.0,5,8,2,2,3,6,0,0,0,1,1,0,1,0,0,4,13
401402525,Baylor Bears,J. Lewis,4065687,,True,40.0,5,12,3,8,2,4,1,4,5,2,7,4,1,0,3,2,13
401402525,Baylor Bears,C. Bickle,4398780,,False,24.0,0,3,0,2,0,1,0,0,1,2,3,0,0,0,2,2,0
401402525,Baylor Bears,J. Owens,4432839,,False,18.0,1,1,1,1,0,0,2,3,0,1,1,2,0,0,2,2,4
401402525,Baylor Bears,TEAM,TOTAL,TOTAL,False,,21,48,16,31,5,17,11,20,9,22,31,8,3,1,16,18,58
401402523,Texas Longhorns,D. Gaston,4433739,,True,34.0,6,11,6,11,0,0,1,1,3,7,10,1,1,0,1,4,13
401402523,Texas Longhorns,L. Ebo,4398943,,True,35.0,5,9,5,9,0,0,4,5,2,5,7,4,3,4,2,4,14
401402523,Texas Longhorns,R. Harmon,4433523,,True,45.0,8,17,3,9,5,8,9,9,1,1,2,4,1,0,0,2,30
401402523,Texas Longhorns,S. Holle,4433449,,True,22.0,1,4,0,1,1,3,0,0,0,2,2,1,0,1,0,1,3
401402523,Texas Longhorns,J. Allen-Taylor,4398984,,True,45.0,5,13,2,9,3,4,0,0,0,1,1,2,0,0,2,1,13
401402523,Texas Longhorns,A. Moore,4433794,,False,2.0,0,0,0,0,0,0,0,0,0,0,0,0,0,0,0,0,0
401402523,Texas Longhorns,A. Matharu,4433638,,False,24.0,2,5,1,4,1,1,2,4,1,6,7,3,2,0,2,1,7
401402523,Texas Longhorns,A. Warren,4398987,,False,18.0,1,4,1,4,0,0,0,0,1,1,2,0,1,0,2,1,2
401402523,Texas Longhorns,TEAM,TOTAL,TOTAL,False,,28,63,18,47,10,16,16,19,10,24,34,15,8,5,11,14,82
401402523,Iowa State Cyclones,N. Diew,4599130,,True,31.0,2,4,1,3,1,1,0,0,0,2,2,1,1,0,0,1,5
401402523,Iowa State Cyclones,M. Kane,4398803,,True,21.0,1,5,1,4,0,1,0,0,2,0,2,2,0,0,2,3,2
401402523,Iowa State Cyclones,E. Ryan,4433436,,True,45.0,3,10,3,10,0,0,2,2,0,5,5,9,0,1,7,5,8
401402523,Iowa State Cyclones,L. Donarski,4433409,,True,43.0,4,10,1,4,3,6,0,0,0,0,0,0,2,0,3,4,11
401402523,Iowa State Cyclones,As. Joens,4398802,,True,45.0,13,27,9,17,4,10,3,3,4,9,13,0,0,0,3,2,33
401402523,Iowa State Cyclones,B. Jordao,4399242,,False,21.0,3,4,2,3,1,1,1,1,1,4,5,1,0,1,0,4,8
401402523,Iowa State Cyclones,M. Espenmiller-McGraw,4594688,,False,1.0,0,0,0,0,0,0,0,0,0,0,0,0,0,0,0,1,0
401402523,Iowa State Cyclones,Au. Joens,4433988,,False,18.0,2,2,0,0,2,2,0,0,1,3,4,0,1,0,0,1,6
401402523,Iowa State Cyclones,TEAM,TOTAL,TOTAL,False,,28,62,17,41,11,21,6,6,10,23,33,13,4,2,15,21,73
401402522,Oklahoma Sooners,L. Scott,4594693,,True,9.0,1,4,1,3,0,1,2,2,1,0,1,1,0,0,1,5,4
401402522,Oklahoma Sooners,M. Williams,4398883,,True,29.0,13,23,9,14,4,9,3,3,5,3,8,2,0,0,2,2,33
401402522,Oklahoma Sooners,N. Tot,4594275,,True,28.0,3,4,3,3,0,1,2,2,0,5,5,4,0,0,0,1,8
401402522,Oklahoma Sooners,K. Tucker,4433150,,True,20.0,1,3,1,3,0,0,2,2,0,2,2,1,0,0,1,2,4
401402522,Oklahoma Sooners,T. Robertson,4398884,,True,37.0,4,8,0,0,4,8,5,5,2,5,7,0,0,0,1,0,17
401402522,Oklahoma Sooners,N. Lampkin,4398882,,False,17.0,1,2,1,2,0,0,0,0,0,5,5,2,0,0,3,1,2
401402522,Oklahoma Sooners,S. Vann,4703432,,False,22.0,2,11,1,7,1,4,0,0,3,4,7,0,1,2,2,2,5
401402522,Oklahoma Sooners,K. Perkins,4899000,,False,11.0,0,1,0,1,0,0,0,0,1,1,2,0,0,0,0,1,0
401402522,Oklahoma Sooners,K. Washington,4898998,,False,21.0,0,5,0,1,0,4,1,2,0,1,1,3,0,0,2,2,1
401402522,Oklahoma Sooners,G. Gregory,4594692,,False,6.0,0,3,0,2,0,1,2,2,1,0,1,0,0,0,1,0,2
401402522,Oklahoma Sooners,TEAM,TOTAL,TOTAL,False,,25,64,16,36,9,28,17,18,14,28,42,13,1,2,13,16,76
401402522,Baylor Bears,N. Smith,4398776,,True,33.0,16,32,16,31,0,1,5,5,5,6,11,0,0,0,1,2,37
401402522,Baylor Bears,Q. Egbo,4398779,,True,22.0,3,9,3,9,0,0,5,6,3,2,5,2,0,2,0,2,11
401402522,Baylor Bears,S. Andrews,4433407,,True,33.0,2,6,1,3,1,3,0,0,1,1,2,4,3,0,0,2,5
401402522,Baylor Bears,J. Asberry,4318562,,True,32.0,3,7,0,2,3,5,0,0,0,4,4,3,0,0,0,4,9
401402522,Baylor Bears,J. Lewis,4065687,,True,35.0,3,7,1,2,2,5,0,0,1,4,5,6,2,0,1,1,8
401402522,Baylor Bears,C. Bickle,4398780,,False,25.0,8,14,7,12,1,2,4,4,4,2,6,1,0,0,0,4,21
401402522,Baylor Bears,J. Owens,4432839,,False,20.0,0,3,0,1,0,2,0,0,0,3,3,2,1,0,0,2,0
401402522,Baylor Bears,TEAM,TOTAL,TOTAL,False,,35,78,28,60,7,18,14,15,16,25,41,18,6,2,2,17,91
401402521,Texas Longhorns,D. Gaston,4433739,,True,21.0,2,4,2,4,0,0,4,4,0,2,2,0,0,0,2,1,8
401402521,Texas Longhorns,L. Ebo,4398943,,True,27.0,5,7,5,7,0,0,7,8,4,6,10,0,1,0,1,2,17
401402521,Texas Longhorns,R. Harmon,4433523,,True,35.0,5,14,4,10,1,4,5,6,0,4,4,4,2,0,4,3,16
401402521,Texas Longhorns,S. Holle,4433449,,True,15.0,0,4,0,3,0,1,0,0,1,1,2,0,0,1,0,0,0
401402521,Texas Longhorns,J. Allen-Taylor,4398984,,True,39.0,3,10,2,8,1,2,5,6,1,1,2,2,0,0,0,4,12
401402521,Texas Longhorns,A. Moore,4433794,,False,4.0,0,1,0,0,0,1,0,0,0,0,0,0,0,0,0,0,0
401402521,Texas Longhorns,L. Lattimore,4433517,,False,4.0,0,0,0,0,0,0,0,0,0,0,0,0,0,1,1,2,0
401402521,Texas Longhorns,A. Matharu,4433638,,False,25.0,5,7,0,1,5,6,0,0,2,2,4,3,3,0,2,1,15
401402521,Texas Longhorns,A. Warren,4398987,,False,30.0,0,4,0,4,0,0,4,4,2,1,3,3,0,1,1,5,4
401402521,Texas Longhorns,TEAM,TOTAL,TOTAL,False,,20,51,13,37,7,14,25,28,11,17,28,12,6,3,11,18,72
401402521,Kansas State Wildcats,A. Lee,4398964,,True,37.0,7,8,7,8,0,0,2,2,1,6,7,2,1,1,1,3,16
401402521,Kansas State Wildcats,B. Glenn,4898995,,True,28.0,2,4,2,4,0,0,4,4,0,3,3,0,3,0,4,5,8
401402521,Kansas State Wildcats,S. Sundell,4898994,,True,25.0,3,8,2,6,1,2,4,4,0,3,3,5,0,0,3,4,11
401402521,Kansas State Wildcats,J. Glenn,4691694,,True,35.0,3,7,2,2,1,5,0,0,0,2,2,3,2,1,3,4,7
401402521,Kansas State Wildcats,E. Ebert,4594690,,True,29.0,3,7,2,5,1,2,8,10,2,3,5,2,0,0,0,2,15
401402521,Kansas State Wildcats,L. Macke,4398962,,False,8.0,0,0,0,0,0,0,2,2,0,0,0,0,0,0,1,0,2
401402521,Kansas State Wildcats,T. Lauterbach,4594273,,False,4.0,1,1,1,1,0,0,0,0,0,1,1,0,0,0,1,0,2
401402521,Kansas State Wildcats,R. Dallinger,4898997,,False,2.0,0,0,0,0,0,0,0,0,0,0,0,0,0,0,0,0,0
401402521,Kansas State Wildcats,J. Moore,4597507,,False,11.0,0,2,0,1,0,1,0,0,0,0,0,1,0,0,0,3,0
401402521,Kansas State Wildcats,C. Goodrich,4281307,,False,21.0,2,4,2,4,0,0,0,0,0,3,3,1,0,0,1,1,4
401402521,Kansas State Wildcats,TEAM,TOTAL,TOTAL,False,,21,41,18,31,3,10,20,22,4,21,25,14,6,2,16,22,65
401402520,West Virginia Mountaineers,E. Martinez,4433353,,True,36.0,8,15,6,10,2,5,0,1,3,8,11,2,2,2,4,1,18
401402520,West Virginia Mountaineers,B. Ejiofor,4280899,,True,20.0,3,4,3,4,0,0,0,0,1,1,2,0,1,1,1,1,6
401402520,West Virginia Mountaineers,J. Quinerly,4434015,,True,37.0,5,16,5,11,0,5,5,5,2,1,3,5,5,1,3,4,15
401402520,West Virginia Mountaineers,J. Hemingway,4432991,,True,14.0,0,3,0,2,0,1,0,0,1,1,2,0,0,0,1,2,0
401402520,West Virginia Mountaineers,M. Smith,4398996,,True,38.0,1,6,1,3,0,3,0,0,0,3,3,7,4,0,3,2,2
401402520,West Virginia Mountaineers,A. Gray,4281368,,False,20.0,4,14,4,13,0,1,1,1,0,10,10,2,0,0,1,4,9
401402520,West Virginia Mountaineers,Y. Morris,4595175,,False,3.0,0,0,0,0,0,0,0,0,0,1,1,0,0,1,0,2,0
401402520,West Virginia Mountaineers,S. Samuel,4595356,,False,32.0,4,10,3,5,1,5,1,2,1,5,6,0,1,0,0,1,10
401402520,West Virginia Mountaineers,TEAM,TOTAL,TOTAL,False,,25,68,22,48,3,20,7,9,8,31,39,16,13,5,13,17,60
401402520,Iowa State Cyclones,N. Diew,4599130,,True,26.0,3,8,1,3,2,5,0,0,1,5,6,0,0,0,1,2,8
401402520,Iowa State Cyclones,M. Kane,4398803,,True,16.0,2,5,2,5,0,0,2,2,1,1,2,1,0,0,2,1,6
401402520,Iowa State Cyclones,E. Ryan,4433436,,True,40.0,5,11,4,8,1,3,3,3,0,5,5,6,4,1,5,2,14
401402520,Iowa State Cyclones,L. Donarski,4433409,,True,40.0,4,16,1,7,3,9,3,4,2,5,7,3,2,0,3,1,14
401402520,Iowa State Cyclones,As. Joens,4398802,,True,40.0,4,16,1,9,3,7,2,2,4,10,14,2,2,0,3,2,13
401402520,Iowa State Cyclones,B. Jordao,4399242,,False,21.0,2,4,2,4,0,0,0,0,4,8,12,1,0,3,3,1,4
401402520,Iowa State Cyclones,M. Espenmiller-McGraw,4594688,,False,8.0,1,4,0,0,1,4,1,2,0,1,1,0,0,0,1,0,4
401402520,Iowa State Cyclones,Au. Joens,4433988,,False,9.0,1,4,0,0,1,4,0,0,0,0,0,1,3,1,0,0,3
401402520,Iowa State Cyclones,TEAM,TOTAL,TOTAL,False,,22,68,11,36,11,32,11,13,15,37,52,14,11,5,18,9,66
401402519,Oklahoma State Cowgirls,T. Collins,4582912,,True,26.0,3,11,3,11,0,0,1,2,3,6,9,0,0,2,2,3,7
401402519,Oklahoma State Cowgirls,K. De Lapp,4398979,,True,20.0,3,4,3,4,0,0,3,5,1,1,2,1,0,0,2,3,9
401402519,Oklahoma State Cowgirls,L. Keys,4703518,,True,34.0,2,10,1,5,1,5,0,0,0,1,1,0,0,0,1,2,5
401402519,Oklahoma State Cowgirls,M. Dennis,4594696,,True,16.0,1,4,0,2,1,2,0,0,0,2,2,2,0,0,1,0,3
401402519,Oklahoma State Cowgirls,L. Fields,4433664,,True,29.0,0,11,0,7,0,4,0,2,0,4,4,2,1,0,4,1,0
401402519,Oklahoma State Cowgirls,M. James,4691726,,False,18.0,1,6,1,4,0,2,0,0,0,2,2,1,0,0,1,1,2
401402519,Oklahoma State Cowgirls,T. Garza,4682636,,False,4.0,0,2,0,1,0,1,0,0,0,0,0,0,0,0,0,0,0
401402519,Oklahoma State Cowgirls,K. Jackson,4433087,,False,3.0,0,0,0,0,0,0,0,0,0,0,0,0,0,1,2,0,0
401402519,Oklahoma State Cowgirls,A. Winchester,4281318,,False,10.0,0,1,0,1,0,0,0,0,1,1,2,0,2,1,1,1,0
401402519,Oklahoma State Cowgirls,B. Reeves,4703520,,False,1.0,0,1,0,1,0,0,0,0,0,0,0,0,0,0,0,0,0
401402519,Oklahoma State Cowgirls,R. Udoumoh,4597510,,False,8.0,0,1,0,1,0,0,2,2,0,2,2,1,0,0,0,0,2
401402519,Oklahoma State Cowgirls,N. Notoa,4703519,,False,16.0,1,3,0,1,1,2,0,0,0,2,2,2,1,0,0,0,3
401402519,Oklahoma State Cowgirls,N. Boyd,4595017,,False,3.0,0,1,0,0,0,1,0,0,0,0,0,0,0,0,0,0,0
401402519,Oklahoma State Cowgirls,S. Rodrigues,4594699,,False,12.0,2,2,1,1,1,1,0,0,0,2,2,0,0,2,1,4,5
401402519,Oklahoma State Cowgirls,TEAM,TOTAL,TOTAL,False,,13,57,9,39,4,18,6,11,9,27,36,9,4,6,17,15,36
401402519,Baylor Bears,N. Smith,4398776,,True,28.0,5,15,5,14,0,1,5,6,2,8,10,1,2,2,0,3,15
401402519,Baylor Bears,Q. Egbo,4398779,,True,23.0,6,12,6,12,0,0,3,3,2,11,13,0,2,5,1,1,15
401402519,Baylor Bears,S. Andrews,4433407,,True,23.0,4,6,3,4,1,2,0,0,0,1,1,3,0,0,1,0,9
401402519,Baylor Bears,J. Asberry,4318562,,True,33.0,6,9,4,4,2,5,2,2,1,0,1,2,2,0,3,0,16
401402519,Baylor Bears,J. Lewis,4065687,,True,26.0,3,6,2,4,1,2,2,2,0,4,4,5,0,0,0,0,9
401402519,Baylor Bears,K. Gillispie,4434027,,False,13.0,2,4,2,4,0,0,1,2,2,1,3,0,0,0,0,3,5
401402519,Baylor Bears,C. Bickle,4398780,,False,25.0,1,5,1,2,0,3,0,0,1,4,5,3,2,0,2,1,2
401402519,Baylor Bears,A. Katramados,4900792,,False,4.0,0,0,0,0,0,0,0,0,0,0,0,0,0,0,0,0,0
401402519,Baylor Bears,J. Owens,4432839,,False,25.0,2,6,1,4,1,2,0,0,1,2,3,3,1,0,2,0,5
401402519,Baylor Bears,TEAM,TOTAL,TOTAL,False,,29,63,24,48,5,15,13,15,9,33,42,17,9,7,9,8,76
401402517,Oklahoma Sooners,L. Scott,4594693,,True,17.0,5,8,4,6,1,2,0,0,4,4,8,1,1,2,4,3,11
401402517,Oklahoma Sooners,M. Williams,4398883,,True,30.0,6,19,3,10,3,9,4,8,1,10,11,7,1,0,3,3,19
401402517,Oklahoma Sooners,N. Tot,4594275,,True,23.0,3,7,1,3,2,4,0,0,0,2,2,5,1,0,1,2,8
401402517,Oklahoma Sooners,K. Tucker,4433150,,True,29.0,2,7,2,4,0,3,0,1,6,1,7,2,1,0,1,3,4
401402517,Oklahoma Sooners,T. Robertson,4398884,,True,32.0,6,11,3,4,3,7,4,4,0,7,7,3,3,0,2,0,19
401402517,Oklahoma Sooners,N. Lampkin,4398882,,False,15.0,2,6,2,6,0,0,2,2,0,5,5,2,0,0,2,1,6
401402517,Oklahoma Sooners,S. Vann,4703432,,False,20.0,2,7,2,3,0,4,0,0,4,1,5,0,3,1,1,1,4
401402517,Oklahoma Sooners,K. Perkins,4899000,,False,6.0,1,2,1,2,0,0,0,0,0,0,0,0,0,0,0,2,2
401402517,Oklahoma Sooners,K. Washington,4898998,,False,22.0,3,5,2,3,1,2,0,0,1,2,3,5,0,0,3,0,7
401402517,Oklahoma Sooners,G. Gregory,4594692,,False,5.0,0,3,0,1,0,2,0,0,2,0,2,0,0,0,0,0,0
401402517,Oklahoma Sooners,TEAM,TOTAL,TOTAL,False,,30,75,20,42,10,33,10,15,18,35,53,25,10,3,19,15,80
401402517,Kansas Jayhawks,I. Chatzileonti,4600665,,True,28.0,4,13,4,13,0,0,3,5,2,2,4,3,1,2,1,1,11
401402517,Kansas Jayhawks,T. Jackson,4898989,,True,31.0,3,7,3,7,0,0,2,6,2,10,12,2,1,6,2,4,8
401402517,Kansas Jayhawks,H. Kersgieter,4433703,,True,32.0,2,11,0,4,2,7,3,4,2,7,9,2,1,1,4,2,9
401402517,Kansas Jayhawks,Z. Franklin,4432983,,True,37.0,5,9,5,9,0,0,5,5,0,0,0,5,4,0,1,1,15
401402517,Kansas Jayhawks,J. Brosseau,4066590,,True,12.0,1,2,0,1,1,1,1,2,0,0,0,0,1,0,2,0,4
401402517,Kansas Jayhawks,K. Jessen,4600607,,False,2.0,0,1,0,1,0,0,0,0,0,0,0,0,0,0,0,1,0
401402517,Kansas Jayhawks,N. Eltayeb,4898993,,False,6.0,1,2,1,2,0,0,0,0,1,1,2,0,0,0,1,1,2
401402517,Kansas Jayhawks,M. Vuksic,4600667,,False,4.0,2,5,0,0,2,5,0,0,0,0,0,0,1,0,1,1,6
401402517,Kansas Jayhawks,C. Prater,4433140,,False,20.0,0,3,0,3,0,0,0,0,1,1,2,1,0,0,4,4,0
401402517,Kansas Jayhawks,A. Thomas,4398826,,False,27.0,4,14,2,7,2,7,3,4,3,4,7,0,0,0,1,3,13
401402517,Kansas Jayhawks,TEAM,TOTAL,TOTAL,False,,22,67,15,47,7,20,17,26,12,29,41,13,9,9,17,18,68
401402516,West Virginia Mountaineers,E. Martinez,4433353,,True,21.0,4,9,3,8,1,1,0,0,3,3,6,2,3,0,3,3,9
401402516,West Virginia Mountaineers,K. Niblack,4398995,,True,15.0,2,4,2,4,0,0,1,4,1,5,6,0,1,1,2,4,5
401402516,West Virginia Mountaineers,J. Quinerly,4434015,,True,36.0,5,10,5,9,0,1,6,9,0,7,7,3,4,1,5,3,16
401402516,West Virginia Mountaineers,J. Hemingway,4432991,,True,17.0,3,4,1,1,2,3,1,2,0,0,0,1,0,1,1,2,9
401402516,West Virginia Mountaineers,M. Smith,4398996,,True,38.0,7,14,3,7,4,7,1,2,0,3,3,5,0,0,3,2,19
401402516,West Virginia Mountaineers,A. Gray,4281368,,False,15.0,2,7,2,7,0,0,0,0,1,3,4,0,1,0,2,3,4
401402516,West Virginia Mountaineers,J. Cunningham,4597333,,False,2.0,0,0,0,0,0,0,0,0,0,1,1,0,0,0,0,0,0
401402516,West Virginia Mountaineers,Y. Morris,4595175,,False,2.0,0,0,0,0,0,0,0,0,0,1,1,0,0,0,0,0,0
401402516,West Virginia Mountaineers,B. Ejiofor,4280899,,False,21.0,2,7,2,7,0,0,0,0,3,5,8,1,3,1,0,1,4
401402516,West Virginia Mountaineers,S. Samuel,4595356,,False,33.0,1,8,1,4,0,4,0,0,0,0,0,6,3,0,2,3,2
401402516,West Virginia Mountaineers,TEAM,TOTAL,TOTAL,False,,26,63,19,47,7,16,9,17,11,31,42,18,15,4,18,21,68
401402516,TCU Horned Frogs,M. Berry,3934229,,True,35.0,2,11,2,5,0,6,2,2,1,5,6,1,0,0,2,4,6
401402516,TCU Horned Frogs,O. Adika,4703593,,True,27.0,6,10,4,7,2,3,3,3,1,4,5,0,1,0,0,3,17
401402516,TCU Horned Frogs,T. Manumaleuga,4411393,,True,19.0,0,3,0,1,0,2,0,0,0,3,3,0,2,1,0,0,0
401402516,TCU Horned Frogs,L. Heard,4281321,,True,36.0,4,12,4,11,0,1,6,8,1,6,7,2,3,0,6,4,14
401402516,TCU Horned Frogs,A. Jackson,4065769,,True,32.0,0,5,0,1,0,4,6,8,4,2,6,2,2,1,3,3,6
401402516,TCU Horned Frogs,Y. Morris,4399222,,False,10.0,0,3,0,3,0,0,0,0,0,0,0,2,0,1,3,2,0
401402516,TCU Horned Frogs,P. Morris,4398815,,False,3.0,0,0,0,0,0,0,0,0,0,1,1,0,0,0,1,0,0
401402516,TCU Horned Frogs,T. Diggs,4433049,,False,4.0,1,2,1,2,0,0,0,2,1,2,3,0,1,0,3,1,2
401402516,TCU Horned Frogs,K. Mokwuah,4399082,,False,10.0,1,2,1,2,0,0,1,2,0,3,3,0,1,3,3,1,3
401402516,TCU Horned Frogs,C. Germond,4600271,,False,17.0,0,2,0,0,0,2,0,0,0,1,1,0,2,0,0,2,0
401402516,TCU Horned Frogs,A. Holmes,4433756,,False,7.0,0,1,0,0,0,1,0,0,0,0,0,0,0,0,1,0,0
401402516,TCU Horned Frogs,TEAM,TOTAL,TOTAL,False,,14,51,12,32,2,19,18,25,8,29,37,7,12,6,24,20,48
401402515,Texas Tech Lady Raiders,B. Gerlich,4398980,,True,30.0,5,14,5,11,0,3,1,1,1,4,5,3,0,2,3,5,11
401402515,Texas Tech Lady Raiders,T. Thomas,4280707,,True,30.0,3,7,3,6,0,1,0,0,3,3,6,0,0,3,3,2,6
401402515,Texas Tech Lady Raiders,E. Tofaeono,4704602,,True,16.0,1,1,1,1,0,0,0,0,0,0,0,0,0,0,0,2,2
401402515,Texas Tech Lady Raiders,L. Hightower,4898413,,True,22.0,0,4,0,4,0,0,0,0,0,3,3,1,2,0,2,3,0
401402515,Texas Tech Lady Raiders,V. Gray,4398981,,True,39.0,9,21,9,18,0,3,2,4,2,4,6,0,3,2,4,2,20
401402515,Texas Tech Lady Raiders,C. Embry,4898416,,False,20.0,1,2,1,1,0,1,3,3,0,8,8,0,0,0,1,1,5
401402515,Texas Tech Lady Raiders,L. Wenger,4898415,,False,2.0,0,0,0,0,0,0,0,0,0,0,0,0,1,1,0,0,0
401402515,Texas Tech Lady Raiders,S. Ukkonen,4898414,,False,4.0,1,1,0,0,1,1,0,0,0,0,0,0,0,0,0,0,3
401402515,Texas Tech Lady Raiders,R. McKinney,4682750,,False,21.0,2,6,0,2,2,4,0,0,0,2,2,1,0,0,3,0,6
401402515,Texas Tech Lady Raiders,T. Veitenheimer,4398886,,False,16.0,2,4,1,2,1,2,0,0,0,1,1,4,0,0,2,1,5
401402515,Texas Tech Lady Raiders,TEAM,TOTAL,TOTAL,False,,24,60,20,45,4,15,6,8,10,26,36,9,6,8,19,16,58
401402515,Oklahoma State Cowgirls,T. Collins,4582912,,True,31.0,7,17,7,17,0,0,0,0,3,9,12,3,1,3,1,2,14
401402515,Oklahoma State Cowgirls,K. De Lapp,4398979,,True,37.0,1,4,1,4,0,0,0,0,1,3,4,4,1,2,2,4,2
401402515,Oklahoma State Cowgirls,L. Keys,4703518,,True,40.0,5,13,3,6,2,7,7,7,0,2,2,3,0,0,2,0,19
401402515,Oklahoma State Cowgirls,M. Dennis,4594696,,True,38.0,2,7,1,5,1,2,1,2,1,3,4,4,3,1,3,0,6
401402515,Oklahoma State Cowgirls,L. Fields,4433664,,True,32.0,7,12,2,5,5,7,3,4,0,4,4,3,4,0,2,4,22
401402515,Oklahoma State Cowgirls,M. James,4691726,,False,13.0,3,5,2,3,1,2,1,2,1,2,3,0,0,0,0,2,8
401402515,Oklahoma State Cowgirls,A. Winchester,4281318,,False,1.0,0,0,0,0,0,0,0,0,0,0,0,0,1,0,0,0,0
401402515,Oklahoma State Cowgirls,N. Notoa,4703519,,False,4.0,0,0,0,0,0,0,0,0,0,0,0,1,0,0,0,0,0
401402515,Oklahoma State Cowgirls,N. Boyd,4595017,,False,2.0,0,1,0,1,0,0,0,0,0,0,0,0,0,0,0,0,0
401402515,Oklahoma State Cowgirls,S. Rodrigues,4594699,,False,2.0,1,2,1,2,0,0,0,0,0,0,0,0,0,0,0,0,2
401402515,Oklahoma State Cowgirls,TEAM,TOTAL,TOTAL,False,,26,61,17,43,9,18,12,15,10,26,36,18,10,6,12,12,73
401402512,Massachusetts Minutewomen,A. Ngalakulondi,4594788,,True,17.0,3,4,3,4,0,0,3,3,1,3,4,1,0,1,0,3,9
401402512,Massachusetts Minutewomen,S. Breen,4281234,,True,40.0,8,16,5,9,3,7,0,0,2,7,9,2,2,0,3,2,19
401402512,Massachusetts Minutewomen,B. Mayo,4704146,,True,40.0,4,8,3,4,1,4,5,6,2,3,5,1,2,0,1,0,14
401402512,Massachusetts Minutewomen,S. Taylor,4594786,,True,40.0,4,11,3,5,1,6,1,2,0,3,3,3,1,0,1,0,10
401402512,Massachusetts Minutewomen,D. Philoxy,4399441,,True,29.0,0,5,0,2,0,3,0,2,1,2,3,5,0,0,3,3,0
401402512,Massachusetts Minutewomen,M. White,4704145,,False,23.0,5,8,5,8,0,0,0,0,1,5,6,1,0,0,3,3,10
401402512,Massachusetts Minutewomen,A. Brooks,4898542,,False,11.0,0,0,0,0,0,0,0,0,0,2,2,2,0,0,0,0,0
401402512,Massachusetts Minutewomen,TEAM,TOTAL,TOTAL,False,,24,52,19,32,5,20,9,13,8,27,35,15,5,1,11,11,62
401402512,Dayton Flyers,K. Whitehead,4399307,,True,37.0,2,6,2,5,0,1,2,4,3,3,6,2,2,1,0,1,6
401402512,Dayton Flyers,T. Magassa,4703739,,True,24.0,3,4,3,4,0,0,0,0,0,3,3,1,2,1,1,1,6
401402512,Dayton Flyers,J. Giacone,4068133,,True,26.0,3,7,0,1,3,6,0,0,0,1,1,1,2,0,2,1,9
401402512,Dayton Flyers,E. Whalen,4065788,,True,31.0,4,11,1,1,3,10,2,2,0,5,5,1,0,0,1,5,13
401402512,Dayton Flyers,A. Bradshaw,4065758,,True,34.0,1,2,1,2,0,0,1,2,0,2,2,4,0,0,1,3,3
401402512,Dayton Flyers,M. Perez,4594754,,False,9.0,1,3,1,3,0,0,0,0,1,3,4,0,0,0,1,0,2
401402512,Dayton Flyers,M. Cook,4682764,,False,31.0,4,15,3,10,1,5,6,6,0,3,3,3,1,0,2,4,15
401402512,Dayton Flyers,M. Perry,4433361,,False,8.0,1,2,1,2,0,0,0,0,0,1,1,0,0,0,1,1,2
401402512,Dayton Flyers,TEAM,TOTAL,TOTAL,False,,19,50,12,28,7,22,11,14,4,22,26,12,7,2,9,16,56
401402511,Saint Joseph's Hawks,L. Fair,4898534,,True,35.0,7,15,7,15,0,0,2,3,1,4,5,0,1,3,1,1,16
401402511,Saint Joseph's Hawks,T. Brugler,4898530,,True,35.0,7,15,7,13,0,2,0,0,4,5,9,2,1,1,1,0,14
401402511,Saint Joseph's Hawks,M. Smith,4898535,,True,13.0,0,1,0,0,0,1,0,0,0,0,0,0,0,0,2,3,0
401402511,Saint Joseph's Hawks,J. Nystrom,4898532,,True,16.0,1,1,1,1,0,0,0,0,0,0,0,1,0,0,3,0,2
401402511,Saint Joseph's Hawks,K. Jekot,4281901,,True,34.0,4,8,2,4,2,4,0,0,1,3,4,3,3,0,2,1,10
401402511,Saint Joseph's Hawks,K. Mayock,4399473,,False,10.0,0,0,0,0,0,0,2,2,0,1,1,0,0,0,0,0,2
401402511,Saint Joseph's Hawks,E. Boslet,4704122,,False,15.0,1,4,0,1,1,3,0,0,0,2,2,1,0,0,2,2,3
401402511,Saint Joseph's Hawks,O. Mullins,4704121,,False,25.0,3,9,1,6,2,3,0,0,0,1,1,1,0,0,1,0,8
401402511,Saint Joseph's Hawks,A. Gribble,4065872,,False,17.0,1,5,0,1,1,4,0,0,0,1,1,2,0,0,0,0,3
401402511,Saint Joseph's Hawks,TEAM,TOTAL,TOTAL,False,,24,58,18,41,6,17,4,5,8,18,26,10,5,4,12,7,58
401402511,Massachusetts Minutewomen,A. Ngalakulondi,4594788,,True,16.0,2,7,2,7,0,0,1,2,3,3,6,1,0,1,1,1,5
401402511,Massachusetts Minutewomen,S. Breen,4281234,,True,39.0,13,19,11,15,2,4,0,2,2,7,9,2,4,1,0,1,28
401402511,Massachusetts Minutewomen,B. Mayo,4704146,,True,40.0,2,6,1,4,1,2,1,2,1,4,5,2,2,0,2,2,6
401402511,Massachusetts Minutewomen,S. Taylor,4594786,,True,34.0,8,14,5,7,3,7,1,1,0,2,2,1,0,0,2,2,20
401402511,Massachusetts Minutewomen,D. Philoxy,4399441,,True,38.0,2,5,1,3,1,2,2,2,0,3,3,5,0,1,3,1,7
401402511,Massachusetts Minutewomen,M. White,4704145,,False,24.0,5,6,5,6,0,0,0,0,3,1,4,2,0,0,2,1,10
401402511,Massachusetts Minutewomen,M. Pruitt,4281295,,False,1.0,0,0,0,0,0,0,0,0,0,0,0,1,0,0,0,0,0
401402511,Massachusetts Minutewomen,A. Brooks,4898542,,False,8.0,0,1,0,0,0,1,0,0,0,0,0,2,0,0,0,1,0
401402511,Massachusetts Minutewomen,TEAM,TOTAL,TOTAL,False,,32,58,25,42,7,16,5,9,10,26,36,16,6,3,10,9,76
401402510,VCU Rams,K. Walters,4399303,,True,21.0,2,7,2,7,0,0,0,0,3,6,9,0,0,1,1,1,4
401402510,VCU Rams,S. Te-Biasu,4704160,,True,36.0,4,11,2,4,2,7,0,1,0,2,2,2,0,0,3,5,10
401402510,VCU Rams,J. Griffith-Wallace,4282453,,True,34.0,1,7,1,5,0,2,0,0,1,3,4,3,0,1,0,2,2
401402510,VCU Rams,M. Hattix-Covington,4281906,,True,35.0,1,4,0,1,1,3,1,2,1,1,2,0,0,1,1,3,4
401402510,VCU Rams,T. Robinson,4281905,,True,37.0,11,27,9,18,2,9,1,1,3,4,7,3,3,2,0,3,25
401402510,VCU Rams,C. Bloom,4433657,,False,18.0,0,4,0,4,0,0,1,2,1,3,4,1,0,0,2,1,1
401402510,VCU Rams,Sa. Robinson,4399312,,False,5.0,0,0,0,0,0,0,0,0,0,2,2,0,0,0,0,0,0
401402510,VCU Rams,D. Townes,4704161,,False,13.0,0,1,0,1,0,0,2,2,2,0,2,1,1,0,0,1,2
401402510,VCU Rams,G. Hutson,4613247,,False,0.0,0,0,0,0,0,0,0,0,0,0,0,0,0,0,0,0,0
401402510,VCU Rams,TEAM,TOTAL,TOTAL,False,,19,61,14,40,5,21,5,8,13,23,36,10,4,5,7,16,48
401402510,Dayton Flyers,K. Whitehead,4399307,,True,39.0,3,5,3,5,0,0,1,2,3,3,6,3,0,0,0,1,7
401402510,Dayton Flyers,T. Magassa,4703739,,True,25.0,2,4,2,4,0,0,0,0,3,6,9,1,0,2,4,4,4
401402510,Dayton Flyers,J. Giacone,4068133,,True,27.0,2,13,2,8,0,5,4,4,0,6,6,4,2,0,0,0,8
401402510,Dayton Flyers,E. Whalen,4065788,,True,30.0,7,14,2,7,5,7,1,2,1,4,5,1,0,0,1,2,20
401402510,Dayton Flyers,A. Bradshaw,4065758,,True,39.0,2,4,1,1,1,3,1,5,2,5,7,2,2,0,4,2,6
401402510,Dayton Flyers,M. Perez,4594754,,False,14.0,1,4,1,4,0,0,0,0,4,1,5,2,0,0,2,2,2
401402510,Dayton Flyers,M. Cook,4682764,,False,25.0,3,13,2,11,1,2,5,6,1,2,3,3,0,1,1,1,12
401402510,Dayton Flyers,TEAM,TOTAL,TOTAL,False,,20,57,13,40,7,17,12,19,17,31,48,16,4,3,13,12,59
401402504,William & Mary Tribe,D. McTeer,4899591,,True,33.0,5,8,5,8,0,0,0,1,5,7,12,0,2,0,1,2,10
401402504,William & Mary Tribe,B. Bellamy,4594744,,True,24.0,1,5,1,5,0,0,0,0,1,3,4,3,0,2,4,2,2
401402504,William & Mary Tribe,K. Sramac,4281413,,True,28.0,0,4,0,3,0,1,0,0,0,4,4,1,1,0,1,2,0
401402504,William & Mary Tribe,R. Casey,4281390,,True,35.0,4,8,3,4,1,4,4,4,0,3,3,2,2,0,5,3,13
401402504,William & Mary Tribe,S. Wagner,4281291,,True,34.0,12,19,8,12,4,7,2,2,0,0,0,3,1,0,3,1,30
401402504,William & Mary Tribe,R. Frisby-Smith,4705066,,False,3.0,0,1,0,1,0,0,2,2,0,0,0,1,0,0,0,1,2
401402504,William & Mary Tribe,K. Beckwith,4705064,,False,20.0,2,4,2,4,0,0,0,1,0,0,0,2,1,0,3,5,4
401402504,William & Mary Tribe,R. Montella,4899592,,False,17.0,0,0,0,0,0,0,0,0,0,0,0,1,0,0,1,3,0
401402504,William & Mary Tribe,L. Brown,4705065,,False,2.0,0,0,0,0,0,0,0,0,0,0,0,0,0,0,0,0,0
401402504,William & Mary Tribe,A. Stevenson,4589980,,False,4.0,0,0,0,0,0,0,0,0,0,1,1,0,0,0,0,1,0
401402504,William & Mary Tribe,TEAM,TOTAL,TOTAL,False,,24,49,19,37,5,12,8,10,7,20,27,13,7,2,18,20,61
401402504,Elon Phoenix,E. McGill,4400005,,True,18.0,2,4,2,4,0,0,3,4,3,4,7,0,0,0,1,3,7
401402504,Elon Phoenix,B. Perpignan,4399846,,True,31.0,5,8,3,5,2,3,4,4,0,2,2,6,1,0,0,3,16
401402504,Elon Phoenix,V. Taylor,4594719,,True,28.0,3,6,2,4,1,2,0,0,0,1,1,0,0,0,2,2,7
401402504,Elon Phoenix,K. Liles,4399847,,True,24.0,3,11,1,6,2,5,0,0,2,7,9,3,1,0,5,0,8
401402504,Elon Phoenix,A. Nance,4281438,,True,19.0,3,8,2,4,1,4,1,1,0,0,0,1,1,0,1,0,8
401402504,Elon Phoenix,A. James,4704635,,False,23.0,5,10,2,3,3,7,4,4,1,2,3,1,1,0,0,3,17
401402504,Elon Phoenix,M. Johnson,4594720,,False,9.0,2,2,2,2,0,0,2,2,1,1,2,1,0,0,0,0,6
401402504,Elon Phoenix,T. Traore,4399850,,False,16.0,2,2,2,2,0,0,1,2,2,1,3,0,0,1,2,1,5
401402504,Elon Phoenix,K. Trowse,4912217,,False,2.0,0,0,0,0,0,0,1,2,0,0,0,0,0,0,0,1,1
401402504,Elon Phoenix,D. Tasman,4399848,,False,2.0,0,0,0,0,0,0,0,0,0,0,0,0,0,0,0,0,0
401402504,Elon Phoenix,B. Harmon,4433666,,False,14.0,2,3,1,1,1,2,0,0,0,1,1,2,0,1,1,1,5
401402504,Elon Phoenix,P. Carter,4281922,,False,14.0,1,2,0,1,1,1,2,6,0,0,0,0,0,0,0,2,5
401402504,Elon Phoenix,TEAM,TOTAL,TOTAL,False,,28,56,17,32,11,24,18,25,12,20,32,14,4,2,12,16,85
401402492,Jacksonville State Gamecocks,K. Griffin,4705593,,True,25.0,1,5,1,3,0,2,0,0,0,6,6,2,0,0,2,0,2
401402492,Jacksonville State Gamecocks,K. Gavin,4281809,,True,29.0,5,6,5,6,0,0,3,4,2,5,7,1,0,0,0,3,13
401402492,Jacksonville State Gamecocks,I. Martin,4705591,,True,27.0,3,11,2,5,1,6,3,4,0,2,2,0,1,0,1,1,10
401402492,Jacksonville State Gamecocks,N. Thompson,4595972,,True,21.0,0,2,0,1,0,1,1,2,0,2,2,1,1,1,1,2,1
401402492,Jacksonville State Gamecocks,K. Johnson,4282440,,True,27.0,5,10,5,10,0,0,3,4,1,1,2,0,0,0,0,1,13
401402492,Jacksonville State Gamecocks,M. McCoy,4898935,,False,15.0,2,5,2,2,0,3,0,2,0,6,6,0,1,0,2,3,4
401402492,Jacksonville State Gamecocks,B. Rhodes,4898934,,False,6.0,0,1,0,1,0,0,0,0,0,1,1,1,0,0,0,1,0
401402492,Jacksonville State Gamecocks,W. Kuimi,4595974,,False,5.0,0,0,0,0,0,0,0,0,0,1,1,0,0,0,0,0,0
401402492,Jacksonville State Gamecocks,K. Burnett,4705592,,False,13.0,2,5,1,2,1,3,0,0,0,0,0,0,0,0,1,0,5
401402492,Jacksonville State Gamecocks,K. Williams,4705590,,False,13.0,0,2,0,1,0,1,0,0,0,0,0,0,0,0,0,0,0
401402492,Jacksonville State Gamecocks,S. Shaw,4400608,,False,19.0,2,6,1,4,1,2,1,2,2,2,4,1,1,0,1,2,6
401402492,Jacksonville State Gamecocks,TEAM,TOTAL,TOTAL,False,,20,53,17,35,3,18,11,18,6,31,37,6,4,1,12,13,54
401402492,Florida Gulf Coast Eagles,T. Morehouse,4704575,,True,37.0,7,18,5,9,2,9,1,6,1,6,7,7,0,1,1,2,17
401402492,Florida Gulf Coast Eagles,K. Bell,4433633,,True,34.0,11,22,7,12,4,10,0,1,0,6,6,1,2,1,0,3,26
401402492,Florida Gulf Coast Eagles,E. List,4281132,,True,38.0,3,4,2,3,1,1,1,1,1,8,9,3,0,0,4,3,8
401402492,Florida Gulf Coast Eagles,K. Phills,4069354,,True,23.0,2,5,1,2,1,3,1,2,3,1,4,2,0,0,0,2,6
401402492,Florida Gulf Coast Eagles,K. Spray,4069207,,True,32.0,2,4,0,0,2,4,0,0,0,2,2,1,2,0,0,1,6
401402492,Florida Gulf Coast Eagles,K. Adams,4594400,,False,1.0,1,1,1,1,0,0,0,0,0,0,0,0,0,0,0,0,2
401402492,Florida Gulf Coast Eagles,S. Hackley,4704577,,False,4.0,0,2,0,0,0,2,0,0,0,0,0,0,1,0,0,0,0
401402492,Florida Gulf Coast Eagles,M. Antenucci,4704576,,False,1.0,0,0,0,0,0,0,0,0,0,0,0,0,0,0,0,0,0
401402492,Florida Gulf Coast Eagles,M. Schimmel,4703636,,False,1.0,0,0,0,0,0,0,0,0,0,1,1,0,0,0,0,0,0
401402492,Florida Gulf Coast Eagles,T. Bryant,4399860,,False,1.0,0,0,0,0,0,0,0,0,0,0,0,0,0,0,0,0,0
401402492,Florida Gulf Coast Eagles,K. Webb,4399370,,False,2.0,0,1,0,0,0,1,0,0,0,0,0,0,0,0,0,0,0
401402492,Florida Gulf Coast Eagles,K. Seay,4398689,,False,22.0,2,4,2,4,0,0,0,0,1,2,3,2,1,0,2,1,4
401402492,Florida Gulf Coast Eagles,T. Cox,4281494,,False,3.0,0,1,0,0,0,1,0,0,0,0,0,0,0,0,0,0,0
401402492,Florida Gulf Coast Eagles,A. Cecil,4068826,,False,1.0,0,0,0,0,0,0,0,0,0,0,0,1,0,0,0,0,0
401402492,Florida Gulf Coast Eagles,TEAM,TOTAL,TOTAL,False,,28,62,18,31,10,31,3,10,6,28,34,17,6,2,8,12,69
401402491,Liberty Flames,B. Rettstatt,4281577,,True,29.0,1,10,1,8,0,2,5,6,5,6,11,1,1,1,1,1,7
401402491,Liberty Flames,M. Berkman,4704261,,True,27.0,6,10,6,10,0,0,3,6,6,3,9,0,0,0,1,3,15
401402491,Liberty Flames,D. Brown,4704260,,True,34.0,3,7,3,6,0,1,5,7,3,4,7,1,2,0,3,4,11
401402491,Liberty Flames,P. Smeenge,4706151,,True,28.0,1,4,1,1,0,3,0,0,0,2,2,0,1,0,2,0,2
401402491,Liberty Flames,K. Williams,4594906,,True,34.0,5,9,5,8,0,1,0,0,0,4,4,3,1,1,1,0,10
401402491,Liberty Flames,J. Bailey,4595227,,False,16.0,2,3,1,2,1,1,0,0,0,0,0,0,0,1,1,1,5
401402491,Liberty Flames,B. Smuda,4433773,,False,8.0,2,4,2,4,0,0,1,2,1,1,2,0,0,1,0,1,5
401402491,Liberty Flames,E. Hess,4898939,,False,7.0,1,3,1,2,0,1,0,0,0,0,0,0,1,0,0,0,2
401402491,Liberty Flames,N. Lindstrom,4594903,,False,9.0,0,1,0,0,0,1,0,0,0,0,0,0,0,0,1,1,0
401402491,Liberty Flames,A. Iverson,4399422,,False,8.0,0,2,0,0,0,2,0,0,0,0,0,1,0,0,1,3,0
401402491,Liberty Flames,TEAM,TOTAL,TOTAL,False,,21,53,20,41,1,12,14,21,16,24,40,6,6,4,12,14,57
401402491,Jacksonville State Gamecocks,K. Griffin,4705593,,True,18.0,0,4,0,3,0,1,0,0,1,3,4,1,1,0,0,2,0
401402491,Jacksonville State Gamecocks,K. Gavin,4281809,,True,27.0,8,15,8,15,0,0,1,2,0,2,2,0,1,0,1,3,17
401402491,Jacksonville State Gamecocks,I. Martin,4705591,,True,26.0,1,5,1,4,0,1,2,4,0,2,2,1,0,0,1,1,4
401402491,Jacksonville State Gamecocks,N. Thompson,4595972,,True,22.0,0,1,0,1,0,0,0,0,0,0,0,1,0,0,2,1,0
401402491,Jacksonville State Gamecocks,K. Johnson,4282440,,True,26.0,9,10,9,10,0,0,3,3,0,2,2,1,2,0,3,4,21
401402491,Jacksonville State Gamecocks,M. McCoy,4898935,,False,22.0,0,0,0,0,0,0,0,0,0,1,1,1,0,0,1,2,0
401402491,Jacksonville State Gamecocks,B. Rhodes,4898934,,False,3.0,0,0,0,0,0,0,0,0,0,1,1,0,0,0,0,2,0
401402491,Jacksonville State Gamecocks,W. Kuimi,4595974,,False,10.0,1,2,1,2,0,0,0,0,2,1,3,0,1,0,1,1,2
401402491,Jacksonville State Gamecocks,K. Burnett,4705592,,False,14.0,0,3,0,1,0,2,0,0,0,0,0,1,2,0,0,0,0
401402491,Jacksonville State Gamecocks,K. Williams,4705590,,False,14.0,1,2,1,2,0,0,0,0,1,1,2,1,0,0,0,2,2
401402491,Jacksonville State Gamecocks,S. Shaw,4400608,,False,18.0,6,12,6,11,0,1,1,4,2,4,6,1,1,0,1,1,13
401402491,Jacksonville State Gamecocks,TEAM,TOTAL,TOTAL,False,,26,54,26,49,0,5,7,13,8,19,27,8,8,0,10,19,59
401402490,Stetson Hatters,T. Streun,4068737,,True,31.0,4,10,3,6,1,4,3,3,0,7,7,0,1,0,0,2,12
401402490,Stetson Hatters,A. Dublin,4068372,,True,30.0,5,10,5,10,0,0,0,2,0,0,0,4,1,0,0,1,10
401402490,Stetson Hatters,A. Hargrove,4898851,,True,38.0,6,10,4,8,2,2,4,4,0,4,4,3,4,0,3,1,18
401402490,Stetson Hatters,Y. Wazeerud-Din,4704531,,True,36.0,4,8,4,7,0,1,0,0,1,3,4,2,2,0,1,3,8
401402490,Stetson Hatters,J. Turner,4594427,,True,24.0,8,13,8,13,0,0,1,4,1,1,2,2,0,0,5,4,17
401402490,Stetson Hatters,T. Robertson,4704530,,False,6.0,0,0,0,0,0,0,0,0,0,1,1,1,0,0,0,0,0
401402490,Stetson Hatters,K. Turner,4595013,,False,23.0,1,5,1,4,0,1,0,0,0,2,2,0,0,0,5,1,2
401402490,Stetson Hatters,K. McNeal,4594274,,False,12.0,0,1,0,1,0,0,0,0,0,1,1,3,0,0,5,0,0
401402490,Stetson Hatters,TEAM,TOTAL,TOTAL,False,,28,57,25,49,3,8,8,13,7,22,29,15,8,0,19,12,67
401402490,Florida Gulf Coast Eagles,T. Morehouse,4704575,,True,32.0,5,8,4,6,1,2,1,2,1,1,2,7,1,0,4,4,12
401402490,Florida Gulf Coast Eagles,K. Bell,4433633,,True,33.0,7,17,4,6,3,11,2,3,1,10,11,4,4,5,6,4,19
401402490,Florida Gulf Coast Eagles,E. List,4281132,,True,34.0,5,9,1,2,4,7,0,0,0,5,5,4,1,0,2,3,14
401402490,Florida Gulf Coast Eagles,K. Phills,4069354,,True,28.0,2,4,0,0,2,4,3,4,1,3,4,1,1,0,2,2,9
401402490,Florida Gulf Coast Eagles,K. Spray,4069207,,True,29.0,4,6,0,0,4,6,0,0,0,4,4,1,0,1,0,2,12
401402490,Florida Gulf Coast Eagles,S. Hackley,4704577,,False,3.0,0,2,0,1,0,1,0,0,0,0,0,0,1,0,0,0,0
401402490,Florida Gulf Coast Eagles,K. Seay,4398689,,False,26.0,5,8,5,6,0,2,3,3,0,1,1,3,1,0,1,0,13
401402490,Florida Gulf Coast Eagles,T. Cox,4281494,,False,13.0,0,1,0,0,0,1,0,0,1,0,1,0,1,0,0,2,0
401402490,Florida Gulf Coast Eagles,A. Cecil,4068826,,False,2.0,1,1,0,0,1,1,0,0,0,0,0,0,1,0,0,0,3
401402490,Florida Gulf Coast Eagles,TEAM,TOTAL,TOTAL,False,,29,56,14,21,15,35,9,12,5,25,30,20,11,6,17,17,82
401402489,North Florida Ospreys,S. Evans,4704297,,True,15.0,1,4,1,1,0,3,0,0,1,1,2,0,1,1,2,0,2
401402489,North Florida Ospreys,E. Broermann,4594421,,True,30.0,7,12,7,11,0,1,2,4,2,7,9,1,0,0,1,2,16
401402489,North Florida Ospreys,Jazz Bond,4399879,,True,28.0,4,9,2,5,2,4,0,0,0,3,3,2,0,3,2,3,10
401402489,North Florida Ospreys,A. Knights,4704296,,True,12.0,1,1,1,1,0,0,0,1,0,3,3,2,0,0,3,2,2
401402489,North Florida Ospreys,R. Moore,4281335,,True,37.0,2,11,1,5,1,6,0,0,1,5,6,2,0,1,1,4,5
401402489,North Florida Ospreys,T. Thompson,4281352,,False,3.0,0,2,0,2,0,0,0,0,0,0,0,0,0,0,2,0,0
401402489,North Florida Ospreys,K. Rougier,4898860,,False,6.0,0,0,0,0,0,0,0,0,0,1,1,0,0,0,0,2,0
401402489,North Florida Ospreys,N. Benedith,4704294,,False,24.0,2,3,2,3,0,0,5,5,0,0,0,0,0,0,3,1,9
401402489,North Florida Ospreys,Jai. Bond,4599315,,False,32.0,6,8,4,4,2,4,2,2,1,3,4,2,1,1,4,0,16
401402489,North Florida Ospreys,T. Tolbert,4281337,,False,9.0,0,1,0,1,0,0,0,0,0,2,2,0,0,0,0,0,0
401402489,North Florida Ospreys,E. Jones,4066582,,False,5.0,0,0,0,0,0,0,0,0,0,2,2,0,0,0,0,0,0
401402489,North Florida Ospreys,TEAM,TOTAL,TOTAL,False,,23,51,18,33,5,18,9,12,6,31,37,9,2,6,18,14,60
401402489,Florida Gulf Coast Eagles,T. Morehouse,4704575,,True,34.0,5,16,5,9,0,7,4,4,1,1,2,7,3,0,0,0,14
401402489,Florida Gulf Coast Eagles,K. Bell,4433633,,True,32.0,10,20,8,13,2,7,0,0,1,6,7,1,3,5,3,3,22
401402489,Florida Gulf Coast Eagles,E. List,4281132,,True,38.0,2,7,2,5,0,2,0,0,2,3,5,4,2,0,1,3,4
401402489,Florida Gulf Coast Eagles,K. Phills,4069354,,True,22.0,1,4,1,2,0,2,1,3,2,4,6,0,0,0,0,1,3
401402489,Florida Gulf Coast Eagles,K. Spray,4069207,,True,35.0,8,10,1,1,7,9,1,2,1,3,4,1,3,0,0,2,24
401402489,Florida Gulf Coast Eagles,K. Adams,4594400,,False,0.0,0,0,0,0,0,0,1,2,0,0,0,0,0,0,1,0,1
401402489,Florida Gulf Coast Eagles,S. Hackley,4704577,,False,2.0,0,1,0,1,0,0,0,0,1,0,1,0,0,0,0,0,0
401402489,Florida Gulf Coast Eagles,M. Antenucci,4704576,,False,0.0,0,0,0,0,0,0,0,0,0,1,1,0,0,0,0,0,0
401402489,Florida Gulf Coast Eagles,M. Schimmel,4703636,,False,0.0,0,0,0,0,0,0,0,0,0,0,0,0,0,0,0,0,0
401402489,Florida Gulf Coast Eagles,T. Bryant,4399860,,False,0.0,0,0,0,0,0,0,0,0,0,0,0,0,0,0,0,1,0
401402489,Florida Gulf Coast Eagles,K. Webb,4399370,,False,3.0,0,2,0,0,0,2,0,0,0,0,0,0,0,0,0,0,0
401402489,Florida Gulf Coast Eagles,K. Seay,4398689,,False,18.0,1,3,0,1,1,2,0,0,1,2,3,1,1,0,0,1,3
401402489,Florida Gulf Coast Eagles,T. Cox,4281494,,False,10.0,0,5,0,3,0,2,0,0,1,2,3,2,0,0,0,1,0
401402489,Florida Gulf Coast Eagles,A. Cecil,4068826,,False,6.0,0,1,0,1,0,0,0,0,0,1,1,0,0,0,0,2,0
401402489,Florida Gulf Coast Eagles,TEAM,TOTAL,TOTAL,False,,27,69,17,36,10,33,7,11,11,24,35,16,12,5,5,14,71
401402488,Jacksonville State Gamecocks,K. Griffin,4705593,,True,30.0,1,7,0,1,1,6,0,0,0,11,11,1,1,0,2,1,3
401402488,Jacksonville State Gamecocks,K. Gavin,4281809,,True,25.0,2,5,2,5,0,0,0,0,0,6,6,0,0,0,1,1,4
401402488,Jacksonville State Gamecocks,I. Martin,4705591,,True,24.0,2,8,1,3,1,5,2,4,0,0,0,0,0,1,1,0,7
401402488,Jacksonville State Gamecocks,N. Thompson,4595972,,True,27.0,1,2,1,1,0,1,4,4,0,6,6,5,2,0,3,4,6
401402488,Jacksonville State Gamecocks,K. Johnson,4282440,,True,22.0,6,11,6,10,0,1,7,8,1,1,2,0,1,0,2,0,19
401402488,Jacksonville State Gamecocks,M. McCoy,4898935,,False,16.0,1,2,1,2,0,0,0,0,0,1,1,0,1,0,0,1,2
401402488,Jacksonville State Gamecocks,B. Rhodes,4898934,,False,8.0,3,3,3,3,0,0,0,0,1,0,1,0,1,0,1,1,6
401402488,Jacksonville State Gamecocks,W. Kuimi,4595974,,False,2.0,0,0,0,0,0,0,0,0,0,1,1,0,0,0,1,0,0
401402488,Jacksonville State Gamecocks,K. Burnett,4705592,,False,16.0,2,6,0,0,2,6,0,0,0,0,0,1,0,0,0,0,6
401402488,Jacksonville State Gamecocks,K. Williams,4705590,,False,18.0,3,3,0,0,3,3,4,5,0,1,1,1,0,0,1,1,13
401402488,Jacksonville State Gamecocks,S. Shaw,4400608,,False,12.0,2,4,2,4,0,0,0,0,1,1,2,5,0,0,2,3,4
401402488,Jacksonville State Gamecocks,TEAM,TOTAL,TOTAL,False,,23,51,16,29,7,22,17,21,5,30,35,13,6,1,14,12,70
401402488,Jacksonville Dolphins,S. Jackson,4400219,,True,37.0,5,13,4,8,1,5,6,7,3,4,7,0,0,0,2,2,17
401402488,Jacksonville Dolphins,K. Hayes,4898930,,True,26.0,4,6,4,6,0,0,0,0,1,3,4,0,1,1,3,3,8
401402488,Jacksonville Dolphins,D. Graham,4704541,,True,30.0,3,7,3,6,0,1,0,1,1,1,2,1,1,0,2,5,6
401402488,Jacksonville Dolphins,C. Walker,4594884,,True,26.0,2,6,1,4,1,2,0,0,0,5,5,0,0,0,1,2,5
401402488,Jacksonville Dolphins,T. Hawks,4282437,,True,39.0,5,12,5,8,0,4,5,9,0,5,5,3,1,0,2,3,15
401402488,Jacksonville Dolphins,M. Edwards,4595196,,False,10.0,0,3,0,1,0,2,0,0,0,0,0,1,1,0,0,1,0
401402488,Jacksonville Dolphins,J. Dunlap,4898927,,False,28.0,2,7,1,4,1,3,0,0,1,2,3,1,2,1,2,3,5
401402488,Jacksonville Dolphins,D. Gillard,4704988,,False,4.0,0,0,0,0,0,0,0,0,0,0,0,0,1,0,3,3,0
401402488,Jacksonville Dolphins,TEAM,TOTAL,TOTAL,False,,21,54,18,37,3,17,11,17,6,24,30,6,7,2,16,22,56
401402487,Stetson Hatters,T. Streun,4068737,,True,18.0,1,7,1,5,0,2,2,3,0,3,3,0,0,1,1,3,4
401402487,Stetson Hatters,A. Dublin,4068372,,True,32.0,8,11,8,11,0,0,2,2,3,8,11,1,0,0,0,1,18
401402487,Stetson Hatters,A. Hargrove,4898851,,True,30.0,1,7,1,4,0,3,2,6,0,6,6,3,1,0,1,1,4
401402487,Stetson Hatters,Y. Wazeerud-Din,4704531,,True,36.0,4,9,3,6,1,3,5,6,1,1,2,1,0,0,0,1,14
401402487,Stetson Hatters,J. Turner,4594427,,True,26.0,2,10,2,9,0,1,0,0,1,5,6,1,1,0,1,1,4
401402487,Stetson Hatters,M. Morgan-Elliott,4595304,,False,6.0,0,2,0,2,0,0,0,0,1,2,3,0,0,0,2,0,0
401402487,Stetson Hatters,T. Robertson,4704530,,False,13.0,1,2,0,1,1,1,0,0,1,0,1,1,0,0,0,1,3
401402487,Stetson Hatters,K. Turner,4595013,,False,29.0,4,10,3,9,1,1,0,0,3,5,8,3,2,1,0,0,9
401402487,Stetson Hatters,K. McNeal,4594274,,False,10.0,3,5,1,2,2,3,0,0,0,2,2,0,1,0,0,2,8
401402487,Stetson Hatters,TEAM,TOTAL,TOTAL,False,,24,63,19,49,5,14,11,17,12,33,45,10,5,2,5,10,64
401402487,North Alabama Lions,S. Gill,4898867,,True,38.0,4,12,1,5,3,7,0,0,1,16,17,4,2,5,0,1,11
401402487,North Alabama Lions,J. Strachan,4898864,,True,26.0,2,5,0,1,2,4,0,0,0,2,2,2,0,1,0,1,6
401402487,North Alabama Lions,H. Suzuki,4704277,,True,31.0,3,9,2,6,1,3,0,0,0,2,2,3,2,0,5,4,7
401402487,North Alabama Lions,A. Callins,4704275,,True,26.0,1,6,1,3,0,3,0,0,1,1,2,4,0,0,1,3,2
401402487,North Alabama Lions,P. Jaworska,4601142,,True,33.0,4,11,2,7,2,4,7,8,1,2,3,0,1,0,3,2,17
401402487,North Alabama Lions,M. Lee,4704274,,False,24.0,1,7,1,4,0,3,0,0,1,5,6,1,0,0,1,0,2
401402487,North Alabama Lions,O. Jones,4898865,,False,1.0,0,0,0,0,0,0,0,0,0,0,0,0,0,0,0,0,0
401402487,North Alabama Lions,J. Moore,4704273,,False,21.0,3,5,1,1,2,4,0,0,0,1,1,0,0,0,0,1,8
401402487,North Alabama Lions,TEAM,TOTAL,TOTAL,False,,18,55,8,27,10,28,7,8,5,30,35,14,5,6,10,12,53
401402486,Liberty Flames,B. Rettstatt,4281577,,True,25.0,4,10,4,8,0,2,1,1,4,8,12,1,0,0,1,2,9
401402486,Liberty Flames,M. Berkman,4704261,,True,25.0,3,6,3,6,0,0,0,0,3,2,5,1,0,0,1,2,6
401402486,Liberty Flames,P. Smeenge,4706151,,True,25.0,6,8,2,3,4,5,2,2,2,0,2,0,0,0,1,2,18
401402486,Liberty Flames,D. Brown,4704260,,True,26.0,6,11,4,6,2,5,2,2,2,5,7,6,1,1,1,3,16
401402486,Liberty Flames,K. Williams,4594906,,True,23.0,2,5,2,4,0,1,1,1,0,0,0,3,1,0,1,1,5
401402486,Liberty Flames,A. Markova,4898942,,False,5.0,0,2,0,0,0,2,0,0,0,1,1,0,0,0,0,0,0
401402486,Liberty Flames,J. Bailey,4595227,,False,11.0,3,10,2,6,1,4,0,0,1,2,3,0,0,0,1,1,7
401402486,Liberty Flames,B. Smuda,4433773,,False,12.0,2,3,2,3,0,0,0,2,4,2,6,3,0,0,1,1,4
401402486,Liberty Flames,J. Hodges,4898940,,False,6.0,0,0,0,0,0,0,0,0,0,0,0,0,0,0,0,0,0
401402486,Liberty Flames,E. Hess,4898939,,False,9.0,2,2,1,1,1,1,1,2,0,1,1,1,0,0,0,3,6
401402486,Liberty Flames,N. Stallings,4704259,,False,3.0,0,0,0,0,0,0,0,0,0,0,0,0,0,0,0,0,0
401402486,Liberty Flames,N. Lindstrom,4594903,,False,14.0,1,4,0,0,1,4,1,2,0,1,1,1,1,0,1,3,4
401402486,Liberty Flames,J. Peters,4399970,,False,3.0,0,0,0,0,0,0,0,0,0,0,0,0,0,0,1,0,0
401402486,Liberty Flames,A. Iverson,4399422,,False,13.0,1,1,1,1,0,0,0,0,0,1,1,3,0,0,0,0,2
401402486,Liberty Flames,TEAM,TOTAL,TOTAL,False,,30,62,21,38,9,24,8,12,17,26,43,19,3,1,10,18,77
401402486,Eastern Kentucky Colonels,J. Johnson,4282607,,True,24.0,4,11,3,9,1,2,4,6,3,3,6,0,0,1,1,4,13
401402486,Eastern Kentucky Colonels,I. Green,4067989,,True,23.0,1,4,1,3,0,1,0,0,0,1,1,0,1,1,0,2,2
401402486,Eastern Kentucky Colonels,B. Crittendon,4898923,,True,16.0,0,2,0,1,0,1,1,2,0,3,3,1,0,0,1,1,1
401402486,Eastern Kentucky Colonels,A. Recanati,4705072,,True,28.0,1,4,1,3,0,1,0,0,0,1,1,1,0,0,1,1,2
401402486,Eastern Kentucky Colonels,B. Bass,4282431,,True,22.0,0,7,0,3,0,4,4,4,0,2,2,0,0,0,1,0,4
401402486,Eastern Kentucky Colonels,E. Hacker,4595770,,False,20.0,2,7,1,3,1,4,1,1,0,0,0,1,0,0,0,3,6
401402486,Eastern Kentucky Colonels,B. Fox,4595283,,False,13.0,4,4,4,4,0,0,0,0,2,2,4,0,0,0,2,1,8
401402486,Eastern Kentucky Colonels,K. Lacy,4898925,,False,10.0,3,6,0,2,3,4,6,6,0,0,0,1,1,0,0,0,15
401402486,Eastern Kentucky Colonels,K. Freeman,4898922,,False,18.0,1,1,1,1,0,0,0,0,0,0,0,3,0,0,1,1,2
401402486,Eastern Kentucky Colonels,A. Collett,4704580,,False,3.0,0,1,0,1,0,0,0,0,0,0,0,0,0,0,0,1,0
401402486,Eastern Kentucky Colonels,A. Kirkwood,4595834,,False,23.0,2,4,2,4,0,0,0,0,1,4,5,1,3,2,2,1,4
401402486,Eastern Kentucky Colonels,TEAM,TOTAL,TOTAL,False,,18,51,13,34,5,17,16,19,8,17,25,8,5,4,11,15,57
401402485,Kennesaw State Owls,A. Poole,4281286,,True,24.0,6,9,6,9,0,0,1,2,3,5,8,1,2,0,2,2,13
401402485,Kennesaw State Owls,G. Piccolino,4594408,,True,15.0,1,6,1,3,0,3,0,0,0,2,2,0,1,0,0,0,2
401402485,Kennesaw State Owls,B. Snipes,4433496,,True,25.0,3,10,2,4,1,6,0,0,0,2,2,0,0,0,1,4,7
401402485,Kennesaw State Owls,J. Whitfield,4400015,,True,32.0,3,14,2,9,1,5,0,0,1,4,5,4,0,0,7,2,7
401402485,Kennesaw State Owls,A. Johnson,4399866,,True,40.0,5,10,4,7,1,3,2,4,0,3,3,5,1,0,3,3,13
401402485,Kennesaw State Owls,P. Harden,4898937,,False,16.0,0,3,0,3,0,0,0,0,2,2,4,2,0,0,1,0,0
401402485,Kennesaw State Owls,S. Jones,4704235,,False,20.0,2,5,2,5,0,0,5,6,1,3,4,0,0,0,3,0,9
401402485,Kennesaw State Owls,G. Legister,4594407,,False,5.0,0,1,0,1,0,0,0,0,0,1,1,0,0,0,0,2,0
401402485,Kennesaw State Owls,A. Baker,4898936,,False,23.0,2,4,0,1,2,3,0,0,1,1,2,0,0,0,1,3,6
401402485,Kennesaw State Owls,A. Free,4710732,,False,0.0,0,0,0,0,0,0,0,0,0,0,0,0,0,0,0,0,0
401402485,Kennesaw State Owls,TEAM,TOTAL,TOTAL,False,,22,62,17,42,5,20,8,12,12,26,38,12,4,0,18,16,57
401402485,Eastern Kentucky Colonels,J. Johnson,4282607,,True,18.0,3,11,2,8,1,3,2,2,2,1,3,0,2,0,2,2,9
401402485,Eastern Kentucky Colonels,I. Green,4067989,,True,37.0,6,11,6,11,0,0,1,2,3,5,8,1,3,5,2,2,13
401402485,Eastern Kentucky Colonels,B. Crittendon,4898923,,True,27.0,2,7,2,5,0,2,1,2,1,3,4,3,2,1,2,1,5
401402485,Eastern Kentucky Colonels,A. Recanati,4705072,,True,39.0,6,9,5,7,1,2,1,2,0,3,3,5,1,0,2,1,14
401402485,Eastern Kentucky Colonels,B. Bass,4282431,,True,29.0,3,9,2,6,1,3,3,3,0,8,8,2,0,0,4,3,10
401402485,Eastern Kentucky Colonels,A. Jordan,4595771,,False,0.0,0,0,0,0,0,0,0,0,0,0,0,0,0,0,0,0,0
401402485,Eastern Kentucky Colonels,E. Hacker,4595770,,False,18.0,3,4,1,1,2,3,2,2,1,2,3,1,1,3,1,1,10
401402485,Eastern Kentucky Colonels,B. Fox,4595283,,False,2.0,0,0,0,0,0,0,0,0,0,0,0,0,0,0,0,0,0
401402485,Eastern Kentucky Colonels,G. Baldwin,4710360,,False,0.0,0,0,0,0,0,0,0,0,0,0,0,0,0,0,0,0,0
401402485,Eastern Kentucky Colonels,K. Lacy,4898925,,False,0.0,0,1,0,0,0,1,0,0,0,0,0,0,0,0,0,0,0
401402485,Eastern Kentucky Colonels,K. Freeman,4898922,,False,11.0,0,2,0,2,0,0,5,6,0,0,0,2,1,0,0,2,5
401402485,Eastern Kentucky Colonels,A. Collett,4704580,,False,0.0,0,0,0,0,0,0,0,0,0,0,0,0,0,0,0,0,0
401402485,Eastern Kentucky Colonels,A. Kirkwood,4595834,,False,19.0,2,6,1,4,1,2,0,0,2,7,9,4,0,1,1,2,5
401402485,Eastern Kentucky Colonels,A. Khlopkova,4595244,,False,0.0,0,0,0,0,0,0,0,0,0,1,1,0,0,0,0,0,0
401402485,Eastern Kentucky Colonels,TEAM,TOTAL,TOTAL,False,,25,60,19,44,6,16,15,19,11,30,41,18,10,10,14,14,71
401402484,Jacksonville Dolphins,S. Jackson,4400219,,True,22.0,0,2,0,1,0,1,5,6,1,2,3,2,1,0,3,2,5
401402484,Jacksonville Dolphins,K. Hayes,4898930,,True,25.0,3,8,3,8,0,0,3,6,2,5,7,2,1,4,3,4,9
401402484,Jacksonville Dolphins,D. Graham,4704541,,True,34.0,5,10,4,7,1,3,2,3,3,2,5,3,1,0,3,4,13
401402484,Jacksonville Dolphins,C. Walker,4594884,,True,34.0,1,3,1,2,0,1,3,4,0,3,3,0,1,0,0,3,5
401402484,Jacksonville Dolphins,T. Hawks,4282437,,True,34.0,3,9,2,6,1,3,2,4,0,3,3,3,0,0,2,0,9
401402484,Jacksonville Dolphins,A. Jones,4066544,,False,30.0,7,11,7,11,0,0,0,0,3,5,8,0,2,2,5,0,14
401402484,Jacksonville Dolphins,M. Edwards,4595196,,False,3.0,0,0,0,0,0,0,0,0,1,0,1,0,0,0,1,0,0
401402484,Jacksonville Dolphins,J. Dunlap,4898927,,False,18.0,4,7,2,3,2,4,0,1,0,1,1,0,1,0,0,0,10
401402484,Jacksonville Dolphins,D. Gillard,4704988,,False,0.0,0,0,0,0,0,0,0,0,0,0,0,0,0,0,1,0,0
401402484,Jacksonville Dolphins,TEAM,TOTAL,TOTAL,False,,23,50,19,38,4,12,15,24,11,29,40,10,7,6,18,13,65
401402484,Central Arkansas Sugar Bears,H. Langhi,4282339,,True,31.0,6,10,5,8,1,2,0,0,1,3,4,3,2,1,3,4,13
401402484,Central Arkansas Sugar Bears,L. Ibeh,4704733,,True,19.0,0,7,0,7,0,0,4,4,0,7,7,0,0,0,4,3,4
401402484,Central Arkansas Sugar Bears,R. Wright,4898916,,True,26.0,0,3,0,2,0,1,6,6,0,1,1,0,0,0,4,2,6
401402484,Central Arkansas Sugar Bears,S. Walker,4595678,,True,28.0,1,4,0,3,1,1,2,2,0,3,3,1,1,0,1,0,5
401402484,Central Arkansas Sugar Bears,C. Hudspeth,4400268,,True,35.0,4,17,1,3,3,14,2,2,1,2,3,1,1,0,1,2,13
401402484,Central Arkansas Sugar Bears,L. Fowler,4898917,,False,18.0,2,6,1,2,1,4,2,2,1,1,2,0,1,0,0,3,7
401402484,Central Arkansas Sugar Bears,L. Perry,4898915,,False,2.0,0,0,0,0,0,0,0,0,0,0,0,0,0,0,0,0,0
401402484,Central Arkansas Sugar Bears,R. Balogun,4704729,,False,20.0,3,5,3,5,0,0,1,1,1,2,3,1,1,0,0,5,7
401402484,Central Arkansas Sugar Bears,J. Cody,4704730,,False,10.0,0,0,0,0,0,0,0,0,0,1,1,1,0,0,0,0,0
401402484,Central Arkansas Sugar Bears,R. James,4898919,,False,11.0,0,1,0,1,0,0,0,0,0,0,0,1,0,0,0,4,0
401402484,Central Arkansas Sugar Bears,TEAM,TOTAL,TOTAL,False,,16,53,10,31,6,22,17,17,8,21,29,8,6,1,14,23,55
401402483,Stetson Hatters,T. Streun,4068737,,True,28.0,5,12,3,6,2,6,3,3,5,9,14,0,5,1,1,1,15
401402483,Stetson Hatters,A. Dublin,4068372,,True,20.0,4,6,4,6,0,0,2,2,2,1,3,1,1,0,0,3,10
401402483,Stetson Hatters,A. Hargrove,4898851,,True,21.0,5,9,5,8,0,1,1,2,1,3,4,1,2,2,2,2,11
401402483,Stetson Hatters,Y. Wazeerud-Din,4704531,,True,28.0,4,10,4,5,0,5,8,10,3,0,3,2,2,0,2,2,16
401402483,Stetson Hatters,J. Turner,4594427,,True,28.0,1,10,1,10,0,0,1,3,2,5,7,3,1,0,0,2,3
401402483,Stetson Hatters,M. Morgan-Elliott,4595304,,False,17.0,3,9,1,5,2,4,0,0,1,2,3,2,0,0,2,2,8
401402483,Stetson Hatters,H. Stinebrickner,4898850,,False,2.0,0,0,0,0,0,0,0,0,0,0,0,0,0,0,2,0,0
401402483,Stetson Hatters,T. Robertson,4704530,,False,20.0,0,3,0,2,0,1,3,4,0,3,3,1,0,0,1,0,3
401402483,Stetson Hatters,K. Turner,4595013,,False,24.0,5,7,5,7,0,0,0,0,1,4,5,4,3,0,3,1,10
401402483,Stetson Hatters,M. Novak,4594431,,False,1.0,0,0,0,0,0,0,0,0,0,1,1,0,0,0,0,0,0
401402483,Stetson Hatters,K. McNeal,4594274,,False,11.0,2,5,1,2,1,3,0,0,1,0,1,1,0,0,0,4,5
401402483,Stetson Hatters,TEAM,TOTAL,TOTAL,False,,29,71,24,51,5,20,18,24,17,30,47,15,14,3,13,17,81
401402483,Bellarmine Knights,K. Scott,4704194,,True,23.0,2,3,2,3,0,0,1,2,1,5,6,0,0,0,6,4,5
401402483,Bellarmine Knights,C. Knies,4704192,,True,23.0,4,10,4,8,0,2,0,1,0,1,1,0,0,0,0,1,8
401402483,Bellarmine Knights,P. Brown,4704190,,True,24.0,1,8,1,5,0,3,0,0,1,6,7,5,1,0,4,4,2
401402483,Bellarmine Knights,B. Harney,4704186,,True,31.0,3,7,1,3,2,4,1,2,0,3,3,2,0,0,2,2,9
401402483,Bellarmine Knights,J. Johnson,4399356,,True,30.0,4,9,3,4,1,5,4,4,1,3,4,5,1,0,6,2,13
401402483,Bellarmine Knights,H. Stoklosa,4898845,,False,6.0,0,1,0,1,0,0,0,0,0,0,0,0,1,0,1,4,0
401402483,Bellarmine Knights,L. Robertson,4704191,,False,11.0,1,2,1,2,0,0,0,0,0,1,1,0,0,1,3,1,2
401402483,Bellarmine Knights,S. Coatney,4400569,,False,12.0,1,2,1,2,0,0,2,2,0,1,1,0,0,2,1,2,4
401402483,Bellarmine Knights,B. Trice,4898847,,False,18.0,1,2,0,1,1,1,0,0,0,2,2,1,0,0,1,4,3
401402483,Bellarmine Knights,M. Keelin,4595970,,False,22.0,3,11,2,2,1,9,0,0,1,3,4,0,0,0,1,2,7
401402483,Bellarmine Knights,TEAM,TOTAL,TOTAL,False,,20,55,15,31,5,24,8,11,7,27,34,13,3,3,25,26,53
401402482,North Florida Ospreys,S. Evans,4704297,,True,29.0,3,5,1,2,2,3,2,2,0,0,0,1,0,0,1,2,10
401402482,North Florida Ospreys,E. Broermann,4594421,,True,15.0,3,6,3,6,0,0,3,3,0,3,3,1,1,1,1,3,9
401402482,North Florida Ospreys,Jazz Bond,4399879,,True,31.0,3,7,1,3,2,4,3,4,0,10,10,1,0,3,1,0,11
401402482,North Florida Ospreys,A. Knights,4704296,,True,19.0,0,3,0,0,0,3,0,0,0,1,1,2,0,0,1,0,0
401402482,North Florida Ospreys,R. Moore,4281335,,True,33.0,0,6,0,3,0,3,2,2,0,12,12,5,2,1,2,0,2
401402482,North Florida Ospreys,B. Gore,4703762,,False,7.0,0,1,0,1,0,0,2,2,0,0,0,0,1,0,1,1,2
401402482,North Florida Ospreys,T. Thompson,4281352,,False,21.0,4,8,3,7,1,1,0,0,1,3,4,0,1,0,4,2,9
401402482,North Florida Ospreys,K. Rougier,4898860,,False,12.0,3,4,3,4,0,0,0,0,0,1,1,0,1,0,0,1,6
401402482,North Florida Ospreys,N. Benedith,4704294,,False,19.0,3,4,3,3,0,1,0,0,0,1,1,1,0,0,1,2,6
401402482,North Florida Ospreys,Jai. Bond,4599315,,False,13.0,1,2,0,1,1,1,0,0,0,0,0,0,0,0,0,2,3
401402482,North Florida Ospreys,T. Tolbert,4281337,,False,1.0,0,0,0,0,0,0,2,2,0,0,0,0,0,0,0,0,2
401402482,North Florida Ospreys,TEAM,TOTAL,TOTAL,False,,20,46,14,30,6,16,14,15,1,33,34,11,6,5,13,13,60
401402482,Lipscomb Bisons,D. Harrison,4280853,,True,17.0,2,8,2,8,0,0,2,2,2,5,7,0,0,0,3,2,6
401402482,Lipscomb Bisons,J. Peete,4704197,,True,33.0,0,1,0,1,0,0,0,0,0,0,0,2,0,0,3,3,0
401402482,Lipscomb Bisons,J. Holcomb,4594409,,True,36.0,8,13,3,4,5,9,0,0,2,10,12,2,1,0,1,2,21
401402482,Lipscomb Bisons,B. Pearson,4433723,,True,32.0,0,9,0,1,0,8,0,0,0,2,2,0,0,0,0,3,0
401402482,Lipscomb Bisons,S. Shelton,4068069,,True,20.0,1,8,0,2,1,6,2,2,0,1,1,0,0,0,0,3,5
401402482,Lipscomb Bisons,N. Hemphill,4596034,,False,1.0,0,0,0,0,0,0,0,0,0,0,0,0,0,0,0,0,0
401402482,Lipscomb Bisons,D. Saleh,4704198,,False,1.0,0,0,0,0,0,0,0,0,0,0,0,0,0,0,0,0,0
401402482,Lipscomb Bisons,B. Jones,4898944,,False,1.0,0,0,0,0,0,0,0,0,0,0,0,0,0,0,0,0,0
401402482,Lipscomb Bisons,B. Vinson,4898943,,False,29.0,2,8,1,2,1,6,1,2,1,3,4,1,0,5,0,1,6
401402482,Lipscomb Bisons,C. Collier,4594410,,False,19.0,1,6,1,3,0,3,0,0,1,0,1,2,1,1,4,4,2
401402482,Lipscomb Bisons,M. Cook,4282392,,False,11.0,1,4,1,4,0,0,0,0,1,3,4,1,0,0,2,0,2
401402482,Lipscomb Bisons,TEAM,TOTAL,TOTAL,False,,15,57,8,25,7,32,5,6,9,25,34,8,2,6,15,18,42
401402481,NC State Wolfpack,K. Jones,4281199,,True,24.0,2,5,1,2,1,3,1,2,3,7,10,1,1,2,0,1,6
401402481,NC State Wolfpack,E. Cunane,4398625,,True,26.0,5,11,5,9,0,2,7,8,3,5,8,0,0,1,2,1,17
401402481,NC State Wolfpack,J. Brown-Turner,4432841,,True,28.0,0,6,0,4,0,2,2,2,1,2,3,1,1,0,1,2,2
401402481,NC State Wolfpack,K. Crutchfield,4281198,,True,32.0,1,4,1,3,0,1,0,0,1,4,5,2,1,0,0,0,2
401402481,NC State Wolfpack,R. Perez,4068715,,True,36.0,5,14,3,9,2,5,0,0,0,2,2,1,0,0,1,1,12
401402481,NC State Wolfpack,J. Boyd,4432859,,False,16.0,1,2,1,2,0,0,0,0,0,3,3,1,2,1,0,1,2
401402481,NC State Wolfpack,C. Hobby,4433005,,False,14.0,3,7,3,7,0,0,2,2,1,2,3,1,0,0,3,2,8
401402481,NC State Wolfpack,D. Johnson,4703768,,False,24.0,3,8,1,2,2,6,3,4,0,2,2,3,3,0,2,1,11
401402481,NC State Wolfpack,TEAM,TOTAL,TOTAL,False,,20,57,15,38,5,19,15,18,10,27,37,10,8,4,9,9,60
401402481,Miami Hurricanes,L. Pendande,4398863,,True,15.0,3,5,3,5,0,0,2,4,2,4,6,0,0,0,1,5,8
401402481,Miami Hurricanes,D. Harden,4281329,,True,27.0,3,6,3,5,0,1,0,0,2,2,4,0,2,0,0,1,6
401402481,Miami Hurricanes,J. Williams,4898556,,True,30.0,2,13,1,11,1,2,0,0,2,5,7,2,1,0,1,1,5
401402481,Miami Hurricanes,K. Erjavec,4400202,,True,30.0,0,4,0,1,0,3,2,2,0,3,3,1,0,0,3,1,2
401402481,Miami Hurricanes,K. Marshall,4281196,,True,35.0,9,19,7,9,2,10,4,4,0,4,4,2,0,0,3,2,24
401402481,Miami Hurricanes,N. Mbandu,4703227,,False,21.0,0,1,0,0,0,1,2,2,0,1,1,1,2,0,1,2,2
401402481,Miami Hurricanes,P. Fraile Ruiz,4703226,,False,2.0,0,1,0,1,0,0,0,0,0,0,0,0,0,1,0,0,0
401402481,Miami Hurricanes,M. Djaldi-Tabdi,4281214,,False,18.0,0,3,0,1,0,2,0,0,2,4,6,1,0,2,1,2,0
401402481,Miami Hurricanes,J. Roberts,4898555,,False,2.0,0,0,0,0,0,0,0,0,0,1,1,0,0,0,2,0,0
401402481,Miami Hurricanes,M. Johnson Sidi Baba,4594386,,False,9.0,0,0,0,0,0,0,0,0,0,2,2,0,0,0,0,0,0
401402481,Miami Hurricanes,M. Gray,4281194,,False,11.0,0,2,0,2,0,0,0,0,0,0,0,0,0,0,2,1,0
401402481,Miami Hurricanes,TEAM,TOTAL,TOTAL,False,,17,54,14,35,3,19,10,12,10,28,38,7,5,3,14,15,47
401402480,Notre Dame Fighting Irish,M. Westbeld,4433424,,True,35.0,5,12,3,6,2,6,2,4,0,9,9,0,1,0,3,3,14
401402480,Notre Dame Fighting Irish,M. Dodson,4282166,,True,29.0,5,9,5,9,0,0,0,0,1,4,5,1,0,2,2,4,10
401402480,Notre Dame Fighting Irish,O. Miles,4433791,,True,30.0,2,7,1,5,1,2,2,2,0,2,2,5,1,0,3,3,7
401402480,Notre Dame Fighting Irish,S. Citron,4433524,,True,37.0,5,8,5,8,0,0,0,0,1,6,7,4,2,0,2,3,10
401402480,Notre Dame Fighting Irish,D. Mabrey,4398736,,True,36.0,2,6,1,2,1,4,0,0,1,3,4,1,0,0,2,3,5
401402480,Notre Dame Fighting Irish,S. Brunelle,4433631,,False,16.0,1,5,0,2,1,3,0,0,0,2,2,0,0,0,0,2,3
401402480,Notre Dame Fighting Irish,A. Peoples,4432842,,False,17.0,2,4,1,3,1,1,0,0,0,1,1,0,2,0,0,1,5
401402480,Notre Dame Fighting Irish,TEAM,TOTAL,TOTAL,False,,22,51,16,35,6,16,4,6,3,28,31,11,6,2,12,19,54
401402480,Miami Hurricanes,L. Pendande,4398863,,True,31.0,2,7,2,7,0,0,2,2,3,3,6,1,0,2,1,2,6
401402480,Miami Hurricanes,D. Harden,4281329,,True,28.0,2,8,1,6,1,2,1,2,2,5,7,0,0,0,1,2,6
401402480,Miami Hurricanes,J. Williams,4898556,,True,23.0,2,4,2,4,0,0,0,0,0,2,2,4,0,0,3,3,4
401402480,Miami Hurricanes,K. Erjavec,4400202,,True,32.0,4,6,3,3,1,3,1,2,0,4,4,0,1,0,5,0,10
401402480,Miami Hurricanes,K. Marshall,4281196,,True,37.0,6,14,2,3,4,11,2,4,0,5,5,3,1,0,1,3,18
401402480,Miami Hurricanes,N. Mbandu,4703227,,False,12.0,0,3,0,2,0,1,0,0,1,2,3,1,1,0,0,0,0
401402480,Miami Hurricanes,M. Djaldi-Tabdi,4281214,,False,5.0,1,3,1,3,0,0,0,0,2,0,2,0,0,1,1,1,2
401402480,Miami Hurricanes,M. Johnson Sidi Baba,4594386,,False,9.0,2,5,2,5,0,0,1,2,1,1,2,0,0,0,0,1,5
401402480,Miami Hurricanes,M. Gray,4281194,,False,23.0,2,5,1,2,1,3,1,2,0,0,0,3,1,0,1,0,6
401402480,Miami Hurricanes,TEAM,TOTAL,TOTAL,False,,21,55,14,35,7,20,8,14,11,25,36,12,4,3,14,12,57
401402478,Virginia Tech Hokies,A. Baines,4432945,,True,25.0,3,4,3,4,0,0,0,1,0,5,5,1,1,2,4,3,6
401402478,Virginia Tech Hokies,G. Amoore,4704180,,True,38.0,4,17,2,9,2,8,2,2,1,1,2,3,2,0,1,2,12
401402478,Virginia Tech Hokies,K. Traylor,4398947,,True,36.0,4,12,3,9,1,3,9,9,1,0,1,1,3,0,1,1,18
401402478,Virginia Tech Hokies,A. Sheppard,4281223,,True,29.0,3,11,3,8,0,3,2,2,0,2,2,2,0,1,1,2,8
401402478,Virginia Tech Hokies,E. Lytle,4069122,,True,26.0,1,3,1,2,0,1,2,2,0,3,3,0,0,0,0,3,4
401402478,Virginia Tech Hokies,D. Gregg,4398592,,False,30.0,2,6,2,4,0,2,0,0,0,6,6,2,0,0,1,0,4
401402478,Virginia Tech Hokies,T. Geiman,4433342,,False,16.0,1,1,0,0,1,1,0,0,0,2,2,0,1,0,0,0,3
401402478,Virginia Tech Hokies,TEAM,TOTAL,TOTAL,False,,18,54,14,36,4,18,15,16,4,19,23,9,7,3,8,11,55
401402478,NC State Wolfpack,K. Jones,4281199,,True,19.0,2,8,1,4,1,4,0,0,2,3,5,4,0,0,1,1,5
401402478,NC State Wolfpack,E. Cunane,4398625,,True,33.0,8,16,6,13,2,3,2,2,6,7,13,1,0,2,4,2,20
401402478,NC State Wolfpack,J. Brown-Turner,4432841,,True,36.0,2,5,2,3,0,2,3,5,1,5,6,6,0,1,2,3,7
401402478,NC State Wolfpack,K. Crutchfield,4281198,,True,37.0,2,7,0,1,2,6,0,0,1,6,7,3,1,0,0,2,6
401402478,NC State Wolfpack,R. Perez,4068715,,True,25.0,4,8,3,5,1,3,0,0,1,2,3,1,2,0,1,3,9
401402478,NC State Wolfpack,J. Boyd,4432859,,False,20.0,7,10,7,10,0,0,2,2,2,2,4,1,0,2,2,3,16
401402478,NC State Wolfpack,C. Hobby,4433005,,False,7.0,0,2,0,2,0,0,0,0,0,2,2,0,0,0,0,0,0
401402478,NC State Wolfpack,D. Johnson,4703768,,False,19.0,3,9,2,2,1,7,0,0,2,0,2,0,1,0,2,1,7
401402478,NC State Wolfpack,J. Timmons,4433811,,False,1.0,0,0,0,0,0,0,0,0,0,0,0,0,0,0,0,0,0
401402478,NC State Wolfpack,A. James,4433807,,False,1.0,0,0,0,0,0,0,0,0,0,0,0,0,0,0,1,1,0
401402478,NC State Wolfpack,G. Bryant,4433450,,False,1.0,0,0,0,0,0,0,0,0,0,0,0,0,0,0,0,0,0
401402478,NC State Wolfpack,M. Hayes,4433413,,False,1.0,0,0,0,0,0,0,0,0,0,0,0,0,0,0,0,0,0
401402478,NC State Wolfpack,TEAM,TOTAL,TOTAL,False,,28,65,21,40,7,25,7,9,16,33,49,16,4,5,13,16,70
401402476,Notre Dame Fighting Irish,M. Westbeld,4433424,,True,28.0,7,12,6,9,1,3,2,2,1,7,8,0,1,1,1,5,17
401402476,Notre Dame Fighting Irish,M. Dodson,4282166,,True,26.0,3,6,3,6,0,0,0,1,2,4,6,1,1,3,3,3,6
401402476,Notre Dame Fighting Irish,O. Miles,4433791,,True,39.0,7,14,4,7,3,7,0,2,0,6,6,13,2,0,3,1,17
401402476,Notre Dame Fighting Irish,S. Citron,4433524,,True,36.0,5,7,4,5,1,2,1,1,2,4,6,0,1,0,3,1,12
401402476,Notre Dame Fighting Irish,D. Mabrey,4398736,,True,32.0,2,8,1,1,1,7,0,0,0,1,1,1,1,0,2,1,5
401402476,Notre Dame Fighting Irish,S. Brunelle,4433631,,False,26.0,5,9,1,1,4,8,0,0,0,3,3,0,0,0,1,1,14
401402476,Notre Dame Fighting Irish,A. Peoples,4432842,,False,13.0,0,0,0,0,0,0,0,0,0,1,1,0,0,0,0,2,0
401402476,Notre Dame Fighting Irish,TEAM,TOTAL,TOTAL,False,,29,56,19,29,10,27,3,6,5,28,33,15,6,4,13,14,71
401402476,Georgia Tech Yellow Jackets,D. Strautmane,4281221,,True,31.0,4,10,0,2,4,8,0,0,1,4,5,1,0,1,1,4,12
401402476,Georgia Tech Yellow Jackets,L. Cubaj,4281183,,True,37.0,2,11,2,9,0,2,0,0,3,8,11,5,2,1,2,1,4
401402476,Georgia Tech Yellow Jackets,N. Hermosa,4433347,,True,29.0,2,5,2,5,0,0,2,2,0,1,1,0,0,0,3,1,6
401402476,Georgia Tech Yellow Jackets,E. Love,4433461,,True,35.0,4,12,4,11,0,1,3,4,3,3,6,5,1,0,2,4,11
401402476,Georgia Tech Yellow Jackets,L. Lahtinen,4398593,,True,34.0,2,13,0,7,2,6,2,2,1,2,3,4,0,0,4,1,8
401402476,Georgia Tech Yellow Jackets,A. Wone Aranaz,4433369,,False,7.0,0,0,0,0,0,0,0,0,1,0,1,0,0,0,1,0,0
401402476,Georgia Tech Yellow Jackets,A. Carter,4433754,,False,4.0,1,2,1,2,0,0,1,2,2,0,2,0,0,0,0,0,3
401402476,Georgia Tech Yellow Jackets,S. Bates,4281728,,False,23.0,3,7,0,0,3,7,0,0,0,2,2,0,0,1,0,1,9
401402476,Georgia Tech Yellow Jackets,TEAM,TOTAL,TOTAL,False,,18,60,9,36,9,24,8,10,13,23,36,15,3,3,13,12,53
401402475,Miami Hurricanes,L. Pendande,4398863,,True,25.0,2,6,2,6,0,0,2,2,1,2,3,0,3,0,2,2,6
401402475,Miami Hurricanes,D. Harden,4281329,,True,25.0,11,15,7,10,4,5,1,1,2,8,10,0,1,0,3,3,27
401402475,Miami Hurricanes,J. Williams,4898556,,True,29.0,3,8,3,6,0,2,2,2,1,4,5,4,4,0,3,0,8
401402475,Miami Hurricanes,K. Erjavec,4400202,,True,31.0,0,5,0,2,0,3,0,0,0,1,1,7,0,0,1,1,0
401402475,Miami Hurricanes,K. Marshall,4281196,,True,31.0,1,5,1,2,0,3,0,0,0,0,0,2,0,0,4,4,2
401402475,Miami Hurricanes,N. Mbandu,4703227,,False,22.0,5,8,3,5,2,3,0,0,1,1,2,1,1,0,0,1,12
401402475,Miami Hurricanes,M. Djaldi-Tabdi,4281214,,False,8.0,0,0,0,0,0,0,0,0,0,0,0,0,0,0,2,1,0
401402475,Miami Hurricanes,J. Roberts,4898555,,False,6.0,0,0,0,0,0,0,0,0,0,0,0,1,0,0,1,0,0
401402475,Miami Hurricanes,M. Johnson Sidi Baba,4594386,,False,6.0,0,1,0,1,0,0,0,0,0,0,0,1,0,0,0,1,0
401402475,Miami Hurricanes,M. Gray,4281194,,False,17.0,2,7,0,2,2,5,0,0,1,0,1,1,0,0,2,2,6
401402475,Miami Hurricanes,TEAM,TOTAL,TOTAL,False,,24,55,16,34,8,21,5,5,9,16,25,17,9,0,18,15,61
401402475,Louisville Cardinals,O. Cochran,4433426,,True,19.0,2,3,2,3,0,0,3,4,3,1,4,0,0,0,2,2,7
401402475,Louisville Cardinals,E. Engstler,4398729,,True,32.0,3,8,1,4,2,4,0,0,4,5,9,2,0,0,6,2,8
401402475,Louisville Cardinals,H. Van Lith,4433412,,True,29.0,2,10,2,8,0,2,4,4,2,3,5,2,0,0,4,0,8
401402475,Louisville Cardinals,K. Smith,4281919,,True,33.0,4,13,2,6,2,7,0,0,0,3,3,2,3,0,3,0,10
401402475,Louisville Cardinals,C. Hall,4280897,,True,29.0,4,8,3,5,1,3,4,4,0,1,1,2,2,0,2,3,13
401402475,Louisville Cardinals,L. Dixon,4398591,,False,20.0,1,1,1,1,0,0,4,6,0,2,2,0,1,2,2,1,6
401402475,Louisville Cardinals,P. Verhulst,4433518,,False,6.0,2,2,1,1,1,1,0,0,0,1,1,0,0,0,0,0,5
401402475,Louisville Cardinals,N. Konno,4433094,,False,1.0,0,0,0,0,0,0,0,0,0,0,0,0,0,0,0,0,0
401402475,Louisville Cardinals,A. Smith,4398835,,False,6.0,1,3,1,2,0,1,0,0,0,1,1,0,0,0,1,1,2
401402475,Louisville Cardinals,M. Robinson,4398604,,False,25.0,0,1,0,1,0,0,0,0,0,1,1,3,2,0,1,0,0
401402475,Louisville Cardinals,TEAM,TOTAL,TOTAL,False,,19,49,13,31,6,18,15,18,12,20,32,11,8,2,21,9,59
401402474,NC State Wolfpack,K. Jones,4281199,,True,15.0,3,7,3,6,0,1,3,3,1,3,4,1,1,0,0,2,9
401402474,NC State Wolfpack,E. Cunane,4398625,,True,23.0,6,9,5,8,1,1,2,3,3,3,6,1,2,1,2,1,15
401402474,NC State Wolfpack,J. Brown-Turner,4432841,,True,29.0,7,9,6,7,1,2,0,0,1,5,6,6,2,0,0,0,15
401402474,NC State Wolfpack,K. Crutchfield,4281198,,True,26.0,2,5,0,1,2,4,0,0,0,4,4,1,1,0,0,2,6
401402474,NC State Wolfpack,R. Perez,4068715,,True,25.0,3,4,2,2,1,2,0,0,0,1,1,0,0,0,3,0,7
401402474,NC State Wolfpack,J. Boyd,4432859,,False,20.0,5,7,5,7,0,0,2,2,0,3,3,1,0,0,1,0,12
401402474,NC State Wolfpack,S. Hart,4898385,,False,3.0,0,1,0,1,0,0,0,0,0,0,0,0,0,0,0,0,0
401402474,NC State Wolfpack,C. Hobby,4433005,,False,14.0,1,1,1,1,0,0,0,0,1,1,2,1,1,0,0,2,2
401402474,NC State Wolfpack,D. Johnson,4703768,,False,20.0,3,13,2,5,1,8,0,0,0,2,2,1,0,0,1,3,7
401402474,NC State Wolfpack,J. Timmons,4433811,,False,7.0,0,0,0,0,0,0,0,2,1,0,1,0,0,0,0,1,0
401402474,NC State Wolfpack,A. James,4433807,,False,10.0,3,5,1,1,2,4,1,1,1,2,3,0,0,0,2,0,9
401402474,NC State Wolfpack,G. Bryant,4433450,,False,3.0,0,0,0,0,0,0,2,2,0,0,0,1,0,0,0,1,2
401402474,NC State Wolfpack,M. Hayes,4433413,,False,5.0,0,2,0,2,0,0,0,0,2,1,3,0,0,0,0,0,0
401402474,NC State Wolfpack,TEAM,TOTAL,TOTAL,False,,33,63,25,41,8,22,10,13,10,28,38,13,7,1,9,12,84
401402474,Florida State Seminoles,E. Howard,4398609,,True,24.0,1,3,1,1,0,2,0,0,0,3,3,0,1,1,2,3,2
401402474,Florida State Seminoles,R. Baldwin,4433304,,True,18.0,1,3,1,3,0,0,0,0,0,3,3,0,0,0,2,2,2
401402474,Florida State Seminoles,O. Gordon,4433520,,True,19.0,3,7,2,6,1,1,2,2,1,1,2,2,1,0,4,1,9
401402474,Florida State Seminoles,S. Puisis,4432862,,True,20.0,0,2,0,2,0,0,0,0,1,4,5,0,1,0,0,0,0
401402474,Florida State Seminoles,M. Jones,2984250,,True,27.0,3,9,3,9,0,0,1,2,0,2,2,1,0,0,1,0,7
401402474,Florida State Seminoles,M. Valenzuela,4683035,,False,6.0,0,2,0,2,0,0,0,0,0,0,0,0,1,0,0,0,0
401402474,Florida State Seminoles,M. Timpson,4433546,,False,14.0,3,4,3,4,0,0,0,0,1,1,2,0,0,1,1,4,6
401402474,Florida State Seminoles,V. Myers,4398583,,False,18.0,2,6,2,6,0,0,1,2,2,0,2,1,1,1,2,3,5
401402474,Florida State Seminoles,S. Bejedi,4595844,,False,21.0,8,11,5,8,3,3,2,4,0,0,0,1,0,0,3,2,21
401402474,Florida State Seminoles,I. Nicoletti,4398584,,False,2.0,0,1,0,0,0,1,0,0,0,0,0,0,0,0,0,0,0
401402474,Florida State Seminoles,K. Weber,4398582,,False,12.0,0,0,0,0,0,0,0,0,0,0,0,2,0,1,0,0,0
401402474,Florida State Seminoles,B. Jackson,4280885,,False,19.0,0,7,0,5,0,2,2,2,0,3,3,1,0,1,0,1,2
401402474,Florida State Seminoles,TEAM,TOTAL,TOTAL,False,,21,55,17,46,4,9,8,12,7,21,28,8,5,5,15,16,54
401402473,Virginia Tech Hokies,A. Baines,4432945,,True,17.0,2,4,2,4,0,0,0,0,1,3,4,1,0,0,1,3,4
401402473,Virginia Tech Hokies,E. Kitley,4433309,,True,11.0,3,3,3,3,0,0,0,0,0,2,2,1,0,0,2,1,6
401402473,Virginia Tech Hokies,G. Amoore,4704180,,True,45.0,6,12,2,3,4,9,6,6,0,5,5,6,1,0,3,3,22
401402473,Virginia Tech Hokies,K. Traylor,4398947,,True,39.0,6,11,4,5,2,6,5,6,0,3,3,3,0,0,1,3,19
401402473,Virginia Tech Hokies,A. Sheppard,4281223,,True,43.0,6,13,2,3,4,10,6,7,0,2,2,2,0,0,3,3,22
401402473,Virginia Tech Hokies,D. Gregg,4398592,,False,32.0,3,6,2,4,1,2,3,6,0,8,8,3,0,0,4,1,10
401402473,Virginia Tech Hokies,E. Lytle,4069122,,False,38.0,1,4,1,2,0,2,2,2,1,1,2,2,1,0,0,1,4
401402473,Virginia Tech Hokies,TEAM,TOTAL,TOTAL,False,,27,53,16,24,11,29,22,27,3,29,32,18,2,0,14,15,87
401402473,North Carolina Tar Heels,A. Poole,4434028,,True,34.0,6,9,6,9,0,0,2,5,6,4,10,1,2,1,1,4,14
401402473,North Carolina Tar Heels,K. Todd-Williams,4433740,,True,37.0,5,14,4,8,1,6,0,0,3,6,9,1,1,0,1,1,11
401402473,North Carolina Tar Heels,A. Ustby,4433489,,True,36.0,7,13,5,9,2,4,2,2,1,6,7,4,2,0,2,5,18
401402473,North Carolina Tar Heels,D. Kelly,4433410,,True,40.0,6,16,5,14,1,2,5,8,0,3,3,6,1,0,2,4,18
401402473,North Carolina Tar Heels,C. Littlefield,4281403,,True,41.0,3,10,3,7,0,3,0,0,0,4,4,1,0,0,1,3,6
401402473,North Carolina Tar Heels,A. Zelaya,4433778,,False,4.0,0,0,0,0,0,0,0,0,1,0,1,0,0,0,0,1,0
401402473,North Carolina Tar Heels,M. Tshitenge,4433300,,False,3.0,0,0,0,0,0,0,0,0,0,0,0,0,0,0,0,1,0
401402473,North Carolina Tar Heels,E. Hodgson,4400235,,False,30.0,4,9,1,4,3,5,2,2,0,1,1,3,2,0,1,3,13
401402473,North Carolina Tar Heels,TEAM,TOTAL,TOTAL,False,,31,71,24,51,7,20,11,17,11,24,35,16,8,1,8,22,80
401402472,Wake Forest Demon Deacons,D. Hinds,4596343,,True,8.0,0,3,0,3,0,0,0,0,0,2,2,0,1,0,1,3,0
401402472,Wake Forest Demon Deacons,N. Becker,4398862,,True,34.0,1,7,1,7,0,0,0,0,3,5,8,1,2,0,3,0,2
401402472,Wake Forest Demon Deacons,O. Summiel,4433706,,True,37.0,3,10,1,6,2,4,0,0,3,8,11,0,3,1,0,1,8
401402472,Wake Forest Demon Deacons,K. Harrison,4433667,,True,33.0,3,12,3,11,0,1,0,0,1,4,5,1,2,0,2,2,6
401402472,Wake Forest Demon Deacons,J. Spear,4433481,,True,27.0,3,16,2,5,1,11,4,6,0,2,2,2,0,0,0,1,11
401402472,Wake Forest Demon Deacons,M. Cowles,4433530,,False,27.0,3,6,3,6,0,0,2,3,7,1,8,0,2,0,1,4,8
401402472,Wake Forest Demon Deacons,E. Williams,4712103,,False,23.0,1,8,1,7,0,1,3,6,1,2,3,1,2,0,2,4,5
401402472,Wake Forest Demon Deacons,A. Andrews,4683030,,False,5.0,0,0,0,0,0,0,0,0,0,0,0,0,0,0,0,0,0
401402472,Wake Forest Demon Deacons,A. Scruggs,4433654,,False,6.0,0,2,0,1,0,1,0,0,1,0,1,0,0,0,0,0,0
401402472,Wake Forest Demon Deacons,TEAM,TOTAL,TOTAL,False,,14,64,11,46,3,18,9,15,16,27,43,5,12,1,10,15,40
401402472,Georgia Tech Yellow Jackets,D. Strautmane,4281221,,True,33.0,2,8,0,2,2,6,2,4,1,7,8,3,0,4,2,2,8
401402472,Georgia Tech Yellow Jackets,L. Cubaj,4281183,,True,10.0,0,0,0,0,0,0,0,0,1,0,1,0,1,1,2,0,0
401402472,Georgia Tech Yellow Jackets,N. Hermosa,4433347,,True,29.0,1,6,1,6,0,0,0,0,1,6,7,1,1,3,0,2,2
401402472,Georgia Tech Yellow Jackets,E. Love,4433461,,True,37.0,7,14,7,11,0,3,2,4,0,4,4,1,0,0,4,1,16
401402472,Georgia Tech Yellow Jackets,L. Lahtinen,4398593,,True,36.0,3,10,2,6,1,4,3,8,0,7,7,5,1,0,6,4,10
401402472,Georgia Tech Yellow Jackets,A. Wone Aranaz,4433369,,False,18.0,1,1,1,1,0,0,0,0,3,0,3,0,0,0,1,1,2
401402472,Georgia Tech Yellow Jackets,E. Bulane,4898402,,False,2.0,0,0,0,0,0,0,0,0,0,0,0,0,0,0,0,0,0
401402472,Georgia Tech Yellow Jackets,A. Carter,4433754,,False,17.0,2,4,2,3,0,1,0,2,0,3,3,0,0,0,3,0,4
401402472,Georgia Tech Yellow Jackets,S. Bates,4281728,,False,18.0,1,3,0,0,1,3,0,0,0,0,0,0,0,0,1,0,3
401402472,Georgia Tech Yellow Jackets,TEAM,TOTAL,TOTAL,False,,17,46,13,29,4,17,7,18,8,34,42,10,3,8,19,10,45
401402471,Miami Hurricanes,L. Pendande,4398863,,True,26.0,4,4,4,4,0,0,3,4,0,4,4,2,0,1,4,3,11
401402471,Miami Hurricanes,D. Harden,4281329,,True,27.0,4,11,4,9,0,2,3,3,0,9,9,2,2,1,3,2,11
401402471,Miami Hurricanes,J. Williams,4898556,,True,29.0,3,7,2,5,1,2,0,0,1,1,2,0,4,0,1,4,7
401402471,Miami Hurricanes,K. Erjavec,4400202,,True,30.0,3,5,3,3,0,2,4,6,0,2,2,2,0,2,3,2,10
401402471,Miami Hurricanes,K. Marshall,4281196,,True,39.0,3,11,2,8,1,3,3,4,0,4,4,4,0,0,0,0,10
401402471,Miami Hurricanes,N. Mbandu,4703227,,False,12.0,1,2,1,2,0,0,0,0,1,0,1,0,1,1,1,1,2
401402471,Miami Hurricanes,M. Djaldi-Tabdi,4281214,,False,14.0,1,3,0,0,1,3,0,0,0,0,0,1,0,1,2,1,3
401402471,Miami Hurricanes,L. Dwyer,4683033,,False,0.0,0,0,0,0,0,0,0,0,0,0,0,0,1,0,0,0,0
401402471,Miami Hurricanes,M. Johnson Sidi Baba,4594386,,False,1.0,0,0,0,0,0,0,0,0,0,0,0,0,0,0,0,0,0
401402471,Miami Hurricanes,M. Gray,4281194,,False,22.0,2,5,2,4,0,1,3,4,0,4,4,3,1,0,1,0,7
401402471,Miami Hurricanes,TEAM,TOTAL,TOTAL,False,,21,48,18,35,3,13,16,21,3,26,29,14,9,6,15,13,61
401402471,Duke Blue Devils,O. Akinbode-James,4398580,,True,18.0,0,3,0,3,0,0,0,2,5,4,9,0,0,0,0,2,0
401402471,Duke Blue Devils,E. Balogun,4398589,,True,30.0,5,12,4,8,1,4,1,2,5,3,8,1,1,3,5,1,12
401402471,Duke Blue Devils,L. Gordon,4281076,,True,15.0,1,5,0,2,1,3,0,0,0,0,0,0,0,0,0,2,3
401402471,Duke Blue Devils,S. Day-Wilson,4433531,,True,33.0,3,13,3,8,0,5,7,10,1,6,7,7,1,0,4,0,13
401402471,Duke Blue Devils,C. Taylor,4432864,,True,32.0,8,15,5,10,3,5,0,0,1,4,5,2,1,0,4,5,19
401402471,Duke Blue Devils,J. Williams,4281179,,False,22.0,0,5,0,5,0,0,0,0,2,2,4,2,1,1,4,3,0
401402471,Duke Blue Devils,V. de Jesus,4702867,,False,10.0,0,1,0,1,0,0,0,0,0,1,1,1,0,0,0,4,0
401402471,Duke Blue Devils,L. Volker,4683453,,False,20.0,1,3,1,2,0,1,0,0,0,1,1,1,0,0,1,1,2
401402471,Duke Blue Devils,M. Goodchild,4398577,,False,20.0,2,5,0,0,2,5,0,0,1,2,3,0,0,0,1,1,6
401402471,Duke Blue Devils,TEAM,TOTAL,TOTAL,False,,20,62,13,39,7,23,8,14,20,24,44,14,4,4,19,19,55
401402470,Florida State Seminoles,E. Howard,4398609,,True,33.0,6,12,2,4,4,8,0,0,1,4,5,0,0,0,5,4,16
401402470,Florida State Seminoles,R. Baldwin,4433304,,True,25.0,1,4,1,4,0,0,0,2,0,3,3,0,0,0,1,2,2
401402470,Florida State Seminoles,O. Gordon,4433520,,True,26.0,4,5,3,4,1,1,0,0,0,1,1,6,1,0,4,1,9
401402470,Florida State Seminoles,S. Puisis,4432862,,True,29.0,4,6,0,1,4,5,0,0,0,1,1,1,1,0,4,2,12
401402470,Florida State Seminoles,M. Jones,2984250,,True,24.0,5,8,5,8,0,0,1,1,1,4,5,2,2,1,4,2,11
401402470,Florida State Seminoles,M. Valenzuela,4683035,,False,2.0,0,0,0,0,0,0,0,0,0,0,0,0,0,0,0,0,0
401402470,Florida State Seminoles,M. Timpson,4433546,,False,6.0,0,1,0,1,0,0,0,0,0,1,1,0,1,1,0,0,0
401402470,Florida State Seminoles,V. Myers,4398583,,False,14.0,1,4,1,4,0,0,1,2,0,5,5,0,1,1,1,3,3
401402470,Florida State Seminoles,S. Bejedi,4595844,,False,15.0,1,3,1,1,0,2,6,10,0,0,0,3,2,0,1,2,8
401402470,Florida State Seminoles,B. Jackson,4280885,,False,26.0,1,7,1,5,0,2,0,0,0,1,1,3,1,1,2,1,2
401402470,Florida State Seminoles,TEAM,TOTAL,TOTAL,False,,23,50,14,32,9,18,8,15,7,23,30,15,9,4,22,17,63
401402470,Boston College Eagles,M. Gakdeng,4898548,,True,32.0,6,13,6,13,0,0,3,4,3,3,6,0,1,1,4,4,15
401402470,Boston College Eagles,A. VanTimmeren,4711798,,True,4.0,0,0,0,0,0,0,0,0,0,0,0,0,0,0,3,1,0
401402470,Boston College Eagles,T. Soule,4398567,,True,39.0,6,12,6,12,0,0,4,6,2,3,5,1,3,0,2,3,16
401402470,Boston College Eagles,C. Swartz,4398758,,True,31.0,3,10,2,6,1,4,4,7,1,4,5,0,0,0,3,1,11
401402470,Boston College Eagles,M. Garraud,4398568,,True,30.0,1,8,1,3,0,5,0,0,0,1,1,4,1,0,3,1,2
401402470,Boston College Eagles,C. Ford,4398571,,False,5.0,0,0,0,0,0,0,0,0,0,1,1,0,0,0,0,2,0
401402470,Boston College Eagles,D. Waggoner,4433482,,False,19.0,3,6,3,6,0,0,1,2,3,2,5,2,4,0,0,2,7
401402470,Boston College Eagles,K. Ivey,4433464,,False,9.0,1,2,1,2,0,0,0,0,0,0,0,1,1,0,1,1,2
401402470,Boston College Eagles,M. Dickens,4398566,,False,31.0,2,9,1,2,1,7,0,0,3,5,8,3,2,0,5,1,5
401402470,Boston College Eagles,TEAM,TOTAL,TOTAL,False,,22,60,20,44,2,16,12,19,16,23,39,11,12,1,21,16,58
401402469,Virginia Tech Hokies,A. Baines,4432945,,True,20.0,2,5,2,5,0,0,1,1,0,5,5,1,0,0,2,3,5
401402469,Virginia Tech Hokies,E. Kitley,4433309,,True,32.0,8,10,8,10,0,0,3,4,1,9,10,1,0,0,2,2,19
401402469,Virginia Tech Hokies,G. Amoore,4704180,,True,34.0,4,7,2,2,2,5,5,6,0,2,2,5,0,0,5,3,15
401402469,Virginia Tech Hokies,C. King,4433089,,True,9.0,1,1,0,0,1,1,0,0,0,0,0,3,0,0,0,2,3
401402469,Virginia Tech Hokies,A. Sheppard,4281223,,True,35.0,7,11,3,3,4,8,2,2,1,4,5,4,0,1,5,2,20
401402469,Virginia Tech Hokies,D. Gregg,4398592,,False,14.0,1,1,1,1,0,0,2,2,1,1,2,1,0,0,4,4,4
401402469,Virginia Tech Hokies,T. Geiman,4433342,,False,4.0,0,1,0,1,0,0,0,0,0,0,0,0,0,0,0,0,0
401402469,Virginia Tech Hokies,K. Traylor,4398947,,False,28.0,4,8,2,4,2,4,6,7,0,1,1,0,1,0,1,0,16
401402469,Virginia Tech Hokies,E. Lytle,4069122,,False,24.0,0,2,0,1,0,1,0,0,1,5,6,2,0,0,2,0,0
401402469,Virginia Tech Hokies,TEAM,TOTAL,TOTAL,False,,27,46,18,27,9,19,19,22,5,29,34,17,1,1,21,16,82
401402469,Clemson Tigers,H. Hank,4594381,,True,36.0,2,8,2,6,0,2,4,4,2,3,5,0,5,0,1,3,8
401402469,Clemson Tigers,A. Robinson,4433682,,True,27.0,4,13,4,13,0,0,3,4,1,0,1,0,0,0,1,4,11
401402469,Clemson Tigers,M. Ott,4898553,,True,21.0,0,1,0,0,0,1,0,0,0,0,0,1,0,0,0,4,0
401402469,Clemson Tigers,D. Bradford,4898552,,True,35.0,3,10,3,8,0,2,3,3,0,2,2,4,0,1,3,4,9
401402469,Clemson Tigers,D. Washington,4065715,,True,35.0,7,17,7,16,0,1,5,6,1,2,3,1,5,0,1,4,19
401402469,Clemson Tigers,M. Elmore,4434000,,False,7.0,0,1,0,0,0,1,0,0,0,0,0,0,0,0,0,1,0
401402469,Clemson Tigers,S. Blackstock,4398575,,False,11.0,1,1,1,1,0,0,0,0,0,2,2,1,0,0,0,0,2
401402469,Clemson Tigers,W. Hipp,4594897,,False,7.0,0,1,0,0,0,1,0,0,0,0,0,0,0,0,0,1,0
401402469,Clemson Tigers,S. Standifer,4433809,,False,4.0,0,0,0,0,0,0,0,0,0,0,0,0,0,0,0,0,0
401402469,Clemson Tigers,K. Gaines,4433533,,False,17.0,3,7,3,6,0,1,5,6,1,4,5,0,0,1,1,0,11
401402469,Clemson Tigers,TEAM,TOTAL,TOTAL,False,,20,59,20,50,0,9,20,23,9,14,23,7,10,2,7,21,60
401402468,Wake Forest Demon Deacons,N. Becker,4398862,,True,24.0,3,5,3,5,0,0,0,0,2,2,4,0,0,2,5,4,6
401402468,Wake Forest Demon Deacons,C. Morra,4398747,,True,40.0,4,12,4,12,0,0,5,5,1,9,10,3,0,1,1,3,13
401402468,Wake Forest Demon Deacons,O. Summiel,4433706,,True,34.0,2,4,1,2,1,2,0,0,4,5,9,4,2,2,2,2,5
401402468,Wake Forest Demon Deacons,K. Harrison,4433667,,True,26.0,3,5,3,4,0,1,0,0,0,4,4,2,0,0,4,3,6
401402468,Wake Forest Demon Deacons,J. Spear,4433481,,True,35.0,6,16,1,6,5,10,6,6,0,3,3,1,0,0,5,1,23
401402468,Wake Forest Demon Deacons,M. Cowles,4433530,,False,5.0,0,0,0,0,0,0,0,0,0,0,0,0,0,3,1,1,0
401402468,Wake Forest Demon Deacons,E. Williams,4712103,,False,32.0,3,8,3,5,0,3,2,2,1,4,5,2,2,1,1,0,8
401402468,Wake Forest Demon Deacons,R. Conley,4691695,,False,3.0,0,0,0,0,0,0,0,0,0,0,0,0,0,0,1,0,0
401402468,Wake Forest Demon Deacons,A. Andrews,4683030,,False,1.0,0,0,0,0,0,0,0,0,0,0,0,0,0,0,0,0,0
401402468,Wake Forest Demon Deacons,TEAM,TOTAL,TOTAL,False,,21,50,15,34,6,16,13,13,8,30,38,12,4,9,20,14,61
401402468,Virginia Cavaliers,L. Clarkson,4433043,,True,35.0,5,8,5,8,0,0,1,3,1,2,3,0,3,0,1,2,11
401402468,Virginia Cavaliers,T. Valladay,4595147,,True,28.0,2,16,2,16,0,0,2,2,2,4,6,2,1,0,1,2,6
401402468,Virginia Cavaliers,M. McLean,4433737,,True,23.0,5,11,5,11,0,0,1,2,5,4,9,2,1,2,1,5,11
401402468,Virginia Cavaliers,C. Miller,4433120,,True,14.0,0,2,0,2,0,0,0,0,1,1,2,0,1,0,0,2,0
401402468,Virginia Cavaliers,A. Toi,4281228,,True,40.0,4,16,3,11,1,5,0,0,0,2,2,2,1,0,1,1,9
401402468,Virginia Cavaliers,D. Bristol,4704182,,False,2.0,1,1,1,1,0,0,0,0,0,0,0,0,0,0,0,0,2
401402468,Virginia Cavaliers,E. Parker,4281388,,False,3.0,0,2,0,2,0,0,2,2,2,1,3,0,0,0,1,0,2
401402468,Virginia Cavaliers,A. Pitts,4433473,,False,15.0,2,2,2,2,0,0,0,0,0,1,1,1,1,0,2,2,4
401402468,Virginia Cavaliers,K. Lawson,4433762,,False,12.0,0,3,0,2,0,1,1,2,3,1,4,2,0,0,1,2,1
401402468,Virginia Cavaliers,M. Dale,4281396,,False,28.0,3,6,2,2,1,4,0,0,0,3,3,3,2,2,2,2,7
401402468,Virginia Cavaliers,TEAM,TOTAL,TOTAL,False,,22,67,20,57,2,10,7,11,15,20,35,12,10,4,10,18,53
401402467,Pittsburgh Panthers,A. Brown,4594393,,True,22.0,2,4,2,4,0,0,2,6,2,4,6,2,0,0,2,4,6
401402467,Pittsburgh Panthers,L. King,4596309,,True,31.0,6,16,6,16,0,0,1,2,2,7,9,2,0,1,3,2,13
401402467,Pittsburgh Panthers,R. Igbokwe,4433668,,True,22.0,1,2,1,2,0,0,1,1,0,8,8,0,1,2,1,3,3
401402467,Pittsburgh Panthers,S. Clesca,4703736,,True,25.0,2,7,2,6,0,1,0,0,0,2,2,0,0,0,3,1,4
401402467,Pittsburgh Panthers,D. Harris,4433695,,True,32.0,4,9,2,7,2,2,1,2,0,1,1,3,1,0,1,1,11
401402467,Pittsburgh Panthers,C. Ezeja,4594395,,False,16.0,2,3,2,3,0,0,0,2,5,1,6,0,0,1,1,2,4
401402467,Pittsburgh Panthers,T. Hueston,4433984,,False,1.0,0,1,0,0,0,1,0,0,0,0,0,0,0,0,0,1,0
401402467,Pittsburgh Panthers,T. Exanor,4600577,,False,25.0,3,8,2,4,1,4,1,2,1,2,3,1,2,1,4,3,8
401402467,Pittsburgh Panthers,D. Strother,4595149,,False,17.0,1,4,0,1,1,3,0,0,0,1,1,1,0,0,1,1,3
401402467,Pittsburgh Panthers,E. Hayford,4433346,,False,9.0,0,1,0,1,0,0,0,2,0,0,0,1,1,0,0,0,0
401402467,Pittsburgh Panthers,TEAM,TOTAL,TOTAL,False,,21,55,17,44,4,11,6,17,12,28,40,10,5,5,16,18,52
401402467,Duke Blue Devils,O. Akinbode-James,4398580,,True,18.0,2,4,2,4,0,0,0,1,1,4,5,0,0,0,3,2,4
401402467,Duke Blue Devils,L. Volker,4683453,,True,34.0,0,3,0,3,0,0,2,2,4,4,8,0,3,1,1,2,2
401402467,Duke Blue Devils,S. Day-Wilson,4433531,,True,31.0,7,17,5,14,2,3,6,7,2,1,3,5,0,0,1,2,22
401402467,Duke Blue Devils,C. Taylor,4432864,,True,34.0,4,13,3,10,1,3,2,6,1,4,5,0,0,0,0,2,11
401402467,Duke Blue Devils,L. Gordon,4281076,,True,11.0,1,4,1,1,0,3,0,2,0,0,0,0,0,0,1,2,2
401402467,Duke Blue Devils,I. Lewis,4398957,,False,2.0,0,0,0,0,0,0,0,0,0,0,0,0,0,0,0,0,0
401402467,Duke Blue Devils,J. Williams,4281179,,False,7.0,0,4,0,4,0,0,0,0,0,0,0,0,0,0,0,0,0
401402467,Duke Blue Devils,E. Balogun,4398589,,False,26.0,3,6,3,4,0,2,2,2,2,3,5,0,0,1,2,3,8
401402467,Duke Blue Devils,A. Finklea-Guity,4281215,,False,14.0,1,1,1,1,0,0,0,0,1,4,5,0,0,0,3,1,2
401402467,Duke Blue Devils,V. de Jesus,4702867,,False,11.0,0,2,0,1,0,1,1,2,1,1,2,1,0,0,2,1,1
401402467,Duke Blue Devils,M. Goodchild,4398577,,False,12.0,1,2,0,0,1,2,0,0,0,2,2,0,0,0,1,0,3
401402467,Duke Blue Devils,TEAM,TOTAL,TOTAL,False,,19,56,15,42,4,14,13,22,14,26,40,6,3,2,14,15,55
401402466,Syracuse Orange,A. Styles,4281918,,True,38.0,5,13,5,13,0,0,1,3,5,3,8,0,3,1,1,3,11
401402466,Syracuse Orange,T. Hyman,4433655,,True,40.0,12,28,12,23,0,5,1,2,3,4,7,8,3,0,7,2,25
401402466,Syracuse Orange,Chrisl. Carr,4398991,,True,40.0,7,11,5,5,2,6,4,5,1,1,2,2,1,0,4,1,20
401402466,Syracuse Orange,Christ. Carr,4398963,,True,32.0,2,8,1,3,1,5,1,2,0,5,5,0,2,0,1,3,6
401402466,Syracuse Orange,N. Murray,4281877,,True,40.0,3,13,2,5,1,8,0,0,0,2,2,5,2,0,3,4,7
401402466,Syracuse Orange,A. Rice,4595516,,False,10.0,0,0,0,0,0,0,0,0,0,1,1,0,0,0,0,1,0
401402466,Syracuse Orange,TEAM,TOTAL,TOTAL,False,,29,73,25,49,4,24,7,12,11,18,29,15,11,1,16,14,69
401402466,Clemson Tigers,H. Hank,4594381,,True,36.0,7,8,6,7,1,1,2,3,3,5,8,2,1,1,2,2,17
401402466,Clemson Tigers,A. Robinson,4433682,,True,35.0,5,7,5,7,0,0,2,2,3,6,9,3,1,2,6,4,12
401402466,Clemson Tigers,M. Ott,4898553,,True,29.0,2,5,1,1,1,4,2,2,0,3,3,2,0,0,1,1,7
401402466,Clemson Tigers,D. Bradford,4898552,,True,25.0,4,10,4,9,0,1,3,3,0,2,2,7,3,0,6,4,11
401402466,Clemson Tigers,D. Washington,4065715,,True,38.0,12,24,11,20,1,4,8,10,0,11,11,6,3,0,5,2,33
401402466,Clemson Tigers,M. Elmore,4434000,,False,8.0,1,2,1,1,0,1,0,0,1,4,5,0,0,1,0,0,2
401402466,Clemson Tigers,S. Blackstock,4398575,,False,1.0,0,0,0,0,0,0,0,0,1,0,1,0,0,0,1,0,0
401402466,Clemson Tigers,W. Hipp,4594897,,False,11.0,1,1,1,1,0,0,0,0,0,0,0,1,0,0,0,0,2
401402466,Clemson Tigers,S. Standifer,4433809,,False,3.0,0,0,0,0,0,0,0,0,0,0,0,0,0,0,0,0,0
401402466,Clemson Tigers,K. Gaines,4433533,,False,14.0,2,4,2,4,0,0,0,0,0,1,1,0,1,0,2,1,4
401402466,Clemson Tigers,TEAM,TOTAL,TOTAL,False,,34,61,31,50,3,11,17,20,10,32,42,21,9,4,23,14,88
401402464,UCF Knights,D. Thomas,4594542,,True,26.0,2,7,2,7,0,0,3,4,6,3,9,0,3,1,2,2,7
401402464,UCF Knights,M. Kaba,4281099,,True,37.0,4,10,4,10,0,0,1,2,4,5,9,2,2,2,5,2,9
401402464,UCF Knights,T. Sanders,4594539,,True,35.0,1,8,1,7,0,1,2,2,1,3,4,1,0,0,0,0,4
401402464,UCF Knights,D. Battles,4399028,,True,40.0,4,16,2,11,2,5,7,8,1,1,2,2,1,0,1,0,17
401402464,UCF Knights,S. Meertens,4281294,,True,16.0,2,3,2,3,0,0,0,0,0,1,1,2,0,0,0,3,4
401402464,UCF Knights,B. Smith,4399030,,False,17.0,3,6,3,6,0,0,0,0,2,3,5,1,0,2,2,2,6
401402464,UCF Knights,A. Lewis,4594397,,False,29.0,1,5,0,1,1,4,3,4,1,4,5,7,1,2,1,2,6
401402464,UCF Knights,TEAM,TOTAL,TOTAL,False,,17,55,14,45,3,10,16,20,17,22,39,15,7,7,12,11,53
401402464,South Florida Bulls,B. Mununga,4594533,,True,40.0,3,6,3,6,0,0,1,4,3,8,11,5,2,1,2,3,7
401402464,South Florida Bulls,S. Leverett,4068149,,True,29.0,5,9,5,9,0,0,0,0,3,2,5,0,2,1,1,4,10
401402464,South Florida Bulls,E. Tsineke,4594531,,True,40.0,6,18,4,14,2,4,0,0,3,4,7,1,1,1,1,4,14
401402464,South Florida Bulls,E. Pinzan,4399238,,True,40.0,3,9,1,3,2,6,1,2,0,5,5,4,2,0,5,3,9
401402464,South Florida Bulls,S. Harvey,4399237,,True,39.0,1,8,0,3,1,5,2,2,1,1,2,3,1,1,2,4,5
401402464,South Florida Bulls,D. Fankam Mendjiadeu,4594527,,False,11.0,0,2,0,2,0,0,0,0,0,0,0,0,0,0,2,1,0
401402464,South Florida Bulls,C. Bermejo,4594532,,False,1.0,0,0,0,0,0,0,0,0,0,0,0,0,0,0,0,0,0
401402464,South Florida Bulls,TEAM,TOTAL,TOTAL,False,,18,52,13,37,5,15,4,8,12,21,33,13,8,4,17,19,45
401402463,South Florida Bulls,B. Mununga,4594533,,True,39.0,3,9,3,8,0,1,2,2,3,15,18,4,2,1,1,3,8
401402463,South Florida Bulls,S. Leverett,4068149,,True,21.0,4,5,4,5,0,0,2,3,1,1,2,0,1,0,0,2,10
401402463,South Florida Bulls,E. Tsineke,4594531,,True,38.0,3,13,2,8,1,5,4,4,7,0,7,5,1,0,6,4,11
401402463,South Florida Bulls,E. Pinzan,4399238,,True,40.0,3,10,2,5,1,5,7,7,1,6,7,4,1,0,3,2,14
401402463,South Florida Bulls,S. Harvey,4399237,,True,36.0,2,14,0,7,2,7,2,2,1,2,3,1,5,1,3,3,8
401402463,South Florida Bulls,P. Williams,4898406,,False,1.0,0,0,0,0,0,0,0,0,0,0,0,0,0,0,0,0,0
401402463,South Florida Bulls,D. Fankam Mendjiadeu,4594527,,False,19.0,2,5,2,5,0,0,3,4,0,3,3,1,1,2,1,1,7
401402463,South Florida Bulls,A. Wilson,4433388,,False,0.0,0,0,0,0,0,0,0,0,0,0,0,0,0,0,0,0,0
401402463,South Florida Bulls,C. Bermejo,4594532,,False,6.0,0,0,0,0,0,0,0,0,0,0,0,0,0,0,0,1,0
401402463,South Florida Bulls,TEAM,TOTAL,TOTAL,False,,17,56,13,38,4,18,20,22,16,28,44,15,11,4,16,16,58
401402463,Houston Cougars,B. Patterson,4433360,,True,28.0,1,3,0,1,1,2,2,4,0,3,3,2,2,0,3,4,5
401402463,Houston Cougars,T. Hill,4399017,,True,23.0,0,3,0,3,0,0,0,0,1,3,4,0,2,1,1,4,0
401402463,Houston Cougars,L. Blair,4433451,,True,40.0,9,18,4,9,5,9,2,2,0,3,3,0,1,0,4,2,25
401402463,Houston Cougars,B. Onyeje,4399029,,True,37.0,4,10,4,6,0,4,3,3,1,4,5,0,6,1,1,3,11
401402463,Houston Cougars,J. Blackshell-Fair,4281088,,True,11.0,0,1,0,1,0,0,0,0,0,0,0,0,0,0,1,0,0
401402463,Houston Cougars,K. Jones,4703658,,False,15.0,0,0,0,0,0,0,0,2,2,1,3,2,0,3,2,1,0
401402463,Houston Cougars,F. Diagne,4281281,,False,9.0,1,1,1,1,0,0,0,0,1,0,1,0,0,0,0,0,2
401402463,Houston Cougars,J. Lewis,4433111,,False,5.0,0,0,0,0,0,0,0,0,0,0,0,0,0,0,0,0,0
401402463,Houston Cougars,T. Young,4433298,,False,25.0,3,13,3,13,0,0,1,2,2,3,5,0,1,1,3,4,7
401402463,Houston Cougars,E. Sidney,4398990,,False,7.0,0,1,0,0,0,1,0,0,0,1,1,3,0,0,0,0,0
401402463,Houston Cougars,TEAM,TOTAL,TOTAL,False,,18,50,12,34,6,16,8,13,7,22,29,7,12,6,15,18,50
401402462,UCF Knights,D. Thomas,4594542,,True,26.0,4,4,4,4,0,0,0,0,2,5,7,0,0,0,0,2,8
401402462,UCF Knights,M. Kaba,4281099,,True,25.0,5,13,5,13,0,0,0,0,1,3,4,1,1,2,0,2,10
401402462,UCF Knights,T. Sanders,4594539,,True,22.0,1,5,1,4,0,1,0,0,0,4,4,5,2,0,0,1,2
401402462,UCF Knights,D. Battles,4399028,,True,31.0,4,13,3,8,1,5,2,2,0,3,3,2,2,1,2,0,11
401402462,UCF Knights,S. Meertens,4281294,,True,26.0,4,5,4,5,0,0,2,2,0,1,1,1,2,0,0,1,10
401402462,UCF Knights,A. Verhulst,4703654,,False,2.0,0,1,0,1,0,0,0,0,1,1,2,0,0,0,0,1,0
401402462,UCF Knights,B. Smith,4399030,,False,23.0,4,9,4,9,0,0,5,6,4,1,5,0,2,2,1,3,13
401402462,UCF Knights,N. Luma,4281482,,False,4.0,0,1,0,1,0,0,0,0,3,1,4,1,0,0,0,0,0
401402462,UCF Knights,L. Jewett,4691700,,False,4.0,0,2,0,1,0,1,0,0,0,0,0,1,0,0,0,0,0
401402462,UCF Knights,A. Burney,4594541,,False,12.0,1,3,1,1,0,2,0,0,0,0,0,2,0,1,0,0,2
401402462,UCF Knights,A. Lewis,4594397,,False,23.0,2,2,1,1,1,1,0,0,0,1,1,3,1,0,3,3,5
401402462,UCF Knights,B. Ripley,4281197,,False,2.0,0,1,0,0,0,1,0,0,0,0,0,0,0,0,0,0,0
401402462,UCF Knights,TEAM,TOTAL,TOTAL,False,,25,59,23,48,2,11,9,10,11,23,34,16,10,6,6,13,61
401402462,SMU Mustangs,D. Sanderlin,4282048,,True,20.0,2,6,2,6,0,0,0,0,3,4,7,0,0,0,2,1,4
401402462,SMU Mustangs,S. Wilkinson,4281175,,True,32.0,1,8,1,7,0,1,1,2,1,4,5,1,0,1,1,1,3
401402462,SMU Mustangs,K. White,4399236,,True,31.0,4,15,4,11,0,4,0,0,0,2,2,0,2,0,5,1,8
401402462,SMU Mustangs,S. Wiggins,4281805,,True,32.0,3,7,2,4,1,3,0,0,2,2,4,0,0,1,3,1,7
401402462,SMU Mustangs,J. Smith,6961,,True,28.0,0,5,0,3,0,2,2,2,1,2,3,0,1,0,5,2,2
401402462,SMU Mustangs,P. Bayliss,4399232,,False,15.0,2,4,2,4,0,0,0,0,0,2,2,0,0,2,0,1,4
401402462,SMU Mustangs,T. Criswell,4898629,,False,2.0,0,0,0,0,0,0,0,0,0,0,0,0,0,0,0,1,0
401402462,SMU Mustangs,Z. Rufus,4898628,,False,2.0,0,0,0,0,0,0,0,0,1,0,1,0,0,0,0,0,0
401402462,SMU Mustangs,T. Jones,4703663,,False,8.0,0,1,0,1,0,0,0,0,1,1,2,2,0,0,0,1,0
401402462,SMU Mustangs,D. Mathis,4594529,,False,4.0,0,0,0,0,0,0,0,0,0,1,1,0,0,0,1,0,0
401402462,SMU Mustangs,R. Bradley,4433337,,False,16.0,0,2,0,1,0,1,0,0,1,2,3,3,0,0,1,1,0
401402462,SMU Mustangs,K. Warthen,4281256,,False,10.0,0,1,0,1,0,0,0,0,0,0,0,1,0,0,0,0,0
401402462,SMU Mustangs,TEAM,TOTAL,TOTAL,False,,12,49,11,38,1,11,3,4,11,23,34,7,3,4,22,10,28
401402461,Tulane Green Wave,M. Heide,4399249,,True,33.0,3,7,3,7,0,0,2,2,3,5,8,1,0,1,1,4,8
401402461,Tulane Green Wave,K. Freeman,4281110,,True,30.0,6,16,5,10,1,6,0,0,0,7,7,0,1,0,1,2,13
401402461,Tulane Green Wave,D. Jones,4399247,,True,33.0,3,12,3,6,0,6,2,2,1,4,5,0,1,1,2,4,8
401402461,Tulane Green Wave,A. Clark,4282592,,True,28.0,2,4,2,4,0,0,2,4,1,5,6,4,0,0,5,0,6
401402461,Tulane Green Wave,M. Ursin,4281254,,True,36.0,4,9,2,5,2,4,2,2,0,8,8,4,0,0,3,2,12
401402461,Tulane Green Wave,A. Grant,4594536,,False,3.0,0,0,0,0,0,0,0,0,1,0,1,0,0,0,0,0,0
401402461,Tulane Green Wave,S. Cheatham,4281109,,False,18.0,2,5,1,2,1,3,2,2,0,3,3,2,2,0,0,4,7
401402461,Tulane Green Wave,K. Anderson,4281107,,False,19.0,1,5,0,0,1,5,0,0,0,1,1,2,0,0,2,4,3
401402461,Tulane Green Wave,TEAM,TOTAL,TOTAL,False,,21,58,16,34,5,24,10,12,7,35,42,13,4,2,14,20,57
401402461,Houston Cougars,B. Patterson,4433360,,True,32.0,2,5,2,5,0,0,1,1,3,4,7,2,1,0,0,4,5
401402461,Houston Cougars,T. Hill,4399017,,True,26.0,2,4,2,4,0,0,0,3,2,8,10,1,3,2,2,4,4
401402461,Houston Cougars,L. Blair,4433451,,True,38.0,7,17,2,6,5,11,4,6,0,3,3,0,0,0,2,2,23
401402461,Houston Cougars,B. Onyeje,4399029,,True,32.0,2,11,2,7,0,4,6,8,2,2,4,2,2,2,1,1,10
401402461,Houston Cougars,J. Blackshell-Fair,4281088,,True,14.0,0,2,0,2,0,0,1,2,1,3,4,1,0,0,0,0,1
401402461,Houston Cougars,K. Jones,4703658,,False,8.0,1,1,1,1,0,0,0,0,0,0,0,0,0,0,0,1,2
401402461,Houston Cougars,F. Diagne,4281281,,False,9.0,0,2,0,2,0,0,0,0,0,2,2,0,0,0,1,1,0
401402461,Houston Cougars,J. Lewis,4433111,,False,5.0,0,3,0,3,0,0,0,0,0,0,0,0,0,0,0,0,0
401402461,Houston Cougars,T. Young,4433298,,False,29.0,6,12,6,10,0,2,6,10,0,3,3,2,1,0,2,1,18
401402461,Houston Cougars,E. Sidney,4398990,,False,7.0,1,2,1,2,0,0,0,0,0,0,0,0,0,0,0,1,2
401402461,Houston Cougars,TEAM,TOTAL,TOTAL,False,,21,59,16,42,5,17,18,30,9,30,39,8,7,4,8,15,65
401402460,South Florida Bulls,B. Mununga,4594533,,True,32.0,4,7,4,7,0,0,2,2,5,8,13,1,1,3,2,3,10
401402460,South Florida Bulls,D. Fankam Mendjiadeu,4594527,,True,15.0,1,6,1,6,0,0,0,0,2,2,4,0,0,0,0,1,2
401402460,South Florida Bulls,E. Tsineke,4594531,,True,31.0,7,15,7,15,0,0,8,9,4,2,6,1,0,0,1,3,22
401402460,South Florida Bulls,E. Pinzan,4399238,,True,40.0,5,12,2,5,3,7,3,3,0,7,7,6,1,0,1,3,16
401402460,South Florida Bulls,S. Harvey,4399237,,True,29.0,3,10,1,1,2,9,2,2,1,1,2,1,1,0,1,1,10
401402460,South Florida Bulls,P. Williams,4898406,,False,6.0,0,2,0,2,0,0,0,0,0,0,0,0,0,0,0,1,0
401402460,South Florida Bulls,S. Leverett,4068149,,False,27.0,0,0,0,0,0,0,0,0,0,4,4,0,0,4,1,2,0
401402460,South Florida Bulls,A. Wilson,4433388,,False,5.0,0,3,0,3,0,0,0,0,0,0,0,0,0,0,0,0,0
401402460,South Florida Bulls,C. Bermejo,4594532,,False,4.0,0,1,0,1,0,0,0,0,0,0,0,0,0,0,0,0,0
401402460,South Florida Bulls,S. Guerreiro,4703675,,False,6.0,0,1,0,1,0,0,0,0,0,0,0,0,0,0,0,0,0
401402460,South Florida Bulls,M. Lazic,4594530,,False,5.0,1,2,1,2,0,0,1,2,0,0,0,0,0,0,0,2,3
401402460,South Florida Bulls,TEAM,TOTAL,TOTAL,False,,21,59,16,43,5,16,16,18,13,24,37,9,3,7,9,16,63
401402460,Memphis Tigers,A. Davis,4281126,,True,27.0,1,6,1,6,0,0,1,2,3,2,5,0,0,1,0,1,3
401402460,Memphis Tigers,T. Frierson,4282093,,True,20.0,1,4,1,4,0,0,0,0,2,3,5,0,0,1,1,0,2
401402460,Memphis Tigers,E. Jefferson,4705118,,True,22.0,2,5,2,4,0,1,2,2,0,3,3,3,3,1,3,4,6
401402460,Memphis Tigers,M. Griggs,4433344,,True,30.0,5,11,3,5,2,6,2,2,0,3,3,2,1,0,1,2,14
401402460,Memphis Tigers,J. Shutes,4399021,,True,25.0,6,15,5,12,1,3,3,3,1,2,3,3,0,1,0,0,16
401402460,Memphis Tigers,A. Green,4898627,,False,7.0,0,0,0,0,0,0,0,0,0,0,0,0,1,0,0,0,0
401402460,Memphis Tigers,H. Riddick,4898624,,False,2.0,0,0,0,0,0,0,0,0,1,0,1,0,0,0,0,0,0
401402460,Memphis Tigers,Lane. Williams,4433649,,False,24.0,2,5,2,5,0,0,1,2,1,6,7,1,0,3,1,3,5
401402460,Memphis Tigers,J. Jones,4703659,,False,16.0,3,4,2,3,1,1,0,0,0,1,1,1,0,0,1,1,7
401402460,Memphis Tigers,C. Beck,4433447,,False,1.0,0,0,0,0,0,0,0,0,0,0,0,0,0,0,1,0,0
401402460,Memphis Tigers,M. Stovall,4399341,,False,26.0,0,4,0,4,0,0,0,0,0,2,2,2,0,0,3,4,0
401402460,Memphis Tigers,TEAM,TOTAL,TOTAL,False,,20,54,16,43,4,11,9,11,9,24,33,12,5,7,13,15,53
401402459,Temple Owls,K. Wood,4898656,,True,13.0,0,3,0,3,0,0,1,2,1,1,2,0,2,2,1,0,1
401402459,Temple Owls,M. Davis,4281116,,True,32.0,4,14,4,13,0,1,4,5,3,6,9,0,1,0,4,4,12
401402459,Temple Owls,A. Gourdine,4898655,,True,25.0,3,10,3,6,0,4,0,0,0,4,4,7,3,0,3,3,6
401402459,Temple Owls,T. East,4691699,,True,21.0,2,4,2,4,0,0,0,0,0,2,2,1,0,2,0,2,4
401402459,Temple Owls,E. Mayo,4281115,,True,25.0,2,7,0,2,2,5,0,0,1,3,4,1,0,0,0,0,6
401402459,Temple Owls,C. Perea,4703754,,False,18.0,2,5,0,1,2,4,0,0,0,2,2,1,1,0,0,2,6
401402459,Temple Owls,A. Williamson,4399244,,False,5.0,0,0,0,0,0,0,0,0,0,0,0,0,0,0,1,0,0
401402459,Temple Owls,S. Taylor,4068165,,False,13.0,2,3,2,3,0,0,0,0,1,1,2,0,0,0,1,2,4
401402459,Temple Owls,J. Clinton,4703686,,False,21.0,4,7,3,5,1,2,0,0,0,1,1,4,0,0,2,4,9
401402459,Temple Owls,J. Holmes,4281490,,False,27.0,2,3,2,3,0,0,3,5,2,2,4,1,2,0,1,3,7
401402459,Temple Owls,TEAM,TOTAL,TOTAL,False,,21,56,16,40,5,16,8,12,9,22,31,15,9,4,14,20,55
401402459,SMU Mustangs,D. Sanderlin,4282048,,True,14.0,3,5,3,5,0,0,0,0,1,3,4,0,0,0,0,0,6
401402459,SMU Mustangs,S. Wilkinson,4281175,,True,37.0,2,8,2,8,0,0,6,8,2,12,14,2,1,1,1,2,10
401402459,SMU Mustangs,K. White,4399236,,True,15.0,2,12,2,11,0,1,0,0,2,0,2,0,2,0,3,3,4
401402459,SMU Mustangs,S. Wiggins,4281805,,True,38.0,3,5,2,3,1,2,3,4,1,3,4,6,0,1,3,0,10
401402459,SMU Mustangs,J. Smith,6961,,True,37.0,5,13,3,8,2,5,4,4,0,5,5,2,1,0,5,1,16
401402459,SMU Mustangs,P. Bayliss,4399232,,False,4.0,0,1,0,1,0,0,0,0,0,0,0,0,1,0,0,0,0
401402459,SMU Mustangs,D. Mathis,4594529,,False,3.0,0,0,0,0,0,0,0,0,0,0,0,1,0,0,0,0,0
401402459,SMU Mustangs,R. Bradley,4433337,,False,27.0,1,6,1,6,0,0,6,6,4,1,5,1,0,0,0,1,8
401402459,SMU Mustangs,K. Warthen,4281256,,False,26.0,3,5,3,5,0,0,3,4,5,4,9,1,0,1,0,1,9
401402459,SMU Mustangs,TEAM,TOTAL,TOTAL,False,,19,55,16,47,3,8,22,26,15,28,43,13,5,3,13,8,63
401402458,UCF Knights,D. Thomas,4594542,,True,17.0,0,4,0,4,0,0,3,4,6,1,7,1,0,0,0,3,3
401402458,UCF Knights,M. Kaba,4281099,,True,34.0,10,20,10,20,0,0,3,7,4,4,8,1,0,2,2,3,23
401402458,UCF Knights,T. Sanders,4594539,,True,35.0,1,6,1,5,0,1,1,2,4,6,10,5,1,0,5,0,3
401402458,UCF Knights,D. Battles,4399028,,True,40.0,5,11,4,6,1,5,0,0,1,6,7,5,3,1,2,0,11
401402458,UCF Knights,S. Meertens,4281294,,True,6.0,0,0,0,0,0,0,0,0,0,1,1,1,0,0,1,0,0
401402458,UCF Knights,B. Smith,4399030,,False,30.0,7,11,7,11,0,0,5,7,6,5,11,1,2,2,3,2,19
401402458,UCF Knights,A. Burney,4594541,,False,4.0,0,2,0,1,0,1,0,0,0,0,0,0,0,0,0,0,0
401402458,UCF Knights,A. Lewis,4594397,,False,35.0,4,7,2,3,2,4,0,0,0,1,1,8,4,0,3,2,10
401402458,UCF Knights,TEAM,TOTAL,TOTAL,False,,27,61,24,50,3,11,12,20,25,25,50,22,10,5,16,10,69
401402458,Tulsa Golden Hurricane,T. Poindexter,4898634,,True,19.0,4,7,0,0,4,7,0,0,1,1,2,0,1,2,2,5,12
401402458,Tulsa Golden Hurricane,W. Mayberry,4703707,,True,37.0,5,12,2,4,3,8,0,0,0,1,1,1,1,0,6,2,13
401402458,Tulsa Golden Hurricane,M. Bittle,4399250,,True,38.0,4,8,1,2,3,6,0,0,0,1,1,6,4,0,2,1,11
401402458,Tulsa Golden Hurricane,M. Mayberry,4282492,,True,18.0,1,4,1,1,0,3,2,2,1,1,2,1,0,0,1,3,4
401402458,Tulsa Golden Hurricane,R. Lescay,4281104,,True,28.0,2,4,2,4,0,0,2,2,0,0,0,6,2,1,5,5,6
401402458,Tulsa Golden Hurricane,J. Evans,4703708,,False,25.0,1,6,1,3,0,3,0,0,1,5,6,0,2,1,1,3,2
401402458,Tulsa Golden Hurricane,O. Clayton,4703705,,False,2.0,0,0,0,0,0,0,0,0,0,0,0,0,0,0,0,0,0
401402458,Tulsa Golden Hurricane,D. Crawford,4898637,,False,33.0,2,8,0,1,2,7,0,0,2,4,6,3,0,0,1,4,6
401402458,Tulsa Golden Hurricane,TEAM,TOTAL,TOTAL,False,,19,49,7,15,12,34,4,4,5,15,20,17,10,4,19,23,54
401402457,Houston Cougars,B. Patterson,4433360,,True,19.0,3,8,3,7,0,1,1,2,2,5,7,1,1,1,0,2,7
401402457,Houston Cougars,T. Hill,4399017,,True,24.0,3,8,3,8,0,0,0,2,7,5,12,3,6,3,2,4,6
401402457,Houston Cougars,L. Blair,4433451,,True,30.0,9,17,5,9,4,8,0,1,2,0,2,0,3,0,1,2,22
401402457,Houston Cougars,B. Onyeje,4399029,,True,27.0,2,8,0,4,2,4,2,2,3,6,9,1,2,4,3,2,8
401402457,Houston Cougars,J. Blackshell-Fair,4281088,,True,2.0,0,0,0,0,0,0,0,0,0,0,0,0,0,0,1,0,0
401402457,Houston Cougars,T. Nard,4898623,,False,6.0,0,1,0,0,0,1,0,0,0,0,0,0,0,1,0,1,0
401402457,Houston Cougars,K. Jones,4703658,,False,17.0,2,3,2,3,0,0,0,0,0,3,3,1,0,2,1,1,4
401402457,Houston Cougars,F. Diagne,4281281,,False,7.0,0,1,0,1,0,0,2,2,0,1,1,0,0,0,1,1,2
401402457,Houston Cougars,J. Lewis,4433111,,False,5.0,2,3,2,3,0,0,1,1,0,1,1,0,0,1,0,0,5
401402457,Houston Cougars,K. Brown,4898622,,False,3.0,0,0,0,0,0,0,0,0,0,1,1,1,0,0,0,0,0
401402457,Houston Cougars,A. Thompson,4704516,,False,4.0,0,1,0,0,0,1,0,0,0,2,2,0,0,0,1,1,0
401402457,Houston Cougars,T. Purvis,4703655,,False,4.0,0,0,0,0,0,0,0,0,0,0,0,1,0,0,0,1,0
401402457,Houston Cougars,T. Young,4433298,,False,28.0,4,10,4,8,0,2,5,7,1,2,3,2,1,0,4,1,13
401402457,Houston Cougars,E. Sidney,4398990,,False,24.0,0,5,0,3,0,2,0,0,0,2,2,5,1,0,1,1,0
401402457,Houston Cougars,TEAM,TOTAL,TOTAL,False,,25,65,19,46,6,19,11,17,17,31,48,15,14,12,15,17,67
401402457,Cincinnati Bearcats,Jadyn Scott,4433395,,True,20.0,4,5,4,5,0,0,0,2,0,2,2,0,1,0,0,1,8
401402457,Cincinnati Bearcats,J. Hayes,4703635,,True,30.0,2,11,2,11,0,0,0,0,1,4,5,3,2,0,3,0,4
401402457,Cincinnati Bearcats,A. Levy,4398740,,True,23.0,0,4,0,2,0,2,1,2,0,2,2,5,1,2,3,5,1
401402457,Cincinnati Bearcats,B. Milton,4898614,,True,21.0,0,1,0,1,0,0,4,4,0,3,3,1,0,1,3,2,4
401402457,Cincinnati Bearcats,C. Wilson,4703633,,True,27.0,1,6,0,1,1,5,0,0,1,2,3,1,0,0,1,2,3
401402457,Cincinnati Bearcats,C. Craig,4898617,,False,6.0,0,5,0,5,0,0,0,0,1,0,1,0,0,1,0,2,0
401402457,Cincinnati Bearcats,M. Williams,4703211,,False,14.0,2,5,1,2,1,3,0,0,0,4,4,1,1,0,0,0,5
401402457,Cincinnati Bearcats,N. Dean,4433982,,False,3.0,1,1,0,0,1,1,0,2,1,1,2,0,0,0,0,1,3
401402457,Cincinnati Bearcats,A. Niang,4282626,,False,13.0,3,6,2,4,1,2,0,0,0,2,2,0,0,1,2,1,7
401402457,Cincinnati Bearcats,Jada Scott,4433400,,False,9.0,0,1,0,1,0,0,1,2,1,0,1,0,0,0,1,0,1
401402457,Cincinnati Bearcats,E. Mashaire,4898616,,False,27.0,2,5,2,2,0,3,5,5,0,1,1,2,3,1,5,2,9
401402457,Cincinnati Bearcats,S. Gritzali,4594521,,False,4.0,0,0,0,0,0,0,0,0,0,0,0,0,0,0,0,0,0
401402457,Cincinnati Bearcats,L. Elfatairy,4898615,,False,3.0,0,1,0,0,0,1,0,0,0,0,0,1,0,0,0,0,0
401402457,Cincinnati Bearcats,TEAM,TOTAL,TOTAL,False,,15,51,11,34,4,17,11,17,8,26,34,14,8,6,18,16,45
401402456,Memphis Tigers,A. Davis,4281126,,True,28.0,3,11,1,5,2,6,0,0,0,2,2,1,1,0,1,1,8
401402456,Memphis Tigers,T. Frierson,4282093,,True,23.0,4,9,4,9,0,0,1,2,4,6,10,0,1,5,1,2,9
401402456,Memphis Tigers,E. Jefferson,4705118,,True,22.0,2,6,2,6,0,0,2,4,2,3,5,3,0,1,1,3,6
401402456,Memphis Tigers,M. Griggs,4433344,,True,28.0,3,9,0,1,3,8,0,0,0,1,1,1,1,0,3,0,9
401402456,Memphis Tigers,J. Shutes,4399021,,True,36.0,7,14,6,10,1,4,1,3,2,7,9,2,1,1,6,3,16
401402456,Memphis Tigers,A. Green,4898627,,False,1.0,0,0,0,0,0,0,0,0,0,0,0,0,0,0,0,0,0
401402456,Memphis Tigers,H. Riddick,4898624,,False,2.0,0,1,0,1,0,0,0,0,1,2,3,0,0,0,0,0,0
401402456,Memphis Tigers,Lane. Williams,4433649,,False,27.0,1,5,1,5,0,0,2,2,2,6,8,1,0,1,1,0,4
401402456,Memphis Tigers,J. Jones,4703659,,False,7.0,2,2,2,2,0,0,2,2,1,1,2,1,1,0,0,1,6
401402456,Memphis Tigers,M. Brooks,4898626,,False,0.0,0,0,0,0,0,0,0,0,0,0,0,0,0,0,0,0,0
401402456,Memphis Tigers,C. Beck,4433447,,False,3.0,0,0,0,0,0,0,0,0,0,0,0,1,0,0,1,2,0
401402456,Memphis Tigers,M. Stovall,4399341,,False,23.0,0,2,0,2,0,0,1,2,0,0,0,7,2,0,3,1,1
401402456,Memphis Tigers,TEAM,TOTAL,TOTAL,False,,22,59,16,41,6,18,9,15,15,29,44,17,7,8,18,13,59
401402456,East Carolina Pirates,T. Bennett,4281180,,True,30.0,1,5,1,5,0,0,0,0,4,2,6,1,3,3,1,3,2
401402456,East Carolina Pirates,I. Adams,4898620,,True,11.0,1,2,1,2,0,0,0,0,2,0,2,0,2,0,0,4,2
401402456,East Carolina Pirates,S. Johnson,4703641,,True,32.0,3,7,2,5,1,2,2,2,3,4,7,2,1,0,3,2,9
401402456,East Carolina Pirates,T. Thompson,4595925,,True,35.0,5,20,5,16,0,4,4,5,1,5,6,3,2,0,3,3,14
401402456,East Carolina Pirates,D. Green,4281047,,True,26.0,4,11,4,7,0,4,1,2,1,2,3,4,2,0,2,0,9
401402456,East Carolina Pirates,T. Chambers,4399229,,False,7.0,0,1,0,1,0,0,0,0,1,0,1,0,0,1,1,3,0
401402456,East Carolina Pirates,B. Franklin,4281305,,False,4.0,0,2,0,2,0,0,0,2,0,1,1,0,0,0,0,0,0
401402456,East Carolina Pirates,A. Rose,4703643,,False,16.0,1,3,1,1,0,2,3,4,0,2,2,1,1,1,4,4,5
401402456,East Carolina Pirates,M. Moseley,4703642,,False,20.0,1,4,1,4,0,0,0,0,3,3,6,0,1,1,1,5,2
401402456,East Carolina Pirates,D. Mcneal,4433314,,False,19.0,2,9,2,7,0,2,1,2,2,1,3,1,0,2,0,0,5
401402456,East Carolina Pirates,TEAM,TOTAL,TOTAL,False,,18,64,17,50,1,14,11,17,20,23,43,12,12,8,16,24,48
401402455,Wichita State Shockers,J. Asinde,4898642,,True,37.0,5,10,5,10,0,0,0,0,3,7,10,3,5,1,5,4,10
401402455,Wichita State Shockers,A. Strong,4399367,,True,40.0,7,13,4,8,3,5,3,4,1,5,6,2,1,0,3,1,20
401402455,Wichita State Shockers,M. McCully,4594545,,True,37.0,8,13,7,11,1,2,0,1,1,3,4,4,2,0,6,1,17
401402455,Wichita State Shockers,S. Bastin,4399038,,True,41.0,5,6,5,6,0,0,6,6,1,4,5,6,0,1,8,2,16
401402455,Wichita State Shockers,C. Bremaud,4399035,,True,32.0,3,5,0,0,3,5,1,2,0,3,3,2,0,0,3,2,10
401402455,Wichita State Shockers,T. Colbert,4399039,,False,13.0,1,3,1,3,0,0,0,0,2,3,5,0,0,2,0,0,2
401402455,Wichita State Shockers,N. Bosch Duran,4898639,,False,6.0,1,2,1,1,0,1,0,0,0,0,0,0,0,0,1,2,2
401402455,Wichita State Shockers,D. McCarty,4594544,,False,19.0,3,6,2,4,1,2,2,2,0,3,3,2,0,0,1,0,9
401402455,Wichita State Shockers,TEAM,TOTAL,TOTAL,False,,33,58,25,43,8,15,12,15,9,30,39,19,8,4,27,12,86
401402455,Tulsa Golden Hurricane,T. Poindexter,4898634,,True,38.0,5,9,1,4,4,5,1,2,0,2,2,7,4,4,2,2,15
401402455,Tulsa Golden Hurricane,W. Mayberry,4703707,,True,39.0,6,15,5,9,1,6,4,5,3,3,6,10,1,1,2,1,17
401402455,Tulsa Golden Hurricane,M. Bittle,4399250,,True,44.0,8,18,5,8,3,10,0,0,0,1,1,2,3,1,0,3,19
401402455,Tulsa Golden Hurricane,M. Mayberry,4282492,,True,20.0,2,6,1,1,1,5,0,0,1,2,3,2,0,1,1,2,5
401402455,Tulsa Golden Hurricane,R. Lescay,4281104,,True,41.0,9,14,9,14,0,0,3,4,3,4,7,4,6,1,4,2,21
401402455,Tulsa Golden Hurricane,J. Evans,4703708,,False,10.0,1,2,1,2,0,0,0,0,2,1,3,1,2,0,1,2,2
401402455,Tulsa Golden Hurricane,D. Crawford,4898637,,False,33.0,3,9,0,1,3,8,0,0,1,1,2,3,0,0,2,3,9
401402455,Tulsa Golden Hurricane,TEAM,TOTAL,TOTAL,False,,34,73,22,39,12,34,8,11,10,16,26,29,16,8,12,15,88
401402449,Massachusetts Minutewomen,A. Ngalakulondi,4594788,,True,34.0,3,4,3,4,0,0,2,3,2,3,5,1,0,0,2,4,8
401402449,Massachusetts Minutewomen,S. Breen,4281234,,True,40.0,7,11,7,10,0,1,4,5,1,5,6,0,0,0,2,4,18
401402449,Massachusetts Minutewomen,B. Mayo,4704146,,True,40.0,5,10,5,8,0,2,2,2,0,1,1,1,2,0,2,2,12
401402449,Massachusetts Minutewomen,S. Taylor,4594786,,True,35.0,5,9,2,2,3,7,2,3,1,5,6,0,0,1,2,4,15
401402449,Massachusetts Minutewomen,D. Philoxy,4399441,,True,39.0,4,13,3,10,1,3,4,4,1,6,7,5,1,0,4,3,13
401402449,Massachusetts Minutewomen,M. White,4704145,,False,6.0,0,3,0,3,0,0,0,0,2,0,2,0,0,0,1,2,0
401402449,Massachusetts Minutewomen,A. Brooks,4898542,,False,6.0,0,0,0,0,0,0,0,0,0,0,0,0,0,0,0,0,0
401402449,Massachusetts Minutewomen,TEAM,TOTAL,TOTAL,False,,24,50,20,37,4,13,14,17,7,21,28,7,3,1,13,19,66
401402449,Fordham Rams,M. Jonassen,4399050,,True,34.0,0,1,0,1,0,0,2,4,9,0,9,0,1,0,1,2,2
401402449,Fordham Rams,K. Downey,4399048,,True,35.0,9,15,4,6,5,9,1,1,1,6,7,1,0,0,2,3,24
401402449,Fordham Rams,A. DeWolfe,4594765,,True,40.0,4,19,4,13,0,6,0,0,0,2,2,2,0,0,1,2,8
401402449,Fordham Rams,A. Dingle,4399322,,True,40.0,7,15,3,9,4,6,5,9,3,4,7,4,1,0,6,3,23
401402449,Fordham Rams,K. Heremaia,4281473,,True,29.0,3,8,3,5,0,3,0,0,0,5,5,4,1,1,3,5,6
401402449,Fordham Rams,M. Prior,4898497,,False,10.0,0,0,0,0,0,0,0,0,1,0,1,0,1,1,1,3,0
401402449,Fordham Rams,C. McQuillen,4898500,,False,0.0,0,0,0,0,0,0,0,0,0,0,0,1,0,0,0,0,0
401402449,Fordham Rams,S. Karpell,4594767,,False,12.0,0,0,0,0,0,0,0,0,1,0,1,1,0,0,0,0,0
401402449,Fordham Rams,TEAM,TOTAL,TOTAL,False,,23,58,14,34,9,24,8,14,16,19,35,13,4,2,14,18,63
401402448,Saint Joseph's Hawks,L. Fair,4898534,,True,34.0,8,14,8,14,0,0,1,2,2,5,7,6,1,3,0,1,17
401402448,Saint Joseph's Hawks,T. Brugler,4898530,,True,35.0,5,10,5,8,0,2,0,0,0,3,3,2,2,1,2,4,10
401402448,Saint Joseph's Hawks,M. Smith,4898535,,True,34.0,2,6,1,2,1,4,1,1,2,3,5,2,2,1,6,2,6
401402448,Saint Joseph's Hawks,J. Nystrom,4898532,,True,24.0,3,6,0,0,3,6,0,0,0,2,2,0,1,0,1,0,9
401402448,Saint Joseph's Hawks,K. Jekot,4281901,,True,31.0,0,2,0,1,0,1,3,4,1,2,3,6,1,0,2,0,3
401402448,Saint Joseph's Hawks,K. Mayock,4399473,,False,6.0,0,0,0,0,0,0,0,0,0,0,0,1,0,0,0,0,0
401402448,Saint Joseph's Hawks,L. Marsicano,4399472,,False,5.0,0,0,0,0,0,0,0,0,0,0,0,0,0,0,1,1,0
401402448,Saint Joseph's Hawks,E. Boslet,4704122,,False,3.0,0,0,0,0,0,0,0,0,0,0,0,0,0,0,0,0,0
401402448,Saint Joseph's Hawks,O. Mullins,4704121,,False,26.0,3,5,3,3,0,2,0,2,0,4,4,2,0,0,3,2,6
401402448,Saint Joseph's Hawks,A. Gribble,4065872,,False,3.0,0,1,0,0,0,1,0,0,0,1,1,0,0,0,1,1,0
401402448,Saint Joseph's Hawks,TEAM,TOTAL,TOTAL,False,,21,44,17,28,4,16,5,9,6,24,30,19,7,5,17,11,51
401402448,Rhode Island Rams,M. Foppossi,4281216,,True,39.0,4,14,4,11,0,3,3,3,2,4,6,0,2,0,1,3,11
401402448,Rhode Island Rams,E. Tahane,4280883,,True,29.0,6,8,6,8,0,0,1,1,2,4,6,1,1,0,1,4,13
401402448,Rhode Island Rams,D. Cairns,4898523,,True,38.0,4,15,2,5,2,10,0,0,0,1,1,1,0,0,3,2,10
401402448,Rhode Island Rams,C. Williams,4281345,,True,30.0,2,6,2,5,0,1,0,0,0,3,3,3,2,0,2,2,4
401402448,Rhode Island Rams,D. Elmore,4065876,,True,38.0,5,7,5,7,0,0,0,0,1,2,3,2,2,0,3,2,10
401402448,Rhode Island Rams,M. Toure,4704153,,False,11.0,0,3,0,3,0,0,0,0,0,2,2,2,0,0,0,1,0
401402448,Rhode Island Rams,E. Rinat,4898525,,False,3.0,0,0,0,0,0,0,0,0,1,0,1,0,1,0,0,0,0
401402448,Rhode Island Rams,Y. Hendley,4704152,,False,10.0,0,0,0,0,0,0,0,0,0,0,0,0,2,0,1,0,0
401402448,Rhode Island Rams,M. Vargas,4281857,,False,2.0,0,1,0,0,0,1,0,0,0,0,0,0,0,0,0,0,0
401402448,Rhode Island Rams,TEAM,TOTAL,TOTAL,False,,21,54,19,39,2,15,4,4,9,18,27,9,10,0,12,14,48
401402447,VCU Rams,K. Walters,4399303,,True,21.0,2,4,2,4,0,0,0,0,1,6,7,0,0,0,2,5,4
401402447,VCU Rams,S. Te-Biasu,4704160,,True,37.0,6,13,3,7,3,6,2,2,0,2,2,3,1,0,2,1,17
401402447,VCU Rams,J. Griffith-Wallace,4282453,,True,34.0,2,5,0,1,2,4,0,0,1,4,5,1,0,0,1,1,6
401402447,VCU Rams,M. Hattix-Covington,4281906,,True,34.0,0,4,0,3,0,1,2,2,1,2,3,1,0,0,0,1,2
401402447,VCU Rams,T. Robinson,4281905,,True,37.0,8,15,7,13,1,2,2,4,2,4,6,3,2,0,3,1,19
401402447,VCU Rams,C. Bloom,4433657,,False,20.0,3,9,3,9,0,0,1,4,1,4,5,0,0,1,2,2,7
401402447,VCU Rams,Sa. Robinson,4399312,,False,4.0,0,0,0,0,0,0,0,0,0,3,3,0,0,0,1,0,0
401402447,VCU Rams,D. Townes,4704161,,False,10.0,0,0,0,0,0,0,0,0,0,0,0,1,1,0,1,1,0
401402447,VCU Rams,G. Hutson,4613247,,False,4.0,0,1,0,1,0,0,0,0,0,0,0,0,0,0,0,0,0
401402447,VCU Rams,TEAM,TOTAL,TOTAL,False,,21,51,15,38,6,13,7,12,6,29,35,9,4,1,12,12,55
401402447,George Washington Revolutionaries,M. Taiwo,4399083,,True,40.0,2,9,2,9,0,0,4,10,4,9,13,3,2,0,2,2,8
401402447,George Washington Revolutionaries,M. Engel,4898515,,True,20.0,1,5,1,1,0,4,0,0,1,1,2,0,1,0,1,1,2
401402447,George Washington Revolutionaries,S. Laureano,4898512,,True,37.0,7,17,6,13,1,4,0,0,1,2,3,0,4,1,3,0,15
401402447,George Washington Revolutionaries,E. Brown,4594778,,True,25.0,0,3,0,3,0,0,0,0,0,3,3,0,0,0,2,5,0
401402447,George Washington Revolutionaries,K. Frames,4281128,,True,38.0,3,9,0,1,3,8,2,4,0,2,2,3,0,0,1,3,11
401402447,George Washington Revolutionaries,N. Lok,4898514,,False,13.0,3,4,0,1,3,3,0,0,0,4,4,0,0,0,1,0,9
401402447,George Washington Revolutionaries,T. Webster,4705003,,False,20.0,1,4,1,2,0,2,0,0,1,1,2,3,0,0,2,2,2
401402447,George Washington Revolutionaries,A. Gingras,4703752,,False,5.0,0,0,0,0,0,0,0,0,0,0,0,0,0,0,0,0,0
401402447,George Washington Revolutionaries,S. Bell,4399630,,False,2.0,0,1,0,0,0,1,0,0,0,0,0,0,0,0,0,0,0
401402447,George Washington Revolutionaries,TEAM,TOTAL,TOTAL,False,,17,52,10,30,7,22,6,14,8,26,34,9,7,1,12,13,47
401402446,Dayton Flyers,K. Whitehead,4399307,,True,43.0,3,5,3,5,0,0,4,4,4,3,7,1,1,0,3,0,10
401402446,Dayton Flyers,T. Magassa,4703739,,True,20.0,3,5,3,5,0,0,4,5,1,1,2,0,0,1,1,4,10
401402446,Dayton Flyers,J. Giacone,4068133,,True,31.0,1,8,1,4,0,4,1,2,0,4,4,1,0,1,1,2,3
401402446,Dayton Flyers,E. Whalen,4065788,,True,27.0,2,9,2,6,0,3,4,4,1,0,1,4,0,0,4,2,8
401402446,Dayton Flyers,A. Bradshaw,4065758,,True,44.0,1,4,0,3,1,1,1,2,0,13,13,3,0,0,1,0,4
401402446,Dayton Flyers,B. Shoup-Hill,4898494,,False,3.0,0,1,0,0,0,1,0,0,0,0,0,0,0,1,0,1,0
401402446,Dayton Flyers,M. Perez,4594754,,False,12.0,4,7,4,7,0,0,0,0,2,2,4,0,1,1,2,2,8
401402446,Dayton Flyers,M. Cook,4682764,,False,37.0,5,17,4,13,1,4,3,4,1,1,2,1,2,0,0,2,14
401402446,Dayton Flyers,C. Brown,4433750,,False,1.0,0,0,0,0,0,0,0,0,0,0,0,0,0,0,1,0,0
401402446,Dayton Flyers,M. Perry,4433361,,False,7.0,1,1,1,1,0,0,1,2,1,3,4,0,0,0,1,0,3
401402446,Dayton Flyers,TEAM,TOTAL,TOTAL,False,,20,57,18,44,2,13,18,23,14,30,44,10,4,4,14,13,60
401402446,Davidson Wildcats,E. Sutphin,4594389,,True,37.0,7,14,7,10,0,4,0,0,1,2,3,1,1,1,2,3,14
401402446,Davidson Wildcats,I. Morgan,4898417,,True,39.0,7,14,5,10,2,4,2,2,2,4,6,5,0,0,1,2,18
401402446,Davidson Wildcats,C. Gould,4399043,,True,37.0,1,8,1,6,0,2,0,0,1,5,6,3,0,0,0,5,2
401402446,Davidson Wildcats,S. Konstans,4399042,,True,38.0,3,10,0,2,3,8,0,0,2,1,3,2,1,1,3,5,9
401402446,Davidson Wildcats,C. Welch,4399041,,True,40.0,2,10,2,6,0,4,2,2,0,9,9,3,2,0,1,2,6
401402446,Davidson Wildcats,A. Fuller,4594435,,False,14.0,0,7,0,4,0,3,2,2,1,0,1,0,0,0,2,2,2
401402446,Davidson Wildcats,C. Tabor,4594433,,False,14.0,1,4,1,3,0,1,0,0,1,0,1,0,0,0,1,0,2
401402446,Davidson Wildcats,S. Deegan,4594432,,False,6.0,1,1,1,1,0,0,0,0,1,0,1,0,0,0,2,0,2
401402446,Davidson Wildcats,TEAM,TOTAL,TOTAL,False,,22,68,17,42,5,26,6,6,15,24,39,14,4,2,13,19,55
401402445,George Mason Patriots,T. Lawhorne,4433109,,True,25.0,1,5,1,2,0,3,2,2,3,2,5,0,2,1,2,4,4
401402445,George Mason Patriots,A. Scott,4282215,,True,40.0,9,23,9,23,0,0,7,8,3,3,6,1,2,0,2,1,25
401402445,George Mason Patriots,J. Doster,4594773,,True,21.0,0,3,0,3,0,0,0,0,3,3,6,0,1,1,1,3,0
401402445,George Mason Patriots,T. Jameson,4703748,,True,33.0,4,9,4,4,0,5,4,5,2,0,2,0,2,1,1,2,12
401402445,George Mason Patriots,J. Ephraim,4398892,,True,19.0,1,1,1,1,0,0,2,2,0,1,1,0,0,0,1,2,4
401402445,George Mason Patriots,P. Surez,4898502,,False,30.0,1,6,0,2,1,4,2,2,0,5,5,2,1,0,4,2,5
401402445,George Mason Patriots,J. Wakefield,4594774,,False,8.0,0,2,0,1,0,1,0,0,0,0,0,0,0,0,0,1,0
401402445,George Mason Patriots,J. Adams,4399495,,False,24.0,0,9,0,8,0,1,0,0,2,3,5,2,0,0,2,2,0
401402445,George Mason Patriots,TEAM,TOTAL,TOTAL,False,,16,58,15,44,1,14,17,19,15,20,35,5,8,3,13,17,50
401402445,Fordham Rams,M. Jonassen,4399050,,True,20.0,1,1,1,1,0,0,0,0,1,3,4,2,0,0,0,4,2
401402445,Fordham Rams,K. Downey,4399048,,True,33.0,4,8,1,1,3,7,0,0,1,7,8,5,2,2,1,0,11
401402445,Fordham Rams,A. DeWolfe,4594765,,True,40.0,5,15,4,11,1,4,1,2,0,4,4,2,2,0,4,2,12
401402445,Fordham Rams,A. Dingle,4399322,,True,40.0,6,12,6,11,0,1,5,6,4,8,12,1,3,0,4,2,17
401402445,Fordham Rams,K. Heremaia,4281473,,True,32.0,7,16,3,6,4,10,4,6,0,2,2,3,0,0,3,4,22
401402445,Fordham Rams,M. Prior,4898497,,False,10.0,1,1,1,1,0,0,0,0,1,0,1,3,0,0,0,0,2
401402445,Fordham Rams,M. Flood,4703743,,False,1.0,0,0,0,0,0,0,0,0,0,0,0,0,0,0,0,0,0
401402445,Fordham Rams,S. Karpell,4594767,,False,24.0,0,0,0,0,0,0,0,0,1,4,5,1,0,0,3,1,0
401402445,Fordham Rams,TEAM,TOTAL,TOTAL,False,,24,53,16,31,8,22,10,14,11,29,40,17,7,2,16,13,66
401402444,Saint Joseph's Hawks,L. Fair,4898534,,True,27.0,6,11,6,11,0,0,8,9,4,5,9,2,1,2,0,0,20
401402444,Saint Joseph's Hawks,T. Brugler,4898530,,True,35.0,8,14,7,11,1,3,3,3,1,7,8,1,1,0,3,3,20
401402444,Saint Joseph's Hawks,M. Smith,4898535,,True,34.0,3,13,2,8,1,5,2,2,2,5,7,2,0,0,5,2,9
401402444,Saint Joseph's Hawks,J. Nystrom,4898532,,True,30.0,0,2,0,1,0,1,2,2,1,2,3,2,0,0,1,1,2
401402444,Saint Joseph's Hawks,K. Jekot,4281901,,True,27.0,2,7,2,3,0,4,1,2,1,2,3,4,2,0,4,3,5
401402444,Saint Joseph's Hawks,K. Mayock,4399473,,False,9.0,0,0,0,0,0,0,2,2,2,1,3,1,0,1,0,0,2
401402444,Saint Joseph's Hawks,L. Marsicano,4399472,,False,9.0,2,2,2,2,0,0,0,0,0,0,0,1,1,0,2,1,4
401402444,Saint Joseph's Hawks,E. Boslet,4704122,,False,2.0,0,0,0,0,0,0,0,0,0,0,0,0,0,0,0,0,0
401402444,Saint Joseph's Hawks,O. Mullins,4704121,,False,27.0,1,4,1,3,0,1,1,2,0,3,3,4,1,0,2,3,3
401402444,Saint Joseph's Hawks,TEAM,TOTAL,TOTAL,False,,22,53,20,39,2,14,19,22,12,27,39,17,6,3,17,13,65
401402444,Duquesne Dukes,F. Pouye,4595264,,True,15.0,3,7,3,4,0,3,2,2,3,1,4,0,1,0,2,5,8
401402444,Duquesne Dukes,A. Hamilton,4594761,,True,19.0,1,10,1,7,0,3,2,2,1,3,4,4,0,0,1,3,4
401402444,Duquesne Dukes,T. Myers,4703742,,True,38.0,5,15,1,2,4,13,1,2,0,3,3,0,1,0,3,3,15
401402444,Duquesne Dukes,M. McConnell,4433510,,True,35.0,1,7,0,4,1,3,2,4,3,3,6,3,5,0,1,2,5
401402444,Duquesne Dukes,L. Bazelak,4281465,,True,39.0,2,6,1,3,1,3,0,0,1,3,4,1,1,0,3,2,5
401402444,Duquesne Dukes,P. Johnson,4594762,,False,21.0,4,10,4,9,0,1,3,4,5,3,8,2,1,0,1,4,11
401402444,Duquesne Dukes,A. Walker,4595306,,False,3.0,0,1,0,1,0,0,0,0,0,1,1,0,0,0,0,0,0
401402444,Duquesne Dukes,L. Sole,4066591,,False,5.0,0,2,0,2,0,0,0,0,0,1,1,0,0,0,0,0,0
401402444,Duquesne Dukes,N. Sekulovska,4898495,,False,1.0,0,0,0,0,0,0,0,0,0,0,0,0,0,0,0,0,0
401402444,Duquesne Dukes,A. Kalin,4281467,,False,6.0,0,0,0,0,0,0,0,0,0,0,0,0,0,0,1,1,0
401402444,Duquesne Dukes,H. Bovell,4068402,,False,18.0,0,1,0,1,0,0,1,2,2,0,2,0,1,1,2,2,1
401402444,Duquesne Dukes,TEAM,TOTAL,TOTAL,False,,16,59,10,33,6,26,11,16,16,21,37,10,10,1,15,22,49
401402443,La Salle Explorers,K. Spruill,4399437,,True,35.0,3,6,3,3,0,3,5,7,0,9,9,2,2,1,2,2,11
401402443,La Salle Explorers,A. Jacobs,4594785,,True,23.0,1,4,0,1,1,3,0,0,4,0,4,5,0,0,2,3,3
401402443,La Salle Explorers,M. Masciantonio,4594782,,True,36.0,5,12,2,5,3,7,3,4,1,2,3,3,4,0,2,4,16
401402443,La Salle Explorers,C. Jacobs,4594781,,True,29.0,4,14,4,8,0,6,1,3,0,2,2,1,1,0,1,5,9
401402443,La Salle Explorers,J. Haynes,4433779,,True,29.0,1,4,0,1,1,3,0,0,0,3,3,0,0,0,2,2,3
401402443,La Salle Explorers,G. Crawford,4398708,,False,23.0,5,15,5,14,0,1,0,2,2,2,4,1,2,1,1,3,10
401402443,La Salle Explorers,M. Kozicki,4704107,,False,2.0,0,1,0,1,0,0,0,0,1,0,1,0,0,0,0,1,0
401402443,La Salle Explorers,K. Cote-Lysius,4898518,,False,21.0,0,2,0,0,0,2,2,2,1,1,2,1,1,0,2,3,2
401402443,La Salle Explorers,C. Kline,4594780,,False,2.0,0,0,0,0,0,0,0,0,0,0,0,0,0,0,0,0,0
401402443,La Salle Explorers,TEAM,TOTAL,TOTAL,False,,19,58,14,33,5,25,11,18,11,20,31,13,10,2,12,23,54
401402443,George Washington Revolutionaries,M. Taiwo,4399083,,True,32.0,4,10,4,10,0,0,2,4,3,7,10,2,0,0,1,3,10
401402443,George Washington Revolutionaries,M. Engel,4898515,,True,18.0,2,2,1,1,1,1,0,0,1,0,1,0,0,0,2,4,5
401402443,George Washington Revolutionaries,S. Laureano,4898512,,True,29.0,5,11,3,7,2,4,0,4,0,4,4,2,3,0,4,2,12
401402443,George Washington Revolutionaries,E. Brown,4594778,,True,34.0,1,4,1,4,0,0,3,4,0,4,4,1,0,0,2,3,5
401402443,George Washington Revolutionaries,K. Frames,4281128,,True,34.0,3,4,0,1,3,3,5,9,0,4,4,7,0,0,2,2,14
401402443,George Washington Revolutionaries,F. Blethen,4594777,,False,5.0,1,1,0,0,1,1,0,0,0,0,0,0,0,0,0,1,3
401402443,George Washington Revolutionaries,N. Lok,4898514,,False,6.0,1,2,1,2,0,0,0,0,0,2,2,1,1,0,0,0,2
401402443,George Washington Revolutionaries,T. Webster,4705003,,False,25.0,4,7,3,5,1,2,0,2,3,5,8,0,1,0,5,1,9
401402443,George Washington Revolutionaries,A. Gingras,4703752,,False,12.0,1,3,1,3,0,0,2,2,0,0,0,0,1,0,3,0,4
401402443,George Washington Revolutionaries,S. Bell,4399630,,False,5.0,0,0,0,0,0,0,0,0,0,0,0,0,0,0,0,0,0
401402443,George Washington Revolutionaries,TEAM,TOTAL,TOTAL,False,,22,44,14,33,8,11,12,25,7,30,37,13,6,0,20,16,64
401402442,Richmond Spiders,A. Budnik,4704117,,True,37.0,8,16,6,10,2,6,1,4,1,4,5,0,0,3,2,0,19
401402442,Richmond Spiders,E. Squires,4399456,,True,34.0,3,9,1,3,2,6,1,2,0,3,3,1,0,0,2,1,9
401402442,Richmond Spiders,S. Ryan,4704119,,True,29.0,3,5,2,2,1,3,1,2,1,2,3,1,2,1,2,2,8
401402442,Richmond Spiders,G. Townsend,4704116,,True,35.0,6,17,4,12,2,5,2,2,3,5,8,8,0,0,2,1,16
401402442,Richmond Spiders,K. Klimkiewicz,4398570,,True,31.0,2,5,2,4,0,1,0,0,1,2,3,0,2,0,1,4,4
401402442,Richmond Spiders,C. Williams,4898528,,False,6.0,0,0,0,0,0,0,0,0,0,0,0,0,0,0,0,0,0
401402442,Richmond Spiders,M. Ettle,4704120,,False,3.0,0,0,0,0,0,0,0,0,0,0,0,1,0,0,0,1,0
401402442,Richmond Spiders,K. Hill,4898529,,False,13.0,0,1,0,1,0,0,0,0,0,0,0,1,0,0,1,0,0
401402442,Richmond Spiders,S. Boone,4898527,,False,5.0,2,4,0,1,2,3,0,0,0,2,2,1,0,0,0,2,6
401402442,Richmond Spiders,C. Holt,4399455,,False,7.0,0,0,0,0,0,0,0,0,0,1,1,0,0,0,1,0,0
401402442,Richmond Spiders,TEAM,TOTAL,TOTAL,False,,24,57,15,33,9,24,5,10,11,21,32,13,4,4,13,11,62
401402442,Davidson Wildcats,E. Sutphin,4594389,,True,33.0,11,17,11,16,0,1,0,1,3,3,6,2,1,2,3,3,22
401402442,Davidson Wildcats,I. Morgan,4898417,,True,38.0,5,11,4,6,1,5,2,3,2,1,3,5,3,1,1,2,13
401402442,Davidson Wildcats,C. Gould,4399043,,True,34.0,3,7,3,6,0,1,0,0,2,6,8,5,1,1,3,2,6
401402442,Davidson Wildcats,S. Konstans,4399042,,True,7.0,0,0,0,0,0,0,0,0,1,0,1,0,0,0,2,0,0
401402442,Davidson Wildcats,C. Welch,4399041,,True,37.0,5,13,3,5,2,8,2,4,1,6,7,4,2,0,1,3,14
401402442,Davidson Wildcats,A. Fuller,4594435,,False,8.0,2,3,2,3,0,0,0,0,0,2,2,0,0,0,1,0,4
401402442,Davidson Wildcats,C. Tabor,4594433,,False,14.0,1,3,0,0,1,3,0,0,2,0,2,0,0,0,1,1,3
401402442,Davidson Wildcats,S. Deegan,4594432,,False,26.0,2,9,2,4,0,5,0,0,1,3,4,0,1,0,1,1,4
401402442,Davidson Wildcats,S. Schutz,4433772,,False,3.0,0,0,0,0,0,0,0,0,0,0,0,0,0,0,0,0,0
401402442,Davidson Wildcats,TEAM,TOTAL,TOTAL,False,,29,63,25,40,4,23,4,8,16,23,39,16,8,4,13,12,66
401402441,Saint Louis Billikens,P. Kennedy,4704135,,True,20.0,2,7,1,2,1,5,0,1,1,1,2,1,0,0,1,3,5
401402441,Saint Louis Billikens,B. Flowers,4399482,,True,32.0,1,5,1,5,0,0,4,4,3,8,11,1,0,8,3,4,6
401402441,Saint Louis Billikens,N. McNeal,4704134,,True,37.0,2,7,2,4,0,3,0,0,0,5,5,3,0,0,1,2,4
401402441,Saint Louis Billikens,J. Martinez,4594812,,True,39.0,5,12,4,9,1,3,5,6,7,7,14,2,3,0,4,3,16
401402441,Saint Louis Billikens,C. Harbison,4399480,,True,39.0,4,16,4,12,0,4,4,4,1,0,1,1,1,0,3,4,12
401402441,Saint Louis Billikens,S. Lazar,4898536,,False,16.0,2,6,1,1,1,5,0,0,0,0,0,0,0,0,1,1,5
401402441,Saint Louis Billikens,S. Gul,4598222,,False,16.0,1,6,1,3,0,3,0,0,0,0,0,0,0,0,0,0,2
401402441,Saint Louis Billikens,A. Prifti,4914835,,False,1.0,0,0,0,0,0,0,0,0,0,0,0,0,0,0,0,0,0
401402441,Saint Louis Billikens,TEAM,TOTAL,TOTAL,False,,17,59,14,36,3,23,13,15,12,24,36,8,4,8,13,17,50
401402441,George Mason Patriots,T. Lawhorne,4433109,,True,28.0,8,17,2,4,6,13,2,2,1,4,5,1,0,1,0,1,24
401402441,George Mason Patriots,A. Scott,4282215,,True,29.0,5,8,5,8,0,0,1,2,1,5,6,3,0,0,3,3,11
401402441,George Mason Patriots,J. Doster,4594773,,True,33.0,7,11,7,11,0,0,0,0,2,5,7,0,1,2,2,3,14
401402441,George Mason Patriots,T. Jameson,4703748,,True,25.0,2,9,1,5,1,4,0,0,0,2,2,0,0,0,0,0,5
401402441,George Mason Patriots,V. Laumbach,4703750,,False,1.0,0,1,0,1,0,0,0,0,0,0,0,0,0,0,0,0,0
401402441,George Mason Patriots,A. Rodriguez,4703676,,False,7.0,0,1,0,1,0,0,0,0,0,0,0,0,0,1,1,2,0
401402441,George Mason Patriots,P. Surez,4898502,,False,37.0,2,5,2,3,0,2,2,2,2,2,4,4,2,0,1,3,6
401402441,George Mason Patriots,J. Wakefield,4594774,,False,6.0,0,0,0,0,0,0,0,0,0,0,0,1,0,0,0,2,0
401402441,George Mason Patriots,J. Adams,4399495,,False,20.0,1,6,1,5,0,1,3,4,0,4,4,1,0,0,3,0,5
401402441,George Mason Patriots,L. Kaktaite,4399314,,False,1.0,0,0,0,0,0,0,0,0,0,0,0,0,0,0,0,0,0
401402441,George Mason Patriots,J. Ephraim,4398892,,False,13.0,0,1,0,0,0,1,0,0,0,1,1,1,0,0,1,0,0
401402441,George Mason Patriots,TEAM,TOTAL,TOTAL,False,,25,59,18,38,7,21,8,10,10,31,41,11,3,4,12,14,65
401402440,St. Bonaventure Bonnies,T. Napper,4898539,,True,7.0,0,1,0,0,0,1,0,0,0,1,1,0,0,0,1,0,0
401402440,St. Bonaventure Bonnies,I. Lops,4595879,,True,35.0,2,4,2,3,0,1,1,2,0,6,6,2,0,6,2,2,5
401402440,St. Bonaventure Bonnies,T. Johnson,4898537,,True,38.0,2,5,2,3,0,2,0,0,1,3,4,3,0,0,3,4,4
401402440,St. Bonaventure Bonnies,A. Johnson,4399461,,True,40.0,8,18,8,18,0,0,1,1,0,7,7,2,1,0,8,1,17
401402440,St. Bonaventure Bonnies,T. Harris,4281443,,True,40.0,7,12,4,8,3,4,1,2,1,4,5,0,1,0,0,2,18
401402440,St. Bonaventure Bonnies,E. Adams,4703711,,False,5.0,0,0,0,0,0,0,0,0,0,2,2,1,1,0,3,1,0
401402440,St. Bonaventure Bonnies,M. Dziezgowski,4704131,,False,16.0,0,2,0,0,0,2,2,4,0,1,1,0,0,0,0,0,2
401402440,St. Bonaventure Bonnies,N. Oppenheimer,4281219,,False,19.0,1,2,0,0,1,2,0,0,0,1,1,0,1,0,0,1,3
401402440,St. Bonaventure Bonnies,TEAM,TOTAL,TOTAL,False,,20,44,16,32,4,12,5,9,3,25,28,8,4,6,18,11,49
401402440,George Washington Revolutionaries,M. Taiwo,4399083,,True,38.0,6,13,6,13,0,0,2,5,3,7,10,2,5,0,2,3,14
401402440,George Washington Revolutionaries,M. Engel,4898515,,True,30.0,4,11,2,4,2,7,2,2,1,2,3,1,0,0,2,3,12
401402440,George Washington Revolutionaries,S. Laureano,4898512,,True,31.0,2,12,1,7,1,5,0,0,0,3,3,5,2,1,4,3,5
401402440,George Washington Revolutionaries,E. Brown,4594778,,True,36.0,2,7,2,6,0,1,0,0,7,5,12,5,0,0,2,3,4
401402440,George Washington Revolutionaries,K. Frames,4281128,,True,37.0,6,11,3,5,3,6,2,3,0,3,3,1,1,0,2,0,17
401402440,George Washington Revolutionaries,N. Lok,4898514,,False,4.0,0,2,0,2,0,0,0,0,0,0,0,0,0,0,0,0,0
401402440,George Washington Revolutionaries,T. Webster,4705003,,False,12.0,1,5,1,3,0,2,0,0,1,2,3,0,0,0,1,0,2
401402440,George Washington Revolutionaries,A. Gingras,4703752,,False,9.0,0,1,0,1,0,0,0,0,0,0,0,0,1,0,0,0,0
401402440,George Washington Revolutionaries,S. Bell,4399630,,False,3.0,0,0,0,0,0,0,0,0,0,0,0,0,0,0,0,1,0
401402440,George Washington Revolutionaries,TEAM,TOTAL,TOTAL,False,,21,62,15,41,6,21,6,10,17,23,40,14,9,1,13,13,54
401386720,Hawai'i Rainbow Wahine,K. Spiller,4282329,,True,14.0,3,6,2,4,1,2,1,2,3,2,5,0,0,2,0,1,8
401386720,Hawai'i Rainbow Wahine,A. Atwell,4068885,,True,37.0,7,17,0,3,7,14,5,5,1,4,5,1,1,0,0,1,26
401386720,Hawai'i Rainbow Wahine,O. Davies,4595197,,True,17.0,2,6,2,4,0,2,1,1,0,3,3,1,0,0,1,0,5
401386720,Hawai'i Rainbow Wahine,K. Imai,4704370,,True,33.0,2,9,1,3,1,6,2,2,2,1,3,4,1,2,2,2,7
401386720,Hawai'i Rainbow Wahine,D. Phillips,4704369,,True,34.0,6,11,5,9,1,2,6,6,2,5,7,5,1,1,0,2,19
401386720,Hawai'i Rainbow Wahine,J. David,4899662,,False,7.0,0,3,0,1,0,2,0,0,0,0,0,0,1,0,1,1,0
401386720,Hawai'i Rainbow Wahine,N. Orji,4704372,,False,17.0,2,4,2,3,0,1,2,3,1,1,2,0,1,1,1,3,6
401386720,Hawai'i Rainbow Wahine,E. Ongoongotau,4899661,,False,1.0,0,0,0,0,0,0,0,0,0,0,0,0,0,0,0,0,0
401386720,Hawai'i Rainbow Wahine,M. McBee,4704375,,False,17.0,0,2,0,0,0,2,0,0,1,1,2,3,1,0,1,0,0
401386720,Hawai'i Rainbow Wahine,A. Thoms,4399949,,False,23.0,1,4,0,0,1,4,1,2,0,1,1,0,0,0,0,2,4
401386720,Hawai'i Rainbow Wahine,TEAM,TOTAL,TOTAL,False,,23,62,12,27,11,35,18,21,13,21,34,14,6,6,6,12,75
401386720,Cal State Northridge Matadors,K. Spriggs,4899651,,True,30.0,2,3,2,3,0,0,0,0,0,5,5,0,0,0,1,2,4
401386720,Cal State Northridge Matadors,M. Duchemin,4899647,,True,10.0,1,3,1,3,0,0,0,0,1,2,3,1,0,0,2,1,2
401386720,Cal State Northridge Matadors,T. Amundsen,4281747,,True,38.0,7,11,5,7,2,4,0,0,1,6,7,2,0,0,4,1,16
401386720,Cal State Northridge Matadors,J. Jackson,4400035,,True,36.0,4,11,4,7,0,4,6,6,1,4,5,4,0,0,3,1,14
401386720,Cal State Northridge Matadors,M. Henderson,4281463,,True,24.0,1,6,0,0,1,6,0,0,0,1,1,2,0,0,1,4,3
401386720,Cal State Northridge Matadors,O. Smith,4595193,,False,3.0,0,0,0,0,0,0,0,0,0,0,0,0,0,0,0,0,0
401386720,Cal State Northridge Matadors,A. Hawkins,4899650,,False,12.0,1,2,1,1,0,1,1,1,1,0,1,0,0,0,1,0,3
401386720,Cal State Northridge Matadors,M. Smith,4899649,,False,24.0,6,12,2,4,4,8,4,6,1,3,4,0,1,0,1,2,20
401386720,Cal State Northridge Matadors,R. Harvey,4704364,,False,23.0,0,3,0,3,0,0,0,0,2,2,4,2,1,0,0,4,0
401386720,Cal State Northridge Matadors,TEAM,TOTAL,TOTAL,False,,22,51,15,28,7,23,11,13,8,24,32,11,2,0,13,15,62
401386719,UC Santa Barbara Gauchos,M. Anderson,4281881,,True,20.0,1,4,0,0,1,4,0,0,0,1,1,2,0,0,1,0,3
401386719,UC Santa Barbara Gauchos,I. Lane,4595216,,True,35.0,7,8,7,8,0,0,0,0,5,6,11,1,2,0,5,3,14
401386719,UC Santa Barbara Gauchos,J. Gonzalez,4433343,,True,20.0,0,2,0,2,0,0,0,0,0,7,7,4,0,0,5,0,0
401386719,UC Santa Barbara Gauchos,A. Tucker,4432947,,True,27.0,6,15,6,14,0,1,11,16,3,2,5,0,2,0,2,2,23
401386719,UC Santa Barbara Gauchos,D. Miller,4281726,,True,38.0,5,13,2,7,3,6,2,2,0,1,1,0,3,0,1,2,15
401386719,UC Santa Barbara Gauchos,T. Modawar,4595249,,False,4.0,0,0,0,0,0,0,0,0,0,1,1,0,0,0,0,1,0
401386719,UC Santa Barbara Gauchos,T. Mole,4400101,,False,3.0,0,1,0,1,0,0,0,0,0,1,1,1,0,0,1,1,0
401386719,UC Santa Barbara Gauchos,K. Johnson,4899739,,False,17.0,1,3,1,3,0,0,2,4,4,4,8,1,0,1,0,0,4
401386719,UC Santa Barbara Gauchos,A. Marin,4704398,,False,2.0,0,0,0,0,0,0,0,0,0,0,0,0,0,0,0,0,0
401386719,UC Santa Barbara Gauchos,A. Choice,4704397,,False,20.0,1,2,1,2,0,0,0,2,0,3,3,2,0,0,3,1,2
401386719,UC Santa Barbara Gauchos,L. Lee,4400069,,False,14.0,1,1,1,1,0,0,0,0,1,2,3,0,0,0,2,1,2
401386719,UC Santa Barbara Gauchos,TEAM,TOTAL,TOTAL,False,,22,49,18,38,4,11,15,24,14,29,43,11,7,1,20,11,63
401386719,Cal State Northridge Matadors,K. Spriggs,4899651,,True,8.0,0,3,0,3,0,0,0,0,0,1,1,1,0,0,2,5,0
401386719,Cal State Northridge Matadors,T. Amundsen,4281747,,True,37.0,8,15,6,10,2,5,2,2,2,5,7,0,3,0,4,3,20
401386719,Cal State Northridge Matadors,A. Tu'ua,4704366,,True,29.0,4,6,2,3,2,3,0,0,0,1,1,1,0,0,1,2,10
401386719,Cal State Northridge Matadors,J. Jackson,4400035,,True,36.0,8,12,7,11,1,1,2,2,0,1,1,4,2,0,1,2,19
401386719,Cal State Northridge Matadors,M. Henderson,4281463,,True,32.0,0,3,0,1,0,2,0,0,0,1,1,2,2,0,1,3,0
401386719,Cal State Northridge Matadors,M. Duchemin,4899647,,False,22.0,1,8,1,8,0,0,0,0,1,4,5,0,1,0,2,2,2
401386719,Cal State Northridge Matadors,O. Smith,4595193,,False,1.0,0,0,0,0,0,0,0,0,0,0,0,0,0,0,0,0,0
401386719,Cal State Northridge Matadors,A. Hawkins,4899650,,False,10.0,0,1,0,0,0,1,0,0,0,1,1,0,0,0,0,1,0
401386719,Cal State Northridge Matadors,M. Smith,4899649,,False,15.0,0,5,0,1,0,4,0,0,0,2,2,1,1,0,1,0,0
401386719,Cal State Northridge Matadors,R. Harvey,4704364,,False,10.0,0,0,0,0,0,0,0,0,0,0,0,0,0,0,1,4,0
401386719,Cal State Northridge Matadors,TEAM,TOTAL,TOTAL,False,,21,53,16,37,5,16,4,4,3,17,20,9,9,0,13,22,51
401383151,Wagner Seahawks,K. Jackson,4595840,,True,23.0,2,7,2,7,0,0,1,2,1,2,3,0,1,5,0,4,5
401383151,Wagner Seahawks,E. Grava,4399598,,True,31.0,10,14,9,13,1,1,2,2,0,4,4,0,0,1,0,3,23
401383151,Wagner Seahawks,D. Heyward,4595838,,True,21.0,2,5,2,3,0,2,2,2,2,4,6,8,2,0,4,5,6
401383151,Wagner Seahawks,A. Cowan,4595837,,True,28.0,3,4,2,2,1,2,4,4,0,2,2,2,2,0,2,1,11
401383151,Wagner Seahawks,Z. Thybulle,4400086,,True,37.0,6,10,5,9,1,1,2,2,0,5,5,11,0,0,3,4,15
401383151,Wagner Seahawks,K. Nwabudu,4400017,,False,25.0,3,6,3,6,0,0,1,2,0,4,4,1,0,0,1,1,7
401383151,Wagner Seahawks,L. Loceniece,4900500,,False,20.0,3,7,1,3,2,4,0,0,0,2,2,0,1,1,2,0,8
401383151,Wagner Seahawks,M. Sanchez-Henry,4705398,,False,5.0,0,1,0,0,0,1,2,2,0,1,1,0,1,1,0,0,2
401383151,Wagner Seahawks,R. Pitt,4399600,,False,10.0,1,2,1,2,0,0,0,0,0,0,0,0,1,0,1,0,2
401383151,Wagner Seahawks,TEAM,TOTAL,TOTAL,False,,30,56,25,45,5,11,14,16,3,26,29,22,8,8,15,18,79
401383151,Merrimack Warriors,T. Brown,4704979,,True,18.0,2,7,2,7,0,0,2,2,1,2,3,0,2,0,4,2,6
401383151,Merrimack Warriors,P. McCormick,4281851,,True,21.0,1,6,1,4,0,2,0,0,2,2,4,0,0,0,2,2,2
401383151,Merrimack Warriors,M. Kimball,4597028,,True,27.0,4,9,4,6,0,3,5,7,0,2,2,4,1,0,1,3,13
401383151,Merrimack Warriors,K. Mager,4597023,,True,29.0,2,5,1,2,1,3,1,2,0,2,2,0,0,0,1,1,6
401383151,Merrimack Warriors,J. DeCesare,4597019,,True,40.0,7,11,5,8,2,3,7,10,3,4,7,3,0,0,5,1,23
401383151,Merrimack Warriors,A. Staton,4704140,,False,14.0,1,4,1,4,0,0,1,2,1,3,4,1,2,0,2,2,3
401383151,Merrimack Warriors,C. Balague,4400120,,False,19.0,5,10,3,6,2,4,0,0,0,3,3,1,0,1,1,1,12
401383151,Merrimack Warriors,A. Owens,4900512,,False,17.0,0,4,0,4,0,0,0,0,0,1,1,3,1,0,2,3,0
401383151,Merrimack Warriors,K. Thomas,4597022,,False,15.0,1,4,1,2,0,2,0,0,0,1,1,0,0,0,1,2,2
401383151,Merrimack Warriors,TEAM,TOTAL,TOTAL,False,,23,60,18,43,5,17,16,23,13,22,35,12,6,1,19,17,67
401382349,Southern Jaguars,R. White,4595966,,True,19.0,3,7,3,7,0,0,4,8,3,2,5,0,0,0,2,2,10
401382349,Southern Jaguars,T. Metcalf,4704148,,True,26.0,1,6,0,5,1,1,0,0,0,0,0,0,0,0,1,1,3
401382349,Southern Jaguars,G. Johnson,4595965,,True,23.0,1,9,1,8,0,1,6,6,2,1,3,0,1,0,1,5,8
401382349,Southern Jaguars,N. Kincey,4595962,,True,35.0,0,7,0,2,0,5,0,0,3,3,6,1,1,0,0,3,0
401382349,Southern Jaguars,A. Mcwain,4400584,,True,27.0,2,13,0,5,2,8,0,0,1,2,3,2,0,0,2,0,6
401382349,Southern Jaguars,T. Moore,4400585,,False,13.0,1,4,1,3,0,1,0,0,2,1,3,1,0,0,1,3,2
401382349,Southern Jaguars,X. Harrison,4900564,,False,2.0,0,0,0,0,0,0,0,0,0,0,0,0,0,0,0,0,0
401382349,Southern Jaguars,T. Lidge,4900563,,False,5.0,0,1,0,1,0,0,0,0,0,1,1,0,0,0,0,0,0
401382349,Southern Jaguars,S. Reed,4900561,,False,2.0,0,0,0,0,0,0,0,0,0,0,0,0,0,0,0,0,0
401382349,Southern Jaguars,A. Fontenot,4900560,,False,6.0,1,2,1,1,0,1,1,2,0,0,0,0,0,0,0,0,3
401382349,Southern Jaguars,D. Hunter,4705035,,False,13.0,1,5,1,3,0,2,1,2,1,0,1,0,2,0,0,1,3
401382349,Southern Jaguars,C. Fleming,4595963,,False,14.0,2,3,2,2,0,1,2,4,0,1,1,2,4,0,3,2,6
401382349,Southern Jaguars,K. Watson,4595961,,False,15.0,2,5,2,5,0,0,1,3,1,1,2,0,1,1,1,4,5
401382349,Southern Jaguars,TEAM,TOTAL,TOTAL,False,,14,62,11,42,3,20,15,25,17,14,31,6,9,1,14,21,46
401382349,Alabama State Lady Hornets,S. Ward,4400468,,True,26.0,5,5,5,5,0,0,1,3,2,8,10,2,0,0,3,3,11
401382349,Alabama State Lady Hornets,J. Nneji,4282073,,True,21.0,2,5,2,5,0,0,1,2,3,8,11,0,0,2,1,3,5
401382349,Alabama State Lady Hornets,J. Crawford,4400465,,True,35.0,4,11,2,5,2,6,6,6,0,3,3,1,1,0,1,2,16
401382349,Alabama State Lady Hornets,T. Rudolph,4400463,,True,2.0,0,1,0,1,0,0,0,0,0,1,1,1,0,0,0,0,0
401382349,Alabama State Lady Hornets,A. Emmanuel,4400462,,True,36.0,8,12,6,8,2,4,6,6,1,8,9,1,1,0,4,3,24
401382349,Alabama State Lady Hornets,T. Thomas,4704008,,False,3.0,0,0,0,0,0,0,0,0,0,0,0,0,0,0,1,2,0
401382349,Alabama State Lady Hornets,B. Watkins,4900452,,False,5.0,0,1,0,1,0,0,1,2,0,0,0,0,1,0,1,1,1
401382349,Alabama State Lady Hornets,T. Ashley,4704007,,False,5.0,1,1,1,1,0,0,0,0,0,2,2,0,0,1,2,1,2
401382349,Alabama State Lady Hornets,D. Sanders,4704005,,False,34.0,1,2,1,1,0,1,1,2,1,0,1,6,2,0,4,3,3
401382349,Alabama State Lady Hornets,H. White,4596194,,False,10.0,0,1,0,0,0,1,0,0,0,3,3,2,0,0,3,2,0
401382349,Alabama State Lady Hornets,K. Jackson,4595512,,False,23.0,1,3,1,2,0,1,0,0,0,1,1,1,1,0,3,2,2
401382349,Alabama State Lady Hornets,TEAM,TOTAL,TOTAL,False,,22,42,18,29,4,13,16,21,7,35,42,14,6,3,26,22,64
401381659,Colgate Raiders,T. McMillan,4704704,,True,29.0,2,7,2,7,0,0,0,0,3,7,10,1,0,0,4,2,4
401381659,Colgate Raiders,T. Golembiewski,4900535,,True,39.0,5,14,4,11,1,3,3,5,0,4,4,2,0,1,3,0,14
401381659,Colgate Raiders,M. McMahon,4900534,,True,28.0,7,12,4,6,3,6,0,0,0,3,3,2,0,0,2,4,17
401381659,Colgate Raiders,A. Brodie,4595550,,True,18.0,1,5,1,3,0,2,1,2,0,0,0,2,0,0,1,0,3
401381659,Colgate Raiders,T. Langan,4400179,,True,16.0,1,3,1,2,0,1,1,2,2,0,2,1,1,0,3,3,3
401381659,Colgate Raiders,S. Diehl,4900536,,False,18.0,2,6,2,5,0,1,5,5,3,1,4,3,0,0,1,3,9
401381659,Colgate Raiders,G. Rerko,4595554,,False,9.0,1,1,1,1,0,0,0,0,0,0,0,0,0,0,0,1,2
401381659,Colgate Raiders,A. Naessens,4400181,,False,14.0,1,1,1,1,0,0,0,0,2,0,2,1,0,0,1,1,2
401381659,Colgate Raiders,J. Paul,4595552,,False,29.0,2,6,1,3,1,3,0,0,0,5,5,0,1,1,3,2,5
401381659,Colgate Raiders,TEAM,TOTAL,TOTAL,False,,22,55,17,39,5,16,10,14,11,21,32,12,2,2,18,16,59
401381659,Bucknell Bison,I. King,4900533,,True,30.0,5,5,0,0,5,5,0,0,0,3,3,2,1,0,0,1,15
401381659,Bucknell Bison,E. Shaffer,4595535,,True,20.0,2,6,2,5,0,1,3,3,4,1,5,2,0,0,1,3,7
401381659,Bucknell Bison,C. Collins,4900532,,True,27.0,6,8,6,8,0,0,2,2,0,0,0,2,2,0,0,2,14
401381659,Bucknell Bison,M. Walls,4400177,,True,29.0,2,7,2,5,0,2,0,0,0,5,5,8,5,0,0,3,4
401381659,Bucknell Bison,T. O'Brien,4400176,,True,27.0,5,11,4,10,1,1,3,3,1,6,7,0,3,1,1,0,14
401381659,Bucknell Bison,C. Krsul,4595534,,False,16.0,2,9,2,9,0,0,0,0,2,1,3,2,1,0,1,2,4
401381659,Bucknell Bison,R. Sisselman,4900531,,False,17.0,3,6,0,2,3,4,1,2,0,0,0,1,0,0,0,1,10
401381659,Bucknell Bison,J. Kulesza,4704702,,False,14.0,5,6,1,1,4,5,2,4,1,0,1,0,0,0,0,0,16
401381659,Bucknell Bison,T. Johnson,4595533,,False,13.0,3,5,3,5,0,0,0,0,0,1,1,1,0,0,1,2,6
401381659,Bucknell Bison,C. Dingler,4577540,,False,7.0,0,0,0,0,0,0,1,2,0,2,2,1,0,0,0,1,1
401381659,Bucknell Bison,TEAM,TOTAL,TOTAL,False,,33,63,20,45,13,18,12,16,9,20,29,19,12,1,5,15,91
401379440,Texas Southern Tigers,J. Perry,4594405,,True,30.0,4,13,4,13,0,0,0,3,6,3,9,0,2,2,1,3,8
401379440,Texas Southern Tigers,A. Taylor,4399621,,True,26.0,1,7,1,3,0,4,0,0,1,0,1,1,1,0,2,3,2
401379440,Texas Southern Tigers,A. Knight,4900566,,True,40.0,4,10,1,4,3,6,0,0,3,5,8,1,1,0,1,1,11
401379440,Texas Southern Tigers,A. Bridges,4595954,,True,40.0,7,19,7,17,0,2,6,10,1,7,8,6,1,0,3,0,20
401379440,Texas Southern Tigers,A. Avent,4595645,,True,36.0,5,18,4,11,1,7,3,4,2,5,7,0,4,0,5,3,14
401379440,Texas Southern Tigers,S. Green,4400007,,False,12.0,0,0,0,0,0,0,0,0,1,2,3,0,0,0,0,2,0
401379440,Texas Southern Tigers,J. Buster,4400582,,False,11.0,0,2,0,2,0,0,0,0,2,1,3,0,0,1,1,4,0
401379440,Texas Southern Tigers,A. Austin,4400105,,False,5.0,0,5,0,2,0,3,1,2,1,1,2,0,0,0,1,0,1
401379440,Texas Southern Tigers,TEAM,TOTAL,TOTAL,False,,21,74,17,52,4,22,10,19,19,29,48,8,9,3,14,16,56
401379440,Prairie View A&M Lady Panthers,J. Soders,4900559,,True,29.0,4,10,4,9,0,1,2,4,3,1,4,2,1,0,0,3,10
401379440,Prairie View A&M Lady Panthers,K. Paul,4595982,,True,35.0,5,13,4,10,1,3,2,4,0,6,6,0,0,0,3,2,13
401379440,Prairie View A&M Lady Panthers,K. Heard,4595980,,True,28.0,2,8,2,5,0,3,0,0,3,7,10,2,2,1,3,3,4
401379440,Prairie View A&M Lady Panthers,E. Rosario,4596283,,True,27.0,2,5,2,4,0,1,0,0,0,3,3,1,2,1,4,1,4
401379440,Prairie View A&M Lady Panthers,D. Rosenthal,4595979,,True,18.0,3,11,3,7,0,4,3,3,1,5,6,2,1,0,1,2,9
401379440,Prairie View A&M Lady Panthers,J. Charles,4900557,,False,4.0,0,0,0,0,0,0,0,0,0,1,1,0,0,0,0,0,0
401379440,Prairie View A&M Lady Panthers,T. Simon,4900556,,False,5.0,0,0,0,0,0,0,0,0,0,2,2,0,0,0,2,0,0
401379440,Prairie View A&M Lady Panthers,G. Smith,4704127,,False,29.0,3,12,3,11,0,1,4,6,7,7,14,1,1,2,3,0,10
401379440,Prairie View A&M Lady Panthers,T. Hudson,4704128,,False,0.0,0,0,0,0,0,0,0,0,0,0,0,0,0,0,0,0,0
401379440,Prairie View A&M Lady Panthers,S. Patton,4704919,,False,3.0,0,2,0,0,0,2,0,0,0,0,0,0,1,0,1,2,0
401379440,Prairie View A&M Lady Panthers,K. Clark,4400518,,False,22.0,4,9,4,7,0,2,3,3,1,5,6,2,0,1,4,4,11
401379440,Prairie View A&M Lady Panthers,TEAM,TOTAL,TOTAL,False,,23,70,22,53,1,17,14,20,21,41,62,10,8,5,21,17,61
401379425,Mississippi Valley State Devilettes,S. Moore,4282565,,True,19.0,3,8,3,8,0,0,1,2,2,2,4,0,0,0,1,3,7
401379425,Mississippi Valley State Devilettes,M. Etienne,4899748,,True,33.0,6,24,5,14,1,10,1,2,2,2,4,3,2,0,1,1,14
401379425,Mississippi Valley State Devilettes,D. McGloster,4705901,,True,36.0,2,10,1,8,1,2,0,0,5,0,5,0,1,0,3,2,5
401379425,Mississippi Valley State Devilettes,Z. Mahoney,4705898,,True,33.0,5,15,5,13,0,2,8,13,5,3,8,0,0,0,4,3,18
401379425,Mississippi Valley State Devilettes,R. Williams,4400564,,True,26.0,1,5,1,5,0,0,3,5,0,9,9,2,2,1,0,4,5
401379425,Mississippi Valley State Devilettes,M. Gibson,4594863,,False,23.0,1,5,1,4,0,1,0,1,2,3,5,0,0,0,5,4,2
401379425,Mississippi Valley State Devilettes,K. Wilson,4899752,,False,9.0,0,1,0,0,0,1,0,0,0,0,0,0,0,0,0,3,0
401379425,Mississippi Valley State Devilettes,K. Hunt,4705106,,False,21.0,2,5,0,1,2,4,0,0,0,1,1,0,0,1,0,3,6
401379425,Mississippi Valley State Devilettes,TEAM,TOTAL,TOTAL,False,,20,73,16,53,4,20,13,23,16,21,37,5,5,2,19,23,57
401379425,Jackson State Lady Tigers,L. Sims,4704560,,True,22.0,3,5,3,5,0,0,4,6,3,3,6,0,0,0,2,1,10
401379425,Jackson State Lady Tigers,A. Williams-Holliday,4065745,,True,23.0,7,14,7,14,0,0,6,8,5,5,10,1,0,2,0,0,20
401379425,Jackson State Lady Tigers,M. Crump,4900475,,True,23.0,1,9,1,7,0,2,4,4,2,4,6,2,1,0,1,1,6
401379425,Jackson State Lady Tigers,D. Rogan,4595999,,True,23.0,8,13,4,4,4,9,0,0,2,3,5,2,0,0,0,3,20
401379425,Jackson State Lady Tigers,K. Luckett,4595995,,True,19.0,1,5,1,3,0,2,2,2,1,3,4,2,1,0,1,0,4
401379425,Jackson State Lady Tigers,K. Ransom,4900480,,False,7.0,1,1,1,1,0,0,3,3,0,2,2,0,0,0,1,1,5
401379425,Jackson State Lady Tigers,J. Hickmon,4900478,,False,15.0,1,2,1,2,0,0,1,4,2,3,5,1,1,1,1,2,3
401379425,Jackson State Lady Tigers,D. Woodard,4900474,,False,13.0,4,5,4,5,0,0,2,2,2,5,7,0,0,0,1,2,10
401379425,Jackson State Lady Tigers,A. Roberts,4900479,,False,7.0,2,2,2,2,0,0,0,1,0,0,0,0,0,0,2,0,4
401379425,Jackson State Lady Tigers,A. Hunter,4900477,,False,17.0,1,3,1,2,0,1,2,2,2,5,7,2,1,0,3,4,4
401379425,Jackson State Lady Tigers,A. Mosley,4900476,,False,5.0,3,3,1,1,2,2,0,0,0,1,1,1,1,0,0,0,8
401379425,Jackson State Lady Tigers,J. Covington,4704112,,False,14.0,3,9,3,8,0,1,3,4,0,2,2,4,2,0,0,1,9
401379425,Jackson State Lady Tigers,T. Boler,4704111,,False,12.0,7,9,6,8,1,1,0,0,1,1,2,1,1,0,0,1,15
401379425,Jackson State Lady Tigers,TEAM,TOTAL,TOTAL,False,,42,80,35,62,7,18,27,36,23,41,64,16,8,3,13,16,118
401379410,Grambling Lady Tigers,J. Forte,4400552,,True,17.0,2,3,2,3,0,0,0,1,1,6,7,0,0,4,1,5,4
401379410,Grambling Lady Tigers,A. Holt,4596275,,True,40.0,9,23,9,19,0,4,3,8,1,8,9,1,1,0,3,0,21
401379410,Grambling Lady Tigers,J. Coleman,4282676,,True,33.0,6,16,6,10,0,6,2,2,2,4,6,3,3,0,1,1,14
401379410,Grambling Lady Tigers,A. Williams,4282675,,True,30.0,6,9,4,5,2,4,4,5,0,4,4,1,2,3,1,2,18
401379410,Grambling Lady Tigers,L. Morrow,4282016,,True,28.0,1,4,1,4,0,0,1,2,3,4,7,2,3,0,1,4,3
401379410,Grambling Lady Tigers,D. Johnson,4704667,,False,1.0,0,0,0,0,0,0,0,0,0,0,0,0,0,0,0,1,0
401379410,Grambling Lady Tigers,T. Totten,4287046,,False,13.0,1,3,1,1,0,2,2,2,1,2,3,0,0,0,0,3,4
401379410,Grambling Lady Tigers,D. Alexander,4399518,,False,15.0,0,2,0,2,0,0,0,0,1,1,2,1,0,1,1,2,0
401379410,Grambling Lady Tigers,C. Maples,4900469,,False,3.0,0,3,0,3,0,0,0,0,0,0,0,0,0,0,1,1,0
401379410,Grambling Lady Tigers,P. Allen,4900468,,False,11.0,0,2,0,2,0,0,0,0,1,1,2,1,0,0,1,0,0
401379410,Grambling Lady Tigers,M. Tell,4900467,,False,1.0,0,0,0,0,0,0,0,0,0,0,0,0,0,0,0,0,0
401379410,Grambling Lady Tigers,K. Chairs,4704665,,False,8.0,0,0,0,0,0,0,0,0,0,0,0,1,0,0,1,0,0
401379410,Grambling Lady Tigers,TEAM,TOTAL,TOTAL,False,,25,65,23,49,2,16,12,20,12,30,42,10,9,8,12,19,64
401379410,Alabama State Lady Hornets,S. Ward,4400468,,True,31.0,5,11,5,11,0,0,7,13,2,5,7,0,1,0,1,1,17
401379410,Alabama State Lady Hornets,J. Nneji,4282073,,True,16.0,2,8,2,7,0,1,1,2,4,1,5,1,0,4,0,3,5
401379410,Alabama State Lady Hornets,D. Sanders,4704005,,True,31.0,0,1,0,1,0,0,0,0,1,3,4,5,1,0,5,3,0
401379410,Alabama State Lady Hornets,J. Crawford,4400465,,True,37.0,8,15,4,7,4,8,5,6,0,5,5,1,0,0,4,1,25
401379410,Alabama State Lady Hornets,A. Emmanuel,4400462,,True,32.0,1,11,1,7,0,4,2,2,3,8,11,2,0,0,3,3,4
401379410,Alabama State Lady Hornets,T. Stallings,4594404,,False,13.0,1,5,1,5,0,0,0,0,0,2,2,0,0,0,2,2,2
401379410,Alabama State Lady Hornets,T. Thomas,4704008,,False,5.0,1,2,1,2,0,0,0,0,0,2,2,0,0,1,2,3,2
401379410,Alabama State Lady Hornets,B. Watkins,4900452,,False,2.0,0,0,0,0,0,0,0,0,0,0,0,0,0,0,0,0,0
401379410,Alabama State Lady Hornets,H. White,4596194,,False,18.0,0,1,0,1,0,0,1,2,0,1,1,1,1,0,0,5,1
401379410,Alabama State Lady Hornets,K. Jackson,4595512,,False,15.0,0,1,0,1,0,0,0,0,1,3,4,1,0,0,1,0,0
401379410,Alabama State Lady Hornets,TEAM,TOTAL,TOTAL,False,,18,55,14,42,4,13,16,25,13,33,46,11,3,5,21,21,56
401379381,Florida A&M Rattlers,A. Roberts,4900617,,True,23.0,3,6,2,3,1,3,1,1,1,2,3,2,0,0,2,0,8
401379381,Florida A&M Rattlers,A. Douglas,4705312,,True,23.0,1,8,1,8,0,0,1,2,5,3,8,1,1,1,3,3,3
401379381,Florida A&M Rattlers,M. Brooks,4705310,,True,39.0,4,11,3,6,1,5,0,0,0,4,4,0,0,0,1,2,9
401379381,Florida A&M Rattlers,M. Bell,4595772,,True,27.0,0,4,0,4,0,0,1,4,2,1,3,1,0,0,2,3,1
401379381,Florida A&M Rattlers,A. Harris,4399734,,True,34.0,4,18,2,11,2,7,2,2,1,3,4,1,0,0,7,3,12
401379381,Florida A&M Rattlers,S. Allen,4595510,,False,20.0,1,4,1,4,0,0,0,0,3,2,5,2,0,0,1,3,2
401379381,Florida A&M Rattlers,J. Blair,4900615,,False,34.0,2,11,2,7,0,4,1,2,1,4,5,5,2,1,2,2,5
401379381,Florida A&M Rattlers,TEAM,TOTAL,TOTAL,False,,15,62,11,43,4,19,6,11,17,20,37,12,3,2,19,16,40
401379381,Bethune-Cookman Wildcats,K. White,4900462,,True,26.0,1,3,1,2,0,1,0,0,0,3,3,5,3,0,2,1,2
401379381,Bethune-Cookman Wildcats,I. Reid,4595491,,True,18.0,3,6,3,5,0,1,2,3,4,3,7,1,0,0,0,3,8
401379381,Bethune-Cookman Wildcats,K. Clark,4900466,,True,23.0,4,9,4,9,0,0,2,3,3,7,10,2,1,0,2,4,10
401379381,Bethune-Cookman Wildcats,T. Hayes,4595490,,True,32.0,1,7,0,2,1,5,0,0,1,2,3,6,2,0,2,2,3
401379381,Bethune-Cookman Wildcats,M. Beacham,4595489,,True,38.0,11,16,8,10,3,6,1,4,2,2,4,3,3,0,3,0,26
401379381,Bethune-Cookman Wildcats,T. Dossous,4914242,,False,14.0,2,5,2,5,0,0,1,3,3,3,6,1,0,0,2,2,5
401379381,Bethune-Cookman Wildcats,T. Williams,4900463,,False,18.0,4,8,4,8,0,0,3,3,0,4,4,0,0,0,1,1,11
401379381,Bethune-Cookman Wildcats,C. Harris,4400309,,False,31.0,6,14,3,7,3,7,2,3,0,3,3,2,1,0,2,2,17
401379381,Bethune-Cookman Wildcats,TEAM,TOTAL,TOTAL,False,,32,68,25,48,7,20,11,19,18,31,49,20,10,0,14,15,82
401379359,Loyola Maryland Greyhounds,L. Therien,4900552,,True,22.0,5,5,5,5,0,0,2,5,0,6,6,1,3,1,3,2,12
401379359,Loyola Maryland Greyhounds,B. Rozzi,4596306,,True,30.0,5,10,4,6,1,4,1,1,1,2,3,3,1,0,3,2,12
401379359,Loyola Maryland Greyhounds,T. Dixon,4400209,,True,24.0,2,10,2,8,0,2,0,0,0,1,1,4,1,1,1,0,4
401379359,Loyola Maryland Greyhounds,L. Edwards,4400208,,True,29.0,2,4,2,4,0,0,0,0,1,3,4,3,1,1,1,1,4
401379359,Loyola Maryland Greyhounds,D. Newman,4399474,,True,28.0,3,9,2,7,1,2,0,0,0,1,1,1,3,1,2,1,7
401379359,Loyola Maryland Greyhounds,C. Roberts,4704777,,False,12.0,1,3,1,3,0,0,0,0,1,1,2,0,0,0,2,1,2
401379359,Loyola Maryland Greyhounds,E. McAteer,4596305,,False,22.0,4,9,4,8,0,1,1,2,2,2,4,0,2,1,1,3,9
401379359,Loyola Maryland Greyhounds,E. Glezen,4596304,,False,6.0,0,0,0,0,0,0,0,0,0,0,0,0,0,0,0,0,0
401379359,Loyola Maryland Greyhounds,A. Therien,4596307,,False,3.0,1,1,1,1,0,0,0,0,0,0,0,2,0,0,1,0,2
401379359,Loyola Maryland Greyhounds,K. Douglas,4900551,,False,18.0,1,2,0,0,1,2,0,0,1,1,2,1,0,0,1,1,3
401379359,Loyola Maryland Greyhounds,B. Steidle,4704776,,False,6.0,0,0,0,0,0,0,0,0,0,0,0,0,0,0,1,0,0
401379359,Loyola Maryland Greyhounds,TEAM,TOTAL,TOTAL,False,,24,53,21,42,3,11,4,8,7,20,27,15,11,5,16,11,55
401379359,Army Black Knights,S. Hunter,4595466,,True,24.0,4,6,4,6,0,0,6,8,3,7,10,1,2,1,1,0,14
401379359,Army Black Knights,K. Hall,4595465,,True,25.0,5,9,4,6,1,3,0,0,1,1,2,3,0,0,1,2,11
401379359,Army Black Knights,S. McNaughton,4704694,,True,24.0,1,7,1,4,0,3,0,0,1,0,1,3,1,0,3,1,2
401379359,Army Black Knights,H. Brown,4595467,,True,17.0,1,2,0,1,1,1,0,0,0,3,3,2,1,1,1,2,3
401379359,Army Black Knights,A. Fallon,4400167,,True,22.0,1,9,1,7,0,2,2,2,0,4,4,3,1,0,1,0,4
401379359,Army Black Knights,M. Muse,4704697,,False,4.0,0,1,0,1,0,0,0,0,0,0,0,0,0,0,0,0,0
401379359,Army Black Knights,R. Warren,4704695,,False,5.0,0,1,0,1,0,0,0,0,0,0,0,0,0,0,0,0,0
401379359,Army Black Knights,T. Sullivan,4400165,,False,3.0,0,1,0,1,0,0,0,0,0,0,0,0,0,0,1,1,0
401379359,Army Black Knights,K. Murray,4400163,,False,15.0,1,1,0,0,1,1,0,0,1,2,3,0,1,0,2,2,3
401379359,Army Black Knights,L. Scamman,4400162,,False,17.0,4,5,2,3,2,2,0,0,3,6,9,0,2,1,1,1,10
401379359,Army Black Knights,A. Bigelow,4899715,,False,3.0,0,0,0,0,0,0,0,0,0,0,0,0,0,0,1,1,0
401379359,Army Black Knights,V. Kearney,4899713,,False,5.0,0,0,0,0,0,0,0,0,0,0,0,0,0,0,1,1,0
401379359,Army Black Knights,L. Lithgow,4704696,,False,15.0,1,3,1,1,0,2,0,0,3,0,3,1,1,0,2,2,2
401379359,Army Black Knights,M. George,4704693,,False,2.0,0,0,0,0,0,0,0,0,0,0,0,0,0,0,1,0,0
401379359,Army Black Knights,J. Strippoli,4595470,,False,3.0,0,1,0,1,0,0,0,0,0,0,0,0,0,0,0,0,0
401379359,Army Black Knights,N. Rhine,4595464,,False,12.0,4,8,1,2,3,6,0,0,0,0,0,0,0,0,1,0,11
401379359,Army Black Knights,N. Stralkus,4400166,,False,4.0,1,2,0,0,1,2,0,0,0,2,2,0,0,0,2,1,3
401379359,Army Black Knights,TEAM,TOTAL,TOTAL,False,,23,56,14,34,9,22,8,10,14,25,39,13,9,3,19,14,63
401379338,Navy Midshipmen,C. Hertelendy,4400214,,True,15.0,2,2,2,2,0,0,0,0,1,1,2,0,0,0,0,1,4
401379338,Navy Midshipmen,L. Llewellyn,4595625,,True,14.0,1,7,1,4,0,3,0,0,0,0,0,0,0,0,1,0,2
401379338,Navy Midshipmen,S. Watts,4704782,,True,25.0,6,16,5,13,1,3,3,4,4,3,7,0,0,1,2,4,16
401379338,Navy Midshipmen,K. Donza,4704781,,True,31.0,0,7,0,2,0,5,0,0,1,2,3,0,0,0,0,1,0
401379338,Navy Midshipmen,J. Coleman,4400211,,True,40.0,3,23,3,19,0,4,5,6,2,12,14,8,2,0,4,1,11
401379338,Navy Midshipmen,S. Lewis,4900553,,False,7.0,0,3,0,2,0,1,0,0,0,0,0,0,1,1,0,1,0
401379338,Navy Midshipmen,M. Andrews,4704780,,False,18.0,2,7,2,7,0,0,0,1,4,4,8,2,0,0,4,2,4
401379338,Navy Midshipmen,S. Schofield,4704779,,False,18.0,1,4,0,1,1,3,0,0,0,1,1,0,0,0,0,0,3
401379338,Navy Midshipmen,M. Schrader,4595622,,False,17.0,0,0,0,0,0,0,0,0,2,1,3,0,0,0,3,2,0
401379338,Navy Midshipmen,D. Langford,4400212,,False,15.0,1,2,1,2,0,0,0,0,0,3,3,0,1,0,0,1,2
401379338,Navy Midshipmen,TEAM,TOTAL,TOTAL,False,,16,71,14,52,2,19,8,11,16,29,45,10,4,2,14,13,42
401379338,Lehigh Mountain Hawks,M. O'Brien,4900547,,True,19.0,1,4,1,3,0,1,0,0,3,7,10,1,0,0,0,0,2
401379338,Lehigh Mountain Hawks,F. Hottinger,4595613,,True,25.0,5,12,3,8,2,4,1,2,4,7,11,0,0,0,1,1,13
401379338,Lehigh Mountain Hawks,E. Grothaus,4400201,,True,26.0,4,11,4,9,0,2,1,1,0,3,3,2,0,2,1,2,9
401379338,Lehigh Mountain Hawks,M. Kramer,4704762,,True,28.0,5,12,3,5,2,7,0,0,0,2,2,1,1,0,3,1,12
401379338,Lehigh Mountain Hawks,C. Steele,4400198,,True,22.0,2,2,1,1,1,1,0,0,0,2,2,9,1,0,1,1,5
401379338,Lehigh Mountain Hawks,J. Vargas-Bines,4900546,,False,4.0,0,1,0,1,0,0,0,0,0,1,1,0,0,0,0,1,0
401379338,Lehigh Mountain Hawks,M. Brown,4433751,,False,4.0,2,3,2,3,0,0,0,0,0,0,0,0,0,0,0,0,4
401379338,Lehigh Mountain Hawks,K. Van Eps,4900545,,False,15.0,4,8,2,2,2,6,5,6,0,5,5,1,0,1,1,2,15
401379338,Lehigh Mountain Hawks,E. Stemmer,4900544,,False,13.0,0,4,0,0,0,4,0,0,1,1,2,0,3,0,0,1,0
401379338,Lehigh Mountain Hawks,M. Albrecht,4704763,,False,12.0,0,0,0,0,0,0,0,0,1,1,2,1,0,2,2,1,0
401379338,Lehigh Mountain Hawks,F. Eggenschwiler,4704761,,False,6.0,0,1,0,0,0,1,0,0,1,0,1,0,0,1,2,0,0
401379338,Lehigh Mountain Hawks,A. Harvey,4595612,,False,17.0,1,4,1,3,0,1,2,2,0,3,3,2,1,0,2,1,4
401379338,Lehigh Mountain Hawks,J. Behar,4433782,,False,9.0,0,2,0,0,0,2,0,0,0,2,2,0,0,0,3,2,0
401379338,Lehigh Mountain Hawks,TEAM,TOTAL,TOTAL,False,,24,64,17,35,7,29,9,11,12,40,52,17,6,6,16,13,64
401379325,Jackson State Lady Tigers,L. Sims,4704560,,True,18.0,1,4,1,4,0,0,0,0,4,4,8,0,0,0,2,2,2
401379325,Jackson State Lady Tigers,A. Williams-Holliday,4065745,,True,25.0,6,12,6,12,0,0,6,8,4,2,6,0,1,4,2,2,18
401379325,Jackson State Lady Tigers,M. Crump,4900475,,True,34.0,6,12,5,10,1,2,1,2,2,8,10,3,1,0,1,2,14
401379325,Jackson State Lady Tigers,D. Rogan,4595999,,True,27.0,2,10,1,6,1,4,2,4,2,4,6,1,2,0,2,2,7
401379325,Jackson State Lady Tigers,K. Luckett,4595995,,True,31.0,2,8,1,5,1,3,3,6,1,5,6,4,4,0,1,2,8
401379325,Jackson State Lady Tigers,J. Hickmon,4900478,,False,2.0,0,0,0,0,0,0,0,0,0,0,0,0,0,0,0,0,0
401379325,Jackson State Lady Tigers,D. Woodard,4900474,,False,28.0,5,11,5,11,0,0,2,2,6,6,12,0,0,3,1,0,12
401379325,Jackson State Lady Tigers,A. Hunter,4900477,,False,0.0,0,0,0,0,0,0,0,0,0,1,1,0,0,0,0,0,0
401379325,Jackson State Lady Tigers,J. Covington,4704112,,False,16.0,1,8,1,7,0,1,2,4,1,1,2,2,0,0,2,3,4
401379325,Jackson State Lady Tigers,T. Boler,4704111,,False,19.0,2,6,1,4,1,2,2,4,3,0,3,1,0,0,0,0,7
401379325,Jackson State Lady Tigers,TEAM,TOTAL,TOTAL,False,,25,71,21,59,4,12,18,30,26,35,61,11,8,7,11,13,72
401379325,Arkansas-Pine Bluff Golden Lions,S. Rachel,4594402,,True,25.0,1,7,1,6,0,1,0,0,5,5,10,1,2,2,2,4,2
401379325,Arkansas-Pine Bluff Golden Lions,M. Peat,4704064,,True,17.0,2,4,2,3,0,1,0,0,0,1,1,0,0,0,2,4,4
401379325,Arkansas-Pine Bluff Golden Lions,T. Juhan,4710602,,True,6.0,2,6,2,4,0,2,0,0,0,1,1,0,0,1,1,4,4
401379325,Arkansas-Pine Bluff Golden Lions,Z. Green,4398766,,True,38.0,6,22,5,16,1,6,1,3,1,7,8,3,1,1,4,2,14
401379325,Arkansas-Pine Bluff Golden Lions,J. Kennerson,3946659,,True,14.0,1,3,1,2,0,1,0,1,0,2,2,1,0,0,1,2,2
401379325,Arkansas-Pine Bluff Golden Lions,K. Ingram,4594403,,False,7.0,0,0,0,0,0,0,0,0,0,0,0,0,0,0,0,1,0
401379325,Arkansas-Pine Bluff Golden Lions,K. Walker,4704060,,False,32.0,10,17,3,4,7,13,0,0,1,2,3,2,0,0,0,2,27
401379325,Arkansas-Pine Bluff Golden Lions,T. Busby,4704059,,False,26.0,1,3,0,0,1,3,0,0,0,5,5,1,0,0,0,3,3
401379325,Arkansas-Pine Bluff Golden Lions,S. Hudson,4400435,,False,35.0,2,12,2,8,0,4,5,6,2,2,4,3,1,0,3,3,9
401379325,Arkansas-Pine Bluff Golden Lions,TEAM,TOTAL,TOTAL,False,,25,74,16,43,9,31,6,10,16,25,41,11,4,4,13,25,65
401379301,Arkansas-Pine Bluff Golden Lions,M. Peat,4704064,,True,23.0,3,5,3,5,0,0,6,6,2,5,7,0,2,0,3,1,12
401379301,Arkansas-Pine Bluff Golden Lions,T. Juhan,4710602,,True,31.0,5,13,4,8,1,5,2,3,0,6,6,2,0,0,3,2,13
401379301,Arkansas-Pine Bluff Golden Lions,T. Busby,4704059,,True,34.0,0,4,0,2,0,2,0,0,2,3,5,4,1,1,1,2,0
401379301,Arkansas-Pine Bluff Golden Lions,Z. Green,4398766,,True,17.0,0,5,0,5,0,0,0,0,0,1,1,2,0,0,2,1,0
401379301,Arkansas-Pine Bluff Golden Lions,J. Kennerson,3946659,,True,37.0,3,9,1,3,2,6,2,2,1,5,6,3,3,0,2,2,10
401379301,Arkansas-Pine Bluff Golden Lions,K. Ingram,4594403,,False,11.0,0,0,0,0,0,0,4,6,0,2,2,0,0,0,0,0,4
401379301,Arkansas-Pine Bluff Golden Lions,S. Rachel,4594402,,False,13.0,6,8,5,7,1,1,2,2,2,1,3,0,1,0,0,4,15
401379301,Arkansas-Pine Bluff Golden Lions,K. Rittenberry,4902602,,False,2.0,0,0,0,0,0,0,0,0,0,0,0,0,0,0,0,0,0
401379301,Arkansas-Pine Bluff Golden Lions,M. Cotten,4900460,,False,1.0,0,0,0,0,0,0,0,0,0,0,0,0,0,0,0,0,0
401379301,Arkansas-Pine Bluff Golden Lions,K. Walker,4704060,,False,24.0,2,6,1,3,1,3,5,6,1,0,1,0,0,0,1,3,10
401379301,Arkansas-Pine Bluff Golden Lions,T. Pyburn,4596269,,False,0.0,0,1,0,0,0,1,0,0,0,0,0,0,0,0,0,0,0
401379301,Arkansas-Pine Bluff Golden Lions,S. Hudson,4400435,,False,7.0,0,1,0,1,0,0,0,0,1,1,2,2,0,0,0,0,0
401379301,Arkansas-Pine Bluff Golden Lions,TEAM,TOTAL,TOTAL,False,,19,52,14,34,5,18,21,25,12,27,39,13,7,1,12,15,64
401379301,Alcorn State Lady Braves,T. Wright,4596203,,True,28.0,3,8,1,2,2,6,0,0,1,8,9,1,0,0,2,0,8
401379301,Alcorn State Lady Braves,B. Broughton,4400521,,True,15.0,1,3,1,3,0,0,0,0,2,1,3,0,0,0,3,3,2
401379301,Alcorn State Lady Braves,M. Claytor,4900458,,True,11.0,1,4,0,1,1,3,0,0,0,1,1,0,0,0,0,1,3
401379301,Alcorn State Lady Braves,K. Watkins,4704640,,True,25.0,2,6,1,3,1,3,3,6,0,0,0,3,1,0,2,2,8
401379301,Alcorn State Lady Braves,L. Rascoe,4596198,,True,22.0,0,2,0,1,0,1,2,2,1,1,2,1,0,0,3,2,2
401379301,Alcorn State Lady Braves,A. Ford,4900456,,False,22.0,3,5,3,5,0,0,1,2,0,4,4,0,0,0,1,4,7
401379301,Alcorn State Lady Braves,T. Griffin,4900453,,False,15.0,0,3,0,0,0,3,0,0,0,0,0,0,0,0,2,1,0
401379301,Alcorn State Lady Braves,Z. White,4900455,,False,16.0,1,5,1,5,0,0,2,2,0,1,1,1,1,0,2,2,4
401379301,Alcorn State Lady Braves,C. Obillo,4596200,,False,25.0,3,9,3,6,0,3,0,0,1,3,4,2,0,1,4,2,6
401379301,Alcorn State Lady Braves,N. McCalphia,4596199,,False,21.0,0,4,0,3,0,1,1,2,1,1,2,3,1,0,1,2,1
401379301,Alcorn State Lady Braves,TEAM,TOTAL,TOTAL,False,,14,49,10,29,4,20,9,14,11,22,33,11,3,1,20,19,41
401379300,Mississippi Valley State Devilettes,S. Moore,4282565,,True,29.0,5,11,5,11,0,0,0,0,4,5,9,0,1,0,1,1,10
401379300,Mississippi Valley State Devilettes,M. Etienne,4899748,,True,26.0,5,15,2,8,3,7,1,2,0,2,2,1,1,0,2,3,14
401379300,Mississippi Valley State Devilettes,D. McGloster,4705901,,True,29.0,4,8,3,7,1,1,0,0,3,4,7,1,2,3,1,2,9
401379300,Mississippi Valley State Devilettes,Z. Mahoney,4705898,,True,28.0,4,10,3,9,1,1,3,4,4,2,6,1,2,0,2,3,12
401379300,Mississippi Valley State Devilettes,R. Williams,4400564,,True,36.0,2,5,2,4,0,1,2,2,0,4,4,9,1,0,5,2,6
401379300,Mississippi Valley State Devilettes,M. Gibson,4594863,,False,24.0,2,9,2,5,0,4,4,4,1,3,4,0,3,0,5,2,8
401379300,Mississippi Valley State Devilettes,K. Wilson,4899752,,False,7.0,0,0,0,0,0,0,0,0,1,1,2,0,0,0,0,0,0
401379300,Mississippi Valley State Devilettes,K. Hunt,4705106,,False,21.0,1,7,0,1,1,6,0,0,1,3,4,1,1,1,4,4,3
401379300,Mississippi Valley State Devilettes,TEAM,TOTAL,TOTAL,False,,23,65,17,45,6,20,10,12,17,29,46,13,11,4,21,17,62
401379300,Alcorn State Lady Braves,T. Wright,4596203,,True,23.0,0,3,0,1,0,2,0,0,0,4,4,0,0,1,3,1,0
401379300,Alcorn State Lady Braves,B. Broughton,4400521,,True,11.0,0,1,0,1,0,0,0,0,0,1,1,1,0,0,1,0,0
401379300,Alcorn State Lady Braves,M. Claytor,4900458,,True,18.0,1,3,0,0,1,3,0,0,1,2,3,0,0,0,1,0,3
401379300,Alcorn State Lady Braves,K. Watkins,4704640,,True,22.0,1,10,1,6,0,4,0,2,2,1,3,1,3,0,3,0,2
401379300,Alcorn State Lady Braves,L. Rascoe,4596198,,True,29.0,3,7,3,5,0,2,9,10,0,4,4,1,2,0,2,3,15
401379300,Alcorn State Lady Braves,A. Ford,4900456,,False,21.0,0,2,0,2,0,0,0,0,1,2,3,0,1,2,2,2,0
401379300,Alcorn State Lady Braves,A. Stewart,4900454,,False,2.0,0,0,0,0,0,0,0,0,0,0,0,0,0,0,0,0,0
401379300,Alcorn State Lady Braves,T. Griffin,4900453,,False,22.0,6,11,4,5,2,6,0,0,2,6,8,1,1,0,1,0,14
401379300,Alcorn State Lady Braves,Z. White,4900455,,False,6.0,0,3,0,2,0,1,0,0,0,0,0,0,0,0,2,2,0
401379300,Alcorn State Lady Braves,C. Obillo,4596200,,False,26.0,4,8,3,5,1,3,2,5,3,1,4,6,1,0,6,1,11
401379300,Alcorn State Lady Braves,N. McCalphia,4596199,,False,20.0,0,3,0,2,0,1,2,2,0,1,1,0,2,0,3,1,2
401379300,Alcorn State Lady Braves,TEAM,TOTAL,TOTAL,False,,15,51,11,29,4,22,13,19,10,27,37,10,10,3,25,10,47
401379279,Southern Jaguars,R. White,4595966,,True,13.0,0,1,0,1,0,0,0,0,0,2,2,3,0,0,2,4,0
401379279,Southern Jaguars,T. Metcalf,4704148,,True,27.0,1,6,1,6,0,0,0,0,0,0,0,5,0,0,4,5,2
401379279,Southern Jaguars,G. Johnson,4595965,,True,36.0,8,15,8,14,0,1,3,8,0,5,5,3,3,0,2,5,19
401379279,Southern Jaguars,N. Kincey,4595962,,True,32.0,2,3,0,1,2,2,2,2,0,1,1,0,1,0,3,1,8
401379279,Southern Jaguars,A. Mcwain,4400584,,True,40.0,9,15,5,9,4,6,1,2,1,5,6,0,3,0,2,1,23
401379279,Southern Jaguars,T. Moore,4400585,,False,41.0,2,5,2,5,0,0,0,0,2,3,5,1,3,1,1,1,4
401379279,Southern Jaguars,T. Lidge,4900563,,False,3.0,1,1,1,1,0,0,0,0,0,0,0,0,0,0,0,1,2
401379279,Southern Jaguars,A. Fontenot,4900560,,False,7.0,0,3,0,1,0,2,0,0,2,0,2,0,1,0,1,0,0
401379279,Southern Jaguars,D. Hunter,4705035,,False,7.0,1,3,1,1,0,2,0,0,0,1,1,0,1,0,0,0,2
401379279,Southern Jaguars,C. Fleming,4595963,,False,18.0,1,5,1,4,0,1,1,2,0,1,1,1,0,0,3,3,3
401379279,Southern Jaguars,K. Watson,4595961,,False,26.0,1,3,1,3,0,0,2,2,1,2,3,0,1,0,1,5,4
401379279,Southern Jaguars,TEAM,TOTAL,TOTAL,False,,26,60,20,46,6,14,9,16,9,24,33,13,13,1,19,26,67
401379279,Alabama A&M Bulldogs,J. Clowers,4704645,,True,36.0,3,5,3,5,0,0,2,4,6,11,17,3,0,0,4,1,8
401379279,Alabama A&M Bulldogs,D. Lewis,4399418,,True,36.0,7,11,7,11,0,0,5,8,3,8,11,1,2,2,5,3,19
401379279,Alabama A&M Bulldogs,D. Burgin,4703971,,True,36.0,2,5,2,5,0,0,0,0,1,4,5,1,1,0,1,3,4
401379279,Alabama A&M Bulldogs,J. Harris,4595412,,True,46.0,1,4,0,0,1,4,2,2,0,0,0,1,1,0,6,1,5
401379279,Alabama A&M Bulldogs,N. Jones,4282633,,True,50.0,8,22,6,16,2,6,10,12,0,2,2,4,5,0,3,3,28
401379279,Alabama A&M Bulldogs,K. Warner,4712239,,False,1.0,0,0,0,0,0,0,0,0,0,0,0,0,0,0,0,0,0
401379279,Alabama A&M Bulldogs,K. Johnson-Graham,4068445,,False,28.0,2,4,2,4,0,0,2,4,0,1,1,2,0,0,1,2,6
401379279,Alabama A&M Bulldogs,J. Alexander,4900445,,False,17.0,1,2,1,2,0,0,1,2,1,0,1,0,0,0,1,0,3
401379279,Alabama A&M Bulldogs,TEAM,TOTAL,TOTAL,False,,24,53,21,43,3,10,22,32,11,29,40,12,9,2,21,13,73
401379278,Grambling Lady Tigers,J. Forte,4400552,,True,20.0,0,4,0,4,0,0,1,2,3,5,8,0,1,2,0,3,1
401379278,Grambling Lady Tigers,A. Holt,4596275,,True,40.0,4,17,3,11,1,6,3,4,1,6,7,3,3,0,1,1,12
401379278,Grambling Lady Tigers,J. Coleman,4282676,,True,38.0,4,14,4,11,0,3,0,0,1,7,8,1,2,0,1,2,8
401379278,Grambling Lady Tigers,A. Williams,4282675,,True,35.0,8,10,6,8,2,2,2,5,1,2,3,2,1,1,5,2,20
401379278,Grambling Lady Tigers,L. Morrow,4282016,,True,23.0,2,6,2,4,0,2,3,5,0,0,0,1,0,0,2,3,7
401379278,Grambling Lady Tigers,T. Totten,4287046,,False,12.0,1,5,1,5,0,0,1,1,1,1,2,0,0,0,0,3,3
401379278,Grambling Lady Tigers,D. Alexander,4399518,,False,9.0,0,0,0,0,0,0,0,0,1,1,2,0,2,1,2,2,0
401379278,Grambling Lady Tigers,J. McLaurin,4900471,,False,0.0,0,1,0,1,0,0,0,0,0,0,0,0,0,0,0,0,0
401379278,Grambling Lady Tigers,C. Maples,4900469,,False,1.0,0,1,0,1,0,0,0,0,0,2,2,0,0,0,1,0,0
401379278,Grambling Lady Tigers,P. Allen,4900468,,False,7.0,0,0,0,0,0,0,0,1,0,1,1,2,0,0,1,2,0
401379278,Grambling Lady Tigers,K. Chairs,4704665,,False,15.0,0,4,0,1,0,3,0,0,1,1,2,1,1,0,0,0,0
401379278,Grambling Lady Tigers,TEAM,TOTAL,TOTAL,False,,19,62,16,46,3,16,10,18,12,28,40,10,10,4,13,18,51
401379278,Alabama A&M Bulldogs,D. Lewis,4399418,,True,34.0,7,18,7,18,0,0,5,6,4,12,16,3,1,4,3,1,19
401379278,Alabama A&M Bulldogs,K. Johnson-Graham,4068445,,True,19.0,2,4,2,3,0,1,2,2,2,3,5,2,1,1,2,1,6
401379278,Alabama A&M Bulldogs,D. Burgin,4703971,,True,22.0,1,6,1,4,0,2,0,0,1,3,4,2,0,0,4,3,2
401379278,Alabama A&M Bulldogs,J. Harris,4595412,,True,36.0,3,6,1,3,2,3,1,2,0,1,1,1,1,1,1,3,9
401379278,Alabama A&M Bulldogs,N. Jones,4282633,,True,38.0,2,16,1,10,1,6,1,1,0,1,1,1,6,0,4,3,6
401379278,Alabama A&M Bulldogs,J. Clowers,4704645,,False,27.0,3,7,3,7,0,0,0,2,5,7,12,1,1,2,3,2,6
401379278,Alabama A&M Bulldogs,J. Alexander,4900445,,False,24.0,3,5,2,4,1,1,0,0,1,3,4,3,0,0,3,2,7
401379278,Alabama A&M Bulldogs,TEAM,TOTAL,TOTAL,False,,21,62,17,49,4,13,9,13,17,34,51,13,10,8,20,15,55
401379218,Holy Cross Crusaders,J. Allen,4704714,,True,24.0,0,4,0,4,0,0,1,2,1,2,3,0,0,0,2,3,1
401379218,Holy Cross Crusaders,M. Demski,4400187,,True,15.0,0,2,0,1,0,1,0,0,0,1,1,0,0,0,2,0,0
401379218,Holy Cross Crusaders,B. Power-Cassidy,4704715,,True,21.0,5,6,2,3,3,3,0,0,1,1,2,1,2,1,0,4,13
401379218,Holy Cross Crusaders,A. Cross,4595975,,True,36.0,3,4,3,3,0,1,0,0,0,0,0,4,1,1,3,1,6
401379218,Holy Cross Crusaders,A. LaBarbera,4400186,,True,38.0,9,18,7,15,2,3,4,5,0,11,11,4,0,1,6,1,24
401379218,Holy Cross Crusaders,O. Ezemma,4400185,,False,27.0,3,7,3,7,0,0,3,4,2,4,6,1,1,0,0,0,9
401379218,Holy Cross Crusaders,G. Munt,4900537,,False,2.0,0,0,0,0,0,0,0,0,0,0,0,0,0,0,0,0,0
401379218,Holy Cross Crusaders,C. McCormack,4704716,,False,30.0,2,11,0,7,2,4,0,3,0,2,2,2,3,0,1,0,6
401379218,Holy Cross Crusaders,K. Petro,4400188,,False,7.0,0,0,0,0,0,0,0,0,0,1,1,0,0,0,0,1,0
401379218,Holy Cross Crusaders,TEAM,TOTAL,TOTAL,False,,22,52,15,40,7,12,8,14,8,23,31,12,7,3,14,10,59
401379218,Boston University Terriers,C. Weimar,4704495,,True,30.0,3,10,3,10,0,0,1,2,7,5,12,0,0,0,5,1,7
401379218,Boston University Terriers,M. Durant,4599732,,True,28.0,5,8,5,8,0,0,0,0,4,6,10,0,0,2,2,2,10
401379218,Boston University Terriers,A. Giannaros,4899717,,True,36.0,5,13,1,5,4,8,1,2,0,3,3,1,2,0,5,3,15
401379218,Boston University Terriers,S. Johnson,4599729,,True,37.0,6,18,6,12,0,6,1,2,0,1,1,1,3,1,1,2,13
401379218,Boston University Terriers,L. Shean,4599727,,True,21.0,0,4,0,1,0,3,0,0,2,3,5,0,1,1,3,4,0
401379218,Boston University Terriers,R. Childs,4400174,,False,16.0,0,4,0,3,0,1,0,0,0,1,1,0,0,0,1,0,0
401379218,Boston University Terriers,C. Tibbitt,4400172,,False,6.0,0,0,0,0,0,0,0,0,0,0,0,0,0,0,0,0,0
401379218,Boston University Terriers,S. Beneventine,4704699,,False,9.0,0,0,0,0,0,0,0,0,0,0,0,0,0,0,0,1,0
401379218,Boston University Terriers,M. Pina,4599731,,False,17.0,1,1,0,0,1,1,0,0,1,2,3,0,2,0,1,1,3
401379218,Boston University Terriers,TEAM,TOTAL,TOTAL,False,,20,58,15,39,5,19,3,6,15,23,38,2,8,4,18,14,48
401379168,Lafayette Leopards,N. Ganpo,4400195,,True,37.0,3,7,3,7,0,0,4,5,9,11,20,2,0,2,1,2,10
401379168,Lafayette Leopards,A. Antognoli,4900540,,True,34.0,4,11,2,5,2,6,0,0,3,3,6,1,0,0,1,0,10
401379168,Lafayette Leopards,M. Andrews,4704756,,True,24.0,2,4,2,4,0,0,0,0,0,1,1,1,0,0,5,4,4
401379168,Lafayette Leopards,J. Booth,4433381,,True,33.0,5,13,5,12,0,1,0,0,0,2,2,4,1,0,5,1,10
401379168,Lafayette Leopards,M. Wilson,4400197,,True,26.0,4,5,4,5,0,0,0,0,4,2,6,2,1,0,1,2,8
401379168,Lafayette Leopards,K. Drummond,4704754,,False,3.0,0,0,0,0,0,0,0,0,0,0,0,0,0,0,0,0,0
401379168,Lafayette Leopards,C. Gallagher,4900542,,False,23.0,1,6,1,3,0,3,0,0,0,1,1,1,0,0,0,1,2
401379168,Lafayette Leopards,K. Favours,4900541,,False,20.0,2,8,2,2,0,6,0,0,0,0,0,0,0,0,1,1,4
401379168,Lafayette Leopards,TEAM,TOTAL,TOTAL,False,,21,54,19,38,2,16,4,5,16,22,38,11,2,2,17,11,48
401379168,American University Eagles,T. Brown,4400157,,True,21.0,0,3,0,2,0,1,0,2,2,1,3,1,0,0,0,3,0
401379168,American University Eagles,L. Graytok,4400159,,True,12.0,0,1,0,0,0,1,0,0,0,1,1,2,1,0,0,1,0
401379168,American University Eagles,M. Doring,4400158,,True,28.0,3,7,2,3,1,4,0,0,0,1,1,4,1,0,0,1,7
401379168,American University Eagles,J. Edwards,4400156,,True,34.0,4,8,3,6,1,2,4,4,3,7,10,2,2,0,1,1,13
401379168,American University Eagles,E. Fisher,4400155,,True,35.0,6,11,4,7,2,4,0,0,0,2,2,3,1,0,1,1,14
401379168,American University Eagles,E. Johns,4704688,,False,22.0,8,14,8,12,0,2,3,3,2,0,2,0,1,1,2,0,19
401379168,American University Eagles,K. Vres,4595454,,False,10.0,3,4,2,3,1,1,0,0,1,1,2,0,0,0,0,0,7
401379168,American University Eagles,K. Henning,4704686,,False,5.0,0,2,0,2,0,0,0,0,0,0,0,1,1,0,0,0,0
401379168,American University Eagles,I. Bales,4704685,,False,18.0,1,3,1,2,0,1,0,0,0,1,1,3,0,1,0,2,2
401379168,American University Eagles,R. DeRubbo,4703746,,False,15.0,0,2,0,0,0,2,0,0,0,2,2,2,0,0,1,0,0
401379168,American University Eagles,TEAM,TOTAL,TOTAL,False,,25,55,20,37,5,18,7,9,9,17,26,18,7,2,6,9,62
401379039,South Carolina State Lady Bulldogs,B. Thompson,4900034,,True,17.0,1,4,1,4,0,0,0,0,3,2,5,0,0,2,1,1,2
401379039,South Carolina State Lady Bulldogs,N. Gwynn,4900040,,True,29.0,8,18,5,7,3,11,5,5,0,4,4,2,0,0,4,5,24
401379039,South Carolina State Lady Bulldogs,V. Jordan,4900038,,True,19.0,2,4,2,4,0,0,1,2,2,5,7,2,0,0,2,2,5
401379039,South Carolina State Lady Bulldogs,M. Lumpkin,4900035,,True,30.0,3,10,3,6,0,4,2,4,1,1,2,5,2,0,5,4,8
401379039,South Carolina State Lady Bulldogs,J. Hicks,4595567,,True,24.0,1,6,0,2,1,4,1,2,1,0,1,0,0,1,2,3,4
401379039,South Carolina State Lady Bulldogs,T. Klock,4705349,,False,34.0,7,10,7,7,0,3,0,0,1,7,8,3,0,1,1,2,14
401379039,South Carolina State Lady Bulldogs,S. Wright,4705348,,False,8.0,0,0,0,0,0,0,0,0,0,0,0,0,1,0,1,0,0
401379039,South Carolina State Lady Bulldogs,R. Reid,4900036,,False,7.0,2,4,2,4,0,0,0,0,0,1,1,0,1,1,0,1,4
401379039,South Carolina State Lady Bulldogs,L. Sonnier,4900033,,False,7.0,1,4,1,3,0,1,1,4,1,1,2,0,0,0,0,3,3
401379039,South Carolina State Lady Bulldogs,T. Walls,4705967,,False,1.0,0,0,0,0,0,0,0,2,1,0,1,0,0,0,0,0,0
401379039,South Carolina State Lady Bulldogs,N. Reese,4705345,,False,24.0,2,5,0,1,2,4,4,4,3,1,4,3,0,0,3,1,10
401379039,South Carolina State Lady Bulldogs,TEAM,TOTAL,TOTAL,False,,27,65,21,38,6,27,14,23,15,23,38,15,4,5,20,22,74
401379039,North Carolina Central Eagles,T. Carter,4595642,,True,24.0,6,11,6,11,0,0,9,10,4,8,12,2,1,1,2,4,21
401379039,North Carolina Central Eagles,A. Lockard,4400384,,True,33.0,6,12,6,12,0,0,1,2,2,1,3,0,0,0,3,3,13
401379039,North Carolina Central Eagles,D. Thomas,4899971,,True,29.0,6,12,6,9,0,3,3,3,0,1,1,1,3,0,1,1,15
401379039,North Carolina Central Eagles,K. Lowery,4703786,,True,38.0,7,12,7,12,0,0,5,8,2,2,4,12,6,0,1,1,19
401379039,North Carolina Central Eagles,T. Williams,4594708,,True,31.0,0,3,0,2,0,1,1,2,0,3,3,3,2,1,2,5,1
401379039,North Carolina Central Eagles,S. Edmundson,4604717,,False,11.0,1,3,1,3,0,0,0,0,0,2,2,1,0,0,0,2,2
401379039,North Carolina Central Eagles,N. Ford,4899972,,False,25.0,4,9,1,3,3,6,0,0,0,1,1,0,0,0,2,1,11
401379039,North Carolina Central Eagles,M. Anderson,4595556,,False,9.0,0,1,0,0,0,1,2,2,1,3,4,0,0,0,0,0,2
401379039,North Carolina Central Eagles,TEAM,TOTAL,TOTAL,False,,30,63,27,52,3,11,21,27,11,24,35,19,12,2,12,17,84
401379012,Norfolk State Spartans,M. Williams,4595001,,True,30.0,4,10,4,9,0,1,0,0,1,4,5,0,2,2,2,4,8
401379012,Norfolk State Spartans,L. Savage,4282370,,True,10.0,0,0,0,0,0,0,0,0,0,1,1,1,0,0,0,0,0
401379012,Norfolk State Spartans,D. Francis,4399462,,True,37.0,5,10,5,9,0,1,6,6,0,1,1,4,0,0,2,2,16
401379012,Norfolk State Spartans,A. Franklin,4282402,,True,13.0,0,3,0,2,0,1,0,0,0,1,1,1,2,0,0,2,0
401379012,Norfolk State Spartans,C. Downs,4282235,,True,35.0,5,17,1,5,4,12,5,7,2,3,5,2,5,0,6,3,19
401379012,Norfolk State Spartans,M. Diawara,4705343,,False,29.0,5,8,5,8,0,0,0,0,6,2,8,2,0,1,0,3,10
401379012,Norfolk State Spartans,J. Turner,4899969,,False,10.0,1,4,1,2,0,2,0,0,0,1,1,0,1,0,0,0,2
401379012,Norfolk State Spartans,N. Fields,4705341,,False,29.0,2,7,0,2,2,5,1,2,2,2,4,3,2,1,0,1,7
401379012,Norfolk State Spartans,C. White,4705327,,False,7.0,0,2,0,0,0,2,0,0,0,0,0,0,1,0,0,0,0
401379012,Norfolk State Spartans,TEAM,TOTAL,TOTAL,False,,22,61,16,37,6,24,12,15,11,15,26,13,13,4,10,15,62
401379012,Howard Bison,B. Fort-Davis,4705321,,True,36.0,5,8,5,8,0,0,5,6,3,8,11,0,0,0,2,4,15
401379012,Howard Bison,K. Marsh,4400350,,True,19.0,1,2,1,2,0,0,0,0,2,4,6,0,1,1,4,3,2
401379012,Howard Bison,K. Harris,4705322,,True,33.0,0,2,0,2,0,0,0,0,1,3,4,6,0,0,1,0,0
401379012,Howard Bison,D. Howell,4705316,,True,40.0,8,21,2,4,6,17,1,1,1,3,4,1,0,0,7,2,23
401379012,Howard Bison,I. Warren,4595524,,True,28.0,4,10,3,9,1,1,0,0,0,2,2,2,0,0,6,1,9
401379012,Howard Bison,K. Creek,4705320,,False,10.0,0,1,0,0,0,1,0,0,0,0,0,1,0,0,0,0,0
401379012,Howard Bison,A. Hutton,4705315,,False,18.0,1,1,1,1,0,0,3,4,5,3,8,1,1,0,3,2,5
401379012,Howard Bison,V. Udoji,4070243,,False,15.0,2,4,2,2,0,2,0,0,0,3,3,1,0,0,3,3,4
401379012,Howard Bison,N. Cooper,4899955,,False,1.0,0,1,0,0,0,1,0,0,0,0,0,0,0,0,0,0,0
401379012,Howard Bison,TEAM,TOTAL,TOTAL,False,,21,50,14,28,7,22,9,11,12,26,38,12,2,1,26,15,58
401378997,Maryland Eastern Shore Hawks,A. Seawell,4899958,,True,9.0,1,2,1,2,0,0,0,0,2,1,3,2,0,0,0,0,2
401378997,Maryland Eastern Shore Hawks,B. Gill-Miles,4282288,,True,21.0,3,12,3,12,0,0,2,2,4,2,6,0,1,0,1,0,8
401378997,Maryland Eastern Shore Hawks,B. Bailey,4400351,,True,21.0,3,5,2,3,1,2,3,3,0,0,0,4,2,0,1,0,10
401378997,Maryland Eastern Shore Hawks,A. Carney,4282292,,True,21.0,2,9,1,4,1,5,0,0,2,4,6,0,1,0,0,0,5
401378997,Maryland Eastern Shore Hawks,A. Taylor,4282289,,True,13.0,3,5,2,3,1,2,0,0,2,1,3,0,2,0,1,3,7
401378997,Maryland Eastern Shore Hawks,L. Thomas,4899959,,False,18.0,0,1,0,1,0,0,1,4,3,2,5,0,0,0,0,1,1
401378997,Maryland Eastern Shore Hawks,M. Lester,4595527,,False,15.0,5,9,5,9,0,0,1,2,3,4,7,0,2,0,1,3,11
401378997,Maryland Eastern Shore Hawks,A. Pearly,4705352,,False,3.0,0,0,0,0,0,0,2,2,0,0,0,0,0,0,0,1,2
401378997,Maryland Eastern Shore Hawks,J. Grady,4705353,,False,9.0,0,3,0,3,0,0,0,0,0,2,2,0,0,0,0,0,0
401378997,Maryland Eastern Shore Hawks,M. Thomas,4595528,,False,19.0,2,4,1,2,1,2,0,0,1,0,1,1,0,0,1,0,5
401378997,Maryland Eastern Shore Hawks,Z. Haynes,4705351,,False,17.0,2,6,1,4,1,2,0,0,1,2,3,2,0,0,1,2,5
401378997,Maryland Eastern Shore Hawks,C. Wilson,4705350,,False,18.0,1,7,0,5,1,2,0,0,0,0,0,0,0,0,0,1,3
401378997,Maryland Eastern Shore Hawks,J. Blanks,4595529,,False,16.0,3,7,3,6,0,1,1,1,3,4,7,3,3,0,3,2,7
401378997,Maryland Eastern Shore Hawks,TEAM,TOTAL,TOTAL,False,,25,70,19,54,6,16,10,14,23,23,46,12,11,0,9,13,66
401378997,Delaware State Hornets,B. Robinson,4899949,,True,31.0,4,5,4,5,0,0,0,0,1,6,7,0,0,2,0,4,8
401378997,Delaware State Hornets,U. Miller,4899954,,True,23.0,1,3,1,3,0,0,2,4,1,5,6,3,1,0,2,2,4
401378997,Delaware State Hornets,R. Twine,4902392,,True,40.0,1,7,0,1,1,6,0,0,0,1,1,1,0,0,4,0,3
401378997,Delaware State Hornets,A. Moragne,4595506,,True,36.0,7,15,4,11,3,4,6,7,1,4,5,0,0,0,2,2,23
401378997,Delaware State Hornets,J. Law,4595504,,True,31.0,1,6,1,3,0,3,2,2,0,4,4,5,1,0,4,2,4
401378997,Delaware State Hornets,D. Jackson,4917388,,False,22.0,2,2,2,2,0,0,0,0,0,4,4,0,1,0,2,3,4
401378997,Delaware State Hornets,M. Johnson,4917389,,False,17.0,0,3,0,1,0,2,2,2,0,0,0,1,0,0,2,0,2
401378997,Delaware State Hornets,TEAM,TOTAL,TOTAL,False,,16,41,12,26,4,15,12,15,3,25,28,10,3,2,17,13,48
401378979,Morgan State Lady Bears,T. Addison,4399569,,True,34.0,3,7,2,6,1,1,0,0,3,2,5,0,1,0,3,2,7
401378979,Morgan State Lady Bears,C. Shepherd,4399530,,True,32.0,7,15,7,14,0,1,3,8,2,6,8,0,2,1,4,3,17
401378979,Morgan State Lady Bears,J. Henson,4595536,,True,33.0,1,6,0,3,1,3,2,2,1,3,4,2,1,0,1,1,5
401378979,Morgan State Lady Bears,A. Brisker,4595384,,True,24.0,1,5,1,3,0,2,2,2,2,2,4,3,1,0,2,3,4
401378979,Morgan State Lady Bears,A. McCalla,4406561,,True,33.0,2,9,0,5,2,4,0,0,1,4,5,3,2,1,4,1,6
401378979,Morgan State Lady Bears,K. Ponder,4899963,,False,9.0,1,2,1,2,0,0,0,0,2,3,5,1,1,0,1,2,2
401378979,Morgan State Lady Bears,S. McCrae,4594729,,False,10.0,4,6,4,6,0,0,0,0,1,3,4,0,0,1,1,0,8
401378979,Morgan State Lady Bears,A. Payne,4899962,,False,3.0,0,0,0,0,0,0,0,0,0,0,0,1,0,0,1,0,0
401378979,Morgan State Lady Bears,E. Jones,4899961,,False,1.0,0,0,0,0,0,0,0,0,0,0,0,0,0,0,0,1,0
401378979,Morgan State Lady Bears,K. Hines,4705324,,False,2.0,0,0,0,0,0,0,0,0,0,1,1,0,0,0,0,0,0
401378979,Morgan State Lady Bears,J. Atmore,4596266,,False,19.0,2,8,2,8,0,0,0,0,1,5,6,1,1,0,5,2,4
401378979,Morgan State Lady Bears,TEAM,TOTAL,TOTAL,False,,21,58,17,47,4,11,7,12,16,33,49,11,9,3,22,15,53
401378979,Coppin State Eagles,J. Salley,4400318,,True,25.0,5,12,5,12,0,0,1,1,8,8,16,0,0,1,1,3,11
401378979,Coppin State Eagles,A. Lawson,4595496,,True,35.0,3,15,1,5,2,10,4,4,1,4,5,2,2,1,1,1,12
401378979,Coppin State Eagles,A. Hamilton,4595495,,True,20.0,0,1,0,1,0,0,0,0,0,0,0,0,0,0,2,2,0
401378979,Coppin State Eagles,M. Staples,4594734,,True,25.0,1,10,1,8,0,2,2,2,2,1,3,1,3,0,3,3,4
401378979,Coppin State Eagles,J. Alexander,4065807,,True,14.0,0,7,0,7,0,0,0,0,0,0,0,0,0,0,0,2,0
401378979,Coppin State Eagles,C. Bucknor,4703653,,False,15.0,3,6,3,5,0,1,0,0,2,3,5,0,0,2,1,0,6
401378979,Coppin State Eagles,C. Gardner,4899917,,False,10.0,1,3,1,2,0,1,0,0,2,0,2,0,0,0,1,0,2
401378979,Coppin State Eagles,J. Watkins,4899915,,False,30.0,2,5,2,4,0,1,0,2,2,7,9,0,4,0,3,2,4
401378979,Coppin State Eagles,H. Evans,4705293,,False,26.0,2,8,2,5,0,3,4,6,0,1,1,3,3,0,3,1,8
401378979,Coppin State Eagles,TEAM,TOTAL,TOTAL,False,,17,67,15,49,2,18,11,15,19,25,44,6,12,4,15,14,47
401378908,UAB Blazers,Z. Weathersby,4595243,,True,26.0,5,8,5,8,0,0,6,7,3,8,11,0,1,2,1,4,16
401378908,UAB Blazers,M. Roters,4595725,,True,29.0,1,4,1,4,0,0,0,0,1,4,5,3,2,0,1,4,2
401378908,UAB Blazers,E. Klaczek,4704558,,True,36.0,4,13,3,8,1,5,1,2,0,2,2,2,2,0,3,2,10
401378908,UAB Blazers,C. Armato,4399943,,True,25.0,0,2,0,1,0,1,0,0,0,0,0,0,0,0,2,2,0
401378908,UAB Blazers,M. Whitley,4399613,,True,33.0,4,13,3,6,1,7,1,1,0,3,3,1,0,0,3,3,10
401378908,UAB Blazers,D. McGhee,4433446,,False,14.0,3,9,2,7,1,2,0,1,3,1,4,0,0,0,1,1,7
401378908,UAB Blazers,S. Rosenfeldt,4399615,,False,5.0,0,0,0,0,0,0,2,2,1,0,1,0,0,0,1,2,2
401378908,UAB Blazers,K. Schneringer,4704559,,False,19.0,1,5,1,3,0,2,2,2,0,0,0,3,0,0,0,0,4
401378908,UAB Blazers,C. Daniels,4704556,,False,12.0,1,3,0,0,1,3,0,0,0,3,3,0,1,1,0,0,3
401378908,UAB Blazers,A. Jordan,4399616,,False,1.0,1,1,1,1,0,0,1,1,0,0,0,0,0,0,0,1,3
401378908,UAB Blazers,TEAM,TOTAL,TOTAL,False,,20,58,16,38,4,20,13,16,11,22,33,9,6,3,13,19,57
401378908,Southern Miss Lady Eagles,M. Grayson,4704539,,True,18.0,3,7,3,7,0,0,0,0,1,1,2,0,2,3,2,2,6
401378908,Southern Miss Lady Eagles,B. Gray,4704534,,True,32.0,2,5,2,4,0,1,1,1,1,7,8,0,1,1,0,1,5
401378908,Southern Miss Lady Eagles,D. Davis,4432949,,True,35.0,5,11,4,8,1,3,4,4,1,2,3,0,1,0,1,1,15
401378908,Southern Miss Lady Eagles,D. Almond,4399612,,True,39.0,10,12,10,11,0,1,5,6,1,5,6,3,2,1,3,2,25
401378908,Southern Miss Lady Eagles,D. Smith,4399611,,True,21.0,0,4,0,4,0,0,0,0,1,1,2,1,0,0,1,0,0
401378908,Southern Miss Lady Eagles,F. Hawkins,4704535,,False,9.0,1,3,1,3,0,0,1,4,0,2,2,1,0,0,0,2,3
401378908,Southern Miss Lady Eagles,K. Jones,4281810,,False,16.0,1,4,1,4,0,0,4,4,1,3,4,0,0,1,1,4,6
401378908,Southern Miss Lady Eagles,R. Warren,4704538,,False,30.0,2,6,1,5,1,1,2,2,1,4,5,1,0,0,2,0,7
401378908,Southern Miss Lady Eagles,TEAM,TOTAL,TOTAL,False,,24,52,22,46,2,6,17,21,7,27,34,6,6,6,10,12,67
401378877,UTSA Roadrunners,E. Coleman,4597330,,True,29.0,6,12,6,10,0,2,3,3,3,2,5,0,1,4,2,3,15
401378877,UTSA Roadrunners,Q. Ulabo,4899595,,True,18.0,3,6,3,6,0,0,0,0,0,3,3,0,0,0,0,4,6
401378877,UTSA Roadrunners,L. Johnson,4595634,,True,31.0,3,8,3,6,0,2,3,6,3,3,6,1,0,0,2,3,9
401378877,UTSA Roadrunners,C. Govan,4595184,,True,29.0,1,6,1,5,0,1,1,2,2,2,4,1,1,0,1,2,3
401378877,UTSA Roadrunners,J. Pimentel,4282351,,True,16.0,2,8,2,6,0,2,0,0,1,3,4,1,1,0,4,1,4
401378877,UTSA Roadrunners,Y. Valcheva,4704551,,False,22.0,2,3,2,2,0,1,3,6,2,1,3,0,0,0,0,2,7
401378877,UTSA Roadrunners,E. Blanding,4595250,,False,4.0,0,0,0,0,0,0,0,0,0,0,0,0,0,0,1,1,0
401378877,UTSA Roadrunners,D. Nwakamma,4899596,,False,18.0,1,6,1,3,0,3,0,0,1,2,3,3,2,0,0,2,2
401378877,UTSA Roadrunners,H. Atwood,4899594,,False,17.0,0,4,0,2,0,2,0,0,0,3,3,1,1,0,1,2,0
401378877,UTSA Roadrunners,Ch. Mass,4595253,,False,16.0,1,7,1,6,0,1,0,0,0,1,1,1,1,0,1,0,2
401378877,UTSA Roadrunners,L. Hunter,4595186,,False,0.0,0,0,0,0,0,0,0,0,0,0,0,0,0,0,0,1,0
401378877,UTSA Roadrunners,TEAM,TOTAL,TOTAL,False,,19,60,19,46,0,14,10,17,14,24,38,8,7,4,13,21,48
401378877,Rice Owls,M. Fisher,4899404,,True,30.0,6,14,6,13,0,1,1,7,3,4,7,0,3,0,1,2,13
401378877,Rice Owls,A. McCurry,4399609,,True,13.0,2,3,2,3,0,0,0,0,1,1,2,1,0,0,2,1,4
401378877,Rice Owls,M. Bokunewicz,4704533,,True,39.0,9,14,2,2,7,12,1,2,2,8,10,3,0,0,1,2,26
401378877,Rice Owls,T. Gooden,4899405,,True,21.0,1,2,0,0,1,2,0,0,0,4,4,3,0,1,1,4,3
401378877,Rice Owls,D. Jackson,4595231,,True,29.0,2,4,2,3,0,1,5,6,4,4,8,6,1,0,0,1,9
401378877,Rice Owls,I. Bellamy,4433709,,False,13.0,1,3,1,3,0,0,0,0,2,1,3,0,0,1,1,1,2
401378877,Rice Owls,A. Austin,4433262,,False,24.0,5,15,1,8,4,7,7,7,3,4,7,4,0,0,2,3,21
401378877,Rice Owls,S. May,4915515,,False,1.0,0,0,0,0,0,0,0,0,0,1,1,0,0,0,0,0,0
401378877,Rice Owls,H. Swayze,4399608,,False,30.0,3,13,1,3,2,10,0,0,2,2,4,3,1,0,1,0,8
401378877,Rice Owls,TEAM,TOTAL,TOTAL,False,,29,68,15,35,14,33,14,22,19,30,49,20,5,2,9,14,86
401378876,UTEP Miners,E. Arike,4704572,,True,17.0,1,3,1,3,0,0,4,4,2,1,3,1,0,0,0,4,6
401378876,UTEP Miners,T. Battle,4282598,,True,22.0,3,5,2,4,1,1,0,3,0,1,1,0,1,0,3,0,7
401378876,UTEP Miners,M. Petree,4595572,,True,25.0,4,15,3,8,1,7,0,0,3,1,4,2,1,0,3,3,9
401378876,UTEP Miners,A. Crouse,4595247,,True,25.0,4,7,1,2,3,5,4,4,1,2,3,0,0,0,2,3,15
401378876,UTEP Miners,K. Gallegos,4595246,,True,36.0,3,11,2,4,1,7,1,2,0,1,1,7,3,1,4,3,8
401378876,UTEP Miners,B. Fontana,4704573,,False,14.0,3,4,2,2,1,2,0,0,0,3,3,2,0,1,0,3,7
401378876,UTEP Miners,D. Apsite,4704571,,False,7.0,1,1,1,1,0,0,0,0,1,0,1,0,0,0,0,0,2
401378876,UTEP Miners,A. Tac,4597075,,False,9.0,0,1,0,1,0,0,0,0,1,0,1,0,0,0,0,2,0
401378876,UTEP Miners,G. Alvarez,4899439,,False,6.0,0,3,0,0,0,3,2,2,0,1,1,0,1,0,2,0,2
401378876,UTEP Miners,E. Wilson,4399863,,False,23.0,2,7,2,6,0,1,2,4,2,4,6,0,0,0,0,4,6
401378876,UTEP Miners,E. Cabral,4399620,,False,16.0,0,2,0,0,0,2,0,0,0,2,2,3,0,0,1,0,0
401378876,UTEP Miners,TEAM,TOTAL,TOTAL,False,,21,59,14,31,7,28,13,19,12,20,32,15,6,2,15,22,62
401378876,Rice Owls,M. Fisher,4899404,,True,33.0,6,10,6,10,0,0,8,8,5,6,11,3,2,0,3,4,20
401378876,Rice Owls,A. Austin,4433262,,True,28.0,2,8,1,6,1,2,9,12,0,5,5,5,3,0,3,2,14
401378876,Rice Owls,M. Bokunewicz,4704533,,True,31.0,5,13,3,5,2,8,2,2,2,4,6,1,1,0,0,0,14
401378876,Rice Owls,T. Gooden,4899405,,True,28.0,4,8,3,5,1,3,1,2,2,0,2,1,1,0,1,4,10
401378876,Rice Owls,D. Jackson,4595231,,True,36.0,5,7,5,7,0,0,4,4,2,4,6,2,1,0,5,3,14
401378876,Rice Owls,I. Bellamy,4433709,,False,14.0,1,2,1,2,0,0,1,2,1,5,6,1,0,0,1,2,3
401378876,Rice Owls,A. McCurry,4399609,,False,5.0,0,0,0,0,0,0,0,0,0,0,0,0,0,0,0,0,0
401378876,Rice Owls,H. Swayze,4399608,,False,25.0,3,8,2,5,1,3,0,0,0,2,2,0,1,2,0,3,7
401378876,Rice Owls,TEAM,TOTAL,TOTAL,False,,26,56,21,40,5,16,25,30,12,28,40,13,9,2,13,18,82
401378040,UTEP Miners,E. Arike,4704572,,True,15.0,0,3,0,3,0,0,1,2,2,0,2,1,0,0,4,3,1
401378040,UTEP Miners,T. Battle,4282598,,True,22.0,2,4,2,4,0,0,2,4,2,4,6,0,0,0,2,5,6
401378040,UTEP Miners,D. Thurman,4704574,,True,30.0,2,13,2,9,0,4,1,2,5,2,7,1,2,0,1,2,5
401378040,UTEP Miners,A. Crouse,4595247,,True,29.0,4,10,3,7,1,3,1,1,2,3,5,1,0,0,2,1,10
401378040,UTEP Miners,K. Gallegos,4595246,,True,35.0,2,7,2,5,0,2,1,2,0,4,4,2,1,1,2,1,5
401378040,UTEP Miners,B. Fontana,4704573,,False,15.0,2,6,1,3,1,3,0,0,0,5,5,1,0,0,2,3,5
401378040,UTEP Miners,A. Tac,4597075,,False,1.0,0,0,0,0,0,0,0,0,1,0,1,0,0,0,1,0,0
401378040,UTEP Miners,M. Petree,4595572,,False,23.0,5,9,5,9,0,0,0,0,1,4,5,0,0,0,2,4,10
401378040,UTEP Miners,E. Wilson,4399863,,False,15.0,1,1,1,1,0,0,0,0,0,3,3,0,0,0,0,1,2
401378040,UTEP Miners,E. Cabral,4399620,,False,15.0,1,2,0,1,1,1,0,0,0,0,0,0,0,0,1,0,3
401378040,UTEP Miners,TEAM,TOTAL,TOTAL,False,,19,55,16,42,3,13,6,11,14,25,39,6,3,1,17,20,47
401378040,North Texas Mean Green,J. Mallard,4596040,,True,30.0,3,6,3,6,0,0,1,1,2,7,9,0,2,0,5,2,7
401378040,North Texas Mean Green,M. Townley,4399531,,True,33.0,2,7,2,7,0,0,0,0,0,4,4,2,1,1,0,3,4
401378040,North Texas Mean Green,J. Jackson,4595018,,True,27.0,1,5,1,5,0,0,2,2,0,1,1,2,1,0,2,2,4
401378040,North Texas Mean Green,Q. Noble,4400145,,True,40.0,5,13,3,9,2,4,2,2,4,4,8,3,0,2,2,1,14
401378040,North Texas Mean Green,A. Gamez,4281826,,True,35.0,5,9,2,4,3,5,7,10,1,6,7,2,3,0,2,4,20
401378040,North Texas Mean Green,E. Villas-Gomis,4594758,,False,1.0,0,0,0,0,0,0,0,0,0,0,0,0,0,0,1,0,0
401378040,North Texas Mean Green,T. Lampkin,4433476,,False,9.0,1,2,1,2,0,0,0,2,0,1,1,0,0,0,0,1,2
401378040,North Texas Mean Green,K. McGruder,4899377,,False,0.0,0,0,0,0,0,0,0,0,0,0,0,0,0,0,0,0,0
401378040,North Texas Mean Green,A. Dixon,4281784,,False,25.0,2,6,2,5,0,1,1,3,1,1,2,2,1,0,3,2,5
401378040,North Texas Mean Green,TEAM,TOTAL,TOTAL,False,,19,48,14,38,5,10,13,20,10,24,34,11,8,3,16,15,56
401378039,UTSA Roadrunners,Y. Valcheva,4704551,,True,12.0,1,2,1,2,0,0,0,2,1,1,2,0,1,0,0,1,2
401378039,UTSA Roadrunners,E. Coleman,4597330,,True,37.0,2,8,2,7,0,1,3,4,1,4,5,1,0,2,2,0,7
401378039,UTSA Roadrunners,L. Johnson,4595634,,True,27.0,3,8,2,7,1,1,0,0,1,2,3,1,0,0,3,4,7
401378039,UTSA Roadrunners,C. Govan,4595184,,True,28.0,1,4,1,2,0,2,2,2,1,4,5,1,0,0,2,3,4
401378039,UTSA Roadrunners,J. Pimentel,4282351,,True,27.0,4,10,3,8,1,2,1,3,0,0,0,3,2,0,5,5,10
401378039,UTSA Roadrunners,E. Blanding,4595250,,False,2.0,1,1,1,1,0,0,0,0,1,0,1,0,0,0,0,0,2
401378039,UTSA Roadrunners,Q. Ulabo,4899595,,False,30.0,4,6,4,6,0,0,0,0,3,4,7,0,0,0,4,4,8
401378039,UTSA Roadrunners,H. Atwood,4899594,,False,5.0,0,0,0,0,0,0,0,0,0,2,2,0,0,0,0,1,0
401378039,UTSA Roadrunners,Ce. Mass,4611209,,False,2.0,0,0,0,0,0,0,0,0,0,0,0,0,0,0,1,0,0
401378039,UTSA Roadrunners,Ch. Mass,4595253,,False,30.0,5,16,4,11,1,5,0,0,1,2,3,1,3,0,2,1,11
401378039,UTSA Roadrunners,TEAM,TOTAL,TOTAL,False,,21,55,18,44,3,11,6,11,15,21,36,7,6,2,20,19,51
401378039,North Texas Mean Green,J. Mallard,4596040,,True,14.0,1,3,1,3,0,0,0,0,1,1,2,0,0,0,1,2,2
401378039,North Texas Mean Green,M. Townley,4399531,,True,33.0,5,10,5,10,0,0,3,4,3,7,10,1,2,3,2,3,13
401378039,North Texas Mean Green,J. Jackson,4595018,,True,35.0,3,6,3,4,0,2,1,2,0,0,0,2,0,0,3,2,7
401378039,North Texas Mean Green,Q. Noble,4400145,,True,39.0,7,17,6,12,1,5,3,5,2,7,9,3,1,0,1,1,18
401378039,North Texas Mean Green,A. Gamez,4281826,,True,39.0,2,8,0,1,2,7,1,2,1,1,2,4,0,0,2,2,7
401378039,North Texas Mean Green,A. Johnson,4899379,,False,2.0,0,0,0,0,0,0,0,0,0,0,0,0,0,0,0,0,0
401378039,North Texas Mean Green,E. Villas-Gomis,4594758,,False,5.0,0,2,0,2,0,0,0,0,0,0,0,0,0,0,2,1,0
401378039,North Texas Mean Green,T. Lampkin,4433476,,False,17.0,2,2,2,2,0,0,0,0,0,1,1,1,0,2,1,4,4
401378039,North Texas Mean Green,K. McGruder,4899377,,False,3.0,0,0,0,0,0,0,0,0,0,0,0,0,0,0,1,0,0
401378039,North Texas Mean Green,A. Dixon,4281784,,False,13.0,1,1,1,1,0,0,0,0,0,1,1,1,0,0,2,1,2
401378039,North Texas Mean Green,TEAM,TOTAL,TOTAL,False,,21,49,18,35,3,14,8,13,10,20,30,12,3,5,15,16,53
401378025,Old Dominion Monarchs,B. Jackson,4594387,,True,20.0,5,8,5,8,0,0,3,6,2,2,4,0,1,0,5,4,13
401378025,Old Dominion Monarchs,A. Young,4399540,,True,21.0,0,6,0,6,0,0,1,2,1,5,6,0,1,0,2,5,1
401378025,Old Dominion Monarchs,I. Allen,4704183,,True,38.0,1,11,1,8,0,3,3,6,2,6,8,2,0,0,2,3,5
401378025,Old Dominion Monarchs,A. Hudson,4399534,,True,36.0,2,3,1,1,1,2,1,3,3,3,6,1,1,0,0,1,6
401378025,Old Dominion Monarchs,M. Adams,4399533,,True,33.0,4,12,4,9,0,3,1,2,0,3,3,1,1,0,5,3,9
401378025,Old Dominion Monarchs,A. Barnes-Williams,4899395,,False,12.0,1,5,1,5,0,0,1,2,3,1,4,1,0,0,1,0,3
401378025,Old Dominion Monarchs,K. Nelson,4899398,,False,18.0,1,6,0,1,1,5,0,0,0,0,0,0,0,0,0,1,3
401378025,Old Dominion Monarchs,K. Clark,4899396,,False,15.0,1,4,1,2,0,2,0,0,1,0,1,2,0,0,1,1,2
401378025,Old Dominion Monarchs,J. Campbell,4704352,,False,7.0,0,1,0,0,0,1,2,2,0,2,2,0,0,0,0,2,2
401378025,Old Dominion Monarchs,TEAM,TOTAL,TOTAL,False,,15,56,13,40,2,16,12,23,15,24,39,7,4,0,16,20,44
401378025,Middle Tennessee Blue Raiders,C. Whitson,4595015,,True,32.0,6,12,3,4,3,8,1,1,2,6,8,4,0,0,7,4,16
401378025,Middle Tennessee Blue Raiders,A. Boldyreva,4899372,,True,33.0,6,8,5,7,1,1,2,4,0,7,7,0,0,4,2,2,15
401378025,Middle Tennessee Blue Raiders,J. Gregory,4899375,,True,36.0,2,6,0,0,2,6,1,2,0,4,4,1,1,0,1,4,7
401378025,Middle Tennessee Blue Raiders,Al. Whittington,4399524,,True,40.0,3,9,1,3,2,6,0,0,1,4,5,1,1,0,2,4,8
401378025,Middle Tennessee Blue Raiders,D. Saar,4281152,,True,37.0,2,12,0,5,2,7,6,6,3,4,7,6,2,0,0,3,12
401378025,Middle Tennessee Blue Raiders,J. Grannum,4704491,,False,3.0,1,1,1,1,0,0,0,0,0,0,0,0,0,0,0,0,2
401378025,Middle Tennessee Blue Raiders,K. Malashka,4399493,,False,10.0,0,2,0,1,0,1,2,2,0,3,3,0,1,1,1,5,2
401378025,Middle Tennessee Blue Raiders,C. Blakely,4899371,,False,8.0,0,1,0,0,0,1,0,0,0,0,0,2,0,0,2,1,0
401378025,Middle Tennessee Blue Raiders,Am. Whittington,4399525,,False,1.0,0,0,0,0,0,0,0,0,0,0,0,0,0,0,0,0,0
401378025,Middle Tennessee Blue Raiders,TEAM,TOTAL,TOTAL,False,,20,51,10,21,10,30,12,15,9,31,40,14,5,5,15,23,62
401377991,Western Kentucky Lady Toppers,J. Foster,4899600,,True,33.0,2,11,2,8,0,3,3,4,3,5,8,3,0,1,1,1,7
401377991,Western Kentucky Lady Toppers,T. Hunter,4595265,,True,3.0,0,1,0,1,0,0,0,0,0,0,0,0,0,0,0,0,0
401377991,Western Kentucky Lady Toppers,M. Blevins,4899602,,True,21.0,4,9,3,5,1,4,0,0,0,4,4,1,0,0,1,3,9
401377991,Western Kentucky Lady Toppers,A. Mead,4899598,,True,32.0,1,11,1,7,0,4,2,2,1,2,3,3,0,0,2,3,4
401377991,Western Kentucky Lady Toppers,M. Abdelgawad,4399629,,True,33.0,6,10,5,8,1,2,3,5,2,7,9,3,3,0,0,1,16
401377991,Western Kentucky Lady Toppers,G. McBride,4433116,,False,12.0,0,1,0,1,0,0,0,0,1,2,3,2,0,0,1,3,0
401377991,Western Kentucky Lady Toppers,S. Kulo,4704582,,False,7.0,2,3,2,3,0,0,0,2,2,3,5,0,0,0,0,1,4
401377991,Western Kentucky Lady Toppers,J. Walker,4899603,,False,18.0,1,6,1,2,0,4,2,2,0,1,1,1,1,0,2,2,4
401377991,Western Kentucky Lady Toppers,T. Faustino,4899601,,False,22.0,2,3,2,2,0,1,0,0,1,3,4,1,0,0,1,0,4
401377991,Western Kentucky Lady Toppers,H. Sivori,4704584,,False,19.0,1,2,0,1,1,1,0,0,0,0,0,0,0,0,1,2,3
401377991,Western Kentucky Lady Toppers,TEAM,TOTAL,TOTAL,False,,19,57,16,38,3,19,10,15,13,28,41,14,4,1,9,16,51
401377991,Marshall Thundering Herd,L. Roper,4399522,,True,22.0,2,5,2,5,0,0,0,0,4,4,8,1,0,1,1,3,4
401377991,Marshall Thundering Herd,K. Colclough,4068712,,True,31.0,5,9,5,7,0,2,3,5,2,9,11,1,0,0,1,1,13
401377991,Marshall Thundering Herd,S. Wheeler,4595007,,True,38.0,6,16,5,8,1,8,1,3,1,3,4,4,1,0,1,3,14
401377991,Marshall Thundering Herd,Bri. Ferby,4282387,,True,33.0,4,15,1,4,3,11,2,4,4,4,8,1,0,0,1,1,13
401377991,Marshall Thundering Herd,A. Dunham,4281365,,True,38.0,3,11,0,2,3,9,2,4,0,3,3,1,0,0,0,2,11
401377991,Marshall Thundering Herd,S. LaFon,4711714,,False,2.0,0,0,0,0,0,0,0,0,0,0,0,0,0,0,1,0,0
401377991,Marshall Thundering Herd,A. Redman,4704482,,False,3.0,0,1,0,1,0,0,0,0,1,0,1,0,0,0,0,1,0
401377991,Marshall Thundering Herd,A. Johnson,4595009,,False,3.0,0,1,0,0,0,1,0,0,0,1,1,0,0,0,0,1,0
401377991,Marshall Thundering Herd,CC Mays,4704479,,False,14.0,1,2,1,1,0,1,1,2,0,1,1,3,2,0,3,1,3
401377991,Marshall Thundering Herd,K. Sivils,4399519,,False,16.0,0,0,0,0,0,0,0,0,2,0,2,2,1,0,0,2,0
401377991,Marshall Thundering Herd,TEAM,TOTAL,TOTAL,False,,21,60,14,28,7,32,9,18,15,28,43,13,4,1,8,15,58
401377990,Western Kentucky Lady Toppers,J. Foster,4899600,,True,32.0,3,11,1,5,2,6,2,4,2,9,11,2,0,0,0,5,10
401377990,Western Kentucky Lady Toppers,T. Hunter,4595265,,True,12.0,2,4,2,4,0,0,0,1,2,3,5,0,0,0,0,1,4
401377990,Western Kentucky Lady Toppers,M. Blevins,4899602,,True,19.0,1,5,1,1,0,4,1,2,0,0,0,0,0,0,1,0,3
401377990,Western Kentucky Lady Toppers,A. Mead,4899598,,True,29.0,3,7,2,4,1,3,0,0,3,2,5,2,0,1,4,2,7
401377990,Western Kentucky Lady Toppers,M. Abdelgawad,4399629,,True,35.0,5,10,4,7,1,3,6,9,2,4,6,4,1,0,4,2,17
401377990,Western Kentucky Lady Toppers,G. McBride,4433116,,False,7.0,1,2,1,2,0,0,0,0,0,0,0,0,0,0,0,1,2
401377990,Western Kentucky Lady Toppers,S. Kulo,4704582,,False,2.0,0,1,0,1,0,0,0,0,0,0,0,0,0,0,1,1,0
401377990,Western Kentucky Lady Toppers,J. Walker,4899603,,False,14.0,0,2,0,0,0,2,0,0,0,1,1,1,1,0,1,3,0
401377990,Western Kentucky Lady Toppers,T. Faustino,4899601,,False,23.0,1,5,0,1,1,4,4,4,3,3,6,5,1,0,1,2,7
401377990,Western Kentucky Lady Toppers,J. Smith,4704585,,False,1.0,0,0,0,0,0,0,0,0,0,0,0,0,0,0,0,1,0
401377990,Western Kentucky Lady Toppers,H. Sivori,4704584,,False,26.0,4,8,0,1,4,7,0,0,0,2,2,0,0,0,3,2,12
401377990,Western Kentucky Lady Toppers,TEAM,TOTAL,TOTAL,False,,20,55,11,26,9,29,13,20,12,24,36,14,3,1,15,20,62
401377990,Marshall Thundering Herd,L. Roper,4399522,,True,30.0,2,5,2,5,0,0,0,0,3,7,10,0,1,1,2,3,4
401377990,Marshall Thundering Herd,K. Colclough,4068712,,True,20.0,4,7,3,4,1,3,0,1,2,3,5,1,0,0,0,3,9
401377990,Marshall Thundering Herd,S. Wheeler,4595007,,True,37.0,11,19,9,14,2,5,3,7,0,3,3,1,1,1,3,3,27
401377990,Marshall Thundering Herd,Bri. Ferby,4282387,,True,33.0,6,18,3,8,3,10,3,3,1,2,3,3,2,0,1,0,18
401377990,Marshall Thundering Herd,A. Dunham,4281365,,True,36.0,5,12,3,6,2,6,2,2,0,4,4,5,3,0,1,4,14
401377990,Marshall Thundering Herd,S. LaFon,4711714,,False,2.0,0,0,0,0,0,0,1,2,0,0,0,0,0,0,0,0,1
401377990,Marshall Thundering Herd,A. Redman,4704482,,False,5.0,0,0,0,0,0,0,0,0,1,1,2,1,0,0,0,1,0
401377990,Marshall Thundering Herd,S. Liberatore,4704481,,False,2.0,0,1,0,1,0,0,0,0,0,0,0,0,0,0,0,0,0
401377990,Marshall Thundering Herd,CC Mays,4704479,,False,12.0,2,2,2,2,0,0,0,0,1,1,2,0,0,0,0,3,4
401377990,Marshall Thundering Herd,C. McLean,4597886,,False,2.0,0,0,0,0,0,0,0,0,0,0,0,0,0,0,0,0,0
401377990,Marshall Thundering Herd,K. Sivils,4399519,,False,21.0,1,2,1,2,0,0,1,2,4,1,5,0,0,0,0,2,3
401377990,Marshall Thundering Herd,TEAM,TOTAL,TOTAL,False,,31,66,23,42,8,24,10,17,13,26,39,11,7,2,7,19,80
401377950,UAB Blazers,Z. Weathersby,4595243,,True,24.0,6,12,6,12,0,0,2,2,4,7,11,3,1,3,4,2,14
401377950,UAB Blazers,M. Roters,4595725,,True,25.0,4,5,2,3,2,2,0,0,0,4,4,2,1,1,2,1,10
401377950,UAB Blazers,K. Schneringer,4704559,,True,11.0,0,3,0,3,0,0,0,0,0,0,0,0,1,0,1,0,0
401377950,UAB Blazers,E. Klaczek,4704558,,True,31.0,4,10,3,8,1,2,1,2,0,1,1,3,0,1,2,3,10
401377950,UAB Blazers,M. Whitley,4399613,,True,34.0,0,6,0,3,0,3,2,2,0,4,4,2,0,0,4,1,2
401377950,UAB Blazers,D. McGhee,4433446,,False,13.0,4,6,4,5,0,1,2,2,1,0,1,0,3,0,1,2,10
401377950,UAB Blazers,S. Rosenfeldt,4399615,,False,11.0,1,2,1,2,0,0,0,0,1,2,3,0,0,0,1,0,2
401377950,UAB Blazers,M. Walsh,4704561,,False,7.0,0,0,0,0,0,0,0,0,0,1,1,0,0,0,0,1,0
401377950,UAB Blazers,A. Denes,4899416,,False,2.0,0,1,0,0,0,1,0,0,0,0,0,0,0,0,1,0,0
401377950,UAB Blazers,C. Daniels,4704556,,False,2.0,0,0,0,0,0,0,0,0,0,0,0,0,0,0,0,0,0
401377950,UAB Blazers,C. Armato,4399943,,False,12.0,0,1,0,0,0,1,0,0,0,0,0,2,1,0,0,0,0
401377950,UAB Blazers,A. Jordan,4399616,,False,28.0,2,3,1,2,1,1,3,4,0,2,2,0,1,0,0,0,8
401377950,UAB Blazers,TEAM,TOTAL,TOTAL,False,,21,49,17,38,4,11,10,12,6,23,29,12,8,5,16,10,56
401377950,Louisiana Tech Lady Techsters,A. Roberson,4595004,,True,30.0,8,14,8,12,0,2,3,5,0,6,6,1,0,1,1,1,19
401377950,Louisiana Tech Lady Techsters,A. Brannon,4899084,,True,19.0,2,2,1,1,1,1,2,2,4,3,7,1,1,0,4,3,7
401377950,Louisiana Tech Lady Techsters,S. Nativi,4899083,,True,18.0,0,2,0,1,0,1,0,0,1,1,2,0,1,0,0,1,0
401377950,Louisiana Tech Lady Techsters,S. Bates,4433173,,True,34.0,3,7,0,3,3,4,0,0,1,2,3,6,0,0,0,0,9
401377950,Louisiana Tech Lady Techsters,K. Walker,4399516,,True,35.0,9,21,8,20,1,1,1,2,2,4,6,8,4,0,2,2,20
401377950,Louisiana Tech Lady Techsters,M. Wurm,4899085,,False,2.0,1,1,1,1,0,0,0,0,0,2,2,0,0,0,0,0,2
401377950,Louisiana Tech Lady Techsters,K. Thompson,4703773,,False,6.0,0,2,0,2,0,0,0,0,0,0,0,0,0,0,2,0,0
401377950,Louisiana Tech Lady Techsters,J. Davis,4281796,,False,4.0,1,4,1,4,0,0,0,0,1,1,2,0,0,0,1,0,2
401377950,Louisiana Tech Lady Techsters,A. Smith,4899081,,False,2.0,0,0,0,0,0,0,0,0,0,0,0,1,0,0,0,0,0
401377950,Louisiana Tech Lady Techsters,R. Lee,4704199,,False,21.0,5,7,4,5,1,2,0,0,1,1,2,0,3,0,0,1,11
401377950,Louisiana Tech Lady Techsters,L. Sant,4595003,,False,29.0,4,6,0,0,4,6,0,0,1,1,2,1,0,0,0,1,12
401377950,Louisiana Tech Lady Techsters,TEAM,TOTAL,TOTAL,False,,33,66,23,49,10,17,6,9,12,23,35,18,9,1,10,9,82
401377949,Old Dominion Monarchs,A. Young,4399540,,True,21.0,2,7,2,7,0,0,0,0,0,4,4,0,2,0,4,3,4
401377949,Old Dominion Monarchs,I. Allen,4704183,,True,34.0,7,16,5,13,2,3,4,4,0,2,2,1,3,0,4,4,20
401377949,Old Dominion Monarchs,A. Wayne,4399539,,True,16.0,1,5,1,4,0,1,0,0,0,0,0,0,0,0,2,1,2
401377949,Old Dominion Monarchs,A. Hudson,4399534,,True,28.0,4,7,1,1,3,6,0,0,0,1,1,0,0,0,0,0,11
401377949,Old Dominion Monarchs,M. Adams,4399533,,True,40.0,2,5,2,5,0,0,0,0,0,3,3,7,2,0,3,1,4
401377949,Old Dominion Monarchs,A. Barnes-Williams,4899395,,False,13.0,3,3,3,3,0,0,0,0,2,2,4,0,0,0,1,2,6
401377949,Old Dominion Monarchs,B. Jackson,4594387,,False,25.0,4,9,4,8,0,1,7,7,1,3,4,2,2,0,0,4,15
401377949,Old Dominion Monarchs,K. Nelson,4899398,,False,3.0,0,1,0,0,0,1,0,0,0,0,0,0,0,0,0,0,0
401377949,Old Dominion Monarchs,K. Clark,4899396,,False,20.0,0,2,0,2,0,0,0,0,2,0,2,1,1,0,0,0,0
401377949,Old Dominion Monarchs,TEAM,TOTAL,TOTAL,False,,23,55,18,43,5,12,11,11,6,16,22,11,10,0,14,15,62
401377949,Louisiana Tech Lady Techsters,A. Roberson,4595004,,True,33.0,10,13,9,11,1,2,10,10,0,8,8,0,2,2,2,2,31
401377949,Louisiana Tech Lady Techsters,A. Brannon,4899084,,True,37.0,1,4,1,2,0,2,0,0,0,5,5,2,2,1,2,1,2
401377949,Louisiana Tech Lady Techsters,S. Nativi,4899083,,True,24.0,1,1,0,0,1,1,0,0,0,2,2,1,0,0,2,1,3
401377949,Louisiana Tech Lady Techsters,S. Bates,4433173,,True,37.0,3,6,3,6,0,0,4,4,1,3,4,6,0,0,2,0,10
401377949,Louisiana Tech Lady Techsters,K. Walker,4399516,,True,22.0,3,5,3,5,0,0,0,1,0,3,3,2,2,0,5,5,6
401377949,Louisiana Tech Lady Techsters,K. Thompson,4703773,,False,7.0,1,1,1,1,0,0,0,0,0,0,0,0,0,0,1,1,2
401377949,Louisiana Tech Lady Techsters,R. Lee,4704199,,False,26.0,4,6,3,4,1,2,2,2,0,2,2,0,1,0,5,1,11
401377949,Louisiana Tech Lady Techsters,L. Sant,4595003,,False,14.0,0,3,0,0,0,3,0,0,0,1,1,1,0,0,1,1,0
401377949,Louisiana Tech Lady Techsters,TEAM,TOTAL,TOTAL,False,,23,39,20,29,3,10,16,17,1,25,26,12,7,3,20,12,65
401377928,Florida International Panthers,A. Danielsson,4704185,,True,8.0,1,3,0,0,1,3,0,0,0,2,2,0,0,0,0,0,3
401377928,Florida International Panthers,E. Ekpiteta,4282163,,True,26.0,4,10,4,9,0,1,0,2,4,4,8,1,1,0,2,3,8
401377928,Florida International Panthers,K. Nelson,4281210,,True,32.0,5,12,3,5,2,7,3,3,0,4,4,5,2,2,1,3,15
401377928,Florida International Panthers,T. Hayes,4899077,,True,35.0,8,15,6,11,2,4,0,0,0,7,7,7,2,0,2,0,18
401377928,Florida International Panthers,R. Ferrer-Bernad,4704184,,True,26.0,2,5,1,1,1,4,1,2,0,3,3,7,1,0,1,2,6
401377928,Florida International Panthers,H. Butera,4899079,,False,19.0,0,1,0,1,0,0,2,2,6,2,8,0,2,0,1,1,2
401377928,Florida International Panthers,M. Torres,4704466,,False,13.0,3,3,3,3,0,0,0,0,0,2,2,0,0,1,0,4,6
401377928,Florida International Panthers,G. Hunter,4899078,,False,14.0,0,2,0,1,0,1,0,0,0,1,1,2,0,0,0,2,0
401377928,Florida International Panthers,Z. Gonzalez,4899076,,False,27.0,6,12,5,9,1,3,1,2,1,1,2,0,1,0,1,1,14
401377928,Florida International Panthers,TEAM,TOTAL,TOTAL,False,,29,63,22,40,7,23,7,11,13,27,40,22,9,3,8,16,72
401377928,Florida Atlantic Owls,A. Gaston,4399501,,True,25.0,4,9,4,9,0,0,2,2,2,4,6,0,1,0,1,1,10
401377928,Florida Atlantic Owls,J. Rozentale,4399241,,True,18.0,4,6,4,6,0,0,1,1,2,4,6,0,0,0,3,3,9
401377928,Florida Atlantic Owls,R. Pleskevich,4595919,,True,30.0,3,14,1,6,2,8,2,2,2,4,6,2,0,0,2,2,10
401377928,Florida Atlantic Owls,N. Ozola,4594988,,True,31.0,1,4,0,0,1,4,1,2,1,0,1,1,0,0,2,1,4
401377928,Florida Atlantic Owls,B. Beck,4399987,,True,30.0,1,4,1,2,0,2,2,4,0,4,4,3,3,0,1,1,4
401377928,Florida Atlantic Owls,S. Galeron,4400535,,False,19.0,0,3,0,1,0,2,0,0,1,4,5,2,0,0,1,1,0
401377928,Florida Atlantic Owls,S. Henshaw,4899074,,False,17.0,2,3,2,3,0,0,1,4,1,0,1,1,0,0,0,0,5
401377928,Florida Atlantic Owls,A. Zaph,4594993,,False,30.0,6,12,4,8,2,4,0,0,0,0,0,1,0,0,1,2,14
401377928,Florida Atlantic Owls,TEAM,TOTAL,TOTAL,False,,21,55,16,35,5,20,9,15,11,22,33,10,4,0,13,11,56
401377927,Florida International Panthers,M. Torres,4704466,,True,26.0,5,5,5,5,0,0,3,3,2,3,5,1,0,1,0,4,13
401377927,Florida International Panthers,K. Nelson,4281210,,True,39.0,6,12,3,6,3,6,1,2,1,3,4,4,1,0,1,1,16
401377927,Florida International Panthers,T. Hayes,4899077,,True,29.0,6,11,6,10,0,1,0,0,1,3,4,3,2,1,2,2,12
401377927,Florida International Panthers,Z. Gonzalez,4899076,,True,18.0,3,9,1,6,2,3,0,0,0,1,1,0,2,0,2,2,8
401377927,Florida International Panthers,R. Ferrer-Bernad,4704184,,True,17.0,1,2,0,1,1,1,0,0,0,1,1,3,0,0,0,5,3
401377927,Florida International Panthers,H. Butera,4899079,,False,9.0,1,1,1,1,0,0,0,0,0,1,1,0,0,0,1,1,2
401377927,Florida International Panthers,A. Danielsson,4704185,,False,7.0,0,1,0,0,0,1,0,0,0,0,0,2,0,0,0,0,0
401377927,Florida International Panthers,E. Ekpiteta,4282163,,False,26.0,3,5,3,5,0,0,2,2,3,2,5,0,0,0,1,2,8
401377927,Florida International Panthers,G. Hunter,4899078,,False,29.0,4,15,4,8,0,7,3,3,0,4,4,3,2,0,1,3,11
401377927,Florida International Panthers,TEAM,TOTAL,TOTAL,False,,29,61,23,42,6,19,9,10,10,23,33,16,7,2,8,20,73
401377927,Florida Atlantic Owls,S. Galeron,4400535,,True,33.0,3,5,0,0,3,5,0,0,1,2,3,4,0,1,1,1,9
401377927,Florida Atlantic Owls,A. Gaston,4399501,,True,17.0,4,7,4,7,0,0,0,2,1,2,3,0,0,1,1,2,8
401377927,Florida Atlantic Owls,R. Pleskevich,4595919,,True,31.0,3,10,2,5,1,5,2,2,0,0,0,0,0,0,1,3,9
401377927,Florida Atlantic Owls,A. Zaph,4594993,,True,31.0,0,9,0,8,0,1,0,0,0,3,3,2,2,0,7,2,0
401377927,Florida Atlantic Owls,B. Beck,4399987,,True,23.0,1,6,0,2,1,4,0,0,1,4,5,3,1,0,1,0,3
401377927,Florida Atlantic Owls,J. Rozentale,4399241,,False,20.0,6,9,5,8,1,1,5,5,5,6,11,0,1,1,2,3,18
401377927,Florida Atlantic Owls,K. Kuykendoll,4899075,,False,16.0,1,3,0,0,1,3,0,0,0,2,2,1,0,0,0,3,3
401377927,Florida Atlantic Owls,S. Henshaw,4899074,,False,11.0,2,3,2,3,0,0,0,1,2,0,2,0,0,0,2,1,4
401377927,Florida Atlantic Owls,N. Ozola,4594988,,False,18.0,0,2,0,0,0,2,1,2,0,0,0,0,0,0,0,0,1
401377927,Florida Atlantic Owls,TEAM,TOTAL,TOTAL,False,,20,54,13,33,7,21,8,12,13,23,36,10,4,3,18,15,55
401377903,Southern Miss Lady Eagles,M. Grayson,4704539,,True,9.0,2,6,2,6,0,0,0,0,2,0,2,1,0,1,1,2,4
401377903,Southern Miss Lady Eagles,B. Gray,4704534,,True,29.0,1,5,1,4,0,1,0,0,0,4,4,2,2,1,2,1,2
401377903,Southern Miss Lady Eagles,D. Davis,4432949,,True,38.0,4,13,4,11,0,2,0,0,1,3,4,1,0,1,1,1,8
401377903,Southern Miss Lady Eagles,D. Almond,4399612,,True,37.0,4,9,3,8,1,1,2,2,0,2,2,4,0,1,3,2,11
401377903,Southern Miss Lady Eagles,D. Smith,4399611,,True,22.0,0,1,0,1,0,0,5,6,0,2,2,1,1,0,4,0,5
401377903,Southern Miss Lady Eagles,A. Leake,4899410,,False,2.0,0,0,0,0,0,0,0,0,1,0,1,0,1,0,2,0,0
401377903,Southern Miss Lady Eagles,A. Broughton,4899408,,False,2.0,0,0,0,0,0,0,0,0,0,0,0,0,0,0,0,0,0
401377903,Southern Miss Lady Eagles,F. Hawkins,4704535,,False,12.0,2,5,2,5,0,0,0,0,2,2,4,1,0,0,0,3,4
401377903,Southern Miss Lady Eagles,K. Jones,4281810,,False,18.0,5,9,5,9,0,0,1,3,2,5,7,0,1,1,2,4,11
401377903,Southern Miss Lady Eagles,M. Dillard,4899409,,False,2.0,0,0,0,0,0,0,0,0,0,0,0,0,0,0,0,0,0
401377903,Southern Miss Lady Eagles,E. Wallhoff,4899407,,False,2.0,0,1,0,0,0,1,0,0,0,0,0,0,0,0,1,0,0
401377903,Southern Miss Lady Eagles,R. Warren,4704538,,False,27.0,1,3,1,3,0,0,2,2,2,3,5,0,1,0,1,4,4
401377903,Southern Miss Lady Eagles,TEAM,TOTAL,TOTAL,False,,19,52,18,47,1,5,10,13,12,24,36,10,6,5,18,17,49
401377903,Charlotte 49ers,M. Williams,4704501,,True,27.0,1,6,1,5,0,1,1,4,1,2,3,1,1,2,0,2,3
401377903,Charlotte 49ers,K. McKinney,4280854,,True,29.0,0,3,0,2,0,1,0,0,4,4,8,1,2,0,2,3,0
401377903,Charlotte 49ers,J. McMillian,4399489,,True,31.0,6,8,6,8,0,0,2,3,0,3,3,3,2,0,0,0,14
401377903,Charlotte 49ers,O. Jett-Wilson,4399487,,True,31.0,5,18,3,11,2,7,0,0,0,3,3,1,0,0,1,0,12
401377903,Charlotte 49ers,M. Boykin,4281177,,True,31.0,6,14,4,11,2,3,1,2,1,4,5,2,0,2,3,1,15
401377903,Charlotte 49ers,M. McGraw,4899072,,False,2.0,0,0,0,0,0,0,0,0,0,0,0,0,0,0,0,0,0
401377903,Charlotte 49ers,A. Middleton,4594982,,False,9.0,0,1,0,1,0,0,2,4,1,0,1,0,0,0,1,2,2
401377903,Charlotte 49ers,A. Wade,4899071,,False,2.0,1,1,1,1,0,0,0,0,0,0,0,0,1,0,0,1,2
401377903,Charlotte 49ers,J. Busick,4704499,,False,13.0,0,0,0,0,0,0,0,0,0,3,3,1,0,0,0,2,0
401377903,Charlotte 49ers,D. Lawrence,4594980,,False,23.0,6,8,3,4,3,4,5,6,2,2,4,1,2,0,1,1,20
401377903,Charlotte 49ers,C. Konek,4433092,,False,1.0,0,0,0,0,0,0,0,0,0,0,0,0,0,0,1,0,0
401377903,Charlotte 49ers,K. Roach,4280856,,False,1.0,1,1,1,1,0,0,0,0,0,0,0,0,2,0,0,0,2
401377903,Charlotte 49ers,TEAM,TOTAL,TOTAL,False,,26,60,19,44,7,16,11,19,13,23,36,10,10,4,10,12,70
401377902,Middle Tennessee Blue Raiders,C. Whitson,4595015,,True,40.0,4,10,3,6,1,4,2,3,2,6,8,1,1,1,0,2,11
401377902,Middle Tennessee Blue Raiders,A. Boldyreva,4899372,,True,16.0,4,12,4,12,0,0,2,2,3,2,5,0,0,0,1,2,10
401377902,Middle Tennessee Blue Raiders,J. Gregory,4899375,,True,40.0,2,6,2,3,0,3,1,2,1,2,3,1,2,0,1,1,5
401377902,Middle Tennessee Blue Raiders,Al. Whittington,4399524,,True,40.0,4,6,2,3,2,3,2,2,2,4,6,2,1,0,1,5,12
401377902,Middle Tennessee Blue Raiders,D. Saar,4281152,,True,28.0,1,4,1,1,0,3,1,2,0,2,2,3,1,0,1,2,3
401377902,Middle Tennessee Blue Raiders,J. Grannum,4704491,,False,2.0,0,0,0,0,0,0,0,0,0,0,0,0,0,0,1,0,0
401377902,Middle Tennessee Blue Raiders,K. Malashka,4399493,,False,22.0,9,18,5,11,4,7,5,6,0,2,2,2,1,2,1,4,27
401377902,Middle Tennessee Blue Raiders,C. Blakely,4899371,,False,12.0,2,5,2,4,0,1,0,0,1,2,3,2,2,0,0,1,4
401377902,Middle Tennessee Blue Raiders,TEAM,TOTAL,TOTAL,False,,26,61,19,40,7,21,13,17,11,23,34,11,8,3,8,17,72
401377902,Charlotte 49ers,M. Williams,4704501,,True,29.0,3,9,3,5,0,4,0,0,3,3,6,0,0,0,1,3,6
401377902,Charlotte 49ers,K. McKinney,4280854,,True,31.0,2,4,0,0,2,4,2,2,0,6,6,0,0,3,0,2,8
401377902,Charlotte 49ers,J. McMillian,4399489,,True,37.0,4,9,4,7,0,2,0,2,2,2,4,1,1,0,4,3,8
401377902,Charlotte 49ers,O. Jett-Wilson,4399487,,True,37.0,3,10,2,5,1,5,13,14,2,6,8,2,1,1,4,2,20
401377902,Charlotte 49ers,M. Boykin,4281177,,True,34.0,7,15,6,11,1,4,0,2,2,3,5,3,2,0,2,2,15
401377902,Charlotte 49ers,A. Middleton,4594982,,False,6.0,2,2,2,2,0,0,0,0,0,1,1,0,0,0,2,2,4
401377902,Charlotte 49ers,J. Busick,4704499,,False,14.0,0,1,0,0,0,1,0,0,0,0,0,0,0,0,1,1,0
401377902,Charlotte 49ers,D. Lawrence,4594980,,False,12.0,2,5,2,4,0,1,0,0,1,1,2,1,0,0,1,1,4
401377902,Charlotte 49ers,TEAM,TOTAL,TOTAL,False,,23,55,19,34,4,21,15,20,12,27,39,7,4,4,15,16,65
401377876,Wichita State Shockers,J. Asinde,4898642,,True,28.0,3,5,3,4,0,1,0,0,4,2,6,0,2,0,2,4,6
401377876,Wichita State Shockers,A. Strong,4399367,,True,39.0,8,18,6,15,2,3,4,6,1,5,6,2,0,0,3,3,22
401377876,Wichita State Shockers,M. McCully,4594545,,True,42.0,8,21,7,15,1,6,2,2,0,5,5,10,2,2,5,2,19
401377876,Wichita State Shockers,S. Bastin,4399038,,True,27.0,3,6,3,6,0,0,0,0,3,1,4,3,1,0,3,5,6
401377876,Wichita State Shockers,C. Bremaud,4399035,,True,35.0,5,11,1,2,4,9,0,0,1,2,3,1,2,0,1,4,14
401377876,Wichita State Shockers,T. Colbert,4399039,,False,22.0,3,4,3,4,0,0,4,6,2,9,11,0,2,2,0,4,10
401377876,Wichita State Shockers,E. Anciaux,4898641,,False,1.0,0,0,0,0,0,0,2,2,0,0,0,0,0,0,0,2,2
401377876,Wichita State Shockers,N. Bosch Duran,4898639,,False,6.0,1,2,0,1,1,1,0,0,0,0,0,0,0,0,0,2,3
401377876,Wichita State Shockers,S. Duncan,4703713,,False,1.0,0,0,0,0,0,0,0,0,0,0,0,0,0,0,0,0,0
401377876,Wichita State Shockers,D. McCarty,4594544,,False,24.0,1,5,1,5,0,0,0,0,0,2,2,1,1,0,0,1,2
401377876,Wichita State Shockers,TEAM,TOTAL,TOTAL,False,,32,72,24,52,8,20,12,16,13,28,41,17,10,4,15,27,84
401377876,Tulane Green Wave,M. Heide,4399249,,True,36.0,4,8,4,8,0,0,5,8,3,6,9,1,1,2,0,5,13
401377876,Tulane Green Wave,K. Freeman,4281110,,True,24.0,2,5,1,2,1,3,2,2,1,2,3,0,1,1,3,2,7
401377876,Tulane Green Wave,D. Jones,4399247,,True,37.0,7,17,5,11,2,6,8,9,0,4,4,2,3,0,2,3,24
401377876,Tulane Green Wave,A. Clark,4282592,,True,42.0,5,14,5,13,0,1,8,11,2,1,3,7,1,1,4,2,18
401377876,Tulane Green Wave,M. Ursin,4281254,,True,40.0,5,11,4,5,1,6,3,4,2,9,11,5,4,0,2,0,14
401377876,Tulane Green Wave,I. Parau,4594537,,False,3.0,1,2,1,2,0,0,0,0,1,1,2,0,0,1,0,1,2
401377876,Tulane Green Wave,A. Grant,4594536,,False,9.0,2,3,2,3,0,0,1,2,0,2,2,0,0,0,0,0,5
401377876,Tulane Green Wave,S. Cheatham,4281109,,False,19.0,0,2,0,0,0,2,0,0,1,0,1,1,0,0,1,1,0
401377876,Tulane Green Wave,K. Anderson,4281107,,False,15.0,0,2,0,1,0,1,0,0,0,0,0,1,0,1,2,2,0
401377876,Tulane Green Wave,TEAM,TOTAL,TOTAL,False,,26,64,22,45,4,19,27,36,14,28,42,17,10,6,14,16,83
401377875,Memphis Tigers,A. Davis,4281126,,True,36.0,5,13,5,10,0,3,5,5,4,5,9,1,2,0,5,2,15
401377875,Memphis Tigers,T. Frierson,4282093,,True,21.0,2,5,2,5,0,0,2,2,3,5,8,0,1,1,1,3,6
401377875,Memphis Tigers,E. Jefferson,4705118,,True,20.0,0,2,0,2,0,0,2,2,0,7,7,1,2,0,5,0,2
401377875,Memphis Tigers,M. Griggs,4433344,,True,30.0,3,9,1,2,2,7,0,0,0,2,2,4,0,0,0,0,8
401377875,Memphis Tigers,J. Shutes,4399021,,True,35.0,1,8,1,6,0,2,7,8,1,2,3,2,2,1,2,1,9
401377875,Memphis Tigers,A. Green,4898627,,False,2.0,0,0,0,0,0,0,0,0,0,1,1,0,0,0,0,0,0
401377875,Memphis Tigers,H. Riddick,4898624,,False,1.0,0,0,0,0,0,0,0,0,1,0,1,0,1,0,0,1,0
401377875,Memphis Tigers,Lane. Williams,4433649,,False,18.0,3,4,3,4,0,0,0,0,1,1,2,1,0,0,1,1,6
401377875,Memphis Tigers,J. Jones,4703659,,False,3.0,0,0,0,0,0,0,0,0,0,2,2,1,0,0,0,0,0
401377875,Memphis Tigers,M. Brooks,4898626,,False,2.0,0,0,0,0,0,0,0,0,0,0,0,0,0,0,0,0,0
401377875,Memphis Tigers,C. Beck,4433447,,False,9.0,0,1,0,1,0,0,1,2,1,1,2,0,0,0,0,0,1
401377875,Memphis Tigers,M. Stovall,4399341,,False,23.0,3,7,2,5,1,2,2,4,0,1,1,0,3,1,2,2,9
401377875,Memphis Tigers,TEAM,TOTAL,TOTAL,False,,17,49,14,35,3,14,19,23,12,27,39,10,11,3,17,10,56
401377875,East Carolina Pirates,T. Bennett,4281180,,True,11.0,1,2,1,2,0,0,0,0,1,0,1,0,0,0,0,4,2
401377875,East Carolina Pirates,I. Adams,4898620,,True,22.0,1,1,1,1,0,0,1,4,0,0,0,2,3,2,1,4,3
401377875,East Carolina Pirates,S. Johnson,4703641,,True,27.0,0,7,0,4,0,3,4,4,5,4,9,3,1,0,2,1,4
401377875,East Carolina Pirates,T. Thompson,4595925,,True,35.0,6,19,3,10,3,9,2,2,1,1,2,2,0,0,4,2,17
401377875,East Carolina Pirates,D. Green,4281047,,True,25.0,4,9,3,6,1,3,0,0,0,3,3,0,0,0,2,2,9
401377875,East Carolina Pirates,X. Josephs,4595926,,False,18.0,2,5,2,5,0,0,0,0,2,2,4,0,0,1,2,2,4
401377875,East Carolina Pirates,T. Chambers,4399229,,False,11.0,2,5,2,5,0,0,0,0,3,1,4,1,1,0,2,2,4
401377875,East Carolina Pirates,B. Franklin,4281305,,False,5.0,2,3,2,3,0,0,0,0,0,0,0,0,0,0,0,2,4
401377875,East Carolina Pirates,A. Rose,4703643,,False,19.0,0,3,0,1,0,2,2,2,0,3,3,1,1,0,1,3,2
401377875,East Carolina Pirates,M. Moseley,4703642,,False,13.0,0,1,0,1,0,0,2,2,0,1,1,0,0,0,1,0,2
401377875,East Carolina Pirates,D. Mcneal,4433314,,False,14.0,1,8,1,7,0,1,0,0,0,2,2,1,2,0,0,1,2
401377875,East Carolina Pirates,TEAM,TOTAL,TOTAL,False,,19,63,15,45,4,18,11,14,18,20,38,10,8,3,15,23,53
401377874,UCF Knights,B. Smith,4399030,,True,30.0,5,12,5,12,0,0,2,4,7,7,14,2,3,0,3,2,12
401377874,UCF Knights,M. Kaba,4281099,,True,20.0,4,10,4,10,0,0,0,0,2,2,4,0,2,2,2,4,8
401377874,UCF Knights,T. Sanders,4594539,,True,21.0,0,8,0,6,0,2,4,4,1,1,2,1,1,0,2,0,4
401377874,UCF Knights,D. Battles,4399028,,True,30.0,5,11,5,11,0,0,4,4,1,0,1,1,3,0,1,2,14
401377874,UCF Knights,S. Meertens,4281294,,True,22.0,0,3,0,3,0,0,0,0,0,3,3,1,0,0,0,1,0
401377874,UCF Knights,D. Thomas,4594542,,False,30.0,5,8,5,8,0,0,4,5,6,5,11,0,2,0,1,3,14
401377874,UCF Knights,A. Burney,4594541,,False,14.0,0,4,0,1,0,3,0,0,0,0,0,0,1,0,0,0,0
401377874,UCF Knights,A. Lewis,4594397,,False,33.0,3,5,0,1,3,4,0,0,0,1,1,7,2,0,2,0,9
401377874,UCF Knights,TEAM,TOTAL,TOTAL,False,,22,61,19,52,3,9,14,17,19,22,41,12,14,2,11,12,61
401377874,Tulsa Golden Hurricane,T. Poindexter,4898634,,True,30.0,7,16,3,7,4,9,0,0,1,1,2,1,0,0,2,5,18
401377874,Tulsa Golden Hurricane,D. Crawford,4898637,,True,40.0,1,6,0,2,1,4,0,2,2,1,3,5,1,0,3,3,3
401377874,Tulsa Golden Hurricane,W. Mayberry,4703707,,True,40.0,5,11,1,5,4,6,1,2,2,2,4,2,1,0,1,2,15
401377874,Tulsa Golden Hurricane,M. Bittle,4399250,,True,38.0,3,8,1,3,2,5,2,2,0,4,4,1,3,0,3,4,10
401377874,Tulsa Golden Hurricane,R. Lescay,4281104,,True,27.0,1,4,1,4,0,0,0,0,2,4,6,4,2,0,7,4,2
401377874,Tulsa Golden Hurricane,J. Evans,4703708,,False,19.0,0,3,0,1,0,2,0,0,1,1,2,2,0,0,1,2,0
401377874,Tulsa Golden Hurricane,O. Clayton,4703705,,False,2.0,0,0,0,0,0,0,0,0,0,0,0,0,0,0,1,0,0
401377874,Tulsa Golden Hurricane,M. Washington,4281835,,False,4.0,0,1,0,1,0,0,0,0,0,0,0,0,1,0,0,0,0
401377874,Tulsa Golden Hurricane,TEAM,TOTAL,TOTAL,False,,17,49,6,23,11,26,3,6,9,22,31,15,8,0,20,20,48
401377873,Temple Owls,K. Wood,4898656,,True,16.0,1,2,1,2,0,0,0,0,1,2,3,0,1,1,1,0,2
401377873,Temple Owls,M. Davis,4281116,,True,34.0,6,12,5,9,1,3,8,9,1,9,10,1,2,0,1,2,21
401377873,Temple Owls,A. Gourdine,4898655,,True,29.0,4,12,3,7,1,5,4,5,0,5,5,4,3,1,1,3,13
401377873,Temple Owls,T. East,4691699,,True,25.0,0,2,0,1,0,1,0,0,0,1,1,1,1,1,2,1,0
401377873,Temple Owls,E. Mayo,4281115,,True,28.0,2,5,1,2,1,3,2,2,2,2,4,0,1,0,1,0,7
401377873,Temple Owls,C. Perea,4703754,,False,7.0,0,1,0,0,0,1,0,0,0,0,0,0,0,0,0,1,0
401377873,Temple Owls,A. Williamson,4399244,,False,16.0,2,5,2,5,0,0,1,2,1,4,5,1,3,0,0,1,5
401377873,Temple Owls,S. Taylor,4068165,,False,8.0,1,1,1,1,0,0,0,0,1,0,1,0,0,0,0,0,2
401377873,Temple Owls,M. Waleed,4898654,,False,1.0,0,0,0,0,0,0,0,0,0,0,0,0,0,0,0,0,0
401377873,Temple Owls,J. Clinton,4703686,,False,27.0,2,7,2,5,0,2,2,2,1,2,3,2,0,0,4,0,6
401377873,Temple Owls,J. Holmes,4281490,,False,9.0,0,3,0,3,0,0,0,0,1,0,1,1,0,0,1,0,0
401377873,Temple Owls,TEAM,TOTAL,TOTAL,False,,18,50,15,35,3,15,17,20,10,27,37,10,11,3,13,8,56
401377873,SMU Mustangs,D. Sanderlin,4282048,,True,20.0,2,7,2,7,0,0,0,0,0,0,0,2,1,0,0,4,4
401377873,SMU Mustangs,S. Wilkinson,4281175,,True,39.0,6,16,6,16,0,0,0,0,2,4,6,3,1,1,1,2,12
401377873,SMU Mustangs,R. Bradley,4433337,,True,20.0,1,3,1,3,0,0,1,1,0,4,4,1,1,1,3,2,3
401377873,SMU Mustangs,K. White,4399236,,True,27.0,3,12,3,12,0,0,0,0,2,4,6,0,1,0,2,0,6
401377873,SMU Mustangs,J. Smith,6961,,True,32.0,1,1,1,1,0,0,2,2,0,1,1,3,0,2,1,1,4
401377873,SMU Mustangs,P. Bayliss,4399232,,False,1.0,0,0,0,0,0,0,0,0,0,0,0,0,0,0,0,0,0
401377873,SMU Mustangs,Z. Rufus,4898628,,False,9.0,0,0,0,0,0,0,0,0,1,0,1,0,0,1,1,2,0
401377873,SMU Mustangs,D. Mathis,4594529,,False,2.0,0,1,0,0,0,1,0,0,0,0,0,0,0,0,0,1,0
401377873,SMU Mustangs,S. Wiggins,4281805,,False,33.0,6,13,5,10,1,3,1,2,1,2,3,6,1,0,3,2,14
401377873,SMU Mustangs,K. Warthen,4281256,,False,17.0,2,7,2,6,0,1,1,2,4,3,7,1,2,0,0,0,5
401377873,SMU Mustangs,TEAM,TOTAL,TOTAL,False,,21,60,20,55,1,5,5,7,10,23,33,16,7,5,12,14,48
401377872,South Florida Bulls,B. Mununga,4594533,,True,28.0,6,13,6,12,0,1,4,4,5,5,10,3,3,0,0,3,16
401377872,South Florida Bulls,S. Leverett,4068149,,True,22.0,0,1,0,1,0,0,0,0,0,2,2,0,1,1,0,2,0
401377872,South Florida Bulls,E. Tsineke,4594531,,True,28.0,7,11,6,9,1,2,3,3,0,1,1,5,0,0,3,2,18
401377872,South Florida Bulls,E. Pinzan,4399238,,True,30.0,2,4,1,2,1,2,0,0,0,6,6,4,1,0,1,0,5
401377872,South Florida Bulls,S. Harvey,4399237,,True,18.0,0,3,0,1,0,2,1,2,1,3,4,2,0,1,2,3,1
401377872,South Florida Bulls,P. Williams,4898406,,False,8.0,1,2,1,2,0,0,0,0,1,1,2,0,1,0,0,3,2
401377872,South Florida Bulls,O. Betancourt,4898405,,False,3.0,0,0,0,0,0,0,0,0,0,1,1,0,1,0,0,1,0
401377872,South Florida Bulls,D. Fankam Mendjiadeu,4594527,,False,15.0,4,8,4,8,0,0,0,0,2,0,2,1,1,0,2,2,8
401377872,South Florida Bulls,A. Wilson,4433388,,False,8.0,1,2,0,1,1,1,0,0,0,1,1,0,0,0,1,0,3
401377872,South Florida Bulls,C. Bermejo,4594532,,False,4.0,0,0,0,0,0,0,0,0,0,0,0,0,0,0,1,1,0
401377872,South Florida Bulls,B. Weary,4898407,,False,3.0,0,1,0,1,0,0,0,0,0,0,0,0,0,0,2,1,0
401377872,South Florida Bulls,S. Guerreiro,4703675,,False,9.0,2,4,2,4,0,0,0,0,0,0,0,1,0,0,0,0,4
401377872,South Florida Bulls,M. Lazic,4594530,,False,3.0,0,0,0,0,0,0,0,0,0,0,0,0,0,0,0,0,0
401377872,South Florida Bulls,M. Alvarez,4432987,,False,21.0,4,5,1,2,3,3,3,4,0,3,3,1,0,0,3,1,14
401377872,South Florida Bulls,TEAM,TOTAL,TOTAL,False,,27,54,21,43,6,11,11,13,10,31,41,17,8,2,17,19,71
401377872,Houston Cougars,B. Patterson,4433360,,True,19.0,1,5,1,2,0,3,1,2,0,0,0,0,0,0,0,2,3
401377872,Houston Cougars,T. Hill,4399017,,True,21.0,1,2,1,2,0,0,0,0,3,7,10,1,2,0,1,1,2
401377872,Houston Cougars,L. Blair,4433451,,True,22.0,2,10,2,9,0,1,2,2,0,1,1,1,0,0,2,3,6
401377872,Houston Cougars,B. Onyeje,4399029,,True,19.0,1,7,0,2,1,5,1,2,3,3,6,1,2,0,1,3,4
401377872,Houston Cougars,J. Blackshell-Fair,4281088,,True,22.0,2,4,2,4,0,0,4,4,2,1,3,1,0,0,1,1,8
401377872,Houston Cougars,T. Nard,4898623,,False,9.0,0,2,0,1,0,1,0,0,0,1,1,0,0,0,2,1,0
401377872,Houston Cougars,K. Jones,4703658,,False,12.0,0,2,0,2,0,0,0,2,0,0,0,0,0,0,1,2,0
401377872,Houston Cougars,F. Diagne,4281281,,False,4.0,0,0,0,0,0,0,1,2,0,1,1,0,0,0,1,1,1
401377872,Houston Cougars,J. Lewis,4433111,,False,15.0,3,7,3,7,0,0,1,3,1,1,2,0,0,0,3,1,7
401377872,Houston Cougars,K. Brown,4898622,,False,6.0,0,1,0,1,0,0,0,0,0,0,0,0,0,0,1,1,0
401377872,Houston Cougars,A. Thompson,4704516,,False,6.0,0,0,0,0,0,0,0,4,0,1,1,0,1,0,0,0,0
401377872,Houston Cougars,T. Young,4433298,,False,19.0,0,4,0,3,0,1,0,2,0,1,1,1,1,0,2,1,0
401377872,Houston Cougars,E. Sidney,4398990,,False,26.0,2,5,1,2,1,3,2,4,0,1,1,2,2,0,1,2,7
401377872,Houston Cougars,TEAM,TOTAL,TOTAL,False,,12,49,10,35,2,14,12,27,11,18,29,7,8,0,17,19,38
401376495,St. Francis (PA) Red Flash,J. Dapaa,4399593,,True,38.0,6,11,6,11,0,0,1,2,4,8,12,3,3,0,2,4,13
401376495,St. Francis (PA) Red Flash,S. Miller,4595816,,True,21.0,1,5,1,5,0,0,2,2,0,1,1,1,1,0,0,3,4
401376495,St. Francis (PA) Red Flash,K. Maxwell,4705076,,True,32.0,5,11,4,9,1,2,0,0,4,2,6,0,1,0,3,2,11
401376495,St. Francis (PA) Red Flash,L. Benzel,4399592,,True,28.0,0,1,0,0,0,1,0,0,0,0,0,2,0,0,4,1,0
401376495,St. Francis (PA) Red Flash,J. McLemore,4399196,,True,33.0,0,5,0,4,0,1,2,2,0,2,2,2,1,0,6,2,2
401376495,St. Francis (PA) Red Flash,A. Moore,4705077,,False,20.0,2,4,2,4,0,0,1,2,3,7,10,0,1,0,2,1,5
401376495,St. Francis (PA) Red Flash,K. Kovac,4399594,,False,1.0,0,0,0,0,0,0,0,0,0,0,0,0,0,0,0,0,0
401376495,St. Francis (PA) Red Flash,D. Allen,4705074,,False,4.0,0,0,0,0,0,0,0,0,0,2,2,0,0,0,1,1,0
401376495,St. Francis (PA) Red Flash,J. Mastellone,4282018,,False,23.0,5,10,5,9,0,1,3,3,0,2,2,1,1,1,3,3,13
401376495,St. Francis (PA) Red Flash,TEAM,TOTAL,TOTAL,False,,19,47,18,42,1,5,9,11,11,25,36,9,8,1,24,17,48
401376495,Mount St. Mary's Mountaineers,I. Hunt,4704996,,True,22.0,2,7,2,7,0,0,0,0,3,3,6,1,2,0,1,3,4
401376495,Mount St. Mary's Mountaineers,J. Tomasetti,4704999,,True,22.0,1,3,1,2,0,1,1,2,1,1,2,2,0,0,0,1,3
401376495,Mount St. Mary's Mountaineers,M. Harrison,4399572,,True,33.0,4,12,2,8,2,4,0,0,0,1,1,0,3,0,1,1,10
401376495,Mount St. Mary's Mountaineers,K. Agentowicz,4069294,,True,30.0,4,9,2,4,2,5,0,0,1,2,3,1,3,0,3,3,10
401376495,Mount St. Mary's Mountaineers,K. Bresee,4068556,,True,31.0,4,10,3,5,1,5,7,10,1,5,6,3,3,0,2,2,16
401376495,Mount St. Mary's Mountaineers,T. Borgosz,4281491,,False,18.0,1,4,1,4,0,0,0,0,0,0,0,0,0,0,2,2,2
401376495,Mount St. Mary's Mountaineers,J. Lee,4704997,,False,20.0,2,4,2,3,0,1,0,0,1,1,2,0,1,1,2,3,4
401376495,Mount St. Mary's Mountaineers,A. Taylor,4281983,,False,24.0,3,7,2,3,1,4,5,6,1,0,1,2,1,1,1,1,12
401376495,Mount St. Mary's Mountaineers,TEAM,TOTAL,TOTAL,False,,21,56,15,36,6,20,13,18,12,17,29,9,13,2,12,16,61
401376486,St. Francis Brooklyn Terriers,A. Lassen,4282034,,True,33.0,9,19,9,19,0,0,3,4,4,2,6,1,0,4,0,0,21
401376486,St. Francis Brooklyn Terriers,F. Horvath,4705057,,True,33.0,9,14,6,8,3,6,1,2,4,7,11,2,0,0,1,1,22
401376486,St. Francis Brooklyn Terriers,A. Fisher,4595797,,True,31.0,5,11,1,4,4,7,0,0,1,4,5,1,3,0,1,0,14
401376486,St. Francis Brooklyn Terriers,N. Dimitrijevic,4595796,,True,30.0,1,6,0,1,1,5,2,2,0,6,6,4,1,1,3,0,5
401376486,St. Francis Brooklyn Terriers,K. Edwards,4399597,,True,31.0,3,7,2,6,1,1,0,1,0,3,3,2,0,0,1,1,7
401376486,St. Francis Brooklyn Terriers,S. Bandoma,4900504,,False,3.0,0,1,0,1,0,0,0,0,0,0,0,0,0,0,0,0,0
401376486,St. Francis Brooklyn Terriers,Z. Hutchinson,4705058,,False,2.0,0,0,0,0,0,0,0,0,0,0,0,0,0,0,0,0,0
401376486,St. Francis Brooklyn Terriers,S. Kavanagh,4900503,,False,1.0,0,1,0,0,0,1,0,0,0,0,0,0,0,0,0,0,0
401376486,St. Francis Brooklyn Terriers,E. Varga,4705060,,False,8.0,0,0,0,0,0,0,0,0,0,0,0,2,0,0,0,2,0
401376486,St. Francis Brooklyn Terriers,J. McMillan,4595800,,False,1.0,0,0,0,0,0,0,0,0,0,0,0,0,0,0,1,0,0
401376486,St. Francis Brooklyn Terriers,I. Posset,4399577,,False,27.0,1,4,1,2,0,2,0,0,0,2,2,6,1,0,3,4,2
401376486,St. Francis Brooklyn Terriers,TEAM,TOTAL,TOTAL,False,,28,63,19,41,9,22,6,9,12,28,40,18,5,5,11,8,71
401376486,Central Connecticut Blue Devils,C. Sutherland-Case,4595721,,True,21.0,2,4,2,4,0,0,0,0,1,2,3,1,0,0,0,1,4
401376486,Central Connecticut Blue Devils,E. Nibbelink,4282061,,True,23.0,2,8,2,5,0,3,0,0,1,4,5,1,0,0,0,2,4
401376486,Central Connecticut Blue Devils,A. Berube,4281958,,True,33.0,9,18,8,16,1,2,1,2,3,7,10,1,0,5,2,1,20
401376486,Central Connecticut Blue Devils,D. Jenkins,4595718,,True,33.0,3,8,2,5,1,3,2,2,0,2,2,3,2,0,0,1,9
401376486,Central Connecticut Blue Devils,F. Toppin,4399543,,True,25.0,1,5,1,5,0,0,2,4,0,1,1,4,1,2,2,2,4
401376486,Central Connecticut Blue Devils,M. Kenefick,4704142,,False,17.0,4,7,1,3,3,4,0,0,1,2,3,1,1,0,0,0,11
401376486,Central Connecticut Blue Devils,C. Reynolds,4399542,,False,7.0,0,0,0,0,0,0,0,0,0,0,0,1,0,0,0,0,0
401376486,Central Connecticut Blue Devils,N. Davy,4900600,,False,7.0,0,0,0,0,0,0,0,0,0,0,0,0,0,1,1,1,0
401376486,Central Connecticut Blue Devils,A. Williams,4900598,,False,9.0,0,2,0,1,0,1,0,0,1,1,2,0,0,0,2,0,0
401376486,Central Connecticut Blue Devils,B. Lanpher,4704961,,False,25.0,3,11,1,6,2,5,2,2,2,1,3,3,2,0,1,3,10
401376486,Central Connecticut Blue Devils,TEAM,TOTAL,TOTAL,False,,24,63,17,45,7,18,7,10,11,21,32,15,6,8,9,11,62
401376477,Sacred Heart Pioneers,M. Bergdorf,4900507,,True,33.0,1,2,1,2,0,0,2,2,4,10,14,0,1,2,0,4,4
401376477,Sacred Heart Pioneers,O. Tucker,4594799,,True,32.0,0,8,0,6,0,2,2,2,1,0,1,2,0,0,3,2,2
401376477,Sacred Heart Pioneers,A. Hagood,4282006,,True,33.0,4,9,3,5,1,4,4,4,1,1,2,1,0,0,2,2,13
401376477,Sacred Heart Pioneers,A. McCray,4282005,,True,22.0,0,2,0,2,0,0,2,4,2,3,5,1,0,0,1,4,2
401376477,Sacred Heart Pioneers,N. Johnson,4068964,,True,18.0,1,6,1,4,0,2,0,0,2,2,4,0,0,0,3,0,2
401376477,Sacred Heart Pioneers,K. Wood,4705033,,False,10.0,2,4,2,4,0,0,1,2,1,1,2,0,0,1,1,2,5
401376477,Sacred Heart Pioneers,C. Stroemel,4595782,,False,10.0,2,4,2,4,0,0,1,1,1,0,1,1,1,0,0,3,5
401376477,Sacred Heart Pioneers,A. Owusu-Mensah,4900506,,False,3.0,0,2,0,2,0,0,0,0,0,0,0,0,0,0,0,0,0
401376477,Sacred Heart Pioneers,A. Porter,4705032,,False,3.0,0,0,0,0,0,0,0,0,0,0,0,0,0,0,0,0,0
401376477,Sacred Heart Pioneers,S. Smith,4595781,,False,30.0,5,13,5,10,0,3,3,3,0,2,2,1,3,0,2,1,13
401376477,Sacred Heart Pioneers,M. Klein,4399374,,False,3.0,0,3,0,1,0,2,0,0,0,0,0,0,0,0,0,0,0
401376477,Sacred Heart Pioneers,W. Jackson,4399144,,False,3.0,1,1,1,1,0,0,0,0,0,0,0,0,0,0,0,0,2
401376477,Sacred Heart Pioneers,TEAM,TOTAL,TOTAL,False,,16,54,15,41,1,13,15,18,14,22,36,6,5,3,13,18,48
401376477,Fairleigh Dickinson Knights,C. Wilson,4704968,,True,28.0,3,9,3,9,0,0,2,2,0,4,4,1,0,1,3,3,8
401376477,Fairleigh Dickinson Knights,M. Stanley,4281968,,True,35.0,8,16,7,12,1,4,7,8,3,5,8,2,0,1,0,3,24
401376477,Fairleigh Dickinson Knights,D. Scott,4704967,,True,19.0,0,5,0,4,0,1,0,0,1,1,2,2,1,0,0,1,0
401376477,Fairleigh Dickinson Knights,A. Bell,4595726,,True,27.0,4,6,2,3,2,3,1,2,1,4,5,3,0,0,0,1,11
401376477,Fairleigh Dickinson Knights,M. Selvaggi,4399552,,True,19.0,0,1,0,1,0,0,0,0,1,2,3,5,2,0,2,3,0
401376477,Fairleigh Dickinson Knights,M. Mahoney,4900589,,False,2.0,1,1,1,1,0,0,0,0,0,1,1,0,0,0,0,0,2
401376477,Fairleigh Dickinson Knights,M. Elebring,4900587,,False,2.0,0,0,0,0,0,0,0,0,0,0,0,1,0,0,0,0,0
401376477,Fairleigh Dickinson Knights,S. DeAngelo,4595727,,False,8.0,0,4,0,3,0,1,0,0,1,0,1,1,0,0,1,0,0
401376477,Fairleigh Dickinson Knights,A. McGinn,4900588,,False,2.0,0,0,0,0,0,0,0,0,0,0,0,0,0,0,0,0,0
401376477,Fairleigh Dickinson Knights,T. Crystian,4704966,,False,3.0,0,1,0,1,0,0,0,0,0,0,0,0,0,0,0,0,0
401376477,Fairleigh Dickinson Knights,A. Conklin,4704965,,False,3.0,1,2,1,2,0,0,0,0,0,0,0,0,0,0,0,0,2
401376477,Fairleigh Dickinson Knights,D. Forgues,4595763,,False,20.0,4,7,1,1,3,6,1,2,0,1,1,0,1,0,1,1,12
401376477,Fairleigh Dickinson Knights,C. Carbonell,4595723,,False,8.0,0,1,0,1,0,0,0,0,0,0,0,0,0,0,1,1,0
401376477,Fairleigh Dickinson Knights,R. Niles,4399550,,False,24.0,2,5,0,0,2,5,0,0,2,2,4,2,0,0,1,2,6
401376477,Fairleigh Dickinson Knights,TEAM,TOTAL,TOTAL,False,,23,58,15,38,8,20,11,14,14,25,39,17,4,2,10,15,65
401376424,Long Island University Sharks,M. Perkins,4595744,,True,6.0,0,0,0,0,0,0,0,0,0,0,0,0,0,0,0,1,0
401376424,Long Island University Sharks,A. Flynn,4400230,,True,23.0,1,6,1,5,0,1,1,2,1,5,6,0,0,2,2,1,3
401376424,Long Island University Sharks,E. O'Brien,4900516,,True,34.0,3,12,1,3,2,9,1,4,1,1,2,0,4,0,4,3,9
401376424,Long Island University Sharks,B. Thomas,4399567,,True,36.0,7,20,7,15,0,5,3,3,4,5,9,3,3,0,6,3,17
401376424,Long Island University Sharks,K. Taylor,4399337,,True,18.0,3,3,3,3,0,0,0,0,1,1,2,2,0,1,2,3,6
401376424,Long Island University Sharks,K. Bell,4399563,,False,16.0,1,4,1,4,0,0,0,0,4,4,8,1,0,0,3,2,2
401376424,Long Island University Sharks,T. Eke,4900521,,False,11.0,1,1,1,1,0,0,0,0,0,1,1,0,1,0,1,0,2
401376424,Long Island University Sharks,D. Carter,4705111,,False,4.0,0,1,0,0,0,1,0,0,0,0,0,0,1,0,0,0,0
401376424,Long Island University Sharks,T. Copeland,4900520,,False,4.0,0,0,0,0,0,0,0,0,1,1,2,0,0,0,0,1,0
401376424,Long Island University Sharks,D. Grim,4900518,,False,22.0,2,4,1,2,1,2,0,0,0,1,1,0,1,0,0,0,5
401376424,Long Island University Sharks,Z. Hache,4705108,,False,17.0,2,7,2,5,0,2,0,0,4,2,6,1,2,0,1,3,4
401376424,Long Island University Sharks,C. Gray,4399564,,False,9.0,0,0,0,0,0,0,0,0,0,0,0,0,1,0,0,0,0
401376424,Long Island University Sharks,TEAM,TOTAL,TOTAL,False,,20,58,17,38,3,20,5,9,18,27,45,7,13,3,20,17,48
401376424,Bryant Bulldogs,M. Planes Fortuny,4705424,,True,32.0,5,13,5,13,0,0,1,2,1,5,6,0,3,1,1,1,11
401376424,Bryant Bulldogs,B. Bjelko,4281950,,True,31.0,1,5,1,5,0,0,2,2,3,3,6,1,1,1,3,2,4
401376424,Bryant Bulldogs,F. Jallow,4705425,,True,40.0,4,13,2,6,2,7,4,6,0,3,3,2,1,1,4,3,14
401376424,Bryant Bulldogs,L. Castagne,4705423,,True,32.0,3,4,1,2,2,2,0,0,1,6,7,1,2,1,3,2,8
401376424,Bryant Bulldogs,N. Gallagher,4595707,,True,25.0,0,3,0,2,0,1,0,0,0,1,1,2,0,0,3,3,0
401376424,Bryant Bulldogs,J. Golden,4705426,,False,15.0,0,3,0,3,0,0,0,0,2,0,2,1,4,0,0,2,0
401376424,Bryant Bulldogs,K. Reynolds,4705227,,False,1.0,0,0,0,0,0,0,0,0,0,0,0,0,0,0,1,0,0
401376424,Bryant Bulldogs,A. Perkins,4595703,,False,24.0,3,9,1,3,2,6,2,2,0,1,1,1,1,0,2,0,10
401376424,Bryant Bulldogs,TEAM,TOTAL,TOTAL,False,,16,50,10,34,6,16,9,12,8,21,29,8,12,4,17,13,47
401376408,Princeton Tigers,E. Mitchell,4594957,,True,30.0,1,3,1,3,0,0,0,0,3,7,10,3,1,2,0,3,2
401376408,Princeton Tigers,K. Chen,4899328,,True,33.0,5,10,5,9,0,1,1,2,3,2,5,6,1,0,1,2,11
401376408,Princeton Tigers,J. Cunningham,4399194,,True,31.0,4,10,3,8,1,2,4,4,2,4,6,1,2,0,3,2,13
401376408,Princeton Tigers,G. Stone,4399190,,True,31.0,6,12,4,9,2,3,2,2,2,2,4,3,2,0,0,2,16
401376408,Princeton Tigers,A. Meyers,4281402,,True,32.0,9,23,7,15,2,8,0,0,4,4,8,3,1,0,3,1,20
401376408,Princeton Tigers,K. Thiers,4899331,,False,2.0,0,0,0,0,0,0,0,0,0,0,0,0,0,0,0,0,0
401376408,Princeton Tigers,P. Hill,4682991,,False,1.0,0,0,0,0,0,0,0,0,0,1,1,0,0,0,0,1,0
401376408,Princeton Tigers,L. Weger,4399195,,False,3.0,0,1,0,1,0,0,0,0,0,0,0,0,0,0,1,0,0
401376408,Princeton Tigers,C. Nweke,4899329,,False,14.0,1,4,1,3,0,1,0,0,1,2,3,1,1,1,0,1,2
401376408,Princeton Tigers,A. Osgood,4899330,,False,2.0,0,0,0,0,0,0,0,0,0,1,1,0,0,0,0,0,0
401376408,Princeton Tigers,M. Plank,4594958,,False,5.0,1,2,1,1,0,1,0,0,0,1,1,0,0,1,0,1,2
401376408,Princeton Tigers,A. Nwokeji,4575702,,False,2.0,0,1,0,1,0,0,0,0,0,0,0,0,0,0,0,0,0
401376408,Princeton Tigers,M. Connolly,4399192,,False,14.0,1,1,0,0,1,1,0,0,0,1,1,0,2,0,1,1,3
401376408,Princeton Tigers,TEAM,TOTAL,TOTAL,False,,28,67,22,50,6,17,7,8,18,28,46,17,10,4,10,14,69
401376408,Pennsylvania Quakers,K. Suttle,4399185,,True,29.0,0,5,0,4,0,1,2,2,4,2,6,1,3,0,2,3,2
401376408,Pennsylvania Quakers,J. Obi,4705226,,True,36.0,4,13,3,10,1,3,6,7,2,9,11,0,0,1,4,2,15
401376408,Pennsylvania Quakers,K. Padilla,4599972,,True,38.0,4,13,2,9,2,4,2,2,2,1,3,3,2,0,4,1,12
401376408,Pennsylvania Quakers,M. McGurk,4599968,,True,13.0,0,0,0,0,0,0,0,0,0,1,1,1,0,0,0,0,0
401376408,Pennsylvania Quakers,M. Lakstigala,4399188,,True,33.0,3,11,1,4,2,7,2,2,1,0,1,1,0,0,2,1,10
401376408,Pennsylvania Quakers,F. Parker,4599969,,False,1.0,0,0,0,0,0,0,0,2,1,0,1,0,0,0,0,0,0
401376408,Pennsylvania Quakers,S. Milliman,4599971,,False,13.0,0,2,0,1,0,1,0,0,3,2,5,1,1,4,0,1,0
401376408,Pennsylvania Quakers,L. Groetsch,4899323,,False,2.0,0,0,0,0,0,0,0,0,0,0,0,0,0,0,0,0,0
401376408,Pennsylvania Quakers,S. Almqvist,4899321,,False,6.0,0,1,0,1,0,0,0,0,0,1,1,0,0,0,2,1,0
401376408,Pennsylvania Quakers,M. Papazoglou,4899320,,False,5.0,0,1,0,1,0,0,0,0,0,0,0,0,0,0,0,0,0
401376408,Pennsylvania Quakers,M. Stanfield,4705228,,False,2.0,0,1,0,1,0,0,0,0,0,0,0,0,0,0,0,0,0
401376408,Pennsylvania Quakers,S. Caldwell,4433338,,False,17.0,1,4,1,3,0,1,2,2,0,3,3,0,1,0,1,3,4
401376408,Pennsylvania Quakers,M. Hair,4399187,,False,2.0,0,0,0,0,0,0,0,0,0,0,0,0,0,0,0,1,0
401376408,Pennsylvania Quakers,N. Kovacikova,4339900,,False,3.0,0,1,0,0,0,1,0,0,0,0,0,0,0,0,0,0,0
401376408,Pennsylvania Quakers,TEAM,TOTAL,TOTAL,False,,12,52,7,34,5,18,14,17,14,21,35,7,7,5,16,13,43
401376380,Cornell Big Red,S. Parker-Hall,4899288,,True,33.0,3,4,2,3,1,1,2,2,0,4,4,1,2,0,2,1,9
401376380,Cornell Big Red,T. Mbanefo,4399171,,True,30.0,5,12,5,12,0,0,0,0,2,5,7,3,0,3,4,1,10
401376380,Cornell Big Red,K. Ingram,4705218,,True,32.0,3,11,3,7,0,4,6,8,0,6,6,4,2,0,4,2,12
401376380,Cornell Big Red,A. McNicholas,4594968,,True,37.0,5,12,4,9,1,3,1,3,2,2,4,1,1,1,2,3,12
401376380,Cornell Big Red,S. Will,4399170,,True,27.0,2,4,2,3,0,1,0,0,0,3,3,0,0,0,0,3,4
401376380,Cornell Big Red,A. Hovis,4594969,,False,5.0,1,1,1,1,0,0,0,0,0,0,0,0,1,0,0,0,2
401376380,Cornell Big Red,M. Beam,4705216,,False,4.0,0,1,0,1,0,0,0,0,0,0,0,1,0,0,0,0,0
401376380,Cornell Big Red,KC Carter,4594971,,False,3.0,0,0,0,0,0,0,0,0,0,0,0,0,0,0,0,0,0
401376380,Cornell Big Red,S. Mulroy,4594970,,False,29.0,4,12,4,7,0,5,0,0,1,3,4,7,1,0,2,5,8
401376380,Cornell Big Red,TEAM,TOTAL,TOTAL,False,,23,57,21,43,2,14,9,13,6,25,31,17,7,4,16,15,57
401376380,Columbia Lions,N. Comesana,4899284,,True,15.0,2,4,2,4,0,0,0,0,1,1,2,1,2,0,0,4,4
401376380,Columbia Lions,K. Davis,4433382,,True,32.0,5,11,5,9,0,2,0,0,0,4,4,4,2,0,3,4,10
401376380,Columbia Lions,K. Henderson,4899283,,True,37.0,3,7,0,1,3,6,0,0,3,2,5,5,0,1,3,3,9
401376380,Columbia Lions,A. Hsu,4594973,,True,37.0,8,18,2,5,6,13,3,6,1,5,6,1,0,3,3,1,25
401376380,Columbia Lions,J. Patrick,4433322,,True,29.0,3,11,3,6,0,5,5,6,3,7,10,6,4,1,5,2,11
401376380,Columbia Lions,H. Pratt,4399165,,False,7.0,2,2,2,2,0,0,0,0,0,0,0,0,0,0,0,0,4
401376380,Columbia Lions,P. Lauder,4433491,,False,1.0,0,0,0,0,0,0,0,0,0,0,0,0,0,0,0,0,0
401376380,Columbia Lions,S. Durr,4399167,,False,16.0,1,4,1,3,0,1,1,2,0,3,3,1,0,0,0,2,3
401376380,Columbia Lions,C. Rivera,4594972,,False,19.0,1,2,0,0,1,2,0,0,0,2,2,2,0,0,0,5,3
401376380,Columbia Lions,M. Markham,4399166,,False,6.0,0,2,0,0,0,2,1,2,0,1,1,0,0,0,2,0,1
401376380,Columbia Lions,M. Hardy,4399163,,False,1.0,0,0,0,0,0,0,0,0,0,0,0,0,0,0,0,0,0
401376380,Columbia Lions,TEAM,TOTAL,TOTAL,False,,25,61,15,30,10,31,10,16,12,27,39,20,8,5,16,21,70
401376366,Yale Bulldogs,C. Emsbo,4399201,,True,32.0,6,13,6,13,0,0,8,9,6,8,14,1,2,3,5,2,20
401376366,Yale Bulldogs,A. Cade,4281399,,True,30.0,2,8,2,8,0,0,1,2,4,6,10,1,1,1,4,0,5
401376366,Yale Bulldogs,C. McCann,4899332,,True,32.0,3,8,0,0,3,8,2,2,1,1,2,4,0,0,2,2,11
401376366,Yale Bulldogs,K. Astrom,4594955,,True,26.0,2,5,1,2,1,3,0,0,0,2,2,4,1,0,0,4,5
401376366,Yale Bulldogs,J. Clark,4594954,,True,39.0,4,13,1,6,3,7,0,0,2,10,12,4,3,0,3,3,11
401376366,Yale Bulldogs,B. McDonald,4899337,,False,5.0,0,1,0,1,0,0,0,0,1,2,3,0,0,0,1,0,0
401376366,Yale Bulldogs,G. Thybulle,4899336,,False,5.0,3,3,3,3,0,0,2,2,2,0,2,0,0,0,1,1,8
401376366,Yale Bulldogs,M. Egger,4899338,,False,7.0,0,2,0,1,0,1,0,0,0,0,0,0,0,0,1,1,0
401376366,Yale Bulldogs,E. van der Maas,4899335,,False,4.0,0,0,0,0,0,0,0,0,0,0,0,0,0,0,0,0,0
401376366,Yale Bulldogs,A. Lee,4899333,,False,11.0,1,3,1,1,0,2,0,1,0,0,0,1,0,0,0,3,2
401376366,Yale Bulldogs,R. Gallagher,4399203,,False,9.0,1,2,1,2,0,0,0,0,0,1,1,2,0,0,1,0,2
401376366,Yale Bulldogs,TEAM,TOTAL,TOTAL,False,,22,58,15,37,7,21,13,16,17,30,47,17,7,4,18,16,64
401376366,Brown Bears,A. Latkany,4899281,,True,20.0,0,3,0,1,0,2,0,0,1,1,2,0,1,0,1,0,0
401376366,Brown Bears,M. Murray,4705210,,True,12.0,1,1,0,0,1,1,1,2,0,4,4,0,1,2,0,4,4
401376366,Brown Bears,A. Ducharme,4399158,,True,32.0,4,9,3,6,1,3,1,2,1,4,5,1,0,1,4,1,10
401376366,Brown Bears,I. Mauricio,4899277,,True,39.0,3,15,2,7,1,8,2,2,0,2,2,6,2,0,3,1,9
401376366,Brown Bears,K. Jones,4705206,,True,40.0,6,15,6,13,0,2,5,9,2,2,4,4,4,0,4,2,17
401376366,Brown Bears,D. Short,4594977,,False,13.0,0,0,0,0,0,0,0,0,1,1,2,0,4,0,0,1,0
401376366,Brown Bears,G. Aiello,4899279,,False,16.0,1,3,1,3,0,0,1,1,0,4,4,0,1,1,2,3,3
401376366,Brown Bears,M. Mullin,4399160,,False,28.0,2,8,0,1,2,7,0,0,0,0,0,0,1,0,0,0,6
401376366,Brown Bears,TEAM,TOTAL,TOTAL,False,,17,54,12,31,5,23,10,16,9,21,30,11,14,4,14,12,49
401375818,Utah Tech Trailblazers,A. Papa,4900107,,True,30.0,3,3,3,3,0,0,1,3,1,3,4,1,0,1,0,4,7
401375818,Utah Tech Trailblazers,E. Isaacson,4602913,,True,40.0,5,11,1,2,4,9,0,0,0,3,3,1,2,0,1,2,14
401375818,Utah Tech Trailblazers,Mac. Warren,4900106,,True,30.0,2,4,1,1,1,3,0,0,0,2,2,0,0,0,3,2,5
401375818,Utah Tech Trailblazers,B. Gillen,4602911,,True,37.0,4,10,3,7,1,3,1,4,3,6,9,7,1,0,5,2,10
401375818,Utah Tech Trailblazers,S. Davison,4281704,,True,22.0,4,8,1,2,3,6,0,2,0,5,5,6,1,0,5,5,11
401375818,Utah Tech Trailblazers,B. Vance,4703956,,False,7.0,0,1,0,0,0,1,0,0,0,0,0,0,0,0,2,0,0
401375818,Utah Tech Trailblazers,M. McCord,4602915,,False,31.0,4,9,1,2,3,7,1,2,2,3,5,1,0,0,2,4,12
401375818,Utah Tech Trailblazers,T. Sireni,4595648,,False,3.0,0,0,0,0,0,0,0,0,0,0,0,0,0,0,1,0,0
401375818,Utah Tech Trailblazers,TEAM,TOTAL,TOTAL,False,,22,46,10,17,12,29,3,11,7,24,31,16,4,1,20,19,59
401375818,Grand Canyon Lopes,K. Shorts,4400116,,True,13.0,1,1,1,1,0,0,0,1,0,2,2,0,0,1,0,3,2
401375818,Grand Canyon Lopes,J. Powell-Smith,4899517,,True,16.0,3,8,3,7,0,1,4,4,0,2,2,0,0,0,1,4,10
401375818,Grand Canyon Lopes,C. Akin-Otiko,4705636,,True,10.0,0,1,0,0,0,1,0,0,1,3,4,0,0,0,0,0,0
401375818,Grand Canyon Lopes,Tiar. Brown,4705634,,True,21.0,3,7,3,7,0,0,8,8,3,1,4,1,0,1,2,4,14
401375818,Grand Canyon Lopes,A. Graham,4068788,,True,35.0,0,5,0,2,0,3,4,4,0,2,2,3,0,0,0,0,4
401375818,Grand Canyon Lopes,J. McChristine,4899523,,False,22.0,0,4,0,4,0,0,0,0,5,3,8,1,4,1,3,0,0
401375818,Grand Canyon Lopes,D. Phillips,4899519,,False,17.0,5,12,4,9,1,3,0,0,4,1,5,0,1,0,0,1,11
401375818,Grand Canyon Lopes,N. Evans,4899524,,False,6.0,0,2,0,1,0,1,0,0,0,0,0,0,2,0,0,0,0
401375818,Grand Canyon Lopes,Tian. Brown,4595892,,False,30.0,5,13,2,3,3,10,0,0,1,3,4,2,2,0,1,3,13
401375818,Grand Canyon Lopes,N. Jackson,4068111,,False,4.0,0,1,0,1,0,0,0,0,0,0,0,1,0,0,0,0,0
401375818,Grand Canyon Lopes,K. Flowers,4899522,,False,26.0,3,7,1,3,2,4,3,4,2,5,7,2,2,0,2,2,11
401375818,Grand Canyon Lopes,TEAM,TOTAL,TOTAL,False,,20,61,14,38,6,23,19,21,16,22,38,10,11,3,10,17,65
401375817,Lamar Cardinals,A. Davis,4899516,,True,28.0,3,9,3,9,0,0,4,4,5,2,7,0,1,1,5,2,10
401375817,Lamar Cardinals,A. Gibbs,4704878,,True,17.0,0,3,0,1,0,2,2,2,0,4,4,0,0,0,2,1,2
401375817,Lamar Cardinals,S. Dean,4704875,,True,20.0,3,3,2,2,1,1,1,2,1,0,1,2,1,0,0,2,8
401375817,Lamar Cardinals,K. Mitchell,4595698,,True,24.0,3,7,0,2,3,5,0,0,0,1,1,3,1,0,2,4,9
401375817,Lamar Cardinals,A. Hastings,4400297,,True,22.0,2,9,0,5,2,4,0,0,0,0,0,2,2,0,3,1,6
401375817,Lamar Cardinals,N. Weems,4899515,,False,23.0,2,5,2,5,0,0,0,2,3,2,5,1,0,0,2,2,4
401375817,Lamar Cardinals,E. Imevbore,4704877,,False,12.0,5,10,5,10,0,0,7,8,6,2,8,1,0,1,0,2,17
401375817,Lamar Cardinals,P. Adams,4899513,,False,29.0,4,12,4,11,0,1,4,5,2,2,4,2,2,0,2,0,12
401375817,Lamar Cardinals,H. LeMelle,4899512,,False,15.0,0,1,0,1,0,0,1,2,0,0,0,0,0,0,1,0,1
401375817,Lamar Cardinals,B. Mitchell,4398828,,False,10.0,1,3,1,2,0,1,5,6,0,1,1,3,0,0,2,1,7
401375817,Lamar Cardinals,TEAM,TOTAL,TOTAL,False,,23,62,17,48,6,14,24,31,18,17,35,14,7,2,19,15,76
401375817,California Baptist Lancers,C. Harper,4419354,,True,20.0,5,9,5,9,0,0,2,2,0,3,3,1,1,2,0,3,12
401375817,California Baptist Lancers,T. San Antonio,4900098,,True,20.0,5,7,4,5,1,2,2,2,0,3,3,2,5,1,3,3,13
401375817,California Baptist Lancers,N. Avila-Ambrosi,4703947,,True,18.0,6,8,3,4,3,4,3,3,0,0,0,3,2,0,0,2,18
401375817,California Baptist Lancers,S. Palma,4419349,,True,21.0,2,3,0,0,2,3,0,0,0,5,5,3,0,0,2,1,6
401375817,California Baptist Lancers,A. Olaeta,4419341,,True,31.0,8,10,8,9,0,1,4,4,0,4,4,13,2,2,3,4,20
401375817,California Baptist Lancers,E. Bravington,4703949,,False,9.0,0,1,0,0,0,1,0,0,0,0,0,0,0,0,0,5,0
401375817,California Baptist Lancers,O. Robin,4703950,,False,7.0,1,2,1,2,0,0,0,0,1,0,1,0,0,0,0,1,2
401375817,California Baptist Lancers,D. Wu,4703946,,False,11.0,2,5,2,2,0,3,0,0,3,4,7,0,1,0,1,4,4
401375817,California Baptist Lancers,T. Wu,4598112,,False,3.0,0,1,0,0,0,1,0,0,0,0,0,0,0,0,1,0,0
401375817,California Baptist Lancers,T. Neale,4598110,,False,12.0,1,1,0,0,1,1,0,0,0,0,0,1,0,0,2,3,3
401375817,California Baptist Lancers,G. Dale,4419346,,False,18.0,3,4,0,0,3,4,0,0,0,1,1,4,1,0,1,2,9
401375817,California Baptist Lancers,N. Yim,4400481,,False,12.0,3,6,0,0,3,6,2,2,0,1,1,0,0,0,1,2,11
401375817,California Baptist Lancers,B. Klaman,4281618,,False,18.0,1,2,0,0,1,2,0,0,0,0,0,1,1,3,3,2,3
401375817,California Baptist Lancers,TEAM,TOTAL,TOTAL,False,,37,59,23,31,14,28,13,13,5,23,28,28,13,8,17,32,101
401375816,Utah Valley Wolverines,J. Williams,4399976,,True,28.0,3,7,3,7,0,0,11,12,1,10,11,1,0,2,4,4,17
401375816,Utah Valley Wolverines,A. Blackham,4899426,,True,10.0,0,2,0,0,0,2,0,0,0,0,0,1,0,0,0,1,0
401375816,Utah Valley Wolverines,E. Tafisi,4703919,,True,40.0,4,10,2,6,2,4,2,4,1,4,5,5,1,0,1,2,12
401375816,Utah Valley Wolverines,K. Anderson,4703918,,True,37.0,1,7,0,3,1,4,1,2,0,4,4,2,0,1,3,2,4
401375816,Utah Valley Wolverines,M. Grange,4399975,,True,39.0,5,9,4,6,1,3,3,4,0,5,5,2,2,0,3,1,14
401375816,Utah Valley Wolverines,M. Jensen,4594439,,False,11.0,0,2,0,1,0,1,0,0,0,1,1,1,0,0,2,3,0
401375816,Utah Valley Wolverines,E. Martin,4899429,,False,8.0,1,3,0,0,1,3,0,0,0,1,1,0,0,0,0,1,3
401375816,Utah Valley Wolverines,A. Conlee,4899428,,False,27.0,3,4,2,3,1,1,3,4,6,6,12,2,2,0,3,4,10
401375816,Utah Valley Wolverines,TEAM,TOTAL,TOTAL,False,,17,44,11,26,6,18,20,26,8,31,39,14,5,3,16,18,60
401375816,New Mexico State Aggies,B. Sarr,4594697,,True,25.0,4,6,4,6,0,0,1,2,1,4,5,0,2,1,0,4,9
401375816,New Mexico State Aggies,J. Bradley,4703938,,True,13.0,0,3,0,3,0,0,0,0,0,1,1,2,0,0,0,0,0
401375816,New Mexico State Aggies,S. Inoussa,4595894,,True,30.0,2,8,0,3,2,5,2,2,0,3,3,5,1,0,1,1,8
401375816,New Mexico State Aggies,T. Grays,4400010,,True,15.0,2,2,2,2,0,0,0,0,0,1,1,1,3,0,1,2,4
401375816,New Mexico State Aggies,A. Henderson,4068799,,True,24.0,0,3,0,3,0,0,0,2,0,2,2,5,1,0,1,2,0
401375816,New Mexico State Aggies,S. Harper,4595893,,False,6.0,1,2,1,2,0,0,0,0,0,2,2,0,0,0,0,4,2
401375816,New Mexico State Aggies,D. Terrell,4281799,,False,19.0,3,6,1,3,2,3,1,2,1,4,5,0,2,0,3,2,9
401375816,New Mexico State Aggies,F. Thiam,4899510,,False,10.0,0,4,0,0,0,4,0,0,0,2,2,2,0,0,1,0,0
401375816,New Mexico State Aggies,S. Peterson,4899509,,False,6.0,0,2,0,0,0,2,1,2,0,0,0,0,1,0,0,0,1
401375816,New Mexico State Aggies,M. Shida,4899508,,False,7.0,0,0,0,0,0,0,0,0,0,0,0,0,0,0,1,0,0
401375816,New Mexico State Aggies,T. Donaldson,4703939,,False,5.0,2,3,2,3,0,0,0,0,1,0,1,0,0,0,1,0,4
401375816,New Mexico State Aggies,M. Kaiser,4703937,,False,27.0,3,7,3,6,0,1,6,9,0,1,1,1,0,0,1,3,12
401375816,New Mexico State Aggies,M. Isbell,4433669,,False,9.0,0,1,0,0,0,1,0,0,0,2,2,0,1,0,0,0,0
401375816,New Mexico State Aggies,G. Colaivalu,4068246,,False,4.0,1,1,1,1,0,0,0,0,0,0,0,0,0,0,0,0,2
401375816,New Mexico State Aggies,TEAM,TOTAL,TOTAL,False,,18,48,14,32,4,16,11,19,3,23,26,16,11,1,11,18,51
401375815,UT Rio Grande Valley Vaqueros,T. Muff,4899433,,True,39.0,8,19,5,11,3,8,4,6,2,4,6,1,2,0,1,4,23
401375815,UT Rio Grande Valley Vaqueros,S. Bershers,4595667,,True,34.0,4,15,0,4,4,11,4,4,2,8,10,2,3,1,3,5,16
401375815,UT Rio Grande Valley Vaqueros,B. Soysal,4595662,,True,14.0,0,3,0,3,0,0,1,2,5,2,7,1,0,1,0,4,1
401375815,UT Rio Grande Valley Vaqueros,K. Kyle,4899435,,True,25.0,1,3,0,1,1,2,0,0,0,5,5,7,1,0,7,2,3
401375815,UT Rio Grande Valley Vaqueros,J. Williams,4433167,,True,28.0,1,4,0,2,1,2,0,0,1,2,3,6,1,0,3,1,3
401375815,UT Rio Grande Valley Vaqueros,B. Jessen,4899436,,False,9.0,1,3,1,2,0,1,0,0,0,1,1,0,0,0,1,2,2
401375815,UT Rio Grande Valley Vaqueros,J. Martino,4703926,,False,1.0,0,0,0,0,0,0,0,0,0,1,1,0,0,0,0,0,0
401375815,UT Rio Grande Valley Vaqueros,I. Belosevic,4595657,,False,9.0,1,2,1,2,0,0,0,0,0,0,0,0,0,0,1,5,2
401375815,UT Rio Grande Valley Vaqueros,A. Sturdivant,4703927,,False,17.0,4,8,0,1,4,7,0,0,0,2,2,0,0,0,0,2,12
401375815,UT Rio Grande Valley Vaqueros,H. Jones,4595665,,False,24.0,5,9,4,6,1,3,3,4,2,6,8,3,0,1,4,2,14
401375815,UT Rio Grande Valley Vaqueros,TEAM,TOTAL,TOTAL,False,,25,66,11,32,14,34,12,16,13,34,47,20,7,3,21,27,76
401375815,Stephen F. Austin Ladyjacks,Ai. Johnson,4400451,,True,32.0,6,14,6,14,0,0,8,18,6,6,12,2,3,1,2,4,20
401375815,Stephen F. Austin Ladyjacks,Aa. Johnson,4400452,,True,7.0,1,5,1,5,0,0,0,0,1,2,3,1,0,1,0,1,2
401375815,Stephen F. Austin Ladyjacks,S. Visscher,4400450,,True,38.0,5,10,3,4,2,6,5,6,3,5,8,4,3,0,4,2,17
401375815,Stephen F. Austin Ladyjacks,B. Mitchell,4400448,,True,35.0,3,11,3,8,0,3,2,2,3,5,8,2,2,0,1,2,8
401375815,Stephen F. Austin Ladyjacks,T. Robinson,4281818,,True,26.0,3,6,0,0,3,6,1,2,1,4,5,1,0,0,2,4,10
401375815,Stephen F. Austin Ladyjacks,A. Brittingham,4705019,,False,8.0,0,2,0,2,0,0,0,0,0,1,1,1,1,0,0,0,0
401375815,Stephen F. Austin Ladyjacks,A. Scott,4899456,,False,18.0,0,4,0,2,0,2,0,0,0,2,2,1,0,0,0,1,0
401375815,Stephen F. Austin Ladyjacks,T. McCliment-Call,4703856,,False,2.0,0,0,0,0,0,0,0,0,0,0,0,0,0,0,1,2,0
401375815,Stephen F. Austin Ladyjacks,Z. Nugent,4595808,,False,34.0,6,18,6,14,0,4,5,5,2,2,4,2,1,0,3,1,17
401375815,Stephen F. Austin Ladyjacks,TEAM,TOTAL,TOTAL,False,,24,70,19,49,5,21,21,33,18,28,46,14,10,2,14,17,74
401375814,Seattle U Redhawks,G. Kehoe,4400003,,True,19.0,0,3,0,3,0,0,0,2,1,5,6,0,1,0,1,2,0
401375814,Seattle U Redhawks,H. Vice-Neat,4281746,,True,31.0,2,5,1,1,1,4,0,0,2,5,7,1,1,0,1,0,5
401375814,Seattle U Redhawks,B. Calhoun,4703934,,True,9.0,1,6,1,3,0,3,1,1,0,0,0,0,2,0,2,0,3
401375814,Seattle U Redhawks,P. Howard,4703932,,True,27.0,2,5,2,4,0,1,3,6,1,2,3,1,0,0,4,4,7
401375814,Seattle U Redhawks,C. Murphy,4400002,,True,32.0,3,9,1,4,2,5,9,10,0,5,5,1,2,0,2,3,17
401375814,Seattle U Redhawks,I. Korolenko,4703935,,False,17.0,3,4,2,3,1,1,1,1,1,1,2,0,1,0,2,4,8
401375814,Seattle U Redhawks,B. Rangel,4595199,,False,21.0,1,3,1,3,0,0,1,2,1,5,6,4,0,2,0,3,3
401375814,Seattle U Redhawks,T. Clark,4899489,,False,11.0,1,2,1,2,0,0,2,4,0,0,0,0,0,0,1,1,4
401375814,Seattle U Redhawks,M. Williams,4282325,,False,32.0,3,9,1,5,2,4,2,4,0,6,6,5,0,0,3,1,10
401375814,Seattle U Redhawks,J. Alexander,4281700,,False,1.0,0,0,0,0,0,0,0,0,0,0,0,0,0,0,0,0,0
401375814,Seattle U Redhawks,TEAM,TOTAL,TOTAL,False,,16,46,10,28,6,18,19,30,7,33,40,12,7,2,16,18,57
401375814,Chicago State Cougars,Q. Mitchell,4900103,,True,29.0,4,16,4,13,0,3,1,2,4,6,10,1,1,0,3,1,9
401375814,Chicago State Cougars,N. Haidara,4399576,,True,18.0,2,5,2,5,0,0,0,1,5,3,8,0,0,1,0,3,4
401375814,Chicago State Cougars,A. Collins,4900102,,True,39.0,5,20,5,12,0,8,5,6,1,2,3,3,0,0,4,1,15
401375814,Chicago State Cougars,J. Newell,4900101,,True,29.0,2,9,2,9,0,0,0,0,0,2,2,1,3,0,2,4,4
401375814,Chicago State Cougars,A. Boothe,4594912,,True,23.0,3,8,0,1,3,7,2,2,0,0,0,1,2,0,0,5,11
401375814,Chicago State Cougars,K. Miles,4900100,,False,20.0,1,2,1,2,0,0,1,1,3,1,4,1,0,0,0,2,3
401375814,Chicago State Cougars,C. Britter,4399340,,False,11.0,1,3,1,3,0,0,1,2,1,2,3,0,0,1,0,4,3
401375814,Chicago State Cougars,A. Haklicka,4703942,,False,18.0,2,3,2,2,0,1,1,1,2,4,6,2,0,0,0,3,5
401375814,Chicago State Cougars,L. Segues,4703941,,False,8.0,0,1,0,0,0,1,0,0,1,3,4,0,1,0,2,4,0
401375814,Chicago State Cougars,J. Covington,4399401,,False,5.0,0,3,0,2,0,1,0,0,0,1,1,1,0,0,0,1,0
401375814,Chicago State Cougars,TEAM,TOTAL,TOTAL,False,,20,70,17,49,3,21,11,15,18,28,46,10,7,2,11,28,54
401375813,Tarleton State Texans,S. Thiam,4704003,,True,4.0,0,0,0,0,0,0,0,0,0,1,1,0,0,1,2,2,0
401375813,Tarleton State Texans,L. Benson,4703959,,True,31.0,4,9,4,9,0,0,0,1,2,2,4,0,5,0,2,2,8
401375813,Tarleton State Texans,M. Kendrick,4703958,,True,34.0,3,11,3,11,0,0,0,0,4,2,6,4,2,0,0,4,6
401375813,Tarleton State Texans,J. Dick,4594823,,True,14.0,0,2,0,1,0,1,0,0,0,0,0,3,1,0,1,1,0
401375813,Tarleton State Texans,J. President,4594798,,True,23.0,4,11,3,6,1,5,0,1,0,1,1,0,0,0,4,0,9
401375813,Tarleton State Texans,N. Mitchels,4594728,,False,17.0,4,5,4,5,0,0,0,2,0,2,2,0,0,0,0,2,8
401375813,Tarleton State Texans,M. Escamilla,4703970,,False,18.0,5,6,4,5,1,1,1,2,2,2,4,0,0,0,1,3,12
401375813,Tarleton State Texans,E. Cunningham,4703962,,False,10.0,0,3,0,0,0,3,0,0,0,0,0,1,0,0,1,1,0
401375813,Tarleton State Texans,T. Jackson,4704200,,False,26.0,3,7,2,4,1,3,3,4,1,2,3,2,0,0,0,0,10
401375813,Tarleton State Texans,K. Guillory,4703963,,False,3.0,0,0,0,0,0,0,0,0,0,0,0,0,0,0,0,0,0
401375813,Tarleton State Texans,I. Dorsey,4703960,,False,20.0,2,7,1,4,1,3,2,4,1,0,1,2,1,0,2,1,7
401375813,Tarleton State Texans,TEAM,TOTAL,TOTAL,False,,25,61,21,45,4,16,6,14,15,16,31,12,9,1,14,16,60
401375813,Abilene Christian Wildcats,J. Bonnarens,4400102,,True,35.0,10,16,6,8,4,8,2,2,2,2,4,2,0,0,3,1,26
401375813,Abilene Christian Wildcats,S. Griswold,4704712,,True,18.0,3,5,3,5,0,0,0,0,0,1,1,2,1,1,0,1,6
401375813,Abilene Christian Wildcats,M. Miller,4400267,,True,28.0,2,4,1,1,1,3,0,0,0,2,2,2,0,0,2,3,5
401375813,Abilene Christian Wildcats,K. Mraz,4400264,,True,37.0,3,8,2,5,1,3,3,4,1,6,7,5,0,0,3,1,10
401375813,Abilene Christian Wildcats,T. Barber,4282564,,True,26.0,1,3,1,2,0,1,2,2,1,6,7,4,3,0,2,2,4
401375813,Abilene Christian Wildcats,E. Middleton,4899859,,False,22.0,5,8,5,8,0,0,4,5,1,3,4,0,0,2,1,2,14
401375813,Abilene Christian Wildcats,N. Cramer,4899863,,False,7.0,1,2,0,0,1,2,2,2,0,0,0,1,0,0,0,3,5
401375813,Abilene Christian Wildcats,B. Earle,4899858,,False,24.0,3,4,1,1,2,3,2,2,1,2,3,2,0,2,4,2,10
401375813,Abilene Christian Wildcats,T. Morgan,4704710,,False,3.0,0,0,0,0,0,0,0,0,0,0,0,1,0,0,1,0,0
401375813,Abilene Christian Wildcats,TEAM,TOTAL,TOTAL,False,,28,50,19,30,9,20,15,17,7,25,32,19,4,5,16,15,80
401375812,Utah Valley Wolverines,J. Williams,4399976,,True,30.0,5,12,5,12,0,0,6,7,7,7,14,0,0,0,1,4,16
401375812,Utah Valley Wolverines,A. Blackham,4899426,,True,30.0,0,3,0,0,0,3,0,0,0,5,5,2,0,0,3,2,0
401375812,Utah Valley Wolverines,K. Anderson,4703918,,True,35.0,3,5,1,1,2,4,0,0,0,4,4,0,0,1,0,1,8
401375812,Utah Valley Wolverines,M. Grange,4399975,,True,38.0,3,6,3,4,0,2,6,7,0,1,1,6,0,0,3,3,12
401375812,Utah Valley Wolverines,M. Carvalho,4399972,,True,40.0,4,15,2,8,2,7,4,4,0,5,5,3,1,0,2,2,14
401375812,Utah Valley Wolverines,M. Jensen,4594439,,False,10.0,2,3,2,3,0,0,1,2,1,1,2,1,1,1,1,2,5
401375812,Utah Valley Wolverines,E. Martin,4899429,,False,7.0,1,4,0,1,1,3,0,0,0,1,1,0,1,1,1,0,3
401375812,Utah Valley Wolverines,E. Tafisi,4703919,,False,10.0,2,3,2,2,0,1,1,1,0,0,0,3,1,0,2,0,5
401375812,Utah Valley Wolverines,TEAM,TOTAL,TOTAL,False,,20,51,15,31,5,20,18,21,8,24,32,15,4,3,13,14,63
401375812,Grand Canyon Lopes,K. Shorts,4400116,,True,12.0,0,0,0,0,0,0,0,0,0,1,1,0,0,0,2,4,0
401375812,Grand Canyon Lopes,J. Powell-Smith,4899517,,True,28.0,6,9,6,8,0,1,6,8,1,0,1,2,0,1,1,2,18
401375812,Grand Canyon Lopes,C. Akin-Otiko,4705636,,True,6.0,0,1,0,1,0,0,0,0,0,0,0,0,0,0,0,0,0
401375812,Grand Canyon Lopes,Tiar. Brown,4705634,,True,25.0,5,9,3,7,2,2,3,5,3,4,7,2,3,0,3,5,15
401375812,Grand Canyon Lopes,A. Graham,4068788,,True,35.0,4,11,1,4,3,7,2,2,0,6,6,1,1,0,2,1,13
401375812,Grand Canyon Lopes,J. McChristine,4899523,,False,23.0,4,13,4,13,0,0,2,2,6,2,8,0,1,0,2,2,10
401375812,Grand Canyon Lopes,D. Phillips,4899519,,False,20.0,2,9,2,7,0,2,0,0,0,1,1,1,0,0,2,0,4
401375812,Grand Canyon Lopes,N. Evans,4899524,,False,10.0,0,0,0,0,0,0,0,0,0,0,0,2,0,0,0,0,0
401375812,Grand Canyon Lopes,Tian. Brown,4595892,,False,21.0,1,5,0,0,1,5,0,0,0,2,2,1,0,0,1,0,3
401375812,Grand Canyon Lopes,K. Flowers,4899522,,False,20.0,1,2,1,2,0,0,0,0,0,5,5,2,3,0,0,3,2
401375812,Grand Canyon Lopes,TEAM,TOTAL,TOTAL,False,,23,59,17,42,6,17,13,17,12,24,36,11,8,1,14,17,65
401375811,UT Rio Grande Valley Vaqueros,T. Muff,4899433,,True,30.0,4,12,3,9,1,3,1,1,1,4,5,1,0,0,7,3,10
401375811,UT Rio Grande Valley Vaqueros,I. Belosevic,4595657,,True,16.0,2,3,2,3,0,0,0,0,0,4,4,2,0,0,1,2,4
401375811,UT Rio Grande Valley Vaqueros,S. Bershers,4595667,,True,37.0,9,18,4,11,5,7,7,7,2,6,8,4,2,6,2,1,30
401375811,UT Rio Grande Valley Vaqueros,K. Kyle,4899435,,True,18.0,2,5,2,4,0,1,0,0,0,3,3,2,0,0,5,4,4
401375811,UT Rio Grande Valley Vaqueros,T. McGarity,4595656,,True,26.0,1,4,1,3,0,1,0,0,0,1,1,2,0,0,1,2,2
401375811,UT Rio Grande Valley Vaqueros,B. Jessen,4899436,,False,8.0,2,3,1,2,1,1,0,0,0,2,2,1,0,1,2,1,5
401375811,UT Rio Grande Valley Vaqueros,J. Martino,4703926,,False,0.0,0,0,0,0,0,0,0,0,0,0,0,0,0,0,0,0,0
401375811,UT Rio Grande Valley Vaqueros,B. Soysal,4595662,,False,5.0,0,0,0,0,0,0,0,0,0,2,2,0,0,0,0,3,0
401375811,UT Rio Grande Valley Vaqueros,M. Llorente,4899434,,False,14.0,2,3,2,3,0,0,0,0,0,1,1,2,0,0,0,5,4
401375811,UT Rio Grande Valley Vaqueros,A. Sturdivant,4703927,,False,3.0,0,0,0,0,0,0,0,0,0,0,0,0,1,0,0,0,0
401375811,UT Rio Grande Valley Vaqueros,H. Jones,4595665,,False,20.0,1,5,1,3,0,2,0,0,0,3,3,2,2,0,1,4,2
401375811,UT Rio Grande Valley Vaqueros,J. Williams,4433167,,False,23.0,0,2,0,1,0,1,0,0,0,2,2,1,1,0,0,2,0
401375811,UT Rio Grande Valley Vaqueros,TEAM,TOTAL,TOTAL,False,,23,55,16,39,7,16,8,8,3,28,31,17,6,7,19,27,61
401375811,Lamar Cardinals,A. Davis,4899516,,True,30.0,6,12,6,12,0,0,4,8,7,5,12,0,0,0,2,2,16
401375811,Lamar Cardinals,A. Gibbs,4704878,,True,25.0,2,6,1,3,1,3,0,0,1,6,7,4,2,3,1,3,5
401375811,Lamar Cardinals,S. Dean,4704875,,True,30.0,2,11,1,9,1,2,3,4,0,1,1,5,2,0,0,2,8
401375811,Lamar Cardinals,K. Mitchell,4595698,,True,21.0,0,2,0,1,0,1,2,2,0,3,3,5,0,0,2,3,2
401375811,Lamar Cardinals,A. Hastings,4400297,,True,36.0,6,15,4,11,2,4,7,7,0,2,2,1,1,0,2,1,21
401375811,Lamar Cardinals,N. Weems,4899515,,False,18.0,2,7,1,3,1,4,0,0,4,3,7,1,0,0,2,1,5
401375811,Lamar Cardinals,E. Imevbore,4704877,,False,7.0,1,1,1,1,0,0,0,0,3,2,5,0,0,0,2,1,2
401375811,Lamar Cardinals,P. Adams,4899513,,False,23.0,4,11,4,10,0,1,2,5,0,4,4,1,1,0,1,2,10
401375811,Lamar Cardinals,B. Mitchell,4398828,,False,10.0,0,1,0,0,0,1,0,0,0,0,0,0,1,0,1,1,0
401375811,Lamar Cardinals,TEAM,TOTAL,TOTAL,False,,23,66,18,50,5,16,18,26,17,27,44,17,7,3,13,16,69
401375810,Stephen F. Austin Ladyjacks,Ai. Johnson,4400451,,True,27.0,3,12,3,12,0,0,5,6,1,1,2,1,0,0,3,2,11
401375810,Stephen F. Austin Ladyjacks,Z. Nugent,4595808,,True,34.0,4,12,3,7,1,5,7,8,2,4,6,3,3,1,6,1,16
401375810,Stephen F. Austin Ladyjacks,S. Visscher,4400450,,True,37.0,6,11,3,6,3,5,4,4,1,4,5,2,1,1,2,2,19
401375810,Stephen F. Austin Ladyjacks,B. Mitchell,4400448,,True,28.0,0,2,0,1,0,1,4,4,0,2,2,5,1,0,1,3,4
401375810,Stephen F. Austin Ladyjacks,T. Robinson,4281818,,True,31.0,3,5,1,2,2,3,0,0,1,0,1,1,0,0,1,2,8
401375810,Stephen F. Austin Ladyjacks,A. Brittingham,4705019,,False,8.0,1,1,1,1,0,0,2,2,1,0,1,0,0,1,3,2,4
401375810,Stephen F. Austin Ladyjacks,Aa. Johnson,4400452,,False,13.0,0,3,0,2,0,1,0,0,0,2,2,1,1,2,0,1,0
401375810,Stephen F. Austin Ladyjacks,A. Scott,4899456,,False,12.0,1,1,1,1,0,0,0,0,0,0,0,0,1,0,0,2,2
401375810,Stephen F. Austin Ladyjacks,T. McCliment-Call,4703856,,False,5.0,0,0,0,0,0,0,0,0,2,0,2,0,0,0,1,0,0
401375810,Stephen F. Austin Ladyjacks,D. Lombard,4597501,,False,5.0,0,1,0,0,0,1,0,0,0,1,1,0,1,0,1,0,0
401375810,Stephen F. Austin Ladyjacks,TEAM,TOTAL,TOTAL,False,,18,48,12,32,6,16,22,24,10,16,26,13,8,5,19,15,64
401375810,New Mexico State Aggies,B. Sarr,4594697,,True,28.0,7,12,7,12,0,0,1,1,6,7,13,0,0,0,4,3,15
401375810,New Mexico State Aggies,F. Thiam,4899510,,True,17.0,1,8,1,3,0,5,1,2,1,2,3,2,0,0,3,1,3
401375810,New Mexico State Aggies,J. Bradley,4703938,,True,6.0,0,0,0,0,0,0,0,0,0,0,0,0,0,0,0,2,0
401375810,New Mexico State Aggies,S. Inoussa,4595894,,True,28.0,2,4,1,1,1,3,0,1,4,2,6,0,2,0,4,2,5
401375810,New Mexico State Aggies,A. Henderson,4068799,,True,37.0,2,3,2,3,0,0,4,4,0,4,4,5,0,0,6,3,8
401375810,New Mexico State Aggies,S. Harper,4595893,,False,7.0,0,2,0,2,0,0,0,0,0,0,0,0,1,0,0,0,0
401375810,New Mexico State Aggies,D. Terrell,4281799,,False,10.0,2,3,2,3,0,0,0,0,0,1,1,0,0,1,0,5,4
401375810,New Mexico State Aggies,S. Peterson,4899509,,False,8.0,1,4,0,0,1,4,0,0,0,1,1,1,1,0,0,0,3
401375810,New Mexico State Aggies,M. Shida,4899508,,False,3.0,0,0,0,0,0,0,0,0,0,0,0,0,0,0,0,0,0
401375810,New Mexico State Aggies,T. Donaldson,4703939,,False,7.0,0,1,0,0,0,1,0,0,0,0,0,0,0,0,1,0,0
401375810,New Mexico State Aggies,M. Kaiser,4703937,,False,30.0,6,10,5,7,1,3,1,2,1,0,1,1,2,0,3,3,14
401375810,New Mexico State Aggies,T. Grays,4400010,,False,3.0,0,0,0,0,0,0,0,0,0,0,0,0,0,0,0,1,0
401375810,New Mexico State Aggies,G. Colaivalu,4068246,,False,16.0,2,5,2,5,0,0,0,0,0,0,0,0,3,0,5,2,4
401375810,New Mexico State Aggies,TEAM,TOTAL,TOTAL,False,,23,52,20,36,3,16,7,10,14,19,33,9,9,1,27,22,56
401375809,Tarleton State Texans,S. Thiam,4704003,,True,9.0,1,1,1,1,0,0,0,0,0,1,1,0,0,2,0,2,2
401375809,Tarleton State Texans,L. Benson,4703959,,True,32.0,6,11,6,11,0,0,5,6,2,8,10,3,4,1,1,2,17
401375809,Tarleton State Texans,M. Kendrick,4703958,,True,23.0,5,9,5,9,0,0,1,2,1,2,3,4,2,0,5,4,11
401375809,Tarleton State Texans,J. Dick,4594823,,True,26.0,1,3,0,0,1,3,2,2,0,3,3,2,0,0,2,4,5
401375809,Tarleton State Texans,J. President,4594798,,True,25.0,1,6,1,4,0,2,2,2,0,2,2,3,1,1,0,3,4
401375809,Tarleton State Texans,N. Mitchels,4594728,,False,13.0,2,2,2,2,0,0,4,4,1,2,3,0,0,1,0,3,8
401375809,Tarleton State Texans,E. Axelsson,4899444,,False,2.0,0,0,0,0,0,0,0,0,0,0,0,0,0,0,0,0,0
401375809,Tarleton State Texans,M. Escamilla,4703970,,False,17.0,2,8,2,6,0,2,0,0,0,3,3,1,1,0,1,2,4
401375809,Tarleton State Texans,E. Cunningham,4703962,,False,6.0,1,2,0,0,1,2,0,0,0,2,2,0,1,0,1,3,3
401375809,Tarleton State Texans,H. Matthews,4704713,,False,1.0,0,0,0,0,0,0,0,0,0,0,0,0,0,0,0,0,0
401375809,Tarleton State Texans,M. Jones,4899443,,False,3.0,0,0,0,0,0,0,0,0,0,0,0,0,0,0,0,0,0
401375809,Tarleton State Texans,C. Smith,4899442,,False,1.0,0,0,0,0,0,0,0,0,0,0,0,0,0,0,1,0,0
401375809,Tarleton State Texans,T. Jackson,4704200,,False,22.0,4,6,3,3,1,3,2,2,0,3,3,0,0,0,2,2,11
401375809,Tarleton State Texans,K. Guillory,4703963,,False,1.0,1,2,1,1,0,1,0,0,0,1,1,0,0,0,0,1,2
401375809,Tarleton State Texans,I. Dorsey,4703960,,False,19.0,4,6,3,3,1,3,7,10,0,1,1,3,2,0,3,1,16
401375809,Tarleton State Texans,TEAM,TOTAL,TOTAL,False,,28,56,24,40,4,16,23,28,5,34,39,16,11,5,16,27,83
401375809,Sam Houston Bearkats,M. Batista,4595756,,True,12.0,4,12,4,12,0,0,0,1,8,4,12,1,2,1,1,5,8
401375809,Sam Houston Bearkats,C. Cleveland,4595754,,True,40.0,6,24,6,23,0,1,16,21,1,7,8,1,3,0,3,2,28
401375809,Sam Houston Bearkats,K. Jefferson,4418429,,True,34.0,2,8,2,6,0,2,2,2,4,2,6,3,2,1,7,3,6
401375809,Sam Houston Bearkats,S. Kemp,4595751,,True,30.0,1,5,1,4,0,1,0,0,2,0,2,0,1,0,1,4,2
401375809,Sam Houston Bearkats,L. Echi,4595590,,True,38.0,5,7,5,7,0,0,3,5,1,6,7,0,0,0,2,4,13
401375809,Sam Houston Bearkats,B. Dollar,4899507,,False,3.0,0,1,0,1,0,0,0,0,0,0,0,0,0,0,0,3,0
401375809,Sam Houston Bearkats,S. Rodgers,4899506,,False,8.0,0,4,0,4,0,0,2,2,0,2,2,0,0,0,1,1,2
401375809,Sam Houston Bearkats,R. Smith,4433705,,False,25.0,0,0,0,0,0,0,4,8,3,2,5,2,2,0,2,3,4
401375809,Sam Houston Bearkats,D. Telemaque,4400581,,False,10.0,0,6,0,6,0,0,0,0,1,0,1,0,0,1,3,1,0
401375809,Sam Houston Bearkats,TEAM,TOTAL,TOTAL,False,,18,67,18,63,0,4,27,39,23,26,49,7,10,3,20,26,63
401375808,Chicago State Cougars,Q. Mitchell,4900103,,True,31.0,4,13,4,12,0,1,4,4,1,8,9,1,1,1,3,4,12
401375808,Chicago State Cougars,N. Haidara,4399576,,True,32.0,2,7,2,7,0,0,0,3,3,11,14,0,3,0,3,3,4
401375808,Chicago State Cougars,A. Collins,4900102,,True,35.0,6,16,5,13,1,3,4,6,2,2,4,6,2,0,8,3,17
401375808,Chicago State Cougars,J. Newell,4900101,,True,10.0,1,5,1,5,0,0,1,2,0,2,2,0,0,0,1,0,3
401375808,Chicago State Cougars,A. Boothe,4594912,,True,39.0,3,4,0,0,3,4,2,2,0,4,4,4,0,0,3,0,11
401375808,Chicago State Cougars,K. Miles,4900100,,False,5.0,0,1,0,1,0,0,0,0,1,0,1,0,1,0,0,0,0
401375808,Chicago State Cougars,C. Britter,4399340,,False,12.0,2,3,2,3,0,0,1,2,0,4,4,0,0,1,1,3,5
401375808,Chicago State Cougars,A. Haklicka,4703942,,False,11.0,2,5,2,3,0,2,0,0,0,0,0,1,1,0,1,3,4
401375808,Chicago State Cougars,L. Segues,4703941,,False,18.0,3,6,2,3,1,3,1,2,2,3,5,1,1,0,2,5,8
401375808,Chicago State Cougars,J. Covington,4399401,,False,32.0,2,9,2,4,0,5,1,2,2,4,6,2,0,0,1,1,5
401375808,Chicago State Cougars,TEAM,TOTAL,TOTAL,False,,25,69,20,51,5,18,14,23,17,41,58,15,9,2,23,22,69
401375808,California Baptist Lancers,C. Harper,4419354,,True,41.0,6,18,5,14,1,4,5,8,0,10,10,1,2,8,2,3,18
401375808,California Baptist Lancers,T. San Antonio,4900098,,True,16.0,2,5,2,3,0,2,1,2,0,3,3,1,1,0,0,5,5
401375808,California Baptist Lancers,N. Avila-Ambrosi,4703947,,True,29.0,3,8,2,3,1,5,1,2,2,2,4,1,3,0,2,3,8
401375808,California Baptist Lancers,S. Palma,4419349,,True,35.0,0,2,0,2,0,0,2,2,0,1,1,0,1,1,2,4,2
401375808,California Baptist Lancers,A. Olaeta,4419341,,True,42.0,8,18,6,11,2,7,1,2,1,4,5,8,2,1,5,2,19
401375808,California Baptist Lancers,E. Bravington,4703949,,False,4.0,1,3,1,1,0,2,0,0,1,1,2,0,0,0,0,0,2
401375808,California Baptist Lancers,T. Neale,4598110,,False,9.0,0,3,0,1,0,2,0,0,0,2,2,0,1,0,0,0,0
401375808,California Baptist Lancers,G. Dale,4419346,,False,17.0,1,3,1,1,0,2,5,7,0,4,4,1,1,0,1,3,7
401375808,California Baptist Lancers,B. Klaman,4281618,,False,32.0,5,8,2,2,3,6,2,3,0,0,0,2,4,0,0,2,15
401375808,California Baptist Lancers,TEAM,TOTAL,TOTAL,False,,26,68,19,38,7,30,17,26,5,30,35,14,15,10,12,22,76
401375807,Utah Tech Trailblazers,A. Papa,4900107,,True,32.0,6,6,5,5,1,1,2,2,3,7,10,1,1,0,4,2,15
401375807,Utah Tech Trailblazers,E. Isaacson,4602913,,True,37.0,7,13,0,2,7,11,1,2,1,3,4,1,1,1,1,3,22
401375807,Utah Tech Trailblazers,Mac. Warren,4900106,,True,19.0,1,3,1,1,0,2,0,0,2,2,4,4,0,0,0,0,2
401375807,Utah Tech Trailblazers,B. Gillen,4602911,,True,37.0,10,18,10,14,0,4,1,2,2,2,4,8,0,0,1,1,21
401375807,Utah Tech Trailblazers,S. Davison,4281704,,True,34.0,9,21,8,16,1,5,2,2,1,6,7,6,4,0,2,3,21
401375807,Utah Tech Trailblazers,B. Vance,4703956,,False,9.0,0,0,0,0,0,0,0,0,0,2,2,0,0,0,0,4,0
401375807,Utah Tech Trailblazers,M. McCord,4602915,,False,30.0,5,10,1,1,4,9,0,0,0,4,4,0,0,0,0,2,14
401375807,Utah Tech Trailblazers,T. Sireni,4595648,,False,2.0,0,0,0,0,0,0,0,0,1,0,1,0,0,0,0,0,0
401375807,Utah Tech Trailblazers,TEAM,TOTAL,TOTAL,False,,38,71,25,39,13,32,6,8,12,30,42,20,6,1,9,15,95
401375807,Abilene Christian Wildcats,J. Bonnarens,4400102,,True,32.0,5,15,2,4,3,11,0,0,2,2,4,3,1,0,1,3,13
401375807,Abilene Christian Wildcats,S. Griswold,4704712,,True,16.0,4,4,4,4,0,0,0,3,1,0,1,0,0,0,0,0,8
401375807,Abilene Christian Wildcats,M. Miller,4400267,,True,13.0,2,6,1,2,1,4,0,0,0,1,1,2,1,0,1,1,5
401375807,Abilene Christian Wildcats,K. Mraz,4400264,,True,34.0,4,12,1,1,3,11,0,0,2,5,7,5,0,1,1,3,11
401375807,Abilene Christian Wildcats,T. Barber,4282564,,True,26.0,5,10,4,5,1,5,5,8,0,4,4,2,0,1,0,0,16
401375807,Abilene Christian Wildcats,E. Middleton,4899859,,False,24.0,4,8,4,8,0,0,2,3,4,3,7,0,1,1,1,0,10
401375807,Abilene Christian Wildcats,N. Cramer,4899863,,False,16.0,5,9,2,2,3,7,0,0,0,1,1,1,0,0,2,3,13
401375807,Abilene Christian Wildcats,B. Earle,4899858,,False,33.0,1,7,0,3,1,4,2,2,2,5,7,6,0,0,2,2,5
401375807,Abilene Christian Wildcats,T. Morgan,4704710,,False,6.0,0,1,0,0,0,1,0,0,1,0,1,1,1,0,2,0,0
401375807,Abilene Christian Wildcats,TEAM,TOTAL,TOTAL,False,,30,72,18,29,12,43,9,16,14,21,35,20,4,3,10,12,81
401375465,McNeese Cowgirls,D. Tanks,4400305,,True,19.0,2,5,2,4,0,1,0,0,1,4,5,0,0,0,0,1,4
401375465,McNeese Cowgirls,K. Chamberlin,4900425,,True,21.0,2,6,1,3,1,3,2,2,1,0,1,2,1,0,3,0,7
401375465,McNeese Cowgirls,L. Stubblefield,4705271,,True,32.0,2,7,2,6,0,1,7,12,2,2,4,5,6,1,4,3,11
401375465,McNeese Cowgirls,Z. Kulinska,4595864,,True,13.0,3,7,2,4,1,3,0,0,0,0,0,0,1,0,0,2,7
401375465,McNeese Cowgirls,D. Hansen,4399933,,True,22.0,1,3,0,2,1,1,0,0,0,4,4,3,0,0,1,3,3
401375465,McNeese Cowgirls,E. Taylor,4900426,,False,2.0,0,1,0,1,0,0,0,0,1,0,1,0,0,0,0,0,0
401375465,McNeese Cowgirls,L. Skripkina,4595540,,False,20.0,2,5,2,3,0,2,0,0,1,2,3,1,0,1,2,1,4
401375465,McNeese Cowgirls,T. Wilkins,4900428,,False,10.0,2,2,1,1,1,1,0,0,0,0,0,0,0,0,0,0,5
401375465,McNeese Cowgirls,M. Yespes,4900427,,False,15.0,1,3,1,3,0,0,0,0,1,2,3,0,2,0,0,1,2
401375465,McNeese Cowgirls,C. Gil,4705627,,False,18.0,3,6,1,2,2,4,0,0,0,1,1,1,0,0,2,1,8
401375465,McNeese Cowgirls,C. Rosini,4705071,,False,13.0,0,0,0,0,0,0,0,0,0,3,3,0,0,0,2,5,0
401375465,McNeese Cowgirls,K. Hamilton,4595710,,False,15.0,3,7,1,3,2,4,2,2,1,2,3,1,0,0,0,2,10
401375465,McNeese Cowgirls,TEAM,TOTAL,TOTAL,False,,21,52,13,32,8,20,11,16,9,23,32,13,10,2,16,19,61
401375465,Houston Christian Huskies,A. Sutherland,4595692,,True,39.0,2,8,2,8,0,0,0,0,6,3,9,3,2,2,1,0,4
401375465,Houston Christian Huskies,M. Nzoiwu,4400275,,True,15.0,2,6,2,6,0,0,0,0,3,3,6,0,0,0,2,1,4
401375465,Houston Christian Huskies,T. Jefferson,4595688,,True,24.0,2,10,2,8,0,2,4,4,2,0,2,3,2,0,5,2,8
401375465,Houston Christian Huskies,K. Wilson,4595687,,True,30.0,2,8,0,4,2,4,5,6,0,2,2,2,0,1,1,3,11
401375465,Houston Christian Huskies,J. Vujakovic,4400274,,True,32.0,6,11,1,1,5,10,2,2,1,2,3,2,1,1,2,3,19
401375465,Houston Christian Huskies,N. Collins,4595690,,False,24.0,4,10,4,10,0,0,2,2,2,7,9,1,1,0,1,1,10
401375465,Houston Christian Huskies,E. Maguire,4704741,,False,21.0,2,5,0,0,2,5,0,0,0,0,0,2,0,0,1,2,6
401375465,Houston Christian Huskies,L. Mapusua,4704731,,False,15.0,2,5,0,2,2,3,0,0,1,2,3,3,1,0,1,1,6
401375465,Houston Christian Huskies,TEAM,TOTAL,TOTAL,False,,22,63,11,39,11,24,13,14,17,25,42,16,7,4,16,13,68
401375464,SE Louisiana Lady Lions,C. Williams,4281056,,True,34.0,8,12,8,12,0,0,2,2,1,6,7,2,3,0,2,3,18
401375464,SE Louisiana Lady Lions,M. Carrier,4281053,,True,22.0,1,8,0,1,1,7,0,0,1,0,1,1,0,0,2,0,3
401375464,SE Louisiana Lady Lions,T. Bell,4900439,,True,11.0,0,2,0,2,0,0,1,2,0,0,0,0,0,0,1,4,1
401375464,SE Louisiana Lady Lions,H. Giaratano,4595778,,True,29.0,2,8,2,6,0,2,0,0,1,1,2,1,2,0,1,2,4
401375464,SE Louisiana Lady Lions,A. Horne,4595776,,True,25.0,1,6,1,5,0,1,0,0,1,4,5,2,1,0,2,2,2
401375464,SE Louisiana Lady Lions,N. Kelly,4398610,,False,9.0,0,2,0,2,0,0,0,4,1,3,4,0,0,1,1,1,0
401375464,SE Louisiana Lady Lions,M. Davis,4900441,,False,14.0,2,3,2,3,0,0,2,2,1,2,3,0,0,0,2,3,6
401375464,SE Louisiana Lady Lions,C. Brown,4705010,,False,27.0,3,8,3,7,0,1,4,6,8,3,11,3,2,0,1,1,10
401375464,SE Louisiana Lady Lions,B. Ducksworth,4595775,,False,20.0,2,7,2,7,0,0,0,0,1,2,3,0,3,0,1,4,4
401375464,SE Louisiana Lady Lions,D. Harvey,4595774,,False,9.0,1,6,0,0,1,6,0,0,0,1,1,0,0,0,0,0,3
401375464,SE Louisiana Lady Lions,TEAM,TOTAL,TOTAL,False,,20,62,18,45,2,17,9,16,16,24,40,9,11,1,14,20,51
401375464,Northwestern State Lady Demons,J. Todd,4900436,,True,30.0,2,6,2,6,0,0,1,2,5,10,15,0,1,2,4,2,5
401375464,Northwestern State Lady Demons,S. Ayres,4595167,,True,20.0,1,6,0,0,1,6,0,0,0,3,3,1,0,0,1,3,3
401375464,Northwestern State Lady Demons,M. Bolden,4595002,,True,31.0,4,9,4,8,0,1,3,5,1,3,4,1,0,0,4,2,11
401375464,Northwestern State Lady Demons,A. Whyte,4594850,,True,25.0,1,3,1,3,0,0,1,6,4,4,8,0,1,0,2,4,3
401375464,Northwestern State Lady Demons,C. Parramore,4400554,,True,33.0,1,10,1,7,0,3,10,10,0,2,2,2,1,1,5,1,12
401375464,Northwestern State Lady Demons,J. Dixon,4704126,,False,10.0,1,2,1,2,0,0,0,2,0,0,0,0,0,0,0,1,2
401375464,Northwestern State Lady Demons,J. McLemore,4900434,,False,2.0,0,0,0,0,0,0,0,0,0,0,0,0,0,0,0,0,0
401375464,Northwestern State Lady Demons,J. Woodson,4900432,,False,18.0,1,3,0,0,1,3,6,6,0,1,1,0,1,0,2,0,9
401375464,Northwestern State Lady Demons,J. Braxton,4399212,,False,31.0,4,7,1,2,3,5,0,0,0,2,2,2,1,0,1,1,11
401375464,Northwestern State Lady Demons,TEAM,TOTAL,TOTAL,False,,15,46,10,28,5,18,21,31,11,28,39,6,5,3,20,14,56
401375463,Texas A&M-Corpus Christi Islanders,D. Wraggs,4595988,,True,23.0,1,1,1,1,0,0,0,0,1,2,3,1,1,0,2,2,2
401375463,Texas A&M-Corpus Christi Islanders,A. Westbrook,4595820,,True,27.0,4,6,4,5,0,1,13,15,0,12,12,1,1,0,1,3,21
401375463,Texas A&M-Corpus Christi Islanders,P. Allen,4704985,,True,37.0,2,5,2,3,0,2,0,0,2,1,3,2,0,0,1,1,4
401375463,Texas A&M-Corpus Christi Islanders,V. Verano,4595574,,True,29.0,0,8,0,5,0,3,0,0,0,1,1,2,0,0,2,3,0
401375463,Texas A&M-Corpus Christi Islanders,M. Serrata,4400456,,True,28.0,5,10,5,10,0,0,4,4,2,3,5,1,0,0,3,3,14
401375463,Texas A&M-Corpus Christi Islanders,N. McGill,4704987,,False,15.0,3,8,3,8,0,0,1,2,3,2,5,0,0,3,2,4,7
401375463,Texas A&M-Corpus Christi Islanders,M. Ellis,4900443,,False,10.0,3,9,2,6,1,3,1,2,1,1,2,0,1,0,0,0,8
401375463,Texas A&M-Corpus Christi Islanders,M. Aguado,4704986,,False,12.0,0,1,0,1,0,0,0,0,0,1,1,1,1,0,2,1,0
401375463,Texas A&M-Corpus Christi Islanders,H. Campbell,4595817,,False,19.0,1,7,1,5,0,2,2,4,2,4,6,0,0,0,1,2,4
401375463,Texas A&M-Corpus Christi Islanders,TEAM,TOTAL,TOTAL,False,,19,55,18,44,1,11,21,27,15,30,45,8,4,3,14,19,60
401375463,Incarnate Word Cardinals,J. Means,4400572,,True,16.0,2,4,2,4,0,0,0,1,0,0,0,0,0,1,0,2,4
401375463,Incarnate Word Cardinals,M. Bell,4704788,,True,34.0,2,11,2,8,0,3,0,1,1,5,6,0,1,0,1,2,4
401375463,Incarnate Word Cardinals,D. Terrell,4704787,,True,14.0,3,7,3,7,0,0,2,2,0,0,0,1,2,0,2,5,8
401375463,Incarnate Word Cardinals,J. Moore,4704786,,True,40.0,6,16,4,9,2,7,4,4,0,6,6,1,3,1,4,2,18
401375463,Incarnate Word Cardinals,H. Wheeler,4704783,,True,26.0,2,3,0,0,2,3,0,0,0,0,0,1,0,0,1,1,6
401375463,Incarnate Word Cardinals,T. Gardner,4704792,,False,24.0,4,5,4,5,0,0,7,10,5,4,9,0,0,0,3,3,15
401375463,Incarnate Word Cardinals,B. Perez,4704790,,False,21.0,0,3,0,3,0,0,0,0,1,3,4,1,1,0,2,2,0
401375463,Incarnate Word Cardinals,S. Omozee,4400296,,False,5.0,0,0,0,0,0,0,0,0,1,1,2,1,0,0,0,0,0
401375463,Incarnate Word Cardinals,K. Gibson,4704784,,False,6.0,0,4,0,4,0,0,0,0,0,1,1,0,0,0,2,4,0
401375463,Incarnate Word Cardinals,D. Jenkins,4595693,,False,14.0,0,3,0,1,0,2,0,0,2,3,5,1,1,0,0,2,0
401375463,Incarnate Word Cardinals,TEAM,TOTAL,TOTAL,False,,19,56,15,41,4,15,13,18,10,24,34,6,8,2,16,23,55
401375462,Nicholls Colonels,L. Bowie,4282360,,True,31.0,5,8,4,5,1,3,2,2,3,7,10,2,0,1,4,0,13
401375462,Nicholls Colonels,B. Washington,4282363,,True,38.0,7,16,7,16,0,0,1,1,3,2,5,5,1,0,0,1,15
401375462,Nicholls Colonels,K. Green,4705290,,True,24.0,1,9,0,4,1,5,5,8,1,4,5,0,1,1,1,4,8
401375462,Nicholls Colonels,C. Allen,4705289,,True,40.0,7,17,6,13,1,4,1,1,0,5,5,3,0,0,6,1,16
401375462,Nicholls Colonels,A. Sandie,4705286,,True,40.0,3,4,2,2,1,2,0,0,0,1,1,2,2,0,2,4,7
401375462,Nicholls Colonels,K. Manley,4705291,,False,8.0,0,0,0,0,0,0,0,0,0,1,1,1,0,0,0,1,0
401375462,Nicholls Colonels,J. Womack,4400562,,False,19.0,3,5,1,3,2,2,0,0,0,1,1,0,0,0,0,0,8
401375462,Nicholls Colonels,TEAM,TOTAL,TOTAL,False,,26,59,20,43,6,16,9,12,9,24,33,13,4,2,14,11,67
401375462,New Orleans Privateers,N. Scott,4900429,,True,21.0,2,5,2,5,0,0,2,2,1,2,3,0,0,0,1,1,6
401375462,New Orleans Privateers,Z. Cooper,4705282,,True,30.0,3,6,3,6,0,0,0,0,2,7,9,1,1,0,4,3,6
401375462,New Orleans Privateers,T. Gipson,4705277,,True,19.0,1,9,0,1,1,8,0,0,0,1,1,1,0,0,0,1,3
401375462,New Orleans Privateers,D. Pryor,4703756,,True,35.0,5,8,3,5,2,3,2,2,1,4,5,3,2,0,2,1,14
401375462,New Orleans Privateers,J. Mathis,4282583,,True,39.0,6,12,3,7,3,5,3,4,0,2,2,8,1,1,3,3,18
401375462,New Orleans Privateers,Z. Cordis,4705285,,False,10.0,1,1,1,1,0,0,0,0,1,2,3,0,0,2,2,2,2
401375462,New Orleans Privateers,J. Ross,4433299,,False,8.0,0,1,0,0,0,1,0,0,0,2,2,1,0,0,2,1,0
401375462,New Orleans Privateers,T. Thompson,4900430,,False,24.0,6,10,6,10,0,0,2,4,2,0,2,1,3,0,1,1,14
401375462,New Orleans Privateers,K. Davis,4705280,,False,14.0,3,5,1,2,2,3,1,2,0,1,1,2,1,0,1,2,9
401375462,New Orleans Privateers,TEAM,TOTAL,TOTAL,False,,27,57,19,37,8,20,10,14,8,25,33,17,8,3,16,15,72
401375461,Texas A&M-Corpus Christi Islanders,D. Wraggs,4595988,,True,24.0,3,5,3,5,0,0,1,2,2,2,4,1,3,0,0,2,7
401375461,Texas A&M-Corpus Christi Islanders,A. Westbrook,4595820,,True,37.0,9,12,9,11,0,1,4,4,5,8,13,2,0,1,2,0,22
401375461,Texas A&M-Corpus Christi Islanders,P. Allen,4704985,,True,34.0,2,6,2,5,0,1,0,0,0,3,3,2,2,0,1,1,4
401375461,Texas A&M-Corpus Christi Islanders,V. Verano,4595574,,True,22.0,1,8,0,3,1,5,0,0,1,0,1,4,0,0,4,4,3
401375461,Texas A&M-Corpus Christi Islanders,M. Serrata,4400456,,True,26.0,6,10,6,9,0,1,2,2,1,6,7,3,3,0,2,0,14
401375461,Texas A&M-Corpus Christi Islanders,N. McGill,4704987,,False,19.0,4,10,4,10,0,0,2,2,5,3,8,3,1,0,3,1,10
401375461,Texas A&M-Corpus Christi Islanders,M. Aguado,4704986,,False,24.0,3,5,3,5,0,0,2,6,0,2,2,0,1,0,0,1,8
401375461,Texas A&M-Corpus Christi Islanders,H. Campbell,4595817,,False,14.0,0,4,0,2,0,2,0,0,0,2,2,1,2,0,1,3,0
401375461,Texas A&M-Corpus Christi Islanders,TEAM,TOTAL,TOTAL,False,,28,60,27,50,1,10,11,16,15,27,42,16,12,1,14,12,68
401375461,Nicholls Colonels,L. Bowie,4282360,,True,36.0,6,9,6,8,0,1,0,0,0,7,7,1,3,0,1,2,12
401375461,Nicholls Colonels,B. Washington,4282363,,True,25.0,4,7,4,7,0,0,2,2,1,5,6,0,1,0,1,3,10
401375461,Nicholls Colonels,K. Green,4705290,,True,31.0,4,13,2,7,2,6,0,0,1,2,3,1,0,0,5,3,10
401375461,Nicholls Colonels,C. Allen,4705289,,True,40.0,6,17,5,13,1,4,6,6,1,1,2,2,2,0,4,3,19
401375461,Nicholls Colonels,A. Sandie,4705286,,True,40.0,1,4,1,3,0,1,0,0,0,2,2,4,2,0,3,0,2
401375461,Nicholls Colonels,K. Manley,4705291,,False,16.0,0,1,0,1,0,0,0,0,1,0,1,1,0,0,1,3,0
401375461,Nicholls Colonels,J. Womack,4400562,,False,12.0,0,3,0,2,0,1,0,0,0,1,1,0,0,0,0,1,0
401375461,Nicholls Colonels,TEAM,TOTAL,TOTAL,False,,21,54,18,41,3,13,8,8,6,20,26,9,8,0,15,15,53
401375460,New Orleans Privateers,N. Scott,4900429,,True,25.0,1,9,1,9,0,0,2,4,1,2,3,0,0,1,1,5,4
401375460,New Orleans Privateers,Z. Cooper,4705282,,True,32.0,3,6,3,6,0,0,0,2,1,4,5,1,0,0,4,1,6
401375460,New Orleans Privateers,T. Gipson,4705277,,True,22.0,1,3,0,0,1,3,0,0,0,0,0,0,0,0,0,3,3
401375460,New Orleans Privateers,D. Pryor,4703756,,True,36.0,4,7,3,5,1,2,3,5,1,6,7,2,1,0,0,1,12
401375460,New Orleans Privateers,J. Mathis,4282583,,True,29.0,4,12,4,10,0,2,0,0,0,3,3,4,2,0,2,3,8
401375460,New Orleans Privateers,Z. Cordis,4705285,,False,18.0,2,3,2,3,0,0,0,0,2,3,5,0,1,1,1,2,4
401375460,New Orleans Privateers,J. Ross,4433299,,False,10.0,2,6,2,4,0,2,0,0,0,1,1,0,0,0,2,0,4
401375460,New Orleans Privateers,T. Thompson,4900430,,False,15.0,3,5,3,5,0,0,0,2,3,0,3,0,0,3,1,2,6
401375460,New Orleans Privateers,K. Davis,4705280,,False,13.0,0,5,0,1,0,4,0,0,0,0,0,1,1,0,0,0,0
401375460,New Orleans Privateers,TEAM,TOTAL,TOTAL,False,,20,56,18,43,2,13,5,13,10,23,33,8,5,5,11,17,47
401375460,Houston Christian Huskies,A. Sutherland,4595692,,True,40.0,2,7,1,2,1,5,2,2,0,5,5,1,2,2,2,0,7
401375460,Houston Christian Huskies,M. Nzoiwu,4400275,,True,32.0,1,3,1,3,0,0,0,0,3,8,11,1,1,0,1,4,2
401375460,Houston Christian Huskies,T. Jefferson,4595688,,True,32.0,5,12,5,11,0,1,2,2,1,4,5,2,0,0,4,2,12
401375460,Houston Christian Huskies,K. Wilson,4595687,,True,40.0,5,11,3,7,2,4,8,8,1,4,5,5,0,0,2,2,20
401375460,Houston Christian Huskies,J. Vujakovic,4400274,,True,38.0,3,10,1,3,2,7,0,2,0,7,7,0,0,1,5,4,8
401375460,Houston Christian Huskies,N. Pierce,4704744,,False,2.0,0,0,0,0,0,0,0,0,0,0,0,0,0,0,0,1,0
401375460,Houston Christian Huskies,N. Collins,4595690,,False,7.0,1,2,1,2,0,0,0,0,0,1,1,1,0,0,0,0,2
401375460,Houston Christian Huskies,E. Maguire,4704741,,False,2.0,0,0,0,0,0,0,0,0,0,1,1,0,0,0,0,0,0
401375460,Houston Christian Huskies,L. Mapusua,4704731,,False,7.0,2,7,1,4,1,3,0,0,0,0,0,0,0,0,1,0,5
401375460,Houston Christian Huskies,TEAM,TOTAL,TOTAL,False,,19,52,13,32,6,20,12,14,10,31,41,10,3,3,16,13,56
401375177,Marist Red Foxes,Z. DeMember-Shazer,4704497,,True,19.0,5,10,5,9,0,1,0,0,1,3,4,0,3,1,1,5,10
401375177,Marist Red Foxes,S. Bailey,4595377,,True,42.0,4,8,1,3,3,5,0,0,3,2,5,3,0,0,1,3,11
401375177,Marist Red Foxes,A. Ellison,4704498,,True,28.0,1,11,0,3,1,8,0,0,1,3,4,6,3,0,2,1,3
401375177,Marist Red Foxes,T. Kennedy,4595374,,True,38.0,2,13,1,6,1,7,1,2,2,4,6,5,2,0,3,4,6
401375177,Marist Red Foxes,K. Krick,4399130,,True,41.0,7,17,2,6,5,11,2,4,3,2,5,2,2,0,0,4,21
401375177,Marist Red Foxes,E. Fox,4704496,,False,17.0,1,6,0,5,1,1,0,0,2,1,3,1,0,0,2,0,3
401375177,Marist Red Foxes,S. Boylan,4899850,,False,23.0,2,4,1,2,1,2,1,2,1,1,2,1,0,1,0,1,6
401375177,Marist Red Foxes,C. Cunningham,4899849,,False,11.0,0,2,0,2,0,0,0,0,1,1,2,0,0,1,1,3,0
401375177,Marist Red Foxes,J. Bonilla,4595376,,False,6.0,0,3,0,1,0,2,0,0,0,3,3,0,0,0,1,0,0
401375177,Marist Red Foxes,TEAM,TOTAL,TOTAL,False,,22,74,10,37,12,37,4,8,15,22,37,18,10,3,13,21,60
401375177,Manhattan Jaspers,P. Juric,4899848,,True,39.0,6,8,6,7,0,1,1,2,5,5,10,1,2,3,1,1,13
401375177,Manhattan Jaspers,J. Blagrove,4703674,,True,29.0,1,3,0,2,1,1,2,2,4,6,10,1,0,0,4,3,5
401375177,Manhattan Jaspers,B. Harvey-Carr,4594792,,True,19.0,0,5,0,2,0,3,0,0,0,5,5,2,0,0,4,4,0
401375177,Manhattan Jaspers,C. Warley,4282141,,True,44.0,4,13,4,13,0,0,3,3,3,10,13,3,1,3,0,1,11
401375177,Manhattan Jaspers,D. Davis,4399126,,True,39.0,7,20,5,15,2,5,6,7,0,2,2,1,1,0,7,1,22
401375177,Manhattan Jaspers,B. Nascimento,4899844,,False,1.0,0,1,0,0,0,1,0,0,0,0,0,0,0,0,0,0,0
401375177,Manhattan Jaspers,E. LaPointe,4595368,,False,34.0,4,13,4,8,0,5,2,2,2,6,8,3,2,0,1,1,10
401375177,Manhattan Jaspers,S. Watkins,4399127,,False,7.0,1,3,0,2,1,1,0,0,0,0,0,0,0,0,1,1,3
401375177,Manhattan Jaspers,S. Mäkelä,4282138,,False,13.0,1,1,1,1,0,0,2,2,1,2,3,2,0,0,2,1,4
401375177,Manhattan Jaspers,TEAM,TOTAL,TOTAL,False,,24,67,20,50,4,17,16,18,20,38,58,13,6,6,21,13,68
401375176,Rider Broncs,A. Ekerstedt,4704619,,True,31.0,0,4,0,2,0,2,1,2,1,7,8,2,1,0,1,3,1
401375176,Rider Broncs,R. Toussaint,4704617,,True,14.0,2,6,1,3,1,3,0,0,1,1,2,0,1,2,2,3,5
401375176,Rider Broncs,M. Firebaugh,4704621,,True,28.0,2,9,0,4,2,5,0,0,1,2,3,0,1,0,4,3,6
401375176,Rider Broncs,L. Evans,4704620,,True,39.0,4,11,4,10,0,1,8,9,1,0,1,1,0,0,1,1,16
401375176,Rider Broncs,J. Schiffer,4595239,,True,30.0,3,9,0,1,3,8,0,0,2,4,6,2,1,0,1,0,9
401375176,Rider Broncs,E. Strunk,4899869,,False,20.0,3,6,2,2,1,4,1,2,2,4,6,0,0,1,0,1,8
401375176,Rider Broncs,S. Bruintjes,4704618,,False,6.0,0,0,0,0,0,0,0,0,0,1,1,0,0,0,2,1,0
401375176,Rider Broncs,V. Toomey,4595396,,False,9.0,0,2,0,2,0,0,2,2,0,1,1,0,0,0,0,2,2
401375176,Rider Broncs,M. Lynch,4704616,,False,12.0,0,0,0,0,0,0,0,0,1,1,2,0,0,0,1,0,0
401375176,Rider Broncs,A. Mobley,4399137,,False,11.0,1,2,1,1,0,1,0,0,0,0,0,2,0,0,1,2,2
401375176,Rider Broncs,TEAM,TOTAL,TOTAL,False,,15,49,8,25,7,24,12,15,9,21,30,7,4,3,13,16,49
401375176,Quinnipiac Bobcats,A. Free,4399092,,True,21.0,2,7,2,6,0,1,3,3,1,2,3,0,1,1,0,3,7
401375176,Quinnipiac Bobcats,M. Morris,4433677,,True,26.0,4,13,4,13,0,0,2,2,2,6,8,3,1,2,2,1,10
401375176,Quinnipiac Bobcats,S. Bonner,4595390,,True,30.0,3,6,1,1,2,5,2,2,0,3,3,1,0,0,2,2,10
401375176,Quinnipiac Bobcats,R. Caverly,4399294,,True,29.0,2,8,0,3,2,5,2,2,0,3,3,2,0,0,0,1,8
401375176,Quinnipiac Bobcats,M. DeWees,4399091,,True,28.0,6,13,6,13,0,0,1,1,7,3,10,6,3,0,0,1,13
401375176,Quinnipiac Bobcats,G. LaBarge,4899864,,False,3.0,1,1,1,1,0,0,2,2,0,0,0,0,0,0,0,0,4
401375176,Quinnipiac Bobcats,T. White,4704552,,False,4.0,1,1,1,1,0,0,0,1,0,0,0,0,0,0,0,1,2
401375176,Quinnipiac Bobcats,C. Almeida,4595388,,False,2.0,1,1,1,1,0,0,0,0,0,0,0,0,0,0,0,0,2
401375176,Quinnipiac Bobcats,C. Haywood,4595389,,False,24.0,3,7,2,3,1,4,2,2,1,6,7,2,0,1,0,2,9
401375176,Quinnipiac Bobcats,R. Douglas,4899866,,False,3.0,1,1,1,1,0,0,0,0,0,0,0,0,0,0,0,1,2
401375176,Quinnipiac Bobcats,J. Grisdale,4899865,,False,11.0,0,1,0,0,0,1,0,0,0,0,0,0,0,0,1,1,0
401375176,Quinnipiac Bobcats,J. Casey,4704555,,False,2.0,0,0,0,0,0,0,0,0,0,1,1,0,0,0,0,0,0
401375176,Quinnipiac Bobcats,H. Smith,4704553,,False,4.0,1,1,1,1,0,0,0,0,0,0,0,1,0,0,1,0,2
401375176,Quinnipiac Bobcats,M. Helms,4433084,,False,13.0,1,2,1,2,0,0,0,0,0,0,0,2,0,0,0,0,2
401375176,Quinnipiac Bobcats,TEAM,TOTAL,TOTAL,False,,26,62,21,46,5,16,14,15,12,24,36,17,5,4,7,13,71
401375175,Iona Gaels,K. Athias,4707986,,True,29.0,2,5,2,5,0,0,2,4,3,9,12,2,0,2,3,0,6
401375175,Iona Gaels,M. Cenis,4899841,,True,16.0,0,1,0,1,0,0,0,0,0,0,0,0,0,0,0,0,0
401375175,Iona Gaels,O. Vezaldenos,4704437,,True,15.0,0,7,0,0,0,7,0,0,0,0,0,0,0,0,0,0,0
401375175,Iona Gaels,J. Camilion,4399121,,True,40.0,12,26,10,15,2,11,4,4,1,6,7,1,1,0,2,4,30
401375175,Iona Gaels,S. Mwai,4399119,,True,35.0,4,12,4,9,0,3,2,2,2,1,3,0,1,0,0,3,10
401375175,Iona Gaels,I. Lipinski,4899839,,False,18.0,2,6,2,6,0,0,2,4,2,2,4,0,0,0,2,3,6
401375175,Iona Gaels,J. Gomez,4899840,,False,22.0,2,4,2,2,0,2,0,0,0,1,1,1,0,1,1,3,4
401375175,Iona Gaels,T. Hodge-Carr,4704438,,False,25.0,2,4,1,3,1,1,1,1,4,2,6,1,0,0,1,4,6
401375175,Iona Gaels,J. Benn,4601643,,False,0.0,0,0,0,0,0,0,0,0,0,0,0,0,0,0,0,0,0
401375175,Iona Gaels,L. Becerra Perez,4595364,,False,0.0,0,0,0,0,0,0,0,0,0,0,0,0,0,0,0,1,0
401375175,Iona Gaels,J. Rogers,4281860,,False,0.0,0,0,0,0,0,0,0,0,0,0,0,0,0,0,0,0,0
401375175,Iona Gaels,TEAM,TOTAL,TOTAL,False,,24,65,21,41,3,24,11,15,14,21,35,5,2,3,9,18,62
401375175,Canisius Golden Griffins,K. Jackson,4399265,,True,21.0,2,4,2,4,0,0,2,2,4,8,12,1,1,0,3,3,6
401375175,Canisius Golden Griffins,E. Vaatanen,4281971,,True,19.0,0,1,0,0,0,1,0,0,0,2,2,0,1,0,2,5,0
401375175,Canisius Golden Griffins,D. Haskell,4704422,,True,33.0,6,15,3,8,3,7,6,6,0,3,3,3,2,0,4,1,21
401375175,Canisius Golden Griffins,S. Brown,4595357,,True,33.0,4,6,1,1,3,5,3,4,1,1,2,3,0,0,0,1,14
401375175,Canisius Golden Griffins,E. Joseph,4399161,,True,36.0,2,10,1,6,1,4,1,2,2,3,5,2,0,0,1,2,6
401375175,Canisius Golden Griffins,R. Porter,4899747,,False,11.0,1,1,1,1,0,0,0,0,1,3,4,0,0,0,0,4,2
401375175,Canisius Golden Griffins,C. Stubbs,4899746,,False,17.0,3,7,3,6,0,1,3,3,1,3,4,1,0,0,3,1,9
401375175,Canisius Golden Griffins,A. Lexa,4899743,,False,22.0,4,7,3,5,1,2,2,2,1,1,2,0,1,0,2,4,11
401375175,Canisius Golden Griffins,L. Gattozzi,4899741,,False,8.0,0,2,0,2,0,0,2,2,0,2,2,0,0,0,0,0,2
401375175,Canisius Golden Griffins,TEAM,TOTAL,TOTAL,False,,22,53,14,33,8,20,19,21,12,28,40,10,5,0,16,21,71
401375174,Siena Saints,S. Philoxy,4281380,,True,34.0,9,21,9,20,0,1,3,6,6,13,19,2,1,3,3,1,21
401375174,Siena Saints,A. Knoflach,4899877,,True,21.0,2,3,0,1,2,2,0,0,0,3,3,0,0,0,0,1,6
401375174,Siena Saints,A. Jackson,4704629,,True,26.0,4,11,2,5,2,6,2,2,3,0,3,0,1,0,1,3,12
401375174,Siena Saints,D. Winston,4282198,,True,34.0,1,2,1,2,0,0,5,6,0,2,2,2,0,0,2,4,7
401375174,Siena Saints,R. Brown,4281840,,True,36.0,4,11,4,11,0,0,5,6,1,9,10,3,0,0,3,2,13
401375174,Siena Saints,E. Selimovic,4899878,,False,1.0,0,1,0,1,0,0,0,0,0,0,0,0,0,0,0,1,0
401375174,Siena Saints,A. Brown,4899879,,False,5.0,1,3,1,3,0,0,1,2,0,1,1,0,0,0,1,3,3
401375174,Siena Saints,C. Talbot,4899876,,False,12.0,0,1,0,1,0,0,1,2,0,0,0,1,0,0,1,1,1
401375174,Siena Saints,V. Fontenelle-Posson,4433552,,False,31.0,2,5,1,2,1,3,1,2,2,4,6,2,0,0,0,0,6
401375174,Siena Saints,TEAM,TOTAL,TOTAL,False,,23,58,18,46,5,12,18,26,12,32,44,10,2,3,13,16,69
401375174,Monmouth Hawks,B. Kranbuhl,4704490,,True,17.0,2,5,2,5,0,0,0,0,1,2,3,0,0,0,2,3,4
401375174,Monmouth Hawks,J. Hall,4704487,,True,19.0,0,7,0,5,0,2,2,2,1,1,2,2,1,0,0,0,2
401375174,Monmouth Hawks,S. Clark,4281487,,True,35.0,9,19,6,10,3,9,0,1,0,0,0,4,0,0,2,3,21
401375174,Monmouth Hawks,J. Louro,4281169,,True,30.0,2,8,2,2,0,6,3,3,1,8,9,1,1,0,1,2,7
401375174,Monmouth Hawks,B. Livingston,4281071,,True,16.0,2,5,2,5,0,0,4,4,3,0,3,0,0,0,3,4,8
401375174,Monmouth Hawks,Z. Chevre,4704488,,False,11.0,0,0,0,0,0,0,0,0,0,1,1,1,0,0,0,2,0
401375174,Monmouth Hawks,S. Kaupyte,4595380,,False,2.0,0,1,0,1,0,0,0,0,2,0,2,0,0,0,1,1,0
401375174,Monmouth Hawks,L. Thomas,4399177,,False,14.0,2,3,2,3,0,0,1,2,1,3,4,1,2,0,1,4,5
401375174,Monmouth Hawks,A. Panayides,4899852,,False,14.0,0,1,0,0,0,1,0,0,1,1,2,1,0,0,0,2,0
401375174,Monmouth Hawks,K. Donovan,4596543,,False,26.0,5,11,2,4,3,7,5,7,0,4,4,1,1,1,2,0,18
401375174,Monmouth Hawks,A. Wallace,4399173,,False,16.0,0,3,0,3,0,0,0,0,0,1,1,0,0,0,1,5,0
401375174,Monmouth Hawks,TEAM,TOTAL,TOTAL,False,,22,63,16,38,6,25,15,19,12,25,37,11,5,1,13,26,65
401375173,Saint Peter's Peacocks,S. Castro,4704637,,True,24.0,1,1,1,1,0,0,0,0,0,3,3,5,2,1,3,1,2
401375173,Saint Peter's Peacocks,K. Brown,4594791,,True,12.0,1,3,1,3,0,0,1,2,3,5,8,2,0,0,1,1,3
401375173,Saint Peter's Peacocks,N. O'Neil,4704633,,True,21.0,1,4,0,2,1,2,1,2,0,2,2,1,0,0,0,2,4
401375173,Saint Peter's Peacocks,K. Crane,4400113,,True,25.0,3,11,3,9,0,2,1,2,0,1,1,1,2,0,3,5,7
401375173,Saint Peter's Peacocks,K. Williams,4399147,,True,29.0,2,9,1,3,1,6,0,0,0,0,0,1,0,0,2,3,5
401375173,Saint Peter's Peacocks,K. Dawkins,4899871,,False,31.0,4,6,4,6,0,0,2,4,2,7,9,1,0,1,1,3,10
401375173,Saint Peter's Peacocks,V. Ikenasio,4704638,,False,13.0,2,4,2,4,0,0,0,0,3,3,6,0,0,0,1,0,4
401375173,Saint Peter's Peacocks,I. Felix,4899873,,False,4.0,0,1,0,0,0,1,0,0,1,0,1,0,0,0,0,0,0
401375173,Saint Peter's Peacocks,R. Kuhl,4704634,,False,21.0,3,10,1,3,2,7,0,0,1,1,2,0,0,0,3,0,8
401375173,Saint Peter's Peacocks,B. Salawu,4704632,,False,10.0,0,5,0,1,0,4,0,0,0,1,1,1,0,0,1,1,0
401375173,Saint Peter's Peacocks,T. McQueen,4399140,,False,10.0,0,3,0,1,0,2,0,0,0,1,1,0,0,0,1,2,0
401375173,Saint Peter's Peacocks,TEAM,TOTAL,TOTAL,False,,17,57,13,33,4,24,5,10,15,24,39,12,4,2,18,18,43
401375173,Fairfield Stags,A. Hernangomez,4399117,,True,22.0,6,7,4,5,2,2,2,5,3,5,8,2,3,0,5,4,16
401375173,Fairfield Stags,L. Lopez-Senechal,4399114,,True,28.0,4,13,2,8,2,5,4,6,2,3,5,2,1,2,2,1,14
401375173,Fairfield Stags,C. Cavanaugh,4281780,,True,21.0,4,11,4,10,0,1,1,2,1,1,2,0,0,3,1,5,9
401375173,Fairfield Stags,S. Lowery,4281189,,True,30.0,0,2,0,2,0,0,3,4,2,4,6,2,3,0,2,0,3
401375173,Fairfield Stags,R. Hakes,4399115,,True,25.0,2,3,2,3,0,0,2,2,1,1,2,2,0,0,0,0,6
401375173,Fairfield Stags,D. Tirado,4704431,,False,3.0,0,2,0,1,0,1,0,0,0,2,2,0,0,1,0,0,0
401375173,Fairfield Stags,M. Daleba,4704430,,False,5.0,0,2,0,2,0,0,1,2,1,1,2,0,2,0,2,0,1
401375173,Fairfield Stags,B. Tatarian,4899783,,False,0.0,0,0,0,0,0,0,0,0,0,0,0,0,0,0,0,0,0
401375173,Fairfield Stags,J. Brown,4704429,,False,10.0,0,2,0,0,0,2,0,0,0,0,0,1,1,0,3,3,0
401375173,Fairfield Stags,M. Rubino,4704428,,False,10.0,1,3,1,2,0,1,2,2,0,1,1,1,0,0,0,0,4
401375173,Fairfield Stags,J. Polansky,4595673,,False,3.0,0,0,0,0,0,0,0,0,0,0,0,0,0,0,0,0,0
401375173,Fairfield Stags,M. Martin,4595363,,False,14.0,0,0,0,0,0,0,0,2,0,3,3,1,0,1,1,0,0
401375173,Fairfield Stags,S. Lewis,4282062,,False,29.0,1,5,0,1,1,4,0,0,0,3,3,1,1,3,0,1,3
401375173,Fairfield Stags,TEAM,TOTAL,TOTAL,False,,18,50,13,34,5,16,15,25,12,29,41,12,11,10,17,14,56
401375172,Rider Broncs,A. Ekerstedt,4704619,,True,35.0,1,4,1,3,0,1,0,0,2,4,6,2,0,1,1,1,2
401375172,Rider Broncs,R. Toussaint,4704617,,True,29.0,6,9,5,7,1,2,3,4,3,4,7,1,0,0,3,3,16
401375172,Rider Broncs,M. Firebaugh,4704621,,True,31.0,3,8,0,0,3,8,0,0,0,3,3,3,2,0,2,1,9
401375172,Rider Broncs,L. Evans,4704620,,True,35.0,7,15,6,14,1,1,3,3,1,0,1,1,1,0,0,1,18
401375172,Rider Broncs,J. Schiffer,4595239,,True,35.0,5,12,1,3,4,9,0,0,0,1,1,3,1,0,1,0,14
401375172,Rider Broncs,V. Toomey,4595396,,False,16.0,0,2,0,2,0,0,0,0,2,3,5,1,0,0,0,0,0
401375172,Rider Broncs,A. Mobley,4399137,,False,19.0,0,3,0,1,0,2,2,2,0,4,4,2,2,1,1,2,2
401375172,Rider Broncs,TEAM,TOTAL,TOTAL,False,,22,53,13,30,9,23,8,9,10,20,30,13,6,2,11,8,61
401375172,Fairfield Stags,A. Hernangomez,4399117,,True,40.0,3,8,3,7,0,1,0,0,7,3,10,3,0,0,2,0,6
401375172,Fairfield Stags,L. Lopez-Senechal,4399114,,True,38.0,11,26,8,16,3,10,5,6,1,4,5,2,2,0,1,0,30
401375172,Fairfield Stags,C. Cavanaugh,4281780,,True,34.0,6,12,6,12,0,0,0,0,2,3,5,0,0,0,2,3,12
401375172,Fairfield Stags,S. Lowery,4281189,,True,28.0,2,7,0,3,2,4,0,0,2,0,2,0,1,0,0,1,6
401375172,Fairfield Stags,R. Hakes,4399115,,True,39.0,3,4,1,1,2,3,0,0,2,6,8,10,1,0,3,0,8
401375172,Fairfield Stags,J. Brown,4704429,,False,6.0,0,1,0,1,0,0,0,0,0,0,0,2,0,0,0,1,0
401375172,Fairfield Stags,M. Martin,4595363,,False,0.0,0,0,0,0,0,0,0,0,0,0,0,0,0,0,0,0,0
401375172,Fairfield Stags,S. Lewis,4282062,,False,15.0,1,3,0,1,1,2,0,0,0,2,2,1,0,0,0,1,3
401375172,Fairfield Stags,TEAM,TOTAL,TOTAL,False,,26,61,18,41,8,20,5,6,15,21,36,18,4,0,9,6,65
401375171,Niagara Purple Eagles,O. Mason,4399134,,True,30.0,5,11,4,10,1,1,3,8,5,5,10,1,5,0,1,2,14
401375171,Niagara Purple Eagles,Aa. Parker,4899856,,True,26.0,4,10,3,6,1,4,1,4,5,4,9,1,3,1,6,4,10
401375171,Niagara Purple Eagles,L. Porter,4704527,,True,27.0,2,6,2,4,0,2,2,2,2,1,3,2,1,1,0,1,6
401375171,Niagara Purple Eagles,An. Parker,4595385,,True,39.0,9,26,8,20,1,6,7,8,1,6,7,5,7,0,3,2,26
401375171,Niagara Purple Eagles,A. Haar,4399135,,True,28.0,1,8,0,4,1,4,0,0,0,1,1,1,2,0,1,0,3
401375171,Niagara Purple Eagles,A. Johnson,4715967,,False,4.0,0,0,0,0,0,0,0,0,0,0,0,0,0,0,0,0,0
401375171,Niagara Purple Eagles,S. Glover,4704528,,False,13.0,2,4,2,4,0,0,0,0,1,1,2,0,0,0,0,2,4
401375171,Niagara Purple Eagles,S. Faulcon,4595386,,False,3.0,0,0,0,0,0,0,0,0,0,0,0,0,0,0,0,0,0
401375171,Niagara Purple Eagles,L. Roe,4899855,,False,3.0,0,0,0,0,0,0,0,0,0,0,0,0,0,0,0,0,0
401375171,Niagara Purple Eagles,B. Jones,4704525,,False,10.0,0,2,0,1,0,1,1,2,1,1,2,0,0,0,1,0,1
401375171,Niagara Purple Eagles,K. Grimshaw,4399136,,False,15.0,0,3,0,1,0,2,0,0,1,2,3,0,1,0,4,0,0
401375171,Niagara Purple Eagles,M. Yelle,4399133,,False,27.0,1,4,1,3,0,1,0,0,2,0,2,1,2,0,3,2,2
401375171,Niagara Purple Eagles,TEAM,TOTAL,TOTAL,False,,24,74,20,53,4,21,14,24,19,21,40,11,21,2,19,13,66
401375171,Iona Gaels,K. Athias,4707986,,True,41.0,11,14,11,14,0,0,0,2,2,9,11,3,1,2,6,3,22
401375171,Iona Gaels,M. Cenis,4899841,,True,22.0,4,4,4,4,0,0,0,0,0,3,3,3,1,0,6,3,8
401375171,Iona Gaels,O. Vezaldenos,4704437,,True,42.0,2,5,2,3,0,2,0,0,0,6,6,3,0,1,2,2,4
401375171,Iona Gaels,J. Camilion,4399121,,True,27.0,4,7,4,6,0,1,0,0,0,3,3,1,1,0,5,5,8
401375171,Iona Gaels,S. Mwai,4399119,,True,39.0,1,9,1,3,0,6,0,0,0,4,4,6,1,0,9,2,2
401375171,Iona Gaels,I. Lipinski,4899839,,False,5.0,0,0,0,0,0,0,0,0,0,1,1,1,0,0,3,2,0
401375171,Iona Gaels,J. Gomez,4899840,,False,11.0,0,3,0,1,0,2,0,0,0,0,0,0,2,0,1,2,0
401375171,Iona Gaels,T. Hodge-Carr,4704438,,False,36.0,3,5,3,5,0,0,0,2,0,4,4,2,1,0,7,4,6
401375171,Iona Gaels,J. Benn,4601643,,False,2.0,0,0,0,0,0,0,0,0,0,0,0,0,0,0,0,0,0
401375171,Iona Gaels,TEAM,TOTAL,TOTAL,False,,25,47,25,36,0,11,0,4,2,31,33,19,7,3,39,23,50
401375170,Siena Saints,S. Philoxy,4281380,,True,23.0,4,11,4,11,0,0,0,1,1,10,11,3,3,2,5,5,8
401375170,Siena Saints,A. Knoflach,4899877,,True,25.0,2,8,0,2,2,6,0,0,1,3,4,1,0,1,0,4,6
401375170,Siena Saints,V. Fontenelle-Posson,4433552,,True,30.0,4,8,4,6,0,2,5,6,6,5,11,0,1,0,1,3,13
401375170,Siena Saints,D. Winston,4282198,,True,34.0,1,4,1,3,0,1,0,0,0,2,2,6,2,0,3,0,2
401375170,Siena Saints,R. Brown,4281840,,True,32.0,5,14,5,14,0,0,1,6,1,6,7,2,1,0,3,2,11
401375170,Siena Saints,E. Selimovic,4899878,,False,3.0,0,1,0,0,0,1,0,0,0,0,0,0,0,0,0,1,0
401375170,Siena Saints,A. Brown,4899879,,False,17.0,5,10,5,10,0,0,1,2,5,4,9,0,1,3,1,2,11
401375170,Siena Saints,C. Talbot,4899876,,False,12.0,2,3,2,3,0,0,0,0,0,0,0,0,0,0,1,1,4
401375170,Siena Saints,A. Jackson,4704629,,False,24.0,2,8,1,4,1,4,9,10,0,2,2,2,0,0,1,3,14
401375170,Siena Saints,TEAM,TOTAL,TOTAL,False,,25,67,22,53,3,14,16,25,16,35,51,14,8,6,15,21,69
401375170,Saint Peter's Peacocks,S. Castro,4704637,,True,14.0,0,2,0,2,0,0,0,0,2,4,6,1,1,0,0,3,0
401375170,Saint Peter's Peacocks,K. Brown,4594791,,True,33.0,9,19,8,17,1,2,9,13,5,8,13,2,1,0,2,2,28
401375170,Saint Peter's Peacocks,N. O'Neil,4704633,,True,24.0,1,7,1,5,0,2,0,0,1,3,4,2,4,0,1,2,2
401375170,Saint Peter's Peacocks,K. Crane,4400113,,True,25.0,0,6,0,3,0,3,1,4,0,3,3,2,1,0,1,4,1
401375170,Saint Peter's Peacocks,K. Williams,4399147,,True,24.0,2,3,2,3,0,0,4,4,0,1,1,0,0,0,4,2,8
401375170,Saint Peter's Peacocks,K. Dawkins,4899871,,False,12.0,2,5,2,5,0,0,0,0,0,0,0,0,0,0,1,0,4
401375170,Saint Peter's Peacocks,V. Ikenasio,4704638,,False,5.0,0,1,0,1,0,0,2,4,1,3,4,0,0,0,0,0,2
401375170,Saint Peter's Peacocks,R. Kuhl,4704634,,False,23.0,2,10,0,4,2,6,0,0,0,2,2,0,0,0,3,1,6
401375170,Saint Peter's Peacocks,B. Salawu,4704632,,False,19.0,0,6,0,2,0,4,0,0,1,1,2,1,0,0,1,2,0
401375170,Saint Peter's Peacocks,T. McQueen,4399140,,False,21.0,3,7,2,3,1,4,0,1,1,4,5,1,1,0,1,4,7
401375170,Saint Peter's Peacocks,TEAM,TOTAL,TOTAL,False,,19,66,15,45,4,21,16,26,14,31,45,9,8,0,15,20,58
401375169,Quinnipiac Bobcats,A. Free,4399092,,True,32.0,3,15,1,8,2,7,3,6,1,4,5,0,1,1,0,2,11
401375169,Quinnipiac Bobcats,M. Morris,4433677,,True,40.0,8,17,8,15,0,2,2,2,0,7,7,3,1,5,3,3,18
401375169,Quinnipiac Bobcats,S. Bonner,4595390,,True,21.0,0,2,0,0,0,2,0,0,1,3,4,0,0,0,1,0,0
401375169,Quinnipiac Bobcats,R. Caverly,4399294,,True,43.0,6,11,4,7,2,4,1,2,0,5,5,8,1,0,2,4,15
401375169,Quinnipiac Bobcats,M. DeWees,4399091,,True,39.0,6,14,6,13,0,1,6,6,3,5,8,1,1,1,4,2,18
401375169,Quinnipiac Bobcats,G. LaBarge,4899864,,False,1.0,0,0,0,0,0,0,0,0,0,0,0,0,0,0,0,0,0
401375169,Quinnipiac Bobcats,T. White,4704552,,False,3.0,1,2,1,2,0,0,0,0,2,0,2,0,0,0,0,2,2
401375169,Quinnipiac Bobcats,C. Haywood,4595389,,False,14.0,0,2,0,0,0,2,2,2,0,4,4,1,0,2,2,3,2
401375169,Quinnipiac Bobcats,J. Grisdale,4899865,,False,26.0,1,2,0,1,1,1,0,0,0,1,1,2,1,0,1,5,3
401375169,Quinnipiac Bobcats,J. Casey,4704555,,False,2.0,0,0,0,0,0,0,0,0,0,0,0,0,0,0,0,0,0
401375169,Quinnipiac Bobcats,M. Helms,4433084,,False,4.0,0,1,0,1,0,0,0,0,0,0,0,0,2,0,2,0,0
401375169,Quinnipiac Bobcats,TEAM,TOTAL,TOTAL,False,,25,66,20,47,5,19,14,18,8,31,39,15,7,9,16,21,69
401375169,Manhattan Jaspers,P. Juric,4899848,,True,39.0,5,7,4,6,1,1,1,2,3,10,13,1,1,4,2,2,12
401375169,Manhattan Jaspers,J. Blagrove,4703674,,True,44.0,4,7,4,7,0,0,4,8,6,8,14,0,1,2,4,3,12
401375169,Manhattan Jaspers,B. Harvey-Carr,4594792,,True,38.0,5,15,4,10,1,5,0,0,3,5,8,4,2,0,1,5,11
401375169,Manhattan Jaspers,C. Warley,4282141,,True,14.0,0,2,0,2,0,0,0,0,0,2,2,0,0,0,2,1,0
401375169,Manhattan Jaspers,D. Davis,4399126,,True,44.0,13,30,12,27,1,3,6,11,0,4,4,4,3,0,5,1,33
401375169,Manhattan Jaspers,B. Wilson,4705296,,False,3.0,0,0,0,0,0,0,0,0,0,1,1,0,0,0,1,1,0
401375169,Manhattan Jaspers,B. Nascimento,4899844,,False,1.0,0,0,0,0,0,0,0,0,0,0,0,0,0,0,0,0,0
401375169,Manhattan Jaspers,E. LaPointe,4595368,,False,25.0,1,3,1,3,0,0,1,4,2,3,5,3,1,0,1,2,3
401375169,Manhattan Jaspers,S. Watkins,4399127,,False,8.0,0,4,0,1,0,3,0,0,0,0,0,0,0,0,0,0,0
401375169,Manhattan Jaspers,S. Mäkelä,4282138,,False,9.0,0,1,0,1,0,0,2,2,0,2,2,0,0,0,0,1,2
401375169,Manhattan Jaspers,TEAM,TOTAL,TOTAL,False,,28,69,25,57,3,12,14,27,17,35,52,12,8,6,16,16,73
401375168,Monmouth Hawks,B. Kranbuhl,4704490,,True,19.0,9,10,9,10,0,0,0,0,2,5,7,0,1,3,3,1,18
401375168,Monmouth Hawks,J. Hall,4704487,,True,26.0,4,6,4,4,0,2,0,0,1,2,3,1,1,0,0,0,8
401375168,Monmouth Hawks,A. Vanderhoop,4704485,,True,16.0,1,2,1,1,0,1,0,0,0,5,5,1,1,0,1,0,2
401375168,Monmouth Hawks,S. Clark,4281487,,True,37.0,3,9,1,3,2,6,1,2,1,7,8,6,1,0,8,2,9
401375168,Monmouth Hawks,J. Louro,4281169,,True,17.0,0,6,0,3,0,3,0,0,3,4,7,1,0,0,3,3,0
401375168,Monmouth Hawks,Z. Chevre,4704488,,False,3.0,0,0,0,0,0,0,0,0,0,0,0,1,0,0,0,1,0
401375168,Monmouth Hawks,L. Thomas,4399177,,False,21.0,3,10,3,10,0,0,0,0,3,5,8,0,2,0,0,1,6
401375168,Monmouth Hawks,A. Panayides,4899852,,False,25.0,0,2,0,1,0,1,0,0,0,0,0,2,1,0,1,1,0
401375168,Monmouth Hawks,K. Donovan,4596543,,False,19.0,0,6,0,1,0,5,1,2,2,4,6,3,0,1,2,1,1
401375168,Monmouth Hawks,A. Wallace,4399173,,False,5.0,0,0,0,0,0,0,0,0,1,0,1,0,0,0,0,0,0
401375168,Monmouth Hawks,B. Livingston,4281071,,False,12.0,3,7,1,4,2,3,0,0,0,2,2,1,0,0,4,3,8
401375168,Monmouth Hawks,TEAM,TOTAL,TOTAL,False,,23,58,19,37,4,21,2,4,13,38,51,16,7,4,23,13,52
401375168,Marist Red Foxes,Z. DeMember-Shazer,4704497,,True,27.0,4,13,4,13,0,0,1,2,0,0,0,1,3,3,1,1,9
401375168,Marist Red Foxes,S. Bailey,4595377,,True,28.0,2,8,2,6,0,2,1,2,0,2,2,1,0,0,1,2,5
401375168,Marist Red Foxes,A. Ellison,4704498,,True,30.0,1,4,1,4,0,0,3,4,1,5,6,3,2,1,3,2,5
401375168,Marist Red Foxes,T. Kennedy,4595374,,True,37.0,4,19,4,15,0,4,2,5,1,5,6,2,3,1,1,2,10
401375168,Marist Red Foxes,K. Krick,4399130,,True,35.0,3,8,3,7,0,1,0,0,2,2,4,1,0,0,2,2,6
401375168,Marist Red Foxes,E. Fox,4704496,,False,6.0,0,1,0,1,0,0,0,0,0,1,1,0,1,0,0,0,0
401375168,Marist Red Foxes,S. Boylan,4899850,,False,7.0,0,2,0,0,0,2,2,2,0,1,1,0,1,0,1,1,2
401375168,Marist Red Foxes,C. Cunningham,4899849,,False,14.0,1,1,1,1,0,0,0,0,1,0,1,0,0,0,0,0,2
401375168,Marist Red Foxes,J. Bonilla,4595376,,False,16.0,2,4,1,1,1,3,0,0,1,5,6,2,1,0,1,1,5
401375168,Marist Red Foxes,TEAM,TOTAL,TOTAL,False,,17,60,16,48,1,12,9,15,8,22,30,10,11,5,11,11,44
401374992,UC San Diego Tritons,B. Claros,4704403,,True,24.0,4,6,1,1,3,5,0,0,0,0,0,7,0,0,1,0,11
401374992,UC San Diego Tritons,M. Baxter,4704402,,True,25.0,8,10,3,3,5,7,1,2,0,2,2,0,1,0,1,0,22
401374992,UC San Diego Tritons,J. Macabuhay,4704401,,True,18.0,3,7,3,6,0,1,1,1,0,3,3,5,0,0,1,0,7
401374992,UC San Diego Tritons,E. Cangelosi,4704400,,True,27.0,7,10,4,6,3,4,0,0,1,7,8,1,1,0,1,1,17
401374992,UC San Diego Tritons,S. Brown,4399164,,True,22.0,0,6,0,3,0,3,1,2,0,3,3,4,1,0,1,3,1
401374992,UC San Diego Tritons,B. Mullings,4899733,,False,21.0,1,2,1,2,0,0,0,0,3,5,8,1,0,5,3,3,2
401374992,UC San Diego Tritons,I. Forsyth,4899731,,False,16.0,2,4,1,2,1,2,0,0,1,2,3,2,0,0,0,1,5
401374992,UC San Diego Tritons,C. Thompson,4899732,,False,10.0,1,2,0,1,1,1,0,0,0,1,1,2,0,0,3,1,3
401374992,UC San Diego Tritons,P. Montgomery,4704408,,False,22.0,7,9,2,3,5,6,0,0,0,6,6,2,0,0,1,0,19
401374992,UC San Diego Tritons,U. Chamberlin,4594874,,False,15.0,0,0,0,0,0,0,3,5,1,4,5,3,1,0,2,1,3
401374992,UC San Diego Tritons,TEAM,TOTAL,TOTAL,False,,33,56,15,27,18,29,6,10,7,33,40,27,4,5,15,10,90
401374992,Cal Poly Mustangs,J. Nielacna,4400510,,True,11.0,2,2,2,2,0,0,0,0,1,1,2,1,0,0,1,2,4
401374992,Cal Poly Mustangs,S. Bourland,4899654,,True,26.0,3,11,3,8,0,3,1,2,4,1,5,0,4,1,1,1,7
401374992,Cal Poly Mustangs,J. Anousinh,4899653,,True,30.0,1,6,1,5,0,1,1,2,2,4,6,1,1,0,4,4,3
401374992,Cal Poly Mustangs,M. Willett,4400024,,True,29.0,3,7,3,5,0,2,0,0,0,3,3,2,0,0,1,1,6
401374992,Cal Poly Mustangs,M. Vick,4400018,,True,10.0,0,1,0,1,0,0,0,0,0,1,1,0,0,0,0,0,0
401374992,Cal Poly Mustangs,Z. Stachowski,4704343,,False,17.0,2,3,2,3,0,0,5,6,1,0,1,1,0,0,0,1,9
401374992,Cal Poly Mustangs,F. Bergstrom,4899656,,False,7.0,2,4,2,3,0,1,0,0,0,1,1,0,0,1,0,0,4
401374992,Cal Poly Mustangs,H. Scanlan,4281948,,False,14.0,1,2,1,2,0,0,0,0,2,2,4,2,0,1,1,0,2
401374992,Cal Poly Mustangs,J. Dickson,4704339,,False,28.0,2,12,1,4,1,8,1,2,0,2,2,1,2,0,1,2,6
401374992,Cal Poly Mustangs,S. Dumitrescu,4433701,,False,8.0,1,8,1,8,0,0,0,0,1,2,3,0,1,0,0,0,2
401374992,Cal Poly Mustangs,A. Shah,4899652,,False,20.0,2,7,1,2,1,5,0,0,0,2,2,1,0,1,0,1,5
401374992,Cal Poly Mustangs,TEAM,TOTAL,TOTAL,False,,19,63,17,43,2,20,8,12,11,19,30,9,8,4,10,12,48
401374991,UC Davis Aggies,C. Hall,4281712,,True,31.0,6,12,3,9,3,3,4,5,2,6,8,5,3,2,3,0,19
401374991,UC Davis Aggies,K. Konrad,4281711,,True,22.0,4,8,2,4,2,4,1,2,1,1,2,1,3,0,2,2,11
401374991,UC Davis Aggies,S. Stobbart,4281710,,True,23.0,4,8,3,7,1,1,4,4,2,7,9,4,0,2,2,3,13
401374991,UC Davis Aggies,S. Burns,4899719,,True,14.0,1,4,1,2,0,2,0,0,0,2,2,2,0,0,1,2,2
401374991,UC Davis Aggies,E. Turner,4595205,,True,23.0,4,9,3,4,1,5,0,0,1,1,2,1,0,0,0,1,9
401374991,UC Davis Aggies,M. Harris,4704336,,False,19.0,2,4,0,1,2,3,0,0,1,3,4,1,1,0,1,1,6
401374991,UC Davis Aggies,L. Svanholm,4281822,,False,14.0,1,1,1,1,0,0,0,0,2,1,3,0,0,0,4,1,2
401374991,UC Davis Aggies,K. Lilly,4595207,,False,8.0,1,2,1,2,0,0,0,0,1,3,4,0,0,0,0,1,2
401374991,UC Davis Aggies,M. Langi,4899720,,False,8.0,1,4,0,0,1,4,0,0,1,1,2,0,1,0,1,0,3
401374991,UC Davis Aggies,C. Gray,4595204,,False,24.0,0,1,0,0,0,1,0,0,0,2,2,5,1,0,3,2,0
401374991,UC Davis Aggies,M. Sanders,4400058,,False,14.0,1,5,0,0,1,5,0,0,0,2,2,1,2,0,0,1,3
401374991,UC Davis Aggies,TEAM,TOTAL,TOTAL,False,,25,58,14,30,11,28,9,11,13,34,47,20,11,4,17,14,70
401374991,Cal State Fullerton Titans,K. Neff,4595189,,True,22.0,2,4,0,0,2,4,0,0,2,1,3,0,0,0,1,2,6
401374991,Cal State Fullerton Titans,C. Gill,4281455,,True,12.0,0,5,0,4,0,1,0,0,1,1,2,0,1,0,1,2,0
401374991,Cal State Fullerton Titans,A. Lewis,4704361,,True,17.0,2,4,2,4,0,0,2,4,3,1,4,1,0,0,3,3,6
401374991,Cal State Fullerton Titans,L. Wahinekapu,4902813,,True,18.0,3,12,2,5,1,7,3,3,0,1,1,0,2,0,2,0,10
401374991,Cal State Fullerton Titans,G. Vidmar,4704360,,True,31.0,1,7,0,3,1,4,0,0,3,1,4,1,2,0,1,0,3
401374991,Cal State Fullerton Titans,A. Hernandez,4902816,,False,19.0,2,7,2,7,0,0,0,0,1,7,8,1,0,0,1,0,4
401374991,Cal State Fullerton Titans,R. MacDonald,4902815,,False,20.0,1,5,0,1,1,4,1,2,0,4,4,0,3,0,1,0,4
401374991,Cal State Fullerton Titans,N. Panagiotopoulou Andritsopoulou,4281268,,False,17.0,2,4,0,0,2,4,0,0,0,0,0,0,0,0,1,2,6
401374991,Cal State Fullerton Titans,B. Furch,4902817,,False,25.0,0,5,0,3,0,2,1,2,0,0,0,3,1,0,2,0,1
401374991,Cal State Fullerton Titans,E. De Vera,4902814,,False,6.0,0,4,0,3,0,1,0,0,2,0,2,0,0,0,2,0,0
401374991,Cal State Fullerton Titans,U. Jovanovic,4902811,,False,13.0,1,4,1,4,0,0,0,0,1,1,2,0,1,0,2,2,2
401374991,Cal State Fullerton Titans,TEAM,TOTAL,TOTAL,False,,14,61,7,34,7,27,7,11,15,20,35,6,10,0,17,11,42
401374990,UC Irvine Anteaters,S. Locandro,4595211,,True,11.0,1,1,1,1,0,0,0,0,0,3,3,0,0,0,0,2,2
401374990,UC Irvine Anteaters,N. Hunt,4281707,,True,10.0,1,3,1,2,0,1,0,0,0,1,1,1,0,0,1,1,2
401374990,UC Irvine Anteaters,N. Tom,4899722,,True,26.0,4,5,3,3,1,2,0,0,2,5,7,1,1,0,2,2,9
401374990,UC Irvine Anteaters,J. Cadee,4595210,,True,25.0,3,7,1,1,2,6,0,0,0,4,4,4,2,0,1,0,8
401374990,UC Irvine Anteaters,K. Williams,4595209,,True,34.0,6,16,3,10,3,6,5,6,1,4,5,2,3,0,0,0,20
401374990,UC Irvine Anteaters,C. Kaupu,4704426,,False,13.0,3,5,3,4,0,1,0,0,0,1,1,0,0,0,0,0,6
401374990,UC Irvine Anteaters,M. Kapinga,4400059,,False,12.0,0,3,0,3,0,0,2,2,1,0,1,0,1,0,0,3,2
401374990,UC Irvine Anteaters,T. Dusharm,3906747,,False,16.0,1,6,1,6,0,0,2,2,3,1,4,1,0,1,0,3,4
401374990,UC Irvine Anteaters,O. Williams,4899726,,False,17.0,1,6,1,4,0,2,0,0,2,4,6,1,0,0,0,0,2
401374990,UC Irvine Anteaters,H. Hernandez,4899725,,False,23.0,6,12,6,8,0,4,0,0,1,5,6,0,0,0,1,1,12
401374990,UC Irvine Anteaters,D. Lee,4899724,,False,6.0,0,0,0,0,0,0,0,0,0,1,1,3,1,0,0,0,0
401374990,UC Irvine Anteaters,A. Scharpf,4899723,,False,4.0,0,0,0,0,0,0,0,0,1,0,1,0,0,0,0,0,0
401374990,UC Irvine Anteaters,T. Ross,4704423,,False,3.0,0,1,0,0,0,1,0,0,0,0,0,0,0,0,1,1,0
401374990,UC Irvine Anteaters,TEAM,TOTAL,TOTAL,False,,26,65,20,42,6,23,9,10,12,31,43,13,8,1,7,13,67
401374990,Cal State Bakersfield Roadrunners,H. van Schaik,4899644,,True,14.0,0,3,0,3,0,0,0,0,2,4,6,3,0,0,2,2,0
401374990,Cal State Bakersfield Roadrunners,J. Eggleston,4282084,,True,35.0,7,15,6,12,1,3,4,5,0,7,7,1,1,0,2,3,19
401374990,Cal State Bakersfield Roadrunners,S. Johnson,4899642,,True,5.0,0,1,0,0,0,1,0,0,0,2,2,0,0,0,2,0,0
401374990,Cal State Bakersfield Roadrunners,S. Bridges-Bey,4704359,,True,6.0,0,0,0,0,0,0,0,0,1,1,2,0,0,0,0,0,0
401374990,Cal State Bakersfield Roadrunners,J. Dixon,4282302,,True,23.0,0,3,0,0,0,3,0,0,1,0,1,0,0,1,0,3,0
401374990,Cal State Bakersfield Roadrunners,V. Austin,4282306,,False,17.0,0,6,0,6,0,0,1,2,1,3,4,0,0,0,0,2,1
401374990,Cal State Bakersfield Roadrunners,S. Herrera,4704358,,False,14.0,3,5,3,5,0,0,1,2,1,1,2,0,0,0,0,0,7
401374990,Cal State Bakersfield Roadrunners,M. Saxon,4400107,,False,28.0,1,4,1,3,0,1,2,2,0,1,1,1,3,0,1,4,4
401374990,Cal State Bakersfield Roadrunners,A. Easley,3911834,,False,28.0,5,12,1,2,4,10,2,2,1,2,3,1,0,0,0,0,16
401374990,Cal State Bakersfield Roadrunners,T. Clayburne,4899643,,False,11.0,0,1,0,0,0,1,0,0,1,2,3,2,0,0,4,1,0
401374990,Cal State Bakersfield Roadrunners,L. Green,4595878,,False,19.0,1,5,0,3,1,2,2,2,0,0,0,3,0,0,1,1,5
401374990,Cal State Bakersfield Roadrunners,TEAM,TOTAL,TOTAL,False,,17,55,11,34,6,21,12,15,9,24,33,11,4,1,12,16,52
401374989,UC Riverside Highlanders,A. Blount,4595640,,True,15.0,3,5,3,5,0,0,0,0,2,0,2,1,2,1,0,0,6
401374989,UC Riverside Highlanders,M. Finau,4594847,,True,27.0,0,3,0,1,0,2,5,6,0,5,5,0,1,0,1,4,5
401374989,UC Riverside Highlanders,J. Holland,4595890,,True,33.0,6,11,4,6,2,5,0,3,1,1,2,4,0,1,5,3,14
401374989,UC Riverside Highlanders,K. Cooper,4281721,,True,33.0,4,12,2,4,2,8,2,2,0,2,2,2,1,0,2,2,12
401374989,UC Riverside Highlanders,O. West,4068416,,True,34.0,2,10,0,3,2,7,0,0,0,4,4,1,3,0,0,4,6
401374989,UC Riverside Highlanders,M. Bryant,4595889,,False,24.0,6,6,6,6,0,0,5,6,2,2,4,0,0,0,2,1,17
401374989,UC Riverside Highlanders,D. Gnago,4281723,,False,3.0,0,0,0,0,0,0,0,0,0,0,0,0,0,0,1,0,0
401374989,UC Riverside Highlanders,J. Webster,4704350,,False,20.0,2,3,0,0,2,3,0,0,1,2,3,0,1,0,2,2,6
401374989,UC Riverside Highlanders,R. Walters,4433366,,False,11.0,0,2,0,0,0,2,0,0,0,0,0,1,0,0,0,3,0
401374989,UC Riverside Highlanders,TEAM,TOTAL,TOTAL,False,,23,52,15,25,8,27,12,17,9,21,30,9,8,2,14,19,66
401374989,Long Beach State Beach,L. Green,4400054,,True,5.0,0,2,0,2,0,0,0,0,2,0,2,0,0,0,2,0,0
401374989,Long Beach State Beach,M. Utti,4281828,,True,37.0,4,13,4,10,0,3,0,0,1,10,11,4,2,0,1,1,8
401374989,Long Beach State Beach,J. Hardy,4400053,,True,38.0,4,6,2,3,2,3,5,5,1,3,4,1,2,0,3,2,15
401374989,Long Beach State Beach,J. King,4400052,,True,34.0,2,9,2,8,0,1,4,4,0,1,1,0,0,1,5,1,8
401374989,Long Beach State Beach,M. Berry,4281701,,True,13.0,2,2,2,2,0,0,1,4,0,0,0,1,0,0,2,2,5
401374989,Long Beach State Beach,P. Chung,4704395,,False,5.0,0,2,0,0,0,2,2,4,0,0,0,1,0,0,0,0,2
401374989,Long Beach State Beach,S. Tucker,4704394,,False,27.0,6,8,5,5,1,3,7,8,2,2,4,0,0,0,1,1,20
401374989,Long Beach State Beach,K. Jeskeova,4595201,,False,18.0,1,2,1,1,0,1,1,2,1,4,5,2,2,1,0,3,3
401374989,Long Beach State Beach,K. Hamilton-Fisher,4400055,,False,23.0,0,2,0,0,0,2,0,0,0,1,1,0,0,0,0,2,0
401374989,Long Beach State Beach,TEAM,TOTAL,TOTAL,False,,19,46,16,31,3,15,20,27,8,23,31,9,6,2,14,12,61
401374988,UC Santa Barbara Gauchos,M. Anderson,4281881,,True,32.0,2,7,2,4,0,3,0,0,1,3,4,0,0,0,0,1,4
401374988,UC Santa Barbara Gauchos,I. Lane,4595216,,True,40.0,5,11,5,11,0,0,1,2,4,14,18,0,0,1,3,3,11
401374988,UC Santa Barbara Gauchos,J. Gonzalez,4433343,,True,10.0,1,5,1,2,0,3,0,0,0,0,0,0,1,0,1,0,2
401374988,UC Santa Barbara Gauchos,A. Tucker,4432947,,True,31.0,4,7,4,6,0,1,6,9,0,4,4,0,2,0,4,4,14
401374988,UC Santa Barbara Gauchos,D. Miller,4281726,,True,38.0,3,12,1,7,2,5,5,6,0,2,2,2,0,0,2,2,13
401374988,UC Santa Barbara Gauchos,T. Mole,4400101,,False,8.0,0,0,0,0,0,0,0,0,0,0,0,0,0,0,0,0,0
401374988,UC Santa Barbara Gauchos,K. Johnson,4899739,,False,9.0,0,2,0,1,0,1,0,0,0,1,1,1,0,0,0,1,0
401374988,UC Santa Barbara Gauchos,A. Choice,4704397,,False,32.0,3,5,1,2,2,3,0,0,1,1,2,0,1,0,4,2,8
401374988,UC Santa Barbara Gauchos,TEAM,TOTAL,TOTAL,False,,18,49,14,33,4,16,12,17,6,26,32,3,4,1,14,13,52
401374988,Hawai'i Rainbow Wahine,K. Spiller,4282329,,True,9.0,1,6,1,3,0,3,0,0,1,1,2,0,0,0,0,1,2
401374988,Hawai'i Rainbow Wahine,A. Atwell,4068885,,True,34.0,4,13,4,8,0,5,1,2,2,9,11,5,3,2,2,3,9
401374988,Hawai'i Rainbow Wahine,K. Imai,4704370,,True,14.0,1,2,0,1,1,1,0,0,0,3,3,1,1,0,3,2,3
401374988,Hawai'i Rainbow Wahine,D. Phillips,4704369,,True,23.0,2,6,2,4,0,2,4,4,1,5,6,1,1,0,1,3,8
401374988,Hawai'i Rainbow Wahine,A. Thoms,4399949,,True,27.0,4,6,4,4,0,2,1,1,0,1,1,0,2,0,0,0,9
401374988,Hawai'i Rainbow Wahine,J. David,4899662,,False,22.0,1,8,0,3,1,5,0,0,2,1,3,0,1,0,0,1,3
401374988,Hawai'i Rainbow Wahine,N. Orji,4704372,,False,11.0,3,4,2,3,1,1,0,0,0,0,0,0,0,0,0,1,7
401374988,Hawai'i Rainbow Wahine,M. McBee,4704375,,False,25.0,1,6,0,2,1,4,0,0,0,0,0,1,2,0,1,3,3
401374988,Hawai'i Rainbow Wahine,N. Calhoun,4595198,,False,9.0,1,2,0,1,1,1,1,2,1,1,2,0,0,0,0,0,4
401374988,Hawai'i Rainbow Wahine,O. Davies,4595197,,False,26.0,2,3,1,1,1,2,5,6,2,3,5,2,0,0,2,1,10
401374988,Hawai'i Rainbow Wahine,TEAM,TOTAL,TOTAL,False,,20,56,14,30,6,26,12,15,11,27,38,10,10,2,9,15,58
401374987,UC San Diego Tritons,P. Montgomery,4704408,,True,30.0,1,9,1,5,0,4,2,5,0,2,2,2,2,0,0,0,4
401374987,UC San Diego Tritons,M. Baxter,4704402,,True,15.0,1,3,0,1,1,2,0,0,0,2,2,1,1,1,0,3,3
401374987,UC San Diego Tritons,J. Macabuhay,4704401,,True,25.0,9,17,8,15,1,2,0,0,0,3,3,1,1,0,1,2,19
401374987,UC San Diego Tritons,E. Cangelosi,4704400,,True,38.0,4,11,4,8,0,3,0,0,2,2,4,2,1,0,2,1,8
401374987,UC San Diego Tritons,S. Brown,4399164,,True,41.0,3,13,2,8,1,5,5,5,5,5,10,3,1,1,3,1,12
401374987,UC San Diego Tritons,B. Mullings,4899733,,False,33.0,5,8,3,5,2,3,0,0,3,1,4,3,1,2,1,4,12
401374987,UC San Diego Tritons,I. Forsyth,4899731,,False,13.0,2,3,2,3,0,0,1,1,0,3,3,0,0,0,2,1,5
401374987,UC San Diego Tritons,B. Claros,4704403,,False,21.0,1,2,1,2,0,0,0,0,0,1,1,2,0,0,1,1,2
401374987,UC San Diego Tritons,U. Chamberlin,4594874,,False,9.0,3,3,2,2,1,1,1,2,0,1,1,1,1,0,1,0,8
401374987,UC San Diego Tritons,TEAM,TOTAL,TOTAL,False,,29,69,23,49,6,20,9,13,11,26,37,15,8,4,11,13,73
401374987,Cal State Bakersfield Roadrunners,H. van Schaik,4899644,,True,10.0,2,4,1,3,1,1,0,0,1,3,4,0,0,0,3,1,5
401374987,Cal State Bakersfield Roadrunners,J. Eggleston,4282084,,True,38.0,2,8,2,7,0,1,0,0,1,4,5,3,1,2,3,2,4
401374987,Cal State Bakersfield Roadrunners,S. Johnson,4899642,,True,14.0,1,3,1,1,0,2,0,0,0,3,3,5,1,0,1,0,2
401374987,Cal State Bakersfield Roadrunners,S. Bridges-Bey,4704359,,True,4.0,0,2,0,1,0,1,0,0,1,0,1,0,0,0,0,0,0
401374987,Cal State Bakersfield Roadrunners,J. Dixon,4282302,,True,21.0,0,2,0,0,0,2,0,0,1,1,2,2,1,2,1,1,0
401374987,Cal State Bakersfield Roadrunners,V. Austin,4282306,,False,31.0,6,13,6,13,0,0,6,6,8,4,12,1,2,0,1,2,18
401374987,Cal State Bakersfield Roadrunners,S. Herrera,4704358,,False,2.0,0,0,0,0,0,0,0,0,0,0,0,0,0,0,1,2,0
401374987,Cal State Bakersfield Roadrunners,M. Saxon,4400107,,False,30.0,5,12,1,5,4,7,0,0,1,6,7,1,2,1,3,4,14
401374987,Cal State Bakersfield Roadrunners,A. Easley,3911834,,False,41.0,4,14,1,5,3,9,6,6,0,4,4,2,1,0,3,1,17
401374987,Cal State Bakersfield Roadrunners,T. Clayburne,4899643,,False,29.0,3,9,0,3,3,6,0,0,0,4,4,1,1,0,2,0,9
401374987,Cal State Bakersfield Roadrunners,L. Green,4595878,,False,5.0,0,0,0,0,0,0,0,0,0,0,0,1,0,0,0,0,0
401374987,Cal State Bakersfield Roadrunners,TEAM,TOTAL,TOTAL,False,,23,67,12,38,11,29,12,12,17,30,47,16,9,5,20,13,69
401374986,UC Riverside Highlanders,A. Blount,4595640,,True,27.0,4,8,4,8,0,0,2,2,1,3,4,1,1,0,1,2,10
401374986,UC Riverside Highlanders,M. Finau,4594847,,True,21.0,3,7,2,6,1,1,0,0,0,1,1,0,0,0,3,3,7
401374986,UC Riverside Highlanders,J. Holland,4595890,,True,25.0,2,5,2,5,0,0,0,0,0,3,3,5,0,0,2,0,4
401374986,UC Riverside Highlanders,K. Cooper,4281721,,True,35.0,6,15,5,12,1,3,3,5,0,5,5,4,5,1,1,4,16
401374986,UC Riverside Highlanders,O. West,4068416,,True,37.0,3,11,0,3,3,8,2,2,0,5,5,1,0,0,1,4,11
401374986,UC Riverside Highlanders,E. Matarranz,4899727,,False,13.0,3,7,3,7,0,0,0,0,0,2,2,0,0,0,0,3,6
401374986,UC Riverside Highlanders,J. Webster,4704350,,False,27.0,0,2,0,0,0,2,6,6,0,4,4,0,2,0,1,0,6
401374986,UC Riverside Highlanders,R. Walters,4433366,,False,15.0,1,3,1,3,0,0,0,0,0,1,1,2,2,0,0,1,2
401374986,UC Riverside Highlanders,TEAM,TOTAL,TOTAL,False,,22,58,17,44,5,14,13,15,4,25,29,13,10,1,9,17,62
401374986,Cal State Fullerton Titans,K. Neff,4595189,,True,18.0,1,4,1,1,0,3,0,0,1,2,3,1,0,2,1,2,2
401374986,Cal State Fullerton Titans,C. Gill,4281455,,True,33.0,3,8,3,6,0,2,0,0,2,10,12,1,0,1,3,2,6
401374986,Cal State Fullerton Titans,A. Lewis,4704361,,True,25.0,6,18,6,18,0,0,4,6,2,5,7,1,0,1,2,3,16
401374986,Cal State Fullerton Titans,L. Wahinekapu,4902813,,True,32.0,3,7,3,6,0,1,3,5,1,4,5,5,2,0,3,3,9
401374986,Cal State Fullerton Titans,G. Vidmar,4704360,,True,32.0,0,6,0,1,0,5,0,0,2,4,6,2,1,1,0,4,0
401374986,Cal State Fullerton Titans,A. Hernandez,4902816,,False,15.0,6,7,6,7,0,0,0,0,1,3,4,1,0,1,2,2,12
401374986,Cal State Fullerton Titans,B. Furch,4902817,,False,22.0,1,6,1,3,0,3,4,4,2,0,2,3,1,0,3,0,6
401374986,Cal State Fullerton Titans,U. Jovanovic,4902811,,False,23.0,3,5,3,4,0,1,2,2,2,3,5,0,1,0,2,0,8
401374986,Cal State Fullerton Titans,TEAM,TOTAL,TOTAL,False,,23,61,23,46,0,15,13,17,15,33,48,14,5,6,16,16,59
401374985,UC Irvine Anteaters,S. Locandro,4595211,,True,27.0,1,6,1,5,0,1,0,0,3,2,5,1,0,0,1,4,2
401374985,UC Irvine Anteaters,N. Hunt,4281707,,True,27.0,4,16,2,7,2,9,3,4,0,4,4,0,1,1,0,2,13
401374985,UC Irvine Anteaters,N. Tom,4899722,,True,33.0,1,6,0,1,1,5,0,0,1,1,2,3,2,0,0,1,3
401374985,UC Irvine Anteaters,J. Cadee,4595210,,True,29.0,2,6,0,0,2,6,0,0,0,2,2,0,0,0,0,2,6
401374985,UC Irvine Anteaters,K. Williams,4595209,,True,36.0,8,17,5,8,3,9,7,12,2,2,4,3,2,0,6,2,26
401374985,UC Irvine Anteaters,C. Kaupu,4704426,,False,4.0,1,2,0,1,1,1,2,2,1,2,3,0,0,0,0,0,5
401374985,UC Irvine Anteaters,M. Kapinga,4400059,,False,2.0,0,0,0,0,0,0,0,0,0,1,1,0,0,0,0,0,0
401374985,UC Irvine Anteaters,T. Dusharm,3906747,,False,6.0,0,0,0,0,0,0,0,0,0,1,1,0,0,1,0,4,0
401374985,UC Irvine Anteaters,O. Williams,4899726,,False,16.0,0,3,0,2,0,1,2,2,3,1,4,1,1,0,0,0,2
401374985,UC Irvine Anteaters,H. Hernandez,4899725,,False,16.0,3,6,3,4,0,2,4,4,0,2,2,0,0,1,2,0,10
401374985,UC Irvine Anteaters,D. Lee,4899724,,False,4.0,0,0,0,0,0,0,0,0,0,0,0,0,1,0,1,1,0
401374985,UC Irvine Anteaters,TEAM,TOTAL,TOTAL,False,,20,62,11,28,9,34,18,24,15,19,34,8,7,3,10,16,67
401374985,Cal Poly Mustangs,J. Nielacna,4400510,,True,18.0,7,12,7,10,0,2,2,4,3,3,6,0,0,0,3,4,16
401374985,Cal Poly Mustangs,K. Brown,4281448,,True,0.0,0,0,0,0,0,0,0,0,0,0,0,0,0,0,0,0,0
401374985,Cal Poly Mustangs,S. Bourland,4899654,,True,13.0,0,0,0,0,0,0,0,0,0,2,2,0,0,0,0,2,0
401374985,Cal Poly Mustangs,M. Willett,4400024,,True,28.0,1,7,0,2,1,5,0,0,0,3,3,3,0,0,1,1,3
401374985,Cal Poly Mustangs,M. Vick,4400018,,True,33.0,4,9,4,9,0,0,2,2,1,1,2,4,1,0,3,5,10
401374985,Cal Poly Mustangs,Z. Stachowski,4704343,,False,6.0,1,3,1,3,0,0,0,0,0,1,1,0,0,0,0,1,2
401374985,Cal Poly Mustangs,H. Scanlan,4281948,,False,24.0,6,7,6,7,0,0,0,0,0,3,3,3,0,2,1,2,12
401374985,Cal Poly Mustangs,J. Dickson,4704339,,False,22.0,5,8,2,4,3,4,0,0,0,4,4,0,1,1,0,0,13
401374985,Cal Poly Mustangs,S. Dumitrescu,4433701,,False,16.0,1,2,1,2,0,0,2,2,0,5,5,1,0,0,3,3,4
401374985,Cal Poly Mustangs,J. Anousinh,4899653,,False,38.0,2,4,2,4,0,0,2,2,0,3,3,4,1,0,3,5,6
401374985,Cal Poly Mustangs,A. Shah,4899652,,False,2.0,0,0,0,0,0,0,0,0,0,0,0,0,0,0,0,1,0
401374985,Cal Poly Mustangs,TEAM,TOTAL,TOTAL,False,,27,52,23,41,4,11,8,10,6,28,34,15,3,3,16,24,66
401374984,UC Davis Aggies,C. Hall,4281712,,True,35.0,3,12,1,6,2,6,1,2,3,5,8,5,3,0,5,4,9
401374984,UC Davis Aggies,K. Konrad,4281711,,True,33.0,7,12,6,8,1,4,0,1,2,6,8,2,1,0,2,2,15
401374984,UC Davis Aggies,S. Stobbart,4281710,,True,34.0,2,5,2,5,0,0,2,4,2,5,7,3,4,1,3,1,6
401374984,UC Davis Aggies,S. Burns,4899719,,True,30.0,4,4,2,2,2,2,2,2,0,3,3,6,0,0,9,3,12
401374984,UC Davis Aggies,E. Turner,4595205,,True,32.0,4,11,1,2,3,9,0,1,0,2,2,2,1,0,2,4,11
401374984,UC Davis Aggies,M. Harris,4704336,,False,17.0,1,2,0,0,1,2,2,2,2,1,3,0,0,0,0,0,5
401374984,UC Davis Aggies,L. Svanholm,4281822,,False,6.0,1,3,1,3,0,0,0,0,0,0,0,0,0,0,1,2,2
401374984,UC Davis Aggies,C. Gray,4595204,,False,11.0,0,0,0,0,0,0,0,1,0,0,0,1,0,0,2,2,0
401374984,UC Davis Aggies,M. Sanders,4400058,,False,2.0,0,0,0,0,0,0,0,0,0,1,1,0,0,0,1,0,0
401374984,UC Davis Aggies,TEAM,TOTAL,TOTAL,False,,22,49,13,26,9,23,7,13,10,25,35,19,9,1,26,18,60
401374984,Long Beach State Beach,L. Green,4400054,,True,12.0,0,1,0,0,0,1,0,0,1,1,2,0,1,0,1,1,0
401374984,Long Beach State Beach,M. Utti,4281828,,True,36.0,6,10,4,7,2,3,2,2,1,5,6,1,2,0,3,1,16
401374984,Long Beach State Beach,J. Hardy,4400053,,True,15.0,1,4,0,2,1,2,0,0,1,0,1,0,0,0,2,3,3
401374984,Long Beach State Beach,J. King,4400052,,True,31.0,3,10,2,8,1,2,6,6,0,1,1,4,3,0,1,3,13
401374984,Long Beach State Beach,M. Berry,4281701,,True,26.0,2,6,2,6,0,0,2,2,1,3,4,4,1,0,1,1,6
401374984,Long Beach State Beach,P. Chung,4704395,,False,3.0,0,1,0,1,0,0,0,0,0,0,0,0,0,0,0,1,0
401374984,Long Beach State Beach,S. Tucker,4704394,,False,18.0,2,4,2,3,0,1,1,1,0,2,2,1,2,1,0,1,5
401374984,Long Beach State Beach,K. Jeskeova,4595201,,False,24.0,2,4,1,1,1,3,2,3,1,4,5,1,3,0,1,2,7
401374984,Long Beach State Beach,K. Hamilton-Fisher,4400055,,False,35.0,6,13,3,8,3,5,0,2,0,4,4,1,3,0,6,3,15
401374984,Long Beach State Beach,TEAM,TOTAL,TOTAL,False,,22,53,14,36,8,17,13,16,8,20,28,12,15,1,17,16,65
401374716,Portland State Vikings,S. Dhaliwal,4281681,,True,23.0,3,9,3,6,0,3,2,3,2,1,3,0,1,0,2,3,8
401374716,Portland State Vikings,A. Fitzgerald,4899531,,True,21.0,0,4,0,3,0,1,0,0,0,2,2,3,1,1,6,1,0
401374716,Portland State Vikings,E. Morales,4899533,,True,38.0,6,10,2,5,4,5,1,1,0,3,3,3,4,0,3,1,17
401374716,Portland State Vikings,M. 'Uhila,4899532,,True,31.0,0,3,0,1,0,2,3,4,0,2,2,1,1,0,2,1,3
401374716,Portland State Vikings,J. Lewis,4594856,,True,21.0,2,7,0,2,2,5,0,0,2,2,4,1,1,0,3,1,6
401374716,Portland State Vikings,M. Baird,4704918,,False,10.0,0,1,0,1,0,0,0,0,1,0,1,0,0,0,0,0,0
401374716,Portland State Vikings,S. Schultz,4594857,,False,20.0,1,3,1,2,0,1,2,4,0,1,1,3,1,0,0,2,4
401374716,Portland State Vikings,M. Canzobre,4594854,,False,6.0,0,0,0,0,0,0,0,0,0,1,1,0,0,0,2,0,0
401374716,Portland State Vikings,J. Kilty,4704914,,False,17.0,4,6,2,2,2,4,0,0,0,2,2,0,0,0,1,0,10
401374716,Portland State Vikings,R. Ogele,4899534,,False,12.0,1,3,1,3,0,0,0,1,1,3,4,1,0,0,1,4,2
401374716,Portland State Vikings,I. Ugarte,4704916,,False,1.0,0,0,0,0,0,0,0,0,0,0,0,0,0,0,0,0,0
401374716,Portland State Vikings,TEAM,TOTAL,TOTAL,False,,17,46,9,25,8,21,8,13,9,22,31,12,9,1,21,13,50
401374716,Eastern Washington Eagles,M. Knowles,4399898,,True,28.0,2,4,2,4,0,0,1,2,3,2,5,4,1,1,1,2,5
401374716,Eastern Washington Eagles,J. Martin,4899031,,True,34.0,7,18,3,11,4,7,4,6,0,3,3,3,2,0,0,2,22
401374716,Eastern Washington Eagles,A. Zylak,4899029,,True,29.0,2,4,1,1,1,3,0,0,0,2,2,4,3,0,2,0,5
401374716,Eastern Washington Eagles,J. Lawrence,4899032,,True,23.0,5,9,3,4,2,5,0,0,1,4,5,0,1,0,2,3,12
401374716,Eastern Washington Eagles,J. Buckley,4595639,,True,34.0,6,13,6,12,0,1,2,4,4,4,8,4,3,0,0,2,14
401374716,Eastern Washington Eagles,D. Warns,4899030,,False,1.0,0,0,0,0,0,0,0,0,0,0,0,1,0,0,0,0,0
401374716,Eastern Washington Eagles,K. Schaplow,4704752,,False,1.0,0,0,0,0,0,0,0,0,0,0,0,0,0,0,0,0,0
401374716,Eastern Washington Eagles,G. Jung,4594825,,False,1.0,0,2,0,1,0,1,0,0,0,0,0,0,0,0,0,0,0
401374716,Eastern Washington Eagles,J. Boesel,4282101,,False,17.0,2,5,0,0,2,5,0,0,1,2,3,0,0,0,1,2,6
401374716,Eastern Washington Eagles,B. Rice,4066514,,False,13.0,0,1,0,0,0,1,1,2,1,1,2,2,1,0,1,2,1
401374716,Eastern Washington Eagles,A. Pettis,4899028,,False,19.0,1,2,1,1,0,1,1,2,0,3,3,2,0,0,2,1,3
401374716,Eastern Washington Eagles,TEAM,TOTAL,TOTAL,False,,25,58,16,34,9,24,9,16,13,22,35,20,11,1,10,14,68
401374715,Northern Colorado Bears,K. Harden,4594852,,True,25.0,6,8,6,8,0,0,4,6,2,5,7,1,0,2,2,3,16
401374715,Northern Colorado Bears,A. Downing,4708502,,True,31.0,4,8,0,2,4,6,2,2,2,7,9,1,2,1,0,2,14
401374715,Northern Colorado Bears,H. Simental,4705487,,True,31.0,3,12,0,5,3,7,10,10,1,1,2,4,3,0,4,1,19
401374715,Northern Colorado Bears,M. Isenbart,4399928,,True,24.0,1,6,0,3,1,3,0,2,2,7,9,1,0,0,1,2,3
401374715,Northern Colorado Bears,A. Chapman,4281679,,True,29.0,5,9,3,6,2,3,2,2,0,1,1,2,2,0,3,1,14
401374715,Northern Colorado Bears,Z. Campbell,4899530,,False,13.0,0,1,0,1,0,0,0,0,2,1,3,1,0,1,2,2,0
401374715,Northern Colorado Bears,J. Galloway,4705490,,False,10.0,0,2,0,1,0,1,0,0,2,0,2,2,0,0,2,0,0
401374715,Northern Colorado Bears,S. Stensgard,4705199,,False,9.0,0,2,0,1,0,1,0,0,0,1,1,0,0,0,2,1,0
401374715,Northern Colorado Bears,S. Lipe,4399618,,False,19.0,2,3,2,2,0,1,1,1,0,4,4,2,1,0,0,0,5
401374715,Northern Colorado Bears,J. Gorzeman,4282077,,False,8.0,0,0,0,0,0,0,0,0,0,1,1,1,0,0,1,3,0
401374715,Northern Colorado Bears,TEAM,TOTAL,TOTAL,False,,21,51,11,29,10,22,19,23,12,30,42,15,8,4,19,15,71
401374715,Montana State Bobcats,K. Bad Bear,4594836,,True,21.0,1,6,1,6,0,0,0,0,2,0,2,0,2,1,3,5,2
401374715,Montana State Bobcats,G. Mocchi,4399914,,True,31.0,2,7,1,2,1,5,2,2,1,3,4,3,2,0,0,4,7
401374715,Montana State Bobcats,K. Limardo,4705201,,True,30.0,1,5,1,1,0,4,0,0,0,2,2,0,3,0,1,3,2
401374715,Montana State Bobcats,L. Beattie,4705202,,True,28.0,4,11,1,2,3,9,2,2,1,1,2,1,0,0,1,2,13
401374715,Montana State Bobcats,D. White,4594835,,True,35.0,13,18,12,16,1,2,5,5,2,6,8,2,5,0,2,1,32
401374715,Montana State Bobcats,T. Janssen,4705204,,False,18.0,1,12,0,6,1,6,0,0,3,1,4,0,0,0,0,1,3
401374715,Montana State Bobcats,L. Deden,4705203,,False,10.0,1,5,1,5,0,0,0,0,2,2,4,0,0,0,2,1,2
401374715,Montana State Bobcats,A. Ranson,4705200,,False,2.0,0,1,0,0,0,1,0,0,0,0,0,0,0,0,0,0,0
401374715,Montana State Bobcats,M. Jackson,4594837,,False,14.0,1,2,1,1,0,1,0,0,1,1,2,1,0,0,2,1,2
401374715,Montana State Bobcats,A. Van Sickle,4281659,,False,10.0,0,1,0,0,0,1,0,0,0,0,0,0,0,0,2,0,0
401374715,Montana State Bobcats,TEAM,TOTAL,TOTAL,False,,24,68,18,39,6,29,9,9,14,19,33,7,12,1,13,18,63
401374714,Northern Arizona Lumberjacks,K. Rasheed,4281671,,True,28.0,3,7,3,7,0,0,0,0,4,7,11,2,1,0,0,4,6
401374714,Northern Arizona Lumberjacks,N. Radford,4281730,,True,24.0,2,6,2,4,0,2,0,0,0,5,5,3,1,0,2,1,4
401374714,Northern Arizona Lumberjacks,E. Rodabaugh,4594845,,True,27.0,4,11,2,7,2,4,0,0,1,3,4,0,1,3,0,3,10
401374714,Northern Arizona Lumberjacks,R. Schenck,4399923,,True,34.0,4,10,4,8,0,2,2,2,0,6,6,7,1,0,3,4,10
401374714,Northern Arizona Lumberjacks,L. Orndoff,4281672,,True,26.0,6,10,4,6,2,4,1,2,1,1,2,0,0,2,3,1,15
401374714,Northern Arizona Lumberjacks,F. Jaiteh,4899311,,False,12.0,2,4,2,4,0,0,0,1,3,0,3,0,1,0,1,2,4
401374714,Northern Arizona Lumberjacks,S. Bryant,4399926,,False,1.0,1,2,1,2,0,0,0,0,0,0,0,0,0,0,0,0,2
401374714,Northern Arizona Lumberjacks,O. Moran,4704921,,False,21.0,8,11,7,10,1,1,1,2,3,1,4,3,1,0,0,0,18
401374714,Northern Arizona Lumberjacks,N. Moran,4704920,,False,10.0,3,4,1,1,2,3,0,0,0,1,1,1,0,0,1,1,8
401374714,Northern Arizona Lumberjacks,M. Maio,4595636,,False,17.0,4,9,4,8,0,1,1,2,1,4,5,0,1,0,0,0,9
401374714,Northern Arizona Lumberjacks,TEAM,TOTAL,TOTAL,False,,37,74,30,57,7,17,5,9,14,28,42,16,7,5,10,16,86
401374714,Idaho Vandals,B. Bea,4594826,,True,33.0,5,13,5,13,0,0,3,4,4,4,8,4,0,0,3,1,13
401374714,Idaho Vandals,A. Wallace,4899034,,True,21.0,0,2,0,0,0,2,0,0,0,2,2,0,0,0,1,1,0
401374714,Idaho Vandals,S. Gandy,4704760,,True,36.0,7,14,2,7,5,7,3,5,0,2,2,0,3,0,3,1,22
401374714,Idaho Vandals,T. Johnson,4281684,,True,32.0,5,13,3,3,2,10,2,2,0,3,3,2,0,1,0,2,14
401374714,Idaho Vandals,A. Kirby,4281627,,True,31.0,0,1,0,0,0,1,2,2,1,3,4,2,0,0,3,1,2
401374714,Idaho Vandals,M. Rubino,4899035,,False,4.0,0,0,0,0,0,0,0,0,1,2,3,0,0,0,0,1,0
401374714,Idaho Vandals,J. Allred,4899037,,False,13.0,0,2,0,0,0,2,0,0,0,1,1,0,1,0,2,2,0
401374714,Idaho Vandals,R. Alexander,4704759,,False,2.0,0,1,0,1,0,0,0,0,0,0,0,0,0,0,0,0,0
401374714,Idaho Vandals,P. Atchley,4704758,,False,6.0,0,2,0,1,0,1,2,2,0,2,2,0,0,0,0,1,2
401374714,Idaho Vandals,L. Forsyth,4281998,,False,22.0,6,14,6,13,0,1,4,5,1,4,5,0,1,1,1,3,16
401374714,Idaho Vandals,TEAM,TOTAL,TOTAL,False,,23,62,16,38,7,24,16,20,10,26,36,8,5,2,14,13,69
401374713,Weber State Wildcats,J. Matthews,4594879,,True,31.0,5,8,3,6,2,2,0,0,3,6,9,0,0,0,1,2,12
401374713,Weber State Wildcats,D. Hickok,4594877,,True,29.0,4,7,4,6,0,1,10,11,1,5,6,1,4,0,4,5,18
401374713,Weber State Wildcats,E. Torbert,4400135,,True,34.0,3,13,2,5,1,8,2,2,1,5,6,2,3,1,3,2,9
401374713,Weber State Wildcats,A. Solovi,4594878,,True,24.0,1,6,1,4,0,2,1,2,1,3,4,2,1,0,0,1,3
401374713,Weber State Wildcats,K. Pentzer,4399951,,True,28.0,1,8,0,2,1,6,4,4,0,3,3,1,1,0,3,4,7
401374713,Weber State Wildcats,V. Parra,4594876,,False,3.0,0,1,0,1,0,0,0,0,1,0,1,0,0,0,0,2,0
401374713,Weber State Wildcats,N. Johnson,4899562,,False,5.0,0,1,0,0,0,1,0,0,0,0,0,0,0,0,0,1,0
401374713,Weber State Wildcats,K. Lesane,4899560,,False,7.0,1,5,1,5,0,0,1,4,2,0,2,1,0,0,0,1,3
401374713,Weber State Wildcats,E. Lovell,4899559,,False,9.0,0,1,0,1,0,0,4,5,0,0,0,0,0,0,0,1,4
401374713,Weber State Wildcats,A. Ellis,4899558,,False,0.0,0,0,0,0,0,0,0,0,0,0,0,0,0,0,0,2,0
401374713,Weber State Wildcats,L. Taylor,4899557,,False,18.0,1,4,1,1,0,3,1,2,0,1,1,1,0,0,1,3,3
401374713,Weber State Wildcats,C. Hegvold,4712925,,False,0.0,0,0,0,0,0,0,0,0,0,0,0,0,0,0,0,1,0
401374713,Weber State Wildcats,A. Williams,4400178,,False,12.0,1,3,1,3,0,0,4,6,0,0,0,0,0,0,0,1,6
401374713,Weber State Wildcats,TEAM,TOTAL,TOTAL,False,,17,57,13,34,4,23,27,36,10,25,35,8,9,1,13,26,65
401374713,Southern Utah Thunderbirds,D. Dotson,4899551,,True,30.0,5,9,5,9,0,0,8,10,4,6,10,1,1,2,1,3,18
401374713,Southern Utah Thunderbirds,L. Williamson,4704907,,True,35.0,8,11,8,11,0,0,0,2,4,9,13,0,3,5,2,2,16
401374713,Southern Utah Thunderbirds,S. Johnston,4704906,,True,30.0,1,8,0,1,1,7,2,2,0,4,4,3,0,0,0,0,5
401374713,Southern Utah Thunderbirds,D. Ballena,4704905,,True,23.0,1,9,1,6,0,3,2,2,0,0,0,2,0,0,1,1,4
401374713,Southern Utah Thunderbirds,C. Daugherty,4704902,,True,24.0,1,5,1,4,0,1,0,0,1,7,8,3,1,0,3,4,2
401374713,Southern Utah Thunderbirds,B. Tronnier,4704900,,False,3.0,0,0,0,0,0,0,0,0,1,0,1,0,0,0,1,3,0
401374713,Southern Utah Thunderbirds,N. Otkhmezuri,4899550,,False,17.0,1,5,0,0,1,5,2,2,1,1,2,0,0,0,1,3,5
401374713,Southern Utah Thunderbirds,K. Clark,4899549,,False,2.0,0,0,0,0,0,0,2,2,0,0,0,0,0,0,0,2,2
401374713,Southern Utah Thunderbirds,A. Lord,4594868,,False,7.0,0,1,0,0,0,1,1,2,0,1,1,0,0,0,1,2,1
401374713,Southern Utah Thunderbirds,M. Satini,4594867,,False,10.0,3,4,3,4,0,0,6,8,0,2,2,0,0,0,2,2,12
401374713,Southern Utah Thunderbirds,M. Eaton,4594866,,False,20.0,3,6,3,5,0,1,4,8,2,1,3,2,1,0,2,1,10
401374713,Southern Utah Thunderbirds,TEAM,TOTAL,TOTAL,False,,23,58,21,40,2,18,27,38,15,34,49,11,6,7,14,23,75
401374712,Sacramento State Hornets,I. Natabou,4899543,,True,38.0,10,17,10,17,0,0,5,6,3,4,7,1,1,2,2,1,25
401374712,Sacramento State Hornets,K. Peneueta,4899542,,True,38.0,1,8,0,0,1,8,0,0,0,4,4,2,2,2,1,1,3
401374712,Sacramento State Hornets,S. Abney,4399940,,True,0.0,0,0,0,0,0,0,0,0,0,0,0,0,0,0,0,1,0
401374712,Sacramento State Hornets,S. Menke,4399937,,True,39.0,2,5,2,3,0,2,0,0,4,6,10,2,2,0,2,4,4
401374712,Sacramento State Hornets,L. Tillman,4282044,,True,40.0,8,28,4,16,4,12,1,2,1,5,6,7,0,0,1,1,21
401374712,Sacramento State Hornets,N. Munguia,4704913,,False,2.0,0,1,0,1,0,0,0,0,1,0,1,0,0,0,0,1,0
401374712,Sacramento State Hornets,J. Olivares,4594861,,False,40.0,0,4,0,2,0,2,0,0,0,4,4,1,0,0,1,4,0
401374712,Sacramento State Hornets,E. Enochs,4399939,,False,3.0,0,1,0,1,0,0,0,0,0,0,0,0,0,0,0,2,0
401374712,Sacramento State Hornets,TEAM,TOTAL,TOTAL,False,,21,64,16,40,5,24,6,8,13,24,37,13,5,4,9,15,53
401374712,Montana Lady Griz,C. Gfeller,4399911,,True,37.0,5,13,5,10,0,3,3,4,0,3,3,0,0,1,2,2,13
401374712,Montana Lady Griz,A. Anderson,4281646,,True,31.0,3,9,3,9,0,0,0,1,1,5,6,5,1,2,3,2,6
401374712,Montana Lady Griz,H. Huard,4899302,,True,25.0,1,1,0,0,1,1,0,0,0,8,8,0,1,1,1,1,3
401374712,Montana Lady Griz,N. Morris-Nelson,4704794,,True,31.0,1,1,0,0,1,1,0,0,0,6,6,0,0,0,0,0,3
401374712,Montana Lady Griz,S. Stiles,4281645,,True,35.0,13,25,12,23,1,2,2,2,1,5,6,3,1,0,1,0,29
401374712,Montana Lady Griz,D. Bartsch,4899304,,False,4.0,0,1,0,0,0,1,0,0,0,0,0,0,0,0,1,1,0
401374712,Montana Lady Griz,K. Frohlich,4399910,,False,8.0,0,0,0,0,0,0,0,0,1,0,1,1,0,0,1,1,0
401374712,Montana Lady Griz,K. Keller,4704796,,False,5.0,0,2,0,1,0,1,0,0,0,0,0,0,0,0,0,0,0
401374712,Montana Lady Griz,K. Tsineke,4595927,,False,13.0,1,3,1,3,0,0,0,0,1,1,2,0,1,0,1,1,2
401374712,Montana Lady Griz,S. Fatkin,4281911,,False,11.0,1,2,0,1,1,1,0,0,2,1,3,0,0,0,0,0,3
401374712,Montana Lady Griz,TEAM,TOTAL,TOTAL,False,,25,57,21,47,4,10,5,7,8,30,38,9,4,4,11,8,59
401374711,Portland State Vikings,S. Dhaliwal,4281681,,True,32.0,9,14,8,9,1,5,0,0,0,2,2,3,0,0,0,3,19
401374711,Portland State Vikings,A. Fitzgerald,4899531,,True,29.0,4,12,2,6,2,6,0,0,0,3,3,4,1,0,1,0,10
401374711,Portland State Vikings,E. Morales,4899533,,True,39.0,9,17,7,10,2,7,2,2,0,3,3,8,3,0,2,1,22
401374711,Portland State Vikings,M. 'Uhila,4899532,,True,31.0,0,1,0,1,0,0,0,0,1,7,8,1,1,0,4,2,0
401374711,Portland State Vikings,J. Lewis,4594856,,True,31.0,3,8,3,5,0,3,0,0,2,0,2,2,0,0,0,2,6
401374711,Portland State Vikings,R. Kelty,4704915,,False,13.0,1,2,1,2,0,0,0,0,2,2,4,0,0,1,3,4,2
401374711,Portland State Vikings,S. Schultz,4594857,,False,20.0,2,7,2,4,0,3,0,0,2,0,2,0,0,0,1,4,4
401374711,Portland State Vikings,M. Canzobre,4594854,,False,1.0,1,1,1,1,0,0,0,0,0,0,0,0,1,0,0,0,2
401374711,Portland State Vikings,J. Kilty,4704914,,False,4.0,1,2,0,0,1,2,0,0,0,1,1,0,0,0,0,0,3
401374711,Portland State Vikings,TEAM,TOTAL,TOTAL,False,,30,64,24,38,6,26,2,2,7,22,29,18,6,1,11,16,68
401374711,Idaho Vandals,B. Bea,4594826,,True,37.0,16,22,16,22,0,0,8,9,2,5,7,1,0,1,1,1,40
401374711,Idaho Vandals,A. Wallace,4899034,,True,19.0,1,5,1,1,0,4,0,0,0,0,0,0,0,0,1,0,2
401374711,Idaho Vandals,S. Gandy,4704760,,True,33.0,4,7,3,3,1,4,1,2,0,1,1,8,1,0,3,2,10
401374711,Idaho Vandals,T. Johnson,4281684,,True,38.0,7,13,5,10,2,3,0,2,0,9,9,1,0,0,1,1,16
401374711,Idaho Vandals,A. Kirby,4281627,,True,32.0,0,0,0,0,0,0,1,2,1,5,6,11,1,1,1,0,1
401374711,Idaho Vandals,J. Allred,4899037,,False,5.0,0,1,0,0,0,1,0,0,0,0,0,0,0,0,0,0,0
401374711,Idaho Vandals,P. Atchley,4704758,,False,14.0,0,0,0,0,0,0,0,0,0,1,1,1,1,0,2,1,0
401374711,Idaho Vandals,L. Forsyth,4281998,,False,22.0,1,5,1,3,0,2,2,2,0,2,2,4,0,0,2,1,4
401374711,Idaho Vandals,TEAM,TOTAL,TOTAL,False,,29,53,26,39,3,14,12,17,5,25,30,26,3,2,11,6,73
401374710,Northern Colorado Bears,K. Harden,4594852,,True,25.0,6,9,6,9,0,0,3,6,1,7,8,3,0,0,6,5,15
401374710,Northern Colorado Bears,A. Downing,4708502,,True,34.0,0,4,0,0,0,4,0,2,2,6,8,1,1,0,0,1,0
401374710,Northern Colorado Bears,H. Simental,4705487,,True,40.0,4,14,2,5,2,9,6,6,2,2,4,3,2,0,3,0,16
401374710,Northern Colorado Bears,M. Isenbart,4399928,,True,29.0,2,5,1,4,1,1,4,4,1,6,7,1,2,1,2,1,9
401374710,Northern Colorado Bears,A. Chapman,4281679,,True,35.0,9,19,4,11,5,8,0,1,2,1,3,2,0,0,1,1,23
401374710,Northern Colorado Bears,C. Boyles,4703967,,False,2.0,0,0,0,0,0,0,0,0,0,0,0,0,0,0,1,1,0
401374710,Northern Colorado Bears,Z. Campbell,4899530,,False,18.0,0,4,0,4,0,0,1,2,1,5,6,2,0,1,0,3,1
401374710,Northern Colorado Bears,J. Galloway,4705490,,False,7.0,0,0,0,0,0,0,0,0,0,0,0,1,0,0,0,1,0
401374710,Northern Colorado Bears,S. Stensgard,4705199,,False,21.0,3,5,2,4,1,1,1,1,1,1,2,2,1,0,1,4,8
401374710,Northern Colorado Bears,S. Lipe,4399618,,False,10.0,0,3,0,1,0,2,0,0,0,4,4,0,1,1,0,1,0
401374710,Northern Colorado Bears,J. Gorzeman,4282077,,False,4.0,0,1,0,1,0,0,0,0,0,0,0,0,1,0,1,1,0
401374710,Northern Colorado Bears,TEAM,TOTAL,TOTAL,False,,24,64,15,39,9,25,15,22,14,32,46,15,8,3,16,19,72
401374710,Montana Lady Griz,C. Gfeller,4399911,,True,43.0,6,10,5,8,1,2,3,4,2,5,7,2,0,0,2,3,16
401374710,Montana Lady Griz,A. Anderson,4281646,,True,20.0,2,5,2,5,0,0,6,7,1,3,4,0,0,4,2,5,10
401374710,Montana Lady Griz,H. Huard,4899302,,True,37.0,2,8,1,1,1,7,1,1,0,5,5,1,1,0,0,0,6
401374710,Montana Lady Griz,N. Morris-Nelson,4704794,,True,25.0,4,10,1,3,3,7,0,0,0,2,2,0,0,0,2,1,11
401374710,Montana Lady Griz,S. Stiles,4281645,,True,37.0,4,13,2,7,2,6,0,0,2,5,7,2,1,1,2,5,10
401374710,Montana Lady Griz,D. Bartsch,4899304,,False,8.0,0,1,0,1,0,0,0,0,0,2,2,0,0,0,0,0,0
401374710,Montana Lady Griz,K. Frohlich,4399910,,False,18.0,2,2,2,2,0,0,3,5,2,0,2,1,1,0,4,2,7
401374710,Montana Lady Griz,K. Keller,4704796,,False,25.0,1,7,1,3,0,4,2,2,0,3,3,3,1,0,0,1,4
401374710,Montana Lady Griz,K. Tsineke,4595927,,False,12.0,0,3,0,2,0,1,0,0,1,1,2,1,0,0,1,3,0
401374710,Montana Lady Griz,TEAM,TOTAL,TOTAL,False,,21,59,14,32,7,27,15,19,8,31,39,10,4,5,16,20,64
401374709,Northern Arizona Lumberjacks,K. Rasheed,4281671,,True,29.0,2,7,2,6,0,1,7,8,4,10,14,2,1,0,2,1,11
401374709,Northern Arizona Lumberjacks,N. Radford,4281730,,True,15.0,2,3,1,2,1,1,2,2,0,4,4,0,0,0,1,0,7
401374709,Northern Arizona Lumberjacks,E. Rodabaugh,4594845,,True,33.0,7,20,3,9,4,11,3,4,2,7,9,0,1,0,2,1,21
401374709,Northern Arizona Lumberjacks,R. Schenck,4399923,,True,32.0,3,8,3,8,0,0,0,0,4,3,7,8,1,0,5,4,6
401374709,Northern Arizona Lumberjacks,L. Orndoff,4281672,,True,32.0,4,9,2,5,2,4,0,0,0,1,1,0,1,1,2,1,10
401374709,Northern Arizona Lumberjacks,F. Jaiteh,4899311,,False,11.0,3,4,3,4,0,0,2,4,2,0,2,0,0,0,0,1,8
401374709,Northern Arizona Lumberjacks,O. Moran,4704921,,False,19.0,3,4,3,4,0,0,4,4,2,5,7,2,0,0,1,3,10
401374709,Northern Arizona Lumberjacks,N. Moran,4704920,,False,9.0,0,2,0,1,0,1,0,0,2,1,3,0,1,0,2,3,0
401374709,Northern Arizona Lumberjacks,M. Maio,4595636,,False,20.0,4,8,4,7,0,1,0,0,1,3,4,2,0,1,1,4,8
401374709,Northern Arizona Lumberjacks,TEAM,TOTAL,TOTAL,False,,28,65,21,46,7,19,18,22,18,35,53,14,5,2,16,18,81
401374709,Eastern Washington Eagles,M. Knowles,4399898,,True,31.0,2,3,2,3,0,0,0,2,1,6,7,1,0,1,2,2,4
401374709,Eastern Washington Eagles,J. Martin,4899031,,True,34.0,6,14,4,9,2,5,2,2,1,3,4,3,2,1,2,4,16
401374709,Eastern Washington Eagles,A. Zylak,4899029,,True,24.0,2,3,2,3,0,0,1,2,0,1,1,2,2,0,0,0,5
401374709,Eastern Washington Eagles,J. Lawrence,4899032,,True,23.0,5,10,2,6,3,4,0,0,0,3,3,3,2,0,3,3,13
401374709,Eastern Washington Eagles,J. Buckley,4595639,,True,29.0,5,14,4,12,1,2,5,6,2,4,6,2,1,0,2,0,16
401374709,Eastern Washington Eagles,N. Cunill,4704747,,False,3.0,0,0,0,0,0,0,0,0,0,0,0,1,0,0,0,2,0
401374709,Eastern Washington Eagles,G. Jung,4594825,,False,3.0,0,1,0,1,0,0,0,2,1,0,1,0,0,0,0,0,0
401374709,Eastern Washington Eagles,J. Boesel,4282101,,False,19.0,3,8,0,0,3,8,0,0,1,0,1,0,0,1,1,3,9
401374709,Eastern Washington Eagles,B. Rice,4066514,,False,17.0,0,2,0,0,0,2,0,0,2,1,3,2,1,0,1,1,0
401374709,Eastern Washington Eagles,A. Pettis,4899028,,False,17.0,1,8,1,8,0,0,2,4,0,1,1,0,1,0,1,4,4
401374709,Eastern Washington Eagles,TEAM,TOTAL,TOTAL,False,,24,63,15,42,9,21,10,18,8,21,29,14,9,3,13,19,67
401374708,Sacramento State Hornets,I. Natabou,4899543,,True,32.0,7,12,7,12,0,0,5,6,4,5,9,0,1,2,3,2,19
401374708,Sacramento State Hornets,K. Peneueta,4899542,,True,31.0,2,4,0,0,2,4,0,0,0,7,7,0,1,0,1,0,6
401374708,Sacramento State Hornets,J. Olivares,4594861,,True,38.0,3,9,2,3,1,6,0,0,1,3,4,1,1,0,2,5,7
401374708,Sacramento State Hornets,S. Menke,4399937,,True,36.0,3,7,3,5,0,2,4,7,2,4,6,0,0,0,2,0,10
401374708,Sacramento State Hornets,L. Tillman,4282044,,True,21.0,1,6,1,2,0,4,0,0,0,2,2,5,0,1,5,2,2
401374708,Sacramento State Hornets,N. Munguia,4704913,,False,6.0,0,0,0,0,0,0,0,0,0,0,0,0,0,0,0,1,0
401374708,Sacramento State Hornets,J. Carrasco,4704909,,False,22.0,2,5,1,2,1,3,0,0,0,3,3,4,1,0,3,4,5
401374708,Sacramento State Hornets,E. Enochs,4399939,,False,14.0,1,2,0,0,1,2,0,0,0,0,0,2,0,0,0,1,3
401374708,Sacramento State Hornets,TEAM,TOTAL,TOTAL,False,,19,45,14,24,5,21,9,13,7,24,31,12,4,3,17,15,52
401374708,Montana State Bobcats,K. Bad Bear,4594836,,True,20.0,7,11,6,9,1,2,5,6,2,2,4,1,1,0,2,2,20
401374708,Montana State Bobcats,G. Mocchi,4399914,,True,26.0,1,2,1,1,0,1,0,0,3,1,4,2,1,0,0,1,2
401374708,Montana State Bobcats,K. Limardo,4705201,,True,33.0,1,5,0,4,1,1,2,2,3,0,3,1,2,0,0,2,5
401374708,Montana State Bobcats,L. Beattie,4705202,,True,30.0,4,11,3,8,1,3,0,0,2,2,4,0,4,0,2,0,9
401374708,Montana State Bobcats,D. White,4594835,,True,30.0,2,10,2,9,0,1,8,12,0,5,5,4,1,0,0,2,12
401374708,Montana State Bobcats,T. Janssen,4705204,,False,14.0,3,8,1,4,2,4,1,2,0,0,0,1,1,0,1,0,9
401374708,Montana State Bobcats,L. Deden,4705203,,False,15.0,3,6,3,6,0,0,0,1,3,3,6,0,0,1,1,0,6
401374708,Montana State Bobcats,A. Ranson,4705200,,False,8.0,0,2,0,0,0,2,0,0,0,1,1,1,1,0,0,0,0
401374708,Montana State Bobcats,M. Jackson,4594837,,False,14.0,0,1,0,1,0,0,0,0,1,1,2,1,1,1,0,1,0
401374708,Montana State Bobcats,A. Van Sickle,4281659,,False,10.0,1,5,1,3,0,2,0,0,0,1,1,0,0,0,1,1,2
401374708,Montana State Bobcats,TEAM,TOTAL,TOTAL,False,,22,61,17,45,5,16,16,23,17,19,36,11,12,2,8,9,65
401374707,Southern Utah Thunderbirds,D. Dotson,4899551,,True,34.0,3,10,3,10,0,0,5,8,3,4,7,3,0,0,5,4,11
401374707,Southern Utah Thunderbirds,L. Williamson,4704907,,True,28.0,6,6,6,6,0,0,0,0,3,7,10,1,0,2,4,2,12
401374707,Southern Utah Thunderbirds,S. Johnston,4704906,,True,33.0,2,5,0,0,2,5,0,0,0,4,4,1,1,0,0,2,6
401374707,Southern Utah Thunderbirds,D. Ballena,4704905,,True,36.0,6,10,3,6,3,4,0,0,0,2,2,1,1,0,3,3,15
401374707,Southern Utah Thunderbirds,C. Daugherty,4704902,,True,38.0,7,12,5,8,2,4,6,10,1,6,7,4,1,0,4,1,22
401374707,Southern Utah Thunderbirds,N. Otkhmezuri,4899550,,False,6.0,0,1,0,0,0,1,0,0,0,0,0,0,0,0,1,1,0
401374707,Southern Utah Thunderbirds,A. Lord,4594868,,False,3.0,1,1,0,0,1,1,0,0,0,0,0,1,0,0,0,0,3
401374707,Southern Utah Thunderbirds,M. Eaton,4594866,,False,22.0,1,2,1,1,0,1,3,4,1,1,2,0,0,0,3,1,5
401374707,Southern Utah Thunderbirds,TEAM,TOTAL,TOTAL,False,,26,47,18,31,8,16,14,22,8,26,34,11,3,2,21,14,74
401374707,Idaho State Bengals,E. Smith,4281638,,True,15.0,2,3,2,3,0,0,0,0,0,0,0,2,1,0,0,1,4
401374707,Idaho State Bengals,T. Whitman,4594829,,True,37.0,8,16,6,10,2,6,0,0,5,5,10,0,0,0,3,4,18
401374707,Idaho State Bengals,D. Konate,4410113,,True,29.0,5,11,5,9,0,2,0,2,1,0,1,3,3,0,3,3,10
401374707,Idaho State Bengals,C. Bourne,4399905,,True,27.0,1,2,1,1,0,1,1,2,1,3,4,3,2,0,1,5,3
401374707,Idaho State Bengals,E. Ors,4068698,,True,31.0,1,7,0,3,1,4,1,4,1,3,4,6,4,0,2,1,4
401374707,Idaho State Bengals,M. Oltrogge,4399907,,False,30.0,10,17,10,14,0,3,2,2,1,2,3,0,1,0,0,4,22
401374707,Idaho State Bengals,F. Garnett,4704767,,False,9.0,1,1,1,1,0,0,0,0,0,0,0,0,1,0,1,3,2
401374707,Idaho State Bengals,D. Goles,4281636,,False,22.0,2,7,1,1,1,6,0,0,0,1,1,1,2,0,2,0,5
401374707,Idaho State Bengals,TEAM,TOTAL,TOTAL,False,,30,64,26,42,4,22,4,10,10,16,26,15,14,0,12,21,68
401368219,Valparaiso Beacons,C. Morrison,4069010,,True,12.0,4,6,1,1,3,5,0,0,0,0,0,0,0,1,0,4,11
401368219,Valparaiso Beacons,O. Brown,4594796,,True,20.0,0,2,0,1,0,1,0,0,1,2,3,1,0,0,0,1,0
401368219,Valparaiso Beacons,S. Frederick,4399435,,True,35.0,6,12,4,7,2,5,1,3,0,6,6,4,0,0,2,1,15
401368219,Valparaiso Beacons,G. White,4282520,,True,26.0,4,7,1,3,3,4,0,0,3,5,8,3,1,1,5,4,11
401368219,Valparaiso Beacons,C. Weinman,4282518,,True,38.0,5,12,4,11,1,1,6,8,1,2,3,2,2,1,1,3,17
401368219,Valparaiso Beacons,K. Beyer,4713884,,False,0.0,0,0,0,0,0,0,0,0,0,0,0,0,0,0,0,0,0
401368219,Valparaiso Beacons,J. Johnston,4705622,,False,0.0,0,0,0,0,0,0,0,0,0,0,0,0,0,0,0,0,0
401368219,Valparaiso Beacons,C. VanKempen,4595610,,False,3.0,0,0,0,0,0,0,0,0,0,0,0,0,0,0,0,2,0
401368219,Valparaiso Beacons,L. Gunn,4705621,,False,10.0,0,1,0,1,0,0,0,0,0,1,1,0,0,0,0,0,0
401368219,Valparaiso Beacons,L. Earnest,4705620,,False,23.0,4,7,3,5,1,2,0,0,2,5,7,0,0,0,1,2,9
401368219,Valparaiso Beacons,A. Interrante,4705618,,False,0.0,0,0,0,0,0,0,0,0,0,0,0,0,1,0,0,0,0
401368219,Valparaiso Beacons,I. Pitts,4399434,,False,11.0,0,1,0,0,0,1,0,0,0,2,2,2,0,0,1,0,0
401368219,Valparaiso Beacons,M. Dunson,4399402,,False,22.0,2,5,2,3,0,2,0,0,1,2,3,1,0,0,3,4,4
401368219,Valparaiso Beacons,TEAM,TOTAL,TOTAL,False,,25,53,15,32,10,21,7,11,8,29,37,13,4,3,15,21,67
401368219,Southern Illinois Salukis,G. Walker,4399431,,True,32.0,5,8,5,8,0,0,1,2,4,5,9,1,2,0,0,3,11
401368219,Southern Illinois Salukis,A. Brockmeyer,4287036,,True,22.0,5,11,5,10,0,1,8,16,6,1,7,1,0,0,2,4,18
401368219,Southern Illinois Salukis,Q. Love,4704868,,True,33.0,3,13,2,7,1,6,2,2,1,2,3,0,3,0,2,3,9
401368219,Southern Illinois Salukis,C. Link,4399430,,True,33.0,0,4,0,1,0,3,0,0,1,4,5,3,0,0,0,0,0
401368219,Southern Illinois Salukis,M. Silvey,4282270,,True,35.0,5,16,4,10,1,6,1,3,0,4,4,4,1,0,1,1,12
401368219,Southern Illinois Salukis,A. Katcher,4704871,,False,20.0,0,3,0,3,0,0,2,2,2,3,5,0,0,1,0,0,2
401368219,Southern Illinois Salukis,L. Randle,4664773,,False,4.0,0,0,0,0,0,0,0,0,0,0,0,0,0,0,0,0,0
401368219,Southern Illinois Salukis,P. Clubb,4900093,,False,1.0,0,0,0,0,0,0,0,0,0,0,0,0,0,0,0,0,0
401368219,Southern Illinois Salukis,T. Brown,4900092,,False,9.0,1,2,1,1,0,1,0,0,0,1,1,0,1,0,2,1,2
401368219,Southern Illinois Salukis,P. McCallister,4399432,,False,11.0,0,3,0,1,0,2,0,0,0,1,1,1,0,0,1,2,0
401368219,Southern Illinois Salukis,TEAM,TOTAL,TOTAL,False,,19,60,17,41,2,19,14,25,16,21,37,10,7,1,8,14,54
401368218,Missouri State Lady Bears,J. Ezeh,4433647,,True,9.0,1,3,1,3,0,0,0,0,0,1,1,0,0,0,1,1,2
401368218,Missouri State Lady Bears,A. Jackson,4280839,,True,34.0,5,18,5,18,0,0,2,2,4,7,11,0,1,5,2,4,12
401368218,Missouri State Lady Bears,M. Bhinhar,4399417,,True,25.0,1,3,1,2,0,1,0,0,2,2,4,1,3,1,2,5,2
401368218,Missouri State Lady Bears,S. Wilson,4399416,,True,33.0,2,12,2,8,0,4,2,2,3,7,10,1,0,0,1,4,6
401368218,Missouri State Lady Bears,B. Calip,4068634,,True,37.0,2,11,2,9,0,2,4,6,1,5,6,5,2,0,3,2,8
401368218,Missouri State Lady Bears,I. Nwachukwu,4900080,,False,21.0,0,4,0,4,0,0,1,2,2,1,3,0,0,0,1,2,1
401368218,Missouri State Lady Bears,I. Delarue,4900081,,False,7.0,1,5,1,2,0,3,1,3,1,0,1,0,1,0,1,0,3
401368218,Missouri State Lady Bears,P. Rocca,4704874,,False,11.0,0,3,0,0,0,3,0,0,0,0,0,0,0,0,0,3,0
401368218,Missouri State Lady Bears,M. White,4281945,,False,23.0,4,8,4,8,0,0,0,0,1,3,4,0,2,0,2,3,8
401368218,Missouri State Lady Bears,TEAM,TOTAL,TOTAL,False,,16,67,16,54,0,13,10,15,17,26,43,7,9,6,13,24,42
401368218,Loyola Chicago Ramblers,A. Day,4399400,,True,28.0,6,13,6,12,0,1,4,4,3,6,9,1,0,2,1,0,16
401368218,Loyola Chicago Ramblers,R. Blackwell,4282145,,True,18.0,4,6,1,1,3,5,2,2,2,3,5,1,0,0,2,0,13
401368218,Loyola Chicago Ramblers,S. Galanopoulos,4595599,,True,36.0,0,3,0,3,0,0,2,2,0,6,6,7,1,0,1,2,2
401368218,Loyola Chicago Ramblers,J. Gonzales,4399399,,True,8.0,0,2,0,0,0,2,0,2,0,3,3,0,0,0,2,1,0
401368218,Loyola Chicago Ramblers,B. Hampton-Bey,4281849,,True,26.0,2,8,2,6,0,2,1,3,2,4,6,2,3,1,3,3,5
401368218,Loyola Chicago Ramblers,S. Tanin,4704845,,False,15.0,0,2,0,2,0,0,2,2,1,2,3,1,2,1,3,2,2
401368218,Loyola Chicago Ramblers,J. Hoefling,4595602,,False,21.0,0,3,0,3,0,0,2,2,0,5,5,0,0,5,1,2,2
401368218,Loyola Chicago Ramblers,M. Chandler,4704844,,False,30.0,5,9,3,6,2,3,3,6,0,3,3,0,0,0,1,1,15
401368218,Loyola Chicago Ramblers,A. Brown,4595601,,False,7.0,1,3,0,0,1,3,0,0,0,0,0,1,0,0,0,1,3
401368218,Loyola Chicago Ramblers,J. Johnson,4595598,,False,11.0,1,3,1,1,0,2,0,0,0,0,0,0,1,0,1,2,2
401368218,Loyola Chicago Ramblers,TEAM,TOTAL,TOTAL,False,,19,52,13,34,6,18,16,23,11,35,46,13,7,9,17,14,60
401368217,Northern Iowa Panthers,G. Boffeli,4704857,,True,12.0,3,8,3,8,0,0,1,1,1,3,4,2,0,0,0,3,7
401368217,Northern Iowa Panthers,B. Gunnels,4282228,,True,17.0,2,3,2,3,0,0,0,0,0,1,1,2,0,2,1,1,4
401368217,Northern Iowa Panthers,K. Finley,4399421,,True,17.0,4,6,2,4,2,2,0,0,1,2,3,2,1,0,2,2,10
401368217,Northern Iowa Panthers,N. Kroeger,4282226,,True,16.0,5,6,2,2,3,4,1,1,0,1,1,1,0,0,0,1,14
401368217,Northern Iowa Panthers,K. Rucker,4282225,,True,18.0,1,7,1,5,0,2,0,0,0,2,2,3,0,0,0,1,2
401368217,Northern Iowa Panthers,S. McCullough,4595605,,False,17.0,1,3,0,1,1,2,0,0,3,3,6,0,1,0,2,1,3
401368217,Northern Iowa Panthers,K. Barney,4399424,,False,10.0,0,1,0,0,0,1,0,0,1,1,2,0,0,0,0,0,0
401368217,Northern Iowa Panthers,T. McKee,4900083,,False,4.0,0,2,0,2,0,0,0,0,0,1,1,0,0,0,0,0,0
401368217,Northern Iowa Panthers,C. Wolf,4399423,,False,21.0,4,8,4,5,0,3,3,3,2,2,4,2,0,1,1,0,11
401368217,Northern Iowa Panthers,K. Laube,4704856,,False,17.0,2,4,0,0,2,4,0,0,0,2,2,1,1,0,2,5,6
401368217,Northern Iowa Panthers,E. Green,4704853,,False,16.0,4,6,4,5,0,1,0,0,1,1,2,3,1,1,0,1,8
401368217,Northern Iowa Panthers,M. McDermott,4704852,,False,22.0,5,9,1,2,4,7,0,0,0,0,0,3,2,0,3,1,14
401368217,Northern Iowa Panthers,C. Morgan,4595604,,False,13.0,2,4,2,4,0,0,0,0,0,1,1,2,0,0,3,0,4
401368217,Northern Iowa Panthers,TEAM,TOTAL,TOTAL,False,,33,67,21,41,12,26,5,5,10,22,32,21,6,4,14,16,83
401368217,Evansville Purple Aces,C. Dupont,4595646,,True,15.0,1,3,1,3,0,0,0,0,3,3,6,0,1,0,2,2,2
401368217,Evansville Purple Aces,A. Feit,4595579,,True,32.0,5,10,4,5,1,5,1,2,2,5,7,0,1,1,3,0,12
401368217,Evansville Purple Aces,J. Davis,4595941,,True,20.0,1,5,1,4,0,1,0,2,1,2,3,1,1,0,3,1,2
401368217,Evansville Purple Aces,M. Clark,4399481,,True,33.0,6,14,6,14,0,0,6,7,2,2,4,1,2,0,3,0,18
401368217,Evansville Purple Aces,A. Newman,4399380,,True,21.0,0,2,0,2,0,0,0,0,1,0,1,1,1,0,0,2,0
401368217,Evansville Purple Aces,K. Myszka,4900059,,False,9.0,2,3,2,3,0,0,0,0,1,1,2,0,0,1,0,1,4
401368217,Evansville Purple Aces,J. Hudson,4595580,,False,14.0,0,2,0,1,0,1,0,0,1,2,3,1,0,0,2,1,0
401368217,Evansville Purple Aces,N. Partee,4595577,,False,4.0,0,1,0,1,0,0,0,0,0,1,1,0,0,0,2,2,0
401368217,Evansville Purple Aces,E. Morgan,4900058,,False,14.0,2,5,1,3,1,2,0,0,1,0,1,0,0,0,0,2,5
401368217,Evansville Purple Aces,G. Camarena,4900057,,False,7.0,0,4,0,2,0,2,0,0,1,0,1,2,1,0,1,0,0
401368217,Evansville Purple Aces,R. Stephens,4704817,,False,6.0,1,1,1,1,0,0,0,0,1,1,2,0,0,1,1,0,2
401368217,Evansville Purple Aces,S. Thurwalker,4704816,,False,5.0,0,0,0,0,0,0,0,0,1,2,3,0,0,0,0,0,0
401368217,Evansville Purple Aces,A. Griffin,4399385,,False,20.0,4,9,4,9,0,0,3,5,0,3,3,0,2,1,5,0,11
401368217,Evansville Purple Aces,TEAM,TOTAL,TOTAL,False,,22,59,20,48,2,11,10,16,16,23,39,6,9,4,22,11,56
401368216,Indiana State Sycamores,A. Smith,4900073,,True,21.0,5,10,5,10,0,0,2,2,1,2,3,2,2,0,2,3,12
401368216,Indiana State Sycamores,M. Glanton,4595587,,True,35.0,3,6,3,6,0,0,0,0,1,2,3,2,1,0,1,3,6
401368216,Indiana State Sycamores,N. Lalic,4704827,,True,30.0,4,11,2,6,2,5,2,2,1,1,2,2,0,0,2,2,12
401368216,Indiana State Sycamores,D. Williams,4595597,,True,32.0,6,11,3,5,3,6,2,2,0,0,0,3,3,0,5,4,17
401368216,Indiana State Sycamores,M. Hunter,4595588,,True,28.0,4,6,3,5,1,1,0,0,0,3,3,5,3,0,3,1,9
401368216,Indiana State Sycamores,F. Tshimanga,4282314,,False,2.0,1,1,1,1,0,0,0,0,0,0,0,0,0,1,0,0,2
401368216,Indiana State Sycamores,A. McKendree,4705287,,False,18.0,3,8,2,3,1,5,0,0,0,2,2,2,3,0,0,1,7
401368216,Indiana State Sycamores,E. Latu,4704826,,False,2.0,0,0,0,0,0,0,0,0,0,0,0,0,0,0,1,0,0
401368216,Indiana State Sycamores,C. Anderson,4595596,,False,14.0,0,2,0,2,0,0,2,2,0,1,1,0,0,0,0,1,2
401368216,Indiana State Sycamores,T. Curry,4281864,,False,18.0,2,3,2,3,0,0,0,1,1,2,3,2,0,0,2,4,4
401368216,Indiana State Sycamores,TEAM,TOTAL,TOTAL,False,,28,58,21,41,7,17,8,9,5,15,20,18,12,1,16,19,71
401368216,Drake Bulldogs,M. Bair,4595576,,True,18.0,5,8,5,7,0,1,2,2,3,4,7,1,2,3,2,3,12
401368216,Drake Bulldogs,G. Berg,4398741,,True,32.0,6,9,6,7,0,2,2,2,0,5,5,5,1,0,3,1,14
401368216,Drake Bulldogs,K. Dinnebier,4900053,,True,28.0,6,9,3,4,3,5,5,6,0,0,0,4,1,0,2,2,20
401368216,Drake Bulldogs,M. Meyer,4433118,,True,33.0,5,13,4,7,1,6,5,9,2,5,7,5,1,0,3,2,16
401368216,Drake Bulldogs,M. Petersen,4282208,,True,30.0,3,4,1,1,2,3,0,0,0,2,2,5,0,0,4,1,8
401368216,Drake Bulldogs,A. Miller,4900055,,False,16.0,3,3,3,3,0,0,0,0,1,2,3,1,1,0,2,0,6
401368216,Drake Bulldogs,A. Iiams,4900054,,False,1.0,0,0,0,0,0,0,0,0,0,0,0,0,0,0,0,0,0
401368216,Drake Bulldogs,C. Becker,4704842,,False,8.0,0,0,0,0,0,0,0,0,1,2,3,1,0,0,1,0,0
401368216,Drake Bulldogs,A. Wooldridge,4399376,,False,6.0,0,0,0,0,0,0,0,0,0,0,0,1,0,0,1,1,0
401368216,Drake Bulldogs,M. Phipps,4900056,,False,3.0,1,1,0,0,1,1,0,0,1,0,1,0,0,0,0,1,3
401368216,Drake Bulldogs,S. Gueldner,4433721,,False,10.0,1,4,0,0,1,4,2,2,0,1,1,1,1,0,0,0,5
401368216,Drake Bulldogs,H. Fuller,4282209,,False,15.0,1,2,1,1,0,1,0,0,0,2,2,1,2,0,2,1,2
401368216,Drake Bulldogs,TEAM,TOTAL,TOTAL,False,,31,53,23,30,8,23,16,21,9,26,35,25,9,3,20,12,86
401368215,Illinois State Redbirds,K. Bullman,4704825,,True,27.0,3,8,3,6,0,2,0,0,0,8,8,0,2,1,1,2,6
401368215,Illinois State Redbirds,D. Wilson,4704824,,True,30.0,8,14,8,14,0,0,6,9,5,12,17,0,0,0,3,4,22
401368215,Illinois State Redbirds,J. Redmond,4595585,,True,37.0,6,16,6,12,0,4,5,6,3,4,7,8,0,0,2,3,17
401368215,Illinois State Redbirds,M. Wong,4595584,,True,31.0,0,3,0,2,0,1,2,2,0,2,2,5,0,0,0,3,2
401368215,Illinois State Redbirds,M. Crompton,4399389,,True,37.0,2,10,0,1,2,9,0,2,1,3,4,0,1,0,0,0,6
401368215,Illinois State Redbirds,C. Van Zeeland,4900067,,False,9.0,3,4,2,3,1,1,0,1,1,1,2,0,0,0,0,0,7
401368215,Illinois State Redbirds,K. Bowers,4900066,,False,15.0,1,5,1,3,0,2,0,0,0,2,2,0,0,0,2,1,2
401368215,Illinois State Redbirds,L. Cohen,4900065,,False,0.0,0,0,0,0,0,0,0,0,0,0,0,0,0,0,0,0,0
401368215,Illinois State Redbirds,K. Newland,4399394,,False,14.0,0,1,0,0,0,1,0,0,0,0,0,0,1,0,1,2,0
401368215,Illinois State Redbirds,TEAM,TOTAL,TOTAL,False,,23,61,20,41,3,20,13,20,14,35,49,13,4,1,12,15,62
401368215,Bradley Braves,I. Fitch,4704808,,True,22.0,3,8,2,5,1,3,0,2,1,5,6,1,0,0,0,1,7
401368215,Bradley Braves,T. Danso,4704806,,True,16.0,0,0,0,0,0,0,0,0,0,1,1,0,0,4,1,4,0
401368215,Bradley Braves,C. Rice,4399479,,True,31.0,2,8,0,2,2,6,5,5,0,3,3,1,0,0,2,0,11
401368215,Bradley Braves,T. Koenig,4399368,,True,40.0,2,8,0,4,2,4,1,2,1,4,5,5,3,1,3,4,7
401368215,Bradley Braves,A. Interrante,4399365,,True,4.0,1,1,1,1,0,0,0,0,0,1,1,1,0,0,0,1,2
401368215,Bradley Braves,C. Ziebell,4900047,,False,6.0,0,3,0,3,0,0,0,0,1,2,3,0,0,0,0,1,0
401368215,Bradley Braves,A. Draper,4900045,,False,25.0,3,7,2,4,1,3,0,0,0,3,3,0,0,1,2,4,7
401368215,Bradley Braves,S. Morrow,4900041,,False,19.0,3,5,3,5,0,0,5,5,1,7,8,0,0,1,0,3,11
401368215,Bradley Braves,V. Roberts,4595573,,False,1.0,0,1,0,1,0,0,0,0,0,0,0,0,0,0,0,1,0
401368215,Bradley Braves,K. Wade,4913494,,False,0.0,0,0,0,0,0,0,0,0,0,0,0,0,0,0,0,0,0
401368215,Bradley Braves,S. Koenig,4900046,,False,3.0,0,1,0,0,0,1,0,0,0,0,0,0,0,0,0,0,0
401368215,Bradley Braves,C. Waite,4900043,,False,33.0,2,12,0,3,2,9,2,2,0,2,2,1,1,0,4,4,8
401368215,Bradley Braves,TEAM,TOTAL,TOTAL,False,,16,54,8,28,8,26,13,16,5,29,34,9,4,7,13,23,53
401368214,Valparaiso Beacons,C. VanKempen,4595610,,True,18.0,0,2,0,0,0,2,0,0,0,2,2,0,0,0,0,0,0
401368214,Valparaiso Beacons,C. Morrison,4069010,,True,20.0,2,6,1,2,1,4,0,0,0,3,3,0,1,1,1,0,5
401368214,Valparaiso Beacons,L. Earnest,4705620,,True,17.0,0,1,0,1,0,0,0,0,0,1,1,1,0,0,1,4,0
401368214,Valparaiso Beacons,O. Brown,4594796,,True,26.0,3,3,2,2,1,1,1,1,0,2,2,0,2,0,4,3,8
401368214,Valparaiso Beacons,S. Frederick,4399435,,True,28.0,4,9,3,6,1,3,2,2,0,2,2,3,1,1,2,0,11
401368214,Valparaiso Beacons,K. Beyer,4713884,,False,1.0,0,0,0,0,0,0,0,0,0,0,0,0,0,0,0,0,0
401368214,Valparaiso Beacons,J. Johnston,4705622,,False,1.0,0,0,0,0,0,0,0,0,0,0,0,0,0,0,0,0,0
401368214,Valparaiso Beacons,L. Gunn,4705621,,False,19.0,2,4,2,4,0,0,0,0,0,1,1,2,0,0,1,0,4
401368214,Valparaiso Beacons,A. Interrante,4705618,,False,1.0,0,1,0,1,0,0,0,0,0,0,0,0,0,0,0,0,0
401368214,Valparaiso Beacons,I. Pitts,4399434,,False,10.0,1,3,0,2,1,1,0,0,0,2,2,1,0,1,3,1,3
401368214,Valparaiso Beacons,M. Dunson,4399402,,False,19.0,0,3,0,1,0,2,0,0,1,4,5,0,0,0,1,0,0
401368214,Valparaiso Beacons,G. White,4282520,,False,24.0,2,8,0,2,2,6,2,2,1,3,4,2,2,0,5,4,8
401368214,Valparaiso Beacons,C. Weinman,4282518,,False,16.0,3,5,2,3,1,2,0,0,0,2,2,0,0,0,2,0,7
401368214,Valparaiso Beacons,TEAM,TOTAL,TOTAL,False,,17,45,10,24,7,21,5,5,2,24,26,9,6,3,21,12,46
401368214,Missouri State Lady Bears,A. Jackson,4280839,,True,27.0,4,11,4,11,0,0,0,0,1,6,7,0,0,2,2,2,8
401368214,Missouri State Lady Bears,M. Bhinhar,4399417,,True,30.0,4,10,0,5,4,5,0,0,4,5,9,4,1,0,2,1,12
401368214,Missouri State Lady Bears,S. Wilson,4399416,,True,30.0,1,5,1,4,0,1,1,2,2,4,6,2,3,1,4,4,3
401368214,Missouri State Lady Bears,M. White,4281945,,True,29.0,6,16,5,15,1,1,3,5,1,1,2,1,3,0,1,2,16
401368214,Missouri State Lady Bears,B. Calip,4068634,,True,36.0,7,14,4,8,3,6,5,5,1,3,4,4,2,0,0,1,22
401368214,Missouri State Lady Bears,I. Nwachukwu,4900080,,False,15.0,2,3,2,3,0,0,0,0,3,3,6,0,0,1,1,3,4
401368214,Missouri State Lady Bears,J. Ezeh,4433647,,False,1.0,0,0,0,0,0,0,0,0,0,1,1,0,0,0,0,0,0
401368214,Missouri State Lady Bears,I. Delarue,4900081,,False,7.0,0,3,0,1,0,2,0,0,0,0,0,0,0,0,0,0,0
401368214,Missouri State Lady Bears,L. Byers,4900079,,False,1.0,0,0,0,0,0,0,0,0,0,0,0,0,0,0,0,0,0
401368214,Missouri State Lady Bears,P. Rocca,4704874,,False,24.0,0,3,0,1,0,2,1,1,2,0,2,0,1,0,3,1,1
401368214,Missouri State Lady Bears,TEAM,TOTAL,TOTAL,False,,24,65,16,48,8,17,10,13,17,25,42,11,10,4,14,14,66
401368213,Southern Illinois Salukis,G. Walker,4399431,,True,32.0,5,12,5,12,0,0,0,0,0,4,4,2,2,0,5,1,10
401368213,Southern Illinois Salukis,A. Brockmeyer,4287036,,True,34.0,6,11,3,7,3,4,2,2,3,11,14,2,1,2,1,0,17
401368213,Southern Illinois Salukis,Q. Love,4704868,,True,31.0,1,5,1,3,0,2,2,2,0,4,4,2,1,0,2,1,4
401368213,Southern Illinois Salukis,C. Link,4399430,,True,30.0,1,3,1,2,0,1,0,0,0,1,1,3,2,0,1,2,2
401368213,Southern Illinois Salukis,M. Silvey,4282270,,True,33.0,4,9,2,4,2,5,0,0,0,8,8,2,1,0,3,1,10
401368213,Southern Illinois Salukis,Z. Belcher,4900094,,False,2.0,0,0,0,0,0,0,0,0,0,1,1,0,0,0,0,0,0
401368213,Southern Illinois Salukis,A. Katcher,4704871,,False,6.0,0,0,0,0,0,0,0,0,0,0,0,0,0,1,0,1,0
401368213,Southern Illinois Salukis,L. Randle,4664773,,False,6.0,1,3,1,3,0,0,0,0,1,2,3,0,0,0,0,1,2
401368213,Southern Illinois Salukis,P. Clubb,4900093,,False,2.0,0,0,0,0,0,0,0,0,0,0,0,0,0,0,1,0,0
401368213,Southern Illinois Salukis,T. Brown,4900092,,False,9.0,0,0,0,0,0,0,0,0,0,0,0,0,0,0,1,0,0
401368213,Southern Illinois Salukis,S. Prochaska,4704869,,False,2.0,0,0,0,0,0,0,0,0,0,0,0,0,0,0,0,0,0
401368213,Southern Illinois Salukis,P. McCallister,4399432,,False,13.0,2,4,0,0,2,4,0,0,0,0,0,1,0,0,0,0,6
401368213,Southern Illinois Salukis,TEAM,TOTAL,TOTAL,False,,20,47,13,31,7,16,4,4,5,32,37,12,7,3,16,7,51
401368213,Loyola Chicago Ramblers,J. Hoefling,4595602,,True,27.0,2,4,2,4,0,0,0,0,0,6,6,0,1,1,0,0,4
401368213,Loyola Chicago Ramblers,A. Day,4399400,,True,23.0,1,7,1,6,0,1,0,0,0,3,3,1,0,1,2,2,2
401368213,Loyola Chicago Ramblers,M. Chandler,4704844,,True,30.0,1,5,1,2,0,3,0,0,0,1,1,0,1,0,2,1,2
401368213,Loyola Chicago Ramblers,S. Galanopoulos,4595599,,True,27.0,2,13,2,10,0,3,0,0,0,3,3,0,0,0,1,0,4
401368213,Loyola Chicago Ramblers,B. Hampton-Bey,4281849,,True,23.0,1,2,1,2,0,0,2,2,2,1,3,3,1,0,4,3,4
401368213,Loyola Chicago Ramblers,S. Tanin,4704845,,False,24.0,4,11,4,11,0,0,0,0,3,4,7,1,2,1,1,1,8
401368213,Loyola Chicago Ramblers,R. Blackwell,4282145,,False,6.0,0,0,0,0,0,0,0,0,0,0,0,0,0,0,0,0,0
401368213,Loyola Chicago Ramblers,K. Evans,4704843,,False,2.0,0,0,0,0,0,0,0,0,0,0,0,0,0,0,0,0,0
401368213,Loyola Chicago Ramblers,A. Brown,4595601,,False,10.0,0,3,0,0,0,3,0,0,0,1,1,1,0,0,0,0,0
401368213,Loyola Chicago Ramblers,J. Johnson,4595598,,False,19.0,0,1,0,1,0,0,3,4,1,0,1,1,2,0,1,1,3
401368213,Loyola Chicago Ramblers,J. Gonzales,4399399,,False,9.0,0,3,0,0,0,3,1,2,0,2,2,0,0,0,1,1,1
401368213,Loyola Chicago Ramblers,TEAM,TOTAL,TOTAL,False,,11,49,11,36,0,13,6,8,6,22,28,7,7,3,13,9,28
401368212,Northern Iowa Panthers,G. Boffeli,4704857,,True,21.0,4,7,4,7,0,0,4,6,3,8,11,0,0,0,1,4,12
401368212,Northern Iowa Panthers,B. Gunnels,4282228,,True,32.0,1,5,1,4,0,1,1,1,2,8,10,1,2,3,2,1,3
401368212,Northern Iowa Panthers,K. Finley,4399421,,True,33.0,2,8,2,3,0,5,0,2,1,1,2,1,0,1,5,1,4
401368212,Northern Iowa Panthers,N. Kroeger,4282226,,True,21.0,1,3,1,1,0,2,0,0,0,1,1,2,1,0,1,2,2
401368212,Northern Iowa Panthers,K. Rucker,4282225,,True,35.0,7,11,4,7,3,4,5,8,0,2,2,2,0,0,4,1,22
401368212,Northern Iowa Panthers,S. McCullough,4595605,,False,2.0,0,0,0,0,0,0,0,0,0,0,0,0,0,0,1,0,0
401368212,Northern Iowa Panthers,C. Wolf,4399423,,False,22.0,1,3,1,3,0,0,0,0,1,5,6,4,2,1,1,2,2
401368212,Northern Iowa Panthers,E. Green,4704853,,False,29.0,6,12,5,8,1,4,3,7,1,2,3,1,0,0,1,0,16
401368212,Northern Iowa Panthers,M. McDermott,4704852,,False,5.0,0,1,0,0,0,1,0,0,0,0,0,0,0,0,1,0,0
401368212,Northern Iowa Panthers,TEAM,TOTAL,TOTAL,False,,22,50,18,33,4,17,13,24,10,31,41,11,5,5,17,11,61
401368212,Indiana State Sycamores,A. Smith,4900073,,True,17.0,4,5,3,4,1,1,1,2,1,0,1,0,1,0,1,5,10
401368212,Indiana State Sycamores,M. Glanton,4595587,,True,28.0,4,11,4,11,0,0,1,2,2,3,5,1,2,0,1,5,9
401368212,Indiana State Sycamores,N. Lalic,4704827,,True,37.0,3,11,2,7,1,4,1,2,0,3,3,2,2,0,0,3,8
401368212,Indiana State Sycamores,D. Williams,4595597,,True,29.0,4,12,3,11,1,1,1,2,1,4,5,2,1,1,1,4,10
401368212,Indiana State Sycamores,M. Hunter,4595588,,True,26.0,4,10,3,9,1,1,1,2,2,3,5,2,1,0,2,1,10
401368212,Indiana State Sycamores,A. McKendree,4705287,,False,20.0,1,5,1,2,0,3,0,0,0,1,1,1,3,1,1,2,2
401368212,Indiana State Sycamores,C. Anderson,4595596,,False,11.0,1,2,1,2,0,0,0,0,0,2,2,0,0,0,4,1,2
401368212,Indiana State Sycamores,T. Curry,4281864,,False,32.0,2,5,2,5,0,0,0,1,2,6,8,5,2,2,3,3,4
401368212,Indiana State Sycamores,TEAM,TOTAL,TOTAL,False,,23,61,19,51,4,10,5,11,9,25,34,13,12,4,13,24,55
401368211,Evansville Purple Aces,C. Dupont,4595646,,True,38.0,3,9,3,8,0,1,2,4,6,5,11,2,0,5,1,4,8
401368211,Evansville Purple Aces,A. Feit,4595579,,True,39.0,11,17,5,9,6,8,0,0,2,9,11,1,3,1,1,4,28
401368211,Evansville Purple Aces,J. Davis,4595941,,True,42.0,8,27,6,18,2,9,1,2,2,5,7,3,0,0,3,3,19
401368211,Evansville Purple Aces,M. Clark,4399481,,True,39.0,2,8,1,5,1,3,2,3,4,2,6,3,3,1,5,1,7
401368211,Evansville Purple Aces,A. Newman,4399380,,True,38.0,1,7,1,6,0,1,3,4,0,4,4,5,1,0,4,3,5
401368211,Evansville Purple Aces,K. Myszka,4900059,,False,6.0,1,1,1,1,0,0,2,2,1,0,1,0,1,0,0,4,4
401368211,Evansville Purple Aces,J. Hudson,4595580,,False,7.0,0,0,0,0,0,0,0,0,0,1,1,0,2,0,2,2,0
401368211,Evansville Purple Aces,E. Morgan,4900058,,False,6.0,0,0,0,0,0,0,0,0,0,0,0,0,0,0,1,0,0
401368211,Evansville Purple Aces,A. Griffin,4399385,,False,10.0,0,6,0,5,0,1,0,0,0,0,0,0,1,0,2,0,0
401368211,Evansville Purple Aces,TEAM,TOTAL,TOTAL,False,,26,75,17,52,9,23,10,15,16,28,44,14,11,7,20,21,71
401368211,Drake Bulldogs,M. Bair,4595576,,True,19.0,2,8,2,8,0,0,2,5,2,8,10,1,1,1,1,5,6
401368211,Drake Bulldogs,G. Berg,4398741,,True,28.0,7,16,6,15,1,1,5,6,3,6,9,0,1,0,5,3,20
401368211,Drake Bulldogs,K. Dinnebier,4900053,,True,26.0,2,6,1,2,1,4,4,6,2,3,5,1,3,0,3,2,9
401368211,Drake Bulldogs,M. Meyer,4433118,,True,33.0,6,10,3,3,3,7,2,2,1,6,7,5,1,0,2,0,17
401368211,Drake Bulldogs,M. Petersen,4282208,,True,34.0,3,5,1,3,2,2,0,0,2,0,2,5,1,0,2,0,8
401368211,Drake Bulldogs,A. Miller,4900055,,False,23.0,2,4,2,4,0,0,1,3,0,7,7,3,0,5,3,1,5
401368211,Drake Bulldogs,C. Becker,4704842,,False,14.0,4,7,4,5,0,2,1,1,5,0,5,3,0,0,3,1,9
401368211,Drake Bulldogs,A. Wooldridge,4399376,,False,4.0,0,1,0,1,0,0,1,2,0,0,0,0,0,0,0,0,1
401368211,Drake Bulldogs,S. Gueldner,4433721,,False,26.0,0,7,0,1,0,6,2,2,0,0,0,0,1,0,1,0,2
401368211,Drake Bulldogs,H. Fuller,4282209,,False,18.0,1,3,0,1,1,2,0,0,0,3,3,2,0,0,2,2,3
401368211,Drake Bulldogs,TEAM,TOTAL,TOTAL,False,,27,67,19,43,8,24,18,27,15,36,51,20,8,6,22,14,80
401368122,Texas Tech Lady Raiders,B. Gerlich,4398980,,True,32.0,5,10,4,8,1,2,1,2,1,1,2,3,1,1,1,0,12
401368122,Texas Tech Lady Raiders,T. Thomas,4280707,,True,29.0,5,12,4,8,1,4,0,0,2,6,8,1,1,0,3,4,11
401368122,Texas Tech Lady Raiders,E. Tofaeono,4704602,,True,29.0,2,4,2,4,0,0,1,4,0,5,5,0,0,0,1,3,5
401368122,Texas Tech Lady Raiders,L. Hightower,4898413,,True,28.0,1,4,1,4,0,0,2,2,1,1,2,2,0,0,0,1,4
401368122,Texas Tech Lady Raiders,V. Gray,4398981,,True,35.0,3,17,2,12,1,5,3,4,1,0,1,1,0,0,3,2,10
401368122,Texas Tech Lady Raiders,C. Embry,4898416,,False,16.0,4,6,4,5,0,1,1,2,2,3,5,0,0,0,0,2,9
401368122,Texas Tech Lady Raiders,L. Wenger,4898415,,False,4.0,0,0,0,0,0,0,0,0,0,0,0,0,0,0,0,0,0
401368122,Texas Tech Lady Raiders,S. Ukkonen,4898414,,False,2.0,1,1,1,1,0,0,0,0,0,0,0,0,0,0,0,0,2
401368122,Texas Tech Lady Raiders,R. McKinney,4682750,,False,13.0,2,3,2,3,0,0,0,0,0,1,1,0,0,0,0,1,4
401368122,Texas Tech Lady Raiders,T. Veitenheimer,4398886,,False,12.0,0,0,0,0,0,0,0,0,0,1,1,1,1,0,3,0,0
401368122,Texas Tech Lady Raiders,TEAM,TOTAL,TOTAL,False,,23,57,20,45,3,12,8,14,9,20,29,8,3,1,11,13,57
401368122,Baylor Bears,C. Bickle,4398780,,True,33.0,3,5,3,4,0,1,0,0,1,3,4,6,1,0,2,3,6
401368122,Baylor Bears,N. Smith,4398776,,True,39.0,13,21,12,17,1,4,8,8,0,12,12,1,2,0,3,2,35
401368122,Baylor Bears,Q. Egbo,4398779,,True,22.0,4,7,4,7,0,0,0,2,2,3,5,0,0,2,1,5,8
401368122,Baylor Bears,J. Asberry,4318562,,True,26.0,2,7,0,2,2,5,0,0,0,3,3,4,1,0,0,0,6
401368122,Baylor Bears,J. Lewis,4065687,,True,29.0,1,5,0,1,1,4,2,2,0,2,2,6,0,0,2,2,5
401368122,Baylor Bears,K. Gillispie,4434027,,False,1.0,1,1,1,1,0,0,0,0,1,0,1,0,0,0,0,0,2
401368122,Baylor Bears,A. Katramados,4900792,,False,1.0,0,1,0,0,0,1,0,0,0,0,0,0,0,0,0,0,0
401368122,Baylor Bears,S. Andrews,4433407,,False,29.0,3,4,2,2,1,2,0,0,0,1,1,5,1,0,1,1,7
401368122,Baylor Bears,J. Owens,4432839,,False,20.0,5,5,2,2,3,3,0,0,0,1,1,2,0,0,0,0,13
401368122,Baylor Bears,TEAM,TOTAL,TOTAL,False,,32,56,24,36,8,20,10,12,5,28,33,24,5,2,9,13,82
401368121,Texas Longhorns,D. Gaston,4433739,,True,13.0,1,1,1,1,0,0,0,0,0,3,3,0,0,2,2,2,2
401368121,Texas Longhorns,L. Ebo,4398943,,True,32.0,6,9,6,9,0,0,5,6,3,3,6,2,0,2,1,4,17
401368121,Texas Longhorns,R. Harmon,4433523,,True,27.0,6,9,6,8,0,1,1,2,0,3,3,4,4,0,2,2,13
401368121,Texas Longhorns,A. Warren,4398987,,True,33.0,4,10,4,9,0,1,0,0,3,2,5,1,0,0,1,1,8
401368121,Texas Longhorns,J. Allen-Taylor,4398984,,True,28.0,2,10,2,9,0,1,0,0,1,1,2,4,1,0,1,1,4
401368121,Texas Longhorns,A. Moore,4433794,,False,18.0,3,4,3,4,0,0,2,4,1,4,5,0,2,0,0,4,8
401368121,Texas Longhorns,L. Lattimore,4433517,,False,6.0,2,2,2,2,0,0,2,2,2,0,2,0,0,0,2,0,6
401368121,Texas Longhorns,K. Hunter,4433806,,False,4.0,0,0,0,0,0,0,0,0,0,0,0,1,0,0,1,1,0
401368121,Texas Longhorns,A. Matharu,4433638,,False,22.0,3,8,2,4,1,4,0,0,0,4,4,0,2,0,3,0,7
401368121,Texas Longhorns,S. Holle,4433449,,False,17.0,0,3,0,3,0,0,0,0,0,1,1,0,0,0,1,3,0
401368121,Texas Longhorns,TEAM,TOTAL,TOTAL,False,,27,56,26,49,1,7,10,14,11,24,35,12,9,4,15,18,65
401368121,Oklahoma State Cowgirls,T. Collins,4582912,,True,18.0,2,5,2,5,0,0,0,0,3,2,5,0,0,0,1,3,4
401368121,Oklahoma State Cowgirls,K. De Lapp,4398979,,True,13.0,0,2,0,2,0,0,0,0,1,2,3,0,0,0,4,4,0
401368121,Oklahoma State Cowgirls,L. Keys,4703518,,True,38.0,2,11,2,9,0,2,6,8,2,1,3,2,1,0,2,1,10
401368121,Oklahoma State Cowgirls,M. Dennis,4594696,,True,23.0,3,8,2,7,1,1,0,0,0,1,1,2,1,0,2,1,7
401368121,Oklahoma State Cowgirls,L. Fields,4433664,,True,40.0,2,10,2,9,0,1,6,8,0,5,5,0,6,0,6,2,10
401368121,Oklahoma State Cowgirls,M. James,4691726,,False,22.0,2,4,1,3,1,1,4,5,2,1,3,1,0,0,0,0,9
401368121,Oklahoma State Cowgirls,A. Winchester,4281318,,False,16.0,1,4,1,4,0,0,0,0,1,2,3,0,0,0,0,1,2
401368121,Oklahoma State Cowgirls,N. Boyd,4595017,,False,17.0,1,2,1,2,0,0,2,2,0,2,2,1,0,0,1,0,4
401368121,Oklahoma State Cowgirls,S. Rodrigues,4594699,,False,13.0,2,3,2,2,0,1,0,0,1,2,3,1,3,2,3,3,4
401368121,Oklahoma State Cowgirls,TEAM,TOTAL,TOTAL,False,,15,49,13,43,2,6,18,23,12,20,32,7,11,2,20,15,50
401368120,TCU Horned Frogs,M. Berry,3934229,,True,34.0,3,10,3,9,0,1,2,2,2,10,12,3,0,0,2,2,8
401368120,TCU Horned Frogs,K. Mokwuah,4399082,,True,10.0,3,4,3,4,0,0,0,2,0,0,0,1,1,1,1,3,6
401368120,TCU Horned Frogs,O. Adika,4703593,,True,29.0,3,9,2,4,1,5,0,0,1,5,6,4,0,0,4,2,7
401368120,TCU Horned Frogs,L. Heard,4281321,,True,40.0,3,14,2,12,1,2,7,13,2,3,5,3,4,0,3,1,14
401368120,TCU Horned Frogs,A. Jackson,4065769,,True,27.0,2,5,1,3,1,2,0,0,0,2,2,1,1,0,1,4,5
401368120,TCU Horned Frogs,Y. Morris,4399222,,False,12.0,0,5,0,5,0,0,0,0,1,0,1,0,1,1,1,2,0
401368120,TCU Horned Frogs,P. Morris,4398815,,False,12.0,2,3,2,3,0,0,2,4,2,3,5,0,0,1,0,0,6
401368120,TCU Horned Frogs,C. Germond,4600271,,False,12.0,1,2,1,1,0,1,0,0,0,0,0,0,2,0,1,2,2
401368120,TCU Horned Frogs,A. Holmes,4433756,,False,15.0,1,4,1,1,0,3,0,0,0,1,1,0,0,0,0,2,2
401368120,TCU Horned Frogs,T. Manumaleuga,4411393,,False,9.0,0,3,0,3,0,0,0,0,0,0,0,0,0,0,1,1,0
401368120,TCU Horned Frogs,TEAM,TOTAL,TOTAL,False,,18,59,15,45,3,14,11,21,10,27,37,12,9,3,14,19,50
401368120,Kansas State Wildcats,A. Lee,4398964,,True,23.0,9,16,9,16,0,0,2,4,2,9,11,0,0,2,5,4,20
401368120,Kansas State Wildcats,B. Glenn,4898995,,True,28.0,1,3,1,1,0,2,2,2,0,3,3,2,0,0,3,4,4
401368120,Kansas State Wildcats,S. Sundell,4898994,,True,36.0,5,11,0,3,5,8,3,4,0,4,4,4,2,1,3,4,18
401368120,Kansas State Wildcats,J. Glenn,4691694,,True,27.0,1,9,0,2,1,7,0,0,0,6,6,0,0,0,3,1,3
401368120,Kansas State Wildcats,E. Ebert,4594690,,True,18.0,0,0,0,0,0,0,0,0,0,5,5,3,0,0,2,4,0
401368120,Kansas State Wildcats,L. Macke,4398962,,False,24.0,3,6,1,2,2,4,2,3,2,2,4,3,0,0,3,0,10
401368120,Kansas State Wildcats,T. Lauterbach,4594273,,False,9.0,0,2,0,2,0,0,0,0,0,2,2,0,0,0,0,1,0
401368120,Kansas State Wildcats,R. Dallinger,4898997,,False,22.0,1,3,0,1,1,2,0,0,0,3,3,4,0,1,0,2,3
401368120,Kansas State Wildcats,J. Moore,4597507,,False,5.0,1,1,1,1,0,0,0,0,0,0,0,0,0,0,0,2,2
401368120,Kansas State Wildcats,C. Goodrich,4281307,,False,8.0,0,0,0,0,0,0,1,2,0,2,2,1,0,0,1,0,1
401368120,Kansas State Wildcats,TEAM,TOTAL,TOTAL,False,,21,51,12,28,9,23,10,15,5,36,41,17,2,4,20,22,61
401368119,Oklahoma Sooners,L. Scott,4594693,,True,8.0,0,2,0,2,0,0,0,0,0,2,2,0,1,0,1,4,0
401368119,Oklahoma Sooners,M. Williams,4398883,,True,31.0,4,17,4,11,0,6,0,0,5,4,9,1,1,0,5,2,8
401368119,Oklahoma Sooners,N. Tot,4594275,,True,28.0,3,6,1,2,2,4,0,0,1,4,5,2,2,0,2,3,8
401368119,Oklahoma Sooners,K. Tucker,4433150,,True,25.0,1,6,0,2,1,4,0,0,0,3,3,4,1,0,1,1,3
401368119,Oklahoma Sooners,T. Robertson,4398884,,True,35.0,5,15,3,6,2,9,2,3,0,2,2,4,1,0,1,0,14
401368119,Oklahoma Sooners,N. Lampkin,4398882,,False,18.0,3,6,3,5,0,1,0,0,1,7,8,2,0,1,1,2,6
401368119,Oklahoma Sooners,S. Vann,4703432,,False,22.0,6,11,2,4,4,7,1,2,2,3,5,1,4,0,3,3,17
401368119,Oklahoma Sooners,K. Perkins,4899000,,False,7.0,0,1,0,1,0,0,0,0,0,2,2,1,0,0,0,0,0
401368119,Oklahoma Sooners,K. Washington,4898998,,False,19.0,2,10,0,5,2,5,3,4,1,1,2,1,2,0,7,3,9
401368119,Oklahoma Sooners,G. Gregory,4594692,,False,7.0,1,5,1,1,0,4,0,0,0,1,1,1,1,0,2,0,2
401368119,Oklahoma Sooners,TEAM,TOTAL,TOTAL,False,,25,79,14,39,11,40,6,9,16,31,47,17,13,1,23,18,67
401368119,Kansas Jayhawks,I. Chatzileonti,4600665,,True,30.0,1,10,1,9,0,1,3,4,1,9,10,1,0,0,3,1,5
401368119,Kansas Jayhawks,T. Jackson,4898989,,True,35.0,7,11,7,11,0,0,4,5,3,3,6,3,3,4,3,3,18
401368119,Kansas Jayhawks,H. Kersgieter,4433703,,True,33.0,2,13,2,7,0,6,2,4,1,7,8,3,2,1,2,1,6
401368119,Kansas Jayhawks,Z. Franklin,4432983,,True,36.0,5,12,4,9,1,3,1,2,0,7,7,3,3,0,4,2,12
401368119,Kansas Jayhawks,J. Brosseau,4066590,,True,13.0,2,5,1,1,1,4,0,0,0,1,1,0,0,0,3,1,5
401368119,Kansas Jayhawks,K. Jessen,4600607,,False,5.0,1,2,1,2,0,0,0,0,2,0,2,0,0,0,1,1,2
401368119,Kansas Jayhawks,N. Eltayeb,4898993,,False,5.0,0,1,0,0,0,1,2,2,1,0,1,0,0,1,0,0,2
401368119,Kansas Jayhawks,C. Prater,4433140,,False,20.0,2,5,2,4,0,1,0,0,1,7,8,1,0,0,3,0,4
401368119,Kansas Jayhawks,A. Thomas,4398826,,False,23.0,8,11,7,8,1,3,2,4,0,1,1,0,4,0,3,1,19
401368119,Kansas Jayhawks,TEAM,TOTAL,TOTAL,False,,28,70,25,51,3,19,14,21,10,36,46,11,12,6,22,10,73
401368118,West Virginia Mountaineers,E. Martinez,4433353,,True,25.0,4,12,4,11,0,1,0,0,7,4,11,3,0,0,2,5,8
401368118,West Virginia Mountaineers,K. Niblack,4398995,,True,5.0,1,1,1,1,0,0,1,2,1,1,2,0,0,0,0,1,3
401368118,West Virginia Mountaineers,J. Quinerly,4434015,,True,16.0,4,9,3,8,1,1,0,0,0,1,1,0,2,0,2,5,9
401368118,West Virginia Mountaineers,J. Hemingway,4432991,,True,31.0,1,9,1,5,0,4,0,0,0,1,1,2,2,1,1,3,2
401368118,West Virginia Mountaineers,M. Smith,4398996,,True,38.0,5,18,4,11,1,7,0,0,1,0,1,2,0,0,2,2,11
401368118,West Virginia Mountaineers,A. Gray,4281368,,False,21.0,3,9,3,9,0,0,0,0,5,3,8,1,0,0,3,4,6
401368118,West Virginia Mountaineers,Y. Morris,4595175,,False,7.0,0,0,0,0,0,0,0,0,0,1,1,0,0,1,0,0,0
401368118,West Virginia Mountaineers,B. Ejiofor,4280899,,False,27.0,4,6,4,6,0,0,0,2,4,6,10,2,0,1,0,3,8
401368118,West Virginia Mountaineers,S. Samuel,4595356,,False,30.0,2,10,0,7,2,3,4,4,1,2,3,2,1,0,1,2,10
401368118,West Virginia Mountaineers,TEAM,TOTAL,TOTAL,False,,24,74,20,58,4,16,5,8,20,22,42,12,5,3,11,25,57
401368118,Iowa State Cyclones,N. Diew,4599130,,True,32.0,3,6,0,2,3,4,0,0,0,2,2,0,0,1,1,2,9
401368118,Iowa State Cyclones,M. Kane,4398803,,True,11.0,2,4,2,4,0,0,2,2,1,0,1,0,0,0,1,2,6
401368118,Iowa State Cyclones,E. Ryan,4433436,,True,40.0,10,12,9,11,1,1,8,11,0,4,4,4,1,0,4,1,29
401368118,Iowa State Cyclones,L. Donarski,4433409,,True,37.0,3,11,2,5,1,6,4,6,0,6,6,1,1,0,4,2,11
401368118,Iowa State Cyclones,As. Joens,4398802,,True,39.0,2,10,0,5,2,5,6,8,0,9,9,3,2,0,2,1,12
401368118,Iowa State Cyclones,M. Vick,4898397,,False,3.0,0,0,0,0,0,0,0,0,0,0,0,0,0,0,0,0,0
401368118,Iowa State Cyclones,I. Zingaro,4712646,,False,0.0,0,0,0,0,0,0,0,0,0,1,1,0,0,0,0,0,0
401368118,Iowa State Cyclones,B. Jordao,4399242,,False,21.0,3,4,3,4,0,0,1,2,3,4,7,0,0,0,1,2,7
401368118,Iowa State Cyclones,M. Espenmiller-McGraw,4594688,,False,7.0,0,0,0,0,0,0,0,0,0,0,0,0,0,0,1,1,0
401368118,Iowa State Cyclones,Au. Joens,4433988,,False,10.0,0,2,0,0,0,2,0,0,0,1,1,1,0,0,0,0,0
401368118,Iowa State Cyclones,M. Frederick,4398801,,False,0.0,0,0,0,0,0,0,0,0,0,0,0,0,0,0,0,0,0
401368118,Iowa State Cyclones,TEAM,TOTAL,TOTAL,False,,23,49,16,31,7,18,21,29,7,31,38,9,4,1,14,11,74
401368117,Texas Tech Lady Raiders,B. Gerlich,4398980,,True,25.0,3,6,2,4,1,2,0,0,0,2,2,6,0,0,3,5,7
401368117,Texas Tech Lady Raiders,T. Thomas,4280707,,True,37.0,2,5,1,3,1,2,2,2,2,6,8,4,1,0,2,4,7
401368117,Texas Tech Lady Raiders,E. Tofaeono,4704602,,True,22.0,7,7,7,7,0,0,1,1,2,1,3,0,0,0,3,5,15
401368117,Texas Tech Lady Raiders,L. Hightower,4898413,,True,26.0,3,7,1,2,2,5,5,6,1,4,5,1,0,0,2,4,13
401368117,Texas Tech Lady Raiders,V. Gray,4398981,,True,39.0,9,18,8,16,1,2,8,11,2,7,9,1,1,2,3,4,27
401368117,Texas Tech Lady Raiders,C. Embry,4898416,,False,10.0,1,2,1,1,0,1,0,0,2,2,4,1,0,0,0,1,2
401368117,Texas Tech Lady Raiders,L. Wenger,4898415,,False,1.0,0,0,0,0,0,0,0,0,0,2,2,0,0,0,0,0,0
401368117,Texas Tech Lady Raiders,S. Ukkonen,4898414,,False,2.0,0,0,0,0,0,0,0,0,0,0,0,0,0,0,0,0,0
401368117,Texas Tech Lady Raiders,R. McKinney,4682750,,False,21.0,4,9,4,5,0,4,4,6,0,0,0,1,1,0,0,2,12
401368117,Texas Tech Lady Raiders,T. Veitenheimer,4398886,,False,17.0,0,1,0,0,0,1,0,0,0,2,2,3,2,0,3,2,0
401368117,Texas Tech Lady Raiders,TEAM,TOTAL,TOTAL,False,,29,55,24,38,5,17,20,26,9,26,35,17,5,2,16,27,83
401368117,TCU Horned Frogs,M. Berry,3934229,,True,36.0,5,7,3,3,2,4,3,4,1,4,5,2,1,0,1,1,15
401368117,TCU Horned Frogs,K. Mokwuah,4399082,,True,17.0,2,5,2,5,0,0,0,0,0,2,2,2,0,0,3,5,4
401368117,TCU Horned Frogs,O. Adika,4703593,,True,29.0,2,6,1,3,1,3,8,8,1,0,1,2,2,0,3,4,13
401368117,TCU Horned Frogs,L. Heard,4281321,,True,37.0,5,12,4,11,1,1,10,12,0,4,4,2,2,0,5,5,21
401368117,TCU Horned Frogs,A. Jackson,4065769,,True,32.0,3,6,0,1,3,5,3,4,0,3,3,1,0,0,0,4,12
401368117,TCU Horned Frogs,Y. Morris,4399222,,False,7.0,1,2,1,2,0,0,2,2,0,1,1,0,1,0,1,2,4
401368117,TCU Horned Frogs,P. Morris,4398815,,False,0.0,0,0,0,0,0,0,0,0,0,0,0,0,0,0,0,0,0
401368117,TCU Horned Frogs,T. Diggs,4433049,,False,1.0,0,0,0,0,0,0,0,0,0,1,1,0,0,0,0,0,0
401368117,TCU Horned Frogs,P. Bradley,4898422,,False,1.0,0,0,0,0,0,0,0,0,0,0,0,0,0,0,0,0,0
401368117,TCU Horned Frogs,C. Germond,4600271,,False,25.0,2,6,2,5,0,1,0,0,0,0,0,3,0,0,1,4,4
401368117,TCU Horned Frogs,A. Holmes,4433756,,False,5.0,0,1,0,0,0,1,0,0,0,1,1,0,0,0,0,0,0
401368117,TCU Horned Frogs,T. Manumaleuga,4411393,,False,10.0,2,4,0,1,2,3,0,0,1,0,1,2,2,0,0,0,6
401368117,TCU Horned Frogs,TEAM,TOTAL,TOTAL,False,,22,49,13,31,9,18,26,30,3,16,19,14,8,0,14,25,79
401368116,West Virginia Mountaineers,E. Martinez,4433353,,True,42.0,8,17,6,13,2,4,4,5,2,17,19,4,4,0,6,2,22
401368116,West Virginia Mountaineers,K. Niblack,4398995,,True,20.0,1,6,1,6,0,0,2,2,1,2,3,1,2,0,2,5,4
401368116,West Virginia Mountaineers,J. Quinerly,4434015,,True,47.0,4,16,4,14,0,2,1,2,1,3,4,6,3,0,0,4,9
401368116,West Virginia Mountaineers,J. Hemingway,4432991,,True,28.0,1,2,1,1,0,1,0,0,0,2,2,2,3,0,3,2,2
401368116,West Virginia Mountaineers,M. Smith,4398996,,True,50.0,7,18,4,8,3,10,5,6,0,1,1,1,1,0,6,1,22
401368116,West Virginia Mountaineers,A. Gray,4281368,,False,7.0,1,1,1,1,0,0,1,2,0,0,0,0,2,0,2,2,3
401368116,West Virginia Mountaineers,Y. Morris,4595175,,False,13.0,2,2,2,2,0,0,2,2,1,3,4,0,0,2,1,3,6
401368116,West Virginia Mountaineers,B. Ejiofor,4280899,,False,17.0,0,1,0,1,0,0,0,0,1,3,4,0,2,1,1,3,0
401368116,West Virginia Mountaineers,S. Samuel,4595356,,False,26.0,2,4,2,2,0,2,2,2,1,2,3,1,1,0,0,4,6
401368116,West Virginia Mountaineers,TEAM,TOTAL,TOTAL,False,,26,67,21,48,5,19,17,21,13,37,50,15,18,3,24,26,74
401368116,Kansas State Wildcats,A. Lee,4398964,,True,41.0,9,16,9,16,0,0,6,9,4,6,10,0,1,1,3,4,24
401368116,Kansas State Wildcats,B. Glenn,4898995,,True,35.0,2,8,2,5,0,3,0,2,0,2,2,1,1,0,0,4,4
401368116,Kansas State Wildcats,S. Sundell,4898994,,True,49.0,3,16,1,6,2,10,7,10,0,6,6,7,2,1,9,4,15
401368116,Kansas State Wildcats,J. Glenn,4691694,,True,48.0,3,13,1,3,2,10,0,0,1,1,2,2,1,0,2,2,8
401368116,Kansas State Wildcats,E. Ebert,4594690,,True,27.0,0,2,0,2,0,0,7,10,1,6,7,2,0,0,2,2,7
401368116,Kansas State Wildcats,L. Macke,4398962,,False,26.0,0,3,0,2,0,1,0,0,3,2,5,0,2,1,2,2,0
401368116,Kansas State Wildcats,T. Lauterbach,4594273,,False,4.0,0,0,0,0,0,0,0,0,0,0,0,0,0,1,0,0,0
401368116,Kansas State Wildcats,R. Dallinger,4898997,,False,8.0,0,0,0,0,0,0,0,0,0,0,0,0,0,0,1,1,0
401368116,Kansas State Wildcats,C. Goodrich,4281307,,False,12.0,2,3,2,3,0,0,0,0,0,1,1,0,0,0,2,1,4
401368116,Kansas State Wildcats,TEAM,TOTAL,TOTAL,False,,19,61,15,37,4,24,20,31,10,29,39,12,7,4,22,20,62
401368115,Texas Longhorns,D. Gaston,4433739,,True,24.0,3,5,3,5,0,0,4,4,2,1,3,0,0,0,1,3,10
401368115,Texas Longhorns,L. Ebo,4398943,,True,33.0,5,7,5,7,0,0,2,2,4,3,7,0,0,3,2,4,12
401368115,Texas Longhorns,R. Harmon,4433523,,True,35.0,1,8,1,7,0,1,8,12,1,4,5,6,6,0,3,3,10
401368115,Texas Longhorns,S. Holle,4433449,,True,26.0,1,7,1,6,0,1,0,2,1,4,5,1,1,1,1,3,2
401368115,Texas Longhorns,J. Allen-Taylor,4398984,,True,36.0,8,16,6,12,2,4,2,2,1,2,3,3,5,0,1,4,20
401368115,Texas Longhorns,A. Moore,4433794,,False,2.0,1,1,1,1,0,0,0,0,0,1,1,0,0,0,0,1,2
401368115,Texas Longhorns,K. Hunter,4433806,,False,2.0,1,1,1,1,0,0,0,0,0,0,0,0,0,0,0,0,2
401368115,Texas Longhorns,A. Matharu,4433638,,False,18.0,2,10,0,3,2,7,0,0,0,1,1,1,1,0,5,2,6
401368115,Texas Longhorns,A. Warren,4398987,,False,24.0,2,4,2,4,0,0,2,2,4,3,7,0,0,1,0,1,6
401368115,Texas Longhorns,TEAM,TOTAL,TOTAL,False,,24,59,20,46,4,13,18,24,14,23,37,11,13,5,14,21,70
401368115,Kansas Jayhawks,I. Chatzileonti,4600665,,True,30.0,2,3,2,3,0,0,6,6,1,1,2,0,1,0,4,1,10
401368115,Kansas Jayhawks,T. Jackson,4898989,,True,24.0,1,1,1,1,0,0,0,1,3,4,7,2,0,1,5,4,2
401368115,Kansas Jayhawks,H. Kersgieter,4433703,,True,34.0,6,12,3,8,3,4,3,3,0,2,2,0,1,0,3,1,18
401368115,Kansas Jayhawks,Z. Franklin,4432983,,True,37.0,4,10,4,9,0,1,8,11,0,6,6,5,0,0,3,2,16
401368115,Kansas Jayhawks,J. Brosseau,4066590,,True,18.0,2,6,0,0,2,6,0,0,0,1,1,0,0,0,3,1,6
401368115,Kansas Jayhawks,K. Jessen,4600607,,False,1.0,0,1,0,1,0,0,0,0,0,0,0,0,0,0,0,2,0
401368115,Kansas Jayhawks,D. Papadopoulou,4898992,,False,14.0,0,1,0,1,0,0,0,0,0,0,0,0,1,0,0,2,0
401368115,Kansas Jayhawks,C. Prater,4433140,,False,26.0,0,7,0,6,0,1,2,2,4,4,8,1,0,0,1,2,2
401368115,Kansas Jayhawks,A. Thomas,4398826,,False,16.0,2,5,2,3,0,2,2,4,0,2,2,0,2,0,1,3,6
401368115,Kansas Jayhawks,TEAM,TOTAL,TOTAL,False,,17,46,12,32,5,14,21,27,8,21,29,8,5,1,22,18,60
401368114,Oklahoma State Cowgirls,A. Winchester,4281318,,True,12.0,1,1,1,1,0,0,0,0,1,2,3,0,0,0,0,4,2
401368114,Oklahoma State Cowgirls,B. Reeves,4703520,,True,2.0,1,3,1,3,0,0,0,0,0,0,0,0,0,0,0,0,2
401368114,Oklahoma State Cowgirls,K. De Lapp,4398979,,True,34.0,7,10,7,10,0,0,4,6,3,6,9,4,4,1,3,4,18
401368114,Oklahoma State Cowgirls,M. Dennis,4594696,,True,35.0,4,10,4,8,0,2,1,3,0,1,1,4,1,0,5,1,9
401368114,Oklahoma State Cowgirls,L. Fields,4433664,,True,38.0,5,19,3,8,2,11,3,6,2,5,7,2,6,1,1,0,15
401368114,Oklahoma State Cowgirls,M. James,4691726,,False,11.0,1,2,1,2,0,0,0,0,2,0,2,1,1,0,0,4,2
401368114,Oklahoma State Cowgirls,T. Collins,4582912,,False,23.0,4,10,4,10,0,0,0,0,3,1,4,1,0,0,1,5,8
401368114,Oklahoma State Cowgirls,L. Keys,4703518,,False,38.0,6,17,1,6,5,11,3,4,1,0,1,1,1,0,1,1,20
401368114,Oklahoma State Cowgirls,N. Boyd,4595017,,False,5.0,0,0,0,0,0,0,0,0,0,0,0,0,0,0,0,0,0
401368114,Oklahoma State Cowgirls,S. Rodrigues,4594699,,False,2.0,0,0,0,0,0,0,0,0,0,2,2,0,0,0,0,0,0
401368114,Oklahoma State Cowgirls,TEAM,TOTAL,TOTAL,False,,29,72,22,48,7,24,11,19,15,17,32,13,13,2,12,20,76
401368114,Oklahoma Sooners,L. Scott,4594693,,True,19.0,1,2,1,2,0,0,0,0,1,2,3,1,2,1,1,3,2
401368114,Oklahoma Sooners,M. Williams,4398883,,True,30.0,4,11,3,7,1,4,4,6,1,5,6,1,0,0,5,4,13
401368114,Oklahoma Sooners,N. Tot,4594275,,True,22.0,0,4,0,1,0,3,0,0,1,1,2,4,0,0,4,2,0
401368114,Oklahoma Sooners,K. Tucker,4433150,,True,30.0,4,7,1,3,3,4,0,0,2,0,2,0,0,1,3,1,11
401368114,Oklahoma Sooners,T. Robertson,4398884,,True,32.0,4,7,1,1,3,6,8,8,0,11,11,3,3,0,3,1,19
401368114,Oklahoma Sooners,N. Lampkin,4398882,,False,14.0,1,3,1,3,0,0,1,2,1,2,3,2,0,1,1,2,3
401368114,Oklahoma Sooners,S. Vann,4703432,,False,20.0,8,12,7,10,1,2,2,2,2,5,7,2,2,1,2,3,19
401368114,Oklahoma Sooners,K. Perkins,4899000,,False,6.0,1,1,0,0,1,1,0,0,0,1,1,0,0,0,0,2,3
401368114,Oklahoma Sooners,K. Washington,4898998,,False,21.0,2,4,2,4,0,0,2,3,1,2,3,4,0,0,5,1,6
401368114,Oklahoma Sooners,G. Gregory,4594692,,False,6.0,1,2,1,1,0,1,1,1,0,0,0,0,0,0,0,0,3
401368114,Oklahoma Sooners,TEAM,TOTAL,TOTAL,False,,26,53,17,32,9,21,18,22,11,31,42,17,7,4,25,19,79
401367742,Western Michigan Broncos,T. Williams,4595309,,True,18.0,7,13,6,10,1,3,2,5,0,6,6,0,2,0,2,5,17
401367742,Western Michigan Broncos,R. Jacobson,4069024,,True,28.0,5,12,3,8,2,4,0,0,0,2,2,1,1,2,0,5,12
401367742,Western Michigan Broncos,L. Ross,4705393,,True,22.0,4,7,4,4,0,3,0,0,1,1,2,2,0,0,4,3,8
401367742,Western Michigan Broncos,M. Wagner,4705392,,True,29.0,1,2,0,1,1,1,0,0,1,1,2,0,0,0,4,2,3
401367742,Western Michigan Broncos,H. Spitzley,4705390,,True,26.0,0,4,0,4,0,0,2,2,1,2,3,0,3,1,0,3,2
401367742,Western Michigan Broncos,H. Douglas,4407901,,False,0.0,0,0,0,0,0,0,0,0,0,0,0,0,0,0,0,0,0
401367742,Western Michigan Broncos,A. Voss,4399498,,False,14.0,1,2,1,2,0,0,1,1,1,2,3,0,0,0,1,0,3
401367742,Western Michigan Broncos,G. Saxman,4705391,,False,12.0,0,0,0,0,0,0,0,0,0,0,0,1,1,0,0,3,0
401367742,Western Michigan Broncos,S. Shafer,4595307,,False,24.0,2,6,2,3,0,3,3,5,0,1,1,1,1,0,4,2,7
401367742,Western Michigan Broncos,M. Watters,4399362,,False,27.0,3,6,0,1,3,5,0,0,0,2,2,1,0,0,0,2,9
401367742,Western Michigan Broncos,TEAM,TOTAL,TOTAL,False,,23,52,16,33,7,19,8,13,4,19,23,6,8,3,15,25,61
401367742,Toledo Rockets,J. Cook,4900087,,True,28.0,4,6,4,6,0,0,1,2,5,1,6,0,0,0,4,2,9
401367742,Toledo Rockets,S. Mikonowicz,4705387,,True,37.0,5,8,4,5,1,3,4,6,2,7,9,1,1,1,3,3,15
401367742,Toledo Rockets,K. Goss,4705386,,True,31.0,2,4,0,2,2,2,5,6,1,3,4,2,2,0,1,2,11
401367742,Toledo Rockets,Q. Lockett,4595303,,True,27.0,4,14,3,9,1,5,5,5,0,2,2,3,2,1,1,5,14
401367742,Toledo Rockets,S. Wiard,4595301,,True,39.0,2,7,2,7,0,0,3,4,0,5,5,6,2,0,3,2,7
401367742,Toledo Rockets,L. Lance,4399357,,False,1.0,0,0,0,0,0,0,0,0,0,1,1,0,0,0,0,0,0
401367742,Toledo Rockets,Y. Curry,4595305,,False,1.0,1,1,1,1,0,0,0,0,0,0,0,0,0,0,0,0,2
401367742,Toledo Rockets,H. Noveroske,4594772,,False,10.0,1,2,1,2,0,0,2,5,2,1,3,0,0,0,1,3,4
401367742,Toledo Rockets,J. Jansen,4900086,,False,21.0,4,6,2,2,2,4,2,2,0,3,3,0,1,0,2,1,12
401367742,Toledo Rockets,N. Garcia,4703763,,False,2.0,0,1,0,1,0,0,0,0,0,0,0,0,0,0,0,0,0
401367742,Toledo Rockets,S. Barnes,4595302,,False,2.0,0,0,0,0,0,0,0,0,0,0,0,1,0,0,1,0,0
401367742,Toledo Rockets,M. Copeland,4282150,,False,1.0,0,0,0,0,0,0,0,0,0,0,0,0,0,0,0,0,0
401367742,Toledo Rockets,TEAM,TOTAL,TOTAL,False,,23,49,17,35,6,14,22,30,11,27,38,13,8,2,17,18,74
401367741,Eastern Michigan Eagles,C. Skanes,4399514,,True,25.0,3,10,3,10,0,0,5,7,3,6,9,1,0,1,0,2,11
401367741,Eastern Michigan Eagles,L. Austin,4900048,,True,36.0,6,10,4,6,2,4,0,0,0,3,3,0,0,1,5,0,14
401367741,Eastern Michigan Eagles,Z. Nelson,4705360,,True,37.0,4,11,2,6,2,5,0,1,1,4,5,2,0,0,3,2,10
401367741,Eastern Michigan Eagles,N. Pineda,4399318,,True,25.0,3,7,2,3,1,4,2,3,0,5,5,3,0,0,1,5,9
401367741,Eastern Michigan Eagles,C. Lewis,4282134,,True,11.0,1,3,1,2,0,1,0,0,0,0,0,0,0,0,2,0,2
401367741,Eastern Michigan Eagles,K. O'Hara,4399512,,False,9.0,1,4,0,2,1,2,0,0,0,0,0,1,0,1,0,0,3
401367741,Eastern Michigan Eagles,R. Harris,4282136,,False,8.0,2,3,2,3,0,0,0,0,1,0,1,0,0,0,0,0,4
401367741,Eastern Michigan Eagles,K. Lewis,4900049,,False,8.0,1,2,1,2,0,0,0,2,0,1,1,0,1,0,0,3,2
401367741,Eastern Michigan Eagles,T. Banner,4400442,,False,6.0,0,1,0,1,0,0,0,0,0,0,0,0,0,0,0,1,0
401367741,Eastern Michigan Eagles,T. Abiola,4282082,,False,11.0,0,4,0,1,0,3,0,0,0,3,3,0,0,0,1,0,0
401367741,Eastern Michigan Eagles,D. Rainey,4068137,,False,24.0,1,7,1,2,0,5,1,2,0,3,3,3,1,0,0,1,3
401367741,Eastern Michigan Eagles,TEAM,TOTAL,TOTAL,False,,22,62,16,38,6,24,8,15,7,28,35,10,2,3,13,14,58
401367741,Ball State Cardinals,T. Dis Agustsdottir,4399285,,True,33.0,9,16,4,6,5,10,1,2,2,6,8,2,1,0,0,0,24
401367741,Ball State Cardinals,C. Latimer,4281480,,True,21.0,4,9,4,8,0,1,3,4,1,4,5,1,2,1,0,1,11
401367741,Ball State Cardinals,B. Smith,4399286,,True,12.0,2,4,1,1,1,3,0,0,0,1,1,0,0,0,0,0,5
401367741,Ball State Cardinals,A. Becki,4900609,,True,29.0,2,7,1,3,1,4,2,2,1,2,3,8,1,1,0,2,7
401367741,Ball State Cardinals,S. Freeman,4595285,,True,31.0,6,13,4,8,2,5,2,2,1,6,7,7,4,0,2,0,16
401367741,Ball State Cardinals,A. Rauch,4595288,,False,11.0,5,7,5,7,0,0,2,2,3,2,5,1,0,0,0,3,12
401367741,Ball State Cardinals,J. Turner,4900613,,False,6.0,1,1,1,1,0,0,2,4,1,2,3,0,1,0,0,1,4
401367741,Ball State Cardinals,M. Kiefer,4900612,,False,17.0,2,5,2,3,0,2,0,0,1,4,5,0,0,3,0,3,4
401367741,Ball State Cardinals,I. Subirats,4705355,,False,15.0,3,4,3,4,0,0,1,2,0,1,1,2,0,0,0,0,7
401367741,Ball State Cardinals,M. Bischoff,4900614,,False,10.0,1,4,1,2,0,2,0,0,0,2,2,1,0,0,0,0,2
401367741,Ball State Cardinals,E. Puiggros,4595287,,False,15.0,0,1,0,0,0,1,0,0,0,4,4,2,0,0,3,2,0
401367741,Ball State Cardinals,TEAM,TOTAL,TOTAL,False,,35,71,26,43,9,28,13,18,10,36,46,24,9,5,5,12,92
401367740,Northern Illinois Huskies,A. Davis,4595300,,True,21.0,3,9,3,9,0,0,4,6,7,9,16,0,0,0,1,2,10
401367740,Northern Illinois Huskies,M. Brandon,4399339,,True,29.0,1,3,1,2,0,1,2,2,1,7,8,4,0,2,3,3,4
401367740,Northern Illinois Huskies,E. Hodges,4282143,,True,1.0,0,1,0,1,0,0,1,2,0,0,0,0,0,0,0,0,1
401367740,Northern Illinois Huskies,N. Ahart,4280999,,True,28.0,5,10,3,5,2,5,0,0,2,2,4,1,0,0,1,0,12
401367740,Northern Illinois Huskies,P. Castro,4069126,,True,21.0,2,2,0,0,2,2,0,0,0,0,0,0,1,0,1,2,6
401367740,Northern Illinois Huskies,B. Stonebraker,4705370,,False,7.0,1,2,1,2,0,0,0,0,1,0,1,0,1,0,1,1,2
401367740,Northern Illinois Huskies,E. Meinert,4705369,,False,19.0,0,4,0,4,0,0,0,0,1,2,3,0,1,1,1,2,0
401367740,Northern Illinois Huskies,L. Nickel,4900077,,False,4.0,0,0,0,0,0,0,0,0,0,1,1,0,0,0,0,0,0
401367740,Northern Illinois Huskies,M. Prewitt,4900078,,False,4.0,2,3,0,0,2,3,0,0,0,1,1,1,0,0,0,1,6
401367740,Northern Illinois Huskies,J. Marable,4705368,,False,28.0,4,11,4,11,0,0,0,0,1,6,7,4,2,0,4,2,8
401367740,Northern Illinois Huskies,S. McCrea,4705367,,False,14.0,0,4,0,0,0,4,2,2,0,0,0,1,0,0,1,0,2
401367740,Northern Illinois Huskies,J. Poisson,4069124,,False,24.0,7,14,3,8,4,6,0,0,0,3,3,0,0,0,3,1,18
401367740,Northern Illinois Huskies,TEAM,TOTAL,TOTAL,False,,25,63,15,42,10,21,9,12,16,37,53,11,5,3,17,14,69
401367740,Central Michigan Chippewas,T. Timpe,4900030,,True,37.0,0,10,0,0,0,10,0,0,0,2,2,2,0,1,0,4,0
401367740,Central Michigan Chippewas,K. Gordon,4900028,,True,36.0,4,11,3,7,1,4,1,2,1,4,5,1,1,1,4,2,10
401367740,Central Michigan Chippewas,H. Knoll,4900027,,True,37.0,6,11,2,4,4,7,7,8,1,3,4,4,0,1,1,2,23
401367740,Central Michigan Chippewas,L. Tesson,4900026,,True,30.0,2,9,2,7,0,2,2,2,1,3,4,3,3,0,5,3,6
401367740,Central Michigan Chippewas,A. Weekes,4399310,,True,36.0,2,13,2,9,0,4,2,2,3,5,8,1,2,0,0,2,6
401367740,Central Michigan Chippewas,R. Gordon,4900029,,False,24.0,2,4,2,3,0,1,0,0,0,4,4,1,2,0,1,4,4
401367740,Central Michigan Chippewas,TEAM,TOTAL,TOTAL,False,,16,58,11,30,5,28,12,14,7,23,30,12,8,3,12,17,49
401367739,Ohio Bobcats,G. Burris,4282121,,True,38.0,2,9,1,3,1,6,0,0,1,7,8,1,2,1,3,2,5
401367739,Ohio Bobcats,E. Johnson,4282118,,True,38.0,5,21,4,10,1,11,1,1,3,6,9,0,0,1,2,3,12
401367739,Ohio Bobcats,M. Mace,4613137,,True,20.0,0,0,0,0,0,0,0,0,0,3,3,1,0,0,2,3,0
401367739,Ohio Bobcats,K. Bambule,4282120,,True,19.0,1,3,0,0,1,3,0,0,0,1,1,0,1,0,0,1,3
401367739,Ohio Bobcats,C. Hooks,4282117,,True,39.0,4,21,4,15,0,6,0,11,3,4,7,5,4,1,0,4,8
401367739,Ohio Bobcats,Y. Felder,4900084,,False,27.0,6,12,2,8,4,4,4,4,3,5,8,1,4,0,2,4,20
401367739,Ohio Bobcats,P. Guice,4433665,,False,19.0,0,1,0,0,0,1,2,2,1,0,1,0,1,0,0,5,2
401367739,Ohio Bobcats,TEAM,TOTAL,TOTAL,False,,18,67,11,36,7,31,7,18,13,28,41,8,12,3,10,22,50
401367739,Kent State Golden Flashes,N. Blackford,4595260,,True,15.0,1,5,1,5,0,0,0,0,0,5,5,1,0,1,0,1,2
401367739,Kent State Golden Flashes,L. Thall,4399327,,True,35.0,3,12,0,3,3,9,0,0,2,6,8,2,2,1,1,3,9
401367739,Kent State Golden Flashes,K. Shumate,4433684,,True,23.0,3,7,2,3,1,4,5,6,0,5,5,2,0,0,1,4,12
401367739,Kent State Golden Flashes,H. Young,4399326,,True,29.0,0,3,0,1,0,2,3,4,3,5,8,3,0,0,1,3,3
401367739,Kent State Golden Flashes,M. Modkins,4399323,,True,22.0,2,5,1,3,1,2,0,0,0,4,4,2,2,0,4,1,5
401367739,Kent State Golden Flashes,B. Dunn,4900064,,False,24.0,2,12,0,3,2,9,3,4,5,2,7,0,0,1,3,2,9
401367739,Kent State Golden Flashes,J. Batsch,4900063,,False,3.0,0,0,0,0,0,0,0,0,0,0,0,0,0,0,0,0,0
401367739,Kent State Golden Flashes,C. Santoro,4704895,,False,21.0,2,4,0,1,2,3,5,6,1,3,4,0,1,0,2,2,11
401367739,Kent State Golden Flashes,C. Kelly,4595261,,False,28.0,3,11,2,3,1,8,1,1,2,3,5,1,0,0,3,3,8
401367739,Kent State Golden Flashes,TEAM,TOTAL,TOTAL,False,,16,59,6,22,10,37,17,21,15,36,51,11,5,3,17,19,59
401367738,Miami (OH) RedHawks,A. Freeman,4595269,,True,10.0,2,2,2,2,0,0,0,2,0,2,2,0,0,0,1,3,4
401367738,Miami (OH) RedHawks,I. Wolf,4900071,,True,36.0,5,16,3,12,2,4,10,10,2,1,3,4,2,0,3,4,22
401367738,Miami (OH) RedHawks,K. Davidson,4705364,,True,27.0,2,6,1,3,1,3,2,2,0,1,1,1,0,0,2,3,7
401367738,Miami (OH) RedHawks,E. Battle,4705362,,True,24.0,6,15,3,7,3,8,0,0,0,2,2,1,2,0,3,5,15
401367738,Miami (OH) RedHawks,P. Scott,4595268,,True,14.0,1,5,1,4,0,1,0,0,0,2,2,3,2,0,0,1,2
401367738,Miami (OH) RedHawks,K. Richason,4900072,,False,3.0,1,3,1,3,0,0,0,0,0,0,0,0,1,0,0,0,2
401367738,Miami (OH) RedHawks,T. Foster-Walker,4595908,,False,16.0,2,4,2,4,0,0,2,2,3,1,4,0,3,0,2,1,6
401367738,Miami (OH) RedHawks,J. Duckett,4705365,,False,11.0,1,1,1,1,0,0,0,0,2,2,4,1,1,0,0,2,2
401367738,Miami (OH) RedHawks,M. Cluse,4900070,,False,26.0,4,11,2,6,2,5,0,0,1,4,5,1,0,1,1,2,10
401367738,Miami (OH) RedHawks,S. Watkins,4705363,,False,7.0,1,1,1,1,0,0,0,0,1,0,1,1,0,0,0,1,2
401367738,Miami (OH) RedHawks,V. Garrelts,4399336,,False,26.0,0,2,0,0,0,2,0,0,1,2,3,4,5,0,0,1,0
401367738,Miami (OH) RedHawks,TEAM,TOTAL,TOTAL,False,,25,66,17,43,8,23,14,16,12,19,31,16,16,1,13,23,72
401367738,Akron Zips,C. Neitzel,4399282,,True,18.0,4,5,4,4,0,1,2,2,0,3,3,5,1,0,1,0,10
401367738,Akron Zips,J. Dawson,4281369,,True,25.0,10,15,10,13,0,2,6,8,1,5,6,5,3,0,6,4,26
401367738,Akron Zips,L. Ferrell,4595221,,True,24.0,3,4,3,3,0,1,2,2,1,6,7,2,1,0,2,2,8
401367738,Akron Zips,G. Brown-Mitchell,4399281,,True,6.0,0,0,0,0,0,0,0,0,0,1,1,0,0,0,2,0,0
401367738,Akron Zips,K. Miller,4399280,,True,31.0,3,6,3,6,0,0,2,2,1,2,3,2,0,0,0,3,8
401367738,Akron Zips,R. Bass,4899611,,False,18.0,2,2,2,2,0,0,4,5,2,1,3,1,0,3,5,3,8
401367738,Akron Zips,L. Brewer,4595218,,False,19.0,1,1,1,1,0,0,0,0,0,3,3,1,0,1,2,0,2
401367738,Akron Zips,M. Neitzel,4595220,,False,4.0,0,3,0,3,0,0,0,0,0,1,1,0,0,0,0,2,0
401367738,Akron Zips,Z. Rasheed,4899610,,False,15.0,0,3,0,1,0,2,0,0,1,0,1,1,0,0,2,0,0
401367738,Akron Zips,Al. Carter,4704834,,False,2.0,0,1,0,1,0,0,0,0,0,0,0,0,0,0,0,0,0
401367738,Akron Zips,A. Corcoran,4595282,,False,12.0,0,0,0,0,0,0,0,0,0,0,0,1,1,0,2,0,0
401367738,Akron Zips,R. Martindale,4595219,,False,26.0,3,9,1,1,2,8,3,4,0,3,3,0,0,1,1,0,11
401367738,Akron Zips,TEAM,TOTAL,TOTAL,False,,26,49,24,35,2,14,19,23,8,28,36,18,6,5,23,14,73
401367737,Buffalo Bulls,L. Christie,4595235,,True,23.0,5,7,5,7,0,0,2,2,2,4,6,0,1,0,1,2,12
401367737,Buffalo Bulls,S. Hemphill,4068803,,True,30.0,8,8,8,8,0,0,2,2,2,10,12,4,1,0,3,4,18
401367737,Buffalo Bulls,G. Woolley,4899639,,True,33.0,4,12,4,8,0,4,12,13,5,3,8,6,2,1,3,2,20
401367737,Buffalo Bulls,D. Camp,4704065,,True,28.0,2,7,1,5,1,2,0,0,0,2,2,7,2,1,1,0,5
401367737,Buffalo Bulls,D. Fair,4595236,,True,35.0,1,13,1,10,0,3,0,0,1,4,5,2,0,0,4,0,2
401367737,Buffalo Bulls,S. Wilson,4433553,,False,2.0,0,0,0,0,0,0,0,0,0,0,0,0,0,0,0,1,0
401367737,Buffalo Bulls,A. Adeyeye,4399304,,False,23.0,6,10,6,10,0,0,1,2,6,2,8,0,4,1,0,3,13
401367737,Buffalo Bulls,N. Jordan,4595728,,False,2.0,0,0,0,0,0,0,0,0,0,0,0,0,0,0,0,0,0
401367737,Buffalo Bulls,E. Gaba,4595238,,False,4.0,1,1,1,1,0,0,0,0,1,1,2,1,0,0,0,0,2
401367737,Buffalo Bulls,C. Valenti-Paea,4711744,,False,3.0,0,1,0,1,0,0,0,0,0,0,0,0,0,0,1,1,0
401367737,Buffalo Bulls,J. Young,4400441,,False,17.0,2,6,1,2,1,4,4,4,0,0,0,3,2,0,0,1,9
401367737,Buffalo Bulls,TEAM,TOTAL,TOTAL,False,,29,65,27,52,2,13,21,23,20,27,47,23,12,3,15,14,81
401367737,Bowling Green Falcons,K. Hempfling,4399299,,True,18.0,6,7,4,4,2,3,0,1,1,5,6,3,0,0,7,0,14
401367737,Bowling Green Falcons,A. Velasco,4899612,,True,25.0,0,6,0,5,0,1,2,2,1,2,3,4,0,0,1,1,2
401367737,Bowling Green Falcons,K. Lewis,4704866,,True,13.0,0,0,0,0,0,0,2,2,0,2,2,0,1,0,4,4,2
401367737,Bowling Green Falcons,N. Hampton,4704864,,True,32.0,5,13,4,9,1,4,1,1,0,0,0,2,4,0,1,1,12
401367737,Bowling Green Falcons,E. Brett,4595223,,True,26.0,3,11,1,6,2,5,0,0,2,4,6,0,0,0,2,2,8
401367737,Bowling Green Falcons,O. Hill,4704865,,False,12.0,0,2,0,2,0,0,2,2,2,0,2,3,2,0,0,4,2
401367737,Bowling Green Falcons,S. Dziekan,4704863,,False,13.0,1,3,1,3,0,0,0,0,2,0,2,1,0,0,2,3,2
401367737,Bowling Green Falcons,J. Tate,4899613,,False,23.0,2,4,2,4,0,0,1,1,3,2,5,3,2,0,3,3,5
401367737,Bowling Green Falcons,M. Sharps,4595176,,False,12.0,2,6,0,1,2,5,0,0,0,1,1,0,0,0,0,0,6
401367737,Bowling Green Falcons,M. Dever,4399297,,False,2.0,0,0,0,0,0,0,0,0,0,0,0,0,0,0,0,0,0
401367737,Bowling Green Falcons,M. Parker,4282037,,False,24.0,3,8,0,2,3,6,0,0,0,2,2,2,0,0,1,2,9
401367737,Bowling Green Falcons,TEAM,TOTAL,TOTAL,False,,22,60,12,36,10,24,8,9,12,18,30,18,9,0,21,20,62
401367736,Western Michigan Broncos,T. Williams,4595309,,True,20.0,6,13,6,13,0,0,1,5,2,7,9,1,0,0,0,4,13
401367736,Western Michigan Broncos,R. Jacobson,4069024,,True,34.0,2,9,2,8,0,1,2,2,2,8,10,4,3,5,1,2,6
401367736,Western Michigan Broncos,L. Ross,4705393,,True,33.0,7,14,4,8,3,6,1,2,1,4,5,2,0,1,1,1,18
401367736,Western Michigan Broncos,M. Wagner,4705392,,True,25.0,0,4,0,1,0,3,0,0,1,1,2,1,1,0,1,3,0
401367736,Western Michigan Broncos,H. Spitzley,4705390,,True,24.0,2,5,1,3,1,2,2,2,2,1,3,1,1,2,0,2,7
401367736,Western Michigan Broncos,H. Douglas,4407901,,False,1.0,0,0,0,0,0,0,0,0,0,0,0,0,0,0,0,0,0
401367736,Western Michigan Broncos,A. Voss,4399498,,False,11.0,2,3,2,3,0,0,4,5,1,0,1,0,0,0,2,1,8
401367736,Western Michigan Broncos,L. Audino,4712323,,False,2.0,0,1,0,1,0,0,0,0,0,0,0,0,0,0,0,0,0
401367736,Western Michigan Broncos,G. Saxman,4705391,,False,9.0,0,1,0,1,0,0,0,0,1,0,1,1,1,0,1,1,0
401367736,Western Michigan Broncos,S. Shafer,4595307,,False,19.0,2,7,2,4,0,3,0,0,1,2,3,2,2,0,2,1,4
401367736,Western Michigan Broncos,M. Watters,4399362,,False,21.0,4,6,0,0,4,6,0,0,0,3,3,1,0,0,0,0,12
401367736,Western Michigan Broncos,K. Brooks,4282152,,False,1.0,0,0,0,0,0,0,0,0,0,0,0,0,0,0,0,0,0
401367736,Western Michigan Broncos,TEAM,TOTAL,TOTAL,False,,25,63,17,42,8,21,10,16,12,26,38,13,8,8,9,15,68
401367736,Eastern Michigan Eagles,C. Skanes,4399514,,True,29.0,4,8,4,8,0,0,6,9,3,4,7,0,0,0,5,1,14
401367736,Eastern Michigan Eagles,L. Austin,4900048,,True,38.0,5,12,5,11,0,1,3,3,1,12,13,3,0,0,4,3,13
401367736,Eastern Michigan Eagles,Z. Nelson,4705360,,True,21.0,0,2,0,1,0,1,0,0,1,2,3,0,0,1,1,4,0
401367736,Eastern Michigan Eagles,N. Pineda,4399318,,True,26.0,2,7,2,5,0,2,0,0,0,3,3,1,1,1,2,1,4
401367736,Eastern Michigan Eagles,C. Lewis,4282134,,True,26.0,2,5,1,1,1,4,0,0,0,4,4,1,0,0,2,3,5
401367736,Eastern Michigan Eagles,K. O'Hara,4399512,,False,4.0,0,0,0,0,0,0,0,0,0,0,0,0,1,0,0,0,0
401367736,Eastern Michigan Eagles,R. Harris,4282136,,False,2.0,0,0,0,0,0,0,0,0,0,0,0,0,0,0,1,0,0
401367736,Eastern Michigan Eagles,K. Lewis,4900049,,False,10.0,0,2,0,2,0,0,0,0,2,2,4,0,1,0,3,2,0
401367736,Eastern Michigan Eagles,J. Agosto,4282133,,False,20.0,1,7,1,5,0,2,0,0,0,0,0,0,0,0,1,2,2
401367736,Eastern Michigan Eagles,T. Abiola,4282082,,False,2.0,0,0,0,0,0,0,0,0,0,0,0,0,0,0,0,0,0
401367736,Eastern Michigan Eagles,D. Rainey,4068137,,False,22.0,5,8,1,1,4,7,0,0,0,2,2,1,0,1,1,1,14
401367736,Eastern Michigan Eagles,TEAM,TOTAL,TOTAL,False,,19,51,14,34,5,17,9,12,8,31,39,6,3,3,20,17,52
401367735,Toledo Rockets,J. Cook,4900087,,True,14.0,6,10,6,10,0,0,2,2,3,5,8,0,0,1,0,3,14
401367735,Toledo Rockets,S. Mikonowicz,4705387,,True,31.0,4,11,3,7,1,4,0,0,5,4,9,5,1,0,2,0,9
401367735,Toledo Rockets,K. Goss,4705386,,True,29.0,3,8,2,4,1,4,0,0,1,0,1,3,1,0,1,2,7
401367735,Toledo Rockets,Q. Lockett,4595303,,True,34.0,6,10,5,8,1,2,1,1,0,5,5,3,2,0,2,1,14
401367735,Toledo Rockets,S. Wiard,4595301,,True,34.0,4,8,2,5,2,3,0,1,0,5,5,7,1,1,2,0,10
401367735,Toledo Rockets,L. Lance,4399357,,False,2.0,0,0,0,0,0,0,0,0,0,1,1,1,0,0,0,0,0
401367735,Toledo Rockets,Y. Curry,4595305,,False,4.0,2,2,2,2,0,0,0,0,0,1,1,0,0,0,0,0,4
401367735,Toledo Rockets,H. Noveroske,4594772,,False,11.0,1,3,1,3,0,0,0,0,0,4,4,1,1,0,0,2,2
401367735,Toledo Rockets,J. Jansen,4900086,,False,13.0,1,2,0,1,1,1,0,0,0,0,0,1,0,0,1,0,3
401367735,Toledo Rockets,E. Doherty,4900085,,False,2.0,0,1,0,1,0,0,0,0,0,0,0,0,0,0,0,0,0
401367735,Toledo Rockets,H. Idowu,4705388,,False,2.0,0,1,0,0,0,1,0,0,0,0,0,0,0,0,0,0,0
401367735,Toledo Rockets,N. Garcia,4703763,,False,13.0,3,4,1,1,2,3,0,0,0,0,0,0,0,0,1,1,8
401367735,Toledo Rockets,S. Barnes,4595302,,False,9.0,1,4,0,0,1,4,0,0,0,1,1,0,0,0,0,0,3
401367735,Toledo Rockets,M. Copeland,4282150,,False,2.0,0,0,0,0,0,0,0,0,0,0,0,0,0,0,0,0,0
401367735,Toledo Rockets,TEAM,TOTAL,TOTAL,False,,31,64,22,42,9,22,3,4,10,26,36,21,6,2,10,9,74
401367735,Northern Illinois Huskies,A. Davis,4595300,,True,34.0,14,24,14,24,0,0,2,3,3,7,10,1,0,0,4,4,30
401367735,Northern Illinois Huskies,M. Brandon,4399339,,True,24.0,0,1,0,0,0,1,0,0,0,2,2,2,0,0,0,0,0
401367735,Northern Illinois Huskies,J. Marable,4705368,,True,32.0,3,8,3,7,0,1,1,2,0,4,4,5,0,0,2,2,7
401367735,Northern Illinois Huskies,N. Ahart,4280999,,True,26.0,0,1,0,0,0,1,0,2,0,2,2,0,1,0,2,0,0
401367735,Northern Illinois Huskies,J. Poisson,4069124,,True,28.0,3,7,2,4,1,3,0,0,0,3,3,2,1,0,2,2,7
401367735,Northern Illinois Huskies,B. Stonebraker,4705370,,False,4.0,1,3,1,3,0,0,0,0,0,0,0,0,0,0,0,0,2
401367735,Northern Illinois Huskies,E. Meinert,4705369,,False,15.0,2,4,2,4,0,0,0,0,1,1,2,0,1,0,0,0,4
401367735,Northern Illinois Huskies,L. Nickel,4900077,,False,3.0,0,0,0,0,0,0,0,0,0,1,1,0,0,0,0,0,0
401367735,Northern Illinois Huskies,M. Prewitt,4900078,,False,3.0,0,0,0,0,0,0,0,0,0,0,0,0,0,0,0,0,0
401367735,Northern Illinois Huskies,S. McCrea,4705367,,False,19.0,2,4,0,1,2,3,0,0,0,2,2,1,2,0,0,0,6
401367735,Northern Illinois Huskies,P. Castro,4069126,,False,12.0,0,3,0,1,0,2,0,0,0,1,1,0,0,0,1,0,0
401367735,Northern Illinois Huskies,TEAM,TOTAL,TOTAL,False,,25,55,22,44,3,11,3,7,5,24,29,11,5,0,11,8,56
401367734,Central Michigan Chippewas,J. Smith,4399313,,True,35.0,6,12,6,12,0,0,1,2,3,5,8,3,2,1,2,3,13
401367734,Central Michigan Chippewas,H. Knoll,4900027,,True,34.0,5,10,2,4,3,6,0,0,0,1,1,3,0,0,4,3,13
401367734,Central Michigan Chippewas,L. Tesson,4900026,,True,32.0,3,7,3,5,0,2,1,1,1,3,4,2,2,0,4,3,7
401367734,Central Michigan Chippewas,M. Davis,4595290,,True,36.0,7,16,5,10,2,6,1,2,1,4,5,5,2,0,2,1,17
401367734,Central Michigan Chippewas,A. Weekes,4399310,,True,38.0,6,10,2,4,4,6,0,0,1,11,12,1,0,0,1,5,16
401367734,Central Michigan Chippewas,R. Gordon,4900029,,False,5.0,0,0,0,0,0,0,0,0,0,0,0,0,0,0,0,1,0
401367734,Central Michigan Chippewas,T. Timpe,4900030,,False,17.0,1,6,0,0,1,6,0,0,0,0,0,0,0,1,0,1,3
401367734,Central Michigan Chippewas,K. Gordon,4900028,,False,3.0,0,2,0,2,0,0,0,0,0,1,1,0,0,0,1,0,0
401367734,Central Michigan Chippewas,TEAM,TOTAL,TOTAL,False,,28,63,18,37,10,26,3,5,9,26,35,14,6,2,16,17,69
401367734,Ball State Cardinals,M. Kiefer,4900612,,True,14.0,1,4,1,1,0,3,0,0,0,2,2,0,0,2,1,0,2
401367734,Ball State Cardinals,T. Dis Agustsdottir,4399285,,True,33.0,4,10,2,4,2,6,2,4,0,2,2,0,1,0,2,0,12
401367734,Ball State Cardinals,C. Latimer,4281480,,True,26.0,6,8,6,7,0,1,1,2,2,2,4,0,1,0,2,1,13
401367734,Ball State Cardinals,A. Becki,4900609,,True,38.0,5,11,2,3,3,8,0,0,1,9,10,9,1,0,2,2,13
401367734,Ball State Cardinals,S. Freeman,4595285,,True,36.0,3,8,1,3,2,5,1,2,0,3,3,7,0,2,1,0,9
401367734,Ball State Cardinals,A. Rauch,4595288,,False,26.0,8,12,8,12,0,0,8,11,4,5,9,1,1,1,1,2,24
401367734,Ball State Cardinals,I. Subirats,4705355,,False,9.0,0,1,0,1,0,0,2,2,0,1,1,0,1,0,0,0,2
401367734,Ball State Cardinals,E. Puiggros,4595287,,False,18.0,0,3,0,1,0,2,0,0,0,1,1,2,1,0,0,1,0
401367734,Ball State Cardinals,TEAM,TOTAL,TOTAL,False,,27,57,20,32,7,25,14,21,7,26,33,19,6,5,9,6,75
401367733,Ohio Bobcats,G. Burris,4282121,,True,37.0,5,12,0,5,5,7,0,2,2,6,8,1,2,2,2,1,15
401367733,Ohio Bobcats,E. Johnson,4282118,,True,35.0,6,15,5,8,1,7,0,0,0,5,5,4,1,0,4,1,13
401367733,Ohio Bobcats,M. Mace,4613137,,True,21.0,2,5,1,2,1,3,0,0,3,1,4,2,0,0,1,2,5
401367733,Ohio Bobcats,K. Bambule,4282120,,True,25.0,0,4,0,1,0,3,2,2,1,3,4,1,1,0,0,2,2
401367733,Ohio Bobcats,C. Hooks,4282117,,True,39.0,8,13,7,11,1,2,6,8,1,4,5,4,3,1,6,3,23
401367733,Ohio Bobcats,A. Antonova,4399349,,False,1.0,0,0,0,0,0,0,0,0,0,0,0,0,0,0,0,0,0
401367733,Ohio Bobcats,Y. Felder,4900084,,False,21.0,4,9,3,7,1,2,1,4,0,3,3,0,0,0,3,2,10
401367733,Ohio Bobcats,K. Dennis,4710736,,False,4.0,0,1,0,1,0,0,0,0,0,1,1,0,0,0,0,1,0
401367733,Ohio Bobcats,P. Guice,4433665,,False,16.0,2,5,1,2,1,3,0,0,0,1,1,1,1,0,0,2,5
401367733,Ohio Bobcats,H. Rogan,4399347,,False,1.0,0,0,0,0,0,0,0,0,0,0,0,0,0,0,0,0,0
401367733,Ohio Bobcats,TEAM,TOTAL,TOTAL,False,,27,64,17,37,10,27,9,16,13,28,41,13,8,3,16,14,73
401367733,Miami (OH) RedHawks,A. Freeman,4595269,,True,23.0,1,2,1,2,0,0,0,0,1,2,3,0,0,0,2,2,2
401367733,Miami (OH) RedHawks,I. Wolf,4900071,,True,38.0,5,16,4,11,1,5,5,6,0,5,5,3,3,0,4,3,16
401367733,Miami (OH) RedHawks,K. Davidson,4705364,,True,25.0,3,7,2,2,1,5,0,0,0,0,0,1,2,0,2,0,7
401367733,Miami (OH) RedHawks,E. Battle,4705362,,True,17.0,0,3,0,1,0,2,2,4,0,0,0,0,0,0,0,0,2
401367733,Miami (OH) RedHawks,P. Scott,4595268,,True,39.0,9,20,8,17,1,3,4,5,2,8,10,1,0,0,5,3,23
401367733,Miami (OH) RedHawks,T. Foster-Walker,4595908,,False,9.0,0,2,0,2,0,0,0,0,1,1,2,2,1,0,0,3,0
401367733,Miami (OH) RedHawks,J. Duckett,4705365,,False,8.0,1,4,1,4,0,0,0,0,1,2,3,0,0,0,5,1,2
401367733,Miami (OH) RedHawks,M. Cluse,4900070,,False,16.0,4,6,2,2,2,4,2,2,1,2,3,0,1,0,1,2,12
401367733,Miami (OH) RedHawks,S. Watkins,4705363,,False,3.0,0,0,0,0,0,0,0,0,0,1,1,0,0,0,0,1,0
401367733,Miami (OH) RedHawks,V. Garrelts,4399336,,False,22.0,0,0,0,0,0,0,0,0,1,1,2,4,1,0,0,4,0
401367733,Miami (OH) RedHawks,TEAM,TOTAL,TOTAL,False,,23,60,18,41,5,19,13,17,10,25,35,11,8,0,19,19,64
401367732,Kent State Golden Flashes,N. Blackford,4595260,,True,18.0,3,6,3,6,0,0,0,0,1,5,6,0,0,0,2,2,6
401367732,Kent State Golden Flashes,L. Thall,4399327,,True,36.0,9,13,5,6,4,7,0,1,1,3,4,4,0,2,6,3,22
401367732,Kent State Golden Flashes,K. Shumate,4433684,,True,28.0,1,4,1,2,0,2,0,0,0,3,3,2,1,0,3,1,2
401367732,Kent State Golden Flashes,H. Young,4399326,,True,24.0,4,9,3,8,1,1,1,2,2,2,4,0,0,0,3,1,10
401367732,Kent State Golden Flashes,M. Modkins,4399323,,True,14.0,0,2,0,1,0,1,2,2,0,3,3,1,0,1,2,2,2
401367732,Kent State Golden Flashes,B. Dunn,4900064,,False,25.0,3,6,1,1,2,5,0,0,0,4,4,2,4,1,0,1,8
401367732,Kent State Golden Flashes,J. Batsch,4900063,,False,3.0,0,0,0,0,0,0,0,0,0,0,0,0,0,0,1,0,0
401367732,Kent State Golden Flashes,C. Santoro,4704895,,False,28.0,2,8,2,5,0,3,2,3,1,1,2,4,0,0,2,4,6
401367732,Kent State Golden Flashes,C. Kelly,4595261,,False,24.0,2,9,2,3,0,6,0,0,1,3,4,3,0,0,0,2,4
401367732,Kent State Golden Flashes,TEAM,TOTAL,TOTAL,False,,24,57,17,32,7,25,5,8,9,26,35,16,5,4,19,16,60
401367732,Bowling Green Falcons,K. Hempfling,4399299,,True,14.0,1,3,1,1,0,2,0,0,1,0,1,1,1,0,2,2,2
401367732,Bowling Green Falcons,A. Velasco,4899612,,True,27.0,3,8,2,4,1,4,6,8,1,3,4,1,2,0,0,3,13
401367732,Bowling Green Falcons,K. Lewis,4704866,,True,29.0,0,3,0,2,0,1,0,0,0,3,3,3,1,0,1,2,0
401367732,Bowling Green Falcons,N. Hampton,4704864,,True,31.0,5,11,4,9,1,2,4,4,0,1,1,5,5,0,4,3,15
401367732,Bowling Green Falcons,E. Brett,4595223,,True,37.0,4,11,3,6,1,5,2,4,1,8,9,1,1,1,1,3,11
401367732,Bowling Green Falcons,S. Dziekan,4704863,,False,11.0,0,1,0,1,0,0,0,0,0,0,0,2,1,1,2,2,0
401367732,Bowling Green Falcons,J. Tate,4899613,,False,25.0,9,13,9,13,0,0,1,1,0,5,5,1,2,0,2,3,19
401367732,Bowling Green Falcons,M. Sharps,4595176,,False,12.0,1,2,0,0,1,2,0,0,0,1,1,0,0,0,0,0,3
401367732,Bowling Green Falcons,M. Parker,4282037,,False,14.0,2,3,0,0,2,3,0,0,0,1,1,0,0,0,0,0,6
401367732,Bowling Green Falcons,TEAM,TOTAL,TOTAL,False,,25,55,19,36,6,19,13,17,6,26,32,14,13,2,12,18,69
401367731,Buffalo Bulls,L. Christie,4595235,,True,25.0,5,9,5,9,0,0,0,0,1,1,2,0,1,0,0,3,10
401367731,Buffalo Bulls,S. Hemphill,4068803,,True,33.0,7,9,7,9,0,0,2,4,4,6,10,2,0,0,0,1,16
401367731,Buffalo Bulls,G. Woolley,4899639,,True,32.0,2,6,2,2,0,4,3,4,1,0,1,5,6,0,5,2,7
401367731,Buffalo Bulls,D. Camp,4704065,,True,22.0,1,4,1,4,0,0,0,0,1,3,4,2,2,0,3,1,2
401367731,Buffalo Bulls,D. Fair,4595236,,True,38.0,10,20,8,15,2,5,3,4,0,3,3,6,4,0,1,1,25
401367731,Buffalo Bulls,S. Wilson,4433553,,False,2.0,0,1,0,1,0,0,0,0,0,0,0,0,0,0,0,0,0
401367731,Buffalo Bulls,A. Adeyeye,4399304,,False,18.0,8,8,8,8,0,0,1,1,2,2,4,0,1,0,0,3,17
401367731,Buffalo Bulls,N. Jordan,4595728,,False,2.0,0,0,0,0,0,0,0,0,0,0,0,0,0,0,0,0,0
401367731,Buffalo Bulls,E. Gaba,4595238,,False,2.0,0,0,0,0,0,0,0,0,0,1,1,1,0,0,0,1,0
401367731,Buffalo Bulls,C. Valenti-Paea,4711744,,False,3.0,0,0,0,0,0,0,0,0,0,1,1,0,0,0,0,0,0
401367731,Buffalo Bulls,J. Young,4400441,,False,23.0,4,5,3,4,1,1,0,0,0,4,4,1,2,0,4,0,9
401367731,Buffalo Bulls,TEAM,TOTAL,TOTAL,False,,37,62,34,52,3,10,9,13,9,21,30,17,16,0,13,12,86
401367731,Akron Zips,R. Bass,4899611,,True,27.0,4,8,4,8,0,0,3,4,6,1,7,1,1,1,3,0,11
401367731,Akron Zips,L. Brewer,4595218,,True,23.0,1,1,1,1,0,0,0,0,2,4,6,1,0,0,5,3,2
401367731,Akron Zips,J. Dawson,4281369,,True,29.0,10,17,10,16,0,1,3,6,2,2,4,1,3,0,6,2,23
401367731,Akron Zips,A. Corcoran,4595282,,True,18.0,0,3,0,2,0,1,0,0,0,0,0,2,0,0,1,4,0
401367731,Akron Zips,L. Ferrell,4595221,,True,16.0,2,4,1,2,1,2,3,3,1,3,4,1,0,0,0,0,8
401367731,Akron Zips,C. Neitzel,4399282,,False,3.0,1,1,1,1,0,0,0,0,1,0,1,0,0,0,1,0,2
401367731,Akron Zips,M. Neitzel,4595220,,False,14.0,1,6,1,5,0,1,0,0,0,1,1,0,0,0,3,2,2
401367731,Akron Zips,Z. Rasheed,4899610,,False,15.0,1,3,0,0,1,3,0,0,1,0,1,0,2,0,5,0,3
401367731,Akron Zips,A. Stewart,4704835,,False,2.0,0,1,0,0,0,1,0,0,0,0,0,0,0,0,0,0,0
401367731,Akron Zips,Al. Carter,4704834,,False,13.0,1,1,1,1,0,0,0,0,0,0,0,3,1,0,0,2,2
401367731,Akron Zips,R. Martindale,4595219,,False,20.0,1,7,0,1,1,6,0,0,0,1,1,1,0,0,1,0,3
401367731,Akron Zips,E. Tecca,4595217,,False,3.0,0,3,0,1,0,2,0,0,0,0,0,0,0,0,0,0,0
401367731,Akron Zips,G. Brown-Mitchell,4399281,,False,0.0,0,1,0,0,0,1,0,0,0,0,0,0,0,0,0,0,0
401367731,Akron Zips,K. Miller,4399280,,False,17.0,2,3,2,3,0,0,0,0,0,3,3,0,3,0,1,0,4
401367731,Akron Zips,TEAM,TOTAL,TOTAL,False,,24,59,21,41,3,18,9,13,13,15,28,10,10,1,26,13,60
401367622,Northeastern Huskies,E. Calabrese,4281866,,True,32.0,7,10,7,10,0,0,3,3,2,4,6,0,0,0,4,3,17
401367622,Northeastern Huskies,C. Soriano,4899587,,True,36.0,2,8,2,4,0,4,3,6,1,2,3,5,2,1,1,2,7
401367622,Northeastern Huskies,G. Motema,4899585,,True,35.0,5,8,5,8,0,0,10,11,0,4,4,3,1,0,6,3,20
401367622,Northeastern Huskies,D. Ntambue,4600575,,True,16.0,0,0,0,0,0,0,0,0,1,5,6,0,0,0,5,5,0
401367622,Northeastern Huskies,K. May,4400228,,True,36.0,6,17,5,7,1,10,0,0,1,8,9,2,0,2,3,2,13
401367622,Northeastern Huskies,A. Parker,4899586,,False,12.0,1,2,1,2,0,0,1,1,1,2,3,1,1,0,2,2,3
401367622,Northeastern Huskies,L. Õztürk,4705029,,False,4.0,0,0,0,0,0,0,0,0,0,0,0,0,0,1,0,0,0
401367622,Northeastern Huskies,I. Larsen,4705028,,False,6.0,0,1,0,0,0,1,0,0,0,1,1,0,0,0,0,0,0
401367622,Northeastern Huskies,C. McCartney,4594735,,False,15.0,0,1,0,1,0,0,2,2,2,5,7,0,0,0,1,3,2
401367622,Northeastern Huskies,C. Clement,4899583,,False,8.0,1,5,1,2,0,3,0,0,0,2,2,0,1,0,1,0,2
401367622,Northeastern Huskies,TEAM,TOTAL,TOTAL,False,,22,52,21,34,1,18,19,23,9,35,44,11,5,4,23,20,64
401367622,Charleston Cougars,A. Eady,4399831,,True,31.0,4,11,4,11,0,0,2,2,4,7,11,1,1,1,2,5,10
401367622,Charleston Cougars,T. Collins,4399832,,True,31.0,4,11,1,5,3,6,11,12,0,0,0,1,1,0,1,3,22
401367622,Charleston Cougars,L. Perkins,4399830,,True,38.0,8,17,6,13,2,4,2,4,4,4,8,2,4,0,2,2,20
401367622,Charleston Cougars,M. Taylor,4399829,,True,20.0,1,5,1,3,0,2,0,0,0,2,2,2,0,0,0,3,2
401367622,Charleston Cougars,J. Annecchiarico,4399317,,True,38.0,3,14,2,10,1,4,4,6,2,5,7,8,2,0,3,3,11
401367622,Charleston Cougars,Z. McCrary,4433463,,False,9.0,0,1,0,1,0,0,0,0,0,1,1,0,0,0,0,1,0
401367622,Charleston Cougars,G. Abercrombie,4899572,,False,6.0,0,2,0,0,0,2,0,0,0,0,0,0,1,0,0,0,0
401367622,Charleston Cougars,A. McGarity,4704471,,False,27.0,3,9,1,1,2,8,0,0,2,0,2,0,3,0,2,2,8
401367622,Charleston Cougars,TEAM,TOTAL,TOTAL,False,,23,70,15,44,8,26,19,24,13,21,34,14,12,1,10,19,73
401367621,UNC Wilmington Seahawks,D. Carter,4281802,,True,22.0,2,4,2,4,0,0,2,4,0,7,7,1,0,1,3,2,6
401367621,UNC Wilmington Seahawks,M. Hoggatt,4281484,,True,31.0,1,3,1,3,0,0,1,2,4,3,7,1,0,0,4,3,3
401367621,UNC Wilmington Seahawks,R. Green,4399486,,True,20.0,3,6,2,4,1,2,1,2,1,1,2,2,1,0,3,1,8
401367621,UNC Wilmington Seahawks,A. Best,4282146,,True,17.0,2,4,1,1,1,3,0,0,0,1,1,1,0,0,0,3,5
401367621,UNC Wilmington Seahawks,S. DaCosta,4066581,,True,32.0,3,14,2,9,1,5,1,2,0,6,6,1,1,0,1,0,8
401367621,UNC Wilmington Seahawks,J. Sharp,4899590,,False,1.0,0,0,0,0,0,0,0,0,0,0,0,0,0,0,0,0,0
401367621,UNC Wilmington Seahawks,A. Henderson,4281098,,False,17.0,2,5,2,5,0,0,0,0,2,3,5,0,0,3,1,1,4
401367621,UNC Wilmington Seahawks,J. Gamble,4899588,,False,10.0,0,0,0,0,0,0,0,2,0,0,0,0,0,0,0,2,0
401367621,UNC Wilmington Seahawks,E. Miller,4705005,,False,1.0,0,0,0,0,0,0,0,0,0,0,0,0,0,0,0,0,0
401367621,UNC Wilmington Seahawks,M. McMillan,4705002,,False,20.0,2,2,0,0,2,2,0,0,0,1,1,2,1,0,5,1,6
401367621,UNC Wilmington Seahawks,C. Gross,4399427,,False,29.0,5,8,5,8,0,0,2,2,3,1,4,0,0,0,1,3,12
401367621,UNC Wilmington Seahawks,TEAM,TOTAL,TOTAL,False,,20,46,15,34,5,12,7,14,10,24,34,8,3,4,19,16,52
401367621,Hofstra Pride,J. Hines,4281440,,True,36.0,9,16,9,16,0,0,2,3,2,6,8,1,0,0,2,2,20
401367621,Hofstra Pride,J. Henry,4281212,,True,24.0,3,6,3,6,0,0,2,5,0,2,2,1,0,0,1,5,8
401367621,Hofstra Pride,S. Markisic,4433992,,True,19.0,3,6,1,3,2,3,1,2,0,0,0,0,0,0,0,0,9
401367621,Hofstra Pride,R. Nicholson,4399892,,True,37.0,4,7,3,5,1,2,2,3,3,4,7,6,2,0,0,1,11
401367621,Hofstra Pride,J. Knight,4398719,,True,27.0,3,7,2,4,1,3,4,8,0,3,3,4,3,0,4,3,11
401367621,Hofstra Pride,C. Reynolds,4399852,,False,5.0,0,0,0,0,0,0,0,0,0,0,0,0,1,0,2,3,0
401367621,Hofstra Pride,Z. Swint,4704976,,False,15.0,0,1,0,1,0,0,0,0,1,3,4,0,1,0,0,2,0
401367621,Hofstra Pride,M. Custis,4703651,,False,15.0,2,3,1,2,1,1,0,0,0,0,0,1,1,0,1,0,5
401367621,Hofstra Pride,S. Ineza,4594722,,False,17.0,1,5,0,1,1,4,0,0,0,1,1,0,0,0,0,0,3
401367621,Hofstra Pride,J. Peacock,4399031,,False,5.0,0,0,0,0,0,0,0,0,0,0,0,0,0,0,0,2,0
401367621,Hofstra Pride,TEAM,TOTAL,TOTAL,False,,25,51,19,38,6,13,11,21,7,19,26,13,8,0,11,18,67
401367620,William & Mary Tribe,D. McTeer,4899591,,True,16.0,1,4,1,4,0,0,0,0,1,3,4,0,0,0,1,3,2
401367620,William & Mary Tribe,B. Bellamy,4594744,,True,27.0,2,4,2,4,0,0,0,0,0,2,2,3,2,4,4,3,4
401367620,William & Mary Tribe,K. Sramac,4281413,,True,36.0,4,7,1,3,3,4,0,0,1,5,6,4,3,0,2,2,11
401367620,William & Mary Tribe,R. Casey,4281390,,True,38.0,5,14,3,8,2,6,0,0,1,1,2,2,0,0,2,2,12
401367620,William & Mary Tribe,S. Wagner,4281291,,True,40.0,4,18,3,11,1,7,2,3,0,5,5,5,1,0,2,1,11
401367620,William & Mary Tribe,K. Beckwith,4705064,,False,34.0,2,4,2,4,0,0,1,2,1,1,2,0,2,0,4,4,5
401367620,William & Mary Tribe,R. Montella,4899592,,False,9.0,0,1,0,0,0,1,0,0,1,0,1,0,0,0,1,1,0
401367620,William & Mary Tribe,TEAM,TOTAL,TOTAL,False,,18,52,12,34,6,18,3,5,7,18,25,14,8,4,17,16,45
401367620,Elon Phoenix,E. McGill,4400005,,True,21.0,6,9,6,9,0,0,1,4,1,6,7,0,2,0,1,3,13
401367620,Elon Phoenix,B. Perpignan,4399846,,True,35.0,3,7,3,6,0,1,6,6,0,3,3,5,0,0,6,3,12
401367620,Elon Phoenix,V. Taylor,4594719,,True,26.0,0,3,0,3,0,0,1,2,2,2,4,0,0,0,2,2,1
401367620,Elon Phoenix,K. Liles,4399847,,True,28.0,2,8,1,2,1,6,0,0,1,8,9,2,2,0,6,3,5
401367620,Elon Phoenix,A. Nance,4281438,,True,31.0,4,6,1,3,3,3,1,2,1,2,3,2,1,0,3,0,12
401367620,Elon Phoenix,A. James,4704635,,False,11.0,0,3,0,1,0,2,0,0,0,3,3,0,0,1,1,0,0
401367620,Elon Phoenix,M. Johnson,4594720,,False,10.0,1,3,1,3,0,0,0,0,1,0,1,0,0,2,0,0,2
401367620,Elon Phoenix,T. Traore,4399850,,False,13.0,0,2,0,2,0,0,2,2,0,0,0,0,0,0,0,1,2
401367620,Elon Phoenix,B. Harmon,4433666,,False,18.0,1,2,1,2,0,0,0,0,0,0,0,0,0,1,0,0,2
401367620,Elon Phoenix,P. Carter,4281922,,False,7.0,0,0,0,0,0,0,0,0,0,0,0,0,0,0,1,0,0
401367620,Elon Phoenix,TEAM,TOTAL,TOTAL,False,,17,43,13,31,4,12,11,16,9,27,36,9,5,4,21,12,49
401367619,Towson Tigers,R. Tucker,4594725,,True,25.0,0,4,0,4,0,0,2,2,1,4,5,1,0,1,1,4,2
401367619,Towson Tigers,N. Dodson,4705048,,True,4.0,0,2,0,1,0,1,0,0,0,0,0,0,0,1,0,1,0
401367619,Towson Tigers,T. Gary,4705049,,True,22.0,2,6,1,3,1,3,0,0,0,3,3,0,1,0,2,0,5
401367619,Towson Tigers,S. Williams,4705047,,True,30.0,3,7,0,3,3,4,7,8,0,7,7,1,0,0,2,4,16
401367619,Towson Tigers,A. Nelson,4433355,,True,36.0,3,11,1,6,2,5,2,4,0,1,1,6,2,0,2,3,10
401367619,Towson Tigers,A. Kubek,4705046,,False,22.0,3,6,3,5,0,1,6,10,1,2,3,2,1,0,1,2,12
401367619,Towson Tigers,A. Rivera,4433681,,False,29.0,9,12,7,7,2,5,2,2,2,6,8,2,2,0,1,2,22
401367619,Towson Tigers,R. Evans,4433397,,False,15.0,0,1,0,1,0,0,0,0,1,3,4,1,1,0,2,2,0
401367619,Towson Tigers,K. Kornegay-Lucas,4433095,,False,17.0,0,5,0,5,0,0,2,4,0,3,3,1,2,2,2,2,2
401367619,Towson Tigers,TEAM,TOTAL,TOTAL,False,,20,54,12,35,8,19,21,30,8,31,39,14,9,4,13,20,69
401367619,Drexel Dragons,K. Connolly,4399844,,True,21.0,1,4,0,2,1,2,2,2,1,1,2,0,0,1,0,4,5
401367619,Drexel Dragons,T. Brugler,4280995,,True,38.0,2,11,2,8,0,3,8,10,3,6,9,3,2,0,3,4,12
401367619,Drexel Dragons,M. Leonard,4068316,,True,27.0,4,8,4,8,0,0,0,0,2,5,7,0,1,0,2,3,8
401367619,Drexel Dragons,K. Washington,4399843,,True,35.0,7,20,6,16,1,4,1,2,2,3,5,3,0,0,4,4,16
401367619,Drexel Dragons,H. Nihill,4281431,,True,40.0,6,16,4,10,2,6,4,4,0,2,2,5,4,0,3,2,18
401367619,Drexel Dragons,J. Valentine,4704570,,False,10.0,0,1,0,1,0,0,0,0,0,2,2,0,0,1,0,1,0
401367619,Drexel Dragons,H. Saatman,4594714,,False,5.0,0,1,0,1,0,0,0,0,0,2,2,0,0,0,0,0,0
401367619,Drexel Dragons,M. Hendrixson,4399845,,False,18.0,1,2,1,1,0,1,0,0,0,2,2,0,0,0,1,5,2
401367619,Drexel Dragons,T. Hyduke,4399080,,False,6.0,0,0,0,0,0,0,0,0,0,0,0,1,1,0,0,0,0
401367619,Drexel Dragons,TEAM,TOTAL,TOTAL,False,,21,63,17,47,4,16,15,18,12,28,40,12,8,2,14,23,61
401367618,James Madison Dukes,A. Goodman,4704989,,True,21.0,3,5,3,5,0,0,3,4,4,1,5,1,1,0,0,4,9
401367618,James Madison Dukes,K. Jefferson,4594726,,True,28.0,6,13,4,8,2,5,6,9,1,2,3,1,1,0,3,2,20
401367618,James Madison Dukes,M. Green,4400081,,True,27.0,1,7,1,3,0,4,3,4,0,4,4,3,1,0,0,1,5
401367618,James Madison Dukes,J. Carodine,4400080,,True,33.0,3,4,3,3,0,1,2,4,4,13,17,1,0,0,1,3,8
401367618,James Madison Dukes,B. Tinsley,4281227,,True,30.0,4,12,1,6,3,6,3,4,0,0,0,3,2,0,4,3,14
401367618,James Madison Dukes,M. Tynes,4899576,,False,14.0,0,0,0,0,0,0,0,0,0,2,2,0,0,0,2,4,0
401367618,James Madison Dukes,S. Pittman,4899575,,False,3.0,0,0,0,0,0,0,0,0,0,0,0,1,0,0,0,0,0
401367618,James Madison Dukes,S. Ouderkirk,4704992,,False,21.0,3,8,2,6,1,2,0,0,0,3,3,1,0,0,1,4,7
401367618,James Madison Dukes,B. Williams,4704993,,False,3.0,0,0,0,0,0,0,0,0,0,0,0,0,0,0,0,0,0
401367618,James Madison Dukes,J. Hazell,4433460,,False,20.0,5,9,4,7,1,2,4,4,0,3,3,0,0,0,0,0,15
401367618,James Madison Dukes,TEAM,TOTAL,TOTAL,False,,25,58,18,38,7,20,21,29,10,34,44,11,5,0,12,21,78
401367618,Delaware Blue Hens,Ty Battle,4282255,,True,40.0,3,5,3,5,0,0,6,6,5,8,13,2,0,1,3,4,12
401367618,Delaware Blue Hens,L. Oleary,4281427,,True,27.0,1,3,1,3,0,0,1,2,1,3,4,0,0,0,1,3,3
401367618,Delaware Blue Hens,T. Skinner,4704510,,True,31.0,2,12,2,8,0,4,5,6,3,3,6,1,1,0,1,3,9
401367618,Delaware Blue Hens,J. Dickey,4399842,,True,39.0,9,30,9,27,0,3,3,3,7,5,12,1,1,0,2,4,21
401367618,Delaware Blue Hens,P. McBride,4399841,,True,34.0,2,10,2,9,0,1,4,5,0,3,3,6,2,0,2,1,8
401367618,Delaware Blue Hens,M. Pippin,4703429,,False,9.0,0,1,0,1,0,0,0,0,2,1,3,0,1,0,0,1,0
401367618,Delaware Blue Hens,M. Tejedor,4704513,,False,0.0,0,0,0,0,0,0,0,0,0,0,0,0,0,0,0,0,0
401367618,Delaware Blue Hens,T. Johnson,4704512,,False,9.0,0,2,0,1,0,1,0,0,0,0,0,0,0,0,0,2,0
401367618,Delaware Blue Hens,T. Cousins,4704511,,False,2.0,0,1,0,0,0,1,0,0,0,0,0,0,0,0,0,1,0
401367618,Delaware Blue Hens,J. Smalls,4400634,,False,9.0,3,9,0,0,3,9,0,0,1,0,1,0,0,0,0,2,9
401367618,Delaware Blue Hens,TEAM,TOTAL,TOTAL,False,,20,73,17,54,3,19,19,22,21,25,46,10,5,1,11,21,62
401367617,UNC Wilmington Seahawks,M. Hoggatt,4281484,,True,33.0,4,8,4,8,0,0,5,5,5,5,10,0,1,0,3,4,13
401367617,UNC Wilmington Seahawks,E. Miller,4705005,,True,17.0,0,2,0,1,0,1,1,2,1,0,1,0,0,0,1,1,1
401367617,UNC Wilmington Seahawks,R. Green,4399486,,True,19.0,2,6,2,5,0,1,1,2,0,2,2,4,0,0,1,1,5
401367617,UNC Wilmington Seahawks,C. Gross,4399427,,True,26.0,2,8,2,8,0,0,0,0,3,2,5,1,2,1,2,4,4
401367617,UNC Wilmington Seahawks,A. Best,4282146,,True,34.0,2,8,0,1,2,7,0,0,0,3,3,0,1,0,1,2,6
401367617,UNC Wilmington Seahawks,D. Carter,4281802,,False,7.0,0,0,0,0,0,0,0,0,0,1,1,1,0,0,3,2,0
401367617,UNC Wilmington Seahawks,A. Henderson,4281098,,False,0.0,0,1,0,1,0,0,0,0,0,0,0,0,0,0,0,0,0
401367617,UNC Wilmington Seahawks,J. Gamble,4899588,,False,12.0,3,3,3,3,0,0,0,2,0,1,1,1,0,0,1,2,6
401367617,UNC Wilmington Seahawks,M. McMillan,4705002,,False,26.0,1,4,0,2,1,2,1,2,0,1,1,2,1,0,1,3,4
401367617,UNC Wilmington Seahawks,S. DaCosta,4066581,,False,26.0,4,9,3,6,1,3,0,0,0,2,2,0,0,0,0,4,9
401367617,UNC Wilmington Seahawks,TEAM,TOTAL,TOTAL,False,,18,49,14,35,4,14,8,13,10,19,29,9,5,1,15,23,48
401367617,Northeastern Huskies,E. Calabrese,4281866,,True,25.0,3,4,3,4,0,0,1,2,3,5,8,1,0,0,0,3,7
401367617,Northeastern Huskies,C. Soriano,4899587,,True,30.0,4,13,2,7,2,6,4,4,4,2,6,7,4,0,1,2,14
401367617,Northeastern Huskies,G. Motema,4899585,,True,27.0,7,11,7,11,0,0,6,6,0,3,3,1,0,0,4,2,20
401367617,Northeastern Huskies,D. Ntambue,4600575,,True,29.0,0,8,0,8,0,0,0,0,5,2,7,1,0,0,3,1,0
401367617,Northeastern Huskies,K. May,4400228,,True,31.0,1,7,1,3,0,4,6,6,0,3,3,2,0,1,0,2,8
401367617,Northeastern Huskies,A. Parker,4899586,,False,3.0,0,0,0,0,0,0,0,0,0,0,0,0,0,0,0,2,0
401367617,Northeastern Huskies,L. Õztürk,4705029,,False,17.0,0,0,0,0,0,0,0,0,2,1,3,0,0,2,0,0,0
401367617,Northeastern Huskies,I. Larsen,4705028,,False,5.0,0,0,0,0,0,0,0,0,0,2,2,0,0,0,0,0,0
401367617,Northeastern Huskies,C. McCartney,4594735,,False,19.0,2,4,2,4,0,0,2,4,1,4,5,0,0,1,2,1,6
401367617,Northeastern Huskies,C. Clement,4899583,,False,13.0,3,6,1,2,2,4,0,0,0,0,0,1,0,0,1,0,8
401367617,Northeastern Huskies,A. Sapenter,4710685,,False,1.0,0,0,0,0,0,0,0,0,0,0,0,0,0,0,0,0,0
401367617,Northeastern Huskies,TEAM,TOTAL,TOTAL,False,,20,53,16,39,4,14,19,22,16,23,39,13,4,4,11,13,63
401367616,Hofstra Pride,J. Hines,4281440,,True,30.0,7,13,7,13,0,0,2,5,6,7,13,1,0,0,3,5,16
401367616,Hofstra Pride,J. Henry,4281212,,True,30.0,3,5,3,5,0,0,0,1,3,5,8,4,1,0,1,1,6
401367616,Hofstra Pride,S. Markisic,4433992,,True,22.0,1,6,1,2,0,4,0,0,0,0,0,0,1,0,1,1,2
401367616,Hofstra Pride,R. Nicholson,4399892,,True,23.0,1,5,1,5,0,0,0,0,1,1,2,1,0,0,6,1,2
401367616,Hofstra Pride,J. Knight,4398719,,True,31.0,0,9,0,7,0,2,0,0,1,7,8,1,2,0,6,3,0
401367616,Hofstra Pride,C. Reynolds,4399852,,False,5.0,1,4,1,4,0,0,0,0,1,0,1,0,0,0,0,1,2
401367616,Hofstra Pride,Z. Swint,4704976,,False,15.0,1,2,1,2,0,0,0,0,1,6,7,1,0,1,2,1,2
401367616,Hofstra Pride,M. Custis,4703651,,False,13.0,0,4,0,2,0,2,0,0,0,1,1,0,0,0,2,1,0
401367616,Hofstra Pride,S. Ineza,4594722,,False,22.0,2,7,1,2,1,5,0,0,0,1,1,0,0,0,1,0,5
401367616,Hofstra Pride,J. Peacock,4399031,,False,9.0,0,2,0,2,0,0,0,0,1,1,2,0,0,0,0,0,0
401367616,Hofstra Pride,TEAM,TOTAL,TOTAL,False,,16,57,15,44,1,13,2,6,16,32,48,8,4,1,24,14,35
401367616,Charleston Cougars,A. Eady,4399831,,True,23.0,4,10,4,10,0,0,0,2,0,5,5,0,2,4,2,2,8
401367616,Charleston Cougars,A. McGarity,4704471,,True,28.0,6,7,1,1,5,6,0,0,1,1,2,2,1,2,1,2,17
401367616,Charleston Cougars,L. Perkins,4399830,,True,31.0,6,12,6,8,0,4,0,0,1,3,4,3,3,0,1,1,12
401367616,Charleston Cougars,M. Taylor,4399829,,True,17.0,0,2,0,1,0,1,0,0,2,2,4,1,3,0,0,3,0
401367616,Charleston Cougars,J. Annecchiarico,4399317,,True,28.0,2,12,1,4,1,8,6,6,1,0,1,8,3,0,0,2,11
401367616,Charleston Cougars,Z. McCrary,4433463,,False,17.0,1,2,1,2,0,0,0,0,3,4,7,1,2,2,1,2,2
401367616,Charleston Cougars,B. McClure,4899573,,False,5.0,2,3,2,2,0,1,0,0,0,0,0,0,0,0,0,0,4
401367616,Charleston Cougars,G. Abercrombie,4899572,,False,18.0,1,7,1,3,0,4,0,0,2,2,4,0,0,0,0,1,2
401367616,Charleston Cougars,E. Pearson,4704469,,False,5.0,1,3,0,0,1,3,0,0,1,1,2,0,0,0,0,0,3
401367616,Charleston Cougars,N. Covington,4594709,,False,7.0,1,2,1,2,0,0,0,0,0,2,2,1,0,0,0,0,2
401367616,Charleston Cougars,T. Collins,4399832,,False,21.0,5,12,2,3,3,9,1,2,1,3,4,2,1,0,1,1,14
401367616,Charleston Cougars,TEAM,TOTAL,TOTAL,False,,29,72,19,36,10,36,7,10,14,27,41,18,15,8,7,14,75
401367615,James Madison Dukes,A. Goodman,4704989,,True,19.0,2,4,2,4,0,0,0,0,5,1,6,0,0,0,1,0,4
401367615,James Madison Dukes,K. Jefferson,4594726,,True,26.0,7,14,7,12,0,2,8,9,0,5,5,3,1,0,1,3,22
401367615,James Madison Dukes,M. Green,4400081,,True,33.0,3,9,2,3,1,6,0,0,0,2,2,1,1,0,0,1,7
401367615,James Madison Dukes,J. Carodine,4400080,,True,29.0,2,7,2,4,0,3,5,6,0,6,6,1,1,0,1,1,9
401367615,James Madison Dukes,B. Tinsley,4281227,,True,20.0,0,4,0,1,0,3,0,0,0,2,2,1,1,0,2,1,0
401367615,James Madison Dukes,M. Tynes,4899576,,False,22.0,2,5,2,5,0,0,2,2,3,0,3,0,0,0,2,1,6
401367615,James Madison Dukes,S. Pittman,4899575,,False,2.0,1,2,1,2,0,0,0,1,0,1,1,0,0,0,0,0,2
401367615,James Madison Dukes,S. Ouderkirk,4704992,,False,25.0,1,5,0,3,1,2,0,0,2,1,3,0,0,0,3,2,3
401367615,James Madison Dukes,B. Williams,4704993,,False,2.0,0,0,0,0,0,0,0,0,0,0,0,0,1,0,0,0,0
401367615,James Madison Dukes,J. Hazell,4433460,,False,22.0,2,6,2,6,0,0,3,4,0,1,1,1,2,0,1,0,7
401367615,James Madison Dukes,TEAM,TOTAL,TOTAL,False,,20,56,18,40,2,16,18,22,12,22,34,7,7,0,11,9,60
401367615,Drexel Dragons,K. Connolly,4399844,,True,30.0,5,7,0,0,5,7,0,0,1,5,6,1,2,0,3,1,15
401367615,Drexel Dragons,T. Brugler,4280995,,True,33.0,4,9,4,9,0,0,0,0,0,9,9,7,0,2,1,1,8
401367615,Drexel Dragons,M. Leonard,4068316,,True,14.0,1,2,1,2,0,0,0,2,0,1,1,0,0,0,0,4,2
401367615,Drexel Dragons,K. Washington,4399843,,True,33.0,7,13,4,6,3,7,0,0,0,1,1,7,2,0,2,2,17
401367615,Drexel Dragons,H. Nihill,4281431,,True,34.0,8,11,5,7,3,4,4,4,1,3,4,6,0,0,2,1,23
401367615,Drexel Dragons,S. Ba,4899568,,False,1.0,0,0,0,0,0,0,0,0,0,0,0,0,0,0,0,1,0
401367615,Drexel Dragons,J. Valentine,4704570,,False,18.0,2,4,2,4,0,0,0,1,0,0,0,1,1,0,0,2,4
401367615,Drexel Dragons,B. Borcky,4594717,,False,2.0,0,1,0,1,0,0,0,0,0,0,0,0,0,0,0,0,0
401367615,Drexel Dragons,H. Saatman,4594714,,False,8.0,1,1,1,1,0,0,0,0,0,1,1,0,0,0,0,1,2
401367615,Drexel Dragons,M. LaClair,4899567,,False,1.0,0,0,0,0,0,0,0,0,0,0,0,0,0,0,1,0,0
401367615,Drexel Dragons,E. Sweeney,4704568,,False,1.0,0,1,0,1,0,0,0,0,0,0,0,0,0,0,0,0,0
401367615,Drexel Dragons,M. Hendrixson,4399845,,False,13.0,1,2,1,1,0,1,0,0,0,1,1,0,0,0,0,2,2
401367615,Drexel Dragons,T. Hyduke,4399080,,False,12.0,3,5,2,2,1,3,0,0,0,1,1,1,1,0,0,0,7
401367615,Drexel Dragons,TEAM,TOTAL,TOTAL,False,,32,56,20,34,12,22,4,7,3,25,28,23,6,2,9,15,80
401367614,Towson Tigers,A. Kubek,4705046,,True,14.0,1,4,1,3,0,1,0,0,0,0,0,1,0,1,1,0,2
401367614,Towson Tigers,R. Tucker,4594725,,True,33.0,4,11,4,11,0,0,2,2,1,3,4,0,0,2,2,2,10
401367614,Towson Tigers,A. Rivera,4433681,,True,34.0,2,13,1,9,1,4,2,2,5,8,13,1,1,1,6,3,7
401367614,Towson Tigers,R. Evans,4433397,,True,15.0,0,1,0,1,0,0,0,0,0,3,3,1,1,0,2,0,0
401367614,Towson Tigers,A. Nelson,4433355,,True,37.0,6,16,5,9,1,7,6,6,0,5,5,5,0,0,1,0,19
401367614,Towson Tigers,N. Dodson,4705048,,False,5.0,0,0,0,0,0,0,0,0,1,0,1,0,0,0,2,1,0
401367614,Towson Tigers,T. Gary,4705049,,False,26.0,7,10,2,3,5,7,3,6,3,4,7,2,1,0,2,0,22
401367614,Towson Tigers,S. Williams,4705047,,False,23.0,5,14,5,13,0,1,1,1,2,1,3,1,1,0,1,1,11
401367614,Towson Tigers,K. Kornegay-Lucas,4433095,,False,13.0,0,4,0,4,0,0,0,0,3,2,5,1,0,1,2,1,0
401367614,Towson Tigers,TEAM,TOTAL,TOTAL,False,,25,73,18,53,7,20,14,17,17,28,45,12,4,5,19,8,71
401367614,Delaware Blue Hens,Ty Battle,4282255,,True,36.0,8,15,8,15,0,0,2,2,10,14,24,2,3,0,4,1,18
401367614,Delaware Blue Hens,L. Oleary,4281427,,True,30.0,3,7,3,7,0,0,0,0,2,2,4,2,0,0,2,4,6
401367614,Delaware Blue Hens,T. Skinner,4704510,,True,40.0,10,19,5,12,5,7,0,0,0,2,2,5,1,0,2,0,25
401367614,Delaware Blue Hens,J. Dickey,4399842,,True,25.0,9,20,7,15,2,5,3,3,1,5,6,1,4,1,1,4,23
401367614,Delaware Blue Hens,P. McBride,4399841,,True,17.0,3,7,3,5,0,2,0,0,0,2,2,4,1,0,1,4,6
401367614,Delaware Blue Hens,M. Pippin,4703429,,False,14.0,1,5,1,4,0,1,1,2,2,0,2,0,0,1,1,1,3
401367614,Delaware Blue Hens,T. Johnson,4704512,,False,18.0,2,4,2,4,0,0,0,0,1,3,4,0,0,0,1,2,4
401367614,Delaware Blue Hens,T. Cousins,4704511,,False,8.0,0,1,0,0,0,1,0,0,0,1,1,0,0,0,2,1,0
401367614,Delaware Blue Hens,J. Smalls,4400634,,False,12.0,0,3,0,0,0,3,0,0,0,0,0,0,0,0,0,0,0
401367614,Delaware Blue Hens,TEAM,TOTAL,TOTAL,False,,36,81,29,62,7,19,6,7,18,30,48,14,9,2,15,17,85
401364708,Wyoming Cowgirls,A. Fertig,4900606,,True,19.0,0,3,0,3,0,0,0,0,1,4,5,0,0,1,2,0,0
401364708,Wyoming Cowgirls,M. Bradshaw,4595681,,True,43.0,4,13,2,9,2,4,5,9,0,2,2,4,0,1,2,0,15
401364708,Wyoming Cowgirls,Q. Weidemann,4400207,,True,43.0,4,10,1,2,3,8,4,4,1,5,6,2,0,0,1,1,15
401364708,Wyoming Cowgirls,A. Sanchez Ramos,4400204,,True,41.0,4,8,4,6,0,2,2,2,4,7,11,7,1,1,1,1,10
401364708,Wyoming Cowgirls,T. Olson,4400203,,True,36.0,6,13,1,3,5,10,0,0,3,2,5,3,1,0,0,2,17
401364708,Wyoming Cowgirls,M. Savic,4704660,,False,2.0,0,1,0,1,0,0,0,0,0,0,0,0,0,0,0,1,0
401364708,Wyoming Cowgirls,G. Ellis,4704657,,False,25.0,3,7,3,5,0,2,0,1,1,10,11,1,1,0,0,1,6
401364708,Wyoming Cowgirls,E. Mellema,4900607,,False,12.0,2,7,0,2,2,5,0,0,0,1,1,1,0,1,1,3,6
401364708,Wyoming Cowgirls,T. Barnes,4900605,,False,4.0,0,0,0,0,0,0,0,0,0,1,1,0,0,0,0,0,0
401364708,Wyoming Cowgirls,TEAM,TOTAL,TOTAL,False,,23,62,11,31,12,31,11,16,11,32,43,18,3,4,8,9,69
401364708,Colorado State Rams,K. Kinzer,4595630,,True,42.0,1,3,0,0,1,3,2,2,0,8,8,1,0,3,2,3,5
401364708,Colorado State Rams,K. Murphy,4068969,,True,35.0,8,15,8,15,0,0,2,2,2,5,7,1,0,0,0,1,18
401364708,Colorado State Rams,S. Mech,4399658,,True,33.0,4,6,3,5,1,1,0,0,0,6,6,0,0,1,0,5,9
401364708,Colorado State Rams,M. Hofschild,4595160,,True,43.0,9,16,7,13,2,3,2,3,0,2,2,5,1,0,2,1,22
401364708,Colorado State Rams,U. Atosu,4594809,,True,40.0,2,9,2,5,0,4,2,4,0,1,1,1,2,0,3,3,6
401364708,Colorado State Rams,C. Gomez,4899769,,False,3.0,0,0,0,0,0,0,0,0,0,1,1,0,0,0,0,0,0
401364708,Colorado State Rams,C. Clark,4704464,,False,10.0,1,4,0,1,1,3,0,0,0,0,0,0,1,0,1,2,3
401364708,Colorado State Rams,A. Prim,4899770,,False,2.0,0,0,0,0,0,0,0,0,0,1,1,0,0,0,0,0,0
401364708,Colorado State Rams,P. Farkas,4704463,,False,17.0,0,3,0,1,0,2,0,0,0,5,5,1,0,0,1,0,0
401364708,Colorado State Rams,TEAM,TOTAL,TOTAL,False,,25,56,20,40,5,16,8,11,2,31,33,9,4,4,10,15,63
401364707,San Diego State Aztecs,M. Adams,4400169,,True,28.0,0,1,0,0,0,1,0,0,0,2,2,0,1,0,2,1,0
401364707,San Diego State Aztecs,K. Pepe,4691705,,True,9.0,1,1,1,1,0,0,0,0,1,2,3,0,0,0,0,3,2
401364707,San Diego State Aztecs,A. Avinger,4433748,,True,33.0,4,14,4,12,0,2,5,5,1,3,4,3,1,0,1,2,13
401364707,San Diego State Aztecs,S. Ramos,4400168,,True,36.0,6,18,4,13,2,5,2,2,1,8,9,2,1,0,1,2,16
401364707,San Diego State Aztecs,M. Staples,4398925,,True,31.0,2,11,1,8,1,3,0,0,1,0,1,2,1,0,0,1,5
401364707,San Diego State Aztecs,K. Gipson,4704563,,False,17.0,0,0,0,0,0,0,0,0,1,0,1,0,0,0,1,2,0
401364707,San Diego State Aztecs,K. Villalobos,4704565,,False,17.0,3,5,3,5,0,0,2,3,1,5,6,0,1,1,4,4,8
401364707,San Diego State Aztecs,F. Vinerte,4704564,,False,4.0,0,1,0,1,0,0,2,2,0,0,0,0,0,0,0,1,2
401364707,San Diego State Aztecs,K. Edwards,4281879,,False,7.0,0,1,0,1,0,0,0,0,1,1,2,0,0,0,0,0,0
401364707,San Diego State Aztecs,I. Hernandez,4595647,,False,7.0,0,1,0,0,0,1,0,0,0,0,0,0,0,0,1,0,0
401364707,San Diego State Aztecs,M. Fiso,4433986,,False,3.0,0,0,0,0,0,0,0,0,1,0,1,0,0,0,0,1,0
401364707,San Diego State Aztecs,A. Crain,4399223,,False,8.0,0,2,0,2,0,0,0,0,0,0,0,0,0,0,0,1,0
401364707,San Diego State Aztecs,TEAM,TOTAL,TOTAL,False,,16,55,13,43,3,12,11,12,8,23,31,7,5,1,11,18,46
401364707,Air Force Falcons,R. Snyder,4399409,,True,34.0,5,11,2,7,3,4,3,4,0,1,1,3,0,0,0,3,16
401364707,Air Force Falcons,H. Jones,4399403,,True,24.0,2,9,2,8,0,1,5,8,8,7,15,1,1,1,0,2,9
401364707,Air Force Falcons,J. Huntimer,4899763,,True,31.0,1,2,0,0,1,2,0,0,1,7,8,4,0,0,2,0,3
401364707,Air Force Falcons,K. Heath,4595614,,True,24.0,3,10,3,10,0,0,0,0,0,3,3,1,1,0,1,3,6
401364707,Air Force Falcons,C. Winters,4399406,,True,19.0,1,4,1,2,0,2,6,8,0,1,1,0,2,0,2,4,8
401364707,Air Force Falcons,S. Mazzilli,4899762,,False,2.0,0,0,0,0,0,0,0,0,0,1,1,0,0,0,0,0,0
401364707,Air Force Falcons,D. MacMillan,4704414,,False,3.0,1,1,1,1,0,0,0,0,1,0,1,0,0,0,0,0,2
401364707,Air Force Falcons,N. McDonald,4595618,,False,16.0,1,2,1,1,0,1,0,0,0,4,4,2,0,0,0,1,2
401364707,Air Force Falcons,L. McDonald,4899761,,False,22.0,6,8,3,4,3,4,1,2,0,4,4,2,2,0,1,4,16
401364707,Air Force Falcons,M. Smith,4899759,,False,3.0,0,0,0,0,0,0,0,0,0,0,0,0,0,0,0,0,0
401364707,Air Force Falcons,K. Pilson,4704411,,False,11.0,2,4,2,3,0,1,0,0,0,1,1,0,1,0,0,1,4
401364707,Air Force Falcons,B. Autrey-Thompson,4399404,,False,11.0,2,4,2,4,0,0,0,0,0,0,0,1,0,0,2,0,4
401364707,Air Force Falcons,TEAM,TOTAL,TOTAL,False,,24,55,17,40,7,15,15,22,13,31,44,14,7,1,9,18,70
401364706,UNLV Lady Rebels,K. Rooks,4282188,,True,29.0,2,4,2,3,0,1,0,0,0,5,5,8,0,0,0,1,4
401364706,UNLV Lady Rebels,D. Young,4704625,,True,32.0,7,11,7,11,0,0,0,1,2,5,7,1,1,2,3,1,14
401364706,UNLV Lady Rebels,A. Durazo-Frescas,4683009,,True,35.0,5,7,1,1,4,6,0,0,0,1,1,1,0,0,0,4,14
401364706,UNLV Lady Rebels,J. Ethridge,4400144,,True,26.0,4,9,2,3,2,6,0,0,0,0,0,0,0,0,2,1,10
401364706,UNLV Lady Rebels,E. Booker,4400133,,True,35.0,2,10,1,8,1,2,6,8,0,3,3,3,3,0,3,1,11
401364706,UNLV Lady Rebels,N. Obiazor,4705419,,False,18.0,3,10,3,10,0,0,1,2,6,3,9,0,1,0,2,3,7
401364706,UNLV Lady Rebels,K. Jackson,4900597,,False,21.0,2,5,2,4,0,1,0,0,1,1,2,2,2,0,3,1,4
401364706,UNLV Lady Rebels,K. Winfrey,4900596,,False,3.0,0,1,0,0,0,1,0,0,0,0,0,0,0,0,0,0,0
401364706,UNLV Lady Rebels,J. Thomas,4704624,,False,1.0,0,0,0,0,0,0,0,0,0,0,0,1,0,0,0,0,0
401364706,UNLV Lady Rebels,TEAM,TOTAL,TOTAL,False,,25,57,18,40,7,17,7,11,11,19,30,16,7,2,13,12,64
401364706,Nevada Wolf Pack,L. Givens,4704506,,True,28.0,2,8,2,8,0,0,2,2,5,3,8,0,1,0,1,4,6
401364706,Nevada Wolf Pack,A. Jimenez,4595635,,True,11.0,0,1,0,1,0,0,0,0,0,0,0,3,0,0,1,0,0
401364706,Nevada Wolf Pack,A. West,4400134,,True,18.0,4,11,4,8,0,3,2,2,0,2,2,0,0,0,2,0,10
401364706,Nevada Wolf Pack,D. Hamilton,4400132,,True,33.0,4,13,4,12,0,1,0,1,2,4,6,5,0,0,2,0,8
401364706,Nevada Wolf Pack,K. Jimenez,4281683,,True,34.0,4,7,4,5,0,2,4,4,3,5,8,3,5,0,1,1,12
401364706,Nevada Wolf Pack,N. Lathrop,4900576,,False,12.0,1,1,1,1,0,0,0,0,1,1,2,0,0,0,0,0,2
401364706,Nevada Wolf Pack,K. Borden,4900574,,False,14.0,1,1,0,0,1,1,0,0,0,1,1,0,0,0,2,2,3
401364706,Nevada Wolf Pack,A. Roden,4900573,,False,8.0,0,2,0,1,0,1,0,0,1,1,2,0,0,0,1,1,0
401364706,Nevada Wolf Pack,K. Holt,4704503,,False,20.0,2,2,2,2,0,0,0,0,0,0,0,1,1,0,1,4,4
401364706,Nevada Wolf Pack,N. Alexander,4068433,,False,22.0,11,17,10,14,1,3,3,4,2,6,8,1,0,0,0,0,26
401364706,Nevada Wolf Pack,TEAM,TOTAL,TOTAL,False,,29,63,27,52,2,11,11,13,16,24,40,13,7,0,12,12,71
401364705,Utah State Aggies,T. Franson,4281892,,True,11.0,2,2,2,2,0,0,0,0,0,2,2,0,1,0,1,0,4
401364705,Utah State Aggies,E. Stafford,4400222,,True,31.0,5,9,4,8,1,1,6,10,3,7,10,3,3,2,1,0,17
401364705,Utah State Aggies,K. Randhawa,4400486,,True,41.0,3,8,2,4,1,4,9,10,1,8,9,5,2,1,1,3,16
401364705,Utah State Aggies,S. Latone,4399209,,True,37.0,6,16,4,7,2,9,0,1,2,2,4,2,2,0,6,3,14
401364705,Utah State Aggies,E. Harris,4281891,,True,38.0,1,6,0,0,1,6,4,4,0,1,1,7,0,0,2,3,7
401364705,Utah State Aggies,L. Hawthorne,4282342,,False,14.0,2,3,2,3,0,0,1,2,3,3,6,1,0,1,1,3,5
401364705,Utah State Aggies,A. Quezada,4595256,,False,34.0,10,17,9,15,1,2,1,1,2,4,6,4,0,0,2,1,22
401364705,Utah State Aggies,M. Mensah,4705051,,False,11.0,2,4,1,1,1,3,0,0,0,1,1,2,0,0,1,0,5
401364705,Utah State Aggies,K. Falslev,4704648,,False,8.0,2,5,0,0,2,5,0,0,0,0,0,0,0,0,0,1,6
401364705,Utah State Aggies,TEAM,TOTAL,TOTAL,False,,33,70,24,40,9,30,21,28,12,30,42,24,8,4,15,14,96
401364705,Fresno State Bulldogs,W. Motta,4595631,,True,35.0,5,11,5,11,0,0,1,2,4,7,11,0,0,0,0,4,11
401364705,Fresno State Bulldogs,I. Lacy,4400136,,True,28.0,4,7,3,6,1,1,2,2,0,2,2,0,2,0,3,1,11
401364705,Fresno State Bulldogs,A. Book,4400031,,True,30.0,3,9,2,4,1,5,1,1,0,4,4,0,1,0,2,4,8
401364705,Fresno State Bulldogs,Hal. Cavinder,4433658,,True,44.0,12,23,11,19,1,4,2,3,1,6,7,5,3,0,4,1,27
401364705,Fresno State Bulldogs,Han. Cavinder,4433372,,True,45.0,9,16,7,12,2,4,0,0,1,2,3,7,5,0,3,2,20
401364705,Fresno State Bulldogs,T. Stricklin,4900571,,False,14.0,1,2,0,0,1,2,0,0,1,4,5,0,0,0,1,3,3
401364705,Fresno State Bulldogs,S. Dethman,4900569,,False,0.0,0,0,0,0,0,0,0,0,0,0,0,0,0,0,1,0,0
401364705,Fresno State Bulldogs,J. Peterson,4900570,,False,11.0,3,3,3,3,0,0,0,1,1,1,2,1,0,0,2,2,6
401364705,Fresno State Bulldogs,D. Dunn,4433511,,False,18.0,1,3,0,0,1,3,1,2,0,1,1,1,0,0,2,0,4
401364705,Fresno State Bulldogs,TEAM,TOTAL,TOTAL,False,,38,74,31,55,7,19,7,11,9,28,37,14,11,0,18,17,90
