game_id,team,player,player_id,position,starter,min,fgm,fga,2pm,2pa,3pm,3pa,ftm,fta,oreb,dreb,reb,ast,stl,blk,to,pf,pts
401027723,West Virginia Mountaineers,K. King,4068207,,True,15.0,2,2,2,2,0,0,0,0,1,0,1,0,1,0,0,3,4
401027723,West Virginia Mountaineers,T. Muldrow,3066473,,True,38.0,9,12,8,10,1,2,14,15,2,5,7,1,2,1,1,2,33
401027723,West Virginia Mountaineers,N. Davenport,4281328,,True,36.0,6,14,6,10,0,4,0,1,0,5,5,1,3,2,4,2,12
401027723,West Virginia Mountaineers,K. Pardee,3910737,,True,35.0,6,10,3,7,3,3,0,0,1,3,4,4,2,0,2,4,15
401027723,West Virginia Mountaineers,C. Ray,3142021,,True,36.0,2,8,0,3,2,5,2,2,1,4,5,8,3,0,3,1,8
401027723,West Virginia Mountaineers,D. Harden,4281329,,False,9.0,0,2,0,2,0,0,0,0,0,0,0,0,0,0,1,1,0
401027723,West Virginia Mountaineers,T. Ekhelar,3906936,,False,18.0,0,1,0,1,0,0,1,2,1,2,3,0,0,2,0,2,1
401027723,West Virginia Mountaineers,A. Jones,4281330,,False,12.0,1,2,1,1,0,1,1,2,0,3,3,2,0,0,1,1,3
401027723,West Virginia Mountaineers,N. Staples,4068209,,False,1.0,0,0,0,0,0,0,0,0,0,0,0,0,0,0,0,0,0
401027723,West Virginia Mountaineers,TEAM,TOTAL,TOTAL,False,,26,51,20,36,6,15,18,22,8,25,33,16,11,5,12,16,76
401027723,St. John's Red Storm,M. Singleton,4068158,,True,38.0,6,14,6,14,0,0,1,1,6,1,7,2,3,1,1,3,13
401027723,St. John's Red Storm,I. Littleton,3142306,,True,31.0,1,2,1,2,0,0,1,2,2,5,7,2,1,1,0,2,3
401027723,St. John's Red Storm,A. Wellere,3906771,,True,38.0,8,13,6,8,2,5,5,8,2,4,6,3,4,1,6,4,23
401027723,St. John's Red Storm,T. England,4068155,,True,25.0,2,9,2,9,0,0,0,0,0,2,2,2,0,0,2,2,4
401027723,St. John's Red Storm,A. Kebbe,4068154,,True,26.0,2,8,1,3,1,5,0,0,0,1,1,0,0,0,4,3,5
401027723,St. John's Red Storm,K. Charles,4281374,,False,6.0,0,1,0,1,0,0,0,0,1,1,2,0,0,0,0,0,0
401027723,St. John's Red Storm,Q. Hoppie,4281375,,False,15.0,0,3,0,2,0,1,2,4,2,1,3,3,0,0,1,1,2
401027723,St. John's Red Storm,A. Adams,4068157,,False,17.0,4,10,0,5,4,5,0,0,1,1,2,0,1,0,1,1,12
401027723,St. John's Red Storm,S. Duncan,4068156,,False,4.0,0,1,0,0,0,1,0,0,0,0,0,0,0,0,0,2,0
401027723,St. John's Red Storm,TEAM,TOTAL,TOTAL,False,,23,61,16,44,7,17,9,15,16,18,34,12,9,3,15,18,62
401027091,St. John's Red Storm,M. Singleton,4068158,,True,34.0,4,8,4,8,0,0,3,6,4,9,13,1,0,1,4,3,11
401027091,St. John's Red Storm,I. Littleton,3142306,,True,39.0,3,6,3,6,0,0,1,5,5,6,11,1,1,5,1,1,7
401027091,St. John's Red Storm,A. Wellere,3906771,,True,32.0,5,8,1,2,4,6,3,4,0,3,3,1,1,0,2,1,17
401027091,St. John's Red Storm,T. England,4068155,,True,36.0,3,9,3,8,0,1,3,4,0,3,3,7,2,0,2,3,9
401027091,St. John's Red Storm,A. Kebbe,4068154,,True,29.0,5,11,4,8,1,3,5,6,1,2,3,0,3,0,1,3,16
401027091,St. John's Red Storm,K. Charles,4281374,,False,2.0,0,0,0,0,0,0,0,0,0,0,0,0,0,0,0,1,0
401027091,St. John's Red Storm,Q. Hoppie,4281375,,False,12.0,0,4,0,3,0,1,0,0,0,0,0,1,0,0,1,1,0
401027091,St. John's Red Storm,A. Adams,4068157,,False,15.0,2,6,1,4,1,2,0,0,0,0,0,1,0,0,2,1,5
401027091,St. John's Red Storm,S. Duncan,4068156,,False,1.0,0,0,0,0,0,0,0,0,0,0,0,0,0,0,0,0,0
401027091,St. John's Red Storm,TEAM,TOTAL,TOTAL,False,,22,52,16,39,6,13,15,25,11,25,36,12,7,6,14,14,65
401027091,Duquesne Dukes,K. Lass,3906440,,True,28.0,4,12,2,9,2,3,0,0,1,4,5,2,2,2,1,4,10
401027091,Duquesne Dukes,P. Cannon,3906436,,True,13.0,0,1,0,1,0,0,0,0,0,0,0,0,0,0,2,4,0
401027091,Duquesne Dukes,J. Vojinovic,4068404,,True,17.0,2,7,1,4,1,3,2,2,0,0,0,0,0,0,1,2,7
401027091,Duquesne Dukes,C. Richardson,3906439,,True,18.0,1,3,1,2,0,1,1,2,0,1,1,0,1,0,3,5,3
401027091,Duquesne Dukes,C. Omogrosso,3906435,,True,37.0,5,11,4,8,1,3,3,3,0,0,0,2,0,0,3,2,14
401027091,Duquesne Dukes,H. Tulonen,4281466,,False,11.0,0,0,0,0,0,0,0,0,0,1,1,0,0,0,2,0,0
401027091,Duquesne Dukes,E. Kuttor,3906438,,False,15.0,1,2,1,1,0,1,0,0,0,6,6,0,0,0,1,1,2
401027091,Duquesne Dukes,J. Sole,3067615,,False,12.0,3,3,3,3,0,0,0,4,0,3,3,0,0,0,1,1,6
401027091,Duquesne Dukes,A. Kalin,4281467,,False,22.0,1,2,1,2,0,0,0,0,1,4,5,2,1,0,2,2,2
401027091,Duquesne Dukes,L. Bazelak,4281465,,False,26.0,2,4,2,2,0,2,4,6,1,4,5,2,2,0,1,3,8
401027091,Duquesne Dukes,K. Elliott,4068405,,False,1.0,0,0,0,0,0,0,0,0,0,0,0,0,0,0,1,1,0
401027091,Duquesne Dukes,TEAM,TOTAL,TOTAL,False,,19,45,15,32,4,13,10,17,4,24,28,8,6,2,18,25,52
401026906,St. John's Red Storm,M. Singleton,4068158,,True,24.0,2,6,2,6,0,0,3,4,2,7,9,1,1,0,2,5,7
401026906,St. John's Red Storm,I. Littleton,3142306,,True,37.0,1,2,1,2,0,0,2,2,3,4,7,0,1,2,1,4,4
401026906,St. John's Red Storm,A. Wellere,3906771,,True,32.0,3,10,1,5,2,5,2,2,1,0,1,2,2,0,0,2,10
401026906,St. John's Red Storm,T. England,4068155,,True,36.0,2,6,2,4,0,2,2,2,0,5,5,2,1,0,6,0,6
401026906,St. John's Red Storm,A. Kebbe,4068154,,True,25.0,3,11,2,4,1,7,1,2,1,1,2,0,1,1,2,1,8
401026906,St. John's Red Storm,K. Charles,4281374,,False,5.0,0,0,0,0,0,0,0,0,0,2,2,0,0,0,0,0,0
401026906,St. John's Red Storm,Q. Hoppie,4281375,,False,22.0,4,5,3,3,1,2,3,4,0,1,1,1,2,0,1,0,12
401026906,St. John's Red Storm,A. Adams,4068157,,False,16.0,3,7,3,5,0,2,0,0,0,0,0,1,0,0,0,1,6
401026906,St. John's Red Storm,S. Duncan,4068156,,False,3.0,0,1,0,0,0,1,0,0,0,0,0,0,0,0,0,0,0
401026906,St. John's Red Storm,TEAM,TOTAL,TOTAL,False,,18,48,14,29,4,19,13,16,11,22,33,7,8,3,12,13,53
401026906,Pennsylvania Quakers,E. Parker,4281388,,True,30.0,7,14,7,14,0,0,1,4,5,6,11,0,0,3,1,2,15
401026906,Pennsylvania Quakers,M. Nwokedi,3142607,,True,34.0,4,6,4,6,0,0,2,4,3,5,8,3,2,0,6,2,10
401026906,Pennsylvania Quakers,A. Russell,3944326,,True,23.0,0,2,0,1,0,1,1,2,1,2,3,2,1,0,0,2,1
401026906,Pennsylvania Quakers,L. Whitlatch,3142606,,True,33.0,5,10,0,0,5,10,0,0,0,3,3,1,0,0,1,3,15
401026906,Pennsylvania Quakers,A. Ross,3142604,,True,36.0,2,9,1,8,1,1,0,0,1,1,2,3,2,1,5,2,5
401026906,Pennsylvania Quakers,T. Crawford,4281384,,False,6.0,0,1,0,0,0,1,0,0,0,0,0,0,0,0,2,2,0
401026906,Pennsylvania Quakers,P. Aghayere,3944329,,False,9.0,0,3,0,2,0,1,0,0,1,3,4,0,1,0,1,1,0
401026906,Pennsylvania Quakers,K. Kinum,4281387,,False,12.0,1,3,1,2,0,1,0,0,0,0,0,0,0,0,1,0,2
401026906,Pennsylvania Quakers,P. Sterba,4068597,,False,3.0,0,0,0,0,0,0,0,0,0,0,0,0,0,0,0,0,0
401026906,Pennsylvania Quakers,K. Grasela,4068595,,False,8.0,0,0,0,0,0,0,0,0,0,0,0,1,0,0,0,0,0
401026906,Pennsylvania Quakers,B. Brzozowski,3142605,,False,6.0,0,1,0,1,0,0,0,0,0,0,0,0,0,0,0,0,0
401026906,Pennsylvania Quakers,TEAM,TOTAL,TOTAL,False,,19,49,13,34,6,15,4,10,13,20,33,10,6,4,17,14,48
401026905,Georgetown Hoyas,C. Petke,4068078,,True,40.0,9,22,7,15,2,7,4,6,5,5,10,0,2,0,2,0,24
401026905,Georgetown Hoyas,M. Smith,4068079,,True,35.0,1,8,1,8,0,0,0,2,5,6,11,0,1,0,3,2,2
401026905,Georgetown Hoyas,Y. Belk,3142295,,True,35.0,2,6,2,6,0,0,1,1,4,2,6,0,1,3,0,0,5
401026905,Georgetown Hoyas,D. White,3948815,,True,40.0,10,26,8,19,2,7,11,13,2,9,11,4,4,1,1,3,33
401026905,Georgetown Hoyas,D. Burton,3142292,,True,40.0,0,3,0,2,0,1,0,0,0,3,3,7,0,0,3,2,0
401026905,Georgetown Hoyas,T. Thompson,4281352,,False,10.0,1,3,1,2,0,1,0,0,0,0,0,0,0,0,1,1,2
401026905,Georgetown Hoyas,TEAM,TOTAL,TOTAL,False,,23,68,19,52,4,16,16,22,16,27,43,11,8,4,10,8,66
401026905,Duquesne Dukes,K. Lass,3906440,,True,32.0,6,10,4,7,2,3,0,0,0,4,4,1,1,1,1,2,14
401026905,Duquesne Dukes,P. Cannon,3906436,,True,27.0,1,6,1,4,0,2,0,0,0,8,8,3,0,0,0,3,2
401026905,Duquesne Dukes,J. Vojinovic,4068404,,True,32.0,8,17,5,10,3,7,0,1,0,1,1,4,2,0,5,2,19
401026905,Duquesne Dukes,C. Richardson,3906439,,True,21.0,1,3,1,3,0,0,4,4,1,1,2,1,1,0,1,4,6
401026905,Duquesne Dukes,C. Omogrosso,3906435,,True,39.0,8,15,4,9,4,6,2,2,0,3,3,5,0,0,4,3,22
401026905,Duquesne Dukes,H. Tulonen,4281466,,False,3.0,0,0,0,0,0,0,0,0,0,1,1,0,0,0,0,0,0
401026905,Duquesne Dukes,E. Kuttor,3906438,,False,17.0,1,2,1,2,0,0,0,0,0,11,11,3,1,0,2,3,2
401026905,Duquesne Dukes,A. Kalin,4281467,,False,19.0,1,2,1,2,0,0,0,0,0,2,2,0,0,0,1,1,2
401026905,Duquesne Dukes,L. Bazelak,4281465,,False,10.0,0,0,0,0,0,0,2,2,0,0,0,0,0,0,2,1,2
401026905,Duquesne Dukes,TEAM,TOTAL,TOTAL,False,,26,55,17,37,9,18,8,9,3,33,36,17,5,1,16,19,69
401026285,Georgetown Hoyas,C. Petke,4068078,,True,35.0,8,14,6,10,2,4,8,10,1,6,7,5,0,0,1,2,26
401026285,Georgetown Hoyas,Y. Belk,3142295,,True,34.0,4,9,4,9,0,0,0,0,7,9,16,1,1,5,1,5,8
401026285,Georgetown Hoyas,D. White,3948815,,True,40.0,5,19,3,12,2,7,4,4,2,4,6,6,1,2,8,1,16
401026285,Georgetown Hoyas,D. Burton,3142292,,True,38.0,3,9,2,5,1,4,0,0,2,3,5,5,2,0,0,3,7
401026285,Georgetown Hoyas,M. Venson,3142105,,True,17.0,1,7,1,5,0,2,0,0,1,0,1,0,0,0,0,1,2
401026285,Georgetown Hoyas,T. Thompson,4281352,,False,5.0,0,1,0,1,0,0,0,0,0,1,1,1,0,0,0,0,0
401026285,Georgetown Hoyas,M. Smith,4068079,,False,31.0,3,6,3,6,0,0,2,2,3,2,5,1,1,0,1,2,8
401026285,Georgetown Hoyas,TEAM,TOTAL,TOTAL,False,,24,65,19,48,5,17,14,16,16,28,44,19,5,7,11,14,67
401026285,Delaware Blue Hens,R. Lawrence,4068312,,True,25.0,2,6,2,5,0,1,0,0,0,2,2,0,0,2,2,3,4
401026285,Delaware Blue Hens,S. DeFreese,4068310,,True,33.0,4,11,4,9,0,2,0,0,1,8,9,1,0,0,2,3,8
401026285,Delaware Blue Hens,N. Enabosi,3918557,,True,31.0,6,10,6,10,0,0,3,6,1,2,3,3,1,1,3,5,15
401026285,Delaware Blue Hens,B. Kargo,4068311,,True,21.0,2,4,1,1,1,3,0,0,0,1,1,2,0,0,2,2,5
401026285,Delaware Blue Hens,A. Gonzales,4068309,,True,33.0,3,10,2,6,1,4,0,1,1,3,4,2,1,0,1,0,7
401026285,Delaware Blue Hens,L. Oleary,4281427,,False,24.0,2,6,2,6,0,0,3,4,1,3,4,2,0,3,1,3,7
401026285,Delaware Blue Hens,J. Mascaro,4281428,,False,7.0,1,2,1,1,0,1,1,2,0,0,0,1,0,0,1,0,3
401026285,Delaware Blue Hens,K. West,3143238,,False,13.0,1,3,1,3,0,0,1,2,0,2,2,1,1,0,0,3,3
401026285,Delaware Blue Hens,A. Lewis,3142303,,False,13.0,1,3,1,3,0,0,3,4,0,3,3,2,0,1,0,0,5
401026285,Delaware Blue Hens,TEAM,TOTAL,TOTAL,False,,22,55,20,44,2,11,11,19,8,25,33,14,3,7,12,19,57
401026281,St. John's Red Storm,M. Singleton,4068158,,True,35.0,4,7,4,7,0,0,4,4,2,9,11,4,0,0,3,1,12
401026281,St. John's Red Storm,I. Littleton,3142306,,True,37.0,6,10,6,10,0,0,0,1,6,4,10,1,2,0,0,1,12
401026281,St. John's Red Storm,A. Wellere,3906771,,True,32.0,5,9,3,4,2,5,0,0,0,1,1,2,3,0,1,4,12
401026281,St. John's Red Storm,T. England,4068155,,True,26.0,1,7,1,5,0,2,0,0,0,2,2,4,2,0,4,3,2
401026281,St. John's Red Storm,A. Kebbe,4068154,,True,27.0,4,10,2,6,2,4,0,0,1,3,4,0,1,0,2,1,10
401026281,St. John's Red Storm,K. Charles,4281374,,False,2.0,0,1,0,1,0,0,0,0,0,2,2,0,0,0,0,1,0
401026281,St. John's Red Storm,Q. Hoppie,4281375,,False,18.0,1,3,0,0,1,3,3,4,0,3,3,3,1,0,2,1,6
401026281,St. John's Red Storm,A. Adams,4068157,,False,19.0,5,10,2,5,3,5,1,2,0,0,0,2,0,0,1,2,14
401026281,St. John's Red Storm,S. Duncan,4068156,,False,2.0,0,0,0,0,0,0,0,0,0,0,0,0,0,0,1,0,0
401026281,St. John's Red Storm,T. Alexander,3142305,,False,2.0,0,0,0,0,0,0,0,0,0,0,0,0,0,0,0,0,0
401026281,St. John's Red Storm,TEAM,TOTAL,TOTAL,False,,26,57,18,38,8,19,8,11,11,25,36,16,9,0,14,14,68
401026281,Marist Red Foxes,W. Duffell,4282147,,True,21.0,0,2,0,2,0,0,0,0,3,3,6,0,0,0,3,1,0
401026281,Marist Red Foxes,A. Gilmer,3949116,,True,32.0,3,7,3,6,0,1,2,2,0,2,2,1,0,1,2,3,8
401026281,Marist Red Foxes,R. Hand,4068854,,True,38.0,2,11,1,6,1,5,5,6,4,0,4,4,0,0,4,2,10
401026281,Marist Red Foxes,G. Vander Weide,3918931,,True,31.0,1,5,1,3,0,2,0,0,1,3,4,1,1,0,5,1,2
401026281,Marist Red Foxes,M. Fitzpatrick,3907613,,True,40.0,7,13,6,9,1,4,5,7,1,4,5,0,0,0,1,0,20
401026281,Marist Red Foxes,G. Redden,4282148,,False,4.0,1,3,1,3,0,0,0,0,0,0,0,0,0,0,0,0,2
401026281,Marist Red Foxes,L. Henningsdottir,3907615,,False,18.0,1,4,0,2,1,2,0,0,0,4,4,0,0,0,1,1,3
401026281,Marist Red Foxes,K. Baab,3142708,,False,1.0,0,0,0,0,0,0,0,0,0,0,0,0,0,0,0,0,0
401026281,Marist Red Foxes,A. Best,4282146,,False,15.0,1,3,1,2,0,1,0,0,0,0,0,0,0,0,2,1,2
401026281,Marist Red Foxes,TEAM,TOTAL,TOTAL,False,,16,48,13,33,3,15,12,15,9,20,29,6,1,1,19,9,47
401026273,Seton Hall Pirates,S. Samuels,4068128,,True,30.0,4,6,4,5,0,1,0,0,0,7,7,3,2,0,4,1,8
401026273,Seton Hall Pirates,K. Evans,4281378,,True,11.0,1,2,1,2,0,0,0,0,0,0,0,1,0,1,1,0,2
401026273,Seton Hall Pirates,N. Jimenez,4281379,,True,19.0,2,8,1,3,1,5,0,0,1,0,1,1,2,0,3,1,5
401026273,Seton Hall Pirates,I. Butina,4281377,,True,26.0,3,5,3,5,0,0,2,2,0,1,1,1,1,0,4,4,8
401026273,Seton Hall Pirates,J. Jackson,3064877,,True,23.0,2,8,2,4,0,4,1,3,1,1,2,1,2,0,0,3,5
401026273,Seton Hall Pirates,S. Philoxy,4281380,,False,25.0,5,10,5,10,0,0,3,3,2,4,6,0,0,1,5,1,13
401026273,Seton Hall Pirates,T. Brown,3941336,,False,21.0,3,5,3,5,0,0,1,2,5,1,6,2,0,0,1,4,7
401026273,Seton Hall Pirates,J. Jones-Pack,4068129,,False,10.0,1,1,1,1,0,0,0,0,1,1,2,1,0,2,2,3,2
401026273,Seton Hall Pirates,D. Winters,4068126,,False,9.0,1,6,1,2,0,4,0,0,0,1,1,0,0,0,1,2,2
401026273,Seton Hall Pirates,K. Hilaire,4068123,,False,19.0,2,4,2,4,0,0,1,1,0,1,1,4,2,0,1,4,5
401026273,Seton Hall Pirates,K. Healy,3943704,,False,7.0,0,0,0,0,0,0,0,0,0,0,0,0,0,0,0,0,0
401026273,Seton Hall Pirates,TEAM,TOTAL,TOTAL,False,,24,55,23,41,1,14,8,11,12,18,30,14,9,4,23,23,57
401026273,Saint Joseph's Hawks,A. Fioravanti,3058922,,True,37.0,8,12,8,12,0,0,3,3,3,2,5,4,4,1,1,3,19
401026273,Saint Joseph's Hawks,C. Woods,3142455,,True,35.0,8,16,8,16,0,0,4,4,4,7,11,2,3,0,3,3,20
401026273,Saint Joseph's Hawks,A. Monaghan,3934208,,True,35.0,4,13,1,5,3,8,4,4,0,1,1,4,0,0,3,0,15
401026273,Saint Joseph's Hawks,K. Baisden,3934207,,True,35.0,1,8,0,3,1,5,4,4,1,1,2,3,1,0,3,3,7
401026273,Saint Joseph's Hawks,J. Garner,17605,,True,37.0,4,6,4,6,0,0,4,8,3,6,9,2,4,0,2,2,12
401026273,Saint Joseph's Hawks,M. Clay,3934210,,False,1.0,0,0,0,0,0,0,0,0,0,0,0,0,0,0,1,0,0
401026273,Saint Joseph's Hawks,W. Fisher,3907696,,False,7.0,1,1,1,1,0,0,0,0,1,1,2,0,1,1,1,0,2
401026273,Saint Joseph's Hawks,C. Belvedere,3142457,,False,1.0,0,0,0,0,0,0,0,0,0,0,0,0,0,0,0,0,0
401026273,Saint Joseph's Hawks,L. Roig,4281899,,False,11.0,0,1,0,1,0,0,0,2,0,2,2,1,0,0,2,1,0
401026273,Saint Joseph's Hawks,A. Marz,3142453,,False,1.0,0,0,0,0,0,0,0,0,0,0,0,0,0,0,0,0,0
401026273,Saint Joseph's Hawks,TEAM,TOTAL,TOTAL,False,,26,57,22,44,4,13,19,25,15,20,35,16,13,2,16,12,75
401026251,Marquette Golden Eagles,E. Davenport,3906756,,True,28.0,5,9,5,9,0,0,1,2,6,3,9,1,2,0,0,4,11
401026251,Marquette Golden Eagles,A. Wilborn,3906758,,True,25.0,1,3,1,3,0,0,4,7,1,1,2,4,0,0,2,1,6
401026251,Marquette Golden Eagles,A. Blockton,3906755,,True,35.0,13,23,10,16,3,7,5,7,2,4,6,5,1,0,1,2,34
401026251,Marquette Golden Eagles,N. Hiedeman,3906753,,True,36.0,4,13,3,8,1,5,0,0,1,4,5,3,2,0,1,0,9
401026251,Marquette Golden Eagles,D. King,3906752,,True,34.0,2,12,1,5,1,7,0,1,0,1,1,2,0,0,2,2,5
401026251,Marquette Golden Eagles,L. Van Kleunen,4068083,,False,14.0,1,4,1,3,0,1,0,0,1,0,1,0,1,0,1,0,2
401026251,Marquette Golden Eagles,S. Valentine,3142300,,False,6.0,0,0,0,0,0,0,0,0,1,0,1,0,0,0,0,0,0
401026251,Marquette Golden Eagles,S. Lott,4281350,,False,21.0,2,4,1,2,1,2,0,0,0,1,1,0,1,1,0,3,5
401026251,Marquette Golden Eagles,I. Spingola,4068082,,False,1.0,0,0,0,0,0,0,0,0,0,0,0,0,0,0,0,2,0
401026251,Marquette Golden Eagles,TEAM,TOTAL,TOTAL,False,,28,68,22,46,6,22,10,17,12,14,26,15,7,1,7,14,72
401026251,Louisville Cardinals,S. Fuehring,3904550,,True,32.0,8,12,8,10,0,2,3,3,1,7,8,3,1,0,3,2,19
401026251,Louisville Cardinals,M. Hines-Allen,3142055,,True,26.0,12,16,12,16,0,0,0,0,2,11,13,4,0,1,4,4,24
401026251,Louisville Cardinals,J. Jones,4065850,,True,34.0,6,9,6,9,0,0,2,2,3,3,6,7,1,0,1,2,14
401026251,Louisville Cardinals,A. Durr,3904553,,True,35.0,8,15,5,9,3,6,0,0,1,4,5,6,0,1,3,3,19
401026251,Louisville Cardinals,A. Carter,3142057,,True,38.0,1,3,1,2,0,1,0,0,0,1,1,5,0,0,3,2,2
401026251,Louisville Cardinals,B. Dunham,4065852,,False,7.0,1,1,1,1,0,0,0,0,0,1,1,1,0,0,0,0,2
401026251,Louisville Cardinals,K. Shook,4065849,,False,15.0,2,3,2,2,0,1,1,2,2,3,5,0,1,4,0,1,5
401026251,Louisville Cardinals,D. Evans,4281190,,False,12.0,1,3,1,1,0,2,0,0,1,2,3,1,0,0,1,1,2
401026251,Louisville Cardinals,J. Laemmle,4065851,,False,1.0,1,1,0,0,1,1,0,0,0,0,0,0,0,0,0,0,3
401026251,Louisville Cardinals,TEAM,TOTAL,TOTAL,False,,40,63,36,50,4,13,6,7,10,32,42,27,3,6,15,15,90
401026206,UCLA Bruins,M. Billings,3142255,,True,28.0,4,8,4,8,0,0,7,8,4,5,9,0,2,1,1,3,15
401026206,UCLA Bruins,L. Drummer,3142252,,True,20.0,5,12,5,10,0,2,0,1,3,1,4,0,1,1,0,4,10
401026206,UCLA Bruins,K. Burke,3922628,,True,30.0,4,9,1,3,3,6,0,0,1,3,4,3,1,1,1,0,11
401026206,UCLA Bruins,K. Hayes,3142254,,True,28.0,2,6,2,3,0,3,0,0,1,1,2,0,1,0,2,4,4
401026206,UCLA Bruins,J. Canada,3142250,,True,31.0,6,7,6,7,0,0,9,10,2,4,6,8,5,0,2,0,21
401026206,UCLA Bruins,L. Miller,4282174,,False,7.0,0,1,0,1,0,0,1,2,1,1,2,1,0,1,1,0,1
401026206,UCLA Bruins,M. Onyenwere,4282173,,False,15.0,2,3,2,3,0,0,1,2,2,4,6,2,1,0,1,4,5
401026206,UCLA Bruins,A. Rosenblum,4066550,,False,6.0,0,3,0,3,0,0,0,0,0,1,1,0,1,0,2,1,0
401026206,UCLA Bruins,C. Horvat,4282171,,False,2.0,0,0,0,0,0,0,0,0,0,0,0,0,0,0,0,0,0
401026206,UCLA Bruins,J. Dean,3914645,,False,29.0,6,12,2,5,4,7,0,0,1,1,2,1,0,0,0,3,16
401026206,UCLA Bruins,C. Baird,3142256,,False,4.0,1,1,0,0,1,1,0,0,0,1,1,0,0,0,0,0,3
401026206,UCLA Bruins,TEAM,TOTAL,TOTAL,False,,30,62,22,43,8,19,18,23,15,22,37,15,12,4,10,19,86
401026206,Creighton Bluejays,A. Faber,3938938,,True,36.0,6,12,2,4,4,8,4,4,0,3,3,2,0,1,2,0,20
401026206,Creighton Bluejays,J. Agnew,3938935,,True,26.0,2,6,1,2,1,4,0,0,1,2,3,1,0,0,0,5,5
401026206,Creighton Bluejays,B. Norby,3142284,,True,14.0,1,4,1,3,0,1,0,0,1,1,2,0,0,0,2,2,2
401026206,Creighton Bluejays,S. Lamberty,3142285,,True,37.0,1,7,1,5,0,2,2,2,0,3,3,7,1,0,5,0,4
401026206,Creighton Bluejays,M. Mellman,3142283,,True,10.0,2,3,0,0,2,3,0,0,0,0,0,0,0,0,1,2,6
401026206,Creighton Bluejays,A. Greene,3938937,,False,13.0,1,2,1,2,0,0,0,0,2,1,3,1,0,0,2,3,2
401026206,Creighton Bluejays,K. Brown,3142286,,False,10.0,1,1,1,1,0,0,0,1,1,2,3,0,0,0,0,4,2
401026206,Creighton Bluejays,T. Carda,4281362,,False,22.0,2,4,1,2,1,2,2,2,0,3,3,2,0,0,4,2,7
401026206,Creighton Bluejays,T. Rembao,4281361,,False,4.0,0,0,0,0,0,0,0,0,0,0,0,2,0,0,0,1,0
401026206,Creighton Bluejays,O. Elger,3938936,,False,22.0,4,10,1,4,3,6,2,2,0,4,4,3,0,0,1,0,13
401026206,Creighton Bluejays,B. Kissinger,3142124,,False,6.0,1,2,1,1,0,1,1,1,0,0,0,0,0,0,1,2,3
401026206,Creighton Bluejays,TEAM,TOTAL,TOTAL,False,,21,51,10,24,11,27,11,12,7,20,27,18,1,1,18,21,64
401026198,Texas A&M Aggies,A. Howard,3906306,,True,40.0,8,11,8,10,0,1,2,5,9,10,19,2,2,1,1,1,18
401026198,Texas A&M Aggies,J. Lumpkin,3156161,,True,29.0,0,5,0,5,0,0,3,3,3,7,10,0,2,0,1,2,3
401026198,Texas A&M Aggies,K. Hillsman,3143139,,True,29.0,1,4,1,4,0,0,4,6,2,4,6,1,0,1,3,1,6
401026198,Texas A&M Aggies,C. Carter,4280892,,True,39.0,13,30,6,21,7,9,4,7,1,2,3,3,0,0,3,3,37
401026198,Texas A&M Aggies,D. Williams,3906307,,True,40.0,1,10,1,5,0,5,6,6,0,2,2,1,0,0,1,0,8
401026198,Texas A&M Aggies,C. Martin,4065773,,False,1.0,0,0,0,0,0,0,0,0,0,0,0,0,0,0,0,0,0
401026198,Texas A&M Aggies,K. Wells,4280893,,False,21.0,3,6,3,6,0,0,2,2,2,1,3,0,0,0,0,2,8
401026198,Texas A&M Aggies,L. McKinney,3147435,,False,1.0,0,0,0,0,0,0,0,0,0,0,0,0,0,0,0,0,0
401026198,Texas A&M Aggies,TEAM,TOTAL,TOTAL,False,,26,66,19,51,7,15,21,29,20,26,46,7,4,2,9,9,80
401026198,DePaul Blue Demons,C. Stonewall,4068072,,True,22.0,5,7,5,6,0,1,2,2,2,5,7,1,1,0,0,4,12
401026198,DePaul Blue Demons,M. Grays,3142287,,True,33.0,6,12,5,8,1,4,1,2,0,6,6,5,1,0,2,3,14
401026198,DePaul Blue Demons,K. Campbell,4068071,,True,39.0,3,6,1,3,2,3,0,0,1,4,5,7,1,0,1,4,8
401026198,DePaul Blue Demons,A. Millender,3142289,,True,38.0,4,14,1,3,3,11,0,0,1,5,6,4,0,0,0,3,11
401026198,DePaul Blue Demons,A. Coleman,3142123,,True,25.0,4,14,3,10,1,4,1,1,0,1,1,3,0,1,1,3,10
401026198,DePaul Blue Demons,R. McLimore,4281358,,False,1.0,0,0,0,0,0,0,0,0,0,0,0,0,0,0,0,1,0
401026198,DePaul Blue Demons,T. Allen,3933760,,False,26.0,7,9,3,3,4,6,1,2,3,1,4,0,0,1,0,2,19
401026198,DePaul Blue Demons,L. Prochaska,3142290,,False,16.0,1,5,0,3,1,2,2,2,0,1,1,4,0,0,2,1,5
401026198,DePaul Blue Demons,TEAM,TOTAL,TOTAL,False,,30,67,18,36,12,31,7,9,10,24,34,24,3,2,7,21,79
401026197,Villanova Wildcats,M. Quinn,3056785,,True,24.0,2,2,1,1,1,1,1,2,0,3,3,2,1,0,0,3,6
401026197,Villanova Wildcats,J. Tucker,3087536,,True,37.0,7,13,4,7,3,6,2,2,0,1,1,1,1,0,1,1,19
401026197,Villanova Wildcats,K. Jekot,4068171,,True,36.0,7,14,5,11,2,3,0,0,2,0,2,2,0,0,0,3,16
401026197,Villanova Wildcats,A. Hahn,3906779,,True,31.0,4,7,1,2,3,5,0,0,0,1,1,1,1,0,1,4,11
401026197,Villanova Wildcats,A. Louin,3142314,,True,28.0,1,7,0,3,1,4,3,4,0,4,4,1,0,1,4,3,6
401026197,Villanova Wildcats,G. Lange,4281371,,False,2.0,0,0,0,0,0,0,0,0,0,0,0,0,0,0,0,0,0
401026197,Villanova Wildcats,M. Gedaka,4068172,,False,11.0,2,4,2,4,0,0,2,5,1,2,3,0,1,0,1,2,6
401026197,Villanova Wildcats,B. Herlihy,4068169,,False,5.0,1,1,1,1,0,0,0,0,0,2,2,0,0,0,0,2,2
401026197,Villanova Wildcats,B. Herlihy,3906778,,False,10.0,1,5,1,4,0,1,1,2,0,1,1,1,0,0,0,0,3
401026197,Villanova Wildcats,G. Stant,3906780,,False,5.0,0,1,0,1,0,0,0,0,0,0,0,0,0,1,0,0,0
401026197,Villanova Wildcats,N. Juliana,4068170,,False,1.0,0,0,0,0,0,0,0,0,0,0,0,0,0,0,0,0,0
401026197,Villanova Wildcats,R. James,4068168,,False,4.0,0,0,0,0,0,0,3,6,0,0,0,0,1,0,0,1,3
401026197,Villanova Wildcats,C. Onken,4068167,,False,6.0,0,0,0,0,0,0,0,0,0,0,0,0,0,0,0,1,0
401026197,Villanova Wildcats,TEAM,TOTAL,TOTAL,False,,25,54,15,34,10,20,12,21,4,15,19,8,5,2,9,20,72
401026197,Notre Dame Fighting Irish,J. Shepard,3906949,,True,33.0,10,12,10,12,0,0,5,7,4,6,10,1,0,0,0,2,25
401026197,Notre Dame Fighting Irish,K. Nelson,3058909,,True,13.0,1,2,1,2,0,0,1,2,1,2,3,1,0,1,1,1,3
401026197,Notre Dame Fighting Irish,J. Young,4065870,,True,40.0,8,17,8,17,0,0,8,8,5,4,9,4,1,1,1,1,24
401026197,Notre Dame Fighting Irish,A. Ogunbowale,3904577,,True,38.0,8,19,7,17,1,2,7,7,1,7,8,3,0,0,1,2,24
401026197,Notre Dame Fighting Irish,M. Mabrey,3904576,,True,37.0,6,9,4,5,2,4,1,2,2,1,3,3,3,0,1,2,15
401026197,Notre Dame Fighting Irish,D. Patterson,4281207,,False,9.0,1,1,1,1,0,0,1,2,1,1,2,0,0,0,1,0,3
401026197,Notre Dame Fighting Irish,M. Butler,4281205,,False,0.0,0,0,0,0,0,0,0,0,0,0,0,0,0,0,0,0,0
401026197,Notre Dame Fighting Irish,K. Westbeld,3142087,,False,16.0,1,5,1,5,0,0,0,0,2,4,6,1,1,1,0,2,2
401026197,Notre Dame Fighting Irish,N. Benz,4293078,,False,2.0,0,2,0,0,0,2,0,0,1,0,1,0,0,0,0,1,0
401026197,Notre Dame Fighting Irish,K. Cole,4281206,,False,12.0,1,2,1,2,0,0,0,0,2,1,3,0,0,0,1,3,2
401026197,Notre Dame Fighting Irish,TEAM,TOTAL,TOTAL,False,,36,69,33,61,3,8,23,28,19,29,48,13,5,3,7,14,98
401026168,Iowa Hawkeyes,M. Gustafson,3934218,,True,40.0,12,16,12,16,0,0,5,5,4,13,17,0,0,0,4,2,29
401026168,Iowa Hawkeyes,C. Coley,3142144,,True,20.0,2,4,2,4,0,0,3,4,0,6,6,2,0,1,2,1,7
401026168,Iowa Hawkeyes,A. Sevillian,4068095,,True,35.0,1,3,1,2,0,1,0,0,0,1,1,2,0,0,1,4,2
401026168,Iowa Hawkeyes,M. Meyer,4068093,,True,34.0,1,4,0,2,1,2,4,4,0,2,2,3,1,1,3,5,7
401026168,Iowa Hawkeyes,K. Doyle,4068092,,True,40.0,3,15,1,7,2,8,3,4,0,2,2,8,1,1,1,2,11
401026168,Iowa Hawkeyes,A. Ollinger,4068094,,False,9.0,2,5,2,4,0,1,0,0,1,0,1,2,0,0,1,2,4
401026168,Iowa Hawkeyes,H. Stewart,3934220,,False,20.0,5,8,5,8,0,0,0,0,2,1,3,0,0,0,1,4,10
401026168,Iowa Hawkeyes,C. Mohns,3142147,,False,2.0,0,1,0,1,0,0,0,0,0,0,0,0,0,0,1,0,0
401026168,Iowa Hawkeyes,TEAM,TOTAL,TOTAL,False,,26,56,23,44,3,12,15,17,12,27,39,17,2,3,14,20,70
401026168,Creighton Bluejays,A. Faber,3938938,,True,33.0,3,15,1,5,2,10,4,6,0,4,4,2,0,3,2,3,12
401026168,Creighton Bluejays,J. Agnew,3938935,,True,38.0,8,14,4,8,4,6,4,5,0,2,2,5,2,1,0,2,24
401026168,Creighton Bluejays,B. Norby,3142284,,True,10.0,2,3,2,3,0,0,1,2,1,0,1,0,0,0,0,2,5
401026168,Creighton Bluejays,S. Lamberty,3142285,,True,39.0,8,12,6,9,2,3,2,4,2,3,5,6,0,1,2,2,20
401026168,Creighton Bluejays,M. Mellman,3142283,,True,14.0,0,0,0,0,0,0,0,0,0,2,2,0,0,0,0,0,0
401026168,Creighton Bluejays,A. Greene,3938937,,False,17.0,1,3,1,3,0,0,2,2,2,1,3,0,0,0,0,4,4
401026168,Creighton Bluejays,K. Brown,3142286,,False,6.0,0,1,0,1,0,0,0,0,1,0,1,0,0,0,0,1,0
401026168,Creighton Bluejays,T. Carda,4281362,,False,17.0,2,4,2,3,0,1,3,4,0,2,2,2,1,0,1,0,7
401026168,Creighton Bluejays,O. Elger,3938936,,False,26.0,1,6,0,2,1,4,1,2,0,3,3,1,1,0,2,1,4
401026168,Creighton Bluejays,TEAM,TOTAL,TOTAL,False,,25,58,16,34,9,24,17,25,10,18,28,16,4,5,7,15,76
401026158,Marquette Golden Eagles,E. Davenport,3906756,,True,31.0,7,11,7,11,0,0,2,4,5,8,13,0,1,1,3,3,16
401026158,Marquette Golden Eagles,A. Wilborn,3906758,,True,38.0,3,13,2,9,1,4,1,2,2,2,4,4,1,0,2,2,8
401026158,Marquette Golden Eagles,A. Blockton,3906755,,True,29.0,4,13,1,8,3,5,4,4,2,2,4,2,0,0,1,2,15
401026158,Marquette Golden Eagles,N. Hiedeman,3906753,,True,34.0,10,18,2,6,8,12,4,5,0,4,4,5,5,1,2,4,32
401026158,Marquette Golden Eagles,D. King,3906752,,True,35.0,5,8,5,7,0,1,1,1,3,0,3,4,3,0,2,1,11
401026158,Marquette Golden Eagles,A. Anderson,4068081,,False,3.0,1,1,1,1,0,0,0,0,1,1,2,0,0,0,0,0,2
401026158,Marquette Golden Eagles,S. Dahling,3906754,,False,1.0,0,0,0,0,0,0,0,0,0,0,0,0,0,0,0,0,0
401026158,Marquette Golden Eagles,L. Van Kleunen,4068083,,False,3.0,0,0,0,0,0,0,0,0,0,0,0,0,0,0,0,1,0
401026158,Marquette Golden Eagles,S. Valentine,3142300,,False,8.0,0,0,0,0,0,0,0,2,0,3,3,0,1,0,0,2,0
401026158,Marquette Golden Eagles,S. Lott,4281350,,False,10.0,0,3,0,0,0,3,0,0,1,1,2,0,0,0,0,4,0
401026158,Marquette Golden Eagles,I. Spingola,4068082,,False,8.0,0,1,0,0,0,1,0,0,0,0,0,0,0,0,0,1,0
401026158,Marquette Golden Eagles,TEAM,TOTAL,TOTAL,False,,30,68,18,42,12,26,12,18,14,22,36,15,11,2,10,20,84
401026158,Dayton Flyers,A. Harris,3064565,,True,26.0,3,3,3,3,0,0,1,1,2,5,7,0,0,2,4,1,7
401026158,Dayton Flyers,J. Scaife,4068134,,True,28.0,5,14,5,12,0,2,1,2,0,4,4,1,0,0,3,3,11
401026158,Dayton Flyers,L. Cannatelli,3906413,,True,39.0,2,9,1,5,1,4,4,5,0,5,5,0,2,0,3,0,9
401026158,Dayton Flyers,J. Layfield,3139280,,True,34.0,4,8,4,8,0,0,3,5,6,7,13,0,1,1,3,3,11
401026158,Dayton Flyers,J. Burdette,3139279,,True,37.0,5,15,4,9,1,6,8,8,1,4,5,4,1,0,4,3,19
401026158,Dayton Flyers,J. Wilmoth,4068131,,False,12.0,2,5,1,4,1,1,1,2,3,0,3,0,0,0,2,4,6
401026158,Dayton Flyers,M. Dennis,3906412,,False,2.0,0,0,0,0,0,0,0,0,0,0,0,0,0,0,0,0,0
401026158,Dayton Flyers,T. Phillips,4281464,,False,15.0,1,2,1,2,0,0,0,0,2,2,4,0,0,0,0,2,2
401026158,Dayton Flyers,C. Szabo,4068132,,False,1.0,0,0,0,0,0,0,0,0,0,0,0,0,0,0,0,0,0
401026158,Dayton Flyers,B. Ward,3914013,,False,6.0,0,1,0,1,0,0,0,0,0,0,0,0,0,0,0,2,0
401026158,Dayton Flyers,TEAM,TOTAL,TOTAL,False,,22,57,19,44,3,13,18,23,15,27,42,5,4,3,19,18,65
401026151,Oklahoma Sooners,V. Pierre-Louis,3133252,,True,24.0,7,9,7,9,0,0,7,11,4,2,6,0,0,1,2,1,21
401026151,Oklahoma Sooners,S. Pellington,4601922,,True,32.0,5,9,5,9,0,0,4,6,0,4,4,2,0,0,4,3,14
401026151,Oklahoma Sooners,A. Llanusa,4281315,,True,22.0,1,7,1,4,0,3,11,12,1,0,1,1,4,0,2,5,13
401026151,Oklahoma Sooners,G. Ortiz,3133255,,True,32.0,7,11,3,4,4,7,0,0,0,4,4,0,1,0,2,4,18
401026151,Oklahoma Sooners,M. Manning,17409,,True,36.0,3,13,3,7,0,6,1,2,2,6,8,2,1,1,0,2,7
401026151,Oklahoma Sooners,I. Odimgbe,3943722,,False,4.0,0,0,0,0,0,0,0,0,0,1,1,0,1,0,0,0,0
401026151,Oklahoma Sooners,L. Williams,3133257,,False,19.0,1,9,1,7,0,2,0,0,1,0,1,0,0,0,0,1,2
401026151,Oklahoma Sooners,G. Penzo,3133253,,False,31.0,1,3,1,2,0,1,2,2,0,7,7,10,2,0,2,3,4
401026151,Oklahoma Sooners,TEAM,TOTAL,TOTAL,False,,25,61,21,42,4,19,25,33,9,24,33,15,9,2,12,19,79
401026151,DePaul Blue Demons,C. Stonewall,4068072,,True,35.0,4,11,4,9,0,2,4,6,0,7,7,6,2,1,1,1,12
401026151,DePaul Blue Demons,M. Grays,3142287,,True,16.0,5,7,3,5,2,2,4,6,0,2,2,1,1,0,3,5,16
401026151,DePaul Blue Demons,K. Campbell,4068071,,True,40.0,5,6,2,2,3,4,4,5,0,6,6,5,1,1,4,4,17
401026151,DePaul Blue Demons,A. Millender,3142289,,True,39.0,7,14,5,8,2,6,0,0,3,3,6,4,1,0,0,2,16
401026151,DePaul Blue Demons,A. Coleman,3142123,,True,26.0,6,9,2,4,4,5,1,2,0,7,7,5,0,0,2,5,17
401026151,DePaul Blue Demons,R. McLimore,4281358,,False,2.0,0,1,0,1,0,0,0,0,0,1,1,0,0,0,0,0,0
401026151,DePaul Blue Demons,D. Bekelja,4281356,,False,2.0,0,0,0,0,0,0,0,0,0,0,0,0,0,0,0,0,0
401026151,DePaul Blue Demons,T. Allen,3933760,,False,26.0,2,9,1,4,1,5,2,2,1,7,8,2,1,1,2,2,7
401026151,DePaul Blue Demons,L. Prochaska,3142290,,False,14.0,1,1,1,1,0,0,3,4,0,0,0,3,0,0,3,4,5
401026151,DePaul Blue Demons,TEAM,TOTAL,TOTAL,False,,30,58,18,34,12,24,18,25,7,34,41,26,6,3,15,23,90
401026150,Villanova Wildcats,M. Quinn,3056785,,True,11.0,1,2,0,0,1,2,0,0,2,2,4,1,0,0,1,3,3
401026150,Villanova Wildcats,J. Tucker,3087536,,True,42.0,6,17,0,4,6,13,2,2,0,3,3,1,1,2,0,2,20
401026150,Villanova Wildcats,K. Jekot,4068171,,True,42.0,2,6,0,2,2,4,3,4,3,5,8,2,0,0,2,3,9
401026150,Villanova Wildcats,A. Hahn,3906779,,True,42.0,7,16,1,4,6,12,4,4,1,3,4,3,0,0,0,2,24
401026150,Villanova Wildcats,A. Louin,3142314,,True,45.0,2,8,1,2,1,6,5,11,1,13,14,8,0,0,3,3,10
401026150,Villanova Wildcats,M. Gedaka,4068172,,False,33.0,7,11,7,11,0,0,1,4,1,1,2,3,0,1,2,3,15
401026150,Villanova Wildcats,B. Herlihy,4068169,,False,1.0,0,0,0,0,0,0,0,0,0,0,0,0,0,0,0,0,0
401026150,Villanova Wildcats,G. Stant,3906780,,False,4.0,0,1,0,0,0,1,0,0,0,0,0,0,1,0,0,1,0
401026150,Villanova Wildcats,R. James,4068168,,False,3.0,0,0,0,0,0,0,0,0,0,0,0,0,0,0,1,1,0
401026150,Villanova Wildcats,C. Onken,4068167,,False,2.0,0,0,0,0,0,0,0,0,0,1,1,0,0,0,0,1,0
401026150,Villanova Wildcats,TEAM,TOTAL,TOTAL,False,,25,61,9,23,16,38,15,25,11,30,41,18,2,3,9,19,81
401026150,South Dakota State Jackrabbits,T. Larson,4069099,,True,38.0,2,6,2,3,0,3,4,6,1,3,4,3,0,1,3,1,8
401026150,South Dakota State Jackrabbits,E. Thompson,3142249,,True,27.0,6,8,6,8,0,0,4,6,2,5,7,2,0,1,0,4,16
401026150,South Dakota State Jackrabbits,M. Guebert,3908281,,True,43.0,7,16,4,8,3,8,4,4,0,2,2,1,2,1,1,4,21
401026150,South Dakota State Jackrabbits,M. Miller,3142248,,True,36.0,10,18,10,15,0,3,5,6,1,7,8,2,1,1,3,1,25
401026150,South Dakota State Jackrabbits,A. Alexander,3142246,,True,27.0,0,1,0,0,0,1,0,0,0,2,2,3,2,0,0,3,0
401026150,South Dakota State Jackrabbits,M. Selland,4282531,,False,24.0,1,5,1,4,0,1,0,0,0,6,6,2,1,1,0,3,2
401026150,South Dakota State Jackrabbits,S. Palmer,3908283,,False,7.0,0,1,0,1,0,0,0,0,0,1,1,0,0,0,0,0,0
401026150,South Dakota State Jackrabbits,T. Irwin,4282530,,False,13.0,0,1,0,1,0,0,0,0,0,0,0,0,0,0,1,4,0
401026150,South Dakota State Jackrabbits,R. Cascio Jensen,4068046,,False,10.0,1,1,1,1,0,0,0,0,0,2,2,0,0,0,1,1,2
401026150,South Dakota State Jackrabbits,TEAM,TOTAL,TOTAL,False,,27,57,24,41,3,16,17,22,4,30,34,13,6,5,9,21,74
401020606,Marquette Golden Eagles,E. Davenport,3906756,,True,21.0,4,8,4,8,0,0,1,2,2,2,4,0,1,0,1,1,9
401020606,Marquette Golden Eagles,A. Wilborn,3906758,,True,25.0,4,7,3,6,1,1,3,5,0,5,5,1,1,0,0,5,12
401020606,Marquette Golden Eagles,A. Blockton,3906755,,True,24.0,4,11,4,7,0,4,0,0,0,5,5,2,0,0,3,1,8
401020606,Marquette Golden Eagles,N. Hiedeman,3906753,,True,24.0,4,13,2,7,2,6,0,1,1,1,2,3,0,1,1,2,10
401020606,Marquette Golden Eagles,D. King,3906752,,True,30.0,1,12,0,7,1,5,0,0,0,1,1,3,1,0,2,0,3
401020606,Marquette Golden Eagles,A. Anderson,4068081,,False,7.0,1,1,1,1,0,0,0,0,1,0,1,0,1,0,0,1,2
401020606,Marquette Golden Eagles,S. Dahling,3906754,,False,4.0,0,2,0,1,0,1,0,0,0,1,1,1,0,0,0,0,0
401020606,Marquette Golden Eagles,L. Van Kleunen,4068083,,False,15.0,1,3,1,2,0,1,1,1,1,4,5,0,1,0,0,1,3
401020606,Marquette Golden Eagles,S. Valentine,3142300,,False,11.0,1,3,1,3,0,0,0,0,0,0,0,0,0,0,0,2,2
401020606,Marquette Golden Eagles,S. Lott,4281350,,False,25.0,3,6,2,4,1,2,1,2,4,3,7,1,2,1,1,2,8
401020606,Marquette Golden Eagles,I. Spingola,4068082,,False,14.0,2,6,0,1,2,5,0,0,0,1,1,0,0,0,2,1,6
401020606,Marquette Golden Eagles,TEAM,TOTAL,TOTAL,False,,25,72,18,47,7,25,6,11,10,24,34,11,7,2,10,16,63
401020606,Marquette Golden Eagles,E. Davenport,3906756,,True,21.0,4,8,4,8,0,0,1,2,2,2,4,0,1,0,1,1,9
401020606,Marquette Golden Eagles,A. Wilborn,3906758,,True,25.0,4,7,3,6,1,1,3,5,0,5,5,1,1,0,0,5,12
401020606,Marquette Golden Eagles,A. Blockton,3906755,,True,24.0,4,11,4,7,0,4,0,0,0,5,5,2,0,0,3,1,8
401020606,Marquette Golden Eagles,N. Hiedeman,3906753,,True,24.0,4,13,2,7,2,6,0,1,1,1,2,3,0,1,1,2,10
401020606,Marquette Golden Eagles,D. King,3906752,,True,30.0,1,12,0,7,1,5,0,0,0,1,1,3,1,0,2,0,3
401020606,Marquette Golden Eagles,A. Anderson,4068081,,False,7.0,1,1,1,1,0,0,0,0,1,0,1,0,1,0,0,1,2
401020606,Marquette Golden Eagles,S. Dahling,3906754,,False,4.0,0,2,0,1,0,1,0,0,0,1,1,1,0,0,0,0,0
401020606,Marquette Golden Eagles,L. Van Kleunen,4068083,,False,15.0,1,3,1,2,0,1,1,1,1,4,5,0,1,0,0,1,3
401020606,Marquette Golden Eagles,S. Valentine,3142300,,False,11.0,1,3,1,3,0,0,0,0,0,0,0,0,0,0,0,2,2
401020606,Marquette Golden Eagles,S. Lott,4281350,,False,25.0,3,6,2,4,1,2,1,2,4,3,7,1,2,1,1,2,8
401020606,Marquette Golden Eagles,I. Spingola,4068082,,False,14.0,2,6,0,1,2,5,0,0,0,1,1,0,0,0,2,1,6
401020606,Marquette Golden Eagles,TEAM,TOTAL,TOTAL,False,,25,72,18,47,7,25,6,11,10,24,34,11,7,2,10,16,63
401020606,DePaul Blue Demons,C. Stonewall,4068072,,True,27.0,6,11,4,7,2,4,0,0,1,10,11,0,1,1,1,1,14
401020606,DePaul Blue Demons,M. Grays,3142287,,True,27.0,6,14,4,8,2,6,0,2,1,6,7,6,1,1,1,1,14
401020606,DePaul Blue Demons,K. Campbell,4068071,,True,29.0,4,5,3,3,1,2,1,1,3,8,11,5,0,0,1,1,10
401020606,DePaul Blue Demons,A. Millender,3142289,,True,31.0,6,13,2,7,4,6,0,0,3,3,6,3,1,0,1,2,16
401020606,DePaul Blue Demons,A. Coleman,3142123,,True,24.0,9,13,4,6,5,7,4,4,1,3,4,5,3,0,2,2,27
401020606,DePaul Blue Demons,R. McLimore,4281358,,False,6.0,1,1,1,1,0,0,0,0,0,0,0,0,0,0,1,0,2
401020606,DePaul Blue Demons,V. Sherrod,4281359,,False,3.0,0,0,0,0,0,0,0,0,0,0,0,0,1,0,0,0,0
401020606,DePaul Blue Demons,D. Bekelja,4281356,,False,6.0,1,3,1,1,0,2,0,0,0,1,1,0,0,0,0,0,2
401020606,DePaul Blue Demons,D. Cage,4068073,,False,5.0,2,4,2,3,0,1,0,0,0,0,0,0,0,0,0,0,4
401020606,DePaul Blue Demons,T. Allen,3933760,,False,18.0,2,6,1,2,1,4,0,0,0,2,2,0,0,0,2,2,5
401020606,DePaul Blue Demons,L. Prochaska,3142290,,False,24.0,1,4,0,1,1,3,1,2,0,4,4,8,0,2,4,2,4
401020606,DePaul Blue Demons,TEAM,TOTAL,TOTAL,False,,38,74,22,39,16,35,6,9,12,40,52,27,7,4,13,11,98
401020606,DePaul Blue Demons,C. Stonewall,4068072,,True,27.0,6,11,4,7,2,4,0,0,1,10,11,0,1,1,1,1,14
401020606,DePaul Blue Demons,M. Grays,3142287,,True,27.0,6,14,4,8,2,6,0,2,1,6,7,6,1,1,1,1,14
401020606,DePaul Blue Demons,K. Campbell,4068071,,True,29.0,4,5,3,3,1,2,1,1,3,8,11,5,0,0,1,1,10
401020606,DePaul Blue Demons,A. Millender,3142289,,True,31.0,6,13,2,7,4,6,0,0,3,3,6,3,1,0,1,2,16
401020606,DePaul Blue Demons,A. Coleman,3142123,,True,24.0,9,13,4,6,5,7,4,4,1,3,4,5,3,0,2,2,27
401020606,DePaul Blue Demons,R. McLimore,4281358,,False,6.0,1,1,1,1,0,0,0,0,0,0,0,0,0,0,1,0,2
401020606,DePaul Blue Demons,V. Sherrod,4281359,,False,3.0,0,0,0,0,0,0,0,0,0,0,0,0,1,0,0,0,0
401020606,DePaul Blue Demons,D. Bekelja,4281356,,False,6.0,1,3,1,1,0,2,0,0,0,1,1,0,0,0,0,0,2
401020606,DePaul Blue Demons,D. Cage,4068073,,False,5.0,2,4,2,3,0,1,0,0,0,0,0,0,0,0,0,0,4
401020606,DePaul Blue Demons,T. Allen,3933760,,False,18.0,2,6,1,2,1,4,0,0,0,2,2,0,0,0,2,2,5
401020606,DePaul Blue Demons,L. Prochaska,3142290,,False,24.0,1,4,0,1,1,3,1,2,0,4,4,8,0,2,4,2,4
401020606,DePaul Blue Demons,TEAM,TOTAL,TOTAL,False,,38,74,22,39,16,35,6,9,12,40,52,27,7,4,13,11,98
401020604,Georgetown Hoyas,C. Petke,4068078,,True,30.0,4,14,3,12,1,2,1,2,1,7,8,1,0,0,0,0,10
401020604,Georgetown Hoyas,Y. Belk,3142295,,True,16.0,1,4,1,4,0,0,0,0,2,2,4,0,1,1,0,2,2
401020604,Georgetown Hoyas,D. White,3948815,,True,30.0,4,16,3,12,1,4,0,0,1,3,4,1,1,0,2,3,9
401020604,Georgetown Hoyas,D. Burton,3142292,,True,29.0,2,6,2,6,0,0,2,2,0,1,1,2,1,0,3,2,6
401020604,Georgetown Hoyas,M. Venson,3142105,,True,32.0,1,6,1,3,0,3,6,6,0,1,1,2,0,0,2,4,8
401020604,Georgetown Hoyas,S. Cureton,4281355,,False,3.0,0,0,0,0,0,0,0,0,0,0,0,0,0,0,0,0,0
401020604,Georgetown Hoyas,T. Thompson,4281352,,False,22.0,3,7,3,6,0,1,0,0,1,1,2,0,1,0,0,0,6
401020604,Georgetown Hoyas,M. Smith,4068079,,False,23.0,3,8,3,7,0,1,2,5,3,5,8,0,2,1,0,2,8
401020604,Georgetown Hoyas,B. Mayfield,4281354,,False,2.0,1,1,1,1,0,0,0,0,0,0,0,0,0,0,0,0,2
401020604,Georgetown Hoyas,L. Kimball,4281353,,False,3.0,0,1,0,1,0,0,0,0,0,1,1,0,0,0,0,0,0
401020604,Georgetown Hoyas,M. Osagie-Erese,4072597,,False,10.0,0,2,0,2,0,0,2,2,0,1,1,0,0,0,0,1,2
401020604,Georgetown Hoyas,TEAM,TOTAL,TOTAL,False,,19,65,17,54,2,11,13,17,9,24,33,6,6,2,7,14,53
401020604,Georgetown Hoyas,C. Petke,4068078,,True,30.0,4,14,3,12,1,2,1,2,1,7,8,1,0,0,0,0,10
401020604,Georgetown Hoyas,Y. Belk,3142295,,True,16.0,1,4,1,4,0,0,0,0,2,2,4,0,1,1,0,2,2
401020604,Georgetown Hoyas,D. White,3948815,,True,30.0,4,16,3,12,1,4,0,0,1,3,4,1,1,0,2,3,9
401020604,Georgetown Hoyas,D. Burton,3142292,,True,29.0,2,6,2,6,0,0,2,2,0,1,1,2,1,0,3,2,6
401020604,Georgetown Hoyas,M. Venson,3142105,,True,32.0,1,6,1,3,0,3,6,6,0,1,1,2,0,0,2,4,8
401020604,Georgetown Hoyas,S. Cureton,4281355,,False,3.0,0,0,0,0,0,0,0,0,0,0,0,0,0,0,0,0,0
401020604,Georgetown Hoyas,T. Thompson,4281352,,False,22.0,3,7,3,6,0,1,0,0,1,1,2,0,1,0,0,0,6
401020604,Georgetown Hoyas,M. Smith,4068079,,False,23.0,3,8,3,7,0,1,2,5,3,5,8,0,2,1,0,2,8
401020604,Georgetown Hoyas,B. Mayfield,4281354,,False,2.0,1,1,1,1,0,0,0,0,0,0,0,0,0,0,0,0,2
401020604,Georgetown Hoyas,L. Kimball,4281353,,False,3.0,0,1,0,1,0,0,0,0,0,1,1,0,0,0,0,0,0
401020604,Georgetown Hoyas,M. Osagie-Erese,4072597,,False,10.0,0,2,0,2,0,0,2,2,0,1,1,0,0,0,0,1,2
401020604,Georgetown Hoyas,TEAM,TOTAL,TOTAL,False,,19,65,17,54,2,11,13,17,9,24,33,6,6,2,7,14,53
401020604,DePaul Blue Demons,C. Stonewall,4068072,,True,26.0,4,9,3,6,1,3,1,2,1,4,5,0,2,0,0,0,10
401020604,DePaul Blue Demons,M. Grays,3142287,,True,22.0,3,8,3,4,0,4,2,2,3,4,7,2,0,0,1,2,8
401020604,DePaul Blue Demons,K. Campbell,4068071,,True,26.0,5,7,4,4,1,3,0,0,4,7,11,3,0,0,0,0,11
401020604,DePaul Blue Demons,A. Millender,3142289,,True,27.0,6,12,3,3,3,9,0,0,1,4,5,0,1,0,0,0,15
401020604,DePaul Blue Demons,A. Coleman,3142123,,True,29.0,4,12,3,8,1,4,4,5,0,6,6,6,0,0,0,2,13
401020604,DePaul Blue Demons,R. McLimore,4281358,,False,5.0,1,1,1,1,0,0,0,0,0,0,0,0,0,1,0,1,2
401020604,DePaul Blue Demons,V. Sherrod,4281359,,False,4.0,0,2,0,0,0,2,0,0,0,1,1,0,0,0,1,1,0
401020604,DePaul Blue Demons,D. Bekelja,4281356,,False,10.0,2,4,1,2,1,2,0,0,1,0,1,2,0,0,2,3,5
401020604,DePaul Blue Demons,D. Cage,4068073,,False,8.0,2,2,1,1,1,1,0,0,0,2,2,1,1,0,1,3,5
401020604,DePaul Blue Demons,T. Allen,3933760,,False,26.0,3,7,2,3,1,4,0,0,0,6,6,1,0,2,3,1,7
401020604,DePaul Blue Demons,L. Prochaska,3142290,,False,17.0,3,4,2,3,1,1,2,3,0,2,2,3,0,0,1,1,9
401020604,DePaul Blue Demons,TEAM,TOTAL,TOTAL,False,,33,68,23,35,10,33,9,12,12,39,51,18,4,3,9,14,85
401020604,DePaul Blue Demons,C. Stonewall,4068072,,True,26.0,4,9,3,6,1,3,1,2,1,4,5,0,2,0,0,0,10
401020604,DePaul Blue Demons,M. Grays,3142287,,True,22.0,3,8,3,4,0,4,2,2,3,4,7,2,0,0,1,2,8
401020604,DePaul Blue Demons,K. Campbell,4068071,,True,26.0,5,7,4,4,1,3,0,0,4,7,11,3,0,0,0,0,11
401020604,DePaul Blue Demons,A. Millender,3142289,,True,27.0,6,12,3,3,3,9,0,0,1,4,5,0,1,0,0,0,15
401020604,DePaul Blue Demons,A. Coleman,3142123,,True,29.0,4,12,3,8,1,4,4,5,0,6,6,6,0,0,0,2,13
401020604,DePaul Blue Demons,R. McLimore,4281358,,False,5.0,1,1,1,1,0,0,0,0,0,0,0,0,0,1,0,1,2
401020604,DePaul Blue Demons,V. Sherrod,4281359,,False,4.0,0,2,0,0,0,2,0,0,0,1,1,0,0,0,1,1,0
401020604,DePaul Blue Demons,D. Bekelja,4281356,,False,10.0,2,4,1,2,1,2,0,0,1,0,1,2,0,0,2,3,5
401020604,DePaul Blue Demons,D. Cage,4068073,,False,8.0,2,2,1,1,1,1,0,0,0,2,2,1,1,0,1,3,5
401020604,DePaul Blue Demons,T. Allen,3933760,,False,26.0,3,7,2,3,1,4,0,0,0,6,6,1,0,2,3,1,7
401020604,DePaul Blue Demons,L. Prochaska,3142290,,False,17.0,3,4,2,3,1,1,2,3,0,2,2,3,0,0,1,1,9
401020604,DePaul Blue Demons,TEAM,TOTAL,TOTAL,False,,33,68,23,35,10,33,9,12,12,39,51,18,4,3,9,14,85
401020603,Marquette Golden Eagles,E. Davenport,3906756,,True,31.0,4,9,4,9,0,0,0,0,3,3,6,1,0,0,4,2,8
401020603,Marquette Golden Eagles,A. Wilborn,3906758,,True,40.0,6,11,6,9,0,2,4,5,1,3,4,4,0,0,1,2,16
401020603,Marquette Golden Eagles,A. Blockton,3906755,,True,37.0,12,21,7,16,5,5,3,3,4,7,11,3,4,0,0,0,32
401020603,Marquette Golden Eagles,N. Hiedeman,3906753,,True,37.0,4,11,4,9,0,2,0,1,0,8,8,2,3,3,1,0,8
401020603,Marquette Golden Eagles,D. King,3906752,,True,33.0,4,13,3,8,1,5,3,4,2,2,4,3,2,0,0,1,12
401020603,Marquette Golden Eagles,L. Van Kleunen,4068083,,False,7.0,0,0,0,0,0,0,0,0,0,1,1,0,0,0,0,1,0
401020603,Marquette Golden Eagles,S. Valentine,3142300,,False,0.0,0,0,0,0,0,0,0,0,0,0,0,0,0,0,0,0,0
401020603,Marquette Golden Eagles,S. Lott,4281350,,False,14.0,0,3,0,1,0,2,0,0,1,1,2,0,1,1,0,3,0
401020603,Marquette Golden Eagles,I. Spingola,4068082,,False,1.0,0,0,0,0,0,0,0,0,0,0,0,0,0,0,0,0,0
401020603,Marquette Golden Eagles,TEAM,TOTAL,TOTAL,False,,30,68,24,52,6,16,10,13,12,26,38,13,10,4,6,9,76
401020603,Marquette Golden Eagles,E. Davenport,3906756,,True,31.0,4,9,4,9,0,0,0,0,3,3,6,1,0,0,4,2,8
401020603,Marquette Golden Eagles,A. Wilborn,3906758,,True,40.0,6,11,6,9,0,2,4,5,1,3,4,4,0,0,1,2,16
401020603,Marquette Golden Eagles,A. Blockton,3906755,,True,37.0,12,21,7,16,5,5,3,3,4,7,11,3,4,0,0,0,32
401020603,Marquette Golden Eagles,N. Hiedeman,3906753,,True,37.0,4,11,4,9,0,2,0,1,0,8,8,2,3,3,1,0,8
401020603,Marquette Golden Eagles,D. King,3906752,,True,33.0,4,13,3,8,1,5,3,4,2,2,4,3,2,0,0,1,12
401020603,Marquette Golden Eagles,L. Van Kleunen,4068083,,False,7.0,0,0,0,0,0,0,0,0,0,1,1,0,0,0,0,1,0
401020603,Marquette Golden Eagles,S. Valentine,3142300,,False,0.0,0,0,0,0,0,0,0,0,0,0,0,0,0,0,0,0,0
401020603,Marquette Golden Eagles,S. Lott,4281350,,False,14.0,0,3,0,1,0,2,0,0,1,1,2,0,1,1,0,3,0
401020603,Marquette Golden Eagles,I. Spingola,4068082,,False,1.0,0,0,0,0,0,0,0,0,0,0,0,0,0,0,0,0,0
401020603,Marquette Golden Eagles,TEAM,TOTAL,TOTAL,False,,30,68,24,52,6,16,10,13,12,26,38,13,10,4,6,9,76
401020603,Creighton Bluejays,A. Faber,3938938,,True,34.0,9,16,7,8,2,8,0,0,0,6,6,4,0,1,2,0,20
401020603,Creighton Bluejays,J. Agnew,3938935,,True,37.0,6,13,3,9,3,4,0,0,1,6,7,2,1,1,1,0,15
401020603,Creighton Bluejays,B. Norby,3142284,,True,9.0,0,0,0,0,0,0,0,0,0,0,0,1,0,1,0,1,0
401020603,Creighton Bluejays,S. Lamberty,3142285,,True,40.0,6,13,5,10,1,3,0,0,1,7,8,5,0,1,5,1,13
401020603,Creighton Bluejays,M. Mellman,3142283,,True,16.0,1,4,0,0,1,4,0,0,1,0,1,3,0,0,0,1,3
401020603,Creighton Bluejays,A. Greene,3938937,,False,13.0,0,1,0,1,0,0,0,0,2,1,3,0,0,0,0,3,0
401020603,Creighton Bluejays,K. Brown,3142286,,False,2.0,1,1,1,1,0,0,0,0,0,0,0,0,0,0,0,0,2
401020603,Creighton Bluejays,T. Carda,4281362,,False,25.0,2,6,1,3,1,3,0,0,0,0,0,1,0,0,3,3,5
401020603,Creighton Bluejays,O. Elger,3938936,,False,24.0,4,9,1,4,3,5,1,2,0,5,5,1,1,0,2,5,12
401020603,Creighton Bluejays,TEAM,TOTAL,TOTAL,False,,29,63,18,36,11,27,1,2,9,29,38,17,2,4,13,14,70
401020603,Creighton Bluejays,A. Faber,3938938,,True,34.0,9,16,7,8,2,8,0,0,0,6,6,4,0,1,2,0,20
401020603,Creighton Bluejays,J. Agnew,3938935,,True,37.0,6,13,3,9,3,4,0,0,1,6,7,2,1,1,1,0,15
401020603,Creighton Bluejays,B. Norby,3142284,,True,9.0,0,0,0,0,0,0,0,0,0,0,0,1,0,1,0,1,0
401020603,Creighton Bluejays,S. Lamberty,3142285,,True,40.0,6,13,5,10,1,3,0,0,1,7,8,5,0,1,5,1,13
401020603,Creighton Bluejays,M. Mellman,3142283,,True,16.0,1,4,0,0,1,4,0,0,1,0,1,3,0,0,0,1,3
401020603,Creighton Bluejays,A. Greene,3938937,,False,13.0,0,1,0,1,0,0,0,0,2,1,3,0,0,0,0,3,0
401020603,Creighton Bluejays,K. Brown,3142286,,False,2.0,1,1,1,1,0,0,0,0,0,0,0,0,0,0,0,0,2
401020603,Creighton Bluejays,T. Carda,4281362,,False,25.0,2,6,1,3,1,3,0,0,0,0,0,1,0,0,3,3,5
401020603,Creighton Bluejays,O. Elger,3938936,,False,24.0,4,9,1,4,3,5,1,2,0,5,5,1,1,0,2,5,12
401020603,Creighton Bluejays,TEAM,TOTAL,TOTAL,False,,29,63,18,36,11,27,1,2,9,29,38,17,2,4,13,14,70
401020601,Villanova Wildcats,M. Quinn,3056785,,True,11.0,1,3,1,2,0,1,1,2,0,3,3,0,0,0,1,1,3
401020601,Villanova Wildcats,J. Tucker,3087536,,True,38.0,3,8,1,2,2,6,0,0,1,2,3,1,1,0,2,1,8
401020601,Villanova Wildcats,K. Jekot,4068171,,True,35.0,3,5,2,4,1,1,1,2,1,2,3,3,0,0,2,3,8
401020601,Villanova Wildcats,A. Hahn,3906779,,True,36.0,4,9,2,3,2,6,2,2,1,4,5,1,1,0,3,3,12
401020601,Villanova Wildcats,A. Louin,3142314,,True,38.0,6,19,6,10,0,9,1,1,1,10,11,3,0,0,3,3,13
401020601,Villanova Wildcats,M. Gedaka,4068172,,False,29.0,5,6,5,6,0,0,2,2,2,3,5,1,1,1,0,1,12
401020601,Villanova Wildcats,B. Herlihy,3906778,,False,8.0,0,1,0,0,0,1,0,0,0,1,1,1,0,2,0,2,0
401020601,Villanova Wildcats,G. Stant,3906780,,False,3.0,0,0,0,0,0,0,0,0,0,0,0,0,0,0,0,0,0
401020601,Villanova Wildcats,R. James,4068168,,False,2.0,0,0,0,0,0,0,2,2,0,2,2,0,0,0,0,0,2
401020601,Villanova Wildcats,TEAM,TOTAL,TOTAL,False,,22,51,17,27,5,24,9,11,7,27,34,10,3,3,12,14,58
401020601,Villanova Wildcats,M. Quinn,3056785,,True,11.0,1,3,1,2,0,1,1,2,0,3,3,0,0,0,1,1,3
401020601,Villanova Wildcats,J. Tucker,3087536,,True,38.0,3,8,1,2,2,6,0,0,1,2,3,1,1,0,2,1,8
401020601,Villanova Wildcats,K. Jekot,4068171,,True,35.0,3,5,2,4,1,1,1,2,1,2,3,3,0,0,2,3,8
401020601,Villanova Wildcats,A. Hahn,3906779,,True,36.0,4,9,2,3,2,6,2,2,1,4,5,1,1,0,3,3,12
401020601,Villanova Wildcats,A. Louin,3142314,,True,38.0,6,19,6,10,0,9,1,1,1,10,11,3,0,0,3,3,13
401020601,Villanova Wildcats,M. Gedaka,4068172,,False,29.0,5,6,5,6,0,0,2,2,2,3,5,1,1,1,0,1,12
401020601,Villanova Wildcats,B. Herlihy,3906778,,False,8.0,0,1,0,0,0,1,0,0,0,1,1,1,0,2,0,2,0
401020601,Villanova Wildcats,G. Stant,3906780,,False,3.0,0,0,0,0,0,0,0,0,0,0,0,0,0,0,0,0,0
401020601,Villanova Wildcats,R. James,4068168,,False,2.0,0,0,0,0,0,0,2,2,0,2,2,0,0,0,0,0,2
401020601,Villanova Wildcats,TEAM,TOTAL,TOTAL,False,,22,51,17,27,5,24,9,11,7,27,34,10,3,3,12,14,58
401020601,Georgetown Hoyas,C. Petke,4068078,,True,40.0,10,17,7,12,3,5,1,2,5,6,11,1,2,0,3,3,24
401020601,Georgetown Hoyas,Y. Belk,3142295,,True,8.0,0,3,0,3,0,0,0,0,1,2,3,0,1,1,0,1,0
401020601,Georgetown Hoyas,D. White,3948815,,True,40.0,6,17,5,15,1,2,7,8,3,6,9,3,1,0,0,1,20
401020601,Georgetown Hoyas,D. Burton,3142292,,True,35.0,3,7,3,6,0,1,0,2,1,4,5,2,0,0,0,2,6
401020601,Georgetown Hoyas,M. Venson,3142105,,True,34.0,4,7,4,6,0,1,1,4,0,0,0,4,1,0,2,3,9
401020601,Georgetown Hoyas,T. Thompson,4281352,,False,11.0,0,3,0,2,0,1,0,0,0,2,2,0,0,0,1,1,0
401020601,Georgetown Hoyas,M. Smith,4068079,,False,32.0,2,6,2,6,0,0,0,0,1,1,2,0,1,1,0,4,4
401020601,Georgetown Hoyas,TEAM,TOTAL,TOTAL,False,,25,60,21,50,4,10,9,16,12,22,34,10,6,2,6,15,63
401020601,Georgetown Hoyas,C. Petke,4068078,,True,40.0,10,17,7,12,3,5,1,2,5,6,11,1,2,0,3,3,24
401020601,Georgetown Hoyas,Y. Belk,3142295,,True,8.0,0,3,0,3,0,0,0,0,1,2,3,0,1,1,0,1,0
401020601,Georgetown Hoyas,D. White,3948815,,True,40.0,6,17,5,15,1,2,7,8,3,6,9,3,1,0,0,1,20
401020601,Georgetown Hoyas,D. Burton,3142292,,True,35.0,3,7,3,6,0,1,0,2,1,4,5,2,0,0,0,2,6
401020601,Georgetown Hoyas,M. Venson,3142105,,True,34.0,4,7,4,6,0,1,1,4,0,0,0,4,1,0,2,3,9
401020601,Georgetown Hoyas,T. Thompson,4281352,,False,11.0,0,3,0,2,0,1,0,0,0,2,2,0,0,0,1,1,0
401020601,Georgetown Hoyas,M. Smith,4068079,,False,32.0,2,6,2,6,0,0,0,0,1,1,2,0,1,1,0,4,4
401020601,Georgetown Hoyas,TEAM,TOTAL,TOTAL,False,,25,60,21,50,4,10,9,16,12,22,34,10,6,2,6,15,63
401020600,Seton Hall Pirates,S. Samuels,4068128,,True,26.0,3,6,3,5,0,1,0,0,0,7,7,1,2,0,2,3,6
401020600,Seton Hall Pirates,K. Evans,4281378,,True,17.0,3,6,3,6,0,0,1,2,1,0,1,0,0,1,2,2,7
401020600,Seton Hall Pirates,N. Jimenez,4281379,,True,26.0,2,10,1,5,1,5,4,4,0,3,3,2,4,0,4,0,9
401020600,Seton Hall Pirates,I. Butina,4281377,,True,30.0,3,8,3,7,0,1,0,0,0,1,1,3,0,0,2,2,6
401020600,Seton Hall Pirates,J. Jackson,3064877,,True,20.0,1,3,1,2,0,1,0,0,0,4,4,0,1,0,1,0,2
401020600,Seton Hall Pirates,S. Philoxy,4281380,,False,22.0,6,8,6,8,0,0,2,7,3,6,9,1,1,0,0,1,14
401020600,Seton Hall Pirates,T. Brown,3941336,,False,17.0,0,1,0,1,0,0,0,0,1,2,3,0,0,0,2,1,0
401020600,Seton Hall Pirates,J. Jones-Pack,4068129,,False,2.0,1,2,1,2,0,0,0,0,1,0,1,0,0,1,0,0,2
401020600,Seton Hall Pirates,D. Winters,4068126,,False,16.0,1,2,1,2,0,0,0,0,1,2,3,0,1,1,1,0,2
401020600,Seton Hall Pirates,K. Hilaire,4068123,,False,19.0,2,8,2,8,0,0,0,0,0,1,1,3,0,0,1,1,4
401020600,Seton Hall Pirates,K. Healy,3943704,,False,5.0,0,0,0,0,0,0,0,0,0,0,0,0,0,0,0,1,0
401020600,Seton Hall Pirates,TEAM,TOTAL,TOTAL,False,,22,54,21,46,1,8,7,13,7,28,35,10,9,3,15,11,52
401020600,Seton Hall Pirates,S. Samuels,4068128,,True,26.0,3,6,3,5,0,1,0,0,0,7,7,1,2,0,2,3,6
401020600,Seton Hall Pirates,K. Evans,4281378,,True,17.0,3,6,3,6,0,0,1,2,1,0,1,0,0,1,2,2,7
401020600,Seton Hall Pirates,N. Jimenez,4281379,,True,26.0,2,10,1,5,1,5,4,4,0,3,3,2,4,0,4,0,9
401020600,Seton Hall Pirates,I. Butina,4281377,,True,30.0,3,8,3,7,0,1,0,0,0,1,1,3,0,0,2,2,6
401020600,Seton Hall Pirates,J. Jackson,3064877,,True,20.0,1,3,1,2,0,1,0,0,0,4,4,0,1,0,1,0,2
401020600,Seton Hall Pirates,S. Philoxy,4281380,,False,22.0,6,8,6,8,0,0,2,7,3,6,9,1,1,0,0,1,14
401020600,Seton Hall Pirates,T. Brown,3941336,,False,17.0,0,1,0,1,0,0,0,0,1,2,3,0,0,0,2,1,0
401020600,Seton Hall Pirates,J. Jones-Pack,4068129,,False,2.0,1,2,1,2,0,0,0,0,1,0,1,0,0,1,0,0,2
401020600,Seton Hall Pirates,D. Winters,4068126,,False,16.0,1,2,1,2,0,0,0,0,1,2,3,0,1,1,1,0,2
401020600,Seton Hall Pirates,K. Hilaire,4068123,,False,19.0,2,8,2,8,0,0,0,0,0,1,1,3,0,0,1,1,4
401020600,Seton Hall Pirates,K. Healy,3943704,,False,5.0,0,0,0,0,0,0,0,0,0,0,0,0,0,0,0,1,0
401020600,Seton Hall Pirates,TEAM,TOTAL,TOTAL,False,,22,54,21,46,1,8,7,13,7,28,35,10,9,3,15,11,52
401020600,DePaul Blue Demons,C. Stonewall,4068072,,True,28.0,5,14,5,11,0,3,1,2,4,6,10,2,0,1,1,1,11
401020600,DePaul Blue Demons,M. Grays,3142287,,True,25.0,7,10,4,5,3,5,4,4,4,6,10,3,1,0,0,2,21
401020600,DePaul Blue Demons,K. Campbell,4068071,,True,31.0,3,12,0,1,3,11,0,0,2,3,5,4,4,1,2,3,9
401020600,DePaul Blue Demons,A. Millender,3142289,,True,33.0,5,10,0,1,5,9,0,0,2,2,4,1,0,0,0,2,15
401020600,DePaul Blue Demons,A. Coleman,3142123,,True,25.0,2,8,0,2,2,6,1,4,1,4,5,1,3,2,7,4,7
401020600,DePaul Blue Demons,R. McLimore,4281358,,False,4.0,1,2,1,2,0,0,0,0,0,1,1,0,0,0,0,0,2
401020600,DePaul Blue Demons,V. Sherrod,4281359,,False,3.0,0,1,0,0,0,1,0,0,0,0,0,1,0,0,0,0,0
401020600,DePaul Blue Demons,D. Bekelja,4281356,,False,6.0,1,4,1,1,0,3,0,0,0,0,0,0,1,0,0,0,2
401020600,DePaul Blue Demons,D. Cage,4068073,,False,4.0,0,1,0,1,0,0,0,0,1,0,1,0,0,0,0,0,0
401020600,DePaul Blue Demons,T. Allen,3933760,,False,20.0,4,9,3,3,1,6,0,0,2,2,4,1,0,0,0,3,9
401020600,DePaul Blue Demons,L. Prochaska,3142290,,False,21.0,1,3,1,3,0,0,0,0,0,2,2,5,0,0,1,1,2
401020600,DePaul Blue Demons,TEAM,TOTAL,TOTAL,False,,29,74,15,30,14,44,6,10,19,29,48,18,9,4,11,16,78
401020600,DePaul Blue Demons,C. Stonewall,4068072,,True,28.0,5,14,5,11,0,3,1,2,4,6,10,2,0,1,1,1,11
401020600,DePaul Blue Demons,M. Grays,3142287,,True,25.0,7,10,4,5,3,5,4,4,4,6,10,3,1,0,0,2,21
401020600,DePaul Blue Demons,K. Campbell,4068071,,True,31.0,3,12,0,1,3,11,0,0,2,3,5,4,4,1,2,3,9
401020600,DePaul Blue Demons,A. Millender,3142289,,True,33.0,5,10,0,1,5,9,0,0,2,2,4,1,0,0,0,2,15
401020600,DePaul Blue Demons,A. Coleman,3142123,,True,25.0,2,8,0,2,2,6,1,4,1,4,5,1,3,2,7,4,7
401020600,DePaul Blue Demons,R. McLimore,4281358,,False,4.0,1,2,1,2,0,0,0,0,0,1,1,0,0,0,0,0,2
401020600,DePaul Blue Demons,V. Sherrod,4281359,,False,3.0,0,1,0,0,0,1,0,0,0,0,0,1,0,0,0,0,0
401020600,DePaul Blue Demons,D. Bekelja,4281356,,False,6.0,1,4,1,1,0,3,0,0,0,0,0,0,1,0,0,0,2
401020600,DePaul Blue Demons,D. Cage,4068073,,False,4.0,0,1,0,1,0,0,0,0,1,0,1,0,0,0,0,0,0
401020600,DePaul Blue Demons,T. Allen,3933760,,False,20.0,4,9,3,3,1,6,0,0,2,2,4,1,0,0,0,3,9
401020600,DePaul Blue Demons,L. Prochaska,3142290,,False,21.0,1,3,1,3,0,0,0,0,0,2,2,5,0,0,1,1,2
401020600,DePaul Blue Demons,TEAM,TOTAL,TOTAL,False,,29,74,15,30,14,44,6,10,19,29,48,18,9,4,11,16,78
401020599,St. John's Red Storm,M. Singleton,4068158,,True,34.0,9,21,9,21,0,0,0,0,5,4,9,1,0,1,0,2,18
401020599,St. John's Red Storm,I. Littleton,3142306,,True,18.0,0,3,0,3,0,0,0,0,1,0,1,0,2,0,0,1,0
401020599,St. John's Red Storm,A. Wellere,3906771,,True,36.0,3,4,3,4,0,0,5,8,1,3,4,2,0,0,1,3,11
401020599,St. John's Red Storm,T. England,4068155,,True,37.0,6,17,5,13,1,4,3,3,1,1,2,1,2,0,0,4,16
401020599,St. John's Red Storm,A. Kebbe,4068154,,True,31.0,2,5,2,4,0,1,1,2,1,3,4,1,3,0,0,2,5
401020599,St. John's Red Storm,K. Charles,4281374,,False,2.0,0,0,0,0,0,0,0,0,0,1,1,0,0,0,0,0,0
401020599,St. John's Red Storm,Q. Hoppie,4281375,,False,28.0,2,4,2,4,0,0,4,4,1,2,3,3,0,0,2,2,8
401020599,St. John's Red Storm,A. Adams,4068157,,False,14.0,0,3,0,2,0,1,0,0,0,0,0,0,0,0,0,1,0
401020599,St. John's Red Storm,TEAM,TOTAL,TOTAL,False,,22,57,21,51,1,6,13,17,10,16,26,8,7,1,3,15,58
401020599,St. John's Red Storm,M. Singleton,4068158,,True,34.0,9,21,9,21,0,0,0,0,5,4,9,1,0,1,0,2,18
401020599,St. John's Red Storm,I. Littleton,3142306,,True,18.0,0,3,0,3,0,0,0,0,1,0,1,0,2,0,0,1,0
401020599,St. John's Red Storm,A. Wellere,3906771,,True,36.0,3,4,3,4,0,0,5,8,1,3,4,2,0,0,1,3,11
401020599,St. John's Red Storm,T. England,4068155,,True,37.0,6,17,5,13,1,4,3,3,1,1,2,1,2,0,0,4,16
401020599,St. John's Red Storm,A. Kebbe,4068154,,True,31.0,2,5,2,4,0,1,1,2,1,3,4,1,3,0,0,2,5
401020599,St. John's Red Storm,K. Charles,4281374,,False,2.0,0,0,0,0,0,0,0,0,0,1,1,0,0,0,0,0,0
401020599,St. John's Red Storm,Q. Hoppie,4281375,,False,28.0,2,4,2,4,0,0,4,4,1,2,3,3,0,0,2,2,8
401020599,St. John's Red Storm,A. Adams,4068157,,False,14.0,0,3,0,2,0,1,0,0,0,0,0,0,0,0,0,1,0
401020599,St. John's Red Storm,TEAM,TOTAL,TOTAL,False,,22,57,21,51,1,6,13,17,10,16,26,8,7,1,3,15,58
401020599,Creighton Bluejays,A. Faber,3938938,,True,33.0,2,8,2,7,0,1,0,0,0,0,0,1,0,0,2,0,4
401020599,Creighton Bluejays,J. Agnew,3938935,,True,35.0,6,12,3,6,3,6,8,8,1,7,8,2,0,1,1,4,23
401020599,Creighton Bluejays,B. Norby,3142284,,True,7.0,0,0,0,0,0,0,0,0,0,0,0,0,0,0,2,0,0
401020599,Creighton Bluejays,S. Lamberty,3142285,,True,40.0,6,11,4,8,2,3,4,4,0,4,4,4,0,1,2,3,18
401020599,Creighton Bluejays,M. Mellman,3142283,,True,8.0,1,1,0,0,1,1,0,0,0,1,1,0,0,0,0,1,3
401020599,Creighton Bluejays,A. Greene,3938937,,False,30.0,3,5,3,5,0,0,0,0,4,2,6,1,0,0,1,2,6
401020599,Creighton Bluejays,T. Carda,4281362,,False,32.0,1,4,1,2,0,2,4,4,1,5,6,3,1,0,2,3,6
401020599,Creighton Bluejays,O. Elger,3938936,,False,15.0,2,3,1,2,1,1,1,3,0,2,2,0,0,2,1,2,6
401020599,Creighton Bluejays,TEAM,TOTAL,TOTAL,False,,21,44,14,30,7,14,17,19,8,27,35,11,1,4,11,15,66
401020599,Creighton Bluejays,A. Faber,3938938,,True,33.0,2,8,2,7,0,1,0,0,0,0,0,1,0,0,2,0,4
401020599,Creighton Bluejays,J. Agnew,3938935,,True,35.0,6,12,3,6,3,6,8,8,1,7,8,2,0,1,1,4,23
401020599,Creighton Bluejays,B. Norby,3142284,,True,7.0,0,0,0,0,0,0,0,0,0,0,0,0,0,0,2,0,0
401020599,Creighton Bluejays,S. Lamberty,3142285,,True,40.0,6,11,4,8,2,3,4,4,0,4,4,4,0,1,2,3,18
401020599,Creighton Bluejays,M. Mellman,3142283,,True,8.0,1,1,0,0,1,1,0,0,0,1,1,0,0,0,0,1,3
401020599,Creighton Bluejays,A. Greene,3938937,,False,30.0,3,5,3,5,0,0,0,0,4,2,6,1,0,0,1,2,6
401020599,Creighton Bluejays,T. Carda,4281362,,False,32.0,1,4,1,2,0,2,4,4,1,5,6,3,1,0,2,3,6
401020599,Creighton Bluejays,O. Elger,3938936,,False,15.0,2,3,1,2,1,1,1,3,0,2,2,0,0,2,1,2,6
401020599,Creighton Bluejays,TEAM,TOTAL,TOTAL,False,,21,44,14,30,7,14,17,19,8,27,35,11,1,4,11,15,66
401020598,Marquette Golden Eagles,E. Davenport,3906756,,True,25.0,1,1,1,1,0,0,2,5,4,2,6,2,0,0,0,4,4
401020598,Marquette Golden Eagles,A. Wilborn,3906758,,True,37.0,9,11,5,5,4,6,4,4,0,6,6,5,2,2,1,2,26
401020598,Marquette Golden Eagles,A. Blockton,3906755,,True,30.0,5,14,4,9,1,5,1,2,2,2,4,1,2,0,0,1,12
401020598,Marquette Golden Eagles,N. Hiedeman,3906753,,True,30.0,5,16,2,6,3,10,2,2,0,1,1,2,1,0,1,2,15
401020598,Marquette Golden Eagles,D. King,3906752,,True,30.0,4,8,3,5,1,3,0,0,0,1,1,4,0,0,1,1,9
401020598,Marquette Golden Eagles,L. Van Kleunen,4068083,,False,24.0,1,4,1,2,0,2,1,2,2,4,6,0,0,0,2,3,3
401020598,Marquette Golden Eagles,S. Valentine,3142300,,False,4.0,0,0,0,0,0,0,0,0,0,1,1,0,0,0,0,0,0
401020598,Marquette Golden Eagles,S. Lott,4281350,,False,16.0,0,2,0,0,0,2,1,2,0,2,2,0,3,1,1,1,1
401020598,Marquette Golden Eagles,I. Spingola,4068082,,False,4.0,1,1,0,0,1,1,0,0,0,0,0,0,0,0,0,2,3
401020598,Marquette Golden Eagles,TEAM,TOTAL,TOTAL,False,,26,57,16,28,10,29,11,17,9,20,29,14,8,3,6,16,73
401020598,Marquette Golden Eagles,E. Davenport,3906756,,True,25.0,1,1,1,1,0,0,2,5,4,2,6,2,0,0,0,4,4
401020598,Marquette Golden Eagles,A. Wilborn,3906758,,True,37.0,9,11,5,5,4,6,4,4,0,6,6,5,2,2,1,2,26
401020598,Marquette Golden Eagles,A. Blockton,3906755,,True,30.0,5,14,4,9,1,5,1,2,2,2,4,1,2,0,0,1,12
401020598,Marquette Golden Eagles,N. Hiedeman,3906753,,True,30.0,5,16,2,6,3,10,2,2,0,1,1,2,1,0,1,2,15
401020598,Marquette Golden Eagles,D. King,3906752,,True,30.0,4,8,3,5,1,3,0,0,0,1,1,4,0,0,1,1,9
401020598,Marquette Golden Eagles,L. Van Kleunen,4068083,,False,24.0,1,4,1,2,0,2,1,2,2,4,6,0,0,0,2,3,3
401020598,Marquette Golden Eagles,S. Valentine,3142300,,False,4.0,0,0,0,0,0,0,0,0,0,1,1,0,0,0,0,0,0
401020598,Marquette Golden Eagles,S. Lott,4281350,,False,16.0,0,2,0,0,0,2,1,2,0,2,2,0,3,1,1,1,1
401020598,Marquette Golden Eagles,I. Spingola,4068082,,False,4.0,1,1,0,0,1,1,0,0,0,0,0,0,0,0,0,2,3
401020598,Marquette Golden Eagles,TEAM,TOTAL,TOTAL,False,,26,57,16,28,10,29,11,17,9,20,29,14,8,3,6,16,73
401020598,Butler Bulldogs,T. Schickel,3914012,,True,38.0,7,13,7,13,0,0,2,3,1,5,6,1,1,1,6,4,16
401020598,Butler Bulldogs,K. Spolyar,4068068,,True,36.0,3,12,1,5,2,7,2,2,0,5,5,1,0,0,2,4,10
401020598,Butler Bulldogs,M. Weaver,3914014,,True,37.0,7,12,5,9,2,3,1,1,4,2,6,5,2,0,2,2,17
401020598,Butler Bulldogs,W. Jennings,3142145,,True,40.0,3,8,3,6,0,2,0,0,1,3,4,0,0,0,4,2,6
401020598,Butler Bulldogs,I. Lathan,3079485,,True,25.0,4,8,4,8,0,0,0,0,2,8,10,2,0,0,0,3,8
401020598,Butler Bulldogs,S. Brey,4068067,,False,19.0,2,6,2,6,0,0,0,0,4,1,5,0,0,0,2,4,4
401020598,Butler Bulldogs,K. Hodges,4068065,,False,1.0,0,0,0,0,0,0,0,0,0,0,0,0,0,0,0,0,0
401020598,Butler Bulldogs,S. Buck,3142279,,False,4.0,0,0,0,0,0,0,0,0,0,0,0,0,0,0,0,0,0
401020598,Butler Bulldogs,TEAM,TOTAL,TOTAL,False,,26,59,22,47,4,12,5,6,14,25,39,9,3,1,17,19,61
401020598,Butler Bulldogs,T. Schickel,3914012,,True,38.0,7,13,7,13,0,0,2,3,1,5,6,1,1,1,6,4,16
401020598,Butler Bulldogs,K. Spolyar,4068068,,True,36.0,3,12,1,5,2,7,2,2,0,5,5,1,0,0,2,4,10
401020598,Butler Bulldogs,M. Weaver,3914014,,True,37.0,7,12,5,9,2,3,1,1,4,2,6,5,2,0,2,2,17
401020598,Butler Bulldogs,W. Jennings,3142145,,True,40.0,3,8,3,6,0,2,0,0,1,3,4,0,0,0,4,2,6
401020598,Butler Bulldogs,I. Lathan,3079485,,True,25.0,4,8,4,8,0,0,0,0,2,8,10,2,0,0,0,3,8
401020598,Butler Bulldogs,S. Brey,4068067,,False,19.0,2,6,2,6,0,0,0,0,4,1,5,0,0,0,2,4,4
401020598,Butler Bulldogs,K. Hodges,4068065,,False,1.0,0,0,0,0,0,0,0,0,0,0,0,0,0,0,0,0,0
401020598,Butler Bulldogs,S. Buck,3142279,,False,4.0,0,0,0,0,0,0,0,0,0,0,0,0,0,0,0,0,0
401020598,Butler Bulldogs,TEAM,TOTAL,TOTAL,False,,26,59,22,47,4,12,5,6,14,25,39,9,3,1,17,19,61
401020588,Providence Friars,A. Cooper,4281349,,True,35.0,4,7,4,7,0,0,0,0,0,2,2,0,0,2,0,4,8
401020588,Providence Friars,O. Orlando,4281347,,True,34.0,4,8,4,8,0,0,0,0,1,4,5,2,1,0,4,3,8
401020588,Providence Friars,C. Williams,4281345,,True,11.0,0,3,0,2,0,1,2,2,0,2,2,2,0,0,2,4,2
401020588,Providence Friars,J. Nogic,3906769,,True,33.0,5,8,3,4,2,4,4,4,0,5,5,2,1,0,1,3,16
401020588,Providence Friars,M. Jolin,3906767,,True,45.0,5,9,2,3,3,6,1,2,2,3,5,1,1,0,5,1,14
401020588,Providence Friars,N. Franklin,4281348,,False,5.0,0,2,0,2,0,0,0,0,1,0,1,0,0,0,1,1,0
401020588,Providence Friars,B. Frias,3142302,,False,5.0,0,1,0,1,0,0,0,0,0,0,0,0,0,0,0,0,0
401020588,Providence Friars,K. Spiwak,4281346,,False,21.0,3,6,3,6,0,0,0,0,0,2,2,1,1,0,0,5,6
401020588,Providence Friars,C. Che,3906766,,False,36.0,5,14,2,7,3,7,0,0,1,3,4,7,2,0,1,0,13
401020588,Providence Friars,TEAM,TOTAL,TOTAL,False,,26,58,18,40,8,18,7,8,6,25,31,15,6,2,16,21,67
401020588,Providence Friars,A. Cooper,4281349,,True,35.0,4,7,4,7,0,0,0,0,0,2,2,0,0,2,0,4,8
401020588,Providence Friars,O. Orlando,4281347,,True,34.0,4,8,4,8,0,0,0,0,1,4,5,2,1,0,4,3,8
401020588,Providence Friars,C. Williams,4281345,,True,11.0,0,3,0,2,0,1,2,2,0,2,2,2,0,0,2,4,2
401020588,Providence Friars,J. Nogic,3906769,,True,33.0,5,8,3,4,2,4,4,4,0,5,5,2,1,0,1,3,16
401020588,Providence Friars,M. Jolin,3906767,,True,45.0,5,9,2,3,3,6,1,2,2,3,5,1,1,0,5,1,14
401020588,Providence Friars,N. Franklin,4281348,,False,5.0,0,2,0,2,0,0,0,0,1,0,1,0,0,0,1,1,0
401020588,Providence Friars,B. Frias,3142302,,False,5.0,0,1,0,1,0,0,0,0,0,0,0,0,0,0,0,0,0
401020588,Providence Friars,K. Spiwak,4281346,,False,21.0,3,6,3,6,0,0,0,0,0,2,2,1,1,0,0,5,6
401020588,Providence Friars,C. Che,3906766,,False,36.0,5,14,2,7,3,7,0,0,1,3,4,7,2,0,1,0,13
401020588,Providence Friars,TEAM,TOTAL,TOTAL,False,,26,58,18,40,8,18,7,8,6,25,31,15,6,2,16,21,67
401020588,Butler Bulldogs,T. Schickel,3914012,,True,43.0,2,6,2,6,0,0,13,16,5,6,11,1,0,5,4,1,17
401020588,Butler Bulldogs,S. Brey,4068067,,True,29.0,1,3,1,3,0,0,0,0,3,2,5,0,1,0,3,0,2
401020588,Butler Bulldogs,K. Spolyar,4068068,,True,39.0,8,21,4,10,4,11,1,3,0,5,5,2,3,0,3,3,21
401020588,Butler Bulldogs,M. Weaver,3914014,,True,34.0,3,6,2,5,1,1,0,0,0,1,1,2,0,0,1,4,7
401020588,Butler Bulldogs,W. Jennings,3142145,,True,43.0,6,15,5,10,1,5,7,9,0,2,2,6,1,0,0,1,20
401020588,Butler Bulldogs,K. Hodges,4068065,,False,4.0,0,0,0,0,0,0,0,0,1,0,1,0,0,0,0,1,0
401020588,Butler Bulldogs,S. Buck,3142279,,False,8.0,2,4,0,0,2,4,0,0,0,0,0,0,0,0,1,0,6
401020588,Butler Bulldogs,I. Lathan,3079485,,False,25.0,0,3,0,3,0,0,0,0,2,7,9,2,1,0,0,3,0
401020588,Butler Bulldogs,TEAM,TOTAL,TOTAL,False,,22,58,14,37,8,21,21,28,12,24,36,13,6,5,12,13,73
401020588,Butler Bulldogs,T. Schickel,3914012,,True,43.0,2,6,2,6,0,0,13,16,5,6,11,1,0,5,4,1,17
401020588,Butler Bulldogs,S. Brey,4068067,,True,29.0,1,3,1,3,0,0,0,0,3,2,5,0,1,0,3,0,2
401020588,Butler Bulldogs,K. Spolyar,4068068,,True,39.0,8,21,4,10,4,11,1,3,0,5,5,2,3,0,3,3,21
401020588,Butler Bulldogs,M. Weaver,3914014,,True,34.0,3,6,2,5,1,1,0,0,0,1,1,2,0,0,1,4,7
401020588,Butler Bulldogs,W. Jennings,3142145,,True,43.0,6,15,5,10,1,5,7,9,0,2,2,6,1,0,0,1,20
401020588,Butler Bulldogs,K. Hodges,4068065,,False,4.0,0,0,0,0,0,0,0,0,1,0,1,0,0,0,0,1,0
401020588,Butler Bulldogs,S. Buck,3142279,,False,8.0,2,4,0,0,2,4,0,0,0,0,0,0,0,0,1,0,6
401020588,Butler Bulldogs,I. Lathan,3079485,,False,25.0,0,3,0,3,0,0,0,0,2,7,9,2,1,0,0,3,0
401020588,Butler Bulldogs,TEAM,TOTAL,TOTAL,False,,22,58,14,37,8,21,21,28,12,24,36,13,6,5,12,13,73
401020587,Xavier Musketeers,I. Partlow,3142320,,True,17.0,2,6,2,5,0,1,5,6,2,1,3,1,1,0,1,0,9
401020587,Xavier Musketeers,A. Aijanen,3142319,,True,21.0,0,4,0,1,0,3,4,6,0,1,1,1,0,0,0,1,4
401020587,Xavier Musketeers,N. Owens,4068187,,True,19.0,0,3,0,1,0,2,0,0,1,2,3,2,1,1,3,2,0
401020587,Xavier Musketeers,J. Byrd,3142318,,True,30.0,2,7,2,7,0,0,1,5,1,2,3,2,1,0,1,1,5
401020587,Xavier Musketeers,K. Fincher,3142317,,True,15.0,2,6,0,1,2,5,0,0,0,0,0,0,0,0,0,0,6
401020587,Xavier Musketeers,A. Gray,4281368,,False,11.0,0,3,0,2,0,1,0,0,1,2,3,0,1,0,2,3,0
401020587,Xavier Musketeers,D. Ross,4281364,,False,22.0,2,8,0,0,2,8,2,2,1,3,4,0,2,2,1,1,8
401020587,Xavier Musketeers,M. Christopher,4068186,,False,7.0,1,2,1,1,0,1,0,0,1,0,1,0,0,0,1,0,2
401020587,Xavier Musketeers,A. Reiff,4281367,,False,6.0,0,3,0,1,0,2,0,0,0,0,0,0,0,0,0,0,0
401020587,Xavier Musketeers,P. Stewart,4281366,,False,19.0,2,6,1,2,1,4,0,0,0,4,4,0,0,0,0,0,5
401020587,Xavier Musketeers,A. Dunham,4281365,,False,26.0,1,4,0,0,1,4,0,0,0,1,1,2,0,0,0,1,3
401020587,Xavier Musketeers,A. Gomez,4068185,,False,7.0,0,1,0,0,0,1,0,0,0,1,1,0,0,0,0,0,0
401020587,Xavier Musketeers,TEAM,TOTAL,TOTAL,False,,12,53,6,21,6,32,12,19,10,20,30,8,6,3,10,9,42
401020587,Xavier Musketeers,I. Partlow,3142320,,True,17.0,2,6,2,5,0,1,5,6,2,1,3,1,1,0,1,0,9
401020587,Xavier Musketeers,A. Aijanen,3142319,,True,21.0,0,4,0,1,0,3,4,6,0,1,1,1,0,0,0,1,4
401020587,Xavier Musketeers,N. Owens,4068187,,True,19.0,0,3,0,1,0,2,0,0,1,2,3,2,1,1,3,2,0
401020587,Xavier Musketeers,J. Byrd,3142318,,True,30.0,2,7,2,7,0,0,1,5,1,2,3,2,1,0,1,1,5
401020587,Xavier Musketeers,K. Fincher,3142317,,True,15.0,2,6,0,1,2,5,0,0,0,0,0,0,0,0,0,0,6
401020587,Xavier Musketeers,A. Gray,4281368,,False,11.0,0,3,0,2,0,1,0,0,1,2,3,0,1,0,2,3,0
401020587,Xavier Musketeers,D. Ross,4281364,,False,22.0,2,8,0,0,2,8,2,2,1,3,4,0,2,2,1,1,8
401020587,Xavier Musketeers,M. Christopher,4068186,,False,7.0,1,2,1,1,0,1,0,0,1,0,1,0,0,0,1,0,2
401020587,Xavier Musketeers,A. Reiff,4281367,,False,6.0,0,3,0,1,0,2,0,0,0,0,0,0,0,0,0,0,0
401020587,Xavier Musketeers,P. Stewart,4281366,,False,19.0,2,6,1,2,1,4,0,0,0,4,4,0,0,0,0,0,5
401020587,Xavier Musketeers,A. Dunham,4281365,,False,26.0,1,4,0,0,1,4,0,0,0,1,1,2,0,0,0,1,3
401020587,Xavier Musketeers,A. Gomez,4068185,,False,7.0,0,1,0,0,0,1,0,0,0,1,1,0,0,0,0,0,0
401020587,Xavier Musketeers,TEAM,TOTAL,TOTAL,False,,12,53,6,21,6,32,12,19,10,20,30,8,6,3,10,9,42
401020587,Seton Hall Pirates,S. Samuels,4068128,,True,25.0,4,9,3,5,1,4,1,2,2,7,9,1,1,1,0,2,10
401020587,Seton Hall Pirates,K. Evans,4281378,,True,14.0,1,3,1,3,0,0,0,0,2,4,6,1,0,0,2,3,2
401020587,Seton Hall Pirates,N. Jimenez,4281379,,True,29.0,4,10,2,6,2,4,2,2,0,7,7,2,2,0,2,2,12
401020587,Seton Hall Pirates,I. Butina,4281377,,True,24.0,4,5,4,5,0,0,0,1,1,2,3,5,0,0,0,3,8
401020587,Seton Hall Pirates,J. Jackson,3064877,,True,23.0,3,6,1,2,2,4,0,0,0,2,2,1,0,0,1,1,8
401020587,Seton Hall Pirates,S. Philoxy,4281380,,False,17.0,5,8,5,8,0,0,0,0,4,2,6,0,0,1,1,2,10
401020587,Seton Hall Pirates,T. Brown,3941336,,False,22.0,3,6,3,5,0,1,1,2,1,5,6,0,0,0,1,1,7
401020587,Seton Hall Pirates,J. Jones-Pack,4068129,,False,6.0,1,2,0,0,1,2,0,0,0,1,1,0,1,0,0,0,3
401020587,Seton Hall Pirates,D. Winters,4068126,,False,8.0,1,1,1,1,0,0,0,0,0,2,2,1,0,0,1,2,2
401020587,Seton Hall Pirates,K. Hilaire,4068123,,False,22.0,2,5,2,4,0,1,0,0,0,0,0,4,0,0,3,1,4
401020587,Seton Hall Pirates,K. Healy,3943704,,False,10.0,0,1,0,0,0,1,0,0,0,0,0,0,0,0,1,0,0
401020587,Seton Hall Pirates,TEAM,TOTAL,TOTAL,False,,28,56,22,39,6,17,4,7,10,35,45,15,4,2,14,17,66
401020587,Seton Hall Pirates,S. Samuels,4068128,,True,25.0,4,9,3,5,1,4,1,2,2,7,9,1,1,1,0,2,10
401020587,Seton Hall Pirates,K. Evans,4281378,,True,14.0,1,3,1,3,0,0,0,0,2,4,6,1,0,0,2,3,2
401020587,Seton Hall Pirates,N. Jimenez,4281379,,True,29.0,4,10,2,6,2,4,2,2,0,7,7,2,2,0,2,2,12
401020587,Seton Hall Pirates,I. Butina,4281377,,True,24.0,4,5,4,5,0,0,0,1,1,2,3,5,0,0,0,3,8
401020587,Seton Hall Pirates,J. Jackson,3064877,,True,23.0,3,6,1,2,2,4,0,0,0,2,2,1,0,0,1,1,8
401020587,Seton Hall Pirates,S. Philoxy,4281380,,False,17.0,5,8,5,8,0,0,0,0,4,2,6,0,0,1,1,2,10
401020587,Seton Hall Pirates,T. Brown,3941336,,False,22.0,3,6,3,5,0,1,1,2,1,5,6,0,0,0,1,1,7
401020587,Seton Hall Pirates,J. Jones-Pack,4068129,,False,6.0,1,2,0,0,1,2,0,0,0,1,1,0,1,0,0,0,3
401020587,Seton Hall Pirates,D. Winters,4068126,,False,8.0,1,1,1,1,0,0,0,0,0,2,2,1,0,0,1,2,2
401020587,Seton Hall Pirates,K. Hilaire,4068123,,False,22.0,2,5,2,4,0,1,0,0,0,0,0,4,0,0,3,1,4
401020587,Seton Hall Pirates,K. Healy,3943704,,False,10.0,0,1,0,0,0,1,0,0,0,0,0,0,0,0,1,0,0
401020587,Seton Hall Pirates,TEAM,TOTAL,TOTAL,False,,28,56,22,39,6,17,4,7,10,35,45,15,4,2,14,17,66
401002976,Rhode Island Rams,J. Ross,3908501,,True,38.0,2,6,1,5,1,1,0,0,1,4,5,3,0,0,2,1,5
401002976,Rhode Island Rams,A. Streeter,4281859,,True,30.0,2,10,1,1,1,9,0,0,0,4,4,0,0,0,2,0,5
401002976,Rhode Island Rams,M. Vargas,4281857,,True,33.0,1,6,0,0,1,6,0,0,0,2,2,3,0,0,5,0,3
401002976,Rhode Island Rams,E. Lassiter,4068571,,True,29.0,2,8,1,4,1,4,0,0,3,3,6,1,0,3,3,2,5
401002976,Rhode Island Rams,L. Perez,3943734,,True,27.0,1,2,0,0,1,2,0,0,1,2,3,1,0,0,1,1,3
401002976,Rhode Island Rams,M. Oberg,4068575,,False,1.0,0,0,0,0,0,0,0,0,0,0,0,0,0,0,1,1,0
401002976,Rhode Island Rams,N. Jorgensen,4068574,,False,22.0,6,9,6,9,0,0,2,2,3,2,5,2,0,1,2,3,14
401002976,Rhode Island Rams,K. Gagan,4281858,,False,3.0,0,0,0,0,0,0,0,0,0,1,1,0,0,0,1,1,0
401002976,Rhode Island Rams,M. Moffitt,4281856,,False,3.0,1,2,0,0,1,2,0,0,0,2,2,1,0,0,1,1,3
401002976,Rhode Island Rams,E. Colome,3907009,,False,14.0,1,4,0,1,1,3,0,0,0,2,2,1,0,0,3,4,3
401002976,Rhode Island Rams,TEAM,TOTAL,TOTAL,False,,16,47,9,20,7,27,2,2,8,25,33,12,0,4,21,14,41
401002976,Providence Friars,N. Franklin,4281348,,True,22.0,2,5,2,5,0,0,0,2,1,2,3,0,0,1,1,2,4
401002976,Providence Friars,B. Frias,3142302,,True,27.0,2,5,2,5,0,0,0,0,2,0,2,0,0,0,0,2,4
401002976,Providence Friars,N. Jackson,4068111,,True,18.0,0,2,0,2,0,0,0,0,2,3,5,5,1,0,1,1,0
401002976,Providence Friars,J. Nogic,3906769,,True,24.0,6,16,1,4,5,12,0,0,1,2,3,4,2,0,0,0,17
401002976,Providence Friars,M. Jolin,3906767,,True,29.0,5,9,1,1,4,8,0,0,0,6,6,3,2,0,3,0,14
401002976,Providence Friars,A. Cooper,4281349,,False,10.0,2,4,2,4,0,0,0,0,0,1,1,0,0,1,0,2,4
401002976,Providence Friars,O. Orlando,4281347,,False,10.0,0,0,0,0,0,0,0,0,0,1,1,0,2,0,0,0,0
401002976,Providence Friars,K. Spiwak,4281346,,False,5.0,1,2,1,2,0,0,1,1,0,1,1,0,0,0,0,0,3
401002976,Providence Friars,C. Williams,4281345,,False,22.0,3,8,3,8,0,0,0,0,2,0,2,2,2,0,1,2,6
401002976,Providence Friars,C. Che,3906766,,False,19.0,4,6,3,5,1,1,0,0,0,2,2,1,0,0,0,0,9
401002976,Providence Friars,A. Botteghi,3142301,,False,14.0,2,4,2,4,0,0,0,0,1,0,1,1,0,0,1,0,4
401002976,Providence Friars,TEAM,TOTAL,TOTAL,False,,27,61,17,40,10,21,1,3,10,22,32,16,9,2,7,9,65
401002490,St. John's Red Storm,M. Singleton,4068158,,True,37.0,5,9,5,9,0,0,1,2,5,6,11,1,1,2,2,2,11
401002490,St. John's Red Storm,A. Wellere,3906771,,True,38.0,4,16,3,9,1,7,2,2,1,0,1,4,1,0,1,5,11
401002490,St. John's Red Storm,A. Adams,4068157,,True,38.0,6,16,3,8,3,8,0,0,2,1,3,2,1,1,0,4,15
401002490,St. John's Red Storm,T. England,4068155,,True,35.0,2,8,2,7,0,1,2,2,0,4,4,5,1,0,1,0,6
401002490,St. John's Red Storm,A. Kebbe,4068154,,True,31.0,1,2,1,2,0,0,0,0,3,5,8,1,0,0,2,3,2
401002490,St. John's Red Storm,K. Charles,4281374,,False,3.0,1,1,1,1,0,0,0,0,0,0,0,0,0,0,0,1,2
401002490,St. John's Red Storm,Q. Hoppie,4281375,,False,18.0,4,12,2,5,2,7,2,2,0,1,1,0,0,0,0,2,12
401002490,St. John's Red Storm,TEAM,TOTAL,TOTAL,False,,23,64,17,41,6,23,7,8,12,20,32,13,4,3,6,17,59
401002490,South Florida Bulls,T. Henshaw,4068150,,True,32.0,1,4,1,4,0,0,0,2,4,4,8,0,0,1,1,3,2
401002490,South Florida Bulls,M. Jespersen,3142676,,True,40.0,7,10,3,6,4,4,7,8,3,4,7,2,0,0,3,0,25
401002490,South Florida Bulls,L. Ferreira,3142674,,True,40.0,4,9,1,1,3,8,1,2,0,7,7,2,0,0,1,0,12
401002490,South Florida Bulls,K. Laksa,3920741,,True,35.0,6,18,4,12,2,6,4,4,1,7,8,2,1,0,0,1,18
401002490,South Florida Bulls,L. Flores,3142675,,True,33.0,1,3,1,3,0,0,2,2,0,4,4,4,0,0,1,1,4
401002490,South Florida Bulls,S. Serrat,4281119,,False,0.0,0,1,0,1,0,0,0,0,0,0,0,0,0,0,0,0,0
401002490,South Florida Bulls,V. Blagmon,4281118,,False,2.0,0,0,0,0,0,0,0,0,0,0,0,0,0,0,0,0,0
401002490,South Florida Bulls,A. Prieto,4281117,,False,15.0,3,5,2,2,1,3,0,0,0,2,2,0,0,0,2,3,7
401002490,South Florida Bulls,E. Pehadzic,4068151,,False,3.0,0,1,0,1,0,0,0,0,0,1,1,0,0,0,0,1,0
401002490,South Florida Bulls,TEAM,TOTAL,TOTAL,False,,22,51,12,30,10,21,14,18,10,29,39,10,1,1,9,9,68
401002477,Seton Hall Pirates,S. Samuels,4068128,,True,25.0,6,8,5,6,1,2,5,7,3,8,11,1,2,0,2,4,18
401002477,Seton Hall Pirates,T. Brown,3941336,,True,29.0,7,14,6,13,1,1,4,4,3,5,8,0,3,3,4,2,19
401002477,Seton Hall Pirates,D. Fountain,3058890,,True,17.0,1,8,1,6,0,2,0,0,0,2,2,0,2,0,4,3,2
401002477,Seton Hall Pirates,I. Butina,4281377,,True,31.0,2,3,2,3,0,0,0,0,2,3,5,4,2,0,2,1,4
401002477,Seton Hall Pirates,J. Jackson,3064877,,True,26.0,5,12,2,5,3,7,5,5,0,2,2,0,0,0,0,1,18
401002477,Seton Hall Pirates,S. Philoxy,4281380,,False,8.0,1,2,1,2,0,0,0,0,2,1,3,0,1,0,2,3,2
401002477,Seton Hall Pirates,K. Evans,4281378,,False,9.0,1,1,1,1,0,0,0,2,0,0,0,0,0,0,0,1,2
401002477,Seton Hall Pirates,J. Jones-Pack,4068129,,False,2.0,0,0,0,0,0,0,0,0,0,0,0,0,0,0,0,0,0
401002477,Seton Hall Pirates,D. Winters,4068126,,False,10.0,0,2,0,0,0,2,0,0,0,0,0,0,3,0,1,0,0
401002477,Seton Hall Pirates,N. Jimenez,4281379,,False,12.0,0,0,0,0,0,0,0,0,0,2,2,0,0,0,2,1,0
401002477,Seton Hall Pirates,T. Smith,4068124,,False,2.0,0,2,0,2,0,0,0,0,1,0,1,0,0,0,0,1,0
401002477,Seton Hall Pirates,K. Hilaire,4068123,,False,28.0,3,6,3,5,0,1,2,2,1,4,5,7,1,0,1,2,8
401002477,Seton Hall Pirates,K. Healy,3943704,,False,1.0,0,0,0,0,0,0,0,0,0,0,0,0,0,0,0,0,0
401002477,Seton Hall Pirates,TEAM,TOTAL,TOTAL,False,,26,58,21,43,5,15,16,20,13,27,40,12,14,3,19,19,73
401002477,Jacksonville State Gamecocks,T. Magruder,4069174,,True,21.0,0,3,0,3,0,0,1,4,1,4,5,0,2,1,1,2,1
401002477,Jacksonville State Gamecocks,T. Phelion,3146545,,True,17.0,3,6,1,3,2,3,1,2,0,5,5,0,2,1,2,2,9
401002477,Jacksonville State Gamecocks,B. Perry,4282441,,True,20.0,3,14,3,10,0,4,1,2,0,0,0,3,1,0,4,1,7
401002477,Jacksonville State Gamecocks,K. Patterson,4069172,,True,18.0,1,3,0,2,1,1,0,0,1,1,2,1,1,0,2,2,3
401002477,Jacksonville State Gamecocks,G. Morrison,3146544,,True,30.0,1,5,0,1,1,4,1,2,1,2,3,1,0,0,2,1,4
401002477,Jacksonville State Gamecocks,R. Pearson,3934248,,False,26.0,6,10,6,10,0,0,1,4,5,3,8,1,2,0,2,2,13
401002477,Jacksonville State Gamecocks,C. Long,3934246,,False,16.0,2,3,2,3,0,0,3,4,3,3,6,1,0,0,1,3,7
401002477,Jacksonville State Gamecocks,J. Walker,4282442,,False,1.0,1,1,0,0,1,1,0,0,0,0,0,0,0,0,0,0,3
401002477,Jacksonville State Gamecocks,K. Johnson,4282440,,False,1.0,0,1,0,1,0,0,0,0,0,0,0,0,0,0,0,0,0
401002477,Jacksonville State Gamecocks,T. Hawks,4282437,,False,15.0,0,2,0,1,0,1,0,0,0,1,1,2,1,0,5,2,0
401002477,Jacksonville State Gamecocks,M. Lawrence,4069173,,False,12.0,2,3,1,1,1,2,0,0,0,0,0,1,0,0,0,1,5
401002477,Jacksonville State Gamecocks,M. Towells,4069171,,False,18.0,1,5,1,3,0,2,0,0,0,2,2,0,0,0,1,1,2
401002477,Jacksonville State Gamecocks,L. Strain,3146542,,False,5.0,0,0,0,0,0,0,0,0,0,0,0,0,0,0,1,0,0
401002477,Jacksonville State Gamecocks,TEAM,TOTAL,TOTAL,False,,20,56,14,38,6,18,8,18,12,21,33,10,9,2,21,17,54
401002352,Villanova Wildcats,M. Quinn,3056785,,True,17.0,5,8,3,4,2,4,0,0,2,5,7,0,1,0,1,0,12
401002352,Villanova Wildcats,K. Jekot,4068171,,True,34.0,4,10,2,6,2,4,4,6,2,3,5,0,1,2,1,1,14
401002352,Villanova Wildcats,A. Hahn,3906779,,True,31.0,5,11,0,0,5,11,1,4,0,4,4,1,0,0,0,3,16
401002352,Villanova Wildcats,A. Louin,3142314,,True,30.0,2,8,2,7,0,1,4,7,3,4,7,5,0,2,1,0,8
401002352,Villanova Wildcats,J. Tucker,3087536,,True,30.0,0,10,0,3,0,7,0,0,0,2,2,2,2,1,2,3,0
401002352,Villanova Wildcats,M. Gedaka,4068172,,False,18.0,2,6,2,4,0,2,6,6,3,1,4,1,1,1,3,3,10
401002352,Villanova Wildcats,B. Herlihy,4068169,,False,5.0,0,0,0,0,0,0,0,0,0,0,0,0,0,0,0,1,0
401002352,Villanova Wildcats,B. Herlihy,3906778,,False,11.0,2,4,1,2,1,2,0,0,0,2,2,0,0,1,1,3,5
401002352,Villanova Wildcats,G. Stant,3906780,,False,11.0,0,1,0,1,0,0,0,0,0,2,2,0,0,0,0,0,0
401002352,Villanova Wildcats,R. James,4068168,,False,6.0,0,1,0,1,0,0,0,0,0,1,1,0,0,0,0,2,0
401002352,Villanova Wildcats,C. Onken,4068167,,False,8.0,0,1,0,0,0,1,0,0,2,0,2,0,1,0,0,0,0
401002352,Villanova Wildcats,TEAM,TOTAL,TOTAL,False,,20,60,10,28,10,32,15,23,13,29,42,9,6,7,9,16,65
401002352,American University Eagles,C. Carl,3945270,,True,28.0,5,12,4,10,1,2,0,0,1,13,14,1,0,1,0,2,11
401002352,American University Eagles,M. Harris,3156948,,True,22.0,1,5,0,3,1,2,0,0,1,1,2,0,0,0,1,2,3
401002352,American University Eagles,E. Koskimies,3945269,,True,17.0,3,4,1,1,2,3,0,0,1,3,4,0,0,0,1,3,8
401002352,American University Eagles,M. Liddane,3156946,,True,16.0,2,3,2,2,0,1,2,2,0,0,0,0,0,0,2,3,6
401002352,American University Eagles,E. Kinneston,3156945,,True,32.0,5,14,5,10,0,4,0,0,4,4,8,2,1,1,1,1,10
401002352,American University Eagles,M. Royle,4280987,,False,10.0,2,6,2,4,0,2,3,4,0,1,1,0,0,0,0,0,7
401002352,American University Eagles,T. Cleveland,4068226,,False,5.0,1,1,0,0,1,1,0,0,0,0,0,0,0,0,0,0,3
401002352,American University Eagles,I. Chaney,3152148,,False,11.0,0,1,0,1,0,0,0,0,0,2,2,0,1,0,2,1,0
401002352,American University Eagles,I. Sanders,4280986,,False,8.0,1,1,0,0,1,1,0,0,0,1,1,0,0,0,1,0,3
401002352,American University Eagles,K. Marenyi,4068227,,False,24.0,1,6,1,4,0,2,0,0,2,3,5,2,0,0,2,2,2
401002352,American University Eagles,K. Lewis,3945430,,False,25.0,2,12,1,4,1,8,2,2,0,1,1,1,0,0,1,2,7
401002352,American University Eagles,K. Bond,3156947,,False,2.0,0,0,0,0,0,0,0,0,0,0,0,0,0,0,0,0,0
401002352,American University Eagles,TEAM,TOTAL,TOTAL,False,,23,65,16,39,7,26,7,8,13,30,43,6,2,2,11,16,60
401002197,Gonzaga Bulldogs,Z. Rice,3920719,,True,24.0,4,6,4,6,0,0,4,6,1,3,4,0,0,0,6,2,12
401002197,Gonzaga Bulldogs,J. Barta,3156496,,True,31.0,3,9,3,7,0,2,4,4,4,4,8,1,1,1,3,1,10
401002197,Gonzaga Bulldogs,J. Loera,4068324,,True,33.0,3,13,1,6,2,7,0,0,2,2,4,7,4,0,1,1,8
401002197,Gonzaga Bulldogs,C. Smith,3920720,,True,32.0,7,13,4,7,3,6,2,2,1,2,3,1,0,1,5,0,19
401002197,Gonzaga Bulldogs,E. Stach,3156498,,True,26.0,2,6,2,5,0,1,0,0,0,2,2,0,0,0,3,1,4
401002197,Gonzaga Bulldogs,L. Wirth,4281997,,False,8.0,1,1,1,1,0,0,0,0,1,1,2,0,0,0,0,0,2
401002197,Gonzaga Bulldogs,J. Wirth,4281996,,False,18.0,1,1,1,1,0,0,3,3,0,1,1,0,0,0,0,0,5
401002197,Gonzaga Bulldogs,J. Townsend,4282001,,False,22.0,4,10,3,6,1,4,2,3,2,2,4,3,2,0,0,2,11
401002197,Gonzaga Bulldogs,K. Campbell,4282000,,False,6.0,0,1,0,0,0,1,0,0,0,0,0,0,0,0,0,1,0
401002197,Gonzaga Bulldogs,TEAM,TOTAL,TOTAL,False,,25,60,19,39,6,21,15,18,13,19,32,12,7,2,18,8,71
401002197,DePaul Blue Demons,M. Grays,3142287,,True,27.0,4,7,1,4,3,3,1,2,1,2,3,1,1,0,3,3,12
401002197,DePaul Blue Demons,K. Campbell,4068071,,True,36.0,6,10,4,5,2,5,5,5,2,6,8,8,2,0,2,2,19
401002197,DePaul Blue Demons,T. Allen,3933760,,True,33.0,6,11,3,4,3,7,0,0,0,5,5,5,3,0,4,3,15
401002197,DePaul Blue Demons,A. Millender,3142289,,True,35.0,5,11,2,3,3,8,2,2,0,1,1,1,2,0,3,1,15
401002197,DePaul Blue Demons,A. Coleman,3142123,,True,14.0,3,4,0,0,3,4,1,2,0,1,1,0,0,0,1,4,10
401002197,DePaul Blue Demons,R. McLimore,4281358,,False,7.0,1,1,1,1,0,0,0,0,0,1,1,0,1,0,0,0,2
401002197,DePaul Blue Demons,C. Stonewall,4068072,,False,18.0,4,6,2,4,2,2,0,0,1,1,2,1,2,0,0,4,10
401002197,DePaul Blue Demons,V. Sherrod,4281359,,False,2.0,0,0,0,0,0,0,0,0,0,0,0,0,0,0,1,0,0
401002197,DePaul Blue Demons,D. Bekelja,4281356,,False,6.0,1,1,1,1,0,0,0,0,0,0,0,0,0,0,0,0,2
401002197,DePaul Blue Demons,L. Prochaska,3142290,,False,22.0,1,2,0,1,1,1,0,0,1,3,4,3,1,0,2,2,3
401002197,DePaul Blue Demons,TEAM,TOTAL,TOTAL,False,,31,53,14,23,17,30,9,11,5,21,26,19,12,0,16,19,88
401002192,St. John's Red Storm,M. Singleton,4068158,,True,34.0,4,11,4,11,0,0,1,2,0,3,3,0,1,0,3,5,9
401002192,St. John's Red Storm,A. Wellere,3906771,,True,30.0,4,8,1,3,3,5,3,4,0,3,3,0,0,0,4,5,14
401002192,St. John's Red Storm,A. Adams,4068157,,True,28.0,1,6,0,2,1,4,2,2,0,1,1,0,1,0,1,3,5
401002192,St. John's Red Storm,T. England,4068155,,True,36.0,4,15,4,12,0,3,1,2,1,2,3,10,1,0,1,0,9
401002192,St. John's Red Storm,A. Kebbe,4068154,,True,28.0,2,6,1,4,1,2,4,4,5,1,6,1,1,1,1,4,9
401002192,St. John's Red Storm,K. Charles,4281374,,False,17.0,2,4,2,4,0,0,4,8,6,4,10,0,1,0,1,5,8
401002192,St. John's Red Storm,Q. Hoppie,4281375,,False,27.0,1,8,1,7,0,1,2,2,0,1,1,0,1,0,1,0,4
401002192,St. John's Red Storm,T. Alexander,3142305,,False,0.0,0,0,0,0,0,0,0,0,0,0,0,0,0,0,0,0,0
401002192,St. John's Red Storm,TEAM,TOTAL,TOTAL,False,,18,58,13,43,5,15,17,24,13,19,32,11,6,1,12,22,58
401002192,South Carolina Gamecocks,A. Wilson,3149391,,True,28.0,5,7,4,6,1,1,6,8,1,16,17,2,0,3,4,3,17
401002192,South Carolina Gamecocks,A. Jennings,3142914,,True,31.0,10,15,10,14,0,1,5,6,2,2,4,1,0,0,1,2,25
401002192,South Carolina Gamecocks,T. Harris,4065760,,True,36.0,3,10,2,5,1,5,1,2,0,2,2,3,1,1,4,4,8
401002192,South Carolina Gamecocks,D. Cliney,3149390,,True,33.0,2,6,2,4,0,2,1,2,0,4,4,5,1,0,3,3,5
401002192,South Carolina Gamecocks,L. Spann,3064566,,True,20.0,2,3,1,2,1,1,0,0,0,0,0,1,0,0,2,4,5
401002192,South Carolina Gamecocks,L. Williams,4280886,,False,2.0,0,0,0,0,0,0,1,2,0,0,0,0,0,0,1,2,1
401002192,South Carolina Gamecocks,M. Herbert Harrigan,4065759,,False,20.0,2,3,2,2,0,1,0,0,0,3,3,1,0,0,2,4,4
401002192,South Carolina Gamecocks,L. Grissett,4280887,,False,6.0,0,0,0,0,0,0,3,4,0,1,1,0,0,0,1,1,3
401002192,South Carolina Gamecocks,B. Jackson,4280885,,False,21.0,2,4,0,1,2,3,2,2,1,2,3,1,0,0,0,2,8
401002192,South Carolina Gamecocks,V. Patrick,4065757,,False,3.0,0,0,0,0,0,0,0,0,0,0,0,0,0,0,0,0,0
401002192,South Carolina Gamecocks,TEAM,TOTAL,TOTAL,False,,26,48,21,34,5,14,19,26,7,32,39,14,2,4,18,25,76
401002177,Memphis Tigers,J. James,4281127,,True,28.0,2,5,2,5,0,0,0,0,1,4,5,1,0,0,5,1,4
401002177,Memphis Tigers,C. Creighton,3142351,,True,36.0,8,14,8,13,0,1,6,8,4,6,10,1,0,1,6,4,22
401002177,Memphis Tigers,T. Barnes,4068044,,True,32.0,4,4,3,3,1,1,3,4,1,7,8,1,1,0,4,4,12
401002177,Memphis Tigers,B. Elmore,3142352,,True,34.0,6,17,3,12,3,5,1,2,0,7,7,2,1,2,5,3,16
401002177,Memphis Tigers,B. Wilder-Cochran,3054121,,True,26.0,0,1,0,1,0,0,2,2,1,6,7,3,0,0,3,2,2
401002177,Memphis Tigers,A. Davis,4281126,,False,16.0,2,3,2,3,0,0,3,4,2,1,3,2,2,0,1,2,7
401002177,Memphis Tigers,J. Stinson,4281124,,False,5.0,0,0,0,0,0,0,0,0,0,1,1,0,0,0,3,0,0
401002177,Memphis Tigers,A. Dean,4068045,,False,23.0,2,7,2,4,0,3,0,0,0,1,1,0,1,0,3,2,4
401002177,Memphis Tigers,TEAM,TOTAL,TOTAL,False,,24,51,20,41,4,10,15,20,9,35,44,10,5,3,30,18,67
401002177,DePaul Blue Demons,M. Grays,3142287,,True,15.0,3,8,3,5,0,3,4,4,0,1,1,2,0,0,2,2,10
401002177,DePaul Blue Demons,K. Campbell,4068071,,True,33.0,1,7,1,3,0,4,5,5,2,4,6,4,6,0,1,3,7
401002177,DePaul Blue Demons,T. Allen,3933760,,True,23.0,6,13,4,8,2,5,1,3,2,5,7,4,3,0,1,3,15
401002177,DePaul Blue Demons,A. Millender,3142289,,True,33.0,4,8,2,4,2,4,0,0,2,0,2,0,3,0,1,1,10
401002177,DePaul Blue Demons,A. Coleman,3142123,,True,32.0,5,13,3,6,2,7,1,1,2,4,6,6,1,0,3,2,13
401002177,DePaul Blue Demons,R. McLimore,4281358,,False,13.0,2,7,0,2,2,5,0,0,0,0,0,1,0,0,1,4,6
401002177,DePaul Blue Demons,C. Stonewall,4068072,,False,25.0,5,10,5,7,0,3,2,2,2,2,4,1,1,0,2,4,12
401002177,DePaul Blue Demons,V. Sherrod,4281359,,False,3.0,1,1,0,0,1,1,0,2,0,0,0,0,0,0,1,0,3
401002177,DePaul Blue Demons,D. Bekelja,4281356,,False,10.0,2,5,1,3,1,2,0,0,0,2,2,0,0,0,0,2,5
401002177,DePaul Blue Demons,C. McMahon,4068074,,False,0.0,0,0,0,0,0,0,0,0,0,0,0,0,0,0,0,0,0
401002177,DePaul Blue Demons,D. Cage,4068073,,False,1.0,0,0,0,0,0,0,0,0,0,0,0,0,0,0,0,0,0
401002177,DePaul Blue Demons,L. Prochaska,3142290,,False,12.0,0,2,0,1,0,1,0,0,0,1,1,4,2,0,1,1,0
401002177,DePaul Blue Demons,TEAM,TOTAL,TOTAL,False,,29,74,19,39,10,35,13,17,12,21,33,22,16,0,13,22,81
401001061,Saint Louis Billikens,M. Gits,3142463,,True,26.0,2,6,2,5,0,1,2,2,1,7,8,0,0,0,1,2,6
401001061,Saint Louis Billikens,J. Vliet,3142462,,True,27.0,3,8,2,3,1,5,0,0,2,3,5,5,2,1,0,4,7
401001061,Saint Louis Billikens,J. Frantz,3906745,,True,32.0,5,8,2,4,3,4,0,0,0,5,5,1,1,0,3,4,13
401001061,Saint Louis Billikens,A. Covington,3142461,,True,23.0,5,11,4,5,1,6,2,2,0,4,4,2,0,0,2,1,13
401001061,Saint Louis Billikens,J. Kemph,3142460,,True,38.0,7,13,7,11,0,2,2,4,0,4,4,7,1,0,1,1,16
401001061,Saint Louis Billikens,P. Rakers,3063631,,False,24.0,4,8,3,3,1,5,1,4,1,4,5,2,0,0,0,2,10
401001061,Saint Louis Billikens,T. Dusharm,3906747,,False,13.0,5,6,5,6,0,0,0,1,0,5,5,1,0,0,2,2,10
401001061,Saint Louis Billikens,T. Jeffries,4281902,,False,3.0,0,0,0,0,0,0,0,0,0,0,0,0,0,0,0,0,0
401001061,Saint Louis Billikens,K. McMahan,3147440,,False,14.0,0,3,0,3,0,0,3,4,0,3,3,0,0,0,1,3,3
401001061,Saint Louis Billikens,TEAM,TOTAL,TOTAL,False,,31,63,25,40,6,23,10,17,4,37,41,18,4,1,12,19,78
401001061,DePaul Blue Demons,C. Stonewall,4068072,,True,19.0,3,10,3,8,0,2,2,2,2,7,9,0,0,0,0,3,8
401001061,DePaul Blue Demons,K. Campbell,4068071,,True,37.0,2,8,1,2,1,6,4,6,2,6,8,7,2,0,1,3,9
401001061,DePaul Blue Demons,T. Allen,3933760,,True,30.0,4,15,2,8,2,7,0,0,3,4,7,4,0,1,1,2,10
401001061,DePaul Blue Demons,L. Prochaska,3142290,,True,22.0,1,1,1,1,0,0,0,0,0,4,4,2,1,0,2,2,2
401001061,DePaul Blue Demons,A. Coleman,3142123,,True,21.0,3,5,0,1,3,4,2,2,3,1,4,4,0,0,1,5,11
401001061,DePaul Blue Demons,R. McLimore,4281358,,False,7.0,1,3,0,1,1,2,0,0,1,2,3,0,1,0,0,1,3
401001061,DePaul Blue Demons,M. Grays,3142287,,False,26.0,9,24,2,13,7,11,0,0,2,1,3,2,0,0,1,0,25
401001061,DePaul Blue Demons,D. Bekelja,4281356,,False,6.0,0,2,0,2,0,0,0,0,0,0,0,1,0,0,0,0,0
401001061,DePaul Blue Demons,A. Millender,3142289,,False,32.0,5,12,2,2,3,10,5,7,1,3,4,1,0,0,2,1,18
401001061,DePaul Blue Demons,TEAM,TOTAL,TOTAL,False,,28,80,11,38,17,42,13,17,14,30,44,21,4,1,8,17,86
400995930,Villanova Wildcats,M. Gedaka,4068172,,True,31.0,3,7,3,7,0,0,0,0,0,2,2,1,1,1,0,0,6
400995930,Villanova Wildcats,J. Tucker,3087536,,True,16.0,1,5,0,3,1,2,0,0,0,1,1,0,1,1,0,2,3
400995930,Villanova Wildcats,K. Jekot,4068171,,True,29.0,9,14,8,11,1,3,1,1,0,4,4,0,0,0,1,1,20
400995930,Villanova Wildcats,A. Hahn,3906779,,True,29.0,4,8,1,2,3,6,2,2,0,5,5,3,0,0,2,1,13
400995930,Villanova Wildcats,A. Louin,3142314,,True,30.0,4,9,2,7,2,2,3,4,3,5,8,4,1,0,1,0,13
400995930,Villanova Wildcats,G. Lange,4281371,,False,2.0,0,0,0,0,0,0,0,0,0,0,0,0,0,0,0,0,0
400995930,Villanova Wildcats,B. Herlihy,4068169,,False,17.0,1,5,1,4,0,1,2,2,5,5,10,0,2,1,0,4,4
400995930,Villanova Wildcats,B. Herlihy,3906778,,False,19.0,5,10,4,7,1,3,1,2,0,4,4,2,1,1,0,0,12
400995930,Villanova Wildcats,G. Stant,3906780,,False,15.0,0,2,0,1,0,1,0,0,0,1,1,3,0,0,1,2,0
400995930,Villanova Wildcats,R. James,4068168,,False,7.0,1,3,1,3,0,0,0,0,0,1,1,0,1,0,0,2,2
400995930,Villanova Wildcats,C. Onken,4068167,,False,5.0,1,1,0,0,1,1,0,0,0,1,1,0,0,0,1,2,3
400995930,Villanova Wildcats,TEAM,TOTAL,TOTAL,False,,29,64,20,45,9,19,9,11,9,31,40,13,7,4,8,14,76
400995930,La Salle Explorers,S. Miller,4068560,,True,26.0,3,6,3,6,0,0,1,1,0,7,7,0,1,0,4,2,7
400995930,La Salle Explorers,A. Freeland,3143827,,True,27.0,0,3,0,2,0,1,0,0,0,4,4,0,1,1,1,1,0
400995930,La Salle Explorers,A. Miller,3924455,,True,32.0,6,18,3,10,3,8,3,4,1,0,1,0,0,0,3,2,18
400995930,La Salle Explorers,D. King,4281841,,True,38.0,2,4,1,3,1,1,3,4,0,3,3,1,1,0,2,3,8
400995930,La Salle Explorers,A. Griffin,3143826,,True,8.0,4,6,4,6,0,0,0,0,0,1,1,1,0,0,1,0,8
400995930,La Salle Explorers,J. White,4281844,,False,11.0,0,1,0,1,0,0,0,0,1,3,4,0,0,0,0,2,0
400995930,La Salle Explorers,J. Reese,4281843,,False,10.0,0,3,0,3,0,0,0,0,1,1,2,0,0,0,1,0,0
400995930,La Salle Explorers,S. Ngwafang,4068561,,False,4.0,0,0,0,0,0,0,0,0,0,1,1,0,0,0,0,0,0
400995930,La Salle Explorers,A. Wilks,3924453,,False,2.0,0,0,0,0,0,0,0,0,0,1,1,0,0,0,0,0,0
400995930,La Salle Explorers,M. Nicholls,4281842,,False,3.0,0,0,0,0,0,0,0,0,0,0,0,0,0,0,0,0,0
400995930,La Salle Explorers,R. Brown,4281840,,False,16.0,0,4,0,4,0,0,3,4,0,3,3,1,0,0,2,1,3
400995930,La Salle Explorers,S. Edwards,4068559,,False,23.0,2,7,1,4,1,3,0,0,0,1,1,1,0,0,1,2,5
400995930,La Salle Explorers,TEAM,TOTAL,TOTAL,False,,17,52,12,39,5,13,10,13,4,26,30,4,3,1,15,13,49
400995929,Villanova Wildcats,M. Quinn,3056785,,True,21.0,1,2,1,2,0,0,0,0,0,4,4,3,2,0,0,4,2
400995929,Villanova Wildcats,J. Tucker,3087536,,True,30.0,5,10,2,3,3,7,0,0,1,2,3,4,0,1,0,1,13
400995929,Villanova Wildcats,K. Jekot,4068171,,True,31.0,11,17,9,11,2,6,3,3,1,4,5,6,1,2,1,0,27
400995929,Villanova Wildcats,A. Hahn,3906779,,True,29.0,0,1,0,1,0,0,0,0,0,4,4,3,0,0,0,2,0
400995929,Villanova Wildcats,A. Louin,3142314,,True,28.0,2,4,2,3,0,1,4,4,0,2,2,1,1,0,1,2,8
400995929,Villanova Wildcats,G. Lange,4281371,,False,1.0,0,0,0,0,0,0,0,0,0,1,1,0,0,0,0,0,0
400995929,Villanova Wildcats,M. Gedaka,4068172,,False,19.0,7,10,7,10,0,0,2,3,3,2,5,0,1,3,2,2,16
400995929,Villanova Wildcats,B. Herlihy,4068169,,False,6.0,0,0,0,0,0,0,0,0,0,2,2,0,0,0,1,0,0
400995929,Villanova Wildcats,B. Herlihy,3906778,,False,10.0,2,6,2,5,0,1,1,1,1,1,2,0,1,0,2,0,5
400995929,Villanova Wildcats,G. Stant,3906780,,False,15.0,2,3,0,0,2,3,0,0,0,0,0,1,0,0,1,1,6
400995929,Villanova Wildcats,R. James,4068168,,False,4.0,1,2,1,2,0,0,0,0,0,0,0,0,0,0,0,2,2
400995929,Villanova Wildcats,C. Onken,4068167,,False,6.0,0,1,0,0,0,1,0,0,2,1,3,0,1,0,2,0,0
400995929,Villanova Wildcats,TEAM,TOTAL,TOTAL,False,,31,56,24,37,7,19,10,11,10,25,35,18,7,6,11,14,79
400995929,Saint Joseph's Hawks,A. Franklyn,3142456,,True,26.0,4,8,4,8,0,0,2,2,2,2,4,0,0,2,2,2,10
400995929,Saint Joseph's Hawks,A. Fioravanti,3058922,,True,21.0,3,9,3,9,0,0,2,2,1,1,2,2,0,0,3,2,8
400995929,Saint Joseph's Hawks,S. Veilleux,3142454,,True,29.0,3,5,3,5,0,0,0,0,0,2,2,1,1,0,1,3,6
400995929,Saint Joseph's Hawks,C. Woods,3142455,,True,26.0,3,9,3,9,0,0,3,3,4,2,6,2,0,0,2,2,9
400995929,Saint Joseph's Hawks,A. Monaghan,3934208,,True,33.0,1,7,1,2,0,5,2,3,0,2,2,1,0,0,2,0,4
400995929,Saint Joseph's Hawks,M. Clay,3934210,,False,6.0,1,2,1,2,0,0,0,0,1,0,1,0,0,0,1,0,2
400995929,Saint Joseph's Hawks,W. Fisher,3907696,,False,1.0,0,0,0,0,0,0,0,0,1,0,1,0,0,1,0,0,0
400995929,Saint Joseph's Hawks,C. Belvedere,3142457,,False,2.0,0,0,0,0,0,0,0,0,0,0,0,0,0,0,0,0,0
400995929,Saint Joseph's Hawks,M. Sheehan,4281900,,False,7.0,0,5,0,5,0,0,0,0,1,1,2,0,0,1,0,0,0
400995929,Saint Joseph's Hawks,L. Roig,4281899,,False,14.0,1,4,1,4,0,0,3,5,0,3,3,3,0,0,1,1,5
400995929,Saint Joseph's Hawks,K. Baisden,3934207,,False,12.0,0,0,0,0,0,0,0,0,0,0,0,1,0,0,0,1,0
400995929,Saint Joseph's Hawks,A. Marz,3142453,,False,5.0,0,0,0,0,0,0,0,0,0,1,1,0,0,0,1,0,0
400995929,Saint Joseph's Hawks,J. Garner,17605,,False,18.0,0,5,0,5,0,0,0,0,1,1,2,1,0,0,1,2,0
400995929,Saint Joseph's Hawks,TEAM,TOTAL,TOTAL,False,,16,54,16,49,0,5,12,15,14,15,29,11,1,4,14,13,44
400995928,Villanova Wildcats,M. Quinn,3056785,,True,29.0,3,6,2,3,1,3,0,0,2,8,10,0,1,0,1,2,7
400995928,Villanova Wildcats,K. Jekot,4068171,,True,35.0,2,4,2,3,0,1,0,0,0,1,1,1,0,1,1,1,4
400995928,Villanova Wildcats,A. Hahn,3906779,,True,37.0,6,15,3,8,3,7,0,2,2,5,7,3,1,0,4,0,15
400995928,Villanova Wildcats,A. Louin,3142314,,True,35.0,5,10,4,9,1,1,5,7,0,2,2,2,0,1,2,4,16
400995928,Villanova Wildcats,J. Tucker,3087536,,True,20.0,0,3,0,2,0,1,0,0,0,2,2,1,1,1,0,0,0
400995928,Villanova Wildcats,M. Gedaka,4068172,,False,26.0,5,7,5,7,0,0,2,2,1,2,3,1,2,1,1,1,12
400995928,Villanova Wildcats,B. Herlihy,3906778,,False,16.0,2,4,0,1,2,3,2,2,0,2,2,2,0,2,0,3,8
400995928,Villanova Wildcats,G. Stant,3906780,,False,2.0,0,0,0,0,0,0,0,0,0,0,0,0,0,0,0,0,0
400995928,Villanova Wildcats,TEAM,TOTAL,TOTAL,False,,23,49,16,33,7,16,9,13,6,22,28,10,5,6,11,11,62
400995928,Princeton Tigers,B. Alarie,4068600,,True,37.0,10,13,7,10,3,3,6,6,4,5,9,1,2,3,1,3,29
400995928,Princeton Tigers,L. Robinson,3142616,,True,30.0,4,13,4,12,0,1,2,2,1,6,7,5,1,0,2,4,10
400995928,Princeton Tigers,S. Jordan,3907120,,True,20.0,1,5,1,5,0,0,0,0,0,1,1,1,1,0,0,2,2
400995928,Princeton Tigers,C. Littlefield,4281403,,True,28.0,1,2,1,2,0,0,0,0,0,3,3,5,1,0,2,3,2
400995928,Princeton Tigers,T. Weledji,3142615,,True,18.0,0,2,0,1,0,1,0,0,2,1,3,0,1,0,2,0,0
400995928,Princeton Tigers,J. Stallworth,4068601,,False,1.0,0,0,0,0,0,0,0,0,0,0,0,0,0,0,1,0,0
400995928,Princeton Tigers,T. Baur,4068599,,False,15.0,2,3,2,3,0,0,2,2,3,3,6,0,0,0,1,2,6
400995928,Princeton Tigers,A. Meyers,4281402,,False,21.0,5,14,5,9,0,5,0,0,1,2,3,1,0,1,1,2,10
400995928,Princeton Tigers,G. Rush,3907123,,False,14.0,0,2,0,0,0,2,0,0,0,0,0,0,0,0,1,0,0
400995928,Princeton Tigers,K. Holland,3142614,,False,16.0,0,3,0,0,0,3,0,0,0,1,1,0,0,0,0,0,0
400995928,Princeton Tigers,TEAM,TOTAL,TOTAL,False,,23,57,20,42,3,15,10,10,12,23,35,13,6,4,11,16,59
400995927,Villanova Wildcats,M. Quinn,3056785,,True,21.0,1,3,0,1,1,2,1,2,1,4,5,0,0,1,1,2,4
400995927,Villanova Wildcats,K. Jekot,4068171,,True,31.0,5,13,5,7,0,6,0,0,0,3,3,1,1,0,1,1,10
400995927,Villanova Wildcats,A. Hahn,3906779,,True,36.0,5,15,2,4,3,11,2,2,0,4,4,2,0,0,0,2,15
400995927,Villanova Wildcats,A. Louin,3142314,,True,37.0,4,10,3,6,1,4,1,2,1,10,11,3,1,0,1,2,10
400995927,Villanova Wildcats,J. Tucker,3087536,,True,32.0,3,7,2,4,1,3,1,5,1,1,2,2,0,0,0,2,8
400995927,Villanova Wildcats,M. Gedaka,4068172,,False,22.0,4,5,4,5,0,0,0,1,1,4,5,0,3,1,1,1,8
400995927,Villanova Wildcats,B. Herlihy,3906778,,False,13.0,2,4,2,3,0,1,1,2,1,1,2,1,0,1,1,3,5
400995927,Villanova Wildcats,G. Stant,3906780,,False,5.0,0,1,0,0,0,1,0,0,0,0,0,1,0,0,0,0,0
400995927,Villanova Wildcats,R. James,4068168,,False,1.0,0,0,0,0,0,0,0,0,0,0,0,0,0,0,0,0,0
400995927,Villanova Wildcats,C. Onken,4068167,,False,2.0,0,1,0,0,0,1,0,0,0,0,0,0,0,0,0,0,0
400995927,Villanova Wildcats,TEAM,TOTAL,TOTAL,False,,24,59,18,30,6,29,6,14,5,29,34,10,5,3,6,13,60
400995927,James Madison Dukes,D. Merritt,4068347,,True,11.0,1,2,1,1,0,1,0,0,1,0,1,0,0,0,0,0,2
400995927,James Madison Dukes,T. Butler,3058916,,True,22.0,2,5,2,5,0,0,0,0,3,6,9,1,0,1,2,3,4
400995927,James Madison Dukes,K. Smalls,4068346,,True,34.0,7,18,4,12,3,6,0,0,0,8,8,2,1,0,3,5,17
400995927,James Madison Dukes,L. Barrier,4068345,,True,34.0,3,14,3,11,0,3,1,2,2,3,5,4,0,0,3,3,7
400995927,James Madison Dukes,H. Barron,3143253,,True,29.0,1,4,0,0,1,4,0,0,1,2,3,1,0,0,0,1,3
400995927,James Madison Dukes,B. Bellerand,4281444,,False,4.0,0,0,0,0,0,0,0,0,1,0,1,0,0,0,1,1,0
400995927,James Madison Dukes,K. Koshuta,3949117,,False,16.0,7,12,6,9,1,3,0,0,0,3,3,1,0,0,0,2,15
400995927,James Madison Dukes,K. Cooper-Williams,3907012,,False,19.0,1,4,1,4,0,0,2,2,1,3,4,0,0,0,0,2,4
400995927,James Madison Dukes,T. Harris,4281443,,False,4.0,0,1,0,0,0,1,0,0,0,0,0,0,0,0,0,0,0
400995927,James Madison Dukes,A. Young,3907011,,False,27.0,1,2,0,1,1,1,2,2,1,3,4,0,0,1,2,1,5
400995927,James Madison Dukes,TEAM,TOTAL,TOTAL,False,,23,62,17,43,6,19,5,6,10,32,42,9,1,2,11,18,57
400995926,Villanova Wildcats,M. Quinn,3056785,,True,20.0,1,9,1,5,0,4,0,0,2,5,7,2,0,1,0,0,2
400995926,Villanova Wildcats,J. Tucker,3087536,,True,27.0,2,8,0,2,2,6,0,0,0,2,2,1,0,1,0,2,6
400995926,Villanova Wildcats,K. Jekot,4068171,,True,30.0,3,13,2,5,1,8,2,2,2,4,6,2,2,1,0,3,9
400995926,Villanova Wildcats,A. Hahn,3906779,,True,31.0,4,14,2,4,2,10,3,4,1,6,7,3,1,0,1,1,13
400995926,Villanova Wildcats,A. Louin,3142314,,True,22.0,1,6,0,1,1,5,2,2,1,3,4,0,1,1,3,3,5
400995926,Villanova Wildcats,G. Lange,4281371,,False,2.0,0,0,0,0,0,0,0,0,0,0,0,1,0,0,1,1,0
400995926,Villanova Wildcats,M. Gedaka,4068172,,False,21.0,6,6,6,6,0,0,1,2,2,4,6,0,0,1,0,3,13
400995926,Villanova Wildcats,B. Herlihy,4068169,,False,12.0,2,5,2,4,0,1,0,0,3,3,6,1,1,1,0,2,4
400995926,Villanova Wildcats,B. Herlihy,3906778,,False,9.0,1,3,1,3,0,0,0,0,1,0,1,3,1,1,1,5,2
400995926,Villanova Wildcats,G. Stant,3906780,,False,14.0,1,3,0,0,1,3,2,2,1,2,3,0,0,0,0,1,5
400995926,Villanova Wildcats,R. James,4068168,,False,6.0,1,2,1,2,0,0,1,1,0,0,0,1,0,0,1,0,3
400995926,Villanova Wildcats,C. Onken,4068167,,False,6.0,0,0,0,0,0,0,0,0,0,1,1,0,0,0,0,1,0
400995926,Villanova Wildcats,TEAM,TOTAL,TOTAL,False,,22,69,15,32,7,37,11,13,14,34,48,14,6,7,7,22,62
400995926,Lehigh Mountain Hawks,G. Grundhoffer,4068270,,True,24.0,2,13,2,11,0,2,0,0,2,5,7,0,0,0,2,1,4
400995926,Lehigh Mountain Hawks,M. Williams,3143308,,True,15.0,0,1,0,1,0,0,0,0,1,6,7,0,0,0,1,3,0
400995926,Lehigh Mountain Hawks,H. Hedstrom,4068273,,True,25.0,1,3,1,2,0,1,2,2,0,6,6,0,0,0,3,5,4
400995926,Lehigh Mountain Hawks,C. Buhr,4068272,,True,31.0,2,10,2,9,0,1,4,4,2,4,6,1,1,0,2,4,8
400995926,Lehigh Mountain Hawks,Q. Mann,3143307,,True,26.0,0,10,0,8,0,2,1,2,0,2,2,0,0,0,2,1,1
400995926,Lehigh Mountain Hawks,M. Sexe,4281011,,False,8.0,0,0,0,0,0,0,0,0,1,2,3,2,0,0,0,0,0
400995926,Lehigh Mountain Hawks,C. Benz,4068274,,False,23.0,5,10,3,5,2,5,2,4,1,6,7,2,0,0,0,0,14
400995926,Lehigh Mountain Hawks,M. Eripret,3913889,,False,9.0,1,3,1,3,0,0,1,2,1,0,1,1,0,2,0,1,3
400995926,Lehigh Mountain Hawks,M. Clougherty,4281010,,False,12.0,1,2,0,0,1,2,0,0,0,2,2,0,0,0,1,2,3
400995926,Lehigh Mountain Hawks,P. Galiani,4068271,,False,5.0,2,3,1,2,1,1,0,0,1,0,1,0,0,0,0,0,5
400995926,Lehigh Mountain Hawks,B. Devaney,3143306,,False,22.0,0,6,0,2,0,4,0,0,0,1,1,3,0,0,1,2,0
400995926,Lehigh Mountain Hawks,TEAM,TOTAL,TOTAL,False,,14,61,10,43,4,18,10,14,14,34,48,9,1,2,14,19,42
400995870,VCU Rams,S. Skinner,3906750,,True,20.0,2,6,2,6,0,0,1,4,0,3,3,0,0,0,2,0,5
400995870,VCU Rams,B. Gibson,3906748,,True,24.0,2,6,2,6,0,0,2,2,1,6,7,1,0,0,1,4,6
400995870,VCU Rams,T. Reed,4281909,,True,33.0,3,12,3,11,0,1,9,11,3,4,7,1,1,0,6,1,15
400995870,VCU Rams,J. Maddox,4072600,,True,35.0,2,7,1,6,1,1,3,4,3,2,5,0,0,0,4,2,8
400995870,VCU Rams,N. Williams,4072599,,True,30.0,1,3,0,1,1,2,1,2,0,1,1,5,3,0,7,5,4
400995870,VCU Rams,S. Archie,4281908,,False,22.0,4,8,3,5,1,3,0,0,2,2,4,0,3,1,1,2,9
400995870,VCU Rams,D. Hammond,4072601,,False,6.0,0,2,0,2,0,0,2,2,0,1,1,0,0,0,1,0,2
400995870,VCU Rams,T. Robinson,4281905,,False,12.0,1,3,0,1,1,2,2,2,1,4,5,1,0,0,0,1,5
400995870,VCU Rams,N. Johnson,4072602,,False,18.0,2,6,1,2,1,4,0,0,0,2,2,0,1,1,1,0,5
400995870,VCU Rams,TEAM,TOTAL,TOTAL,False,,17,53,12,40,5,13,20,27,10,25,35,8,8,2,24,15,59
400995870,Georgetown Hoyas,C. Petke,4068078,,True,39.0,5,13,5,11,0,2,0,0,2,10,12,2,2,0,0,3,10
400995870,Georgetown Hoyas,Y. Belk,3142295,,True,35.0,3,6,3,6,0,0,2,2,0,2,2,0,1,4,2,4,8
400995870,Georgetown Hoyas,D. White,3948815,,True,40.0,9,18,6,10,3,8,0,1,1,3,4,4,5,1,8,3,21
400995870,Georgetown Hoyas,D. Burton,3142292,,True,33.0,1,4,0,2,1,2,2,4,0,3,3,7,4,0,0,1,5
400995870,Georgetown Hoyas,M. Venson,3142105,,True,38.0,7,10,4,6,3,4,2,3,0,3,3,3,3,0,3,4,19
400995870,Georgetown Hoyas,T. Thompson,4281352,,False,6.0,0,2,0,1,0,1,0,0,0,0,0,0,0,0,2,0,0
400995870,Georgetown Hoyas,M. Smith,4068079,,False,9.0,3,4,3,4,0,0,2,2,0,1,1,1,1,0,0,3,8
400995870,Georgetown Hoyas,TEAM,TOTAL,TOTAL,False,,28,57,21,40,7,17,8,12,3,22,25,17,16,5,18,18,71
400995869,St. John's Red Storm,M. Singleton,4068158,,True,28.0,5,9,5,9,0,0,1,2,2,5,7,0,0,1,1,3,11
400995869,St. John's Red Storm,I. Littleton,3142306,,True,35.0,3,8,3,8,0,0,3,4,1,4,5,2,2,1,2,1,9
400995869,St. John's Red Storm,A. Wellere,3906771,,True,34.0,0,7,0,2,0,5,3,4,1,4,5,1,0,0,2,1,3
400995869,St. John's Red Storm,A. Kebbe,4068154,,True,21.0,3,7,2,4,1,3,0,1,0,2,2,1,0,1,0,4,7
400995869,St. John's Red Storm,T. Alexander,3142305,,True,5.0,0,0,0,0,0,0,0,0,1,0,1,1,0,0,1,0,0
400995869,St. John's Red Storm,K. Charles,4281374,,False,3.0,0,1,0,1,0,0,0,0,1,0,1,0,0,0,1,1,0
400995869,St. John's Red Storm,Q. Hoppie,4281375,,False,20.0,3,12,2,8,1,4,0,0,0,1,1,1,1,0,2,0,7
400995869,St. John's Red Storm,A. Adams,4068157,,False,20.0,5,7,4,5,1,2,0,0,1,1,2,0,1,0,1,2,11
400995869,St. John's Red Storm,S. Duncan,4068156,,False,5.0,1,1,1,1,0,0,0,0,0,0,0,0,0,0,0,2,2
400995869,St. John's Red Storm,T. England,4068155,,False,29.0,2,5,2,3,0,2,3,4,2,0,2,3,0,0,6,2,7
400995869,St. John's Red Storm,TEAM,TOTAL,TOTAL,False,,22,57,19,41,3,16,10,15,10,20,30,9,4,3,17,16,57
400995869,St. John's Red Storm,M. Singleton,4068158,,True,28.0,5,9,5,9,0,0,1,2,2,5,7,0,0,1,1,3,11
400995869,St. John's Red Storm,I. Littleton,3142306,,True,35.0,3,8,3,8,0,0,3,4,1,4,5,2,2,1,2,1,9
400995869,St. John's Red Storm,A. Wellere,3906771,,True,34.0,0,7,0,2,0,5,3,4,1,4,5,1,0,0,2,1,3
400995869,St. John's Red Storm,A. Kebbe,4068154,,True,21.0,3,7,2,4,1,3,0,1,0,2,2,1,0,1,0,4,7
400995869,St. John's Red Storm,T. Alexander,3142305,,True,5.0,0,0,0,0,0,0,0,0,1,0,1,1,0,0,1,0,0
400995869,St. John's Red Storm,K. Charles,4281374,,False,3.0,0,1,0,1,0,0,0,0,1,0,1,0,0,0,1,1,0
400995869,St. John's Red Storm,Q. Hoppie,4281375,,False,20.0,3,12,2,8,1,4,0,0,0,1,1,1,1,0,2,0,7
400995869,St. John's Red Storm,A. Adams,4068157,,False,20.0,5,7,4,5,1,2,0,0,1,1,2,0,1,0,1,2,11
400995869,St. John's Red Storm,S. Duncan,4068156,,False,5.0,1,1,1,1,0,0,0,0,0,0,0,0,0,0,0,2,2
400995869,St. John's Red Storm,T. England,4068155,,False,29.0,2,5,2,3,0,2,3,4,2,0,2,3,0,0,6,2,7
400995869,St. John's Red Storm,TEAM,TOTAL,TOTAL,False,,22,57,19,41,3,16,10,15,10,20,30,9,4,3,17,16,57
400995869,Marquette Golden Eagles,E. Davenport,3906756,,True,26.0,6,11,6,11,0,0,0,1,2,9,11,0,6,2,5,4,12
400995869,Marquette Golden Eagles,A. Wilborn,3906758,,True,33.0,4,7,2,4,2,3,8,9,1,2,3,3,0,0,0,4,18
400995869,Marquette Golden Eagles,A. Blockton,3906755,,True,28.0,7,11,7,11,0,0,5,6,2,5,7,3,2,0,0,2,19
400995869,Marquette Golden Eagles,N. Hiedeman,3906753,,True,29.0,2,8,2,6,0,2,0,0,1,2,3,2,1,1,3,4,4
400995869,Marquette Golden Eagles,D. King,3906752,,True,36.0,4,11,4,8,0,3,3,4,0,1,1,2,0,0,4,1,11
400995869,Marquette Golden Eagles,A. Anderson,4068081,,False,1.0,0,0,0,0,0,0,0,0,0,1,1,0,0,0,0,0,0
400995869,Marquette Golden Eagles,S. Dahling,3906754,,False,1.0,0,0,0,0,0,0,0,0,0,0,0,0,0,0,0,0,0
400995869,Marquette Golden Eagles,L. Van Kleunen,4068083,,False,14.0,3,4,3,3,0,1,0,0,1,2,3,0,0,0,0,1,6
400995869,Marquette Golden Eagles,S. Valentine,3142300,,False,7.0,0,0,0,0,0,0,0,0,0,1,1,0,1,0,0,0,0
400995869,Marquette Golden Eagles,S. Lott,4281350,,False,22.0,1,4,1,2,0,2,2,2,3,1,4,0,2,1,2,2,4
400995869,Marquette Golden Eagles,I. Spingola,4068082,,False,3.0,1,2,1,1,0,1,0,0,0,0,0,1,0,0,0,0,2
400995869,Marquette Golden Eagles,TEAM,TOTAL,TOTAL,False,,28,58,26,46,2,12,18,22,12,27,39,11,12,4,14,18,76
400995869,Marquette Golden Eagles,E. Davenport,3906756,,True,26.0,6,11,6,11,0,0,0,1,2,9,11,0,6,2,5,4,12
400995869,Marquette Golden Eagles,A. Wilborn,3906758,,True,33.0,4,7,2,4,2,3,8,9,1,2,3,3,0,0,0,4,18
400995869,Marquette Golden Eagles,A. Blockton,3906755,,True,28.0,7,11,7,11,0,0,5,6,2,5,7,3,2,0,0,2,19
400995869,Marquette Golden Eagles,N. Hiedeman,3906753,,True,29.0,2,8,2,6,0,2,0,0,1,2,3,2,1,1,3,4,4
400995869,Marquette Golden Eagles,D. King,3906752,,True,36.0,4,11,4,8,0,3,3,4,0,1,1,2,0,0,4,1,11
400995869,Marquette Golden Eagles,A. Anderson,4068081,,False,1.0,0,0,0,0,0,0,0,0,0,1,1,0,0,0,0,0,0
400995869,Marquette Golden Eagles,S. Dahling,3906754,,False,1.0,0,0,0,0,0,0,0,0,0,0,0,0,0,0,0,0,0
400995869,Marquette Golden Eagles,L. Van Kleunen,4068083,,False,14.0,3,4,3,3,0,1,0,0,1,2,3,0,0,0,0,1,6
400995869,Marquette Golden Eagles,S. Valentine,3142300,,False,7.0,0,0,0,0,0,0,0,0,0,1,1,0,1,0,0,0,0
400995869,Marquette Golden Eagles,S. Lott,4281350,,False,22.0,1,4,1,2,0,2,2,2,3,1,4,0,2,1,2,2,4
400995869,Marquette Golden Eagles,I. Spingola,4068082,,False,3.0,1,2,1,1,0,1,0,0,0,0,0,1,0,0,0,0,2
400995869,Marquette Golden Eagles,TEAM,TOTAL,TOTAL,False,,28,58,26,46,2,12,18,22,12,27,39,11,12,4,14,18,76
400995868,Providence Friars,A. Cooper,4281349,,True,14.0,0,2,0,2,0,0,1,2,0,0,0,0,0,0,4,3,1
400995868,Providence Friars,B. Frias,3142302,,True,32.0,0,1,0,1,0,0,0,0,2,3,5,2,1,1,2,2,0
400995868,Providence Friars,C. Williams,4281345,,True,24.0,1,5,1,4,0,1,2,2,1,5,6,2,0,0,5,3,4
400995868,Providence Friars,J. Nogic,3906769,,True,35.0,9,17,4,6,5,11,2,3,0,4,4,0,0,1,4,1,25
400995868,Providence Friars,M. Jolin,3906767,,True,34.0,2,9,1,5,1,4,2,2,1,6,7,2,0,0,4,1,7
400995868,Providence Friars,O. Orlando,4281347,,False,19.0,3,6,3,6,0,0,3,4,1,7,8,0,0,0,0,2,9
400995868,Providence Friars,K. Spiwak,4281346,,False,24.0,0,5,0,3,0,2,2,2,2,3,5,1,0,0,1,2,2
400995868,Providence Friars,C. Che,3906766,,False,18.0,0,3,0,2,0,1,0,0,0,0,0,1,1,0,2,0,0
400995868,Providence Friars,TEAM,TOTAL,TOTAL,False,,15,48,9,29,6,19,12,15,8,28,36,8,2,2,22,14,48
400995868,Providence Friars,A. Cooper,4281349,,True,14.0,0,2,0,2,0,0,1,2,0,0,0,0,0,0,4,3,1
400995868,Providence Friars,B. Frias,3142302,,True,32.0,0,1,0,1,0,0,0,0,2,3,5,2,1,1,2,2,0
400995868,Providence Friars,C. Williams,4281345,,True,24.0,1,5,1,4,0,1,2,2,1,5,6,2,0,0,5,3,4
400995868,Providence Friars,J. Nogic,3906769,,True,35.0,9,17,4,6,5,11,2,3,0,4,4,0,0,1,4,1,25
400995868,Providence Friars,M. Jolin,3906767,,True,34.0,2,9,1,5,1,4,2,2,1,6,7,2,0,0,4,1,7
400995868,Providence Friars,O. Orlando,4281347,,False,19.0,3,6,3,6,0,0,3,4,1,7,8,0,0,0,0,2,9
400995868,Providence Friars,K. Spiwak,4281346,,False,24.0,0,5,0,3,0,2,2,2,2,3,5,1,0,0,1,2,2
400995868,Providence Friars,C. Che,3906766,,False,18.0,0,3,0,2,0,1,0,0,0,0,0,1,1,0,2,0,0
400995868,Providence Friars,TEAM,TOTAL,TOTAL,False,,15,48,9,29,6,19,12,15,8,28,36,8,2,2,22,14,48
400995868,Georgetown Hoyas,C. Petke,4068078,,True,32.0,7,18,7,17,0,1,7,8,7,8,15,0,5,1,4,1,21
400995868,Georgetown Hoyas,Y. Belk,3142295,,True,18.0,1,5,1,5,0,0,0,0,1,4,5,0,0,0,2,3,2
400995868,Georgetown Hoyas,D. White,3948815,,True,37.0,8,14,6,10,2,4,5,5,3,4,7,3,5,1,0,1,23
400995868,Georgetown Hoyas,D. Burton,3142292,,True,27.0,4,7,4,7,0,0,0,0,0,0,0,2,1,0,0,2,8
400995868,Georgetown Hoyas,M. Venson,3142105,,True,35.0,6,8,6,7,0,1,0,0,0,2,2,3,1,0,3,3,12
400995868,Georgetown Hoyas,T. Thompson,4281352,,False,14.0,2,8,2,4,0,4,0,0,0,0,0,1,0,0,0,3,4
400995868,Georgetown Hoyas,M. Smith,4068079,,False,21.0,1,1,1,1,0,0,1,2,0,2,2,1,0,0,0,0,3
400995868,Georgetown Hoyas,B. Mayfield,4281354,,False,3.0,0,3,0,3,0,0,0,0,0,2,2,0,0,0,0,0,0
400995868,Georgetown Hoyas,L. Kimball,4281353,,False,3.0,0,1,0,1,0,0,0,0,0,0,0,0,0,0,0,0,0
400995868,Georgetown Hoyas,M. Osagie-Erese,4072597,,False,10.0,0,2,0,1,0,1,1,2,0,2,2,0,0,0,0,3,1
400995868,Georgetown Hoyas,TEAM,TOTAL,TOTAL,False,,29,67,27,56,2,11,14,17,12,26,38,10,12,2,9,16,74
400995868,Georgetown Hoyas,C. Petke,4068078,,True,32.0,7,18,7,17,0,1,7,8,7,8,15,0,5,1,4,1,21
400995868,Georgetown Hoyas,Y. Belk,3142295,,True,18.0,1,5,1,5,0,0,0,0,1,4,5,0,0,0,2,3,2
400995868,Georgetown Hoyas,D. White,3948815,,True,37.0,8,14,6,10,2,4,5,5,3,4,7,3,5,1,0,1,23
400995868,Georgetown Hoyas,D. Burton,3142292,,True,27.0,4,7,4,7,0,0,0,0,0,0,0,2,1,0,0,2,8
400995868,Georgetown Hoyas,M. Venson,3142105,,True,35.0,6,8,6,7,0,1,0,0,0,2,2,3,1,0,3,3,12
400995868,Georgetown Hoyas,T. Thompson,4281352,,False,14.0,2,8,2,4,0,4,0,0,0,0,0,1,0,0,0,3,4
400995868,Georgetown Hoyas,M. Smith,4068079,,False,21.0,1,1,1,1,0,0,1,2,0,2,2,1,0,0,0,0,3
400995868,Georgetown Hoyas,B. Mayfield,4281354,,False,3.0,0,3,0,3,0,0,0,0,0,2,2,0,0,0,0,0,0
400995868,Georgetown Hoyas,L. Kimball,4281353,,False,3.0,0,1,0,1,0,0,0,0,0,0,0,0,0,0,0,0,0
400995868,Georgetown Hoyas,M. Osagie-Erese,4072597,,False,10.0,0,2,0,1,0,1,1,2,0,2,2,0,0,0,0,3,1
400995868,Georgetown Hoyas,TEAM,TOTAL,TOTAL,False,,29,67,27,56,2,11,14,17,12,26,38,10,12,2,9,16,74
400995867,Xavier Musketeers,I. Partlow,3142320,,True,22.0,2,4,2,4,0,0,2,3,3,1,4,0,0,0,2,4,6
400995867,Xavier Musketeers,A. Aijanen,3142319,,True,29.0,1,6,1,2,0,4,1,2,0,6,6,2,2,2,4,3,3
400995867,Xavier Musketeers,N. Owens,4068187,,True,30.0,4,8,3,6,1,2,3,4,0,2,2,1,1,1,1,0,12
400995867,Xavier Musketeers,J. Byrd,3142318,,True,29.0,3,9,3,8,0,1,6,9,0,1,1,4,5,0,1,1,12
400995867,Xavier Musketeers,K. Fincher,3142317,,True,32.0,4,11,0,2,4,9,1,2,0,3,3,3,1,0,4,2,13
400995867,Xavier Musketeers,A. Gray,4281368,,False,20.0,1,4,0,2,1,2,3,4,4,4,8,1,0,0,1,3,6
400995867,Xavier Musketeers,D. Ross,4281364,,False,10.0,1,5,0,1,1,4,2,2,0,5,5,0,0,0,1,1,5
400995867,Xavier Musketeers,P. Stewart,4281366,,False,7.0,0,1,0,0,0,1,0,0,0,0,0,0,0,0,0,0,0
400995867,Xavier Musketeers,A. Dunham,4281365,,False,21.0,0,3,0,1,0,2,0,0,0,2,2,2,0,0,1,2,0
400995867,Xavier Musketeers,TEAM,TOTAL,TOTAL,False,,16,51,9,26,7,25,18,26,12,25,37,13,9,3,15,16,57
400995867,Xavier Musketeers,I. Partlow,3142320,,True,22.0,2,4,2,4,0,0,2,3,3,1,4,0,0,0,2,4,6
400995867,Xavier Musketeers,A. Aijanen,3142319,,True,29.0,1,6,1,2,0,4,1,2,0,6,6,2,2,2,4,3,3
400995867,Xavier Musketeers,N. Owens,4068187,,True,30.0,4,8,3,6,1,2,3,4,0,2,2,1,1,1,1,0,12
400995867,Xavier Musketeers,J. Byrd,3142318,,True,29.0,3,9,3,8,0,1,6,9,0,1,1,4,5,0,1,1,12
400995867,Xavier Musketeers,K. Fincher,3142317,,True,32.0,4,11,0,2,4,9,1,2,0,3,3,3,1,0,4,2,13
400995867,Xavier Musketeers,A. Gray,4281368,,False,20.0,1,4,0,2,1,2,3,4,4,4,8,1,0,0,1,3,6
400995867,Xavier Musketeers,D. Ross,4281364,,False,10.0,1,5,0,1,1,4,2,2,0,5,5,0,0,0,1,1,5
400995867,Xavier Musketeers,P. Stewart,4281366,,False,7.0,0,1,0,0,0,1,0,0,0,0,0,0,0,0,0,0,0
400995867,Xavier Musketeers,A. Dunham,4281365,,False,21.0,0,3,0,1,0,2,0,0,0,2,2,2,0,0,1,2,0
400995867,Xavier Musketeers,TEAM,TOTAL,TOTAL,False,,16,51,9,26,7,25,18,26,12,25,37,13,9,3,15,16,57
400995867,Butler Bulldogs,T. Schickel,3914012,,True,37.0,5,11,5,10,0,1,0,1,2,5,7,2,2,2,3,1,10
400995867,Butler Bulldogs,K. Spolyar,4068068,,True,32.0,2,5,1,2,1,3,7,9,0,3,3,1,3,0,5,5,12
400995867,Butler Bulldogs,M. Weaver,3914014,,True,36.0,4,8,3,4,1,4,0,0,0,1,1,2,2,0,2,4,9
400995867,Butler Bulldogs,W. Jennings,3142145,,True,39.0,6,18,5,10,1,8,2,2,0,3,3,2,0,0,5,5,15
400995867,Butler Bulldogs,I. Lathan,3079485,,True,25.0,3,7,3,7,0,0,0,0,2,5,7,3,0,0,1,3,6
400995867,Butler Bulldogs,S. Brey,4068067,,False,23.0,1,2,1,2,0,0,0,2,1,4,5,1,1,0,2,3,2
400995867,Butler Bulldogs,K. Hodges,4068065,,False,4.0,0,1,0,1,0,0,0,0,1,1,2,0,0,0,0,2,0
400995867,Butler Bulldogs,S. Buck,3142279,,False,4.0,0,0,0,0,0,0,0,0,0,0,0,0,0,0,0,0,0
400995867,Butler Bulldogs,TEAM,TOTAL,TOTAL,False,,21,52,18,36,3,16,9,14,9,27,36,11,8,2,18,23,54
400995867,Butler Bulldogs,T. Schickel,3914012,,True,37.0,5,11,5,10,0,1,0,1,2,5,7,2,2,2,3,1,10
400995867,Butler Bulldogs,K. Spolyar,4068068,,True,32.0,2,5,1,2,1,3,7,9,0,3,3,1,3,0,5,5,12
400995867,Butler Bulldogs,M. Weaver,3914014,,True,36.0,4,8,3,4,1,4,0,0,0,1,1,2,2,0,2,4,9
400995867,Butler Bulldogs,W. Jennings,3142145,,True,39.0,6,18,5,10,1,8,2,2,0,3,3,2,0,0,5,5,15
400995867,Butler Bulldogs,I. Lathan,3079485,,True,25.0,3,7,3,7,0,0,0,0,2,5,7,3,0,0,1,3,6
400995867,Butler Bulldogs,S. Brey,4068067,,False,23.0,1,2,1,2,0,0,0,2,1,4,5,1,1,0,2,3,2
400995867,Butler Bulldogs,K. Hodges,4068065,,False,4.0,0,1,0,1,0,0,0,0,1,1,2,0,0,0,0,2,0
400995867,Butler Bulldogs,S. Buck,3142279,,False,4.0,0,0,0,0,0,0,0,0,0,0,0,0,0,0,0,0,0
400995867,Butler Bulldogs,TEAM,TOTAL,TOTAL,False,,21,52,18,36,3,16,9,14,9,27,36,11,8,2,18,23,54
400995866,Villanova Wildcats,M. Quinn,3056785,,True,16.0,2,3,2,3,0,0,0,2,0,6,6,1,0,0,1,0,4
400995866,Villanova Wildcats,J. Tucker,3087536,,True,38.0,3,9,1,4,2,5,2,2,0,4,4,3,0,2,0,2,10
400995866,Villanova Wildcats,K. Jekot,4068171,,True,37.0,2,6,1,4,1,2,0,0,2,3,5,1,0,0,1,1,5
400995866,Villanova Wildcats,N. Juliana,4068170,,True,4.0,0,1,0,0,0,1,0,0,1,0,1,0,0,0,0,0,0
400995866,Villanova Wildcats,A. Louin,3142314,,True,39.0,3,8,3,5,0,3,6,6,1,8,9,3,0,1,0,2,12
400995866,Villanova Wildcats,M. Gedaka,4068172,,False,21.0,9,16,9,14,0,2,3,3,1,1,2,0,0,1,1,3,21
400995866,Villanova Wildcats,B. Herlihy,3906778,,False,14.0,1,5,0,2,1,3,0,0,0,3,3,0,0,0,0,1,3
400995866,Villanova Wildcats,G. Stant,3906780,,False,2.0,0,2,0,1,0,1,0,0,0,0,0,0,0,0,0,0,0
400995866,Villanova Wildcats,A. Hahn,3906779,,False,29.0,0,4,0,2,0,2,0,0,0,3,3,1,0,0,1,3,0
400995866,Villanova Wildcats,TEAM,TOTAL,TOTAL,False,,20,54,16,35,4,19,11,13,7,32,39,9,0,4,5,12,55
400995866,Villanova Wildcats,M. Quinn,3056785,,True,16.0,2,3,2,3,0,0,0,2,0,6,6,1,0,0,1,0,4
400995866,Villanova Wildcats,J. Tucker,3087536,,True,38.0,3,9,1,4,2,5,2,2,0,4,4,3,0,2,0,2,10
400995866,Villanova Wildcats,K. Jekot,4068171,,True,37.0,2,6,1,4,1,2,0,0,2,3,5,1,0,0,1,1,5
400995866,Villanova Wildcats,N. Juliana,4068170,,True,4.0,0,1,0,0,0,1,0,0,1,0,1,0,0,0,0,0,0
400995866,Villanova Wildcats,A. Louin,3142314,,True,39.0,3,8,3,5,0,3,6,6,1,8,9,3,0,1,0,2,12
400995866,Villanova Wildcats,M. Gedaka,4068172,,False,21.0,9,16,9,14,0,2,3,3,1,1,2,0,0,1,1,3,21
400995866,Villanova Wildcats,B. Herlihy,3906778,,False,14.0,1,5,0,2,1,3,0,0,0,3,3,0,0,0,0,1,3
400995866,Villanova Wildcats,G. Stant,3906780,,False,2.0,0,2,0,1,0,1,0,0,0,0,0,0,0,0,0,0,0
400995866,Villanova Wildcats,A. Hahn,3906779,,False,29.0,0,4,0,2,0,2,0,0,0,3,3,1,0,0,1,3,0
400995866,Villanova Wildcats,TEAM,TOTAL,TOTAL,False,,20,54,16,35,4,19,11,13,7,32,39,9,0,4,5,12,55
400995866,Creighton Bluejays,A. Faber,3938938,,True,34.0,3,11,3,9,0,2,1,2,1,5,6,1,0,0,1,3,7
400995866,Creighton Bluejays,J. Agnew,3938935,,True,35.0,1,6,1,4,0,2,2,2,0,4,4,1,0,1,0,4,4
400995866,Creighton Bluejays,B. Norby,3142284,,True,12.0,1,2,1,1,0,1,0,0,1,1,2,0,0,0,1,0,2
400995866,Creighton Bluejays,S. Lamberty,3142285,,True,40.0,8,17,7,12,1,5,3,3,2,8,10,3,1,0,0,1,20
400995866,Creighton Bluejays,M. Mellman,3142283,,True,11.0,1,2,0,0,1,2,0,0,0,2,2,0,0,0,0,0,3
400995866,Creighton Bluejays,A. Greene,3938937,,False,14.0,1,2,1,2,0,0,0,0,1,1,2,0,0,0,1,3,2
400995866,Creighton Bluejays,T. Carda,4281362,,False,26.0,4,9,4,7,0,2,0,1,0,3,3,0,0,0,2,4,8
400995866,Creighton Bluejays,O. Elger,3938936,,False,28.0,0,8,0,3,0,5,2,2,1,2,3,0,0,0,1,3,2
400995866,Creighton Bluejays,TEAM,TOTAL,TOTAL,False,,19,57,17,38,2,19,8,10,7,28,35,5,1,1,6,18,48
400995866,Creighton Bluejays,A. Faber,3938938,,True,34.0,3,11,3,9,0,2,1,2,1,5,6,1,0,0,1,3,7
400995866,Creighton Bluejays,J. Agnew,3938935,,True,35.0,1,6,1,4,0,2,2,2,0,4,4,1,0,1,0,4,4
400995866,Creighton Bluejays,B. Norby,3142284,,True,12.0,1,2,1,1,0,1,0,0,1,1,2,0,0,0,1,0,2
400995866,Creighton Bluejays,S. Lamberty,3142285,,True,40.0,8,17,7,12,1,5,3,3,2,8,10,3,1,0,0,1,20
400995866,Creighton Bluejays,M. Mellman,3142283,,True,11.0,1,2,0,0,1,2,0,0,0,2,2,0,0,0,0,0,3
400995866,Creighton Bluejays,A. Greene,3938937,,False,14.0,1,2,1,2,0,0,0,0,1,1,2,0,0,0,1,3,2
400995866,Creighton Bluejays,T. Carda,4281362,,False,26.0,4,9,4,7,0,2,0,1,0,3,3,0,0,0,2,4,8
400995866,Creighton Bluejays,O. Elger,3938936,,False,28.0,0,8,0,3,0,5,2,2,1,2,3,0,0,0,1,3,2
400995866,Creighton Bluejays,TEAM,TOTAL,TOTAL,False,,19,57,17,38,2,19,8,10,7,28,35,5,1,1,6,18,48
400995865,Seton Hall Pirates,S. Samuels,4068128,,True,35.0,4,14,4,14,0,0,1,1,6,5,11,3,0,1,1,3,9
400995865,Seton Hall Pirates,K. Evans,4281378,,True,11.0,1,4,1,4,0,0,1,2,1,1,2,0,0,0,1,1,3
400995865,Seton Hall Pirates,N. Jimenez,4281379,,True,27.0,6,12,2,4,4,8,0,0,1,1,2,2,4,0,0,1,16
400995865,Seton Hall Pirates,I. Butina,4281377,,True,37.0,4,10,1,4,3,6,1,2,0,3,3,6,1,0,1,4,12
400995865,Seton Hall Pirates,J. Jackson,3064877,,True,36.0,4,10,0,1,4,9,0,0,0,1,1,1,2,0,3,1,12
400995865,Seton Hall Pirates,S. Philoxy,4281380,,False,13.0,0,2,0,2,0,0,0,0,1,3,4,0,0,0,1,2,0
400995865,Seton Hall Pirates,T. Brown,3941336,,False,21.0,7,9,7,9,0,0,0,0,3,1,4,1,0,0,0,2,14
400995865,Seton Hall Pirates,D. Winters,4068126,,False,3.0,0,0,0,0,0,0,0,0,0,1,1,0,0,0,0,0,0
400995865,Seton Hall Pirates,K. Hilaire,4068123,,False,14.0,1,6,1,6,0,0,0,0,0,0,0,3,0,0,2,2,2
400995865,Seton Hall Pirates,K. Healy,3943704,,False,3.0,0,0,0,0,0,0,0,0,0,0,0,0,0,0,1,2,0
400995865,Seton Hall Pirates,TEAM,TOTAL,TOTAL,False,,27,67,16,44,11,23,3,5,15,19,34,16,7,1,11,18,68
400995865,Seton Hall Pirates,S. Samuels,4068128,,True,35.0,4,14,4,14,0,0,1,1,6,5,11,3,0,1,1,3,9
400995865,Seton Hall Pirates,K. Evans,4281378,,True,11.0,1,4,1,4,0,0,1,2,1,1,2,0,0,0,1,1,3
400995865,Seton Hall Pirates,N. Jimenez,4281379,,True,27.0,6,12,2,4,4,8,0,0,1,1,2,2,4,0,0,1,16
400995865,Seton Hall Pirates,I. Butina,4281377,,True,37.0,4,10,1,4,3,6,1,2,0,3,3,6,1,0,1,4,12
400995865,Seton Hall Pirates,J. Jackson,3064877,,True,36.0,4,10,0,1,4,9,0,0,0,1,1,1,2,0,3,1,12
400995865,Seton Hall Pirates,S. Philoxy,4281380,,False,13.0,0,2,0,2,0,0,0,0,1,3,4,0,0,0,1,2,0
400995865,Seton Hall Pirates,T. Brown,3941336,,False,21.0,7,9,7,9,0,0,0,0,3,1,4,1,0,0,0,2,14
400995865,Seton Hall Pirates,D. Winters,4068126,,False,3.0,0,0,0,0,0,0,0,0,0,1,1,0,0,0,0,0,0
400995865,Seton Hall Pirates,K. Hilaire,4068123,,False,14.0,1,6,1,6,0,0,0,0,0,0,0,3,0,0,2,2,2
400995865,Seton Hall Pirates,K. Healy,3943704,,False,3.0,0,0,0,0,0,0,0,0,0,0,0,0,0,0,1,2,0
400995865,Seton Hall Pirates,TEAM,TOTAL,TOTAL,False,,27,67,16,44,11,23,3,5,15,19,34,16,7,1,11,18,68
400995865,DePaul Blue Demons,C. Stonewall,4068072,,True,31.0,5,9,4,5,1,4,1,2,4,6,10,0,2,0,1,0,12
400995865,DePaul Blue Demons,M. Grays,3142287,,True,32.0,3,9,2,3,1,6,1,2,2,2,4,2,0,0,3,1,8
400995865,DePaul Blue Demons,K. Campbell,4068071,,True,37.0,0,9,0,1,0,8,4,4,0,11,11,2,0,0,1,3,4
400995865,DePaul Blue Demons,A. Millender,3142289,,True,35.0,5,12,2,4,3,8,3,4,2,1,3,2,0,0,3,3,16
400995865,DePaul Blue Demons,A. Coleman,3142123,,True,13.0,1,2,0,0,1,2,2,2,1,1,2,1,0,1,2,3,5
400995865,DePaul Blue Demons,D. Bekelja,4281356,,False,7.0,2,2,1,1,1,1,0,0,0,0,0,0,0,0,0,1,5
400995865,DePaul Blue Demons,T. Allen,3933760,,False,17.0,4,6,1,3,3,3,0,0,0,1,1,3,1,1,1,0,11
400995865,DePaul Blue Demons,L. Prochaska,3142290,,False,28.0,3,5,1,1,2,4,3,4,1,1,2,4,2,1,2,2,11
400995865,DePaul Blue Demons,TEAM,TOTAL,TOTAL,False,,23,54,11,18,12,36,14,18,12,26,38,14,5,3,13,13,72
400995865,DePaul Blue Demons,C. Stonewall,4068072,,True,31.0,5,9,4,5,1,4,1,2,4,6,10,0,2,0,1,0,12
400995865,DePaul Blue Demons,M. Grays,3142287,,True,32.0,3,9,2,3,1,6,1,2,2,2,4,2,0,0,3,1,8
400995865,DePaul Blue Demons,K. Campbell,4068071,,True,37.0,0,9,0,1,0,8,4,4,0,11,11,2,0,0,1,3,4
400995865,DePaul Blue Demons,A. Millender,3142289,,True,35.0,5,12,2,4,3,8,3,4,2,1,3,2,0,0,3,3,16
400995865,DePaul Blue Demons,A. Coleman,3142123,,True,13.0,1,2,0,0,1,2,2,2,1,1,2,1,0,1,2,3,5
400995865,DePaul Blue Demons,D. Bekelja,4281356,,False,7.0,2,2,1,1,1,1,0,0,0,0,0,0,0,0,0,1,5
400995865,DePaul Blue Demons,T. Allen,3933760,,False,17.0,4,6,1,3,3,3,0,0,0,1,1,3,1,1,1,0,11
400995865,DePaul Blue Demons,L. Prochaska,3142290,,False,28.0,3,5,1,1,2,4,3,4,1,1,2,4,2,1,2,2,11
400995865,DePaul Blue Demons,TEAM,TOTAL,TOTAL,False,,23,54,11,18,12,36,14,18,12,26,38,14,5,3,13,13,72
400995864,Villanova Wildcats,M. Quinn,3056785,,True,17.0,0,5,0,2,0,3,1,2,2,4,6,0,0,0,3,2,1
400995864,Villanova Wildcats,J. Tucker,3087536,,True,27.0,4,9,0,1,4,8,0,0,2,3,5,3,0,0,0,2,12
400995864,Villanova Wildcats,K. Jekot,4068171,,True,26.0,4,11,1,4,3,7,4,4,0,1,1,2,0,0,2,0,15
400995864,Villanova Wildcats,A. Hahn,3906779,,True,24.0,1,4,0,0,1,4,0,0,0,4,4,2,1,0,1,1,3
400995864,Villanova Wildcats,A. Louin,3142314,,True,27.0,4,7,3,5,1,2,4,4,2,2,4,3,2,0,0,0,13
400995864,Villanova Wildcats,G. Lange,4281371,,False,2.0,0,1,0,0,0,1,0,0,0,0,0,0,0,0,0,0,0
400995864,Villanova Wildcats,M. Gedaka,4068172,,False,18.0,6,9,5,8,1,1,0,1,1,3,4,1,2,0,0,1,13
400995864,Villanova Wildcats,B. Herlihy,4068169,,False,6.0,0,1,0,0,0,1,0,0,1,0,1,0,0,0,0,3,0
400995864,Villanova Wildcats,B. Herlihy,3906778,,False,18.0,2,3,0,0,2,3,1,2,3,3,6,3,0,1,0,2,7
400995864,Villanova Wildcats,G. Stant,3906780,,False,13.0,0,4,0,0,0,4,0,0,2,1,3,1,0,1,0,0,0
400995864,Villanova Wildcats,N. Juliana,4068170,,False,2.0,1,1,0,0,1,1,0,0,0,0,0,0,0,0,0,0,3
400995864,Villanova Wildcats,R. James,4068168,,False,11.0,0,0,0,0,0,0,1,2,1,1,2,1,2,0,2,1,1
400995864,Villanova Wildcats,C. Onken,4068167,,False,9.0,1,5,1,2,0,3,0,0,1,2,3,1,0,0,0,0,2
400995864,Villanova Wildcats,TEAM,TOTAL,TOTAL,False,,23,60,10,22,13,38,11,15,17,28,45,17,7,2,8,12,70
400995864,Villanova Wildcats,M. Quinn,3056785,,True,17.0,0,5,0,2,0,3,1,2,2,4,6,0,0,0,3,2,1
400995864,Villanova Wildcats,J. Tucker,3087536,,True,27.0,4,9,0,1,4,8,0,0,2,3,5,3,0,0,0,2,12
400995864,Villanova Wildcats,K. Jekot,4068171,,True,26.0,4,11,1,4,3,7,4,4,0,1,1,2,0,0,2,0,15
400995864,Villanova Wildcats,A. Hahn,3906779,,True,24.0,1,4,0,0,1,4,0,0,0,4,4,2,1,0,1,1,3
400995864,Villanova Wildcats,A. Louin,3142314,,True,27.0,4,7,3,5,1,2,4,4,2,2,4,3,2,0,0,0,13
400995864,Villanova Wildcats,G. Lange,4281371,,False,2.0,0,1,0,0,0,1,0,0,0,0,0,0,0,0,0,0,0
400995864,Villanova Wildcats,M. Gedaka,4068172,,False,18.0,6,9,5,8,1,1,0,1,1,3,4,1,2,0,0,1,13
400995864,Villanova Wildcats,B. Herlihy,4068169,,False,6.0,0,1,0,0,0,1,0,0,1,0,1,0,0,0,0,3,0
400995864,Villanova Wildcats,B. Herlihy,3906778,,False,18.0,2,3,0,0,2,3,1,2,3,3,6,3,0,1,0,2,7
400995864,Villanova Wildcats,G. Stant,3906780,,False,13.0,0,4,0,0,0,4,0,0,2,1,3,1,0,1,0,0,0
400995864,Villanova Wildcats,N. Juliana,4068170,,False,2.0,1,1,0,0,1,1,0,0,0,0,0,0,0,0,0,0,3
400995864,Villanova Wildcats,R. James,4068168,,False,11.0,0,0,0,0,0,0,1,2,1,1,2,1,2,0,2,1,1
400995864,Villanova Wildcats,C. Onken,4068167,,False,9.0,1,5,1,2,0,3,0,0,1,2,3,1,0,0,0,0,2
400995864,Villanova Wildcats,TEAM,TOTAL,TOTAL,False,,23,60,10,22,13,38,11,15,17,28,45,17,7,2,8,12,70
400995864,Providence Friars,A. Cooper,4281349,,True,35.0,4,11,4,11,0,0,1,2,3,7,10,2,0,0,2,2,9
400995864,Providence Friars,B. Frias,3142302,,True,16.0,1,1,1,1,0,0,1,4,1,1,2,1,1,0,1,1,3
400995864,Providence Friars,C. Williams,4281345,,True,25.0,4,8,4,8,0,0,1,1,0,3,3,4,0,0,2,2,9
400995864,Providence Friars,J. Nogic,3906769,,True,35.0,3,11,2,8,1,3,0,0,1,3,4,1,0,0,2,1,7
400995864,Providence Friars,M. Jolin,3906767,,True,34.0,2,9,1,6,1,3,2,2,0,2,2,1,2,0,0,2,7
400995864,Providence Friars,O. Orlando,4281347,,False,17.0,1,4,1,4,0,0,0,0,3,1,4,0,0,0,2,2,2
400995864,Providence Friars,K. Spiwak,4281346,,False,14.0,1,4,1,4,0,0,2,2,1,2,3,0,0,1,0,0,4
400995864,Providence Friars,C. Che,3906766,,False,24.0,1,5,1,4,0,1,0,0,0,0,0,3,1,0,0,0,2
400995864,Providence Friars,TEAM,TOTAL,TOTAL,False,,17,53,15,46,2,7,7,11,10,20,30,12,4,1,9,10,43
400995864,Providence Friars,A. Cooper,4281349,,True,35.0,4,11,4,11,0,0,1,2,3,7,10,2,0,0,2,2,9
400995864,Providence Friars,B. Frias,3142302,,True,16.0,1,1,1,1,0,0,1,4,1,1,2,1,1,0,1,1,3
400995864,Providence Friars,C. Williams,4281345,,True,25.0,4,8,4,8,0,0,1,1,0,3,3,4,0,0,2,2,9
400995864,Providence Friars,J. Nogic,3906769,,True,35.0,3,11,2,8,1,3,0,0,1,3,4,1,0,0,2,1,7
400995864,Providence Friars,M. Jolin,3906767,,True,34.0,2,9,1,6,1,3,2,2,0,2,2,1,2,0,0,2,7
400995864,Providence Friars,O. Orlando,4281347,,False,17.0,1,4,1,4,0,0,0,0,3,1,4,0,0,0,2,2,2
400995864,Providence Friars,K. Spiwak,4281346,,False,14.0,1,4,1,4,0,0,2,2,1,2,3,0,0,1,0,0,4
400995864,Providence Friars,C. Che,3906766,,False,24.0,1,5,1,4,0,1,0,0,0,0,0,3,1,0,0,0,2
400995864,Providence Friars,TEAM,TOTAL,TOTAL,False,,17,53,15,46,2,7,7,11,10,20,30,12,4,1,9,10,43
400995863,Seton Hall Pirates,S. Samuels,4068128,,True,28.0,2,5,1,2,1,3,0,1,2,1,3,2,2,1,5,4,5
400995863,Seton Hall Pirates,K. Evans,4281378,,True,14.0,0,0,0,0,0,0,0,0,0,1,1,1,0,0,1,4,0
400995863,Seton Hall Pirates,N. Jimenez,4281379,,True,26.0,5,11,3,5,2,6,0,0,1,1,2,1,4,1,2,0,12
400995863,Seton Hall Pirates,I. Butina,4281377,,True,27.0,0,6,0,4,0,2,0,0,0,4,4,3,2,0,2,1,0
400995863,Seton Hall Pirates,J. Jackson,3064877,,True,24.0,4,12,1,4,3,8,2,2,0,5,5,0,2,0,3,1,13
400995863,Seton Hall Pirates,S. Philoxy,4281380,,False,21.0,4,5,4,5,0,0,0,0,1,5,6,1,0,1,0,0,8
400995863,Seton Hall Pirates,T. Brown,3941336,,False,15.0,4,8,4,7,0,1,2,2,1,1,2,0,1,0,0,3,10
400995863,Seton Hall Pirates,J. Jones-Pack,4068129,,False,3.0,0,0,0,0,0,0,0,0,0,0,0,0,0,0,1,1,0
400995863,Seton Hall Pirates,D. Winters,4068126,,False,4.0,0,2,0,0,0,2,0,0,0,0,0,0,0,0,1,0,0
400995863,Seton Hall Pirates,K. Hilaire,4068123,,False,26.0,2,6,2,6,0,0,2,2,0,0,0,7,1,0,4,1,6
400995863,Seton Hall Pirates,K. Healy,3943704,,False,12.0,0,1,0,0,0,1,0,0,0,0,0,0,0,0,0,1,0
400995863,Seton Hall Pirates,TEAM,TOTAL,TOTAL,False,,21,56,15,33,6,23,6,7,6,19,25,15,12,3,21,16,54
400995863,Seton Hall Pirates,S. Samuels,4068128,,True,28.0,2,5,1,2,1,3,0,1,2,1,3,2,2,1,5,4,5
400995863,Seton Hall Pirates,K. Evans,4281378,,True,14.0,0,0,0,0,0,0,0,0,0,1,1,1,0,0,1,4,0
400995863,Seton Hall Pirates,N. Jimenez,4281379,,True,26.0,5,11,3,5,2,6,0,0,1,1,2,1,4,1,2,0,12
400995863,Seton Hall Pirates,I. Butina,4281377,,True,27.0,0,6,0,4,0,2,0,0,0,4,4,3,2,0,2,1,0
400995863,Seton Hall Pirates,J. Jackson,3064877,,True,24.0,4,12,1,4,3,8,2,2,0,5,5,0,2,0,3,1,13
400995863,Seton Hall Pirates,S. Philoxy,4281380,,False,21.0,4,5,4,5,0,0,0,0,1,5,6,1,0,1,0,0,8
400995863,Seton Hall Pirates,T. Brown,3941336,,False,15.0,4,8,4,7,0,1,2,2,1,1,2,0,1,0,0,3,10
400995863,Seton Hall Pirates,J. Jones-Pack,4068129,,False,3.0,0,0,0,0,0,0,0,0,0,0,0,0,0,0,1,1,0
400995863,Seton Hall Pirates,D. Winters,4068126,,False,4.0,0,2,0,0,0,2,0,0,0,0,0,0,0,0,1,0,0
400995863,Seton Hall Pirates,K. Hilaire,4068123,,False,26.0,2,6,2,6,0,0,2,2,0,0,0,7,1,0,4,1,6
400995863,Seton Hall Pirates,K. Healy,3943704,,False,12.0,0,1,0,0,0,1,0,0,0,0,0,0,0,0,0,1,0
400995863,Seton Hall Pirates,TEAM,TOTAL,TOTAL,False,,21,56,15,33,6,23,6,7,6,19,25,15,12,3,21,16,54
400995863,Marquette Golden Eagles,E. Davenport,3906756,,True,28.0,5,5,5,5,0,0,1,3,9,8,17,2,2,0,4,1,11
400995863,Marquette Golden Eagles,A. Wilborn,3906758,,True,33.0,4,8,4,6,0,2,3,4,2,5,7,5,3,0,4,2,11
400995863,Marquette Golden Eagles,A. Blockton,3906755,,True,26.0,9,16,9,14,0,2,3,3,1,2,3,1,2,0,6,4,21
400995863,Marquette Golden Eagles,N. Hiedeman,3906753,,True,32.0,7,11,5,6,2,5,2,2,0,2,2,3,2,0,1,2,18
400995863,Marquette Golden Eagles,D. King,3906752,,True,27.0,4,10,4,7,0,3,1,2,1,6,7,3,2,0,1,3,9
400995863,Marquette Golden Eagles,A. Anderson,4068081,,False,5.0,0,1,0,0,0,1,0,0,0,0,0,0,1,0,1,0,0
400995863,Marquette Golden Eagles,S. Dahling,3906754,,False,2.0,0,0,0,0,0,0,0,0,0,0,0,0,0,0,0,0,0
400995863,Marquette Golden Eagles,L. Van Kleunen,4068083,,False,14.0,1,6,1,3,0,3,0,0,0,2,2,1,1,0,1,2,2
400995863,Marquette Golden Eagles,S. Valentine,3142300,,False,7.0,1,1,1,1,0,0,0,0,1,1,2,0,0,0,0,0,2
400995863,Marquette Golden Eagles,S. Lott,4281350,,False,19.0,3,7,2,4,1,3,0,0,2,2,4,1,0,0,1,0,7
400995863,Marquette Golden Eagles,I. Spingola,4068082,,False,7.0,0,2,0,0,0,2,0,0,0,1,1,0,0,0,0,2,0
400995863,Marquette Golden Eagles,TEAM,TOTAL,TOTAL,False,,34,67,31,46,3,21,10,14,17,30,47,16,13,0,19,16,81
400995863,Marquette Golden Eagles,E. Davenport,3906756,,True,28.0,5,5,5,5,0,0,1,3,9,8,17,2,2,0,4,1,11
400995863,Marquette Golden Eagles,A. Wilborn,3906758,,True,33.0,4,8,4,6,0,2,3,4,2,5,7,5,3,0,4,2,11
400995863,Marquette Golden Eagles,A. Blockton,3906755,,True,26.0,9,16,9,14,0,2,3,3,1,2,3,1,2,0,6,4,21
400995863,Marquette Golden Eagles,N. Hiedeman,3906753,,True,32.0,7,11,5,6,2,5,2,2,0,2,2,3,2,0,1,2,18
400995863,Marquette Golden Eagles,D. King,3906752,,True,27.0,4,10,4,7,0,3,1,2,1,6,7,3,2,0,1,3,9
400995863,Marquette Golden Eagles,A. Anderson,4068081,,False,5.0,0,1,0,0,0,1,0,0,0,0,0,0,1,0,1,0,0
400995863,Marquette Golden Eagles,S. Dahling,3906754,,False,2.0,0,0,0,0,0,0,0,0,0,0,0,0,0,0,0,0,0
400995863,Marquette Golden Eagles,L. Van Kleunen,4068083,,False,14.0,1,6,1,3,0,3,0,0,0,2,2,1,1,0,1,2,2
400995863,Marquette Golden Eagles,S. Valentine,3142300,,False,7.0,1,1,1,1,0,0,0,0,1,1,2,0,0,0,0,0,2
400995863,Marquette Golden Eagles,S. Lott,4281350,,False,19.0,3,7,2,4,1,3,0,0,2,2,4,1,0,0,1,0,7
400995863,Marquette Golden Eagles,I. Spingola,4068082,,False,7.0,0,2,0,0,0,2,0,0,0,1,1,0,0,0,0,2,0
400995863,Marquette Golden Eagles,TEAM,TOTAL,TOTAL,False,,34,67,31,46,3,21,10,14,17,30,47,16,13,0,19,16,81
400995862,St. John's Red Storm,M. Singleton,4068158,,True,26.0,5,8,5,8,0,0,1,2,2,8,10,1,0,0,1,4,11
400995862,St. John's Red Storm,I. Littleton,3142306,,True,30.0,1,2,1,2,0,0,0,0,0,4,4,0,4,2,1,5,2
400995862,St. John's Red Storm,A. Wellere,3906771,,True,26.0,3,10,2,4,1,6,0,2,1,0,1,0,2,0,1,5,7
400995862,St. John's Red Storm,T. England,4068155,,True,35.0,9,12,9,10,0,2,3,3,0,2,2,4,1,0,2,0,21
400995862,St. John's Red Storm,A. Kebbe,4068154,,True,26.0,2,9,2,4,0,5,0,0,3,2,5,0,1,0,3,1,4
400995862,St. John's Red Storm,K. Charles,4281374,,False,4.0,1,1,1,1,0,0,0,0,0,0,0,0,0,0,0,0,2
400995862,St. John's Red Storm,Q. Hoppie,4281375,,False,24.0,2,13,2,10,0,3,1,2,1,2,3,1,0,0,2,2,5
400995862,St. John's Red Storm,A. Adams,4068157,,False,22.0,1,7,1,4,0,3,0,0,0,1,1,0,0,0,1,1,2
400995862,St. John's Red Storm,S. Duncan,4068156,,False,5.0,0,1,0,0,0,1,0,0,0,0,0,0,0,0,0,0,0
400995862,St. John's Red Storm,T. Alexander,3142305,,False,2.0,0,0,0,0,0,0,0,0,0,0,0,0,0,0,0,0,0
400995862,St. John's Red Storm,TEAM,TOTAL,TOTAL,False,,24,63,23,43,1,20,5,9,8,21,29,6,8,2,11,18,54
400995862,St. John's Red Storm,M. Singleton,4068158,,True,26.0,5,8,5,8,0,0,1,2,2,8,10,1,0,0,1,4,11
400995862,St. John's Red Storm,I. Littleton,3142306,,True,30.0,1,2,1,2,0,0,0,0,0,4,4,0,4,2,1,5,2
400995862,St. John's Red Storm,A. Wellere,3906771,,True,26.0,3,10,2,4,1,6,0,2,1,0,1,0,2,0,1,5,7
400995862,St. John's Red Storm,T. England,4068155,,True,35.0,9,12,9,10,0,2,3,3,0,2,2,4,1,0,2,0,21
400995862,St. John's Red Storm,A. Kebbe,4068154,,True,26.0,2,9,2,4,0,5,0,0,3,2,5,0,1,0,3,1,4
400995862,St. John's Red Storm,K. Charles,4281374,,False,4.0,1,1,1,1,0,0,0,0,0,0,0,0,0,0,0,0,2
400995862,St. John's Red Storm,Q. Hoppie,4281375,,False,24.0,2,13,2,10,0,3,1,2,1,2,3,1,0,0,2,2,5
400995862,St. John's Red Storm,A. Adams,4068157,,False,22.0,1,7,1,4,0,3,0,0,0,1,1,0,0,0,1,1,2
400995862,St. John's Red Storm,S. Duncan,4068156,,False,5.0,0,1,0,0,0,1,0,0,0,0,0,0,0,0,0,0,0
400995862,St. John's Red Storm,T. Alexander,3142305,,False,2.0,0,0,0,0,0,0,0,0,0,0,0,0,0,0,0,0,0
400995862,St. John's Red Storm,TEAM,TOTAL,TOTAL,False,,24,63,23,43,1,20,5,9,8,21,29,6,8,2,11,18,54
400995862,DePaul Blue Demons,C. Stonewall,4068072,,True,25.0,3,7,3,6,0,1,1,2,1,7,8,2,2,0,2,3,7
400995862,DePaul Blue Demons,M. Grays,3142287,,True,32.0,5,10,4,8,1,2,6,6,3,7,10,0,1,0,3,2,17
400995862,DePaul Blue Demons,K. Campbell,4068071,,True,30.0,4,6,2,2,2,4,2,3,1,9,10,6,0,0,3,3,12
400995862,DePaul Blue Demons,A. Millender,3142289,,True,37.0,5,12,1,3,4,9,0,0,1,2,3,2,0,0,2,0,14
400995862,DePaul Blue Demons,A. Coleman,3142123,,True,22.0,3,8,1,5,2,3,0,0,0,1,1,0,0,0,4,4,8
400995862,DePaul Blue Demons,R. McLimore,4281358,,False,2.0,0,1,0,0,0,1,0,0,0,0,0,0,0,0,0,0,0
400995862,DePaul Blue Demons,V. Sherrod,4281359,,False,1.0,0,0,0,0,0,0,0,0,0,0,0,0,0,0,0,0,0
400995862,DePaul Blue Demons,D. Bekelja,4281356,,False,3.0,0,0,0,0,0,0,0,0,0,0,0,0,0,0,0,0,0
400995862,DePaul Blue Demons,D. Cage,4068073,,False,2.0,0,1,0,0,0,1,0,0,0,1,1,0,0,1,1,0,0
400995862,DePaul Blue Demons,T. Allen,3933760,,False,20.0,3,5,2,3,1,2,0,0,2,2,4,0,0,0,4,1,7
400995862,DePaul Blue Demons,L. Prochaska,3142290,,False,26.0,0,3,0,2,0,1,2,2,0,1,1,5,2,0,1,1,2
400995862,DePaul Blue Demons,TEAM,TOTAL,TOTAL,False,,23,53,13,29,10,24,11,13,10,32,42,15,5,1,21,14,67
400995862,DePaul Blue Demons,C. Stonewall,4068072,,True,25.0,3,7,3,6,0,1,1,2,1,7,8,2,2,0,2,3,7
400995862,DePaul Blue Demons,M. Grays,3142287,,True,32.0,5,10,4,8,1,2,6,6,3,7,10,0,1,0,3,2,17
400995862,DePaul Blue Demons,K. Campbell,4068071,,True,30.0,4,6,2,2,2,4,2,3,1,9,10,6,0,0,3,3,12
400995862,DePaul Blue Demons,A. Millender,3142289,,True,37.0,5,12,1,3,4,9,0,0,1,2,3,2,0,0,2,0,14
400995862,DePaul Blue Demons,A. Coleman,3142123,,True,22.0,3,8,1,5,2,3,0,0,0,1,1,0,0,0,4,4,8
400995862,DePaul Blue Demons,R. McLimore,4281358,,False,2.0,0,1,0,0,0,1,0,0,0,0,0,0,0,0,0,0,0
400995862,DePaul Blue Demons,V. Sherrod,4281359,,False,1.0,0,0,0,0,0,0,0,0,0,0,0,0,0,0,0,0,0
400995862,DePaul Blue Demons,D. Bekelja,4281356,,False,3.0,0,0,0,0,0,0,0,0,0,0,0,0,0,0,0,0,0
400995862,DePaul Blue Demons,D. Cage,4068073,,False,2.0,0,1,0,0,0,1,0,0,0,1,1,0,0,1,1,0,0
400995862,DePaul Blue Demons,T. Allen,3933760,,False,20.0,3,5,2,3,1,2,0,0,2,2,4,0,0,0,4,1,7
400995862,DePaul Blue Demons,L. Prochaska,3142290,,False,26.0,0,3,0,2,0,1,2,2,0,1,1,5,2,0,1,1,2
400995862,DePaul Blue Demons,TEAM,TOTAL,TOTAL,False,,23,53,13,29,10,24,11,13,10,32,42,15,5,1,21,14,67
400995861,Georgetown Hoyas,C. Petke,4068078,,True,40.0,8,14,8,14,0,0,2,2,3,8,11,4,2,0,1,3,18
400995861,Georgetown Hoyas,Y. Belk,3142295,,True,15.0,0,3,0,3,0,0,0,0,1,1,2,0,0,1,0,1,0
400995861,Georgetown Hoyas,D. White,3948815,,True,38.0,4,10,4,9,0,1,4,4,1,7,8,8,5,0,3,2,12
400995861,Georgetown Hoyas,D. Burton,3142292,,True,29.0,6,9,4,5,2,4,0,0,0,1,1,4,2,0,6,1,14
400995861,Georgetown Hoyas,M. Venson,3142105,,True,38.0,2,8,1,3,1,5,2,2,1,2,3,5,0,0,1,2,7
400995861,Georgetown Hoyas,T. Thompson,4281352,,False,16.0,1,5,0,3,1,2,0,0,1,2,3,1,0,0,0,3,3
400995861,Georgetown Hoyas,M. Smith,4068079,,False,23.0,6,12,6,11,0,1,4,4,3,2,5,0,0,0,1,1,16
400995861,Georgetown Hoyas,TEAM,TOTAL,TOTAL,False,,27,61,23,48,4,13,12,12,11,28,39,22,9,1,12,13,70
400995861,Georgetown Hoyas,C. Petke,4068078,,True,40.0,8,14,8,14,0,0,2,2,3,8,11,4,2,0,1,3,18
400995861,Georgetown Hoyas,Y. Belk,3142295,,True,15.0,0,3,0,3,0,0,0,0,1,1,2,0,0,1,0,1,0
400995861,Georgetown Hoyas,D. White,3948815,,True,38.0,4,10,4,9,0,1,4,4,1,7,8,8,5,0,3,2,12
400995861,Georgetown Hoyas,D. Burton,3142292,,True,29.0,6,9,4,5,2,4,0,0,0,1,1,4,2,0,6,1,14
400995861,Georgetown Hoyas,M. Venson,3142105,,True,38.0,2,8,1,3,1,5,2,2,1,2,3,5,0,0,1,2,7
400995861,Georgetown Hoyas,T. Thompson,4281352,,False,16.0,1,5,0,3,1,2,0,0,1,2,3,1,0,0,0,3,3
400995861,Georgetown Hoyas,M. Smith,4068079,,False,23.0,6,12,6,11,0,1,4,4,3,2,5,0,0,0,1,1,16
400995861,Georgetown Hoyas,TEAM,TOTAL,TOTAL,False,,27,61,23,48,4,13,12,12,11,28,39,22,9,1,12,13,70
400995861,Creighton Bluejays,A. Faber,3938938,,True,29.0,4,15,1,7,3,8,4,6,0,2,2,3,0,1,3,4,15
400995861,Creighton Bluejays,J. Agnew,3938935,,True,39.0,4,13,3,6,1,7,2,3,2,7,9,3,0,2,2,3,11
400995861,Creighton Bluejays,B. Norby,3142284,,True,10.0,0,0,0,0,0,0,0,0,1,2,3,2,0,1,1,3,0
400995861,Creighton Bluejays,S. Lamberty,3142285,,True,37.0,3,7,0,2,3,5,0,0,2,0,2,5,3,0,4,0,9
400995861,Creighton Bluejays,M. Mellman,3142283,,True,24.0,3,3,0,0,3,3,2,2,0,1,1,1,0,1,0,1,11
400995861,Creighton Bluejays,A. Greene,3938937,,False,15.0,1,2,1,2,0,0,1,2,2,2,4,1,0,0,1,1,3
400995861,Creighton Bluejays,K. Brown,3142286,,False,6.0,1,1,1,1,0,0,0,0,1,0,1,0,0,0,0,1,2
400995861,Creighton Bluejays,T. Carda,4281362,,False,26.0,0,3,0,2,0,1,0,0,0,4,4,3,2,0,0,1,0
400995861,Creighton Bluejays,O. Elger,3938936,,False,13.0,5,10,1,2,4,8,2,2,0,1,1,1,1,0,2,4,16
400995861,Creighton Bluejays,B. Kissinger,3142124,,False,1.0,0,1,0,0,0,1,0,0,0,0,0,0,0,0,0,0,0
400995861,Creighton Bluejays,TEAM,TOTAL,TOTAL,False,,21,55,7,22,14,33,11,15,9,20,29,19,6,5,15,18,67
400995861,Creighton Bluejays,A. Faber,3938938,,True,29.0,4,15,1,7,3,8,4,6,0,2,2,3,0,1,3,4,15
400995861,Creighton Bluejays,J. Agnew,3938935,,True,39.0,4,13,3,6,1,7,2,3,2,7,9,3,0,2,2,3,11
400995861,Creighton Bluejays,B. Norby,3142284,,True,10.0,0,0,0,0,0,0,0,0,1,2,3,2,0,1,1,3,0
400995861,Creighton Bluejays,S. Lamberty,3142285,,True,37.0,3,7,0,2,3,5,0,0,2,0,2,5,3,0,4,0,9
400995861,Creighton Bluejays,M. Mellman,3142283,,True,24.0,3,3,0,0,3,3,2,2,0,1,1,1,0,1,0,1,11
400995861,Creighton Bluejays,A. Greene,3938937,,False,15.0,1,2,1,2,0,0,1,2,2,2,4,1,0,0,1,1,3
400995861,Creighton Bluejays,K. Brown,3142286,,False,6.0,1,1,1,1,0,0,0,0,1,0,1,0,0,0,0,1,2
400995861,Creighton Bluejays,T. Carda,4281362,,False,26.0,0,3,0,2,0,1,0,0,0,4,4,3,2,0,0,1,0
400995861,Creighton Bluejays,O. Elger,3938936,,False,13.0,5,10,1,2,4,8,2,2,0,1,1,1,1,0,2,4,16
400995861,Creighton Bluejays,B. Kissinger,3142124,,False,1.0,0,1,0,0,0,1,0,0,0,0,0,0,0,0,0,0,0
400995861,Creighton Bluejays,TEAM,TOTAL,TOTAL,False,,21,55,7,22,14,33,11,15,9,20,29,19,6,5,15,18,67
400995860,Marquette Golden Eagles,E. Davenport,3906756,,True,30.0,4,10,4,10,0,0,3,12,5,4,9,0,1,1,6,3,11
400995860,Marquette Golden Eagles,S. Valentine,3142300,,True,17.0,1,2,1,2,0,0,0,0,0,4,4,1,0,2,1,2,2
400995860,Marquette Golden Eagles,A. Blockton,3906755,,True,23.0,5,9,3,5,2,4,3,4,0,1,1,2,0,0,3,5,15
400995860,Marquette Golden Eagles,N. Hiedeman,3906753,,True,37.0,5,15,3,7,2,8,3,7,1,5,6,4,3,0,1,2,15
400995860,Marquette Golden Eagles,D. King,3906752,,True,23.0,1,3,1,1,0,2,2,2,0,1,1,0,1,0,1,1,4
400995860,Marquette Golden Eagles,L. Van Kleunen,4068083,,False,19.0,3,6,3,4,0,2,0,0,0,4,4,2,1,0,1,1,6
400995860,Marquette Golden Eagles,S. Lott,4281350,,False,20.0,1,1,1,1,0,0,2,2,1,2,3,0,1,0,1,0,4
400995860,Marquette Golden Eagles,I. Spingola,4068082,,False,6.0,1,2,0,0,1,2,0,0,0,1,1,0,0,0,0,1,3
400995860,Marquette Golden Eagles,A. Wilborn,3906758,,False,25.0,5,6,5,5,0,1,1,1,2,3,5,8,1,0,3,2,11
400995860,Marquette Golden Eagles,TEAM,TOTAL,TOTAL,False,,26,54,21,35,5,19,14,28,11,26,37,17,8,3,18,17,71
400995860,Marquette Golden Eagles,E. Davenport,3906756,,True,30.0,4,10,4,10,0,0,3,12,5,4,9,0,1,1,6,3,11
400995860,Marquette Golden Eagles,S. Valentine,3142300,,True,17.0,1,2,1,2,0,0,0,0,0,4,4,1,0,2,1,2,2
400995860,Marquette Golden Eagles,A. Blockton,3906755,,True,23.0,5,9,3,5,2,4,3,4,0,1,1,2,0,0,3,5,15
400995860,Marquette Golden Eagles,N. Hiedeman,3906753,,True,37.0,5,15,3,7,2,8,3,7,1,5,6,4,3,0,1,2,15
400995860,Marquette Golden Eagles,D. King,3906752,,True,23.0,1,3,1,1,0,2,2,2,0,1,1,0,1,0,1,1,4
400995860,Marquette Golden Eagles,L. Van Kleunen,4068083,,False,19.0,3,6,3,4,0,2,0,0,0,4,4,2,1,0,1,1,6
400995860,Marquette Golden Eagles,S. Lott,4281350,,False,20.0,1,1,1,1,0,0,2,2,1,2,3,0,1,0,1,0,4
400995860,Marquette Golden Eagles,I. Spingola,4068082,,False,6.0,1,2,0,0,1,2,0,0,0,1,1,0,0,0,0,1,3
400995860,Marquette Golden Eagles,A. Wilborn,3906758,,False,25.0,5,6,5,5,0,1,1,1,2,3,5,8,1,0,3,2,11
400995860,Marquette Golden Eagles,TEAM,TOTAL,TOTAL,False,,26,54,21,35,5,19,14,28,11,26,37,17,8,3,18,17,71
400995860,Georgetown Hoyas,C. Petke,4068078,,True,40.0,4,17,4,16,0,1,3,6,6,6,12,1,0,0,3,3,11
400995860,Georgetown Hoyas,Y. Belk,3142295,,True,18.0,3,4,3,4,0,0,0,0,1,5,6,0,1,0,1,4,6
400995860,Georgetown Hoyas,D. White,3948815,,True,40.0,11,18,9,12,2,6,3,3,0,4,4,2,1,0,2,4,27
400995860,Georgetown Hoyas,D. Burton,3142292,,True,31.0,1,2,1,2,0,0,1,2,1,3,4,4,4,0,4,4,3
400995860,Georgetown Hoyas,M. Venson,3142105,,True,28.0,3,9,2,6,1,3,2,3,0,1,1,3,2,0,1,3,9
400995860,Georgetown Hoyas,T. Thompson,4281352,,False,22.0,3,8,3,6,0,2,0,0,0,1,1,2,1,0,1,2,6
400995860,Georgetown Hoyas,M. Smith,4068079,,False,21.0,3,7,3,7,0,0,0,0,3,2,5,0,0,0,0,4,6
400995860,Georgetown Hoyas,TEAM,TOTAL,TOTAL,False,,28,65,25,53,3,12,9,14,12,23,35,12,9,0,12,24,68
400995860,Georgetown Hoyas,C. Petke,4068078,,True,40.0,4,17,4,16,0,1,3,6,6,6,12,1,0,0,3,3,11
400995860,Georgetown Hoyas,Y. Belk,3142295,,True,18.0,3,4,3,4,0,0,0,0,1,5,6,0,1,0,1,4,6
400995860,Georgetown Hoyas,D. White,3948815,,True,40.0,11,18,9,12,2,6,3,3,0,4,4,2,1,0,2,4,27
400995860,Georgetown Hoyas,D. Burton,3142292,,True,31.0,1,2,1,2,0,0,1,2,1,3,4,4,4,0,4,4,3
400995860,Georgetown Hoyas,M. Venson,3142105,,True,28.0,3,9,2,6,1,3,2,3,0,1,1,3,2,0,1,3,9
400995860,Georgetown Hoyas,T. Thompson,4281352,,False,22.0,3,8,3,6,0,2,0,0,0,1,1,2,1,0,1,2,6
400995860,Georgetown Hoyas,M. Smith,4068079,,False,21.0,3,7,3,7,0,0,0,0,3,2,5,0,0,0,0,4,6
400995860,Georgetown Hoyas,TEAM,TOTAL,TOTAL,False,,28,65,25,53,3,12,9,14,12,23,35,12,9,0,12,24,68
400995859,Villanova Wildcats,M. Quinn,3056785,,True,17.0,1,3,0,0,1,3,0,0,0,2,2,2,0,0,1,1,3
400995859,Villanova Wildcats,K. Jekot,4068171,,True,35.0,7,18,4,13,3,5,0,0,0,4,4,2,0,0,2,1,17
400995859,Villanova Wildcats,C. Onken,4068167,,True,21.0,1,4,1,1,0,3,0,0,0,3,3,2,1,0,0,4,2
400995859,Villanova Wildcats,A. Louin,3142314,,True,34.0,4,15,3,9,1,6,4,4,1,6,7,6,1,0,2,4,13
400995859,Villanova Wildcats,J. Tucker,3087536,,True,35.0,5,10,3,5,2,5,0,0,1,3,4,1,0,0,2,2,12
400995859,Villanova Wildcats,M. Gedaka,4068172,,False,24.0,5,9,5,9,0,0,2,4,1,5,6,0,0,0,2,1,12
400995859,Villanova Wildcats,Brid. Herlihy,3906778,,False,12.0,0,3,0,2,0,1,0,0,0,2,2,2,0,0,1,2,0
400995859,Villanova Wildcats,G. Stant,3906780,,False,17.0,1,2,0,0,1,2,4,4,2,1,3,1,0,0,0,0,7
400995859,Villanova Wildcats,R. James,4068168,,False,5.0,0,0,0,0,0,0,0,0,0,1,1,1,0,0,0,1,0
400995859,Villanova Wildcats,TEAM,TOTAL,TOTAL,False,,24,64,16,39,8,25,10,12,7,29,36,17,2,0,10,16,66
400995859,Villanova Wildcats,M. Quinn,3056785,,True,17.0,1,3,0,0,1,3,0,0,0,2,2,2,0,0,1,1,3
400995859,Villanova Wildcats,K. Jekot,4068171,,True,35.0,7,18,4,13,3,5,0,0,0,4,4,2,0,0,2,1,17
400995859,Villanova Wildcats,C. Onken,4068167,,True,21.0,1,4,1,1,0,3,0,0,0,3,3,2,1,0,0,4,2
400995859,Villanova Wildcats,A. Louin,3142314,,True,34.0,4,15,3,9,1,6,4,4,1,6,7,6,1,0,2,4,13
400995859,Villanova Wildcats,J. Tucker,3087536,,True,35.0,5,10,3,5,2,5,0,0,1,3,4,1,0,0,2,2,12
400995859,Villanova Wildcats,M. Gedaka,4068172,,False,24.0,5,9,5,9,0,0,2,4,1,5,6,0,0,0,2,1,12
400995859,Villanova Wildcats,Brid. Herlihy,3906778,,False,12.0,0,3,0,2,0,1,0,0,0,2,2,2,0,0,1,2,0
400995859,Villanova Wildcats,G. Stant,3906780,,False,17.0,1,2,0,0,1,2,4,4,2,1,3,1,0,0,0,0,7
400995859,Villanova Wildcats,R. James,4068168,,False,5.0,0,0,0,0,0,0,0,0,0,1,1,1,0,0,0,1,0
400995859,Villanova Wildcats,TEAM,TOTAL,TOTAL,False,,24,64,16,39,8,25,10,12,7,29,36,17,2,0,10,16,66
400995859,DePaul Blue Demons,C. Stonewall,4068072,,True,22.0,2,6,1,4,1,2,3,5,3,3,6,1,1,0,1,3,8
400995859,DePaul Blue Demons,K. Campbell,4068071,,True,36.0,1,5,0,2,1,3,1,2,4,9,13,4,2,0,2,2,4
400995859,DePaul Blue Demons,L. Prochaska,3142290,,True,34.0,2,5,2,4,0,1,4,7,1,2,3,4,0,0,0,0,8
400995859,DePaul Blue Demons,A. Millender,3142289,,True,35.0,8,14,5,8,3,6,0,0,0,1,1,1,0,1,0,1,19
400995859,DePaul Blue Demons,A. Coleman,3142123,,True,33.0,5,11,4,7,1,4,4,4,0,7,7,4,1,1,1,2,15
400995859,DePaul Blue Demons,M. Grays,3142287,,False,24.0,3,13,2,8,1,5,1,2,0,5,5,2,0,1,3,5,8
400995859,DePaul Blue Demons,D. Cage,4068073,,False,0.0,0,0,0,0,0,0,0,0,0,0,0,0,0,0,0,1,0
400995859,DePaul Blue Demons,T. Allen,3933760,,False,16.0,3,6,2,3,1,3,2,3,0,5,5,0,0,0,2,0,9
400995859,DePaul Blue Demons,TEAM,TOTAL,TOTAL,False,,24,60,16,36,8,24,15,23,9,32,41,16,4,3,9,14,71
400995859,DePaul Blue Demons,C. Stonewall,4068072,,True,22.0,2,6,1,4,1,2,3,5,3,3,6,1,1,0,1,3,8
400995859,DePaul Blue Demons,K. Campbell,4068071,,True,36.0,1,5,0,2,1,3,1,2,4,9,13,4,2,0,2,2,4
400995859,DePaul Blue Demons,L. Prochaska,3142290,,True,34.0,2,5,2,4,0,1,4,7,1,2,3,4,0,0,0,0,8
400995859,DePaul Blue Demons,A. Millender,3142289,,True,35.0,8,14,5,8,3,6,0,0,0,1,1,1,0,1,0,1,19
400995859,DePaul Blue Demons,A. Coleman,3142123,,True,33.0,5,11,4,7,1,4,4,4,0,7,7,4,1,1,1,2,15
400995859,DePaul Blue Demons,M. Grays,3142287,,False,24.0,3,13,2,8,1,5,1,2,0,5,5,2,0,1,3,5,8
400995859,DePaul Blue Demons,D. Cage,4068073,,False,0.0,0,0,0,0,0,0,0,0,0,0,0,0,0,0,0,1,0
400995859,DePaul Blue Demons,T. Allen,3933760,,False,16.0,3,6,2,3,1,3,2,3,0,5,5,0,0,0,2,0,9
400995859,DePaul Blue Demons,TEAM,TOTAL,TOTAL,False,,24,60,16,36,8,24,15,23,9,32,41,16,4,3,9,14,71
400995858,Creighton Bluejays,K. Brown,3142286,,True,10.0,1,2,1,2,0,0,0,0,0,0,0,0,0,2,0,0,2
400995858,Creighton Bluejays,B. Norby,3142284,,True,8.0,1,3,1,2,0,1,0,0,0,4,4,0,1,0,1,2,2
400995858,Creighton Bluejays,T. Rembao,4281361,,True,0.0,0,1,0,1,0,0,0,0,0,0,0,0,0,0,0,0,0
400995858,Creighton Bluejays,A. Rischard,3943697,,True,2.0,0,0,0,0,0,0,0,0,0,0,0,0,0,0,1,0,0
400995858,Creighton Bluejays,M. Mellman,3142283,,True,13.0,1,2,0,0,1,2,0,0,0,1,1,1,0,0,1,1,3
400995858,Creighton Bluejays,A. Faber,3938938,,False,34.0,5,8,2,3,3,5,0,0,1,7,8,3,0,3,3,3,13
400995858,Creighton Bluejays,A. Greene,3938937,,False,22.0,5,6,5,6,0,0,4,4,3,1,4,1,0,1,1,4,14
400995858,Creighton Bluejays,J. Agnew,3938935,,False,35.0,5,12,5,8,0,4,1,2,1,6,7,4,2,2,1,2,11
400995858,Creighton Bluejays,T. Carda,4281362,,False,11.0,1,2,0,1,1,1,0,0,0,1,1,0,0,0,2,2,3
400995858,Creighton Bluejays,O. Elger,3938936,,False,28.0,3,8,1,4,2,4,4,6,1,5,6,3,1,0,1,4,12
400995858,Creighton Bluejays,S. Lamberty,3142285,,False,35.0,1,9,1,8,0,1,2,2,2,4,6,5,0,1,5,1,4
400995858,Creighton Bluejays,B. Kissinger,3142124,,False,2.0,0,0,0,0,0,0,0,0,0,1,1,0,0,0,0,0,0
400995858,Creighton Bluejays,TEAM,TOTAL,TOTAL,False,,23,53,16,35,7,18,11,14,8,30,38,17,4,9,16,19,64
400995858,Creighton Bluejays,K. Brown,3142286,,True,10.0,1,2,1,2,0,0,0,0,0,0,0,0,0,2,0,0,2
400995858,Creighton Bluejays,B. Norby,3142284,,True,8.0,1,3,1,2,0,1,0,0,0,4,4,0,1,0,1,2,2
400995858,Creighton Bluejays,T. Rembao,4281361,,True,0.0,0,1,0,1,0,0,0,0,0,0,0,0,0,0,0,0,0
400995858,Creighton Bluejays,A. Rischard,3943697,,True,2.0,0,0,0,0,0,0,0,0,0,0,0,0,0,0,1,0,0
400995858,Creighton Bluejays,M. Mellman,3142283,,True,13.0,1,2,0,0,1,2,0,0,0,1,1,1,0,0,1,1,3
400995858,Creighton Bluejays,A. Faber,3938938,,False,34.0,5,8,2,3,3,5,0,0,1,7,8,3,0,3,3,3,13
400995858,Creighton Bluejays,A. Greene,3938937,,False,22.0,5,6,5,6,0,0,4,4,3,1,4,1,0,1,1,4,14
400995858,Creighton Bluejays,J. Agnew,3938935,,False,35.0,5,12,5,8,0,4,1,2,1,6,7,4,2,2,1,2,11
400995858,Creighton Bluejays,T. Carda,4281362,,False,11.0,1,2,0,1,1,1,0,0,0,1,1,0,0,0,2,2,3
400995858,Creighton Bluejays,O. Elger,3938936,,False,28.0,3,8,1,4,2,4,4,6,1,5,6,3,1,0,1,4,12
400995858,Creighton Bluejays,S. Lamberty,3142285,,False,35.0,1,9,1,8,0,1,2,2,2,4,6,5,0,1,5,1,4
400995858,Creighton Bluejays,B. Kissinger,3142124,,False,2.0,0,0,0,0,0,0,0,0,0,1,1,0,0,0,0,0,0
400995858,Creighton Bluejays,TEAM,TOTAL,TOTAL,False,,23,53,16,35,7,18,11,14,8,30,38,17,4,9,16,19,64
400995858,Butler Bulldogs,T. Schickel,3914012,,True,38.0,7,16,7,16,0,0,6,7,6,2,8,2,1,0,3,2,20
400995858,Butler Bulldogs,K. Spolyar,4068068,,True,30.0,3,13,2,9,1,4,0,2,2,6,8,3,3,1,4,4,7
400995858,Butler Bulldogs,M. Weaver,3914014,,True,32.0,2,6,2,4,0,2,0,0,0,0,0,2,3,0,2,5,4
400995858,Butler Bulldogs,W. Jennings,3142145,,True,39.0,4,16,2,7,2,9,0,0,0,4,4,5,0,0,2,4,10
400995858,Butler Bulldogs,I. Lathan,3079485,,True,14.0,1,5,1,5,0,0,0,0,0,2,2,2,1,0,1,2,2
400995858,Butler Bulldogs,S. Brey,4068067,,False,22.0,3,3,3,3,0,0,0,0,1,5,6,1,1,0,1,1,6
400995858,Butler Bulldogs,K. Hodges,4068065,,False,10.0,3,4,3,4,0,0,0,0,1,0,1,0,1,0,0,1,6
400995858,Butler Bulldogs,S. Buck,3142279,,False,15.0,0,1,0,0,0,1,0,0,0,1,1,1,0,0,0,0,0
400995858,Butler Bulldogs,TEAM,TOTAL,TOTAL,False,,23,64,20,48,3,16,6,9,14,21,35,16,10,1,13,19,55
400995858,Butler Bulldogs,T. Schickel,3914012,,True,38.0,7,16,7,16,0,0,6,7,6,2,8,2,1,0,3,2,20
400995858,Butler Bulldogs,K. Spolyar,4068068,,True,30.0,3,13,2,9,1,4,0,2,2,6,8,3,3,1,4,4,7
400995858,Butler Bulldogs,M. Weaver,3914014,,True,32.0,2,6,2,4,0,2,0,0,0,0,0,2,3,0,2,5,4
400995858,Butler Bulldogs,W. Jennings,3142145,,True,39.0,4,16,2,7,2,9,0,0,0,4,4,5,0,0,2,4,10
400995858,Butler Bulldogs,I. Lathan,3079485,,True,14.0,1,5,1,5,0,0,0,0,0,2,2,2,1,0,1,2,2
400995858,Butler Bulldogs,S. Brey,4068067,,False,22.0,3,3,3,3,0,0,0,0,1,5,6,1,1,0,1,1,6
400995858,Butler Bulldogs,K. Hodges,4068065,,False,10.0,3,4,3,4,0,0,0,0,1,0,1,0,1,0,0,1,6
400995858,Butler Bulldogs,S. Buck,3142279,,False,15.0,0,1,0,0,0,1,0,0,0,1,1,1,0,0,0,0,0
400995858,Butler Bulldogs,TEAM,TOTAL,TOTAL,False,,23,64,20,48,3,16,6,9,14,21,35,16,10,1,13,19,55
400995857,Xavier Musketeers,I. Partlow,3142320,,True,10.0,1,1,1,1,0,0,1,2,2,0,2,0,0,0,2,1,3
400995857,Xavier Musketeers,A. Äijänen,3142319,,True,24.0,2,8,2,6,0,2,0,0,0,3,3,0,1,0,2,3,4
400995857,Xavier Musketeers,A. Dunham,4281365,,True,22.0,1,5,0,0,1,5,0,0,0,0,0,1,1,0,0,1,3
400995857,Xavier Musketeers,N. Owens,4068187,,True,26.0,5,8,4,4,1,4,2,3,0,1,1,3,0,0,0,0,13
400995857,Xavier Musketeers,J. Byrd,3142318,,True,23.0,2,6,2,5,0,1,0,2,2,4,6,1,0,0,3,4,4
400995857,Xavier Musketeers,A. Gray,4281368,,False,23.0,5,11,4,6,1,5,1,1,4,5,9,0,3,0,2,1,12
400995857,Xavier Musketeers,D. Ross,4281364,,False,7.0,0,2,0,0,0,2,0,0,0,0,0,0,1,0,1,0,0
400995857,Xavier Musketeers,M. Christopher,4068186,,False,5.0,0,0,0,0,0,0,0,0,0,0,0,0,0,0,0,4,0
400995857,Xavier Musketeers,A. Reiff,4281367,,False,8.0,1,1,0,0,1,1,1,2,0,0,0,0,0,0,0,1,4
400995857,Xavier Musketeers,P. Stewart,4281366,,False,16.0,1,4,1,3,0,1,0,0,0,1,1,0,0,0,1,1,2
400995857,Xavier Musketeers,A. Gomez,4068185,,False,11.0,0,3,0,0,0,3,0,0,0,1,1,0,0,0,0,0,0
400995857,Xavier Musketeers,K. Fincher,3142317,,False,25.0,1,5,0,1,1,4,0,0,1,1,2,2,0,0,1,0,3
400995857,Xavier Musketeers,TEAM,TOTAL,TOTAL,False,,19,54,14,26,5,28,5,10,9,18,27,7,6,0,12,16,48
400995857,Xavier Musketeers,I. Partlow,3142320,,True,10.0,1,1,1,1,0,0,1,2,2,0,2,0,0,0,2,1,3
400995857,Xavier Musketeers,A. Äijänen,3142319,,True,24.0,2,8,2,6,0,2,0,0,0,3,3,0,1,0,2,3,4
400995857,Xavier Musketeers,A. Dunham,4281365,,True,22.0,1,5,0,0,1,5,0,0,0,0,0,1,1,0,0,1,3
400995857,Xavier Musketeers,N. Owens,4068187,,True,26.0,5,8,4,4,1,4,2,3,0,1,1,3,0,0,0,0,13
400995857,Xavier Musketeers,J. Byrd,3142318,,True,23.0,2,6,2,5,0,1,0,2,2,4,6,1,0,0,3,4,4
400995857,Xavier Musketeers,A. Gray,4281368,,False,23.0,5,11,4,6,1,5,1,1,4,5,9,0,3,0,2,1,12
400995857,Xavier Musketeers,D. Ross,4281364,,False,7.0,0,2,0,0,0,2,0,0,0,0,0,0,1,0,1,0,0
400995857,Xavier Musketeers,M. Christopher,4068186,,False,5.0,0,0,0,0,0,0,0,0,0,0,0,0,0,0,0,4,0
400995857,Xavier Musketeers,A. Reiff,4281367,,False,8.0,1,1,0,0,1,1,1,2,0,0,0,0,0,0,0,1,4
400995857,Xavier Musketeers,P. Stewart,4281366,,False,16.0,1,4,1,3,0,1,0,0,0,1,1,0,0,0,1,1,2
400995857,Xavier Musketeers,A. Gomez,4068185,,False,11.0,0,3,0,0,0,3,0,0,0,1,1,0,0,0,0,0,0
400995857,Xavier Musketeers,K. Fincher,3142317,,False,25.0,1,5,0,1,1,4,0,0,1,1,2,2,0,0,1,0,3
400995857,Xavier Musketeers,TEAM,TOTAL,TOTAL,False,,19,54,14,26,5,28,5,10,9,18,27,7,6,0,12,16,48
400995857,Providence Friars,B. Frias,3142302,,True,20.0,2,3,2,3,0,0,0,0,1,3,4,0,1,0,0,2,4
400995857,Providence Friars,C. Williams,4281345,,True,32.0,6,10,5,8,1,2,0,2,1,3,4,4,0,0,5,3,13
400995857,Providence Friars,J. Nogic,3906769,,True,38.0,10,17,7,10,3,7,2,2,0,5,5,3,1,1,3,2,25
400995857,Providence Friars,M. Jolin,3906767,,True,29.0,4,7,1,2,3,5,0,2,0,10,10,3,0,0,2,1,11
400995857,Providence Friars,A. Botteghi,3142301,,True,27.0,3,7,3,7,0,0,1,1,1,6,7,2,1,0,2,2,7
400995857,Providence Friars,A. Cooper,4281349,,False,15.0,0,0,0,0,0,0,0,0,0,0,0,0,1,1,0,2,0
400995857,Providence Friars,K. Spiwak,4281346,,False,10.0,1,2,1,2,0,0,0,0,0,0,0,0,0,0,0,0,2
400995857,Providence Friars,N. Jackson,4068111,,False,9.0,1,1,1,1,0,0,0,0,1,1,2,0,0,0,0,0,2
400995857,Providence Friars,C. Che,3906766,,False,20.0,2,4,1,2,1,2,0,0,0,0,0,0,0,0,1,2,5
400995857,Providence Friars,TEAM,TOTAL,TOTAL,False,,29,51,21,35,8,16,3,7,4,30,34,12,4,2,13,14,69
400995857,Providence Friars,B. Frias,3142302,,True,20.0,2,3,2,3,0,0,0,0,1,3,4,0,1,0,0,2,4
400995857,Providence Friars,C. Williams,4281345,,True,32.0,6,10,5,8,1,2,0,2,1,3,4,4,0,0,5,3,13
400995857,Providence Friars,J. Nogic,3906769,,True,38.0,10,17,7,10,3,7,2,2,0,5,5,3,1,1,3,2,25
400995857,Providence Friars,M. Jolin,3906767,,True,29.0,4,7,1,2,3,5,0,2,0,10,10,3,0,0,2,1,11
400995857,Providence Friars,A. Botteghi,3142301,,True,27.0,3,7,3,7,0,0,1,1,1,6,7,2,1,0,2,2,7
400995857,Providence Friars,A. Cooper,4281349,,False,15.0,0,0,0,0,0,0,0,0,0,0,0,0,1,1,0,2,0
400995857,Providence Friars,K. Spiwak,4281346,,False,10.0,1,2,1,2,0,0,0,0,0,0,0,0,0,0,0,0,2
400995857,Providence Friars,N. Jackson,4068111,,False,9.0,1,1,1,1,0,0,0,0,1,1,2,0,0,0,0,0,2
400995857,Providence Friars,C. Che,3906766,,False,20.0,2,4,1,2,1,2,0,0,0,0,0,0,0,0,1,2,5
400995857,Providence Friars,TEAM,TOTAL,TOTAL,False,,29,51,21,35,8,16,3,7,4,30,34,12,4,2,13,14,69
400995856,Villanova Wildcats,M. Quinn,3056785,,True,16.0,3,9,1,3,2,6,2,3,3,3,6,2,0,3,0,0,10
400995856,Villanova Wildcats,K. Jekot,4068171,,True,30.0,3,10,3,7,0,3,0,0,0,2,2,2,0,0,3,1,6
400995856,Villanova Wildcats,A. Hahn,3906779,,True,29.0,2,6,1,3,1,3,2,2,1,1,2,3,0,0,1,1,7
400995856,Villanova Wildcats,A. Louin,3142314,,True,36.0,7,13,5,7,2,6,4,4,1,3,4,1,1,0,1,2,20
400995856,Villanova Wildcats,J. Tucker,3087536,,True,26.0,3,5,1,2,2,3,0,0,0,1,1,2,1,0,2,3,8
400995856,Villanova Wildcats,M. Gedaka,4068172,,False,19.0,5,11,5,10,0,1,0,0,3,4,7,2,0,0,1,1,10
400995856,Villanova Wildcats,Bria. Herlihy,4068169,,False,4.0,2,3,2,3,0,0,0,0,1,0,1,0,0,0,0,0,4
400995856,Villanova Wildcats,Brid. Herlihy,3906778,,False,15.0,1,4,1,2,0,2,0,0,1,1,2,1,1,1,2,2,2
400995856,Villanova Wildcats,G. Stant,3906780,,False,13.0,0,4,0,0,0,4,0,0,0,4,4,0,0,0,0,1,0
400995856,Villanova Wildcats,R. James,4068168,,False,4.0,1,1,1,1,0,0,0,0,1,0,1,0,0,0,0,1,2
400995856,Villanova Wildcats,C. Onken,4068167,,False,8.0,0,3,0,0,0,3,0,0,1,0,1,0,0,0,1,0,0
400995856,Villanova Wildcats,TEAM,TOTAL,TOTAL,False,,27,69,20,38,7,31,8,9,14,22,36,13,3,4,11,12,69
400995856,Villanova Wildcats,M. Quinn,3056785,,True,16.0,3,9,1,3,2,6,2,3,3,3,6,2,0,3,0,0,10
400995856,Villanova Wildcats,K. Jekot,4068171,,True,30.0,3,10,3,7,0,3,0,0,0,2,2,2,0,0,3,1,6
400995856,Villanova Wildcats,A. Hahn,3906779,,True,29.0,2,6,1,3,1,3,2,2,1,1,2,3,0,0,1,1,7
400995856,Villanova Wildcats,A. Louin,3142314,,True,36.0,7,13,5,7,2,6,4,4,1,3,4,1,1,0,1,2,20
400995856,Villanova Wildcats,J. Tucker,3087536,,True,26.0,3,5,1,2,2,3,0,0,0,1,1,2,1,0,2,3,8
400995856,Villanova Wildcats,M. Gedaka,4068172,,False,19.0,5,11,5,10,0,1,0,0,3,4,7,2,0,0,1,1,10
400995856,Villanova Wildcats,Bria. Herlihy,4068169,,False,4.0,2,3,2,3,0,0,0,0,1,0,1,0,0,0,0,0,4
400995856,Villanova Wildcats,Brid. Herlihy,3906778,,False,15.0,1,4,1,2,0,2,0,0,1,1,2,1,1,1,2,2,2
400995856,Villanova Wildcats,G. Stant,3906780,,False,13.0,0,4,0,0,0,4,0,0,0,4,4,0,0,0,0,1,0
400995856,Villanova Wildcats,R. James,4068168,,False,4.0,1,1,1,1,0,0,0,0,1,0,1,0,0,0,0,1,2
400995856,Villanova Wildcats,C. Onken,4068167,,False,8.0,0,3,0,0,0,3,0,0,1,0,1,0,0,0,1,0,0
400995856,Villanova Wildcats,TEAM,TOTAL,TOTAL,False,,27,69,20,38,7,31,8,9,14,22,36,13,3,4,11,12,69
400995856,Marquette Golden Eagles,E. Davenport,3906756,,True,28.0,8,15,8,15,0,0,0,1,4,4,8,1,1,0,3,3,16
400995856,Marquette Golden Eagles,A. Wilborn,3906758,,True,34.0,4,11,3,8,1,3,0,1,0,5,5,4,1,0,0,0,9
400995856,Marquette Golden Eagles,A. Blockton,3906755,,True,31.0,6,14,5,13,1,1,2,2,3,3,6,2,0,0,3,4,15
400995856,Marquette Golden Eagles,N. Hiedeman,3906753,,True,24.0,10,14,7,8,3,6,3,4,1,2,3,2,2,0,0,3,26
400995856,Marquette Golden Eagles,A. Anderson,4068081,,False,1.0,0,0,0,0,0,0,0,0,0,1,1,0,0,0,0,1,0
400995856,Marquette Golden Eagles,S. Dahling,3906754,,False,1.0,0,0,0,0,0,0,0,0,0,0,0,0,0,0,0,0,0
400995856,Marquette Golden Eagles,L. Van Kleunen,4068083,,False,10.0,1,2,1,1,0,1,0,0,0,2,2,0,0,0,0,2,2
400995856,Marquette Golden Eagles,S. Valentine,3142300,,False,9.0,2,2,2,2,0,0,0,0,1,0,1,1,0,0,1,1,4
400995856,Marquette Golden Eagles,S. Lott,4281350,,False,23.0,1,2,0,0,1,2,0,0,2,2,4,2,2,1,0,1,3
400995856,Marquette Golden Eagles,I. Spingola,4068082,,False,4.0,0,1,0,0,0,1,0,0,0,0,0,0,0,0,0,0,0
400995856,Marquette Golden Eagles,D. King,3906752,,False,35.0,6,11,4,6,2,5,1,1,2,5,7,8,0,0,1,0,15
400995856,Marquette Golden Eagles,TEAM,TOTAL,TOTAL,False,,38,72,30,53,8,19,6,9,13,26,39,20,6,1,8,15,90
400995856,Marquette Golden Eagles,E. Davenport,3906756,,True,28.0,8,15,8,15,0,0,0,1,4,4,8,1,1,0,3,3,16
400995856,Marquette Golden Eagles,A. Wilborn,3906758,,True,34.0,4,11,3,8,1,3,0,1,0,5,5,4,1,0,0,0,9
400995856,Marquette Golden Eagles,A. Blockton,3906755,,True,31.0,6,14,5,13,1,1,2,2,3,3,6,2,0,0,3,4,15
400995856,Marquette Golden Eagles,N. Hiedeman,3906753,,True,24.0,10,14,7,8,3,6,3,4,1,2,3,2,2,0,0,3,26
400995856,Marquette Golden Eagles,A. Anderson,4068081,,False,1.0,0,0,0,0,0,0,0,0,0,1,1,0,0,0,0,1,0
400995856,Marquette Golden Eagles,S. Dahling,3906754,,False,1.0,0,0,0,0,0,0,0,0,0,0,0,0,0,0,0,0,0
400995856,Marquette Golden Eagles,L. Van Kleunen,4068083,,False,10.0,1,2,1,1,0,1,0,0,0,2,2,0,0,0,0,2,2
400995856,Marquette Golden Eagles,S. Valentine,3142300,,False,9.0,2,2,2,2,0,0,0,0,1,0,1,1,0,0,1,1,4
400995856,Marquette Golden Eagles,S. Lott,4281350,,False,23.0,1,2,0,0,1,2,0,0,2,2,4,2,2,1,0,1,3
400995856,Marquette Golden Eagles,I. Spingola,4068082,,False,4.0,0,1,0,0,0,1,0,0,0,0,0,0,0,0,0,0,0
400995856,Marquette Golden Eagles,D. King,3906752,,False,35.0,6,11,4,6,2,5,1,1,2,5,7,8,0,0,1,0,15
400995856,Marquette Golden Eagles,TEAM,TOTAL,TOTAL,False,,38,72,30,53,8,19,6,9,13,26,39,20,6,1,8,15,90
400995855,Georgetown Hoyas,C. Petke,4068078,,True,38.0,10,15,10,14,0,1,3,4,5,6,11,3,2,1,3,1,23
400995855,Georgetown Hoyas,M. Smith,4068079,,True,33.0,3,8,3,8,0,0,0,0,1,1,2,1,2,0,0,2,6
400995855,Georgetown Hoyas,Y. Belk,3142295,,True,19.0,3,7,3,7,0,0,2,2,1,4,5,2,3,1,1,2,8
400995855,Georgetown Hoyas,D. White,3948815,,True,40.0,14,25,11,19,3,6,2,2,2,2,4,3,4,1,4,2,33
400995855,Georgetown Hoyas,D. Burton,3142292,,True,39.0,2,7,2,7,0,0,2,2,1,3,4,8,2,0,1,4,6
400995855,Georgetown Hoyas,T. Thompson,4281352,,False,26.0,4,6,2,4,2,2,0,0,2,1,3,0,1,0,1,0,10
400995855,Georgetown Hoyas,M. Osagie-Erese,4072597,,False,5.0,0,1,0,1,0,0,0,0,0,1,1,0,0,0,1,1,0
400995855,Georgetown Hoyas,TEAM,TOTAL,TOTAL,False,,36,69,31,60,5,9,9,10,14,18,32,17,14,3,11,12,86
400995855,Georgetown Hoyas,C. Petke,4068078,,True,38.0,10,15,10,14,0,1,3,4,5,6,11,3,2,1,3,1,23
400995855,Georgetown Hoyas,M. Smith,4068079,,True,33.0,3,8,3,8,0,0,0,0,1,1,2,1,2,0,0,2,6
400995855,Georgetown Hoyas,Y. Belk,3142295,,True,19.0,3,7,3,7,0,0,2,2,1,4,5,2,3,1,1,2,8
400995855,Georgetown Hoyas,D. White,3948815,,True,40.0,14,25,11,19,3,6,2,2,2,2,4,3,4,1,4,2,33
400995855,Georgetown Hoyas,D. Burton,3142292,,True,39.0,2,7,2,7,0,0,2,2,1,3,4,8,2,0,1,4,6
400995855,Georgetown Hoyas,T. Thompson,4281352,,False,26.0,4,6,2,4,2,2,0,0,2,1,3,0,1,0,1,0,10
400995855,Georgetown Hoyas,M. Osagie-Erese,4072597,,False,5.0,0,1,0,1,0,0,0,0,0,1,1,0,0,0,1,1,0
400995855,Georgetown Hoyas,TEAM,TOTAL,TOTAL,False,,36,69,31,60,5,9,9,10,14,18,32,17,14,3,11,12,86
400995855,DePaul Blue Demons,C. Stonewall,4068072,,True,25.0,4,7,4,6,0,1,4,4,3,2,5,1,0,1,2,1,12
400995855,DePaul Blue Demons,M. Grays,3142287,,True,33.0,6,10,6,7,0,3,1,1,0,4,4,3,0,1,3,3,13
400995855,DePaul Blue Demons,K. Campbell,4068071,,True,36.0,4,7,2,3,2,4,0,0,3,3,6,13,3,0,2,2,10
400995855,DePaul Blue Demons,A. Millender,3142289,,True,35.0,6,10,1,2,5,8,2,2,1,1,2,2,1,0,1,3,19
400995855,DePaul Blue Demons,A. Coleman,3142123,,True,33.0,6,10,2,6,4,4,2,3,0,4,4,4,0,0,4,1,18
400995855,DePaul Blue Demons,D. Cage,4068073,,False,7.0,3,4,1,1,2,3,0,0,0,3,3,0,0,0,2,0,8
400995855,DePaul Blue Demons,T. Allen,3933760,,False,21.0,1,6,1,3,0,3,2,2,1,1,2,1,0,0,2,0,4
400995855,DePaul Blue Demons,L. Prochaska,3142290,,False,10.0,0,2,0,1,0,1,1,2,1,1,2,1,0,0,2,1,1
400995855,DePaul Blue Demons,TEAM,TOTAL,TOTAL,False,,30,56,17,29,13,27,12,14,9,20,29,25,4,2,19,11,85
400995855,DePaul Blue Demons,C. Stonewall,4068072,,True,25.0,4,7,4,6,0,1,4,4,3,2,5,1,0,1,2,1,12
400995855,DePaul Blue Demons,M. Grays,3142287,,True,33.0,6,10,6,7,0,3,1,1,0,4,4,3,0,1,3,3,13
400995855,DePaul Blue Demons,K. Campbell,4068071,,True,36.0,4,7,2,3,2,4,0,0,3,3,6,13,3,0,2,2,10
400995855,DePaul Blue Demons,A. Millender,3142289,,True,35.0,6,10,1,2,5,8,2,2,1,1,2,2,1,0,1,3,19
400995855,DePaul Blue Demons,A. Coleman,3142123,,True,33.0,6,10,2,6,4,4,2,3,0,4,4,4,0,0,4,1,18
400995855,DePaul Blue Demons,D. Cage,4068073,,False,7.0,3,4,1,1,2,3,0,0,0,3,3,0,0,0,2,0,8
400995855,DePaul Blue Demons,T. Allen,3933760,,False,21.0,1,6,1,3,0,3,2,2,1,1,2,1,0,0,2,0,4
400995855,DePaul Blue Demons,L. Prochaska,3142290,,False,10.0,0,2,0,1,0,1,1,2,1,1,2,1,0,0,2,1,1
400995855,DePaul Blue Demons,TEAM,TOTAL,TOTAL,False,,30,56,17,29,13,27,12,14,9,20,29,25,4,2,19,11,85
400995854,Xavier Musketeers,A. Äijänen,3142319,,True,28.0,0,3,0,0,0,3,2,2,0,2,2,1,0,0,2,2,2
400995854,Xavier Musketeers,P. Stewart,4281366,,True,28.0,2,3,0,0,2,3,0,0,0,2,2,2,1,0,1,1,6
400995854,Xavier Musketeers,A. Dunham,4281365,,True,33.0,2,7,1,2,1,5,0,0,0,2,2,2,1,1,0,1,5
400995854,Xavier Musketeers,N. Owens,4068187,,True,30.0,6,8,6,7,0,1,3,3,0,2,2,1,2,0,4,2,15
400995854,Xavier Musketeers,J. Byrd,3142318,,True,31.0,6,10,6,9,0,1,1,2,0,2,2,1,0,0,2,2,13
400995854,Xavier Musketeers,A. Gray,4281368,,False,17.0,2,6,1,2,1,4,0,0,1,5,6,0,0,1,0,3,5
400995854,Xavier Musketeers,I. Partlow,3142320,,False,17.0,4,8,4,7,0,1,0,0,2,2,4,0,0,0,3,1,8
400995854,Xavier Musketeers,A. Reiff,4281367,,False,8.0,0,0,0,0,0,0,0,0,0,1,1,0,0,0,0,1,0
400995854,Xavier Musketeers,K. Fincher,3142317,,False,8.0,0,0,0,0,0,0,0,0,0,1,1,1,0,0,0,1,0
400995854,Xavier Musketeers,TEAM,TOTAL,TOTAL,False,,22,45,18,27,4,18,6,7,3,20,23,8,4,2,13,14,54
400995854,Xavier Musketeers,A. Äijänen,3142319,,True,28.0,0,3,0,0,0,3,2,2,0,2,2,1,0,0,2,2,2
400995854,Xavier Musketeers,P. Stewart,4281366,,True,28.0,2,3,0,0,2,3,0,0,0,2,2,2,1,0,1,1,6
400995854,Xavier Musketeers,A. Dunham,4281365,,True,33.0,2,7,1,2,1,5,0,0,0,2,2,2,1,1,0,1,5
400995854,Xavier Musketeers,N. Owens,4068187,,True,30.0,6,8,6,7,0,1,3,3,0,2,2,1,2,0,4,2,15
400995854,Xavier Musketeers,J. Byrd,3142318,,True,31.0,6,10,6,9,0,1,1,2,0,2,2,1,0,0,2,2,13
400995854,Xavier Musketeers,A. Gray,4281368,,False,17.0,2,6,1,2,1,4,0,0,1,5,6,0,0,1,0,3,5
400995854,Xavier Musketeers,I. Partlow,3142320,,False,17.0,4,8,4,7,0,1,0,0,2,2,4,0,0,0,3,1,8
400995854,Xavier Musketeers,A. Reiff,4281367,,False,8.0,0,0,0,0,0,0,0,0,0,1,1,0,0,0,0,1,0
400995854,Xavier Musketeers,K. Fincher,3142317,,False,8.0,0,0,0,0,0,0,0,0,0,1,1,1,0,0,0,1,0
400995854,Xavier Musketeers,TEAM,TOTAL,TOTAL,False,,22,45,18,27,4,18,6,7,3,20,23,8,4,2,13,14,54
400995854,Creighton Bluejays,A. Faber,3938938,,True,35.0,4,10,2,5,2,5,0,0,0,3,3,3,0,1,4,3,10
400995854,Creighton Bluejays,J. Agnew,3938935,,True,37.0,4,8,2,3,2,5,2,2,1,8,9,3,1,1,1,1,12
400995854,Creighton Bluejays,B. Norby,3142284,,True,10.0,3,4,3,3,0,1,0,0,0,2,2,1,0,0,1,1,6
400995854,Creighton Bluejays,S. Lamberty,3142285,,True,38.0,5,14,2,10,3,4,0,0,2,3,5,9,1,1,1,0,13
400995854,Creighton Bluejays,M. Mellman,3142283,,True,6.0,1,2,1,2,0,0,0,0,0,0,0,0,0,0,0,0,2
400995854,Creighton Bluejays,A. Greene,3938937,,False,23.0,3,4,3,4,0,0,2,2,7,1,8,1,0,0,1,1,8
400995854,Creighton Bluejays,K. Brown,3142286,,False,4.0,0,0,0,0,0,0,0,0,0,0,0,1,0,0,0,0,0
400995854,Creighton Bluejays,T. Carda,4281362,,False,17.0,1,6,1,5,0,1,0,0,0,1,1,1,0,0,0,1,2
400995854,Creighton Bluejays,O. Elger,3938936,,False,26.0,4,6,1,2,3,4,1,2,0,2,2,2,3,0,2,2,12
400995854,Creighton Bluejays,B. Kissinger,3142124,,False,4.0,0,1,0,1,0,0,0,0,0,0,0,0,0,0,1,0,0
400995854,Creighton Bluejays,TEAM,TOTAL,TOTAL,False,,25,55,15,35,10,20,5,6,10,20,30,21,5,3,11,9,65
400995854,Creighton Bluejays,A. Faber,3938938,,True,35.0,4,10,2,5,2,5,0,0,0,3,3,3,0,1,4,3,10
400995854,Creighton Bluejays,J. Agnew,3938935,,True,37.0,4,8,2,3,2,5,2,2,1,8,9,3,1,1,1,1,12
400995854,Creighton Bluejays,B. Norby,3142284,,True,10.0,3,4,3,3,0,1,0,0,0,2,2,1,0,0,1,1,6
400995854,Creighton Bluejays,S. Lamberty,3142285,,True,38.0,5,14,2,10,3,4,0,0,2,3,5,9,1,1,1,0,13
400995854,Creighton Bluejays,M. Mellman,3142283,,True,6.0,1,2,1,2,0,0,0,0,0,0,0,0,0,0,0,0,2
400995854,Creighton Bluejays,A. Greene,3938937,,False,23.0,3,4,3,4,0,0,2,2,7,1,8,1,0,0,1,1,8
400995854,Creighton Bluejays,K. Brown,3142286,,False,4.0,0,0,0,0,0,0,0,0,0,0,0,1,0,0,0,0,0
400995854,Creighton Bluejays,T. Carda,4281362,,False,17.0,1,6,1,5,0,1,0,0,0,1,1,1,0,0,0,1,2
400995854,Creighton Bluejays,O. Elger,3938936,,False,26.0,4,6,1,2,3,4,1,2,0,2,2,2,3,0,2,2,12
400995854,Creighton Bluejays,B. Kissinger,3142124,,False,4.0,0,1,0,1,0,0,0,0,0,0,0,0,0,0,1,0,0
400995854,Creighton Bluejays,TEAM,TOTAL,TOTAL,False,,25,55,15,35,10,20,5,6,10,20,30,21,5,3,11,9,65
400995853,Providence Friars,A. Cooper,4281349,,True,26.0,3,8,3,8,0,0,2,2,2,2,4,1,0,1,1,4,8
400995853,Providence Friars,C. Williams,4281345,,True,23.0,2,10,2,9,0,1,0,0,1,1,2,2,0,0,1,0,4
400995853,Providence Friars,J. Nogic,3906769,,True,28.0,4,14,2,7,2,7,0,0,0,2,2,2,0,0,2,1,10
400995853,Providence Friars,M. Jolin,3906767,,True,36.0,2,9,0,1,2,8,0,0,0,5,5,3,1,1,0,1,6
400995853,Providence Friars,C. Che,3906766,,True,19.0,3,8,1,2,2,6,0,0,0,1,1,1,1,0,3,1,8
400995853,Providence Friars,B. Frias,3142302,,False,10.0,0,0,0,0,0,0,0,0,0,1,1,0,0,2,0,0,0
400995853,Providence Friars,O. Orlando,4281347,,False,2.0,1,2,1,2,0,0,0,0,0,0,0,0,0,0,0,0,2
400995853,Providence Friars,K. Spiwak,4281346,,False,29.0,2,3,2,3,0,0,0,0,2,2,4,1,1,0,1,0,4
400995853,Providence Friars,N. Jackson,4068111,,False,15.0,2,5,2,5,0,0,0,0,0,1,1,2,0,0,0,0,4
400995853,Providence Friars,A. Botteghi,3142301,,False,12.0,1,5,1,5,0,0,0,0,5,3,8,0,0,1,2,0,2
400995853,Providence Friars,TEAM,TOTAL,TOTAL,False,,20,64,14,42,6,22,2,2,11,23,34,12,3,5,10,7,48
400995853,Providence Friars,A. Cooper,4281349,,True,26.0,3,8,3,8,0,0,2,2,2,2,4,1,0,1,1,4,8
400995853,Providence Friars,C. Williams,4281345,,True,23.0,2,10,2,9,0,1,0,0,1,1,2,2,0,0,1,0,4
400995853,Providence Friars,J. Nogic,3906769,,True,28.0,4,14,2,7,2,7,0,0,0,2,2,2,0,0,2,1,10
400995853,Providence Friars,M. Jolin,3906767,,True,36.0,2,9,0,1,2,8,0,0,0,5,5,3,1,1,0,1,6
400995853,Providence Friars,C. Che,3906766,,True,19.0,3,8,1,2,2,6,0,0,0,1,1,1,1,0,3,1,8
400995853,Providence Friars,B. Frias,3142302,,False,10.0,0,0,0,0,0,0,0,0,0,1,1,0,0,2,0,0,0
400995853,Providence Friars,O. Orlando,4281347,,False,2.0,1,2,1,2,0,0,0,0,0,0,0,0,0,0,0,0,2
400995853,Providence Friars,K. Spiwak,4281346,,False,29.0,2,3,2,3,0,0,0,0,2,2,4,1,1,0,1,0,4
400995853,Providence Friars,N. Jackson,4068111,,False,15.0,2,5,2,5,0,0,0,0,0,1,1,2,0,0,0,0,4
400995853,Providence Friars,A. Botteghi,3142301,,False,12.0,1,5,1,5,0,0,0,0,5,3,8,0,0,1,2,0,2
400995853,Providence Friars,TEAM,TOTAL,TOTAL,False,,20,64,14,42,6,22,2,2,11,23,34,12,3,5,10,7,48
400995853,Butler Bulldogs,T. Schickel,3914012,,True,32.0,5,10,5,10,0,0,2,2,2,5,7,6,1,3,2,1,12
400995853,Butler Bulldogs,K. Spolyar,4068068,,True,26.0,4,11,2,5,2,6,3,4,1,6,7,3,1,0,1,1,13
400995853,Butler Bulldogs,M. Weaver,3914014,,True,31.0,7,10,4,4,3,6,3,4,1,1,2,1,2,0,2,2,20
400995853,Butler Bulldogs,W. Jennings,3142145,,True,34.0,4,13,0,3,4,10,2,2,0,3,3,3,0,0,2,1,14
400995853,Butler Bulldogs,I. Lathan,3079485,,True,27.0,1,4,1,4,0,0,0,0,0,10,10,1,1,0,0,0,2
400995853,Butler Bulldogs,S. Brey,4068067,,False,21.0,3,5,3,5,0,0,0,0,1,4,5,0,1,0,2,3,6
400995853,Butler Bulldogs,K. Hodges,4068065,,False,13.0,1,4,1,4,0,0,0,0,3,1,4,0,2,0,1,1,2
400995853,Butler Bulldogs,S. Humphrey,4068066,,False,1.0,0,0,0,0,0,0,0,0,0,0,0,0,0,0,0,0,0
400995853,Butler Bulldogs,S. Buck,3142279,,False,15.0,0,1,0,0,0,1,0,0,0,1,1,0,0,0,0,0,0
400995853,Butler Bulldogs,TEAM,TOTAL,TOTAL,False,,25,58,16,35,9,23,10,12,10,32,42,14,8,3,10,9,69
400995853,Butler Bulldogs,T. Schickel,3914012,,True,32.0,5,10,5,10,0,0,2,2,2,5,7,6,1,3,2,1,12
400995853,Butler Bulldogs,K. Spolyar,4068068,,True,26.0,4,11,2,5,2,6,3,4,1,6,7,3,1,0,1,1,13
400995853,Butler Bulldogs,M. Weaver,3914014,,True,31.0,7,10,4,4,3,6,3,4,1,1,2,1,2,0,2,2,20
400995853,Butler Bulldogs,W. Jennings,3142145,,True,34.0,4,13,0,3,4,10,2,2,0,3,3,3,0,0,2,1,14
400995853,Butler Bulldogs,I. Lathan,3079485,,True,27.0,1,4,1,4,0,0,0,0,0,10,10,1,1,0,0,0,2
400995853,Butler Bulldogs,S. Brey,4068067,,False,21.0,3,5,3,5,0,0,0,0,1,4,5,0,1,0,2,3,6
400995853,Butler Bulldogs,K. Hodges,4068065,,False,13.0,1,4,1,4,0,0,0,0,3,1,4,0,2,0,1,1,2
400995853,Butler Bulldogs,S. Humphrey,4068066,,False,1.0,0,0,0,0,0,0,0,0,0,0,0,0,0,0,0,0,0
400995853,Butler Bulldogs,S. Buck,3142279,,False,15.0,0,1,0,0,0,1,0,0,0,1,1,0,0,0,0,0,0
400995853,Butler Bulldogs,TEAM,TOTAL,TOTAL,False,,25,58,16,35,9,23,10,12,10,32,42,14,8,3,10,9,69
400995852,St. John's Red Storm,M. Singleton,4068158,,True,30.0,5,8,5,8,0,0,1,3,0,9,9,0,1,1,2,4,11
400995852,St. John's Red Storm,I. Littleton,3142306,,True,26.0,0,0,0,0,0,0,0,2,2,2,4,4,1,1,1,2,0
400995852,St. John's Red Storm,A. Wellere,3906771,,True,31.0,3,7,0,2,3,5,2,2,1,1,2,3,1,0,3,3,11
400995852,St. John's Red Storm,Q. Hoppie,4281375,,True,28.0,6,12,3,8,3,4,3,3,1,1,2,2,0,0,3,0,18
400995852,St. John's Red Storm,A. Kebbe,4068154,,True,29.0,7,8,5,5,2,3,4,4,0,3,3,2,2,2,1,0,20
400995852,St. John's Red Storm,K. Charles,4281374,,False,10.0,3,4,3,4,0,0,2,2,0,2,2,1,0,1,0,0,8
400995852,St. John's Red Storm,A. Adams,4068157,,False,18.0,0,3,0,2,0,1,0,0,0,0,0,1,1,0,1,3,0
400995852,St. John's Red Storm,S. Duncan,4068156,,False,3.0,1,1,0,0,1,1,0,0,0,0,0,1,0,0,0,0,3
400995852,St. John's Red Storm,T. England,4068155,,False,21.0,1,3,1,3,0,0,2,2,0,3,3,4,1,0,2,2,4
400995852,St. John's Red Storm,T. Alexander,3142305,,False,4.0,0,0,0,0,0,0,0,0,0,0,0,0,0,0,2,0,0
400995852,St. John's Red Storm,TEAM,TOTAL,TOTAL,False,,26,46,17,32,9,14,14,18,5,22,27,18,7,5,15,14,75
400995852,St. John's Red Storm,M. Singleton,4068158,,True,30.0,5,8,5,8,0,0,1,3,0,9,9,0,1,1,2,4,11
400995852,St. John's Red Storm,I. Littleton,3142306,,True,26.0,0,0,0,0,0,0,0,2,2,2,4,4,1,1,1,2,0
400995852,St. John's Red Storm,A. Wellere,3906771,,True,31.0,3,7,0,2,3,5,2,2,1,1,2,3,1,0,3,3,11
400995852,St. John's Red Storm,Q. Hoppie,4281375,,True,28.0,6,12,3,8,3,4,3,3,1,1,2,2,0,0,3,0,18
400995852,St. John's Red Storm,A. Kebbe,4068154,,True,29.0,7,8,5,5,2,3,4,4,0,3,3,2,2,2,1,0,20
400995852,St. John's Red Storm,K. Charles,4281374,,False,10.0,3,4,3,4,0,0,2,2,0,2,2,1,0,1,0,0,8
400995852,St. John's Red Storm,A. Adams,4068157,,False,18.0,0,3,0,2,0,1,0,0,0,0,0,1,1,0,1,3,0
400995852,St. John's Red Storm,S. Duncan,4068156,,False,3.0,1,1,0,0,1,1,0,0,0,0,0,1,0,0,0,0,3
400995852,St. John's Red Storm,T. England,4068155,,False,21.0,1,3,1,3,0,0,2,2,0,3,3,4,1,0,2,2,4
400995852,St. John's Red Storm,T. Alexander,3142305,,False,4.0,0,0,0,0,0,0,0,0,0,0,0,0,0,0,2,0,0
400995852,St. John's Red Storm,TEAM,TOTAL,TOTAL,False,,26,46,17,32,9,14,14,18,5,22,27,18,7,5,15,14,75
400995852,Seton Hall Pirates,S. Samuels,4068128,,True,24.0,0,4,0,4,0,0,1,2,1,5,6,5,0,1,4,1,1
400995852,Seton Hall Pirates,K. Evans,4281378,,True,22.0,6,9,6,9,0,0,2,4,2,2,4,0,0,0,1,2,14
400995852,Seton Hall Pirates,N. Jimenez,4281379,,True,34.0,6,10,2,3,4,7,1,2,0,2,2,2,2,0,2,3,17
400995852,Seton Hall Pirates,I. Butina,4281377,,True,29.0,3,7,3,6,0,1,4,4,2,2,4,1,0,0,4,2,10
400995852,Seton Hall Pirates,J. Jackson,3064877,,True,24.0,2,5,2,5,0,0,2,2,0,0,0,0,3,0,0,1,6
400995852,Seton Hall Pirates,S. Philoxy,4281380,,False,22.0,0,5,0,5,0,0,0,0,1,3,4,0,1,2,1,4,0
400995852,Seton Hall Pirates,J. Jones-Pack,4068129,,False,2.0,0,0,0,0,0,0,0,0,0,0,0,0,0,0,0,0,0
400995852,Seton Hall Pirates,D. Winters,4068126,,False,15.0,3,5,3,4,0,1,0,0,1,2,3,0,2,0,1,1,6
400995852,Seton Hall Pirates,K. Hilaire,4068123,,False,18.0,1,3,1,3,0,0,0,0,0,0,0,1,0,0,2,4,2
400995852,Seton Hall Pirates,K. Healy,3943704,,False,10.0,0,0,0,0,0,0,0,0,0,0,0,0,0,0,0,0,0
400995852,Seton Hall Pirates,TEAM,TOTAL,TOTAL,False,,21,48,17,39,4,9,10,14,7,17,24,9,8,3,15,18,56
400995852,Seton Hall Pirates,S. Samuels,4068128,,True,24.0,0,4,0,4,0,0,1,2,1,5,6,5,0,1,4,1,1
400995852,Seton Hall Pirates,K. Evans,4281378,,True,22.0,6,9,6,9,0,0,2,4,2,2,4,0,0,0,1,2,14
400995852,Seton Hall Pirates,N. Jimenez,4281379,,True,34.0,6,10,2,3,4,7,1,2,0,2,2,2,2,0,2,3,17
400995852,Seton Hall Pirates,I. Butina,4281377,,True,29.0,3,7,3,6,0,1,4,4,2,2,4,1,0,0,4,2,10
400995852,Seton Hall Pirates,J. Jackson,3064877,,True,24.0,2,5,2,5,0,0,2,2,0,0,0,0,3,0,0,1,6
400995852,Seton Hall Pirates,S. Philoxy,4281380,,False,22.0,0,5,0,5,0,0,0,0,1,3,4,0,1,2,1,4,0
400995852,Seton Hall Pirates,J. Jones-Pack,4068129,,False,2.0,0,0,0,0,0,0,0,0,0,0,0,0,0,0,0,0,0
400995852,Seton Hall Pirates,D. Winters,4068126,,False,15.0,3,5,3,4,0,1,0,0,1,2,3,0,2,0,1,1,6
400995852,Seton Hall Pirates,K. Hilaire,4068123,,False,18.0,1,3,1,3,0,0,0,0,0,0,0,1,0,0,2,4,2
400995852,Seton Hall Pirates,K. Healy,3943704,,False,10.0,0,0,0,0,0,0,0,0,0,0,0,0,0,0,0,0,0
400995852,Seton Hall Pirates,TEAM,TOTAL,TOTAL,False,,21,48,17,39,4,9,10,14,7,17,24,9,8,3,15,18,56
400995851,Xavier Musketeers,A. Aijanen,3142319,,True,30.0,7,9,4,5,3,4,1,2,0,4,4,2,3,0,0,2,18
400995851,Xavier Musketeers,P. Stewart,4281366,,True,36.0,5,6,2,2,3,4,0,2,1,4,5,2,1,1,2,2,13
400995851,Xavier Musketeers,A. Dunham,4281365,,True,33.0,4,9,1,2,3,7,0,0,0,3,3,3,0,0,4,2,11
400995851,Xavier Musketeers,N. Owens,4068187,,True,28.0,4,6,2,3,2,3,1,2,1,2,3,6,2,0,3,3,11
400995851,Xavier Musketeers,J. Byrd,3142318,,True,28.0,3,6,3,6,0,0,1,2,0,0,0,1,0,0,4,4,7
400995851,Xavier Musketeers,A. Gray,4281368,,False,23.0,3,6,2,3,1,3,1,2,1,0,1,0,0,0,2,4,8
400995851,Xavier Musketeers,A. Reiff,4281367,,False,9.0,0,1,0,1,0,0,0,0,0,0,0,1,1,0,1,1,0
400995851,Xavier Musketeers,K. Fincher,3142317,,False,13.0,1,2,1,1,0,1,2,4,0,1,1,1,0,0,0,0,4
400995851,Xavier Musketeers,TEAM,TOTAL,TOTAL,False,,27,45,15,23,12,22,6,14,4,17,21,16,7,1,16,18,72
400995851,Xavier Musketeers,A. Aijanen,3142319,,True,30.0,7,9,4,5,3,4,1,2,0,4,4,2,3,0,0,2,18
400995851,Xavier Musketeers,P. Stewart,4281366,,True,36.0,5,6,2,2,3,4,0,2,1,4,5,2,1,1,2,2,13
400995851,Xavier Musketeers,A. Dunham,4281365,,True,33.0,4,9,1,2,3,7,0,0,0,3,3,3,0,0,4,2,11
400995851,Xavier Musketeers,N. Owens,4068187,,True,28.0,4,6,2,3,2,3,1,2,1,2,3,6,2,0,3,3,11
400995851,Xavier Musketeers,J. Byrd,3142318,,True,28.0,3,6,3,6,0,0,1,2,0,0,0,1,0,0,4,4,7
400995851,Xavier Musketeers,A. Gray,4281368,,False,23.0,3,6,2,3,1,3,1,2,1,0,1,0,0,0,2,4,8
400995851,Xavier Musketeers,A. Reiff,4281367,,False,9.0,0,1,0,1,0,0,0,0,0,0,0,1,1,0,1,1,0
400995851,Xavier Musketeers,K. Fincher,3142317,,False,13.0,1,2,1,1,0,1,2,4,0,1,1,1,0,0,0,0,4
400995851,Xavier Musketeers,TEAM,TOTAL,TOTAL,False,,27,45,15,23,12,22,6,14,4,17,21,16,7,1,16,18,72
400995851,DePaul Blue Demons,C. Stonewall,4068072,,True,31.0,5,8,3,3,2,5,0,0,4,1,5,1,1,0,1,0,12
400995851,DePaul Blue Demons,M. Grays,3142287,,True,34.0,5,16,3,8,2,8,4,6,2,4,6,0,2,0,3,3,16
400995851,DePaul Blue Demons,K. Campbell,4068071,,True,35.0,2,9,0,4,2,5,3,4,5,9,14,9,1,0,1,3,9
400995851,DePaul Blue Demons,A. Millender,3142289,,True,36.0,6,11,4,5,2,6,2,2,3,0,3,2,2,0,1,3,16
400995851,DePaul Blue Demons,A. Coleman,3142123,,True,24.0,4,8,4,5,0,3,2,2,0,2,2,2,2,1,6,3,10
400995851,DePaul Blue Demons,D. Bekelja,4281356,,False,1.0,0,0,0,0,0,0,0,0,0,0,0,0,0,0,0,0,0
400995851,DePaul Blue Demons,T. Allen,3933760,,False,18.0,2,5,2,4,0,1,1,2,2,1,3,0,1,0,2,2,5
400995851,DePaul Blue Demons,L. Prochaska,3142290,,False,21.0,1,2,0,1,1,1,2,2,1,1,2,3,0,0,1,2,5
400995851,DePaul Blue Demons,TEAM,TOTAL,TOTAL,False,,25,59,16,30,9,29,14,18,18,20,38,17,9,1,15,16,73
400995851,DePaul Blue Demons,C. Stonewall,4068072,,True,31.0,5,8,3,3,2,5,0,0,4,1,5,1,1,0,1,0,12
400995851,DePaul Blue Demons,M. Grays,3142287,,True,34.0,5,16,3,8,2,8,4,6,2,4,6,0,2,0,3,3,16
400995851,DePaul Blue Demons,K. Campbell,4068071,,True,35.0,2,9,0,4,2,5,3,4,5,9,14,9,1,0,1,3,9
400995851,DePaul Blue Demons,A. Millender,3142289,,True,36.0,6,11,4,5,2,6,2,2,3,0,3,2,2,0,1,3,16
400995851,DePaul Blue Demons,A. Coleman,3142123,,True,24.0,4,8,4,5,0,3,2,2,0,2,2,2,2,1,6,3,10
400995851,DePaul Blue Demons,D. Bekelja,4281356,,False,1.0,0,0,0,0,0,0,0,0,0,0,0,0,0,0,0,0,0
400995851,DePaul Blue Demons,T. Allen,3933760,,False,18.0,2,5,2,4,0,1,1,2,2,1,3,0,1,0,2,2,5
400995851,DePaul Blue Demons,L. Prochaska,3142290,,False,21.0,1,2,0,1,1,1,2,2,1,1,2,3,0,0,1,2,5
400995851,DePaul Blue Demons,TEAM,TOTAL,TOTAL,False,,25,59,16,30,9,29,14,18,18,20,38,17,9,1,15,16,73
400995850,Villanova Wildcats,M. Quinn,3056785,,True,13.0,3,7,1,2,2,5,0,0,1,3,4,1,0,1,0,1,8
400995850,Villanova Wildcats,K. Jekot,4068171,,True,36.0,5,9,3,6,2,3,0,0,0,1,1,3,1,0,2,1,12
400995850,Villanova Wildcats,A. Hahn,3906779,,True,36.0,4,11,2,6,2,5,0,0,0,4,4,3,1,0,1,1,10
400995850,Villanova Wildcats,A. Louin,3142314,,True,37.0,5,11,5,6,0,5,2,4,1,13,14,2,1,0,2,2,12
400995850,Villanova Wildcats,J. Tucker,3087536,,True,35.0,2,5,0,1,2,4,0,0,1,1,2,4,1,0,1,3,6
400995850,Villanova Wildcats,M. Gedaka,4068172,,False,26.0,4,9,4,8,0,1,0,2,2,4,6,0,2,3,3,0,8
400995850,Villanova Wildcats,Bria. Herlihy,4068169,,False,2.0,0,0,0,0,0,0,0,0,0,0,0,0,0,0,0,0,0
400995850,Villanova Wildcats,Brid. Herlihy,3906778,,False,13.0,1,4,0,0,1,4,0,2,0,2,2,2,0,3,0,1,3
400995850,Villanova Wildcats,G. Stant,3906780,,False,2.0,0,0,0,0,0,0,0,0,0,0,0,0,0,0,1,1,0
400995850,Villanova Wildcats,TEAM,TOTAL,TOTAL,False,,24,56,15,29,9,27,2,8,7,32,39,15,6,7,10,10,59
400995850,Villanova Wildcats,M. Quinn,3056785,,True,13.0,3,7,1,2,2,5,0,0,1,3,4,1,0,1,0,1,8
400995850,Villanova Wildcats,K. Jekot,4068171,,True,36.0,5,9,3,6,2,3,0,0,0,1,1,3,1,0,2,1,12
400995850,Villanova Wildcats,A. Hahn,3906779,,True,36.0,4,11,2,6,2,5,0,0,0,4,4,3,1,0,1,1,10
400995850,Villanova Wildcats,A. Louin,3142314,,True,37.0,5,11,5,6,0,5,2,4,1,13,14,2,1,0,2,2,12
400995850,Villanova Wildcats,J. Tucker,3087536,,True,35.0,2,5,0,1,2,4,0,0,1,1,2,4,1,0,1,3,6
400995850,Villanova Wildcats,M. Gedaka,4068172,,False,26.0,4,9,4,8,0,1,0,2,2,4,6,0,2,3,3,0,8
400995850,Villanova Wildcats,Bria. Herlihy,4068169,,False,2.0,0,0,0,0,0,0,0,0,0,0,0,0,0,0,0,0,0
400995850,Villanova Wildcats,Brid. Herlihy,3906778,,False,13.0,1,4,0,0,1,4,0,2,0,2,2,2,0,3,0,1,3
400995850,Villanova Wildcats,G. Stant,3906780,,False,2.0,0,0,0,0,0,0,0,0,0,0,0,0,0,0,1,1,0
400995850,Villanova Wildcats,TEAM,TOTAL,TOTAL,False,,24,56,15,29,9,27,2,8,7,32,39,15,6,7,10,10,59
400995850,Seton Hall Pirates,S. Samuels,4068128,,True,37.0,2,8,2,8,0,0,0,2,1,6,7,1,2,2,1,4,4
400995850,Seton Hall Pirates,K. Evans,4281378,,True,15.0,2,7,2,7,0,0,0,0,4,0,4,0,0,1,1,1,4
400995850,Seton Hall Pirates,N. Jimenez,4281379,,True,24.0,1,7,1,4,0,3,1,1,0,4,4,2,1,0,1,0,3
400995850,Seton Hall Pirates,I. Butina,4281377,,True,37.0,3,11,2,6,1,5,0,0,1,4,5,3,1,0,1,2,7
400995850,Seton Hall Pirates,J. Jackson,3064877,,True,35.0,6,15,6,12,0,3,1,1,0,6,6,0,1,1,3,0,13
400995850,Seton Hall Pirates,S. Philoxy,4281380,,False,22.0,6,14,6,14,0,0,0,1,7,3,10,0,1,0,1,0,12
400995850,Seton Hall Pirates,J. Jones-Pack,4068129,,False,3.0,0,0,0,0,0,0,0,0,1,0,1,0,0,0,0,0,0
400995850,Seton Hall Pirates,D. Winters,4068126,,False,1.0,0,0,0,0,0,0,0,0,0,0,0,0,0,0,0,0,0
400995850,Seton Hall Pirates,K. Hilaire,4068123,,False,25.0,5,10,5,10,0,0,0,0,1,5,6,2,1,0,1,3,10
400995850,Seton Hall Pirates,K. Healy,3943704,,False,1.0,0,0,0,0,0,0,0,0,0,0,0,0,0,0,0,0,0
400995850,Seton Hall Pirates,TEAM,TOTAL,TOTAL,False,,25,72,24,61,1,11,2,5,17,28,45,8,7,4,9,10,53
400995850,Seton Hall Pirates,S. Samuels,4068128,,True,37.0,2,8,2,8,0,0,0,2,1,6,7,1,2,2,1,4,4
400995850,Seton Hall Pirates,K. Evans,4281378,,True,15.0,2,7,2,7,0,0,0,0,4,0,4,0,0,1,1,1,4
400995850,Seton Hall Pirates,N. Jimenez,4281379,,True,24.0,1,7,1,4,0,3,1,1,0,4,4,2,1,0,1,0,3
400995850,Seton Hall Pirates,I. Butina,4281377,,True,37.0,3,11,2,6,1,5,0,0,1,4,5,3,1,0,1,2,7
400995850,Seton Hall Pirates,J. Jackson,3064877,,True,35.0,6,15,6,12,0,3,1,1,0,6,6,0,1,1,3,0,13
400995850,Seton Hall Pirates,S. Philoxy,4281380,,False,22.0,6,14,6,14,0,0,0,1,7,3,10,0,1,0,1,0,12
400995850,Seton Hall Pirates,J. Jones-Pack,4068129,,False,3.0,0,0,0,0,0,0,0,0,1,0,1,0,0,0,0,0,0
400995850,Seton Hall Pirates,D. Winters,4068126,,False,1.0,0,0,0,0,0,0,0,0,0,0,0,0,0,0,0,0,0
400995850,Seton Hall Pirates,K. Hilaire,4068123,,False,25.0,5,10,5,10,0,0,0,0,1,5,6,2,1,0,1,3,10
400995850,Seton Hall Pirates,K. Healy,3943704,,False,1.0,0,0,0,0,0,0,0,0,0,0,0,0,0,0,0,0,0
400995850,Seton Hall Pirates,TEAM,TOTAL,TOTAL,False,,25,72,24,61,1,11,2,5,17,28,45,8,7,4,9,10,53
400995849,St. John's Red Storm,M. Singleton,4068158,,True,32.0,8,9,8,9,0,0,3,4,4,7,11,2,0,2,4,4,19
400995849,St. John's Red Storm,I. Littleton,3142306,,True,21.0,3,5,3,5,0,0,1,2,0,4,4,0,0,2,2,3,7
400995849,St. John's Red Storm,A. Wellere,3906771,,True,32.0,0,3,0,1,0,2,2,2,0,3,3,2,0,0,2,1,2
400995849,St. John's Red Storm,T. England,4068155,,True,36.0,1,4,0,1,1,3,3,4,0,3,3,7,2,1,3,3,6
400995849,St. John's Red Storm,A. Kebbe,4068154,,True,32.0,6,10,4,5,2,5,4,6,2,3,5,0,1,1,3,3,18
400995849,St. John's Red Storm,K. Charles,4281374,,False,9.0,0,2,0,2,0,0,3,6,3,3,6,0,0,0,1,3,3
400995849,St. John's Red Storm,Q. Hoppie,4281375,,False,24.0,2,7,1,4,1,3,4,4,1,2,3,1,0,0,1,2,9
400995849,St. John's Red Storm,A. Adams,4068157,,False,14.0,2,5,0,1,2,4,1,2,0,0,0,0,0,0,1,2,7
400995849,St. John's Red Storm,TEAM,TOTAL,TOTAL,False,,22,45,16,28,6,17,21,30,10,29,39,12,3,6,18,21,71
400995849,St. John's Red Storm,M. Singleton,4068158,,True,32.0,8,9,8,9,0,0,3,4,4,7,11,2,0,2,4,4,19
400995849,St. John's Red Storm,I. Littleton,3142306,,True,21.0,3,5,3,5,0,0,1,2,0,4,4,0,0,2,2,3,7
400995849,St. John's Red Storm,A. Wellere,3906771,,True,32.0,0,3,0,1,0,2,2,2,0,3,3,2,0,0,2,1,2
400995849,St. John's Red Storm,T. England,4068155,,True,36.0,1,4,0,1,1,3,3,4,0,3,3,7,2,1,3,3,6
400995849,St. John's Red Storm,A. Kebbe,4068154,,True,32.0,6,10,4,5,2,5,4,6,2,3,5,0,1,1,3,3,18
400995849,St. John's Red Storm,K. Charles,4281374,,False,9.0,0,2,0,2,0,0,3,6,3,3,6,0,0,0,1,3,3
400995849,St. John's Red Storm,Q. Hoppie,4281375,,False,24.0,2,7,1,4,1,3,4,4,1,2,3,1,0,0,1,2,9
400995849,St. John's Red Storm,A. Adams,4068157,,False,14.0,2,5,0,1,2,4,1,2,0,0,0,0,0,0,1,2,7
400995849,St. John's Red Storm,TEAM,TOTAL,TOTAL,False,,22,45,16,28,6,17,21,30,10,29,39,12,3,6,18,21,71
400995849,Georgetown Hoyas,C. Petke,4068078,,True,39.0,5,17,5,15,0,2,2,4,6,5,11,2,3,0,3,4,12
400995849,Georgetown Hoyas,Y. Belk,3142295,,True,20.0,2,3,2,3,0,0,0,0,1,0,1,0,1,0,1,4,4
400995849,Georgetown Hoyas,D. White,3948815,,True,39.0,6,20,5,17,1,3,4,4,4,2,6,2,3,0,4,4,17
400995849,Georgetown Hoyas,D. Burton,3142292,,True,35.0,2,6,2,4,0,2,0,2,1,3,4,2,0,0,0,3,4
400995849,Georgetown Hoyas,M. Venson,3142105,,True,34.0,4,12,2,7,2,5,8,9,1,4,5,1,0,0,2,3,18
400995849,Georgetown Hoyas,T. Thompson,4281352,,False,9.0,0,0,0,0,0,0,0,0,0,0,0,0,0,0,0,0,0
400995849,Georgetown Hoyas,M. Smith,4068079,,False,24.0,2,4,2,2,0,2,4,6,2,2,4,0,1,0,1,1,8
400995849,Georgetown Hoyas,TEAM,TOTAL,TOTAL,False,,21,62,18,48,3,14,18,25,17,17,34,7,8,0,11,19,63
400995849,Georgetown Hoyas,C. Petke,4068078,,True,39.0,5,17,5,15,0,2,2,4,6,5,11,2,3,0,3,4,12
400995849,Georgetown Hoyas,Y. Belk,3142295,,True,20.0,2,3,2,3,0,0,0,0,1,0,1,0,1,0,1,4,4
400995849,Georgetown Hoyas,D. White,3948815,,True,39.0,6,20,5,17,1,3,4,4,4,2,6,2,3,0,4,4,17
400995849,Georgetown Hoyas,D. Burton,3142292,,True,35.0,2,6,2,4,0,2,0,2,1,3,4,2,0,0,0,3,4
400995849,Georgetown Hoyas,M. Venson,3142105,,True,34.0,4,12,2,7,2,5,8,9,1,4,5,1,0,0,2,3,18
400995849,Georgetown Hoyas,T. Thompson,4281352,,False,9.0,0,0,0,0,0,0,0,0,0,0,0,0,0,0,0,0,0
400995849,Georgetown Hoyas,M. Smith,4068079,,False,24.0,2,4,2,2,0,2,4,6,2,2,4,0,1,0,1,1,8
400995849,Georgetown Hoyas,TEAM,TOTAL,TOTAL,False,,21,62,18,48,3,14,18,25,17,17,34,7,8,0,11,19,63
400995848,Marquette Golden Eagles,E. Davenport,3906756,,True,26.0,3,6,3,6,0,0,0,0,4,9,13,4,1,1,3,4,6
400995848,Marquette Golden Eagles,A. Wilborn,3906758,,True,21.0,5,9,4,5,1,4,1,3,0,1,1,1,1,0,4,4,12
400995848,Marquette Golden Eagles,A. Blockton,3906755,,True,35.0,8,14,7,12,1,2,2,3,4,7,11,1,2,1,2,2,19
400995848,Marquette Golden Eagles,N. Hiedeman,3906753,,True,33.0,2,8,1,3,1,5,6,6,0,3,3,4,4,0,3,0,11
400995848,Marquette Golden Eagles,D. King,3906752,,True,37.0,9,15,4,6,5,9,2,2,1,3,4,1,4,0,3,1,25
400995848,Marquette Golden Eagles,A. Anderson,4068081,,False,2.0,0,0,0,0,0,0,0,0,0,1,1,0,0,0,0,0,0
400995848,Marquette Golden Eagles,S. Dahling,3906754,,False,1.0,0,0,0,0,0,0,0,0,0,0,0,0,0,0,0,0,0
400995848,Marquette Golden Eagles,L. Van Kleunen,4068083,,False,16.0,1,2,0,0,1,2,0,0,2,2,4,1,0,0,2,3,3
400995848,Marquette Golden Eagles,S. Valentine,3142300,,False,4.0,0,0,0,0,0,0,0,0,0,1,1,0,0,0,0,0,0
400995848,Marquette Golden Eagles,S. Lott,4281350,,False,20.0,1,5,1,1,0,4,0,0,3,1,4,1,2,0,1,3,2
400995848,Marquette Golden Eagles,I. Spingola,4068082,,False,6.0,0,2,0,1,0,1,0,0,0,0,0,0,0,0,0,0,0
400995848,Marquette Golden Eagles,TEAM,TOTAL,TOTAL,False,,29,61,20,34,9,27,11,14,14,30,44,13,14,2,19,17,78
400995848,Marquette Golden Eagles,E. Davenport,3906756,,True,26.0,3,6,3,6,0,0,0,0,4,9,13,4,1,1,3,4,6
400995848,Marquette Golden Eagles,A. Wilborn,3906758,,True,21.0,5,9,4,5,1,4,1,3,0,1,1,1,1,0,4,4,12
400995848,Marquette Golden Eagles,A. Blockton,3906755,,True,35.0,8,14,7,12,1,2,2,3,4,7,11,1,2,1,2,2,19
400995848,Marquette Golden Eagles,N. Hiedeman,3906753,,True,33.0,2,8,1,3,1,5,6,6,0,3,3,4,4,0,3,0,11
400995848,Marquette Golden Eagles,D. King,3906752,,True,37.0,9,15,4,6,5,9,2,2,1,3,4,1,4,0,3,1,25
400995848,Marquette Golden Eagles,A. Anderson,4068081,,False,2.0,0,0,0,0,0,0,0,0,0,1,1,0,0,0,0,0,0
400995848,Marquette Golden Eagles,S. Dahling,3906754,,False,1.0,0,0,0,0,0,0,0,0,0,0,0,0,0,0,0,0,0
400995848,Marquette Golden Eagles,L. Van Kleunen,4068083,,False,16.0,1,2,0,0,1,2,0,0,2,2,4,1,0,0,2,3,3
400995848,Marquette Golden Eagles,S. Valentine,3142300,,False,4.0,0,0,0,0,0,0,0,0,0,1,1,0,0,0,0,0,0
400995848,Marquette Golden Eagles,S. Lott,4281350,,False,20.0,1,5,1,1,0,4,0,0,3,1,4,1,2,0,1,3,2
400995848,Marquette Golden Eagles,I. Spingola,4068082,,False,6.0,0,2,0,1,0,1,0,0,0,0,0,0,0,0,0,0,0
400995848,Marquette Golden Eagles,TEAM,TOTAL,TOTAL,False,,29,61,20,34,9,27,11,14,14,30,44,13,14,2,19,17,78
400995848,Butler Bulldogs,K. Hodges,4068065,,True,12.0,0,1,0,1,0,0,0,0,0,0,0,1,3,1,2,2,0
400995848,Butler Bulldogs,T. Schickel,3914012,,True,36.0,9,14,9,14,0,0,0,2,2,8,10,2,0,2,1,3,18
400995848,Butler Bulldogs,S. Buck,3142279,,True,16.0,1,2,0,0,1,2,0,0,0,0,0,0,0,0,3,0,3
400995848,Butler Bulldogs,W. Jennings,3142145,,True,37.0,4,16,2,8,2,8,2,2,0,2,2,0,2,0,3,2,12
400995848,Butler Bulldogs,I. Lathan,3079485,,True,24.0,2,6,2,6,0,0,0,0,1,3,4,1,1,0,2,1,4
400995848,Butler Bulldogs,S. Brey,4068067,,False,23.0,2,3,2,3,0,0,2,2,1,1,2,2,1,1,0,3,6
400995848,Butler Bulldogs,K. Spolyar,4068068,,False,20.0,1,8,1,4,0,4,1,2,1,2,3,2,2,0,2,2,3
400995848,Butler Bulldogs,M. Weaver,3914014,,False,33.0,6,10,5,7,1,3,0,0,2,0,2,3,0,0,2,4,13
400995848,Butler Bulldogs,TEAM,TOTAL,TOTAL,False,,25,60,21,43,4,17,5,8,7,17,24,11,9,4,15,17,59
400995848,Butler Bulldogs,K. Hodges,4068065,,True,12.0,0,1,0,1,0,0,0,0,0,0,0,1,3,1,2,2,0
400995848,Butler Bulldogs,T. Schickel,3914012,,True,36.0,9,14,9,14,0,0,0,2,2,8,10,2,0,2,1,3,18
400995848,Butler Bulldogs,S. Buck,3142279,,True,16.0,1,2,0,0,1,2,0,0,0,0,0,0,0,0,3,0,3
400995848,Butler Bulldogs,W. Jennings,3142145,,True,37.0,4,16,2,8,2,8,2,2,0,2,2,0,2,0,3,2,12
400995848,Butler Bulldogs,I. Lathan,3079485,,True,24.0,2,6,2,6,0,0,0,0,1,3,4,1,1,0,2,1,4
400995848,Butler Bulldogs,S. Brey,4068067,,False,23.0,2,3,2,3,0,0,2,2,1,1,2,2,1,1,0,3,6
400995848,Butler Bulldogs,K. Spolyar,4068068,,False,20.0,1,8,1,4,0,4,1,2,1,2,3,2,2,0,2,2,3
400995848,Butler Bulldogs,M. Weaver,3914014,,False,33.0,6,10,5,7,1,3,0,0,2,0,2,3,0,0,2,4,13
400995848,Butler Bulldogs,TEAM,TOTAL,TOTAL,False,,25,60,21,43,4,17,5,8,7,17,24,11,9,4,15,17,59
400995847,Providence Friars,N. Franklin,4281348,,True,11.0,1,2,1,2,0,0,1,2,0,1,1,0,0,1,2,0,3
400995847,Providence Friars,C. Williams,4281345,,True,35.0,5,15,5,15,0,0,2,5,0,1,1,4,3,1,1,4,12
400995847,Providence Friars,J. Nogic,3906769,,True,42.0,11,21,8,17,3,4,2,2,0,6,6,2,2,1,4,4,27
400995847,Providence Friars,M. Jolin,3906767,,True,46.0,4,8,3,5,1,3,0,0,1,17,18,5,1,0,1,2,9
400995847,Providence Friars,C. Che,3906766,,True,43.0,6,11,4,7,2,4,0,0,1,1,2,2,0,0,0,0,14
400995847,Providence Friars,A. Cooper,4281349,,False,39.0,8,10,8,10,0,0,1,3,0,2,2,0,0,0,1,1,17
400995847,Providence Friars,K. Spiwak,4281346,,False,26.0,1,2,1,2,0,0,0,0,0,3,3,2,0,0,0,3,2
400995847,Providence Friars,A. Botteghi,3142301,,False,8.0,0,0,0,0,0,0,0,0,1,0,1,0,0,0,0,1,0
400995847,Providence Friars,TEAM,TOTAL,TOTAL,False,,36,69,30,58,6,11,6,12,3,31,34,15,6,3,10,15,84
400995847,Providence Friars,N. Franklin,4281348,,True,11.0,1,2,1,2,0,0,1,2,0,1,1,0,0,1,2,0,3
400995847,Providence Friars,C. Williams,4281345,,True,35.0,5,15,5,15,0,0,2,5,0,1,1,4,3,1,1,4,12
400995847,Providence Friars,J. Nogic,3906769,,True,42.0,11,21,8,17,3,4,2,2,0,6,6,2,2,1,4,4,27
400995847,Providence Friars,M. Jolin,3906767,,True,46.0,4,8,3,5,1,3,0,0,1,17,18,5,1,0,1,2,9
400995847,Providence Friars,C. Che,3906766,,True,43.0,6,11,4,7,2,4,0,0,1,1,2,2,0,0,0,0,14
400995847,Providence Friars,A. Cooper,4281349,,False,39.0,8,10,8,10,0,0,1,3,0,2,2,0,0,0,1,1,17
400995847,Providence Friars,K. Spiwak,4281346,,False,26.0,1,2,1,2,0,0,0,0,0,3,3,2,0,0,0,3,2
400995847,Providence Friars,A. Botteghi,3142301,,False,8.0,0,0,0,0,0,0,0,0,1,0,1,0,0,0,0,1,0
400995847,Providence Friars,TEAM,TOTAL,TOTAL,False,,36,69,30,58,6,11,6,12,3,31,34,15,6,3,10,15,84
400995847,Creighton Bluejays,A. Faber,3938938,,True,46.0,4,12,1,3,3,9,2,2,0,5,5,3,0,1,3,3,13
400995847,Creighton Bluejays,J. Agnew,3938935,,True,48.0,9,18,4,10,5,8,10,10,3,8,11,4,0,0,1,1,33
400995847,Creighton Bluejays,B. Norby,3142284,,True,11.0,0,1,0,1,0,0,0,0,0,3,3,0,0,0,1,1,0
400995847,Creighton Bluejays,S. Lamberty,3142285,,True,50.0,4,14,3,9,1,5,2,3,4,4,8,3,1,0,1,1,11
400995847,Creighton Bluejays,M. Mellman,3142283,,True,8.0,0,1,0,0,0,1,0,0,0,0,0,1,0,0,0,0,0
400995847,Creighton Bluejays,A. Greene,3938937,,False,19.0,3,4,3,4,0,0,0,0,3,5,8,0,0,0,3,3,6
400995847,Creighton Bluejays,K. Brown,3142286,,False,4.0,0,1,0,1,0,0,0,0,0,0,0,0,0,0,0,1,0
400995847,Creighton Bluejays,T. Carda,4281362,,False,39.0,6,12,3,6,3,6,2,4,0,2,2,1,0,0,0,4,17
400995847,Creighton Bluejays,O. Elger,3938936,,False,25.0,2,5,1,3,1,2,2,2,0,2,2,0,1,0,1,4,7
400995847,Creighton Bluejays,TEAM,TOTAL,TOTAL,False,,28,68,15,37,13,31,18,21,10,32,42,12,2,1,11,18,87
400995847,Creighton Bluejays,A. Faber,3938938,,True,46.0,4,12,1,3,3,9,2,2,0,5,5,3,0,1,3,3,13
400995847,Creighton Bluejays,J. Agnew,3938935,,True,48.0,9,18,4,10,5,8,10,10,3,8,11,4,0,0,1,1,33
400995847,Creighton Bluejays,B. Norby,3142284,,True,11.0,0,1,0,1,0,0,0,0,0,3,3,0,0,0,1,1,0
400995847,Creighton Bluejays,S. Lamberty,3142285,,True,50.0,4,14,3,9,1,5,2,3,4,4,8,3,1,0,1,1,11
400995847,Creighton Bluejays,M. Mellman,3142283,,True,8.0,0,1,0,0,0,1,0,0,0,0,0,1,0,0,0,0,0
400995847,Creighton Bluejays,A. Greene,3938937,,False,19.0,3,4,3,4,0,0,0,0,3,5,8,0,0,0,3,3,6
400995847,Creighton Bluejays,K. Brown,3142286,,False,4.0,0,1,0,1,0,0,0,0,0,0,0,0,0,0,0,1,0
400995847,Creighton Bluejays,T. Carda,4281362,,False,39.0,6,12,3,6,3,6,2,4,0,2,2,1,0,0,0,4,17
400995847,Creighton Bluejays,O. Elger,3938936,,False,25.0,2,5,1,3,1,2,2,2,0,2,2,0,1,0,1,4,7
400995847,Creighton Bluejays,TEAM,TOTAL,TOTAL,False,,28,68,15,37,13,31,18,21,10,32,42,12,2,1,11,18,87
400995846,Villanova Wildcats,M. Quinn,3056785,,True,14.0,0,3,0,2,0,1,0,0,2,1,3,0,0,1,0,0,0
400995846,Villanova Wildcats,J. Tucker,3087536,,True,37.0,5,11,3,6,2,5,1,1,1,2,3,2,0,0,0,0,13
400995846,Villanova Wildcats,K. Jekot,4068171,,True,27.0,3,11,2,5,1,6,1,1,0,2,2,0,0,0,1,2,8
400995846,Villanova Wildcats,A. Hahn,3906779,,True,38.0,3,7,2,3,1,4,2,2,0,2,2,2,0,0,2,5,9
400995846,Villanova Wildcats,A. Louin,3142314,,True,31.0,5,9,0,4,5,5,0,0,1,10,11,3,0,0,0,2,15
400995846,Villanova Wildcats,M. Gedaka,4068172,,False,29.0,8,10,7,8,1,2,4,6,2,3,5,3,3,0,2,0,21
400995846,Villanova Wildcats,B. Herlihy,3906778,,False,16.0,1,4,0,1,1,3,0,0,0,1,1,0,0,0,0,0,3
400995846,Villanova Wildcats,R. James,4068168,,False,1.0,0,0,0,0,0,0,0,0,0,0,0,0,0,0,0,0,0
400995846,Villanova Wildcats,C. Onken,4068167,,False,7.0,0,0,0,0,0,0,0,0,0,0,0,0,0,0,0,0,0
400995846,Villanova Wildcats,TEAM,TOTAL,TOTAL,False,,25,55,14,29,11,26,8,10,7,24,31,10,3,1,5,9,69
400995846,Villanova Wildcats,M. Quinn,3056785,,True,14.0,0,3,0,2,0,1,0,0,2,1,3,0,0,1,0,0,0
400995846,Villanova Wildcats,J. Tucker,3087536,,True,37.0,5,11,3,6,2,5,1,1,1,2,3,2,0,0,0,0,13
400995846,Villanova Wildcats,K. Jekot,4068171,,True,27.0,3,11,2,5,1,6,1,1,0,2,2,0,0,0,1,2,8
400995846,Villanova Wildcats,A. Hahn,3906779,,True,38.0,3,7,2,3,1,4,2,2,0,2,2,2,0,0,2,5,9
400995846,Villanova Wildcats,A. Louin,3142314,,True,31.0,5,9,0,4,5,5,0,0,1,10,11,3,0,0,0,2,15
400995846,Villanova Wildcats,M. Gedaka,4068172,,False,29.0,8,10,7,8,1,2,4,6,2,3,5,3,3,0,2,0,21
400995846,Villanova Wildcats,B. Herlihy,3906778,,False,16.0,1,4,0,1,1,3,0,0,0,1,1,0,0,0,0,0,3
400995846,Villanova Wildcats,R. James,4068168,,False,1.0,0,0,0,0,0,0,0,0,0,0,0,0,0,0,0,0,0
400995846,Villanova Wildcats,C. Onken,4068167,,False,7.0,0,0,0,0,0,0,0,0,0,0,0,0,0,0,0,0,0
400995846,Villanova Wildcats,TEAM,TOTAL,TOTAL,False,,25,55,14,29,11,26,8,10,7,24,31,10,3,1,5,9,69
400995846,St. John's Red Storm,M. Singleton,4068158,,True,35.0,5,10,5,10,0,0,1,2,4,14,18,1,3,0,0,3,11
400995846,St. John's Red Storm,I. Littleton,3142306,,True,25.0,2,2,2,2,0,0,0,0,2,4,6,0,0,0,2,4,4
400995846,St. John's Red Storm,A. Wellere,3906771,,True,38.0,3,10,1,3,2,7,0,1,0,1,1,3,0,0,1,1,8
400995846,St. John's Red Storm,T. England,4068155,,True,40.0,5,10,5,8,0,2,2,4,1,1,2,4,0,0,5,1,12
400995846,St. John's Red Storm,A. Kebbe,4068154,,True,31.0,6,12,3,6,3,6,0,0,3,3,6,1,0,0,0,1,15
400995846,St. John's Red Storm,Q. Hoppie,4281375,,False,17.0,0,6,0,4,0,2,0,0,0,0,0,0,0,0,2,1,0
400995846,St. John's Red Storm,A. Adams,4068157,,False,14.0,1,5,1,3,0,2,0,0,0,0,0,1,0,0,0,0,2
400995846,St. John's Red Storm,TEAM,TOTAL,TOTAL,False,,22,55,17,36,5,19,3,7,11,24,35,10,3,0,10,11,52
400995846,St. John's Red Storm,M. Singleton,4068158,,True,35.0,5,10,5,10,0,0,1,2,4,14,18,1,3,0,0,3,11
400995846,St. John's Red Storm,I. Littleton,3142306,,True,25.0,2,2,2,2,0,0,0,0,2,4,6,0,0,0,2,4,4
400995846,St. John's Red Storm,A. Wellere,3906771,,True,38.0,3,10,1,3,2,7,0,1,0,1,1,3,0,0,1,1,8
400995846,St. John's Red Storm,T. England,4068155,,True,40.0,5,10,5,8,0,2,2,4,1,1,2,4,0,0,5,1,12
400995846,St. John's Red Storm,A. Kebbe,4068154,,True,31.0,6,12,3,6,3,6,0,0,3,3,6,1,0,0,0,1,15
400995846,St. John's Red Storm,Q. Hoppie,4281375,,False,17.0,0,6,0,4,0,2,0,0,0,0,0,0,0,0,2,1,0
400995846,St. John's Red Storm,A. Adams,4068157,,False,14.0,1,5,1,3,0,2,0,0,0,0,0,1,0,0,0,0,2
400995846,St. John's Red Storm,TEAM,TOTAL,TOTAL,False,,22,55,17,36,5,19,3,7,11,24,35,10,3,0,10,11,52
400995845,Xavier Musketeers,I. Partlow,3142320,,True,20.0,2,4,2,3,0,1,1,2,1,3,4,0,0,0,0,2,5
400995845,Xavier Musketeers,A. Aijanen,3142319,,True,32.0,4,9,4,7,0,2,1,1,4,3,7,1,0,3,2,4,9
400995845,Xavier Musketeers,N. Owens,4068187,,True,26.0,3,5,2,2,1,3,0,1,1,1,2,2,1,0,2,0,7
400995845,Xavier Musketeers,J. Byrd,3142318,,True,33.0,9,12,8,9,1,3,3,4,0,2,2,2,0,0,4,0,22
400995845,Xavier Musketeers,K. Fincher,3142317,,True,15.0,0,6,0,1,0,5,0,0,1,2,3,0,0,0,0,1,0
400995845,Xavier Musketeers,A. Gray,4281368,,False,22.0,1,7,1,5,0,2,7,8,2,7,9,5,1,0,3,2,9
400995845,Xavier Musketeers,D. Ross,4281364,,False,2.0,0,0,0,0,0,0,0,0,0,0,0,0,0,0,1,0,0
400995845,Xavier Musketeers,M. Christopher,4068186,,False,2.0,0,0,0,0,0,0,0,0,0,0,0,0,0,0,0,0,0
400995845,Xavier Musketeers,A. Reiff,4281367,,False,2.0,0,0,0,0,0,0,0,0,0,0,0,0,0,0,0,0,0
400995845,Xavier Musketeers,P. Stewart,4281366,,False,20.0,1,4,1,1,0,3,0,0,1,0,1,1,0,1,0,1,2
400995845,Xavier Musketeers,A. Dunham,4281365,,False,25.0,3,7,0,0,3,7,0,0,1,2,3,3,3,0,2,0,9
400995845,Xavier Musketeers,A. Gomez,4068185,,False,1.0,0,0,0,0,0,0,0,0,0,0,0,0,0,0,1,0,0
400995845,Xavier Musketeers,TEAM,TOTAL,TOTAL,False,,23,54,18,28,5,26,12,16,13,21,34,14,5,4,15,10,63
400995845,Xavier Musketeers,I. Partlow,3142320,,True,20.0,2,4,2,3,0,1,1,2,1,3,4,0,0,0,0,2,5
400995845,Xavier Musketeers,A. Aijanen,3142319,,True,32.0,4,9,4,7,0,2,1,1,4,3,7,1,0,3,2,4,9
400995845,Xavier Musketeers,N. Owens,4068187,,True,26.0,3,5,2,2,1,3,0,1,1,1,2,2,1,0,2,0,7
400995845,Xavier Musketeers,J. Byrd,3142318,,True,33.0,9,12,8,9,1,3,3,4,0,2,2,2,0,0,4,0,22
400995845,Xavier Musketeers,K. Fincher,3142317,,True,15.0,0,6,0,1,0,5,0,0,1,2,3,0,0,0,0,1,0
400995845,Xavier Musketeers,A. Gray,4281368,,False,22.0,1,7,1,5,0,2,7,8,2,7,9,5,1,0,3,2,9
400995845,Xavier Musketeers,D. Ross,4281364,,False,2.0,0,0,0,0,0,0,0,0,0,0,0,0,0,0,1,0,0
400995845,Xavier Musketeers,M. Christopher,4068186,,False,2.0,0,0,0,0,0,0,0,0,0,0,0,0,0,0,0,0,0
400995845,Xavier Musketeers,A. Reiff,4281367,,False,2.0,0,0,0,0,0,0,0,0,0,0,0,0,0,0,0,0,0
400995845,Xavier Musketeers,P. Stewart,4281366,,False,20.0,1,4,1,1,0,3,0,0,1,0,1,1,0,1,0,1,2
400995845,Xavier Musketeers,A. Dunham,4281365,,False,25.0,3,7,0,0,3,7,0,0,1,2,3,3,3,0,2,0,9
400995845,Xavier Musketeers,A. Gomez,4068185,,False,1.0,0,0,0,0,0,0,0,0,0,0,0,0,0,0,1,0,0
400995845,Xavier Musketeers,TEAM,TOTAL,TOTAL,False,,23,54,18,28,5,26,12,16,13,21,34,14,5,4,15,10,63
400995845,Marquette Golden Eagles,L. Van Kleunen,4068083,,True,22.0,2,8,1,4,1,4,0,2,2,2,4,1,1,0,0,1,5
400995845,Marquette Golden Eagles,E. Davenport,3906756,,True,22.0,3,9,3,9,0,0,1,1,4,3,7,1,1,0,2,1,7
400995845,Marquette Golden Eagles,S. Lott,4281350,,True,25.0,2,4,0,0,2,4,0,0,2,4,6,3,3,0,2,0,6
400995845,Marquette Golden Eagles,A. Blockton,3906755,,True,30.0,9,15,6,9,3,6,2,2,3,2,5,6,1,0,3,3,23
400995845,Marquette Golden Eagles,D. King,3906752,,True,19.0,2,6,2,4,0,2,1,2,1,2,3,1,1,0,1,2,5
400995845,Marquette Golden Eagles,A. Anderson,4068081,,False,5.0,1,1,0,0,1,1,0,0,0,1,1,0,0,0,0,2,3
400995845,Marquette Golden Eagles,S. Dahling,3906754,,False,1.0,0,0,0,0,0,0,0,0,0,0,0,1,0,0,0,1,0
400995845,Marquette Golden Eagles,S. Valentine,3142300,,False,8.0,0,1,0,1,0,0,0,2,2,1,3,0,0,0,0,1,0
400995845,Marquette Golden Eagles,I. Spingola,4068082,,False,9.0,0,3,0,0,0,3,0,0,0,0,0,0,0,0,0,0,0
400995845,Marquette Golden Eagles,A. Wilborn,3906758,,False,28.0,5,7,3,4,2,3,1,3,1,2,3,6,2,0,0,1,13
400995845,Marquette Golden Eagles,N. Hiedeman,3906753,,False,31.0,7,14,3,8,4,6,0,0,1,1,2,2,2,0,1,1,18
400995845,Marquette Golden Eagles,TEAM,TOTAL,TOTAL,False,,31,68,18,39,13,29,5,12,17,19,36,21,11,0,9,13,80
400995845,Marquette Golden Eagles,L. Van Kleunen,4068083,,True,22.0,2,8,1,4,1,4,0,2,2,2,4,1,1,0,0,1,5
400995845,Marquette Golden Eagles,E. Davenport,3906756,,True,22.0,3,9,3,9,0,0,1,1,4,3,7,1,1,0,2,1,7
400995845,Marquette Golden Eagles,S. Lott,4281350,,True,25.0,2,4,0,0,2,4,0,0,2,4,6,3,3,0,2,0,6
400995845,Marquette Golden Eagles,A. Blockton,3906755,,True,30.0,9,15,6,9,3,6,2,2,3,2,5,6,1,0,3,3,23
400995845,Marquette Golden Eagles,D. King,3906752,,True,19.0,2,6,2,4,0,2,1,2,1,2,3,1,1,0,1,2,5
400995845,Marquette Golden Eagles,A. Anderson,4068081,,False,5.0,1,1,0,0,1,1,0,0,0,1,1,0,0,0,0,2,3
400995845,Marquette Golden Eagles,S. Dahling,3906754,,False,1.0,0,0,0,0,0,0,0,0,0,0,0,1,0,0,0,1,0
400995845,Marquette Golden Eagles,S. Valentine,3142300,,False,8.0,0,1,0,1,0,0,0,2,2,1,3,0,0,0,0,1,0
400995845,Marquette Golden Eagles,I. Spingola,4068082,,False,9.0,0,3,0,0,0,3,0,0,0,0,0,0,0,0,0,0,0
400995845,Marquette Golden Eagles,A. Wilborn,3906758,,False,28.0,5,7,3,4,2,3,1,3,1,2,3,6,2,0,0,1,13
400995845,Marquette Golden Eagles,N. Hiedeman,3906753,,False,31.0,7,14,3,8,4,6,0,0,1,1,2,2,2,0,1,1,18
400995845,Marquette Golden Eagles,TEAM,TOTAL,TOTAL,False,,31,68,18,39,13,29,5,12,17,19,36,21,11,0,9,13,80
400995844,Seton Hall Pirates,S. Samuels,4068128,,True,28.0,3,8,3,7,0,1,0,0,4,6,10,1,0,0,3,3,6
400995844,Seton Hall Pirates,K. Evans,4281378,,True,13.0,0,2,0,2,0,0,0,0,3,1,4,0,0,0,0,0,0
400995844,Seton Hall Pirates,D. Winters,4068126,,True,15.0,2,4,1,2,1,2,0,0,1,2,3,0,0,0,1,0,5
400995844,Seton Hall Pirates,I. Butina,4281377,,True,35.0,6,14,5,12,1,2,0,0,0,3,3,1,1,0,3,2,13
400995844,Seton Hall Pirates,J. Jackson,3064877,,True,23.0,2,7,2,3,0,4,0,0,0,2,2,0,0,0,0,2,4
400995844,Seton Hall Pirates,S. Philoxy,4281380,,False,26.0,2,2,2,2,0,0,2,2,0,5,5,4,4,1,2,4,6
400995844,Seton Hall Pirates,J. Jones-Pack,4068129,,False,12.0,2,2,1,1,1,1,0,0,0,2,2,0,0,1,1,4,5
400995844,Seton Hall Pirates,N. Jimenez,4281379,,False,15.0,0,5,0,0,0,5,5,8,0,3,3,0,2,0,0,1,5
400995844,Seton Hall Pirates,K. Hilaire,4068123,,False,22.0,2,7,1,6,1,1,3,4,0,2,2,2,0,0,6,2,8
400995844,Seton Hall Pirates,K. Healy,3943704,,False,11.0,0,2,0,0,0,2,0,0,0,1,1,0,0,0,1,0,0
400995844,Seton Hall Pirates,TEAM,TOTAL,TOTAL,False,,19,53,15,35,4,18,10,14,10,29,39,8,7,2,18,18,52
400995844,Seton Hall Pirates,S. Samuels,4068128,,True,28.0,3,8,3,7,0,1,0,0,4,6,10,1,0,0,3,3,6
400995844,Seton Hall Pirates,K. Evans,4281378,,True,13.0,0,2,0,2,0,0,0,0,3,1,4,0,0,0,0,0,0
400995844,Seton Hall Pirates,D. Winters,4068126,,True,15.0,2,4,1,2,1,2,0,0,1,2,3,0,0,0,1,0,5
400995844,Seton Hall Pirates,I. Butina,4281377,,True,35.0,6,14,5,12,1,2,0,0,0,3,3,1,1,0,3,2,13
400995844,Seton Hall Pirates,J. Jackson,3064877,,True,23.0,2,7,2,3,0,4,0,0,0,2,2,0,0,0,0,2,4
400995844,Seton Hall Pirates,S. Philoxy,4281380,,False,26.0,2,2,2,2,0,0,2,2,0,5,5,4,4,1,2,4,6
400995844,Seton Hall Pirates,J. Jones-Pack,4068129,,False,12.0,2,2,1,1,1,1,0,0,0,2,2,0,0,1,1,4,5
400995844,Seton Hall Pirates,N. Jimenez,4281379,,False,15.0,0,5,0,0,0,5,5,8,0,3,3,0,2,0,0,1,5
400995844,Seton Hall Pirates,K. Hilaire,4068123,,False,22.0,2,7,1,6,1,1,3,4,0,2,2,2,0,0,6,2,8
400995844,Seton Hall Pirates,K. Healy,3943704,,False,11.0,0,2,0,0,0,2,0,0,0,1,1,0,0,0,1,0,0
400995844,Seton Hall Pirates,TEAM,TOTAL,TOTAL,False,,19,53,15,35,4,18,10,14,10,29,39,8,7,2,18,18,52
400995844,Georgetown Hoyas,C. Petke,4068078,,True,38.0,8,15,8,13,0,2,1,2,4,10,14,1,2,0,3,1,17
400995844,Georgetown Hoyas,Y. Belk,3142295,,True,21.0,2,5,2,5,0,0,0,0,3,4,7,1,3,0,1,0,4
400995844,Georgetown Hoyas,D. White,3948815,,True,35.0,6,15,4,11,2,4,7,9,1,5,6,5,1,1,3,2,21
400995844,Georgetown Hoyas,D. Burton,3142292,,True,28.0,1,5,1,3,0,2,0,0,1,2,3,6,2,0,2,2,2
400995844,Georgetown Hoyas,M. Venson,3142105,,True,35.0,4,9,3,6,1,3,1,2,0,0,0,3,0,0,3,3,10
400995844,Georgetown Hoyas,S. Cureton,4281355,,False,1.0,0,0,0,0,0,0,0,0,0,0,0,0,0,0,0,0,0
400995844,Georgetown Hoyas,T. Thompson,4281352,,False,13.0,3,6,1,3,2,3,0,0,0,3,3,0,2,0,1,0,8
400995844,Georgetown Hoyas,M. Smith,4068079,,False,24.0,3,8,3,7,0,1,1,5,4,1,5,1,0,1,0,2,7
400995844,Georgetown Hoyas,B. Mayfield,4281354,,False,2.0,1,2,1,2,0,0,0,0,0,0,0,0,0,0,0,0,2
400995844,Georgetown Hoyas,L. Kimball,4281353,,False,2.0,0,1,0,1,0,0,0,0,1,0,1,1,0,0,0,0,0
400995844,Georgetown Hoyas,M. Osagie-Erese,4072597,,False,1.0,0,0,0,0,0,0,0,0,0,0,0,0,1,0,0,1,0
400995844,Georgetown Hoyas,TEAM,TOTAL,TOTAL,False,,28,66,23,51,5,15,10,18,15,25,40,18,11,2,13,11,71
400995844,Georgetown Hoyas,C. Petke,4068078,,True,38.0,8,15,8,13,0,2,1,2,4,10,14,1,2,0,3,1,17
400995844,Georgetown Hoyas,Y. Belk,3142295,,True,21.0,2,5,2,5,0,0,0,0,3,4,7,1,3,0,1,0,4
400995844,Georgetown Hoyas,D. White,3948815,,True,35.0,6,15,4,11,2,4,7,9,1,5,6,5,1,1,3,2,21
400995844,Georgetown Hoyas,D. Burton,3142292,,True,28.0,1,5,1,3,0,2,0,0,1,2,3,6,2,0,2,2,2
400995844,Georgetown Hoyas,M. Venson,3142105,,True,35.0,4,9,3,6,1,3,1,2,0,0,0,3,0,0,3,3,10
400995844,Georgetown Hoyas,S. Cureton,4281355,,False,1.0,0,0,0,0,0,0,0,0,0,0,0,0,0,0,0,0,0
400995844,Georgetown Hoyas,T. Thompson,4281352,,False,13.0,3,6,1,3,2,3,0,0,0,3,3,0,2,0,1,0,8
400995844,Georgetown Hoyas,M. Smith,4068079,,False,24.0,3,8,3,7,0,1,1,5,4,1,5,1,0,1,0,2,7
400995844,Georgetown Hoyas,B. Mayfield,4281354,,False,2.0,1,2,1,2,0,0,0,0,0,0,0,0,0,0,0,0,2
400995844,Georgetown Hoyas,L. Kimball,4281353,,False,2.0,0,1,0,1,0,0,0,0,1,0,1,1,0,0,0,0,0
400995844,Georgetown Hoyas,M. Osagie-Erese,4072597,,False,1.0,0,0,0,0,0,0,0,0,0,0,0,0,1,0,0,1,0
400995844,Georgetown Hoyas,TEAM,TOTAL,TOTAL,False,,28,66,23,51,5,15,10,18,15,25,40,18,11,2,13,11,71
400995843,DePaul Blue Demons,C. Stonewall,4068072,,True,29.0,5,11,1,4,4,7,2,4,4,2,6,1,1,0,2,2,16
400995843,DePaul Blue Demons,M. Grays,3142287,,True,30.0,6,11,5,7,1,4,0,0,1,5,6,1,1,0,2,3,13
400995843,DePaul Blue Demons,K. Campbell,4068071,,True,30.0,5,10,2,5,3,5,2,2,4,5,9,3,2,1,0,2,15
400995843,DePaul Blue Demons,A. Millender,3142289,,True,27.0,4,7,2,3,2,4,0,1,2,4,6,2,2,0,3,3,10
400995843,DePaul Blue Demons,A. Coleman,3142123,,True,29.0,5,11,5,7,0,4,5,6,2,4,6,5,2,1,1,1,15
400995843,DePaul Blue Demons,R. McLimore,4281358,,False,8.0,0,2,0,2,0,0,0,0,2,1,3,2,0,0,0,0,0
400995843,DePaul Blue Demons,V. Sherrod,4281359,,False,2.0,0,0,0,0,0,0,0,0,0,0,0,0,0,0,1,0,0
400995843,DePaul Blue Demons,D. Bekelja,4281356,,False,5.0,0,2,0,2,0,0,0,0,0,0,0,1,0,0,0,0,0
400995843,DePaul Blue Demons,D. Cage,4068073,,False,3.0,1,1,1,1,0,0,0,0,0,0,0,0,0,0,1,0,2
400995843,DePaul Blue Demons,T. Allen,3933760,,False,14.0,2,7,2,4,0,3,0,0,1,3,4,2,0,0,1,1,4
400995843,DePaul Blue Demons,L. Prochaska,3142290,,False,23.0,3,7,0,2,3,5,2,2,1,4,5,1,0,0,4,2,11
400995843,DePaul Blue Demons,TEAM,TOTAL,TOTAL,False,,31,69,18,37,13,32,11,15,17,28,45,18,8,2,15,14,86
400995843,DePaul Blue Demons,C. Stonewall,4068072,,True,29.0,5,11,1,4,4,7,2,4,4,2,6,1,1,0,2,2,16
400995843,DePaul Blue Demons,M. Grays,3142287,,True,30.0,6,11,5,7,1,4,0,0,1,5,6,1,1,0,2,3,13
400995843,DePaul Blue Demons,K. Campbell,4068071,,True,30.0,5,10,2,5,3,5,2,2,4,5,9,3,2,1,0,2,15
400995843,DePaul Blue Demons,A. Millender,3142289,,True,27.0,4,7,2,3,2,4,0,1,2,4,6,2,2,0,3,3,10
400995843,DePaul Blue Demons,A. Coleman,3142123,,True,29.0,5,11,5,7,0,4,5,6,2,4,6,5,2,1,1,1,15
400995843,DePaul Blue Demons,R. McLimore,4281358,,False,8.0,0,2,0,2,0,0,0,0,2,1,3,2,0,0,0,0,0
400995843,DePaul Blue Demons,V. Sherrod,4281359,,False,2.0,0,0,0,0,0,0,0,0,0,0,0,0,0,0,1,0,0
400995843,DePaul Blue Demons,D. Bekelja,4281356,,False,5.0,0,2,0,2,0,0,0,0,0,0,0,1,0,0,0,0,0
400995843,DePaul Blue Demons,D. Cage,4068073,,False,3.0,1,1,1,1,0,0,0,0,0,0,0,0,0,0,1,0,2
400995843,DePaul Blue Demons,T. Allen,3933760,,False,14.0,2,7,2,4,0,3,0,0,1,3,4,2,0,0,1,1,4
400995843,DePaul Blue Demons,L. Prochaska,3142290,,False,23.0,3,7,0,2,3,5,2,2,1,4,5,1,0,0,4,2,11
400995843,DePaul Blue Demons,TEAM,TOTAL,TOTAL,False,,31,69,18,37,13,32,11,15,17,28,45,18,8,2,15,14,86
400995843,Butler Bulldogs,S. Brey,4068067,,True,35.0,2,3,2,3,0,0,0,0,2,6,8,2,3,0,2,1,4
400995843,Butler Bulldogs,T. Schickel,3914012,,True,22.0,3,8,3,8,0,0,1,2,4,1,5,4,1,0,5,3,7
400995843,Butler Bulldogs,K. Spolyar,4068068,,True,38.0,5,13,3,9,2,4,4,4,1,2,3,4,1,0,2,4,16
400995843,Butler Bulldogs,W. Jennings,3142145,,True,38.0,8,21,3,11,5,10,2,2,0,2,2,1,2,0,2,1,23
400995843,Butler Bulldogs,I. Lathan,3079485,,True,21.0,2,4,2,4,0,0,0,2,0,2,2,2,0,0,1,3,4
400995843,Butler Bulldogs,K. Hodges,4068065,,False,16.0,3,5,3,5,0,0,0,0,3,3,6,1,1,0,0,4,6
400995843,Butler Bulldogs,S. Humphrey,4068066,,False,5.0,0,1,0,0,0,1,1,2,0,0,0,0,0,0,0,2,1
400995843,Butler Bulldogs,S. Buck,3142279,,False,25.0,3,7,2,3,1,4,0,0,0,0,0,0,2,0,2,0,7
400995843,Butler Bulldogs,TEAM,TOTAL,TOTAL,False,,26,62,18,43,8,19,8,12,10,20,30,14,10,0,16,18,68
400995843,Butler Bulldogs,S. Brey,4068067,,True,35.0,2,3,2,3,0,0,0,0,2,6,8,2,3,0,2,1,4
400995843,Butler Bulldogs,T. Schickel,3914012,,True,22.0,3,8,3,8,0,0,1,2,4,1,5,4,1,0,5,3,7
400995843,Butler Bulldogs,K. Spolyar,4068068,,True,38.0,5,13,3,9,2,4,4,4,1,2,3,4,1,0,2,4,16
400995843,Butler Bulldogs,W. Jennings,3142145,,True,38.0,8,21,3,11,5,10,2,2,0,2,2,1,2,0,2,1,23
400995843,Butler Bulldogs,I. Lathan,3079485,,True,21.0,2,4,2,4,0,0,0,2,0,2,2,2,0,0,1,3,4
400995843,Butler Bulldogs,K. Hodges,4068065,,False,16.0,3,5,3,5,0,0,0,0,3,3,6,1,1,0,0,4,6
400995843,Butler Bulldogs,S. Humphrey,4068066,,False,5.0,0,1,0,0,0,1,1,2,0,0,0,0,0,0,0,2,1
400995843,Butler Bulldogs,S. Buck,3142279,,False,25.0,3,7,2,3,1,4,0,0,0,0,0,0,2,0,2,0,7
400995843,Butler Bulldogs,TEAM,TOTAL,TOTAL,False,,26,62,18,43,8,19,8,12,10,20,30,14,10,0,16,18,68
400995842,Marquette Golden Eagles,S. Valentine,3142300,,True,6.0,0,0,0,0,0,0,2,2,1,0,1,0,0,0,0,0,2
400995842,Marquette Golden Eagles,S. Lott,4281350,,True,23.0,1,3,1,2,0,1,1,1,1,2,3,0,0,1,0,2,3
400995842,Marquette Golden Eagles,I. Spingola,4068082,,True,11.0,0,3,0,0,0,3,0,0,0,0,0,0,0,0,0,0,0
400995842,Marquette Golden Eagles,A. Wilborn,3906758,,True,31.0,3,9,3,5,0,4,4,4,3,3,6,3,0,1,1,3,10
400995842,Marquette Golden Eagles,D. King,3906752,,True,36.0,4,14,2,8,2,6,1,2,5,1,6,3,0,0,1,4,11
400995842,Marquette Golden Eagles,E. Davenport,3906756,,False,29.0,11,16,11,15,0,1,1,2,4,6,10,1,1,0,1,3,23
400995842,Marquette Golden Eagles,L. Van Kleunen,4068083,,False,9.0,0,0,0,0,0,0,0,0,0,2,2,1,0,0,0,1,0
400995842,Marquette Golden Eagles,A. Blockton,3906755,,False,33.0,9,19,9,17,0,2,2,2,1,1,2,7,1,0,3,1,20
400995842,Marquette Golden Eagles,N. Hiedeman,3906753,,False,22.0,1,4,1,3,0,1,2,2,1,5,6,1,0,0,1,1,4
400995842,Marquette Golden Eagles,TEAM,TOTAL,TOTAL,False,,29,68,27,50,2,18,13,15,16,21,37,16,2,2,7,15,73
400995842,Marquette Golden Eagles,S. Valentine,3142300,,True,6.0,0,0,0,0,0,0,2,2,1,0,1,0,0,0,0,0,2
400995842,Marquette Golden Eagles,S. Lott,4281350,,True,23.0,1,3,1,2,0,1,1,1,1,2,3,0,0,1,0,2,3
400995842,Marquette Golden Eagles,I. Spingola,4068082,,True,11.0,0,3,0,0,0,3,0,0,0,0,0,0,0,0,0,0,0
400995842,Marquette Golden Eagles,A. Wilborn,3906758,,True,31.0,3,9,3,5,0,4,4,4,3,3,6,3,0,1,1,3,10
400995842,Marquette Golden Eagles,D. King,3906752,,True,36.0,4,14,2,8,2,6,1,2,5,1,6,3,0,0,1,4,11
400995842,Marquette Golden Eagles,E. Davenport,3906756,,False,29.0,11,16,11,15,0,1,1,2,4,6,10,1,1,0,1,3,23
400995842,Marquette Golden Eagles,L. Van Kleunen,4068083,,False,9.0,0,0,0,0,0,0,0,0,0,2,2,1,0,0,0,1,0
400995842,Marquette Golden Eagles,A. Blockton,3906755,,False,33.0,9,19,9,17,0,2,2,2,1,1,2,7,1,0,3,1,20
400995842,Marquette Golden Eagles,N. Hiedeman,3906753,,False,22.0,1,4,1,3,0,1,2,2,1,5,6,1,0,0,1,1,4
400995842,Marquette Golden Eagles,TEAM,TOTAL,TOTAL,False,,29,68,27,50,2,18,13,15,16,21,37,16,2,2,7,15,73
400995842,Creighton Bluejays,A. Faber,3938938,,True,38.0,7,15,6,10,1,5,1,1,0,8,8,1,1,1,4,2,16
400995842,Creighton Bluejays,J. Agnew,3938935,,True,37.0,4,11,1,4,3,7,1,2,1,5,6,2,0,1,1,4,12
400995842,Creighton Bluejays,B. Norby,3142284,,True,19.0,3,3,2,2,1,1,2,2,1,1,2,3,0,0,0,2,9
400995842,Creighton Bluejays,S. Lamberty,3142285,,True,37.0,7,11,6,10,1,1,3,3,0,4,4,7,0,0,3,1,18
400995842,Creighton Bluejays,M. Mellman,3142283,,True,13.0,0,1,0,0,0,1,0,0,0,1,1,2,0,0,0,0,0
400995842,Creighton Bluejays,A. Greene,3938937,,False,12.0,1,2,1,2,0,0,0,0,0,0,0,0,0,0,0,5,2
400995842,Creighton Bluejays,K. Brown,3142286,,False,9.0,2,3,2,3,0,0,0,0,0,0,0,0,0,1,1,2,4
400995842,Creighton Bluejays,T. Carda,4281362,,False,28.0,4,7,3,6,1,1,4,8,1,4,5,1,0,0,2,0,13
400995842,Creighton Bluejays,T. Rembao,4281361,,False,1.0,0,0,0,0,0,0,0,0,0,0,0,0,0,0,0,0,0
400995842,Creighton Bluejays,B. Kissinger,3142124,,False,6.0,0,0,0,0,0,0,0,0,0,0,0,0,0,0,0,0,0
400995842,Creighton Bluejays,TEAM,TOTAL,TOTAL,False,,28,53,21,37,7,16,11,16,6,23,29,16,1,3,12,16,74
400995842,Creighton Bluejays,A. Faber,3938938,,True,38.0,7,15,6,10,1,5,1,1,0,8,8,1,1,1,4,2,16
400995842,Creighton Bluejays,J. Agnew,3938935,,True,37.0,4,11,1,4,3,7,1,2,1,5,6,2,0,1,1,4,12
400995842,Creighton Bluejays,B. Norby,3142284,,True,19.0,3,3,2,2,1,1,2,2,1,1,2,3,0,0,0,2,9
400995842,Creighton Bluejays,S. Lamberty,3142285,,True,37.0,7,11,6,10,1,1,3,3,0,4,4,7,0,0,3,1,18
400995842,Creighton Bluejays,M. Mellman,3142283,,True,13.0,0,1,0,0,0,1,0,0,0,1,1,2,0,0,0,0,0
400995842,Creighton Bluejays,A. Greene,3938937,,False,12.0,1,2,1,2,0,0,0,0,0,0,0,0,0,0,0,5,2
400995842,Creighton Bluejays,K. Brown,3142286,,False,9.0,2,3,2,3,0,0,0,0,0,0,0,0,0,1,1,2,4
400995842,Creighton Bluejays,T. Carda,4281362,,False,28.0,4,7,3,6,1,1,4,8,1,4,5,1,0,0,2,0,13
400995842,Creighton Bluejays,T. Rembao,4281361,,False,1.0,0,0,0,0,0,0,0,0,0,0,0,0,0,0,0,0,0
400995842,Creighton Bluejays,B. Kissinger,3142124,,False,6.0,0,0,0,0,0,0,0,0,0,0,0,0,0,0,0,0,0
400995842,Creighton Bluejays,TEAM,TOTAL,TOTAL,False,,28,53,21,37,7,16,11,16,6,23,29,16,1,3,12,16,74
400995841,Providence Friars,N. Franklin,4281348,,True,16.0,2,4,2,4,0,0,0,0,0,5,5,0,0,1,1,4,4
400995841,Providence Friars,C. Williams,4281345,,True,29.0,6,18,6,17,0,1,3,3,1,4,5,3,1,1,2,1,15
400995841,Providence Friars,J. Nogic,3906769,,True,29.0,3,12,1,6,2,6,0,0,0,1,1,0,1,0,1,1,8
400995841,Providence Friars,M. Jolin,3906767,,True,17.0,0,4,0,2,0,2,1,2,1,1,2,0,0,0,1,1,1
400995841,Providence Friars,C. Che,3906766,,True,27.0,2,7,2,5,0,2,0,0,0,2,2,1,1,0,3,0,4
400995841,Providence Friars,A. Cooper,4281349,,False,8.0,0,0,0,0,0,0,1,2,0,2,2,0,0,0,0,2,1
400995841,Providence Friars,B. Frias,3142302,,False,2.0,1,1,1,1,0,0,0,0,0,1,1,0,0,0,0,1,2
400995841,Providence Friars,O. Orlando,4281347,,False,7.0,0,0,0,0,0,0,0,0,0,0,0,0,0,0,2,3,0
400995841,Providence Friars,K. Spiwak,4281346,,False,28.0,1,5,1,5,0,0,0,0,1,2,3,0,0,0,2,1,2
400995841,Providence Friars,N. Jackson,4068111,,False,18.0,1,1,1,1,0,0,0,1,0,1,1,1,0,0,1,0,2
400995841,Providence Friars,A. Botteghi,3142301,,False,19.0,3,4,3,4,0,0,2,2,1,2,3,0,0,0,1,1,8
400995841,Providence Friars,TEAM,TOTAL,TOTAL,False,,19,56,17,45,2,11,7,10,5,24,29,5,3,2,15,15,47
400995841,Providence Friars,N. Franklin,4281348,,True,16.0,2,4,2,4,0,0,0,0,0,5,5,0,0,1,1,4,4
400995841,Providence Friars,C. Williams,4281345,,True,29.0,6,18,6,17,0,1,3,3,1,4,5,3,1,1,2,1,15
400995841,Providence Friars,J. Nogic,3906769,,True,29.0,3,12,1,6,2,6,0,0,0,1,1,0,1,0,1,1,8
400995841,Providence Friars,M. Jolin,3906767,,True,17.0,0,4,0,2,0,2,1,2,1,1,2,0,0,0,1,1,1
400995841,Providence Friars,C. Che,3906766,,True,27.0,2,7,2,5,0,2,0,0,0,2,2,1,1,0,3,0,4
400995841,Providence Friars,A. Cooper,4281349,,False,8.0,0,0,0,0,0,0,1,2,0,2,2,0,0,0,0,2,1
400995841,Providence Friars,B. Frias,3142302,,False,2.0,1,1,1,1,0,0,0,0,0,1,1,0,0,0,0,1,2
400995841,Providence Friars,O. Orlando,4281347,,False,7.0,0,0,0,0,0,0,0,0,0,0,0,0,0,0,2,3,0
400995841,Providence Friars,K. Spiwak,4281346,,False,28.0,1,5,1,5,0,0,0,0,1,2,3,0,0,0,2,1,2
400995841,Providence Friars,N. Jackson,4068111,,False,18.0,1,1,1,1,0,0,0,1,0,1,1,1,0,0,1,0,2
400995841,Providence Friars,A. Botteghi,3142301,,False,19.0,3,4,3,4,0,0,2,2,1,2,3,0,0,0,1,1,8
400995841,Providence Friars,TEAM,TOTAL,TOTAL,False,,19,56,17,45,2,11,7,10,5,24,29,5,3,2,15,15,47
400995841,DePaul Blue Demons,C. Stonewall,4068072,,True,27.0,5,14,2,9,3,5,2,2,4,3,7,2,1,0,0,0,15
400995841,DePaul Blue Demons,M. Grays,3142287,,True,24.0,5,10,3,6,2,4,2,3,2,5,7,2,0,0,4,2,14
400995841,DePaul Blue Demons,K. Campbell,4068071,,True,31.0,4,7,3,4,1,3,2,2,3,7,10,6,0,0,1,2,11
400995841,DePaul Blue Demons,A. Millender,3142289,,True,27.0,3,7,2,4,1,3,1,1,2,4,6,4,0,0,2,0,8
400995841,DePaul Blue Demons,A. Coleman,3142123,,True,29.0,5,14,4,10,1,4,2,2,2,3,5,2,1,0,4,4,13
400995841,DePaul Blue Demons,R. McLimore,4281358,,False,6.0,1,1,1,1,0,0,0,0,2,2,4,0,0,0,1,1,2
400995841,DePaul Blue Demons,V. Sherrod,4281359,,False,4.0,1,2,0,0,1,2,0,0,0,0,0,0,0,0,0,1,3
400995841,DePaul Blue Demons,D. Bekelja,4281356,,False,8.0,2,3,2,3,0,0,0,2,0,3,3,0,0,0,0,2,4
400995841,DePaul Blue Demons,D. Cage,4068073,,False,8.0,0,4,0,3,0,1,0,0,0,2,2,2,0,0,0,1,0
400995841,DePaul Blue Demons,T. Allen,3933760,,False,15.0,2,4,0,0,2,4,3,3,0,0,0,2,0,0,0,1,9
400995841,DePaul Blue Demons,L. Prochaska,3142290,,False,21.0,1,2,1,1,0,1,0,0,0,4,4,1,1,1,1,1,2
400995841,DePaul Blue Demons,TEAM,TOTAL,TOTAL,False,,29,68,18,41,11,27,12,15,17,34,51,21,3,1,13,15,81
400995841,DePaul Blue Demons,C. Stonewall,4068072,,True,27.0,5,14,2,9,3,5,2,2,4,3,7,2,1,0,0,0,15
400995841,DePaul Blue Demons,M. Grays,3142287,,True,24.0,5,10,3,6,2,4,2,3,2,5,7,2,0,0,4,2,14
400995841,DePaul Blue Demons,K. Campbell,4068071,,True,31.0,4,7,3,4,1,3,2,2,3,7,10,6,0,0,1,2,11
400995841,DePaul Blue Demons,A. Millender,3142289,,True,27.0,3,7,2,4,1,3,1,1,2,4,6,4,0,0,2,0,8
400995841,DePaul Blue Demons,A. Coleman,3142123,,True,29.0,5,14,4,10,1,4,2,2,2,3,5,2,1,0,4,4,13
400995841,DePaul Blue Demons,R. McLimore,4281358,,False,6.0,1,1,1,1,0,0,0,0,2,2,4,0,0,0,1,1,2
400995841,DePaul Blue Demons,V. Sherrod,4281359,,False,4.0,1,2,0,0,1,2,0,0,0,0,0,0,0,0,0,1,3
400995841,DePaul Blue Demons,D. Bekelja,4281356,,False,8.0,2,3,2,3,0,0,0,2,0,3,3,0,0,0,0,2,4
400995841,DePaul Blue Demons,D. Cage,4068073,,False,8.0,0,4,0,3,0,1,0,0,0,2,2,2,0,0,0,1,0
400995841,DePaul Blue Demons,T. Allen,3933760,,False,15.0,2,4,0,0,2,4,3,3,0,0,0,2,0,0,0,1,9
400995841,DePaul Blue Demons,L. Prochaska,3142290,,False,21.0,1,2,1,1,0,1,0,0,0,4,4,1,1,1,1,1,2
400995841,DePaul Blue Demons,TEAM,TOTAL,TOTAL,False,,29,68,18,41,11,27,12,15,17,34,51,21,3,1,13,15,81
400995840,Xavier Musketeers,I. Partlow,3142320,,True,31.0,4,10,4,9,0,1,3,8,4,7,11,0,2,0,1,0,11
400995840,Xavier Musketeers,A. Aijanen,3142319,,True,21.0,1,4,0,1,1,3,0,0,0,2,2,1,0,0,0,1,3
400995840,Xavier Musketeers,N. Owens,4068187,,True,23.0,2,6,2,6,0,0,1,3,1,3,4,0,1,0,1,2,5
400995840,Xavier Musketeers,J. Byrd,3142318,,True,24.0,4,6,4,6,0,0,1,2,0,0,0,1,1,0,4,2,9
400995840,Xavier Musketeers,K. Fincher,3142317,,True,22.0,1,4,0,1,1,3,0,0,1,0,1,0,0,0,3,1,3
400995840,Xavier Musketeers,A. Gray,4281368,,False,18.0,0,6,0,4,0,2,1,2,2,2,4,0,1,1,3,2,1
400995840,Xavier Musketeers,D. Ross,4281364,,False,11.0,0,2,0,1,0,1,0,0,0,1,1,0,0,0,3,2,0
400995840,Xavier Musketeers,M. Christopher,4068186,,False,5.0,0,1,0,1,0,0,0,0,0,0,0,0,0,0,0,2,0
400995840,Xavier Musketeers,A. Reiff,4281367,,False,7.0,0,0,0,0,0,0,0,0,0,0,0,0,0,0,0,2,0
400995840,Xavier Musketeers,P. Stewart,4281366,,False,17.0,0,3,0,2,0,1,0,0,0,3,3,0,0,0,1,0,0
400995840,Xavier Musketeers,A. Dunham,4281365,,False,16.0,2,3,2,2,0,1,0,0,0,1,1,0,1,0,1,0,4
400995840,Xavier Musketeers,A. Gomez,4068185,,False,5.0,0,0,0,0,0,0,0,0,0,0,0,0,0,0,1,0,0
400995840,Xavier Musketeers,TEAM,TOTAL,TOTAL,False,,14,45,12,33,2,12,6,15,9,19,28,2,6,1,18,14,36
400995840,Xavier Musketeers,I. Partlow,3142320,,True,31.0,4,10,4,9,0,1,3,8,4,7,11,0,2,0,1,0,11
400995840,Xavier Musketeers,A. Aijanen,3142319,,True,21.0,1,4,0,1,1,3,0,0,0,2,2,1,0,0,0,1,3
400995840,Xavier Musketeers,N. Owens,4068187,,True,23.0,2,6,2,6,0,0,1,3,1,3,4,0,1,0,1,2,5
400995840,Xavier Musketeers,J. Byrd,3142318,,True,24.0,4,6,4,6,0,0,1,2,0,0,0,1,1,0,4,2,9
400995840,Xavier Musketeers,K. Fincher,3142317,,True,22.0,1,4,0,1,1,3,0,0,1,0,1,0,0,0,3,1,3
400995840,Xavier Musketeers,A. Gray,4281368,,False,18.0,0,6,0,4,0,2,1,2,2,2,4,0,1,1,3,2,1
400995840,Xavier Musketeers,D. Ross,4281364,,False,11.0,0,2,0,1,0,1,0,0,0,1,1,0,0,0,3,2,0
400995840,Xavier Musketeers,M. Christopher,4068186,,False,5.0,0,1,0,1,0,0,0,0,0,0,0,0,0,0,0,2,0
400995840,Xavier Musketeers,A. Reiff,4281367,,False,7.0,0,0,0,0,0,0,0,0,0,0,0,0,0,0,0,2,0
400995840,Xavier Musketeers,P. Stewart,4281366,,False,17.0,0,3,0,2,0,1,0,0,0,3,3,0,0,0,1,0,0
400995840,Xavier Musketeers,A. Dunham,4281365,,False,16.0,2,3,2,2,0,1,0,0,0,1,1,0,1,0,1,0,4
400995840,Xavier Musketeers,A. Gomez,4068185,,False,5.0,0,0,0,0,0,0,0,0,0,0,0,0,0,0,1,0,0
400995840,Xavier Musketeers,TEAM,TOTAL,TOTAL,False,,14,45,12,33,2,12,6,15,9,19,28,2,6,1,18,14,36
400995840,St. John's Red Storm,M. Singleton,4068158,,True,29.0,6,12,6,12,0,0,0,0,3,4,7,1,1,0,1,3,12
400995840,St. John's Red Storm,I. Littleton,3142306,,True,24.0,3,6,3,6,0,0,0,0,1,6,7,1,0,2,0,0,6
400995840,St. John's Red Storm,A. Wellere,3906771,,True,26.0,4,5,2,2,2,3,1,1,0,1,1,3,1,1,1,2,11
400995840,St. John's Red Storm,T. England,4068155,,True,28.0,1,6,1,5,0,1,0,0,1,1,2,4,2,2,5,1,2
400995840,St. John's Red Storm,A. Kebbe,4068154,,True,28.0,5,8,4,5,1,3,4,4,5,4,9,2,0,1,0,1,15
400995840,St. John's Red Storm,K. Charles,4281374,,False,8.0,2,2,2,2,0,0,0,0,0,2,2,0,0,1,1,4,4
400995840,St. John's Red Storm,Q. Hoppie,4281375,,False,23.0,4,9,3,6,1,3,0,0,0,3,3,0,0,0,1,1,9
400995840,St. John's Red Storm,A. Adams,4068157,,False,21.0,2,8,2,5,0,3,2,2,0,1,1,1,1,0,1,0,6
400995840,St. John's Red Storm,S. Duncan,4068156,,False,5.0,2,5,1,1,1,4,0,0,0,0,0,1,0,0,0,0,5
400995840,St. John's Red Storm,T. Alexander,3142305,,False,8.0,0,1,0,1,0,0,0,0,0,1,1,1,0,0,1,0,0
400995840,St. John's Red Storm,TEAM,TOTAL,TOTAL,False,,29,62,24,45,5,17,7,7,14,26,40,14,5,7,11,12,70
400995840,St. John's Red Storm,M. Singleton,4068158,,True,29.0,6,12,6,12,0,0,0,0,3,4,7,1,1,0,1,3,12
400995840,St. John's Red Storm,I. Littleton,3142306,,True,24.0,3,6,3,6,0,0,0,0,1,6,7,1,0,2,0,0,6
400995840,St. John's Red Storm,A. Wellere,3906771,,True,26.0,4,5,2,2,2,3,1,1,0,1,1,3,1,1,1,2,11
400995840,St. John's Red Storm,T. England,4068155,,True,28.0,1,6,1,5,0,1,0,0,1,1,2,4,2,2,5,1,2
400995840,St. John's Red Storm,A. Kebbe,4068154,,True,28.0,5,8,4,5,1,3,4,4,5,4,9,2,0,1,0,1,15
400995840,St. John's Red Storm,K. Charles,4281374,,False,8.0,2,2,2,2,0,0,0,0,0,2,2,0,0,1,1,4,4
400995840,St. John's Red Storm,Q. Hoppie,4281375,,False,23.0,4,9,3,6,1,3,0,0,0,3,3,0,0,0,1,1,9
400995840,St. John's Red Storm,A. Adams,4068157,,False,21.0,2,8,2,5,0,3,2,2,0,1,1,1,1,0,1,0,6
400995840,St. John's Red Storm,S. Duncan,4068156,,False,5.0,2,5,1,1,1,4,0,0,0,0,0,1,0,0,0,0,5
400995840,St. John's Red Storm,T. Alexander,3142305,,False,8.0,0,1,0,1,0,0,0,0,0,1,1,1,0,0,1,0,0
400995840,St. John's Red Storm,TEAM,TOTAL,TOTAL,False,,29,62,24,45,5,17,7,7,14,26,40,14,5,7,11,12,70
400995839,Seton Hall Pirates,S. Samuels,4068128,,True,40.0,7,11,5,7,2,4,6,8,2,9,11,1,3,1,2,3,22
400995839,Seton Hall Pirates,K. Evans,4281378,,True,16.0,2,3,2,3,0,0,1,1,0,1,1,0,0,1,0,3,5
400995839,Seton Hall Pirates,N. Jimenez,4281379,,True,22.0,2,6,1,2,1,4,5,5,0,0,0,1,1,0,1,1,10
400995839,Seton Hall Pirates,D. Winters,4068126,,True,10.0,0,2,0,0,0,2,0,0,0,0,0,0,0,1,0,2,0
400995839,Seton Hall Pirates,J. Jackson,3064877,,True,34.0,6,14,3,6,3,8,3,3,1,6,7,0,1,0,1,1,18
400995839,Seton Hall Pirates,S. Philoxy,4281380,,False,20.0,2,4,2,4,0,0,1,2,2,0,2,2,3,0,1,5,5
400995839,Seton Hall Pirates,J. Jones-Pack,4068129,,False,4.0,0,2,0,2,0,0,1,2,2,2,4,0,0,5,1,4,1
400995839,Seton Hall Pirates,K. Hilaire,4068123,,False,33.0,3,13,3,9,0,4,8,10,1,1,2,6,3,1,0,5,14
400995839,Seton Hall Pirates,K. Healy,3943704,,False,21.0,0,3,0,0,0,3,0,0,0,0,0,2,0,0,0,0,0
400995839,Seton Hall Pirates,TEAM,TOTAL,TOTAL,False,,22,58,16,33,6,25,25,31,9,23,32,12,11,9,7,24,75
400995839,Seton Hall Pirates,S. Samuels,4068128,,True,40.0,7,11,5,7,2,4,6,8,2,9,11,1,3,1,2,3,22
400995839,Seton Hall Pirates,K. Evans,4281378,,True,16.0,2,3,2,3,0,0,1,1,0,1,1,0,0,1,0,3,5
400995839,Seton Hall Pirates,N. Jimenez,4281379,,True,22.0,2,6,1,2,1,4,5,5,0,0,0,1,1,0,1,1,10
400995839,Seton Hall Pirates,D. Winters,4068126,,True,10.0,0,2,0,0,0,2,0,0,0,0,0,0,0,1,0,2,0
400995839,Seton Hall Pirates,J. Jackson,3064877,,True,34.0,6,14,3,6,3,8,3,3,1,6,7,0,1,0,1,1,18
400995839,Seton Hall Pirates,S. Philoxy,4281380,,False,20.0,2,4,2,4,0,0,1,2,2,0,2,2,3,0,1,5,5
400995839,Seton Hall Pirates,J. Jones-Pack,4068129,,False,4.0,0,2,0,2,0,0,1,2,2,2,4,0,0,5,1,4,1
400995839,Seton Hall Pirates,K. Hilaire,4068123,,False,33.0,3,13,3,9,0,4,8,10,1,1,2,6,3,1,0,5,14
400995839,Seton Hall Pirates,K. Healy,3943704,,False,21.0,0,3,0,0,0,3,0,0,0,0,0,2,0,0,0,0,0
400995839,Seton Hall Pirates,TEAM,TOTAL,TOTAL,False,,22,58,16,33,6,25,25,31,9,23,32,12,11,9,7,24,75
400995839,Butler Bulldogs,T. Schickel,3914012,,True,40.0,8,14,8,14,0,0,8,14,3,11,14,1,0,0,1,4,24
400995839,Butler Bulldogs,S. Brey,4068067,,True,37.0,0,1,0,1,0,0,0,0,4,6,10,1,1,0,5,3,0
400995839,Butler Bulldogs,K. Spolyar,4068068,,True,28.0,1,6,0,3,1,3,1,2,0,3,3,5,1,0,3,2,4
400995839,Butler Bulldogs,M. Weaver,3914014,,True,38.0,4,10,0,2,4,8,1,3,0,4,4,2,0,0,3,4,13
400995839,Butler Bulldogs,W. Jennings,3142145,,True,39.0,6,15,5,11,1,4,4,4,0,4,4,1,0,0,2,5,17
400995839,Butler Bulldogs,S. Buck,3142279,,False,1.0,0,0,0,0,0,0,0,0,0,0,0,0,0,0,0,0,0
400995839,Butler Bulldogs,I. Lathan,3079485,,False,17.0,3,7,3,7,0,0,0,0,2,1,3,0,1,0,4,4,6
400995839,Butler Bulldogs,TEAM,TOTAL,TOTAL,False,,22,53,16,38,6,15,14,23,13,29,42,10,3,0,19,22,64
400995839,Butler Bulldogs,T. Schickel,3914012,,True,40.0,8,14,8,14,0,0,8,14,3,11,14,1,0,0,1,4,24
400995839,Butler Bulldogs,S. Brey,4068067,,True,37.0,0,1,0,1,0,0,0,0,4,6,10,1,1,0,5,3,0
400995839,Butler Bulldogs,K. Spolyar,4068068,,True,28.0,1,6,0,3,1,3,1,2,0,3,3,5,1,0,3,2,4
400995839,Butler Bulldogs,M. Weaver,3914014,,True,38.0,4,10,0,2,4,8,1,3,0,4,4,2,0,0,3,4,13
400995839,Butler Bulldogs,W. Jennings,3142145,,True,39.0,6,15,5,11,1,4,4,4,0,4,4,1,0,0,2,5,17
400995839,Butler Bulldogs,S. Buck,3142279,,False,1.0,0,0,0,0,0,0,0,0,0,0,0,0,0,0,0,0,0
400995839,Butler Bulldogs,I. Lathan,3079485,,False,17.0,3,7,3,7,0,0,0,0,2,1,3,0,1,0,4,4,6
400995839,Butler Bulldogs,TEAM,TOTAL,TOTAL,False,,22,53,16,38,6,15,14,23,13,29,42,10,3,0,19,22,64
400995838,Villanova Wildcats,M. Quinn,3056785,,True,16.0,2,4,2,2,0,2,0,0,0,2,2,1,0,0,2,0,4
400995838,Villanova Wildcats,J. Tucker,3087536,,True,35.0,3,9,1,5,2,4,1,2,1,3,4,1,0,0,1,2,9
400995838,Villanova Wildcats,K. Jekot,4068171,,True,40.0,4,9,3,4,1,5,4,5,1,3,4,4,0,0,3,0,13
400995838,Villanova Wildcats,A. Hahn,3906779,,True,35.0,3,5,1,2,2,3,0,1,0,3,3,2,0,0,4,2,8
400995838,Villanova Wildcats,A. Louin,3142314,,True,32.0,5,9,5,9,0,0,4,6,4,5,9,2,0,1,1,4,14
400995838,Villanova Wildcats,M. Gedaka,4068172,,False,28.0,7,12,6,11,1,1,2,6,2,7,9,0,0,2,0,1,17
400995838,Villanova Wildcats,B. Herlihy,3906778,,False,4.0,0,0,0,0,0,0,0,0,0,0,0,0,0,1,1,0,0
400995838,Villanova Wildcats,G. Stant,3906780,,False,10.0,1,1,0,0,1,1,0,0,0,1,1,1,0,0,0,0,3
400995838,Villanova Wildcats,TEAM,TOTAL,TOTAL,False,,25,49,18,33,7,16,11,20,9,25,34,11,0,4,12,9,68
400995838,Villanova Wildcats,M. Quinn,3056785,,True,16.0,2,4,2,2,0,2,0,0,0,2,2,1,0,0,2,0,4
400995838,Villanova Wildcats,J. Tucker,3087536,,True,35.0,3,9,1,5,2,4,1,2,1,3,4,1,0,0,1,2,9
400995838,Villanova Wildcats,K. Jekot,4068171,,True,40.0,4,9,3,4,1,5,4,5,1,3,4,4,0,0,3,0,13
400995838,Villanova Wildcats,A. Hahn,3906779,,True,35.0,3,5,1,2,2,3,0,1,0,3,3,2,0,0,4,2,8
400995838,Villanova Wildcats,A. Louin,3142314,,True,32.0,5,9,5,9,0,0,4,6,4,5,9,2,0,1,1,4,14
400995838,Villanova Wildcats,M. Gedaka,4068172,,False,28.0,7,12,6,11,1,1,2,6,2,7,9,0,0,2,0,1,17
400995838,Villanova Wildcats,B. Herlihy,3906778,,False,4.0,0,0,0,0,0,0,0,0,0,0,0,0,0,1,1,0,0
400995838,Villanova Wildcats,G. Stant,3906780,,False,10.0,1,1,0,0,1,1,0,0,0,1,1,1,0,0,0,0,3
400995838,Villanova Wildcats,TEAM,TOTAL,TOTAL,False,,25,49,18,33,7,16,11,20,9,25,34,11,0,4,12,9,68
400995838,Georgetown Hoyas,C. Petke,4068078,,True,40.0,6,16,6,14,0,2,0,0,6,8,14,1,2,1,2,3,12
400995838,Georgetown Hoyas,Y. Belk,3142295,,True,35.0,4,10,4,10,0,0,0,0,5,1,6,2,0,0,0,2,8
400995838,Georgetown Hoyas,D. White,3948815,,True,39.0,10,26,9,20,1,6,0,1,2,3,5,2,5,1,2,2,21
400995838,Georgetown Hoyas,D. Burton,3142292,,True,26.0,1,3,1,3,0,0,1,2,2,2,4,2,0,0,0,3,3
400995838,Georgetown Hoyas,M. Venson,3142105,,True,36.0,8,14,3,5,5,9,2,3,1,2,3,1,0,0,0,2,23
400995838,Georgetown Hoyas,T. Thompson,4281352,,False,14.0,0,2,0,1,0,1,0,0,1,1,2,1,1,0,1,3,0
400995838,Georgetown Hoyas,M. Smith,4068079,,False,10.0,0,4,0,3,0,1,0,2,4,0,4,0,0,0,0,1,0
400995838,Georgetown Hoyas,TEAM,TOTAL,TOTAL,False,,29,75,23,56,6,19,3,8,23,19,42,9,8,2,5,16,67
400995838,Georgetown Hoyas,C. Petke,4068078,,True,40.0,6,16,6,14,0,2,0,0,6,8,14,1,2,1,2,3,12
400995838,Georgetown Hoyas,Y. Belk,3142295,,True,35.0,4,10,4,10,0,0,0,0,5,1,6,2,0,0,0,2,8
400995838,Georgetown Hoyas,D. White,3948815,,True,39.0,10,26,9,20,1,6,0,1,2,3,5,2,5,1,2,2,21
400995838,Georgetown Hoyas,D. Burton,3142292,,True,26.0,1,3,1,3,0,0,1,2,2,2,4,2,0,0,0,3,3
400995838,Georgetown Hoyas,M. Venson,3142105,,True,36.0,8,14,3,5,5,9,2,3,1,2,3,1,0,0,0,2,23
400995838,Georgetown Hoyas,T. Thompson,4281352,,False,14.0,0,2,0,1,0,1,0,0,1,1,2,1,1,0,1,3,0
400995838,Georgetown Hoyas,M. Smith,4068079,,False,10.0,0,4,0,3,0,1,0,2,4,0,4,0,0,0,0,1,0
400995838,Georgetown Hoyas,TEAM,TOTAL,TOTAL,False,,29,75,23,56,6,19,3,8,23,19,42,9,8,2,5,16,67
400995837,Providence Friars,N. Franklin,4281348,,True,18.0,0,1,0,1,0,0,0,2,0,4,4,0,0,0,1,1,0
400995837,Providence Friars,C. Williams,4281345,,True,15.0,2,6,2,6,0,0,2,3,0,0,0,4,0,0,5,3,6
400995837,Providence Friars,J. Nogic,3906769,,True,28.0,6,11,2,5,4,6,2,2,0,1,1,2,1,0,3,2,18
400995837,Providence Friars,M. Jolin,3906767,,True,20.0,4,7,2,3,2,4,0,0,0,2,2,1,0,0,1,4,10
400995837,Providence Friars,C. Che,3906766,,True,29.0,4,7,3,4,1,3,0,0,0,0,0,4,2,0,4,1,9
400995837,Providence Friars,A. Cooper,4281349,,False,23.0,2,4,2,4,0,0,1,2,0,0,0,0,1,0,1,3,5
400995837,Providence Friars,B. Frias,3142302,,False,4.0,0,0,0,0,0,0,0,0,0,0,0,0,0,0,0,1,0
400995837,Providence Friars,O. Orlando,4281347,,False,11.0,1,3,1,3,0,0,1,1,1,1,2,2,0,0,0,1,3
400995837,Providence Friars,K. Spiwak,4281346,,False,26.0,2,7,2,7,0,0,0,0,0,1,1,0,1,0,1,1,4
400995837,Providence Friars,N. Jackson,4068111,,False,13.0,1,2,1,2,0,0,0,0,3,1,4,2,0,0,1,2,2
400995837,Providence Friars,A. Botteghi,3142301,,False,13.0,2,2,2,2,0,0,0,0,0,1,1,0,1,0,0,0,4
400995837,Providence Friars,TEAM,TOTAL,TOTAL,False,,24,50,17,37,7,13,6,10,4,13,17,15,6,0,19,19,61
400995837,Providence Friars,N. Franklin,4281348,,True,18.0,0,1,0,1,0,0,0,2,0,4,4,0,0,0,1,1,0
400995837,Providence Friars,C. Williams,4281345,,True,15.0,2,6,2,6,0,0,2,3,0,0,0,4,0,0,5,3,6
400995837,Providence Friars,J. Nogic,3906769,,True,28.0,6,11,2,5,4,6,2,2,0,1,1,2,1,0,3,2,18
400995837,Providence Friars,M. Jolin,3906767,,True,20.0,4,7,2,3,2,4,0,0,0,2,2,1,0,0,1,4,10
400995837,Providence Friars,C. Che,3906766,,True,29.0,4,7,3,4,1,3,0,0,0,0,0,4,2,0,4,1,9
400995837,Providence Friars,A. Cooper,4281349,,False,23.0,2,4,2,4,0,0,1,2,0,0,0,0,1,0,1,3,5
400995837,Providence Friars,B. Frias,3142302,,False,4.0,0,0,0,0,0,0,0,0,0,0,0,0,0,0,0,1,0
400995837,Providence Friars,O. Orlando,4281347,,False,11.0,1,3,1,3,0,0,1,1,1,1,2,2,0,0,0,1,3
400995837,Providence Friars,K. Spiwak,4281346,,False,26.0,2,7,2,7,0,0,0,0,0,1,1,0,1,0,1,1,4
400995837,Providence Friars,N. Jackson,4068111,,False,13.0,1,2,1,2,0,0,0,0,3,1,4,2,0,0,1,2,2
400995837,Providence Friars,A. Botteghi,3142301,,False,13.0,2,2,2,2,0,0,0,0,0,1,1,0,1,0,0,0,4
400995837,Providence Friars,TEAM,TOTAL,TOTAL,False,,24,50,17,37,7,13,6,10,4,13,17,15,6,0,19,19,61
400995837,Marquette Golden Eagles,S. Valentine,3142300,,True,15.0,2,2,2,2,0,0,0,0,0,2,2,0,0,0,0,1,4
400995837,Marquette Golden Eagles,S. Lott,4281350,,True,24.0,3,4,1,1,2,3,0,0,1,4,5,1,1,0,0,3,8
400995837,Marquette Golden Eagles,I. Spingola,4068082,,True,25.0,9,12,2,2,7,10,3,3,0,3,3,1,1,0,1,3,28
400995837,Marquette Golden Eagles,A. Wilborn,3906758,,True,31.0,4,9,4,8,0,1,4,4,1,1,2,7,2,0,2,1,12
400995837,Marquette Golden Eagles,D. King,3906752,,True,23.0,3,5,2,3,1,2,0,0,0,1,1,4,1,0,3,1,7
400995837,Marquette Golden Eagles,A. Anderson,4068081,,False,13.0,1,1,1,1,0,0,0,0,2,3,5,0,1,0,1,2,2
400995837,Marquette Golden Eagles,S. Dahling,3906754,,False,6.0,0,3,0,1,0,2,0,0,0,0,0,0,0,0,0,0,0
400995837,Marquette Golden Eagles,L. Van Kleunen,4068083,,False,16.0,2,3,1,1,1,2,0,0,2,4,6,0,1,1,1,3,5
400995837,Marquette Golden Eagles,A. Blockton,3906755,,False,25.0,8,13,8,10,0,3,4,6,4,2,6,5,1,1,3,2,20
400995837,Marquette Golden Eagles,N. Hiedeman,3906753,,False,22.0,2,4,2,3,0,1,4,7,1,3,4,2,1,0,3,3,8
400995837,Marquette Golden Eagles,TEAM,TOTAL,TOTAL,False,,34,56,23,32,11,24,15,20,11,23,34,20,9,2,15,19,94
400995837,Marquette Golden Eagles,S. Valentine,3142300,,True,15.0,2,2,2,2,0,0,0,0,0,2,2,0,0,0,0,1,4
400995837,Marquette Golden Eagles,S. Lott,4281350,,True,24.0,3,4,1,1,2,3,0,0,1,4,5,1,1,0,0,3,8
400995837,Marquette Golden Eagles,I. Spingola,4068082,,True,25.0,9,12,2,2,7,10,3,3,0,3,3,1,1,0,1,3,28
400995837,Marquette Golden Eagles,A. Wilborn,3906758,,True,31.0,4,9,4,8,0,1,4,4,1,1,2,7,2,0,2,1,12
400995837,Marquette Golden Eagles,D. King,3906752,,True,23.0,3,5,2,3,1,2,0,0,0,1,1,4,1,0,3,1,7
400995837,Marquette Golden Eagles,A. Anderson,4068081,,False,13.0,1,1,1,1,0,0,0,0,2,3,5,0,1,0,1,2,2
400995837,Marquette Golden Eagles,S. Dahling,3906754,,False,6.0,0,3,0,1,0,2,0,0,0,0,0,0,0,0,0,0,0
400995837,Marquette Golden Eagles,L. Van Kleunen,4068083,,False,16.0,2,3,1,1,1,2,0,0,2,4,6,0,1,1,1,3,5
400995837,Marquette Golden Eagles,A. Blockton,3906755,,False,25.0,8,13,8,10,0,3,4,6,4,2,6,5,1,1,3,2,20
400995837,Marquette Golden Eagles,N. Hiedeman,3906753,,False,22.0,2,4,2,3,0,1,4,7,1,3,4,2,1,0,3,3,8
400995837,Marquette Golden Eagles,TEAM,TOTAL,TOTAL,False,,34,56,23,32,11,24,15,20,11,23,34,20,9,2,15,19,94
400995836,DePaul Blue Demons,C. Stonewall,4068072,,True,16.0,6,7,6,6,0,1,0,1,2,1,3,0,1,0,0,3,12
400995836,DePaul Blue Demons,M. Grays,3142287,,True,34.0,10,18,7,11,3,7,2,2,0,3,3,1,0,0,6,1,25
400995836,DePaul Blue Demons,K. Campbell,4068071,,True,32.0,2,8,2,6,0,2,1,1,4,11,15,6,0,0,2,3,5
400995836,DePaul Blue Demons,A. Millender,3142289,,True,34.0,1,5,1,2,0,3,0,0,0,4,4,2,0,0,0,2,2
400995836,DePaul Blue Demons,A. Coleman,3142123,,True,30.0,3,8,3,7,0,1,2,2,1,0,1,3,0,1,1,1,8
400995836,DePaul Blue Demons,R. McLimore,4281358,,False,8.0,1,3,1,3,0,0,0,0,1,3,4,0,0,0,0,0,2
400995836,DePaul Blue Demons,T. Allen,3933760,,False,19.0,4,7,3,5,1,2,2,3,0,4,4,1,1,0,0,4,11
400995836,DePaul Blue Demons,L. Prochaska,3142290,,False,27.0,4,8,3,4,1,4,3,4,0,3,3,7,1,0,0,1,12
400995836,DePaul Blue Demons,TEAM,TOTAL,TOTAL,False,,31,64,26,44,5,20,10,13,9,30,39,20,3,1,10,15,77
400995836,DePaul Blue Demons,C. Stonewall,4068072,,True,16.0,6,7,6,6,0,1,0,1,2,1,3,0,1,0,0,3,12
400995836,DePaul Blue Demons,M. Grays,3142287,,True,34.0,10,18,7,11,3,7,2,2,0,3,3,1,0,0,6,1,25
400995836,DePaul Blue Demons,K. Campbell,4068071,,True,32.0,2,8,2,6,0,2,1,1,4,11,15,6,0,0,2,3,5
400995836,DePaul Blue Demons,A. Millender,3142289,,True,34.0,1,5,1,2,0,3,0,0,0,4,4,2,0,0,0,2,2
400995836,DePaul Blue Demons,A. Coleman,3142123,,True,30.0,3,8,3,7,0,1,2,2,1,0,1,3,0,1,1,1,8
400995836,DePaul Blue Demons,R. McLimore,4281358,,False,8.0,1,3,1,3,0,0,0,0,1,3,4,0,0,0,0,0,2
400995836,DePaul Blue Demons,T. Allen,3933760,,False,19.0,4,7,3,5,1,2,2,3,0,4,4,1,1,0,0,4,11
400995836,DePaul Blue Demons,L. Prochaska,3142290,,False,27.0,4,8,3,4,1,4,3,4,0,3,3,7,1,0,0,1,12
400995836,DePaul Blue Demons,TEAM,TOTAL,TOTAL,False,,31,64,26,44,5,20,10,13,9,30,39,20,3,1,10,15,77
400995836,Creighton Bluejays,A. Faber,3938938,,True,39.0,6,14,5,8,1,6,0,1,0,2,2,6,1,0,1,3,13
400995836,Creighton Bluejays,J. Agnew,3938935,,True,38.0,3,9,1,4,2,5,3,3,0,10,10,1,1,0,3,1,11
400995836,Creighton Bluejays,B. Norby,3142284,,True,7.0,0,1,0,1,0,0,0,0,1,0,1,0,0,0,1,0,0
400995836,Creighton Bluejays,S. Lamberty,3142285,,True,37.0,6,11,6,10,0,1,2,2,1,3,4,5,2,1,3,1,14
400995836,Creighton Bluejays,M. Mellman,3142283,,True,9.0,1,5,0,0,1,5,0,0,0,0,0,0,0,0,0,0,3
400995836,Creighton Bluejays,A. Greene,3938937,,False,21.0,5,7,5,7,0,0,0,0,2,4,6,0,2,0,0,2,10
400995836,Creighton Bluejays,K. Brown,3142286,,False,5.0,1,1,1,1,0,0,2,4,1,2,3,0,0,0,0,1,4
400995836,Creighton Bluejays,T. Carda,4281362,,False,34.0,5,12,3,8,2,4,0,0,0,3,3,4,0,0,2,2,12
400995836,Creighton Bluejays,T. Rembao,4281361,,False,2.0,0,0,0,0,0,0,0,0,0,0,0,0,0,0,1,0,0
400995836,Creighton Bluejays,B. Kissinger,3142124,,False,8.0,0,0,0,0,0,0,0,0,0,2,2,2,0,0,0,1,0
400995836,Creighton Bluejays,TEAM,TOTAL,TOTAL,False,,27,60,21,39,6,21,7,10,5,27,32,18,6,1,12,11,67
400995836,Creighton Bluejays,A. Faber,3938938,,True,39.0,6,14,5,8,1,6,0,1,0,2,2,6,1,0,1,3,13
400995836,Creighton Bluejays,J. Agnew,3938935,,True,38.0,3,9,1,4,2,5,3,3,0,10,10,1,1,0,3,1,11
400995836,Creighton Bluejays,B. Norby,3142284,,True,7.0,0,1,0,1,0,0,0,0,1,0,1,0,0,0,1,0,0
400995836,Creighton Bluejays,S. Lamberty,3142285,,True,37.0,6,11,6,10,0,1,2,2,1,3,4,5,2,1,3,1,14
400995836,Creighton Bluejays,M. Mellman,3142283,,True,9.0,1,5,0,0,1,5,0,0,0,0,0,0,0,0,0,0,3
400995836,Creighton Bluejays,A. Greene,3938937,,False,21.0,5,7,5,7,0,0,0,0,2,4,6,0,2,0,0,2,10
400995836,Creighton Bluejays,K. Brown,3142286,,False,5.0,1,1,1,1,0,0,2,4,1,2,3,0,0,0,0,1,4
400995836,Creighton Bluejays,T. Carda,4281362,,False,34.0,5,12,3,8,2,4,0,0,0,3,3,4,0,0,2,2,12
400995836,Creighton Bluejays,T. Rembao,4281361,,False,2.0,0,0,0,0,0,0,0,0,0,0,0,0,0,0,1,0,0
400995836,Creighton Bluejays,B. Kissinger,3142124,,False,8.0,0,0,0,0,0,0,0,0,0,2,2,2,0,0,0,1,0
400995836,Creighton Bluejays,TEAM,TOTAL,TOTAL,False,,27,60,21,39,6,21,7,10,5,27,32,18,6,1,12,11,67
400995835,Xavier Musketeers,I. Partlow,3142320,,True,17.0,2,6,2,6,0,0,2,4,2,6,8,0,0,0,3,4,6
400995835,Xavier Musketeers,A. Aijanen,3142319,,True,29.0,4,7,2,3,2,4,0,0,3,2,5,2,3,1,3,4,10
400995835,Xavier Musketeers,N. Owens,4068187,,True,25.0,2,4,1,2,1,2,0,0,1,3,4,2,1,0,4,2,5
400995835,Xavier Musketeers,J. Byrd,3142318,,True,33.0,4,4,4,4,0,0,5,6,0,1,1,2,0,0,5,3,13
400995835,Xavier Musketeers,K. Fincher,3142317,,True,31.0,2,9,1,3,1,6,0,0,0,1,1,1,0,0,3,4,5
400995835,Xavier Musketeers,A. Gray,4281368,,False,17.0,2,3,1,1,1,2,1,2,0,5,5,0,1,1,2,3,6
400995835,Xavier Musketeers,D. Ross,4281364,,False,16.0,2,8,1,2,1,6,1,1,0,1,1,1,0,0,1,0,6
400995835,Xavier Musketeers,P. Stewart,4281366,,False,8.0,0,0,0,0,0,0,0,0,0,1,1,0,1,0,1,1,0
400995835,Xavier Musketeers,A. Dunham,4281365,,False,13.0,0,1,0,0,0,1,2,2,0,1,1,2,2,0,1,1,2
400995835,Xavier Musketeers,A. Gomez,4068185,,False,11.0,0,1,0,0,0,1,0,2,0,1,1,2,0,0,0,0,0
400995835,Xavier Musketeers,TEAM,TOTAL,TOTAL,False,,18,43,12,21,6,22,11,17,7,24,31,12,8,2,23,22,53
400995835,Xavier Musketeers,I. Partlow,3142320,,True,17.0,2,6,2,6,0,0,2,4,2,6,8,0,0,0,3,4,6
400995835,Xavier Musketeers,A. Aijanen,3142319,,True,29.0,4,7,2,3,2,4,0,0,3,2,5,2,3,1,3,4,10
400995835,Xavier Musketeers,N. Owens,4068187,,True,25.0,2,4,1,2,1,2,0,0,1,3,4,2,1,0,4,2,5
400995835,Xavier Musketeers,J. Byrd,3142318,,True,33.0,4,4,4,4,0,0,5,6,0,1,1,2,0,0,5,3,13
400995835,Xavier Musketeers,K. Fincher,3142317,,True,31.0,2,9,1,3,1,6,0,0,0,1,1,1,0,0,3,4,5
400995835,Xavier Musketeers,A. Gray,4281368,,False,17.0,2,3,1,1,1,2,1,2,0,5,5,0,1,1,2,3,6
400995835,Xavier Musketeers,D. Ross,4281364,,False,16.0,2,8,1,2,1,6,1,1,0,1,1,1,0,0,1,0,6
400995835,Xavier Musketeers,P. Stewart,4281366,,False,8.0,0,0,0,0,0,0,0,0,0,1,1,0,1,0,1,1,0
400995835,Xavier Musketeers,A. Dunham,4281365,,False,13.0,0,1,0,0,0,1,2,2,0,1,1,2,2,0,1,1,2
400995835,Xavier Musketeers,A. Gomez,4068185,,False,11.0,0,1,0,0,0,1,0,2,0,1,1,2,0,0,0,0,0
400995835,Xavier Musketeers,TEAM,TOTAL,TOTAL,False,,18,43,12,21,6,22,11,17,7,24,31,12,8,2,23,22,53
400995835,Seton Hall Pirates,S. Samuels,4068128,,True,39.0,3,12,3,11,0,1,4,4,5,4,9,5,1,0,2,2,10
400995835,Seton Hall Pirates,K. Evans,4281378,,True,11.0,0,3,0,3,0,0,0,0,1,3,4,1,0,2,2,2,0
400995835,Seton Hall Pirates,I. Butina,4281377,,True,31.0,4,8,3,7,1,1,8,8,0,0,0,1,2,0,2,3,17
400995835,Seton Hall Pirates,D. Winters,4068126,,True,25.0,1,5,0,1,1,4,2,2,0,2,2,2,1,0,0,1,5
400995835,Seton Hall Pirates,J. Jackson,3064877,,True,34.0,4,16,4,12,0,4,2,3,2,6,8,2,1,0,2,3,10
400995835,Seton Hall Pirates,S. Philoxy,4281380,,False,10.0,0,1,0,1,0,0,0,2,2,0,2,0,1,0,0,1,0
400995835,Seton Hall Pirates,J. Jones-Pack,4068129,,False,13.0,2,2,1,1,1,1,0,0,2,2,4,0,1,0,2,2,5
400995835,Seton Hall Pirates,N. Jimenez,4281379,,False,15.0,3,4,2,3,1,1,0,0,1,1,2,1,1,0,4,3,7
400995835,Seton Hall Pirates,K. Hilaire,4068123,,False,16.0,2,3,2,3,0,0,0,0,0,3,3,0,2,0,2,2,4
400995835,Seton Hall Pirates,K. Healy,3943704,,False,6.0,0,1,0,0,0,1,0,0,0,0,0,0,0,0,0,0,0
400995835,Seton Hall Pirates,TEAM,TOTAL,TOTAL,False,,19,55,15,42,4,13,16,19,13,21,34,12,10,2,16,19,58
400995835,Seton Hall Pirates,S. Samuels,4068128,,True,39.0,3,12,3,11,0,1,4,4,5,4,9,5,1,0,2,2,10
400995835,Seton Hall Pirates,K. Evans,4281378,,True,11.0,0,3,0,3,0,0,0,0,1,3,4,1,0,2,2,2,0
400995835,Seton Hall Pirates,I. Butina,4281377,,True,31.0,4,8,3,7,1,1,8,8,0,0,0,1,2,0,2,3,17
400995835,Seton Hall Pirates,D. Winters,4068126,,True,25.0,1,5,0,1,1,4,2,2,0,2,2,2,1,0,0,1,5
400995835,Seton Hall Pirates,J. Jackson,3064877,,True,34.0,4,16,4,12,0,4,2,3,2,6,8,2,1,0,2,3,10
400995835,Seton Hall Pirates,S. Philoxy,4281380,,False,10.0,0,1,0,1,0,0,0,2,2,0,2,0,1,0,0,1,0
400995835,Seton Hall Pirates,J. Jones-Pack,4068129,,False,13.0,2,2,1,1,1,1,0,0,2,2,4,0,1,0,2,2,5
400995835,Seton Hall Pirates,N. Jimenez,4281379,,False,15.0,3,4,2,3,1,1,0,0,1,1,2,1,1,0,4,3,7
400995835,Seton Hall Pirates,K. Hilaire,4068123,,False,16.0,2,3,2,3,0,0,0,0,0,3,3,0,2,0,2,2,4
400995835,Seton Hall Pirates,K. Healy,3943704,,False,6.0,0,1,0,0,0,1,0,0,0,0,0,0,0,0,0,0,0
400995835,Seton Hall Pirates,TEAM,TOTAL,TOTAL,False,,19,55,15,42,4,13,16,19,13,21,34,12,10,2,16,19,58
400995834,St. John's Red Storm,M. Singleton,4068158,,True,28.0,4,6,4,6,0,0,0,0,0,6,6,0,3,1,0,1,8
400995834,St. John's Red Storm,I. Littleton,3142306,,True,22.0,1,2,1,2,0,0,0,0,1,2,3,1,2,2,1,3,2
400995834,St. John's Red Storm,A. Wellere,3906771,,True,31.0,4,5,4,4,0,1,1,2,1,4,5,1,0,1,2,2,9
400995834,St. John's Red Storm,T. England,4068155,,True,28.0,3,7,2,3,1,4,0,0,0,4,4,7,1,2,4,0,7
400995834,St. John's Red Storm,A. Kebbe,4068154,,True,19.0,5,8,3,6,2,2,0,0,3,2,5,2,0,1,1,0,12
400995834,St. John's Red Storm,K. Charles,4281374,,False,14.0,1,2,1,2,0,0,0,0,0,6,6,1,0,1,0,4,2
400995834,St. John's Red Storm,Q. Hoppie,4281375,,False,27.0,6,14,2,6,4,8,0,0,0,1,1,3,0,0,2,1,16
400995834,St. John's Red Storm,A. Adams,4068157,,False,17.0,4,7,2,3,2,4,0,0,1,2,3,1,1,0,2,4,10
400995834,St. John's Red Storm,S. Duncan,4068156,,False,7.0,3,5,1,1,2,4,0,0,0,0,0,0,0,0,1,0,8
400995834,St. John's Red Storm,T. Alexander,3142305,,False,7.0,0,0,0,0,0,0,2,2,0,1,1,2,0,0,1,0,2
400995834,St. John's Red Storm,TEAM,TOTAL,TOTAL,False,,31,56,20,33,11,23,3,4,8,30,38,18,7,8,14,15,76
400995834,St. John's Red Storm,M. Singleton,4068158,,True,28.0,4,6,4,6,0,0,0,0,0,6,6,0,3,1,0,1,8
400995834,St. John's Red Storm,I. Littleton,3142306,,True,22.0,1,2,1,2,0,0,0,0,1,2,3,1,2,2,1,3,2
400995834,St. John's Red Storm,A. Wellere,3906771,,True,31.0,4,5,4,4,0,1,1,2,1,4,5,1,0,1,2,2,9
400995834,St. John's Red Storm,T. England,4068155,,True,28.0,3,7,2,3,1,4,0,0,0,4,4,7,1,2,4,0,7
400995834,St. John's Red Storm,A. Kebbe,4068154,,True,19.0,5,8,3,6,2,2,0,0,3,2,5,2,0,1,1,0,12
400995834,St. John's Red Storm,K. Charles,4281374,,False,14.0,1,2,1,2,0,0,0,0,0,6,6,1,0,1,0,4,2
400995834,St. John's Red Storm,Q. Hoppie,4281375,,False,27.0,6,14,2,6,4,8,0,0,0,1,1,3,0,0,2,1,16
400995834,St. John's Red Storm,A. Adams,4068157,,False,17.0,4,7,2,3,2,4,0,0,1,2,3,1,1,0,2,4,10
400995834,St. John's Red Storm,S. Duncan,4068156,,False,7.0,3,5,1,1,2,4,0,0,0,0,0,0,0,0,1,0,8
400995834,St. John's Red Storm,T. Alexander,3142305,,False,7.0,0,0,0,0,0,0,2,2,0,1,1,2,0,0,1,0,2
400995834,St. John's Red Storm,TEAM,TOTAL,TOTAL,False,,31,56,20,33,11,23,3,4,8,30,38,18,7,8,14,15,76
400995834,Butler Bulldogs,S. Brey,4068067,,True,27.0,0,3,0,3,0,0,4,4,0,3,3,1,2,1,3,0,4
400995834,Butler Bulldogs,T. Schickel,3914012,,True,37.0,5,9,5,9,0,0,0,2,1,3,4,1,0,1,3,3,10
400995834,Butler Bulldogs,K. Spolyar,4068068,,True,35.0,2,12,1,7,1,5,7,8,0,1,1,0,1,0,2,2,12
400995834,Butler Bulldogs,M. Weaver,3914014,,True,32.0,2,7,1,4,1,3,0,0,1,2,3,1,4,0,2,2,5
400995834,Butler Bulldogs,W. Jennings,3142145,,True,36.0,3,13,3,9,0,4,1,4,0,4,4,1,1,0,1,1,7
400995834,Butler Bulldogs,S. Buck,3142279,,False,17.0,0,2,0,0,0,2,0,0,0,2,2,0,0,0,2,0,0
400995834,Butler Bulldogs,I. Lathan,3079485,,False,16.0,0,4,0,4,0,0,0,0,0,1,1,0,1,0,2,1,0
400995834,Butler Bulldogs,TEAM,TOTAL,TOTAL,False,,12,50,10,36,2,14,12,18,9,18,27,4,9,2,15,9,38
400995834,Butler Bulldogs,S. Brey,4068067,,True,27.0,0,3,0,3,0,0,4,4,0,3,3,1,2,1,3,0,4
400995834,Butler Bulldogs,T. Schickel,3914012,,True,37.0,5,9,5,9,0,0,0,2,1,3,4,1,0,1,3,3,10
400995834,Butler Bulldogs,K. Spolyar,4068068,,True,35.0,2,12,1,7,1,5,7,8,0,1,1,0,1,0,2,2,12
400995834,Butler Bulldogs,M. Weaver,3914014,,True,32.0,2,7,1,4,1,3,0,0,1,2,3,1,4,0,2,2,5
400995834,Butler Bulldogs,W. Jennings,3142145,,True,36.0,3,13,3,9,0,4,1,4,0,4,4,1,1,0,1,1,7
400995834,Butler Bulldogs,S. Buck,3142279,,False,17.0,0,2,0,0,0,2,0,0,0,2,2,0,0,0,2,0,0
400995834,Butler Bulldogs,I. Lathan,3079485,,False,16.0,0,4,0,4,0,0,0,0,0,1,1,0,1,0,2,1,0
400995834,Butler Bulldogs,TEAM,TOTAL,TOTAL,False,,12,50,10,36,2,14,12,18,9,18,27,4,9,2,15,9,38
400995833,Marquette Golden Eagles,E. Davenport,3906756,,True,28.0,3,9,3,9,0,0,3,4,5,1,6,0,2,0,3,3,9
400995833,Marquette Golden Eagles,A. Wilborn,3906758,,True,34.0,5,13,4,11,1,2,0,4,1,6,7,2,1,1,2,3,11
400995833,Marquette Golden Eagles,A. Blockton,3906755,,True,28.0,4,14,3,10,1,4,2,2,2,6,8,2,1,0,0,3,11
400995833,Marquette Golden Eagles,N. Hiedeman,3906753,,True,34.0,8,17,4,6,4,11,1,2,0,1,1,6,4,0,2,4,21
400995833,Marquette Golden Eagles,D. King,3906752,,True,38.0,9,14,8,13,1,1,4,4,1,2,3,5,3,0,4,2,23
400995833,Marquette Golden Eagles,L. Van Kleunen,4068083,,False,9.0,1,1,1,1,0,0,0,2,0,1,1,0,1,0,1,1,2
400995833,Marquette Golden Eagles,S. Lott,4281350,,False,22.0,0,2,0,0,0,2,0,0,1,1,2,0,1,0,1,3,0
400995833,Marquette Golden Eagles,I. Spingola,4068082,,False,7.0,2,3,0,0,2,3,0,0,0,0,0,0,0,0,1,0,6
400995833,Marquette Golden Eagles,TEAM,TOTAL,TOTAL,False,,32,73,23,50,9,23,10,18,14,22,36,15,13,1,15,19,83
400995833,Marquette Golden Eagles,E. Davenport,3906756,,True,28.0,3,9,3,9,0,0,3,4,5,1,6,0,2,0,3,3,9
400995833,Marquette Golden Eagles,A. Wilborn,3906758,,True,34.0,5,13,4,11,1,2,0,4,1,6,7,2,1,1,2,3,11
400995833,Marquette Golden Eagles,A. Blockton,3906755,,True,28.0,4,14,3,10,1,4,2,2,2,6,8,2,1,0,0,3,11
400995833,Marquette Golden Eagles,N. Hiedeman,3906753,,True,34.0,8,17,4,6,4,11,1,2,0,1,1,6,4,0,2,4,21
400995833,Marquette Golden Eagles,D. King,3906752,,True,38.0,9,14,8,13,1,1,4,4,1,2,3,5,3,0,4,2,23
400995833,Marquette Golden Eagles,L. Van Kleunen,4068083,,False,9.0,1,1,1,1,0,0,0,2,0,1,1,0,1,0,1,1,2
400995833,Marquette Golden Eagles,S. Lott,4281350,,False,22.0,0,2,0,0,0,2,0,0,1,1,2,0,1,0,1,3,0
400995833,Marquette Golden Eagles,I. Spingola,4068082,,False,7.0,2,3,0,0,2,3,0,0,0,0,0,0,0,0,1,0,6
400995833,Marquette Golden Eagles,TEAM,TOTAL,TOTAL,False,,32,73,23,50,9,23,10,18,14,22,36,15,13,1,15,19,83
400995833,DePaul Blue Demons,C. Stonewall,4068072,,True,26.0,5,8,5,5,0,3,4,5,4,4,8,0,2,0,1,1,14
400995833,DePaul Blue Demons,M. Grays,3142287,,True,31.0,5,11,3,6,2,5,0,0,4,2,6,2,2,1,3,2,12
400995833,DePaul Blue Demons,K. Campbell,4068071,,True,37.0,6,11,3,3,3,8,5,6,0,9,9,6,1,0,2,3,20
400995833,DePaul Blue Demons,A. Millender,3142289,,True,35.0,6,12,4,5,2,7,2,2,0,2,2,2,0,0,2,4,16
400995833,DePaul Blue Demons,A. Coleman,3142123,,True,28.0,5,13,4,7,1,6,4,4,2,5,7,5,1,2,5,3,15
400995833,DePaul Blue Demons,R. McLimore,4281358,,False,2.0,0,1,0,1,0,0,0,0,1,0,1,2,0,0,0,0,0
400995833,DePaul Blue Demons,D. Bekelja,4281356,,False,1.0,0,0,0,0,0,0,0,0,0,0,0,0,0,0,1,0,0
400995833,DePaul Blue Demons,T. Allen,3933760,,False,18.0,4,6,2,4,2,2,0,0,1,3,4,1,0,0,2,1,10
400995833,DePaul Blue Demons,L. Prochaska,3142290,,False,22.0,2,4,1,1,1,3,3,4,1,5,6,4,0,1,3,2,8
400995833,DePaul Blue Demons,TEAM,TOTAL,TOTAL,False,,33,66,22,32,11,34,18,21,13,31,44,22,6,4,19,16,95
400995833,DePaul Blue Demons,C. Stonewall,4068072,,True,26.0,5,8,5,5,0,3,4,5,4,4,8,0,2,0,1,1,14
400995833,DePaul Blue Demons,M. Grays,3142287,,True,31.0,5,11,3,6,2,5,0,0,4,2,6,2,2,1,3,2,12
400995833,DePaul Blue Demons,K. Campbell,4068071,,True,37.0,6,11,3,3,3,8,5,6,0,9,9,6,1,0,2,3,20
400995833,DePaul Blue Demons,A. Millender,3142289,,True,35.0,6,12,4,5,2,7,2,2,0,2,2,2,0,0,2,4,16
400995833,DePaul Blue Demons,A. Coleman,3142123,,True,28.0,5,13,4,7,1,6,4,4,2,5,7,5,1,2,5,3,15
400995833,DePaul Blue Demons,R. McLimore,4281358,,False,2.0,0,1,0,1,0,0,0,0,1,0,1,2,0,0,0,0,0
400995833,DePaul Blue Demons,D. Bekelja,4281356,,False,1.0,0,0,0,0,0,0,0,0,0,0,0,0,0,0,1,0,0
400995833,DePaul Blue Demons,T. Allen,3933760,,False,18.0,4,6,2,4,2,2,0,0,1,3,4,1,0,0,2,1,10
400995833,DePaul Blue Demons,L. Prochaska,3142290,,False,22.0,2,4,1,1,1,3,3,4,1,5,6,4,0,1,3,2,8
400995833,DePaul Blue Demons,TEAM,TOTAL,TOTAL,False,,33,66,22,32,11,34,18,21,13,31,44,22,6,4,19,16,95
400995832,Xavier Musketeers,I. Partlow,3142320,,True,27.0,5,8,5,7,0,1,2,6,4,5,9,0,0,0,6,1,12
400995832,Xavier Musketeers,A. Aijanen,3142319,,True,26.0,0,3,0,1,0,2,0,0,1,2,3,1,0,0,3,2,0
400995832,Xavier Musketeers,N. Owens,4068187,,True,25.0,3,6,1,2,2,4,2,3,1,5,6,0,1,0,2,3,10
400995832,Xavier Musketeers,J. Byrd,3142318,,True,28.0,5,7,5,7,0,0,5,7,1,2,3,4,0,0,2,1,15
400995832,Xavier Musketeers,K. Fincher,3142317,,True,22.0,1,10,0,2,1,8,0,0,1,3,4,0,0,1,1,0,3
400995832,Xavier Musketeers,A. Gray,4281368,,False,14.0,1,4,1,2,0,2,2,2,1,5,6,1,1,0,0,3,4
400995832,Xavier Musketeers,D. Ross,4281364,,False,10.0,0,3,0,0,0,3,0,0,0,0,0,0,1,0,1,0,0
400995832,Xavier Musketeers,M. Christopher,4068186,,False,4.0,0,0,0,0,0,0,0,0,0,0,0,0,0,0,0,0,0
400995832,Xavier Musketeers,A. Reiff,4281367,,False,1.0,0,2,0,1,0,1,0,0,0,1,1,0,0,0,0,0,0
400995832,Xavier Musketeers,P. Stewart,4281366,,False,17.0,0,1,0,1,0,0,2,2,0,0,0,0,1,0,0,1,2
400995832,Xavier Musketeers,A. Dunham,4281365,,False,14.0,0,2,0,0,0,2,2,2,0,1,1,0,1,0,0,2,2
400995832,Xavier Musketeers,A. Gomez,4068185,,False,12.0,0,1,0,0,0,1,0,0,0,2,2,1,0,0,1,0,0
400995832,Xavier Musketeers,TEAM,TOTAL,TOTAL,False,,15,47,12,23,3,24,15,22,10,26,36,7,5,1,16,13,48
400995832,Xavier Musketeers,I. Partlow,3142320,,True,27.0,5,8,5,7,0,1,2,6,4,5,9,0,0,0,6,1,12
400995832,Xavier Musketeers,A. Aijanen,3142319,,True,26.0,0,3,0,1,0,2,0,0,1,2,3,1,0,0,3,2,0
400995832,Xavier Musketeers,N. Owens,4068187,,True,25.0,3,6,1,2,2,4,2,3,1,5,6,0,1,0,2,3,10
400995832,Xavier Musketeers,J. Byrd,3142318,,True,28.0,5,7,5,7,0,0,5,7,1,2,3,4,0,0,2,1,15
400995832,Xavier Musketeers,K. Fincher,3142317,,True,22.0,1,10,0,2,1,8,0,0,1,3,4,0,0,1,1,0,3
400995832,Xavier Musketeers,A. Gray,4281368,,False,14.0,1,4,1,2,0,2,2,2,1,5,6,1,1,0,0,3,4
400995832,Xavier Musketeers,D. Ross,4281364,,False,10.0,0,3,0,0,0,3,0,0,0,0,0,0,1,0,1,0,0
400995832,Xavier Musketeers,M. Christopher,4068186,,False,4.0,0,0,0,0,0,0,0,0,0,0,0,0,0,0,0,0,0
400995832,Xavier Musketeers,A. Reiff,4281367,,False,1.0,0,2,0,1,0,1,0,0,0,1,1,0,0,0,0,0,0
400995832,Xavier Musketeers,P. Stewart,4281366,,False,17.0,0,1,0,1,0,0,2,2,0,0,0,0,1,0,0,1,2
400995832,Xavier Musketeers,A. Dunham,4281365,,False,14.0,0,2,0,0,0,2,2,2,0,1,1,0,1,0,0,2,2
400995832,Xavier Musketeers,A. Gomez,4068185,,False,12.0,0,1,0,0,0,1,0,0,0,2,2,1,0,0,1,0,0
400995832,Xavier Musketeers,TEAM,TOTAL,TOTAL,False,,15,47,12,23,3,24,15,22,10,26,36,7,5,1,16,13,48
400995832,Georgetown Hoyas,C. Petke,4068078,,True,39.0,8,16,7,14,1,2,3,6,6,5,11,0,2,1,4,2,20
400995832,Georgetown Hoyas,Y. Belk,3142295,,True,23.0,3,6,3,6,0,0,0,0,2,4,6,2,1,1,0,1,6
400995832,Georgetown Hoyas,D. White,3948815,,True,35.0,5,13,3,7,2,6,2,3,1,6,7,4,3,0,1,4,14
400995832,Georgetown Hoyas,D. Burton,3142292,,True,22.0,4,8,4,7,0,1,1,1,1,3,4,4,0,0,2,2,9
400995832,Georgetown Hoyas,M. Venson,3142105,,True,37.0,5,8,5,7,0,1,2,3,0,0,0,5,0,0,1,3,12
400995832,Georgetown Hoyas,S. Cureton,4281355,,False,1.0,0,0,0,0,0,0,0,0,0,0,0,0,0,0,0,0,0
400995832,Georgetown Hoyas,T. Thompson,4281352,,False,16.0,1,4,1,3,0,1,0,0,1,6,7,0,0,0,1,2,2
400995832,Georgetown Hoyas,M. Smith,4068079,,False,17.0,0,2,0,2,0,0,0,0,0,0,0,0,0,1,1,3,0
400995832,Georgetown Hoyas,B. Mayfield,4281354,,False,4.0,0,1,0,1,0,0,0,0,0,0,0,0,0,0,0,1,0
400995832,Georgetown Hoyas,L. Kimball,4281353,,False,2.0,0,0,0,0,0,0,0,0,0,0,0,1,0,0,0,0,0
400995832,Georgetown Hoyas,M. Osagie-Erese,4072597,,False,4.0,1,2,1,1,0,1,0,0,0,0,0,0,0,0,0,1,2
400995832,Georgetown Hoyas,TEAM,TOTAL,TOTAL,False,,27,60,24,48,3,12,8,13,11,26,37,16,6,3,10,19,65
400995832,Georgetown Hoyas,C. Petke,4068078,,True,39.0,8,16,7,14,1,2,3,6,6,5,11,0,2,1,4,2,20
400995832,Georgetown Hoyas,Y. Belk,3142295,,True,23.0,3,6,3,6,0,0,0,0,2,4,6,2,1,1,0,1,6
400995832,Georgetown Hoyas,D. White,3948815,,True,35.0,5,13,3,7,2,6,2,3,1,6,7,4,3,0,1,4,14
400995832,Georgetown Hoyas,D. Burton,3142292,,True,22.0,4,8,4,7,0,1,1,1,1,3,4,4,0,0,2,2,9
400995832,Georgetown Hoyas,M. Venson,3142105,,True,37.0,5,8,5,7,0,1,2,3,0,0,0,5,0,0,1,3,12
400995832,Georgetown Hoyas,S. Cureton,4281355,,False,1.0,0,0,0,0,0,0,0,0,0,0,0,0,0,0,0,0,0
400995832,Georgetown Hoyas,T. Thompson,4281352,,False,16.0,1,4,1,3,0,1,0,0,1,6,7,0,0,0,1,2,2
400995832,Georgetown Hoyas,M. Smith,4068079,,False,17.0,0,2,0,2,0,0,0,0,0,0,0,0,0,1,1,3,0
400995832,Georgetown Hoyas,B. Mayfield,4281354,,False,4.0,0,1,0,1,0,0,0,0,0,0,0,0,0,0,0,1,0
400995832,Georgetown Hoyas,L. Kimball,4281353,,False,2.0,0,0,0,0,0,0,0,0,0,0,0,1,0,0,0,0,0
400995832,Georgetown Hoyas,M. Osagie-Erese,4072597,,False,4.0,1,2,1,1,0,1,0,0,0,0,0,0,0,0,0,1,2
400995832,Georgetown Hoyas,TEAM,TOTAL,TOTAL,False,,27,60,24,48,3,12,8,13,11,26,37,16,6,3,10,19,65
400995831,Seton Hall Pirates,S. Samuels,4068128,,True,37.0,7,15,7,14,0,1,0,2,2,6,8,2,2,1,1,4,14
400995831,Seton Hall Pirates,K. Evans,4281378,,True,11.0,0,1,0,1,0,0,0,0,0,1,1,0,0,0,2,3,0
400995831,Seton Hall Pirates,D. Winters,4068126,,True,37.0,2,8,1,4,1,4,0,0,3,5,8,0,2,1,1,4,5
400995831,Seton Hall Pirates,I. Butina,4281377,,True,43.0,8,16,8,15,0,1,0,0,3,4,7,10,2,0,4,3,16
400995831,Seton Hall Pirates,J. Jackson,3064877,,True,39.0,6,16,1,7,5,9,4,4,2,2,4,3,2,0,1,3,21
400995831,Seton Hall Pirates,S. Philoxy,4281380,,False,28.0,1,6,1,6,0,0,1,6,2,6,8,0,0,0,0,1,3
400995831,Seton Hall Pirates,J. Jones-Pack,4068129,,False,5.0,0,0,0,0,0,0,0,0,0,1,1,0,0,0,0,0,0
400995831,Seton Hall Pirates,N. Jimenez,4281379,,False,21.0,2,6,1,4,1,2,0,0,0,1,1,1,1,0,2,2,5
400995831,Seton Hall Pirates,K. Hilaire,4068123,,False,2.0,0,0,0,0,0,0,0,0,0,0,0,0,0,0,1,0,0
400995831,Seton Hall Pirates,K. Healy,3943704,,False,2.0,0,0,0,0,0,0,0,0,0,0,0,0,0,0,0,0,0
400995831,Seton Hall Pirates,TEAM,TOTAL,TOTAL,False,,26,68,19,51,7,17,5,12,12,26,38,16,9,2,12,20,64
400995831,Seton Hall Pirates,S. Samuels,4068128,,True,37.0,7,15,7,14,0,1,0,2,2,6,8,2,2,1,1,4,14
400995831,Seton Hall Pirates,K. Evans,4281378,,True,11.0,0,1,0,1,0,0,0,0,0,1,1,0,0,0,2,3,0
400995831,Seton Hall Pirates,D. Winters,4068126,,True,37.0,2,8,1,4,1,4,0,0,3,5,8,0,2,1,1,4,5
400995831,Seton Hall Pirates,I. Butina,4281377,,True,43.0,8,16,8,15,0,1,0,0,3,4,7,10,2,0,4,3,16
400995831,Seton Hall Pirates,J. Jackson,3064877,,True,39.0,6,16,1,7,5,9,4,4,2,2,4,3,2,0,1,3,21
400995831,Seton Hall Pirates,S. Philoxy,4281380,,False,28.0,1,6,1,6,0,0,1,6,2,6,8,0,0,0,0,1,3
400995831,Seton Hall Pirates,J. Jones-Pack,4068129,,False,5.0,0,0,0,0,0,0,0,0,0,1,1,0,0,0,0,0,0
400995831,Seton Hall Pirates,N. Jimenez,4281379,,False,21.0,2,6,1,4,1,2,0,0,0,1,1,1,1,0,2,2,5
400995831,Seton Hall Pirates,K. Hilaire,4068123,,False,2.0,0,0,0,0,0,0,0,0,0,0,0,0,0,0,1,0,0
400995831,Seton Hall Pirates,K. Healy,3943704,,False,2.0,0,0,0,0,0,0,0,0,0,0,0,0,0,0,0,0,0
400995831,Seton Hall Pirates,TEAM,TOTAL,TOTAL,False,,26,68,19,51,7,17,5,12,12,26,38,16,9,2,12,20,64
400995831,Creighton Bluejays,A. Faber,3938938,,True,31.0,2,8,0,1,2,7,0,0,1,1,2,2,0,1,3,5,6
400995831,Creighton Bluejays,J. Agnew,3938935,,True,40.0,5,11,1,3,4,8,0,0,1,11,12,5,1,1,3,2,14
400995831,Creighton Bluejays,B. Norby,3142284,,True,10.0,3,6,3,6,0,0,0,1,3,2,5,1,1,0,0,1,6
400995831,Creighton Bluejays,S. Lamberty,3142285,,True,44.0,7,12,5,7,2,5,5,5,2,6,8,6,0,0,4,0,21
400995831,Creighton Bluejays,M. Mellman,3142283,,True,17.0,0,4,0,0,0,4,0,0,0,0,0,2,0,0,0,0,0
400995831,Creighton Bluejays,A. Greene,3938937,,False,20.0,3,4,3,4,0,0,1,2,3,2,5,1,1,0,0,3,7
400995831,Creighton Bluejays,K. Brown,3142286,,False,4.0,0,0,0,0,0,0,0,0,0,1,1,0,0,0,0,0,0
400995831,Creighton Bluejays,T. Carda,4281362,,False,20.0,1,4,0,2,1,2,4,4,0,4,4,2,0,0,2,1,7
400995831,Creighton Bluejays,T. Rembao,4281361,,False,1.0,0,0,0,0,0,0,0,0,0,1,1,0,0,0,1,0,0
400995831,Creighton Bluejays,O. Elger,3938936,,False,34.0,5,13,2,7,3,6,4,6,3,5,8,4,1,0,3,3,17
400995831,Creighton Bluejays,B. Kissinger,3142124,,False,4.0,1,2,0,1,1,1,0,0,0,0,0,0,0,0,0,0,3
400995831,Creighton Bluejays,TEAM,TOTAL,TOTAL,False,,27,64,14,31,13,33,14,18,14,34,48,23,4,2,16,15,81
400995831,Creighton Bluejays,A. Faber,3938938,,True,31.0,2,8,0,1,2,7,0,0,1,1,2,2,0,1,3,5,6
400995831,Creighton Bluejays,J. Agnew,3938935,,True,40.0,5,11,1,3,4,8,0,0,1,11,12,5,1,1,3,2,14
400995831,Creighton Bluejays,B. Norby,3142284,,True,10.0,3,6,3,6,0,0,0,1,3,2,5,1,1,0,0,1,6
400995831,Creighton Bluejays,S. Lamberty,3142285,,True,44.0,7,12,5,7,2,5,5,5,2,6,8,6,0,0,4,0,21
400995831,Creighton Bluejays,M. Mellman,3142283,,True,17.0,0,4,0,0,0,4,0,0,0,0,0,2,0,0,0,0,0
400995831,Creighton Bluejays,A. Greene,3938937,,False,20.0,3,4,3,4,0,0,1,2,3,2,5,1,1,0,0,3,7
400995831,Creighton Bluejays,K. Brown,3142286,,False,4.0,0,0,0,0,0,0,0,0,0,1,1,0,0,0,0,0,0
400995831,Creighton Bluejays,T. Carda,4281362,,False,20.0,1,4,0,2,1,2,4,4,0,4,4,2,0,0,2,1,7
400995831,Creighton Bluejays,T. Rembao,4281361,,False,1.0,0,0,0,0,0,0,0,0,0,1,1,0,0,0,1,0,0
400995831,Creighton Bluejays,O. Elger,3938936,,False,34.0,5,13,2,7,3,6,4,6,3,5,8,4,1,0,3,3,17
400995831,Creighton Bluejays,B. Kissinger,3142124,,False,4.0,1,2,0,1,1,1,0,0,0,0,0,0,0,0,0,0,3
400995831,Creighton Bluejays,TEAM,TOTAL,TOTAL,False,,27,64,14,31,13,33,14,18,14,34,48,23,4,2,16,15,81
400995830,Villanova Wildcats,M. Quinn,3056785,,True,17.0,1,5,0,0,1,5,0,0,0,2,2,1,1,0,0,1,3
400995830,Villanova Wildcats,K. Jekot,4068171,,True,30.0,5,11,1,3,4,8,2,2,1,4,5,1,0,1,2,1,16
400995830,Villanova Wildcats,A. Hahn,3906779,,True,37.0,3,8,1,1,2,7,6,6,1,2,3,4,3,0,3,2,14
400995830,Villanova Wildcats,A. Louin,3142314,,True,34.0,3,7,3,5,0,2,2,4,2,8,10,2,0,0,4,4,8
400995830,Villanova Wildcats,J. Tucker,3087536,,True,37.0,3,11,0,3,3,8,0,1,2,3,5,0,1,0,3,2,9
400995830,Villanova Wildcats,M. Gedaka,4068172,,False,23.0,3,4,2,3,1,1,3,3,2,3,5,2,0,1,1,3,10
400995830,Villanova Wildcats,B. Herlihy,3906778,,False,9.0,2,2,0,0,2,2,0,0,0,1,1,2,0,0,1,1,6
400995830,Villanova Wildcats,G. Stant,3906780,,False,2.0,0,0,0,0,0,0,0,0,0,0,0,1,0,0,0,0,0
400995830,Villanova Wildcats,C. Onken,4068167,,False,11.0,1,3,0,0,1,3,0,0,1,1,2,0,0,0,1,0,3
400995830,Villanova Wildcats,TEAM,TOTAL,TOTAL,False,,21,51,7,15,14,36,13,16,9,24,33,13,5,2,16,14,69
400995830,Villanova Wildcats,M. Quinn,3056785,,True,17.0,1,5,0,0,1,5,0,0,0,2,2,1,1,0,0,1,3
400995830,Villanova Wildcats,K. Jekot,4068171,,True,30.0,5,11,1,3,4,8,2,2,1,4,5,1,0,1,2,1,16
400995830,Villanova Wildcats,A. Hahn,3906779,,True,37.0,3,8,1,1,2,7,6,6,1,2,3,4,3,0,3,2,14
400995830,Villanova Wildcats,A. Louin,3142314,,True,34.0,3,7,3,5,0,2,2,4,2,8,10,2,0,0,4,4,8
400995830,Villanova Wildcats,J. Tucker,3087536,,True,37.0,3,11,0,3,3,8,0,1,2,3,5,0,1,0,3,2,9
400995830,Villanova Wildcats,M. Gedaka,4068172,,False,23.0,3,4,2,3,1,1,3,3,2,3,5,2,0,1,1,3,10
400995830,Villanova Wildcats,B. Herlihy,3906778,,False,9.0,2,2,0,0,2,2,0,0,0,1,1,2,0,0,1,1,6
400995830,Villanova Wildcats,G. Stant,3906780,,False,2.0,0,0,0,0,0,0,0,0,0,0,0,1,0,0,0,0,0
400995830,Villanova Wildcats,C. Onken,4068167,,False,11.0,1,3,0,0,1,3,0,0,1,1,2,0,0,0,1,0,3
400995830,Villanova Wildcats,TEAM,TOTAL,TOTAL,False,,21,51,7,15,14,36,13,16,9,24,33,13,5,2,16,14,69
400995830,Butler Bulldogs,S. Brey,4068067,,True,16.0,0,1,0,0,0,1,0,0,0,1,1,0,2,0,2,4,0
400995830,Butler Bulldogs,T. Schickel,3914012,,True,39.0,6,7,6,7,0,0,7,7,1,5,6,1,1,0,1,1,19
400995830,Butler Bulldogs,M. Weaver,3914014,,True,31.0,2,7,1,3,1,4,0,0,0,1,1,3,1,0,1,5,5
400995830,Butler Bulldogs,W. Jennings,3142145,,True,40.0,10,14,3,5,7,9,2,2,0,4,4,3,3,0,2,2,29
400995830,Butler Bulldogs,I. Lathan,3079485,,True,24.0,2,10,2,10,0,0,1,2,0,2,2,2,0,0,1,3,5
400995830,Butler Bulldogs,K. Spolyar,4068068,,False,34.0,4,15,3,11,1,4,0,0,1,6,7,2,3,0,1,4,9
400995830,Butler Bulldogs,S. Buck,3142279,,False,16.0,0,0,0,0,0,0,0,0,0,2,2,1,1,0,1,1,0
400995830,Butler Bulldogs,TEAM,TOTAL,TOTAL,False,,24,54,15,36,9,18,10,11,4,22,26,12,11,0,9,20,67
400995830,Butler Bulldogs,S. Brey,4068067,,True,16.0,0,1,0,0,0,1,0,0,0,1,1,0,2,0,2,4,0
400995830,Butler Bulldogs,T. Schickel,3914012,,True,39.0,6,7,6,7,0,0,7,7,1,5,6,1,1,0,1,1,19
400995830,Butler Bulldogs,M. Weaver,3914014,,True,31.0,2,7,1,3,1,4,0,0,0,1,1,3,1,0,1,5,5
400995830,Butler Bulldogs,W. Jennings,3142145,,True,40.0,10,14,3,5,7,9,2,2,0,4,4,3,3,0,2,2,29
400995830,Butler Bulldogs,I. Lathan,3079485,,True,24.0,2,10,2,10,0,0,1,2,0,2,2,2,0,0,1,3,5
400995830,Butler Bulldogs,K. Spolyar,4068068,,False,34.0,4,15,3,11,1,4,0,0,1,6,7,2,3,0,1,4,9
400995830,Butler Bulldogs,S. Buck,3142279,,False,16.0,0,0,0,0,0,0,0,0,0,2,2,1,1,0,1,1,0
400995830,Butler Bulldogs,TEAM,TOTAL,TOTAL,False,,24,54,15,36,9,18,10,11,4,22,26,12,11,0,9,20,67
400995829,St. John's Red Storm,M. Singleton,4068158,,True,18.0,1,7,1,7,0,0,0,1,2,3,5,0,0,1,0,4,2
400995829,St. John's Red Storm,I. Littleton,3142306,,True,17.0,0,0,0,0,0,0,0,0,0,4,4,0,0,1,4,1,0
400995829,St. John's Red Storm,A. Wellere,3906771,,True,30.0,5,14,3,9,2,5,2,3,0,2,2,1,1,0,2,2,14
400995829,St. John's Red Storm,T. England,4068155,,True,32.0,4,7,4,7,0,0,2,3,1,3,4,5,3,0,0,1,10
400995829,St. John's Red Storm,A. Kebbe,4068154,,True,28.0,1,8,1,4,0,4,2,2,2,0,2,0,0,0,3,3,4
400995829,St. John's Red Storm,K. Charles,4281374,,False,12.0,0,0,0,0,0,0,2,2,1,6,7,1,0,1,1,1,2
400995829,St. John's Red Storm,Q. Hoppie,4281375,,False,34.0,6,13,5,9,1,4,6,8,1,3,4,2,2,1,3,3,19
400995829,St. John's Red Storm,A. Adams,4068157,,False,14.0,3,4,3,3,0,1,0,0,1,0,1,0,0,0,2,2,6
400995829,St. John's Red Storm,S. Duncan,4068156,,False,12.0,4,6,1,1,3,5,0,0,1,1,2,0,1,0,0,1,11
400995829,St. John's Red Storm,T. Alexander,3142305,,False,3.0,0,0,0,0,0,0,0,0,0,0,0,0,0,0,0,0,0
400995829,St. John's Red Storm,TEAM,TOTAL,TOTAL,False,,24,59,18,40,6,19,14,19,10,24,34,9,7,4,15,18,68
400995829,St. John's Red Storm,M. Singleton,4068158,,True,18.0,1,7,1,7,0,0,0,1,2,3,5,0,0,1,0,4,2
400995829,St. John's Red Storm,I. Littleton,3142306,,True,17.0,0,0,0,0,0,0,0,0,0,4,4,0,0,1,4,1,0
400995829,St. John's Red Storm,A. Wellere,3906771,,True,30.0,5,14,3,9,2,5,2,3,0,2,2,1,1,0,2,2,14
400995829,St. John's Red Storm,T. England,4068155,,True,32.0,4,7,4,7,0,0,2,3,1,3,4,5,3,0,0,1,10
400995829,St. John's Red Storm,A. Kebbe,4068154,,True,28.0,1,8,1,4,0,4,2,2,2,0,2,0,0,0,3,3,4
400995829,St. John's Red Storm,K. Charles,4281374,,False,12.0,0,0,0,0,0,0,2,2,1,6,7,1,0,1,1,1,2
400995829,St. John's Red Storm,Q. Hoppie,4281375,,False,34.0,6,13,5,9,1,4,6,8,1,3,4,2,2,1,3,3,19
400995829,St. John's Red Storm,A. Adams,4068157,,False,14.0,3,4,3,3,0,1,0,0,1,0,1,0,0,0,2,2,6
400995829,St. John's Red Storm,S. Duncan,4068156,,False,12.0,4,6,1,1,3,5,0,0,1,1,2,0,1,0,0,1,11
400995829,St. John's Red Storm,T. Alexander,3142305,,False,3.0,0,0,0,0,0,0,0,0,0,0,0,0,0,0,0,0,0
400995829,St. John's Red Storm,TEAM,TOTAL,TOTAL,False,,24,59,18,40,6,19,14,19,10,24,34,9,7,4,15,18,68
400995829,Providence Friars,N. Franklin,4281348,,True,25.0,1,6,1,6,0,0,1,2,2,1,3,0,0,0,2,2,3
400995829,Providence Friars,C. Williams,4281345,,True,24.0,6,10,6,9,0,1,1,4,0,4,4,3,0,0,5,4,13
400995829,Providence Friars,J. Nogic,3906769,,True,35.0,9,17,4,10,5,7,4,5,1,1,2,0,2,0,2,2,27
400995829,Providence Friars,M. Jolin,3906767,,True,31.0,3,5,0,1,3,4,2,2,0,4,4,0,1,0,2,1,11
400995829,Providence Friars,C. Che,3906766,,True,32.0,2,6,2,4,0,2,0,0,0,8,8,2,0,0,0,1,4
400995829,Providence Friars,A. Cooper,4281349,,False,15.0,2,5,2,5,0,0,2,4,1,1,2,0,0,0,0,2,6
400995829,Providence Friars,O. Orlando,4281347,,False,3.0,0,0,0,0,0,0,0,0,0,1,1,0,0,0,2,1,0
400995829,Providence Friars,K. Spiwak,4281346,,False,14.0,1,1,1,1,0,0,0,0,1,2,3,2,0,0,0,3,2
400995829,Providence Friars,N. Jackson,4068111,,False,17.0,2,2,2,2,0,0,0,0,0,4,4,1,0,0,2,1,4
400995829,Providence Friars,A. Botteghi,3142301,,False,4.0,0,0,0,0,0,0,0,0,0,0,0,0,0,0,0,0,0
400995829,Providence Friars,TEAM,TOTAL,TOTAL,False,,26,52,18,38,8,14,10,17,5,27,32,8,3,0,16,17,70
400995829,Providence Friars,N. Franklin,4281348,,True,25.0,1,6,1,6,0,0,1,2,2,1,3,0,0,0,2,2,3
400995829,Providence Friars,C. Williams,4281345,,True,24.0,6,10,6,9,0,1,1,4,0,4,4,3,0,0,5,4,13
400995829,Providence Friars,J. Nogic,3906769,,True,35.0,9,17,4,10,5,7,4,5,1,1,2,0,2,0,2,2,27
400995829,Providence Friars,M. Jolin,3906767,,True,31.0,3,5,0,1,3,4,2,2,0,4,4,0,1,0,2,1,11
400995829,Providence Friars,C. Che,3906766,,True,32.0,2,6,2,4,0,2,0,0,0,8,8,2,0,0,0,1,4
400995829,Providence Friars,A. Cooper,4281349,,False,15.0,2,5,2,5,0,0,2,4,1,1,2,0,0,0,0,2,6
400995829,Providence Friars,O. Orlando,4281347,,False,3.0,0,0,0,0,0,0,0,0,0,1,1,0,0,0,2,1,0
400995829,Providence Friars,K. Spiwak,4281346,,False,14.0,1,1,1,1,0,0,0,0,1,2,3,2,0,0,0,3,2
400995829,Providence Friars,N. Jackson,4068111,,False,17.0,2,2,2,2,0,0,0,0,0,4,4,1,0,0,2,1,4
400995829,Providence Friars,A. Botteghi,3142301,,False,4.0,0,0,0,0,0,0,0,0,0,0,0,0,0,0,0,0,0
400995829,Providence Friars,TEAM,TOTAL,TOTAL,False,,26,52,18,38,8,14,10,17,5,27,32,8,3,0,16,17,70
400995828,Seton Hall Pirates,S. Samuels,4068128,,True,37.0,5,8,5,8,0,0,0,0,3,6,9,2,1,0,5,5,10
400995828,Seton Hall Pirates,K. Evans,4281378,,True,22.0,3,3,3,3,0,0,0,0,1,0,1,0,1,0,0,4,6
400995828,Seton Hall Pirates,D. Winters,4068126,,True,16.0,2,9,1,4,1,5,1,2,2,0,2,0,1,0,1,2,6
400995828,Seton Hall Pirates,I. Butina,4281377,,True,39.0,3,10,3,10,0,0,2,2,1,5,6,6,6,0,7,2,8
400995828,Seton Hall Pirates,J. Jackson,3064877,,True,35.0,7,10,4,5,3,5,5,5,0,1,1,0,3,0,2,1,22
400995828,Seton Hall Pirates,S. Philoxy,4281380,,False,18.0,2,2,2,2,0,0,0,0,0,3,3,1,1,0,2,1,4
400995828,Seton Hall Pirates,N. Jimenez,4281379,,False,29.0,2,8,1,4,1,4,4,4,0,1,1,4,2,0,1,1,9
400995828,Seton Hall Pirates,K. Hilaire,4068123,,False,3.0,0,0,0,0,0,0,0,0,0,0,0,0,0,0,0,2,0
400995828,Seton Hall Pirates,K. Healy,3943704,,False,1.0,0,0,0,0,0,0,0,0,0,0,0,0,0,0,0,0,0
400995828,Seton Hall Pirates,TEAM,TOTAL,TOTAL,False,,24,50,19,36,5,14,12,13,9,17,26,13,15,0,20,18,65
400995828,Seton Hall Pirates,S. Samuels,4068128,,True,37.0,5,8,5,8,0,0,0,0,3,6,9,2,1,0,5,5,10
400995828,Seton Hall Pirates,K. Evans,4281378,,True,22.0,3,3,3,3,0,0,0,0,1,0,1,0,1,0,0,4,6
400995828,Seton Hall Pirates,D. Winters,4068126,,True,16.0,2,9,1,4,1,5,1,2,2,0,2,0,1,0,1,2,6
400995828,Seton Hall Pirates,I. Butina,4281377,,True,39.0,3,10,3,10,0,0,2,2,1,5,6,6,6,0,7,2,8
400995828,Seton Hall Pirates,J. Jackson,3064877,,True,35.0,7,10,4,5,3,5,5,5,0,1,1,0,3,0,2,1,22
400995828,Seton Hall Pirates,S. Philoxy,4281380,,False,18.0,2,2,2,2,0,0,0,0,0,3,3,1,1,0,2,1,4
400995828,Seton Hall Pirates,N. Jimenez,4281379,,False,29.0,2,8,1,4,1,4,4,4,0,1,1,4,2,0,1,1,9
400995828,Seton Hall Pirates,K. Hilaire,4068123,,False,3.0,0,0,0,0,0,0,0,0,0,0,0,0,0,0,0,2,0
400995828,Seton Hall Pirates,K. Healy,3943704,,False,1.0,0,0,0,0,0,0,0,0,0,0,0,0,0,0,0,0,0
400995828,Seton Hall Pirates,TEAM,TOTAL,TOTAL,False,,24,50,19,36,5,14,12,13,9,17,26,13,15,0,20,18,65
400995828,Providence Friars,N. Franklin,4281348,,True,21.0,3,7,3,7,0,0,2,2,2,1,3,1,1,0,3,1,8
400995828,Providence Friars,C. Williams,4281345,,True,31.0,2,8,2,8,0,0,0,0,3,4,7,4,1,0,6,1,4
400995828,Providence Friars,J. Nogic,3906769,,True,26.0,3,9,1,5,2,4,3,3,0,2,2,2,3,1,4,4,11
400995828,Providence Friars,M. Jolin,3906767,,True,35.0,5,12,2,3,3,9,3,3,0,2,2,3,1,2,4,1,16
400995828,Providence Friars,C. Che,3906766,,True,17.0,1,3,1,1,0,2,0,0,0,1,1,0,2,0,2,1,2
400995828,Providence Friars,A. Cooper,4281349,,False,9.0,4,5,4,5,0,0,0,1,2,0,2,0,0,0,0,1,8
400995828,Providence Friars,B. Frias,3142302,,False,5.0,0,0,0,0,0,0,0,2,1,0,1,0,0,0,0,0,0
400995828,Providence Friars,O. Orlando,4281347,,False,6.0,0,0,0,0,0,0,0,0,0,1,1,3,0,0,1,1,0
400995828,Providence Friars,K. Spiwak,4281346,,False,26.0,2,3,2,3,0,0,1,4,3,6,9,1,1,0,1,4,5
400995828,Providence Friars,N. Jackson,4068111,,False,11.0,1,1,1,1,0,0,0,0,0,0,0,0,1,0,3,0,2
400995828,Providence Friars,A. Botteghi,3142301,,False,13.0,0,1,0,1,0,0,0,0,2,1,3,1,0,0,1,0,0
400995828,Providence Friars,TEAM,TOTAL,TOTAL,False,,21,49,16,34,5,15,9,15,13,18,31,15,10,3,25,14,56
400995828,Providence Friars,N. Franklin,4281348,,True,21.0,3,7,3,7,0,0,2,2,2,1,3,1,1,0,3,1,8
400995828,Providence Friars,C. Williams,4281345,,True,31.0,2,8,2,8,0,0,0,0,3,4,7,4,1,0,6,1,4
400995828,Providence Friars,J. Nogic,3906769,,True,26.0,3,9,1,5,2,4,3,3,0,2,2,2,3,1,4,4,11
400995828,Providence Friars,M. Jolin,3906767,,True,35.0,5,12,2,3,3,9,3,3,0,2,2,3,1,2,4,1,16
400995828,Providence Friars,C. Che,3906766,,True,17.0,1,3,1,1,0,2,0,0,0,1,1,0,2,0,2,1,2
400995828,Providence Friars,A. Cooper,4281349,,False,9.0,4,5,4,5,0,0,0,1,2,0,2,0,0,0,0,1,8
400995828,Providence Friars,B. Frias,3142302,,False,5.0,0,0,0,0,0,0,0,2,1,0,1,0,0,0,0,0,0
400995828,Providence Friars,O. Orlando,4281347,,False,6.0,0,0,0,0,0,0,0,0,0,1,1,3,0,0,1,1,0
400995828,Providence Friars,K. Spiwak,4281346,,False,26.0,2,3,2,3,0,0,1,4,3,6,9,1,1,0,1,4,5
400995828,Providence Friars,N. Jackson,4068111,,False,11.0,1,1,1,1,0,0,0,0,0,0,0,0,1,0,3,0,2
400995828,Providence Friars,A. Botteghi,3142301,,False,13.0,0,1,0,1,0,0,0,0,2,1,3,1,0,0,1,0,0
400995828,Providence Friars,TEAM,TOTAL,TOTAL,False,,21,49,16,34,5,15,9,15,13,18,31,15,10,3,25,14,56
400995827,St. John's Red Storm,M. Singleton,4068158,,True,24.0,2,11,2,11,0,0,0,0,4,4,8,0,2,1,3,1,4
400995827,St. John's Red Storm,I. Littleton,3142306,,True,17.0,0,1,0,1,0,0,2,2,0,4,4,1,0,1,0,3,2
400995827,St. John's Red Storm,A. Wellere,3906771,,True,26.0,1,4,1,2,0,2,2,2,0,2,2,0,1,0,2,2,4
400995827,St. John's Red Storm,T. England,4068155,,True,37.0,4,11,4,8,0,3,0,0,0,1,1,2,4,1,2,1,8
400995827,St. John's Red Storm,A. Kebbe,4068154,,True,28.0,0,8,0,6,0,2,0,0,3,3,6,0,0,0,2,1,0
400995827,St. John's Red Storm,K. Charles,4281374,,False,15.0,2,4,2,4,0,0,1,1,4,2,6,1,0,1,0,2,5
400995827,St. John's Red Storm,Q. Hoppie,4281375,,False,25.0,2,5,1,2,1,3,2,2,0,0,0,0,0,0,0,2,7
400995827,St. John's Red Storm,A. Adams,4068157,,False,25.0,4,12,3,9,1,3,0,0,0,5,5,1,0,0,0,2,9
400995827,St. John's Red Storm,T. Alexander,3142305,,False,3.0,0,2,0,2,0,0,0,0,1,0,1,1,0,0,0,0,0
400995827,St. John's Red Storm,TEAM,TOTAL,TOTAL,False,,15,58,13,45,2,13,7,7,12,22,34,6,7,4,9,14,39
400995827,St. John's Red Storm,M. Singleton,4068158,,True,24.0,2,11,2,11,0,0,0,0,4,4,8,0,2,1,3,1,4
400995827,St. John's Red Storm,I. Littleton,3142306,,True,17.0,0,1,0,1,0,0,2,2,0,4,4,1,0,1,0,3,2
400995827,St. John's Red Storm,A. Wellere,3906771,,True,26.0,1,4,1,2,0,2,2,2,0,2,2,0,1,0,2,2,4
400995827,St. John's Red Storm,T. England,4068155,,True,37.0,4,11,4,8,0,3,0,0,0,1,1,2,4,1,2,1,8
400995827,St. John's Red Storm,A. Kebbe,4068154,,True,28.0,0,8,0,6,0,2,0,0,3,3,6,0,0,0,2,1,0
400995827,St. John's Red Storm,K. Charles,4281374,,False,15.0,2,4,2,4,0,0,1,1,4,2,6,1,0,1,0,2,5
400995827,St. John's Red Storm,Q. Hoppie,4281375,,False,25.0,2,5,1,2,1,3,2,2,0,0,0,0,0,0,0,2,7
400995827,St. John's Red Storm,A. Adams,4068157,,False,25.0,4,12,3,9,1,3,0,0,0,5,5,1,0,0,0,2,9
400995827,St. John's Red Storm,T. Alexander,3142305,,False,3.0,0,2,0,2,0,0,0,0,1,0,1,1,0,0,0,0,0
400995827,St. John's Red Storm,TEAM,TOTAL,TOTAL,False,,15,58,13,45,2,13,7,7,12,22,34,6,7,4,9,14,39
400995827,Creighton Bluejays,A. Faber,3938938,,True,35.0,2,10,2,7,0,3,0,0,0,7,7,2,2,3,1,0,4
400995827,Creighton Bluejays,J. Agnew,3938935,,True,33.0,2,9,1,4,1,5,0,0,1,11,12,3,0,1,0,1,5
400995827,Creighton Bluejays,B. Norby,3142284,,True,8.0,0,1,0,1,0,0,0,0,0,1,1,0,1,0,3,1,0
400995827,Creighton Bluejays,S. Lamberty,3142285,,True,38.0,5,9,3,6,2,3,1,2,1,7,8,6,0,1,4,0,13
400995827,Creighton Bluejays,M. Mellman,3142283,,True,9.0,0,1,0,1,0,0,0,0,0,1,1,0,0,0,1,1,0
400995827,Creighton Bluejays,A. Greene,3938937,,False,24.0,6,9,6,8,0,1,2,2,5,1,6,1,0,1,1,3,14
400995827,Creighton Bluejays,K. Brown,3142286,,False,5.0,0,0,0,0,0,0,0,0,0,0,0,0,1,1,0,1,0
400995827,Creighton Bluejays,T. Carda,4281362,,False,18.0,0,2,0,0,0,2,1,2,0,2,2,0,0,0,0,2,1
400995827,Creighton Bluejays,T. Rembao,4281361,,False,1.0,0,0,0,0,0,0,0,0,0,0,0,0,0,0,0,0,0
400995827,Creighton Bluejays,O. Elger,3938936,,False,28.0,5,8,3,6,2,2,4,6,0,1,1,4,1,0,2,3,16
400995827,Creighton Bluejays,B. Kissinger,3142124,,False,1.0,0,0,0,0,0,0,0,0,0,0,0,0,0,0,0,0,0
400995827,Creighton Bluejays,TEAM,TOTAL,TOTAL,False,,20,49,15,33,5,16,8,12,8,31,39,16,5,7,12,12,53
400995827,Creighton Bluejays,A. Faber,3938938,,True,35.0,2,10,2,7,0,3,0,0,0,7,7,2,2,3,1,0,4
400995827,Creighton Bluejays,J. Agnew,3938935,,True,33.0,2,9,1,4,1,5,0,0,1,11,12,3,0,1,0,1,5
400995827,Creighton Bluejays,B. Norby,3142284,,True,8.0,0,1,0,1,0,0,0,0,0,1,1,0,1,0,3,1,0
400995827,Creighton Bluejays,S. Lamberty,3142285,,True,38.0,5,9,3,6,2,3,1,2,1,7,8,6,0,1,4,0,13
400995827,Creighton Bluejays,M. Mellman,3142283,,True,9.0,0,1,0,1,0,0,0,0,0,1,1,0,0,0,1,1,0
400995827,Creighton Bluejays,A. Greene,3938937,,False,24.0,6,9,6,8,0,1,2,2,5,1,6,1,0,1,1,3,14
400995827,Creighton Bluejays,K. Brown,3142286,,False,5.0,0,0,0,0,0,0,0,0,0,0,0,0,1,1,0,1,0
400995827,Creighton Bluejays,T. Carda,4281362,,False,18.0,0,2,0,0,0,2,1,2,0,2,2,0,0,0,0,2,1
400995827,Creighton Bluejays,T. Rembao,4281361,,False,1.0,0,0,0,0,0,0,0,0,0,0,0,0,0,0,0,0,0
400995827,Creighton Bluejays,O. Elger,3938936,,False,28.0,5,8,3,6,2,2,4,6,0,1,1,4,1,0,2,3,16
400995827,Creighton Bluejays,B. Kissinger,3142124,,False,1.0,0,0,0,0,0,0,0,0,0,0,0,0,0,0,0,0,0
400995827,Creighton Bluejays,TEAM,TOTAL,TOTAL,False,,20,49,15,33,5,16,8,12,8,31,39,16,5,7,12,12,53
400995826,Xavier Musketeers,A. Aijanen,3142319,,True,19.0,1,3,0,0,1,3,0,0,1,2,3,1,0,0,0,1,3
400995826,Xavier Musketeers,A. Dunham,4281365,,True,16.0,4,6,3,4,1,2,0,0,0,0,0,1,1,0,0,0,9
400995826,Xavier Musketeers,N. Owens,4068187,,True,23.0,5,9,4,5,1,4,0,0,0,3,3,0,0,0,2,0,11
400995826,Xavier Musketeers,J. Byrd,3142318,,True,17.0,0,9,0,7,0,2,0,0,2,1,3,1,0,0,2,1,0
400995826,Xavier Musketeers,K. Fincher,3142317,,True,14.0,2,9,1,4,1,5,1,1,1,2,3,2,0,0,3,0,6
400995826,Xavier Musketeers,A. Gray,4281368,,False,21.0,1,5,1,3,0,2,1,4,3,3,6,2,4,0,0,1,3
400995826,Xavier Musketeers,D. Ross,4281364,,False,10.0,1,3,0,1,1,2,2,2,0,4,4,0,0,0,0,0,5
400995826,Xavier Musketeers,M. Christopher,4068186,,False,13.0,1,2,1,1,0,1,1,2,0,1,1,0,0,0,1,1,3
400995826,Xavier Musketeers,I. Partlow,3142320,,False,14.0,1,4,1,3,0,1,0,0,1,2,3,0,0,0,1,2,2
400995826,Xavier Musketeers,A. Reiff,4281367,,False,12.0,0,5,0,3,0,2,0,0,0,0,0,0,0,0,1,0,0
400995826,Xavier Musketeers,P. Stewart,4281366,,False,28.0,3,6,3,4,0,2,0,0,0,2,2,3,0,0,0,0,6
400995826,Xavier Musketeers,A. Gomez,4068185,,False,13.0,0,1,0,1,0,0,2,2,0,0,0,0,1,0,0,1,2
400995826,Xavier Musketeers,TEAM,TOTAL,TOTAL,False,,19,62,14,36,5,26,7,11,11,20,31,10,6,0,10,7,50
400995826,Xavier Musketeers,A. Aijanen,3142319,,True,19.0,1,3,0,0,1,3,0,0,1,2,3,1,0,0,0,1,3
400995826,Xavier Musketeers,A. Dunham,4281365,,True,16.0,4,6,3,4,1,2,0,0,0,0,0,1,1,0,0,0,9
400995826,Xavier Musketeers,N. Owens,4068187,,True,23.0,5,9,4,5,1,4,0,0,0,3,3,0,0,0,2,0,11
400995826,Xavier Musketeers,J. Byrd,3142318,,True,17.0,0,9,0,7,0,2,0,0,2,1,3,1,0,0,2,1,0
400995826,Xavier Musketeers,K. Fincher,3142317,,True,14.0,2,9,1,4,1,5,1,1,1,2,3,2,0,0,3,0,6
400995826,Xavier Musketeers,A. Gray,4281368,,False,21.0,1,5,1,3,0,2,1,4,3,3,6,2,4,0,0,1,3
400995826,Xavier Musketeers,D. Ross,4281364,,False,10.0,1,3,0,1,1,2,2,2,0,4,4,0,0,0,0,0,5
400995826,Xavier Musketeers,M. Christopher,4068186,,False,13.0,1,2,1,1,0,1,1,2,0,1,1,0,0,0,1,1,3
400995826,Xavier Musketeers,I. Partlow,3142320,,False,14.0,1,4,1,3,0,1,0,0,1,2,3,0,0,0,1,2,2
400995826,Xavier Musketeers,A. Reiff,4281367,,False,12.0,0,5,0,3,0,2,0,0,0,0,0,0,0,0,1,0,0
400995826,Xavier Musketeers,P. Stewart,4281366,,False,28.0,3,6,3,4,0,2,0,0,0,2,2,3,0,0,0,0,6
400995826,Xavier Musketeers,A. Gomez,4068185,,False,13.0,0,1,0,1,0,0,2,2,0,0,0,0,1,0,0,1,2
400995826,Xavier Musketeers,TEAM,TOTAL,TOTAL,False,,19,62,14,36,5,26,7,11,11,20,31,10,6,0,10,7,50
400995826,Villanova Wildcats,M. Quinn,3056785,,True,14.0,4,4,4,4,0,0,0,0,0,1,1,2,1,0,1,2,8
400995826,Villanova Wildcats,J. Tucker,3087536,,True,22.0,5,5,3,3,2,2,0,0,0,3,3,1,0,1,0,0,12
400995826,Villanova Wildcats,K. Jekot,4068171,,True,23.0,4,9,3,6,1,3,0,0,2,1,3,4,0,0,1,0,9
400995826,Villanova Wildcats,A. Hahn,3906779,,True,27.0,4,4,2,2,2,2,0,0,0,5,5,6,2,0,0,1,10
400995826,Villanova Wildcats,A. Louin,3142314,,True,26.0,9,14,4,4,5,10,1,1,0,6,6,4,0,0,1,0,24
400995826,Villanova Wildcats,G. Lange,4281371,,False,2.0,1,1,1,1,0,0,0,0,0,0,0,0,0,0,0,0,2
400995826,Villanova Wildcats,M. Gedaka,4068172,,False,18.0,3,7,2,5,1,2,0,0,1,4,5,2,1,0,1,1,7
400995826,Villanova Wildcats,B. Herlihy,4068169,,False,8.0,1,1,1,1,0,0,0,0,0,3,3,0,0,0,1,2,2
400995826,Villanova Wildcats,B. Herlihy,3906778,,False,19.0,1,3,1,2,0,1,0,0,0,3,3,4,1,1,1,1,2
400995826,Villanova Wildcats,G. Stant,3906780,,False,16.0,2,5,0,0,2,5,0,0,0,1,1,0,0,0,1,1,6
400995826,Villanova Wildcats,N. Juliana,4068170,,False,3.0,0,1,0,0,0,1,0,0,0,1,1,1,0,0,1,0,0
400995826,Villanova Wildcats,R. James,4068168,,False,11.0,1,1,1,1,0,0,0,0,0,2,2,2,0,0,1,0,2
400995826,Villanova Wildcats,C. Onken,4068167,,False,11.0,2,5,1,1,1,4,0,2,0,4,4,0,1,0,0,2,5
400995826,Villanova Wildcats,TEAM,TOTAL,TOTAL,False,,37,60,23,30,14,30,1,3,3,35,38,26,6,2,9,10,89
400995826,Villanova Wildcats,M. Quinn,3056785,,True,14.0,4,4,4,4,0,0,0,0,0,1,1,2,1,0,1,2,8
400995826,Villanova Wildcats,J. Tucker,3087536,,True,22.0,5,5,3,3,2,2,0,0,0,3,3,1,0,1,0,0,12
400995826,Villanova Wildcats,K. Jekot,4068171,,True,23.0,4,9,3,6,1,3,0,0,2,1,3,4,0,0,1,0,9
400995826,Villanova Wildcats,A. Hahn,3906779,,True,27.0,4,4,2,2,2,2,0,0,0,5,5,6,2,0,0,1,10
400995826,Villanova Wildcats,A. Louin,3142314,,True,26.0,9,14,4,4,5,10,1,1,0,6,6,4,0,0,1,0,24
400995826,Villanova Wildcats,G. Lange,4281371,,False,2.0,1,1,1,1,0,0,0,0,0,0,0,0,0,0,0,0,2
400995826,Villanova Wildcats,M. Gedaka,4068172,,False,18.0,3,7,2,5,1,2,0,0,1,4,5,2,1,0,1,1,7
400995826,Villanova Wildcats,B. Herlihy,4068169,,False,8.0,1,1,1,1,0,0,0,0,0,3,3,0,0,0,1,2,2
400995826,Villanova Wildcats,B. Herlihy,3906778,,False,19.0,1,3,1,2,0,1,0,0,0,3,3,4,1,1,1,1,2
400995826,Villanova Wildcats,G. Stant,3906780,,False,16.0,2,5,0,0,2,5,0,0,0,1,1,0,0,0,1,1,6
400995826,Villanova Wildcats,N. Juliana,4068170,,False,3.0,0,1,0,0,0,1,0,0,0,1,1,1,0,0,1,0,0
400995826,Villanova Wildcats,R. James,4068168,,False,11.0,1,1,1,1,0,0,0,0,0,2,2,2,0,0,1,0,2
400995826,Villanova Wildcats,C. Onken,4068167,,False,11.0,2,5,1,1,1,4,0,2,0,4,4,0,1,0,0,2,5
400995826,Villanova Wildcats,TEAM,TOTAL,TOTAL,False,,37,60,23,30,14,30,1,3,3,35,38,26,6,2,9,10,89
400995825,Georgetown Hoyas,T. Thompson,4281352,,True,17.0,3,8,2,6,1,2,0,0,1,0,1,1,1,0,1,1,7
400995825,Georgetown Hoyas,C. Petke,4068078,,True,40.0,5,16,4,11,1,5,1,2,1,4,5,1,2,1,0,0,12
400995825,Georgetown Hoyas,M. Smith,4068079,,True,17.0,0,1,0,1,0,0,0,0,1,1,2,1,1,1,0,0,0
400995825,Georgetown Hoyas,Y. Belk,3142295,,True,40.0,2,7,2,7,0,0,0,0,7,6,13,0,2,5,3,3,4
400995825,Georgetown Hoyas,M. Venson,3142105,,True,32.0,4,9,1,3,3,6,6,6,0,1,1,3,0,0,1,2,17
400995825,Georgetown Hoyas,D. White,3948815,,False,31.0,6,12,2,5,4,7,3,4,2,5,7,3,4,0,2,4,19
400995825,Georgetown Hoyas,D. Burton,3142292,,False,23.0,2,11,2,9,0,2,0,2,0,1,1,5,4,0,0,2,4
400995825,Georgetown Hoyas,TEAM,TOTAL,TOTAL,False,,22,64,13,42,9,22,10,14,14,21,35,14,14,7,7,12,63
400995825,Georgetown Hoyas,T. Thompson,4281352,,True,17.0,3,8,2,6,1,2,0,0,1,0,1,1,1,0,1,1,7
400995825,Georgetown Hoyas,C. Petke,4068078,,True,40.0,5,16,4,11,1,5,1,2,1,4,5,1,2,1,0,0,12
400995825,Georgetown Hoyas,M. Smith,4068079,,True,17.0,0,1,0,1,0,0,0,0,1,1,2,1,1,1,0,0,0
400995825,Georgetown Hoyas,Y. Belk,3142295,,True,40.0,2,7,2,7,0,0,0,0,7,6,13,0,2,5,3,3,4
400995825,Georgetown Hoyas,M. Venson,3142105,,True,32.0,4,9,1,3,3,6,6,6,0,1,1,3,0,0,1,2,17
400995825,Georgetown Hoyas,D. White,3948815,,False,31.0,6,12,2,5,4,7,3,4,2,5,7,3,4,0,2,4,19
400995825,Georgetown Hoyas,D. Burton,3142292,,False,23.0,2,11,2,9,0,2,0,2,0,1,1,5,4,0,0,2,4
400995825,Georgetown Hoyas,TEAM,TOTAL,TOTAL,False,,22,64,13,42,9,22,10,14,14,21,35,14,14,7,7,12,63
400995825,Butler Bulldogs,S. Brey,4068067,,True,30.0,2,3,2,3,0,0,0,0,1,6,7,5,0,0,4,2,4
400995825,Butler Bulldogs,T. Schickel,3914012,,True,40.0,3,7,3,7,0,0,5,8,4,4,8,1,0,1,5,2,11
400995825,Butler Bulldogs,M. Weaver,3914014,,True,38.0,2,5,0,1,2,4,0,0,0,2,2,1,1,0,3,2,6
400995825,Butler Bulldogs,W. Jennings,3142145,,True,38.0,6,13,1,3,5,10,2,2,0,6,6,0,1,1,2,2,19
400995825,Butler Bulldogs,I. Lathan,3079485,,True,21.0,2,5,2,5,0,0,1,2,0,2,2,2,0,0,1,1,5
400995825,Butler Bulldogs,K. Spolyar,4068068,,False,29.0,2,12,1,4,1,8,2,3,1,9,10,2,0,0,4,4,7
400995825,Butler Bulldogs,S. Buck,3142279,,False,4.0,0,0,0,0,0,0,0,0,0,0,0,0,0,0,0,0,0
400995825,Butler Bulldogs,TEAM,TOTAL,TOTAL,False,,17,45,9,23,8,22,10,15,9,29,38,11,2,2,20,13,52
400995825,Butler Bulldogs,S. Brey,4068067,,True,30.0,2,3,2,3,0,0,0,0,1,6,7,5,0,0,4,2,4
400995825,Butler Bulldogs,T. Schickel,3914012,,True,40.0,3,7,3,7,0,0,5,8,4,4,8,1,0,1,5,2,11
400995825,Butler Bulldogs,M. Weaver,3914014,,True,38.0,2,5,0,1,2,4,0,0,0,2,2,1,1,0,3,2,6
400995825,Butler Bulldogs,W. Jennings,3142145,,True,38.0,6,13,1,3,5,10,2,2,0,6,6,0,1,1,2,2,19
400995825,Butler Bulldogs,I. Lathan,3079485,,True,21.0,2,5,2,5,0,0,1,2,0,2,2,2,0,0,1,1,5
400995825,Butler Bulldogs,K. Spolyar,4068068,,False,29.0,2,12,1,4,1,8,2,3,1,9,10,2,0,0,4,4,7
400995825,Butler Bulldogs,S. Buck,3142279,,False,4.0,0,0,0,0,0,0,0,0,0,0,0,0,0,0,0,0,0
400995825,Butler Bulldogs,TEAM,TOTAL,TOTAL,False,,17,45,9,23,8,22,10,15,9,29,38,11,2,2,20,13,52
400995824,Xavier Musketeers,I. Partlow,3142320,,True,26.0,3,6,3,4,0,2,0,1,0,7,7,0,0,0,1,3,6
400995824,Xavier Musketeers,A. Aijanen,3142319,,True,33.0,6,10,4,7,2,3,0,0,0,1,1,1,0,0,2,5,14
400995824,Xavier Musketeers,N. Owens,4068187,,True,29.0,5,12,3,9,2,3,0,2,2,3,5,4,1,0,0,1,12
400995824,Xavier Musketeers,J. Byrd,3142318,,True,33.0,5,10,5,9,0,1,3,4,0,1,1,4,2,0,1,2,13
400995824,Xavier Musketeers,K. Fincher,3142317,,True,35.0,2,7,1,2,1,5,0,0,1,6,7,1,1,1,2,1,5
400995824,Xavier Musketeers,A. Gray,4281368,,False,8.0,0,3,0,3,0,0,0,0,0,2,2,0,0,0,1,1,0
400995824,Xavier Musketeers,D. Ross,4281364,,False,11.0,0,2,0,0,0,2,0,0,0,2,2,0,0,0,1,0,0
400995824,Xavier Musketeers,M. Christopher,4068186,,False,2.0,0,0,0,0,0,0,0,0,0,0,0,0,0,0,0,1,0
400995824,Xavier Musketeers,A. Reiff,4281367,,False,9.0,0,1,0,1,0,0,3,4,0,1,1,1,0,0,0,0,3
400995824,Xavier Musketeers,P. Stewart,4281366,,False,15.0,1,6,0,3,1,3,0,0,0,1,1,2,0,0,1,0,3
400995824,Xavier Musketeers,A. Dunham,4281365,,False,23.0,3,4,1,2,2,2,0,0,0,4,4,3,0,0,0,2,8
400995824,Xavier Musketeers,A. Gomez,4068185,,False,1.0,0,0,0,0,0,0,0,0,0,0,0,0,0,0,0,0,0
400995824,Xavier Musketeers,TEAM,TOTAL,TOTAL,False,,25,61,17,40,8,21,6,11,3,29,32,16,4,1,9,16,64
400995824,Xavier Musketeers,I. Partlow,3142320,,True,26.0,3,6,3,4,0,2,0,1,0,7,7,0,0,0,1,3,6
400995824,Xavier Musketeers,A. Aijanen,3142319,,True,33.0,6,10,4,7,2,3,0,0,0,1,1,1,0,0,2,5,14
400995824,Xavier Musketeers,N. Owens,4068187,,True,29.0,5,12,3,9,2,3,0,2,2,3,5,4,1,0,0,1,12
400995824,Xavier Musketeers,J. Byrd,3142318,,True,33.0,5,10,5,9,0,1,3,4,0,1,1,4,2,0,1,2,13
400995824,Xavier Musketeers,K. Fincher,3142317,,True,35.0,2,7,1,2,1,5,0,0,1,6,7,1,1,1,2,1,5
400995824,Xavier Musketeers,A. Gray,4281368,,False,8.0,0,3,0,3,0,0,0,0,0,2,2,0,0,0,1,1,0
400995824,Xavier Musketeers,D. Ross,4281364,,False,11.0,0,2,0,0,0,2,0,0,0,2,2,0,0,0,1,0,0
400995824,Xavier Musketeers,M. Christopher,4068186,,False,2.0,0,0,0,0,0,0,0,0,0,0,0,0,0,0,0,1,0
400995824,Xavier Musketeers,A. Reiff,4281367,,False,9.0,0,1,0,1,0,0,3,4,0,1,1,1,0,0,0,0,3
400995824,Xavier Musketeers,P. Stewart,4281366,,False,15.0,1,6,0,3,1,3,0,0,0,1,1,2,0,0,1,0,3
400995824,Xavier Musketeers,A. Dunham,4281365,,False,23.0,3,4,1,2,2,2,0,0,0,4,4,3,0,0,0,2,8
400995824,Xavier Musketeers,A. Gomez,4068185,,False,1.0,0,0,0,0,0,0,0,0,0,0,0,0,0,0,0,0,0
400995824,Xavier Musketeers,TEAM,TOTAL,TOTAL,False,,25,61,17,40,8,21,6,11,3,29,32,16,4,1,9,16,64
400995824,Creighton Bluejays,A. Faber,3938938,,True,38.0,2,6,1,3,1,3,0,0,1,0,1,1,1,0,0,1,5
400995824,Creighton Bluejays,J. Agnew,3938935,,True,44.0,3,14,2,5,1,9,8,8,1,5,6,4,0,1,1,3,15
400995824,Creighton Bluejays,B. Norby,3142284,,True,19.0,3,9,3,7,0,2,0,0,1,4,5,1,0,0,3,2,6
400995824,Creighton Bluejays,S. Lamberty,3142285,,True,44.0,6,10,4,6,2,4,1,2,1,14,15,5,0,1,3,1,15
400995824,Creighton Bluejays,M. Mellman,3142283,,True,12.0,2,2,0,0,2,2,0,0,0,0,0,1,0,0,0,1,6
400995824,Creighton Bluejays,A. Greene,3938937,,False,10.0,1,2,1,1,0,1,0,0,0,0,0,0,0,0,0,1,2
400995824,Creighton Bluejays,K. Brown,3142286,,False,3.0,2,3,2,3,0,0,0,0,0,1,1,0,0,0,0,0,4
400995824,Creighton Bluejays,T. Carda,4281362,,False,31.0,3,5,1,2,2,3,5,6,0,3,3,3,0,0,1,3,13
400995824,Creighton Bluejays,O. Elger,3938936,,False,24.0,2,6,2,3,0,3,1,2,0,3,3,1,2,0,3,4,5
400995824,Creighton Bluejays,TEAM,TOTAL,TOTAL,False,,24,57,16,30,8,27,15,18,6,33,39,16,3,2,13,16,71
400995824,Creighton Bluejays,A. Faber,3938938,,True,38.0,2,6,1,3,1,3,0,0,1,0,1,1,1,0,0,1,5
400995824,Creighton Bluejays,J. Agnew,3938935,,True,44.0,3,14,2,5,1,9,8,8,1,5,6,4,0,1,1,3,15
400995824,Creighton Bluejays,B. Norby,3142284,,True,19.0,3,9,3,7,0,2,0,0,1,4,5,1,0,0,3,2,6
400995824,Creighton Bluejays,S. Lamberty,3142285,,True,44.0,6,10,4,6,2,4,1,2,1,14,15,5,0,1,3,1,15
400995824,Creighton Bluejays,M. Mellman,3142283,,True,12.0,2,2,0,0,2,2,0,0,0,0,0,1,0,0,0,1,6
400995824,Creighton Bluejays,A. Greene,3938937,,False,10.0,1,2,1,1,0,1,0,0,0,0,0,0,0,0,0,1,2
400995824,Creighton Bluejays,K. Brown,3142286,,False,3.0,2,3,2,3,0,0,0,0,0,1,1,0,0,0,0,0,4
400995824,Creighton Bluejays,T. Carda,4281362,,False,31.0,3,5,1,2,2,3,5,6,0,3,3,3,0,0,1,3,13
400995824,Creighton Bluejays,O. Elger,3938936,,False,24.0,2,6,2,3,0,3,1,2,0,3,3,1,2,0,3,4,5
400995824,Creighton Bluejays,TEAM,TOTAL,TOTAL,False,,24,57,16,30,8,27,15,18,6,33,39,16,3,2,13,16,71
400995823,Georgetown Hoyas,C. Petke,4068078,,True,34.0,11,21,11,20,0,1,2,5,1,5,6,2,3,0,1,3,24
400995823,Georgetown Hoyas,Y. Belk,3142295,,True,6.0,0,0,0,0,0,0,0,0,0,0,0,0,0,0,0,1,0
400995823,Georgetown Hoyas,D. White,3948815,,True,37.0,6,15,5,14,1,1,4,5,3,6,9,2,3,0,3,3,17
400995823,Georgetown Hoyas,D. Burton,3142292,,True,35.0,2,7,2,7,0,0,1,2,0,1,1,8,2,1,2,3,5
400995823,Georgetown Hoyas,M. Venson,3142105,,True,39.0,2,8,2,6,0,2,1,2,0,1,1,4,0,0,1,1,5
400995823,Georgetown Hoyas,T. Thompson,4281352,,False,15.0,2,6,2,5,0,1,0,0,0,0,0,0,0,0,1,1,4
400995823,Georgetown Hoyas,M. Smith,4068079,,False,31.0,3,8,3,8,0,0,0,0,3,4,7,1,0,0,2,2,6
400995823,Georgetown Hoyas,B. Mayfield,4281354,,False,1.0,0,0,0,0,0,0,1,2,1,0,1,0,0,0,0,0,1
400995823,Georgetown Hoyas,L. Kimball,4281353,,False,1.0,0,0,0,0,0,0,0,0,0,0,0,0,0,0,0,0,0
400995823,Georgetown Hoyas,M. Osagie-Erese,4072597,,False,1.0,0,0,0,0,0,0,0,0,0,0,0,0,0,0,0,0,0
400995823,Georgetown Hoyas,TEAM,TOTAL,TOTAL,False,,26,65,25,60,1,5,9,16,12,21,33,17,8,1,10,14,62
400995823,Georgetown Hoyas,C. Petke,4068078,,True,34.0,11,21,11,20,0,1,2,5,1,5,6,2,3,0,1,3,24
400995823,Georgetown Hoyas,Y. Belk,3142295,,True,6.0,0,0,0,0,0,0,0,0,0,0,0,0,0,0,0,1,0
400995823,Georgetown Hoyas,D. White,3948815,,True,37.0,6,15,5,14,1,1,4,5,3,6,9,2,3,0,3,3,17
400995823,Georgetown Hoyas,D. Burton,3142292,,True,35.0,2,7,2,7,0,0,1,2,0,1,1,8,2,1,2,3,5
400995823,Georgetown Hoyas,M. Venson,3142105,,True,39.0,2,8,2,6,0,2,1,2,0,1,1,4,0,0,1,1,5
400995823,Georgetown Hoyas,T. Thompson,4281352,,False,15.0,2,6,2,5,0,1,0,0,0,0,0,0,0,0,1,1,4
400995823,Georgetown Hoyas,M. Smith,4068079,,False,31.0,3,8,3,8,0,0,0,0,3,4,7,1,0,0,2,2,6
400995823,Georgetown Hoyas,B. Mayfield,4281354,,False,1.0,0,0,0,0,0,0,1,2,1,0,1,0,0,0,0,0,1
400995823,Georgetown Hoyas,L. Kimball,4281353,,False,1.0,0,0,0,0,0,0,0,0,0,0,0,0,0,0,0,0,0
400995823,Georgetown Hoyas,M. Osagie-Erese,4072597,,False,1.0,0,0,0,0,0,0,0,0,0,0,0,0,0,0,0,0,0
400995823,Georgetown Hoyas,TEAM,TOTAL,TOTAL,False,,26,65,25,60,1,5,9,16,12,21,33,17,8,1,10,14,62
400995823,DePaul Blue Demons,C. Stonewall,4068072,,True,18.0,0,2,0,1,0,1,0,0,2,0,2,2,2,1,3,3,0
400995823,DePaul Blue Demons,M. Grays,3142287,,True,30.0,8,14,4,7,4,7,2,2,1,0,1,2,0,0,5,4,22
400995823,DePaul Blue Demons,K. Campbell,4068071,,True,30.0,3,8,2,4,1,4,0,0,3,8,11,7,1,1,3,4,7
400995823,DePaul Blue Demons,A. Millender,3142289,,True,33.0,3,7,1,2,2,5,2,2,0,6,6,3,0,0,1,1,10
400995823,DePaul Blue Demons,A. Coleman,3142123,,True,28.0,5,11,1,5,4,6,2,2,0,3,3,3,1,0,2,2,16
400995823,DePaul Blue Demons,R. McLimore,4281358,,False,4.0,0,0,0,0,0,0,0,0,0,0,0,0,0,0,1,0,0
400995823,DePaul Blue Demons,V. Sherrod,4281359,,False,1.0,0,1,0,0,0,1,0,0,0,0,0,0,0,0,0,0,0
400995823,DePaul Blue Demons,D. Bekelja,4281356,,False,1.0,0,0,0,0,0,0,0,0,0,0,0,0,0,0,0,1,0
400995823,DePaul Blue Demons,D. Cage,4068073,,False,4.0,0,0,0,0,0,0,0,0,0,0,0,1,0,0,0,0,0
400995823,DePaul Blue Demons,T. Allen,3933760,,False,30.0,6,9,4,5,2,4,1,2,1,10,11,1,1,0,3,1,15
400995823,DePaul Blue Demons,L. Prochaska,3142290,,False,21.0,3,4,1,1,2,3,0,0,0,0,0,4,0,1,0,1,8
400995823,DePaul Blue Demons,TEAM,TOTAL,TOTAL,False,,28,56,13,25,15,31,7,8,7,30,37,23,5,3,18,17,78
400995823,DePaul Blue Demons,C. Stonewall,4068072,,True,18.0,0,2,0,1,0,1,0,0,2,0,2,2,2,1,3,3,0
400995823,DePaul Blue Demons,M. Grays,3142287,,True,30.0,8,14,4,7,4,7,2,2,1,0,1,2,0,0,5,4,22
400995823,DePaul Blue Demons,K. Campbell,4068071,,True,30.0,3,8,2,4,1,4,0,0,3,8,11,7,1,1,3,4,7
400995823,DePaul Blue Demons,A. Millender,3142289,,True,33.0,3,7,1,2,2,5,2,2,0,6,6,3,0,0,1,1,10
400995823,DePaul Blue Demons,A. Coleman,3142123,,True,28.0,5,11,1,5,4,6,2,2,0,3,3,3,1,0,2,2,16
400995823,DePaul Blue Demons,R. McLimore,4281358,,False,4.0,0,0,0,0,0,0,0,0,0,0,0,0,0,0,1,0,0
400995823,DePaul Blue Demons,V. Sherrod,4281359,,False,1.0,0,1,0,0,0,1,0,0,0,0,0,0,0,0,0,0,0
400995823,DePaul Blue Demons,D. Bekelja,4281356,,False,1.0,0,0,0,0,0,0,0,0,0,0,0,0,0,0,0,1,0
400995823,DePaul Blue Demons,D. Cage,4068073,,False,4.0,0,0,0,0,0,0,0,0,0,0,0,1,0,0,0,0,0
400995823,DePaul Blue Demons,T. Allen,3933760,,False,30.0,6,9,4,5,2,4,1,2,1,10,11,1,1,0,3,1,15
400995823,DePaul Blue Demons,L. Prochaska,3142290,,False,21.0,3,4,1,1,2,3,0,0,0,0,0,4,0,1,0,1,8
400995823,DePaul Blue Demons,TEAM,TOTAL,TOTAL,False,,28,56,13,25,15,31,7,8,7,30,37,23,5,3,18,17,78
400995822,St. John's Red Storm,M. Singleton,4068158,,True,31.0,1,8,1,8,0,0,4,6,4,8,12,3,1,1,1,4,6
400995822,St. John's Red Storm,I. Littleton,3142306,,True,24.0,2,4,2,4,0,0,0,2,0,0,0,2,1,0,4,2,4
400995822,St. John's Red Storm,Q. Hoppie,4281375,,True,35.0,5,14,4,8,1,6,0,0,0,1,1,0,0,0,3,2,11
400995822,St. John's Red Storm,T. England,4068155,,True,26.0,1,6,1,5,0,1,1,2,0,5,5,3,2,0,4,1,3
400995822,St. John's Red Storm,A. Kebbe,4068154,,True,34.0,5,12,2,5,3,7,2,2,3,5,8,2,1,1,0,4,15
400995822,St. John's Red Storm,K. Charles,4281374,,False,2.0,0,0,0,0,0,0,0,0,0,0,0,0,0,1,0,1,0
400995822,St. John's Red Storm,A. Wellere,3906771,,False,28.0,3,7,2,4,1,3,2,2,0,3,3,1,1,0,1,2,9
400995822,St. John's Red Storm,A. Adams,4068157,,False,20.0,3,6,2,3,1,3,2,2,1,2,3,2,1,0,3,3,9
400995822,St. John's Red Storm,TEAM,TOTAL,TOTAL,False,,20,57,14,37,6,20,11,16,9,25,34,13,7,3,16,19,57
400995822,St. John's Red Storm,M. Singleton,4068158,,True,31.0,1,8,1,8,0,0,4,6,4,8,12,3,1,1,1,4,6
400995822,St. John's Red Storm,I. Littleton,3142306,,True,24.0,2,4,2,4,0,0,0,2,0,0,0,2,1,0,4,2,4
400995822,St. John's Red Storm,Q. Hoppie,4281375,,True,35.0,5,14,4,8,1,6,0,0,0,1,1,0,0,0,3,2,11
400995822,St. John's Red Storm,T. England,4068155,,True,26.0,1,6,1,5,0,1,1,2,0,5,5,3,2,0,4,1,3
400995822,St. John's Red Storm,A. Kebbe,4068154,,True,34.0,5,12,2,5,3,7,2,2,3,5,8,2,1,1,0,4,15
400995822,St. John's Red Storm,K. Charles,4281374,,False,2.0,0,0,0,0,0,0,0,0,0,0,0,0,0,1,0,1,0
400995822,St. John's Red Storm,A. Wellere,3906771,,False,28.0,3,7,2,4,1,3,2,2,0,3,3,1,1,0,1,2,9
400995822,St. John's Red Storm,A. Adams,4068157,,False,20.0,3,6,2,3,1,3,2,2,1,2,3,2,1,0,3,3,9
400995822,St. John's Red Storm,TEAM,TOTAL,TOTAL,False,,20,57,14,37,6,20,11,16,9,25,34,13,7,3,16,19,57
400995822,Seton Hall Pirates,S. Samuels,4068128,,True,28.0,4,6,4,5,0,1,1,4,0,4,4,1,2,0,4,4,9
400995822,Seton Hall Pirates,K. Evans,4281378,,True,28.0,2,3,2,3,0,0,2,2,2,4,6,1,1,2,3,4,6
400995822,Seton Hall Pirates,I. Butina,4281377,,True,38.0,6,14,3,10,3,4,0,0,1,2,3,5,1,0,6,2,15
400995822,Seton Hall Pirates,D. Winters,4068126,,True,21.0,1,8,0,3,1,5,1,2,1,2,3,0,3,0,1,1,4
400995822,Seton Hall Pirates,J. Jackson,3064877,,True,37.0,6,11,6,7,0,4,2,3,0,8,8,0,0,0,1,3,14
400995822,Seton Hall Pirates,S. Philoxy,4281380,,False,23.0,2,6,2,6,0,0,0,1,2,5,7,4,4,1,3,1,4
400995822,Seton Hall Pirates,J. Jones-Pack,4068129,,False,4.0,0,1,0,1,0,0,0,0,1,1,2,0,0,0,1,1,0
400995822,Seton Hall Pirates,N. Jimenez,4281379,,False,4.0,0,0,0,0,0,0,0,0,0,1,1,0,0,0,0,0,0
400995822,Seton Hall Pirates,K. Hilaire,4068123,,False,17.0,2,4,2,4,0,0,6,6,0,1,1,0,1,0,3,3,10
400995822,Seton Hall Pirates,TEAM,TOTAL,TOTAL,False,,23,53,19,39,4,14,12,18,9,31,40,11,12,3,22,19,62
400995822,Seton Hall Pirates,S. Samuels,4068128,,True,28.0,4,6,4,5,0,1,1,4,0,4,4,1,2,0,4,4,9
400995822,Seton Hall Pirates,K. Evans,4281378,,True,28.0,2,3,2,3,0,0,2,2,2,4,6,1,1,2,3,4,6
400995822,Seton Hall Pirates,I. Butina,4281377,,True,38.0,6,14,3,10,3,4,0,0,1,2,3,5,1,0,6,2,15
400995822,Seton Hall Pirates,D. Winters,4068126,,True,21.0,1,8,0,3,1,5,1,2,1,2,3,0,3,0,1,1,4
400995822,Seton Hall Pirates,J. Jackson,3064877,,True,37.0,6,11,6,7,0,4,2,3,0,8,8,0,0,0,1,3,14
400995822,Seton Hall Pirates,S. Philoxy,4281380,,False,23.0,2,6,2,6,0,0,0,1,2,5,7,4,4,1,3,1,4
400995822,Seton Hall Pirates,J. Jones-Pack,4068129,,False,4.0,0,1,0,1,0,0,0,0,1,1,2,0,0,0,1,1,0
400995822,Seton Hall Pirates,N. Jimenez,4281379,,False,4.0,0,0,0,0,0,0,0,0,0,1,1,0,0,0,0,0,0
400995822,Seton Hall Pirates,K. Hilaire,4068123,,False,17.0,2,4,2,4,0,0,6,6,0,1,1,0,1,0,3,3,10
400995822,Seton Hall Pirates,TEAM,TOTAL,TOTAL,False,,23,53,19,39,4,14,12,18,9,31,40,11,12,3,22,19,62
400995821,Providence Friars,N. Franklin,4281348,,True,20.0,1,5,1,5,0,0,0,0,0,2,2,1,0,0,2,2,2
400995821,Providence Friars,C. Williams,4281345,,True,23.0,4,8,4,8,0,0,1,1,0,2,2,3,1,0,2,2,9
400995821,Providence Friars,J. Nogic,3906769,,True,33.0,4,7,2,3,2,4,3,3,0,0,0,0,1,0,4,3,13
400995821,Providence Friars,M. Jolin,3906767,,True,30.0,3,9,0,1,3,8,0,2,0,3,3,3,1,1,2,1,9
400995821,Providence Friars,C. Che,3906766,,True,24.0,4,7,2,2,2,5,4,4,0,1,1,1,3,0,3,1,14
400995821,Providence Friars,A. Cooper,4281349,,False,1.0,0,1,0,1,0,0,0,0,0,0,0,0,0,0,0,1,0
400995821,Providence Friars,B. Frias,3142302,,False,12.0,0,0,0,0,0,0,0,0,0,0,0,0,1,2,0,1,0
400995821,Providence Friars,K. Spiwak,4281346,,False,12.0,1,2,1,2,0,0,0,0,0,2,2,1,1,0,2,3,2
400995821,Providence Friars,N. Jackson,4068111,,False,23.0,3,4,3,4,0,0,0,0,1,5,6,1,0,1,2,3,6
400995821,Providence Friars,A. Botteghi,3142301,,False,23.0,1,5,1,5,0,0,0,0,0,3,3,1,3,0,0,0,2
400995821,Providence Friars,TEAM,TOTAL,TOTAL,False,,21,48,14,31,7,17,8,10,4,19,23,11,11,4,17,17,57
400995821,Providence Friars,N. Franklin,4281348,,True,20.0,1,5,1,5,0,0,0,0,0,2,2,1,0,0,2,2,2
400995821,Providence Friars,C. Williams,4281345,,True,23.0,4,8,4,8,0,0,1,1,0,2,2,3,1,0,2,2,9
400995821,Providence Friars,J. Nogic,3906769,,True,33.0,4,7,2,3,2,4,3,3,0,0,0,0,1,0,4,3,13
400995821,Providence Friars,M. Jolin,3906767,,True,30.0,3,9,0,1,3,8,0,2,0,3,3,3,1,1,2,1,9
400995821,Providence Friars,C. Che,3906766,,True,24.0,4,7,2,2,2,5,4,4,0,1,1,1,3,0,3,1,14
400995821,Providence Friars,A. Cooper,4281349,,False,1.0,0,1,0,1,0,0,0,0,0,0,0,0,0,0,0,1,0
400995821,Providence Friars,B. Frias,3142302,,False,12.0,0,0,0,0,0,0,0,0,0,0,0,0,1,2,0,1,0
400995821,Providence Friars,K. Spiwak,4281346,,False,12.0,1,2,1,2,0,0,0,0,0,2,2,1,1,0,2,3,2
400995821,Providence Friars,N. Jackson,4068111,,False,23.0,3,4,3,4,0,0,0,0,1,5,6,1,0,1,2,3,6
400995821,Providence Friars,A. Botteghi,3142301,,False,23.0,1,5,1,5,0,0,0,0,0,3,3,1,3,0,0,0,2
400995821,Providence Friars,TEAM,TOTAL,TOTAL,False,,21,48,14,31,7,17,8,10,4,19,23,11,11,4,17,17,57
400995821,Butler Bulldogs,S. Brey,4068067,,True,36.0,2,4,2,4,0,0,2,3,3,5,8,3,3,0,0,2,6
400995821,Butler Bulldogs,T. Schickel,3914012,,True,40.0,11,17,11,17,0,0,5,6,2,7,9,2,3,1,1,3,27
400995821,Butler Bulldogs,M. Weaver,3914014,,True,34.0,4,4,2,2,2,2,0,0,2,1,3,3,1,1,2,1,10
400995821,Butler Bulldogs,W. Jennings,3142145,,True,38.0,5,14,2,6,3,8,3,4,0,2,2,4,0,0,6,2,16
400995821,Butler Bulldogs,I. Lathan,3079485,,True,20.0,1,4,1,4,0,0,0,0,1,4,5,1,0,0,3,2,2
400995821,Butler Bulldogs,K. Hodges,4068065,,False,2.0,0,0,0,0,0,0,0,0,0,2,2,0,0,0,0,1,0
400995821,Butler Bulldogs,K. Spolyar,4068068,,False,27.0,2,9,2,6,0,3,3,4,0,1,1,4,4,0,4,3,7
400995821,Butler Bulldogs,S. Buck,3142279,,False,3.0,0,0,0,0,0,0,0,0,0,0,0,0,0,0,0,0,0
400995821,Butler Bulldogs,TEAM,TOTAL,TOTAL,False,,25,52,20,39,5,13,13,17,9,24,33,17,11,2,16,14,68
400995821,Butler Bulldogs,S. Brey,4068067,,True,36.0,2,4,2,4,0,0,2,3,3,5,8,3,3,0,0,2,6
400995821,Butler Bulldogs,T. Schickel,3914012,,True,40.0,11,17,11,17,0,0,5,6,2,7,9,2,3,1,1,3,27
400995821,Butler Bulldogs,M. Weaver,3914014,,True,34.0,4,4,2,2,2,2,0,0,2,1,3,3,1,1,2,1,10
400995821,Butler Bulldogs,W. Jennings,3142145,,True,38.0,5,14,2,6,3,8,3,4,0,2,2,4,0,0,6,2,16
400995821,Butler Bulldogs,I. Lathan,3079485,,True,20.0,1,4,1,4,0,0,0,0,1,4,5,1,0,0,3,2,2
400995821,Butler Bulldogs,K. Hodges,4068065,,False,2.0,0,0,0,0,0,0,0,0,0,2,2,0,0,0,0,1,0
400995821,Butler Bulldogs,K. Spolyar,4068068,,False,27.0,2,9,2,6,0,3,3,4,0,1,1,4,4,0,4,3,7
400995821,Butler Bulldogs,S. Buck,3142279,,False,3.0,0,0,0,0,0,0,0,0,0,0,0,0,0,0,0,0,0
400995821,Butler Bulldogs,TEAM,TOTAL,TOTAL,False,,25,52,20,39,5,13,13,17,9,24,33,17,11,2,16,14,68
400995820,Villanova Wildcats,M. Quinn,3056785,,True,22.0,3,8,3,5,0,3,3,4,0,7,7,1,0,1,0,1,9
400995820,Villanova Wildcats,J. Tucker,3087536,,True,33.0,3,8,0,3,3,5,0,0,1,2,3,3,1,4,0,2,9
400995820,Villanova Wildcats,K. Jekot,4068171,,True,27.0,1,9,1,6,0,3,0,0,0,4,4,2,0,0,2,1,2
400995820,Villanova Wildcats,A. Hahn,3906779,,True,36.0,2,4,2,2,0,2,0,0,0,1,1,3,0,0,1,2,4
400995820,Villanova Wildcats,A. Louin,3142314,,True,33.0,5,10,5,6,0,4,1,2,0,3,3,0,1,0,4,3,11
400995820,Villanova Wildcats,M. Gedaka,4068172,,False,18.0,5,9,5,9,0,0,1,3,2,3,5,2,0,0,1,2,11
400995820,Villanova Wildcats,B. Herlihy,3906778,,False,17.0,2,3,1,2,1,1,2,2,3,4,7,2,0,1,4,0,7
400995820,Villanova Wildcats,G. Stant,3906780,,False,11.0,1,4,0,0,1,4,1,2,0,1,1,0,0,0,0,1,4
400995820,Villanova Wildcats,C. Onken,4068167,,False,3.0,0,1,0,0,0,1,0,0,0,0,0,0,0,0,0,2,0
400995820,Villanova Wildcats,TEAM,TOTAL,TOTAL,False,,22,56,17,33,5,23,8,13,6,28,34,13,2,6,13,14,57
400995820,Villanova Wildcats,M. Quinn,3056785,,True,22.0,3,8,3,5,0,3,3,4,0,7,7,1,0,1,0,1,9
400995820,Villanova Wildcats,J. Tucker,3087536,,True,33.0,3,8,0,3,3,5,0,0,1,2,3,3,1,4,0,2,9
400995820,Villanova Wildcats,K. Jekot,4068171,,True,27.0,1,9,1,6,0,3,0,0,0,4,4,2,0,0,2,1,2
400995820,Villanova Wildcats,A. Hahn,3906779,,True,36.0,2,4,2,2,0,2,0,0,0,1,1,3,0,0,1,2,4
400995820,Villanova Wildcats,A. Louin,3142314,,True,33.0,5,10,5,6,0,4,1,2,0,3,3,0,1,0,4,3,11
400995820,Villanova Wildcats,M. Gedaka,4068172,,False,18.0,5,9,5,9,0,0,1,3,2,3,5,2,0,0,1,2,11
400995820,Villanova Wildcats,B. Herlihy,3906778,,False,17.0,2,3,1,2,1,1,2,2,3,4,7,2,0,1,4,0,7
400995820,Villanova Wildcats,G. Stant,3906780,,False,11.0,1,4,0,0,1,4,1,2,0,1,1,0,0,0,0,1,4
400995820,Villanova Wildcats,C. Onken,4068167,,False,3.0,0,1,0,0,0,1,0,0,0,0,0,0,0,0,0,2,0
400995820,Villanova Wildcats,TEAM,TOTAL,TOTAL,False,,22,56,17,33,5,23,8,13,6,28,34,13,2,6,13,14,57
400995820,Marquette Golden Eagles,E. Davenport,3906756,,True,33.0,8,16,7,15,1,1,5,5,7,5,12,0,1,0,4,4,22
400995820,Marquette Golden Eagles,A. Wilborn,3906758,,True,34.0,2,8,2,6,0,2,4,5,0,2,2,3,1,0,2,2,8
400995820,Marquette Golden Eagles,A. Blockton,3906755,,True,35.0,9,19,9,19,0,0,3,3,1,7,8,0,0,0,1,4,21
400995820,Marquette Golden Eagles,N. Hiedeman,3906753,,True,31.0,4,10,2,5,2,5,1,2,0,5,5,1,1,0,3,3,11
400995820,Marquette Golden Eagles,D. King,3906752,,True,34.0,2,7,2,6,0,1,1,2,0,3,3,2,1,0,0,1,5
400995820,Marquette Golden Eagles,A. Anderson,4068081,,False,1.0,0,0,0,0,0,0,0,0,0,0,0,0,0,0,0,0,0
400995820,Marquette Golden Eagles,L. Van Kleunen,4068083,,False,12.0,0,1,0,1,0,0,0,0,0,2,2,0,0,0,0,3,0
400995820,Marquette Golden Eagles,S. Lott,4281350,,False,15.0,0,0,0,0,0,0,0,0,2,3,5,0,0,1,0,2,0
400995820,Marquette Golden Eagles,I. Spingola,4068082,,False,5.0,0,1,0,0,0,1,0,0,0,0,0,0,0,0,0,1,0
400995820,Marquette Golden Eagles,TEAM,TOTAL,TOTAL,False,,25,62,22,52,3,10,14,17,10,30,40,6,4,1,10,20,67
400995820,Marquette Golden Eagles,E. Davenport,3906756,,True,33.0,8,16,7,15,1,1,5,5,7,5,12,0,1,0,4,4,22
400995820,Marquette Golden Eagles,A. Wilborn,3906758,,True,34.0,2,8,2,6,0,2,4,5,0,2,2,3,1,0,2,2,8
400995820,Marquette Golden Eagles,A. Blockton,3906755,,True,35.0,9,19,9,19,0,0,3,3,1,7,8,0,0,0,1,4,21
400995820,Marquette Golden Eagles,N. Hiedeman,3906753,,True,31.0,4,10,2,5,2,5,1,2,0,5,5,1,1,0,3,3,11
400995820,Marquette Golden Eagles,D. King,3906752,,True,34.0,2,7,2,6,0,1,1,2,0,3,3,2,1,0,0,1,5
400995820,Marquette Golden Eagles,A. Anderson,4068081,,False,1.0,0,0,0,0,0,0,0,0,0,0,0,0,0,0,0,0,0
400995820,Marquette Golden Eagles,L. Van Kleunen,4068083,,False,12.0,0,1,0,1,0,0,0,0,0,2,2,0,0,0,0,3,0
400995820,Marquette Golden Eagles,S. Lott,4281350,,False,15.0,0,0,0,0,0,0,0,0,2,3,5,0,0,1,0,2,0
400995820,Marquette Golden Eagles,I. Spingola,4068082,,False,5.0,0,1,0,0,0,1,0,0,0,0,0,0,0,0,0,1,0
400995820,Marquette Golden Eagles,TEAM,TOTAL,TOTAL,False,,25,62,22,52,3,10,14,17,10,30,40,6,4,1,10,20,67
400995819,Xavier Musketeers,I. Partlow,3142320,,True,26.0,3,7,3,7,0,0,1,5,2,4,6,2,1,0,3,2,7
400995819,Xavier Musketeers,A. Aijanen,3142319,,True,31.0,8,11,5,5,3,6,0,0,5,6,11,0,0,0,0,2,19
400995819,Xavier Musketeers,N. Owens,4068187,,True,22.0,2,5,1,1,1,4,0,0,0,1,1,2,1,0,3,1,5
400995819,Xavier Musketeers,J. Byrd,3142318,,True,30.0,5,7,5,7,0,0,1,1,0,1,1,4,1,0,3,1,11
400995819,Xavier Musketeers,K. Fincher,3142317,,True,22.0,5,11,2,5,3,6,1,2,1,2,3,1,1,0,2,1,14
400995819,Xavier Musketeers,A. Gray,4281368,,False,16.0,2,3,2,2,0,1,1,1,0,4,4,2,0,1,0,1,5
400995819,Xavier Musketeers,D. Ross,4281364,,False,7.0,0,2,0,1,0,1,0,0,0,2,2,1,0,0,1,0,0
400995819,Xavier Musketeers,A. Reiff,4281367,,False,2.0,0,0,0,0,0,0,0,0,0,0,0,0,0,0,0,0,0
400995819,Xavier Musketeers,P. Stewart,4281366,,False,7.0,0,1,0,0,0,1,0,0,0,2,2,0,0,0,0,0,0
400995819,Xavier Musketeers,A. Dunham,4281365,,False,26.0,1,4,0,1,1,3,4,7,0,3,3,1,1,0,0,0,7
400995819,Xavier Musketeers,A. Gomez,4068185,,False,10.0,0,1,0,0,0,1,0,0,0,0,0,1,0,0,0,1,0
400995819,Xavier Musketeers,TEAM,TOTAL,TOTAL,False,,26,52,18,29,8,23,8,16,8,27,35,14,5,1,12,9,68
400995819,Xavier Musketeers,I. Partlow,3142320,,True,26.0,3,7,3,7,0,0,1,5,2,4,6,2,1,0,3,2,7
400995819,Xavier Musketeers,A. Aijanen,3142319,,True,31.0,8,11,5,5,3,6,0,0,5,6,11,0,0,0,0,2,19
400995819,Xavier Musketeers,N. Owens,4068187,,True,22.0,2,5,1,1,1,4,0,0,0,1,1,2,1,0,3,1,5
400995819,Xavier Musketeers,J. Byrd,3142318,,True,30.0,5,7,5,7,0,0,1,1,0,1,1,4,1,0,3,1,11
400995819,Xavier Musketeers,K. Fincher,3142317,,True,22.0,5,11,2,5,3,6,1,2,1,2,3,1,1,0,2,1,14
400995819,Xavier Musketeers,A. Gray,4281368,,False,16.0,2,3,2,2,0,1,1,1,0,4,4,2,0,1,0,1,5
400995819,Xavier Musketeers,D. Ross,4281364,,False,7.0,0,2,0,1,0,1,0,0,0,2,2,1,0,0,1,0,0
400995819,Xavier Musketeers,A. Reiff,4281367,,False,2.0,0,0,0,0,0,0,0,0,0,0,0,0,0,0,0,0,0
400995819,Xavier Musketeers,P. Stewart,4281366,,False,7.0,0,1,0,0,0,1,0,0,0,2,2,0,0,0,0,0,0
400995819,Xavier Musketeers,A. Dunham,4281365,,False,26.0,1,4,0,1,1,3,4,7,0,3,3,1,1,0,0,0,7
400995819,Xavier Musketeers,A. Gomez,4068185,,False,10.0,0,1,0,0,0,1,0,0,0,0,0,1,0,0,0,1,0
400995819,Xavier Musketeers,TEAM,TOTAL,TOTAL,False,,26,52,18,29,8,23,8,16,8,27,35,14,5,1,12,9,68
400995819,Providence Friars,B. Frias,3142302,,True,6.0,0,0,0,0,0,0,0,0,0,0,0,0,0,1,0,1,0
400995819,Providence Friars,K. Spiwak,4281346,,True,18.0,0,1,0,1,0,0,1,2,0,1,1,1,0,0,1,1,1
400995819,Providence Friars,C. Williams,4281345,,True,28.0,4,8,4,8,0,0,0,0,0,3,3,4,0,0,1,4,8
400995819,Providence Friars,J. Nogic,3906769,,True,28.0,6,14,3,7,3,7,0,0,0,5,5,2,0,0,1,2,15
400995819,Providence Friars,M. Jolin,3906767,,True,29.0,7,12,4,8,3,4,2,2,1,4,5,3,2,0,1,0,19
400995819,Providence Friars,A. Cooper,4281349,,False,16.0,0,3,0,3,0,0,1,2,1,2,3,0,0,3,0,3,1
400995819,Providence Friars,N. Franklin,4281348,,False,22.0,2,5,2,5,0,0,1,4,0,3,3,1,1,1,1,0,5
400995819,Providence Friars,O. Orlando,4281347,,False,3.0,0,0,0,0,0,0,0,0,0,0,0,1,0,0,0,0,0
400995819,Providence Friars,N. Jackson,4068111,,False,14.0,0,0,0,0,0,0,0,0,0,2,2,2,0,0,2,3,0
400995819,Providence Friars,C. Che,3906766,,False,25.0,4,5,2,2,2,3,0,0,0,1,1,3,0,0,2,1,10
400995819,Providence Friars,A. Botteghi,3142301,,False,11.0,0,4,0,3,0,1,0,0,1,1,2,0,0,0,0,1,0
400995819,Providence Friars,TEAM,TOTAL,TOTAL,False,,23,52,15,37,8,15,5,10,5,23,28,17,3,5,9,16,59
400995819,Providence Friars,B. Frias,3142302,,True,6.0,0,0,0,0,0,0,0,0,0,0,0,0,0,1,0,1,0
400995819,Providence Friars,K. Spiwak,4281346,,True,18.0,0,1,0,1,0,0,1,2,0,1,1,1,0,0,1,1,1
400995819,Providence Friars,C. Williams,4281345,,True,28.0,4,8,4,8,0,0,0,0,0,3,3,4,0,0,1,4,8
400995819,Providence Friars,J. Nogic,3906769,,True,28.0,6,14,3,7,3,7,0,0,0,5,5,2,0,0,1,2,15
400995819,Providence Friars,M. Jolin,3906767,,True,29.0,7,12,4,8,3,4,2,2,1,4,5,3,2,0,1,0,19
400995819,Providence Friars,A. Cooper,4281349,,False,16.0,0,3,0,3,0,0,1,2,1,2,3,0,0,3,0,3,1
400995819,Providence Friars,N. Franklin,4281348,,False,22.0,2,5,2,5,0,0,1,4,0,3,3,1,1,1,1,0,5
400995819,Providence Friars,O. Orlando,4281347,,False,3.0,0,0,0,0,0,0,0,0,0,0,0,1,0,0,0,0,0
400995819,Providence Friars,N. Jackson,4068111,,False,14.0,0,0,0,0,0,0,0,0,0,2,2,2,0,0,2,3,0
400995819,Providence Friars,C. Che,3906766,,False,25.0,4,5,2,2,2,3,0,0,0,1,1,3,0,0,2,1,10
400995819,Providence Friars,A. Botteghi,3142301,,False,11.0,0,4,0,3,0,1,0,0,1,1,2,0,0,0,0,1,0
400995819,Providence Friars,TEAM,TOTAL,TOTAL,False,,23,52,15,37,8,15,5,10,5,23,28,17,3,5,9,16,59
400995818,Villanova Wildcats,M. Quinn,3056785,,True,13.0,2,7,2,6,0,1,6,6,2,5,7,2,0,0,1,3,10
400995818,Villanova Wildcats,J. Tucker,3087536,,True,27.0,3,6,0,0,3,6,0,0,0,1,1,0,1,0,0,1,9
400995818,Villanova Wildcats,K. Jekot,4068171,,True,33.0,3,6,2,4,1,2,0,0,2,3,5,2,2,0,1,0,7
400995818,Villanova Wildcats,A. Hahn,3906779,,True,38.0,7,10,4,5,3,5,0,0,1,2,3,7,2,0,0,1,17
400995818,Villanova Wildcats,A. Louin,3142314,,True,35.0,7,8,6,7,1,1,2,2,2,7,9,1,0,1,2,2,17
400995818,Villanova Wildcats,M. Gedaka,4068172,,False,25.0,7,13,7,12,0,1,0,0,2,2,4,4,0,1,2,1,14
400995818,Villanova Wildcats,B. Herlihy,4068169,,False,1.0,0,0,0,0,0,0,0,0,0,1,1,0,0,0,2,2,0
400995818,Villanova Wildcats,B. Herlihy,3906778,,False,17.0,3,6,2,3,1,3,0,0,0,1,1,3,2,0,0,1,7
400995818,Villanova Wildcats,G. Stant,3906780,,False,7.0,1,2,0,0,1,2,0,0,0,0,0,1,0,0,0,0,3
400995818,Villanova Wildcats,R. James,4068168,,False,1.0,0,0,0,0,0,0,0,0,0,0,0,0,0,0,0,0,0
400995818,Villanova Wildcats,C. Onken,4068167,,False,2.0,0,0,0,0,0,0,0,0,0,0,0,0,1,0,0,0,0
400995818,Villanova Wildcats,TEAM,TOTAL,TOTAL,False,,33,58,23,37,10,21,8,8,9,24,33,20,8,2,8,11,84
400995818,Villanova Wildcats,M. Quinn,3056785,,True,13.0,2,7,2,6,0,1,6,6,2,5,7,2,0,0,1,3,10
400995818,Villanova Wildcats,J. Tucker,3087536,,True,27.0,3,6,0,0,3,6,0,0,0,1,1,0,1,0,0,1,9
400995818,Villanova Wildcats,K. Jekot,4068171,,True,33.0,3,6,2,4,1,2,0,0,2,3,5,2,2,0,1,0,7
400995818,Villanova Wildcats,A. Hahn,3906779,,True,38.0,7,10,4,5,3,5,0,0,1,2,3,7,2,0,0,1,17
400995818,Villanova Wildcats,A. Louin,3142314,,True,35.0,7,8,6,7,1,1,2,2,2,7,9,1,0,1,2,2,17
400995818,Villanova Wildcats,M. Gedaka,4068172,,False,25.0,7,13,7,12,0,1,0,0,2,2,4,4,0,1,2,1,14
400995818,Villanova Wildcats,B. Herlihy,4068169,,False,1.0,0,0,0,0,0,0,0,0,0,1,1,0,0,0,2,2,0
400995818,Villanova Wildcats,B. Herlihy,3906778,,False,17.0,3,6,2,3,1,3,0,0,0,1,1,3,2,0,0,1,7
400995818,Villanova Wildcats,G. Stant,3906780,,False,7.0,1,2,0,0,1,2,0,0,0,0,0,1,0,0,0,0,3
400995818,Villanova Wildcats,R. James,4068168,,False,1.0,0,0,0,0,0,0,0,0,0,0,0,0,0,0,0,0,0
400995818,Villanova Wildcats,C. Onken,4068167,,False,2.0,0,0,0,0,0,0,0,0,0,0,0,0,1,0,0,0,0
400995818,Villanova Wildcats,TEAM,TOTAL,TOTAL,False,,33,58,23,37,10,21,8,8,9,24,33,20,8,2,8,11,84
400995818,DePaul Blue Demons,M. Grays,3142287,,True,26.0,3,8,3,4,0,4,2,2,3,3,6,2,0,0,3,2,8
400995818,DePaul Blue Demons,K. Campbell,4068071,,True,38.0,4,10,1,6,3,4,1,2,5,4,9,3,0,0,1,2,12
400995818,DePaul Blue Demons,L. Prochaska,3142290,,True,16.0,0,2,0,1,0,1,0,0,0,1,1,1,0,0,1,0,0
400995818,DePaul Blue Demons,A. Millender,3142289,,True,32.0,3,8,0,1,3,7,0,0,0,3,3,1,0,0,1,1,9
400995818,DePaul Blue Demons,A. Coleman,3142123,,True,30.0,5,10,2,4,3,6,0,0,2,1,3,5,0,1,3,1,13
400995818,DePaul Blue Demons,R. McLimore,4281358,,False,1.0,0,0,0,0,0,0,0,0,0,0,0,0,0,0,0,0,0
400995818,DePaul Blue Demons,C. Stonewall,4068072,,False,22.0,0,8,0,4,0,4,0,0,3,1,4,0,0,0,1,2,0
400995818,DePaul Blue Demons,V. Sherrod,4281359,,False,1.0,0,1,0,1,0,0,0,0,0,0,0,0,1,0,0,0,0
400995818,DePaul Blue Demons,D. Bekelja,4281356,,False,2.0,1,2,1,1,0,1,0,0,0,0,0,0,0,0,1,0,2
400995818,DePaul Blue Demons,D. Cage,4068073,,False,14.0,2,3,2,2,0,1,0,0,0,1,1,3,0,0,2,1,4
400995818,DePaul Blue Demons,T. Allen,3933760,,False,18.0,4,10,3,5,1,5,1,2,1,0,1,0,0,0,3,0,10
400995818,DePaul Blue Demons,TEAM,TOTAL,TOTAL,False,,22,62,12,29,10,33,4,6,16,15,31,15,1,1,16,9,58
400995818,DePaul Blue Demons,M. Grays,3142287,,True,26.0,3,8,3,4,0,4,2,2,3,3,6,2,0,0,3,2,8
400995818,DePaul Blue Demons,K. Campbell,4068071,,True,38.0,4,10,1,6,3,4,1,2,5,4,9,3,0,0,1,2,12
400995818,DePaul Blue Demons,L. Prochaska,3142290,,True,16.0,0,2,0,1,0,1,0,0,0,1,1,1,0,0,1,0,0
400995818,DePaul Blue Demons,A. Millender,3142289,,True,32.0,3,8,0,1,3,7,0,0,0,3,3,1,0,0,1,1,9
400995818,DePaul Blue Demons,A. Coleman,3142123,,True,30.0,5,10,2,4,3,6,0,0,2,1,3,5,0,1,3,1,13
400995818,DePaul Blue Demons,R. McLimore,4281358,,False,1.0,0,0,0,0,0,0,0,0,0,0,0,0,0,0,0,0,0
400995818,DePaul Blue Demons,C. Stonewall,4068072,,False,22.0,0,8,0,4,0,4,0,0,3,1,4,0,0,0,1,2,0
400995818,DePaul Blue Demons,V. Sherrod,4281359,,False,1.0,0,1,0,1,0,0,0,0,0,0,0,0,1,0,0,0,0
400995818,DePaul Blue Demons,D. Bekelja,4281356,,False,2.0,1,2,1,1,0,1,0,0,0,0,0,0,0,0,1,0,2
400995818,DePaul Blue Demons,D. Cage,4068073,,False,14.0,2,3,2,2,0,1,0,0,0,1,1,3,0,0,2,1,4
400995818,DePaul Blue Demons,T. Allen,3933760,,False,18.0,4,10,3,5,1,5,1,2,1,0,1,0,0,0,3,0,10
400995818,DePaul Blue Demons,TEAM,TOTAL,TOTAL,False,,22,62,12,29,10,33,4,6,16,15,31,15,1,1,16,9,58
400995817,Marquette Golden Eagles,E. Davenport,3906756,,True,25.0,5,11,5,10,0,1,0,0,2,4,6,0,1,0,6,3,10
400995817,Marquette Golden Eagles,A. Wilborn,3906758,,True,39.0,7,13,5,10,2,3,4,4,0,4,4,4,1,0,1,3,20
400995817,Marquette Golden Eagles,A. Blockton,3906755,,True,26.0,2,8,2,4,0,4,2,2,4,7,11,3,0,2,4,3,6
400995817,Marquette Golden Eagles,N. Hiedeman,3906753,,True,25.0,3,10,1,4,2,6,0,0,0,2,2,1,1,2,3,2,8
400995817,Marquette Golden Eagles,D. King,3906752,,True,27.0,0,5,0,3,0,2,6,6,1,0,1,4,2,0,3,1,6
400995817,Marquette Golden Eagles,M. Smith Traore,4281351,,False,4.0,0,1,0,1,0,0,0,0,2,0,2,1,0,0,0,2,0
400995817,Marquette Golden Eagles,A. Anderson,4068081,,False,6.0,1,2,1,2,0,0,0,0,1,0,1,1,1,1,0,0,2
400995817,Marquette Golden Eagles,L. Van Kleunen,4068083,,False,16.0,1,6,1,4,0,2,0,0,3,2,5,0,0,1,2,1,2
400995817,Marquette Golden Eagles,S. Valentine,3142300,,False,1.0,0,0,0,0,0,0,0,0,0,0,0,0,0,0,0,0,0
400995817,Marquette Golden Eagles,S. Lott,4281350,,False,18.0,1,3,0,0,1,3,0,2,1,1,2,0,1,0,1,0,3
400995817,Marquette Golden Eagles,I. Spingola,4068082,,False,13.0,0,5,0,0,0,5,1,2,0,0,0,0,0,0,0,0,1
400995817,Marquette Golden Eagles,TEAM,TOTAL,TOTAL,False,,20,64,15,38,5,26,13,16,14,22,36,14,7,6,21,15,58
400995817,Marquette Golden Eagles,E. Davenport,3906756,,True,25.0,5,11,5,10,0,1,0,0,2,4,6,0,1,0,6,3,10
400995817,Marquette Golden Eagles,A. Wilborn,3906758,,True,39.0,7,13,5,10,2,3,4,4,0,4,4,4,1,0,1,3,20
400995817,Marquette Golden Eagles,A. Blockton,3906755,,True,26.0,2,8,2,4,0,4,2,2,4,7,11,3,0,2,4,3,6
400995817,Marquette Golden Eagles,N. Hiedeman,3906753,,True,25.0,3,10,1,4,2,6,0,0,0,2,2,1,1,2,3,2,8
400995817,Marquette Golden Eagles,D. King,3906752,,True,27.0,0,5,0,3,0,2,6,6,1,0,1,4,2,0,3,1,6
400995817,Marquette Golden Eagles,M. Smith Traore,4281351,,False,4.0,0,1,0,1,0,0,0,0,2,0,2,1,0,0,0,2,0
400995817,Marquette Golden Eagles,A. Anderson,4068081,,False,6.0,1,2,1,2,0,0,0,0,1,0,1,1,1,1,0,0,2
400995817,Marquette Golden Eagles,L. Van Kleunen,4068083,,False,16.0,1,6,1,4,0,2,0,0,3,2,5,0,0,1,2,1,2
400995817,Marquette Golden Eagles,S. Valentine,3142300,,False,1.0,0,0,0,0,0,0,0,0,0,0,0,0,0,0,0,0,0
400995817,Marquette Golden Eagles,S. Lott,4281350,,False,18.0,1,3,0,0,1,3,0,2,1,1,2,0,1,0,1,0,3
400995817,Marquette Golden Eagles,I. Spingola,4068082,,False,13.0,0,5,0,0,0,5,1,2,0,0,0,0,0,0,0,0,1
400995817,Marquette Golden Eagles,TEAM,TOTAL,TOTAL,False,,20,64,15,38,5,26,13,16,14,22,36,14,7,6,21,15,58
400995817,Georgetown Hoyas,C. Petke,4068078,,True,35.0,9,16,9,13,0,3,8,8,3,9,12,3,4,1,3,0,26
400995817,Georgetown Hoyas,Y. Belk,3142295,,True,21.0,3,6,3,6,0,0,0,0,0,10,10,2,1,4,2,3,6
400995817,Georgetown Hoyas,D. White,3948815,,True,29.0,8,18,8,16,0,2,1,2,3,4,7,4,1,1,2,4,17
400995817,Georgetown Hoyas,D. Burton,3142292,,True,30.0,1,3,0,2,1,1,1,2,0,0,0,8,1,0,1,0,4
400995817,Georgetown Hoyas,M. Venson,3142105,,True,25.0,6,8,4,5,2,3,2,2,0,2,2,0,1,0,2,3,16
400995817,Georgetown Hoyas,T. Thompson,4281352,,False,22.0,2,7,1,6,1,1,0,0,0,2,2,1,0,0,1,1,5
400995817,Georgetown Hoyas,M. Smith,4068079,,False,32.0,3,7,2,6,1,1,2,2,2,2,4,0,5,0,1,3,9
400995817,Georgetown Hoyas,B. Mayfield,4281354,,False,2.0,1,1,1,1,0,0,0,0,0,1,1,0,0,0,1,1,2
400995817,Georgetown Hoyas,L. Kimball,4281353,,False,2.0,0,0,0,0,0,0,0,0,0,0,0,0,0,0,0,0,0
400995817,Georgetown Hoyas,M. Osagie-Erese,4072597,,False,2.0,0,0,0,0,0,0,0,0,0,0,0,0,0,0,1,1,0
400995817,Georgetown Hoyas,TEAM,TOTAL,TOTAL,False,,33,66,28,55,5,11,14,16,10,31,41,18,13,6,15,16,85
400995817,Georgetown Hoyas,C. Petke,4068078,,True,35.0,9,16,9,13,0,3,8,8,3,9,12,3,4,1,3,0,26
400995817,Georgetown Hoyas,Y. Belk,3142295,,True,21.0,3,6,3,6,0,0,0,0,0,10,10,2,1,4,2,3,6
400995817,Georgetown Hoyas,D. White,3948815,,True,29.0,8,18,8,16,0,2,1,2,3,4,7,4,1,1,2,4,17
400995817,Georgetown Hoyas,D. Burton,3142292,,True,30.0,1,3,0,2,1,1,1,2,0,0,0,8,1,0,1,0,4
400995817,Georgetown Hoyas,M. Venson,3142105,,True,25.0,6,8,4,5,2,3,2,2,0,2,2,0,1,0,2,3,16
400995817,Georgetown Hoyas,T. Thompson,4281352,,False,22.0,2,7,1,6,1,1,0,0,0,2,2,1,0,0,1,1,5
400995817,Georgetown Hoyas,M. Smith,4068079,,False,32.0,3,7,2,6,1,1,2,2,2,2,4,0,5,0,1,3,9
400995817,Georgetown Hoyas,B. Mayfield,4281354,,False,2.0,1,1,1,1,0,0,0,0,0,1,1,0,0,0,1,1,2
400995817,Georgetown Hoyas,L. Kimball,4281353,,False,2.0,0,0,0,0,0,0,0,0,0,0,0,0,0,0,0,0,0
400995817,Georgetown Hoyas,M. Osagie-Erese,4072597,,False,2.0,0,0,0,0,0,0,0,0,0,0,0,0,0,0,1,1,0
400995817,Georgetown Hoyas,TEAM,TOTAL,TOTAL,False,,33,66,28,55,5,11,14,16,10,31,41,18,13,6,15,16,85
400995816,Creighton Bluejays,A. Faber,3938938,,True,40.0,6,13,3,6,3,7,2,4,0,5,5,3,0,0,4,2,17
400995816,Creighton Bluejays,J. Agnew,3938935,,True,40.0,4,7,4,6,0,1,0,0,1,5,6,2,1,2,1,3,8
400995816,Creighton Bluejays,B. Norby,3142284,,True,10.0,2,7,1,5,1,2,0,0,2,1,3,0,0,0,1,1,5
400995816,Creighton Bluejays,S. Lamberty,3142285,,True,39.0,2,5,2,4,0,1,0,0,0,8,8,0,0,1,1,0,4
400995816,Creighton Bluejays,M. Mellman,3142283,,True,6.0,0,3,0,2,0,1,0,0,0,0,0,1,1,0,0,0,0
400995816,Creighton Bluejays,A. Greene,3938937,,False,5.0,0,0,0,0,0,0,0,0,0,0,0,0,1,0,1,1,0
400995816,Creighton Bluejays,K. Brown,3142286,,False,3.0,0,3,0,3,0,0,0,0,0,0,0,0,0,0,0,0,0
400995816,Creighton Bluejays,T. Carda,4281362,,False,29.0,2,9,2,5,0,4,1,2,2,5,7,1,2,0,1,2,5
400995816,Creighton Bluejays,T. Rembao,4281361,,False,2.0,0,0,0,0,0,0,2,2,0,0,0,0,0,0,1,0,2
400995816,Creighton Bluejays,O. Elger,3938936,,False,26.0,4,9,3,5,1,4,3,5,0,1,1,1,0,0,0,4,12
400995816,Creighton Bluejays,TEAM,TOTAL,TOTAL,False,,20,56,15,36,5,20,8,13,5,30,35,8,5,3,10,13,53
400995816,Creighton Bluejays,A. Faber,3938938,,True,40.0,6,13,3,6,3,7,2,4,0,5,5,3,0,0,4,2,17
400995816,Creighton Bluejays,J. Agnew,3938935,,True,40.0,4,7,4,6,0,1,0,0,1,5,6,2,1,2,1,3,8
400995816,Creighton Bluejays,B. Norby,3142284,,True,10.0,2,7,1,5,1,2,0,0,2,1,3,0,0,0,1,1,5
400995816,Creighton Bluejays,S. Lamberty,3142285,,True,39.0,2,5,2,4,0,1,0,0,0,8,8,0,0,1,1,0,4
400995816,Creighton Bluejays,M. Mellman,3142283,,True,6.0,0,3,0,2,0,1,0,0,0,0,0,1,1,0,0,0,0
400995816,Creighton Bluejays,A. Greene,3938937,,False,5.0,0,0,0,0,0,0,0,0,0,0,0,0,1,0,1,1,0
400995816,Creighton Bluejays,K. Brown,3142286,,False,3.0,0,3,0,3,0,0,0,0,0,0,0,0,0,0,0,0,0
400995816,Creighton Bluejays,T. Carda,4281362,,False,29.0,2,9,2,5,0,4,1,2,2,5,7,1,2,0,1,2,5
400995816,Creighton Bluejays,T. Rembao,4281361,,False,2.0,0,0,0,0,0,0,2,2,0,0,0,0,0,0,1,0,2
400995816,Creighton Bluejays,O. Elger,3938936,,False,26.0,4,9,3,5,1,4,3,5,0,1,1,1,0,0,0,4,12
400995816,Creighton Bluejays,TEAM,TOTAL,TOTAL,False,,20,56,15,36,5,20,8,13,5,30,35,8,5,3,10,13,53
400995816,Butler Bulldogs,S. Brey,4068067,,True,33.0,2,4,2,4,0,0,0,0,2,10,12,4,1,0,0,0,4
400995816,Butler Bulldogs,T. Schickel,3914012,,True,39.0,6,10,6,10,0,0,1,3,2,7,9,4,3,1,3,3,13
400995816,Butler Bulldogs,M. Weaver,3914014,,True,37.0,4,10,3,4,1,6,1,2,0,2,2,2,0,2,0,4,10
400995816,Butler Bulldogs,W. Jennings,3142145,,True,39.0,5,17,2,11,3,6,4,4,0,6,6,3,1,0,2,0,17
400995816,Butler Bulldogs,I. Lathan,3079485,,True,18.0,3,12,3,12,0,0,0,0,1,2,3,1,0,0,1,3,6
400995816,Butler Bulldogs,K. Spolyar,4068068,,False,32.0,4,10,3,5,1,5,0,2,2,4,6,1,2,1,1,5,9
400995816,Butler Bulldogs,S. Buck,3142279,,False,2.0,0,0,0,0,0,0,0,0,0,1,1,0,0,0,0,0,0
400995816,Butler Bulldogs,TEAM,TOTAL,TOTAL,False,,24,63,19,46,5,17,6,11,10,32,42,15,7,4,8,15,59
400995816,Butler Bulldogs,S. Brey,4068067,,True,33.0,2,4,2,4,0,0,0,0,2,10,12,4,1,0,0,0,4
400995816,Butler Bulldogs,T. Schickel,3914012,,True,39.0,6,10,6,10,0,0,1,3,2,7,9,4,3,1,3,3,13
400995816,Butler Bulldogs,M. Weaver,3914014,,True,37.0,4,10,3,4,1,6,1,2,0,2,2,2,0,2,0,4,10
400995816,Butler Bulldogs,W. Jennings,3142145,,True,39.0,5,17,2,11,3,6,4,4,0,6,6,3,1,0,2,0,17
400995816,Butler Bulldogs,I. Lathan,3079485,,True,18.0,3,12,3,12,0,0,0,0,1,2,3,1,0,0,1,3,6
400995816,Butler Bulldogs,K. Spolyar,4068068,,False,32.0,4,10,3,5,1,5,0,2,2,4,6,1,2,1,1,5,9
400995816,Butler Bulldogs,S. Buck,3142279,,False,2.0,0,0,0,0,0,0,0,0,0,1,1,0,0,0,0,0,0
400995816,Butler Bulldogs,TEAM,TOTAL,TOTAL,False,,24,63,19,46,5,17,6,11,10,32,42,15,7,4,8,15,59
400995815,Villanova Wildcats,M. Quinn,3056785,,True,18.0,2,6,2,4,0,2,0,0,0,1,1,1,1,0,1,1,4
400995815,Villanova Wildcats,J. Tucker,3087536,,True,34.0,6,14,1,3,5,11,0,0,1,0,1,2,0,0,3,1,17
400995815,Villanova Wildcats,K. Jekot,4068171,,True,37.0,3,7,0,3,3,4,1,2,2,6,8,5,1,1,2,0,10
400995815,Villanova Wildcats,A. Hahn,3906779,,True,38.0,3,9,1,1,2,8,0,0,1,2,3,2,0,0,0,2,8
400995815,Villanova Wildcats,A. Louin,3142314,,True,35.0,5,8,3,5,2,3,7,7,2,5,7,6,1,0,4,3,19
400995815,Villanova Wildcats,M. Gedaka,4068172,,False,28.0,6,9,6,9,0,0,7,9,5,5,10,2,0,0,2,4,19
400995815,Villanova Wildcats,B. Herlihy,4068169,,False,3.0,0,1,0,0,0,1,0,0,0,0,0,0,0,0,1,0,0
400995815,Villanova Wildcats,B. Herlihy,3906778,,False,3.0,0,1,0,0,0,1,0,0,0,0,0,0,0,0,0,0,0
400995815,Villanova Wildcats,G. Stant,3906780,,False,4.0,0,1,0,0,0,1,0,0,0,1,1,1,0,0,0,0,0
400995815,Villanova Wildcats,TEAM,TOTAL,TOTAL,False,,25,56,13,25,12,31,15,18,12,24,36,19,3,1,13,11,77
400995815,Pennsylvania Quakers,E. Parker,4281388,,True,36.0,10,16,10,16,0,0,5,6,3,6,9,0,3,3,3,4,25
400995815,Pennsylvania Quakers,M. Nwokedi,3142607,,True,37.0,7,15,5,10,2,5,1,1,3,5,8,1,1,1,0,3,17
400995815,Pennsylvania Quakers,A. Russell,3944326,,True,35.0,3,7,3,5,0,2,0,0,3,1,4,5,0,0,1,3,6
400995815,Pennsylvania Quakers,L. Whitlatch,3142606,,True,34.0,5,11,1,1,4,10,2,2,0,4,4,5,1,1,1,3,16
400995815,Pennsylvania Quakers,A. Ross,3142604,,True,38.0,4,11,4,9,0,2,3,3,1,2,3,8,2,0,1,2,11
400995815,Pennsylvania Quakers,P. Aghayere,3944329,,False,7.0,2,4,2,3,0,1,0,0,1,1,2,0,0,0,0,1,4
400995815,Pennsylvania Quakers,K. Kinum,4281387,,False,3.0,0,1,0,0,0,1,0,0,0,0,0,0,0,0,0,0,0
400995815,Pennsylvania Quakers,P. Sterba,4068597,,False,4.0,0,0,0,0,0,0,0,0,0,0,0,0,0,0,0,1,0
400995815,Pennsylvania Quakers,K. Grasela,4068595,,False,2.0,0,0,0,0,0,0,0,0,0,0,0,0,0,0,0,0,0
400995815,Pennsylvania Quakers,B. Brzozowski,3142605,,False,4.0,0,2,0,0,0,2,0,0,0,0,0,0,0,0,0,2,0
400995815,Pennsylvania Quakers,TEAM,TOTAL,TOTAL,False,,31,67,25,44,6,23,11,12,13,21,34,19,7,5,6,19,79
400995814,DePaul Blue Demons,C. Stonewall,4068072,,True,28.0,5,10,3,6,2,4,0,0,3,5,8,1,2,0,1,1,12
400995814,DePaul Blue Demons,M. Grays,3142287,,True,28.0,7,13,5,7,2,6,4,7,1,2,3,1,2,1,2,3,20
400995814,DePaul Blue Demons,K. Campbell,4068071,,True,27.0,3,6,1,1,2,5,2,4,3,3,6,5,0,0,1,2,10
400995814,DePaul Blue Demons,A. Millender,3142289,,True,33.0,8,13,6,7,2,6,2,4,2,5,7,3,3,0,1,2,20
400995814,DePaul Blue Demons,A. Coleman,3142123,,True,25.0,4,11,3,7,1,4,1,3,1,1,2,4,3,0,4,2,10
400995814,DePaul Blue Demons,R. McLimore,4281358,,False,6.0,0,1,0,0,0,1,0,0,0,0,0,2,0,0,0,2,0
400995814,DePaul Blue Demons,V. Sherrod,4281359,,False,3.0,0,0,0,0,0,0,0,0,0,0,0,0,0,0,1,0,0
400995814,DePaul Blue Demons,D. Bekelja,4281356,,False,4.0,0,0,0,0,0,0,0,0,0,1,1,0,0,0,0,0,0
400995814,DePaul Blue Demons,D. Cage,4068073,,False,9.0,0,2,0,0,0,2,2,3,0,0,0,0,1,0,2,0,2
400995814,DePaul Blue Demons,T. Allen,3933760,,False,20.0,4,7,2,2,2,5,0,0,1,7,8,2,1,1,2,1,10
400995814,DePaul Blue Demons,L. Prochaska,3142290,,False,17.0,1,4,0,1,1,3,0,0,1,0,1,5,1,1,3,2,3
400995814,DePaul Blue Demons,TEAM,TOTAL,TOTAL,False,,32,67,20,31,12,36,11,21,12,25,37,23,13,3,17,15,87
400995814,DePaul Blue Demons,C. Stonewall,4068072,,True,28.0,5,10,3,6,2,4,0,0,3,5,8,1,2,0,1,1,12
400995814,DePaul Blue Demons,M. Grays,3142287,,True,28.0,7,13,5,7,2,6,4,7,1,2,3,1,2,1,2,3,20
400995814,DePaul Blue Demons,K. Campbell,4068071,,True,27.0,3,6,1,1,2,5,2,4,3,3,6,5,0,0,1,2,10
400995814,DePaul Blue Demons,A. Millender,3142289,,True,33.0,8,13,6,7,2,6,2,4,2,5,7,3,3,0,1,2,20
400995814,DePaul Blue Demons,A. Coleman,3142123,,True,25.0,4,11,3,7,1,4,1,3,1,1,2,4,3,0,4,2,10
400995814,DePaul Blue Demons,R. McLimore,4281358,,False,6.0,0,1,0,0,0,1,0,0,0,0,0,2,0,0,0,2,0
400995814,DePaul Blue Demons,V. Sherrod,4281359,,False,3.0,0,0,0,0,0,0,0,0,0,0,0,0,0,0,1,0,0
400995814,DePaul Blue Demons,D. Bekelja,4281356,,False,4.0,0,0,0,0,0,0,0,0,0,1,1,0,0,0,0,0,0
400995814,DePaul Blue Demons,D. Cage,4068073,,False,9.0,0,2,0,0,0,2,2,3,0,0,0,0,1,0,2,0,2
400995814,DePaul Blue Demons,T. Allen,3933760,,False,20.0,4,7,2,2,2,5,0,0,1,7,8,2,1,1,2,1,10
400995814,DePaul Blue Demons,L. Prochaska,3142290,,False,17.0,1,4,0,1,1,3,0,0,1,0,1,5,1,1,3,2,3
400995814,DePaul Blue Demons,TEAM,TOTAL,TOTAL,False,,32,67,20,31,12,36,11,21,12,25,37,23,13,3,17,15,87
400995814,Butler Bulldogs,S. Brey,4068067,,True,25.0,1,1,1,1,0,0,0,0,1,8,9,2,0,1,3,4,2
400995814,Butler Bulldogs,T. Schickel,3914012,,True,38.0,7,15,7,15,0,0,3,4,2,6,8,1,1,0,3,0,17
400995814,Butler Bulldogs,M. Weaver,3914014,,True,38.0,5,7,5,7,0,0,2,2,2,3,5,4,4,0,3,4,12
400995814,Butler Bulldogs,W. Jennings,3142145,,True,38.0,7,16,4,10,3,6,1,2,0,2,2,5,3,1,5,3,18
400995814,Butler Bulldogs,I. Lathan,3079485,,True,18.0,3,5,3,5,0,0,0,0,0,4,4,1,0,0,3,4,6
400995814,Butler Bulldogs,A. Aube,4281363,,False,1.0,0,1,0,0,0,1,0,0,0,0,0,0,0,0,1,0,0
400995814,Butler Bulldogs,K. Hodges,4068065,,False,2.0,0,1,0,1,0,0,0,0,2,0,2,0,0,0,0,0,0
400995814,Butler Bulldogs,S. Humphrey,4068066,,False,3.0,0,0,0,0,0,0,0,0,0,0,0,0,0,0,0,0,0
400995814,Butler Bulldogs,K. Spolyar,4068068,,False,31.0,4,11,4,7,0,4,0,2,1,4,5,3,1,0,6,4,8
400995814,Butler Bulldogs,S. Buck,3142279,,False,6.0,1,4,1,1,0,3,0,0,0,0,0,0,0,0,0,0,2
400995814,Butler Bulldogs,TEAM,TOTAL,TOTAL,False,,28,61,25,47,3,14,6,10,10,28,38,16,9,2,24,19,65
400995814,Butler Bulldogs,S. Brey,4068067,,True,25.0,1,1,1,1,0,0,0,0,1,8,9,2,0,1,3,4,2
400995814,Butler Bulldogs,T. Schickel,3914012,,True,38.0,7,15,7,15,0,0,3,4,2,6,8,1,1,0,3,0,17
400995814,Butler Bulldogs,M. Weaver,3914014,,True,38.0,5,7,5,7,0,0,2,2,2,3,5,4,4,0,3,4,12
400995814,Butler Bulldogs,W. Jennings,3142145,,True,38.0,7,16,4,10,3,6,1,2,0,2,2,5,3,1,5,3,18
400995814,Butler Bulldogs,I. Lathan,3079485,,True,18.0,3,5,3,5,0,0,0,0,0,4,4,1,0,0,3,4,6
400995814,Butler Bulldogs,A. Aube,4281363,,False,1.0,0,1,0,0,0,1,0,0,0,0,0,0,0,0,1,0,0
400995814,Butler Bulldogs,K. Hodges,4068065,,False,2.0,0,1,0,1,0,0,0,0,2,0,2,0,0,0,0,0,0
400995814,Butler Bulldogs,S. Humphrey,4068066,,False,3.0,0,0,0,0,0,0,0,0,0,0,0,0,0,0,0,0,0
400995814,Butler Bulldogs,K. Spolyar,4068068,,False,31.0,4,11,4,7,0,4,0,2,1,4,5,3,1,0,6,4,8
400995814,Butler Bulldogs,S. Buck,3142279,,False,6.0,1,4,1,1,0,3,0,0,0,0,0,0,0,0,0,0,2
400995814,Butler Bulldogs,TEAM,TOTAL,TOTAL,False,,28,61,25,47,3,14,6,10,10,28,38,16,9,2,24,19,65
400995813,Xavier Musketeers,I. Partlow,3142320,,True,30.0,7,11,6,10,1,1,4,6,4,5,9,0,1,1,2,3,19
400995813,Xavier Musketeers,A. Aijanen,3142319,,True,28.0,1,5,1,2,0,3,0,0,1,3,4,1,0,0,0,1,2
400995813,Xavier Musketeers,A. Dunham,4281365,,True,25.0,3,3,2,2,1,1,5,5,0,2,2,6,0,0,4,1,12
400995813,Xavier Musketeers,J. Byrd,3142318,,True,25.0,3,7,2,6,1,1,2,2,0,1,1,1,1,0,0,1,9
400995813,Xavier Musketeers,K. Fincher,3142317,,True,18.0,3,10,0,3,3,7,0,0,0,1,1,1,0,0,6,2,9
400995813,Xavier Musketeers,A. Gray,4281368,,False,12.0,1,3,1,3,0,0,0,0,3,2,5,0,0,0,2,4,2
400995813,Xavier Musketeers,D. Ross,4281364,,False,20.0,3,9,3,6,0,3,0,0,0,3,3,2,1,0,2,3,6
400995813,Xavier Musketeers,M. Christopher,4068186,,False,3.0,0,0,0,0,0,0,0,0,1,0,1,0,0,0,0,0,0
400995813,Xavier Musketeers,A. Reiff,4281367,,False,11.0,0,2,0,1,0,1,0,0,1,1,2,0,1,0,1,0,0
400995813,Xavier Musketeers,P. Stewart,4281366,,False,26.0,2,10,2,6,0,4,4,4,0,2,2,2,0,0,3,2,8
400995813,Xavier Musketeers,A. Gomez,4068185,,False,3.0,0,0,0,0,0,0,0,0,0,1,1,0,0,0,0,0,0
400995813,Xavier Musketeers,TEAM,TOTAL,TOTAL,False,,23,60,17,39,6,21,15,17,16,25,41,13,4,1,21,17,67
400995813,Xavier Musketeers,I. Partlow,3142320,,True,30.0,7,11,6,10,1,1,4,6,4,5,9,0,1,1,2,3,19
400995813,Xavier Musketeers,A. Aijanen,3142319,,True,28.0,1,5,1,2,0,3,0,0,1,3,4,1,0,0,0,1,2
400995813,Xavier Musketeers,A. Dunham,4281365,,True,25.0,3,3,2,2,1,1,5,5,0,2,2,6,0,0,4,1,12
400995813,Xavier Musketeers,J. Byrd,3142318,,True,25.0,3,7,2,6,1,1,2,2,0,1,1,1,1,0,0,1,9
400995813,Xavier Musketeers,K. Fincher,3142317,,True,18.0,3,10,0,3,3,7,0,0,0,1,1,1,0,0,6,2,9
400995813,Xavier Musketeers,A. Gray,4281368,,False,12.0,1,3,1,3,0,0,0,0,3,2,5,0,0,0,2,4,2
400995813,Xavier Musketeers,D. Ross,4281364,,False,20.0,3,9,3,6,0,3,0,0,0,3,3,2,1,0,2,3,6
400995813,Xavier Musketeers,M. Christopher,4068186,,False,3.0,0,0,0,0,0,0,0,0,1,0,1,0,0,0,0,0,0
400995813,Xavier Musketeers,A. Reiff,4281367,,False,11.0,0,2,0,1,0,1,0,0,1,1,2,0,1,0,1,0,0
400995813,Xavier Musketeers,P. Stewart,4281366,,False,26.0,2,10,2,6,0,4,4,4,0,2,2,2,0,0,3,2,8
400995813,Xavier Musketeers,A. Gomez,4068185,,False,3.0,0,0,0,0,0,0,0,0,0,1,1,0,0,0,0,0,0
400995813,Xavier Musketeers,TEAM,TOTAL,TOTAL,False,,23,60,17,39,6,21,15,17,16,25,41,13,4,1,21,17,67
400995813,Marquette Golden Eagles,E. Davenport,3906756,,True,19.0,5,9,5,9,0,0,2,4,3,5,8,2,1,0,2,2,12
400995813,Marquette Golden Eagles,A. Wilborn,3906758,,True,19.0,7,10,7,9,0,1,1,1,0,3,3,4,2,0,1,4,15
400995813,Marquette Golden Eagles,A. Blockton,3906755,,True,25.0,9,15,8,14,1,1,0,0,0,3,3,1,2,0,0,0,19
400995813,Marquette Golden Eagles,N. Hiedeman,3906753,,True,26.0,3,11,2,7,1,4,0,0,0,3,3,3,2,2,3,3,7
400995813,Marquette Golden Eagles,D. King,3906752,,True,26.0,5,9,3,5,2,4,4,5,0,4,4,5,2,0,1,1,16
400995813,Marquette Golden Eagles,M. Smith Traore,4281351,,False,11.0,0,3,0,2,0,1,2,2,2,0,2,0,0,1,0,1,2
400995813,Marquette Golden Eagles,A. Anderson,4068081,,False,3.0,0,1,0,1,0,0,0,0,1,0,1,0,0,0,0,0,0
400995813,Marquette Golden Eagles,S. Dahling,3906754,,False,6.0,0,2,0,2,0,0,0,0,1,0,1,0,0,0,1,0,0
400995813,Marquette Golden Eagles,L. Van Kleunen,4068083,,False,15.0,2,4,2,3,0,1,0,0,1,0,1,1,1,0,0,1,4
400995813,Marquette Golden Eagles,S. Valentine,3142300,,False,6.0,0,1,0,1,0,0,0,0,2,2,4,0,0,0,0,1,0
400995813,Marquette Golden Eagles,S. Lott,4281350,,False,26.0,2,4,1,1,1,3,0,0,1,0,1,3,2,3,0,3,5
400995813,Marquette Golden Eagles,I. Spingola,4068082,,False,19.0,2,6,0,0,2,6,2,2,1,2,3,2,0,0,0,2,8
400995813,Marquette Golden Eagles,TEAM,TOTAL,TOTAL,False,,35,75,28,54,7,21,11,14,16,22,38,21,12,6,8,18,88
400995813,Marquette Golden Eagles,E. Davenport,3906756,,True,19.0,5,9,5,9,0,0,2,4,3,5,8,2,1,0,2,2,12
400995813,Marquette Golden Eagles,A. Wilborn,3906758,,True,19.0,7,10,7,9,0,1,1,1,0,3,3,4,2,0,1,4,15
400995813,Marquette Golden Eagles,A. Blockton,3906755,,True,25.0,9,15,8,14,1,1,0,0,0,3,3,1,2,0,0,0,19
400995813,Marquette Golden Eagles,N. Hiedeman,3906753,,True,26.0,3,11,2,7,1,4,0,0,0,3,3,3,2,2,3,3,7
400995813,Marquette Golden Eagles,D. King,3906752,,True,26.0,5,9,3,5,2,4,4,5,0,4,4,5,2,0,1,1,16
400995813,Marquette Golden Eagles,M. Smith Traore,4281351,,False,11.0,0,3,0,2,0,1,2,2,2,0,2,0,0,1,0,1,2
400995813,Marquette Golden Eagles,A. Anderson,4068081,,False,3.0,0,1,0,1,0,0,0,0,1,0,1,0,0,0,0,0,0
400995813,Marquette Golden Eagles,S. Dahling,3906754,,False,6.0,0,2,0,2,0,0,0,0,1,0,1,0,0,0,1,0,0
400995813,Marquette Golden Eagles,L. Van Kleunen,4068083,,False,15.0,2,4,2,3,0,1,0,0,1,0,1,1,1,0,0,1,4
400995813,Marquette Golden Eagles,S. Valentine,3142300,,False,6.0,0,1,0,1,0,0,0,0,2,2,4,0,0,0,0,1,0
400995813,Marquette Golden Eagles,S. Lott,4281350,,False,26.0,2,4,1,1,1,3,0,0,1,0,1,3,2,3,0,3,5
400995813,Marquette Golden Eagles,I. Spingola,4068082,,False,19.0,2,6,0,0,2,6,2,2,1,2,3,2,0,0,0,2,8
400995813,Marquette Golden Eagles,TEAM,TOTAL,TOTAL,False,,35,75,28,54,7,21,11,14,16,22,38,21,12,6,8,18,88
400995812,Villanova Wildcats,M. Quinn,3056785,,True,15.0,1,1,1,1,0,0,0,0,0,1,1,0,0,0,0,0,2
400995812,Villanova Wildcats,J. Tucker,3087536,,True,35.0,3,9,0,4,3,5,2,2,1,2,3,0,1,0,0,1,11
400995812,Villanova Wildcats,K. Jekot,4068171,,True,37.0,7,10,6,7,1,3,1,2,0,2,2,0,0,0,1,4,16
400995812,Villanova Wildcats,A. Hahn,3906779,,True,36.0,3,6,1,2,2,4,1,1,0,2,2,2,0,0,5,2,9
400995812,Villanova Wildcats,A. Louin,3142314,,True,38.0,3,12,3,8,0,4,5,5,0,5,5,0,1,1,3,4,11
400995812,Villanova Wildcats,M. Gedaka,4068172,,False,26.0,5,8,5,7,0,1,5,7,5,3,8,2,0,1,2,2,15
400995812,Villanova Wildcats,B. Herlihy,3906778,,False,4.0,0,0,0,0,0,0,0,0,0,0,0,0,0,0,2,0,0
400995812,Villanova Wildcats,G. Stant,3906780,,False,9.0,0,0,0,0,0,0,0,0,0,1,1,1,0,0,0,2,0
400995812,Villanova Wildcats,R. James,4068168,,False,0.0,0,0,0,0,0,0,0,0,0,0,0,0,0,0,0,1,0
400995812,Villanova Wildcats,C. Onken,4068167,,False,0.0,0,0,0,0,0,0,0,0,0,0,0,0,0,0,0,1,0
400995812,Villanova Wildcats,TEAM,TOTAL,TOTAL,False,,22,46,16,29,6,17,14,17,6,17,23,5,2,2,13,17,64
400995812,Villanova Wildcats,M. Quinn,3056785,,True,15.0,1,1,1,1,0,0,0,0,0,1,1,0,0,0,0,0,2
400995812,Villanova Wildcats,J. Tucker,3087536,,True,35.0,3,9,0,4,3,5,2,2,1,2,3,0,1,0,0,1,11
400995812,Villanova Wildcats,K. Jekot,4068171,,True,37.0,7,10,6,7,1,3,1,2,0,2,2,0,0,0,1,4,16
400995812,Villanova Wildcats,A. Hahn,3906779,,True,36.0,3,6,1,2,2,4,1,1,0,2,2,2,0,0,5,2,9
400995812,Villanova Wildcats,A. Louin,3142314,,True,38.0,3,12,3,8,0,4,5,5,0,5,5,0,1,1,3,4,11
400995812,Villanova Wildcats,M. Gedaka,4068172,,False,26.0,5,8,5,7,0,1,5,7,5,3,8,2,0,1,2,2,15
400995812,Villanova Wildcats,B. Herlihy,3906778,,False,4.0,0,0,0,0,0,0,0,0,0,0,0,0,0,0,2,0,0
400995812,Villanova Wildcats,G. Stant,3906780,,False,9.0,0,0,0,0,0,0,0,0,0,1,1,1,0,0,0,2,0
400995812,Villanova Wildcats,R. James,4068168,,False,0.0,0,0,0,0,0,0,0,0,0,0,0,0,0,0,0,1,0
400995812,Villanova Wildcats,C. Onken,4068167,,False,0.0,0,0,0,0,0,0,0,0,0,0,0,0,0,0,0,1,0
400995812,Villanova Wildcats,TEAM,TOTAL,TOTAL,False,,22,46,16,29,6,17,14,17,6,17,23,5,2,2,13,17,64
400995812,St. John's Red Storm,M. Singleton,4068158,,True,31.0,6,11,6,10,0,1,4,7,4,7,11,5,1,0,3,4,16
400995812,St. John's Red Storm,I. Littleton,3142306,,True,26.0,1,2,1,2,0,0,0,0,1,4,5,0,0,0,0,3,2
400995812,St. John's Red Storm,Q. Hoppie,4281375,,True,17.0,4,8,3,7,1,1,0,0,0,0,0,1,0,0,0,3,9
400995812,St. John's Red Storm,T. England,4068155,,True,38.0,4,9,3,7,1,2,3,4,0,2,2,3,2,0,1,2,12
400995812,St. John's Red Storm,A. Kebbe,4068154,,True,33.0,5,10,3,7,2,3,4,4,3,3,6,0,0,0,1,1,16
400995812,St. John's Red Storm,A. Wellere,3906771,,False,24.0,2,5,1,3,1,2,0,0,0,0,0,1,0,0,1,0,5
400995812,St. John's Red Storm,A. Adams,4068157,,False,29.0,3,6,2,4,1,2,3,4,1,2,3,2,1,0,2,1,10
400995812,St. John's Red Storm,T. Alexander,3142305,,False,2.0,0,0,0,0,0,0,0,0,0,0,0,0,0,0,1,1,0
400995812,St. John's Red Storm,TEAM,TOTAL,TOTAL,False,,25,51,19,40,6,11,14,19,9,19,28,12,4,0,10,15,70
400995812,St. John's Red Storm,M. Singleton,4068158,,True,31.0,6,11,6,10,0,1,4,7,4,7,11,5,1,0,3,4,16
400995812,St. John's Red Storm,I. Littleton,3142306,,True,26.0,1,2,1,2,0,0,0,0,1,4,5,0,0,0,0,3,2
400995812,St. John's Red Storm,Q. Hoppie,4281375,,True,17.0,4,8,3,7,1,1,0,0,0,0,0,1,0,0,0,3,9
400995812,St. John's Red Storm,T. England,4068155,,True,38.0,4,9,3,7,1,2,3,4,0,2,2,3,2,0,1,2,12
400995812,St. John's Red Storm,A. Kebbe,4068154,,True,33.0,5,10,3,7,2,3,4,4,3,3,6,0,0,0,1,1,16
400995812,St. John's Red Storm,A. Wellere,3906771,,False,24.0,2,5,1,3,1,2,0,0,0,0,0,1,0,0,1,0,5
400995812,St. John's Red Storm,A. Adams,4068157,,False,29.0,3,6,2,4,1,2,3,4,1,2,3,2,1,0,2,1,10
400995812,St. John's Red Storm,T. Alexander,3142305,,False,2.0,0,0,0,0,0,0,0,0,0,0,0,0,0,0,1,1,0
400995812,St. John's Red Storm,TEAM,TOTAL,TOTAL,False,,25,51,19,40,6,11,14,19,9,19,28,12,4,0,10,15,70
400995811,Seton Hall Pirates,S. Samuels,4068128,,True,28.0,4,6,4,6,0,0,0,0,1,5,6,1,1,1,2,5,8
400995811,Seton Hall Pirates,D. Fountain,3058890,,True,36.0,6,16,4,13,2,3,6,6,3,7,10,2,1,0,3,4,20
400995811,Seton Hall Pirates,K. Evans,4281378,,True,32.0,5,6,5,6,0,0,2,5,4,3,7,0,0,2,5,2,12
400995811,Seton Hall Pirates,I. Butina,4281377,,True,37.0,5,8,3,6,2,2,5,8,0,3,3,8,5,0,2,3,17
400995811,Seton Hall Pirates,J. Jackson,3064877,,True,18.0,1,6,1,4,0,2,0,0,0,1,1,2,2,0,2,0,2
400995811,Seton Hall Pirates,S. Philoxy,4281380,,False,13.0,0,1,0,1,0,0,0,0,1,1,2,2,0,0,1,0,0
400995811,Seton Hall Pirates,J. Jones-Pack,4068129,,False,2.0,0,0,0,0,0,0,1,2,0,1,1,0,0,0,0,0,1
400995811,Seton Hall Pirates,D. Winters,4068126,,False,22.0,3,7,1,2,2,5,2,2,0,2,2,1,0,2,2,5,10
400995811,Seton Hall Pirates,N. Jimenez,4281379,,False,6.0,0,1,0,0,0,1,0,0,1,1,2,0,0,0,3,0,0
400995811,Seton Hall Pirates,K. Hilaire,4068123,,False,4.0,0,0,0,0,0,0,0,0,0,1,1,0,0,0,1,0,0
400995811,Seton Hall Pirates,K. Healy,3943704,,False,2.0,0,0,0,0,0,0,0,0,0,1,1,0,0,0,0,0,0
400995811,Seton Hall Pirates,TEAM,TOTAL,TOTAL,False,,24,51,18,38,6,13,16,23,11,28,39,16,9,5,21,19,70
400995811,Seton Hall Pirates,S. Samuels,4068128,,True,28.0,4,6,4,6,0,0,0,0,1,5,6,1,1,1,2,5,8
400995811,Seton Hall Pirates,D. Fountain,3058890,,True,36.0,6,16,4,13,2,3,6,6,3,7,10,2,1,0,3,4,20
400995811,Seton Hall Pirates,K. Evans,4281378,,True,32.0,5,6,5,6,0,0,2,5,4,3,7,0,0,2,5,2,12
400995811,Seton Hall Pirates,I. Butina,4281377,,True,37.0,5,8,3,6,2,2,5,8,0,3,3,8,5,0,2,3,17
400995811,Seton Hall Pirates,J. Jackson,3064877,,True,18.0,1,6,1,4,0,2,0,0,0,1,1,2,2,0,2,0,2
400995811,Seton Hall Pirates,S. Philoxy,4281380,,False,13.0,0,1,0,1,0,0,0,0,1,1,2,2,0,0,1,0,0
400995811,Seton Hall Pirates,J. Jones-Pack,4068129,,False,2.0,0,0,0,0,0,0,1,2,0,1,1,0,0,0,0,0,1
400995811,Seton Hall Pirates,D. Winters,4068126,,False,22.0,3,7,1,2,2,5,2,2,0,2,2,1,0,2,2,5,10
400995811,Seton Hall Pirates,N. Jimenez,4281379,,False,6.0,0,1,0,0,0,1,0,0,1,1,2,0,0,0,3,0,0
400995811,Seton Hall Pirates,K. Hilaire,4068123,,False,4.0,0,0,0,0,0,0,0,0,0,1,1,0,0,0,1,0,0
400995811,Seton Hall Pirates,K. Healy,3943704,,False,2.0,0,0,0,0,0,0,0,0,0,1,1,0,0,0,0,0,0
400995811,Seton Hall Pirates,TEAM,TOTAL,TOTAL,False,,24,51,18,38,6,13,16,23,11,28,39,16,9,5,21,19,70
400995811,Georgetown Hoyas,C. Petke,4068078,,True,30.0,5,9,5,7,0,2,2,3,4,5,9,0,0,0,2,3,12
400995811,Georgetown Hoyas,M. Smith,4068079,,True,21.0,2,7,2,7,0,0,2,2,1,2,3,0,1,0,1,4,6
400995811,Georgetown Hoyas,B. Mayfield,4281354,,True,6.0,0,1,0,1,0,0,0,0,0,2,2,0,0,2,0,0,0
400995811,Georgetown Hoyas,D. White,3948815,,True,31.0,4,17,4,10,0,7,5,5,0,3,3,2,2,0,2,4,13
400995811,Georgetown Hoyas,M. Venson,3142105,,True,38.0,9,16,6,10,3,6,7,7,0,2,2,0,1,0,3,4,28
400995811,Georgetown Hoyas,T. Thompson,4281352,,False,7.0,0,1,0,1,0,0,0,0,0,0,0,0,0,0,1,0,0
400995811,Georgetown Hoyas,Y. Belk,3142295,,False,31.0,1,5,1,5,0,0,2,4,3,2,5,2,2,1,2,1,4
400995811,Georgetown Hoyas,D. Burton,3142292,,False,36.0,1,5,1,4,0,1,0,0,1,3,4,2,3,0,2,4,2
400995811,Georgetown Hoyas,TEAM,TOTAL,TOTAL,False,,22,61,19,45,3,16,18,21,11,21,32,6,9,3,13,20,65
400995811,Georgetown Hoyas,C. Petke,4068078,,True,30.0,5,9,5,7,0,2,2,3,4,5,9,0,0,0,2,3,12
400995811,Georgetown Hoyas,M. Smith,4068079,,True,21.0,2,7,2,7,0,0,2,2,1,2,3,0,1,0,1,4,6
400995811,Georgetown Hoyas,B. Mayfield,4281354,,True,6.0,0,1,0,1,0,0,0,0,0,2,2,0,0,2,0,0,0
400995811,Georgetown Hoyas,D. White,3948815,,True,31.0,4,17,4,10,0,7,5,5,0,3,3,2,2,0,2,4,13
400995811,Georgetown Hoyas,M. Venson,3142105,,True,38.0,9,16,6,10,3,6,7,7,0,2,2,0,1,0,3,4,28
400995811,Georgetown Hoyas,T. Thompson,4281352,,False,7.0,0,1,0,1,0,0,0,0,0,0,0,0,0,0,1,0,0
400995811,Georgetown Hoyas,Y. Belk,3142295,,False,31.0,1,5,1,5,0,0,2,4,3,2,5,2,2,1,2,1,4
400995811,Georgetown Hoyas,D. Burton,3142292,,False,36.0,1,5,1,4,0,1,0,0,1,3,4,2,3,0,2,4,2
400995811,Georgetown Hoyas,TEAM,TOTAL,TOTAL,False,,22,61,19,45,3,16,18,21,11,21,32,6,9,3,13,20,65
400995810,Providence Friars,B. Frias,3142302,,True,11.0,0,1,0,1,0,0,0,0,0,2,2,0,0,1,0,1,0
400995810,Providence Friars,K. Spiwak,4281346,,True,22.0,1,3,1,2,0,1,0,0,1,1,2,2,0,1,1,1,2
400995810,Providence Friars,C. Williams,4281345,,True,24.0,4,7,4,7,0,0,2,2,0,3,3,3,1,0,4,3,10
400995810,Providence Friars,J. Nogic,3906769,,True,26.0,5,11,3,8,2,3,3,3,0,3,3,3,1,0,1,1,15
400995810,Providence Friars,M. Jolin,3906767,,True,22.0,0,3,0,1,0,2,0,0,0,0,0,2,0,0,2,0,0
400995810,Providence Friars,A. Cooper,4281349,,False,6.0,1,2,1,2,0,0,0,0,0,0,0,0,0,0,2,4,2
400995810,Providence Friars,N. Franklin,4281348,,False,22.0,4,7,4,7,0,0,0,0,1,4,5,1,0,0,3,1,8
400995810,Providence Friars,O. Orlando,4281347,,False,6.0,2,2,2,2,0,0,1,2,1,1,2,0,1,0,1,1,5
400995810,Providence Friars,N. Jackson,4068111,,False,20.0,3,3,3,3,0,0,0,1,2,2,4,2,0,0,1,2,6
400995810,Providence Friars,C. Che,3906766,,False,27.0,2,6,2,4,0,2,0,0,1,1,2,2,0,0,1,2,4
400995810,Providence Friars,A. Botteghi,3142301,,False,14.0,2,3,2,3,0,0,0,0,0,1,1,1,0,0,1,1,4
400995810,Providence Friars,TEAM,TOTAL,TOTAL,False,,24,48,22,40,2,8,6,8,6,19,25,16,3,2,17,17,56
400995810,Providence Friars,B. Frias,3142302,,True,11.0,0,1,0,1,0,0,0,0,0,2,2,0,0,1,0,1,0
400995810,Providence Friars,K. Spiwak,4281346,,True,22.0,1,3,1,2,0,1,0,0,1,1,2,2,0,1,1,1,2
400995810,Providence Friars,C. Williams,4281345,,True,24.0,4,7,4,7,0,0,2,2,0,3,3,3,1,0,4,3,10
400995810,Providence Friars,J. Nogic,3906769,,True,26.0,5,11,3,8,2,3,3,3,0,3,3,3,1,0,1,1,15
400995810,Providence Friars,M. Jolin,3906767,,True,22.0,0,3,0,1,0,2,0,0,0,0,0,2,0,0,2,0,0
400995810,Providence Friars,A. Cooper,4281349,,False,6.0,1,2,1,2,0,0,0,0,0,0,0,0,0,0,2,4,2
400995810,Providence Friars,N. Franklin,4281348,,False,22.0,4,7,4,7,0,0,0,0,1,4,5,1,0,0,3,1,8
400995810,Providence Friars,O. Orlando,4281347,,False,6.0,2,2,2,2,0,0,1,2,1,1,2,0,1,0,1,1,5
400995810,Providence Friars,N. Jackson,4068111,,False,20.0,3,3,3,3,0,0,0,1,2,2,4,2,0,0,1,2,6
400995810,Providence Friars,C. Che,3906766,,False,27.0,2,6,2,4,0,2,0,0,1,1,2,2,0,0,1,2,4
400995810,Providence Friars,A. Botteghi,3142301,,False,14.0,2,3,2,3,0,0,0,0,0,1,1,1,0,0,1,1,4
400995810,Providence Friars,TEAM,TOTAL,TOTAL,False,,24,48,22,40,2,8,6,8,6,19,25,16,3,2,17,17,56
400995810,Creighton Bluejays,A. Faber,3938938,,True,30.0,6,15,2,6,4,9,0,0,2,3,5,4,1,1,3,2,16
400995810,Creighton Bluejays,J. Agnew,3938935,,True,29.0,6,11,4,5,2,6,1,2,0,2,2,2,2,2,1,4,15
400995810,Creighton Bluejays,B. Norby,3142284,,True,12.0,2,5,1,3,1,2,2,2,1,2,3,1,1,0,0,0,7
400995810,Creighton Bluejays,S. Lamberty,3142285,,True,31.0,4,8,2,3,2,5,0,0,2,2,4,11,2,0,2,0,10
400995810,Creighton Bluejays,M. Mellman,3142283,,True,20.0,1,3,0,0,1,3,0,0,2,0,2,0,0,0,1,0,3
400995810,Creighton Bluejays,A. Greene,3938937,,False,13.0,1,3,1,3,0,0,3,4,6,3,9,0,0,0,2,3,5
400995810,Creighton Bluejays,K. Brown,3142286,,False,11.0,0,1,0,1,0,0,0,0,0,0,0,1,0,1,0,1,0
400995810,Creighton Bluejays,T. Carda,4281362,,False,23.0,3,3,1,1,2,2,2,2,0,3,3,2,1,0,2,1,10
400995810,Creighton Bluejays,T. Rembao,4281361,,False,6.0,0,0,0,0,0,0,0,0,0,0,0,1,0,0,3,2,0
400995810,Creighton Bluejays,O. Elger,3938936,,False,15.0,2,3,2,2,0,1,0,2,0,3,3,1,1,0,0,3,4
400995810,Creighton Bluejays,B. Kissinger,3142124,,False,10.0,1,4,0,2,1,2,0,0,0,1,1,0,1,0,0,1,3
400995810,Creighton Bluejays,TEAM,TOTAL,TOTAL,False,,26,56,13,26,13,30,8,12,13,19,32,23,9,4,14,17,73
400995810,Creighton Bluejays,A. Faber,3938938,,True,30.0,6,15,2,6,4,9,0,0,2,3,5,4,1,1,3,2,16
400995810,Creighton Bluejays,J. Agnew,3938935,,True,29.0,6,11,4,5,2,6,1,2,0,2,2,2,2,2,1,4,15
400995810,Creighton Bluejays,B. Norby,3142284,,True,12.0,2,5,1,3,1,2,2,2,1,2,3,1,1,0,0,0,7
400995810,Creighton Bluejays,S. Lamberty,3142285,,True,31.0,4,8,2,3,2,5,0,0,2,2,4,11,2,0,2,0,10
400995810,Creighton Bluejays,M. Mellman,3142283,,True,20.0,1,3,0,0,1,3,0,0,2,0,2,0,0,0,1,0,3
400995810,Creighton Bluejays,A. Greene,3938937,,False,13.0,1,3,1,3,0,0,3,4,6,3,9,0,0,0,2,3,5
400995810,Creighton Bluejays,K. Brown,3142286,,False,11.0,0,1,0,1,0,0,0,0,0,0,0,1,0,1,0,1,0
400995810,Creighton Bluejays,T. Carda,4281362,,False,23.0,3,3,1,1,2,2,2,2,0,3,3,2,1,0,2,1,10
400995810,Creighton Bluejays,T. Rembao,4281361,,False,6.0,0,0,0,0,0,0,0,0,0,0,0,1,0,0,3,2,0
400995810,Creighton Bluejays,O. Elger,3938936,,False,15.0,2,3,2,2,0,1,0,2,0,3,3,1,1,0,0,3,4
400995810,Creighton Bluejays,B. Kissinger,3142124,,False,10.0,1,4,0,2,1,2,0,0,0,1,1,0,1,0,0,1,3
400995810,Creighton Bluejays,TEAM,TOTAL,TOTAL,False,,26,56,13,26,13,30,8,12,13,19,32,23,9,4,14,17,73
400995809,Marquette Golden Eagles,E. Davenport,3906756,,True,14.0,3,5,3,5,0,0,2,4,0,4,4,1,1,0,1,0,8
400995809,Marquette Golden Eagles,A. Wilborn,3906758,,True,23.0,3,6,2,4,1,2,2,4,2,1,3,3,0,1,3,3,9
400995809,Marquette Golden Eagles,A. Blockton,3906755,,True,38.0,8,12,7,10,1,2,8,9,2,4,6,1,0,0,2,2,25
400995809,Marquette Golden Eagles,N. Hiedeman,3906753,,True,34.0,0,7,0,4,0,3,0,0,0,3,3,5,1,0,2,1,0
400995809,Marquette Golden Eagles,D. King,3906752,,True,28.0,5,12,4,9,1,3,1,2,0,1,1,6,3,0,4,3,12
400995809,Marquette Golden Eagles,A. Anderson,4068081,,False,2.0,0,0,0,0,0,0,0,0,0,1,1,0,0,0,0,2,0
400995809,Marquette Golden Eagles,L. Van Kleunen,4068083,,False,14.0,2,7,2,4,0,3,0,0,1,1,2,1,2,0,2,2,4
400995809,Marquette Golden Eagles,S. Valentine,3142300,,False,13.0,0,1,0,1,0,0,0,0,1,2,3,0,0,0,0,0,0
400995809,Marquette Golden Eagles,S. Lott,4281350,,False,20.0,0,1,0,0,0,1,0,0,4,1,5,3,2,0,1,1,0
400995809,Marquette Golden Eagles,I. Spingola,4068082,,False,14.0,4,7,1,3,3,4,0,0,0,0,0,0,1,0,0,1,11
400995809,Marquette Golden Eagles,TEAM,TOTAL,TOTAL,False,,25,58,19,40,6,18,13,19,11,21,32,20,10,1,15,15,69
400995809,Marquette Golden Eagles,E. Davenport,3906756,,True,14.0,3,5,3,5,0,0,2,4,0,4,4,1,1,0,1,0,8
400995809,Marquette Golden Eagles,A. Wilborn,3906758,,True,23.0,3,6,2,4,1,2,2,4,2,1,3,3,0,1,3,3,9
400995809,Marquette Golden Eagles,A. Blockton,3906755,,True,38.0,8,12,7,10,1,2,8,9,2,4,6,1,0,0,2,2,25
400995809,Marquette Golden Eagles,N. Hiedeman,3906753,,True,34.0,0,7,0,4,0,3,0,0,0,3,3,5,1,0,2,1,0
400995809,Marquette Golden Eagles,D. King,3906752,,True,28.0,5,12,4,9,1,3,1,2,0,1,1,6,3,0,4,3,12
400995809,Marquette Golden Eagles,A. Anderson,4068081,,False,2.0,0,0,0,0,0,0,0,0,0,1,1,0,0,0,0,2,0
400995809,Marquette Golden Eagles,L. Van Kleunen,4068083,,False,14.0,2,7,2,4,0,3,0,0,1,1,2,1,2,0,2,2,4
400995809,Marquette Golden Eagles,S. Valentine,3142300,,False,13.0,0,1,0,1,0,0,0,0,1,2,3,0,0,0,0,0,0
400995809,Marquette Golden Eagles,S. Lott,4281350,,False,20.0,0,1,0,0,0,1,0,0,4,1,5,3,2,0,1,1,0
400995809,Marquette Golden Eagles,I. Spingola,4068082,,False,14.0,4,7,1,3,3,4,0,0,0,0,0,0,1,0,0,1,11
400995809,Marquette Golden Eagles,TEAM,TOTAL,TOTAL,False,,25,58,19,40,6,18,13,19,11,21,32,20,10,1,15,15,69
400995809,Butler Bulldogs,T. Schickel,3914012,,True,39.0,5,9,5,9,0,0,2,4,6,7,13,6,1,1,2,4,12
400995809,Butler Bulldogs,S. Brey,4068067,,True,31.0,3,4,3,4,0,0,0,0,1,6,7,2,0,0,2,1,6
400995809,Butler Bulldogs,M. Weaver,3914014,,True,34.0,4,9,2,7,2,2,1,2,0,1,1,3,2,1,2,1,11
400995809,Butler Bulldogs,W. Jennings,3142145,,True,40.0,3,15,1,9,2,6,0,0,0,3,3,6,1,0,4,2,8
400995809,Butler Bulldogs,I. Lathan,3079485,,True,23.0,4,9,4,9,0,0,0,0,1,3,4,3,1,0,3,1,8
400995809,Butler Bulldogs,K. Hodges,4068065,,False,1.0,0,0,0,0,0,0,0,0,0,0,0,0,0,0,0,2,0
400995809,Butler Bulldogs,S. Humphrey,4068066,,False,1.0,0,0,0,0,0,0,0,0,0,0,0,0,0,0,0,0,0
400995809,Butler Bulldogs,K. Spolyar,4068068,,False,28.0,8,12,5,7,3,5,3,4,1,5,6,0,2,0,3,5,22
400995809,Butler Bulldogs,S. Buck,3142279,,False,3.0,0,2,0,0,0,2,0,0,0,0,0,0,0,0,1,1,0
400995809,Butler Bulldogs,TEAM,TOTAL,TOTAL,False,,27,60,20,45,7,15,6,10,10,25,35,20,7,2,18,17,67
400995809,Butler Bulldogs,T. Schickel,3914012,,True,39.0,5,9,5,9,0,0,2,4,6,7,13,6,1,1,2,4,12
400995809,Butler Bulldogs,S. Brey,4068067,,True,31.0,3,4,3,4,0,0,0,0,1,6,7,2,0,0,2,1,6
400995809,Butler Bulldogs,M. Weaver,3914014,,True,34.0,4,9,2,7,2,2,1,2,0,1,1,3,2,1,2,1,11
400995809,Butler Bulldogs,W. Jennings,3142145,,True,40.0,3,15,1,9,2,6,0,0,0,3,3,6,1,0,4,2,8
400995809,Butler Bulldogs,I. Lathan,3079485,,True,23.0,4,9,4,9,0,0,0,0,1,3,4,3,1,0,3,1,8
400995809,Butler Bulldogs,K. Hodges,4068065,,False,1.0,0,0,0,0,0,0,0,0,0,0,0,0,0,0,0,2,0
400995809,Butler Bulldogs,S. Humphrey,4068066,,False,1.0,0,0,0,0,0,0,0,0,0,0,0,0,0,0,0,0,0
400995809,Butler Bulldogs,K. Spolyar,4068068,,False,28.0,8,12,5,7,3,5,3,4,1,5,6,0,2,0,3,5,22
400995809,Butler Bulldogs,S. Buck,3142279,,False,3.0,0,2,0,0,0,2,0,0,0,0,0,0,0,0,1,1,0
400995809,Butler Bulldogs,TEAM,TOTAL,TOTAL,False,,27,60,20,45,7,15,6,10,10,25,35,20,7,2,18,17,67
400995808,Villanova Wildcats,M. Quinn,3056785,,True,16.0,1,6,0,1,1,5,0,0,2,3,5,1,1,0,2,0,3
400995808,Villanova Wildcats,A. Louin,3142314,,True,35.0,1,3,1,3,0,0,4,4,1,2,3,2,1,1,1,4,6
400995808,Villanova Wildcats,J. Tucker,3087536,,True,28.0,4,9,1,4,3,5,0,0,0,1,1,2,0,0,0,3,11
400995808,Villanova Wildcats,K. Jekot,4068171,,True,39.0,5,13,2,6,3,7,8,9,2,3,5,1,1,1,1,0,21
400995808,Villanova Wildcats,A. Hahn,3906779,,True,37.0,2,11,2,8,0,3,4,4,3,4,7,4,1,0,1,2,8
400995808,Villanova Wildcats,M. Gedaka,4068172,,False,19.0,6,9,5,8,1,1,3,3,3,5,8,1,1,1,1,2,16
400995808,Villanova Wildcats,B. Herlihy,4068169,,False,5.0,0,1,0,1,0,0,0,0,0,0,0,1,0,0,0,0,0
400995808,Villanova Wildcats,B. Herlihy,3906778,,False,4.0,0,1,0,1,0,0,0,0,0,0,0,0,0,1,0,2,0
400995808,Villanova Wildcats,G. Stant,3906780,,False,4.0,0,1,0,0,0,1,0,0,0,0,0,0,0,0,0,0,0
400995808,Villanova Wildcats,R. James,4068168,,False,2.0,0,0,0,0,0,0,0,0,0,0,0,0,0,0,1,1,0
400995808,Villanova Wildcats,C. Onken,4068167,,False,11.0,1,3,1,1,0,2,0,0,0,1,1,0,0,0,0,0,2
400995808,Villanova Wildcats,TEAM,TOTAL,TOTAL,False,,20,57,12,33,8,24,19,20,12,22,34,12,5,4,7,14,67
400995808,Villanova Wildcats,M. Quinn,3056785,,True,16.0,1,6,0,1,1,5,0,0,2,3,5,1,1,0,2,0,3
400995808,Villanova Wildcats,A. Louin,3142314,,True,35.0,1,3,1,3,0,0,4,4,1,2,3,2,1,1,1,4,6
400995808,Villanova Wildcats,J. Tucker,3087536,,True,28.0,4,9,1,4,3,5,0,0,0,1,1,2,0,0,0,3,11
400995808,Villanova Wildcats,K. Jekot,4068171,,True,39.0,5,13,2,6,3,7,8,9,2,3,5,1,1,1,1,0,21
400995808,Villanova Wildcats,A. Hahn,3906779,,True,37.0,2,11,2,8,0,3,4,4,3,4,7,4,1,0,1,2,8
400995808,Villanova Wildcats,M. Gedaka,4068172,,False,19.0,6,9,5,8,1,1,3,3,3,5,8,1,1,1,1,2,16
400995808,Villanova Wildcats,B. Herlihy,4068169,,False,5.0,0,1,0,1,0,0,0,0,0,0,0,1,0,0,0,0,0
400995808,Villanova Wildcats,B. Herlihy,3906778,,False,4.0,0,1,0,1,0,0,0,0,0,0,0,0,0,1,0,2,0
400995808,Villanova Wildcats,G. Stant,3906780,,False,4.0,0,1,0,0,0,1,0,0,0,0,0,0,0,0,0,0,0
400995808,Villanova Wildcats,R. James,4068168,,False,2.0,0,0,0,0,0,0,0,0,0,0,0,0,0,0,1,1,0
400995808,Villanova Wildcats,C. Onken,4068167,,False,11.0,1,3,1,1,0,2,0,0,0,1,1,0,0,0,0,0,2
400995808,Villanova Wildcats,TEAM,TOTAL,TOTAL,False,,20,57,12,33,8,24,19,20,12,22,34,12,5,4,7,14,67
400995808,Seton Hall Pirates,S. Samuels,4068128,,True,39.0,8,11,7,10,1,1,3,4,2,7,9,2,0,0,5,2,20
400995808,Seton Hall Pirates,D. Fountain,3058890,,True,35.0,9,20,6,14,3,6,7,10,4,9,13,0,0,0,0,4,28
400995808,Seton Hall Pirates,K. Evans,4281378,,True,23.0,1,3,1,3,0,0,0,0,1,2,3,1,0,1,2,1,2
400995808,Seton Hall Pirates,I. Butina,4281377,,True,33.0,0,5,0,4,0,1,0,0,1,2,3,6,0,0,1,3,0
400995808,Seton Hall Pirates,J. Jackson,3064877,,True,26.0,1,7,0,4,1,3,0,0,1,1,2,1,0,0,1,0,3
400995808,Seton Hall Pirates,S. Philoxy,4281380,,False,8.0,1,3,1,3,0,0,0,0,1,2,3,0,0,0,0,0,2
400995808,Seton Hall Pirates,D. Winters,4068126,,False,2.0,0,0,0,0,0,0,0,0,0,0,0,0,0,0,0,0,0
400995808,Seton Hall Pirates,N. Jimenez,4281379,,False,17.0,0,3,0,2,0,1,0,0,2,0,2,1,1,0,0,0,0
400995808,Seton Hall Pirates,K. Hilaire,4068123,,False,17.0,2,4,2,4,0,0,0,0,0,0,0,3,2,0,2,3,4
400995808,Seton Hall Pirates,K. Healy,3943704,,False,0.0,0,0,0,0,0,0,0,0,0,0,0,0,0,0,0,1,0
400995808,Seton Hall Pirates,TEAM,TOTAL,TOTAL,False,,22,56,17,44,5,12,10,14,15,26,41,14,3,1,12,14,59
400995808,Seton Hall Pirates,S. Samuels,4068128,,True,39.0,8,11,7,10,1,1,3,4,2,7,9,2,0,0,5,2,20
400995808,Seton Hall Pirates,D. Fountain,3058890,,True,35.0,9,20,6,14,3,6,7,10,4,9,13,0,0,0,0,4,28
400995808,Seton Hall Pirates,K. Evans,4281378,,True,23.0,1,3,1,3,0,0,0,0,1,2,3,1,0,1,2,1,2
400995808,Seton Hall Pirates,I. Butina,4281377,,True,33.0,0,5,0,4,0,1,0,0,1,2,3,6,0,0,1,3,0
400995808,Seton Hall Pirates,J. Jackson,3064877,,True,26.0,1,7,0,4,1,3,0,0,1,1,2,1,0,0,1,0,3
400995808,Seton Hall Pirates,S. Philoxy,4281380,,False,8.0,1,3,1,3,0,0,0,0,1,2,3,0,0,0,0,0,2
400995808,Seton Hall Pirates,D. Winters,4068126,,False,2.0,0,0,0,0,0,0,0,0,0,0,0,0,0,0,0,0,0
400995808,Seton Hall Pirates,N. Jimenez,4281379,,False,17.0,0,3,0,2,0,1,0,0,2,0,2,1,1,0,0,0,0
400995808,Seton Hall Pirates,K. Hilaire,4068123,,False,17.0,2,4,2,4,0,0,0,0,0,0,0,3,2,0,2,3,4
400995808,Seton Hall Pirates,K. Healy,3943704,,False,0.0,0,0,0,0,0,0,0,0,0,0,0,0,0,0,0,1,0
400995808,Seton Hall Pirates,TEAM,TOTAL,TOTAL,False,,22,56,17,44,5,12,10,14,15,26,41,14,3,1,12,14,59
400995807,St. John's Red Storm,M. Singleton,4068158,,True,28.0,4,9,4,9,0,0,3,3,2,12,14,1,0,0,5,4,11
400995807,St. John's Red Storm,I. Littleton,3142306,,True,34.0,1,2,1,2,0,0,0,0,3,2,5,1,1,2,2,2,2
400995807,St. John's Red Storm,Q. Hoppie,4281375,,True,32.0,4,9,2,7,2,2,5,6,0,0,0,2,0,1,5,2,15
400995807,St. John's Red Storm,T. England,4068155,,True,32.0,3,8,2,7,1,1,0,0,0,5,5,5,1,0,2,1,7
400995807,St. John's Red Storm,A. Kebbe,4068154,,True,30.0,4,8,3,5,1,3,3,4,5,2,7,1,1,0,1,0,12
400995807,St. John's Red Storm,K. Charles,4281374,,False,6.0,0,0,0,0,0,0,0,0,0,1,1,1,0,0,0,2,0
400995807,St. John's Red Storm,A. Wellere,3906771,,False,17.0,1,6,1,2,0,4,0,0,0,0,0,0,0,0,0,0,2
400995807,St. John's Red Storm,A. Adams,4068157,,False,16.0,5,10,3,4,2,6,0,0,1,4,5,0,2,0,3,2,12
400995807,St. John's Red Storm,S. Duncan,4068156,,False,2.0,1,1,0,0,1,1,0,0,0,0,0,0,0,0,0,0,3
400995807,St. John's Red Storm,T. Alexander,3142305,,False,3.0,0,0,0,0,0,0,0,0,0,0,0,1,0,0,0,1,0
400995807,St. John's Red Storm,TEAM,TOTAL,TOTAL,False,,23,53,16,36,7,17,11,13,12,28,40,12,5,3,18,14,64
400995807,St. John's Red Storm,M. Singleton,4068158,,True,28.0,4,9,4,9,0,0,3,3,2,12,14,1,0,0,5,4,11
400995807,St. John's Red Storm,I. Littleton,3142306,,True,34.0,1,2,1,2,0,0,0,0,3,2,5,1,1,2,2,2,2
400995807,St. John's Red Storm,Q. Hoppie,4281375,,True,32.0,4,9,2,7,2,2,5,6,0,0,0,2,0,1,5,2,15
400995807,St. John's Red Storm,T. England,4068155,,True,32.0,3,8,2,7,1,1,0,0,0,5,5,5,1,0,2,1,7
400995807,St. John's Red Storm,A. Kebbe,4068154,,True,30.0,4,8,3,5,1,3,3,4,5,2,7,1,1,0,1,0,12
400995807,St. John's Red Storm,K. Charles,4281374,,False,6.0,0,0,0,0,0,0,0,0,0,1,1,1,0,0,0,2,0
400995807,St. John's Red Storm,A. Wellere,3906771,,False,17.0,1,6,1,2,0,4,0,0,0,0,0,0,0,0,0,0,2
400995807,St. John's Red Storm,A. Adams,4068157,,False,16.0,5,10,3,4,2,6,0,0,1,4,5,0,2,0,3,2,12
400995807,St. John's Red Storm,S. Duncan,4068156,,False,2.0,1,1,0,0,1,1,0,0,0,0,0,0,0,0,0,0,3
400995807,St. John's Red Storm,T. Alexander,3142305,,False,3.0,0,0,0,0,0,0,0,0,0,0,0,1,0,0,0,1,0
400995807,St. John's Red Storm,TEAM,TOTAL,TOTAL,False,,23,53,16,36,7,17,11,13,12,28,40,12,5,3,18,14,64
400995807,Georgetown Hoyas,C. Petke,4068078,,True,32.0,2,9,2,8,0,1,0,0,1,2,3,0,1,0,2,1,4
400995807,Georgetown Hoyas,Y. Belk,3142295,,True,30.0,2,9,2,9,0,0,0,0,6,4,10,0,2,1,2,3,4
400995807,Georgetown Hoyas,D. White,3948815,,True,37.0,6,16,6,15,0,1,4,6,3,4,7,0,3,1,4,2,16
400995807,Georgetown Hoyas,D. Burton,3142292,,True,11.0,0,0,0,0,0,0,0,0,0,0,0,0,2,0,1,3,0
400995807,Georgetown Hoyas,M. Venson,3142105,,True,38.0,3,9,1,6,2,3,4,4,0,2,2,1,2,0,2,1,12
400995807,Georgetown Hoyas,T. Thompson,4281352,,False,19.0,0,6,0,4,0,2,1,2,0,0,0,0,0,0,1,2,1
400995807,Georgetown Hoyas,M. Smith,4068079,,False,28.0,2,6,2,4,0,2,0,3,3,2,5,0,0,0,2,1,4
400995807,Georgetown Hoyas,B. Mayfield,4281354,,False,5.0,0,0,0,0,0,0,0,0,0,1,1,0,0,0,1,0,0
400995807,Georgetown Hoyas,TEAM,TOTAL,TOTAL,False,,15,55,13,46,2,9,9,15,15,16,31,1,10,2,15,13,41
400995807,Georgetown Hoyas,C. Petke,4068078,,True,32.0,2,9,2,8,0,1,0,0,1,2,3,0,1,0,2,1,4
400995807,Georgetown Hoyas,Y. Belk,3142295,,True,30.0,2,9,2,9,0,0,0,0,6,4,10,0,2,1,2,3,4
400995807,Georgetown Hoyas,D. White,3948815,,True,37.0,6,16,6,15,0,1,4,6,3,4,7,0,3,1,4,2,16
400995807,Georgetown Hoyas,D. Burton,3142292,,True,11.0,0,0,0,0,0,0,0,0,0,0,0,0,2,0,1,3,0
400995807,Georgetown Hoyas,M. Venson,3142105,,True,38.0,3,9,1,6,2,3,4,4,0,2,2,1,2,0,2,1,12
400995807,Georgetown Hoyas,T. Thompson,4281352,,False,19.0,0,6,0,4,0,2,1,2,0,0,0,0,0,0,1,2,1
400995807,Georgetown Hoyas,M. Smith,4068079,,False,28.0,2,6,2,4,0,2,0,3,3,2,5,0,0,0,2,1,4
400995807,Georgetown Hoyas,B. Mayfield,4281354,,False,5.0,0,0,0,0,0,0,0,0,0,1,1,0,0,0,1,0,0
400995807,Georgetown Hoyas,TEAM,TOTAL,TOTAL,False,,15,55,13,46,2,9,9,15,15,16,31,1,10,2,15,13,41
400995806,Xavier Musketeers,I. Partlow,3142320,,True,14.0,3,3,3,3,0,0,0,0,1,1,2,0,0,0,2,0,6
400995806,Xavier Musketeers,A. Aijanen,3142319,,True,26.0,1,5,1,3,0,2,0,0,1,4,5,1,1,1,1,1,2
400995806,Xavier Musketeers,A. Dunham,4281365,,True,31.0,3,7,2,5,1,2,0,0,0,3,3,6,0,0,3,1,7
400995806,Xavier Musketeers,J. Byrd,3142318,,True,26.0,2,6,2,6,0,0,3,4,1,4,5,0,0,0,1,0,7
400995806,Xavier Musketeers,K. Fincher,3142317,,True,24.0,4,15,3,8,1,7,1,1,0,5,5,0,0,0,3,1,10
400995806,Xavier Musketeers,A. Gray,4281368,,False,17.0,2,7,2,6,0,1,0,0,2,4,6,0,0,0,1,4,4
400995806,Xavier Musketeers,D. Ross,4281364,,False,18.0,0,3,0,2,0,1,0,0,0,2,2,0,0,0,1,0,0
400995806,Xavier Musketeers,M. Christopher,4068186,,False,2.0,0,0,0,0,0,0,0,0,0,0,0,0,0,0,0,1,0
400995806,Xavier Musketeers,A. Reiff,4281367,,False,15.0,2,3,1,2,1,1,0,0,0,0,0,0,0,0,1,1,5
400995806,Xavier Musketeers,P. Stewart,4281366,,False,20.0,3,6,2,5,1,1,0,1,0,1,1,1,0,0,5,1,7
400995806,Xavier Musketeers,A. Gomez,4068185,,False,7.0,0,0,0,0,0,0,0,0,0,0,0,0,0,0,1,1,0
400995806,Xavier Musketeers,TEAM,TOTAL,TOTAL,False,,20,55,16,40,4,15,4,6,7,27,34,8,1,1,19,11,48
400995806,Xavier Musketeers,I. Partlow,3142320,,True,14.0,3,3,3,3,0,0,0,0,1,1,2,0,0,0,2,0,6
400995806,Xavier Musketeers,A. Aijanen,3142319,,True,26.0,1,5,1,3,0,2,0,0,1,4,5,1,1,1,1,1,2
400995806,Xavier Musketeers,A. Dunham,4281365,,True,31.0,3,7,2,5,1,2,0,0,0,3,3,6,0,0,3,1,7
400995806,Xavier Musketeers,J. Byrd,3142318,,True,26.0,2,6,2,6,0,0,3,4,1,4,5,0,0,0,1,0,7
400995806,Xavier Musketeers,K. Fincher,3142317,,True,24.0,4,15,3,8,1,7,1,1,0,5,5,0,0,0,3,1,10
400995806,Xavier Musketeers,A. Gray,4281368,,False,17.0,2,7,2,6,0,1,0,0,2,4,6,0,0,0,1,4,4
400995806,Xavier Musketeers,D. Ross,4281364,,False,18.0,0,3,0,2,0,1,0,0,0,2,2,0,0,0,1,0,0
400995806,Xavier Musketeers,M. Christopher,4068186,,False,2.0,0,0,0,0,0,0,0,0,0,0,0,0,0,0,0,1,0
400995806,Xavier Musketeers,A. Reiff,4281367,,False,15.0,2,3,1,2,1,1,0,0,0,0,0,0,0,0,1,1,5
400995806,Xavier Musketeers,P. Stewart,4281366,,False,20.0,3,6,2,5,1,1,0,1,0,1,1,1,0,0,5,1,7
400995806,Xavier Musketeers,A. Gomez,4068185,,False,7.0,0,0,0,0,0,0,0,0,0,0,0,0,0,0,1,1,0
400995806,Xavier Musketeers,TEAM,TOTAL,TOTAL,False,,20,55,16,40,4,15,4,6,7,27,34,8,1,1,19,11,48
400995806,DePaul Blue Demons,C. Stonewall,4068072,,True,26.0,4,11,4,7,0,4,0,0,6,3,9,1,2,2,2,2,8
400995806,DePaul Blue Demons,M. Grays,3142287,,True,21.0,6,13,1,2,5,11,1,1,1,6,7,1,1,1,4,3,18
400995806,DePaul Blue Demons,K. Campbell,4068071,,True,25.0,4,9,1,3,3,6,0,0,2,6,8,4,2,1,1,1,11
400995806,DePaul Blue Demons,A. Millender,3142289,,True,20.0,3,6,1,2,2,4,0,0,1,1,2,0,1,0,0,2,8
400995806,DePaul Blue Demons,A. Coleman,3142123,,True,22.0,4,9,3,6,1,3,0,0,4,1,5,4,2,0,2,1,9
400995806,DePaul Blue Demons,R. McLimore,4281358,,False,7.0,2,2,2,2,0,0,1,2,0,2,2,2,1,2,0,0,5
400995806,DePaul Blue Demons,V. Sherrod,4281359,,False,5.0,2,4,0,1,2,3,0,0,0,1,1,0,0,0,0,2,6
400995806,DePaul Blue Demons,D. Bekelja,4281356,,False,11.0,0,2,0,0,0,2,1,2,0,1,1,0,0,0,0,1,1
400995806,DePaul Blue Demons,D. Cage,4068073,,False,19.0,3,5,3,3,0,2,2,2,0,3,3,2,0,0,0,1,8
400995806,DePaul Blue Demons,T. Allen,3933760,,False,20.0,2,7,1,2,1,5,0,0,0,2,2,1,2,0,1,1,5
400995806,DePaul Blue Demons,L. Prochaska,3142290,,False,24.0,0,2,0,0,0,2,0,0,0,1,1,2,0,1,0,1,0
400995806,DePaul Blue Demons,TEAM,TOTAL,TOTAL,False,,30,70,16,28,14,42,5,7,14,30,44,17,11,7,10,15,79
400995806,DePaul Blue Demons,C. Stonewall,4068072,,True,26.0,4,11,4,7,0,4,0,0,6,3,9,1,2,2,2,2,8
400995806,DePaul Blue Demons,M. Grays,3142287,,True,21.0,6,13,1,2,5,11,1,1,1,6,7,1,1,1,4,3,18
400995806,DePaul Blue Demons,K. Campbell,4068071,,True,25.0,4,9,1,3,3,6,0,0,2,6,8,4,2,1,1,1,11
400995806,DePaul Blue Demons,A. Millender,3142289,,True,20.0,3,6,1,2,2,4,0,0,1,1,2,0,1,0,0,2,8
400995806,DePaul Blue Demons,A. Coleman,3142123,,True,22.0,4,9,3,6,1,3,0,0,4,1,5,4,2,0,2,1,9
400995806,DePaul Blue Demons,R. McLimore,4281358,,False,7.0,2,2,2,2,0,0,1,2,0,2,2,2,1,2,0,0,5
400995806,DePaul Blue Demons,V. Sherrod,4281359,,False,5.0,2,4,0,1,2,3,0,0,0,1,1,0,0,0,0,2,6
400995806,DePaul Blue Demons,D. Bekelja,4281356,,False,11.0,0,2,0,0,0,2,1,2,0,1,1,0,0,0,0,1,1
400995806,DePaul Blue Demons,D. Cage,4068073,,False,19.0,3,5,3,3,0,2,2,2,0,3,3,2,0,0,0,1,8
400995806,DePaul Blue Demons,T. Allen,3933760,,False,20.0,2,7,1,2,1,5,0,0,0,2,2,1,2,0,1,1,5
400995806,DePaul Blue Demons,L. Prochaska,3142290,,False,24.0,0,2,0,0,0,2,0,0,0,1,1,2,0,1,0,1,0
400995806,DePaul Blue Demons,TEAM,TOTAL,TOTAL,False,,30,70,16,28,14,42,5,7,14,30,44,17,11,7,10,15,79
400995805,DePaul Blue Demons,C. Stonewall,4068072,,True,21.0,4,10,4,9,0,1,3,3,2,0,2,1,3,0,1,0,11
400995805,DePaul Blue Demons,M. Grays,3142287,,True,24.0,4,11,2,7,2,4,1,2,1,3,4,2,1,2,4,1,11
400995805,DePaul Blue Demons,K. Campbell,4068071,,True,31.0,4,7,2,4,2,3,2,2,3,8,11,5,0,2,0,1,12
400995805,DePaul Blue Demons,A. Millender,3142289,,True,26.0,5,9,2,3,3,6,0,1,0,1,1,3,0,0,1,1,13
400995805,DePaul Blue Demons,A. Coleman,3142123,,True,25.0,3,5,1,2,2,3,0,0,0,3,3,3,3,0,2,2,8
400995805,DePaul Blue Demons,R. McLimore,4281358,,False,6.0,1,2,1,1,0,1,0,0,1,0,1,1,1,0,1,0,2
400995805,DePaul Blue Demons,V. Sherrod,4281359,,False,3.0,0,0,0,0,0,0,0,0,0,0,0,0,0,0,0,0,0
400995805,DePaul Blue Demons,D. Bekelja,4281356,,False,7.0,1,2,1,2,0,0,0,0,0,1,1,1,0,0,0,1,2
400995805,DePaul Blue Demons,D. Cage,4068073,,False,14.0,3,6,1,3,2,3,0,0,0,3,3,2,0,0,0,1,8
400995805,DePaul Blue Demons,T. Allen,3933760,,False,23.0,5,8,3,4,2,4,0,0,0,5,5,1,0,0,0,3,12
400995805,DePaul Blue Demons,L. Prochaska,3142290,,False,20.0,1,1,0,0,1,1,0,0,0,3,3,6,1,0,1,1,3
400995805,DePaul Blue Demons,TEAM,TOTAL,TOTAL,False,,31,61,17,35,14,26,6,8,9,31,40,25,9,4,12,11,82
400995805,DePaul Blue Demons,C. Stonewall,4068072,,True,21.0,4,10,4,9,0,1,3,3,2,0,2,1,3,0,1,0,11
400995805,DePaul Blue Demons,M. Grays,3142287,,True,24.0,4,11,2,7,2,4,1,2,1,3,4,2,1,2,4,1,11
400995805,DePaul Blue Demons,K. Campbell,4068071,,True,31.0,4,7,2,4,2,3,2,2,3,8,11,5,0,2,0,1,12
400995805,DePaul Blue Demons,A. Millender,3142289,,True,26.0,5,9,2,3,3,6,0,1,0,1,1,3,0,0,1,1,13
400995805,DePaul Blue Demons,A. Coleman,3142123,,True,25.0,3,5,1,2,2,3,0,0,0,3,3,3,3,0,2,2,8
400995805,DePaul Blue Demons,R. McLimore,4281358,,False,6.0,1,2,1,1,0,1,0,0,1,0,1,1,1,0,1,0,2
400995805,DePaul Blue Demons,V. Sherrod,4281359,,False,3.0,0,0,0,0,0,0,0,0,0,0,0,0,0,0,0,0,0
400995805,DePaul Blue Demons,D. Bekelja,4281356,,False,7.0,1,2,1,2,0,0,0,0,0,1,1,1,0,0,0,1,2
400995805,DePaul Blue Demons,D. Cage,4068073,,False,14.0,3,6,1,3,2,3,0,0,0,3,3,2,0,0,0,1,8
400995805,DePaul Blue Demons,T. Allen,3933760,,False,23.0,5,8,3,4,2,4,0,0,0,5,5,1,0,0,0,3,12
400995805,DePaul Blue Demons,L. Prochaska,3142290,,False,20.0,1,1,0,0,1,1,0,0,0,3,3,6,1,0,1,1,3
400995805,DePaul Blue Demons,TEAM,TOTAL,TOTAL,False,,31,61,17,35,14,26,6,8,9,31,40,25,9,4,12,11,82
400995805,Creighton Bluejays,A. Faber,3938938,,True,32.0,6,17,3,10,3,7,1,1,1,2,3,5,1,1,4,3,16
400995805,Creighton Bluejays,J. Agnew,3938935,,True,33.0,2,6,1,1,1,5,2,2,0,6,6,3,1,2,0,0,7
400995805,Creighton Bluejays,B. Norby,3142284,,True,13.0,3,6,3,6,0,0,0,0,2,2,4,0,0,0,1,1,6
400995805,Creighton Bluejays,S. Lamberty,3142285,,True,31.0,3,7,3,5,0,2,0,0,0,1,1,3,0,0,3,0,6
400995805,Creighton Bluejays,M. Mellman,3142283,,True,12.0,1,3,0,1,1,2,0,0,1,2,3,3,0,0,0,0,3
400995805,Creighton Bluejays,A. Greene,3938937,,False,8.0,1,2,1,2,0,0,0,0,1,2,3,1,0,0,0,1,2
400995805,Creighton Bluejays,K. Brown,3142286,,False,16.0,1,3,1,3,0,0,0,0,1,1,2,1,0,1,1,0,2
400995805,Creighton Bluejays,T. Carda,4281362,,False,14.0,3,6,2,4,1,2,0,1,0,1,1,2,0,0,0,1,7
400995805,Creighton Bluejays,T. Rembao,4281361,,False,8.0,1,2,1,1,0,1,0,0,0,2,2,0,0,0,1,1,2
400995805,Creighton Bluejays,O. Elger,3938936,,False,20.0,1,7,0,4,1,3,0,0,1,3,4,1,0,0,5,2,3
400995805,Creighton Bluejays,B. Kissinger,3142124,,False,13.0,0,1,0,0,0,1,0,2,0,0,0,1,0,0,0,2,0
400995805,Creighton Bluejays,TEAM,TOTAL,TOTAL,False,,22,60,15,37,7,23,3,6,9,22,31,20,2,4,15,11,54
400995805,Creighton Bluejays,A. Faber,3938938,,True,32.0,6,17,3,10,3,7,1,1,1,2,3,5,1,1,4,3,16
400995805,Creighton Bluejays,J. Agnew,3938935,,True,33.0,2,6,1,1,1,5,2,2,0,6,6,3,1,2,0,0,7
400995805,Creighton Bluejays,B. Norby,3142284,,True,13.0,3,6,3,6,0,0,0,0,2,2,4,0,0,0,1,1,6
400995805,Creighton Bluejays,S. Lamberty,3142285,,True,31.0,3,7,3,5,0,2,0,0,0,1,1,3,0,0,3,0,6
400995805,Creighton Bluejays,M. Mellman,3142283,,True,12.0,1,3,0,1,1,2,0,0,1,2,3,3,0,0,0,0,3
400995805,Creighton Bluejays,A. Greene,3938937,,False,8.0,1,2,1,2,0,0,0,0,1,2,3,1,0,0,0,1,2
400995805,Creighton Bluejays,K. Brown,3142286,,False,16.0,1,3,1,3,0,0,0,0,1,1,2,1,0,1,1,0,2
400995805,Creighton Bluejays,T. Carda,4281362,,False,14.0,3,6,2,4,1,2,0,1,0,1,1,2,0,0,0,1,7
400995805,Creighton Bluejays,T. Rembao,4281361,,False,8.0,1,2,1,1,0,1,0,0,0,2,2,0,0,0,1,1,2
400995805,Creighton Bluejays,O. Elger,3938936,,False,20.0,1,7,0,4,1,3,0,0,1,3,4,1,0,0,5,2,3
400995805,Creighton Bluejays,B. Kissinger,3142124,,False,13.0,0,1,0,0,0,1,0,2,0,0,0,1,0,0,0,2,0
400995805,Creighton Bluejays,TEAM,TOTAL,TOTAL,False,,22,60,15,37,7,23,3,6,9,22,31,20,2,4,15,11,54
400995804,Xavier Musketeers,D. Ross,4281364,,True,18.0,4,4,0,0,4,4,2,2,0,4,4,1,2,0,1,1,14
400995804,Xavier Musketeers,A. Aijanen,3142319,,True,33.0,2,6,0,1,2,5,2,2,2,5,7,4,1,1,3,2,8
400995804,Xavier Musketeers,A. Dunham,4281365,,True,24.0,0,3,0,1,0,2,2,2,1,1,2,5,2,0,6,0,2
400995804,Xavier Musketeers,J. Byrd,3142318,,True,29.0,2,9,2,8,0,1,0,0,2,0,2,1,1,0,6,2,4
400995804,Xavier Musketeers,K. Fincher,3142317,,True,29.0,0,6,0,0,0,6,0,0,0,2,2,1,2,0,4,1,0
400995804,Xavier Musketeers,A. Gray,4281368,,False,7.0,0,1,0,1,0,0,0,0,0,2,2,0,1,0,0,0,0
400995804,Xavier Musketeers,I. Partlow,3142320,,False,22.0,5,7,5,7,0,0,0,0,0,4,4,1,0,0,1,3,10
400995804,Xavier Musketeers,A. Reiff,4281367,,False,6.0,1,2,1,2,0,0,2,2,0,0,0,0,0,0,0,1,4
400995804,Xavier Musketeers,P. Stewart,4281366,,False,16.0,2,6,2,5,0,1,2,3,0,2,2,0,0,0,4,0,6
400995804,Xavier Musketeers,A. Gomez,4068185,,False,16.0,1,2,0,0,1,2,0,0,0,4,4,0,0,0,0,0,3
400995804,Xavier Musketeers,TEAM,TOTAL,TOTAL,False,,17,46,10,25,7,21,10,11,8,24,32,13,9,1,25,10,51
400995804,Xavier Musketeers,D. Ross,4281364,,True,18.0,4,4,0,0,4,4,2,2,0,4,4,1,2,0,1,1,14
400995804,Xavier Musketeers,A. Aijanen,3142319,,True,33.0,2,6,0,1,2,5,2,2,2,5,7,4,1,1,3,2,8
400995804,Xavier Musketeers,A. Dunham,4281365,,True,24.0,0,3,0,1,0,2,2,2,1,1,2,5,2,0,6,0,2
400995804,Xavier Musketeers,J. Byrd,3142318,,True,29.0,2,9,2,8,0,1,0,0,2,0,2,1,1,0,6,2,4
400995804,Xavier Musketeers,K. Fincher,3142317,,True,29.0,0,6,0,0,0,6,0,0,0,2,2,1,2,0,4,1,0
400995804,Xavier Musketeers,A. Gray,4281368,,False,7.0,0,1,0,1,0,0,0,0,0,2,2,0,1,0,0,0,0
400995804,Xavier Musketeers,I. Partlow,3142320,,False,22.0,5,7,5,7,0,0,0,0,0,4,4,1,0,0,1,3,10
400995804,Xavier Musketeers,A. Reiff,4281367,,False,6.0,1,2,1,2,0,0,2,2,0,0,0,0,0,0,0,1,4
400995804,Xavier Musketeers,P. Stewart,4281366,,False,16.0,2,6,2,5,0,1,2,3,0,2,2,0,0,0,4,0,6
400995804,Xavier Musketeers,A. Gomez,4068185,,False,16.0,1,2,0,0,1,2,0,0,0,4,4,0,0,0,0,0,3
400995804,Xavier Musketeers,TEAM,TOTAL,TOTAL,False,,17,46,10,25,7,21,10,11,8,24,32,13,9,1,25,10,51
400995804,Seton Hall Pirates,S. Samuels,4068128,,True,27.0,3,6,3,6,0,0,0,1,2,5,7,0,0,2,1,4,6
400995804,Seton Hall Pirates,D. Fountain,3058890,,True,33.0,6,12,6,9,0,3,5,7,1,6,7,1,2,0,3,2,17
400995804,Seton Hall Pirates,K. Evans,4281378,,True,19.0,3,5,3,5,0,0,0,0,0,1,1,0,1,2,1,2,6
400995804,Seton Hall Pirates,I. Butina,4281377,,True,34.0,3,8,3,6,0,2,0,0,0,1,1,5,4,0,5,2,6
400995804,Seton Hall Pirates,J. Jackson,3064877,,True,22.0,4,10,2,6,2,4,0,0,0,0,0,3,3,0,2,2,10
400995804,Seton Hall Pirates,S. Philoxy,4281380,,False,18.0,2,4,2,4,0,0,0,0,2,4,6,0,2,0,4,3,4
400995804,Seton Hall Pirates,T. Brown,3941336,,False,16.0,4,6,4,6,0,0,2,2,1,2,3,1,2,0,0,2,10
400995804,Seton Hall Pirates,D. Winters,4068126,,False,6.0,0,2,0,1,0,1,0,0,0,0,0,0,0,0,0,0,0
400995804,Seton Hall Pirates,N. Jimenez,4281379,,False,18.0,1,2,0,0,1,2,0,0,0,2,2,6,2,0,2,2,3
400995804,Seton Hall Pirates,K. Healy,3943704,,False,7.0,0,0,0,0,0,0,0,0,0,0,0,0,0,0,0,1,0
400995804,Seton Hall Pirates,TEAM,TOTAL,TOTAL,False,,26,55,23,43,3,12,7,10,7,22,29,16,16,4,18,20,62
400995804,Seton Hall Pirates,S. Samuels,4068128,,True,27.0,3,6,3,6,0,0,0,1,2,5,7,0,0,2,1,4,6
400995804,Seton Hall Pirates,D. Fountain,3058890,,True,33.0,6,12,6,9,0,3,5,7,1,6,7,1,2,0,3,2,17
400995804,Seton Hall Pirates,K. Evans,4281378,,True,19.0,3,5,3,5,0,0,0,0,0,1,1,0,1,2,1,2,6
400995804,Seton Hall Pirates,I. Butina,4281377,,True,34.0,3,8,3,6,0,2,0,0,0,1,1,5,4,0,5,2,6
400995804,Seton Hall Pirates,J. Jackson,3064877,,True,22.0,4,10,2,6,2,4,0,0,0,0,0,3,3,0,2,2,10
400995804,Seton Hall Pirates,S. Philoxy,4281380,,False,18.0,2,4,2,4,0,0,0,0,2,4,6,0,2,0,4,3,4
400995804,Seton Hall Pirates,T. Brown,3941336,,False,16.0,4,6,4,6,0,0,2,2,1,2,3,1,2,0,0,2,10
400995804,Seton Hall Pirates,D. Winters,4068126,,False,6.0,0,2,0,1,0,1,0,0,0,0,0,0,0,0,0,0,0
400995804,Seton Hall Pirates,N. Jimenez,4281379,,False,18.0,1,2,0,0,1,2,0,0,0,2,2,6,2,0,2,2,3
400995804,Seton Hall Pirates,K. Healy,3943704,,False,7.0,0,0,0,0,0,0,0,0,0,0,0,0,0,0,0,1,0
400995804,Seton Hall Pirates,TEAM,TOTAL,TOTAL,False,,26,55,23,43,3,12,7,10,7,22,29,16,16,4,18,20,62
400995803,Providence Friars,B. Frias,3142302,,True,8.0,0,0,0,0,0,0,0,0,0,2,2,1,0,1,0,2,0
400995803,Providence Friars,K. Spiwak,4281346,,True,28.0,1,4,1,4,0,0,1,2,1,1,2,1,1,0,2,2,3
400995803,Providence Friars,C. Williams,4281345,,True,24.0,3,8,3,8,0,0,5,5,0,6,6,3,5,0,1,5,11
400995803,Providence Friars,J. Nogic,3906769,,True,32.0,8,17,4,8,4,9,4,4,0,5,5,0,0,0,7,1,24
400995803,Providence Friars,M. Jolin,3906767,,True,19.0,1,5,0,1,1,4,0,0,0,1,1,1,1,0,3,4,3
400995803,Providence Friars,N. Franklin,4281348,,False,26.0,4,6,4,6,0,0,1,2,4,3,7,1,2,0,4,2,9
400995803,Providence Friars,O. Orlando,4281347,,False,3.0,0,0,0,0,0,0,0,0,0,0,0,0,0,0,0,1,0
400995803,Providence Friars,N. Jackson,4068111,,False,19.0,1,4,1,4,0,0,0,2,1,4,5,2,0,0,1,2,2
400995803,Providence Friars,C. Che,3906766,,False,31.0,3,8,2,4,1,4,1,1,0,2,2,1,0,0,3,2,8
400995803,Providence Friars,A. Botteghi,3142301,,False,10.0,0,0,0,0,0,0,0,0,1,2,3,0,0,0,1,1,0
400995803,Providence Friars,TEAM,TOTAL,TOTAL,False,,21,52,15,35,6,17,12,16,8,28,36,10,9,1,24,22,60
400995803,Providence Friars,B. Frias,3142302,,True,8.0,0,0,0,0,0,0,0,0,0,2,2,1,0,1,0,2,0
400995803,Providence Friars,K. Spiwak,4281346,,True,28.0,1,4,1,4,0,0,1,2,1,1,2,1,1,0,2,2,3
400995803,Providence Friars,C. Williams,4281345,,True,24.0,3,8,3,8,0,0,5,5,0,6,6,3,5,0,1,5,11
400995803,Providence Friars,J. Nogic,3906769,,True,32.0,8,17,4,8,4,9,4,4,0,5,5,0,0,0,7,1,24
400995803,Providence Friars,M. Jolin,3906767,,True,19.0,1,5,0,1,1,4,0,0,0,1,1,1,1,0,3,4,3
400995803,Providence Friars,N. Franklin,4281348,,False,26.0,4,6,4,6,0,0,1,2,4,3,7,1,2,0,4,2,9
400995803,Providence Friars,O. Orlando,4281347,,False,3.0,0,0,0,0,0,0,0,0,0,0,0,0,0,0,0,1,0
400995803,Providence Friars,N. Jackson,4068111,,False,19.0,1,4,1,4,0,0,0,2,1,4,5,2,0,0,1,2,2
400995803,Providence Friars,C. Che,3906766,,False,31.0,3,8,2,4,1,4,1,1,0,2,2,1,0,0,3,2,8
400995803,Providence Friars,A. Botteghi,3142301,,False,10.0,0,0,0,0,0,0,0,0,1,2,3,0,0,0,1,1,0
400995803,Providence Friars,TEAM,TOTAL,TOTAL,False,,21,52,15,35,6,17,12,16,8,28,36,10,9,1,24,22,60
400995803,Marquette Golden Eagles,E. Davenport,3906756,,True,27.0,4,12,4,12,0,0,2,6,4,13,17,1,3,0,2,0,10
400995803,Marquette Golden Eagles,A. Wilborn,3906758,,True,31.0,3,9,3,8,0,1,6,8,2,3,5,5,3,0,1,1,12
400995803,Marquette Golden Eagles,A. Blockton,3906755,,True,28.0,7,14,7,13,0,1,4,5,2,2,4,3,2,0,3,2,18
400995803,Marquette Golden Eagles,N. Hiedeman,3906753,,True,16.0,2,5,1,3,1,2,0,0,0,1,1,1,1,0,0,5,5
400995803,Marquette Golden Eagles,D. King,3906752,,True,37.0,7,10,5,7,2,3,5,5,0,1,1,2,0,0,4,1,21
400995803,Marquette Golden Eagles,M. Smith Traore,4281351,,False,3.0,1,2,0,0,1,2,0,0,0,1,1,0,0,0,0,1,3
400995803,Marquette Golden Eagles,A. Anderson,4068081,,False,2.0,0,0,0,0,0,0,0,0,0,0,0,0,0,0,0,0,0
400995803,Marquette Golden Eagles,S. Dahling,3906754,,False,2.0,0,0,0,0,0,0,0,0,0,0,0,0,0,0,0,2,0
400995803,Marquette Golden Eagles,L. Van Kleunen,4068083,,False,12.0,1,2,1,1,0,1,0,0,1,1,2,0,0,0,0,2,2
400995803,Marquette Golden Eagles,S. Valentine,3142300,,False,3.0,0,0,0,0,0,0,0,0,0,0,0,0,0,0,0,0,0
400995803,Marquette Golden Eagles,S. Lott,4281350,,False,22.0,1,4,0,0,1,4,0,0,0,0,0,0,1,1,1,5,3
400995803,Marquette Golden Eagles,I. Spingola,4068082,,False,16.0,1,4,0,0,1,4,0,0,0,2,2,0,0,0,0,1,3
400995803,Marquette Golden Eagles,O. Moskari,3906757,,False,1.0,0,0,0,0,0,0,0,0,0,0,0,0,0,0,1,0,0
400995803,Marquette Golden Eagles,TEAM,TOTAL,TOTAL,False,,27,62,21,44,6,18,17,24,11,25,36,12,10,1,12,20,77
400995803,Marquette Golden Eagles,E. Davenport,3906756,,True,27.0,4,12,4,12,0,0,2,6,4,13,17,1,3,0,2,0,10
400995803,Marquette Golden Eagles,A. Wilborn,3906758,,True,31.0,3,9,3,8,0,1,6,8,2,3,5,5,3,0,1,1,12
400995803,Marquette Golden Eagles,A. Blockton,3906755,,True,28.0,7,14,7,13,0,1,4,5,2,2,4,3,2,0,3,2,18
400995803,Marquette Golden Eagles,N. Hiedeman,3906753,,True,16.0,2,5,1,3,1,2,0,0,0,1,1,1,1,0,0,5,5
400995803,Marquette Golden Eagles,D. King,3906752,,True,37.0,7,10,5,7,2,3,5,5,0,1,1,2,0,0,4,1,21
400995803,Marquette Golden Eagles,M. Smith Traore,4281351,,False,3.0,1,2,0,0,1,2,0,0,0,1,1,0,0,0,0,1,3
400995803,Marquette Golden Eagles,A. Anderson,4068081,,False,2.0,0,0,0,0,0,0,0,0,0,0,0,0,0,0,0,0,0
400995803,Marquette Golden Eagles,S. Dahling,3906754,,False,2.0,0,0,0,0,0,0,0,0,0,0,0,0,0,0,0,2,0
400995803,Marquette Golden Eagles,L. Van Kleunen,4068083,,False,12.0,1,2,1,1,0,1,0,0,1,1,2,0,0,0,0,2,2
400995803,Marquette Golden Eagles,S. Valentine,3142300,,False,3.0,0,0,0,0,0,0,0,0,0,0,0,0,0,0,0,0,0
400995803,Marquette Golden Eagles,S. Lott,4281350,,False,22.0,1,4,0,0,1,4,0,0,0,0,0,0,1,1,1,5,3
400995803,Marquette Golden Eagles,I. Spingola,4068082,,False,16.0,1,4,0,0,1,4,0,0,0,2,2,0,0,0,0,1,3
400995803,Marquette Golden Eagles,O. Moskari,3906757,,False,1.0,0,0,0,0,0,0,0,0,0,0,0,0,0,0,1,0,0
400995803,Marquette Golden Eagles,TEAM,TOTAL,TOTAL,False,,27,62,21,44,6,18,17,24,11,25,36,12,10,1,12,20,77
400995802,Villanova Wildcats,M. Quinn,3056785,,True,13.0,3,4,2,2,1,2,0,0,0,1,1,0,1,0,1,2,7
400995802,Villanova Wildcats,J. Tucker,3087536,,True,35.0,3,10,1,4,2,6,0,0,0,1,1,2,1,0,2,2,8
400995802,Villanova Wildcats,K. Jekot,4068171,,True,36.0,5,11,3,6,2,5,2,2,0,4,4,3,0,1,2,2,14
400995802,Villanova Wildcats,A. Hahn,3906779,,True,37.0,6,10,2,5,4,5,1,2,1,7,8,3,0,0,2,1,17
400995802,Villanova Wildcats,A. Louin,3142314,,True,30.0,3,8,3,7,0,1,1,6,2,6,8,3,0,1,2,1,7
400995802,Villanova Wildcats,M. Gedaka,4068172,,False,32.0,2,7,2,6,0,1,1,1,1,4,5,3,1,1,0,2,5
400995802,Villanova Wildcats,B. Herlihy,3906778,,False,13.0,1,3,1,1,0,2,0,0,1,4,5,1,0,0,2,2,2
400995802,Villanova Wildcats,G. Stant,3906780,,False,1.0,0,0,0,0,0,0,0,0,0,1,1,0,0,0,0,0,0
400995802,Villanova Wildcats,R. James,4068168,,False,3.0,0,0,0,0,0,0,0,0,0,0,0,2,0,0,0,0,0
400995802,Villanova Wildcats,TEAM,TOTAL,TOTAL,False,,23,53,14,31,9,22,5,11,5,30,35,17,3,3,13,12,60
400995802,Villanova Wildcats,M. Quinn,3056785,,True,13.0,3,4,2,2,1,2,0,0,0,1,1,0,1,0,1,2,7
400995802,Villanova Wildcats,J. Tucker,3087536,,True,35.0,3,10,1,4,2,6,0,0,0,1,1,2,1,0,2,2,8
400995802,Villanova Wildcats,K. Jekot,4068171,,True,36.0,5,11,3,6,2,5,2,2,0,4,4,3,0,1,2,2,14
400995802,Villanova Wildcats,A. Hahn,3906779,,True,37.0,6,10,2,5,4,5,1,2,1,7,8,3,0,0,2,1,17
400995802,Villanova Wildcats,A. Louin,3142314,,True,30.0,3,8,3,7,0,1,1,6,2,6,8,3,0,1,2,1,7
400995802,Villanova Wildcats,M. Gedaka,4068172,,False,32.0,2,7,2,6,0,1,1,1,1,4,5,3,1,1,0,2,5
400995802,Villanova Wildcats,B. Herlihy,3906778,,False,13.0,1,3,1,1,0,2,0,0,1,4,5,1,0,0,2,2,2
400995802,Villanova Wildcats,G. Stant,3906780,,False,1.0,0,0,0,0,0,0,0,0,0,1,1,0,0,0,0,0,0
400995802,Villanova Wildcats,R. James,4068168,,False,3.0,0,0,0,0,0,0,0,0,0,0,0,2,0,0,0,0,0
400995802,Villanova Wildcats,TEAM,TOTAL,TOTAL,False,,23,53,14,31,9,22,5,11,5,30,35,17,3,3,13,12,60
400995802,Georgetown Hoyas,C. Petke,4068078,,True,37.0,2,8,2,7,0,1,1,3,3,9,12,1,1,0,1,0,5
400995802,Georgetown Hoyas,Y. Belk,3142295,,True,5.0,0,1,0,1,0,0,0,0,0,2,2,0,0,0,2,1,0
400995802,Georgetown Hoyas,D. White,3948815,,True,33.0,8,16,8,14,0,2,3,5,1,3,4,2,1,0,2,3,19
400995802,Georgetown Hoyas,D. Burton,3142292,,True,34.0,2,4,2,4,0,0,1,1,0,2,2,3,1,0,0,2,5
400995802,Georgetown Hoyas,M. Venson,3142105,,True,37.0,3,11,3,10,0,1,2,3,0,4,4,4,2,1,2,3,8
400995802,Georgetown Hoyas,T. Thompson,4281352,,False,28.0,5,11,3,5,2,6,1,2,1,1,2,0,0,0,0,1,13
400995802,Georgetown Hoyas,M. Smith,4068079,,False,26.0,4,9,4,7,0,2,0,0,1,4,5,1,3,1,1,1,8
400995802,Georgetown Hoyas,TEAM,TOTAL,TOTAL,False,,24,60,22,48,2,12,8,14,8,26,34,11,8,2,9,11,58
400995802,Georgetown Hoyas,C. Petke,4068078,,True,37.0,2,8,2,7,0,1,1,3,3,9,12,1,1,0,1,0,5
400995802,Georgetown Hoyas,Y. Belk,3142295,,True,5.0,0,1,0,1,0,0,0,0,0,2,2,0,0,0,2,1,0
400995802,Georgetown Hoyas,D. White,3948815,,True,33.0,8,16,8,14,0,2,3,5,1,3,4,2,1,0,2,3,19
400995802,Georgetown Hoyas,D. Burton,3142292,,True,34.0,2,4,2,4,0,0,1,1,0,2,2,3,1,0,0,2,5
400995802,Georgetown Hoyas,M. Venson,3142105,,True,37.0,3,11,3,10,0,1,2,3,0,4,4,4,2,1,2,3,8
400995802,Georgetown Hoyas,T. Thompson,4281352,,False,28.0,5,11,3,5,2,6,1,2,1,1,2,0,0,0,0,1,13
400995802,Georgetown Hoyas,M. Smith,4068079,,False,26.0,4,9,4,7,0,2,0,0,1,4,5,1,3,1,1,1,8
400995802,Georgetown Hoyas,TEAM,TOTAL,TOTAL,False,,24,60,22,48,2,12,8,14,8,26,34,11,8,2,9,11,58
400995801,St. John's Red Storm,M. Singleton,4068158,,True,23.0,4,8,4,8,0,0,4,4,5,5,10,0,3,1,1,4,12
400995801,St. John's Red Storm,I. Littleton,3142306,,True,25.0,4,5,4,5,0,0,1,1,1,2,3,0,1,1,0,4,9
400995801,St. John's Red Storm,Q. Hoppie,4281375,,True,38.0,5,14,5,11,0,3,4,5,0,1,1,3,2,1,1,1,14
400995801,St. John's Red Storm,T. England,4068155,,True,38.0,4,9,3,6,1,3,0,3,0,1,1,6,0,0,4,0,9
400995801,St. John's Red Storm,A. Kebbe,4068154,,True,35.0,6,14,5,8,1,6,1,1,5,6,11,4,3,0,0,1,14
400995801,St. John's Red Storm,K. Charles,4281374,,False,12.0,3,4,3,4,0,0,0,0,2,1,3,0,0,1,3,3,6
400995801,St. John's Red Storm,A. Adams,4068157,,False,25.0,3,6,3,3,0,3,3,4,0,2,2,3,1,0,3,0,9
400995801,St. John's Red Storm,S. Duncan,4068156,,False,2.0,0,1,0,0,0,1,0,0,0,0,0,0,0,0,0,0,0
400995801,St. John's Red Storm,T. Alexander,3142305,,False,2.0,0,0,0,0,0,0,0,0,0,1,1,0,0,0,1,0,0
400995801,St. John's Red Storm,TEAM,TOTAL,TOTAL,False,,29,61,27,45,2,16,13,18,14,21,35,16,10,4,15,13,73
400995801,St. John's Red Storm,M. Singleton,4068158,,True,23.0,4,8,4,8,0,0,4,4,5,5,10,0,3,1,1,4,12
400995801,St. John's Red Storm,I. Littleton,3142306,,True,25.0,4,5,4,5,0,0,1,1,1,2,3,0,1,1,0,4,9
400995801,St. John's Red Storm,Q. Hoppie,4281375,,True,38.0,5,14,5,11,0,3,4,5,0,1,1,3,2,1,1,1,14
400995801,St. John's Red Storm,T. England,4068155,,True,38.0,4,9,3,6,1,3,0,3,0,1,1,6,0,0,4,0,9
400995801,St. John's Red Storm,A. Kebbe,4068154,,True,35.0,6,14,5,8,1,6,1,1,5,6,11,4,3,0,0,1,14
400995801,St. John's Red Storm,K. Charles,4281374,,False,12.0,3,4,3,4,0,0,0,0,2,1,3,0,0,1,3,3,6
400995801,St. John's Red Storm,A. Adams,4068157,,False,25.0,3,6,3,3,0,3,3,4,0,2,2,3,1,0,3,0,9
400995801,St. John's Red Storm,S. Duncan,4068156,,False,2.0,0,1,0,0,0,1,0,0,0,0,0,0,0,0,0,0,0
400995801,St. John's Red Storm,T. Alexander,3142305,,False,2.0,0,0,0,0,0,0,0,0,0,1,1,0,0,0,1,0,0
400995801,St. John's Red Storm,TEAM,TOTAL,TOTAL,False,,29,61,27,45,2,16,13,18,14,21,35,16,10,4,15,13,73
400995801,Butler Bulldogs,T. Schickel,3914012,,True,34.0,4,8,4,8,0,0,11,11,3,4,7,4,1,2,5,3,19
400995801,Butler Bulldogs,S. Humphrey,4068066,,True,5.0,1,1,1,1,0,0,0,0,1,0,1,1,0,0,0,0,2
400995801,Butler Bulldogs,M. Weaver,3914014,,True,33.0,2,3,2,3,0,0,1,1,0,2,2,0,2,0,2,4,5
400995801,Butler Bulldogs,W. Jennings,3142145,,True,38.0,2,15,2,10,0,5,2,2,0,5,5,2,1,0,5,2,6
400995801,Butler Bulldogs,I. Lathan,3079485,,True,15.0,4,7,4,7,0,0,0,0,0,2,2,1,2,0,2,4,8
400995801,Butler Bulldogs,A. Aube,4281363,,False,2.0,0,1,0,0,0,1,0,0,0,0,0,0,0,0,0,0,0
400995801,Butler Bulldogs,S. Brey,4068067,,False,33.0,3,4,3,4,0,0,2,2,4,3,7,2,1,0,2,1,8
400995801,Butler Bulldogs,K. Hodges,4068065,,False,9.0,0,1,0,1,0,0,0,0,0,0,0,0,1,0,2,3,0
400995801,Butler Bulldogs,K. Spolyar,4068068,,False,29.0,3,10,2,5,1,5,0,0,0,3,3,1,2,0,2,4,7
400995801,Butler Bulldogs,S. Buck,3142279,,False,2.0,0,0,0,0,0,0,0,0,0,0,0,0,0,0,0,0,0
400995801,Butler Bulldogs,TEAM,TOTAL,TOTAL,False,,19,50,18,39,1,11,16,16,9,20,29,11,10,2,20,21,55
400995801,Butler Bulldogs,T. Schickel,3914012,,True,34.0,4,8,4,8,0,0,11,11,3,4,7,4,1,2,5,3,19
400995801,Butler Bulldogs,S. Humphrey,4068066,,True,5.0,1,1,1,1,0,0,0,0,1,0,1,1,0,0,0,0,2
400995801,Butler Bulldogs,M. Weaver,3914014,,True,33.0,2,3,2,3,0,0,1,1,0,2,2,0,2,0,2,4,5
400995801,Butler Bulldogs,W. Jennings,3142145,,True,38.0,2,15,2,10,0,5,2,2,0,5,5,2,1,0,5,2,6
400995801,Butler Bulldogs,I. Lathan,3079485,,True,15.0,4,7,4,7,0,0,0,0,0,2,2,1,2,0,2,4,8
400995801,Butler Bulldogs,A. Aube,4281363,,False,2.0,0,1,0,0,0,1,0,0,0,0,0,0,0,0,0,0,0
400995801,Butler Bulldogs,S. Brey,4068067,,False,33.0,3,4,3,4,0,0,2,2,4,3,7,2,1,0,2,1,8
400995801,Butler Bulldogs,K. Hodges,4068065,,False,9.0,0,1,0,1,0,0,0,0,0,0,0,0,1,0,2,3,0
400995801,Butler Bulldogs,K. Spolyar,4068068,,False,29.0,3,10,2,5,1,5,0,0,0,3,3,1,2,0,2,4,7
400995801,Butler Bulldogs,S. Buck,3142279,,False,2.0,0,0,0,0,0,0,0,0,0,0,0,0,0,0,0,0,0
400995801,Butler Bulldogs,TEAM,TOTAL,TOTAL,False,,19,50,18,39,1,11,16,16,9,20,29,11,10,2,20,21,55
400995800,Marquette Golden Eagles,E. Davenport,3906756,,True,18.0,4,8,4,7,0,1,0,1,3,2,5,0,1,0,1,4,8
400995800,Marquette Golden Eagles,A. Wilborn,3906758,,True,34.0,9,15,8,11,1,4,4,4,4,4,8,1,2,0,1,3,23
400995800,Marquette Golden Eagles,A. Blockton,3906755,,True,29.0,7,13,5,11,2,2,4,6,3,3,6,2,0,0,0,5,20
400995800,Marquette Golden Eagles,N. Hiedeman,3906753,,True,33.0,2,12,0,7,2,5,10,11,1,1,2,5,4,1,0,4,16
400995800,Marquette Golden Eagles,D. King,3906752,,True,33.0,3,13,3,7,0,6,9,9,2,4,6,6,4,0,1,1,15
400995800,Marquette Golden Eagles,A. Anderson,4068081,,False,4.0,0,0,0,0,0,0,0,0,0,1,1,0,0,1,0,1,0
400995800,Marquette Golden Eagles,L. Van Kleunen,4068083,,False,11.0,0,2,0,0,0,2,2,2,2,3,5,0,0,0,0,1,2
400995800,Marquette Golden Eagles,S. Lott,4281350,,False,28.0,2,5,1,3,1,2,0,0,2,2,4,1,0,0,0,3,5
400995800,Marquette Golden Eagles,I. Spingola,4068082,,False,10.0,1,2,0,1,1,1,0,0,0,2,2,0,0,0,0,1,3
400995800,Marquette Golden Eagles,TEAM,TOTAL,TOTAL,False,,28,70,21,47,7,23,29,33,18,23,41,15,11,2,4,23,92
400995800,Marquette Golden Eagles,E. Davenport,3906756,,True,18.0,4,8,4,7,0,1,0,1,3,2,5,0,1,0,1,4,8
400995800,Marquette Golden Eagles,A. Wilborn,3906758,,True,34.0,9,15,8,11,1,4,4,4,4,4,8,1,2,0,1,3,23
400995800,Marquette Golden Eagles,A. Blockton,3906755,,True,29.0,7,13,5,11,2,2,4,6,3,3,6,2,0,0,0,5,20
400995800,Marquette Golden Eagles,N. Hiedeman,3906753,,True,33.0,2,12,0,7,2,5,10,11,1,1,2,5,4,1,0,4,16
400995800,Marquette Golden Eagles,D. King,3906752,,True,33.0,3,13,3,7,0,6,9,9,2,4,6,6,4,0,1,1,15
400995800,Marquette Golden Eagles,A. Anderson,4068081,,False,4.0,0,0,0,0,0,0,0,0,0,1,1,0,0,1,0,1,0
400995800,Marquette Golden Eagles,L. Van Kleunen,4068083,,False,11.0,0,2,0,0,0,2,2,2,2,3,5,0,0,0,0,1,2
400995800,Marquette Golden Eagles,S. Lott,4281350,,False,28.0,2,5,1,3,1,2,0,0,2,2,4,1,0,0,0,3,5
400995800,Marquette Golden Eagles,I. Spingola,4068082,,False,10.0,1,2,0,1,1,1,0,0,0,2,2,0,0,0,0,1,3
400995800,Marquette Golden Eagles,TEAM,TOTAL,TOTAL,False,,28,70,21,47,7,23,29,33,18,23,41,15,11,2,4,23,92
400995800,Creighton Bluejays,A. Faber,3938938,,True,32.0,7,17,6,14,1,3,5,5,0,0,0,4,0,0,3,1,20
400995800,Creighton Bluejays,A. Greene,3938937,,True,10.0,1,3,1,3,0,0,2,2,3,2,5,0,0,0,0,1,4
400995800,Creighton Bluejays,J. Agnew,3938935,,True,24.0,6,11,2,4,4,7,1,3,0,4,4,3,0,3,3,3,17
400995800,Creighton Bluejays,S. Lamberty,3142285,,True,34.0,3,7,3,7,0,0,3,3,2,10,12,6,0,0,1,1,9
400995800,Creighton Bluejays,M. Mellman,3142283,,True,14.0,1,1,1,1,0,0,3,3,0,1,1,0,0,0,0,2,5
400995800,Creighton Bluejays,K. Brown,3142286,,False,11.0,1,2,1,2,0,0,0,0,0,2,2,0,0,0,1,0,2
400995800,Creighton Bluejays,B. Norby,3142284,,False,8.0,2,2,2,2,0,0,0,2,0,1,1,0,0,0,2,0,4
400995800,Creighton Bluejays,T. Carda,4281362,,False,24.0,2,4,1,2,1,2,2,2,0,3,3,0,0,0,2,5,7
400995800,Creighton Bluejays,T. Rembao,4281361,,False,9.0,1,1,1,1,0,0,3,4,0,1,1,0,0,0,2,3,5
400995800,Creighton Bluejays,O. Elger,3938936,,False,25.0,2,3,2,3,0,0,0,0,0,2,2,4,0,0,1,5,4
400995800,Creighton Bluejays,B. Kissinger,3142124,,False,9.0,0,2,0,1,0,1,0,0,0,0,0,1,0,0,0,3,0
400995800,Creighton Bluejays,TEAM,TOTAL,TOTAL,False,,26,53,20,40,6,13,19,24,5,26,31,18,0,3,16,24,77
400995800,Creighton Bluejays,A. Faber,3938938,,True,32.0,7,17,6,14,1,3,5,5,0,0,0,4,0,0,3,1,20
400995800,Creighton Bluejays,A. Greene,3938937,,True,10.0,1,3,1,3,0,0,2,2,3,2,5,0,0,0,0,1,4
400995800,Creighton Bluejays,J. Agnew,3938935,,True,24.0,6,11,2,4,4,7,1,3,0,4,4,3,0,3,3,3,17
400995800,Creighton Bluejays,S. Lamberty,3142285,,True,34.0,3,7,3,7,0,0,3,3,2,10,12,6,0,0,1,1,9
400995800,Creighton Bluejays,M. Mellman,3142283,,True,14.0,1,1,1,1,0,0,3,3,0,1,1,0,0,0,0,2,5
400995800,Creighton Bluejays,K. Brown,3142286,,False,11.0,1,2,1,2,0,0,0,0,0,2,2,0,0,0,1,0,2
400995800,Creighton Bluejays,B. Norby,3142284,,False,8.0,2,2,2,2,0,0,0,2,0,1,1,0,0,0,2,0,4
400995800,Creighton Bluejays,T. Carda,4281362,,False,24.0,2,4,1,2,1,2,2,2,0,3,3,0,0,0,2,5,7
400995800,Creighton Bluejays,T. Rembao,4281361,,False,9.0,1,1,1,1,0,0,3,4,0,1,1,0,0,0,2,3,5
400995800,Creighton Bluejays,O. Elger,3938936,,False,25.0,2,3,2,3,0,0,0,0,0,2,2,4,0,0,1,5,4
400995800,Creighton Bluejays,B. Kissinger,3142124,,False,9.0,0,2,0,1,0,1,0,0,0,0,0,1,0,0,0,3,0
400995800,Creighton Bluejays,TEAM,TOTAL,TOTAL,False,,26,53,20,40,6,13,19,24,5,26,31,18,0,3,16,24,77
400995799,Xavier Musketeers,I. Partlow,3142320,,True,24.0,4,6,3,5,1,1,0,0,0,3,3,1,0,0,0,1,9
400995799,Xavier Musketeers,A. Aijanen,3142319,,True,27.0,2,5,1,2,1,3,0,1,1,3,4,2,0,0,0,3,5
400995799,Xavier Musketeers,N. Owens,4068187,,True,20.0,3,5,1,3,2,2,0,0,0,3,3,1,0,0,1,1,8
400995799,Xavier Musketeers,J. Byrd,3142318,,True,32.0,4,10,3,9,1,1,4,5,0,4,4,4,0,0,3,1,13
400995799,Xavier Musketeers,K. Fincher,3142317,,True,10.0,1,3,0,2,1,1,1,2,1,0,1,1,0,0,3,3,4
400995799,Xavier Musketeers,A. Gray,4281368,,False,16.0,1,3,1,3,0,0,2,2,1,6,7,1,2,0,0,2,4
400995799,Xavier Musketeers,D. Ross,4281364,,False,11.0,1,3,0,0,1,3,0,0,0,2,2,0,0,0,3,2,3
400995799,Xavier Musketeers,A. Reiff,4281367,,False,18.0,0,2,0,0,0,2,0,0,1,2,3,3,0,0,0,1,0
400995799,Xavier Musketeers,P. Stewart,4281366,,False,7.0,0,1,0,1,0,0,0,0,0,0,0,0,0,0,2,0,0
400995799,Xavier Musketeers,A. Dunham,4281365,,False,20.0,2,3,1,2,1,1,2,3,0,2,2,0,0,0,2,4,7
400995799,Xavier Musketeers,A. Gomez,4068185,,False,15.0,3,7,0,0,3,7,1,2,0,0,0,0,0,0,0,1,10
400995799,Xavier Musketeers,TEAM,TOTAL,TOTAL,False,,21,48,10,27,11,21,10,15,5,27,32,13,2,0,14,19,63
400995799,Xavier Musketeers,I. Partlow,3142320,,True,24.0,4,6,3,5,1,1,0,0,0,3,3,1,0,0,0,1,9
400995799,Xavier Musketeers,A. Aijanen,3142319,,True,27.0,2,5,1,2,1,3,0,1,1,3,4,2,0,0,0,3,5
400995799,Xavier Musketeers,N. Owens,4068187,,True,20.0,3,5,1,3,2,2,0,0,0,3,3,1,0,0,1,1,8
400995799,Xavier Musketeers,J. Byrd,3142318,,True,32.0,4,10,3,9,1,1,4,5,0,4,4,4,0,0,3,1,13
400995799,Xavier Musketeers,K. Fincher,3142317,,True,10.0,1,3,0,2,1,1,1,2,1,0,1,1,0,0,3,3,4
400995799,Xavier Musketeers,A. Gray,4281368,,False,16.0,1,3,1,3,0,0,2,2,1,6,7,1,2,0,0,2,4
400995799,Xavier Musketeers,D. Ross,4281364,,False,11.0,1,3,0,0,1,3,0,0,0,2,2,0,0,0,3,2,3
400995799,Xavier Musketeers,A. Reiff,4281367,,False,18.0,0,2,0,0,0,2,0,0,1,2,3,3,0,0,0,1,0
400995799,Xavier Musketeers,P. Stewart,4281366,,False,7.0,0,1,0,1,0,0,0,0,0,0,0,0,0,0,2,0,0
400995799,Xavier Musketeers,A. Dunham,4281365,,False,20.0,2,3,1,2,1,1,2,3,0,2,2,0,0,0,2,4,7
400995799,Xavier Musketeers,A. Gomez,4068185,,False,15.0,3,7,0,0,3,7,1,2,0,0,0,0,0,0,0,1,10
400995799,Xavier Musketeers,TEAM,TOTAL,TOTAL,False,,21,48,10,27,11,21,10,15,5,27,32,13,2,0,14,19,63
400995799,St. John's Red Storm,M. Singleton,4068158,,True,37.0,6,15,6,15,0,0,4,4,7,7,14,1,2,1,1,2,16
400995799,St. John's Red Storm,I. Littleton,3142306,,True,38.0,3,4,3,4,0,0,1,2,1,2,3,3,2,1,1,1,7
400995799,St. John's Red Storm,Q. Hoppie,4281375,,True,35.0,5,11,2,6,3,5,3,6,0,2,2,2,0,0,2,3,16
400995799,St. John's Red Storm,T. England,4068155,,True,40.0,2,9,2,8,0,1,4,5,1,6,7,3,0,0,0,1,8
400995799,St. John's Red Storm,A. Kebbe,4068154,,True,34.0,5,10,3,6,2,4,3,4,1,6,7,4,1,0,0,2,15
400995799,St. John's Red Storm,K. Charles,4281374,,False,1.0,0,0,0,0,0,0,1,2,0,0,0,0,0,0,0,1,1
400995799,St. John's Red Storm,A. Adams,4068157,,False,15.0,1,7,1,4,0,3,2,2,0,0,0,0,0,1,1,1,4
400995799,St. John's Red Storm,TEAM,TOTAL,TOTAL,False,,22,56,17,43,5,13,18,25,11,24,35,13,5,3,6,11,67
400995799,St. John's Red Storm,M. Singleton,4068158,,True,37.0,6,15,6,15,0,0,4,4,7,7,14,1,2,1,1,2,16
400995799,St. John's Red Storm,I. Littleton,3142306,,True,38.0,3,4,3,4,0,0,1,2,1,2,3,3,2,1,1,1,7
400995799,St. John's Red Storm,Q. Hoppie,4281375,,True,35.0,5,11,2,6,3,5,3,6,0,2,2,2,0,0,2,3,16
400995799,St. John's Red Storm,T. England,4068155,,True,40.0,2,9,2,8,0,1,4,5,1,6,7,3,0,0,0,1,8
400995799,St. John's Red Storm,A. Kebbe,4068154,,True,34.0,5,10,3,6,2,4,3,4,1,6,7,4,1,0,0,2,15
400995799,St. John's Red Storm,K. Charles,4281374,,False,1.0,0,0,0,0,0,0,1,2,0,0,0,0,0,0,0,1,1
400995799,St. John's Red Storm,A. Adams,4068157,,False,15.0,1,7,1,4,0,3,2,2,0,0,0,0,0,1,1,1,4
400995799,St. John's Red Storm,TEAM,TOTAL,TOTAL,False,,22,56,17,43,5,13,18,25,11,24,35,13,5,3,6,11,67
400995798,Providence Friars,K. Spiwak,4281346,,True,23.0,1,6,1,5,0,1,0,0,0,3,3,1,0,0,2,4,2
400995798,Providence Friars,C. Williams,4281345,,True,28.0,2,9,2,9,0,0,4,8,0,5,5,2,1,0,3,1,8
400995798,Providence Friars,J. Nogic,3906769,,True,22.0,1,6,1,1,0,5,0,0,0,3,3,0,1,0,2,0,2
400995798,Providence Friars,M. Jolin,3906767,,True,31.0,6,13,3,6,3,7,5,6,0,3,3,1,5,0,2,2,20
400995798,Providence Friars,A. Botteghi,3142301,,True,19.0,2,6,2,6,0,0,0,0,2,4,6,0,0,0,3,3,4
400995798,Providence Friars,N. Franklin,4281348,,False,12.0,1,4,1,4,0,0,0,2,1,2,3,0,0,0,2,2,2
400995798,Providence Friars,B. Frias,3142302,,False,9.0,1,1,1,1,0,0,0,0,0,2,2,0,0,0,0,0,2
400995798,Providence Friars,O. Orlando,4281347,,False,8.0,1,1,1,1,0,0,0,0,0,1,1,0,0,0,1,0,2
400995798,Providence Friars,N. Jackson,4068111,,False,19.0,0,2,0,2,0,0,0,0,5,2,7,0,0,0,3,3,0
400995798,Providence Friars,C. Che,3906766,,False,29.0,2,11,1,4,1,7,1,2,0,3,3,1,0,0,2,1,6
400995798,Providence Friars,TEAM,TOTAL,TOTAL,False,,17,59,13,39,4,20,10,18,11,30,41,5,7,0,20,16,48
400995798,Providence Friars,K. Spiwak,4281346,,True,23.0,1,6,1,5,0,1,0,0,0,3,3,1,0,0,2,4,2
400995798,Providence Friars,C. Williams,4281345,,True,28.0,2,9,2,9,0,0,4,8,0,5,5,2,1,0,3,1,8
400995798,Providence Friars,J. Nogic,3906769,,True,22.0,1,6,1,1,0,5,0,0,0,3,3,0,1,0,2,0,2
400995798,Providence Friars,M. Jolin,3906767,,True,31.0,6,13,3,6,3,7,5,6,0,3,3,1,5,0,2,2,20
400995798,Providence Friars,A. Botteghi,3142301,,True,19.0,2,6,2,6,0,0,0,0,2,4,6,0,0,0,3,3,4
400995798,Providence Friars,N. Franklin,4281348,,False,12.0,1,4,1,4,0,0,0,2,1,2,3,0,0,0,2,2,2
400995798,Providence Friars,B. Frias,3142302,,False,9.0,1,1,1,1,0,0,0,0,0,2,2,0,0,0,0,0,2
400995798,Providence Friars,O. Orlando,4281347,,False,8.0,1,1,1,1,0,0,0,0,0,1,1,0,0,0,1,0,2
400995798,Providence Friars,N. Jackson,4068111,,False,19.0,0,2,0,2,0,0,0,0,5,2,7,0,0,0,3,3,0
400995798,Providence Friars,C. Che,3906766,,False,29.0,2,11,1,4,1,7,1,2,0,3,3,1,0,0,2,1,6
400995798,Providence Friars,TEAM,TOTAL,TOTAL,False,,17,59,13,39,4,20,10,18,11,30,41,5,7,0,20,16,48
400995798,DePaul Blue Demons,C. Stonewall,4068072,,True,24.0,1,6,1,5,0,1,0,0,1,3,4,2,0,0,2,1,2
400995798,DePaul Blue Demons,M. Grays,3142287,,True,28.0,7,14,6,10,1,4,0,2,2,4,6,2,2,1,3,3,15
400995798,DePaul Blue Demons,K. Campbell,4068071,,True,30.0,2,4,2,2,0,2,2,2,1,7,8,5,1,1,1,3,6
400995798,DePaul Blue Demons,A. Millender,3142289,,True,30.0,4,9,1,3,3,6,0,0,2,0,2,2,1,0,1,0,11
400995798,DePaul Blue Demons,A. Coleman,3142123,,True,28.0,3,11,2,6,1,5,2,4,3,9,12,1,0,0,3,3,9
400995798,DePaul Blue Demons,R. McLimore,4281358,,False,5.0,0,2,0,1,0,1,0,0,0,1,1,0,0,0,0,1,0
400995798,DePaul Blue Demons,V. Sherrod,4281359,,False,2.0,1,1,1,1,0,0,0,0,0,0,0,0,0,0,2,0,2
400995798,DePaul Blue Demons,D. Bekelja,4281356,,False,7.0,2,3,1,2,1,1,0,0,1,0,1,0,1,0,1,0,5
400995798,DePaul Blue Demons,D. Cage,4068073,,False,10.0,1,3,0,2,1,1,2,2,0,3,3,1,0,0,0,1,5
400995798,DePaul Blue Demons,T. Allen,3933760,,False,20.0,3,9,1,3,2,6,0,0,0,4,4,0,0,1,1,2,8
400995798,DePaul Blue Demons,L. Prochaska,3142290,,False,16.0,3,5,1,2,2,3,0,0,0,3,3,4,2,0,1,4,8
400995798,DePaul Blue Demons,TEAM,TOTAL,TOTAL,False,,27,67,16,37,11,30,6,10,12,36,48,17,7,3,15,18,71
400995798,DePaul Blue Demons,C. Stonewall,4068072,,True,24.0,1,6,1,5,0,1,0,0,1,3,4,2,0,0,2,1,2
400995798,DePaul Blue Demons,M. Grays,3142287,,True,28.0,7,14,6,10,1,4,0,2,2,4,6,2,2,1,3,3,15
400995798,DePaul Blue Demons,K. Campbell,4068071,,True,30.0,2,4,2,2,0,2,2,2,1,7,8,5,1,1,1,3,6
400995798,DePaul Blue Demons,A. Millender,3142289,,True,30.0,4,9,1,3,3,6,0,0,2,0,2,2,1,0,1,0,11
400995798,DePaul Blue Demons,A. Coleman,3142123,,True,28.0,3,11,2,6,1,5,2,4,3,9,12,1,0,0,3,3,9
400995798,DePaul Blue Demons,R. McLimore,4281358,,False,5.0,0,2,0,1,0,1,0,0,0,1,1,0,0,0,0,1,0
400995798,DePaul Blue Demons,V. Sherrod,4281359,,False,2.0,1,1,1,1,0,0,0,0,0,0,0,0,0,0,2,0,2
400995798,DePaul Blue Demons,D. Bekelja,4281356,,False,7.0,2,3,1,2,1,1,0,0,1,0,1,0,1,0,1,0,5
400995798,DePaul Blue Demons,D. Cage,4068073,,False,10.0,1,3,0,2,1,1,2,2,0,3,3,1,0,0,0,1,5
400995798,DePaul Blue Demons,T. Allen,3933760,,False,20.0,3,9,1,3,2,6,0,0,0,4,4,0,0,1,1,2,8
400995798,DePaul Blue Demons,L. Prochaska,3142290,,False,16.0,3,5,1,2,2,3,0,0,0,3,3,4,2,0,1,4,8
400995798,DePaul Blue Demons,TEAM,TOTAL,TOTAL,False,,27,67,16,37,11,30,6,10,12,36,48,17,7,3,15,18,71
400995797,Seton Hall Pirates,S. Samuels,4068128,,True,21.0,2,5,2,5,0,0,1,2,0,6,6,0,1,1,2,1,5
400995797,Seton Hall Pirates,D. Fountain,3058890,,True,20.0,2,10,1,8,1,2,1,2,1,3,4,0,0,0,2,4,6
400995797,Seton Hall Pirates,K. Evans,4281378,,True,16.0,1,5,1,5,0,0,2,2,3,0,3,0,0,1,0,1,4
400995797,Seton Hall Pirates,I. Butina,4281377,,True,29.0,2,5,1,1,1,4,2,2,0,0,0,1,0,0,4,5,7
400995797,Seton Hall Pirates,J. Jackson,3064877,,True,35.0,4,8,2,4,2,4,0,0,0,1,1,2,3,0,3,2,10
400995797,Seton Hall Pirates,S. Philoxy,4281380,,False,6.0,0,0,0,0,0,0,0,0,0,1,1,0,0,0,0,0,0
400995797,Seton Hall Pirates,T. Brown,3941336,,False,24.0,1,5,1,5,0,0,3,4,4,2,6,0,3,0,3,5,5
400995797,Seton Hall Pirates,J. Jones-Pack,4068129,,False,5.0,0,0,0,0,0,0,0,0,0,0,0,0,0,2,2,2,0
400995797,Seton Hall Pirates,D. Winters,4068126,,False,13.0,1,7,0,0,1,7,0,0,0,0,0,0,2,0,1,1,3
400995797,Seton Hall Pirates,N. Jimenez,4281379,,False,28.0,1,7,0,3,1,4,5,8,0,2,2,5,0,1,2,1,8
400995797,Seton Hall Pirates,K. Healy,3943704,,False,3.0,0,1,0,0,0,1,0,0,0,0,0,0,0,0,0,0,0
400995797,Seton Hall Pirates,TEAM,TOTAL,TOTAL,False,,14,53,8,31,6,22,14,20,9,16,25,8,9,5,19,22,48
400995797,Seton Hall Pirates,S. Samuels,4068128,,True,21.0,2,5,2,5,0,0,1,2,0,6,6,0,1,1,2,1,5
400995797,Seton Hall Pirates,D. Fountain,3058890,,True,20.0,2,10,1,8,1,2,1,2,1,3,4,0,0,0,2,4,6
400995797,Seton Hall Pirates,K. Evans,4281378,,True,16.0,1,5,1,5,0,0,2,2,3,0,3,0,0,1,0,1,4
400995797,Seton Hall Pirates,I. Butina,4281377,,True,29.0,2,5,1,1,1,4,2,2,0,0,0,1,0,0,4,5,7
400995797,Seton Hall Pirates,J. Jackson,3064877,,True,35.0,4,8,2,4,2,4,0,0,0,1,1,2,3,0,3,2,10
400995797,Seton Hall Pirates,S. Philoxy,4281380,,False,6.0,0,0,0,0,0,0,0,0,0,1,1,0,0,0,0,0,0
400995797,Seton Hall Pirates,T. Brown,3941336,,False,24.0,1,5,1,5,0,0,3,4,4,2,6,0,3,0,3,5,5
400995797,Seton Hall Pirates,J. Jones-Pack,4068129,,False,5.0,0,0,0,0,0,0,0,0,0,0,0,0,0,2,2,2,0
400995797,Seton Hall Pirates,D. Winters,4068126,,False,13.0,1,7,0,0,1,7,0,0,0,0,0,0,2,0,1,1,3
400995797,Seton Hall Pirates,N. Jimenez,4281379,,False,28.0,1,7,0,3,1,4,5,8,0,2,2,5,0,1,2,1,8
400995797,Seton Hall Pirates,K. Healy,3943704,,False,3.0,0,1,0,0,0,1,0,0,0,0,0,0,0,0,0,0,0
400995797,Seton Hall Pirates,TEAM,TOTAL,TOTAL,False,,14,53,8,31,6,22,14,20,9,16,25,8,9,5,19,22,48
400995797,Butler Bulldogs,S. Brey,4068067,,True,33.0,3,3,3,3,0,0,3,3,1,3,4,4,2,0,2,3,9
400995797,Butler Bulldogs,T. Schickel,3914012,,True,37.0,5,9,5,9,0,0,2,6,4,5,9,3,3,1,5,3,12
400995797,Butler Bulldogs,M. Weaver,3914014,,True,34.0,3,4,2,2,1,2,0,0,0,1,1,5,3,0,1,3,7
400995797,Butler Bulldogs,W. Jennings,3142145,,True,37.0,4,16,3,10,1,6,2,2,0,4,4,1,0,1,2,4,11
400995797,Butler Bulldogs,I. Lathan,3079485,,True,14.0,2,3,2,3,0,0,3,4,1,1,2,1,0,0,0,2,7
400995797,Butler Bulldogs,A. Aube,4281363,,False,2.0,0,0,0,0,0,0,0,0,0,1,1,0,0,0,0,0,0
400995797,Butler Bulldogs,K. Hodges,4068065,,False,7.0,0,1,0,1,0,0,0,0,0,5,5,0,1,0,4,0,0
400995797,Butler Bulldogs,S. Humphrey,4068066,,False,2.0,0,0,0,0,0,0,0,0,0,0,0,0,0,0,0,0,0
400995797,Butler Bulldogs,K. Spolyar,4068068,,False,29.0,6,12,4,8,2,4,6,9,0,7,7,1,0,0,5,3,20
400995797,Butler Bulldogs,S. Buck,3142279,,False,5.0,0,0,0,0,0,0,0,0,0,0,0,0,0,0,1,0,0
400995797,Butler Bulldogs,TEAM,TOTAL,TOTAL,False,,23,48,19,36,4,12,16,24,10,31,41,15,9,2,21,18,66
400995797,Butler Bulldogs,S. Brey,4068067,,True,33.0,3,3,3,3,0,0,3,3,1,3,4,4,2,0,2,3,9
400995797,Butler Bulldogs,T. Schickel,3914012,,True,37.0,5,9,5,9,0,0,2,6,4,5,9,3,3,1,5,3,12
400995797,Butler Bulldogs,M. Weaver,3914014,,True,34.0,3,4,2,2,1,2,0,0,0,1,1,5,3,0,1,3,7
400995797,Butler Bulldogs,W. Jennings,3142145,,True,37.0,4,16,3,10,1,6,2,2,0,4,4,1,0,1,2,4,11
400995797,Butler Bulldogs,I. Lathan,3079485,,True,14.0,2,3,2,3,0,0,3,4,1,1,2,1,0,0,0,2,7
400995797,Butler Bulldogs,A. Aube,4281363,,False,2.0,0,0,0,0,0,0,0,0,0,1,1,0,0,0,0,0,0
400995797,Butler Bulldogs,K. Hodges,4068065,,False,7.0,0,1,0,1,0,0,0,0,0,5,5,0,1,0,4,0,0
400995797,Butler Bulldogs,S. Humphrey,4068066,,False,2.0,0,0,0,0,0,0,0,0,0,0,0,0,0,0,0,0,0
400995797,Butler Bulldogs,K. Spolyar,4068068,,False,29.0,6,12,4,8,2,4,6,9,0,7,7,1,0,0,5,3,20
400995797,Butler Bulldogs,S. Buck,3142279,,False,5.0,0,0,0,0,0,0,0,0,0,0,0,0,0,0,1,0,0
400995797,Butler Bulldogs,TEAM,TOTAL,TOTAL,False,,23,48,19,36,4,12,16,24,10,31,41,15,9,2,21,18,66
400995796,Xavier Musketeers,I. Partlow,3142320,,True,22.0,4,8,4,8,0,0,3,4,1,2,3,1,1,0,1,1,11
400995796,Xavier Musketeers,A. Aijanen,3142319,,True,22.0,2,5,2,3,0,2,0,0,1,1,2,1,0,0,0,3,4
400995796,Xavier Musketeers,N. Owens,4068187,,True,17.0,1,2,1,2,0,0,1,1,0,3,3,1,0,0,2,2,3
400995796,Xavier Musketeers,J. Byrd,3142318,,True,26.0,4,8,4,8,0,0,4,4,1,3,4,3,1,0,2,0,12
400995796,Xavier Musketeers,K. Fincher,3142317,,True,22.0,0,2,0,0,0,2,2,2,0,3,3,1,1,1,2,2,2
400995796,Xavier Musketeers,A. Gray,4281368,,False,14.0,3,6,1,4,2,2,0,0,1,2,3,0,0,1,0,3,8
400995796,Xavier Musketeers,D. Ross,4281364,,False,22.0,2,7,1,3,1,4,3,4,0,4,4,1,0,0,0,3,8
400995796,Xavier Musketeers,A. Reiff,4281367,,False,8.0,1,1,1,1,0,0,0,0,0,1,1,0,1,0,0,0,2
400995796,Xavier Musketeers,P. Stewart,4281366,,False,21.0,1,5,1,3,0,2,2,2,0,1,1,0,1,0,0,0,4
400995796,Xavier Musketeers,A. Dunham,4281365,,False,24.0,1,4,0,1,1,3,0,0,1,2,3,3,0,0,2,0,3
400995796,Xavier Musketeers,A. Gomez,4068185,,False,2.0,0,0,0,0,0,0,0,0,0,0,0,0,0,0,0,1,0
400995796,Xavier Musketeers,TEAM,TOTAL,TOTAL,False,,19,48,15,33,4,15,15,17,5,23,28,11,5,2,10,15,57
400995796,Xavier Musketeers,I. Partlow,3142320,,True,22.0,4,8,4,8,0,0,3,4,1,2,3,1,1,0,1,1,11
400995796,Xavier Musketeers,A. Aijanen,3142319,,True,22.0,2,5,2,3,0,2,0,0,1,1,2,1,0,0,0,3,4
400995796,Xavier Musketeers,N. Owens,4068187,,True,17.0,1,2,1,2,0,0,1,1,0,3,3,1,0,0,2,2,3
400995796,Xavier Musketeers,J. Byrd,3142318,,True,26.0,4,8,4,8,0,0,4,4,1,3,4,3,1,0,2,0,12
400995796,Xavier Musketeers,K. Fincher,3142317,,True,22.0,0,2,0,0,0,2,2,2,0,3,3,1,1,1,2,2,2
400995796,Xavier Musketeers,A. Gray,4281368,,False,14.0,3,6,1,4,2,2,0,0,1,2,3,0,0,1,0,3,8
400995796,Xavier Musketeers,D. Ross,4281364,,False,22.0,2,7,1,3,1,4,3,4,0,4,4,1,0,0,0,3,8
400995796,Xavier Musketeers,A. Reiff,4281367,,False,8.0,1,1,1,1,0,0,0,0,0,1,1,0,1,0,0,0,2
400995796,Xavier Musketeers,P. Stewart,4281366,,False,21.0,1,5,1,3,0,2,2,2,0,1,1,0,1,0,0,0,4
400995796,Xavier Musketeers,A. Dunham,4281365,,False,24.0,1,4,0,1,1,3,0,0,1,2,3,3,0,0,2,0,3
400995796,Xavier Musketeers,A. Gomez,4068185,,False,2.0,0,0,0,0,0,0,0,0,0,0,0,0,0,0,0,1,0
400995796,Xavier Musketeers,TEAM,TOTAL,TOTAL,False,,19,48,15,33,4,15,15,17,5,23,28,11,5,2,10,15,57
400995796,Villanova Wildcats,M. Quinn,3056785,,True,22.0,4,5,2,2,2,3,0,0,0,2,2,1,0,0,0,2,10
400995796,Villanova Wildcats,J. Tucker,3087536,,True,14.0,1,4,1,1,0,3,2,2,0,2,2,0,0,0,1,0,4
400995796,Villanova Wildcats,K. Jekot,4068171,,True,35.0,6,14,3,7,3,7,6,8,0,5,5,6,1,0,2,2,21
400995796,Villanova Wildcats,A. Hahn,3906779,,True,26.0,3,4,2,3,1,1,2,3,1,2,3,2,1,0,1,3,9
400995796,Villanova Wildcats,A. Louin,3142314,,True,39.0,4,12,4,8,0,4,0,0,2,1,3,8,0,0,0,2,8
400995796,Villanova Wildcats,M. Gedaka,4068172,,False,22.0,4,7,4,6,0,1,0,1,1,1,2,1,1,2,2,1,8
400995796,Villanova Wildcats,B. Herlihy,4068169,,False,2.0,0,0,0,0,0,0,0,0,0,2,2,0,0,0,1,0,0
400995796,Villanova Wildcats,B. Herlihy,3906778,,False,19.0,3,6,1,1,2,5,0,0,0,6,6,1,2,1,0,3,8
400995796,Villanova Wildcats,G. Stant,3906780,,False,14.0,2,2,0,0,2,2,1,2,1,2,3,0,0,0,0,0,7
400995796,Villanova Wildcats,R. James,4068168,,False,2.0,0,1,0,1,0,0,0,0,0,0,0,1,0,0,0,0,0
400995796,Villanova Wildcats,C. Onken,4068167,,False,5.0,0,0,0,0,0,0,0,0,0,1,1,0,0,0,0,1,0
400995796,Villanova Wildcats,TEAM,TOTAL,TOTAL,False,,27,55,17,29,10,26,11,16,7,24,31,20,5,3,7,14,75
400995796,Villanova Wildcats,M. Quinn,3056785,,True,22.0,4,5,2,2,2,3,0,0,0,2,2,1,0,0,0,2,10
400995796,Villanova Wildcats,J. Tucker,3087536,,True,14.0,1,4,1,1,0,3,2,2,0,2,2,0,0,0,1,0,4
400995796,Villanova Wildcats,K. Jekot,4068171,,True,35.0,6,14,3,7,3,7,6,8,0,5,5,6,1,0,2,2,21
400995796,Villanova Wildcats,A. Hahn,3906779,,True,26.0,3,4,2,3,1,1,2,3,1,2,3,2,1,0,1,3,9
400995796,Villanova Wildcats,A. Louin,3142314,,True,39.0,4,12,4,8,0,4,0,0,2,1,3,8,0,0,0,2,8
400995796,Villanova Wildcats,M. Gedaka,4068172,,False,22.0,4,7,4,6,0,1,0,1,1,1,2,1,1,2,2,1,8
400995796,Villanova Wildcats,B. Herlihy,4068169,,False,2.0,0,0,0,0,0,0,0,0,0,2,2,0,0,0,1,0,0
400995796,Villanova Wildcats,B. Herlihy,3906778,,False,19.0,3,6,1,1,2,5,0,0,0,6,6,1,2,1,0,3,8
400995796,Villanova Wildcats,G. Stant,3906780,,False,14.0,2,2,0,0,2,2,1,2,1,2,3,0,0,0,0,0,7
400995796,Villanova Wildcats,R. James,4068168,,False,2.0,0,1,0,1,0,0,0,0,0,0,0,1,0,0,0,0,0
400995796,Villanova Wildcats,C. Onken,4068167,,False,5.0,0,0,0,0,0,0,0,0,0,1,1,0,0,0,0,1,0
400995796,Villanova Wildcats,TEAM,TOTAL,TOTAL,False,,27,55,17,29,10,26,11,16,7,24,31,20,5,3,7,14,75
400995795,Seton Hall Pirates,S. Samuels,4068128,,True,29.0,2,4,2,4,0,0,1,2,3,5,8,0,0,0,2,3,5
400995795,Seton Hall Pirates,D. Fountain,3058890,,True,29.0,7,11,4,8,3,3,3,3,0,12,12,0,1,0,3,1,20
400995795,Seton Hall Pirates,K. Evans,4281378,,True,24.0,2,5,2,5,0,0,0,0,2,4,6,0,0,1,2,4,4
400995795,Seton Hall Pirates,I. Butina,4281377,,True,25.0,2,5,2,5,0,0,4,4,0,0,0,5,0,0,0,2,8
400995795,Seton Hall Pirates,J. Jackson,3064877,,True,34.0,6,15,3,7,3,8,0,0,0,0,0,3,0,0,0,0,15
400995795,Seton Hall Pirates,S. Philoxy,4281380,,False,15.0,1,2,1,2,0,0,0,0,1,4,5,0,0,0,1,1,2
400995795,Seton Hall Pirates,T. Brown,3941336,,False,11.0,1,4,1,4,0,0,0,0,0,2,2,0,0,0,2,2,2
400995795,Seton Hall Pirates,D. Winters,4068126,,False,13.0,2,6,2,3,0,3,0,0,1,2,3,0,2,0,0,1,4
400995795,Seton Hall Pirates,N. Jimenez,4281379,,False,18.0,2,4,1,2,1,2,0,0,0,0,0,2,1,0,1,3,5
400995795,Seton Hall Pirates,K. Healy,3943704,,False,2.0,0,0,0,0,0,0,0,0,0,0,0,0,0,0,0,0,0
400995795,Seton Hall Pirates,TEAM,TOTAL,TOTAL,False,,25,56,18,40,7,16,8,9,7,29,36,10,4,1,12,17,65
400995795,Seton Hall Pirates,S. Samuels,4068128,,True,29.0,2,4,2,4,0,0,1,2,3,5,8,0,0,0,2,3,5
400995795,Seton Hall Pirates,D. Fountain,3058890,,True,29.0,7,11,4,8,3,3,3,3,0,12,12,0,1,0,3,1,20
400995795,Seton Hall Pirates,K. Evans,4281378,,True,24.0,2,5,2,5,0,0,0,0,2,4,6,0,0,1,2,4,4
400995795,Seton Hall Pirates,I. Butina,4281377,,True,25.0,2,5,2,5,0,0,4,4,0,0,0,5,0,0,0,2,8
400995795,Seton Hall Pirates,J. Jackson,3064877,,True,34.0,6,15,3,7,3,8,0,0,0,0,0,3,0,0,0,0,15
400995795,Seton Hall Pirates,S. Philoxy,4281380,,False,15.0,1,2,1,2,0,0,0,0,1,4,5,0,0,0,1,1,2
400995795,Seton Hall Pirates,T. Brown,3941336,,False,11.0,1,4,1,4,0,0,0,0,0,2,2,0,0,0,2,2,2
400995795,Seton Hall Pirates,D. Winters,4068126,,False,13.0,2,6,2,3,0,3,0,0,1,2,3,0,2,0,0,1,4
400995795,Seton Hall Pirates,N. Jimenez,4281379,,False,18.0,2,4,1,2,1,2,0,0,0,0,0,2,1,0,1,3,5
400995795,Seton Hall Pirates,K. Healy,3943704,,False,2.0,0,0,0,0,0,0,0,0,0,0,0,0,0,0,0,0,0
400995795,Seton Hall Pirates,TEAM,TOTAL,TOTAL,False,,25,56,18,40,7,16,8,9,7,29,36,10,4,1,12,17,65
400995795,Providence Friars,J. Nogic,3906769,,True,26.0,4,11,3,4,1,7,4,4,0,1,1,1,0,0,3,2,13
400995795,Providence Friars,A. Botteghi,3142301,,True,24.0,1,9,1,7,0,2,0,0,0,3,3,0,0,1,1,0,2
400995795,Providence Friars,O. Orlando,4281347,,True,15.0,0,1,0,1,0,0,0,0,1,1,2,1,1,0,0,2,0
400995795,Providence Friars,C. Williams,4281345,,True,29.0,6,9,6,9,0,0,4,5,1,5,6,2,0,0,1,3,16
400995795,Providence Friars,M. Jolin,3906767,,True,28.0,5,11,3,5,2,6,1,1,1,2,3,0,1,0,1,1,13
400995795,Providence Friars,N. Franklin,4281348,,False,24.0,2,8,2,8,0,0,1,2,2,3,5,0,0,0,0,2,5
400995795,Providence Friars,B. Frias,3142302,,False,4.0,0,0,0,0,0,0,0,0,0,0,0,0,0,0,0,0,0
400995795,Providence Friars,K. Spiwak,4281346,,False,29.0,2,4,2,3,0,1,0,0,1,3,4,1,0,0,1,1,4
400995795,Providence Friars,N. Jackson,4068111,,False,8.0,0,0,0,0,0,0,0,0,0,1,1,0,1,0,1,2,0
400995795,Providence Friars,C. Che,3906766,,False,13.0,1,3,0,1,1,2,0,0,0,2,2,0,1,0,1,1,3
400995795,Providence Friars,TEAM,TOTAL,TOTAL,False,,21,56,17,38,4,18,10,12,6,21,27,5,4,1,10,14,56
400995795,Providence Friars,J. Nogic,3906769,,True,26.0,4,11,3,4,1,7,4,4,0,1,1,1,0,0,3,2,13
400995795,Providence Friars,A. Botteghi,3142301,,True,24.0,1,9,1,7,0,2,0,0,0,3,3,0,0,1,1,0,2
400995795,Providence Friars,O. Orlando,4281347,,True,15.0,0,1,0,1,0,0,0,0,1,1,2,1,1,0,0,2,0
400995795,Providence Friars,C. Williams,4281345,,True,29.0,6,9,6,9,0,0,4,5,1,5,6,2,0,0,1,3,16
400995795,Providence Friars,M. Jolin,3906767,,True,28.0,5,11,3,5,2,6,1,1,1,2,3,0,1,0,1,1,13
400995795,Providence Friars,N. Franklin,4281348,,False,24.0,2,8,2,8,0,0,1,2,2,3,5,0,0,0,0,2,5
400995795,Providence Friars,B. Frias,3142302,,False,4.0,0,0,0,0,0,0,0,0,0,0,0,0,0,0,0,0,0
400995795,Providence Friars,K. Spiwak,4281346,,False,29.0,2,4,2,3,0,1,0,0,1,3,4,1,0,0,1,1,4
400995795,Providence Friars,N. Jackson,4068111,,False,8.0,0,0,0,0,0,0,0,0,0,1,1,0,1,0,1,2,0
400995795,Providence Friars,C. Che,3906766,,False,13.0,1,3,0,1,1,2,0,0,0,2,2,0,1,0,1,1,3
400995795,Providence Friars,TEAM,TOTAL,TOTAL,False,,21,56,17,38,4,18,10,12,6,21,27,5,4,1,10,14,56
400995794,St. John's Red Storm,M. Singleton,4068158,,True,18.0,2,6,2,6,0,0,0,0,2,7,9,1,1,1,1,3,4
400995794,St. John's Red Storm,I. Littleton,3142306,,True,43.0,4,7,4,7,0,0,3,7,5,4,9,1,2,1,2,1,11
400995794,St. John's Red Storm,Q. Hoppie,4281375,,True,45.0,6,13,3,8,3,5,0,1,3,0,3,2,1,1,5,3,15
400995794,St. John's Red Storm,T. England,4068155,,True,43.0,6,14,4,11,2,3,3,4,1,3,4,10,3,0,3,3,17
400995794,St. John's Red Storm,A. Kebbe,4068154,,True,40.0,6,11,3,4,3,7,2,2,2,5,7,1,0,0,4,4,17
400995794,St. John's Red Storm,K. Charles,4281374,,False,7.0,0,0,0,0,0,0,1,2,2,2,4,0,0,1,0,1,1
400995794,St. John's Red Storm,A. Adams,4068157,,False,25.0,2,10,2,7,0,3,3,4,1,6,7,1,0,0,2,0,7
400995794,St. John's Red Storm,T. Alexander,3142305,,False,4.0,0,1,0,1,0,0,0,0,1,2,3,0,0,0,0,0,0
400995794,St. John's Red Storm,TEAM,TOTAL,TOTAL,False,,26,62,18,44,8,18,12,20,17,29,46,16,7,4,17,15,72
400995794,St. John's Red Storm,M. Singleton,4068158,,True,18.0,2,6,2,6,0,0,0,0,2,7,9,1,1,1,1,3,4
400995794,St. John's Red Storm,I. Littleton,3142306,,True,43.0,4,7,4,7,0,0,3,7,5,4,9,1,2,1,2,1,11
400995794,St. John's Red Storm,Q. Hoppie,4281375,,True,45.0,6,13,3,8,3,5,0,1,3,0,3,2,1,1,5,3,15
400995794,St. John's Red Storm,T. England,4068155,,True,43.0,6,14,4,11,2,3,3,4,1,3,4,10,3,0,3,3,17
400995794,St. John's Red Storm,A. Kebbe,4068154,,True,40.0,6,11,3,4,3,7,2,2,2,5,7,1,0,0,4,4,17
400995794,St. John's Red Storm,K. Charles,4281374,,False,7.0,0,0,0,0,0,0,1,2,2,2,4,0,0,1,0,1,1
400995794,St. John's Red Storm,A. Adams,4068157,,False,25.0,2,10,2,7,0,3,3,4,1,6,7,1,0,0,2,0,7
400995794,St. John's Red Storm,T. Alexander,3142305,,False,4.0,0,1,0,1,0,0,0,0,1,2,3,0,0,0,0,0,0
400995794,St. John's Red Storm,TEAM,TOTAL,TOTAL,False,,26,62,18,44,8,18,12,20,17,29,46,16,7,4,17,15,72
400995794,Creighton Bluejays,A. Faber,3938938,,True,43.0,4,13,4,9,0,4,1,2,0,3,3,3,1,3,3,1,9
400995794,Creighton Bluejays,A. Greene,3938937,,True,12.0,2,2,2,2,0,0,0,0,0,1,1,0,1,0,1,1,4
400995794,Creighton Bluejays,J. Agnew,3938935,,True,42.0,5,10,3,5,2,5,1,2,0,3,3,1,2,1,1,4,13
400995794,Creighton Bluejays,S. Lamberty,3142285,,True,40.0,4,11,2,8,2,3,4,6,0,1,1,4,1,0,2,2,14
400995794,Creighton Bluejays,M. Mellman,3142283,,True,13.0,1,1,0,0,1,1,0,0,0,3,3,2,1,0,0,2,3
400995794,Creighton Bluejays,K. Brown,3142286,,False,4.0,0,0,0,0,0,0,0,0,0,0,0,0,0,0,0,0,0
400995794,Creighton Bluejays,B. Norby,3142284,,False,9.0,1,2,1,2,0,0,3,4,0,1,1,0,2,0,1,3,5
400995794,Creighton Bluejays,T. Carda,4281362,,False,14.0,3,8,1,4,2,4,0,0,0,2,2,1,0,0,0,1,8
400995794,Creighton Bluejays,T. Rembao,4281361,,False,15.0,1,3,1,3,0,0,1,1,4,0,4,1,0,0,2,1,3
400995794,Creighton Bluejays,O. Elger,3938936,,False,29.0,2,8,2,5,0,3,2,2,2,3,5,0,1,1,2,2,6
400995794,Creighton Bluejays,B. Kissinger,3142124,,False,4.0,0,0,0,0,0,0,0,0,0,0,0,1,0,0,0,1,0
400995794,Creighton Bluejays,TEAM,TOTAL,TOTAL,False,,23,58,16,38,7,20,12,17,6,17,23,13,9,5,12,18,65
400995794,Creighton Bluejays,A. Faber,3938938,,True,43.0,4,13,4,9,0,4,1,2,0,3,3,3,1,3,3,1,9
400995794,Creighton Bluejays,A. Greene,3938937,,True,12.0,2,2,2,2,0,0,0,0,0,1,1,0,1,0,1,1,4
400995794,Creighton Bluejays,J. Agnew,3938935,,True,42.0,5,10,3,5,2,5,1,2,0,3,3,1,2,1,1,4,13
400995794,Creighton Bluejays,S. Lamberty,3142285,,True,40.0,4,11,2,8,2,3,4,6,0,1,1,4,1,0,2,2,14
400995794,Creighton Bluejays,M. Mellman,3142283,,True,13.0,1,1,0,0,1,1,0,0,0,3,3,2,1,0,0,2,3
400995794,Creighton Bluejays,K. Brown,3142286,,False,4.0,0,0,0,0,0,0,0,0,0,0,0,0,0,0,0,0,0
400995794,Creighton Bluejays,B. Norby,3142284,,False,9.0,1,2,1,2,0,0,3,4,0,1,1,0,2,0,1,3,5
400995794,Creighton Bluejays,T. Carda,4281362,,False,14.0,3,8,1,4,2,4,0,0,0,2,2,1,0,0,0,1,8
400995794,Creighton Bluejays,T. Rembao,4281361,,False,15.0,1,3,1,3,0,0,1,1,4,0,4,1,0,0,2,1,3
400995794,Creighton Bluejays,O. Elger,3938936,,False,29.0,2,8,2,5,0,3,2,2,2,3,5,0,1,1,2,2,6
400995794,Creighton Bluejays,B. Kissinger,3142124,,False,4.0,0,0,0,0,0,0,0,0,0,0,0,1,0,0,0,1,0
400995794,Creighton Bluejays,TEAM,TOTAL,TOTAL,False,,23,58,16,38,7,20,12,17,6,17,23,13,9,5,12,18,65
400995793,Georgetown Hoyas,C. Petke,4068078,,True,33.0,5,11,5,10,0,1,2,2,5,4,9,0,0,0,0,0,12
400995793,Georgetown Hoyas,Y. Belk,3142295,,True,27.0,2,4,2,4,0,0,0,0,2,1,3,2,3,3,0,4,4
400995793,Georgetown Hoyas,D. White,3948815,,True,33.0,2,13,1,8,1,5,6,6,3,2,5,2,1,1,3,3,11
400995793,Georgetown Hoyas,D. Burton,3142292,,True,30.0,4,7,4,6,0,1,2,4,0,2,2,1,2,0,1,3,10
400995793,Georgetown Hoyas,M. Venson,3142105,,True,40.0,1,13,1,5,0,8,2,2,2,2,4,5,1,1,3,2,4
400995793,Georgetown Hoyas,T. Thompson,4281352,,False,12.0,2,4,2,3,0,1,0,0,1,0,1,0,0,0,0,2,4
400995793,Georgetown Hoyas,M. Smith,4068079,,False,22.0,4,11,3,8,1,3,3,4,2,0,2,0,0,1,1,2,12
400995793,Georgetown Hoyas,B. Mayfield,4281354,,False,3.0,0,1,0,1,0,0,0,0,0,0,0,0,0,0,0,1,0
400995793,Georgetown Hoyas,TEAM,TOTAL,TOTAL,False,,20,64,18,45,2,19,15,18,15,11,26,10,7,6,8,17,57
400995793,Georgetown Hoyas,C. Petke,4068078,,True,33.0,5,11,5,10,0,1,2,2,5,4,9,0,0,0,0,0,12
400995793,Georgetown Hoyas,Y. Belk,3142295,,True,27.0,2,4,2,4,0,0,0,0,2,1,3,2,3,3,0,4,4
400995793,Georgetown Hoyas,D. White,3948815,,True,33.0,2,13,1,8,1,5,6,6,3,2,5,2,1,1,3,3,11
400995793,Georgetown Hoyas,D. Burton,3142292,,True,30.0,4,7,4,6,0,1,2,4,0,2,2,1,2,0,1,3,10
400995793,Georgetown Hoyas,M. Venson,3142105,,True,40.0,1,13,1,5,0,8,2,2,2,2,4,5,1,1,3,2,4
400995793,Georgetown Hoyas,T. Thompson,4281352,,False,12.0,2,4,2,3,0,1,0,0,1,0,1,0,0,0,0,2,4
400995793,Georgetown Hoyas,M. Smith,4068079,,False,22.0,4,11,3,8,1,3,3,4,2,0,2,0,0,1,1,2,12
400995793,Georgetown Hoyas,B. Mayfield,4281354,,False,3.0,0,1,0,1,0,0,0,0,0,0,0,0,0,0,0,1,0
400995793,Georgetown Hoyas,TEAM,TOTAL,TOTAL,False,,20,64,18,45,2,19,15,18,15,11,26,10,7,6,8,17,57
400995793,Butler Bulldogs,S. Brey,4068067,,True,34.0,1,2,1,1,0,1,0,0,2,5,7,2,0,0,0,2,2
400995793,Butler Bulldogs,T. Schickel,3914012,,True,40.0,11,20,11,20,0,0,6,6,8,6,14,2,2,2,3,2,28
400995793,Butler Bulldogs,M. Weaver,3914014,,True,35.0,1,5,1,4,0,1,2,4,0,1,1,3,2,0,3,2,4
400995793,Butler Bulldogs,W. Jennings,3142145,,True,38.0,9,21,4,8,5,13,3,3,0,5,5,1,0,0,7,3,26
400995793,Butler Bulldogs,I. Lathan,3079485,,True,14.0,2,4,2,4,0,0,0,0,2,4,6,2,0,0,0,4,4
400995793,Butler Bulldogs,K. Hodges,4068065,,False,20.0,0,0,0,0,0,0,2,2,1,5,6,1,1,2,1,3,2
400995793,Butler Bulldogs,S. Buck,3142279,,False,18.0,0,2,0,0,0,2,0,0,0,1,1,2,0,0,0,1,0
400995793,Butler Bulldogs,TEAM,TOTAL,TOTAL,False,,24,54,19,37,5,17,13,15,13,27,40,13,5,4,16,17,66
400995793,Butler Bulldogs,S. Brey,4068067,,True,34.0,1,2,1,1,0,1,0,0,2,5,7,2,0,0,0,2,2
400995793,Butler Bulldogs,T. Schickel,3914012,,True,40.0,11,20,11,20,0,0,6,6,8,6,14,2,2,2,3,2,28
400995793,Butler Bulldogs,M. Weaver,3914014,,True,35.0,1,5,1,4,0,1,2,4,0,1,1,3,2,0,3,2,4
400995793,Butler Bulldogs,W. Jennings,3142145,,True,38.0,9,21,4,8,5,13,3,3,0,5,5,1,0,0,7,3,26
400995793,Butler Bulldogs,I. Lathan,3079485,,True,14.0,2,4,2,4,0,0,0,0,2,4,6,2,0,0,0,4,4
400995793,Butler Bulldogs,K. Hodges,4068065,,False,20.0,0,0,0,0,0,0,2,2,1,5,6,1,1,2,1,3,2
400995793,Butler Bulldogs,S. Buck,3142279,,False,18.0,0,2,0,0,0,2,0,0,0,1,1,2,0,0,0,1,0
400995793,Butler Bulldogs,TEAM,TOTAL,TOTAL,False,,24,54,19,37,5,17,13,15,13,27,40,13,5,4,16,17,66
400995792,Marquette Golden Eagles,E. Davenport,3906756,,True,29.0,5,11,5,11,0,0,1,2,4,2,6,0,0,0,3,3,11
400995792,Marquette Golden Eagles,A. Wilborn,3906758,,True,31.0,7,10,7,9,0,1,3,3,2,5,7,1,0,0,2,2,17
400995792,Marquette Golden Eagles,A. Blockton,3906755,,True,34.0,11,17,11,15,0,2,3,6,3,9,12,2,0,0,4,2,25
400995792,Marquette Golden Eagles,N. Hiedeman,3906753,,True,33.0,7,16,6,11,1,5,2,3,1,4,5,4,0,0,1,2,17
400995792,Marquette Golden Eagles,D. King,3906752,,True,37.0,6,13,6,10,0,3,5,8,2,5,7,6,3,0,0,2,17
400995792,Marquette Golden Eagles,A. Anderson,4068081,,False,1.0,0,0,0,0,0,0,0,0,1,1,2,0,0,0,0,1,0
400995792,Marquette Golden Eagles,L. Van Kleunen,4068083,,False,9.0,1,2,0,0,1,2,0,0,0,0,0,0,0,0,0,3,3
400995792,Marquette Golden Eagles,S. Lott,4281350,,False,22.0,1,1,0,0,1,1,0,2,1,4,5,2,1,1,0,1,3
400995792,Marquette Golden Eagles,I. Spingola,4068082,,False,4.0,0,0,0,0,0,0,0,0,0,0,0,0,0,0,1,2,0
400995792,Marquette Golden Eagles,TEAM,TOTAL,TOTAL,False,,38,70,35,56,3,14,14,24,15,31,46,15,4,1,11,18,93
400995792,Marquette Golden Eagles,E. Davenport,3906756,,True,29.0,5,11,5,11,0,0,1,2,4,2,6,0,0,0,3,3,11
400995792,Marquette Golden Eagles,A. Wilborn,3906758,,True,31.0,7,10,7,9,0,1,3,3,2,5,7,1,0,0,2,2,17
400995792,Marquette Golden Eagles,A. Blockton,3906755,,True,34.0,11,17,11,15,0,2,3,6,3,9,12,2,0,0,4,2,25
400995792,Marquette Golden Eagles,N. Hiedeman,3906753,,True,33.0,7,16,6,11,1,5,2,3,1,4,5,4,0,0,1,2,17
400995792,Marquette Golden Eagles,D. King,3906752,,True,37.0,6,13,6,10,0,3,5,8,2,5,7,6,3,0,0,2,17
400995792,Marquette Golden Eagles,A. Anderson,4068081,,False,1.0,0,0,0,0,0,0,0,0,1,1,2,0,0,0,0,1,0
400995792,Marquette Golden Eagles,L. Van Kleunen,4068083,,False,9.0,1,2,0,0,1,2,0,0,0,0,0,0,0,0,0,3,3
400995792,Marquette Golden Eagles,S. Lott,4281350,,False,22.0,1,1,0,0,1,1,0,2,1,4,5,2,1,1,0,1,3
400995792,Marquette Golden Eagles,I. Spingola,4068082,,False,4.0,0,0,0,0,0,0,0,0,0,0,0,0,0,0,1,2,0
400995792,Marquette Golden Eagles,TEAM,TOTAL,TOTAL,False,,38,70,35,56,3,14,14,24,15,31,46,15,4,1,11,18,93
400995792,DePaul Blue Demons,M. Grays,3142287,,True,31.0,8,16,7,12,1,4,2,2,2,0,2,0,1,0,2,3,19
400995792,DePaul Blue Demons,K. Campbell,4068071,,True,35.0,6,10,4,5,2,5,3,4,5,7,12,7,1,1,2,2,17
400995792,DePaul Blue Demons,T. Allen,3933760,,True,14.0,1,9,1,7,0,2,0,0,1,0,1,1,0,0,2,3,2
400995792,DePaul Blue Demons,A. Millender,3142289,,True,34.0,3,11,1,3,2,8,0,0,2,1,3,3,0,0,1,4,8
400995792,DePaul Blue Demons,A. Coleman,3142123,,True,30.0,6,18,6,12,0,6,4,5,1,2,3,2,0,0,1,3,16
400995792,DePaul Blue Demons,R. McLimore,4281358,,False,2.0,0,0,0,0,0,0,0,0,0,0,0,1,0,0,0,0,0
400995792,DePaul Blue Demons,C. Stonewall,4068072,,False,32.0,6,13,5,10,1,3,0,0,4,4,8,0,2,0,0,1,13
400995792,DePaul Blue Demons,D. Bekelja,4281356,,False,2.0,0,0,0,0,0,0,0,0,0,0,0,0,0,0,0,0,0
400995792,DePaul Blue Demons,D. Cage,4068073,,False,7.0,1,3,1,3,0,0,0,0,1,0,1,2,0,0,1,1,2
400995792,DePaul Blue Demons,L. Prochaska,3142290,,False,13.0,2,2,2,2,0,0,0,0,0,3,3,1,0,1,0,2,4
400995792,DePaul Blue Demons,TEAM,TOTAL,TOTAL,False,,33,82,27,54,6,28,9,11,16,18,34,17,4,2,9,19,81
400995792,DePaul Blue Demons,M. Grays,3142287,,True,31.0,8,16,7,12,1,4,2,2,2,0,2,0,1,0,2,3,19
400995792,DePaul Blue Demons,K. Campbell,4068071,,True,35.0,6,10,4,5,2,5,3,4,5,7,12,7,1,1,2,2,17
400995792,DePaul Blue Demons,T. Allen,3933760,,True,14.0,1,9,1,7,0,2,0,0,1,0,1,1,0,0,2,3,2
400995792,DePaul Blue Demons,A. Millender,3142289,,True,34.0,3,11,1,3,2,8,0,0,2,1,3,3,0,0,1,4,8
400995792,DePaul Blue Demons,A. Coleman,3142123,,True,30.0,6,18,6,12,0,6,4,5,1,2,3,2,0,0,1,3,16
400995792,DePaul Blue Demons,R. McLimore,4281358,,False,2.0,0,0,0,0,0,0,0,0,0,0,0,1,0,0,0,0,0
400995792,DePaul Blue Demons,C. Stonewall,4068072,,False,32.0,6,13,5,10,1,3,0,0,4,4,8,0,2,0,0,1,13
400995792,DePaul Blue Demons,D. Bekelja,4281356,,False,2.0,0,0,0,0,0,0,0,0,0,0,0,0,0,0,0,0,0
400995792,DePaul Blue Demons,D. Cage,4068073,,False,7.0,1,3,1,3,0,0,0,0,1,0,1,2,0,0,1,1,2
400995792,DePaul Blue Demons,L. Prochaska,3142290,,False,13.0,2,2,2,2,0,0,0,0,0,3,3,1,0,1,0,2,4
400995792,DePaul Blue Demons,TEAM,TOTAL,TOTAL,False,,33,82,27,54,6,28,9,11,16,18,34,17,4,2,9,19,81
400995791,Villanova Wildcats,M. Quinn,3056785,,True,24.0,4,9,3,3,1,6,0,0,0,2,2,2,0,0,0,1,9
400995791,Villanova Wildcats,J. Tucker,3087536,,True,30.0,4,8,2,4,2,4,0,1,0,0,0,2,1,0,1,1,10
400995791,Villanova Wildcats,K. Jekot,4068171,,True,34.0,2,9,2,6,0,3,0,0,1,0,1,1,0,0,0,2,4
400995791,Villanova Wildcats,A. Hahn,3906779,,True,26.0,2,7,2,2,0,5,0,0,0,0,0,1,0,0,1,0,4
400995791,Villanova Wildcats,A. Louin,3142314,,True,33.0,6,12,6,8,0,4,4,5,1,9,10,2,1,1,2,4,16
400995791,Villanova Wildcats,M. Gedaka,4068172,,False,15.0,2,4,2,3,0,1,0,1,1,1,2,1,0,0,2,4,4
400995791,Villanova Wildcats,B. Herlihy,4068169,,False,4.0,0,0,0,0,0,0,0,0,0,0,0,0,0,0,0,0,0
400995791,Villanova Wildcats,B. Herlihy,3906778,,False,6.0,0,2,0,1,0,1,1,1,0,0,0,0,0,0,3,2,1
400995791,Villanova Wildcats,G. Stant,3906780,,False,10.0,0,1,0,0,0,1,0,0,0,1,1,0,1,0,0,0,0
400995791,Villanova Wildcats,R. James,4068168,,False,4.0,0,0,0,0,0,0,2,2,0,0,0,0,0,0,0,0,2
400995791,Villanova Wildcats,C. Onken,4068167,,False,14.0,1,2,0,0,1,2,0,0,0,1,1,1,0,0,1,3,3
400995791,Villanova Wildcats,TEAM,TOTAL,TOTAL,False,,21,54,17,27,4,27,7,10,4,15,19,10,3,1,10,17,53
400995791,Villanova Wildcats,M. Quinn,3056785,,True,24.0,4,9,3,3,1,6,0,0,0,2,2,2,0,0,0,1,9
400995791,Villanova Wildcats,J. Tucker,3087536,,True,30.0,4,8,2,4,2,4,0,1,0,0,0,2,1,0,1,1,10
400995791,Villanova Wildcats,K. Jekot,4068171,,True,34.0,2,9,2,6,0,3,0,0,1,0,1,1,0,0,0,2,4
400995791,Villanova Wildcats,A. Hahn,3906779,,True,26.0,2,7,2,2,0,5,0,0,0,0,0,1,0,0,1,0,4
400995791,Villanova Wildcats,A. Louin,3142314,,True,33.0,6,12,6,8,0,4,4,5,1,9,10,2,1,1,2,4,16
400995791,Villanova Wildcats,M. Gedaka,4068172,,False,15.0,2,4,2,3,0,1,0,1,1,1,2,1,0,0,2,4,4
400995791,Villanova Wildcats,B. Herlihy,4068169,,False,4.0,0,0,0,0,0,0,0,0,0,0,0,0,0,0,0,0,0
400995791,Villanova Wildcats,B. Herlihy,3906778,,False,6.0,0,2,0,1,0,1,1,1,0,0,0,0,0,0,3,2,1
400995791,Villanova Wildcats,G. Stant,3906780,,False,10.0,0,1,0,0,0,1,0,0,0,1,1,0,1,0,0,0,0
400995791,Villanova Wildcats,R. James,4068168,,False,4.0,0,0,0,0,0,0,2,2,0,0,0,0,0,0,0,0,2
400995791,Villanova Wildcats,C. Onken,4068167,,False,14.0,1,2,0,0,1,2,0,0,0,1,1,1,0,0,1,3,3
400995791,Villanova Wildcats,TEAM,TOTAL,TOTAL,False,,21,54,17,27,4,27,7,10,4,15,19,10,3,1,10,17,53
400995791,Butler Bulldogs,T. Schickel,3914012,,True,35.0,10,11,10,11,0,0,6,9,3,4,7,6,0,2,5,2,26
400995791,Butler Bulldogs,S. Brey,4068067,,True,34.0,0,1,0,1,0,0,0,0,2,5,7,4,2,0,0,1,0
400995791,Butler Bulldogs,M. Weaver,3914014,,True,35.0,2,6,2,4,0,2,7,8,0,5,5,0,0,0,2,3,11
400995791,Butler Bulldogs,W. Jennings,3142145,,True,39.0,7,14,5,9,2,5,0,0,1,5,6,2,1,0,1,4,16
400995791,Butler Bulldogs,I. Lathan,3079485,,True,13.0,4,9,4,9,0,0,0,0,0,3,3,1,0,0,1,0,8
400995791,Butler Bulldogs,A. Aube,4281363,,False,1.0,0,1,0,1,0,0,0,0,0,0,0,0,0,0,0,0,0
400995791,Butler Bulldogs,K. Hodges,4068065,,False,6.0,1,1,1,1,0,0,0,0,1,1,2,0,1,0,1,1,2
400995791,Butler Bulldogs,S. Humphrey,4068066,,False,1.0,0,0,0,0,0,0,0,0,0,0,0,0,0,0,0,0,0
400995791,Butler Bulldogs,K. Spolyar,4068068,,False,31.0,4,9,0,1,4,8,1,2,2,6,8,2,0,0,0,3,13
400995791,Butler Bulldogs,S. Buck,3142279,,False,5.0,0,1,0,0,0,1,0,0,0,0,0,1,0,0,0,1,0
400995791,Butler Bulldogs,TEAM,TOTAL,TOTAL,False,,28,53,22,37,6,16,14,19,11,32,43,16,4,2,10,15,76
400995791,Butler Bulldogs,T. Schickel,3914012,,True,35.0,10,11,10,11,0,0,6,9,3,4,7,6,0,2,5,2,26
400995791,Butler Bulldogs,S. Brey,4068067,,True,34.0,0,1,0,1,0,0,0,0,2,5,7,4,2,0,0,1,0
400995791,Butler Bulldogs,M. Weaver,3914014,,True,35.0,2,6,2,4,0,2,7,8,0,5,5,0,0,0,2,3,11
400995791,Butler Bulldogs,W. Jennings,3142145,,True,39.0,7,14,5,9,2,5,0,0,1,5,6,2,1,0,1,4,16
400995791,Butler Bulldogs,I. Lathan,3079485,,True,13.0,4,9,4,9,0,0,0,0,0,3,3,1,0,0,1,0,8
400995791,Butler Bulldogs,A. Aube,4281363,,False,1.0,0,1,0,1,0,0,0,0,0,0,0,0,0,0,0,0,0
400995791,Butler Bulldogs,K. Hodges,4068065,,False,6.0,1,1,1,1,0,0,0,0,1,1,2,0,1,0,1,1,2
400995791,Butler Bulldogs,S. Humphrey,4068066,,False,1.0,0,0,0,0,0,0,0,0,0,0,0,0,0,0,0,0,0
400995791,Butler Bulldogs,K. Spolyar,4068068,,False,31.0,4,9,0,1,4,8,1,2,2,6,8,2,0,0,0,3,13
400995791,Butler Bulldogs,S. Buck,3142279,,False,5.0,0,1,0,0,0,1,0,0,0,0,0,1,0,0,0,1,0
400995791,Butler Bulldogs,TEAM,TOTAL,TOTAL,False,,28,53,22,37,6,16,14,19,11,32,43,16,4,2,10,15,76
400995790,Seton Hall Pirates,S. Samuels,4068128,,True,29.0,8,15,6,11,2,4,1,1,3,3,6,3,1,0,2,0,19
400995790,Seton Hall Pirates,D. Fountain,3058890,,True,23.0,2,13,2,11,0,2,2,2,3,7,10,0,1,0,1,1,6
400995790,Seton Hall Pirates,K. Evans,4281378,,True,19.0,2,3,2,3,0,0,2,2,2,0,2,0,1,4,2,0,6
400995790,Seton Hall Pirates,I. Butina,4281377,,True,28.0,2,4,2,4,0,0,0,0,0,2,2,3,1,0,3,1,4
400995790,Seton Hall Pirates,J. Jackson,3064877,,True,31.0,3,7,3,7,0,0,0,0,2,3,5,0,3,0,0,3,6
400995790,Seton Hall Pirates,S. Philoxy,4281380,,False,4.0,1,1,1,1,0,0,0,0,0,0,0,0,1,0,1,3,2
400995790,Seton Hall Pirates,T. Brown,3941336,,False,16.0,2,4,2,3,0,1,2,2,0,3,3,0,0,1,1,2,6
400995790,Seton Hall Pirates,D. Winters,4068126,,False,19.0,1,2,1,2,0,0,0,0,0,3,3,0,1,0,3,2,2
400995790,Seton Hall Pirates,N. Jimenez,4281379,,False,8.0,0,1,0,0,0,1,0,0,0,0,0,0,0,0,0,2,0
400995790,Seton Hall Pirates,K. Hilaire,4068123,,False,23.0,0,9,0,7,0,2,0,0,0,0,0,3,0,0,0,1,0
400995790,Seton Hall Pirates,TEAM,TOTAL,TOTAL,False,,21,59,19,49,2,10,7,7,12,22,34,9,9,5,13,15,51
400995790,Seton Hall Pirates,S. Samuels,4068128,,True,29.0,8,15,6,11,2,4,1,1,3,3,6,3,1,0,2,0,19
400995790,Seton Hall Pirates,D. Fountain,3058890,,True,23.0,2,13,2,11,0,2,2,2,3,7,10,0,1,0,1,1,6
400995790,Seton Hall Pirates,K. Evans,4281378,,True,19.0,2,3,2,3,0,0,2,2,2,0,2,0,1,4,2,0,6
400995790,Seton Hall Pirates,I. Butina,4281377,,True,28.0,2,4,2,4,0,0,0,0,0,2,2,3,1,0,3,1,4
400995790,Seton Hall Pirates,J. Jackson,3064877,,True,31.0,3,7,3,7,0,0,0,0,2,3,5,0,3,0,0,3,6
400995790,Seton Hall Pirates,S. Philoxy,4281380,,False,4.0,1,1,1,1,0,0,0,0,0,0,0,0,1,0,1,3,2
400995790,Seton Hall Pirates,T. Brown,3941336,,False,16.0,2,4,2,3,0,1,2,2,0,3,3,0,0,1,1,2,6
400995790,Seton Hall Pirates,D. Winters,4068126,,False,19.0,1,2,1,2,0,0,0,0,0,3,3,0,1,0,3,2,2
400995790,Seton Hall Pirates,N. Jimenez,4281379,,False,8.0,0,1,0,0,0,1,0,0,0,0,0,0,0,0,0,2,0
400995790,Seton Hall Pirates,K. Hilaire,4068123,,False,23.0,0,9,0,7,0,2,0,0,0,0,0,3,0,0,0,1,0
400995790,Seton Hall Pirates,TEAM,TOTAL,TOTAL,False,,21,59,19,49,2,10,7,7,12,22,34,9,9,5,13,15,51
400995790,Creighton Bluejays,A. Faber,3938938,,True,29.0,2,6,1,3,1,3,0,0,0,3,3,2,0,0,4,1,5
400995790,Creighton Bluejays,A. Greene,3938937,,True,10.0,0,3,0,3,0,0,0,0,0,2,2,0,0,0,1,1,0
400995790,Creighton Bluejays,J. Agnew,3938935,,True,36.0,8,15,7,8,1,7,0,0,2,2,4,4,3,2,0,2,17
400995790,Creighton Bluejays,S. Lamberty,3142285,,True,37.0,5,9,3,5,2,4,1,1,3,4,7,4,1,1,2,0,13
400995790,Creighton Bluejays,M. Mellman,3142283,,True,12.0,1,5,0,2,1,3,0,0,2,2,4,0,0,0,0,1,3
400995790,Creighton Bluejays,K. Brown,3142286,,False,9.0,3,4,3,4,0,0,1,2,1,0,1,0,0,0,0,1,7
400995790,Creighton Bluejays,B. Norby,3142284,,False,7.0,1,5,1,4,0,1,0,0,0,3,3,0,0,1,0,0,2
400995790,Creighton Bluejays,T. Carda,4281362,,False,20.0,2,4,1,2,1,2,0,0,1,4,5,1,0,0,2,2,5
400995790,Creighton Bluejays,T. Rembao,4281361,,False,8.0,0,0,0,0,0,0,0,0,0,0,0,0,0,0,0,0,0
400995790,Creighton Bluejays,O. Elger,3938936,,False,26.0,4,8,2,4,2,4,6,7,1,3,4,5,3,0,2,2,16
400995790,Creighton Bluejays,B. Kissinger,3142124,,False,6.0,0,0,0,0,0,0,0,0,1,0,1,1,0,0,0,0,0
400995790,Creighton Bluejays,TEAM,TOTAL,TOTAL,False,,26,59,18,35,8,24,8,10,12,26,38,17,7,4,12,10,68
400995790,Creighton Bluejays,A. Faber,3938938,,True,29.0,2,6,1,3,1,3,0,0,0,3,3,2,0,0,4,1,5
400995790,Creighton Bluejays,A. Greene,3938937,,True,10.0,0,3,0,3,0,0,0,0,0,2,2,0,0,0,1,1,0
400995790,Creighton Bluejays,J. Agnew,3938935,,True,36.0,8,15,7,8,1,7,0,0,2,2,4,4,3,2,0,2,17
400995790,Creighton Bluejays,S. Lamberty,3142285,,True,37.0,5,9,3,5,2,4,1,1,3,4,7,4,1,1,2,0,13
400995790,Creighton Bluejays,M. Mellman,3142283,,True,12.0,1,5,0,2,1,3,0,0,2,2,4,0,0,0,0,1,3
400995790,Creighton Bluejays,K. Brown,3142286,,False,9.0,3,4,3,4,0,0,1,2,1,0,1,0,0,0,0,1,7
400995790,Creighton Bluejays,B. Norby,3142284,,False,7.0,1,5,1,4,0,1,0,0,0,3,3,0,0,1,0,0,2
400995790,Creighton Bluejays,T. Carda,4281362,,False,20.0,2,4,1,2,1,2,0,0,1,4,5,1,0,0,2,2,5
400995790,Creighton Bluejays,T. Rembao,4281361,,False,8.0,0,0,0,0,0,0,0,0,0,0,0,0,0,0,0,0,0
400995790,Creighton Bluejays,O. Elger,3938936,,False,26.0,4,8,2,4,2,4,6,7,1,3,4,5,3,0,2,2,16
400995790,Creighton Bluejays,B. Kissinger,3142124,,False,6.0,0,0,0,0,0,0,0,0,1,0,1,1,0,0,0,0,0
400995790,Creighton Bluejays,TEAM,TOTAL,TOTAL,False,,26,59,18,35,8,24,8,10,12,26,38,17,7,4,12,10,68
400995789,St. John's Red Storm,M. Singleton,4068158,,True,28.0,5,15,5,14,0,1,3,9,8,10,18,2,0,1,1,4,13
400995789,St. John's Red Storm,I. Littleton,3142306,,True,30.0,1,3,1,3,0,0,0,0,1,1,2,0,0,1,2,1,2
400995789,St. John's Red Storm,A. Wellere,3906771,,True,2.0,1,2,0,1,1,1,0,0,0,1,1,0,0,0,0,0,3
400995789,St. John's Red Storm,T. England,4068155,,True,40.0,3,6,1,3,2,3,0,0,1,1,2,1,1,2,5,2,8
400995789,St. John's Red Storm,A. Kebbe,4068154,,True,18.0,0,6,0,3,0,3,2,2,1,2,3,0,1,1,1,5,2
400995789,St. John's Red Storm,K. Charles,4281374,,False,20.0,1,4,1,4,0,0,0,0,3,7,10,0,2,2,2,2,2
400995789,St. John's Red Storm,Q. Hoppie,4281375,,False,34.0,3,16,1,11,2,5,2,2,1,1,2,2,2,1,2,5,10
400995789,St. John's Red Storm,S. Duncan,4068156,,False,6.0,0,0,0,0,0,0,0,0,0,0,0,0,0,0,0,0,0
400995789,St. John's Red Storm,T. Alexander,3142305,,False,22.0,2,4,2,4,0,0,0,0,1,2,3,2,1,0,1,0,4
400995789,St. John's Red Storm,TEAM,TOTAL,TOTAL,False,,16,56,11,43,5,13,7,13,16,25,41,7,7,8,14,19,44
400995789,St. John's Red Storm,M. Singleton,4068158,,True,28.0,5,15,5,14,0,1,3,9,8,10,18,2,0,1,1,4,13
400995789,St. John's Red Storm,I. Littleton,3142306,,True,30.0,1,3,1,3,0,0,0,0,1,1,2,0,0,1,2,1,2
400995789,St. John's Red Storm,A. Wellere,3906771,,True,2.0,1,2,0,1,1,1,0,0,0,1,1,0,0,0,0,0,3
400995789,St. John's Red Storm,T. England,4068155,,True,40.0,3,6,1,3,2,3,0,0,1,1,2,1,1,2,5,2,8
400995789,St. John's Red Storm,A. Kebbe,4068154,,True,18.0,0,6,0,3,0,3,2,2,1,2,3,0,1,1,1,5,2
400995789,St. John's Red Storm,K. Charles,4281374,,False,20.0,1,4,1,4,0,0,0,0,3,7,10,0,2,2,2,2,2
400995789,St. John's Red Storm,Q. Hoppie,4281375,,False,34.0,3,16,1,11,2,5,2,2,1,1,2,2,2,1,2,5,10
400995789,St. John's Red Storm,S. Duncan,4068156,,False,6.0,0,0,0,0,0,0,0,0,0,0,0,0,0,0,0,0,0
400995789,St. John's Red Storm,T. Alexander,3142305,,False,22.0,2,4,2,4,0,0,0,0,1,2,3,2,1,0,1,0,4
400995789,St. John's Red Storm,TEAM,TOTAL,TOTAL,False,,16,56,11,43,5,13,7,13,16,25,41,7,7,8,14,19,44
400995789,Providence Friars,O. Orlando,4281347,,True,9.0,0,0,0,0,0,0,0,0,0,2,2,0,0,0,1,1,0
400995789,Providence Friars,C. Williams,4281345,,True,26.0,4,6,4,6,0,0,2,2,0,3,3,4,1,0,2,2,10
400995789,Providence Friars,J. Nogic,3906769,,True,24.0,1,9,0,5,1,4,8,8,0,5,5,0,1,0,5,1,11
400995789,Providence Friars,M. Jolin,3906767,,True,20.0,5,6,1,2,4,4,0,0,0,4,4,0,2,1,1,0,14
400995789,Providence Friars,A. Botteghi,3142301,,True,21.0,1,6,1,6,0,0,1,1,0,2,2,0,1,0,0,1,3
400995789,Providence Friars,N. Franklin,4281348,,False,30.0,1,8,1,8,0,0,2,4,4,4,8,1,1,0,1,4,4
400995789,Providence Friars,B. Frias,3142302,,False,13.0,0,0,0,0,0,0,0,0,1,1,2,1,0,1,0,2,0
400995789,Providence Friars,K. Spiwak,4281346,,False,22.0,3,4,3,4,0,0,1,1,0,1,1,0,0,0,0,1,7
400995789,Providence Friars,N. Jackson,4068111,,False,10.0,0,1,0,1,0,0,0,0,1,2,3,0,0,0,1,1,0
400995789,Providence Friars,C. Che,3906766,,False,25.0,0,7,0,6,0,1,0,0,0,2,2,0,0,0,3,2,0
400995789,Providence Friars,TEAM,TOTAL,TOTAL,False,,15,47,10,38,5,9,14,16,8,27,35,6,6,2,14,15,49
400995789,Providence Friars,O. Orlando,4281347,,True,9.0,0,0,0,0,0,0,0,0,0,2,2,0,0,0,1,1,0
400995789,Providence Friars,C. Williams,4281345,,True,26.0,4,6,4,6,0,0,2,2,0,3,3,4,1,0,2,2,10
400995789,Providence Friars,J. Nogic,3906769,,True,24.0,1,9,0,5,1,4,8,8,0,5,5,0,1,0,5,1,11
400995789,Providence Friars,M. Jolin,3906767,,True,20.0,5,6,1,2,4,4,0,0,0,4,4,0,2,1,1,0,14
400995789,Providence Friars,A. Botteghi,3142301,,True,21.0,1,6,1,6,0,0,1,1,0,2,2,0,1,0,0,1,3
400995789,Providence Friars,N. Franklin,4281348,,False,30.0,1,8,1,8,0,0,2,4,4,4,8,1,1,0,1,4,4
400995789,Providence Friars,B. Frias,3142302,,False,13.0,0,0,0,0,0,0,0,0,1,1,2,1,0,1,0,2,0
400995789,Providence Friars,K. Spiwak,4281346,,False,22.0,3,4,3,4,0,0,1,1,0,1,1,0,0,0,0,1,7
400995789,Providence Friars,N. Jackson,4068111,,False,10.0,0,1,0,1,0,0,0,0,1,2,3,0,0,0,1,1,0
400995789,Providence Friars,C. Che,3906766,,False,25.0,0,7,0,6,0,1,0,0,0,2,2,0,0,0,3,2,0
400995789,Providence Friars,TEAM,TOTAL,TOTAL,False,,15,47,10,38,5,9,14,16,8,27,35,6,6,2,14,15,49
400995788,Xavier Musketeers,I. Partlow,3142320,,True,19.0,1,7,1,6,0,1,6,7,1,3,4,2,0,0,0,0,8
400995788,Xavier Musketeers,A. Äijänen,3142319,,True,31.0,7,11,4,5,3,6,0,0,0,2,2,1,0,0,0,0,17
400995788,Xavier Musketeers,N. Owens,4068187,,True,24.0,1,5,1,3,0,2,0,0,0,2,2,2,1,0,2,3,2
400995788,Xavier Musketeers,J. Byrd,3142318,,True,27.0,4,7,4,7,0,0,1,2,2,6,8,1,0,1,5,5,9
400995788,Xavier Musketeers,K. Fincher,3142317,,True,18.0,0,2,0,0,0,2,0,0,0,1,1,2,0,0,1,0,0
400995788,Xavier Musketeers,A. Gray,4281368,,False,15.0,2,4,2,4,0,0,3,6,0,0,0,0,2,0,2,1,7
400995788,Xavier Musketeers,D. Ross,4281364,,False,13.0,3,4,1,1,2,3,0,0,0,1,1,0,0,0,0,2,8
400995788,Xavier Musketeers,A. Reiff,4281367,,False,19.0,1,2,0,0,1,2,0,0,0,2,2,0,0,0,1,2,3
400995788,Xavier Musketeers,P. Stewart,4281366,,False,5.0,0,0,0,0,0,0,0,0,0,1,1,0,0,0,1,1,0
400995788,Xavier Musketeers,A. Dunham,4281365,,False,17.0,2,3,0,0,2,3,0,0,0,0,0,3,0,0,1,0,6
400995788,Xavier Musketeers,A. Gomez,4068185,,False,12.0,0,1,0,0,0,1,0,0,0,0,0,1,1,0,2,3,0
400995788,Xavier Musketeers,TEAM,TOTAL,TOTAL,False,,21,46,13,26,8,20,10,15,4,20,24,12,4,1,15,17,60
400995788,Xavier Musketeers,I. Partlow,3142320,,True,19.0,1,7,1,6,0,1,6,7,1,3,4,2,0,0,0,0,8
400995788,Xavier Musketeers,A. Äijänen,3142319,,True,31.0,7,11,4,5,3,6,0,0,0,2,2,1,0,0,0,0,17
400995788,Xavier Musketeers,N. Owens,4068187,,True,24.0,1,5,1,3,0,2,0,0,0,2,2,2,1,0,2,3,2
400995788,Xavier Musketeers,J. Byrd,3142318,,True,27.0,4,7,4,7,0,0,1,2,2,6,8,1,0,1,5,5,9
400995788,Xavier Musketeers,K. Fincher,3142317,,True,18.0,0,2,0,0,0,2,0,0,0,1,1,2,0,0,1,0,0
400995788,Xavier Musketeers,A. Gray,4281368,,False,15.0,2,4,2,4,0,0,3,6,0,0,0,0,2,0,2,1,7
400995788,Xavier Musketeers,D. Ross,4281364,,False,13.0,3,4,1,1,2,3,0,0,0,1,1,0,0,0,0,2,8
400995788,Xavier Musketeers,A. Reiff,4281367,,False,19.0,1,2,0,0,1,2,0,0,0,2,2,0,0,0,1,2,3
400995788,Xavier Musketeers,P. Stewart,4281366,,False,5.0,0,0,0,0,0,0,0,0,0,1,1,0,0,0,1,1,0
400995788,Xavier Musketeers,A. Dunham,4281365,,False,17.0,2,3,0,0,2,3,0,0,0,0,0,3,0,0,1,0,6
400995788,Xavier Musketeers,A. Gomez,4068185,,False,12.0,0,1,0,0,0,1,0,0,0,0,0,1,1,0,2,3,0
400995788,Xavier Musketeers,TEAM,TOTAL,TOTAL,False,,21,46,13,26,8,20,10,15,4,20,24,12,4,1,15,17,60
400995788,Georgetown Hoyas,C. Petke,4068078,,True,29.0,5,11,2,6,3,5,0,0,3,4,7,3,0,0,2,5,13
400995788,Georgetown Hoyas,Y. Belk,3142295,,True,26.0,3,5,3,5,0,0,2,2,8,4,12,1,0,3,3,3,8
400995788,Georgetown Hoyas,D. White,3948815,,True,38.0,9,21,8,18,1,3,1,2,1,6,7,1,3,2,3,2,20
400995788,Georgetown Hoyas,D. Burton,3142292,,True,29.0,0,5,0,5,0,0,0,2,2,3,5,5,1,0,1,2,0
400995788,Georgetown Hoyas,M. Venson,3142105,,True,40.0,5,13,4,8,1,5,4,6,0,1,1,5,0,0,1,1,15
400995788,Georgetown Hoyas,T. Thompson,4281352,,False,6.0,0,1,0,0,0,1,0,0,0,2,2,0,0,0,2,1,0
400995788,Georgetown Hoyas,M. Smith,4068079,,False,30.0,4,6,3,5,1,1,0,0,2,2,4,1,1,0,1,1,9
400995788,Georgetown Hoyas,B. Mayfield,4281354,,False,2.0,0,0,0,0,0,0,0,0,0,1,1,0,0,0,0,0,0
400995788,Georgetown Hoyas,TEAM,TOTAL,TOTAL,False,,26,62,20,47,6,15,7,12,17,24,41,16,5,5,13,15,65
400995788,Georgetown Hoyas,C. Petke,4068078,,True,29.0,5,11,2,6,3,5,0,0,3,4,7,3,0,0,2,5,13
400995788,Georgetown Hoyas,Y. Belk,3142295,,True,26.0,3,5,3,5,0,0,2,2,8,4,12,1,0,3,3,3,8
400995788,Georgetown Hoyas,D. White,3948815,,True,38.0,9,21,8,18,1,3,1,2,1,6,7,1,3,2,3,2,20
400995788,Georgetown Hoyas,D. Burton,3142292,,True,29.0,0,5,0,5,0,0,0,2,2,3,5,5,1,0,1,2,0
400995788,Georgetown Hoyas,M. Venson,3142105,,True,40.0,5,13,4,8,1,5,4,6,0,1,1,5,0,0,1,1,15
400995788,Georgetown Hoyas,T. Thompson,4281352,,False,6.0,0,1,0,0,0,1,0,0,0,2,2,0,0,0,2,1,0
400995788,Georgetown Hoyas,M. Smith,4068079,,False,30.0,4,6,3,5,1,1,0,0,2,2,4,1,1,0,1,1,9
400995788,Georgetown Hoyas,B. Mayfield,4281354,,False,2.0,0,0,0,0,0,0,0,0,0,1,1,0,0,0,0,0,0
400995788,Georgetown Hoyas,TEAM,TOTAL,TOTAL,False,,26,62,20,47,6,15,7,12,17,24,41,16,5,5,13,15,65
400995787,St. John's Red Storm,M. Singleton,4068158,,True,33.0,6,13,6,13,0,0,1,2,5,12,17,1,4,2,2,3,13
400995787,St. John's Red Storm,I. Littleton,3142306,,True,38.0,3,7,3,7,0,0,1,4,3,7,10,1,2,1,0,3,7
400995787,St. John's Red Storm,A. Wellere,3906771,,True,34.0,3,10,2,7,1,3,4,6,2,2,4,3,0,0,0,4,11
400995787,St. John's Red Storm,T. England,4068155,,True,36.0,6,13,6,12,0,1,2,2,0,5,5,5,1,0,2,5,14
400995787,St. John's Red Storm,A. Kebbe,4068154,,True,27.0,2,6,2,5,0,1,3,4,3,3,6,0,0,1,4,3,7
400995787,St. John's Red Storm,K. Charles,4281374,,False,3.0,1,1,1,1,0,0,0,0,0,0,0,0,0,0,0,1,2
400995787,St. John's Red Storm,Q. Hoppie,4281375,,False,12.0,2,6,2,4,0,2,3,4,0,0,0,0,0,1,6,2,7
400995787,St. John's Red Storm,A. Adams,4068157,,False,17.0,2,5,0,1,2,4,0,0,1,0,1,2,0,0,1,2,6
400995787,St. John's Red Storm,TEAM,TOTAL,TOTAL,False,,25,61,22,50,3,11,14,22,14,30,44,12,7,5,15,23,67
400995787,St. John's Red Storm,M. Singleton,4068158,,True,33.0,6,13,6,13,0,0,1,2,5,12,17,1,4,2,2,3,13
400995787,St. John's Red Storm,I. Littleton,3142306,,True,38.0,3,7,3,7,0,0,1,4,3,7,10,1,2,1,0,3,7
400995787,St. John's Red Storm,A. Wellere,3906771,,True,34.0,3,10,2,7,1,3,4,6,2,2,4,3,0,0,0,4,11
400995787,St. John's Red Storm,T. England,4068155,,True,36.0,6,13,6,12,0,1,2,2,0,5,5,5,1,0,2,5,14
400995787,St. John's Red Storm,A. Kebbe,4068154,,True,27.0,2,6,2,5,0,1,3,4,3,3,6,0,0,1,4,3,7
400995787,St. John's Red Storm,K. Charles,4281374,,False,3.0,1,1,1,1,0,0,0,0,0,0,0,0,0,0,0,1,2
400995787,St. John's Red Storm,Q. Hoppie,4281375,,False,12.0,2,6,2,4,0,2,3,4,0,0,0,0,0,1,6,2,7
400995787,St. John's Red Storm,A. Adams,4068157,,False,17.0,2,5,0,1,2,4,0,0,1,0,1,2,0,0,1,2,6
400995787,St. John's Red Storm,TEAM,TOTAL,TOTAL,False,,25,61,22,50,3,11,14,22,14,30,44,12,7,5,15,23,67
400995787,DePaul Blue Demons,M. Grays,3142287,,True,25.0,5,9,1,3,4,6,4,6,0,3,3,2,0,0,3,5,18
400995787,DePaul Blue Demons,K. Campbell,4068071,,True,35.0,4,7,2,3,2,4,0,0,0,12,12,9,4,0,2,3,10
400995787,DePaul Blue Demons,T. Allen,3933760,,True,29.0,2,9,2,6,0,3,1,3,1,3,4,2,2,0,1,2,5
400995787,DePaul Blue Demons,A. Millender,3142289,,True,36.0,6,12,3,3,3,9,0,0,0,1,1,1,0,0,0,2,15
400995787,DePaul Blue Demons,A. Coleman,3142123,,True,25.0,3,13,3,9,0,4,3,3,3,5,8,3,1,0,6,2,9
400995787,DePaul Blue Demons,R. McLimore,4281358,,False,0.0,0,0,0,0,0,0,0,0,0,0,0,0,0,0,0,1,0
400995787,DePaul Blue Demons,C. Stonewall,4068072,,False,25.0,3,7,3,5,0,2,5,9,3,2,5,1,1,1,0,1,11
400995787,DePaul Blue Demons,D. Cage,4068073,,False,5.0,1,1,1,1,0,0,0,0,1,1,2,1,1,0,0,2,2
400995787,DePaul Blue Demons,L. Prochaska,3142290,,False,20.0,2,3,2,3,0,0,2,2,0,0,0,3,0,0,1,1,6
400995787,DePaul Blue Demons,TEAM,TOTAL,TOTAL,False,,26,61,17,33,9,28,15,23,10,28,38,22,9,1,14,19,76
400995787,DePaul Blue Demons,M. Grays,3142287,,True,25.0,5,9,1,3,4,6,4,6,0,3,3,2,0,0,3,5,18
400995787,DePaul Blue Demons,K. Campbell,4068071,,True,35.0,4,7,2,3,2,4,0,0,0,12,12,9,4,0,2,3,10
400995787,DePaul Blue Demons,T. Allen,3933760,,True,29.0,2,9,2,6,0,3,1,3,1,3,4,2,2,0,1,2,5
400995787,DePaul Blue Demons,A. Millender,3142289,,True,36.0,6,12,3,3,3,9,0,0,0,1,1,1,0,0,0,2,15
400995787,DePaul Blue Demons,A. Coleman,3142123,,True,25.0,3,13,3,9,0,4,3,3,3,5,8,3,1,0,6,2,9
400995787,DePaul Blue Demons,R. McLimore,4281358,,False,0.0,0,0,0,0,0,0,0,0,0,0,0,0,0,0,0,1,0
400995787,DePaul Blue Demons,C. Stonewall,4068072,,False,25.0,3,7,3,5,0,2,5,9,3,2,5,1,1,1,0,1,11
400995787,DePaul Blue Demons,D. Cage,4068073,,False,5.0,1,1,1,1,0,0,0,0,1,1,2,1,1,0,0,2,2
400995787,DePaul Blue Demons,L. Prochaska,3142290,,False,20.0,2,3,2,3,0,0,2,2,0,0,0,3,0,0,1,1,6
400995787,DePaul Blue Demons,TEAM,TOTAL,TOTAL,False,,26,61,17,33,9,28,15,23,10,28,38,22,9,1,14,19,76
400995786,Seton Hall Pirates,S. Samuels,4068128,,True,18.0,0,0,0,0,0,0,0,0,0,0,0,1,0,0,1,4,0
400995786,Seton Hall Pirates,D. Fountain,3058890,,True,25.0,6,13,3,7,3,6,1,2,1,3,4,0,0,1,4,4,16
400995786,Seton Hall Pirates,J. Jones-Pack,4068129,,True,3.0,0,0,0,0,0,0,0,0,0,1,1,0,0,1,0,2,0
400995786,Seton Hall Pirates,I. Butina,4281377,,True,19.0,1,2,0,1,1,1,0,0,0,0,0,1,0,0,5,0,3
400995786,Seton Hall Pirates,J. Jackson,3064877,,True,27.0,5,10,1,2,4,8,0,0,0,0,0,2,1,0,0,2,14
400995786,Seton Hall Pirates,S. Philoxy,4281380,,False,20.0,2,4,2,4,0,0,1,2,2,1,3,4,4,2,0,0,5
400995786,Seton Hall Pirates,T. Brown,3941336,,False,23.0,5,7,4,6,1,1,0,1,1,2,3,1,0,0,7,4,11
400995786,Seton Hall Pirates,K. Evans,4281378,,False,11.0,3,4,3,4,0,0,0,0,1,1,2,0,0,2,0,1,6
400995786,Seton Hall Pirates,D. Winters,4068126,,False,20.0,4,6,0,1,4,5,0,0,1,2,3,3,0,0,0,1,12
400995786,Seton Hall Pirates,N. Jimenez,4281379,,False,15.0,2,4,0,0,2,4,0,0,0,3,3,2,1,0,1,2,6
400995786,Seton Hall Pirates,K. Hilaire,4068123,,False,19.0,5,8,5,7,0,1,1,1,0,1,1,6,1,0,3,2,11
400995786,Seton Hall Pirates,TEAM,TOTAL,TOTAL,False,,33,58,18,32,15,26,3,6,6,17,23,20,7,6,22,22,84
400995786,Seton Hall Pirates,S. Samuels,4068128,,True,18.0,0,0,0,0,0,0,0,0,0,0,0,1,0,0,1,4,0
400995786,Seton Hall Pirates,D. Fountain,3058890,,True,25.0,6,13,3,7,3,6,1,2,1,3,4,0,0,1,4,4,16
400995786,Seton Hall Pirates,J. Jones-Pack,4068129,,True,3.0,0,0,0,0,0,0,0,0,0,1,1,0,0,1,0,2,0
400995786,Seton Hall Pirates,I. Butina,4281377,,True,19.0,1,2,0,1,1,1,0,0,0,0,0,1,0,0,5,0,3
400995786,Seton Hall Pirates,J. Jackson,3064877,,True,27.0,5,10,1,2,4,8,0,0,0,0,0,2,1,0,0,2,14
400995786,Seton Hall Pirates,S. Philoxy,4281380,,False,20.0,2,4,2,4,0,0,1,2,2,1,3,4,4,2,0,0,5
400995786,Seton Hall Pirates,T. Brown,3941336,,False,23.0,5,7,4,6,1,1,0,1,1,2,3,1,0,0,7,4,11
400995786,Seton Hall Pirates,K. Evans,4281378,,False,11.0,3,4,3,4,0,0,0,0,1,1,2,0,0,2,0,1,6
400995786,Seton Hall Pirates,D. Winters,4068126,,False,20.0,4,6,0,1,4,5,0,0,1,2,3,3,0,0,0,1,12
400995786,Seton Hall Pirates,N. Jimenez,4281379,,False,15.0,2,4,0,0,2,4,0,0,0,3,3,2,1,0,1,2,6
400995786,Seton Hall Pirates,K. Hilaire,4068123,,False,19.0,5,8,5,7,0,1,1,1,0,1,1,6,1,0,3,2,11
400995786,Seton Hall Pirates,TEAM,TOTAL,TOTAL,False,,33,58,18,32,15,26,3,6,6,17,23,20,7,6,22,22,84
400995786,Marquette Golden Eagles,E. Davenport,3906756,,True,28.0,9,14,9,14,0,0,3,3,5,6,11,1,2,1,0,2,21
400995786,Marquette Golden Eagles,A. Wilborn,3906758,,True,33.0,3,11,3,9,0,2,1,2,1,3,4,8,3,0,2,2,7
400995786,Marquette Golden Eagles,A. Blockton,3906755,,True,26.0,10,12,9,9,1,3,8,8,2,1,3,2,2,0,0,1,29
400995786,Marquette Golden Eagles,N. Hiedeman,3906753,,True,32.0,4,15,3,7,1,8,5,5,2,5,7,5,3,1,1,0,14
400995786,Marquette Golden Eagles,D. King,3906752,,True,29.0,2,8,1,5,1,3,0,0,1,2,3,7,2,0,3,2,5
400995786,Marquette Golden Eagles,A. Anderson,4068081,,False,8.0,2,2,2,2,0,0,2,4,2,1,3,0,0,0,1,0,6
400995786,Marquette Golden Eagles,S. Dahling,3906754,,False,1.0,0,0,0,0,0,0,0,0,0,0,0,0,0,0,0,0,0
400995786,Marquette Golden Eagles,L. Van Kleunen,4068083,,False,20.0,4,8,4,8,0,0,0,0,6,2,8,3,2,0,1,0,8
400995786,Marquette Golden Eagles,S. Lott,4281350,,False,11.0,1,4,1,3,0,1,0,0,1,1,2,1,0,1,0,0,2
400995786,Marquette Golden Eagles,I. Spingola,4068082,,False,11.0,2,4,1,1,1,3,0,0,2,0,2,0,0,0,0,0,5
400995786,Marquette Golden Eagles,O. Moskari,3906757,,False,1.0,0,0,0,0,0,0,0,0,0,0,0,0,0,0,1,0,0
400995786,Marquette Golden Eagles,TEAM,TOTAL,TOTAL,False,,37,78,33,58,4,20,19,22,24,22,46,27,14,3,9,7,97
400995786,Marquette Golden Eagles,E. Davenport,3906756,,True,28.0,9,14,9,14,0,0,3,3,5,6,11,1,2,1,0,2,21
400995786,Marquette Golden Eagles,A. Wilborn,3906758,,True,33.0,3,11,3,9,0,2,1,2,1,3,4,8,3,0,2,2,7
400995786,Marquette Golden Eagles,A. Blockton,3906755,,True,26.0,10,12,9,9,1,3,8,8,2,1,3,2,2,0,0,1,29
400995786,Marquette Golden Eagles,N. Hiedeman,3906753,,True,32.0,4,15,3,7,1,8,5,5,2,5,7,5,3,1,1,0,14
400995786,Marquette Golden Eagles,D. King,3906752,,True,29.0,2,8,1,5,1,3,0,0,1,2,3,7,2,0,3,2,5
400995786,Marquette Golden Eagles,A. Anderson,4068081,,False,8.0,2,2,2,2,0,0,2,4,2,1,3,0,0,0,1,0,6
400995786,Marquette Golden Eagles,S. Dahling,3906754,,False,1.0,0,0,0,0,0,0,0,0,0,0,0,0,0,0,0,0,0
400995786,Marquette Golden Eagles,L. Van Kleunen,4068083,,False,20.0,4,8,4,8,0,0,0,0,6,2,8,3,2,0,1,0,8
400995786,Marquette Golden Eagles,S. Lott,4281350,,False,11.0,1,4,1,3,0,1,0,0,1,1,2,1,0,1,0,0,2
400995786,Marquette Golden Eagles,I. Spingola,4068082,,False,11.0,2,4,1,1,1,3,0,0,2,0,2,0,0,0,0,0,5
400995786,Marquette Golden Eagles,O. Moskari,3906757,,False,1.0,0,0,0,0,0,0,0,0,0,0,0,0,0,0,1,0,0
400995786,Marquette Golden Eagles,TEAM,TOTAL,TOTAL,False,,37,78,33,58,4,20,19,22,24,22,46,27,14,3,9,7,97
400995785,Georgetown Hoyas,C. Petke,4068078,,True,31.0,0,5,0,3,0,2,1,2,2,1,3,2,0,0,1,3,1
400995785,Georgetown Hoyas,Y. Belk,3142295,,True,29.0,5,10,5,10,0,0,0,0,4,6,10,1,0,1,1,3,10
400995785,Georgetown Hoyas,D. White,3948815,,True,36.0,6,12,4,9,2,3,4,5,1,4,5,3,1,1,4,5,18
400995785,Georgetown Hoyas,D. Burton,3142292,,True,35.0,3,10,3,8,0,2,0,0,1,0,1,2,2,0,0,3,6
400995785,Georgetown Hoyas,M. Venson,3142105,,True,40.0,5,10,3,5,2,5,5,6,0,1,1,6,2,0,2,2,17
400995785,Georgetown Hoyas,T. Thompson,4281352,,False,9.0,1,2,1,2,0,0,2,4,2,2,4,0,0,0,1,0,4
400995785,Georgetown Hoyas,M. Smith,4068079,,False,20.0,1,4,1,3,0,1,0,0,0,2,2,1,0,0,0,1,2
400995785,Georgetown Hoyas,TEAM,TOTAL,TOTAL,False,,21,53,17,40,4,13,12,17,10,19,29,15,5,2,9,17,58
400995785,Georgetown Hoyas,C. Petke,4068078,,True,31.0,0,5,0,3,0,2,1,2,2,1,3,2,0,0,1,3,1
400995785,Georgetown Hoyas,Y. Belk,3142295,,True,29.0,5,10,5,10,0,0,0,0,4,6,10,1,0,1,1,3,10
400995785,Georgetown Hoyas,D. White,3948815,,True,36.0,6,12,4,9,2,3,4,5,1,4,5,3,1,1,4,5,18
400995785,Georgetown Hoyas,D. Burton,3142292,,True,35.0,3,10,3,8,0,2,0,0,1,0,1,2,2,0,0,3,6
400995785,Georgetown Hoyas,M. Venson,3142105,,True,40.0,5,10,3,5,2,5,5,6,0,1,1,6,2,0,2,2,17
400995785,Georgetown Hoyas,T. Thompson,4281352,,False,9.0,1,2,1,2,0,0,2,4,2,2,4,0,0,0,1,0,4
400995785,Georgetown Hoyas,M. Smith,4068079,,False,20.0,1,4,1,3,0,1,0,0,0,2,2,1,0,0,0,1,2
400995785,Georgetown Hoyas,TEAM,TOTAL,TOTAL,False,,21,53,17,40,4,13,12,17,10,19,29,15,5,2,9,17,58
400995785,Creighton Bluejays,A. Faber,3938938,,True,37.0,11,15,10,12,1,3,3,4,1,6,7,1,0,0,1,2,26
400995785,Creighton Bluejays,A. Greene,3938937,,True,8.0,0,1,0,1,0,0,0,0,0,0,0,0,0,0,0,0,0
400995785,Creighton Bluejays,J. Agnew,3938935,,True,33.0,4,10,3,4,1,6,0,0,0,1,1,3,0,0,2,3,9
400995785,Creighton Bluejays,S. Lamberty,3142285,,True,38.0,7,12,6,10,1,2,2,2,1,10,11,5,2,1,2,1,17
400995785,Creighton Bluejays,M. Mellman,3142283,,True,18.0,1,2,0,0,1,2,0,0,0,1,1,1,0,0,0,0,3
400995785,Creighton Bluejays,K. Brown,3142286,,False,11.0,0,1,0,1,0,0,0,0,0,1,1,1,0,1,1,1,0
400995785,Creighton Bluejays,B. Norby,3142284,,False,6.0,0,1,0,0,0,1,0,0,0,0,0,2,0,0,0,1,0
400995785,Creighton Bluejays,T. Carda,4281362,,False,13.0,0,0,0,0,0,0,1,2,0,2,2,0,0,0,1,2,1
400995785,Creighton Bluejays,T. Rembao,4281361,,False,3.0,0,0,0,0,0,0,0,0,0,0,0,0,0,0,1,0,0
400995785,Creighton Bluejays,O. Elger,3938936,,False,28.0,4,7,4,6,0,1,3,3,1,1,2,7,2,0,1,2,11
400995785,Creighton Bluejays,B. Kissinger,3142124,,False,5.0,1,1,1,1,0,0,0,0,0,1,1,1,0,0,0,0,2
400995785,Creighton Bluejays,TEAM,TOTAL,TOTAL,False,,28,50,24,35,4,15,9,11,4,25,29,21,4,2,11,12,69
400995785,Creighton Bluejays,A. Faber,3938938,,True,37.0,11,15,10,12,1,3,3,4,1,6,7,1,0,0,1,2,26
400995785,Creighton Bluejays,A. Greene,3938937,,True,8.0,0,1,0,1,0,0,0,0,0,0,0,0,0,0,0,0,0
400995785,Creighton Bluejays,J. Agnew,3938935,,True,33.0,4,10,3,4,1,6,0,0,0,1,1,3,0,0,2,3,9
400995785,Creighton Bluejays,S. Lamberty,3142285,,True,38.0,7,12,6,10,1,2,2,2,1,10,11,5,2,1,2,1,17
400995785,Creighton Bluejays,M. Mellman,3142283,,True,18.0,1,2,0,0,1,2,0,0,0,1,1,1,0,0,0,0,3
400995785,Creighton Bluejays,K. Brown,3142286,,False,11.0,0,1,0,1,0,0,0,0,0,1,1,1,0,1,1,1,0
400995785,Creighton Bluejays,B. Norby,3142284,,False,6.0,0,1,0,0,0,1,0,0,0,0,0,2,0,0,0,1,0
400995785,Creighton Bluejays,T. Carda,4281362,,False,13.0,0,0,0,0,0,0,1,2,0,2,2,0,0,0,1,2,1
400995785,Creighton Bluejays,T. Rembao,4281361,,False,3.0,0,0,0,0,0,0,0,0,0,0,0,0,0,0,1,0,0
400995785,Creighton Bluejays,O. Elger,3938936,,False,28.0,4,7,4,6,0,1,3,3,1,1,2,7,2,0,1,2,11
400995785,Creighton Bluejays,B. Kissinger,3142124,,False,5.0,1,1,1,1,0,0,0,0,0,1,1,1,0,0,0,0,2
400995785,Creighton Bluejays,TEAM,TOTAL,TOTAL,False,,28,50,24,35,4,15,9,11,4,25,29,21,4,2,11,12,69
400995784,Villanova Wildcats,M. Quinn,3056785,,True,12.0,0,3,0,2,0,1,0,0,0,1,1,0,0,0,0,1,0
400995784,Villanova Wildcats,K. Jekot,4068171,,True,35.0,1,7,0,3,1,4,2,2,1,3,4,3,1,0,1,0,5
400995784,Villanova Wildcats,A. Hahn,3906779,,True,38.0,3,12,0,1,3,11,2,2,1,6,7,4,0,0,1,1,11
400995784,Villanova Wildcats,A. Louin,3142314,,True,30.0,4,8,3,4,1,4,5,5,1,5,6,2,0,0,3,3,14
400995784,Villanova Wildcats,J. Tucker,3087536,,True,34.0,1,8,0,1,1,7,0,0,0,1,1,2,0,0,0,3,3
400995784,Villanova Wildcats,M. Gedaka,4068172,,False,30.0,11,12,10,11,1,1,1,1,2,3,5,1,0,0,0,3,24
400995784,Villanova Wildcats,B. Herlihy,3906778,,False,14.0,2,7,0,2,2,5,0,0,2,2,4,2,1,1,2,0,6
400995784,Villanova Wildcats,G. Stant,3906780,,False,7.0,0,0,0,0,0,0,0,0,0,0,0,1,0,0,0,1,0
400995784,Villanova Wildcats,TEAM,TOTAL,TOTAL,False,,22,57,13,24,9,33,10,10,8,23,31,15,2,1,7,12,63
400995784,Villanova Wildcats,M. Quinn,3056785,,True,12.0,0,3,0,2,0,1,0,0,0,1,1,0,0,0,0,1,0
400995784,Villanova Wildcats,K. Jekot,4068171,,True,35.0,1,7,0,3,1,4,2,2,1,3,4,3,1,0,1,0,5
400995784,Villanova Wildcats,A. Hahn,3906779,,True,38.0,3,12,0,1,3,11,2,2,1,6,7,4,0,0,1,1,11
400995784,Villanova Wildcats,A. Louin,3142314,,True,30.0,4,8,3,4,1,4,5,5,1,5,6,2,0,0,3,3,14
400995784,Villanova Wildcats,J. Tucker,3087536,,True,34.0,1,8,0,1,1,7,0,0,0,1,1,2,0,0,0,3,3
400995784,Villanova Wildcats,M. Gedaka,4068172,,False,30.0,11,12,10,11,1,1,1,1,2,3,5,1,0,0,0,3,24
400995784,Villanova Wildcats,B. Herlihy,3906778,,False,14.0,2,7,0,2,2,5,0,0,2,2,4,2,1,1,2,0,6
400995784,Villanova Wildcats,G. Stant,3906780,,False,7.0,0,0,0,0,0,0,0,0,0,0,0,1,0,0,0,1,0
400995784,Villanova Wildcats,TEAM,TOTAL,TOTAL,False,,22,57,13,24,9,33,10,10,8,23,31,15,2,1,7,12,63
400995784,Providence Friars,O. Orlando,4281347,,True,19.0,0,0,0,0,0,0,0,0,0,1,1,0,0,0,0,1,0
400995784,Providence Friars,K. Spiwak,4281346,,True,12.0,0,0,0,0,0,0,0,0,0,3,3,0,0,0,0,0,0
400995784,Providence Friars,J. Nogic,3906769,,True,34.0,9,15,5,7,4,8,4,4,0,4,4,2,0,1,4,1,26
400995784,Providence Friars,M. Jolin,3906767,,True,32.0,4,12,3,7,1,5,1,2,2,3,5,2,1,0,3,4,10
400995784,Providence Friars,A. Botteghi,3142301,,True,20.0,3,7,3,7,0,0,0,0,1,3,4,0,0,0,0,1,6
400995784,Providence Friars,N. Franklin,4281348,,False,30.0,2,6,2,6,0,0,3,4,1,7,8,0,0,0,2,2,7
400995784,Providence Friars,B. Frias,3142302,,False,3.0,0,0,0,0,0,0,0,0,0,0,0,0,0,0,0,0,0
400995784,Providence Friars,C. Williams,4281345,,False,21.0,1,4,1,4,0,0,0,0,1,4,5,1,0,0,1,2,2
400995784,Providence Friars,N. Jackson,4068111,,False,3.0,1,1,1,1,0,0,0,0,0,1,1,1,1,0,0,0,2
400995784,Providence Friars,C. Che,3906766,,False,26.0,1,4,1,2,0,2,0,0,0,0,0,2,0,0,1,1,2
400995784,Providence Friars,TEAM,TOTAL,TOTAL,False,,21,49,16,34,5,15,8,10,5,27,32,8,2,1,12,12,55
400995784,Providence Friars,O. Orlando,4281347,,True,19.0,0,0,0,0,0,0,0,0,0,1,1,0,0,0,0,1,0
400995784,Providence Friars,K. Spiwak,4281346,,True,12.0,0,0,0,0,0,0,0,0,0,3,3,0,0,0,0,0,0
400995784,Providence Friars,J. Nogic,3906769,,True,34.0,9,15,5,7,4,8,4,4,0,4,4,2,0,1,4,1,26
400995784,Providence Friars,M. Jolin,3906767,,True,32.0,4,12,3,7,1,5,1,2,2,3,5,2,1,0,3,4,10
400995784,Providence Friars,A. Botteghi,3142301,,True,20.0,3,7,3,7,0,0,0,0,1,3,4,0,0,0,0,1,6
400995784,Providence Friars,N. Franklin,4281348,,False,30.0,2,6,2,6,0,0,3,4,1,7,8,0,0,0,2,2,7
400995784,Providence Friars,B. Frias,3142302,,False,3.0,0,0,0,0,0,0,0,0,0,0,0,0,0,0,0,0,0
400995784,Providence Friars,C. Williams,4281345,,False,21.0,1,4,1,4,0,0,0,0,1,4,5,1,0,0,1,2,2
400995784,Providence Friars,N. Jackson,4068111,,False,3.0,1,1,1,1,0,0,0,0,0,1,1,1,1,0,0,0,2
400995784,Providence Friars,C. Che,3906766,,False,26.0,1,4,1,2,0,2,0,0,0,0,0,2,0,0,1,1,2
400995784,Providence Friars,TEAM,TOTAL,TOTAL,False,,21,49,16,34,5,15,8,10,5,27,32,8,2,1,12,12,55
400995783,Xavier Musketeers,A. Gray,4281368,,True,9.0,1,1,1,1,0,0,0,0,2,0,2,0,1,0,1,2,2
400995783,Xavier Musketeers,A. Aijanen,3142319,,True,29.0,6,11,5,6,1,5,1,1,1,6,7,3,0,1,1,3,14
400995783,Xavier Musketeers,N. Owens,4068187,,True,23.0,1,3,0,2,1,1,2,2,1,3,4,3,0,0,3,2,5
400995783,Xavier Musketeers,J. Byrd,3142318,,True,19.0,0,6,0,3,0,3,0,0,0,1,1,3,0,0,4,1,0
400995783,Xavier Musketeers,K. Fincher,3142317,,True,32.0,6,12,3,6,3,6,5,6,0,7,7,1,2,0,5,1,20
400995783,Xavier Musketeers,D. Ross,4281364,,False,16.0,2,3,0,0,2,3,0,0,0,4,4,0,0,0,2,2,6
400995783,Xavier Musketeers,I. Partlow,3142320,,False,23.0,5,10,3,8,2,2,3,4,2,4,6,1,1,1,3,2,15
400995783,Xavier Musketeers,A. Reiff,4281367,,False,1.0,0,0,0,0,0,0,0,0,0,0,0,0,0,0,0,0,0
400995783,Xavier Musketeers,P. Stewart,4281366,,False,11.0,0,1,0,0,0,1,0,0,0,1,1,0,0,0,1,1,0
400995783,Xavier Musketeers,A. Dunham,4281365,,False,18.0,1,2,0,0,1,2,1,2,0,2,2,4,1,0,1,2,4
400995783,Xavier Musketeers,A. Gomez,4068185,,False,19.0,1,4,0,0,1,4,0,0,0,0,0,1,1,0,2,1,3
400995783,Xavier Musketeers,TEAM,TOTAL,TOTAL,False,,23,53,12,26,11,27,12,15,9,32,41,16,6,2,24,17,69
400995783,Xavier Musketeers,A. Gray,4281368,,True,9.0,1,1,1,1,0,0,0,0,2,0,2,0,1,0,1,2,2
400995783,Xavier Musketeers,A. Aijanen,3142319,,True,29.0,6,11,5,6,1,5,1,1,1,6,7,3,0,1,1,3,14
400995783,Xavier Musketeers,N. Owens,4068187,,True,23.0,1,3,0,2,1,1,2,2,1,3,4,3,0,0,3,2,5
400995783,Xavier Musketeers,J. Byrd,3142318,,True,19.0,0,6,0,3,0,3,0,0,0,1,1,3,0,0,4,1,0
400995783,Xavier Musketeers,K. Fincher,3142317,,True,32.0,6,12,3,6,3,6,5,6,0,7,7,1,2,0,5,1,20
400995783,Xavier Musketeers,D. Ross,4281364,,False,16.0,2,3,0,0,2,3,0,0,0,4,4,0,0,0,2,2,6
400995783,Xavier Musketeers,I. Partlow,3142320,,False,23.0,5,10,3,8,2,2,3,4,2,4,6,1,1,1,3,2,15
400995783,Xavier Musketeers,A. Reiff,4281367,,False,1.0,0,0,0,0,0,0,0,0,0,0,0,0,0,0,0,0,0
400995783,Xavier Musketeers,P. Stewart,4281366,,False,11.0,0,1,0,0,0,1,0,0,0,1,1,0,0,0,1,1,0
400995783,Xavier Musketeers,A. Dunham,4281365,,False,18.0,1,2,0,0,1,2,1,2,0,2,2,4,1,0,1,2,4
400995783,Xavier Musketeers,A. Gomez,4068185,,False,19.0,1,4,0,0,1,4,0,0,0,0,0,1,1,0,2,1,3
400995783,Xavier Musketeers,TEAM,TOTAL,TOTAL,False,,23,53,12,26,11,27,12,15,9,32,41,16,6,2,24,17,69
400995783,Butler Bulldogs,S. Brey,4068067,,True,15.0,2,3,2,2,0,1,1,1,2,1,3,2,1,0,1,3,5
400995783,Butler Bulldogs,T. Schickel,3914012,,True,39.0,4,9,4,9,0,0,2,2,2,6,8,0,0,4,5,3,10
400995783,Butler Bulldogs,M. Weaver,3914014,,True,36.0,1,3,1,2,0,1,2,2,1,3,4,4,8,0,3,3,4
400995783,Butler Bulldogs,W. Jennings,3142145,,True,40.0,7,21,6,15,1,6,10,10,1,2,3,2,1,0,3,3,25
400995783,Butler Bulldogs,I. Lathan,3079485,,True,23.0,1,5,1,5,0,0,1,2,2,3,5,2,0,0,0,2,3
400995783,Butler Bulldogs,K. Hodges,4068065,,False,1.0,0,0,0,0,0,0,0,0,0,1,1,0,0,0,0,0,0
400995783,Butler Bulldogs,K. Spolyar,4068068,,False,31.0,5,21,3,11,2,10,3,5,2,1,3,1,3,0,1,4,15
400995783,Butler Bulldogs,S. Buck,3142279,,False,15.0,0,1,0,0,0,1,0,0,0,3,3,0,0,0,1,1,0
400995783,Butler Bulldogs,TEAM,TOTAL,TOTAL,False,,20,63,17,44,3,19,19,22,12,21,33,11,13,4,14,19,62
400995783,Butler Bulldogs,S. Brey,4068067,,True,15.0,2,3,2,2,0,1,1,1,2,1,3,2,1,0,1,3,5
400995783,Butler Bulldogs,T. Schickel,3914012,,True,39.0,4,9,4,9,0,0,2,2,2,6,8,0,0,4,5,3,10
400995783,Butler Bulldogs,M. Weaver,3914014,,True,36.0,1,3,1,2,0,1,2,2,1,3,4,4,8,0,3,3,4
400995783,Butler Bulldogs,W. Jennings,3142145,,True,40.0,7,21,6,15,1,6,10,10,1,2,3,2,1,0,3,3,25
400995783,Butler Bulldogs,I. Lathan,3079485,,True,23.0,1,5,1,5,0,0,1,2,2,3,5,2,0,0,0,2,3
400995783,Butler Bulldogs,K. Hodges,4068065,,False,1.0,0,0,0,0,0,0,0,0,0,1,1,0,0,0,0,0,0
400995783,Butler Bulldogs,K. Spolyar,4068068,,False,31.0,5,21,3,11,2,10,3,5,2,1,3,1,3,0,1,4,15
400995783,Butler Bulldogs,S. Buck,3142279,,False,15.0,0,1,0,0,0,1,0,0,0,3,3,0,0,0,1,1,0
400995783,Butler Bulldogs,TEAM,TOTAL,TOTAL,False,,20,63,17,44,3,19,19,22,12,21,33,11,13,4,14,19,62
400995782,St. John's Red Storm,I. Littleton,3142306,,True,37.0,3,4,3,4,0,0,1,1,0,4,4,0,1,4,1,3,7
400995782,St. John's Red Storm,A. Wellere,3906771,,True,29.0,3,10,3,5,0,5,0,0,0,1,1,4,0,0,4,4,6
400995782,St. John's Red Storm,Q. Hoppie,4281375,,True,29.0,5,14,3,11,2,3,1,1,1,1,2,1,1,0,1,0,13
400995782,St. John's Red Storm,T. England,4068155,,True,36.0,4,7,3,5,1,2,0,0,0,3,3,5,1,0,6,4,9
400995782,St. John's Red Storm,A. Kebbe,4068154,,True,36.0,7,13,5,7,2,6,0,0,1,5,6,1,4,0,1,3,16
400995782,St. John's Red Storm,M. Singleton,4068158,,False,21.0,3,7,3,7,0,0,2,2,2,7,9,1,1,1,1,1,8
400995782,St. John's Red Storm,A. Adams,4068157,,False,26.0,6,16,5,9,1,7,0,0,2,0,2,0,1,1,2,3,13
400995782,St. John's Red Storm,T. Alexander,3142305,,False,11.0,0,1,0,1,0,0,0,0,0,1,1,0,0,0,3,2,0
400995782,St. John's Red Storm,TEAM,TOTAL,TOTAL,False,,31,72,25,49,6,23,4,4,7,23,30,12,9,6,19,20,72
400995782,St. John's Red Storm,I. Littleton,3142306,,True,37.0,3,4,3,4,0,0,1,1,0,4,4,0,1,4,1,3,7
400995782,St. John's Red Storm,A. Wellere,3906771,,True,29.0,3,10,3,5,0,5,0,0,0,1,1,4,0,0,4,4,6
400995782,St. John's Red Storm,Q. Hoppie,4281375,,True,29.0,5,14,3,11,2,3,1,1,1,1,2,1,1,0,1,0,13
400995782,St. John's Red Storm,T. England,4068155,,True,36.0,4,7,3,5,1,2,0,0,0,3,3,5,1,0,6,4,9
400995782,St. John's Red Storm,A. Kebbe,4068154,,True,36.0,7,13,5,7,2,6,0,0,1,5,6,1,4,0,1,3,16
400995782,St. John's Red Storm,M. Singleton,4068158,,False,21.0,3,7,3,7,0,0,2,2,2,7,9,1,1,1,1,1,8
400995782,St. John's Red Storm,A. Adams,4068157,,False,26.0,6,16,5,9,1,7,0,0,2,0,2,0,1,1,2,3,13
400995782,St. John's Red Storm,T. Alexander,3142305,,False,11.0,0,1,0,1,0,0,0,0,0,1,1,0,0,0,3,2,0
400995782,St. John's Red Storm,TEAM,TOTAL,TOTAL,False,,31,72,25,49,6,23,4,4,7,23,30,12,9,6,19,20,72
400995782,Marquette Golden Eagles,E. Davenport,3906756,,True,34.0,4,5,4,5,0,0,0,2,1,7,8,1,3,1,8,2,8
400995782,Marquette Golden Eagles,A. Wilborn,3906758,,True,24.0,3,13,1,10,2,3,4,6,2,0,2,3,0,0,1,2,12
400995782,Marquette Golden Eagles,A. Blockton,3906755,,True,35.0,6,11,5,10,1,1,6,6,3,4,7,3,1,1,7,4,19
400995782,Marquette Golden Eagles,N. Hiedeman,3906753,,True,40.0,5,14,2,7,3,7,1,3,0,9,9,1,1,1,7,2,14
400995782,Marquette Golden Eagles,D. King,3906752,,True,35.0,4,10,3,8,1,2,0,1,1,1,2,3,0,0,2,3,9
400995782,Marquette Golden Eagles,L. Van Kleunen,4068083,,False,37.0,5,8,5,7,0,1,2,3,5,6,11,1,0,0,0,1,12
400995782,Marquette Golden Eagles,S. Lott,4281350,,False,16.0,0,2,0,1,0,1,0,0,1,3,4,2,3,0,1,1,0
400995782,Marquette Golden Eagles,I. Spingola,4068082,,False,4.0,0,1,0,0,0,1,0,0,0,0,0,0,0,0,1,0,0
400995782,Marquette Golden Eagles,TEAM,TOTAL,TOTAL,False,,27,64,20,48,7,16,13,21,17,32,49,14,8,3,27,15,74
400995782,Marquette Golden Eagles,E. Davenport,3906756,,True,34.0,4,5,4,5,0,0,0,2,1,7,8,1,3,1,8,2,8
400995782,Marquette Golden Eagles,A. Wilborn,3906758,,True,24.0,3,13,1,10,2,3,4,6,2,0,2,3,0,0,1,2,12
400995782,Marquette Golden Eagles,A. Blockton,3906755,,True,35.0,6,11,5,10,1,1,6,6,3,4,7,3,1,1,7,4,19
400995782,Marquette Golden Eagles,N. Hiedeman,3906753,,True,40.0,5,14,2,7,3,7,1,3,0,9,9,1,1,1,7,2,14
400995782,Marquette Golden Eagles,D. King,3906752,,True,35.0,4,10,3,8,1,2,0,1,1,1,2,3,0,0,2,3,9
400995782,Marquette Golden Eagles,L. Van Kleunen,4068083,,False,37.0,5,8,5,7,0,1,2,3,5,6,11,1,0,0,0,1,12
400995782,Marquette Golden Eagles,S. Lott,4281350,,False,16.0,0,2,0,1,0,1,0,0,1,3,4,2,3,0,1,1,0
400995782,Marquette Golden Eagles,I. Spingola,4068082,,False,4.0,0,1,0,0,0,1,0,0,0,0,0,0,0,0,1,0,0
400995782,Marquette Golden Eagles,TEAM,TOTAL,TOTAL,False,,27,64,20,48,7,16,13,21,17,32,49,14,8,3,27,15,74
400995781,Seton Hall Pirates,S. Samuels,4068128,,True,24.0,0,2,0,2,0,0,0,0,2,1,3,0,2,0,0,2,0
400995781,Seton Hall Pirates,T. Brown,3941336,,True,13.0,1,4,1,4,0,0,0,0,2,3,5,1,0,1,1,2,2
400995781,Seton Hall Pirates,D. Fountain,3058890,,True,30.0,9,19,6,15,3,4,2,3,2,4,6,0,1,0,2,1,23
400995781,Seton Hall Pirates,I. Butina,4281377,,True,22.0,1,3,1,3,0,0,0,0,0,3,3,5,1,0,5,1,2
400995781,Seton Hall Pirates,J. Jackson,3064877,,True,27.0,3,10,3,5,0,5,0,0,2,2,4,1,0,0,1,0,6
400995781,Seton Hall Pirates,S. Philoxy,4281380,,False,3.0,0,0,0,0,0,0,0,0,0,0,0,0,0,0,0,0,0
400995781,Seton Hall Pirates,K. Evans,4281378,,False,13.0,3,3,3,3,0,0,0,0,1,0,1,0,0,0,1,1,6
400995781,Seton Hall Pirates,J. Jones-Pack,4068129,,False,11.0,0,1,0,1,0,0,0,0,1,2,3,0,0,1,2,2,0
400995781,Seton Hall Pirates,D. Winters,4068126,,False,16.0,5,10,0,2,5,8,1,2,1,0,1,0,3,1,0,2,16
400995781,Seton Hall Pirates,N. Jimenez,4281379,,False,20.0,1,7,0,3,1,4,4,4,1,1,2,5,1,0,3,1,7
400995781,Seton Hall Pirates,K. Hilaire,4068123,,False,19.0,2,5,2,5,0,0,0,0,0,0,0,2,1,0,3,0,4
400995781,Seton Hall Pirates,K. Healy,3943704,,False,2.0,0,0,0,0,0,0,0,0,0,0,0,0,0,0,1,0,0
400995781,Seton Hall Pirates,TEAM,TOTAL,TOTAL,False,,25,64,16,43,9,21,7,9,13,22,35,14,9,3,20,12,66
400995781,Seton Hall Pirates,S. Samuels,4068128,,True,24.0,0,2,0,2,0,0,0,0,2,1,3,0,2,0,0,2,0
400995781,Seton Hall Pirates,T. Brown,3941336,,True,13.0,1,4,1,4,0,0,0,0,2,3,5,1,0,1,1,2,2
400995781,Seton Hall Pirates,D. Fountain,3058890,,True,30.0,9,19,6,15,3,4,2,3,2,4,6,0,1,0,2,1,23
400995781,Seton Hall Pirates,I. Butina,4281377,,True,22.0,1,3,1,3,0,0,0,0,0,3,3,5,1,0,5,1,2
400995781,Seton Hall Pirates,J. Jackson,3064877,,True,27.0,3,10,3,5,0,5,0,0,2,2,4,1,0,0,1,0,6
400995781,Seton Hall Pirates,S. Philoxy,4281380,,False,3.0,0,0,0,0,0,0,0,0,0,0,0,0,0,0,0,0,0
400995781,Seton Hall Pirates,K. Evans,4281378,,False,13.0,3,3,3,3,0,0,0,0,1,0,1,0,0,0,1,1,6
400995781,Seton Hall Pirates,J. Jones-Pack,4068129,,False,11.0,0,1,0,1,0,0,0,0,1,2,3,0,0,1,2,2,0
400995781,Seton Hall Pirates,D. Winters,4068126,,False,16.0,5,10,0,2,5,8,1,2,1,0,1,0,3,1,0,2,16
400995781,Seton Hall Pirates,N. Jimenez,4281379,,False,20.0,1,7,0,3,1,4,4,4,1,1,2,5,1,0,3,1,7
400995781,Seton Hall Pirates,K. Hilaire,4068123,,False,19.0,2,5,2,5,0,0,0,0,0,0,0,2,1,0,3,0,4
400995781,Seton Hall Pirates,K. Healy,3943704,,False,2.0,0,0,0,0,0,0,0,0,0,0,0,0,0,0,1,0,0
400995781,Seton Hall Pirates,TEAM,TOTAL,TOTAL,False,,25,64,16,43,9,21,7,9,13,22,35,14,9,3,20,12,66
400995781,DePaul Blue Demons,M. Grays,3142287,,True,28.0,5,11,2,5,3,6,3,3,1,4,5,0,1,0,1,1,16
400995781,DePaul Blue Demons,K. Campbell,4068071,,True,40.0,3,6,0,1,3,5,2,2,3,9,12,11,2,0,2,4,11
400995781,DePaul Blue Demons,T. Allen,3933760,,True,18.0,5,8,3,3,2,5,1,2,3,3,6,2,1,1,3,4,13
400995781,DePaul Blue Demons,A. Millender,3142289,,True,34.0,7,13,0,2,7,11,0,0,1,2,3,2,0,1,1,1,21
400995781,DePaul Blue Demons,A. Coleman,3142123,,True,6.0,0,2,0,1,0,1,1,2,0,0,0,2,0,0,1,4,1
400995781,DePaul Blue Demons,R. McLimore,4281358,,False,8.0,1,3,1,2,0,1,0,0,0,2,2,2,0,1,2,1,2
400995781,DePaul Blue Demons,C. Stonewall,4068072,,False,21.0,5,9,4,7,1,2,0,0,1,3,4,2,0,0,0,2,11
400995781,DePaul Blue Demons,D. Bekelja,4281356,,False,9.0,0,1,0,0,0,1,0,0,0,1,1,0,0,0,3,0,0
400995781,DePaul Blue Demons,D. Cage,4068073,,False,14.0,4,7,2,2,2,5,1,2,0,0,0,2,2,0,1,1,11
400995781,DePaul Blue Demons,L. Prochaska,3142290,,False,22.0,1,6,0,1,1,5,0,0,3,1,4,6,2,0,3,0,3
400995781,DePaul Blue Demons,TEAM,TOTAL,TOTAL,False,,31,66,12,24,19,42,8,11,12,28,40,29,8,3,17,18,89
400995781,DePaul Blue Demons,M. Grays,3142287,,True,28.0,5,11,2,5,3,6,3,3,1,4,5,0,1,0,1,1,16
400995781,DePaul Blue Demons,K. Campbell,4068071,,True,40.0,3,6,0,1,3,5,2,2,3,9,12,11,2,0,2,4,11
400995781,DePaul Blue Demons,T. Allen,3933760,,True,18.0,5,8,3,3,2,5,1,2,3,3,6,2,1,1,3,4,13
400995781,DePaul Blue Demons,A. Millender,3142289,,True,34.0,7,13,0,2,7,11,0,0,1,2,3,2,0,1,1,1,21
400995781,DePaul Blue Demons,A. Coleman,3142123,,True,6.0,0,2,0,1,0,1,1,2,0,0,0,2,0,0,1,4,1
400995781,DePaul Blue Demons,R. McLimore,4281358,,False,8.0,1,3,1,2,0,1,0,0,0,2,2,2,0,1,2,1,2
400995781,DePaul Blue Demons,C. Stonewall,4068072,,False,21.0,5,9,4,7,1,2,0,0,1,3,4,2,0,0,0,2,11
400995781,DePaul Blue Demons,D. Bekelja,4281356,,False,9.0,0,1,0,0,0,1,0,0,0,1,1,0,0,0,3,0,0
400995781,DePaul Blue Demons,D. Cage,4068073,,False,14.0,4,7,2,2,2,5,1,2,0,0,0,2,2,0,1,1,11
400995781,DePaul Blue Demons,L. Prochaska,3142290,,False,22.0,1,6,0,1,1,5,0,0,3,1,4,6,2,0,3,0,3
400995781,DePaul Blue Demons,TEAM,TOTAL,TOTAL,False,,31,66,12,24,19,42,8,11,12,28,40,29,8,3,17,18,89
400995780,Villanova Wildcats,M. Quinn,3056785,,True,30.0,4,7,1,2,3,5,0,0,0,3,3,4,1,2,0,2,11
400995780,Villanova Wildcats,K. Jekot,4068171,,True,26.0,3,11,3,7,0,4,0,0,1,4,5,1,0,1,1,3,6
400995780,Villanova Wildcats,A. Hahn,3906779,,True,28.0,4,7,2,4,2,3,0,0,1,1,2,3,1,0,0,4,10
400995780,Villanova Wildcats,A. Louin,3142314,,True,35.0,1,4,1,3,0,1,2,2,0,6,6,3,0,0,5,4,4
400995780,Villanova Wildcats,J. Tucker,3087536,,True,34.0,5,9,4,4,1,5,0,0,1,3,4,2,0,0,1,0,11
400995780,Villanova Wildcats,M. Gedaka,4068172,,False,15.0,3,7,3,7,0,0,1,5,0,4,4,1,0,0,1,2,7
400995780,Villanova Wildcats,B. Herlihy,4068169,,False,3.0,0,1,0,0,0,1,0,0,0,0,0,0,0,0,1,1,0
400995780,Villanova Wildcats,B. Herlihy,3906778,,False,7.0,2,4,1,2,1,2,0,0,0,0,0,0,0,1,1,3,5
400995780,Villanova Wildcats,G. Stant,3906780,,False,10.0,0,1,0,0,0,1,0,0,1,1,2,0,0,0,0,0,0
400995780,Villanova Wildcats,R. James,4068168,,False,1.0,0,0,0,0,0,0,0,0,0,0,0,0,0,0,0,0,0
400995780,Villanova Wildcats,C. Onken,4068167,,False,11.0,0,1,0,0,0,1,0,0,0,1,1,3,0,0,0,0,0
400995780,Villanova Wildcats,TEAM,TOTAL,TOTAL,False,,22,52,15,29,7,23,3,7,5,23,28,17,2,4,10,19,54
400995780,Villanova Wildcats,M. Quinn,3056785,,True,30.0,4,7,1,2,3,5,0,0,0,3,3,4,1,2,0,2,11
400995780,Villanova Wildcats,K. Jekot,4068171,,True,26.0,3,11,3,7,0,4,0,0,1,4,5,1,0,1,1,3,6
400995780,Villanova Wildcats,A. Hahn,3906779,,True,28.0,4,7,2,4,2,3,0,0,1,1,2,3,1,0,0,4,10
400995780,Villanova Wildcats,A. Louin,3142314,,True,35.0,1,4,1,3,0,1,2,2,0,6,6,3,0,0,5,4,4
400995780,Villanova Wildcats,J. Tucker,3087536,,True,34.0,5,9,4,4,1,5,0,0,1,3,4,2,0,0,1,0,11
400995780,Villanova Wildcats,M. Gedaka,4068172,,False,15.0,3,7,3,7,0,0,1,5,0,4,4,1,0,0,1,2,7
400995780,Villanova Wildcats,B. Herlihy,4068169,,False,3.0,0,1,0,0,0,1,0,0,0,0,0,0,0,0,1,1,0
400995780,Villanova Wildcats,B. Herlihy,3906778,,False,7.0,2,4,1,2,1,2,0,0,0,0,0,0,0,1,1,3,5
400995780,Villanova Wildcats,G. Stant,3906780,,False,10.0,0,1,0,0,0,1,0,0,1,1,2,0,0,0,0,0,0
400995780,Villanova Wildcats,R. James,4068168,,False,1.0,0,0,0,0,0,0,0,0,0,0,0,0,0,0,0,0,0
400995780,Villanova Wildcats,C. Onken,4068167,,False,11.0,0,1,0,0,0,1,0,0,0,1,1,3,0,0,0,0,0
400995780,Villanova Wildcats,TEAM,TOTAL,TOTAL,False,,22,52,15,29,7,23,3,7,5,23,28,17,2,4,10,19,54
400995780,Creighton Bluejays,A. Faber,3938938,,True,36.0,6,12,4,9,2,3,5,6,0,5,5,2,1,0,3,3,19
400995780,Creighton Bluejays,A. Greene,3938937,,True,9.0,0,0,0,0,0,0,0,0,1,2,3,0,0,0,0,1,0
400995780,Creighton Bluejays,J. Agnew,3938935,,True,31.0,7,11,3,5,4,6,1,2,0,6,6,0,2,0,0,2,19
400995780,Creighton Bluejays,S. Lamberty,3142285,,True,33.0,3,8,3,5,0,3,1,1,2,4,6,7,1,0,2,1,7
400995780,Creighton Bluejays,M. Mellman,3142283,,True,14.0,1,1,1,1,0,0,2,2,1,2,3,0,0,0,0,0,4
400995780,Creighton Bluejays,K. Brown,3142286,,False,5.0,0,1,0,1,0,0,0,0,0,1,1,0,0,0,0,0,0
400995780,Creighton Bluejays,B. Norby,3142284,,False,10.0,2,4,2,3,0,1,0,1,1,2,3,1,0,0,1,3,4
400995780,Creighton Bluejays,T. Carda,4281362,,False,26.0,4,6,4,5,0,1,0,1,0,4,4,1,0,0,1,2,8
400995780,Creighton Bluejays,T. Rembao,4281361,,False,9.0,0,2,0,2,0,0,0,0,0,1,1,1,0,0,0,0,0
400995780,Creighton Bluejays,O. Elger,3938936,,False,22.0,4,9,4,8,0,1,0,0,2,0,2,1,0,0,1,0,8
400995780,Creighton Bluejays,B. Kissinger,3142124,,False,5.0,0,1,0,0,0,1,0,0,1,0,1,1,0,0,0,0,0
400995780,Creighton Bluejays,TEAM,TOTAL,TOTAL,False,,27,55,21,39,6,16,9,13,8,27,35,14,4,0,9,12,69
400995780,Creighton Bluejays,A. Faber,3938938,,True,36.0,6,12,4,9,2,3,5,6,0,5,5,2,1,0,3,3,19
400995780,Creighton Bluejays,A. Greene,3938937,,True,9.0,0,0,0,0,0,0,0,0,1,2,3,0,0,0,0,1,0
400995780,Creighton Bluejays,J. Agnew,3938935,,True,31.0,7,11,3,5,4,6,1,2,0,6,6,0,2,0,0,2,19
400995780,Creighton Bluejays,S. Lamberty,3142285,,True,33.0,3,8,3,5,0,3,1,1,2,4,6,7,1,0,2,1,7
400995780,Creighton Bluejays,M. Mellman,3142283,,True,14.0,1,1,1,1,0,0,2,2,1,2,3,0,0,0,0,0,4
400995780,Creighton Bluejays,K. Brown,3142286,,False,5.0,0,1,0,1,0,0,0,0,0,1,1,0,0,0,0,0,0
400995780,Creighton Bluejays,B. Norby,3142284,,False,10.0,2,4,2,3,0,1,0,1,1,2,3,1,0,0,1,3,4
400995780,Creighton Bluejays,T. Carda,4281362,,False,26.0,4,6,4,5,0,1,0,1,0,4,4,1,0,0,1,2,8
400995780,Creighton Bluejays,T. Rembao,4281361,,False,9.0,0,2,0,2,0,0,0,0,0,1,1,1,0,0,0,0,0
400995780,Creighton Bluejays,O. Elger,3938936,,False,22.0,4,9,4,8,0,1,0,0,2,0,2,1,0,0,1,0,8
400995780,Creighton Bluejays,B. Kissinger,3142124,,False,5.0,0,1,0,0,0,1,0,0,1,0,1,1,0,0,0,0,0
400995780,Creighton Bluejays,TEAM,TOTAL,TOTAL,False,,27,55,21,39,6,16,9,13,8,27,35,14,4,0,9,12,69
400995779,Providence Friars,B. Frias,3142302,,True,12.0,0,2,0,2,0,0,0,0,1,1,2,0,0,0,0,1,0
400995779,Providence Friars,J. Nogic,3906769,,True,19.0,2,7,1,2,1,5,0,0,0,2,2,0,0,0,4,3,5
400995779,Providence Friars,M. Jolin,3906767,,True,30.0,5,12,2,5,3,7,1,1,1,5,6,1,1,0,4,1,14
400995779,Providence Friars,C. Che,3906766,,True,25.0,3,6,1,2,2,4,0,0,0,6,6,1,0,0,4,1,8
400995779,Providence Friars,A. Botteghi,3142301,,True,29.0,0,8,0,8,0,0,7,8,3,3,6,2,0,1,2,1,7
400995779,Providence Friars,N. Franklin,4281348,,False,16.0,0,3,0,3,0,0,1,2,0,3,3,0,0,0,6,0,1
400995779,Providence Friars,O. Orlando,4281347,,False,13.0,1,2,1,2,0,0,1,2,0,2,2,1,2,0,2,1,3
400995779,Providence Friars,K. Spiwak,4281346,,False,23.0,0,3,0,2,0,1,0,0,2,1,3,0,1,1,0,4,0
400995779,Providence Friars,C. Williams,4281345,,False,21.0,1,3,1,3,0,0,1,1,1,2,3,3,0,0,3,5,3
400995779,Providence Friars,N. Jackson,4068111,,False,12.0,1,1,1,1,0,0,0,0,0,2,2,1,1,0,5,2,2
400995779,Providence Friars,TEAM,TOTAL,TOTAL,False,,13,47,7,30,6,17,11,14,8,28,36,9,5,2,30,19,43
400995779,Providence Friars,B. Frias,3142302,,True,12.0,0,2,0,2,0,0,0,0,1,1,2,0,0,0,0,1,0
400995779,Providence Friars,J. Nogic,3906769,,True,19.0,2,7,1,2,1,5,0,0,0,2,2,0,0,0,4,3,5
400995779,Providence Friars,M. Jolin,3906767,,True,30.0,5,12,2,5,3,7,1,1,1,5,6,1,1,0,4,1,14
400995779,Providence Friars,C. Che,3906766,,True,25.0,3,6,1,2,2,4,0,0,0,6,6,1,0,0,4,1,8
400995779,Providence Friars,A. Botteghi,3142301,,True,29.0,0,8,0,8,0,0,7,8,3,3,6,2,0,1,2,1,7
400995779,Providence Friars,N. Franklin,4281348,,False,16.0,0,3,0,3,0,0,1,2,0,3,3,0,0,0,6,0,1
400995779,Providence Friars,O. Orlando,4281347,,False,13.0,1,2,1,2,0,0,1,2,0,2,2,1,2,0,2,1,3
400995779,Providence Friars,K. Spiwak,4281346,,False,23.0,0,3,0,2,0,1,0,0,2,1,3,0,1,1,0,4,0
400995779,Providence Friars,C. Williams,4281345,,False,21.0,1,3,1,3,0,0,1,1,1,2,3,3,0,0,3,5,3
400995779,Providence Friars,N. Jackson,4068111,,False,12.0,1,1,1,1,0,0,0,0,0,2,2,1,1,0,5,2,2
400995779,Providence Friars,TEAM,TOTAL,TOTAL,False,,13,47,7,30,6,17,11,14,8,28,36,9,5,2,30,19,43
400995779,Georgetown Hoyas,C. Petke,4068078,,True,33.0,3,9,3,7,0,2,2,2,2,8,10,1,3,0,2,2,8
400995779,Georgetown Hoyas,Y. Belk,3142295,,True,16.0,1,3,1,3,0,0,0,0,0,3,3,0,0,1,0,4,2
400995779,Georgetown Hoyas,D. White,3948815,,True,35.0,11,18,11,15,0,3,3,5,2,6,8,3,5,1,3,2,25
400995779,Georgetown Hoyas,D. Burton,3142292,,True,33.0,3,8,2,3,1,5,0,0,1,4,5,2,3,0,1,1,7
400995779,Georgetown Hoyas,M. Venson,3142105,,True,38.0,6,12,4,8,2,4,5,6,0,3,3,1,3,1,3,2,19
400995779,Georgetown Hoyas,S. Cureton,4281355,,False,2.0,0,0,0,0,0,0,0,0,0,0,0,0,0,0,0,0,0
400995779,Georgetown Hoyas,T. Thompson,4281352,,False,13.0,2,4,1,2,1,2,1,2,0,1,1,0,0,0,0,2,6
400995779,Georgetown Hoyas,M. Smith,4068079,,False,19.0,2,5,2,5,0,0,4,4,2,2,4,0,2,0,1,3,8
400995779,Georgetown Hoyas,B. Mayfield,4281354,,False,3.0,0,1,0,1,0,0,0,0,0,0,0,0,0,0,0,1,0
400995779,Georgetown Hoyas,L. Kimball,4281353,,False,4.0,0,2,0,0,0,2,0,0,0,0,0,0,0,1,1,0,0
400995779,Georgetown Hoyas,M. Osagie-Erese,4072597,,False,4.0,0,1,0,1,0,0,0,0,1,1,2,1,0,0,0,2,0
400995779,Georgetown Hoyas,TEAM,TOTAL,TOTAL,False,,28,63,24,45,4,18,15,19,8,28,36,8,16,4,11,19,75
400995779,Georgetown Hoyas,C. Petke,4068078,,True,33.0,3,9,3,7,0,2,2,2,2,8,10,1,3,0,2,2,8
400995779,Georgetown Hoyas,Y. Belk,3142295,,True,16.0,1,3,1,3,0,0,0,0,0,3,3,0,0,1,0,4,2
400995779,Georgetown Hoyas,D. White,3948815,,True,35.0,11,18,11,15,0,3,3,5,2,6,8,3,5,1,3,2,25
400995779,Georgetown Hoyas,D. Burton,3142292,,True,33.0,3,8,2,3,1,5,0,0,1,4,5,2,3,0,1,1,7
400995779,Georgetown Hoyas,M. Venson,3142105,,True,38.0,6,12,4,8,2,4,5,6,0,3,3,1,3,1,3,2,19
400995779,Georgetown Hoyas,S. Cureton,4281355,,False,2.0,0,0,0,0,0,0,0,0,0,0,0,0,0,0,0,0,0
400995779,Georgetown Hoyas,T. Thompson,4281352,,False,13.0,2,4,1,2,1,2,1,2,0,1,1,0,0,0,0,2,6
400995779,Georgetown Hoyas,M. Smith,4068079,,False,19.0,2,5,2,5,0,0,4,4,2,2,4,0,2,0,1,3,8
400995779,Georgetown Hoyas,B. Mayfield,4281354,,False,3.0,0,1,0,1,0,0,0,0,0,0,0,0,0,0,0,1,0
400995779,Georgetown Hoyas,L. Kimball,4281353,,False,4.0,0,2,0,0,0,2,0,0,0,0,0,0,0,1,1,0,0
400995779,Georgetown Hoyas,M. Osagie-Erese,4072597,,False,4.0,0,1,0,1,0,0,0,0,1,1,2,1,0,0,0,2,0
400995779,Georgetown Hoyas,TEAM,TOTAL,TOTAL,False,,28,63,24,45,4,18,15,19,8,28,36,8,16,4,11,19,75
400995778,Xavier Musketeers,A. Gray,4281368,,True,18.0,1,3,1,2,0,1,3,4,0,6,6,1,1,1,1,1,5
400995778,Xavier Musketeers,A. Aijanen,3142319,,True,25.0,4,7,3,4,1,3,1,2,3,3,6,1,0,0,1,1,10
400995778,Xavier Musketeers,N. Owens,4068187,,True,22.0,3,6,0,1,3,5,1,4,1,1,2,3,4,0,5,0,10
400995778,Xavier Musketeers,J. Byrd,3142318,,True,20.0,3,5,3,5,0,0,1,2,1,3,4,0,1,0,3,3,7
400995778,Xavier Musketeers,K. Fincher,3142317,,True,20.0,2,7,0,0,2,7,3,4,0,3,3,3,1,0,1,0,9
400995778,Xavier Musketeers,D. Ross,4281364,,False,22.0,3,7,1,2,2,5,0,0,1,5,6,2,1,1,3,3,8
400995778,Xavier Musketeers,M. Christopher,4068186,,False,3.0,0,0,0,0,0,0,0,0,1,0,1,0,0,0,0,2,0
400995778,Xavier Musketeers,I. Partlow,3142320,,False,9.0,2,5,2,4,0,1,1,1,0,0,0,0,1,0,1,1,5
400995778,Xavier Musketeers,J. Dawson,4281369,,False,3.0,0,1,0,1,0,0,0,0,0,0,0,1,0,0,0,0,0
400995778,Xavier Musketeers,A. Reiff,4281367,,False,10.0,1,3,0,0,1,3,0,0,0,0,0,2,0,0,1,2,3
400995778,Xavier Musketeers,P. Stewart,4281366,,False,17.0,1,4,0,1,1,3,0,0,1,4,5,2,0,0,0,1,3
400995778,Xavier Musketeers,A. Dunham,4281365,,False,18.0,0,2,0,1,0,1,1,2,0,1,1,6,0,0,0,3,1
400995778,Xavier Musketeers,A. Gomez,4068185,,False,13.0,3,6,0,0,3,6,0,0,1,1,2,0,0,0,1,0,9
400995778,Xavier Musketeers,TEAM,TOTAL,TOTAL,False,,23,56,10,21,13,35,11,19,11,29,40,21,9,2,17,17,70
400995778,Florida A&M Rattlers,S. Morrison,4069371,,True,29.0,2,3,2,3,0,0,2,4,5,7,12,1,1,0,3,2,6
400995778,Florida A&M Rattlers,S. Burney-Robinson,3156653,,True,15.0,1,4,1,4,0,0,0,0,1,4,5,0,1,0,0,2,2
400995778,Florida A&M Rattlers,D. Davis,4282258,,True,13.0,3,3,3,3,0,0,0,0,1,0,1,0,1,0,1,0,6
400995778,Florida A&M Rattlers,D. King,3156656,,True,18.0,1,7,1,4,0,3,0,0,0,0,0,1,0,0,0,1,2
400995778,Florida A&M Rattlers,F. Ouattara,3064750,,True,28.0,2,17,2,12,0,5,1,2,0,4,4,3,1,0,4,2,5
400995778,Florida A&M Rattlers,D. Royal,4069372,,False,15.0,2,4,2,4,0,0,0,0,3,0,3,2,0,2,1,3,4
400995778,Florida A&M Rattlers,G. Holston,3058891,,False,3.0,0,2,0,1,0,1,0,0,0,2,2,0,0,1,1,0,0
400995778,Florida A&M Rattlers,M. Thomas,4282260,,False,9.0,1,2,1,2,0,0,0,0,0,0,0,1,0,0,0,0,2
400995778,Florida A&M Rattlers,N. Davis,4069369,,False,10.0,2,5,2,5,0,0,0,0,1,1,2,0,0,0,1,2,4
400995778,Florida A&M Rattlers,T. Darks,3910713,,False,21.0,1,3,1,3,0,0,2,2,1,3,4,3,1,1,1,0,4
400995778,Florida A&M Rattlers,A. Arkorful,4282257,,False,20.0,2,5,2,5,0,0,2,3,0,2,2,1,0,0,2,1,6
400995778,Florida A&M Rattlers,E. Yurdakul,3143263,,False,19.0,3,5,0,1,3,4,2,2,1,1,2,1,0,0,1,3,11
400995778,Florida A&M Rattlers,TEAM,TOTAL,TOTAL,False,,20,60,17,47,3,13,9,13,14,24,38,13,5,4,16,16,52
400995777,Indiana State Sycamores,T. Battle,4282255,,True,33.0,0,7,0,3,0,4,0,2,1,2,3,1,2,1,1,2,0
400995777,Indiana State Sycamores,W. Bibbins,4068627,,True,26.0,3,9,3,9,0,0,2,2,3,6,9,0,0,1,3,4,8
400995777,Indiana State Sycamores,R. Wentland,3919482,,True,24.0,0,4,0,4,0,0,0,0,1,3,4,3,2,1,2,2,0
400995777,Indiana State Sycamores,A. O'Neal,4068623,,True,34.0,5,9,1,3,4,6,1,1,1,1,2,2,1,0,8,4,15
400995777,Indiana State Sycamores,T. Webb,3919481,,True,35.0,3,9,2,5,1,4,1,5,3,2,5,4,3,0,4,3,8
400995777,Indiana State Sycamores,A. Thomas,4282256,,False,10.0,0,2,0,1,0,1,2,2,1,1,2,0,1,0,2,1,2
400995777,Indiana State Sycamores,A. Delgado,4282252,,False,28.0,5,11,0,4,5,7,0,0,0,3,3,1,1,0,4,3,15
400995777,Indiana State Sycamores,M. Kitantou,4282250,,False,9.0,1,3,0,0,1,3,0,0,0,1,1,0,1,0,0,2,3
400995777,Indiana State Sycamores,TEAM,TOTAL,TOTAL,False,,17,54,6,29,11,25,6,12,10,19,29,11,11,3,24,21,51
400995777,Butler Bulldogs,S. Brey,4068067,,True,25.0,1,2,1,2,0,0,0,0,2,4,6,1,0,1,2,3,2
400995777,Butler Bulldogs,T. Schickel,3914012,,True,34.0,9,18,9,18,0,0,5,6,3,2,5,0,2,4,6,4,23
400995777,Butler Bulldogs,M. Weaver,3914014,,True,33.0,0,3,0,2,0,1,0,0,1,1,2,4,5,0,3,0,0
400995777,Butler Bulldogs,W. Jennings,3142145,,True,38.0,3,9,1,3,2,6,8,10,0,5,5,1,2,0,1,2,16
400995777,Butler Bulldogs,I. Lathan,3079485,,True,24.0,1,3,1,3,0,0,1,2,2,6,8,0,1,0,2,2,3
400995777,Butler Bulldogs,K. Hodges,4068065,,False,7.0,0,1,0,1,0,0,0,0,0,3,3,0,0,0,0,1,0
400995777,Butler Bulldogs,S. Humphrey,4068066,,False,5.0,0,0,0,0,0,0,0,0,0,0,0,0,0,0,0,0,0
400995777,Butler Bulldogs,K. Spolyar,4068068,,False,29.0,5,11,4,8,1,3,2,5,0,5,5,2,0,0,4,3,13
400995777,Butler Bulldogs,S. Buck,3142279,,False,5.0,1,2,0,0,1,2,0,0,0,0,0,1,1,0,1,1,3
400995777,Butler Bulldogs,TEAM,TOTAL,TOTAL,False,,20,49,16,37,4,12,16,23,8,26,34,9,11,5,19,16,60
400995776,St. John's Red Storm,M. Singleton,4068158,,True,23.0,4,8,4,8,0,0,7,8,3,2,5,0,2,1,1,3,15
400995776,St. John's Red Storm,I. Littleton,3142306,,True,20.0,2,4,2,4,0,0,1,2,0,1,1,0,0,3,2,1,5
400995776,St. John's Red Storm,A. Wellere,3906771,,True,33.0,5,12,3,8,2,4,0,1,2,1,3,3,1,0,9,4,12
400995776,St. John's Red Storm,T. England,4068155,,True,39.0,2,7,2,6,0,1,0,0,0,4,4,9,2,0,3,4,4
400995776,St. John's Red Storm,A. Kebbe,4068154,,True,25.0,4,6,2,2,2,4,0,0,0,4,4,2,1,0,3,1,10
400995776,St. John's Red Storm,K. Charles,4281374,,False,11.0,1,1,1,1,0,0,2,4,1,4,5,1,0,0,1,1,4
400995776,St. John's Red Storm,Q. Hoppie,4281375,,False,30.0,2,8,2,4,0,4,4,4,0,3,3,3,0,0,3,1,8
400995776,St. John's Red Storm,A. Adams,4068157,,False,19.0,4,5,1,1,3,4,3,4,0,1,1,0,0,1,1,2,14
400995776,St. John's Red Storm,TEAM,TOTAL,TOTAL,False,,24,51,17,34,7,17,17,23,7,23,30,18,6,5,23,17,72
400995776,Buffalo Bulls,C. Oursler,3067614,,True,32.0,6,16,6,16,0,0,0,0,5,4,9,3,0,2,3,5,12
400995776,Buffalo Bulls,S. Hemphill,4068803,,True,24.0,3,8,3,8,0,0,0,0,5,5,10,0,1,1,4,1,6
400995776,Buffalo Bulls,S. Reid,3164299,,True,37.0,6,10,6,9,0,1,4,4,0,4,4,5,1,0,2,2,16
400995776,Buffalo Bulls,K. Ups,3143209,,True,16.0,2,6,2,5,0,1,0,0,0,1,1,1,1,0,2,4,4
400995776,Buffalo Bulls,C. Dillard,3142386,,True,33.0,2,8,1,5,1,3,2,4,1,2,3,3,2,0,3,3,7
400995776,Buffalo Bulls,B. Morrison,3910795,,False,20.0,4,7,4,7,0,0,0,0,1,3,4,1,3,1,2,2,8
400995776,Buffalo Bulls,M. Suchan,3143210,,False,3.0,0,1,0,1,0,0,0,0,0,0,0,0,0,0,0,1,0
400995776,Buffalo Bulls,A. Jones,4282088,,False,28.0,6,10,2,4,4,6,1,2,0,0,0,2,4,0,1,3,17
400995776,Buffalo Bulls,A. Sodade,3910794,,False,7.0,1,2,1,2,0,0,1,1,0,0,0,0,0,0,2,0,3
400995776,Buffalo Bulls,TEAM,TOTAL,TOTAL,False,,30,68,25,57,5,11,8,11,15,23,38,15,12,4,19,21,73
400995775,IU Indianapolis Jaguars,T. Sims,3142784,,True,20.0,5,12,5,11,0,1,0,0,0,5,5,1,1,0,6,1,10
400995775,IU Indianapolis Jaguars,J. Gunn,3142180,,True,36.0,2,12,2,11,0,1,0,0,3,2,5,2,0,0,1,1,4
400995775,IU Indianapolis Jaguars,M. Williams,4281963,,True,21.0,9,9,9,9,0,0,3,5,4,2,6,0,2,0,1,4,21
400995775,IU Indianapolis Jaguars,S. Hall,3924758,,True,26.0,3,8,1,2,2,6,3,4,0,1,1,1,1,0,3,0,11
400995775,IU Indianapolis Jaguars,D. Lawrence,3142176,,True,23.0,4,12,4,9,0,3,0,0,1,2,3,1,1,0,6,2,8
400995775,IU Indianapolis Jaguars,A. Brown,3924757,,False,2.0,0,0,0,0,0,0,2,2,0,2,2,0,0,0,0,0,2
400995775,IU Indianapolis Jaguars,M. Allen,4281962,,False,17.0,3,5,3,5,0,0,2,2,4,2,6,0,1,1,1,1,8
400995775,IU Indianapolis Jaguars,B. Welch,4281961,,False,11.0,0,4,0,3,0,1,0,0,1,1,2,2,0,0,0,1,0
400995775,IU Indianapolis Jaguars,A. Beier,4281960,,False,18.0,0,2,0,1,0,1,0,0,0,4,4,2,1,0,0,0,0
400995775,IU Indianapolis Jaguars,S. Roule,4281959,,False,6.0,0,1,0,0,0,1,0,0,0,0,0,0,0,0,0,2,0
400995775,IU Indianapolis Jaguars,H. Hoopingarner,4068619,,False,20.0,2,6,1,3,1,3,2,2,3,1,4,2,0,0,1,1,7
400995775,IU Indianapolis Jaguars,TEAM,TOTAL,TOTAL,False,,28,71,25,54,3,17,12,15,18,26,44,11,7,1,19,13,71
400995775,DePaul Blue Demons,C. Stonewall,4068072,,True,19.0,5,7,4,5,1,2,1,2,2,0,2,5,3,1,2,3,12
400995775,DePaul Blue Demons,M. Grays,3142287,,True,23.0,3,11,3,6,0,5,2,2,1,3,4,2,0,1,2,3,8
400995775,DePaul Blue Demons,K. Campbell,4068071,,True,31.0,1,5,0,0,1,5,2,2,2,14,16,7,2,0,3,2,5
400995775,DePaul Blue Demons,A. Millender,3142289,,True,26.0,4,9,2,5,2,4,0,0,0,0,0,0,0,0,1,0,10
400995775,DePaul Blue Demons,A. Coleman,3142123,,True,30.0,8,17,6,11,2,6,2,3,2,3,5,2,4,0,3,0,20
400995775,DePaul Blue Demons,R. McLimore,4281358,,False,11.0,2,3,1,2,1,1,0,0,1,1,2,1,1,0,1,3,5
400995775,DePaul Blue Demons,V. Sherrod,4281359,,False,2.0,0,1,0,1,0,0,0,0,0,0,0,0,0,0,0,0,0
400995775,DePaul Blue Demons,D. Bekelja,4281356,,False,10.0,1,1,0,0,1,1,1,2,0,0,0,0,0,0,0,1,4
400995775,DePaul Blue Demons,D. Cage,4068073,,False,4.0,0,1,0,1,0,0,0,0,0,1,1,0,0,0,1,0,0
400995775,DePaul Blue Demons,T. Allen,3933760,,False,25.0,6,12,6,10,0,2,0,0,6,4,10,0,0,1,2,2,12
400995775,DePaul Blue Demons,L. Prochaska,3142290,,False,19.0,3,5,2,4,1,1,2,2,1,1,2,3,3,0,2,2,9
400995775,DePaul Blue Demons,TEAM,TOTAL,TOTAL,False,,33,72,24,45,9,27,10,13,15,28,43,20,13,3,17,16,85
400995774,Notre Dame Fighting Irish,J. Shepard,3906949,,True,38.0,6,9,6,8,0,1,1,4,3,9,12,4,1,1,3,4,13
400995774,Notre Dame Fighting Irish,K. Westbeld,3142087,,True,27.0,5,6,5,6,0,0,3,4,4,6,10,3,1,0,2,0,13
400995774,Notre Dame Fighting Irish,J. Young,4065870,,True,40.0,5,13,5,11,0,2,0,1,2,8,10,3,1,1,3,3,10
400995774,Notre Dame Fighting Irish,A. Ogunbowale,3904577,,True,38.0,7,18,6,13,1,5,7,9,1,5,6,3,1,0,0,0,22
400995774,Notre Dame Fighting Irish,M. Mabrey,3904576,,True,45.0,8,19,5,7,3,12,0,2,2,1,3,6,3,2,2,2,19
400995774,Notre Dame Fighting Irish,D. Patterson,4281207,,False,8.0,1,1,1,1,0,0,0,0,0,1,1,0,0,0,1,0,2
400995774,Notre Dame Fighting Irish,K. Nelson,3058909,,False,5.0,1,2,1,2,0,0,0,0,0,0,0,0,0,0,2,1,2
400995774,Notre Dame Fighting Irish,L. Thompson,3056731,,False,24.0,2,5,2,3,0,2,6,8,0,4,4,4,2,2,4,3,10
400995774,Notre Dame Fighting Irish,TEAM,TOTAL,TOTAL,False,,35,73,31,51,4,22,17,28,14,37,51,23,9,6,17,13,91
400995774,Marquette Golden Eagles,E. Davenport,3906756,,True,39.0,7,11,7,11,0,0,5,8,7,9,16,1,2,1,2,3,19
400995774,Marquette Golden Eagles,A. Wilborn,3906758,,True,30.0,4,6,4,4,0,2,2,3,1,4,5,6,1,0,2,4,10
400995774,Marquette Golden Eagles,A. Blockton,3906755,,True,43.0,9,20,9,16,0,4,2,2,0,10,10,4,2,0,1,2,20
400995774,Marquette Golden Eagles,N. Hiedeman,3906753,,True,39.0,4,19,2,8,2,11,2,2,0,1,1,1,2,0,2,4,12
400995774,Marquette Golden Eagles,D. King,3906752,,True,42.0,6,19,6,16,0,3,0,0,2,2,4,4,0,0,3,1,12
400995774,Marquette Golden Eagles,A. Anderson,4068081,,False,0.0,0,0,0,0,0,0,0,0,0,0,0,0,1,0,0,0,0
400995774,Marquette Golden Eagles,L. Van Kleunen,4068083,,False,8.0,0,2,0,1,0,1,0,0,0,1,1,0,0,0,2,1,0
400995774,Marquette Golden Eagles,S. Lott,4281350,,False,14.0,0,1,0,0,0,1,0,0,0,2,2,1,1,0,0,2,0
400995774,Marquette Golden Eagles,I. Spingola,4068082,,False,10.0,4,6,0,0,4,6,0,0,0,0,0,0,0,0,1,4,12
400995774,Marquette Golden Eagles,TEAM,TOTAL,TOTAL,False,,34,84,28,56,6,28,11,15,15,29,44,17,9,1,13,21,85
400995773,Loyola Chicago Ramblers,A. O'Connor,4282263,,True,36.0,4,11,4,9,0,2,4,4,2,6,8,2,0,0,1,0,12
400995773,Loyola Chicago Ramblers,K. Salmon,3142804,,True,32.0,5,13,3,9,2,4,0,0,2,7,9,2,1,0,2,1,12
400995773,Loyola Chicago Ramblers,K. Strawbridge,4282264,,True,32.0,3,10,2,4,1,6,4,6,2,3,5,1,1,0,5,4,11
400995773,Loyola Chicago Ramblers,L. Segars,4068628,,True,14.0,0,1,0,1,0,0,1,2,0,1,1,3,1,0,3,1,1
400995773,Loyola Chicago Ramblers,J. Cerda,3065188,,True,34.0,2,13,0,6,2,7,0,0,0,1,1,1,0,0,2,3,6
400995773,Loyola Chicago Ramblers,K. Nolan,4282265,,False,13.0,0,2,0,0,0,2,0,0,1,2,3,0,0,0,0,1,0
400995773,Loyola Chicago Ramblers,E. Rice,4282261,,False,26.0,2,8,0,5,2,3,2,4,0,4,4,0,0,1,1,3,8
400995773,Loyola Chicago Ramblers,T. Wallace,4068629,,False,13.0,1,2,1,2,0,0,0,0,1,1,2,2,0,1,0,4,2
400995773,Loyola Chicago Ramblers,TEAM,TOTAL,TOTAL,False,,17,60,10,36,7,24,11,16,10,28,38,11,3,2,14,17,52
400995773,Butler Bulldogs,T. Schickel,3914012,,True,38.0,4,8,4,8,0,0,0,0,3,8,11,4,2,3,3,2,8
400995773,Butler Bulldogs,S. Brey,4068067,,True,22.0,2,5,2,4,0,1,0,0,2,1,3,2,2,0,0,0,4
400995773,Butler Bulldogs,M. Weaver,3914014,,True,33.0,3,6,1,1,2,5,2,2,0,3,3,1,0,1,2,3,10
400995773,Butler Bulldogs,W. Jennings,3142145,,True,36.0,7,14,3,6,4,8,5,5,0,4,4,1,1,0,2,5,23
400995773,Butler Bulldogs,I. Lathan,3079485,,True,14.0,1,5,1,5,0,0,0,0,0,5,5,1,0,0,2,2,2
400995773,Butler Bulldogs,K. Hodges,4068065,,False,11.0,1,3,1,3,0,0,0,0,1,3,4,0,0,2,0,2,2
400995773,Butler Bulldogs,S. Humphrey,4068066,,False,5.0,0,0,0,0,0,0,0,0,0,0,0,0,0,0,0,0,0
400995773,Butler Bulldogs,S. Shelton,4068069,,False,5.0,1,4,1,2,0,2,0,0,0,0,0,0,0,0,0,0,2
400995773,Butler Bulldogs,K. Spolyar,4068068,,False,32.0,3,16,3,11,0,5,7,8,1,8,9,1,2,0,3,1,13
400995773,Butler Bulldogs,S. Buck,3142279,,False,4.0,0,2,0,0,0,2,0,0,0,0,0,0,0,0,0,0,0
400995773,Butler Bulldogs,TEAM,TOTAL,TOTAL,False,,22,63,16,40,6,23,14,15,8,35,43,10,7,6,13,15,64
400995772,Xavier Musketeers,A. Gray,4281368,,True,25.0,4,10,4,9,0,1,1,2,8,3,11,1,3,1,1,0,9
400995772,Xavier Musketeers,A. Äijänen,3142319,,True,25.0,5,8,3,3,2,5,0,0,0,3,3,0,0,0,2,3,12
400995772,Xavier Musketeers,N. Owens,4068187,,True,17.0,4,6,4,5,0,1,0,0,2,1,3,2,0,0,2,0,8
400995772,Xavier Musketeers,J. Byrd,3142318,,True,24.0,2,6,2,5,0,1,0,2,0,3,3,3,0,0,2,2,4
400995772,Xavier Musketeers,K. Fincher,3142317,,True,24.0,2,8,1,3,1,5,2,2,0,1,1,1,0,0,3,0,7
400995772,Xavier Musketeers,D. Ross,4281364,,False,21.0,2,3,0,0,2,3,0,0,1,4,5,1,1,1,2,3,6
400995772,Xavier Musketeers,J. Dawson,4281369,,False,13.0,1,2,1,2,0,0,0,0,0,3,3,0,1,0,2,1,2
400995772,Xavier Musketeers,A. Reiff,4281367,,False,6.0,0,1,0,0,0,1,0,0,0,0,0,0,0,0,0,1,0
400995772,Xavier Musketeers,P. Stewart,4281366,,False,15.0,2,5,0,1,2,4,4,4,0,3,3,1,1,0,1,3,10
400995772,Xavier Musketeers,A. Dunham,4281365,,False,22.0,3,5,2,4,1,1,7,9,2,1,3,6,2,0,1,2,14
400995772,Xavier Musketeers,A. Gomez,4068185,,False,8.0,1,3,0,0,1,3,0,0,0,1,1,1,0,0,1,0,3
400995772,Xavier Musketeers,TEAM,TOTAL,TOTAL,False,,26,57,17,32,9,25,14,19,15,24,39,16,8,2,17,15,75
400995772,Furman Paladins,K. Duncan,3910712,,True,31.0,3,7,3,6,0,1,1,3,4,5,9,2,0,2,4,2,7
400995772,Furman Paladins,C. Carter,3144166,,True,40.0,10,17,6,9,4,8,1,1,0,3,3,0,2,0,3,1,25
400995772,Furman Paladins,D. Jackson,3062102,,True,28.0,2,4,2,4,0,0,0,0,2,1,3,0,2,3,3,5,4
400995772,Furman Paladins,L. Davidson,4068934,,True,31.0,5,12,4,7,1,5,1,2,0,2,2,0,1,0,1,4,12
400995772,Furman Paladins,S. Oramas,3143248,,True,33.0,3,10,1,7,2,3,1,2,1,1,2,8,2,0,4,3,9
400995772,Furman Paladins,C. Taborn,4281029,,False,15.0,2,3,2,3,0,0,1,2,1,3,4,0,1,0,2,4,5
400995772,Furman Paladins,S. Donovan,4281025,,False,1.0,0,0,0,0,0,0,0,0,0,0,0,0,0,0,0,0,0
400995772,Furman Paladins,T. Hunter,4281027,,False,5.0,0,1,0,1,0,0,0,0,0,0,0,0,0,0,0,0,0
400995772,Furman Paladins,H. Sellinger,4281026,,False,0.0,0,0,0,0,0,0,0,0,0,0,0,0,0,0,0,1,0
400995772,Furman Paladins,J. Outten,4281024,,False,16.0,0,0,0,0,0,0,0,0,0,1,1,3,0,0,1,2,0
400995772,Furman Paladins,TEAM,TOTAL,TOTAL,False,,25,54,18,37,7,17,5,10,8,17,25,13,8,5,18,22,62
400995771,Milwaukee Panthers,S. Kostowicz,3142567,,True,26.0,5,7,5,7,0,0,0,0,1,4,5,1,0,1,1,2,10
400995771,Milwaukee Panthers,J. Reit,4068977,,True,32.0,5,10,5,7,0,3,0,0,0,2,2,1,0,1,3,3,10
400995771,Milwaukee Panthers,J. Lindner,3142566,,True,30.0,5,12,5,11,0,1,3,3,1,5,6,1,0,0,4,0,13
400995771,Milwaukee Panthers,K. Cunningham,3142564,,True,22.0,0,3,0,2,0,1,2,3,1,3,4,0,1,0,1,0,2
400995771,Milwaukee Panthers,B. Farley,3067503,,True,24.0,3,6,1,3,2,3,2,3,0,3,3,2,0,0,4,0,10
400995771,Milwaukee Panthers,L. Odegard,4068979,,False,15.0,1,1,1,1,0,0,0,0,0,7,7,0,0,1,7,0,2
400995771,Milwaukee Panthers,R. Johnson,3142805,,False,5.0,1,2,1,2,0,0,0,0,1,1,2,0,0,0,0,0,2
400995771,Milwaukee Panthers,B. Bisping,4282010,,False,11.0,1,1,0,0,1,1,0,0,0,3,3,1,1,0,2,2,3
400995771,Milwaukee Panthers,S. Staver,4282009,,False,7.0,1,3,1,3,0,0,1,1,0,1,1,0,0,0,0,1,3
400995771,Milwaukee Panthers,M. Schmelzer,4068976,,False,20.0,2,2,1,1,1,1,1,1,0,0,0,3,0,1,6,2,6
400995771,Milwaukee Panthers,A. Fischer,3942587,,False,6.0,2,2,0,0,2,2,1,2,0,1,1,0,0,0,1,0,7
400995771,Milwaukee Panthers,A. Hayes,3942585,,False,2.0,0,0,0,0,0,0,0,0,0,0,0,0,0,0,0,1,0
400995771,Milwaukee Panthers,TEAM,TOTAL,TOTAL,False,,26,49,20,37,6,12,10,13,4,31,35,9,2,4,31,11,68
400995771,Marquette Golden Eagles,E. Davenport,3906756,,True,23.0,7,10,7,10,0,0,0,2,2,2,4,0,2,1,4,3,14
400995771,Marquette Golden Eagles,A. Wilborn,3906758,,True,25.0,6,13,4,7,2,6,0,0,0,3,3,3,3,0,0,3,14
400995771,Marquette Golden Eagles,A. Blockton,3906755,,True,34.0,12,17,10,13,2,4,3,4,0,4,4,1,1,0,4,2,29
400995771,Marquette Golden Eagles,N. Hiedeman,3906753,,True,30.0,6,13,5,9,1,4,2,4,2,2,4,2,2,0,1,0,15
400995771,Marquette Golden Eagles,D. King,3906752,,True,26.0,2,8,2,6,0,2,0,0,1,1,2,2,1,0,0,3,4
400995771,Marquette Golden Eagles,M. Smith Traore,4281351,,False,4.0,0,0,0,0,0,0,0,0,0,1,1,0,1,0,0,1,0
400995771,Marquette Golden Eagles,A. Anderson,4068081,,False,7.0,0,1,0,1,0,0,0,0,0,3,3,0,1,0,1,1,0
400995771,Marquette Golden Eagles,S. Dahling,3906754,,False,1.0,0,0,0,0,0,0,0,0,0,0,0,0,0,0,0,0,0
400995771,Marquette Golden Eagles,L. Van Kleunen,4068083,,False,20.0,2,8,2,7,0,1,0,0,3,0,3,1,2,0,0,4,4
400995771,Marquette Golden Eagles,S. Lott,4281350,,False,21.0,0,4,0,2,0,2,0,0,0,2,2,1,5,1,0,2,0
400995771,Marquette Golden Eagles,I. Spingola,4068082,,False,9.0,1,1,0,0,1,1,0,0,0,1,1,1,2,0,0,1,3
400995771,Marquette Golden Eagles,TEAM,TOTAL,TOTAL,False,,36,75,30,55,6,20,5,10,10,20,30,11,20,2,10,20,83
400995770,South Dakota State Jackrabbits,M. Selland,4282531,,True,14.0,2,6,1,3,1,3,0,0,2,2,4,1,1,0,1,2,5
400995770,South Dakota State Jackrabbits,E. Thompson,3142249,,True,22.0,3,8,2,5,1,3,2,2,2,4,6,1,0,0,1,5,9
400995770,South Dakota State Jackrabbits,M. Guebert,3908281,,True,37.0,3,10,2,6,1,4,3,3,0,1,1,5,0,0,2,0,10
400995770,South Dakota State Jackrabbits,M. Miller,3142248,,True,34.0,6,14,6,11,0,3,5,5,1,1,2,4,1,0,1,1,17
400995770,South Dakota State Jackrabbits,A. Alexander,3142246,,True,21.0,0,3,0,1,0,2,0,0,0,2,2,4,1,0,0,1,0
400995770,South Dakota State Jackrabbits,T. Larson,4069099,,False,26.0,4,9,3,7,1,2,0,0,0,6,6,0,0,1,1,1,9
400995770,South Dakota State Jackrabbits,S. Palmer,3908283,,False,18.0,2,3,0,0,2,3,0,0,0,2,2,1,0,1,0,0,6
400995770,South Dakota State Jackrabbits,T. Irwin,4282530,,False,6.0,0,0,0,0,0,0,2,2,0,1,1,0,0,0,2,0,2
400995770,South Dakota State Jackrabbits,S. Tracy,4069100,,False,10.0,2,3,2,3,0,0,1,1,0,4,4,2,0,0,1,1,5
400995770,South Dakota State Jackrabbits,R. Cascio Jensen,4068046,,False,12.0,1,2,1,2,0,0,0,0,0,1,1,1,1,0,0,1,2
400995770,South Dakota State Jackrabbits,TEAM,TOTAL,TOTAL,False,,23,58,17,38,6,20,13,13,9,24,33,19,4,2,9,12,65
400995770,Creighton Bluejays,A. Faber,3938938,,True,34.0,6,11,4,6,2,5,0,0,1,2,3,6,1,2,1,2,14
400995770,Creighton Bluejays,A. Greene,3938937,,True,12.0,1,2,1,2,0,0,2,2,2,0,2,0,0,0,1,0,4
400995770,Creighton Bluejays,J. Agnew,3938935,,True,32.0,8,16,3,7,5,9,0,0,0,5,5,6,1,1,2,2,21
400995770,Creighton Bluejays,S. Lamberty,3142285,,True,38.0,1,5,0,3,1,2,0,0,1,3,4,6,0,1,0,3,3
400995770,Creighton Bluejays,M. Mellman,3142283,,True,10.0,0,3,0,0,0,3,0,0,0,4,4,0,1,0,1,0,0
400995770,Creighton Bluejays,K. Brown,3142286,,False,6.0,0,0,0,0,0,0,0,0,1,0,1,0,0,0,0,0,0
400995770,Creighton Bluejays,B. Norby,3142284,,False,10.0,1,1,0,0,1,1,0,0,0,2,2,2,1,0,1,0,3
400995770,Creighton Bluejays,T. Carda,4281362,,False,22.0,1,2,1,2,0,0,0,0,1,4,5,0,0,0,1,3,2
400995770,Creighton Bluejays,T. Rembao,4281361,,False,3.0,1,1,1,1,0,0,0,0,0,0,0,0,0,0,0,0,2
400995770,Creighton Bluejays,O. Elger,3938936,,False,26.0,6,15,2,8,4,7,5,5,0,3,3,3,1,0,0,2,21
400995770,Creighton Bluejays,B. Kissinger,3142124,,False,7.0,1,1,1,1,0,0,0,0,0,2,2,0,0,0,0,1,2
400995770,Creighton Bluejays,TEAM,TOTAL,TOTAL,False,,26,57,13,30,13,27,7,7,7,26,33,23,5,4,8,13,72
400995769,St. John's Red Storm,M. Singleton,4068158,,True,49.0,5,12,5,12,0,0,3,5,2,13,15,0,4,2,1,2,13
400995769,St. John's Red Storm,I. Littleton,3142306,,True,39.0,0,1,0,1,0,0,1,2,3,4,7,1,0,1,1,3,1
400995769,St. John's Red Storm,A. Wellere,3906771,,True,39.0,2,11,1,6,1,5,0,0,3,2,5,1,0,0,6,3,5
400995769,St. John's Red Storm,Q. Hoppie,4281375,,True,19.0,1,3,1,2,0,1,1,2,0,1,1,0,0,1,2,1,3
400995769,St. John's Red Storm,T. England,4068155,,True,48.0,7,15,5,9,2,6,1,2,1,4,5,5,0,0,3,0,17
400995769,St. John's Red Storm,A. Adams,4068157,,False,26.0,5,10,4,6,1,4,1,1,0,1,1,0,1,0,1,5,12
400995769,St. John's Red Storm,A. Kebbe,4068154,,False,29.0,6,12,5,9,1,3,0,0,2,3,5,1,0,1,4,5,13
400995769,St. John's Red Storm,T. Alexander,3142305,,False,2.0,0,0,0,0,0,0,0,0,0,0,0,0,0,0,0,0,0
400995769,St. John's Red Storm,TEAM,TOTAL,TOTAL,False,,26,64,21,45,5,19,7,12,12,30,42,8,5,5,18,19,64
400995769,Fordham Rams,J. Klug,4281470,,True,44.0,6,8,4,6,2,2,0,0,1,2,3,3,0,1,1,3,14
400995769,Fordham Rams,M. Goulding,4068440,,True,50.0,4,15,4,12,0,3,4,4,7,3,10,7,0,0,3,3,12
400995769,Fordham Rams,G. Davis,3139286,,True,48.0,4,12,4,12,0,0,3,4,1,13,14,1,3,2,3,4,11
400995769,Fordham Rams,L. Holden,3916497,,True,50.0,3,10,1,4,2,6,0,0,0,0,0,0,1,0,1,2,8
400995769,Fordham Rams,B. Cavanaugh,3913869,,True,48.0,7,18,5,12,2,6,4,5,0,5,5,1,1,0,2,2,20
400995769,Fordham Rams,K. Heremaia,4281473,,False,3.0,0,0,0,0,0,0,2,2,0,1,1,0,0,0,2,0,2
400995769,Fordham Rams,Z. Jillings,4281468,,False,11.0,0,1,0,0,0,1,0,0,1,0,1,0,0,0,0,1,0
400995769,Fordham Rams,TEAM,TOTAL,TOTAL,False,,24,64,18,46,6,18,13,15,10,26,36,12,5,3,12,15,67
400995768,Marquette Golden Eagles,E. Davenport,3906756,,True,26.0,5,8,5,8,0,0,2,2,2,4,6,0,1,2,3,3,12
400995768,Marquette Golden Eagles,A. Wilborn,3906758,,True,28.0,5,11,5,10,0,1,0,0,2,4,6,4,3,0,3,3,10
400995768,Marquette Golden Eagles,A. Blockton,3906755,,True,26.0,4,11,4,10,0,1,4,4,2,4,6,3,2,0,2,1,12
400995768,Marquette Golden Eagles,N. Hiedeman,3906753,,True,25.0,9,11,6,6,3,5,0,0,0,2,2,1,2,1,0,3,21
400995768,Marquette Golden Eagles,D. King,3906752,,True,30.0,5,11,5,9,0,2,0,0,2,0,2,3,2,0,3,2,10
400995768,Marquette Golden Eagles,M. Smith Traore,4281351,,False,10.0,1,2,1,2,0,0,0,0,1,0,1,0,2,0,2,1,2
400995768,Marquette Golden Eagles,A. Anderson,4068081,,False,11.0,1,2,1,2,0,0,0,0,1,4,5,1,2,0,1,0,2
400995768,Marquette Golden Eagles,S. Dahling,3906754,,False,3.0,0,1,0,0,0,1,0,0,0,0,0,0,0,0,0,0,0
400995768,Marquette Golden Eagles,L. Van Kleunen,4068083,,False,17.0,3,6,1,2,2,4,0,0,1,0,1,1,1,0,2,1,8
400995768,Marquette Golden Eagles,S. Lott,4281350,,False,17.0,1,6,0,3,1,3,0,1,1,2,3,0,0,0,0,3,3
400995768,Marquette Golden Eagles,I. Spingola,4068082,,False,6.0,1,2,0,0,1,2,0,0,0,0,0,0,1,0,0,1,3
400995768,Marquette Golden Eagles,O. Moskari,3906757,,False,2.0,0,0,0,0,0,0,0,0,0,0,0,0,0,0,0,0,0
400995768,Marquette Golden Eagles,TEAM,TOTAL,TOTAL,False,,35,71,28,52,7,19,6,7,12,23,35,13,16,3,16,18,83
400995768,Army Black Knights,M. Hovren,3944371,,True,25.0,2,4,2,4,0,0,4,5,0,4,4,0,1,0,3,2,8
400995768,Army Black Knights,A. Murray,3143279,,True,25.0,1,5,1,5,0,0,1,2,2,4,6,3,1,0,0,1,3
400995768,Army Black Knights,L. Tacka,4068230,,True,32.0,4,12,3,8,1,4,0,0,3,1,4,1,2,0,5,2,9
400995768,Army Black Knights,D. Morris,3143282,,True,28.0,6,11,6,9,0,2,3,7,1,1,2,0,3,0,7,1,15
400995768,Army Black Knights,J. McNeal,3143281,,True,15.0,0,1,0,1,0,0,0,0,1,3,4,3,0,0,3,5,0
400995768,Army Black Knights,L. Layne,4280990,,False,4.0,0,0,0,0,0,0,0,0,0,0,0,0,0,0,0,0,0
400995768,Army Black Knights,M. Hubbell,3143278,,False,17.0,2,3,2,3,0,0,0,0,1,3,4,0,0,0,1,1,4
400995768,Army Black Knights,L. Hicks,3143276,,False,13.0,1,1,1,1,0,0,2,6,1,5,6,0,0,1,0,0,4
400995768,Army Black Knights,G. White,4280988,,False,3.0,0,2,0,2,0,0,0,0,0,1,1,0,0,0,1,0,0
400995768,Army Black Knights,S. Haynes,4068232,,False,1.0,0,0,0,0,0,0,0,0,0,0,0,0,0,0,0,0,0
400995768,Army Black Knights,M. Yancey,4068231,,False,18.0,4,9,2,2,2,7,0,0,0,0,0,0,1,0,2,1,10
400995768,Army Black Knights,C. Schnell,4068229,,False,6.0,0,1,0,0,0,1,0,0,0,0,0,0,0,0,2,0,0
400995768,Army Black Knights,D. Morris,3143280,,False,13.0,0,2,0,0,0,2,0,0,0,0,0,2,1,0,2,0,0
400995768,Army Black Knights,TEAM,TOTAL,TOTAL,False,,20,51,17,35,3,16,10,20,10,24,34,9,9,1,28,13,53
400995767,Omaha Mavericks,C. Vaccher,3146154,,True,23.0,1,3,1,3,0,0,2,4,0,2,2,2,0,0,0,1,4
400995767,Omaha Mavericks,C. Killian,4282498,,True,32.0,2,6,2,3,0,3,3,4,0,0,0,0,3,0,3,3,7
400995767,Omaha Mavericks,E. Brecht,3908275,,True,36.0,3,6,1,1,2,5,1,1,1,7,8,1,1,0,0,1,9
400995767,Omaha Mavericks,A. Vidal,3908272,,True,28.0,3,10,1,5,2,5,1,2,0,4,4,3,1,0,5,2,9
400995767,Omaha Mavericks,J. Walter,3142140,,True,32.0,2,11,2,8,0,3,2,2,2,2,4,0,0,0,2,3,6
400995767,Omaha Mavericks,R. Wallace,4282503,,False,11.0,1,3,1,3,0,0,0,0,2,6,8,0,0,0,2,0,2
400995767,Omaha Mavericks,J. Bridgeman,3908276,,False,20.0,5,8,3,5,2,3,2,4,1,4,5,0,1,2,0,0,14
400995767,Omaha Mavericks,A. Mountain,4282501,,False,3.0,0,1,0,1,0,0,0,0,0,0,0,0,0,0,0,1,0
400995767,Omaha Mavericks,E. Petersen,4282500,,False,2.0,0,0,0,0,0,0,0,0,0,0,0,0,0,0,0,0,0
400995767,Omaha Mavericks,S. Echelberry,3908271,,False,2.0,0,1,0,1,0,0,0,0,0,0,0,0,0,0,0,1,0
400995767,Omaha Mavericks,K. Phillips,3908270,,False,11.0,0,3,0,2,0,1,0,0,0,0,0,1,0,0,1,1,0
400995767,Omaha Mavericks,TEAM,TOTAL,TOTAL,False,,17,52,11,32,6,20,11,17,9,25,34,7,6,2,13,13,51
400995767,Creighton Bluejays,A. Faber,3938938,,True,30.0,2,10,1,4,1,6,0,0,1,3,4,6,1,0,2,0,5
400995767,Creighton Bluejays,A. Greene,3938937,,True,11.0,1,1,1,1,0,0,0,0,3,1,4,0,1,0,0,3,2
400995767,Creighton Bluejays,J. Agnew,3938935,,True,30.0,5,13,2,6,3,7,2,4,0,4,4,3,2,2,0,3,15
400995767,Creighton Bluejays,S. Lamberty,3142285,,True,30.0,8,12,5,8,3,4,2,2,0,1,1,6,0,0,4,0,21
400995767,Creighton Bluejays,M. Mellman,3142283,,True,13.0,1,1,0,0,1,1,0,0,1,1,2,0,0,0,1,0,3
400995767,Creighton Bluejays,K. Brown,3142286,,False,13.0,1,2,1,2,0,0,1,1,1,1,2,0,0,0,0,2,3
400995767,Creighton Bluejays,B. Norby,3142284,,False,16.0,5,7,4,6,1,1,0,0,2,5,7,0,0,1,0,1,11
400995767,Creighton Bluejays,T. Carda,4281362,,False,13.0,0,4,0,2,0,2,0,0,2,5,7,2,0,0,0,1,0
400995767,Creighton Bluejays,T. Rembao,4281361,,False,12.0,1,5,0,4,1,1,0,0,0,4,4,1,0,0,1,3,3
400995767,Creighton Bluejays,O. Elger,3938936,,False,17.0,1,3,1,2,0,1,0,0,1,3,4,3,2,0,0,0,2
400995767,Creighton Bluejays,B. Kissinger,3142124,,False,15.0,2,5,1,1,1,4,2,6,0,0,0,0,2,0,0,2,7
400995767,Creighton Bluejays,TEAM,TOTAL,TOTAL,False,,27,63,16,36,11,27,7,13,13,29,42,21,8,3,8,15,72
400995766,Sacred Heart Pioneers,K. Haines,3152153,,True,37.0,4,10,3,7,1,3,3,4,1,11,12,2,2,3,4,3,12
400995766,Sacred Heart Pioneers,O. Dabney,4282004,,True,22.0,1,2,0,0,1,2,1,2,0,3,3,1,0,0,0,5,4
400995766,Sacred Heart Pioneers,E. Storck,3934244,,True,39.0,12,18,11,14,1,4,4,7,1,2,3,1,0,0,2,3,29
400995766,Sacred Heart Pioneers,T. Carter,3152152,,True,36.0,4,10,1,4,3,6,5,6,1,2,3,3,2,0,1,1,16
400995766,Sacred Heart Pioneers,C. Leatherwood,3142850,,True,35.0,6,12,6,9,0,3,2,4,0,4,4,7,0,0,2,2,14
400995766,Sacred Heart Pioneers,A. Kangudie,4282007,,False,1.0,0,0,0,0,0,0,0,0,0,0,0,0,0,0,0,1,0
400995766,Sacred Heart Pioneers,J. Silletti,4069329,,False,2.0,0,0,0,0,0,0,0,0,0,0,0,0,0,0,0,2,0
400995766,Sacred Heart Pioneers,A. Hagood,4282006,,False,19.0,1,3,0,0,1,3,0,0,0,0,0,1,0,1,0,4,3
400995766,Sacred Heart Pioneers,A. McCray,4282005,,False,4.0,0,1,0,0,0,1,0,0,0,0,0,0,0,0,0,0,0
400995766,Sacred Heart Pioneers,A. Murphy,4069326,,False,5.0,0,1,0,1,0,0,0,0,0,0,0,0,0,0,0,1,0
400995766,Sacred Heart Pioneers,TEAM,TOTAL,TOTAL,False,,28,57,21,35,7,22,15,23,4,26,30,15,4,4,9,22,78
400995766,Providence Friars,N. Franklin,4281348,,True,12.0,1,4,1,4,0,0,1,2,0,1,1,0,0,0,2,3,3
400995766,Providence Friars,B. Frias,3142302,,True,10.0,0,1,0,1,0,0,0,0,0,0,0,0,0,0,0,0,0
400995766,Providence Friars,N. Jackson,4068111,,True,27.0,5,5,5,5,0,0,1,3,2,6,8,3,0,0,3,4,11
400995766,Providence Friars,J. Nogic,3906769,,True,34.0,7,21,2,8,5,13,5,5,0,5,5,2,1,0,4,4,24
400995766,Providence Friars,M. Jolin,3906767,,True,18.0,4,9,3,5,1,4,0,2,1,2,3,3,0,0,0,1,9
400995766,Providence Friars,A. Cooper,4281349,,False,25.0,3,5,3,5,0,0,2,2,1,3,4,0,1,1,0,4,8
400995766,Providence Friars,O. Orlando,4281347,,False,14.0,0,1,0,1,0,0,0,0,1,3,4,0,0,0,0,2,0
400995766,Providence Friars,K. Spiwak,4281346,,False,2.0,0,0,0,0,0,0,0,0,0,0,0,0,0,0,0,0,0
400995766,Providence Friars,C. Williams,4281345,,False,11.0,0,3,0,3,0,0,0,0,1,0,1,1,0,0,0,2,0
400995766,Providence Friars,C. Che,3906766,,False,33.0,4,8,2,2,2,6,2,2,0,5,5,4,1,0,0,5,12
400995766,Providence Friars,A. Botteghi,3142301,,False,14.0,2,6,2,5,0,1,4,5,3,0,3,2,0,0,1,1,8
400995766,Providence Friars,TEAM,TOTAL,TOTAL,False,,26,63,18,39,8,24,15,21,11,26,37,15,3,1,10,26,75
400995765,St. John's Red Storm,M. Singleton,4068158,,True,28.0,4,8,4,8,0,0,7,15,3,6,9,1,1,0,1,4,15
400995765,St. John's Red Storm,I. Littleton,3142306,,True,16.0,1,2,1,2,0,0,1,2,1,0,1,1,0,0,0,4,3
400995765,St. John's Red Storm,A. Wellere,3906771,,True,38.0,7,16,3,9,4,7,0,0,0,5,5,0,3,0,1,3,18
400995765,St. John's Red Storm,Q. Hoppie,4281375,,True,33.0,2,7,2,4,0,3,2,2,0,1,1,2,4,3,4,2,6
400995765,St. John's Red Storm,T. England,4068155,,True,40.0,6,6,4,4,2,2,3,4,0,6,6,8,2,1,4,0,17
400995765,St. John's Red Storm,K. Charles,4281374,,False,6.0,0,0,0,0,0,0,0,0,0,0,0,0,0,0,0,2,0
400995765,St. John's Red Storm,A. Adams,4068157,,False,22.0,5,7,2,4,3,3,4,4,0,2,2,1,1,0,1,0,17
400995765,St. John's Red Storm,A. Kebbe,4068154,,False,17.0,1,6,0,3,1,3,2,2,0,2,2,0,0,1,0,2,5
400995765,St. John's Red Storm,TEAM,TOTAL,TOTAL,False,,26,52,16,34,10,18,19,29,6,23,29,13,11,5,11,17,81
400995765,James Madison Dukes,K. Koshuta,3949117,,True,24.0,5,8,4,6,1,2,3,4,5,4,9,0,0,1,2,2,14
400995765,James Madison Dukes,T. Butler,3058916,,True,4.0,0,1,0,0,0,1,0,0,0,0,0,0,0,0,0,2,0
400995765,James Madison Dukes,K. Smalls,4068346,,True,36.0,8,15,7,11,1,4,2,3,0,5,5,2,1,0,6,2,19
400995765,James Madison Dukes,L. Barrier,4068345,,True,24.0,6,15,6,11,0,4,1,3,3,1,4,1,0,1,1,4,13
400995765,James Madison Dukes,H. Barron,3143253,,True,30.0,1,3,1,1,0,2,0,0,1,2,3,1,3,0,3,4,2
400995765,James Madison Dukes,D. Merritt,4068347,,False,15.0,2,4,2,4,0,0,2,2,1,1,2,0,0,1,0,3,6
400995765,James Madison Dukes,K. Cooper-Williams,3907012,,False,19.0,0,3,0,3,0,0,0,0,1,8,9,0,0,1,1,3,0
400995765,James Madison Dukes,T. Harris,4281443,,False,14.0,2,5,1,1,1,4,0,0,1,2,3,0,0,0,1,2,5
400995765,James Madison Dukes,A. Young,3907011,,False,11.0,1,5,1,2,0,3,0,0,2,2,4,1,0,0,2,0,2
400995765,James Madison Dukes,L. Reynolds,3907010,,False,23.0,1,3,1,1,0,2,1,2,0,0,0,1,1,0,3,0,3
400995765,James Madison Dukes,TEAM,TOTAL,TOTAL,False,,26,62,23,40,3,22,9,14,15,25,40,6,5,4,19,22,64
400995764,Xavier Musketeers,A. Gray,4281368,,True,23.0,4,7,3,5,1,2,1,2,3,4,7,1,3,1,2,2,10
400995764,Xavier Musketeers,A. Aijanen,3142319,,True,27.0,2,6,2,4,0,2,2,2,2,1,3,1,2,1,3,3,6
400995764,Xavier Musketeers,A. Reiff,4281367,,True,13.0,0,2,0,1,0,1,0,0,0,1,1,1,1,0,1,0,0
400995764,Xavier Musketeers,A. Dunham,4281365,,True,24.0,2,7,2,5,0,2,1,2,0,1,1,1,0,0,0,1,5
400995764,Xavier Musketeers,N. Owens,4068187,,True,20.0,1,6,1,5,0,1,0,2,2,4,6,2,3,0,4,1,2
400995764,Xavier Musketeers,D. Ross,4281364,,False,23.0,3,9,0,2,3,7,0,0,0,4,4,0,0,0,2,0,9
400995764,Xavier Musketeers,M. Christopher,4068186,,False,7.0,0,0,0,0,0,0,0,0,1,0,1,0,1,0,0,1,0
400995764,Xavier Musketeers,J. Dawson,4281369,,False,8.0,0,0,0,0,0,0,0,0,0,0,0,0,0,0,0,0,0
400995764,Xavier Musketeers,P. Stewart,4281366,,False,23.0,5,8,5,7,0,1,0,0,0,3,3,1,1,0,2,1,10
400995764,Xavier Musketeers,A. Gomez,4068185,,False,11.0,1,1,0,0,1,1,0,0,1,0,1,0,1,0,0,0,3
400995764,Xavier Musketeers,K. Fincher,3142317,,False,21.0,1,5,0,1,1,4,5,8,0,3,3,1,1,0,1,1,8
400995764,Xavier Musketeers,TEAM,TOTAL,TOTAL,False,,19,51,13,30,6,21,9,16,10,23,33,8,13,2,16,10,53
400995764,Bowling Green Falcons,J. Uecker,4068828,,True,26.0,0,3,0,2,0,1,0,0,2,4,6,1,0,0,1,1,0
400995764,Bowling Green Falcons,A. Cecil,4068826,,True,37.0,6,14,5,11,1,3,1,2,1,6,7,4,1,0,4,3,14
400995764,Bowling Green Falcons,H. Puk,3143206,,True,22.0,3,6,0,2,3,4,0,0,0,1,1,2,0,0,3,1,9
400995764,Bowling Green Falcons,C. Santoro,3907626,,True,31.0,5,11,4,7,1,4,1,2,3,2,5,0,1,0,2,3,12
400995764,Bowling Green Falcons,S. Lambert,3907625,,True,34.0,3,9,0,3,3,6,0,0,1,6,7,4,5,0,4,0,9
400995764,Bowling Green Falcons,S. Thompson,4282039,,False,9.0,0,1,0,1,0,0,0,0,0,1,1,0,0,0,0,4,0
400995764,Bowling Green Falcons,M. Cole,3907628,,False,1.0,0,0,0,0,0,0,0,0,0,0,0,0,0,0,0,0,0
400995764,Bowling Green Falcons,T. Battle,4282038,,False,5.0,0,0,0,0,0,0,0,0,0,2,2,0,0,0,1,0,0
400995764,Bowling Green Falcons,C. Glowniak,4068829,,False,2.0,0,0,0,0,0,0,0,0,0,0,0,0,0,0,2,0,0
400995764,Bowling Green Falcons,M. Parker,4282037,,False,1.0,0,0,0,0,0,0,0,0,0,0,0,0,0,0,0,0,0
400995764,Bowling Green Falcons,K. Williams,4282036,,False,6.0,0,0,0,0,0,0,0,0,0,2,2,0,1,0,0,1,0
400995764,Bowling Green Falcons,C. Thompson,4068827,,False,23.0,6,9,1,3,5,6,2,2,0,0,0,0,0,0,0,0,19
400995764,Bowling Green Falcons,R. Myers,3143204,,False,4.0,0,1,0,1,0,0,0,0,0,0,0,0,0,0,0,0,0
400995764,Bowling Green Falcons,TEAM,TOTAL,TOTAL,False,,23,54,10,30,13,24,4,6,9,25,34,11,8,0,17,13,63
400995763,Loyola Chicago Ramblers,K. Strawbridge,4282264,,True,33.0,2,5,2,2,0,3,6,6,0,4,4,4,1,0,6,0,10
400995763,Loyola Chicago Ramblers,A. O'Connor,4282263,,True,33.0,6,10,5,8,1,2,2,2,3,4,7,3,1,2,2,2,15
400995763,Loyola Chicago Ramblers,L. Segars,4068628,,True,20.0,0,4,0,2,0,2,0,0,0,1,1,2,0,0,4,1,0
400995763,Loyola Chicago Ramblers,K. Salmon,3142804,,True,33.0,5,15,4,12,1,3,0,0,3,9,12,0,0,0,0,0,11
400995763,Loyola Chicago Ramblers,J. Cerda,3065188,,True,31.0,3,12,1,3,2,9,0,0,0,3,3,2,1,1,2,3,8
400995763,Loyola Chicago Ramblers,K. Nolan,4282265,,False,1.0,0,2,0,2,0,0,0,0,1,1,2,0,0,0,0,0,0
400995763,Loyola Chicago Ramblers,A. Meyer,4282262,,False,2.0,0,0,0,0,0,0,0,0,0,0,0,0,0,0,0,2,0
400995763,Loyola Chicago Ramblers,E. Rice,4282261,,False,29.0,0,6,0,1,0,5,3,4,1,2,3,0,0,0,3,3,3
400995763,Loyola Chicago Ramblers,T. Wallace,4068629,,False,7.0,0,1,0,1,0,0,0,0,1,0,1,0,0,0,2,0,0
400995763,Loyola Chicago Ramblers,B. Segars,3907700,,False,11.0,0,3,0,3,0,0,0,0,0,0,0,0,0,0,4,1,0
400995763,Loyola Chicago Ramblers,TEAM,TOTAL,TOTAL,False,,16,58,12,34,4,24,11,12,13,28,41,11,3,3,24,12,47
400995763,DePaul Blue Demons,M. Grays,3142287,,True,18.0,4,8,4,7,0,1,0,0,0,2,2,1,0,0,3,1,8
400995763,DePaul Blue Demons,K. Campbell,4068071,,True,23.0,7,9,4,4,3,5,1,1,0,5,5,3,3,0,1,2,18
400995763,DePaul Blue Demons,T. Allen,3933760,,True,26.0,0,8,0,4,0,4,0,0,1,2,3,1,1,2,0,3,0
400995763,DePaul Blue Demons,A. Millender,3142289,,True,22.0,3,7,1,2,2,5,0,0,2,0,2,0,1,0,0,0,8
400995763,DePaul Blue Demons,A. Coleman,3142123,,True,17.0,5,10,3,5,2,5,3,4,3,3,6,2,1,0,1,1,15
400995763,DePaul Blue Demons,R. McLimore,4281358,,False,18.0,2,5,2,5,0,0,0,0,3,1,4,5,3,0,1,0,4
400995763,DePaul Blue Demons,C. Stonewall,4068072,,False,19.0,3,6,1,4,2,2,1,3,2,1,3,1,1,2,0,0,9
400995763,DePaul Blue Demons,V. Sherrod,4281359,,False,9.0,1,4,0,2,1,2,0,0,0,0,0,0,0,0,2,3,3
400995763,DePaul Blue Demons,D. Bekelja,4281356,,False,17.0,3,8,1,3,2,5,0,0,1,5,6,3,1,0,1,2,8
400995763,DePaul Blue Demons,C. McMahon,4068074,,False,3.0,0,0,0,0,0,0,0,0,0,0,0,0,0,0,0,0,0
400995763,DePaul Blue Demons,D. Cage,4068073,,False,9.0,6,10,3,4,3,6,0,0,1,1,2,0,1,0,0,0,15
400995763,DePaul Blue Demons,L. Prochaska,3142290,,False,19.0,0,1,0,0,0,1,0,0,0,4,4,4,1,0,0,0,0
400995763,DePaul Blue Demons,TEAM,TOTAL,TOTAL,False,,34,76,19,40,15,36,5,8,13,28,41,20,13,4,10,12,88
400995762,Drake Bulldogs,S. Rhine,3907686,,True,30.0,9,19,8,15,1,4,6,6,3,5,8,2,0,2,3,2,25
400995762,Drake Bulldogs,B. Jonas,3142792,,True,37.0,4,9,3,7,1,2,1,1,6,4,10,3,1,0,1,4,10
400995762,Drake Bulldogs,M. Petersen,4282208,,True,47.0,4,7,3,4,1,3,0,1,0,2,2,3,1,0,2,2,9
400995762,Drake Bulldogs,B. Hittner,4068464,,True,37.0,5,13,4,10,1,3,7,8,2,3,5,2,2,1,0,2,18
400995762,Drake Bulldogs,S. Bachrodt,3907683,,True,50.0,7,16,5,9,2,7,0,0,1,6,7,5,1,0,1,4,16
400995762,Drake Bulldogs,K. Van Scyoc,4282210,,False,1.0,0,0,0,0,0,0,0,0,0,0,0,0,0,0,0,1,0
400995762,Drake Bulldogs,H. Fuller,4282209,,False,3.0,0,0,0,0,0,0,0,0,1,0,1,0,0,0,1,1,0
400995762,Drake Bulldogs,B. Rose,4068465,,False,33.0,4,12,3,8,1,4,8,11,1,4,5,0,0,1,1,2,17
400995762,Drake Bulldogs,N. Miller,3907685,,False,39.0,1,3,0,0,1,3,2,2,1,1,2,2,0,0,2,0,5
400995762,Drake Bulldogs,P. Greiner,3142791,,False,12.0,0,0,0,0,0,0,0,0,0,2,2,0,0,0,0,0,0
400995762,Drake Bulldogs,M. Dean,3142790,,False,11.0,0,4,0,4,0,0,0,0,1,1,2,2,0,0,1,1,0
400995762,Drake Bulldogs,TEAM,TOTAL,TOTAL,False,,34,83,26,57,8,26,24,29,18,31,49,19,5,4,12,19,100
400995762,Creighton Bluejays,A. Faber,3938938,,True,57.0,11,22,8,15,3,7,9,9,1,3,4,6,1,1,1,4,34
400995762,Creighton Bluejays,A. Greene,3938937,,True,36.0,2,4,2,4,0,0,1,2,6,3,9,0,0,0,1,3,5
400995762,Creighton Bluejays,J. Agnew,3938935,,True,56.0,7,17,1,4,6,13,0,0,4,4,8,1,2,1,1,3,20
400995762,Creighton Bluejays,S. Lamberty,3142285,,True,53.0,6,10,4,5,2,5,7,10,3,9,12,6,2,1,2,0,21
400995762,Creighton Bluejays,M. Mellman,3142283,,True,9.0,0,4,0,0,0,4,0,0,0,0,0,0,0,0,0,0,0
400995762,Creighton Bluejays,K. Brown,3142286,,False,18.0,4,5,4,5,0,0,0,0,1,0,1,2,0,0,0,5,8
400995762,Creighton Bluejays,B. Norby,3142284,,False,4.0,2,2,2,2,0,0,0,0,0,0,0,0,0,0,1,0,4
400995762,Creighton Bluejays,T. Carda,4281362,,False,45.0,5,18,3,6,2,12,4,4,2,8,10,2,1,0,1,4,16
400995762,Creighton Bluejays,T. Rembao,4281361,,False,12.0,0,3,0,2,0,1,0,0,0,1,1,2,0,0,1,1,0
400995762,Creighton Bluejays,B. Kissinger,3142124,,False,10.0,0,1,0,0,0,1,0,0,0,0,0,3,0,0,0,2,0
400995762,Creighton Bluejays,TEAM,TOTAL,TOTAL,False,,37,86,24,43,13,43,21,25,18,32,50,22,6,3,12,22,108
400995761,Illinois State Redbirds,V. Livingston,3907695,,True,38.0,2,6,1,3,1,3,2,2,4,1,5,1,1,0,3,1,7
400995761,Illinois State Redbirds,K. Beck,3907693,,True,37.0,4,10,2,4,2,6,2,4,1,5,6,0,1,1,5,4,12
400995761,Illinois State Redbirds,M. Talbot,4068493,,True,31.0,1,5,1,1,0,4,0,0,4,5,9,0,1,0,1,3,2
400995761,Illinois State Redbirds,H. Green,4068490,,True,34.0,5,19,3,16,2,3,6,7,1,7,8,1,1,3,5,4,18
400995761,Illinois State Redbirds,P. Saylor,4282220,,True,38.0,0,5,0,1,0,4,3,4,0,2,2,4,1,0,2,3,3
400995761,Illinois State Redbirds,M. Stevens,3907692,,False,13.0,0,2,0,2,0,0,0,0,1,2,3,0,0,0,2,0,0
400995761,Illinois State Redbirds,F. Corrigan,4068489,,False,9.0,1,4,0,2,1,2,0,0,0,1,1,0,0,1,1,2,3
400995761,Illinois State Redbirds,TEAM,TOTAL,TOTAL,False,,13,51,7,29,6,22,13,17,11,24,35,6,5,5,19,17,45
400995761,Butler Bulldogs,T. Schickel,3914012,,True,29.0,5,12,5,12,0,0,2,3,5,6,11,1,1,1,2,4,12
400995761,Butler Bulldogs,S. Brey,4068067,,True,27.0,1,3,1,1,0,2,1,2,1,3,4,1,0,0,1,3,3
400995761,Butler Bulldogs,I. Lathan,3079485,,True,22.0,4,7,4,7,0,0,0,0,2,4,6,1,1,0,5,2,8
400995761,Butler Bulldogs,M. Weaver,3914014,,True,29.0,3,9,1,6,2,3,4,4,0,3,3,2,3,0,1,1,12
400995761,Butler Bulldogs,W. Jennings,3142145,,True,35.0,3,10,2,5,1,5,2,2,0,4,4,4,3,0,2,0,9
400995761,Butler Bulldogs,A. Aube,4281363,,False,1.0,0,0,0,0,0,0,0,0,0,0,0,0,0,0,1,0,0
400995761,Butler Bulldogs,K. Hodges,4068065,,False,10.0,0,3,0,3,0,0,0,0,2,1,3,1,0,0,2,0,0
400995761,Butler Bulldogs,S. Humphrey,4068066,,False,3.0,0,1,0,1,0,0,0,0,0,0,0,0,0,0,0,1,0
400995761,Butler Bulldogs,S. Shelton,4068069,,False,9.0,0,1,0,0,0,1,0,0,0,1,1,0,0,0,0,3,0
400995761,Butler Bulldogs,K. Spolyar,4068068,,False,27.0,3,9,2,6,1,3,5,8,2,0,2,1,4,0,1,0,12
400995761,Butler Bulldogs,T. Buford,3914011,,False,1.0,0,0,0,0,0,0,0,0,0,0,0,0,0,0,0,1,0
400995761,Butler Bulldogs,S. Buck,3142279,,False,7.0,0,1,0,0,0,1,0,0,0,0,0,0,0,0,0,0,0
400995761,Butler Bulldogs,TEAM,TOTAL,TOTAL,False,,19,56,15,41,4,15,14,19,14,27,41,11,12,1,15,15,56
400995760,Marquette Golden Eagles,E. Davenport,3906756,,True,27.0,0,5,0,5,0,0,2,4,2,3,5,0,2,0,1,4,2
400995760,Marquette Golden Eagles,L. Van Kleunen,4068083,,True,19.0,1,7,1,4,0,3,0,0,2,4,6,0,1,1,2,1,2
400995760,Marquette Golden Eagles,A. Blockton,3906755,,True,31.0,3,10,3,8,0,2,0,0,1,4,5,2,3,0,4,5,6
400995760,Marquette Golden Eagles,N. Hiedeman,3906753,,True,27.0,2,5,1,1,1,4,5,8,1,3,4,0,1,0,1,3,10
400995760,Marquette Golden Eagles,D. King,3906752,,True,39.0,6,14,5,10,1,4,3,4,0,1,1,0,0,0,0,1,16
400995760,Marquette Golden Eagles,A. Anderson,4068081,,False,6.0,0,0,0,0,0,0,0,0,0,0,0,0,0,0,0,1,0
400995760,Marquette Golden Eagles,S. Lott,4281350,,False,18.0,0,1,0,0,0,1,1,2,0,1,1,1,1,0,1,1,1
400995760,Marquette Golden Eagles,I. Spingola,4068082,,False,3.0,0,1,0,0,0,1,0,0,0,0,0,0,0,0,0,0,0
400995760,Marquette Golden Eagles,A. Wilborn,3906758,,False,30.0,5,7,4,5,1,2,7,9,1,0,1,2,2,0,3,3,18
400995760,Marquette Golden Eagles,TEAM,TOTAL,TOTAL,False,,17,50,14,33,3,17,18,27,11,19,30,5,10,1,15,19,55
400995760,Green Bay Phoenix,K. Murphy,4068969,,True,32.0,4,12,4,12,0,0,3,4,6,6,12,1,0,1,2,2,11
400995760,Green Bay Phoenix,J. Lindstrom,3142542,,True,35.0,7,14,6,11,1,3,0,0,1,5,6,0,1,1,6,4,15
400995760,Green Bay Phoenix,C. Hibner,4068967,,True,7.0,1,2,1,2,0,0,0,0,0,0,0,0,0,0,2,1,2
400995760,Green Bay Phoenix,J. Wellnitz,3142543,,True,30.0,5,8,5,7,0,1,0,0,0,4,4,4,2,0,6,3,10
400995760,Green Bay Phoenix,A. Leclaire,3142541,,True,35.0,6,12,6,12,0,0,1,5,3,3,6,2,2,0,0,3,13
400995760,Green Bay Phoenix,M. Wolf,3944290,,False,10.0,0,0,0,0,0,0,2,4,1,1,2,0,0,0,1,3,2
400995760,Green Bay Phoenix,M. Wolf,3944289,,False,2.0,0,0,0,0,0,0,0,0,0,0,0,0,0,0,0,0,0
400995760,Green Bay Phoenix,L. Robson,4282451,,False,3.0,0,1,0,0,0,1,1,2,0,0,0,0,0,0,0,0,1
400995760,Green Bay Phoenix,F. Wurtz,3944288,,False,13.0,1,3,0,1,1,2,0,0,1,3,4,1,0,0,1,3,3
400995760,Green Bay Phoenix,L. James,3142540,,False,33.0,3,6,3,6,0,0,0,0,3,6,9,1,0,0,0,1,6
400995760,Green Bay Phoenix,TEAM,TOTAL,TOTAL,False,,27,58,25,51,2,7,7,15,15,28,43,9,5,2,18,20,63
400995759,St. Francis Brooklyn Terriers,L. Hickman,3922621,,True,17.0,2,5,2,5,0,0,0,0,1,0,1,0,0,0,2,3,4
400995759,St. Francis Brooklyn Terriers,A. Delaney,3143621,,True,31.0,3,11,1,2,2,9,3,4,0,5,5,3,0,0,8,0,11
400995759,St. Francis Brooklyn Terriers,A. O'Neill,4282031,,True,31.0,1,3,1,3,0,0,1,1,2,2,4,5,6,0,5,2,3
400995759,St. Francis Brooklyn Terriers,J. Johnson,4069339,,True,30.0,4,9,2,3,2,6,0,0,0,3,3,0,0,1,4,1,10
400995759,St. Francis Brooklyn Terriers,M. Palarino,3922617,,True,20.0,2,6,2,6,0,0,0,0,1,1,2,2,0,0,1,1,4
400995759,St. Francis Brooklyn Terriers,C. Carangelo,4282035,,False,10.0,2,3,2,3,0,0,0,0,0,0,0,0,0,0,0,1,4
400995759,St. Francis Brooklyn Terriers,A. Lassen,4282034,,False,6.0,0,1,0,1,0,0,1,2,1,0,1,0,1,0,0,0,1
400995759,St. Francis Brooklyn Terriers,A. Anderson,4282033,,False,12.0,0,1,0,1,0,0,0,2,2,0,2,1,0,0,1,1,0
400995759,St. Francis Brooklyn Terriers,S. Keltos,4069338,,False,13.0,1,3,1,3,0,0,0,0,1,0,1,0,1,0,4,3,2
400995759,St. Francis Brooklyn Terriers,T. Wagner,3922622,,False,7.0,1,4,1,4,0,0,1,2,1,0,1,0,0,0,1,1,3
400995759,St. Francis Brooklyn Terriers,D. DiRenzo,3922619,,False,23.0,2,4,1,3,1,1,3,4,2,2,4,1,1,0,1,1,8
400995759,St. Francis Brooklyn Terriers,TEAM,TOTAL,TOTAL,False,,18,50,13,34,5,16,9,15,14,14,28,12,9,1,27,14,50
400995759,Seton Hall Pirates,S. Samuels,4068128,,True,18.0,3,6,3,6,0,0,2,2,0,1,1,0,1,0,1,3,8
400995759,Seton Hall Pirates,T. Brown,3941336,,True,22.0,8,9,8,9,0,0,1,1,3,1,4,3,1,0,3,1,17
400995759,Seton Hall Pirates,D. Fountain,3058890,,True,3.0,1,1,1,1,0,0,0,2,0,0,0,0,1,0,0,0,2
400995759,Seton Hall Pirates,I. Butina,4281377,,True,23.0,3,5,3,4,0,1,2,2,0,2,2,8,5,0,0,2,8
400995759,Seton Hall Pirates,J. Jackson,3064877,,True,19.0,6,9,2,3,4,6,0,0,0,1,1,0,0,0,1,1,16
400995759,Seton Hall Pirates,S. Philoxy,4281380,,False,12.0,0,4,0,3,0,1,0,0,1,1,2,1,1,0,2,3,0
400995759,Seton Hall Pirates,K. Evans,4281378,,False,14.0,4,6,4,6,0,0,0,0,2,2,4,0,0,0,1,2,8
400995759,Seton Hall Pirates,J. Jones-Pack,4068129,,False,17.0,2,3,2,3,0,0,4,6,3,2,5,0,2,2,2,1,8
400995759,Seton Hall Pirates,D. Winters,4068126,,False,16.0,3,4,2,2,1,2,0,0,1,1,2,0,3,1,1,1,7
400995759,Seton Hall Pirates,N. Jimenez,4281379,,False,19.0,3,4,1,1,2,3,0,0,0,3,3,1,2,0,1,0,8
400995759,Seton Hall Pirates,T. Smith,4068124,,False,6.0,0,1,0,1,0,0,0,0,0,0,0,0,0,0,3,0,0
400995759,Seton Hall Pirates,K. Hilaire,4068123,,False,20.0,1,3,1,3,0,0,0,0,0,4,4,4,2,1,3,3,2
400995759,Seton Hall Pirates,K. Healy,3943704,,False,11.0,0,1,0,0,0,1,0,0,0,0,0,0,0,0,0,3,0
400995759,Seton Hall Pirates,TEAM,TOTAL,TOTAL,False,,34,56,27,42,7,14,9,13,10,21,31,17,18,4,18,20,84
400995758,Xavier Musketeers,A. Gray,4281368,,True,24.0,4,8,3,6,1,2,0,0,1,4,5,1,1,1,1,1,9
400995758,Xavier Musketeers,A. Aijanen,3142319,,True,30.0,6,13,5,9,1,4,0,0,2,6,8,1,1,0,1,3,13
400995758,Xavier Musketeers,N. Owens,4068187,,True,20.0,2,3,1,2,1,1,0,0,0,4,4,2,2,0,1,1,5
400995758,Xavier Musketeers,A. Gomez,4068185,,True,24.0,1,6,1,3,0,3,0,0,0,0,0,0,0,0,1,0,2
400995758,Xavier Musketeers,J. Byrd,3142318,,True,24.0,8,11,8,11,0,0,3,3,2,2,4,6,2,0,2,2,19
400995758,Xavier Musketeers,D. Ross,4281364,,False,19.0,0,6,0,2,0,4,0,0,1,1,2,1,1,0,1,3,0
400995758,Xavier Musketeers,M. Christopher,4068186,,False,1.0,0,0,0,0,0,0,0,0,0,0,0,0,0,0,0,0,0
400995758,Xavier Musketeers,J. Dawson,4281369,,False,6.0,0,1,0,1,0,0,0,0,1,0,1,0,1,0,1,0,0
400995758,Xavier Musketeers,A. Reiff,4281367,,False,12.0,3,4,3,3,0,1,1,2,1,0,1,1,1,0,1,1,7
400995758,Xavier Musketeers,P. Stewart,4281366,,False,20.0,1,3,1,3,0,0,1,1,0,0,0,1,0,0,1,0,3
400995758,Xavier Musketeers,A. Dunham,4281365,,False,20.0,1,4,0,1,1,3,1,2,0,1,1,2,0,0,0,0,4
400995758,Xavier Musketeers,TEAM,TOTAL,TOTAL,False,,26,59,22,41,4,18,6,8,12,19,31,15,9,1,11,11,62
400995758,Purdue Fort Wayne Mastodons,J. Williams,4282509,,True,22.0,4,9,4,9,0,0,0,0,2,7,9,0,0,2,1,1,8
400995758,Purdue Fort Wayne Mastodons,K. Repp,4282514,,True,26.0,2,6,1,4,1,2,0,0,1,2,3,0,0,0,2,1,5
400995758,Purdue Fort Wayne Mastodons,H. Albrecht,4282510,,True,27.0,1,3,1,3,0,0,0,0,0,3,3,2,1,1,0,2,2
400995758,Purdue Fort Wayne Mastodons,A. Lappenkuper,4068616,,True,36.0,7,12,5,9,2,3,3,4,0,1,1,2,0,0,1,3,19
400995758,Purdue Fort Wayne Mastodons,D. Young,3908265,,True,30.0,1,7,1,7,0,0,2,2,3,2,5,2,2,1,6,1,4
400995758,Purdue Fort Wayne Mastodons,D. Williams,4282512,,False,7.0,1,1,1,1,0,0,0,0,1,1,2,0,1,0,1,0,2
400995758,Purdue Fort Wayne Mastodons,K. McCarver,3142166,,False,20.0,0,5,0,2,0,3,0,0,5,1,6,4,0,0,0,3,0
400995758,Purdue Fort Wayne Mastodons,E. Tuominen,4282511,,False,4.0,0,0,0,0,0,0,0,0,0,0,0,0,0,0,1,0,0
400995758,Purdue Fort Wayne Mastodons,H. Hess,4068615,,False,28.0,4,10,2,2,2,8,0,0,0,2,2,2,1,0,3,1,10
400995758,Purdue Fort Wayne Mastodons,TEAM,TOTAL,TOTAL,False,,20,53,15,37,5,16,5,6,13,21,34,12,5,4,17,12,50
400995757,Georgetown Hoyas,C. Petke,4068078,,True,37.0,6,11,6,7,0,4,6,10,3,13,16,2,0,0,0,3,18
400995757,Georgetown Hoyas,Y. Belk,3142295,,True,17.0,1,4,1,4,0,0,0,0,0,6,6,1,0,2,0,2,2
400995757,Georgetown Hoyas,D. White,3948815,,True,33.0,7,18,4,14,3,4,7,9,5,8,13,4,3,1,5,3,24
400995757,Georgetown Hoyas,D. Burton,3142292,,True,33.0,1,5,1,5,0,0,0,0,0,2,2,5,0,0,1,4,2
400995757,Georgetown Hoyas,M. Venson,3142105,,True,40.0,6,14,4,7,2,7,4,6,0,1,1,2,1,0,4,3,18
400995757,Georgetown Hoyas,T. Thompson,4281352,,False,8.0,2,6,2,6,0,0,1,1,3,0,3,0,0,0,1,0,5
400995757,Georgetown Hoyas,M. Smith,4068079,,False,32.0,2,6,2,5,0,1,4,4,1,2,3,0,0,1,0,2,8
400995757,Georgetown Hoyas,TEAM,TOTAL,TOTAL,False,,25,64,20,48,5,16,22,30,14,35,49,14,4,4,11,17,77
400995757,Florida International Panthers,C. Cavanaugh,4281780,,True,24.0,1,5,1,5,0,0,0,2,0,2,2,0,0,0,0,1,2
400995757,Florida International Panthers,K. Pound,3064874,,True,25.0,6,13,6,11,0,2,3,4,3,3,6,0,1,0,0,4,15
400995757,Florida International Panthers,T. Taylor,4281779,,True,11.0,2,4,2,4,0,0,0,0,0,0,0,0,1,0,0,1,4
400995757,Florida International Panthers,L. Snipes,4281778,,True,27.0,1,6,1,3,0,3,1,2,1,4,5,0,0,0,1,2,3
400995757,Florida International Panthers,K. Hudson,3907044,,True,37.0,3,15,3,9,0,6,3,5,0,6,6,7,0,0,4,3,9
400995757,Florida International Panthers,S. Walker,4281781,,False,31.0,7,11,4,5,3,6,3,4,1,7,8,0,0,1,5,4,20
400995757,Florida International Panthers,C. Lee,4281777,,False,11.0,0,1,0,1,0,0,0,0,0,0,0,1,0,0,0,1,0
400995757,Florida International Panthers,K. Rogers,4068341,,False,20.0,1,2,1,2,0,0,1,2,0,0,0,2,0,0,3,5,3
400995757,Florida International Panthers,A. Gordon,4068340,,False,14.0,0,4,0,1,0,3,0,0,1,1,2,0,0,0,4,1,0
400995757,Florida International Panthers,TEAM,TOTAL,TOTAL,False,,21,61,18,41,3,20,11,19,10,27,37,10,2,1,18,22,56
400995756,Butler Bulldogs,S. Brey,4068067,,True,27.0,2,5,2,5,0,0,0,1,3,2,5,2,1,0,3,2,4
400995756,Butler Bulldogs,T. Schickel,3914012,,True,31.0,1,4,1,4,0,0,7,8,2,8,10,2,3,1,4,4,9
400995756,Butler Bulldogs,M. Weaver,3914014,,True,33.0,3,9,3,5,0,4,2,2,1,2,3,3,1,0,3,5,8
400995756,Butler Bulldogs,W. Jennings,3142145,,True,40.0,9,21,4,11,5,10,3,3,1,1,2,5,3,0,1,4,26
400995756,Butler Bulldogs,I. Lathan,3079485,,True,15.0,3,6,3,6,0,0,1,1,0,3,3,1,0,0,1,1,7
400995756,Butler Bulldogs,K. Hodges,4068065,,False,10.0,0,0,0,0,0,0,2,2,3,1,4,0,0,0,0,2,2
400995756,Butler Bulldogs,S. Shelton,4068069,,False,18.0,2,7,0,0,2,7,0,0,0,3,3,0,0,0,2,2,6
400995756,Butler Bulldogs,K. Spolyar,4068068,,False,19.0,5,11,2,5,3,6,0,0,0,1,1,0,2,0,3,4,13
400995756,Butler Bulldogs,S. Buck,3142279,,False,7.0,0,3,0,0,0,3,0,0,0,1,1,0,0,0,0,0,0
400995756,Butler Bulldogs,TEAM,TOTAL,TOTAL,False,,25,66,15,36,10,30,15,17,14,22,36,13,10,1,18,24,75
400995756,Ball State Cardinals,A. Walker,4068945,,True,14.0,1,2,1,2,0,0,0,0,2,3,5,3,1,0,0,4,2
400995756,Ball State Cardinals,M. Monaco,3143859,,True,39.0,8,13,6,10,2,3,5,8,1,1,2,3,0,2,2,3,23
400995756,Ball State Cardinals,C. Grande,3907651,,True,40.0,3,10,3,9,0,1,9,10,0,6,6,9,3,2,10,2,15
400995756,Ball State Cardinals,J. Samz,3906746,,True,36.0,4,9,1,4,3,5,4,4,0,3,3,2,1,2,0,2,15
400995756,Ball State Cardinals,F. Frazier,3143858,,True,37.0,6,11,5,9,1,2,4,4,1,5,6,2,4,2,2,2,17
400995756,Ball State Cardinals,O. Brown,4282023,,False,26.0,2,6,2,6,0,0,2,2,1,9,10,1,0,1,0,3,6
400995756,Ball State Cardinals,M. Howard-Bass,4282021,,False,8.0,3,4,0,0,3,4,0,0,1,1,2,2,0,0,2,1,9
400995756,Ball State Cardinals,TEAM,TOTAL,TOTAL,False,,27,55,18,40,9,15,24,28,8,29,37,22,9,9,16,17,87
400995755,Yale Bulldogs,E. Andrews,4281400,,True,25.0,4,8,4,4,0,4,0,1,1,0,1,1,2,0,1,2,8
400995755,Yale Bulldogs,J. Berkowitz,3142628,,True,40.0,2,10,2,8,0,2,1,2,3,6,9,1,0,1,1,0,5
400995755,Yale Bulldogs,M. Gorman,4068603,,True,32.0,2,6,2,6,0,0,1,3,2,4,6,0,0,0,3,2,5
400995755,Yale Bulldogs,R. Barahman,4068604,,True,34.0,5,13,4,8,1,5,2,4,3,1,4,3,3,0,3,1,13
400995755,Yale Bulldogs,T. Simpson,3142631,,True,40.0,7,17,4,9,3,8,0,0,0,1,1,2,9,0,2,1,17
400995755,Yale Bulldogs,B. Davies,4068605,,False,6.0,0,0,0,0,0,0,0,0,0,0,0,0,0,1,0,1,0
400995755,Yale Bulldogs,A. Maund,3911785,,False,2.0,0,1,0,1,0,0,0,0,0,1,1,0,0,0,1,1,0
400995755,Yale Bulldogs,G. Nelson,3911786,,False,6.0,1,2,0,0,1,2,0,0,0,1,1,0,0,0,1,0,3
400995755,Yale Bulldogs,M. Santucci,3142630,,False,15.0,0,1,0,0,0,1,0,0,0,1,1,0,0,0,1,5,0
400995755,Yale Bulldogs,TEAM,TOTAL,TOTAL,False,,21,58,16,36,5,22,4,10,11,17,28,7,14,2,13,13,51
400995755,Providence Friars,B. Frias,3142302,,True,11.0,0,1,0,1,0,0,0,0,0,1,1,0,0,0,1,2,0
400995755,Providence Friars,J. Nogic,3906769,,True,35.0,5,11,2,2,3,9,5,5,0,6,6,5,3,0,4,1,18
400995755,Providence Friars,M. Jolin,3906767,,True,22.0,4,6,2,2,2,4,0,0,0,7,7,1,1,0,5,0,10
400995755,Providence Friars,C. Che,3906766,,True,30.0,2,3,0,1,2,2,1,2,0,3,3,1,0,0,3,2,7
400995755,Providence Friars,A. Botteghi,3142301,,True,18.0,0,3,0,2,0,1,0,0,1,2,3,2,0,0,0,1,0
400995755,Providence Friars,A. Cooper,4281349,,False,25.0,2,2,2,2,0,0,0,0,1,1,2,0,0,0,0,2,4
400995755,Providence Friars,N. Franklin,4281348,,False,27.0,6,9,6,9,0,0,0,0,2,1,3,0,0,0,4,3,12
400995755,Providence Friars,C. Williams,4281345,,False,17.0,1,3,1,3,0,0,0,0,0,2,2,5,1,0,3,1,2
400995755,Providence Friars,N. Jackson,4068111,,False,15.0,1,2,1,2,0,0,0,0,0,4,4,2,0,0,2,1,2
400995755,Providence Friars,TEAM,TOTAL,TOTAL,False,,21,40,14,24,7,16,6,7,4,30,34,16,5,0,23,13,55
400995754,Marquette Golden Eagles,E. Davenport,3906756,,True,19.0,6,7,6,7,0,0,2,4,2,2,4,0,0,0,1,0,14
400995754,Marquette Golden Eagles,L. Van Kleunen,4068083,,True,12.0,3,6,2,5,1,1,0,0,1,1,2,0,0,0,0,1,7
400995754,Marquette Golden Eagles,A. Blockton,3906755,,True,18.0,4,8,2,5,2,3,3,3,1,1,2,5,1,0,3,0,13
400995754,Marquette Golden Eagles,N. Hiedeman,3906753,,True,21.0,2,6,2,3,0,3,0,0,1,4,5,7,2,1,3,1,4
400995754,Marquette Golden Eagles,D. King,3906752,,True,18.0,6,8,5,5,1,3,0,0,0,3,3,1,2,0,0,0,13
400995754,Marquette Golden Eagles,M. Smith Traore,4281351,,False,15.0,1,1,1,1,0,0,1,2,1,3,4,1,0,0,1,3,3
400995754,Marquette Golden Eagles,A. Anderson,4068081,,False,16.0,1,2,1,2,0,0,0,0,3,3,6,0,3,1,2,2,2
400995754,Marquette Golden Eagles,S. Dahling,3906754,,False,15.0,2,2,0,0,2,2,0,0,1,1,2,0,0,0,0,0,6
400995754,Marquette Golden Eagles,S. Valentine,3142300,,False,13.0,1,5,1,5,0,0,0,0,1,2,3,0,1,0,1,1,2
400995754,Marquette Golden Eagles,S. Lott,4281350,,False,12.0,1,1,1,1,0,0,2,2,0,1,1,1,3,0,2,1,4
400995754,Marquette Golden Eagles,I. Spingola,4068082,,False,13.0,2,7,1,1,1,6,0,0,1,1,2,0,0,0,1,0,5
400995754,Marquette Golden Eagles,A. Wilborn,3906758,,False,21.0,7,10,7,9,0,1,5,7,1,8,9,2,3,0,1,2,19
400995754,Marquette Golden Eagles,O. Moskari,3906757,,False,7.0,0,0,0,0,0,0,0,0,0,0,0,1,0,0,0,0,0
400995754,Marquette Golden Eagles,TEAM,TOTAL,TOTAL,False,,36,63,29,44,7,19,13,18,13,31,44,18,15,2,15,11,92
400995754,Loyola Chicago Ramblers,A. O'Connor,4282263,,True,34.0,4,10,3,8,1,2,2,2,4,1,5,0,2,0,0,2,11
400995754,Loyola Chicago Ramblers,K. Strawbridge,4282264,,True,31.0,0,6,0,1,0,5,0,0,0,2,2,1,0,0,9,3,0
400995754,Loyola Chicago Ramblers,A. Meyer,4282262,,True,8.0,0,2,0,2,0,0,0,0,0,0,0,0,0,0,1,0,0
400995754,Loyola Chicago Ramblers,T. Wallace,4068629,,True,23.0,1,3,1,1,0,2,0,0,0,1,1,2,0,0,4,1,2
400995754,Loyola Chicago Ramblers,L. Segars,4068628,,True,28.0,0,6,0,4,0,2,0,0,1,2,3,0,0,0,3,4,0
400995754,Loyola Chicago Ramblers,K. Nolan,4282265,,False,19.0,2,6,2,5,0,1,0,0,1,3,4,1,0,1,0,3,4
400995754,Loyola Chicago Ramblers,E. Rice,4282261,,False,11.0,0,2,0,1,0,1,1,2,0,2,2,0,0,0,3,1,1
400995754,Loyola Chicago Ramblers,B. Segars,3907700,,False,2.0,0,0,0,0,0,0,0,0,0,0,0,0,0,0,0,1,0
400995754,Loyola Chicago Ramblers,C. Negatu,3907699,,False,2.0,0,1,0,0,0,1,0,0,0,0,0,0,0,0,0,0,0
400995754,Loyola Chicago Ramblers,K. Salmon,3142804,,False,16.0,0,3,0,1,0,2,3,4,1,2,3,1,1,0,1,1,3
400995754,Loyola Chicago Ramblers,J. Cerda,3065188,,False,26.0,3,10,0,1,3,9,0,0,0,0,0,1,1,0,1,2,9
400995754,Loyola Chicago Ramblers,TEAM,TOTAL,TOTAL,False,,10,49,6,24,4,25,6,8,8,16,24,6,4,1,26,18,30
400995753,Georgetown Hoyas,C. Petke,4068078,,True,38.0,3,7,3,7,0,0,2,4,6,5,11,0,1,1,1,1,8
400995753,Georgetown Hoyas,Y. Belk,3142295,,True,25.0,4,7,4,7,0,0,0,0,4,6,10,0,0,0,0,1,8
400995753,Georgetown Hoyas,D. White,3948815,,True,38.0,6,21,6,18,0,3,0,0,2,2,4,0,2,0,3,1,12
400995753,Georgetown Hoyas,D. Burton,3142292,,True,28.0,0,3,0,2,0,1,0,0,1,1,2,0,2,0,1,1,0
400995753,Georgetown Hoyas,M. Venson,3142105,,True,29.0,2,7,2,6,0,1,1,2,0,1,1,1,0,0,3,2,5
400995753,Georgetown Hoyas,T. Thompson,4281352,,False,18.0,2,9,2,7,0,2,2,4,1,1,2,0,1,0,0,1,6
400995753,Georgetown Hoyas,M. Smith,4068079,,False,24.0,0,3,0,3,0,0,2,4,2,0,2,1,1,0,0,2,2
400995753,Georgetown Hoyas,TEAM,TOTAL,TOTAL,False,,17,57,17,50,0,7,7,14,17,17,34,2,7,1,9,9,41
400995753,Chattanooga Mocs,A. Whitaker,3906823,,True,25.0,2,5,2,5,0,0,1,2,0,7,7,1,0,0,1,1,5
400995753,Chattanooga Mocs,L. Bouldin,4068925,,True,33.0,5,9,1,3,4,6,0,0,0,3,3,1,0,0,2,1,14
400995753,Chattanooga Mocs,M. Melton,3924933,,True,40.0,1,2,0,1,1,1,0,0,0,3,3,8,1,0,2,1,3
400995753,Chattanooga Mocs,K. Gilbert,3144001,,True,39.0,7,11,6,8,1,3,2,2,1,6,7,1,0,0,3,3,17
400995753,Chattanooga Mocs,A. Gilbert,3079487,,True,31.0,4,10,1,4,3,6,2,2,1,2,3,2,0,1,2,1,13
400995753,Chattanooga Mocs,A. Wert,3144002,,False,12.0,1,3,1,3,0,0,0,0,0,4,4,0,0,3,2,1,2
400995753,Chattanooga Mocs,B. Dial,4281017,,False,6.0,0,0,0,0,0,0,0,0,0,0,0,0,0,0,0,1,0
400995753,Chattanooga Mocs,S. Davenport,3141994,,False,6.0,0,0,0,0,0,0,0,0,0,0,0,0,0,0,1,3,0
400995753,Chattanooga Mocs,R. Lee,4281019,,False,2.0,0,0,0,0,0,0,0,0,1,0,1,0,0,0,0,2,0
400995753,Chattanooga Mocs,J. Lynn,4281016,,False,2.0,0,1,0,1,0,0,0,0,0,0,0,0,0,0,0,0,0
400995753,Chattanooga Mocs,M. Long,4281015,,False,4.0,0,1,0,1,0,0,0,0,0,0,0,1,0,0,0,0,0
400995753,Chattanooga Mocs,TEAM,TOTAL,TOTAL,False,,20,42,11,26,9,16,5,6,4,27,31,14,1,4,17,14,54
400995752,Drexel Dragons,B. Greenberg,4068314,,True,34.0,6,12,5,10,1,2,2,2,3,1,4,1,0,0,0,1,15
400995752,Drexel Dragons,K. Lidge,3143242,,True,35.0,4,8,0,0,4,8,0,0,2,2,4,3,2,0,3,4,12
400995752,Drexel Dragons,A. Brown,3943744,,True,33.0,2,10,1,6,1,4,1,2,2,3,5,9,0,1,4,0,6
400995752,Drexel Dragons,M. Marecic,3143241,,True,17.0,5,8,2,2,3,6,2,2,0,3,3,1,2,0,1,4,15
400995752,Drexel Dragons,S. Woods,3143240,,True,36.0,5,12,5,12,0,0,4,4,2,0,2,3,0,1,0,2,14
400995752,Drexel Dragons,N. Metzel,4068315,,False,8.0,1,2,1,2,0,0,0,0,2,0,2,0,0,0,0,0,2
400995752,Drexel Dragons,E. Maesschalck,3943743,,False,2.0,0,0,0,0,0,0,0,0,0,0,0,0,0,0,0,0,0
400995752,Drexel Dragons,T. Kracikova,3943745,,False,5.0,0,0,0,0,0,0,0,0,0,0,0,0,0,0,0,3,0
400995752,Drexel Dragons,H. Nihill,4281431,,False,26.0,4,6,2,3,2,3,0,0,0,2,2,2,1,0,0,3,10
400995752,Drexel Dragons,A. Ferariu,4068317,,False,4.0,1,1,1,1,0,0,0,0,0,1,1,1,0,0,0,0,2
400995752,Drexel Dragons,TEAM,TOTAL,TOTAL,False,,28,59,17,36,11,23,9,10,12,17,29,20,5,2,8,17,76
400995752,Butler Bulldogs,T. Schickel,3914012,,True,39.0,3,7,3,7,0,0,4,4,7,4,11,2,0,0,2,2,10
400995752,Butler Bulldogs,K. Spolyar,4068068,,True,27.0,1,5,1,4,0,1,0,0,0,1,1,2,0,0,3,4,2
400995752,Butler Bulldogs,M. Weaver,3914014,,True,23.0,2,4,2,3,0,1,0,0,0,3,3,3,1,0,6,4,4
400995752,Butler Bulldogs,W. Jennings,3142145,,True,39.0,12,20,10,15,2,5,2,2,0,0,0,1,1,0,2,1,28
400995752,Butler Bulldogs,I. Lathan,3079485,,True,20.0,2,7,2,7,0,0,1,1,1,4,5,1,0,0,0,3,5
400995752,Butler Bulldogs,S. Brey,4068067,,False,29.0,3,3,2,2,1,1,0,0,1,5,6,3,1,1,1,1,7
400995752,Butler Bulldogs,K. Hodges,4068065,,False,3.0,0,0,0,0,0,0,0,0,0,0,0,0,0,0,0,1,0
400995752,Butler Bulldogs,S. Humphrey,4068066,,False,1.0,0,1,0,1,0,0,0,0,0,0,0,0,0,0,0,0,0
400995752,Butler Bulldogs,S. Shelton,4068069,,False,5.0,0,2,0,0,0,2,1,2,0,0,0,0,0,0,0,0,1
400995752,Butler Bulldogs,T. Buford,3914011,,False,1.0,0,0,0,0,0,0,0,0,0,0,0,0,0,0,0,0,0
400995752,Butler Bulldogs,S. Buck,3142279,,False,13.0,2,3,1,1,1,2,0,0,0,0,0,0,1,0,0,1,5
400995752,Butler Bulldogs,TEAM,TOTAL,TOTAL,False,,25,52,21,40,4,12,8,9,10,18,28,12,4,1,15,17,62
400995751,Seton Hall Pirates,S. Samuels,4068128,,True,17.0,2,4,2,4,0,0,2,4,0,5,5,0,1,0,2,2,6
400995751,Seton Hall Pirates,T. Brown,3941336,,True,20.0,4,7,4,7,0,0,3,4,0,5,5,3,2,0,5,1,11
400995751,Seton Hall Pirates,D. Fountain,3058890,,True,19.0,6,10,3,5,3,5,5,5,1,4,5,1,0,0,1,1,20
400995751,Seton Hall Pirates,N. Jimenez,4281379,,True,22.0,0,5,0,1,0,4,0,0,1,1,2,6,2,0,4,4,0
400995751,Seton Hall Pirates,J. Jackson,3064877,,True,21.0,6,10,1,1,5,9,2,2,2,2,4,2,0,0,2,2,19
400995751,Seton Hall Pirates,S. Philoxy,4281380,,False,14.0,4,4,4,4,0,0,0,0,0,3,3,1,3,0,2,0,8
400995751,Seton Hall Pirates,K. Evans,4281378,,False,14.0,1,2,1,2,0,0,1,2,1,4,5,0,0,2,1,2,3
400995751,Seton Hall Pirates,J. Jones-Pack,4068129,,False,12.0,0,1,0,1,0,0,0,0,1,6,7,0,0,4,0,2,0
400995751,Seton Hall Pirates,D. Winters,4068126,,False,15.0,3,6,1,1,2,5,1,2,0,2,2,0,0,0,0,0,9
400995751,Seton Hall Pirates,I. Butina,4281377,,False,14.0,2,3,1,2,1,1,0,0,0,1,1,3,1,1,0,3,5
400995751,Seton Hall Pirates,T. Smith,4068124,,False,3.0,2,3,2,2,0,1,0,0,0,1,1,0,0,0,1,0,4
400995751,Seton Hall Pirates,K. Hilaire,4068123,,False,16.0,0,3,0,1,0,2,0,0,0,1,1,7,0,0,3,3,0
400995751,Seton Hall Pirates,K. Healy,3943704,,False,12.0,0,2,0,0,0,2,0,0,0,0,0,0,0,0,0,0,0
400995751,Seton Hall Pirates,TEAM,TOTAL,TOTAL,False,,30,60,19,31,11,29,14,19,10,35,45,23,9,7,21,20,85
400995751,Rider Broncs,A. Johnson,4282184,,True,11.0,1,2,1,2,0,0,3,4,1,2,3,0,1,0,0,4,5
400995751,Rider Broncs,L. Favre,4068888,,True,24.0,1,4,1,3,0,1,0,0,1,2,3,0,1,0,0,0,2
400995751,Rider Broncs,S. Johnson,4068890,,True,23.0,2,4,1,2,1,2,2,2,0,4,4,0,1,0,4,4,7
400995751,Rider Broncs,L. Posset,3916562,,True,26.0,2,6,1,3,1,3,3,4,0,1,1,0,1,0,2,1,8
400995751,Rider Broncs,K. Hoskova,3142726,,True,27.0,2,8,2,7,0,1,2,6,1,3,4,1,1,0,2,1,6
400995751,Rider Broncs,D. Moses,4282182,,False,8.0,0,0,0,0,0,0,0,0,1,0,1,1,0,0,0,0,0
400995751,Rider Broncs,T. Goodman,4068889,,False,17.0,1,10,1,9,0,1,0,0,3,1,4,0,0,1,2,1,2
400995751,Rider Broncs,A. Muwwakkil,4068891,,False,8.0,0,0,0,0,0,0,0,0,0,0,0,0,0,0,1,1,0
400995751,Rider Broncs,T. Jones,4282183,,False,14.0,0,5,0,3,0,2,2,2,0,2,2,0,1,0,4,0,2
400995751,Rider Broncs,J. Morris,4282181,,False,28.0,7,17,6,15,1,2,2,4,1,3,4,2,0,1,4,1,17
400995751,Rider Broncs,L. Stover,3916563,,False,14.0,0,1,0,0,0,1,0,0,0,0,0,0,0,0,1,0,0
400995751,Rider Broncs,TEAM,TOTAL,TOTAL,False,,16,57,13,44,3,13,14,22,11,23,34,4,6,2,20,13,49
400995750,Montana Lady Griz,J. Henderson,3911672,,True,36.0,2,4,2,4,0,0,2,6,1,7,8,2,2,2,0,2,6
400995750,Montana Lady Griz,M. Isaak,3057572,,True,15.0,2,3,2,3,0,0,0,0,0,0,0,0,0,2,0,3,4
400995750,Montana Lady Griz,M. Schoening,4068703,,True,22.0,4,7,3,4,1,3,2,2,0,2,2,2,0,0,2,0,11
400995750,Montana Lady Griz,M. Johnston,3911674,,True,39.0,4,12,1,6,3,6,0,0,1,4,5,4,0,0,3,0,11
400995750,Montana Lady Griz,S. Anderson,3142459,,True,19.0,4,9,4,5,0,4,0,0,0,0,0,2,0,0,1,2,8
400995750,Montana Lady Griz,E. Stockholm,4068704,,False,11.0,1,3,1,1,0,2,1,4,0,2,2,1,0,0,0,2,3
400995750,Montana Lady Griz,H. Nicholson,4068702,,False,18.0,4,13,4,13,0,0,2,2,0,4,4,1,2,0,0,0,10
400995750,Montana Lady Griz,N. Klick,4068701,,False,4.0,1,3,1,2,0,1,1,1,0,0,0,0,0,0,0,1,3
400995750,Montana Lady Griz,S. Stiles,4281645,,False,20.0,2,4,1,3,1,1,1,4,1,3,4,2,2,0,2,1,6
400995750,Montana Lady Griz,T. Goligoski,3911671,,False,16.0,2,5,2,4,0,1,2,2,0,1,1,0,0,0,3,2,6
400995750,Montana Lady Griz,TEAM,TOTAL,TOTAL,False,,26,63,21,45,5,18,11,21,7,25,32,14,6,4,12,13,68
400995750,Marquette Golden Eagles,E. Davenport,3906756,,True,20.0,6,8,6,8,0,0,1,4,2,3,5,0,0,0,1,3,13
400995750,Marquette Golden Eagles,L. Van Kleunen,4068083,,True,16.0,4,10,4,7,0,3,1,2,3,4,7,1,0,0,0,1,9
400995750,Marquette Golden Eagles,A. Blockton,3906755,,True,23.0,8,13,7,11,1,2,0,0,0,6,6,4,0,0,2,0,17
400995750,Marquette Golden Eagles,N. Hiedeman,3906753,,True,25.0,7,13,1,4,6,9,1,2,2,0,2,6,2,0,3,1,21
400995750,Marquette Golden Eagles,D. King,3906752,,True,20.0,1,6,0,4,1,2,1,2,1,2,3,1,1,0,1,4,4
400995750,Marquette Golden Eagles,M. Smith Traore,4281351,,False,10.0,1,3,1,3,0,0,0,0,0,1,1,0,0,1,0,3,2
400995750,Marquette Golden Eagles,A. Anderson,4068081,,False,11.0,0,0,0,0,0,0,0,0,1,3,4,1,1,1,1,1,0
400995750,Marquette Golden Eagles,S. Dahling,3906754,,False,6.0,0,0,0,0,0,0,0,0,0,0,0,2,0,0,0,0,0
400995750,Marquette Golden Eagles,S. Valentine,3142300,,False,7.0,0,0,0,0,0,0,0,0,1,2,3,1,0,0,2,1,0
400995750,Marquette Golden Eagles,S. Lott,4281350,,False,17.0,1,3,0,0,1,3,0,0,0,4,4,2,1,0,0,4,3
400995750,Marquette Golden Eagles,I. Spingola,4068082,,False,19.0,4,8,0,1,4,7,2,2,1,3,4,0,0,0,3,2,14
400995750,Marquette Golden Eagles,A. Wilborn,3906758,,False,23.0,2,5,2,5,0,0,0,1,0,2,2,7,0,1,2,2,4
400995750,Marquette Golden Eagles,O. Moskari,3906757,,False,3.0,0,0,0,0,0,0,0,0,0,0,0,0,0,0,0,0,0
400995750,Marquette Golden Eagles,TEAM,TOTAL,TOTAL,False,,34,69,21,43,13,26,6,13,13,30,43,25,5,3,15,22,87
400995749,Western Michigan Broncos,B. Mobley,3912647,,True,26.0,6,12,6,12,0,0,4,6,4,3,7,2,0,0,3,2,16
400995749,Western Michigan Broncos,J. Walker,3142621,,True,22.0,1,4,0,1,1,3,1,4,0,2,2,0,1,0,3,4,4
400995749,Western Michigan Broncos,M. Hill,3054117,,True,20.0,2,6,2,6,0,0,0,0,0,2,2,0,2,0,1,0,4
400995749,Western Michigan Broncos,D. Wimby,3912644,,True,24.0,3,11,3,10,0,1,1,1,1,2,3,1,0,0,2,2,7
400995749,Western Michigan Broncos,L. Brooks,3143990,,True,8.0,0,0,0,0,0,0,0,0,0,0,0,2,0,0,0,0,0
400995749,Western Michigan Broncos,E. VanZanten,4069162,,False,8.0,2,3,2,3,0,0,0,0,0,1,1,2,0,0,1,2,4
400995749,Western Michigan Broncos,L. Wool,4282155,,False,18.0,0,2,0,1,0,1,2,2,0,3,3,1,0,0,1,1,2
400995749,Western Michigan Broncos,M. Miller,3912646,,False,8.0,1,3,0,1,1,2,0,0,0,2,2,1,0,0,1,0,3
400995749,Western Michigan Broncos,J. Walker,4282154,,False,17.0,1,3,1,3,0,0,0,0,0,3,3,1,3,0,0,0,2
400995749,Western Michigan Broncos,N. Farkic,4282153,,False,6.0,1,5,1,3,0,2,0,0,3,0,3,0,0,0,1,0,2
400995749,Western Michigan Broncos,K. Brooks,4282152,,False,6.0,0,3,0,2,0,1,0,0,0,0,0,0,0,0,0,2,0
400995749,Western Michigan Broncos,K. Reed,4069161,,False,9.0,0,3,0,2,0,1,0,0,0,1,1,0,2,0,0,0,0
400995749,Western Michigan Broncos,L. McCane,3912645,,False,6.0,0,1,0,1,0,0,0,0,0,0,0,0,0,0,1,1,0
400995749,Western Michigan Broncos,A. Carlisle,3143989,,False,4.0,1,2,1,2,0,0,0,0,0,0,0,0,0,0,0,0,2
400995749,Western Michigan Broncos,N. Smith,3143988,,False,7.0,1,5,1,3,0,2,0,0,0,1,1,0,1,0,1,0,2
400995749,Western Michigan Broncos,A. Parks,3143987,,False,11.0,0,2,0,1,0,1,0,0,0,0,0,0,0,0,1,5,0
400995749,Western Michigan Broncos,TEAM,TOTAL,TOTAL,False,,19,65,17,51,2,14,8,13,12,23,35,10,9,0,16,19,48
400995749,St. John's Red Storm,M. Singleton,4068158,,True,31.0,5,10,5,10,0,0,2,4,3,10,13,4,2,0,1,2,12
400995749,St. John's Red Storm,A. Wellere,3906771,,True,33.0,7,12,5,8,2,4,0,0,0,5,5,1,0,1,3,2,16
400995749,St. John's Red Storm,A. Adams,4068157,,True,22.0,3,9,2,4,1,5,0,0,1,2,3,0,0,0,1,2,7
400995749,St. John's Red Storm,T. England,4068155,,True,23.0,4,6,4,6,0,0,5,5,0,2,2,3,0,0,3,2,13
400995749,St. John's Red Storm,A. Kebbe,4068154,,True,29.0,4,6,4,5,0,1,1,1,2,8,10,4,1,0,2,1,9
400995749,St. John's Red Storm,K. Charles,4281374,,False,16.0,0,3,0,3,0,0,2,4,3,4,7,0,1,1,4,3,2
400995749,St. John's Red Storm,Q. Hoppie,4281375,,False,28.0,5,11,3,5,2,6,1,2,0,2,2,2,2,2,2,2,13
400995749,St. John's Red Storm,S. Duncan,4068156,,False,6.0,0,0,0,0,0,0,2,2,0,0,0,0,0,0,1,0,2
400995749,St. John's Red Storm,T. Alexander,3142305,,False,12.0,1,2,1,2,0,0,0,0,0,1,1,0,1,0,0,1,2
400995749,St. John's Red Storm,TEAM,TOTAL,TOTAL,False,,29,59,24,43,5,16,13,18,11,36,47,14,7,4,17,15,76
400995748,Wright State Raiders,L. Smith,3142627,,True,29.0,6,11,6,11,0,0,3,6,9,1,10,0,0,0,0,5,15
400995748,Wright State Raiders,S. Simmons,3934411,,True,25.0,3,7,3,7,0,0,0,0,2,4,6,1,0,0,1,2,6
400995748,Wright State Raiders,C. Welch,3934409,,True,35.0,9,19,9,17,0,2,6,7,0,2,2,3,0,0,1,4,24
400995748,Wright State Raiders,M. Taylor,3934408,,True,32.0,5,11,4,8,1,3,1,1,1,1,2,3,0,0,2,3,12
400995748,Wright State Raiders,E. Vogelpohl,3934406,,True,38.0,2,8,1,4,1,4,2,2,3,5,8,1,2,0,1,2,7
400995748,Wright State Raiders,N. Sumpter,4282091,,False,8.0,0,1,0,1,0,0,0,0,1,1,2,0,1,0,0,4,0
400995748,Wright State Raiders,K. Adderton,4282090,,False,3.0,0,0,0,0,0,0,0,2,0,0,0,0,0,0,0,0,0
400995748,Wright State Raiders,D. Evans,4069036,,False,14.0,0,3,0,3,0,0,0,0,0,1,1,1,0,0,0,0,0
400995748,Wright State Raiders,T. Frierson,4282093,,False,3.0,2,2,2,2,0,0,1,1,0,0,0,0,0,0,0,1,5
400995748,Wright State Raiders,B. Lloyd,4282092,,False,8.0,0,1,0,1,0,0,0,0,0,0,0,0,0,0,1,2,0
400995748,Wright State Raiders,J. Beck,4069035,,False,5.0,0,1,0,1,0,0,0,0,0,2,2,0,0,0,1,0,0
400995748,Wright State Raiders,TEAM,TOTAL,TOTAL,False,,27,64,25,55,2,9,13,19,18,18,36,9,3,0,9,23,69
400995748,Providence Friars,B. Frias,3142302,,True,8.0,0,0,0,0,0,0,2,2,0,1,1,1,0,0,0,4,2
400995748,Providence Friars,J. Nogic,3906769,,True,33.0,7,13,2,6,5,7,7,7,0,2,2,2,1,0,3,1,26
400995748,Providence Friars,M. Jolin,3906767,,True,35.0,4,9,0,1,4,8,4,4,0,5,5,3,2,0,2,2,16
400995748,Providence Friars,C. Che,3906766,,True,28.0,0,0,0,0,0,0,2,4,0,0,0,1,2,0,3,2,2
400995748,Providence Friars,A. Botteghi,3142301,,True,32.0,5,7,5,7,0,0,2,2,1,4,5,0,0,0,3,0,12
400995748,Providence Friars,A. Cooper,4281349,,False,7.0,0,0,0,0,0,0,0,2,0,1,1,0,0,0,1,4,0
400995748,Providence Friars,N. Franklin,4281348,,False,20.0,3,5,3,5,0,0,1,2,0,2,2,1,0,0,0,5,7
400995748,Providence Friars,C. Williams,4281345,,False,11.0,0,1,0,1,0,0,2,2,0,0,0,0,0,0,0,2,2
400995748,Providence Friars,N. Jackson,4068111,,False,26.0,1,2,1,2,0,0,5,6,1,3,4,2,1,0,1,1,7
400995748,Providence Friars,TEAM,TOTAL,TOTAL,False,,20,37,11,22,9,15,25,31,2,21,23,10,6,0,14,21,74
400995747,Savannah State Tigers,J. Bartlett,4282417,,True,18.0,1,4,1,3,0,1,4,4,0,3,3,0,2,0,0,5,6
400995747,Savannah State Tigers,D. Scott,4282416,,True,38.0,3,13,2,10,1,3,4,6,3,4,7,0,2,0,5,2,11
400995747,Savannah State Tigers,L. Mathis,4282411,,True,25.0,3,7,3,7,0,0,0,0,2,0,2,3,1,0,3,2,6
400995747,Savannah State Tigers,K. Allen,3917247,,True,26.0,1,9,1,4,0,5,2,2,1,2,3,0,0,0,2,2,4
400995747,Savannah State Tigers,K. Vance,4282420,,False,14.0,2,3,2,3,0,0,0,2,4,3,7,0,2,1,1,3,4
400995747,Savannah State Tigers,J. Gray,4282414,,False,3.0,0,1,0,1,0,0,0,0,1,0,1,0,0,0,1,1,0
400995747,Savannah State Tigers,A. Sowell,4282419,,False,23.0,0,2,0,2,0,0,0,8,4,6,10,0,0,0,1,1,0
400995747,Savannah State Tigers,N. Farmer,4282415,,False,24.0,3,7,1,2,2,5,0,2,1,0,1,0,1,1,0,1,8
400995747,Savannah State Tigers,H. Moton,4282412,,False,24.0,3,8,2,6,1,2,2,2,0,0,0,0,0,0,0,0,9
400995747,Savannah State Tigers,P. Russell,4070012,,False,5.0,0,1,0,1,0,0,0,0,0,1,1,0,0,0,2,0,0
400995747,Savannah State Tigers,TEAM,TOTAL,TOTAL,False,,16,55,12,39,4,16,12,26,16,20,36,3,8,2,15,17,48
400995747,Providence Friars,B. Frias,3142302,,True,19.0,0,0,0,0,0,0,0,0,0,0,0,0,0,1,1,2,0
400995747,Providence Friars,J. Nogic,3906769,,True,21.0,8,17,1,3,7,14,1,1,1,2,3,2,0,0,1,2,24
400995747,Providence Friars,M. Jolin,3906767,,True,21.0,5,7,2,2,3,5,0,0,1,4,5,3,1,0,3,3,13
400995747,Providence Friars,C. Che,3906766,,True,25.0,5,5,0,0,5,5,0,0,1,1,2,3,1,0,2,0,15
400995747,Providence Friars,A. Botteghi,3142301,,True,22.0,2,3,2,3,0,0,0,0,1,2,3,4,1,0,0,0,4
400995747,Providence Friars,A. Cooper,4281349,,False,24.0,2,3,2,3,0,0,0,0,1,2,3,2,1,0,2,3,4
400995747,Providence Friars,N. Franklin,4281348,,False,7.0,2,7,2,7,0,0,1,2,1,3,4,0,0,1,4,4,5
400995747,Providence Friars,O. Orlando,4281347,,False,8.0,1,1,1,1,0,0,0,0,1,0,1,0,0,0,0,2,2
400995747,Providence Friars,K. Spiwak,4281346,,False,14.0,1,4,1,3,0,1,0,0,1,1,2,0,2,0,0,0,2
400995747,Providence Friars,C. Williams,4281345,,False,17.0,2,7,2,7,0,0,1,1,0,2,2,3,2,0,1,2,5
400995747,Providence Friars,N. Jackson,4068111,,False,22.0,2,3,2,3,0,0,0,0,0,9,9,3,1,0,1,0,4
400995747,Providence Friars,TEAM,TOTAL,TOTAL,False,,30,57,15,32,15,25,3,4,8,30,38,20,9,2,15,18,78
400995746,Northern Iowa Panthers,M. Maahs,4068639,,True,31.0,5,13,5,11,0,2,5,6,3,11,14,1,0,1,1,5,15
400995746,Northern Iowa Panthers,H. Hillyard,3907721,,True,36.0,3,7,0,0,3,7,0,0,1,5,6,0,0,0,1,4,9
400995746,Northern Iowa Panthers,E. Howell,4282227,,True,47.0,6,14,5,13,1,1,3,4,1,2,3,3,3,0,3,2,16
400995746,Northern Iowa Panthers,M. Morgan,3907720,,True,46.0,3,8,2,5,1,3,3,3,0,3,3,1,2,0,2,4,10
400995746,Northern Iowa Panthers,K. Kirkpatrick,3067104,,True,42.0,3,8,3,6,0,2,5,6,0,3,3,9,0,0,2,4,11
400995746,Northern Iowa Panthers,B. Gunnels,4282228,,False,3.0,0,1,0,1,0,0,0,0,0,1,1,0,0,0,0,1,0
400995746,Northern Iowa Panthers,T. Hagen,3907722,,False,8.0,0,3,0,3,0,0,0,0,2,1,3,0,1,0,0,0,0
400995746,Northern Iowa Panthers,N. Kroeger,4282226,,False,6.0,1,1,0,0,1,1,1,2,0,1,1,0,1,0,2,0,4
400995746,Northern Iowa Panthers,K. Rucker,4282225,,False,12.0,3,6,2,4,1,2,0,0,1,1,2,1,0,0,3,1,7
400995746,Northern Iowa Panthers,A. Gerrits,4068638,,False,13.0,2,4,2,3,0,1,0,0,1,0,1,1,0,0,2,1,4
400995746,Northern Iowa Panthers,R. Simon-Ressler,3907719,,False,6.0,1,4,1,4,0,0,0,0,1,3,4,0,1,0,2,2,2
400995746,Northern Iowa Panthers,TEAM,TOTAL,TOTAL,False,,27,69,20,50,7,19,17,21,10,33,43,16,8,1,18,24,78
400995746,Creighton Bluejays,A. Faber,3938938,,True,47.0,8,19,6,12,2,7,11,12,2,6,8,4,0,3,4,2,29
400995746,Creighton Bluejays,A. Greene,3938937,,True,9.0,1,4,1,4,0,0,1,2,0,1,1,0,0,0,0,0,3
400995746,Creighton Bluejays,J. Agnew,3938935,,True,48.0,7,11,3,6,4,5,8,10,2,12,14,4,3,4,1,2,26
400995746,Creighton Bluejays,S. Lamberty,3142285,,True,49.0,4,11,3,9,1,2,2,2,0,8,8,9,1,0,5,2,11
400995746,Creighton Bluejays,M. Mellman,3142283,,True,25.0,0,1,0,0,0,1,2,2,1,0,1,0,2,1,1,2,2
400995746,Creighton Bluejays,K. Brown,3142286,,False,10.0,1,3,1,3,0,0,0,0,0,3,3,0,0,2,1,1,2
400995746,Creighton Bluejays,T. Carda,4281362,,False,27.0,1,7,1,4,0,3,0,0,0,2,2,0,0,0,0,3,2
400995746,Creighton Bluejays,T. Rembao,4281361,,False,29.0,5,7,5,6,0,1,4,7,3,2,5,2,3,0,2,5,14
400995746,Creighton Bluejays,B. Kissinger,3142124,,False,6.0,0,0,0,0,0,0,0,0,0,0,0,0,0,0,2,0,0
400995746,Creighton Bluejays,TEAM,TOTAL,TOTAL,False,,27,63,20,44,7,19,28,35,8,34,42,19,9,10,16,17,89
400995745,Marquette Golden Eagles,E. Davenport,3906756,,True,23.0,4,12,4,12,0,0,4,6,5,5,10,2,1,1,1,1,12
400995745,Marquette Golden Eagles,L. Van Kleunen,4068083,,True,26.0,5,7,3,3,2,4,0,0,1,6,7,1,1,1,0,3,12
400995745,Marquette Golden Eagles,A. Wilborn,3906758,,True,27.0,3,7,3,6,0,1,1,2,0,1,1,6,1,0,5,3,7
400995745,Marquette Golden Eagles,A. Blockton,3906755,,True,25.0,7,14,6,11,1,3,4,4,2,2,4,5,3,1,3,1,19
400995745,Marquette Golden Eagles,D. King,3906752,,True,33.0,5,11,3,8,2,3,1,1,0,2,2,7,4,0,3,2,13
400995745,Marquette Golden Eagles,M. Smith Traore,4281351,,False,12.0,1,2,1,1,0,1,1,1,0,4,4,0,0,0,1,3,3
400995745,Marquette Golden Eagles,A. Anderson,4068081,,False,17.0,1,2,1,1,0,1,2,2,0,4,4,2,1,2,0,2,4
400995745,Marquette Golden Eagles,S. Dahling,3906754,,False,9.0,0,0,0,0,0,0,0,0,1,0,1,0,0,0,0,0,0
400995745,Marquette Golden Eagles,S. Valentine,3142300,,False,4.0,0,1,0,1,0,0,0,0,1,0,1,0,1,0,0,1,0
400995745,Marquette Golden Eagles,I. Spingola,4068082,,False,19.0,5,11,3,5,2,6,1,1,0,0,0,0,0,0,0,1,13
400995745,Marquette Golden Eagles,O. Moskari,3906757,,False,5.0,0,1,0,0,0,1,0,0,0,0,0,0,0,0,0,0,0
400995745,Marquette Golden Eagles,TEAM,TOTAL,TOTAL,False,,31,68,24,48,7,20,14,17,13,27,40,23,12,5,13,17,83
400995745,Loyola Maryland Greyhounds,M. McDonald,3147112,,True,14.0,1,2,1,2,0,0,1,2,0,1,1,2,0,0,2,3,3
400995745,Loyola Maryland Greyhounds,M. Taylor,4068279,,True,17.0,2,5,1,2,1,3,1,1,1,0,1,0,0,0,1,0,6
400995745,Loyola Maryland Greyhounds,S. Karcz,4068277,,True,37.0,10,19,10,19,0,0,7,10,1,8,9,2,3,2,3,2,27
400995745,Loyola Maryland Greyhounds,A. Gray,4068275,,True,29.0,4,10,2,5,2,5,3,4,0,1,1,1,1,0,1,1,13
400995745,Loyola Maryland Greyhounds,C. Gelbaugh,3147111,,True,37.0,2,6,2,3,0,3,2,2,0,3,3,6,2,0,3,4,6
400995745,Loyola Maryland Greyhounds,D. Connolly,4281013,,False,18.0,2,6,2,6,0,0,0,0,2,4,6,2,0,1,2,1,4
400995745,Loyola Maryland Greyhounds,C. Jakaitis,4068276,,False,7.0,1,1,1,1,0,0,0,0,0,0,0,0,0,0,0,1,2
400995745,Loyola Maryland Greyhounds,C. Vannoy,3907775,,False,15.0,1,2,1,2,0,0,0,0,0,1,1,1,1,0,2,1,2
400995745,Loyola Maryland Greyhounds,M. Kilcullen,3907774,,False,5.0,0,1,0,0,0,1,0,0,0,1,1,0,0,0,0,0,0
400995745,Loyola Maryland Greyhounds,A. Omdahl,3907771,,False,21.0,0,1,0,1,0,0,0,0,0,2,2,0,0,0,1,2,0
400995745,Loyola Maryland Greyhounds,TEAM,TOTAL,TOTAL,False,,23,53,20,41,3,12,14,19,5,23,28,14,7,3,18,15,63
400995744,Georgetown Hoyas,C. Petke,4068078,,True,40.0,4,11,1,4,3,7,3,4,6,10,16,1,0,0,3,1,14
400995744,Georgetown Hoyas,Y. Belk,3142295,,True,25.0,4,7,4,7,0,0,2,2,2,1,3,0,0,5,1,1,10
400995744,Georgetown Hoyas,D. White,3948815,,True,35.0,5,16,4,11,1,5,0,0,3,5,8,4,2,3,5,2,11
400995744,Georgetown Hoyas,D. Burton,3142292,,True,24.0,1,3,1,2,0,1,0,0,1,2,3,4,0,0,3,5,2
400995744,Georgetown Hoyas,M. Venson,3142105,,True,37.0,2,8,0,1,2,7,2,2,0,4,4,3,2,0,3,1,8
400995744,Georgetown Hoyas,T. Thompson,4281352,,False,18.0,1,8,1,5,0,3,0,0,0,0,0,1,0,0,1,1,2
400995744,Georgetown Hoyas,M. Smith,4068079,,False,21.0,3,5,3,5,0,0,1,3,1,0,1,0,0,0,0,1,7
400995744,Georgetown Hoyas,TEAM,TOTAL,TOTAL,False,,20,58,14,35,6,23,8,11,15,23,38,13,4,8,17,12,54
400995744,George Washington Revolutionaries,N. Luma,4281482,,True,24.0,5,9,5,9,0,0,1,1,3,5,8,1,1,0,2,3,11
400995744,George Washington Revolutionaries,K. Prange,3142380,,True,25.0,4,9,3,6,1,3,1,2,1,5,6,2,0,0,2,2,10
400995744,George Washington Revolutionaries,M. Bautista,3906454,,True,30.0,2,8,0,3,2,5,0,0,0,1,1,4,3,0,1,1,6
400995744,George Washington Revolutionaries,B. Cummings,3142381,,True,37.0,3,8,3,8,0,0,4,4,3,5,8,2,2,1,2,2,10
400995744,George Washington Revolutionaries,C. Tapias,3142377,,True,25.0,3,4,2,3,1,1,0,0,1,0,1,2,1,0,1,1,7
400995744,George Washington Revolutionaries,K. Mahoney,3906453,,False,20.0,5,12,4,6,1,6,0,0,1,1,2,1,0,1,3,1,11
400995744,George Washington Revolutionaries,L. Levy,4281481,,False,16.0,2,4,0,0,2,4,2,2,0,0,0,2,1,0,0,1,8
400995744,George Washington Revolutionaries,K. Bresee,4068556,,False,19.0,0,5,0,4,0,1,2,2,1,4,5,3,0,0,0,0,2
400995744,George Washington Revolutionaries,T. Campbell,3143305,,False,4.0,0,0,0,0,0,0,0,0,0,2,2,0,0,0,0,0,0
400995744,George Washington Revolutionaries,TEAM,TOTAL,TOTAL,False,,24,59,17,39,7,20,10,11,12,24,36,17,8,2,13,11,65
400995742,William & Mary Tribe,L. Underwood,4281492,,True,10.0,2,2,1,1,1,1,0,0,0,0,0,0,0,0,2,1,5
400995742,William & Mary Tribe,M. Jones,3907016,,True,9.0,0,1,0,0,0,1,2,2,0,1,1,1,0,0,0,3,2
400995742,William & Mary Tribe,B. Boggs,3907014,,True,30.0,4,10,3,8,1,2,6,6,1,3,4,3,4,1,5,4,15
400995742,William & Mary Tribe,V. Reynolds,4068386,,False,35.0,4,11,4,10,0,1,0,0,2,8,10,1,5,1,4,2,8
400995742,William & Mary Tribe,G. Rogers,4281496,,False,9.0,2,3,2,3,0,0,0,0,0,2,2,0,0,0,0,1,4
400995742,William & Mary Tribe,C. Smith,3907017,,False,1.0,0,0,0,0,0,0,0,0,0,0,0,0,0,0,0,0,0
400995742,William & Mary Tribe,A. Rendle,3143268,,False,30.0,7,13,7,13,0,0,8,9,3,2,5,1,1,5,2,3,22
400995742,William & Mary Tribe,N. Pollard,4281493,,False,33.0,3,6,2,5,1,1,2,2,0,3,3,2,0,0,5,3,9
400995742,William & Mary Tribe,N. Garner,4068384,,False,8.0,2,4,1,2,1,2,1,2,1,2,3,0,1,0,0,0,6
400995742,William & Mary Tribe,J. Green,3143267,,False,35.0,5,7,5,6,0,1,0,0,0,2,2,7,0,0,3,3,10
400995742,William & Mary Tribe,TEAM,TOTAL,TOTAL,False,,29,57,25,48,4,9,19,21,9,26,35,15,11,7,21,20,81
400995742,St. John's Red Storm,K. Charles,4281374,,True,2.0,0,0,0,0,0,0,0,0,0,0,0,0,0,0,0,0,0
400995742,St. John's Red Storm,T. England,4068155,,True,33.0,5,13,5,10,0,3,1,3,0,0,0,4,1,0,1,1,11
400995742,St. John's Red Storm,A. Kebbe,4068154,,True,24.0,3,5,1,3,2,2,2,2,0,0,0,2,0,0,1,2,10
400995742,St. John's Red Storm,M. Singleton,4068158,,False,30.0,5,9,5,9,0,0,2,2,4,9,13,4,3,3,2,5,12
400995742,St. John's Red Storm,I. Littleton,3142306,,False,24.0,3,8,3,8,0,0,2,3,1,3,4,0,1,0,0,4,8
400995742,St. John's Red Storm,A. Wellere,3906771,,False,36.0,6,12,5,9,1,3,8,8,1,3,4,6,1,0,6,1,21
400995742,St. John's Red Storm,Q. Hoppie,4281375,,False,27.0,8,13,4,8,4,5,1,2,1,0,1,0,2,0,2,2,21
400995742,St. John's Red Storm,A. Adams,4068157,,False,24.0,3,6,0,2,3,4,0,0,0,2,2,2,0,0,2,2,9
400995742,St. John's Red Storm,TEAM,TOTAL,TOTAL,False,,33,66,23,49,10,17,16,20,10,19,29,18,8,3,14,17,92
400995741,Delaware State Hornets,A. Sharpe,4069278,,True,20.0,1,5,1,5,0,0,2,2,3,5,8,1,1,0,3,4,4
400995741,Delaware State Hornets,N. Pollard,3934341,,True,32.0,10,16,10,16,0,0,7,7,3,7,10,0,0,1,3,2,27
400995741,Delaware State Hornets,R. Jones,4282246,,True,29.0,4,11,4,8,0,3,7,9,1,3,4,4,1,0,4,1,15
400995741,Delaware State Hornets,K. Barber,4282241,,True,24.0,0,4,0,2,0,2,0,0,2,3,5,0,0,0,2,4,0
400995741,Delaware State Hornets,L. Ashe,4069275,,True,28.0,2,9,1,7,1,2,0,0,1,3,4,5,2,0,6,2,5
400995741,Delaware State Hornets,A. Jackson,4282245,,False,15.0,6,7,6,7,0,0,0,0,1,4,5,0,1,0,1,1,12
400995741,Delaware State Hornets,A. Bonefont,4282243,,False,7.0,0,0,0,0,0,0,0,0,0,0,0,0,0,0,0,0,0
400995741,Delaware State Hornets,K. Abrams,4069273,,False,18.0,0,3,0,1,0,2,1,2,0,2,2,0,1,0,4,0,1
400995741,Delaware State Hornets,S. Williams,4282249,,False,8.0,3,4,3,4,0,0,1,1,1,0,1,0,0,0,3,3,7
400995741,Delaware State Hornets,R. Tucker,4282247,,False,7.0,0,2,0,1,0,1,0,0,0,0,0,0,0,0,0,0,0
400995741,Delaware State Hornets,N. Carroll-Jackson,4282244,,False,9.0,0,2,0,2,0,0,0,0,0,0,0,0,1,0,3,0,0
400995741,Delaware State Hornets,G. Addison,4069274,,False,3.0,0,0,0,0,0,0,0,0,0,0,0,0,0,0,0,0,0
400995741,Delaware State Hornets,TEAM,TOTAL,TOTAL,False,,26,63,25,53,1,10,18,21,13,31,44,10,7,1,30,17,71
400995741,DePaul Blue Demons,M. Grays,3142287,,True,15.0,4,7,3,4,1,3,2,2,1,1,2,2,0,1,2,4,11
400995741,DePaul Blue Demons,K. Campbell,4068071,,True,15.0,2,4,1,1,1,3,0,0,2,4,6,5,0,1,1,2,5
400995741,DePaul Blue Demons,T. Allen,3933760,,True,22.0,4,12,2,4,2,8,4,4,1,3,4,2,0,0,2,2,14
400995741,DePaul Blue Demons,A. Millender,3142289,,True,15.0,10,12,3,3,7,9,0,0,3,0,3,1,0,0,1,0,27
400995741,DePaul Blue Demons,A. Coleman,3142123,,True,15.0,2,6,1,3,1,3,1,4,2,4,6,7,2,0,1,3,6
400995741,DePaul Blue Demons,R. McLimore,4281358,,False,20.0,5,10,4,7,1,3,2,2,2,1,3,3,4,0,0,1,13
400995741,DePaul Blue Demons,C. Stonewall,4068072,,False,13.0,6,6,4,4,2,2,0,2,0,2,2,1,3,0,0,1,14
400995741,DePaul Blue Demons,V. Sherrod,4281359,,False,19.0,1,8,1,1,0,7,0,0,0,2,2,3,4,0,2,4,2
400995741,DePaul Blue Demons,D. Bekelja,4281356,,False,23.0,4,10,4,6,0,4,6,7,4,3,7,2,2,0,1,2,14
400995741,DePaul Blue Demons,C. McMahon,4068074,,False,13.0,0,4,0,1,0,3,0,0,1,0,1,2,0,2,0,3,0
400995741,DePaul Blue Demons,D. Cage,4068073,,False,14.0,2,9,2,4,0,5,0,0,1,0,1,4,0,0,1,0,4
400995741,DePaul Blue Demons,L. Prochaska,3142290,,False,16.0,0,3,0,0,0,3,0,0,0,1,1,4,2,0,0,0,0
400995741,DePaul Blue Demons,TEAM,TOTAL,TOTAL,False,,40,91,25,38,15,53,15,21,21,23,44,36,17,4,11,22,110
400995740,Loyola Maryland Greyhounds,S. Karcz,4068277,,True,27.0,6,10,6,9,0,1,5,10,0,5,5,1,2,0,4,4,17
400995740,Loyola Maryland Greyhounds,M. Taylor,4068279,,True,24.0,3,7,2,3,1,4,0,0,0,0,0,2,0,0,0,1,7
400995740,Loyola Maryland Greyhounds,A. Gray,4068275,,True,40.0,3,12,1,5,2,7,0,0,1,1,2,3,1,0,3,1,8
400995740,Loyola Maryland Greyhounds,M. McDonald,3147112,,True,16.0,1,3,1,3,0,0,0,0,4,4,8,1,0,1,0,4,2
400995740,Loyola Maryland Greyhounds,C. Gelbaugh,3147111,,True,35.0,6,12,5,8,1,4,0,0,1,1,2,4,1,0,4,1,13
400995740,Loyola Maryland Greyhounds,D. Connolly,4281013,,False,16.0,2,5,1,3,1,2,0,0,1,7,8,0,0,1,2,2,5
400995740,Loyola Maryland Greyhounds,C. Jakaitis,4068276,,False,6.0,0,0,0,0,0,0,0,0,0,0,0,0,0,0,1,0,0
400995740,Loyola Maryland Greyhounds,C. Vannoy,3907775,,False,12.0,1,7,1,7,0,0,0,0,0,3,3,0,0,0,1,2,2
400995740,Loyola Maryland Greyhounds,A. Hunter,3907772,,False,5.0,0,0,0,0,0,0,0,0,1,2,3,0,0,0,0,0,0
400995740,Loyola Maryland Greyhounds,H. Niles,4068278,,False,2.0,0,0,0,0,0,0,0,0,0,0,0,0,0,0,0,0,0
400995740,Loyola Maryland Greyhounds,A. Barazotti,3907773,,False,1.0,0,0,0,0,0,0,0,0,0,0,0,0,0,0,0,0,0
400995740,Loyola Maryland Greyhounds,A. Omdahl,3907771,,False,16.0,0,3,0,3,0,0,0,0,1,2,3,2,0,0,1,1,0
400995740,Loyola Maryland Greyhounds,TEAM,TOTAL,TOTAL,False,,22,59,17,41,5,18,5,10,9,28,37,13,4,2,16,16,54
400995740,Georgetown Hoyas,C. Petke,4068078,,True,34.0,7,10,6,9,1,1,2,5,3,10,13,1,1,0,2,3,17
400995740,Georgetown Hoyas,Y. Belk,3142295,,True,15.0,0,5,0,5,0,0,2,2,5,2,7,1,0,2,1,1,2
400995740,Georgetown Hoyas,D. White,3948815,,True,40.0,9,21,7,13,2,8,3,5,3,4,7,2,5,0,3,2,23
400995740,Georgetown Hoyas,D. Burton,3142292,,True,27.0,1,9,1,7,0,2,0,0,1,1,2,5,2,0,2,0,2
400995740,Georgetown Hoyas,M. Venson,3142105,,True,38.0,7,14,3,7,4,7,2,2,0,7,7,2,1,0,2,3,20
400995740,Georgetown Hoyas,T. Thompson,4281352,,False,19.0,2,5,0,2,2,3,0,2,1,2,3,0,0,0,0,2,6
400995740,Georgetown Hoyas,M. Smith,4068079,,False,27.0,1,4,1,4,0,0,0,2,3,1,4,0,0,0,2,3,2
400995740,Georgetown Hoyas,TEAM,TOTAL,TOTAL,False,,27,68,18,47,9,21,9,18,17,28,45,11,9,2,12,14,72
400995739,Seton Hall Pirates,S. Samuels,4068128,,True,20.0,1,5,1,4,0,1,4,4,2,3,5,1,1,0,0,5,6
400995739,Seton Hall Pirates,T. Brown,3941336,,True,31.0,3,12,3,12,0,0,7,8,7,4,11,1,1,0,2,4,13
400995739,Seton Hall Pirates,D. Fountain,3058890,,True,31.0,6,20,6,14,0,6,9,10,4,5,9,0,3,0,4,3,21
400995739,Seton Hall Pirates,N. Jimenez,4281379,,True,12.0,1,1,1,1,0,0,0,0,0,0,0,1,1,0,2,2,2
400995739,Seton Hall Pirates,J. Jackson,3064877,,True,28.0,2,6,2,4,0,2,9,9,0,4,4,2,0,0,1,4,13
400995739,Seton Hall Pirates,S. Philoxy,4281380,,False,8.0,1,3,1,3,0,0,0,1,1,2,3,0,0,0,0,2,2
400995739,Seton Hall Pirates,K. Evans,4281378,,False,11.0,1,2,1,2,0,0,0,2,1,0,1,0,0,1,0,0,2
400995739,Seton Hall Pirates,D. Winters,4068126,,False,14.0,4,8,1,2,3,6,0,0,0,1,1,0,0,1,1,2,11
400995739,Seton Hall Pirates,I. Butina,4281377,,False,31.0,2,3,1,1,1,2,2,2,0,1,1,3,2,0,3,2,7
400995739,Seton Hall Pirates,K. Hilaire,4068123,,False,14.0,3,6,3,4,0,2,0,0,0,2,2,2,1,0,0,1,6
400995739,Seton Hall Pirates,K. Healy,3943704,,False,0.0,0,0,0,0,0,0,0,0,0,0,0,0,0,0,0,1,0
400995739,Seton Hall Pirates,TEAM,TOTAL,TOTAL,False,,24,66,20,47,4,19,31,36,18,22,40,10,9,2,13,26,83
400995739,Princeton Tigers,L. Robinson,3142616,,True,37.0,5,12,5,12,0,0,6,7,1,4,5,7,0,1,2,3,16
400995739,Princeton Tigers,B. Alarie,4068600,,True,36.0,8,14,7,11,1,3,5,8,5,7,12,3,1,1,3,4,22
400995739,Princeton Tigers,S. Jordan,3907120,,True,4.0,0,0,0,0,0,0,0,0,0,0,0,0,0,0,0,2,0
400995739,Princeton Tigers,C. Littlefield,4281403,,True,38.0,5,9,5,9,0,0,3,6,1,3,4,2,1,0,6,3,13
400995739,Princeton Tigers,T. Weledji,3142615,,True,32.0,7,10,7,9,0,1,2,4,3,7,10,0,1,0,1,3,16
400995739,Princeton Tigers,J. Stallworth,4068601,,False,4.0,1,1,1,1,0,0,0,0,0,0,0,0,0,0,0,0,2
400995739,Princeton Tigers,T. Baur,4068599,,False,7.0,0,1,0,1,0,0,0,0,0,1,1,0,2,0,1,3,0
400995739,Princeton Tigers,A. Meyers,4281402,,False,9.0,1,3,1,1,0,2,0,0,0,1,1,1,0,0,1,3,2
400995739,Princeton Tigers,G. Rush,3907123,,False,19.0,3,6,0,0,3,6,5,6,1,3,4,2,0,0,1,1,14
400995739,Princeton Tigers,K. Holland,3142614,,False,14.0,0,1,0,0,0,1,0,0,0,0,0,0,0,0,2,5,0
400995739,Princeton Tigers,TEAM,TOTAL,TOTAL,False,,30,57,26,44,4,13,21,31,11,28,39,15,5,2,19,27,85
400995738,Xavier Musketeers,I. Partlow,3142320,,True,32.0,4,7,4,7,0,0,8,11,4,8,12,1,2,0,6,1,16
400995738,Xavier Musketeers,A. Aijanen,3142319,,True,30.0,1,4,1,2,0,2,0,1,0,1,1,0,2,0,3,4,2
400995738,Xavier Musketeers,N. Owens,4068187,,True,24.0,3,7,1,2,2,5,0,2,0,2,2,3,0,1,2,2,8
400995738,Xavier Musketeers,A. Gomez,4068185,,True,22.0,3,7,0,0,3,7,0,0,0,0,0,3,1,0,2,1,9
400995738,Xavier Musketeers,J. Byrd,3142318,,True,31.0,5,7,4,6,1,1,7,8,1,3,4,0,1,0,3,1,18
400995738,Xavier Musketeers,A. Gray,4281368,,False,13.0,0,2,0,2,0,0,0,0,2,5,7,3,1,0,4,0,0
400995738,Xavier Musketeers,D. Ross,4281364,,False,5.0,0,0,0,0,0,0,0,0,0,0,0,0,1,0,0,0,0
400995738,Xavier Musketeers,A. Reiff,4281367,,False,15.0,1,3,0,1,1,2,0,0,0,0,0,2,1,0,1,0,3
400995738,Xavier Musketeers,P. Stewart,4281366,,False,11.0,2,4,1,1,1,3,0,0,1,2,3,1,1,0,2,2,5
400995738,Xavier Musketeers,A. Dunham,4281365,,False,17.0,2,4,0,2,2,2,5,6,1,0,1,1,0,0,1,2,11
400995738,Xavier Musketeers,TEAM,TOTAL,TOTAL,False,,21,45,11,23,10,22,20,28,11,23,34,14,10,1,24,13,72
400995738,Grambling Lady Tigers,J. Torian,4073664,,True,23.0,2,10,2,7,0,3,0,0,1,4,5,2,2,0,1,2,4
400995738,Grambling Lady Tigers,K. Gideon,4282680,,True,22.0,0,1,0,1,0,0,0,0,0,3,3,0,0,3,2,2,0
400995738,Grambling Lady Tigers,J. Coleman,4282676,,True,9.0,0,0,0,0,0,0,0,0,1,1,2,0,0,0,0,0,0
400995738,Grambling Lady Tigers,J. Boyd,3945298,,True,23.0,3,7,2,4,1,3,0,0,0,1,1,2,0,0,0,4,7
400995738,Grambling Lady Tigers,S. Hill,3945296,,True,37.0,4,11,4,9,0,2,5,5,5,1,6,10,6,1,5,3,13
400995738,Grambling Lady Tigers,A. WIlliams,4282678,,False,3.0,0,1,0,1,0,0,0,0,2,0,2,0,1,0,2,0,0
400995738,Grambling Lady Tigers,A. Machado,4282673,,False,23.0,3,5,3,5,0,0,0,0,0,2,2,1,0,0,0,3,6
400995738,Grambling Lady Tigers,J. Jones,4282677,,False,11.0,0,2,0,1,0,1,2,2,1,1,2,0,0,0,2,1,2
400995738,Grambling Lady Tigers,L. Jeans,4282674,,False,5.0,1,2,0,0,1,2,2,2,0,0,0,1,0,0,0,0,5
400995738,Grambling Lady Tigers,T. Parsons,3945300,,False,15.0,2,2,2,2,0,0,3,4,0,0,0,1,1,0,2,2,7
400995738,Grambling Lady Tigers,D. Taylor,3945299,,False,11.0,1,6,1,6,0,0,0,0,2,1,3,0,3,0,0,1,2
400995738,Grambling Lady Tigers,D. McKinney,3908148,,False,18.0,8,14,3,4,5,10,0,0,0,1,1,0,2,0,2,4,21
400995738,Grambling Lady Tigers,TEAM,TOTAL,TOTAL,False,,24,61,17,40,7,21,12,13,13,17,30,17,15,4,17,22,67
400995737,Murray State Racers,K. James,3066733,,True,36.0,6,17,5,10,1,7,8,9,1,7,8,2,2,2,7,4,21
400995737,Murray State Racers,A. Gulledge,3917422,,True,33.0,2,8,2,4,0,4,3,4,0,1,1,0,0,0,2,1,7
400995737,Murray State Racers,B. Bethea,3917421,,True,28.0,6,11,5,8,1,3,2,2,3,2,5,0,2,0,1,3,15
400995737,Murray State Racers,J. Griffith-Wallace,4282453,,True,20.0,1,10,1,7,0,3,0,0,1,1,2,3,0,0,3,3,2
400995737,Murray State Racers,J. Borders,3146836,,True,31.0,4,8,1,2,3,6,1,2,1,2,3,0,0,0,4,1,12
400995737,Murray State Racers,B. Crane,4282457,,False,16.0,0,2,0,2,0,0,0,0,2,1,3,1,2,1,0,0,0
400995737,Murray State Racers,T. Reese,3917426,,False,10.0,0,0,0,0,0,0,2,2,2,0,2,0,0,0,1,4,2
400995737,Murray State Racers,P. Barrett,4282455,,False,1.0,0,0,0,0,0,0,0,0,0,0,0,1,0,0,0,0,0
400995737,Murray State Racers,L. Richardson,4282454,,False,18.0,0,2,0,0,0,2,0,0,0,0,0,0,0,0,3,1,0
400995737,Murray State Racers,M. Manley,3917424,,False,7.0,0,1,0,0,0,1,0,0,0,0,0,0,0,0,0,1,0
400995737,Murray State Racers,TEAM,TOTAL,TOTAL,False,,19,59,14,33,5,26,16,19,11,17,28,7,6,3,21,18,59
400995737,Butler Bulldogs,T. Schickel,3914012,,True,28.0,12,19,12,19,0,0,5,5,1,7,8,2,3,1,2,2,29
400995737,Butler Bulldogs,S. Brey,4068067,,True,23.0,2,2,2,2,0,0,1,2,2,6,8,2,0,3,3,3,5
400995737,Butler Bulldogs,M. Weaver,3914014,,True,27.0,5,6,5,5,0,1,0,0,1,3,4,4,1,0,4,3,10
400995737,Butler Bulldogs,W. Jennings,3142145,,True,27.0,3,6,1,2,2,4,0,1,0,4,4,4,3,0,4,0,8
400995737,Butler Bulldogs,I. Lathan,3079485,,True,17.0,2,5,2,5,0,0,0,3,0,1,1,1,1,0,1,2,4
400995737,Butler Bulldogs,A. Aube,4281363,,False,2.0,0,1,0,0,0,1,0,0,0,0,0,0,0,0,0,0,0
400995737,Butler Bulldogs,K. Hodges,4068065,,False,16.0,2,2,2,2,0,0,2,2,1,1,2,0,1,0,0,4,6
400995737,Butler Bulldogs,S. Humphrey,4068066,,False,10.0,0,2,0,2,0,0,0,0,0,4,4,0,0,1,3,1,0
400995737,Butler Bulldogs,S. Shelton,4068069,,False,22.0,3,6,1,4,2,2,0,0,1,2,3,1,1,0,2,1,8
400995737,Butler Bulldogs,K. Spolyar,4068068,,False,19.0,6,7,4,4,2,3,4,5,1,2,3,3,2,0,2,2,18
400995737,Butler Bulldogs,T. Buford,3914011,,False,3.0,0,0,0,0,0,0,0,0,0,0,0,0,0,0,1,0,0
400995737,Butler Bulldogs,S. Buck,3142279,,False,6.0,0,1,0,0,0,1,0,0,0,0,0,0,0,0,0,0,0
400995737,Butler Bulldogs,TEAM,TOTAL,TOTAL,False,,35,57,29,45,6,12,12,18,9,31,40,17,12,5,22,18,88
400995736,South Dakota Coyotes,K. Liveringhouse,3149828,,True,24.0,7,13,5,9,2,4,2,2,1,3,4,0,0,0,0,2,18
400995736,South Dakota Coyotes,C. Duffy,4069098,,True,33.0,3,8,3,7,0,1,2,2,0,5,5,2,1,0,6,1,8
400995736,South Dakota Coyotes,M. McKeever,4069097,,True,35.0,4,9,3,8,1,1,0,0,1,6,7,4,2,0,0,3,9
400995736,South Dakota Coyotes,J. Bradley,3917891,,True,33.0,2,7,1,4,1,3,3,3,1,5,6,4,1,0,0,2,8
400995736,South Dakota Coyotes,A. Arens,3917889,,True,30.0,4,9,3,7,1,2,10,11,1,5,6,1,2,0,1,3,19
400995736,South Dakota Coyotes,T. Frederick,4069096,,False,8.0,2,6,1,3,1,3,0,0,0,1,1,0,0,0,0,2,5
400995736,South Dakota Coyotes,C. Lamb,4282528,,False,20.0,2,5,2,3,0,2,0,0,0,3,3,0,0,0,0,2,4
400995736,South Dakota Coyotes,M. Arens,4282527,,False,12.0,0,1,0,1,0,0,2,2,0,2,2,0,0,0,0,2,2
400995736,South Dakota Coyotes,C. Duffy,18224,,False,5.0,0,1,0,1,0,0,0,0,0,1,1,0,0,0,0,0,0
400995736,South Dakota Coyotes,TEAM,TOTAL,TOTAL,False,,24,59,18,43,6,16,19,20,6,32,38,11,6,0,7,17,73
400995736,Creighton Bluejays,A. Faber,3938938,,True,36.0,5,11,2,5,3,6,2,2,0,4,4,2,0,2,1,1,15
400995736,Creighton Bluejays,J. Agnew,3938935,,True,32.0,4,10,1,3,3,7,1,1,1,1,2,3,1,1,3,5,12
400995736,Creighton Bluejays,K. Brown,3142286,,True,8.0,0,1,0,1,0,0,0,0,0,2,2,0,0,0,0,1,0
400995736,Creighton Bluejays,S. Lamberty,3142285,,True,37.0,3,13,2,8,1,5,4,4,1,4,5,3,0,1,1,3,11
400995736,Creighton Bluejays,M. Mellman,3142283,,True,13.0,1,1,0,0,1,1,0,0,1,1,2,0,0,0,2,1,3
400995736,Creighton Bluejays,A. Greene,3938937,,False,4.0,0,0,0,0,0,0,2,2,0,1,1,0,0,0,0,0,2
400995736,Creighton Bluejays,B. Norby,3142284,,False,7.0,1,1,1,1,0,0,0,0,0,2,2,0,0,0,0,1,2
400995736,Creighton Bluejays,T. Carda,4281362,,False,29.0,5,9,5,7,0,2,5,7,2,5,7,1,0,0,2,4,15
400995736,Creighton Bluejays,T. Rembao,4281361,,False,26.0,3,8,3,7,0,1,2,2,0,4,4,1,1,2,0,2,8
400995736,Creighton Bluejays,B. Kissinger,3142124,,False,8.0,0,4,0,1,0,3,0,0,0,1,1,0,0,0,0,0,0
400995736,Creighton Bluejays,TEAM,TOTAL,TOTAL,False,,22,58,14,33,8,25,16,18,5,27,32,10,2,6,9,18,68
400995735,Xavier Musketeers,I. Partlow,3142320,,True,28.0,5,8,5,6,0,2,2,5,0,7,7,0,1,1,1,2,12
400995735,Xavier Musketeers,A. Aijanen,3142319,,True,25.0,2,6,2,4,0,2,1,2,0,2,2,4,2,1,1,1,5
400995735,Xavier Musketeers,N. Owens,4068187,,True,21.0,1,2,0,0,1,2,0,0,0,6,6,2,1,1,2,1,3
400995735,Xavier Musketeers,A. Gomez,4068185,,True,19.0,3,4,2,2,1,2,0,0,0,0,0,0,3,0,1,1,7
400995735,Xavier Musketeers,J. Byrd,3142318,,True,21.0,3,6,2,5,1,1,0,0,1,2,3,2,0,0,5,2,7
400995735,Xavier Musketeers,A. Gray,4281368,,False,15.0,3,6,3,5,0,1,3,4,3,7,10,0,0,2,3,3,9
400995735,Xavier Musketeers,D. Ross,4281364,,False,6.0,1,3,1,2,0,1,0,0,1,1,2,0,0,0,0,0,2
400995735,Xavier Musketeers,M. Christopher,4068186,,False,2.0,0,1,0,0,0,1,0,0,0,0,0,0,0,0,0,0,0
400995735,Xavier Musketeers,J. Dawson,4281369,,False,6.0,0,2,0,1,0,1,0,0,0,4,4,1,1,1,1,0,0
400995735,Xavier Musketeers,A. Reiff,4281367,,False,18.0,1,6,0,1,1,5,0,2,0,1,1,1,1,0,1,0,3
400995735,Xavier Musketeers,P. Stewart,4281366,,False,20.0,1,2,1,2,0,0,0,0,1,4,5,1,0,0,1,1,2
400995735,Xavier Musketeers,A. Dunham,4281365,,False,19.0,4,6,2,2,2,4,6,8,0,2,2,2,0,0,1,1,16
400995735,Xavier Musketeers,TEAM,TOTAL,TOTAL,False,,24,52,18,30,6,22,12,21,7,36,43,13,9,6,18,12,66
400995735,Mount St. Mary's Mountaineers,C. Hummell,3143607,,True,19.0,2,9,2,7,0,2,2,2,1,1,2,0,1,1,1,0,6
400995735,Mount St. Mary's Mountaineers,K. Dickson,3143605,,True,36.0,4,13,4,11,0,2,6,6,1,3,4,0,5,1,3,2,14
400995735,Mount St. Mary's Mountaineers,K. Agentowicz,4069294,,True,21.0,1,6,1,5,0,1,0,0,0,4,4,2,3,0,0,3,2
400995735,Mount St. Mary's Mountaineers,A. White,4069293,,True,33.0,3,10,3,8,0,2,2,4,0,3,3,3,3,0,3,4,8
400995735,Mount St. Mary's Mountaineers,J. Lawless,3907750,,True,22.0,0,4,0,3,0,1,1,2,0,5,5,3,0,0,3,3,1
400995735,Mount St. Mary's Mountaineers,R. Lee,4281985,,False,6.0,1,2,1,2,0,0,0,0,2,0,2,0,0,0,0,1,2
400995735,Mount St. Mary's Mountaineers,H. Rowson,4281984,,False,12.0,1,4,1,4,0,0,0,0,1,1,2,0,1,0,2,2,2
400995735,Mount St. Mary's Mountaineers,J. Settle,4281982,,False,10.0,1,3,1,3,0,0,0,0,0,0,0,0,0,0,1,0,2
400995735,Mount St. Mary's Mountaineers,B. Birkhead,4281981,,False,18.0,2,7,0,3,2,4,0,0,0,2,2,0,0,0,1,3,6
400995735,Mount St. Mary's Mountaineers,D. Sullivan,4281980,,False,23.0,1,5,1,3,0,2,0,0,1,3,4,2,0,0,1,0,2
400995735,Mount St. Mary's Mountaineers,TEAM,TOTAL,TOTAL,False,,16,63,14,49,2,14,11,14,11,26,37,10,13,2,15,18,45
400995734,Howard Bison,J. Myles,4072639,,True,20.0,1,8,1,8,0,0,2,2,2,0,2,0,0,2,2,3,4
400995734,Howard Bison,C. Moore,4282275,,True,18.0,2,2,2,2,0,0,4,4,1,6,7,0,0,0,3,4,8
400995734,Howard Bison,A. Williams,4072640,,True,15.0,1,7,1,4,0,3,0,1,1,3,4,1,0,0,3,0,2
400995734,Howard Bison,S. Edmond,4072635,,True,29.0,1,7,1,5,0,2,0,2,0,3,3,4,0,0,2,1,2
400995734,Howard Bison,T. Dopson,3154161,,True,22.0,2,9,2,9,0,0,1,6,0,2,2,0,2,0,5,3,5
400995734,Howard Bison,D. Griffin,4072637,,False,3.0,0,0,0,0,0,0,0,0,2,0,2,0,1,0,1,0,0
400995734,Howard Bison,S. Fitzgerald-Greer,4072636,,False,15.0,1,4,1,3,0,1,0,0,0,3,3,1,0,1,0,4,2
400995734,Howard Bison,I. Bryant,4072634,,False,12.0,0,0,0,0,0,0,1,2,2,2,4,0,1,1,5,5,1
400995734,Howard Bison,A. Johnson,4282278,,False,10.0,2,5,2,4,0,1,1,2,1,0,1,0,1,0,0,0,5
400995734,Howard Bison,J. Thornton,4282277,,False,20.0,1,8,0,3,1,5,0,0,0,0,0,0,0,0,2,2,3
400995734,Howard Bison,T. Johnson,4282276,,False,14.0,1,4,0,1,1,3,3,6,1,3,4,1,3,1,1,5,6
400995734,Howard Bison,K. Jacobs,4282274,,False,7.0,1,3,1,2,0,1,0,0,0,1,1,0,0,0,1,1,2
400995734,Howard Bison,A. McCants,4072638,,False,9.0,0,2,0,1,0,1,1,2,0,1,1,0,0,0,1,1,1
400995734,Howard Bison,D. Shumate,3154162,,False,6.0,0,2,0,2,0,0,0,0,1,0,1,0,0,0,0,2,0
400995734,Howard Bison,TEAM,TOTAL,TOTAL,False,,13,61,11,44,2,17,13,27,17,27,44,7,8,5,28,31,41
400995734,Georgetown Hoyas,C. Petke,4068078,,True,27.0,4,10,1,5,3,5,3,4,4,11,15,0,1,1,0,2,14
400995734,Georgetown Hoyas,Y. Belk,3142295,,True,19.0,4,7,4,7,0,0,1,2,3,6,9,0,2,2,2,0,9
400995734,Georgetown Hoyas,D. White,3948815,,True,28.0,8,14,4,8,4,6,7,7,4,2,6,3,3,0,1,2,27
400995734,Georgetown Hoyas,D. Burton,3142292,,True,26.0,3,8,2,5,1,3,0,1,1,1,2,4,2,0,1,0,7
400995734,Georgetown Hoyas,M. Venson,3142105,,True,24.0,1,7,1,2,0,5,2,2,1,1,2,3,1,0,2,4,4
400995734,Georgetown Hoyas,S. Cureton,4281355,,False,3.0,0,1,0,1,0,0,0,0,0,0,0,0,0,0,0,0,0
400995734,Georgetown Hoyas,T. Thompson,4281352,,False,23.0,4,9,4,6,0,3,6,7,2,4,6,2,1,0,5,5,14
400995734,Georgetown Hoyas,M. Smith,4068079,,False,26.0,3,8,3,6,0,2,2,5,2,4,6,1,1,0,3,2,8
400995734,Georgetown Hoyas,B. Mayfield,4281354,,False,10.0,1,3,1,3,0,0,1,2,1,1,2,0,0,3,1,3,3
400995734,Georgetown Hoyas,L. Kimball,4281353,,False,7.0,0,3,0,2,0,1,2,2,0,1,1,0,1,0,0,1,2
400995734,Georgetown Hoyas,M. Osagie-Erese,4072597,,False,7.0,1,1,1,1,0,0,3,4,0,2,2,0,0,0,2,1,5
400995734,Georgetown Hoyas,TEAM,TOTAL,TOTAL,False,,29,71,21,46,8,25,27,36,20,39,59,13,12,6,17,20,93
400995733,Providence Friars,B. Frias,3142302,,True,15.0,1,1,1,1,0,0,0,0,1,1,2,0,0,0,2,0,2
400995733,Providence Friars,C. Che,3906766,,True,36.0,5,9,2,5,3,4,2,2,0,3,3,5,1,0,1,0,15
400995733,Providence Friars,N. Jackson,4068111,,True,16.0,0,1,0,1,0,0,2,2,0,1,1,1,1,0,1,1,2
400995733,Providence Friars,J. Nogic,3906769,,True,38.0,12,19,11,15,1,4,6,6,0,3,3,4,0,0,4,3,31
400995733,Providence Friars,A. Botteghi,3142301,,True,21.0,1,1,1,1,0,0,1,2,1,1,2,0,0,0,2,3,3
400995733,Providence Friars,A. Cooper,4281349,,False,2.0,0,1,0,1,0,0,0,0,0,1,1,0,0,0,0,0,0
400995733,Providence Friars,N. Franklin,4281348,,False,34.0,7,11,7,11,0,0,1,3,5,7,12,0,3,0,3,5,15
400995733,Providence Friars,O. Orlando,4281347,,False,17.0,0,2,0,2,0,0,0,0,2,2,4,0,0,0,4,1,0
400995733,Providence Friars,K. Spiwak,4281346,,False,2.0,0,0,0,0,0,0,0,0,0,0,0,0,0,0,0,1,0
400995733,Providence Friars,C. Williams,4281345,,False,10.0,3,5,3,5,0,0,1,2,0,0,0,2,2,0,2,5,7
400995733,Providence Friars,M. Jolin,3906767,,False,34.0,8,11,4,6,4,5,3,4,0,1,1,0,1,0,0,3,23
400995733,Providence Friars,TEAM,TOTAL,TOTAL,False,,37,61,29,48,8,13,16,21,11,22,33,12,8,0,19,22,98
400995733,Northeastern Huskies,S. Michel,4281488,,True,3.0,0,0,0,0,0,0,0,0,0,0,0,0,0,0,0,0,0
400995733,Northeastern Huskies,L. Lassiter,3156334,,True,14.0,0,0,0,0,0,0,0,0,4,0,4,1,0,0,1,3,0
400995733,Northeastern Huskies,S. Todd,4068373,,True,38.0,5,8,2,3,3,5,2,2,0,3,3,3,0,0,3,5,15
400995733,Northeastern Huskies,J. Genco,3938932,,True,45.0,5,11,3,3,2,8,1,2,0,2,2,5,0,0,3,2,13
400995733,Northeastern Huskies,C. Ortiz,3156335,,True,42.0,5,11,4,8,1,3,8,9,1,1,2,2,2,0,6,1,19
400995733,Northeastern Huskies,J. Braswell,4068375,,False,2.0,0,0,0,0,0,0,0,0,0,0,0,0,0,0,0,1,0
400995733,Northeastern Huskies,C. Redcross,4068374,,False,3.0,0,0,0,0,0,0,0,0,0,0,0,0,0,0,0,0,0
400995733,Northeastern Huskies,G. Giacone,3938933,,False,37.0,8,20,8,19,0,1,4,6,5,4,9,2,2,2,2,3,20
400995733,Northeastern Huskies,S. Clark,4281487,,False,41.0,9,15,3,5,6,10,4,6,1,5,6,4,1,0,3,4,28
400995733,Northeastern Huskies,TEAM,TOTAL,TOTAL,False,,32,65,20,38,12,27,19,25,12,16,28,17,5,2,18,19,95
400995732,New Mexico Lobos,J. Nunn,3920344,,True,34.0,14,15,14,15,0,0,11,12,3,10,13,0,1,0,0,1,39
400995732,New Mexico Lobos,N. Flye,4281831,,True,36.0,3,8,3,6,0,2,2,6,2,3,5,3,0,0,1,2,8
400995732,New Mexico Lobos,C. Beynon,3145672,,True,37.0,4,15,3,14,1,1,4,4,1,1,2,7,2,1,9,0,13
400995732,New Mexico Lobos,T. Buck,3079465,,True,30.0,3,6,2,3,1,3,0,0,0,3,3,2,3,0,2,2,7
400995732,New Mexico Lobos,A. Lapeyrolerie,3066890,,True,11.0,0,3,0,0,0,3,0,0,0,4,4,0,0,0,1,2,0
400995732,New Mexico Lobos,A. Anderson,4281834,,False,13.0,2,2,2,2,0,0,0,0,0,1,1,1,0,1,0,0,4
400995732,New Mexico Lobos,J. Smith,4281832,,False,33.0,8,18,8,17,0,1,1,1,1,4,5,0,0,0,0,2,17
400995732,New Mexico Lobos,M. Burleson,4068350,,False,5.0,0,0,0,0,0,0,0,0,0,0,0,2,0,0,0,0,0
400995732,New Mexico Lobos,L. Bryan,3145675,,False,1.0,0,0,0,0,0,0,0,0,0,0,0,0,0,0,0,0,0
400995732,New Mexico Lobos,TEAM,TOTAL,TOTAL,False,,34,67,32,57,2,10,18,23,8,30,38,15,6,2,13,9,88
400995732,Marquette Golden Eagles,E. Davenport,3906756,,True,30.0,5,10,5,10,0,0,1,1,3,6,9,1,1,0,2,2,11
400995732,Marquette Golden Eagles,L. Van Kleunen,4068083,,True,29.0,8,15,3,5,5,10,2,2,3,5,8,1,2,0,2,4,23
400995732,Marquette Golden Eagles,S. Lott,4281350,,True,30.0,2,6,1,5,1,1,2,2,1,3,4,1,5,3,2,3,7
400995732,Marquette Golden Eagles,N. Hiedeman,3906753,,True,32.0,3,10,0,0,3,10,1,2,2,1,3,8,0,0,1,4,10
400995732,Marquette Golden Eagles,D. King,3906752,,True,36.0,6,15,4,9,2,6,0,0,3,6,9,7,0,0,6,2,14
400995732,Marquette Golden Eagles,M. Smith Traore,4281351,,False,2.0,1,1,1,1,0,0,0,0,0,0,0,0,0,0,0,1,2
400995732,Marquette Golden Eagles,S. Dahling,3906754,,False,0.0,0,0,0,0,0,0,0,0,0,0,0,0,0,0,0,1,0
400995732,Marquette Golden Eagles,S. Valentine,3142300,,False,3.0,0,0,0,0,0,0,0,0,0,0,0,1,0,0,0,0,0
400995732,Marquette Golden Eagles,I. Spingola,4068082,,False,5.0,0,2,0,1,0,1,0,0,0,0,0,0,0,0,0,1,0
400995732,Marquette Golden Eagles,A. Blockton,3906755,,False,33.0,9,20,7,14,2,6,0,0,2,5,7,5,0,1,0,3,20
400995732,Marquette Golden Eagles,TEAM,TOTAL,TOTAL,False,,34,79,21,45,13,34,6,7,15,26,41,24,8,4,13,21,87
400995731,Butler Bulldogs,S. Brey,4068067,,True,24.0,1,1,1,1,0,0,0,0,0,5,5,2,1,0,4,2,2
400995731,Butler Bulldogs,T. Schickel,3914012,,True,34.0,4,9,4,9,0,0,6,6,0,6,6,2,5,2,3,4,14
400995731,Butler Bulldogs,M. Weaver,3914014,,True,24.0,2,3,2,3,0,0,7,10,3,1,4,3,0,0,4,1,11
400995731,Butler Bulldogs,W. Jennings,3142145,,True,37.0,11,21,7,13,4,8,4,4,1,2,3,4,2,0,4,1,30
400995731,Butler Bulldogs,I. Lathan,3079485,,True,19.0,1,3,1,3,0,0,0,0,0,4,4,2,1,0,0,2,2
400995731,Butler Bulldogs,K. Hodges,4068065,,False,8.0,2,2,2,2,0,0,0,0,2,1,3,0,1,0,3,4,4
400995731,Butler Bulldogs,S. Humphrey,4068066,,False,10.0,0,0,0,0,0,0,0,0,1,1,2,0,0,1,3,1,0
400995731,Butler Bulldogs,S. Shelton,4068069,,False,18.0,1,1,1,1,0,0,3,4,0,3,3,0,1,0,1,0,5
400995731,Butler Bulldogs,K. Spolyar,4068068,,False,17.0,3,9,3,8,0,1,1,2,1,0,1,0,2,0,1,3,7
400995731,Butler Bulldogs,T. Buford,3914011,,False,2.0,0,1,0,1,0,0,0,0,0,0,0,0,0,0,0,1,0
400995731,Butler Bulldogs,S. Buck,3142279,,False,7.0,0,1,0,0,0,1,0,0,0,1,1,1,0,0,0,0,0
400995731,Butler Bulldogs,TEAM,TOTAL,TOTAL,False,,25,51,21,41,4,10,21,26,12,25,37,14,13,3,23,19,75
400995731,Austin Peay Governors,K. Kenol,4282385,,True,8.0,0,1,0,1,0,0,0,0,0,0,0,0,1,0,1,5,0
400995731,Austin Peay Governors,B. Alexander,3146762,,True,20.0,4,11,4,9,0,2,1,1,1,2,3,1,0,2,4,2,9
400995731,Austin Peay Governors,B. Williams,4069114,,True,33.0,1,2,1,1,0,1,0,0,0,2,2,4,3,0,3,2,2
400995731,Austin Peay Governors,K. Gregory,3945183,,True,31.0,2,6,1,2,1,4,0,0,0,2,2,1,1,0,2,2,5
400995731,Austin Peay Governors,F. Baker,3146763,,True,21.0,2,4,1,1,1,3,0,0,0,1,1,3,0,0,3,2,5
400995731,Austin Peay Governors,L. Persinger,4282383,,False,2.0,0,1,0,1,0,0,0,0,0,0,0,0,0,0,0,2,0
400995731,Austin Peay Governors,M. LeFlore,4282382,,False,6.0,0,2,0,1,0,1,0,0,0,2,2,0,0,0,1,0,0
400995731,Austin Peay Governors,A. Gonzalez-Varner,4069112,,False,2.0,0,0,0,0,0,0,1,2,1,0,1,0,0,0,0,0,1
400995731,Austin Peay Governors,J. Harrison,4282388,,False,17.0,3,4,3,4,0,0,2,2,1,1,2,0,0,0,0,2,8
400995731,Austin Peay Governors,B. Ferby,4282387,,False,21.0,2,7,0,1,2,6,0,0,4,0,4,2,4,0,5,3,6
400995731,Austin Peay Governors,M. Campbell,4282386,,False,14.0,4,9,1,3,3,6,0,0,0,1,1,0,1,1,3,1,11
400995731,Austin Peay Governors,B. Ferby,4282381,,False,2.0,0,1,0,0,0,1,0,0,0,0,0,0,0,0,1,0,0
400995731,Austin Peay Governors,S. Piggie,4069113,,False,19.0,2,7,1,3,1,4,0,0,0,2,2,0,0,0,1,2,5
400995731,Austin Peay Governors,N. Crawford,4069111,,False,2.0,0,0,0,0,0,0,2,2,0,0,0,0,0,0,0,0,2
400995731,Austin Peay Governors,G. Gregory,4068088,,False,2.0,0,0,0,0,0,0,0,0,0,0,0,0,0,0,0,0,0
400995731,Austin Peay Governors,TEAM,TOTAL,TOTAL,False,,20,55,12,27,8,28,6,7,7,16,23,11,10,3,25,23,54
400995730,Northern Colorado Bears,C. Smith,3906799,,True,33.0,8,13,8,12,0,1,8,8,0,7,7,0,0,2,0,2,24
400995730,Northern Colorado Bears,K. Leger-Walker,4068719,,True,38.0,3,7,1,5,2,2,0,0,1,6,7,6,1,0,1,4,8
400995730,Northern Colorado Bears,K. Williams,3156546,,True,29.0,2,4,2,4,0,0,0,0,2,4,6,4,1,0,1,4,4
400995730,Northern Colorado Bears,S. Smith,3156544,,True,29.0,2,8,1,4,1,4,8,11,1,4,5,4,0,0,9,5,13
400995730,Northern Colorado Bears,S. Scott,3156542,,True,36.0,9,13,5,7,4,6,13,13,2,4,6,1,2,1,3,3,35
400995730,Northern Colorado Bears,A. Meyer,4068722,,False,0.0,0,0,0,0,0,0,0,0,0,0,0,0,0,0,1,0,0
400995730,Northern Colorado Bears,B. Hintz,4068723,,False,10.0,2,5,2,5,0,0,1,1,0,2,2,0,0,0,1,2,5
400995730,Northern Colorado Bears,A. Chapman,4281679,,False,12.0,1,1,1,1,0,0,0,0,0,0,0,0,0,0,1,2,2
400995730,Northern Colorado Bears,T. Clarke,4281678,,False,13.0,0,2,0,1,0,1,3,4,1,0,1,4,0,0,3,5,3
400995730,Northern Colorado Bears,TEAM,TOTAL,TOTAL,False,,27,53,20,39,7,14,33,37,8,30,38,19,4,3,20,27,94
400995730,DePaul Blue Demons,M. Grays,3142287,,True,25.0,5,15,4,10,1,5,1,2,2,4,6,0,1,0,3,4,12
400995730,DePaul Blue Demons,K. Campbell,4068071,,True,33.0,5,6,4,4,1,2,2,3,2,3,5,3,1,1,2,5,13
400995730,DePaul Blue Demons,T. Allen,3933760,,True,33.0,6,9,4,6,2,3,3,6,3,6,9,3,4,0,2,5,17
400995730,DePaul Blue Demons,A. Millender,3142289,,True,35.0,5,14,2,4,3,10,1,1,0,1,1,3,0,0,1,2,14
400995730,DePaul Blue Demons,A. Coleman,3142123,,True,27.0,4,15,4,11,0,4,8,11,3,3,6,3,0,0,1,5,16
400995730,DePaul Blue Demons,C. Stonewall,4068072,,False,10.0,1,2,0,0,1,2,0,0,2,2,4,2,1,1,1,5,3
400995730,DePaul Blue Demons,D. Bekelja,4281356,,False,2.0,0,0,0,0,0,0,1,2,1,0,1,0,1,0,0,2,1
400995730,DePaul Blue Demons,D. Cage,4068073,,False,7.0,3,9,3,7,0,2,2,4,3,0,3,0,0,0,1,1,8
400995730,DePaul Blue Demons,L. Prochaska,3142290,,False,11.0,0,0,0,0,0,0,0,0,0,0,0,1,2,0,2,2,0
400995730,DePaul Blue Demons,R. Dahlman,3056673,,False,17.0,2,3,2,3,0,0,0,0,1,1,2,2,0,0,2,3,4
400995730,DePaul Blue Demons,TEAM,TOTAL,TOTAL,False,,31,73,23,45,8,28,18,29,19,21,40,17,10,2,16,34,88
400995729,St. John's Red Storm,M. Singleton,4068158,,True,33.0,5,8,5,8,0,0,0,0,2,9,11,1,4,5,1,3,10
400995729,St. John's Red Storm,I. Littleton,3142306,,True,29.0,0,4,0,4,0,0,1,2,2,3,5,1,2,4,1,1,1
400995729,St. John's Red Storm,A. Wellere,3906771,,True,38.0,4,14,3,10,1,4,4,6,1,3,4,2,1,2,0,2,13
400995729,St. John's Red Storm,T. England,4068155,,True,30.0,6,14,6,11,0,3,0,0,1,0,1,5,2,0,6,3,12
400995729,St. John's Red Storm,A. Kebbe,4068154,,True,20.0,1,4,1,2,0,2,0,0,1,3,4,2,0,0,2,2,2
400995729,St. John's Red Storm,K. Charles,4281374,,False,2.0,0,0,0,0,0,0,0,0,0,1,1,0,0,1,0,0,0
400995729,St. John's Red Storm,Q. Hoppie,4281375,,False,27.0,6,13,4,9,2,4,2,3,0,2,2,3,1,2,1,2,16
400995729,St. John's Red Storm,A. Adams,4068157,,False,15.0,6,7,2,2,4,5,0,0,1,2,3,1,1,0,1,3,16
400995729,St. John's Red Storm,S. Duncan,4068156,,False,1.0,1,1,0,0,1,1,0,0,0,0,0,0,0,0,0,0,3
400995729,St. John's Red Storm,T. Alexander,3142305,,False,5.0,0,0,0,0,0,0,0,0,0,1,1,0,1,0,0,0,0
400995729,St. John's Red Storm,TEAM,TOTAL,TOTAL,False,,29,65,21,46,8,19,7,11,10,26,36,15,12,14,12,16,73
400995729,St. Francis Brooklyn Terriers,L. Hickman,3922621,,True,14.0,1,5,1,5,0,0,2,2,1,1,2,0,0,0,2,1,4
400995729,St. Francis Brooklyn Terriers,A. Delaney,3143621,,True,26.0,4,9,1,4,3,5,0,0,0,4,4,4,1,2,3,2,11
400995729,St. Francis Brooklyn Terriers,M. Palarino,3922617,,True,24.0,1,5,1,4,0,1,0,0,0,3,3,1,1,2,1,2,2
400995729,St. Francis Brooklyn Terriers,A. O'Neill,4282031,,True,29.0,0,5,0,5,0,0,2,4,3,4,7,2,1,0,4,2,2
400995729,St. Francis Brooklyn Terriers,J. Johnson,4069339,,True,27.0,1,8,0,4,1,4,0,0,0,3,3,0,0,0,2,2,3
400995729,St. Francis Brooklyn Terriers,C. Carangelo,4282035,,False,6.0,1,3,1,3,0,0,1,2,2,2,4,0,0,0,4,1,3
400995729,St. Francis Brooklyn Terriers,A. Lassen,4282034,,False,4.0,0,0,0,0,0,0,0,0,0,0,0,0,0,0,0,1,0
400995729,St. Francis Brooklyn Terriers,A. Anderson,4282033,,False,18.0,3,4,2,3,1,1,1,2,0,1,1,1,1,0,1,0,8
400995729,St. Francis Brooklyn Terriers,S. Keltos,4069338,,False,12.0,2,5,2,4,0,1,0,0,1,4,5,1,1,0,1,0,4
400995729,St. Francis Brooklyn Terriers,T. Wagner,3922622,,False,8.0,3,6,3,6,0,0,0,0,0,0,0,0,0,0,0,1,6
400995729,St. Francis Brooklyn Terriers,M. Ehling,3922620,,False,20.0,2,7,0,4,2,3,0,0,0,2,2,3,1,0,3,2,6
400995729,St. Francis Brooklyn Terriers,D. DiRenzo,3922619,,False,12.0,0,2,0,2,0,0,0,0,1,2,3,0,0,1,0,0,0
400995729,St. Francis Brooklyn Terriers,TEAM,TOTAL,TOTAL,False,,18,59,11,44,7,15,6,10,15,27,42,12,6,5,21,14,49
400995728,Providence Friars,B. Frias,3142302,,True,31.0,1,2,1,2,0,0,0,2,4,3,7,2,0,0,0,3,2
400995728,Providence Friars,J. Nogic,3906769,,True,33.0,7,14,6,11,1,3,5,6,0,0,0,1,2,0,3,3,20
400995728,Providence Friars,M. Jolin,3906767,,True,29.0,3,8,1,5,2,3,3,4,0,2,2,0,0,0,1,2,11
400995728,Providence Friars,C. Che,3906766,,True,33.0,3,10,1,4,2,6,2,2,0,6,6,1,0,0,1,2,10
400995728,Providence Friars,A. Botteghi,3142301,,True,31.0,1,2,1,2,0,0,1,1,2,4,6,0,0,0,3,1,3
400995728,Providence Friars,N. Franklin,4281348,,False,18.0,2,6,2,6,0,0,0,2,2,2,4,0,0,0,2,2,4
400995728,Providence Friars,C. Williams,4281345,,False,23.0,5,11,5,11,0,0,4,6,0,2,2,3,1,0,3,4,14
400995728,Providence Friars,N. Jackson,4068111,,False,2.0,0,0,0,0,0,0,0,0,2,0,2,0,0,0,2,0,0
400995728,Providence Friars,TEAM,TOTAL,TOTAL,False,,22,53,17,41,5,12,15,23,11,20,31,7,3,0,15,17,64
400995728,Columbia Lions,A. Lee,3907094,,True,31.0,4,9,4,4,0,5,0,0,1,7,8,0,0,0,1,3,8
400995728,Columbia Lions,C. Zimmerman,3142519,,True,29.0,9,12,8,10,1,2,6,7,1,3,4,2,0,0,4,4,25
400995728,Columbia Lions,R. Casey,4281390,,True,37.0,5,8,1,2,4,6,0,0,0,2,2,2,0,0,1,4,14
400995728,Columbia Lions,M. Sampleton,4068467,,True,21.0,2,6,2,4,0,2,2,3,1,1,2,0,2,1,4,5,6
400995728,Columbia Lions,P. Tippet,3142517,,True,29.0,0,2,0,1,0,1,4,4,0,0,0,5,0,0,2,1,4
400995728,Columbia Lions,M. Pack,4281392,,False,26.0,2,7,1,2,1,5,0,0,0,7,7,0,0,0,0,4,5
400995728,Columbia Lions,I. Whittington,4281389,,False,5.0,0,0,0,0,0,0,0,0,0,1,1,0,0,0,0,1,0
400995728,Columbia Lions,S. Flynn,4068469,,False,2.0,1,2,0,0,1,2,0,0,0,0,0,0,0,0,0,0,3
400995728,Columbia Lions,J. Clemmons,4068468,,False,20.0,3,3,3,3,0,0,2,3,0,0,0,1,0,0,2,1,8
400995728,Columbia Lions,TEAM,TOTAL,TOTAL,False,,26,49,19,26,7,23,14,17,4,23,27,10,2,1,16,23,73
400995681,Providence Friars,B. Frias,3142302,,True,6.0,0,0,0,0,0,0,0,0,0,3,3,0,0,0,0,0,0
400995681,Providence Friars,J. Nogic,3906769,,True,30.0,6,14,5,9,1,5,0,0,0,2,2,1,1,0,6,0,13
400995681,Providence Friars,M. Jolin,3906767,,True,35.0,6,10,4,6,2,4,2,2,1,8,9,1,0,0,2,1,16
400995681,Providence Friars,C. Che,3906766,,True,26.0,0,4,0,0,0,4,0,0,0,1,1,1,0,0,2,1,0
400995681,Providence Friars,A. Botteghi,3142301,,True,14.0,1,3,1,3,0,0,2,2,2,1,3,0,1,0,2,1,4
400995681,Providence Friars,A. Cooper,4281349,,False,25.0,3,7,3,7,0,0,0,2,2,3,5,1,1,1,0,2,6
400995681,Providence Friars,N. Franklin,4281348,,False,25.0,6,11,6,11,0,0,2,3,1,1,2,1,0,0,1,2,14
400995681,Providence Friars,C. Williams,4281345,,False,16.0,0,4,0,4,0,0,0,0,2,1,3,3,2,0,3,1,0
400995681,Providence Friars,N. Jackson,4068111,,False,23.0,3,7,3,7,0,0,0,0,2,5,7,0,0,0,1,1,6
400995681,Providence Friars,TEAM,TOTAL,TOTAL,False,,25,60,22,47,3,13,6,9,13,30,43,8,5,1,17,10,59
400995681,Brown Bears,E. Steeves,3907079,,True,24.0,4,11,2,3,2,8,2,4,1,3,4,0,0,0,2,0,12
400995681,Brown Bears,J. White,3142514,,True,26.0,1,5,1,2,0,3,0,0,2,7,9,2,0,4,2,4,2
400995681,Brown Bears,J. Gaziano,4068453,,True,28.0,7,14,4,6,3,8,3,4,0,0,0,1,1,0,1,2,20
400995681,Brown Bears,T. Will,3907080,,True,38.0,5,12,5,8,0,4,2,2,5,3,8,6,2,0,4,0,12
400995681,Brown Bears,S. Mehta,3907078,,True,35.0,5,15,3,7,2,8,2,2,2,4,6,0,0,0,3,3,14
400995681,Brown Bears,K. Ryan,4068455,,False,9.0,1,4,0,0,1,4,0,0,0,1,1,0,0,0,0,1,3
400995681,Brown Bears,M. Butler,3907076,,False,12.0,0,1,0,0,0,1,0,0,1,2,3,0,1,1,0,1,0
400995681,Brown Bears,D. Leonidas,4281393,,False,22.0,0,5,0,5,0,0,1,2,3,2,5,1,1,0,0,1,1
400995681,Brown Bears,M. Reilly,3142513,,False,6.0,0,0,0,0,0,0,0,0,0,0,0,0,0,0,0,0,0
400995681,Brown Bears,TEAM,TOTAL,TOTAL,False,,23,67,15,31,8,36,10,14,15,23,38,10,5,5,12,12,64
400995516,Xavier Musketeers,A. Gray,4281368,,True,28.0,0,3,0,2,0,1,0,0,1,6,7,2,1,1,3,3,0
400995516,Xavier Musketeers,A. Aijanen,3142319,,True,31.0,3,7,3,4,0,3,1,1,2,2,4,1,1,0,3,2,7
400995516,Xavier Musketeers,P. Stewart,4281366,,True,26.0,5,9,3,4,2,5,0,0,1,4,5,5,0,0,1,1,12
400995516,Xavier Musketeers,N. Owens,4068187,,True,23.0,1,11,1,5,0,6,0,0,1,4,5,4,1,0,1,2,2
400995516,Xavier Musketeers,K. Fincher,3142317,,True,28.0,5,10,2,2,3,8,0,0,0,5,5,1,0,0,2,0,13
400995516,Xavier Musketeers,D. Ross,4281364,,False,13.0,1,3,0,0,1,3,0,0,0,1,1,0,0,0,0,3,3
400995516,Xavier Musketeers,J. Dawson,4281369,,False,9.0,1,2,1,1,0,1,0,0,0,2,2,1,1,0,1,2,2
400995516,Xavier Musketeers,A. Reiff,4281367,,False,14.0,1,2,0,0,1,2,0,0,0,1,1,0,1,0,0,0,3
400995516,Xavier Musketeers,A. Dunham,4281365,,False,17.0,2,5,0,1,2,4,0,1,0,0,0,1,0,0,1,0,6
400995516,Xavier Musketeers,A. Gomez,4068185,,False,11.0,2,3,1,1,1,2,0,0,0,0,0,0,0,0,1,0,5
400995516,Xavier Musketeers,TEAM,TOTAL,TOTAL,False,,21,55,11,20,10,35,1,2,7,27,34,15,5,1,13,13,53
400995516,Cincinnati Bearcats,A. Rizor,4067984,,True,34.0,6,11,6,11,0,0,3,3,6,6,12,1,3,1,0,1,15
400995516,Cincinnati Bearcats,S. Johnson,3064718,,True,21.0,1,7,1,4,0,3,1,2,1,7,8,0,1,1,2,4,3
400995516,Cincinnati Bearcats,S. Rodgers,4067985,,True,25.0,1,4,1,3,0,1,0,0,0,1,1,1,0,0,0,0,2
400995516,Cincinnati Bearcats,N. Goings,3904506,,True,31.0,4,10,4,7,0,3,1,1,2,5,7,1,0,0,3,0,9
400995516,Cincinnati Bearcats,A. Owens,3142321,,True,34.0,2,10,1,5,1,5,4,4,1,2,3,0,0,0,3,1,9
400995516,Cincinnati Bearcats,I. Thomas,4281072,,False,24.0,2,7,2,7,0,0,1,1,2,2,4,0,2,1,2,2,5
400995516,Cincinnati Bearcats,C. Warren,3904508,,False,2.0,0,1,0,1,0,0,0,0,0,0,0,0,0,0,0,0,0
400995516,Cincinnati Bearcats,A. Miller,4067986,,False,26.0,2,6,1,2,1,4,2,2,0,2,2,3,1,0,1,1,7
400995516,Cincinnati Bearcats,G. Parker,4065882,,False,3.0,0,1,0,1,0,0,0,0,0,0,0,0,0,0,1,1,0
400995516,Cincinnati Bearcats,TEAM,TOTAL,TOTAL,False,,18,57,16,41,2,16,12,13,12,28,40,6,7,3,12,10,50
400995514,Villanova Wildcats,M. Quinn,3056785,,True,22.0,3,8,1,4,2,4,4,4,1,5,6,2,0,1,0,1,12
400995514,Villanova Wildcats,J. Tucker,3087536,,True,33.0,4,10,2,4,2,6,0,0,0,2,2,2,2,1,0,1,10
400995514,Villanova Wildcats,K. Jekot,4068171,,True,25.0,0,6,0,5,0,1,1,2,0,4,4,1,0,1,2,0,1
400995514,Villanova Wildcats,A. Hahn,3906779,,True,40.0,7,14,5,7,2,7,3,4,1,5,6,4,1,0,1,1,19
400995514,Villanova Wildcats,A. Louin,3142314,,True,30.0,6,9,4,6,2,3,1,2,0,5,5,1,0,0,0,2,15
400995514,Villanova Wildcats,M. Gedaka,4068172,,False,20.0,3,8,3,8,0,0,1,1,1,0,1,1,0,1,1,2,7
400995514,Villanova Wildcats,B. Herlihy,3906778,,False,25.0,2,8,1,4,1,4,0,0,0,4,4,0,1,1,0,3,5
400995514,Villanova Wildcats,G. Stant,3906780,,False,5.0,0,0,0,0,0,0,0,0,2,0,2,1,0,0,0,1,0
400995514,Villanova Wildcats,TEAM,TOTAL,TOTAL,False,,25,63,16,38,9,25,10,13,7,30,37,12,4,5,5,11,69
400995514,Temple Owls,M. Davis,4281116,,True,28.0,6,14,6,13,0,1,1,1,2,7,9,2,0,0,1,4,13
400995514,Temple Owls,B. Perry,4281111,,True,25.0,1,7,1,4,0,3,1,4,2,3,5,1,0,0,1,0,3
400995514,Temple Owls,E. Mayo,4281115,,True,19.0,3,7,2,4,1,3,0,0,1,1,2,0,0,0,0,2,7
400995514,Temple Owls,T. Atkinson,3142687,,True,40.0,9,24,8,21,1,3,5,5,3,15,18,1,0,0,3,2,24
400995514,Temple Owls,K. Berger,3142686,,True,34.0,2,6,0,3,2,3,0,0,0,1,1,3,0,0,1,0,6
400995514,Temple Owls,L. Niang,3910479,,False,22.0,1,8,1,2,0,6,2,2,2,2,4,0,0,0,0,2,4
400995514,Temple Owls,S. Atkinson,4068164,,False,14.0,0,0,0,0,0,0,0,0,2,1,3,0,0,1,0,0,0
400995514,Temple Owls,D. Reynolds,3929726,,False,18.0,3,5,3,4,0,1,2,4,1,1,2,2,0,0,0,5,8
400995514,Temple Owls,TEAM,TOTAL,TOTAL,False,,25,71,21,51,4,20,11,16,17,32,49,9,0,1,6,15,65
400995510,UConn Huskies,N. Collier,3917450,,True,25.0,8,11,8,11,0,0,1,2,4,6,10,5,1,3,3,4,17
400995510,UConn Huskies,G. Williams,3142328,,True,23.0,5,7,5,7,0,0,1,1,2,8,10,7,1,1,7,1,11
400995510,UConn Huskies,K. Samuelson,3917453,,True,30.0,8,16,5,9,3,7,1,1,2,3,5,4,0,0,0,2,20
400995510,UConn Huskies,C. Dangerfield,4066585,,True,31.0,6,7,0,0,6,7,0,0,1,2,3,9,1,0,2,1,18
400995510,UConn Huskies,K. Nurse,3142327,,True,33.0,4,10,2,3,2,7,3,3,1,3,4,4,0,2,1,1,13
400995510,UConn Huskies,K. Irwin,4066586,,False,7.0,1,1,1,1,0,0,0,0,1,1,2,1,1,0,1,1,2
400995510,UConn Huskies,B. Camara,3922630,,False,4.0,0,1,0,1,0,0,0,0,1,2,3,0,0,0,0,0,0
400995510,UConn Huskies,A. Stevens,3142010,,False,21.0,7,9,7,8,0,1,2,2,2,7,9,3,0,4,3,1,16
400995510,UConn Huskies,M. Walker,4281077,,False,17.0,1,4,1,3,0,1,2,2,0,3,3,1,1,0,2,3,4
400995510,UConn Huskies,A. Espinoza-Hunter,4281075,,False,4.0,0,1,0,0,0,1,0,0,0,0,0,0,0,0,2,0,0
400995510,UConn Huskies,M. Bent,4066584,,False,5.0,1,2,1,2,0,0,0,0,0,0,0,0,0,0,3,2,2
400995510,UConn Huskies,TEAM,TOTAL,TOTAL,False,,41,69,30,45,11,24,10,11,15,38,53,34,5,10,24,16,103
400995510,DePaul Blue Demons,M. Grays,3142287,,True,26.0,4,10,3,7,1,3,0,0,2,2,4,1,2,0,1,3,9
400995510,DePaul Blue Demons,K. Campbell,4068071,,True,27.0,1,5,0,2,1,3,0,0,1,1,2,3,6,0,2,4,3
400995510,DePaul Blue Demons,T. Allen,3933760,,True,22.0,4,9,1,2,3,7,0,0,1,0,1,1,1,0,1,3,11
400995510,DePaul Blue Demons,A. Millender,3142289,,True,27.0,3,9,1,2,2,7,0,0,0,1,1,0,3,0,1,1,8
400995510,DePaul Blue Demons,A. Coleman,3142123,,True,26.0,5,17,3,9,2,8,4,5,1,2,3,3,1,0,3,2,16
400995510,DePaul Blue Demons,R. McLimore,4281358,,False,11.0,0,2,0,1,0,1,2,2,1,0,1,1,0,0,2,0,2
400995510,DePaul Blue Demons,C. Stonewall,4068072,,False,14.0,1,4,1,2,0,2,3,6,1,1,2,0,1,0,2,1,5
400995510,DePaul Blue Demons,V. Sherrod,4281359,,False,7.0,1,6,0,1,1,5,2,2,2,0,2,0,0,0,1,1,5
400995510,DePaul Blue Demons,D. Bekelja,4281356,,False,15.0,1,6,0,2,1,4,0,0,0,0,0,0,0,0,0,0,3
400995510,DePaul Blue Demons,D. Cage,4068073,,False,12.0,3,8,2,5,1,3,0,1,2,1,3,3,0,0,2,1,7
400995510,DePaul Blue Demons,L. Prochaska,3142290,,False,13.0,0,0,0,0,0,0,0,0,0,1,1,1,1,0,0,1,0
400995510,DePaul Blue Demons,TEAM,TOTAL,TOTAL,False,,23,76,11,33,12,43,11,16,16,11,27,13,15,0,15,17,69
400995472,South Florida Bulls,T. Henshaw,4068150,,True,14.0,4,8,4,8,0,0,0,0,3,0,3,0,0,2,0,3,8
400995472,South Florida Bulls,M. Jespersen,3142676,,True,40.0,6,14,6,11,0,3,2,2,2,10,12,5,2,0,2,2,14
400995472,South Florida Bulls,L. Ferreira,3142674,,True,38.0,7,13,5,6,2,7,1,2,1,4,5,4,3,1,1,3,17
400995472,South Florida Bulls,K. Laksa,3920741,,True,37.0,6,15,3,8,3,7,2,2,0,0,0,3,1,0,3,2,17
400995472,South Florida Bulls,L. Flores,3142675,,True,31.0,3,8,2,6,1,2,1,2,1,4,5,5,3,0,2,0,8
400995472,South Florida Bulls,S. Leverett,4068149,,False,26.0,1,2,1,2,0,0,0,2,1,2,3,0,1,2,0,0,2
400995472,South Florida Bulls,V. Blagmon,4281118,,False,3.0,0,1,0,1,0,0,0,0,0,0,0,0,0,0,1,1,0
400995472,South Florida Bulls,A. Prieto,4281117,,False,11.0,2,2,1,1,1,1,0,0,0,1,1,0,0,0,0,1,5
400995472,South Florida Bulls,TEAM,TOTAL,TOTAL,False,,29,63,22,43,7,20,6,10,12,25,37,17,10,5,9,12,71
400995472,Butler Bulldogs,T. Schickel,3914012,,True,39.0,9,16,9,16,0,0,0,0,7,8,15,2,1,4,3,2,18
400995472,Butler Bulldogs,S. Brey,4068067,,True,26.0,1,4,1,4,0,0,0,0,2,1,3,1,0,1,1,1,2
400995472,Butler Bulldogs,M. Weaver,3914014,,True,20.0,1,3,0,2,1,1,2,2,0,2,2,1,2,0,2,5,5
400995472,Butler Bulldogs,W. Jennings,3142145,,True,40.0,8,24,6,14,2,10,0,0,1,2,3,4,3,0,4,3,18
400995472,Butler Bulldogs,I. Lathan,3079485,,True,17.0,0,2,0,2,0,0,0,0,0,1,1,2,1,0,2,2,0
400995472,Butler Bulldogs,K. Hodges,4068065,,False,14.0,1,2,1,2,0,0,0,0,2,4,6,2,0,0,0,1,2
400995472,Butler Bulldogs,S. Humphrey,4068066,,False,1.0,0,0,0,0,0,0,0,0,0,0,0,0,0,0,0,0,0
400995472,Butler Bulldogs,S. Shelton,4068069,,False,16.0,0,4,0,0,0,4,0,0,0,1,1,0,0,0,1,1,0
400995472,Butler Bulldogs,K. Spolyar,4068068,,False,22.0,3,8,0,4,3,4,1,2,1,2,3,0,0,0,1,4,10
400995472,Butler Bulldogs,T. Buford,3914011,,False,0.0,0,0,0,0,0,0,0,0,0,0,0,0,0,0,0,0,0
400995472,Butler Bulldogs,S. Buck,3142279,,False,5.0,0,2,0,0,0,2,0,0,0,1,1,0,0,0,2,0,0
400995472,Butler Bulldogs,TEAM,TOTAL,TOTAL,False,,23,65,17,44,6,21,3,4,17,24,41,12,7,5,16,19,55
400995447,Wichita State Shockers,R. Bessard,3142161,,True,37.0,7,14,6,12,1,2,4,6,2,7,9,0,1,0,2,3,19
400995447,Wichita State Shockers,S. Lzada-Cabbge,4073914,,True,11.0,0,2,0,1,0,1,0,0,0,1,1,0,1,0,2,4,0
400995447,Wichita State Shockers,J. Preston,4068646,,True,24.0,2,9,2,8,0,1,2,3,0,1,1,0,1,0,0,0,6
400995447,Wichita State Shockers,K. Thompson,4068645,,True,32.0,8,15,8,12,0,3,1,2,5,3,8,6,2,0,1,3,17
400995447,Wichita State Shockers,D. Lockhart,3073479,,True,19.0,0,4,0,4,0,0,0,0,1,0,1,2,0,0,0,0,0
400995447,Wichita State Shockers,A. Faye,4281096,,False,5.0,0,0,0,0,0,0,0,0,0,1,1,0,1,0,1,0,0
400995447,Wichita State Shockers,A. Tompkins,4068648,,False,11.0,2,3,2,3,0,0,0,0,2,1,3,0,0,0,3,5,4
400995447,Wichita State Shockers,C. Ambrosio,4281097,,False,11.0,0,2,0,1,0,1,0,0,0,0,0,2,1,0,1,1,0
400995447,Wichita State Shockers,A. Stovall,3148855,,False,26.0,1,4,0,1,1,3,2,2,0,0,0,2,0,0,0,3,5
400995447,Wichita State Shockers,T. Lee,3142158,,False,23.0,3,6,1,2,2,4,2,2,0,3,3,0,0,0,0,2,10
400995447,Wichita State Shockers,TEAM,TOTAL,TOTAL,False,,23,59,19,44,4,15,11,15,10,19,29,12,7,0,10,21,61
400995447,Creighton Bluejays,A. Faber,3938938,,True,31.0,6,9,5,7,1,2,3,5,0,6,6,2,0,3,4,2,16
400995447,Creighton Bluejays,J. Agnew,3938935,,True,35.0,0,2,0,0,0,2,2,2,1,6,7,3,1,2,4,1,2
400995447,Creighton Bluejays,K. Brown,3142286,,True,9.0,1,1,1,1,0,0,0,0,0,3,3,1,0,1,1,0,2
400995447,Creighton Bluejays,S. Lamberty,3142285,,True,34.0,5,10,5,10,0,0,4,5,2,5,7,5,1,0,2,3,14
400995447,Creighton Bluejays,M. Mellman,3142283,,True,14.0,2,2,0,0,2,2,3,4,0,0,0,1,0,0,0,0,9
400995447,Creighton Bluejays,A. Greene,3938937,,False,10.0,1,1,1,1,0,0,0,0,0,1,1,0,0,0,0,1,2
400995447,Creighton Bluejays,B. Norby,3142284,,False,9.0,0,1,0,1,0,0,1,2,1,0,1,1,0,0,1,1,1
400995447,Creighton Bluejays,T. Carda,4281362,,False,22.0,4,7,4,6,0,1,0,0,0,4,4,1,0,0,1,4,8
400995447,Creighton Bluejays,T. Rembao,4281361,,False,12.0,0,0,0,0,0,0,0,0,0,0,0,1,1,0,1,1,0
400995447,Creighton Bluejays,O. Elger,3938936,,False,19.0,5,7,3,3,2,4,0,2,0,2,2,1,0,0,1,3,12
400995447,Creighton Bluejays,J. Owens,3142282,,False,0.0,0,0,0,0,0,0,0,0,0,0,0,0,0,0,1,0,0
400995447,Creighton Bluejays,B. Kissinger,3142124,,False,5.0,0,1,0,0,0,1,0,0,0,1,1,0,0,0,3,2,0
400995447,Creighton Bluejays,TEAM,TOTAL,TOTAL,False,,24,41,19,29,5,12,13,20,4,28,32,16,3,6,19,18,66
400995277,Xavier Musketeers,I. Partlow,3142320,,True,35.0,2,8,2,6,0,2,5,6,3,3,6,1,1,0,1,2,9
400995277,Xavier Musketeers,A. Aijanen,3142319,,True,39.0,3,11,0,1,3,10,3,4,0,6,6,0,0,3,3,3,12
400995277,Xavier Musketeers,N. Owens,4068187,,True,24.0,2,5,2,4,0,1,4,6,2,3,5,4,0,0,2,2,8
400995277,Xavier Musketeers,A. Gomez,4068185,,True,3.0,0,1,0,0,0,1,0,0,0,0,0,0,0,0,0,0,0
400995277,Xavier Musketeers,J. Byrd,3142318,,True,31.0,3,8,2,7,1,1,6,10,1,4,5,3,2,0,4,3,13
400995277,Xavier Musketeers,A. Gray,4281368,,False,10.0,2,2,0,0,2,2,2,2,0,1,1,1,0,0,1,3,8
400995277,Xavier Musketeers,D. Ross,4281364,,False,5.0,1,2,0,1,1,1,0,0,0,0,0,0,0,0,1,0,3
400995277,Xavier Musketeers,J. Dawson,4281369,,False,1.0,0,0,0,0,0,0,0,0,0,1,1,0,0,0,0,1,0
400995277,Xavier Musketeers,A. Reiff,4281367,,False,27.0,2,4,1,1,1,3,1,2,3,1,4,1,0,0,1,1,6
400995277,Xavier Musketeers,P. Stewart,4281366,,False,29.0,2,6,1,3,1,3,2,2,1,4,5,0,1,0,0,2,7
400995277,Xavier Musketeers,A. Dunham,4281365,,False,21.0,2,5,1,3,1,2,0,0,0,2,2,2,1,0,1,2,5
400995277,Xavier Musketeers,TEAM,TOTAL,TOTAL,False,,19,52,9,26,10,26,23,32,12,27,39,12,5,3,14,19,71
400995277,New Hampshire Wildcats,O. Healy,4080403,,True,39.0,2,8,2,6,0,2,5,6,3,4,7,5,4,2,2,3,9
400995277,New Hampshire Wildcats,K. Fogarty,3066823,,True,39.0,6,13,5,11,1,2,5,6,5,6,11,1,0,0,2,3,18
400995277,New Hampshire Wildcats,C. Pogue,3142078,,True,42.0,9,17,9,17,0,0,0,2,2,5,7,4,0,0,2,3,18
400995277,New Hampshire Wildcats,A. Simpson,3142075,,True,30.0,4,8,1,3,3,5,0,0,1,3,4,4,3,0,1,5,11
400995277,New Hampshire Wildcats,B. Lai,3066824,,True,43.0,3,14,3,12,0,2,4,4,0,4,4,4,2,0,2,4,10
400995277,New Hampshire Wildcats,M. Bassett-Smith,3142079,,False,6.0,0,1,0,1,0,0,0,0,1,0,1,0,0,0,1,0,0
400995277,New Hampshire Wildcats,A. Torres,4281156,,False,4.0,0,0,0,0,0,0,0,0,0,0,0,0,0,0,1,1,0
400995277,New Hampshire Wildcats,C. Soucy,4066622,,False,11.0,0,1,0,1,0,0,0,0,0,0,0,0,0,0,1,1,0
400995277,New Hampshire Wildcats,P. Booth,3142076,,False,11.0,0,0,0,0,0,0,0,0,1,1,2,0,0,0,1,1,0
400995277,New Hampshire Wildcats,TEAM,TOTAL,TOTAL,False,,24,62,20,51,4,11,14,18,13,25,38,18,9,2,13,21,66
400995208,Villanova Wildcats,M. Quinn,3056785,,True,19.0,3,4,3,4,0,0,0,0,1,5,6,6,0,0,3,1,6
400995208,Villanova Wildcats,J. Tucker,3087536,,True,28.0,4,11,2,5,2,6,0,0,0,3,3,0,1,0,2,1,10
400995208,Villanova Wildcats,K. Jekot,4068171,,True,34.0,4,9,3,7,1,2,1,1,3,4,7,2,2,0,2,1,10
400995208,Villanova Wildcats,A. Hahn,3906779,,True,34.0,7,20,3,6,4,14,0,0,0,1,1,3,1,0,0,4,18
400995208,Villanova Wildcats,A. Louin,3142314,,True,28.0,2,7,2,4,0,3,0,0,1,3,4,5,1,1,0,3,4
400995208,Villanova Wildcats,M. Gedaka,4068172,,False,23.0,7,9,7,9,0,0,1,2,4,7,11,0,1,4,2,1,15
400995208,Villanova Wildcats,B. Herlihy,4068169,,False,8.0,1,1,1,1,0,0,0,0,2,3,5,0,0,2,1,1,2
400995208,Villanova Wildcats,B. Herlihy,3906778,,False,8.0,2,2,0,0,2,2,0,0,0,0,0,0,1,1,2,1,6
400995208,Villanova Wildcats,G. Stant,3906780,,False,7.0,0,0,0,0,0,0,0,0,0,2,2,1,0,0,0,1,0
400995208,Villanova Wildcats,R. James,4068168,,False,2.0,0,0,0,0,0,0,0,0,0,0,0,0,0,0,0,1,0
400995208,Villanova Wildcats,C. Onken,4068167,,False,9.0,0,1,0,0,0,1,0,0,0,1,1,0,0,0,1,0,0
400995208,Villanova Wildcats,TEAM,TOTAL,TOTAL,False,,30,64,21,36,9,28,2,3,14,31,45,17,7,8,16,15,71
400995208,Hartford Hawks,J. Harrison,3147395,,True,20.0,2,7,2,6,0,1,1,2,0,4,4,1,1,0,1,3,5
400995208,Hartford Hawks,D. Lee,3147393,,True,36.0,7,14,7,14,0,0,3,5,6,2,8,0,0,0,2,2,17
400995208,Hartford Hawks,S. DaCosta,4066581,,True,34.0,1,8,1,7,0,1,5,6,2,4,6,0,0,0,2,2,7
400995208,Hartford Hawks,K. Douglass,3918377,,True,26.0,0,3,0,0,0,3,0,0,0,3,3,0,2,1,1,0,0
400995208,Hartford Hawks,L. Abed,3918376,,True,38.0,6,14,5,9,1,5,2,2,0,2,2,3,2,0,0,0,15
400995208,Hartford Hawks,C. Dobrzynski,4281148,,False,4.0,0,0,0,0,0,0,0,0,0,0,0,0,0,0,1,1,0
400995208,Hartford Hawks,J. Young,4281146,,False,15.0,1,5,1,4,0,1,1,1,1,2,3,1,1,1,2,3,3
400995208,Hartford Hawks,A. Douglas,3916496,,False,18.0,1,4,1,2,0,2,1,2,0,0,0,1,1,0,1,0,3
400995208,Hartford Hawks,M. Pattison,3147392,,False,9.0,0,3,0,1,0,2,3,4,1,0,1,0,0,0,0,2,3
400995208,Hartford Hawks,TEAM,TOTAL,TOTAL,False,,18,58,17,43,1,15,16,22,13,20,33,6,7,2,10,13,53
400995149,UAlbany Great Danes,H. Forster,3906806,,True,33.0,2,4,2,4,0,0,2,2,4,3,7,2,2,1,4,4,6
400995149,UAlbany Great Danes,T. Carter,3142025,,True,20.0,4,8,4,8,0,0,3,4,2,2,4,0,2,2,1,4,11
400995149,UAlbany Great Danes,J. Féquière,3067586,,True,40.0,6,18,4,10,2,8,7,8,3,3,6,2,3,0,1,1,21
400995149,UAlbany Great Danes,M. Trpcic,4066570,,True,27.0,2,7,0,1,2,6,2,2,1,1,2,8,1,1,3,3,8
400995149,UAlbany Great Danes,B. Aiyalogbe,3067583,,True,28.0,2,9,1,3,1,6,0,0,1,2,3,2,0,0,2,5,5
400995149,UAlbany Great Danes,C. Canada,3929727,,False,27.0,4,7,4,7,0,0,3,4,2,0,2,0,2,2,1,2,11
400995149,UAlbany Great Danes,C. Mayo,4281133,,False,0.0,0,0,0,0,0,0,0,0,0,0,0,0,0,0,0,0,0
400995149,UAlbany Great Danes,E. List,4281132,,False,12.0,2,3,2,3,0,0,0,0,0,0,0,1,1,0,1,1,4
400995149,UAlbany Great Danes,K. Frames,4281128,,False,13.0,0,3,0,1,0,2,0,0,0,2,2,2,0,0,1,0,0
400995149,UAlbany Great Danes,TEAM,TOTAL,TOTAL,False,,22,59,17,37,5,22,17,20,17,14,31,17,11,6,15,20,66
400995149,St. John's Red Storm,M. Singleton,4068158,,True,22.0,3,11,3,11,0,0,1,4,3,4,7,1,2,1,1,4,7
400995149,St. John's Red Storm,I. Littleton,3142306,,True,34.0,4,6,4,6,0,0,0,1,1,2,3,0,2,1,2,4,8
400995149,St. John's Red Storm,A. Wellere,3906771,,True,20.0,2,6,2,3,0,3,2,2,0,1,1,2,1,0,4,5,6
400995149,St. John's Red Storm,T. England,4068155,,True,39.0,6,6,5,5,1,1,3,4,2,5,7,9,0,0,7,3,16
400995149,St. John's Red Storm,A. Kebbe,4068154,,True,7.0,0,0,0,0,0,0,0,0,0,1,1,0,0,0,2,0,0
400995149,St. John's Red Storm,K. Charles,4281374,,False,15.0,2,3,2,3,0,0,0,2,1,4,5,0,3,2,1,1,4
400995149,St. John's Red Storm,C. Brelove,3142472,,False,0.0,0,0,0,0,0,0,0,0,0,0,0,0,0,0,1,0,0
400995149,St. John's Red Storm,Q. Hoppie,4281375,,False,28.0,1,4,1,3,0,1,3,4,0,0,0,6,1,1,1,2,5
400995149,St. John's Red Storm,A. Adams,4068157,,False,33.0,8,10,2,3,6,7,1,1,1,1,2,2,0,1,2,3,23
400995149,St. John's Red Storm,T. Alexander,3142305,,False,2.0,1,1,1,1,0,0,0,0,0,0,0,0,0,0,0,0,2
400995149,St. John's Red Storm,TEAM,TOTAL,TOTAL,False,,27,47,20,35,7,12,10,18,9,21,30,20,9,6,22,22,71
400995008,Florida State Seminoles,S. Thomas,3142022,,True,17.0,3,7,3,7,0,0,0,0,1,4,5,1,2,0,1,3,6
400995008,Florida State Seminoles,C. White,3142125,,True,27.0,7,13,6,12,1,1,4,5,7,4,11,0,0,1,1,1,19
400995008,Florida State Seminoles,A. Degbeon,3142020,,True,29.0,6,9,6,9,0,0,0,0,4,2,6,1,0,2,0,3,12
400995008,Florida State Seminoles,A. Alix,3065700,,True,34.0,6,10,5,8,1,2,4,5,2,4,6,6,1,0,0,2,17
400995008,Florida State Seminoles,I. Wright,3054094,,True,37.0,6,11,3,5,3,6,1,1,0,3,3,3,0,0,0,3,16
400995008,Florida State Seminoles,I. Lopez,4065831,,False,2.0,0,0,0,0,0,0,2,2,0,0,0,0,0,0,0,0,2
400995008,Florida State Seminoles,S. Wilkinson,4281175,,False,5.0,0,1,0,1,0,0,0,0,0,0,0,0,0,0,1,0,0
400995008,Florida State Seminoles,N. Woolfolk,4065830,,False,25.0,3,11,3,8,0,3,4,5,1,3,4,1,2,0,1,3,10
400995008,Florida State Seminoles,N. Ekhomu,4065828,,False,24.0,4,8,4,8,0,0,2,4,1,6,7,1,0,1,4,5,10
400995008,Florida State Seminoles,TEAM,TOTAL,TOTAL,False,,35,70,30,58,5,12,17,22,17,27,44,13,5,4,8,20,92
400995008,Creighton Bluejays,A. Faber,3938938,,True,34.0,9,19,2,8,7,11,5,6,1,7,8,2,0,2,2,2,30
400995008,Creighton Bluejays,J. Agnew,3938935,,True,33.0,6,12,2,4,4,8,1,2,3,2,5,1,0,1,0,5,17
400995008,Creighton Bluejays,B. Norby,3142284,,True,7.0,0,1,0,1,0,0,0,0,0,1,1,1,0,0,1,0,0
400995008,Creighton Bluejays,T. Carda,4281362,,True,25.0,3,7,3,4,0,3,2,2,1,2,3,2,0,0,2,3,8
400995008,Creighton Bluejays,S. Lamberty,3142285,,True,38.0,2,8,2,4,0,4,0,0,4,6,10,9,0,0,1,1,4
400995008,Creighton Bluejays,A. Greene,3938937,,False,6.0,0,0,0,0,0,0,0,0,0,0,0,0,0,0,0,2,0
400995008,Creighton Bluejays,K. Brown,3142286,,False,13.0,0,3,0,3,0,0,0,0,0,0,0,1,0,1,0,1,0
400995008,Creighton Bluejays,T. Rembao,4281361,,False,12.0,0,1,0,1,0,0,0,0,2,1,3,3,1,0,2,0,0
400995008,Creighton Bluejays,O. Elger,3938936,,False,22.0,7,14,2,6,5,8,1,3,0,0,0,2,1,0,2,2,20
400995008,Creighton Bluejays,M. Mellman,3142283,,False,10.0,1,1,0,0,1,1,0,0,0,1,1,2,0,0,0,1,3
400995008,Creighton Bluejays,TEAM,TOTAL,TOTAL,False,,28,66,11,31,17,35,9,13,12,22,34,23,2,4,10,17,82
400995004,Providence Friars,B. Frias,3142302,,True,15.0,0,0,0,0,0,0,0,0,0,1,1,1,1,1,2,1,0
400995004,Providence Friars,N. Jackson,4068111,,True,25.0,0,2,0,2,0,0,0,0,1,4,5,3,1,0,3,1,0
400995004,Providence Friars,J. Nogic,3906769,,True,33.0,4,13,2,6,2,7,8,10,0,3,3,3,1,0,1,1,18
400995004,Providence Friars,M. Jolin,3906767,,True,21.0,1,4,0,2,1,2,1,4,0,8,8,1,1,0,1,1,4
400995004,Providence Friars,A. Botteghi,3142301,,True,25.0,5,8,5,8,0,0,0,1,1,1,2,0,0,0,1,1,10
400995004,Providence Friars,N. Franklin,4281348,,False,21.0,5,6,5,6,0,0,3,5,1,5,6,2,1,0,3,3,13
400995004,Providence Friars,O. Orlando,4281347,,False,16.0,1,3,1,3,0,0,0,0,1,2,3,1,0,0,0,1,2
400995004,Providence Friars,K. Spiwak,4281346,,False,9.0,0,0,0,0,0,0,0,0,0,1,1,0,0,0,0,0,0
400995004,Providence Friars,C. Williams,4281345,,False,4.0,0,0,0,0,0,0,1,2,0,0,0,0,0,0,0,2,1
400995004,Providence Friars,C. Che,3906766,,False,31.0,6,10,4,6,2,4,1,2,0,1,1,1,0,0,1,1,15
400995004,Providence Friars,TEAM,TOTAL,TOTAL,False,,22,46,17,33,5,13,14,24,4,26,30,12,5,1,14,12,63
400995004,Boston College Eagles,G. Pineau,4065798,,True,30.0,3,5,3,5,0,0,3,4,1,8,9,2,0,1,4,5,9
400995004,Boston College Eagles,M. Bolden-Morris,4281188,,True,37.0,6,13,2,5,4,8,0,0,1,4,5,0,0,0,4,1,16
400995004,Boston College Eagles,A. Anastos,4281187,,True,35.0,1,2,1,2,0,0,1,2,0,6,6,3,1,0,3,4,3
400995004,Boston College Eagles,T. Ortlepp,4065799,,True,34.0,4,11,2,4,2,7,2,2,0,0,0,0,2,0,1,1,12
400995004,Boston College Eagles,M. Mosetti,3141988,,True,34.0,2,8,2,7,0,1,1,2,0,2,2,7,2,0,2,4,5
400995004,Boston College Eagles,S. Lowery,4281189,,False,16.0,2,3,2,2,0,1,2,2,0,1,1,1,0,0,1,4,6
400995004,Boston College Eagles,K. Quandt,3141989,,False,11.0,2,6,2,6,0,0,0,0,0,2,2,1,0,0,1,2,4
400995004,Boston College Eagles,R. Gartner,3141986,,False,3.0,0,0,0,0,0,0,0,0,0,1,1,0,0,0,1,1,0
400995004,Boston College Eagles,TEAM,TOTAL,TOTAL,False,,20,48,14,31,6,17,9,12,4,25,29,14,5,1,17,22,55
400994994,Notre Dame Fighting Irish,J. Shepard,3906949,,True,33.0,17,22,17,22,0,0,5,6,6,5,11,3,1,3,4,0,39
400994994,Notre Dame Fighting Irish,K. Westbeld,3142087,,True,19.0,4,5,4,5,0,0,2,2,0,3,3,1,0,1,1,0,10
400994994,Notre Dame Fighting Irish,J. Young,4065870,,True,36.0,1,6,1,4,0,2,2,4,1,6,7,4,1,4,4,2,4
400994994,Notre Dame Fighting Irish,A. Ogunbowale,3904577,,True,35.0,8,17,5,13,3,4,2,4,0,7,7,4,0,1,1,0,21
400994994,Notre Dame Fighting Irish,M. Mabrey,3904576,,True,36.0,2,10,1,7,1,3,8,8,1,7,8,6,1,2,3,2,13
400994994,Notre Dame Fighting Irish,D. Patterson,4281207,,False,5.0,0,1,0,1,0,0,0,0,0,0,0,0,0,0,0,0,0
400994994,Notre Dame Fighting Irish,M. Butler,4281205,,False,0.0,0,0,0,0,0,0,0,0,0,0,0,0,0,0,0,0,0
400994994,Notre Dame Fighting Irish,K. Nelson,3058909,,False,4.0,0,0,0,0,0,0,0,0,0,0,0,0,0,0,1,0,0
400994994,Notre Dame Fighting Irish,K. Cole,4281206,,False,0.0,0,0,0,0,0,0,0,0,0,0,0,0,0,0,0,0,0
400994994,Notre Dame Fighting Irish,L. Thompson,3056731,,False,32.0,2,5,2,4,0,1,0,0,0,5,5,4,4,2,5,3,4
400994994,Notre Dame Fighting Irish,TEAM,TOTAL,TOTAL,False,,34,66,30,56,4,10,19,24,11,35,46,22,7,13,19,7,91
400994994,DePaul Blue Demons,M. Grays,3142287,,True,19.0,4,9,3,6,1,3,0,0,1,2,3,1,0,0,2,5,9
400994994,DePaul Blue Demons,K. Campbell,4068071,,True,39.0,3,12,3,7,0,5,0,0,2,6,8,4,2,0,1,5,6
400994994,DePaul Blue Demons,L. Prochaska,3142290,,True,11.0,0,1,0,1,0,0,0,0,0,1,1,0,1,0,1,0,0
400994994,DePaul Blue Demons,A. Millender,3142289,,True,36.0,7,11,3,3,4,8,0,0,0,4,4,0,1,1,2,2,18
400994994,DePaul Blue Demons,A. Coleman,3142123,,True,26.0,6,21,5,14,1,7,4,4,3,0,3,2,2,0,1,3,17
400994994,DePaul Blue Demons,R. McLimore,4281358,,False,1.0,0,1,0,1,0,0,0,0,1,0,1,0,0,0,0,0,0
400994994,DePaul Blue Demons,C. Stonewall,4068072,,False,31.0,6,11,2,7,4,4,0,0,1,6,7,4,3,1,1,3,16
400994994,DePaul Blue Demons,D. Bekelja,4281356,,False,11.0,2,7,1,4,1,3,0,0,1,4,5,1,1,0,2,1,5
400994994,DePaul Blue Demons,D. Cage,4068073,,False,14.0,3,7,1,4,2,3,0,0,2,1,3,2,1,0,4,3,8
400994994,DePaul Blue Demons,T. Allen,3933760,,False,12.0,1,4,1,1,0,3,1,1,0,0,0,1,0,0,1,0,3
400994994,DePaul Blue Demons,TEAM,TOTAL,TOTAL,False,,32,84,19,48,13,36,5,5,15,24,39,15,11,2,15,22,82
400994986,NC State Wolfpack,C. Nelson,3142080,,True,24.0,4,11,4,9,0,2,2,2,0,8,8,3,0,1,0,3,10
400994986,NC State Wolfpack,A. Maize,3142084,,True,31.0,5,8,5,8,0,0,3,4,3,4,7,1,1,1,5,3,13
400994986,NC State Wolfpack,A. Konig,4065866,,True,40.0,6,13,2,2,4,11,0,0,0,5,5,4,0,0,2,2,16
400994986,NC State Wolfpack,K. Ealey,3910476,,True,27.0,0,4,0,4,0,0,0,0,4,3,7,6,2,0,2,2,0
400994986,NC State Wolfpack,K. Leslie,3142149,,True,37.0,6,10,5,7,1,3,3,5,2,5,7,2,1,2,4,1,16
400994986,NC State Wolfpack,K. Jones,4281199,,False,1.0,0,0,0,0,0,0,0,0,0,0,0,0,0,0,0,0,0
400994986,NC State Wolfpack,D. Rogers,3910477,,False,7.0,1,2,1,1,0,1,1,1,1,1,2,0,1,0,0,0,3
400994986,NC State Wolfpack,N. Cole,3910480,,False,1.0,0,0,0,0,0,0,0,0,0,0,0,0,0,0,0,0,0
400994986,NC State Wolfpack,E. Cassell,4065868,,False,16.0,2,5,1,2,1,3,0,0,3,8,11,0,0,1,4,1,5
400994986,NC State Wolfpack,K. Crutchfield,4281198,,False,4.0,0,1,0,0,0,1,0,0,0,0,0,0,0,0,0,0,0
400994986,NC State Wolfpack,L. Rudd,4065867,,False,12.0,0,5,0,3,0,2,0,0,0,2,2,0,1,0,1,0,0
400994986,NC State Wolfpack,TEAM,TOTAL,TOTAL,False,,24,59,18,36,6,23,9,12,13,37,50,16,6,5,19,12,63
400994986,Georgetown Hoyas,C. Petke,4068078,,True,39.0,6,16,5,12,1,4,2,2,1,9,10,0,2,1,0,2,15
400994986,Georgetown Hoyas,Y. Belk,3142295,,True,17.0,2,4,2,4,0,0,0,0,1,2,3,2,0,0,1,3,4
400994986,Georgetown Hoyas,D. White,3948815,,True,32.0,4,15,3,10,1,5,0,2,1,4,5,3,4,0,3,2,9
400994986,Georgetown Hoyas,D. Burton,3142292,,True,34.0,0,3,0,3,0,0,0,0,1,2,3,2,1,0,2,1,0
400994986,Georgetown Hoyas,M. Venson,3142105,,True,40.0,6,9,4,7,2,2,0,1,0,1,1,3,1,0,3,3,14
400994986,Georgetown Hoyas,T. Thompson,4281352,,False,19.0,2,13,2,8,0,5,3,4,1,2,3,0,0,0,1,1,7
400994986,Georgetown Hoyas,M. Smith,4068079,,False,12.0,0,0,0,0,0,0,0,0,1,1,2,1,0,0,2,1,0
400994986,Georgetown Hoyas,B. Mayfield,4281354,,False,7.0,0,1,0,1,0,0,0,0,0,1,1,0,0,0,0,1,0
400994986,Georgetown Hoyas,TEAM,TOTAL,TOTAL,False,,20,61,16,45,4,16,5,9,7,23,30,11,8,1,12,14,49
400994983,Seton Hall Pirates,S. Samuels,4068128,,True,24.0,3,5,3,4,0,1,0,1,1,5,6,2,1,2,3,2,6
400994983,Seton Hall Pirates,T. Brown,3941336,,True,22.0,3,6,3,6,0,0,0,2,3,2,5,1,1,0,2,2,6
400994983,Seton Hall Pirates,D. Fountain,3058890,,True,30.0,8,15,8,12,0,3,5,6,1,9,10,1,0,1,1,2,21
400994983,Seton Hall Pirates,K. Hilaire,4068123,,True,28.0,3,7,3,6,0,1,0,0,0,4,4,8,2,0,2,1,6
400994983,Seton Hall Pirates,J. Jackson,3064877,,True,27.0,5,11,1,5,4,6,1,2,2,1,3,1,2,1,0,1,15
400994983,Seton Hall Pirates,S. Philoxy,4281380,,False,2.0,0,0,0,0,0,0,0,0,0,0,0,1,0,0,1,0,0
400994983,Seton Hall Pirates,K. Evans,4281378,,False,12.0,2,2,2,2,0,0,0,0,1,1,2,0,0,1,1,3,4
400994983,Seton Hall Pirates,J. Jones-Pack,4068129,,False,21.0,1,5,1,5,0,0,2,2,2,1,3,0,1,3,3,2,4
400994983,Seton Hall Pirates,D. Winters,4068126,,False,12.0,1,3,1,2,0,1,0,0,0,3,3,0,0,1,0,1,2
400994983,Seton Hall Pirates,N. Jimenez,4281379,,False,11.0,1,4,0,2,1,2,0,0,0,1,1,2,1,0,0,1,3
400994983,Seton Hall Pirates,T. Smith,4068124,,False,6.0,1,3,0,1,1,2,0,0,0,1,1,0,0,0,1,2,3
400994983,Seton Hall Pirates,K. Healy,3943704,,False,5.0,1,1,0,0,1,1,0,0,0,1,1,0,0,0,0,0,3
400994983,Seton Hall Pirates,TEAM,TOTAL,TOTAL,False,,29,62,22,45,7,17,8,13,12,30,42,16,8,9,14,17,73
400994983,Boston College Eagles,E. Guy,4065800,,True,11.0,3,6,3,6,0,0,0,0,2,4,6,0,0,0,3,2,6
400994983,Boston College Eagles,G. Pineau,4065798,,True,36.0,8,14,8,14,0,0,2,3,3,5,8,3,1,2,2,4,18
400994983,Boston College Eagles,S. Lowery,4281189,,True,26.0,0,11,0,7,0,4,0,0,1,0,1,0,0,0,2,0,0
400994983,Boston College Eagles,M. Bolden-Morris,4281188,,True,28.0,2,13,1,4,1,9,0,0,0,2,2,0,2,0,1,1,5
400994983,Boston College Eagles,T. Ortlepp,4065799,,True,35.0,2,13,2,6,0,7,2,2,0,1,1,4,2,0,2,2,6
400994983,Boston College Eagles,K. Quandt,3141989,,False,24.0,4,6,4,6,0,0,1,1,2,5,7,0,0,3,1,1,9
400994983,Boston College Eagles,A. Anastos,4281187,,False,33.0,1,1,0,0,1,1,4,6,0,0,0,5,0,0,2,2,7
400994983,Boston College Eagles,R. Gartner,3141986,,False,7.0,1,3,1,2,0,1,0,0,0,1,1,1,0,0,1,0,2
400994983,Boston College Eagles,TEAM,TOTAL,TOTAL,False,,21,67,19,45,2,22,9,12,17,24,41,13,5,5,14,12,53
400994967,Xavier Musketeers,A. Gray,4281368,,True,28.0,4,13,4,12,0,1,0,0,5,5,10,1,0,1,1,3,8
400994967,Xavier Musketeers,A. Aijanen,3142319,,True,30.0,7,11,5,8,2,3,0,0,1,1,2,1,2,2,3,1,16
400994967,Xavier Musketeers,N. Owens,4068187,,True,26.0,5,10,2,5,3,5,0,0,0,2,2,3,0,0,0,1,13
400994967,Xavier Musketeers,A. Gomez,4068185,,True,20.0,1,9,0,2,1,7,0,0,1,1,2,2,0,0,0,0,3
400994967,Xavier Musketeers,J. Byrd,3142318,,True,30.0,4,6,4,5,0,1,1,5,2,4,6,5,1,0,6,1,9
400994967,Xavier Musketeers,D. Ross,4281364,,False,19.0,2,3,1,1,1,2,0,0,1,5,6,0,0,3,2,4,5
400994967,Xavier Musketeers,J. Dawson,4281369,,False,2.0,0,0,0,0,0,0,0,0,0,0,0,0,0,0,0,0,0
400994967,Xavier Musketeers,A. Reiff,4281367,,False,12.0,0,0,0,0,0,0,0,0,0,1,1,0,1,1,0,1,0
400994967,Xavier Musketeers,P. Stewart,4281366,,False,11.0,0,3,0,2,0,1,0,0,0,1,1,1,0,0,1,0,0
400994967,Xavier Musketeers,A. Dunham,4281365,,False,15.0,1,3,0,1,1,2,0,0,0,0,0,3,1,0,1,1,3
400994967,Xavier Musketeers,K. Fincher,3142317,,False,7.0,0,3,0,2,0,1,0,0,0,0,0,0,0,0,1,1,0
400994967,Xavier Musketeers,TEAM,TOTAL,TOTAL,False,,24,61,16,38,8,23,1,5,12,21,33,16,5,7,15,13,57
400994967,Wake Forest Demon Deacons,O. Udoh,4065889,,True,21.0,2,4,2,4,0,0,0,0,1,4,5,0,2,2,1,3,4
400994967,Wake Forest Demon Deacons,E. Penna,3959169,,True,31.0,5,8,5,7,0,1,4,6,2,5,7,2,0,1,4,0,14
400994967,Wake Forest Demon Deacons,A. Sharp,4065886,,True,34.0,4,6,4,5,0,1,3,3,3,6,9,5,1,0,2,2,11
400994967,Wake Forest Demon Deacons,A. Stephenson,3904606,,True,37.0,7,16,3,8,4,8,0,0,1,3,4,1,1,0,2,0,18
400994967,Wake Forest Demon Deacons,A. Campbell,3142120,,True,33.0,4,9,4,9,0,0,3,4,2,4,6,3,4,0,3,1,11
400994967,Wake Forest Demon Deacons,I. Raca,4281231,,False,9.0,0,1,0,1,0,0,0,0,0,1,1,0,0,0,2,1,0
400994967,Wake Forest Demon Deacons,M. Banks,4281229,,False,2.0,0,0,0,0,0,0,0,0,0,1,1,1,0,0,0,0,0
400994967,Wake Forest Demon Deacons,T. Whitehead,4065888,,False,15.0,1,6,1,6,0,0,0,0,2,2,4,0,0,0,2,1,2
400994967,Wake Forest Demon Deacons,R. Branch,4065887,,False,4.0,1,1,1,1,0,0,0,0,0,0,0,0,0,1,0,0,2
400994967,Wake Forest Demon Deacons,G. Conti,4281230,,False,14.0,0,4,0,3,0,1,0,0,0,1,1,1,1,1,0,0,0
400994967,Wake Forest Demon Deacons,TEAM,TOTAL,TOTAL,False,,24,55,20,44,4,11,10,13,12,27,39,13,9,5,16,8,62
400994958,St. John's Red Storm,M. Singleton,4068158,,True,37.0,7,15,7,15,0,0,1,2,5,12,17,4,3,3,3,5,15
400994958,St. John's Red Storm,I. Littleton,3142306,,True,25.0,1,3,1,3,0,0,2,3,2,1,3,0,0,2,1,4,4
400994958,St. John's Red Storm,A. Wellere,3906771,,True,21.0,5,12,3,7,2,5,0,0,1,0,1,1,1,0,3,3,12
400994958,St. John's Red Storm,Q. Hoppie,4281375,,True,36.0,6,10,2,3,4,7,0,0,0,2,2,2,2,1,3,1,16
400994958,St. John's Red Storm,T. England,4068155,,True,39.0,5,9,5,7,0,2,3,3,0,1,1,6,1,0,3,1,13
400994958,St. John's Red Storm,K. Charles,4281374,,False,7.0,0,1,0,1,0,0,1,2,3,3,6,0,0,0,1,3,1
400994958,St. John's Red Storm,A. Adams,4068157,,False,28.0,4,10,2,5,2,5,3,4,0,0,0,2,0,0,0,2,13
400994958,St. John's Red Storm,T. Alexander,3142305,,False,7.0,0,2,0,2,0,0,0,2,0,1,1,1,1,0,1,0,0
400994958,St. John's Red Storm,TEAM,TOTAL,TOTAL,False,,28,62,20,43,8,19,10,16,12,22,34,16,8,6,17,19,74
400994958,Miami Hurricanes,K. Harris,3142065,,True,25.0,4,6,3,4,1,2,0,0,0,3,3,4,1,0,2,1,9
400994958,Miami Hurricanes,E. Hof,3913680,,True,21.0,2,3,2,3,0,0,2,2,1,4,5,0,1,1,2,3,6
400994958,Miami Hurricanes,E. Davenport,3142068,,True,31.0,2,5,2,5,0,0,3,3,2,6,8,2,1,0,3,3,7
400994958,Miami Hurricanes,M. Gray,4281194,,True,20.0,1,9,0,4,1,5,2,2,0,0,0,2,1,0,2,3,5
400994958,Miami Hurricanes,E. Banks,4281193,,True,26.0,4,10,3,8,1,2,1,1,3,3,6,0,0,0,4,1,10
400994958,Miami Hurricanes,S. Mortensen,4065855,,False,10.0,2,2,1,1,1,1,1,4,1,0,1,1,0,0,0,2,6
400994958,Miami Hurricanes,S. Bailey,3064861,,False,15.0,2,4,2,4,0,0,3,4,2,3,5,0,0,0,0,1,7
400994958,Miami Hurricanes,S. Geldof,4065854,,False,7.0,1,4,1,4,0,0,2,2,4,1,5,0,0,2,3,2,4
400994958,Miami Hurricanes,K. Marshall,4281196,,False,22.0,3,11,1,4,2,7,0,0,0,1,1,2,0,0,3,3,8
400994958,Miami Hurricanes,T. Mason,4281195,,False,12.0,0,2,0,2,0,0,2,2,1,0,1,1,1,0,1,2,2
400994958,Miami Hurricanes,N. Petithomme,3142204,,False,11.0,0,2,0,1,0,1,0,0,0,1,1,0,1,0,3,0,0
400994958,Miami Hurricanes,TEAM,TOTAL,TOTAL,False,,21,58,15,40,6,18,16,20,18,23,41,12,6,3,23,21,64
400994938,Virginia Tech Hokies,A. Jean,3932486,,True,24.0,2,11,1,7,1,4,1,4,3,6,9,1,0,0,0,4,6
400994938,Virginia Tech Hokies,R. Magarity,3142115,,True,36.0,5,16,4,10,1,6,2,3,5,6,11,0,1,1,4,4,13
400994938,Virginia Tech Hokies,K. Brooks,4065884,,True,20.0,2,8,0,0,2,8,0,0,1,1,2,1,1,0,1,2,6
400994938,Virginia Tech Hokies,C. Hicks,3949114,,True,39.0,4,12,4,12,0,0,4,5,0,2,2,12,5,0,4,3,12
400994938,Virginia Tech Hokies,T. Emery,3904531,,True,36.0,5,9,4,8,1,1,9,9,3,0,3,0,1,1,1,2,20
400994938,Virginia Tech Hokies,M. Berry,3934229,,False,6.0,0,1,0,1,0,0,0,0,0,1,1,0,0,0,0,1,0
400994938,Virginia Tech Hokies,A. Sheppard,4281223,,False,18.0,4,8,0,2,4,6,1,1,0,0,0,0,1,0,1,2,13
400994938,Virginia Tech Hokies,R. Camp,3142117,,False,21.0,3,7,2,5,1,2,0,0,2,2,4,0,1,0,1,2,7
400994938,Virginia Tech Hokies,TEAM,TOTAL,TOTAL,False,,25,72,15,45,10,27,17,22,17,22,39,14,10,2,12,20,77
400994938,Butler Bulldogs,S. Brey,4068067,,True,23.0,0,2,0,2,0,0,0,0,3,3,6,1,1,1,2,2,0
400994938,Butler Bulldogs,T. Schickel,3914012,,True,40.0,12,18,12,18,0,0,3,4,2,13,15,2,2,1,3,3,27
400994938,Butler Bulldogs,M. Weaver,3914014,,True,37.0,2,4,2,3,0,1,1,3,0,3,3,6,1,0,5,3,5
400994938,Butler Bulldogs,W. Jennings,3142145,,True,37.0,4,11,2,5,2,6,0,2,0,4,4,7,1,0,0,4,10
400994938,Butler Bulldogs,I. Lathan,3079485,,True,25.0,4,8,4,7,0,1,2,2,0,2,2,1,1,0,5,1,10
400994938,Butler Bulldogs,A. Aube,4281363,,False,1.0,0,0,0,0,0,0,0,0,0,0,0,0,0,0,0,0,0
400994938,Butler Bulldogs,K. Hodges,4068065,,False,7.0,0,0,0,0,0,0,2,2,2,1,3,0,0,0,0,2,2
400994938,Butler Bulldogs,S. Humphrey,4068066,,False,0.0,0,0,0,0,0,0,0,0,0,0,0,0,0,0,0,0,0
400994938,Butler Bulldogs,S. Shelton,4068069,,False,3.0,0,0,0,0,0,0,2,2,0,1,1,0,0,0,2,0,2
400994938,Butler Bulldogs,K. Spolyar,4068068,,False,24.0,5,11,2,3,3,8,7,7,1,3,4,1,0,0,3,2,20
400994938,Butler Bulldogs,S. Buck,3142279,,False,3.0,1,2,0,0,1,2,0,0,0,0,0,0,0,0,0,0,3
400994938,Butler Bulldogs,TEAM,TOTAL,TOTAL,False,,28,56,22,38,6,18,17,22,8,31,39,18,6,2,20,17,79
400994918,Villanova Wildcats,M. Quinn,3056785,,True,26.0,0,3,0,2,0,1,2,2,4,2,6,2,1,2,3,1,2
400994918,Villanova Wildcats,J. Tucker,3087536,,True,26.0,4,14,2,3,2,11,0,0,0,0,0,1,0,1,1,3,10
400994918,Villanova Wildcats,K. Jekot,4068171,,True,37.0,8,14,1,5,7,9,0,0,1,2,3,2,1,0,2,1,23
400994918,Villanova Wildcats,A. Hahn,3906779,,True,37.0,3,9,0,0,3,9,0,0,0,1,1,5,0,0,1,3,9
400994918,Villanova Wildcats,A. Louin,3142314,,True,38.0,4,10,1,3,3,7,6,7,0,9,9,4,4,1,0,2,17
400994918,Villanova Wildcats,M. Gedaka,4068172,,False,16.0,0,0,0,0,0,0,1,2,1,3,4,0,1,0,1,1,1
400994918,Villanova Wildcats,B. Herlihy,4068169,,False,6.0,0,2,0,1,0,1,0,0,0,0,0,0,0,0,0,1,0
400994918,Villanova Wildcats,B. Herlihy,3906778,,False,12.0,1,3,1,1,0,2,0,0,0,0,0,1,1,2,0,1,2
400994918,Villanova Wildcats,G. Stant,3906780,,False,1.0,0,0,0,0,0,0,0,0,0,0,0,0,0,0,0,2,0
400994918,Villanova Wildcats,C. Onken,4068167,,False,1.0,0,0,0,0,0,0,0,0,0,0,0,0,0,0,0,0,0
400994918,Villanova Wildcats,TEAM,TOTAL,TOTAL,False,,20,55,5,15,15,40,9,11,8,18,26,15,8,6,8,15,64
400994918,Duke Blue Devils,L. Odom,4065818,,True,38.0,5,10,5,10,0,0,3,4,7,5,12,1,1,1,4,2,13
400994918,Duke Blue Devils,E. Mathias,3142013,,True,25.0,2,5,2,5,0,0,1,2,2,4,6,2,1,0,1,2,5
400994918,Duke Blue Devils,M. Boykin,4281177,,True,29.0,1,7,1,6,0,1,1,2,2,0,2,2,1,0,4,3,3
400994918,Duke Blue Devils,L. Brown,3058892,,True,29.0,6,13,5,8,1,5,3,3,0,3,3,1,1,0,2,5,16
400994918,Duke Blue Devils,R. Greenwell,18759,,True,37.0,4,14,3,9,1,5,0,0,1,5,6,0,1,0,1,3,9
400994918,Duke Blue Devils,J. Williams,4281179,,False,13.0,0,2,0,2,0,0,2,4,4,3,7,2,0,0,2,4,2
400994918,Duke Blue Devils,F. Suggs,3904547,,False,3.0,0,1,0,1,0,0,0,0,0,0,0,0,0,0,0,1,0
400994918,Duke Blue Devils,B. Faz Davalos,3079479,,False,5.0,0,0,0,0,0,0,0,0,0,2,2,0,0,0,1,0,0
400994918,Duke Blue Devils,J. Adams,4281176,,False,5.0,1,1,1,1,0,0,0,0,1,0,1,0,0,0,0,1,2
400994918,Duke Blue Devils,H. Gorecki,3904544,,False,16.0,2,3,2,2,0,1,1,1,0,1,1,0,0,0,0,0,5
400994918,Duke Blue Devils,TEAM,TOTAL,TOTAL,False,,21,56,19,44,2,12,11,16,18,26,44,8,5,1,15,21,55
400994904,Wake Forest Demon Deacons,T. Whitehead,4065888,,True,35.0,6,13,6,13,0,0,0,4,4,8,12,1,1,0,3,2,12
400994904,Wake Forest Demon Deacons,D. Walker,3904604,,True,16.0,1,4,1,4,0,0,2,3,1,3,4,0,0,0,0,3,4
400994904,Wake Forest Demon Deacons,A. Sharp,4065886,,True,38.0,6,15,5,12,1,3,0,1,4,5,9,3,1,1,5,3,13
400994904,Wake Forest Demon Deacons,A. Stephenson,3904606,,True,24.0,0,5,0,2,0,3,0,0,1,1,2,2,2,0,5,3,0
400994904,Wake Forest Demon Deacons,A. Campbell,3142120,,True,36.0,6,13,5,9,1,4,4,4,0,1,1,1,1,2,4,1,17
400994904,Wake Forest Demon Deacons,I. Raca,4281231,,False,28.0,2,4,2,3,0,1,5,6,4,3,7,3,0,1,4,3,9
400994904,Wake Forest Demon Deacons,O. Udoh,4065889,,False,7.0,0,2,0,2,0,0,0,0,0,0,0,0,0,0,0,0,0
400994904,Wake Forest Demon Deacons,R. Branch,4065887,,False,3.0,0,0,0,0,0,0,0,0,0,1,1,0,0,0,0,0,0
400994904,Wake Forest Demon Deacons,G. Conti,4281230,,False,13.0,1,5,1,4,0,1,0,0,0,1,1,1,0,0,2,1,2
400994904,Wake Forest Demon Deacons,TEAM,TOTAL,TOTAL,False,,22,61,20,49,2,12,11,18,16,25,41,11,5,4,23,16,57
400994904,Seton Hall Pirates,S. Samuels,4068128,,True,30.0,2,3,2,2,0,1,0,0,0,4,4,1,1,3,2,3,4
400994904,Seton Hall Pirates,T. Brown,3941336,,True,18.0,4,7,3,6,1,1,2,3,2,2,4,1,1,0,0,4,11
400994904,Seton Hall Pirates,D. Fountain,3058890,,True,31.0,6,17,3,10,3,7,3,4,2,11,13,1,1,1,7,2,18
400994904,Seton Hall Pirates,N. Jimenez,4281379,,True,11.0,1,1,0,0,1,1,0,0,0,0,0,0,1,0,1,1,3
400994904,Seton Hall Pirates,J. Jackson,3064877,,True,19.0,1,5,1,3,0,2,2,2,0,2,2,1,1,0,1,0,4
400994904,Seton Hall Pirates,S. Philoxy,4281380,,False,5.0,0,1,0,1,0,0,0,0,1,2,3,0,0,0,1,1,0
400994904,Seton Hall Pirates,K. Evans,4281378,,False,20.0,4,5,4,5,0,0,0,0,2,0,2,0,0,0,1,2,8
400994904,Seton Hall Pirates,J. Jones-Pack,4068129,,False,5.0,0,1,0,1,0,0,0,0,1,1,2,0,0,0,1,1,0
400994904,Seton Hall Pirates,D. Winters,4068126,,False,8.0,0,3,0,2,0,1,0,0,1,0,1,0,0,0,0,0,0
400994904,Seton Hall Pirates,I. Butina,4281377,,False,29.0,3,5,3,5,0,0,2,2,0,1,1,1,3,0,3,4,8
400994904,Seton Hall Pirates,K. Hilaire,4068123,,False,24.0,3,11,3,9,0,2,5,6,0,1,1,5,3,0,3,3,11
400994904,Seton Hall Pirates,TEAM,TOTAL,TOTAL,False,,24,59,19,44,5,15,14,17,12,26,38,10,11,4,20,21,67
400994696,Seton Hall Pirates,S. Samuels,4068128,,True,23.0,1,3,1,2,0,1,0,0,0,6,6,3,1,2,3,3,2
400994696,Seton Hall Pirates,T. Brown,3941336,,True,26.0,4,6,4,6,0,0,3,4,1,4,5,3,2,1,3,4,11
400994696,Seton Hall Pirates,D. Fountain,3058890,,True,28.0,5,14,5,11,0,3,0,0,2,6,8,5,0,1,1,1,10
400994696,Seton Hall Pirates,I. Butina,4281377,,True,31.0,3,5,1,2,2,3,2,2,0,1,1,6,2,0,4,1,10
400994696,Seton Hall Pirates,J. Jackson,3064877,,True,31.0,11,13,6,7,5,6,1,1,0,1,1,1,2,0,0,2,28
400994696,Seton Hall Pirates,S. Philoxy,4281380,,False,4.0,0,1,0,1,0,0,0,0,0,1,1,1,0,0,0,0,0
400994696,Seton Hall Pirates,K. Evans,4281378,,False,7.0,2,5,2,5,0,0,2,2,0,0,0,0,0,0,1,0,6
400994696,Seton Hall Pirates,J. Jones-Pack,4068129,,False,2.0,0,0,0,0,0,0,0,0,0,0,0,0,0,0,0,0,0
400994696,Seton Hall Pirates,D. Winters,4068126,,False,14.0,3,8,0,2,3,6,0,0,0,0,0,0,2,1,1,1,9
400994696,Seton Hall Pirates,N. Jimenez,4281379,,False,15.0,1,2,1,1,0,1,0,0,0,2,2,1,2,0,1,3,2
400994696,Seton Hall Pirates,K. Hilaire,4068123,,False,17.0,1,1,1,1,0,0,0,0,1,2,3,0,0,0,2,4,2
400994696,Seton Hall Pirates,K. Healy,3943704,,False,2.0,0,0,0,0,0,0,0,0,0,0,0,1,0,0,0,0,0
400994696,Seton Hall Pirates,TEAM,TOTAL,TOTAL,False,,31,58,21,38,10,20,8,9,4,23,27,21,11,5,17,19,80
400994696,Fairfield Stags,K. Diouf,3142178,,True,24.0,4,8,4,8,0,0,0,0,0,4,4,0,0,0,4,4,8
400994696,Fairfield Stags,S. Cooper,3066772,,True,36.0,7,16,5,9,2,7,5,6,1,6,7,2,1,1,4,2,21
400994696,Fairfield Stags,S. Kramer,4068819,,True,33.0,3,9,1,2,2,7,1,2,0,5,5,3,0,0,1,2,9
400994696,Fairfield Stags,K. Landy,3907605,,True,24.0,0,1,0,0,0,1,2,2,0,1,1,4,1,0,4,0,2
400994696,Fairfield Stags,C. Foley,3907604,,True,37.0,2,5,1,2,1,3,0,0,0,1,1,4,0,0,3,1,5
400994696,Fairfield Stags,M. Bauer,4282063,,False,1.0,0,0,0,0,0,0,0,0,0,0,0,0,0,0,0,0,0
400994696,Fairfield Stags,E. Nibbelink,4282061,,False,3.0,0,1,0,1,0,0,0,0,0,0,0,0,0,0,0,0,0
400994696,Fairfield Stags,J. Frye,4282064,,False,2.0,0,0,0,0,0,0,0,0,0,0,0,0,0,0,0,0,0
400994696,Fairfield Stags,S. Lewis,4282062,,False,11.0,1,3,0,1,1,2,0,0,0,1,1,0,0,1,2,1,3
400994696,Fairfield Stags,E. Schlosser,4068820,,False,6.0,1,2,1,1,0,1,0,0,0,0,0,0,0,0,0,0,2
400994696,Fairfield Stags,K. McLaughlin,3142684,,False,17.0,1,2,1,1,0,1,1,1,0,3,3,1,0,1,1,1,3
400994696,Fairfield Stags,M. Hollenshead,3142683,,False,5.0,3,6,1,3,2,3,0,0,2,0,2,0,2,0,2,0,8
400994696,Fairfield Stags,TEAM,TOTAL,TOTAL,False,,22,53,14,28,8,25,9,11,3,21,24,14,4,3,21,11,61
400994667,Quinnipiac Bobcats,P. Strautmane,3949517,,True,28.0,7,12,6,10,1,2,0,0,0,2,2,5,5,0,1,2,15
400994667,Quinnipiac Bobcats,J. Fay,3157031,,True,29.0,4,11,3,8,1,3,0,2,2,13,15,1,0,0,0,0,9
400994667,Quinnipiac Bobcats,T. Herd,4070244,,True,20.0,4,11,2,5,2,6,0,0,2,1,3,1,2,1,1,2,10
400994667,Quinnipiac Bobcats,A. McClure,3949520,,True,25.0,1,6,1,3,0,3,0,0,0,1,1,2,0,1,1,3,2
400994667,Quinnipiac Bobcats,C. Fabbri,3157029,,True,29.0,3,8,2,4,1,4,0,0,0,1,1,6,3,1,2,0,7
400994667,Quinnipiac Bobcats,P. Warfel,4070246,,False,18.0,2,6,2,6,0,0,0,0,4,4,8,1,1,0,2,1,4
400994667,Quinnipiac Bobcats,J. Ward,4070245,,False,11.0,4,7,3,5,1,2,0,0,3,2,5,1,3,1,0,1,9
400994667,Quinnipiac Bobcats,K. Grant,4070247,,False,1.0,0,0,0,0,0,0,0,0,0,0,0,0,0,0,0,0,0
400994667,Quinnipiac Bobcats,C. Bacchini,4282170,,False,17.0,1,6,1,4,0,2,0,0,0,1,1,1,2,0,2,1,2
400994667,Quinnipiac Bobcats,D. Bradley,4282169,,False,3.0,0,0,0,0,0,0,0,0,0,0,0,0,0,0,0,0,0
400994667,Quinnipiac Bobcats,B. Martin,3949519,,False,1.0,0,0,0,0,0,0,0,0,0,0,0,0,0,0,0,0,0
400994667,Quinnipiac Bobcats,E. Thornton,3949518,,False,18.0,2,4,2,3,0,1,0,0,0,4,4,2,1,0,1,3,4
400994667,Quinnipiac Bobcats,TEAM,TOTAL,TOTAL,False,,28,71,22,48,6,23,0,2,13,29,42,20,17,4,10,13,62
400994667,Providence Friars,N. Franklin,4281348,,True,27.0,7,9,7,9,0,0,0,1,4,4,8,2,0,0,3,2,14
400994667,Providence Friars,B. Frias,3142302,,True,11.0,0,0,0,0,0,0,0,0,0,0,0,1,0,0,2,1,0
400994667,Providence Friars,N. Jackson,4068111,,True,21.0,0,1,0,1,0,0,0,0,1,5,6,1,1,0,4,3,0
400994667,Providence Friars,J. Nogic,3906769,,True,24.0,2,13,0,4,2,9,0,0,0,2,2,4,1,1,2,1,6
400994667,Providence Friars,M. Jolin,3906767,,True,25.0,2,9,2,2,0,7,0,0,0,3,3,2,0,1,6,2,4
400994667,Providence Friars,A. Cooper,4281349,,False,28.0,4,5,4,5,0,0,0,0,0,2,2,0,0,1,0,0,8
400994667,Providence Friars,O. Orlando,4281347,,False,8.0,0,0,0,0,0,0,0,0,0,1,1,1,0,0,0,0,0
400994667,Providence Friars,K. Spiwak,4281346,,False,7.0,0,0,0,0,0,0,0,0,0,0,0,0,0,0,0,2,0
400994667,Providence Friars,C. Williams,4281345,,False,15.0,1,6,1,6,0,0,0,0,0,1,1,1,0,0,2,1,2
400994667,Providence Friars,C. Che,3906766,,False,19.0,1,6,1,4,0,2,0,0,0,3,3,2,1,0,1,0,2
400994667,Providence Friars,A. Botteghi,3142301,,False,15.0,0,4,0,4,0,0,0,0,1,6,7,0,0,1,2,0,0
400994667,Providence Friars,TEAM,TOTAL,TOTAL,False,,17,53,15,35,2,18,0,1,8,29,37,14,3,4,22,12,36
400994666,Villanova Wildcats,M. Quinn,3056785,,True,21.0,1,6,1,2,0,4,1,1,1,5,6,2,0,1,2,0,3
400994666,Villanova Wildcats,J. Tucker,3087536,,True,20.0,1,4,0,0,1,4,0,0,0,1,1,0,0,0,2,1,3
400994666,Villanova Wildcats,K. Jekot,4068171,,True,25.0,3,7,3,5,0,2,1,1,0,5,5,5,1,0,2,0,7
400994666,Villanova Wildcats,A. Hahn,3906779,,True,34.0,8,12,3,3,5,9,0,0,0,3,3,1,0,1,0,1,21
400994666,Villanova Wildcats,A. Louin,3142314,,True,31.0,3,8,3,6,0,2,0,0,0,9,9,1,0,0,0,0,6
400994666,Villanova Wildcats,G. Lange,4281371,,False,2.0,0,0,0,0,0,0,0,0,0,1,1,0,0,0,0,0,0
400994666,Villanova Wildcats,M. Gedaka,4068172,,False,20.0,3,4,3,4,0,0,1,1,0,4,4,2,0,1,1,1,7
400994666,Villanova Wildcats,B. Herlihy,4068169,,False,3.0,1,1,1,1,0,0,0,0,0,0,0,0,0,0,0,1,2
400994666,Villanova Wildcats,B. Herlihy,3906778,,False,20.0,7,10,3,4,4,6,1,1,0,3,3,2,0,1,1,2,19
400994666,Villanova Wildcats,G. Stant,3906780,,False,16.0,2,5,1,1,1,4,0,0,0,2,2,1,0,0,0,1,5
400994666,Villanova Wildcats,R. James,4068168,,False,3.0,0,1,0,1,0,0,0,0,0,2,2,0,0,0,0,0,0
400994666,Villanova Wildcats,C. Onken,4068167,,False,5.0,0,1,0,0,0,1,0,0,0,0,0,1,0,0,0,0,0
400994666,Villanova Wildcats,TEAM,TOTAL,TOTAL,False,,29,59,18,27,11,32,4,4,2,39,41,15,1,4,9,7,73
400994666,Fairfield Stags,K. Diouf,3142178,,True,33.0,2,14,2,14,0,0,2,2,7,4,11,1,0,0,0,1,6
400994666,Fairfield Stags,S. Cooper,3066772,,True,37.0,3,19,2,15,1,4,0,4,3,8,11,0,0,0,0,0,7
400994666,Fairfield Stags,S. Kramer,4068819,,True,30.0,5,11,4,7,1,4,0,0,2,3,5,2,0,0,0,1,11
400994666,Fairfield Stags,K. Landy,3907605,,True,18.0,1,6,1,3,0,3,0,0,0,4,4,3,0,0,2,2,2
400994666,Fairfield Stags,C. Foley,3907604,,True,33.0,1,5,0,3,1,2,0,0,0,2,2,1,0,0,2,3,3
400994666,Fairfield Stags,E. Nibbelink,4282061,,False,3.0,0,2,0,0,0,2,0,0,0,0,0,0,0,0,0,0,0
400994666,Fairfield Stags,S. Lewis,4282062,,False,10.0,2,4,1,2,1,2,0,0,2,1,3,0,0,0,0,1,5
400994666,Fairfield Stags,E. Schlosser,4068820,,False,16.0,1,5,1,1,0,4,0,0,0,1,1,0,1,0,1,0,2
400994666,Fairfield Stags,K. McLaughlin,3142684,,False,7.0,2,5,2,3,0,2,0,0,2,0,2,0,0,0,0,1,4
400994666,Fairfield Stags,M. Hollenshead,3142683,,False,13.0,2,3,2,3,0,0,0,0,1,2,3,0,0,0,0,0,4
400994666,Fairfield Stags,TEAM,TOTAL,TOTAL,False,,19,74,15,51,4,23,2,6,18,27,45,7,1,0,5,9,44
400994653,Seton Hall Pirates,S. Samuels,4068128,,True,19.0,1,1,1,1,0,0,1,3,1,6,7,6,1,0,0,1,3
400994653,Seton Hall Pirates,T. Brown,3941336,,True,25.0,6,12,6,12,0,0,4,6,5,1,6,2,3,0,4,2,16
400994653,Seton Hall Pirates,D. Fountain,3058890,,True,23.0,3,7,2,3,1,4,3,3,2,1,3,2,2,0,3,4,10
400994653,Seton Hall Pirates,I. Butina,4281377,,True,18.0,5,6,2,2,3,4,0,0,1,3,4,3,1,0,0,2,13
400994653,Seton Hall Pirates,J. Jackson,3064877,,True,19.0,4,9,1,3,3,6,1,1,1,2,3,2,3,0,2,0,12
400994653,Seton Hall Pirates,S. Philoxy,4281380,,False,8.0,0,1,0,1,0,0,0,0,1,1,2,0,0,0,3,4,0
400994653,Seton Hall Pirates,K. Evans,4281378,,False,12.0,3,8,3,8,0,0,1,2,2,1,3,0,0,2,2,1,7
400994653,Seton Hall Pirates,J. Jones-Pack,4068129,,False,10.0,0,1,0,1,0,0,3,4,5,1,6,0,1,0,2,4,3
400994653,Seton Hall Pirates,D. Winters,4068126,,False,14.0,2,6,0,0,2,6,0,0,0,3,3,0,0,0,0,0,6
400994653,Seton Hall Pirates,N. Jimenez,4281379,,False,19.0,1,6,1,1,0,5,0,0,1,4,5,1,3,0,3,2,2
400994653,Seton Hall Pirates,T. Smith,4068124,,False,6.0,0,3,0,2,0,1,0,2,0,1,1,0,0,0,0,0,0
400994653,Seton Hall Pirates,K. Hilaire,4068123,,False,20.0,3,6,1,3,2,3,2,4,0,0,0,4,5,0,0,0,10
400994653,Seton Hall Pirates,K. Healy,3943704,,False,7.0,1,2,0,0,1,2,0,0,0,0,0,0,0,0,1,1,3
400994653,Seton Hall Pirates,TEAM,TOTAL,TOTAL,False,,29,68,17,37,12,31,15,25,22,24,46,20,19,2,20,21,85
400994653,Marist Red Foxes,A. Gilmer,3949116,,True,25.0,3,7,3,4,0,3,0,2,0,2,2,2,1,1,5,3,6
400994653,Marist Red Foxes,L. Henningsdóttir,3907615,,True,20.0,1,5,0,2,1,3,0,0,0,2,2,1,0,0,1,3,3
400994653,Marist Red Foxes,A. Best,4282146,,True,34.0,2,5,1,1,1,4,2,2,0,2,2,1,1,0,6,1,7
400994653,Marist Red Foxes,R. Hand,4068854,,True,12.0,2,4,1,2,1,2,0,0,0,0,0,0,0,0,1,0,5
400994653,Marist Red Foxes,M. Fitzpatrick,3907613,,True,35.0,2,5,2,5,0,0,2,2,2,1,3,3,2,0,2,0,6
400994653,Marist Red Foxes,G. Redden,4282148,,False,11.0,1,3,1,3,0,0,2,2,1,3,4,1,2,0,1,1,4
400994653,Marist Red Foxes,W. Duffell,4282147,,False,15.0,0,1,0,1,0,0,4,6,1,5,6,0,1,2,2,3,4
400994653,Marist Red Foxes,K. Baab,3142708,,False,16.0,4,5,3,4,1,1,2,4,1,4,5,2,0,1,1,5,11
400994653,Marist Red Foxes,A. Clement,3142710,,False,32.0,6,11,5,6,1,5,1,2,1,1,2,1,0,0,6,1,14
400994653,Marist Red Foxes,TEAM,TOTAL,TOTAL,False,,21,46,16,28,5,18,13,20,6,21,27,11,7,4,27,17,60
400994415,UCLA Bruins,M. Onyenwere,4282173,,True,31.0,7,9,7,9,0,0,0,0,1,8,9,2,1,0,1,1,14
400994415,UCLA Bruins,L. Drummer,3142252,,True,12.0,0,5,0,4,0,1,0,0,0,3,3,0,0,1,2,1,0
400994415,UCLA Bruins,K. Burke,3922628,,True,31.0,5,8,5,7,0,1,0,0,0,3,3,0,0,1,0,3,10
400994415,UCLA Bruins,K. Hayes,3142254,,True,24.0,5,9,2,3,3,6,2,2,3,1,4,2,0,0,2,4,15
400994415,UCLA Bruins,J. Canada,3142250,,True,36.0,5,13,5,11,0,2,1,2,2,3,5,10,2,0,1,3,11
400994415,UCLA Bruins,L. Miller,4282174,,False,6.0,0,0,0,0,0,0,0,0,0,0,0,0,0,0,0,0,0
400994415,UCLA Bruins,M. Billings,3142255,,False,30.0,5,9,5,9,0,0,7,10,3,4,7,2,2,6,3,3,17
400994415,UCLA Bruins,C. Horvat,4282171,,False,9.0,1,2,1,1,0,1,0,0,1,2,3,1,0,0,2,2,2
400994415,UCLA Bruins,J. Dean,3914645,,False,19.0,3,5,1,1,2,4,0,0,0,3,3,1,0,0,3,2,8
400994415,UCLA Bruins,C. Baird,3142256,,False,2.0,0,0,0,0,0,0,0,0,0,0,0,0,0,0,0,0,0
400994415,UCLA Bruins,TEAM,TOTAL,TOTAL,False,,31,60,26,45,5,15,10,14,11,28,39,18,5,8,14,19,77
400994415,Seton Hall Pirates,S. Samuels,4068128,,True,21.0,1,2,1,2,0,0,0,0,0,5,5,0,0,0,0,4,2
400994415,Seton Hall Pirates,T. Brown,3941336,,True,34.0,0,9,0,9,0,0,5,8,5,3,8,2,3,0,2,1,5
400994415,Seton Hall Pirates,D. Fountain,3058890,,True,38.0,9,23,9,21,0,2,5,7,5,3,8,1,2,1,5,1,23
400994415,Seton Hall Pirates,K. Hilaire,4068123,,True,13.0,1,3,1,3,0,0,0,0,1,0,1,1,0,0,2,2,2
400994415,Seton Hall Pirates,J. Jackson,3064877,,True,24.0,1,8,0,3,1,5,0,0,1,0,1,2,3,0,0,0,3
400994415,Seton Hall Pirates,S. Philoxy,4281380,,False,1.0,0,1,0,1,0,0,0,0,0,0,0,0,0,0,0,1,0
400994415,Seton Hall Pirates,K. Evans,4281378,,False,10.0,0,0,0,0,0,0,0,0,0,0,0,0,0,1,0,0,0
400994415,Seton Hall Pirates,J. Jones-Pack,4068129,,False,11.0,1,2,1,2,0,0,0,0,2,1,3,0,0,1,0,2,2
400994415,Seton Hall Pirates,D. Winters,4068126,,False,21.0,5,10,4,5,1,5,0,0,0,2,2,0,1,0,3,1,11
400994415,Seton Hall Pirates,N. Jimenez,4281379,,False,27.0,6,7,3,3,3,4,5,5,1,1,2,2,3,0,3,4,20
400994415,Seton Hall Pirates,TEAM,TOTAL,TOTAL,False,,24,65,19,49,5,16,15,20,17,18,35,8,12,3,15,16,68
400994374,UCLA Bruins,M. Billings,3142255,,True,26.0,5,10,5,10,0,0,2,2,3,4,7,0,1,1,3,2,12
400994374,UCLA Bruins,L. Drummer,3142252,,True,23.0,5,8,5,7,0,1,0,0,2,1,3,0,1,0,1,4,10
400994374,UCLA Bruins,K. Burke,3922628,,True,28.0,7,18,6,13,1,5,2,2,5,1,6,2,2,0,1,2,17
400994374,UCLA Bruins,K. Hayes,3142254,,True,28.0,2,3,1,1,1,2,0,0,1,2,3,2,1,1,0,4,5
400994374,UCLA Bruins,J. Canada,3142250,,True,33.0,2,6,2,5,0,1,1,2,2,5,7,2,2,0,1,2,5
400994374,UCLA Bruins,L. Miller,4282174,,False,11.0,1,1,1,1,0,0,0,0,0,1,1,0,0,0,0,1,2
400994374,UCLA Bruins,M. Onyenwere,4282173,,False,14.0,1,3,1,3,0,0,2,2,0,2,2,0,0,1,0,0,4
400994374,UCLA Bruins,A. Rosenblum,4066550,,False,6.0,0,1,0,1,0,0,0,0,0,1,1,0,0,0,0,1,0
400994374,UCLA Bruins,K. Owens,4282172,,False,7.0,3,7,2,2,1,5,1,2,1,1,2,1,0,0,1,0,8
400994374,UCLA Bruins,C. Horvat,4282171,,False,24.0,2,5,0,0,2,5,3,6,1,1,2,5,1,1,1,3,9
400994374,UCLA Bruins,TEAM,TOTAL,TOTAL,False,,28,62,23,43,5,19,11,16,16,21,37,12,8,4,8,19,72
400994374,Creighton Bluejays,A. Faber,3938938,,True,32.0,4,12,1,7,3,5,2,2,1,3,4,2,1,0,2,2,13
400994374,Creighton Bluejays,A. Greene,3938937,,True,20.0,0,0,0,0,0,0,4,4,3,4,7,0,2,0,0,5,4
400994374,Creighton Bluejays,J. Agnew,3938935,,True,34.0,6,18,5,10,1,8,2,2,0,2,2,3,1,0,2,2,15
400994374,Creighton Bluejays,S. Lamberty,3142285,,True,38.0,2,6,2,6,0,0,3,4,1,2,3,2,0,0,1,0,7
400994374,Creighton Bluejays,M. Mellman,3142283,,True,10.0,1,1,1,1,0,0,0,0,0,1,1,1,0,0,1,0,2
400994374,Creighton Bluejays,K. Brown,3142286,,False,8.0,0,0,0,0,0,0,0,0,1,0,1,0,0,0,0,2,0
400994374,Creighton Bluejays,B. Norby,3142284,,False,7.0,1,1,1,1,0,0,0,0,0,0,0,0,0,0,2,2,2
400994374,Creighton Bluejays,T. Carda,4281362,,False,25.0,4,10,0,5,4,5,0,0,2,2,4,1,1,0,1,2,12
400994374,Creighton Bluejays,T. Rembao,4281361,,False,17.0,1,4,1,2,0,2,4,4,1,2,3,2,0,0,1,0,6
400994374,Creighton Bluejays,B. Kissinger,3142124,,False,9.0,0,1,0,0,0,1,2,2,1,1,2,1,0,0,1,0,2
400994374,Creighton Bluejays,TEAM,TOTAL,TOTAL,False,,19,53,11,32,8,21,17,18,13,20,33,12,5,0,12,15,63
400994365,Washington Huskies,M. Henson,4066554,,True,27.0,4,13,2,7,2,6,7,11,4,5,9,3,3,0,2,0,17
400994365,Washington Huskies,H. Johnson,3142264,,True,21.0,4,7,4,7,0,0,2,2,3,3,6,0,1,0,2,3,10
400994365,Washington Huskies,F. Semebene,4282185,,True,17.0,1,7,1,6,0,1,0,0,1,3,4,1,1,1,1,2,2
400994365,Washington Huskies,A. Melgoza,4066555,,True,26.0,6,14,6,13,0,1,2,2,2,2,4,1,2,0,1,2,14
400994365,Washington Huskies,J. Moser,3962595,,True,29.0,2,4,0,1,2,3,0,0,2,6,8,1,2,0,4,1,6
400994365,Washington Huskies,K. Rooks,4282188,,False,15.0,2,3,2,3,0,0,1,2,0,1,1,0,0,0,1,0,5
400994365,Washington Huskies,M. Peterson,4282190,,False,15.0,1,1,1,1,0,0,0,0,0,2,2,2,0,0,2,2,2
400994365,Washington Huskies,L. Griggsby,4282189,,False,19.0,1,5,1,3,0,2,1,2,2,1,3,2,1,0,0,1,3
400994365,Washington Huskies,K. Collier,4282186,,False,20.0,2,7,2,5,0,2,2,4,4,1,5,2,1,0,2,2,6
400994365,Washington Huskies,M. Wieburg,3142267,,False,11.0,1,4,1,1,0,3,0,0,2,3,5,2,0,0,0,1,2
400994365,Washington Huskies,TEAM,TOTAL,TOTAL,False,,24,65,20,47,4,18,15,23,22,30,52,14,11,1,16,14,67
400994365,Creighton Bluejays,A. Faber,3938938,,True,38.0,8,15,5,10,3,5,0,0,0,5,5,3,0,2,4,2,19
400994365,Creighton Bluejays,A. Greene,3938937,,True,12.0,0,2,0,2,0,0,1,2,1,1,2,0,0,1,1,4,1
400994365,Creighton Bluejays,J. Agnew,3938935,,True,38.0,6,14,2,4,4,10,0,0,3,5,8,4,2,1,2,4,16
400994365,Creighton Bluejays,S. Lamberty,3142285,,True,39.0,2,11,0,6,2,5,2,2,1,5,6,6,1,0,2,0,8
400994365,Creighton Bluejays,M. Mellman,3142283,,True,16.0,2,7,0,2,2,5,0,0,1,2,3,3,1,1,0,2,6
400994365,Creighton Bluejays,K. Brown,3142286,,False,5.0,1,1,1,1,0,0,0,0,0,0,0,0,0,1,0,0,2
400994365,Creighton Bluejays,B. Norby,3142284,,False,3.0,0,1,0,1,0,0,0,0,1,0,1,0,0,0,0,0,0
400994365,Creighton Bluejays,T. Carda,4281362,,False,16.0,0,1,0,0,0,1,0,0,0,0,0,1,0,0,3,3,0
400994365,Creighton Bluejays,T. Rembao,4281361,,False,26.0,5,15,3,11,2,4,0,0,4,3,7,3,2,0,2,4,12
400994365,Creighton Bluejays,B. Kissinger,3142124,,False,7.0,0,1,0,0,0,1,0,0,2,0,2,0,0,0,1,0,0
400994365,Creighton Bluejays,TEAM,TOTAL,TOTAL,False,,24,68,11,37,13,31,3,4,15,23,38,20,6,6,15,19,64
400994325,Seton Hall Pirates,S. Samuels,4068128,,True,14.0,1,6,1,5,0,1,1,2,1,1,2,1,3,1,1,3,3
400994325,Seton Hall Pirates,T. Brown,3941336,,True,18.0,5,7,5,6,0,1,4,6,2,4,6,0,1,0,0,1,14
400994325,Seton Hall Pirates,D. Fountain,3058890,,True,15.0,6,15,4,11,2,4,8,10,5,1,6,0,1,0,0,2,22
400994325,Seton Hall Pirates,N. Jimenez,4281379,,True,18.0,0,2,0,0,0,2,0,0,0,0,0,3,2,1,0,2,0
400994325,Seton Hall Pirates,J. Jackson,3064877,,True,18.0,5,7,3,3,2,4,0,0,0,0,0,0,2,0,2,1,12
400994325,Seton Hall Pirates,S. Philoxy,4281380,,False,20.0,1,3,1,3,0,0,2,6,5,4,9,0,3,0,0,1,4
400994325,Seton Hall Pirates,K. Evans,4281378,,False,10.0,1,2,1,2,0,0,1,3,1,3,4,0,0,0,2,0,3
400994325,Seton Hall Pirates,J. Jones-Pack,4068129,,False,18.0,3,7,3,6,0,1,3,3,4,0,4,0,0,0,0,2,9
400994325,Seton Hall Pirates,D. Winters,4068126,,False,16.0,1,8,0,1,1,7,2,4,0,2,2,0,1,0,1,0,5
400994325,Seton Hall Pirates,I. Butina,4281377,,False,17.0,1,4,1,2,0,2,1,2,0,1,1,5,4,1,0,2,3
400994325,Seton Hall Pirates,T. Smith,4068124,,False,8.0,1,5,1,4,0,1,2,2,0,1,1,0,0,0,0,0,4
400994325,Seton Hall Pirates,K. Hilaire,4068123,,False,23.0,4,9,2,6,2,3,2,4,0,1,1,4,5,0,1,2,12
400994325,Seton Hall Pirates,K. Healy,3943704,,False,5.0,0,0,0,0,0,0,0,0,1,0,1,0,0,0,0,0,0
400994325,Seton Hall Pirates,TEAM,TOTAL,TOTAL,False,,29,75,22,49,7,26,26,42,23,19,42,13,22,3,7,16,91
400994325,Saint Peter's Peacocks,D. Martin,4282195,,True,17.0,1,5,1,5,0,0,0,0,1,3,4,1,0,1,0,2,2
400994325,Saint Peter's Peacocks,T. Hughes,3147099,,True,23.0,3,5,3,5,0,0,0,0,1,1,2,2,1,0,2,3,6
400994325,Saint Peter's Peacocks,S. Bethea,3147098,,True,25.0,3,8,3,7,0,1,2,2,5,4,9,0,0,0,4,2,8
400994325,Saint Peter's Peacocks,S. Lochner,4068899,,True,18.0,2,3,1,1,1,2,0,0,0,2,2,0,0,0,9,1,5
400994325,Saint Peter's Peacocks,A. Velles,3147101,,True,23.0,1,4,0,0,1,4,0,0,0,6,6,0,0,0,2,0,3
400994325,Saint Peter's Peacocks,Z. Pero,4068900,,False,19.0,2,7,2,6,0,1,0,0,0,3,3,0,1,1,5,4,4
400994325,Saint Peter's Peacocks,A. Howell,4068902,,False,8.0,0,0,0,0,0,0,0,0,0,0,0,2,0,0,0,0,0
400994325,Saint Peter's Peacocks,S. Meier,3147100,,False,9.0,0,0,0,0,0,0,0,0,0,0,0,1,0,0,0,1,0
400994325,Saint Peter's Peacocks,P. Featherson,4282193,,False,4.0,1,1,1,1,0,0,1,2,0,1,1,0,0,0,0,0,3
400994325,Saint Peter's Peacocks,H. Dalonzo,4282194,,False,12.0,1,3,1,2,0,1,0,0,2,2,4,1,0,0,0,4,2
400994325,Saint Peter's Peacocks,A. Maguire,4282192,,False,6.0,2,4,2,3,0,1,0,0,0,0,0,0,0,0,4,0,4
400994325,Saint Peter's Peacocks,D. Magazine,4282191,,False,14.0,1,8,0,6,1,2,4,4,0,0,0,2,0,0,6,4,7
400994325,Saint Peter's Peacocks,B. Tarabocchia,4068901,,False,8.0,1,2,0,0,1,2,0,0,0,1,1,2,0,0,0,2,3
400994325,Saint Peter's Peacocks,B. Spencer,3949523,,False,14.0,1,2,1,2,0,0,0,0,1,1,2,0,1,0,1,5,2
400994325,Saint Peter's Peacocks,TEAM,TOTAL,TOTAL,False,,19,52,15,38,4,14,7,8,13,28,41,11,3,2,33,28,49
400994170,West Virginia Mountaineers,K. King,4068207,,True,38.0,5,7,5,7,0,0,0,1,3,3,6,4,1,2,4,1,10
400994170,West Virginia Mountaineers,T. Muldrow,3066473,,True,39.0,6,13,5,9,1,4,5,5,3,4,7,4,2,0,5,4,18
400994170,West Virginia Mountaineers,N. Davenport,4281328,,True,33.0,7,13,6,9,1,4,1,2,4,11,15,1,1,0,3,2,16
400994170,West Virginia Mountaineers,K. Pardee,3910737,,True,37.0,4,9,2,5,2,4,0,0,1,1,2,1,1,0,3,2,10
400994170,West Virginia Mountaineers,C. Ray,3142021,,True,40.0,4,9,1,1,3,8,5,6,0,3,3,8,3,0,0,2,16
400994170,West Virginia Mountaineers,D. Harden,4281329,,False,1.0,0,0,0,0,0,0,0,2,0,0,0,0,0,0,0,0,0
400994170,West Virginia Mountaineers,A. Jones,4281330,,False,12.0,1,2,0,0,1,2,2,2,0,0,0,2,0,0,4,2,5
400994170,West Virginia Mountaineers,TEAM,TOTAL,TOTAL,False,,27,53,19,31,8,22,13,18,12,23,35,20,8,2,19,13,75
400994170,Butler Bulldogs,S. Brey,4068067,,True,23.0,0,3,0,2,0,1,0,0,0,4,4,1,1,1,2,5,0
400994170,Butler Bulldogs,T. Schickel,3914012,,True,39.0,3,11,3,11,0,0,6,9,4,5,9,3,0,0,2,4,12
400994170,Butler Bulldogs,M. Weaver,3914014,,True,34.0,3,10,2,5,1,5,0,0,2,1,3,6,5,0,2,3,7
400994170,Butler Bulldogs,W. Jennings,3142145,,True,40.0,7,13,2,6,5,7,5,6,0,2,2,3,0,0,5,1,24
400994170,Butler Bulldogs,I. Lathan,3079485,,True,23.0,3,7,3,7,0,0,0,0,2,0,2,0,1,0,1,2,6
400994170,Butler Bulldogs,K. Hodges,4068065,,False,10.0,1,3,1,3,0,0,0,0,1,2,3,1,0,0,0,2,2
400994170,Butler Bulldogs,S. Shelton,4068069,,False,6.0,0,1,0,1,0,0,0,0,0,0,0,0,1,0,0,0,0
400994170,Butler Bulldogs,K. Spolyar,4068068,,False,25.0,6,10,3,6,3,4,2,2,2,0,2,0,3,0,2,0,17
400994170,Butler Bulldogs,TEAM,TOTAL,TOTAL,False,,23,58,14,41,9,17,13,17,13,15,28,14,11,1,14,17,68
400994115,Oklahoma Sooners,M. Simpson,4281313,,True,5.0,0,1,0,1,0,0,0,0,0,0,0,0,0,0,2,0,0
400994115,Oklahoma Sooners,V. Pierre-Louis,3133252,,True,36.0,10,13,10,13,0,0,5,7,5,11,16,1,3,2,7,1,25
400994115,Oklahoma Sooners,L. Williams,3133257,,True,35.0,4,8,3,7,1,1,1,2,1,1,2,3,1,0,2,0,10
400994115,Oklahoma Sooners,G. Ortiz,3133255,,True,45.0,5,14,2,5,3,9,2,2,1,4,5,3,2,0,2,2,15
400994115,Oklahoma Sooners,M. Manning,17409,,True,36.0,4,10,2,6,2,4,10,13,1,3,4,4,2,0,5,3,20
400994115,Oklahoma Sooners,I. Odimgbe,3943722,,False,8.0,1,1,1,1,0,0,0,3,0,0,0,0,1,0,0,2,2
400994115,Oklahoma Sooners,S. Pellington,4601922,,False,33.0,9,12,9,12,0,0,5,6,1,5,6,5,0,0,1,3,23
400994115,Oklahoma Sooners,A. Llanusa,4281315,,False,18.0,5,12,5,9,0,3,0,0,1,1,2,2,1,0,0,5,10
400994115,Oklahoma Sooners,G. Penzo,3133253,,False,9.0,1,1,0,0,1,1,0,0,0,1,1,0,0,0,1,0,3
400994115,Oklahoma Sooners,TEAM,TOTAL,TOTAL,False,,39,72,32,54,7,18,23,33,11,30,41,18,10,2,21,16,108
400994115,DePaul Blue Demons,M. Grays,3142287,,True,33.0,7,18,5,9,2,9,2,2,1,5,6,1,2,1,2,2,18
400994115,DePaul Blue Demons,K. Campbell,4068071,,True,41.0,5,8,3,4,2,4,4,4,1,5,6,10,0,1,1,5,16
400994115,DePaul Blue Demons,T. Allen,3933760,,True,28.0,3,11,1,6,2,5,2,2,1,6,7,2,2,0,3,4,10
400994115,DePaul Blue Demons,A. Millender,3142289,,True,37.0,7,16,2,3,5,13,2,2,3,1,4,4,0,0,0,4,21
400994115,DePaul Blue Demons,A. Coleman,3142123,,True,27.0,9,13,4,6,5,7,0,0,1,1,2,2,1,0,2,4,23
400994115,DePaul Blue Demons,R. McLimore,4281358,,False,2.0,1,1,0,0,1,1,0,0,0,0,0,0,0,0,0,0,3
400994115,DePaul Blue Demons,C. Stonewall,4068072,,False,27.0,6,11,4,7,2,4,2,3,3,2,5,3,7,1,5,2,16
400994115,DePaul Blue Demons,V. Sherrod,4281359,,False,5.0,0,1,0,0,0,1,0,0,0,0,0,0,0,0,1,1,0
400994115,DePaul Blue Demons,D. Bekelja,4281356,,False,1.0,0,0,0,0,0,0,0,0,0,0,0,0,1,0,0,0,0
400994115,DePaul Blue Demons,D. Cage,4068073,,False,4.0,0,0,0,0,0,0,0,0,0,1,1,2,0,0,2,0,0
400994115,DePaul Blue Demons,L. Prochaska,3142290,,False,20.0,2,4,2,3,0,1,0,0,1,1,2,4,0,1,0,4,4
400994115,DePaul Blue Demons,TEAM,TOTAL,TOTAL,False,,40,83,21,38,19,45,12,13,11,22,33,28,13,4,17,26,111
400994082,St. John's Red Storm,M. Singleton,4068158,,True,42.0,6,12,6,12,0,0,2,2,5,19,24,1,3,1,2,3,14
400994082,St. John's Red Storm,I. Littleton,3142306,,True,25.0,1,2,1,2,0,0,0,0,0,4,4,0,2,2,1,3,2
400994082,St. John's Red Storm,A. Wellere,3906771,,True,40.0,5,17,2,8,3,9,5,6,1,4,5,4,3,2,2,1,18
400994082,St. John's Red Storm,T. England,4068155,,True,41.0,0,8,0,6,0,2,2,2,0,1,1,7,4,0,3,3,2
400994082,St. John's Red Storm,A. Kebbe,4068154,,True,24.0,4,9,1,5,3,4,0,0,3,3,6,1,1,1,1,1,11
400994082,St. John's Red Storm,K. Charles,4281374,,False,3.0,0,0,0,0,0,0,0,0,0,0,0,0,0,0,0,0,0
400994082,St. John's Red Storm,Q. Hoppie,4281375,,False,27.0,2,8,0,3,2,5,4,4,0,1,1,1,0,0,3,4,10
400994082,St. John's Red Storm,A. Adams,4068157,,False,23.0,3,13,1,7,2,6,0,2,2,1,3,0,0,1,1,3,8
400994082,St. John's Red Storm,TEAM,TOTAL,TOTAL,False,,21,69,11,43,10,26,13,16,12,33,45,14,13,7,13,18,65
400994082,Kansas Jayhawks,A. Richardson,4281304,,True,38.0,3,13,2,10,1,3,0,2,2,6,8,0,0,2,3,5,7
400994082,Kansas Jayhawks,B. Helgren,4281306,,True,13.0,0,0,0,0,0,0,2,2,1,2,3,0,0,2,0,0,2
400994082,Kansas Jayhawks,B. Osorio,4281302,,True,32.0,5,11,4,9,1,2,3,4,0,4,4,2,1,1,8,3,14
400994082,Kansas Jayhawks,C. Lyons,4281301,,True,40.0,3,11,3,10,0,1,6,8,2,5,7,1,1,0,4,3,12
400994082,Kansas Jayhawks,K. Kopatich,3906990,,True,38.0,2,6,2,5,0,1,3,4,1,3,4,1,2,1,5,2,7
400994082,Kansas Jayhawks,M. Wilson,4281303,,False,16.0,0,5,0,1,0,4,0,0,1,4,5,0,1,0,0,1,0
400994082,Kansas Jayhawks,C. Lott,3906987,,False,13.0,2,2,2,2,0,0,0,0,2,3,5,0,0,0,0,2,4
400994082,Kansas Jayhawks,T. Johnson,3906991,,False,19.0,1,5,1,5,0,0,0,0,2,2,4,0,0,2,1,1,2
400994082,Kansas Jayhawks,E. Watts,4068101,,False,12.0,1,3,0,0,1,3,2,3,0,6,6,1,0,0,3,0,5
400994082,Kansas Jayhawks,S. Benoit,3943717,,False,4.0,0,1,0,0,0,1,0,0,0,0,0,0,0,0,0,0,0
400994082,Kansas Jayhawks,TEAM,TOTAL,TOTAL,False,,17,57,14,42,3,15,16,23,12,37,49,5,5,8,24,17,53
400993854,Stetson Hatters,M. Vincent,4281293,,True,20.0,2,3,2,3,0,0,0,0,1,4,5,1,1,2,2,1,4
400993854,Stetson Hatters,K. Lentz,4281296,,True,26.0,0,2,0,1,0,1,0,0,1,3,4,1,0,0,0,4,0
400993854,Stetson Hatters,K. Colclough,4068712,,True,26.0,3,8,3,7,0,1,1,2,1,3,4,0,0,0,4,5,7
400993854,Stetson Hatters,B. Chambers,4068711,,True,37.0,3,15,1,9,2,6,6,6,2,1,3,3,1,1,6,1,14
400993854,Stetson Hatters,M. Beach,3914022,,True,38.0,6,8,2,4,4,4,2,2,1,12,13,4,0,0,0,1,18
400993854,Stetson Hatters,M. Pruitt,4281295,,False,16.0,0,1,0,1,0,0,0,0,0,0,0,0,0,0,1,1,0
400993854,Stetson Hatters,J. Tully,3907736,,False,8.0,0,1,0,1,0,0,0,0,2,0,2,0,0,0,0,0,0
400993854,Stetson Hatters,S. Wagner,4281291,,False,29.0,1,11,1,6,0,5,0,0,0,1,1,1,0,0,1,3,2
400993854,Stetson Hatters,TEAM,TOTAL,TOTAL,False,,15,49,9,32,6,17,9,10,8,25,33,10,2,3,14,16,45
400993854,Providence Friars,B. Frias,3142302,,True,13.0,1,1,1,1,0,0,0,0,1,2,3,0,0,1,1,0,2
400993854,Providence Friars,A. Botteghi,3142301,,True,23.0,2,5,2,5,0,0,2,2,0,5,5,2,0,0,1,1,6
400993854,Providence Friars,J. Nogic,3906769,,True,36.0,5,16,1,9,4,7,4,4,0,3,3,3,1,1,1,2,18
400993854,Providence Friars,M. Jolin,3906767,,True,25.0,2,7,1,3,1,4,0,0,1,4,5,1,1,1,1,1,5
400993854,Providence Friars,C. Che,3906766,,True,27.0,1,3,0,1,1,2,0,0,0,3,3,1,0,0,1,0,3
400993854,Providence Friars,A. Cooper,4281349,,False,13.0,1,1,1,1,0,0,0,0,0,1,1,1,0,0,0,2,2
400993854,Providence Friars,N. Franklin,4281348,,False,27.0,6,12,6,12,0,0,2,2,3,2,5,1,0,0,0,0,14
400993854,Providence Friars,C. Williams,4281345,,False,13.0,1,3,1,3,0,0,2,2,0,4,4,1,1,0,2,4,4
400993854,Providence Friars,N. Jackson,4068111,,False,23.0,0,3,0,3,0,0,2,2,1,2,3,1,1,0,3,1,2
400993854,Providence Friars,TEAM,TOTAL,TOTAL,False,,19,51,13,38,6,13,12,12,7,26,33,11,4,3,10,11,56
400993839,Wisconsin Badgers,A. Laszewski,4068087,,True,18.0,3,5,3,5,0,0,0,0,0,2,2,0,0,0,0,1,6
400993839,Wisconsin Badgers,M. Howard,3943382,,True,22.0,4,10,4,10,0,0,0,0,4,3,7,2,0,2,1,5,8
400993839,Wisconsin Badgers,N. Beverley,4281273,,True,23.0,2,7,2,5,0,2,0,0,2,0,2,1,0,0,2,3,4
400993839,Wisconsin Badgers,K. Van Leeuwen,4068086,,True,23.0,0,7,0,2,0,5,0,0,0,4,4,5,2,0,1,1,0
400993839,Wisconsin Badgers,C. McMorris,3142200,,True,31.0,7,18,5,13,2,5,4,4,3,7,10,1,1,0,2,0,20
400993839,Wisconsin Badgers,C. Fredrickson,4068089,,False,30.0,2,4,2,3,0,1,0,0,3,3,6,1,1,0,1,0,4
400993839,Wisconsin Badgers,K. Shaw,17394,,False,9.0,0,2,0,2,0,0,0,0,1,1,2,1,0,0,0,1,0
400993839,Wisconsin Badgers,S. Gilreath,4068085,,False,28.0,6,11,1,1,5,10,0,0,0,0,0,3,0,0,1,0,17
400993839,Wisconsin Badgers,R. Marble,3142199,,False,16.0,1,2,0,0,1,2,0,0,0,0,0,1,0,0,1,5,3
400993839,Wisconsin Badgers,TEAM,TOTAL,TOTAL,False,,25,66,17,41,8,25,4,4,16,21,37,15,4,2,9,16,62
400993839,Butler Bulldogs,T. Schickel,3914012,,True,36.0,8,15,8,15,0,0,3,4,6,4,10,4,1,1,2,2,19
400993839,Butler Bulldogs,S. Brey,4068067,,True,28.0,3,8,3,5,0,3,0,0,3,2,5,2,1,0,1,0,6
400993839,Butler Bulldogs,M. Weaver,3914014,,True,35.0,3,8,0,1,3,7,0,0,2,1,3,3,1,0,3,2,9
400993839,Butler Bulldogs,W. Jennings,3142145,,True,39.0,3,11,1,2,2,9,4,4,0,5,5,3,3,0,0,0,12
400993839,Butler Bulldogs,I. Lathan,3079485,,True,29.0,4,10,4,10,0,0,1,2,1,4,5,1,0,0,1,1,9
400993839,Butler Bulldogs,K. Hodges,4068065,,False,4.0,0,1,0,1,0,0,0,0,0,0,0,1,0,0,0,0,0
400993839,Butler Bulldogs,S. Shelton,4068069,,False,3.0,0,0,0,0,0,0,0,0,0,0,0,1,0,0,1,0,0
400993839,Butler Bulldogs,K. Spolyar,4068068,,False,23.0,4,7,1,1,3,6,3,4,0,9,9,0,0,0,1,1,14
400993839,Butler Bulldogs,S. Buck,3142279,,False,3.0,0,0,0,0,0,0,0,0,0,0,0,0,0,0,0,0,0
400993839,Butler Bulldogs,TEAM,TOTAL,TOTAL,False,,25,60,17,35,8,25,11,14,14,25,39,15,6,1,9,6,69
400993837,Wisconsin Badgers,A. Laszewski,4068087,,True,20.0,6,6,6,6,0,0,0,1,2,2,4,0,0,0,0,1,12
400993837,Wisconsin Badgers,M. Howard,3943382,,True,25.0,3,8,3,8,0,0,2,4,1,5,6,1,1,1,0,1,8
400993837,Wisconsin Badgers,N. Beverley,4281273,,True,30.0,7,8,7,8,0,0,0,1,2,1,3,5,1,0,3,1,14
400993837,Wisconsin Badgers,K. Van Leeuwen,4068086,,True,20.0,0,4,0,1,0,3,3,4,0,1,1,0,2,0,3,4,3
400993837,Wisconsin Badgers,C. McMorris,3142200,,True,25.0,2,12,2,9,0,3,5,7,2,3,5,2,0,0,5,2,9
400993837,Wisconsin Badgers,K. Crowley,4281274,,False,2.0,1,1,1,1,0,0,0,0,0,1,1,0,0,0,1,0,2
400993837,Wisconsin Badgers,C. Fredrickson,4068089,,False,23.0,2,8,2,7,0,1,0,0,3,2,5,0,1,0,3,3,4
400993837,Wisconsin Badgers,K. Shaw,17394,,False,11.0,1,1,1,1,0,0,0,0,1,1,2,0,0,0,1,1,2
400993837,Wisconsin Badgers,L. Miller,4281272,,False,2.0,0,0,0,0,0,0,0,0,0,0,0,1,0,0,0,0,0
400993837,Wisconsin Badgers,S. Gilreath,4068085,,False,18.0,1,7,1,1,0,6,0,0,3,1,4,2,1,0,2,3,2
400993837,Wisconsin Badgers,L. Richardson,3959898,,False,4.0,1,1,0,0,1,1,0,0,0,0,0,0,0,0,0,1,3
400993837,Wisconsin Badgers,R. Marble,3142199,,False,20.0,2,6,1,4,1,2,1,2,0,2,2,1,1,0,3,2,6
400993837,Wisconsin Badgers,TEAM,TOTAL,TOTAL,False,,26,62,24,46,2,16,11,19,16,20,36,12,7,1,22,19,65
400993837,Marquette Golden Eagles,L. Van Kleunen,4068083,,True,18.0,2,6,1,2,1,4,0,0,0,3,3,0,1,0,2,1,5
400993837,Marquette Golden Eagles,S. Lott,4281350,,True,17.0,1,2,1,2,0,0,0,1,2,3,5,2,0,1,2,3,2
400993837,Marquette Golden Eagles,A. Wilborn,3906758,,True,30.0,3,8,3,5,0,3,3,4,0,2,2,8,6,0,0,1,9
400993837,Marquette Golden Eagles,N. Hiedeman,3906753,,True,25.0,9,16,6,7,3,9,5,8,0,3,3,3,4,1,1,2,26
400993837,Marquette Golden Eagles,D. King,3906752,,True,32.0,6,8,6,7,0,1,2,2,0,1,1,3,0,0,1,1,14
400993837,Marquette Golden Eagles,M. Smith Traore,4281351,,False,11.0,1,1,1,1,0,0,0,0,0,0,0,0,1,2,0,4,2
400993837,Marquette Golden Eagles,A. Anderson,4068081,,False,14.0,0,1,0,1,0,0,2,2,0,0,0,1,1,1,1,3,2
400993837,Marquette Golden Eagles,E. Davenport,3906756,,False,14.0,2,2,2,2,0,0,0,0,3,2,5,0,0,0,3,4,4
400993837,Marquette Golden Eagles,S. Dahling,3906754,,False,4.0,0,0,0,0,0,0,0,0,0,0,0,1,0,0,0,0,0
400993837,Marquette Golden Eagles,I. Spingola,4068082,,False,6.0,1,2,0,0,1,2,2,2,0,2,2,0,0,0,0,0,5
400993837,Marquette Golden Eagles,O. Moskari,3906757,,False,2.0,0,1,0,0,0,1,0,0,0,0,0,0,0,0,0,0,0
400993837,Marquette Golden Eagles,A. Blockton,3906755,,False,27.0,8,12,6,9,2,3,1,2,2,6,8,3,4,0,2,3,19
400993837,Marquette Golden Eagles,TEAM,TOTAL,TOTAL,False,,33,59,26,36,7,23,15,21,8,23,31,21,17,5,12,22,88
400993825,Seton Hall Pirates,S. Samuels,4068128,,True,23.0,2,6,2,6,0,0,1,2,5,5,10,0,2,1,3,0,5
400993825,Seton Hall Pirates,T. Brown,3941336,,True,35.0,4,12,4,12,0,0,0,0,0,2,2,2,3,0,2,3,8
400993825,Seton Hall Pirates,D. Fountain,3058890,,True,25.0,4,15,3,10,1,5,1,4,3,8,11,0,0,1,1,4,10
400993825,Seton Hall Pirates,I. Butina,4281377,,True,20.0,1,2,1,2,0,0,0,1,0,0,0,0,0,0,1,2,2
400993825,Seton Hall Pirates,J. Jackson,3064877,,True,21.0,1,10,1,3,0,7,0,0,2,1,3,3,0,0,0,3,2
400993825,Seton Hall Pirates,S. Philoxy,4281380,,False,3.0,1,1,1,1,0,0,0,0,1,1,2,0,0,0,1,0,2
400993825,Seton Hall Pirates,K. Evans,4281378,,False,5.0,0,0,0,0,0,0,0,0,0,0,0,0,0,0,0,2,0
400993825,Seton Hall Pirates,J. Jones-Pack,4068129,,False,11.0,0,1,0,1,0,0,0,0,0,0,0,0,2,0,1,1,0
400993825,Seton Hall Pirates,D. Winters,4068126,,False,18.0,1,4,0,1,1,3,0,0,0,0,0,0,1,0,2,1,3
400993825,Seton Hall Pirates,N. Jimenez,4281379,,False,8.0,2,2,0,0,2,2,0,0,1,1,2,0,0,0,3,1,6
400993825,Seton Hall Pirates,K. Hilaire,4068123,,False,29.0,2,7,2,5,0,2,3,4,0,1,1,4,3,0,4,4,7
400993825,Seton Hall Pirates,K. Healy,3943704,,False,2.0,0,0,0,0,0,0,0,0,0,0,0,0,0,0,0,0,0
400993825,Seton Hall Pirates,TEAM,TOTAL,TOTAL,False,,18,60,14,41,4,19,5,11,15,20,35,9,11,2,18,21,45
400993825,Rutgers Scarlet Knights,S. Carey,3142094,,True,34.0,4,4,2,2,2,2,0,1,2,13,15,0,1,2,3,2,10
400993825,Rutgers Scarlet Knights,V. Harris,3919476,,True,22.0,2,2,2,2,0,0,0,0,2,4,6,3,2,3,2,2,4
400993825,Rutgers Scarlet Knights,K. Sanders,3919474,,True,24.0,1,7,1,6,0,1,2,2,0,2,2,2,0,0,2,1,4
400993825,Rutgers Scarlet Knights,T. Scaife,3079415,,True,25.0,8,15,7,13,1,2,6,7,1,2,3,1,2,1,2,1,23
400993825,Rutgers Scarlet Knights,K. Fitzpatrick,3079161,,True,8.0,1,2,0,0,1,2,0,0,0,1,1,1,1,0,0,1,3
400993825,Rutgers Scarlet Knights,T. Mack,4281276,,False,4.0,0,1,0,1,0,0,0,2,2,0,2,1,0,0,1,1,0
400993825,Rutgers Scarlet Knights,M. Gilles,4281275,,False,4.0,0,1,0,1,0,0,0,0,0,0,0,0,0,1,0,0,0
400993825,Rutgers Scarlet Knights,C. Jenkins,3907057,,False,10.0,0,2,0,2,0,0,0,0,0,2,2,0,1,2,1,0,0
400993825,Rutgers Scarlet Knights,J. Wallace,4068077,,False,6.0,1,2,1,2,0,0,0,0,0,3,3,0,0,0,0,1,2
400993825,Rutgers Scarlet Knights,D. Keeling,3919475,,False,2.0,0,0,0,0,0,0,0,0,0,1,1,0,0,0,0,0,0
400993825,Rutgers Scarlet Knights,K. Hill,4068075,,False,8.0,0,0,0,0,0,0,0,0,0,1,1,1,0,0,2,0,0
400993825,Rutgers Scarlet Knights,C. Cryor,3904562,,False,23.0,6,8,5,7,1,1,3,5,1,0,1,2,2,0,6,1,16
400993825,Rutgers Scarlet Knights,J. Rollins,3146860,,False,16.0,1,6,1,6,0,0,0,0,0,0,0,3,0,0,1,1,2
400993825,Rutgers Scarlet Knights,N. Greene,3058897,,False,14.0,3,3,3,3,0,0,0,0,1,0,1,1,1,0,0,0,6
400993825,Rutgers Scarlet Knights,TEAM,TOTAL,TOTAL,False,,27,53,22,45,5,8,11,17,10,30,40,15,10,9,20,11,70
400993787,Providence Friars,B. Frias,3142302,,True,21.0,0,0,0,0,0,0,0,0,0,3,3,0,0,1,2,4,0
400993787,Providence Friars,J. Nogic,3906769,,True,31.0,6,18,2,7,4,11,0,0,0,5,5,2,0,0,3,3,16
400993787,Providence Friars,M. Jolin,3906767,,True,36.0,4,11,1,2,3,9,0,0,0,4,4,3,1,0,1,2,11
400993787,Providence Friars,C. Che,3906766,,True,36.0,3,10,1,2,2,8,0,0,0,3,3,2,1,0,3,1,8
400993787,Providence Friars,A. Botteghi,3142301,,True,33.0,2,4,2,4,0,0,4,5,2,6,8,2,1,0,1,2,8
400993787,Providence Friars,A. Cooper,4281349,,False,2.0,0,0,0,0,0,0,0,0,0,0,0,0,0,0,0,0,0
400993787,Providence Friars,N. Franklin,4281348,,False,16.0,1,2,1,2,0,0,0,0,0,4,4,0,0,0,4,2,2
400993787,Providence Friars,K. Spiwak,4281346,,False,2.0,0,0,0,0,0,0,0,0,0,0,0,0,0,0,0,0,0
400993787,Providence Friars,C. Williams,4281345,,False,12.0,2,6,2,6,0,0,0,2,0,1,1,1,1,0,0,2,4
400993787,Providence Friars,N. Jackson,4068111,,False,11.0,1,4,1,4,0,0,0,0,1,0,1,1,1,0,1,1,2
400993787,Providence Friars,TEAM,TOTAL,TOTAL,False,,19,55,10,27,9,28,4,7,5,28,33,11,5,1,16,17,51
400993787,Penn State Lady Lions,J. Williams,3922261,,True,14.0,3,5,3,5,0,0,0,1,1,5,6,3,0,0,0,5,6
400993787,Penn State Lady Lions,D. Boykin,3917449,,True,33.0,0,4,0,4,0,0,1,2,1,6,7,1,0,0,6,4,1
400993787,Penn State Lady Lions,J. Travascio-Green,4068059,,True,33.0,2,11,2,5,0,6,2,2,2,4,6,0,0,0,2,0,6
400993787,Penn State Lady Lions,S. Frazier,4068058,,True,24.0,4,7,4,7,0,0,2,2,0,2,2,0,1,1,1,3,10
400993787,Penn State Lady Lions,A. Carter,3922259,,True,40.0,10,20,7,11,3,9,0,0,0,3,3,1,2,0,1,1,23
400993787,Penn State Lady Lions,S. Breen,4281234,,False,17.0,1,3,1,2,0,1,1,2,0,6,6,0,0,0,2,0,3
400993787,Penn State Lady Lions,A. Smith,4281232,,False,15.0,2,4,2,4,0,0,1,2,3,2,5,1,0,1,2,2,5
400993787,Penn State Lady Lions,K. McDaniel,4281233,,False,23.0,2,3,0,0,2,3,0,0,0,2,2,0,1,0,0,1,6
400993787,Penn State Lady Lions,L. Knizner,3949123,,False,1.0,0,0,0,0,0,0,0,0,0,0,0,0,0,0,0,0,0
400993787,Penn State Lady Lions,TEAM,TOTAL,TOTAL,False,,24,57,19,38,5,19,7,11,8,32,40,6,4,2,14,16,60
400993758,Northwestern Wildcats,A. Scheid,4068053,,True,34.0,6,10,6,8,0,2,2,2,2,3,5,1,0,1,2,1,14
400993758,Northwestern Wildcats,P. Kunaiyi-Akpanah,3926411,,True,19.0,1,4,1,4,0,0,3,4,2,6,8,1,2,1,6,3,5
400993758,Northwestern Wildcats,J. Hamilton,4281239,,True,26.0,4,10,2,7,2,3,0,0,1,7,8,2,1,0,5,2,10
400993758,Northwestern Wildcats,L. Pulliam,4281237,,True,35.0,4,15,4,15,0,0,6,6,3,4,7,3,0,0,3,2,14
400993758,Northwestern Wildcats,L. Rohde,3142184,,True,27.0,2,5,1,1,1,4,0,0,0,1,1,5,0,0,0,3,5
400993758,Northwestern Wildcats,A. Wolf,4068051,,False,3.0,2,2,2,2,0,0,0,0,2,1,3,0,0,1,0,0,4
400993758,Northwestern Wildcats,B. Hopkins,4068050,,False,20.0,2,8,2,8,0,0,3,6,0,2,2,2,0,0,2,4,7
400993758,Northwestern Wildcats,O. Hamilton,3054621,,False,10.0,1,1,1,1,0,0,2,4,2,2,4,0,0,0,1,4,4
400993758,Northwestern Wildcats,B. Pikiell,4281238,,False,3.0,0,0,0,0,0,0,0,2,0,1,1,0,0,0,0,0,0
400993758,Northwestern Wildcats,B. Galernik,4068052,,False,23.0,0,3,0,3,0,0,0,2,0,3,3,2,0,0,4,0,0
400993758,Northwestern Wildcats,TEAM,TOTAL,TOTAL,False,,22,58,19,49,3,9,16,26,13,32,45,16,3,3,23,19,63
400993758,DePaul Blue Demons,C. Stonewall,4068072,,True,24.0,6,12,3,6,3,6,4,4,1,4,5,3,1,0,0,1,19
400993758,DePaul Blue Demons,M. Grays,3142287,,True,23.0,6,12,2,4,4,8,3,3,0,3,3,0,1,0,1,3,19
400993758,DePaul Blue Demons,K. Campbell,4068071,,True,30.0,7,10,5,5,2,5,2,2,0,6,6,7,5,0,1,5,18
400993758,DePaul Blue Demons,A. Millender,3142289,,True,29.0,4,8,2,3,2,5,0,0,0,1,1,0,0,0,1,1,10
400993758,DePaul Blue Demons,A. Coleman,3142123,,True,16.0,0,5,0,4,0,1,3,4,1,1,2,3,2,0,1,3,3
400993758,DePaul Blue Demons,R. McLimore,4281358,,False,9.0,0,2,0,0,0,2,0,0,1,1,2,1,1,0,1,2,0
400993758,DePaul Blue Demons,V. Sherrod,4281359,,False,4.0,0,2,0,1,0,1,0,0,1,0,1,0,0,0,0,0,0
400993758,DePaul Blue Demons,D. Bekelja,4281356,,False,24.0,6,9,5,7,1,2,0,0,1,2,3,1,3,0,1,2,13
400993758,DePaul Blue Demons,D. Cage,4068073,,False,20.0,3,10,2,3,1,7,3,5,3,3,6,4,0,0,1,2,10
400993758,DePaul Blue Demons,L. Prochaska,3142290,,False,21.0,0,4,0,3,0,1,0,0,0,2,2,6,0,1,1,1,0
400993758,DePaul Blue Demons,TEAM,TOTAL,TOTAL,False,,32,74,19,36,13,38,15,18,9,26,35,25,13,1,8,20,92
400993754,Northwestern Wildcats,A. Scheid,4068053,,True,38.0,4,14,2,9,2,5,1,2,0,5,5,3,1,0,1,2,11
400993754,Northwestern Wildcats,P. Kunaiyi-Akpanah,3926411,,True,25.0,2,6,2,6,0,0,8,11,3,11,14,1,0,0,4,2,12
400993754,Northwestern Wildcats,J. Hamilton,4281239,,True,33.0,1,4,1,3,0,1,2,2,0,3,3,3,1,1,3,4,4
400993754,Northwestern Wildcats,L. Pulliam,4281237,,True,35.0,5,13,4,12,1,1,5,8,2,2,4,0,1,0,2,2,16
400993754,Northwestern Wildcats,L. Rohde,3142184,,True,30.0,1,4,0,0,1,4,1,2,0,2,2,0,1,0,1,2,4
400993754,Northwestern Wildcats,B. Hopkins,4068050,,False,15.0,1,2,0,1,1,1,0,0,3,1,4,0,0,1,1,4,3
400993754,Northwestern Wildcats,O. Hamilton,3054621,,False,12.0,1,1,1,1,0,0,2,2,1,2,3,2,0,0,2,1,4
400993754,Northwestern Wildcats,B. Galernik,4068052,,False,12.0,0,0,0,0,0,0,0,0,0,2,2,0,0,0,1,0,0
400993754,Northwestern Wildcats,TEAM,TOTAL,TOTAL,False,,15,44,10,32,5,12,19,27,10,32,42,9,4,2,16,17,54
400993754,Georgetown Hoyas,C. Petke,4068078,,True,37.0,5,12,2,5,3,7,0,2,3,7,10,0,1,0,2,3,13
400993754,Georgetown Hoyas,Y. Belk,3142295,,True,21.0,2,6,2,6,0,0,0,0,3,2,5,0,1,1,2,5,4
400993754,Georgetown Hoyas,D. White,3948815,,True,32.0,6,21,3,10,3,11,4,4,1,3,4,3,0,0,2,2,19
400993754,Georgetown Hoyas,D. Burton,3142292,,True,33.0,0,5,0,4,0,1,0,0,3,3,6,6,3,0,0,4,0
400993754,Georgetown Hoyas,M. Venson,3142105,,True,38.0,6,14,2,6,4,8,1,3,1,3,4,4,1,0,2,1,17
400993754,Georgetown Hoyas,T. Thompson,4281352,,False,21.0,0,3,0,2,0,1,2,4,1,3,4,0,1,0,0,2,2
400993754,Georgetown Hoyas,M. Smith,4068079,,False,3.0,0,1,0,1,0,0,0,0,0,0,0,0,0,0,0,0,0
400993754,Georgetown Hoyas,B. Mayfield,4281354,,False,15.0,0,0,0,0,0,0,0,0,1,1,2,0,0,0,0,0,0
400993754,Georgetown Hoyas,TEAM,TOTAL,TOTAL,False,,19,62,9,34,10,28,7,13,15,23,38,13,7,1,9,17,55
400993733,Nebraska Cornhuskers,K. Cain,4281240,,True,16.0,3,7,3,7,0,0,0,0,2,2,4,2,0,1,1,2,6
400993733,Nebraska Cornhuskers,T. Kissinger,4281241,,True,32.0,2,9,1,6,1,3,0,0,1,2,3,3,1,2,1,0,5
400993733,Nebraska Cornhuskers,G. Mitchell,4068048,,True,20.0,3,6,3,6,0,0,1,2,2,3,5,0,0,0,0,0,7
400993733,Nebraska Cornhuskers,H. Whitish,4068049,,True,29.0,5,10,3,7,2,3,2,4,0,3,3,1,1,0,3,1,14
400993733,Nebraska Cornhuskers,J. Cincore,3142169,,True,29.0,1,7,1,4,0,3,1,2,0,1,1,1,2,0,0,2,3
400993733,Nebraska Cornhuskers,R. Blackburn,3906947,,False,11.0,1,1,1,1,0,0,2,4,1,2,3,0,0,0,2,3,4
400993733,Nebraska Cornhuskers,D. Washington,3142174,,False,9.0,1,2,1,2,0,0,1,2,3,1,4,0,1,0,3,2,3
400993733,Nebraska Cornhuskers,N. Eliely,4068047,,False,15.0,1,7,1,6,0,1,2,2,2,3,5,0,1,3,2,1,4
400993733,Nebraska Cornhuskers,B. Stallworth,3906461,,False,18.0,0,4,0,3,0,1,0,0,0,3,3,1,0,0,1,0,0
400993733,Nebraska Cornhuskers,E. Wood,3142175,,False,21.0,1,2,0,1,1,1,0,0,0,3,3,3,3,0,0,0,3
400993733,Nebraska Cornhuskers,TEAM,TOTAL,TOTAL,False,,18,55,14,43,4,12,9,16,15,23,38,11,9,6,13,11,49
400993733,Creighton Bluejays,A. Faber,3938938,,True,34.0,5,15,3,9,2,6,2,2,0,7,7,8,0,0,2,1,14
400993733,Creighton Bluejays,A. Greene,3938937,,True,16.0,1,3,1,3,0,0,0,0,4,1,5,0,0,0,2,2,2
400993733,Creighton Bluejays,J. Agnew,3938935,,True,35.0,7,11,1,2,6,9,0,0,2,7,9,0,1,3,0,2,20
400993733,Creighton Bluejays,S. Lamberty,3142285,,True,35.0,3,9,2,8,1,1,0,0,1,0,1,4,2,0,2,2,7
400993733,Creighton Bluejays,M. Mellman,3142283,,True,14.0,1,3,1,2,0,1,0,0,1,2,3,0,0,0,0,0,2
400993733,Creighton Bluejays,K. Brown,3142286,,False,11.0,2,4,2,4,0,0,0,0,0,0,0,1,0,1,0,3,4
400993733,Creighton Bluejays,T. Carda,4281362,,False,28.0,3,9,2,3,1,6,1,1,0,3,3,1,0,0,0,3,8
400993733,Creighton Bluejays,T. Rembao,4281361,,False,14.0,3,5,2,3,1,2,0,0,1,4,5,1,1,0,2,0,7
400993733,Creighton Bluejays,B. Kissinger,3142124,,False,13.0,0,3,0,1,0,2,0,0,1,0,1,1,0,0,1,2,0
400993733,Creighton Bluejays,TEAM,TOTAL,TOTAL,False,,25,62,14,35,11,27,3,3,14,25,39,16,4,4,11,15,64
400993718,Minnesota Golden Gophers,J. Edwards,3921815,,True,23.0,2,6,2,6,0,0,1,2,3,4,7,1,2,0,0,2,5
400993718,Minnesota Golden Gophers,D. Pitts,4285010,,True,34.0,2,6,2,2,0,4,0,0,0,3,3,1,1,0,1,2,4
400993718,Minnesota Golden Gophers,G. Hubbard,4068036,,True,29.0,2,8,2,5,0,3,0,0,0,2,2,6,1,0,2,2,4
400993718,Minnesota Golden Gophers,K. Bell,3142297,,True,31.0,8,15,8,13,0,2,5,8,0,2,2,2,4,0,9,3,21
400993718,Minnesota Golden Gophers,C. Wagner,3142165,,True,36.0,12,14,5,6,7,8,0,0,0,3,3,0,1,0,3,0,31
400993718,Minnesota Golden Gophers,P. Kaposi,4068037,,False,4.0,0,0,0,0,0,0,0,0,1,0,1,0,0,0,1,0,0
400993718,Minnesota Golden Gophers,T. Bello,4068034,,False,15.0,0,0,0,0,0,0,0,0,0,3,3,0,0,1,0,4,0
400993718,Minnesota Golden Gophers,A. Lamke,3921818,,False,1.0,0,1,0,1,0,0,0,0,1,0,1,0,0,0,0,0,0
400993718,Minnesota Golden Gophers,B. Fernstrom,3133239,,False,4.0,0,3,0,2,0,1,0,0,1,1,2,0,0,0,0,0,0
400993718,Minnesota Golden Gophers,J. Brunson,4068035,,False,23.0,4,4,4,4,0,0,0,0,0,0,0,0,2,0,1,3,8
400993718,Minnesota Golden Gophers,TEAM,TOTAL,TOTAL,False,,30,57,23,39,7,18,6,10,8,25,33,10,11,1,18,16,73
400993718,Georgetown Hoyas,C. Petke,4068078,,True,38.0,6,11,6,10,0,1,0,0,2,2,4,4,2,0,2,2,12
400993718,Georgetown Hoyas,Y. Belk,3142295,,True,29.0,1,7,1,7,0,0,5,6,6,5,11,0,1,5,3,2,7
400993718,Georgetown Hoyas,D. White,3948815,,True,38.0,10,28,9,22,1,6,2,2,6,4,10,1,4,0,2,3,23
400993718,Georgetown Hoyas,D. Burton,3142292,,True,20.0,2,4,2,3,0,1,0,0,0,1,1,4,1,0,3,3,4
400993718,Georgetown Hoyas,M. Venson,3142105,,True,39.0,6,12,2,4,4,8,1,2,0,3,3,1,1,0,5,3,17
400993718,Georgetown Hoyas,T. Thompson,4281352,,False,11.0,0,3,0,3,0,0,0,0,2,3,5,1,0,1,2,1,0
400993718,Georgetown Hoyas,M. Smith,4068079,,False,25.0,0,4,0,3,0,1,0,0,1,1,2,0,1,0,1,2,0
400993718,Georgetown Hoyas,TEAM,TOTAL,TOTAL,False,,25,69,20,52,5,17,8,10,20,21,41,11,10,6,18,16,63
400993714,Xavier Musketeers,A. Gray,4281368,,True,27.0,4,7,3,6,1,1,1,2,2,9,11,1,1,0,3,2,10
400993714,Xavier Musketeers,A. Aijanen,3142319,,True,32.0,4,9,3,4,1,5,0,1,0,5,5,0,0,0,5,4,9
400993714,Xavier Musketeers,N. Owens,4068187,,True,22.0,3,8,0,1,3,7,3,6,0,1,1,2,0,1,1,0,12
400993714,Xavier Musketeers,A. Gomez,4068185,,True,12.0,0,1,0,0,0,1,0,0,0,1,1,0,0,0,1,1,0
400993714,Xavier Musketeers,J. Byrd,3142318,,True,29.0,3,7,3,7,0,0,1,3,0,1,1,2,0,0,2,0,7
400993714,Xavier Musketeers,D. Ross,4281364,,False,19.0,2,4,1,1,1,3,4,4,0,6,6,0,1,1,0,4,9
400993714,Xavier Musketeers,J. Dawson,4281369,,False,2.0,0,0,0,0,0,0,0,0,0,0,0,0,0,0,1,0,0
400993714,Xavier Musketeers,A. Reiff,4281367,,False,13.0,0,2,0,1,0,1,0,0,0,2,2,0,1,0,2,0,0
400993714,Xavier Musketeers,P. Stewart,4281366,,False,25.0,3,7,2,4,1,3,2,2,0,1,1,3,1,0,1,1,9
400993714,Xavier Musketeers,A. Dunham,4281365,,False,19.0,2,6,1,4,1,2,1,2,1,3,4,1,0,0,0,1,6
400993714,Xavier Musketeers,TEAM,TOTAL,TOTAL,False,,21,51,13,28,8,23,12,20,4,32,36,9,4,2,17,13,62
400993714,Minnesota Golden Gophers,J. Edwards,3921815,,True,15.0,4,5,4,5,0,0,0,0,1,6,7,0,0,0,0,2,8
400993714,Minnesota Golden Gophers,D. Pitts,4285010,,True,32.0,2,8,1,4,1,4,2,2,1,9,10,0,1,0,1,2,7
400993714,Minnesota Golden Gophers,G. Hubbard,4068036,,True,39.0,2,7,1,3,1,4,0,0,0,2,2,6,1,0,0,2,5
400993714,Minnesota Golden Gophers,K. Bell,3142297,,True,38.0,6,17,6,15,0,2,8,11,3,3,6,7,2,0,3,2,20
400993714,Minnesota Golden Gophers,C. Wagner,3142165,,True,40.0,8,19,5,13,3,6,5,6,0,3,3,4,1,0,2,2,24
400993714,Minnesota Golden Gophers,P. Kaposi,4068037,,False,3.0,0,0,0,0,0,0,0,0,0,0,0,0,0,0,0,1,0
400993714,Minnesota Golden Gophers,T. Bello,4068034,,False,17.0,2,7,2,7,0,0,0,0,3,1,4,0,1,0,1,0,4
400993714,Minnesota Golden Gophers,B. Fernstrom,3133239,,False,13.0,2,4,2,4,0,0,0,0,2,4,6,0,1,0,0,2,4
400993714,Minnesota Golden Gophers,J. Brunson,4068035,,False,3.0,1,1,1,1,0,0,0,0,0,1,1,0,0,0,0,1,2
400993714,Minnesota Golden Gophers,TEAM,TOTAL,TOTAL,False,,27,68,22,52,5,16,15,19,10,32,42,17,7,0,7,14,74
400993695,Michigan Wolverines,J. Dunston,3142152,,True,38.0,3,5,3,5,0,0,1,4,2,12,14,4,2,1,3,3,7
400993695,Michigan Wolverines,H. Brown,4281243,,True,24.0,3,8,3,6,0,2,2,4,4,2,6,1,0,3,1,4,8
400993695,Michigan Wolverines,H. Thome,3914642,,True,37.0,7,12,7,12,0,0,3,4,2,0,2,3,1,1,1,1,17
400993695,Michigan Wolverines,N. Munger,3914640,,True,35.0,3,9,0,2,3,7,1,2,2,6,8,1,1,0,0,3,10
400993695,Michigan Wolverines,K. Flaherty,3142151,,True,38.0,8,21,7,14,1,7,10,11,0,3,3,3,1,0,6,3,27
400993695,Michigan Wolverines,K. Robbins,4065821,,False,2.0,0,1,0,1,0,0,1,2,0,0,0,0,0,0,0,0,1
400993695,Michigan Wolverines,D. Church,4281244,,False,26.0,5,8,4,7,1,1,1,1,1,2,3,0,0,1,4,3,12
400993695,Michigan Wolverines,TEAM,TOTAL,TOTAL,False,,29,64,24,47,5,17,19,28,13,26,39,12,5,6,16,17,82
400993695,Marquette Golden Eagles,E. Davenport,3906756,,True,35.0,8,14,8,14,0,0,7,8,5,2,7,0,0,0,2,4,23
400993695,Marquette Golden Eagles,A. Wilborn,3906758,,True,19.0,0,6,0,4,0,2,2,3,0,0,0,3,1,1,3,5,2
400993695,Marquette Golden Eagles,A. Blockton,3906755,,True,37.0,7,16,6,14,1,2,4,4,3,8,11,3,0,0,2,1,19
400993695,Marquette Golden Eagles,N. Hiedeman,3906753,,True,38.0,3,9,1,4,2,5,0,0,2,6,8,2,1,0,4,3,8
400993695,Marquette Golden Eagles,D. King,3906752,,True,37.0,7,16,5,10,2,6,3,4,2,4,6,5,2,0,3,3,19
400993695,Marquette Golden Eagles,M. Smith Traore,4281351,,False,2.0,0,0,0,0,0,0,0,0,0,0,0,0,0,0,0,1,0
400993695,Marquette Golden Eagles,A. Anderson,4068081,,False,8.0,1,2,1,2,0,0,0,0,0,0,0,0,0,0,0,3,2
400993695,Marquette Golden Eagles,L. Van Kleunen,4068083,,False,1.0,0,0,0,0,0,0,0,0,0,0,0,0,0,0,0,2,0
400993695,Marquette Golden Eagles,S. Lott,4281350,,False,16.0,1,5,0,2,1,3,0,0,0,1,1,0,0,0,0,5,3
400993695,Marquette Golden Eagles,I. Spingola,4068082,,False,7.0,0,3,0,0,0,3,0,0,0,0,0,0,0,0,4,1,0
400993695,Marquette Golden Eagles,TEAM,TOTAL,TOTAL,False,,27,71,21,50,6,21,16,19,18,22,40,13,4,1,18,28,76
400993442,Florida Gulf Coast Eagles,T. Adderly,4068664,,True,29.0,5,8,5,8,0,0,1,2,5,4,9,1,1,0,2,5,11
400993442,Florida Gulf Coast Eagles,R. Julien,4068663,,True,33.0,6,14,6,11,0,3,10,11,2,1,3,0,2,0,0,2,22
400993442,Florida Gulf Coast Eagles,N. Ulel,4068662,,True,22.0,2,6,2,5,0,1,1,3,0,3,3,0,1,0,2,0,5
400993442,Florida Gulf Coast Eagles,E. Nelson,4068659,,True,27.0,4,7,4,6,0,1,0,0,1,3,4,0,0,0,2,5,8
400993442,Florida Gulf Coast Eagles,T. Gradinjan,17910,,True,42.0,1,3,0,0,1,3,2,2,0,7,7,0,1,1,2,1,5
400993442,Florida Gulf Coast Eagles,A. Blair,4281269,,False,2.0,0,0,0,0,0,0,0,0,0,0,0,0,0,0,0,1,0
400993442,Florida Gulf Coast Eagles,L. Zderadicka,3143814,,False,30.0,5,13,4,12,1,1,1,3,0,0,0,2,1,0,1,5,12
400993442,Florida Gulf Coast Eagles,J. Cattani,3077353,,False,10.0,0,1,0,0,0,1,0,0,0,1,1,1,0,0,0,0,0
400993442,Florida Gulf Coast Eagles,C. Dow,3064944,,False,30.0,6,11,6,7,0,4,14,15,2,7,9,1,3,0,6,4,26
400993442,Florida Gulf Coast Eagles,TEAM,TOTAL,TOTAL,False,,29,63,27,49,2,14,29,36,11,31,42,5,9,1,18,23,89
400993442,DePaul Blue Demons,M. Grays,3142287,,True,30.0,7,15,6,13,1,2,2,4,1,8,9,2,1,2,4,4,17
400993442,DePaul Blue Demons,K. Campbell,4068071,,True,42.0,2,6,2,3,0,3,6,7,0,2,2,5,0,0,1,2,10
400993442,DePaul Blue Demons,T. Allen,3933760,,True,34.0,4,13,3,6,1,7,3,4,4,6,10,3,0,1,1,5,12
400993442,DePaul Blue Demons,A. Millender,3142289,,True,38.0,4,12,2,3,2,9,0,0,1,3,4,1,0,0,2,4,10
400993442,DePaul Blue Demons,A. Coleman,3142123,,True,36.0,5,11,3,7,2,4,2,6,4,3,7,7,0,1,4,4,14
400993442,DePaul Blue Demons,R. McLimore,4281358,,False,8.0,1,1,1,1,0,0,0,0,1,1,2,1,0,0,1,3,2
400993442,DePaul Blue Demons,C. Stonewall,4068072,,False,17.0,6,8,4,6,2,2,1,1,2,2,4,0,1,3,2,5,15
400993442,DePaul Blue Demons,D. Bekelja,4281356,,False,2.0,0,1,0,0,0,1,0,0,0,0,0,0,0,0,0,1,0
400993442,DePaul Blue Demons,L. Prochaska,3142290,,False,18.0,0,3,0,1,0,2,4,4,0,2,2,0,0,1,2,1,4
400993442,DePaul Blue Demons,TEAM,TOTAL,TOTAL,False,,29,70,21,40,8,30,18,26,14,28,42,19,2,8,17,29,84
400993324,Lipscomb Bisons,E. Kmec,4068676,,True,28.0,7,12,2,4,5,8,0,0,3,5,8,1,1,0,0,1,19
400993324,Lipscomb Bisons,L. Jones,4068673,,True,21.0,2,8,2,8,0,0,0,0,2,3,5,0,0,1,3,4,4
400993324,Lipscomb Bisons,L. Manos,4068679,,True,19.0,0,3,0,1,0,2,0,0,0,0,0,2,1,0,2,4,0
400993324,Lipscomb Bisons,L. Cagle,3142407,,True,40.0,4,10,1,3,3,7,0,0,0,8,8,4,1,2,4,2,11
400993324,Lipscomb Bisons,K. Potts,3142404,,True,16.0,1,5,0,1,1,4,0,0,0,1,1,1,0,0,0,3,3
400993324,Lipscomb Bisons,R. Northway,3142408,,False,14.0,3,6,3,6,0,0,4,4,1,2,3,0,0,0,0,1,10
400993324,Lipscomb Bisons,K. Cotton,4068681,,False,12.0,0,4,0,0,0,4,0,0,0,4,4,0,0,0,3,2,0
400993324,Lipscomb Bisons,L. Rau,4068680,,False,29.0,2,7,2,4,0,3,0,0,0,3,3,4,2,0,2,3,4
400993324,Lipscomb Bisons,A. Broughton,4068677,,False,6.0,0,1,0,0,0,1,1,2,0,0,0,0,1,0,0,1,1
400993324,Lipscomb Bisons,C. Short,4068675,,False,1.0,0,0,0,0,0,0,0,0,0,0,0,0,1,0,0,0,0
400993324,Lipscomb Bisons,M. Lovelady,4068674,,False,14.0,2,11,0,1,2,10,0,0,0,1,1,2,0,0,0,3,6
400993324,Lipscomb Bisons,TEAM,TOTAL,TOTAL,False,,21,67,10,28,11,39,5,6,9,28,37,14,7,3,16,24,58
400993324,Butler Bulldogs,T. Schickel,3914012,,True,34.0,5,13,5,13,0,0,5,6,7,10,17,2,3,1,1,1,15
400993324,Butler Bulldogs,S. Brey,4068067,,True,25.0,2,2,2,2,0,0,0,1,1,3,4,0,1,1,0,2,4
400993324,Butler Bulldogs,M. Weaver,3914014,,True,31.0,1,3,0,2,1,1,0,0,2,4,6,1,0,0,1,0,3
400993324,Butler Bulldogs,W. Jennings,3142145,,True,34.0,7,22,6,14,1,8,5,6,1,7,8,6,1,0,2,2,20
400993324,Butler Bulldogs,I. Lathan,3079485,,True,19.0,6,9,6,9,0,0,0,0,2,4,6,2,1,0,2,3,12
400993324,Butler Bulldogs,A. Aube,4281363,,False,1.0,0,0,0,0,0,0,0,0,0,0,0,0,0,0,0,1,0
400993324,Butler Bulldogs,K. Hodges,4068065,,False,10.0,0,2,0,2,0,0,2,2,1,3,4,1,0,0,1,2,2
400993324,Butler Bulldogs,S. Humphrey,4068066,,False,3.0,1,1,1,1,0,0,0,0,0,0,0,0,0,0,2,0,2
400993324,Butler Bulldogs,S. Shelton,4068069,,False,16.0,0,4,0,0,0,4,0,0,0,2,2,0,0,1,0,1,0
400993324,Butler Bulldogs,K. Spolyar,4068068,,False,9.0,1,5,1,3,0,2,3,3,0,1,1,1,1,0,3,3,5
400993324,Butler Bulldogs,T. Buford,3914011,,False,5.0,0,0,0,0,0,0,3,4,2,0,2,0,0,0,2,1,3
400993324,Butler Bulldogs,S. Buck,3142279,,False,13.0,1,6,0,0,1,6,1,2,0,1,1,0,0,0,0,0,4
400993324,Butler Bulldogs,TEAM,TOTAL,TOTAL,False,,24,67,21,46,3,21,19,24,16,38,54,13,7,3,14,16,70
400987870,Tennessee Lady Volunteers,M. Russell,3056672,,True,36.0,7,13,7,13,0,0,3,5,6,9,15,0,2,2,1,4,17
400987870,Tennessee Lady Volunteers,R. Davis,4280888,,True,36.0,7,13,7,10,0,3,0,0,5,5,10,1,0,0,2,5,14
400987870,Tennessee Lady Volunteers,J. Nared,3143136,,True,40.0,7,21,6,17,1,4,11,12,7,8,15,6,3,2,3,5,26
400987870,Tennessee Lady Volunteers,E. Westbrook,4280890,,True,30.0,4,10,2,5,2,5,0,0,1,3,4,3,0,0,4,5,10
400987870,Tennessee Lady Volunteers,M. Jackson,3907791,,True,30.0,3,6,1,2,2,4,0,2,0,4,4,4,1,0,0,3,8
400987870,Tennessee Lady Volunteers,C. Green,4065764,,False,7.0,2,3,2,3,0,0,0,0,1,1,2,0,0,0,2,0,4
400987870,Tennessee Lady Volunteers,K. Dunbar,3143134,,False,20.0,2,6,0,0,2,6,0,0,0,0,0,0,1,1,0,0,6
400987870,Tennessee Lady Volunteers,A. Hayes,4280889,,False,26.0,3,9,2,8,1,1,9,13,0,3,3,2,0,0,8,3,16
400987870,Tennessee Lady Volunteers,TEAM,TOTAL,TOTAL,False,,35,81,27,58,8,23,23,32,22,35,57,16,7,5,20,25,101
400987870,Marquette Golden Eagles,E. Davenport,3906756,,True,39.0,5,12,5,12,0,0,0,0,4,8,12,1,4,0,3,4,10
400987870,Marquette Golden Eagles,L. Van Kleunen,4068083,,True,24.0,6,10,5,8,1,2,1,2,1,2,3,0,3,0,1,1,14
400987870,Marquette Golden Eagles,A. Blockton,3906755,,True,34.0,8,17,7,16,1,1,11,12,5,6,11,2,0,0,4,4,28
400987870,Marquette Golden Eagles,N. Hiedeman,3906753,,True,43.0,9,21,8,11,1,10,4,9,0,2,2,3,2,0,2,3,23
400987870,Marquette Golden Eagles,D. King,3906752,,True,27.0,4,11,3,8,1,3,0,0,0,1,1,2,0,0,2,4,9
400987870,Marquette Golden Eagles,S. Lott,4281350,,False,23.0,0,1,0,1,0,0,0,0,2,3,5,1,0,0,1,3,0
400987870,Marquette Golden Eagles,I. Spingola,4068082,,False,1.0,0,0,0,0,0,0,0,0,0,0,0,0,0,0,0,1,0
400987870,Marquette Golden Eagles,A. Wilborn,3906758,,False,34.0,6,15,6,13,0,2,3,4,2,0,2,3,1,1,2,4,15
400987870,Marquette Golden Eagles,TEAM,TOTAL,TOTAL,False,,38,87,34,69,4,18,19,27,18,26,44,12,10,1,15,24,99
400987827,Xavier Musketeers,A. Gray,4281368,,True,10.0,0,4,0,2,0,2,0,0,0,2,2,0,1,0,1,3,0
400987827,Xavier Musketeers,A. Aijanen,3142319,,True,28.0,2,7,1,3,1,4,0,0,3,5,8,2,0,0,1,2,5
400987827,Xavier Musketeers,N. Owens,4068187,,True,18.0,2,8,0,4,2,4,1,2,0,1,1,1,0,0,0,0,7
400987827,Xavier Musketeers,J. Byrd,3142318,,True,17.0,2,7,2,6,0,1,1,1,0,0,0,1,0,0,1,1,5
400987827,Xavier Musketeers,K. Fincher,3142317,,True,21.0,1,6,0,1,1,5,2,2,0,1,1,1,0,0,2,3,5
400987827,Xavier Musketeers,D. Ross,4281364,,False,29.0,4,10,1,2,3,8,2,2,2,4,6,1,0,0,0,3,13
400987827,Xavier Musketeers,M. Christopher,4068186,,False,5.0,0,1,0,1,0,0,0,0,0,1,1,0,0,0,0,0,0
400987827,Xavier Musketeers,J. Dawson,4281369,,False,14.0,2,5,2,5,0,0,0,0,1,0,1,1,1,0,0,0,4
400987827,Xavier Musketeers,A. Reiff,4281367,,False,10.0,0,1,0,1,0,0,0,0,0,2,2,1,0,0,0,3,0
400987827,Xavier Musketeers,P. Stewart,4281366,,False,19.0,1,6,1,3,0,3,0,0,0,1,1,0,0,0,3,0,2
400987827,Xavier Musketeers,A. Dunham,4281365,,False,18.0,3,6,2,2,1,4,0,0,1,2,3,1,0,0,1,0,7
400987827,Xavier Musketeers,A. Gomez,4068185,,False,11.0,0,0,0,0,0,0,0,0,0,0,0,0,2,0,0,0,0
400987827,Xavier Musketeers,TEAM,TOTAL,TOTAL,False,,17,61,9,30,8,31,6,7,8,21,29,9,4,0,9,15,48
400987827,Missouri Tigers,C. Porter,3907783,,True,21.0,5,7,4,6,1,1,1,2,1,9,10,1,0,1,3,1,12
400987827,Missouri Tigers,J. Frericks,3056659,,True,15.0,5,8,5,8,0,0,0,0,4,2,6,3,1,0,0,2,10
400987827,Missouri Tigers,A. Smith,4065749,,True,26.0,2,7,2,5,0,2,0,0,0,4,4,1,0,0,0,0,4
400987827,Missouri Tigers,S. Cunningham,3907781,,True,24.0,7,9,5,6,2,3,4,4,0,4,4,4,2,0,1,3,20
400987827,Missouri Tigers,L. Aldridge,3133240,,True,26.0,3,4,3,3,0,1,4,7,0,2,2,4,1,0,1,0,10
400987827,Missouri Tigers,E. Tahane,4280883,,False,7.0,0,2,0,1,0,1,0,0,0,1,1,0,0,0,0,0,0
400987827,Missouri Tigers,H. Schuchts,3907782,,False,17.0,0,4,0,2,0,2,2,2,4,2,6,0,0,0,0,1,2
400987827,Missouri Tigers,K. Michael,3056658,,False,15.0,0,6,0,4,0,2,1,2,1,4,5,1,1,0,1,0,1
400987827,Missouri Tigers,E. Brown,4280882,,False,5.0,0,0,0,0,0,0,0,0,0,0,0,0,0,1,1,0,0
400987827,Missouri Tigers,N. Green,4280881,,False,8.0,1,3,1,3,0,0,0,0,2,1,3,0,0,0,1,1,2
400987827,Missouri Tigers,K. Winfrey,4280880,,False,3.0,1,1,1,1,0,0,0,0,0,2,2,0,0,0,0,0,2
400987827,Missouri Tigers,J. Chavis,4065748,,False,22.0,3,6,0,1,3,5,0,0,0,2,2,1,0,0,2,1,9
400987827,Missouri Tigers,J. Roundtree,4065747,,False,11.0,1,2,1,1,0,1,0,0,0,1,1,0,0,0,1,1,2
400987827,Missouri Tigers,TEAM,TOTAL,TOTAL,False,,28,59,22,41,6,18,12,17,12,36,48,15,5,2,11,10,74
400987659,Georgetown Hoyas,C. Petke,4068078,,True,38.0,0,5,0,1,0,4,4,4,1,1,2,0,1,0,1,1,4
400987659,Georgetown Hoyas,Y. Belk,3142295,,True,20.0,1,3,1,3,0,0,0,2,2,4,6,0,2,0,3,3,2
400987659,Georgetown Hoyas,D. White,3948815,,True,33.0,3,13,3,8,0,5,1,2,3,4,7,4,2,0,6,3,7
400987659,Georgetown Hoyas,D. Burton,3142292,,True,28.0,2,6,1,4,1,2,0,0,0,2,2,3,2,0,3,3,5
400987659,Georgetown Hoyas,M. Venson,3142105,,True,35.0,7,14,2,4,5,10,0,0,1,0,1,2,1,0,2,2,19
400987659,Georgetown Hoyas,T. Thompson,4281352,,False,22.0,1,2,1,2,0,0,0,0,0,0,0,0,0,0,1,1,2
400987659,Georgetown Hoyas,M. Smith,4068079,,False,18.0,0,2,0,1,0,1,1,2,2,1,3,0,0,0,1,1,1
400987659,Georgetown Hoyas,B. Mayfield,4281354,,False,2.0,0,1,0,1,0,0,0,0,0,0,0,0,0,0,1,0,0
400987659,Georgetown Hoyas,M. Osagie-Erese,4072597,,False,4.0,0,2,0,1,0,1,0,0,0,1,1,0,1,0,1,0,0
400987659,Georgetown Hoyas,TEAM,TOTAL,TOTAL,False,,14,48,8,25,6,23,6,10,10,15,25,9,9,0,20,14,40
400987659,Auburn Tigers,J. Jones,3142202,,True,24.0,5,8,5,8,0,0,0,0,3,1,4,1,1,0,1,2,10
400987659,Auburn Tigers,U. Thompson,4280841,,True,26.0,5,9,5,9,0,0,2,2,3,4,7,0,1,0,2,2,12
400987659,Auburn Tigers,E. Jones,4065708,,True,27.0,1,4,0,0,1,4,0,0,1,2,3,1,2,0,2,1,3
400987659,Auburn Tigers,J. McKay,3906294,,True,27.0,0,5,0,4,0,1,0,0,0,3,3,6,1,0,3,3,0
400987659,Auburn Tigers,T. Lewis,3141992,,True,21.0,3,7,2,3,1,4,0,0,1,4,5,1,0,0,2,1,7
400987659,Auburn Tigers,A. Jackson,4280839,,False,2.0,0,0,0,0,0,0,0,0,0,1,1,0,0,0,1,0,0
400987659,Auburn Tigers,J. Jones,3142203,,False,19.0,6,6,6,6,0,0,0,2,1,3,4,1,0,1,0,1,12
400987659,Auburn Tigers,J. Wright,3142000,,False,8.0,0,0,0,0,0,0,0,0,1,1,2,0,0,0,2,0,0
400987659,Auburn Tigers,I. Lopez,4280842,,False,11.0,2,3,1,1,1,2,1,2,0,0,0,0,0,0,2,1,6
400987659,Auburn Tigers,D. Alexander,4065706,,False,19.0,4,8,3,6,1,2,1,2,0,5,5,2,3,0,2,3,10
400987659,Auburn Tigers,E. Sanders,3906292,,False,16.0,0,1,0,1,0,0,0,0,1,0,1,2,2,0,2,1,0
400987659,Auburn Tigers,TEAM,TOTAL,TOTAL,False,,26,51,22,38,4,13,4,8,11,26,37,14,10,1,19,15,60
401312270,Rice Owls,L. Schwartz,4595232,,True,37.0,8,14,5,11,3,3,1,2,5,2,7,4,1,0,2,0,20
401312270,Rice Owls,N. Mulkey,4068109,,True,34.0,11,21,11,21,0,0,6,7,3,5,8,2,1,2,1,1,28
401312270,Rice Owls,K. Crosthwait,4595230,,True,28.0,2,7,0,1,2,6,0,0,0,6,6,1,0,0,0,2,6
401312270,Rice Owls,H. Swayze,4399608,,True,36.0,5,13,3,7,2,6,2,2,0,4,4,4,0,2,0,1,14
401312270,Rice Owls,J. Smith,4399607,,True,38.0,6,10,5,8,1,2,2,3,0,7,7,10,4,0,4,1,15
401312270,Rice Owls,I. Bellamy,4433709,,False,5.0,0,0,0,0,0,0,0,0,0,0,0,0,0,0,2,0,0
401312270,Rice Owls,D. Jackson,4595231,,False,22.0,2,3,2,3,0,0,0,0,0,4,4,4,2,0,1,0,4
401312270,Rice Owls,TEAM,TOTAL,TOTAL,False,,34,68,26,51,8,17,11,14,10,30,40,25,8,4,10,5,87
401312270,Fresno State Bulldogs,W. Motta,4595631,,True,27.0,5,12,5,12,0,0,0,0,2,4,6,1,0,0,1,3,10
401312270,Fresno State Bulldogs,Y. Todorova,4704475,,True,19.0,4,5,2,2,2,3,0,0,0,3,3,2,2,0,2,4,10
401312270,Fresno State Bulldogs,K. Brown,4704473,,True,36.0,2,8,2,6,0,2,0,1,2,6,8,4,2,5,1,1,4
401312270,Fresno State Bulldogs,Hal. Cavinder,4433658,,True,38.0,9,16,6,9,3,7,0,0,1,5,6,6,1,0,3,4,21
401312270,Fresno State Bulldogs,Han. Cavinder,4433372,,True,40.0,10,20,8,16,2,4,0,0,0,3,3,3,2,0,2,2,22
401312270,Fresno State Bulldogs,C. Fairley,4704474,,False,13.0,1,2,0,1,1,1,0,0,0,1,1,1,0,0,3,1,3
401312270,Fresno State Bulldogs,A. James,4433292,,False,16.0,1,4,0,0,1,4,0,0,2,1,3,2,0,0,0,3,3
401312270,Fresno State Bulldogs,D. Dunn,4433511,,False,11.0,0,2,0,0,0,2,0,0,0,0,0,0,0,0,1,0,0
401312270,Fresno State Bulldogs,TEAM,TOTAL,TOTAL,False,,32,69,23,46,9,23,0,1,8,26,34,19,7,5,14,18,73
401312267,Missouri Tigers,L. Williams,4280886,,True,22.0,5,8,5,8,0,0,0,0,0,3,3,0,0,3,2,1,10
401312267,Missouri Tigers,S. Dufficy,4068417,,True,32.0,4,10,3,5,1,5,2,4,2,6,8,3,0,1,0,1,11
401312267,Missouri Tigers,M. Dembele,4704449,,True,25.0,2,4,2,2,0,2,0,0,0,1,1,4,4,0,2,2,4
401312267,Missouri Tigers,A. Blackwell,4432833,,True,29.0,5,8,3,5,2,3,4,6,2,6,8,5,1,1,6,3,16
401312267,Missouri Tigers,H. Troup,4280879,,True,31.0,4,10,3,5,1,5,0,0,2,3,5,2,1,0,1,1,9
401312267,Missouri Tigers,M. Linthacum,4433671,,False,12.0,1,3,1,3,0,0,0,0,0,1,1,1,0,0,0,1,2
401312267,Missouri Tigers,J. Kelly,4433470,,False,6.0,2,3,2,3,0,0,0,1,0,0,0,0,0,0,1,2,4
401312267,Missouri Tigers,S. Smith,4704448,,False,9.0,0,2,0,1,0,1,0,0,1,2,3,0,0,0,1,0,0
401312267,Missouri Tigers,L. Hansen,4432951,,False,11.0,4,6,2,3,2,3,0,0,0,0,0,1,1,0,0,3,10
401312267,Missouri Tigers,S. Dickson,4068184,,False,23.0,4,5,4,5,0,0,1,1,0,5,5,4,1,0,4,4,9
401312267,Missouri Tigers,TEAM,TOTAL,TOTAL,False,,31,59,25,40,6,19,7,12,7,28,35,20,8,5,18,18,75
401312267,Fresno State Bulldogs,W. Motta,4595631,,True,33.0,1,9,1,7,0,2,2,6,2,6,8,2,1,0,0,3,4
401312267,Fresno State Bulldogs,Y. Todorova,4704475,,True,30.0,7,11,2,3,5,8,0,0,1,0,1,0,3,1,2,0,19
401312267,Fresno State Bulldogs,K. Brown,4704473,,True,21.0,1,5,1,3,0,2,0,0,0,3,3,2,0,0,3,1,2
401312267,Fresno State Bulldogs,Hal. Cavinder,4433658,,True,39.0,10,16,8,11,2,5,3,4,2,6,8,7,3,1,4,0,25
401312267,Fresno State Bulldogs,Han. Cavinder,4433372,,True,38.0,4,12,4,9,0,3,6,10,2,4,6,7,2,0,1,2,14
401312267,Fresno State Bulldogs,C. Fairley,4704474,,False,6.0,0,0,0,0,0,0,0,0,1,0,1,0,0,0,0,1,0
401312267,Fresno State Bulldogs,A. James,4433292,,False,20.0,3,6,2,4,1,2,1,2,0,0,0,1,0,0,0,4,8
401312267,Fresno State Bulldogs,D. Dunn,4433511,,False,13.0,2,4,0,0,2,4,0,0,0,0,0,0,0,0,0,0,6
401312267,Fresno State Bulldogs,TEAM,TOTAL,TOTAL,False,,28,63,18,37,10,26,12,22,10,21,31,19,9,2,10,11,78
401312265,New Mexico Lobos,S. McGruder,4400149,,True,15.0,4,5,3,4,1,1,0,0,3,1,4,1,1,0,2,0,9
401312265,New Mexico Lobos,A. Anderson,4281834,,True,6.0,2,5,1,4,1,1,0,0,0,2,2,1,2,0,0,0,5
401312265,New Mexico Lobos,Lato. Duff,4704520,,True,28.0,2,4,2,3,0,1,0,0,0,2,2,4,0,0,0,0,4
401312265,New Mexico Lobos,A. Hurst,4400147,,True,34.0,3,8,1,3,2,5,0,0,0,4,4,3,2,2,0,2,8
401312265,New Mexico Lobos,J. De La Cerda,4281833,,True,35.0,11,26,9,19,2,7,4,6,3,4,7,6,2,0,1,3,28
401312265,New Mexico Lobos,A. Watts,4433688,,False,22.0,3,5,3,3,0,2,0,0,2,2,4,0,5,0,0,4,6
401312265,New Mexico Lobos,A. Robinson,4432993,,False,7.0,1,2,1,2,0,0,0,2,2,2,4,0,0,0,1,4,2
401312265,New Mexico Lobos,K. van Bennekom,4704522,,False,1.0,0,1,0,1,0,0,0,0,0,0,0,0,0,0,0,1,0
401312265,New Mexico Lobos,Lata. Duff,4704519,,False,32.0,5,17,3,5,2,12,8,8,0,0,0,1,1,1,1,0,20
401312265,New Mexico Lobos,C. Carter,4433646,,False,20.0,1,3,1,1,0,2,1,4,0,4,4,2,0,1,1,0,3
401312265,New Mexico Lobos,TEAM,TOTAL,TOTAL,False,,32,76,24,45,8,31,13,20,12,22,34,18,13,4,6,14,85
401312265,California Baptist Lancers,C. Harper,4419354,,True,24.0,10,15,8,11,2,4,3,3,2,7,9,1,0,2,1,2,25
401312265,California Baptist Lancers,B. Thomas,4419353,,True,21.0,10,11,10,11,0,0,2,2,3,7,10,1,0,1,2,2,22
401312265,California Baptist Lancers,T. Neale,4598110,,True,29.0,3,5,0,1,3,4,0,0,0,2,2,5,1,1,1,1,9
401312265,California Baptist Lancers,S. Palma,4419349,,True,16.0,1,3,1,2,0,1,0,0,0,2,2,1,0,1,2,1,2
401312265,California Baptist Lancers,A. Olaeta,4419341,,True,36.0,5,12,5,9,0,3,1,2,1,6,7,14,1,0,5,2,11
401312265,California Baptist Lancers,D. Wu,4703946,,False,7.0,0,3,0,3,0,0,0,0,1,1,2,1,0,0,1,0,0
401312265,California Baptist Lancers,T. Wu,4598112,,False,26.0,3,6,1,1,2,5,1,4,0,3,3,1,0,0,1,2,9
401312265,California Baptist Lancers,G. Dale,4419346,,False,11.0,1,1,0,0,1,1,0,0,0,2,2,1,2,0,1,1,3
401312265,California Baptist Lancers,B. Klaman,4281618,,False,30.0,3,11,0,1,3,10,0,0,1,3,4,5,0,0,3,2,9
401312265,California Baptist Lancers,TEAM,TOTAL,TOTAL,False,,36,67,25,39,11,28,7,11,11,34,45,30,4,5,17,13,90
401311228,Wyoming Cowgirls,D. Davidsdottir,4068870,,True,34.0,2,4,2,4,0,0,1,2,1,2,3,1,1,1,1,2,5
401311228,Wyoming Cowgirls,J. Johnson,4595683,,True,16.0,1,2,1,1,0,1,0,1,0,1,1,1,0,0,1,1,2
401311228,Wyoming Cowgirls,Q. Weidemann,4400207,,True,38.0,4,16,3,10,1,6,2,2,0,1,1,2,0,0,1,4,11
401311228,Wyoming Cowgirls,A. Sanchez Ramos,4400204,,True,38.0,4,11,2,6,2,5,5,8,4,6,10,0,0,0,1,2,15
401311228,Wyoming Cowgirls,T. Olson,4400203,,True,34.0,1,4,1,3,0,1,0,0,2,3,5,0,0,0,2,3,2
401311228,Wyoming Cowgirls,M. Savic,4704660,,False,1.0,0,0,0,0,0,0,0,0,0,0,0,0,0,0,0,0,0
401311228,Wyoming Cowgirls,P. Salazar,4704659,,False,1.0,0,0,0,0,0,0,0,0,0,0,0,0,0,0,0,0,0
401311228,Wyoming Cowgirls,G. Ellis,4704657,,False,6.0,0,1,0,1,0,0,0,0,0,1,1,0,0,0,0,0,0
401311228,Wyoming Cowgirls,L. Bull,4704655,,False,1.0,0,1,0,0,0,1,0,0,0,0,0,0,0,0,0,0,0
401311228,Wyoming Cowgirls,O. Ustowska,4704662,,False,7.0,0,1,0,0,0,1,0,0,0,0,0,1,0,0,1,1,0
401311228,Wyoming Cowgirls,L. Hudson,4704658,,False,1.0,0,0,0,0,0,0,0,0,0,0,0,0,0,0,0,0,0
401311228,Wyoming Cowgirls,M. Bradshaw,4595681,,False,23.0,4,8,2,5,2,3,3,4,0,1,1,0,0,0,2,0,13
401311228,Wyoming Cowgirls,TEAM,TOTAL,TOTAL,False,,16,48,11,30,5,18,11,17,8,19,27,5,1,1,12,13,48
401311228,UCLA Bruins,L. Miller,4282174,,True,23.0,3,9,3,9,0,0,0,0,2,5,7,0,1,0,1,4,6
401311228,UCLA Bruins,M. Onyenwere,4282173,,True,33.0,9,17,8,13,1,4,6,6,3,4,7,2,2,1,3,4,25
401311228,UCLA Bruins,C. Osborne,4433293,,True,37.0,6,10,6,8,0,2,3,3,4,6,10,4,0,0,0,1,15
401311228,UCLA Bruins,N. Chou,4066562,,True,35.0,6,13,3,8,3,5,0,0,3,3,6,1,1,1,0,2,15
401311228,UCLA Bruins,L. Corsaro,4066549,,True,27.0,1,5,1,4,0,1,2,2,0,1,1,3,0,0,0,2,4
401311228,UCLA Bruins,E. Bessoir,4703592,,False,25.0,1,4,1,1,0,3,2,4,3,5,8,1,1,1,2,4,4
401311228,UCLA Bruins,E. Sigal,4398838,,False,1.0,0,0,0,0,0,0,0,0,0,0,0,0,0,0,0,0,0
401311228,UCLA Bruins,D. Darius,4711802,,False,19.0,0,3,0,1,0,2,0,2,2,1,3,0,0,0,0,1,0
401311228,UCLA Bruins,TEAM,TOTAL,TOTAL,False,,26,61,22,44,4,17,13,17,17,26,43,11,5,3,8,18,69
401306533,New Mexico Lobos,S. McGruder,4400149,,True,30.0,3,10,3,8,0,2,1,2,6,9,15,1,2,1,3,3,7
401306533,New Mexico Lobos,A. Anderson,4281834,,True,28.0,5,14,3,6,2,8,1,2,2,7,9,2,0,1,0,2,13
401306533,New Mexico Lobos,Lato. Duff,4704520,,True,21.0,4,8,3,6,1,2,0,0,0,3,3,3,0,0,1,1,9
401306533,New Mexico Lobos,A. Hurst,4400147,,True,40.0,7,16,2,6,5,10,2,2,0,6,6,4,0,0,0,1,21
401306533,New Mexico Lobos,J. De La Cerda,4281833,,True,26.0,2,6,2,5,0,1,0,0,1,5,6,0,1,1,2,2,4
401306533,New Mexico Lobos,A. Watts,4433688,,False,12.0,1,6,1,3,0,3,0,0,2,1,3,0,0,0,2,2,2
401306533,New Mexico Lobos,Lata. Duff,4704519,,False,23.0,1,6,1,4,0,2,2,2,1,1,2,3,0,2,1,3,4
401306533,New Mexico Lobos,C. Carter,4433646,,False,20.0,3,5,1,3,2,2,3,4,0,1,1,2,1,0,0,0,11
401306533,New Mexico Lobos,TEAM,TOTAL,TOTAL,False,,26,71,16,41,10,30,9,12,13,36,49,15,4,5,9,14,71
401306533,New Mexico Lobos,S. McGruder,4400149,,True,30.0,3,10,3,8,0,2,1,2,6,9,15,1,2,1,3,3,7
401306533,New Mexico Lobos,A. Anderson,4281834,,True,28.0,5,14,3,6,2,8,1,2,2,7,9,2,0,1,0,2,13
401306533,New Mexico Lobos,Lato. Duff,4704520,,True,21.0,4,8,3,6,1,2,0,0,0,3,3,3,0,0,1,1,9
401306533,New Mexico Lobos,A. Hurst,4400147,,True,40.0,7,16,2,6,5,10,2,2,0,6,6,4,0,0,0,1,21
401306533,New Mexico Lobos,J. De La Cerda,4281833,,True,26.0,2,6,2,5,0,1,0,0,1,5,6,0,1,1,2,2,4
401306533,New Mexico Lobos,A. Watts,4433688,,False,12.0,1,6,1,3,0,3,0,0,2,1,3,0,0,0,2,2,2
401306533,New Mexico Lobos,Lata. Duff,4704519,,False,23.0,1,6,1,4,0,2,2,2,1,1,2,3,0,2,1,3,4
401306533,New Mexico Lobos,C. Carter,4433646,,False,20.0,3,5,1,3,2,2,3,4,0,1,1,2,1,0,0,0,11
401306533,New Mexico Lobos,TEAM,TOTAL,TOTAL,False,,26,71,16,41,10,30,9,12,13,36,49,15,4,5,9,14,71
401306533,Colorado State Rams,K. Murphy,4068969,,True,24.0,4,5,4,5,0,0,0,0,2,3,5,1,0,0,1,3,8
401306533,Colorado State Rams,E. Boni,4704462,,True,29.0,3,10,3,8,0,2,0,2,0,3,3,1,1,0,0,0,6
401306533,Colorado State Rams,M. Hofschild,4595160,,True,29.0,4,13,1,7,3,6,3,4,0,5,5,5,2,0,1,1,14
401306533,Colorado State Rams,L. Devos,4284002,,True,22.0,0,4,0,3,0,1,1,2,2,2,4,0,0,0,2,0,1
401306533,Colorado State Rams,T. Williams,4282176,,True,30.0,2,12,1,2,1,10,0,0,1,6,7,0,0,0,0,3,5
401306533,Colorado State Rams,C. Clark,4704464,,False,16.0,4,4,4,4,0,0,0,2,1,4,5,1,0,3,1,2,8
401306533,Colorado State Rams,J. Bonnarens,4400102,,False,19.0,5,8,3,5,2,3,2,2,1,5,6,2,0,0,2,2,14
401306533,Colorado State Rams,P. Farkas,4704463,,False,11.0,2,5,2,4,0,1,0,0,0,1,1,1,0,0,0,0,4
401306533,Colorado State Rams,B. Alper,4595629,,False,5.0,0,1,0,1,0,0,0,0,0,1,1,0,1,0,1,1,0
401306533,Colorado State Rams,S. Mech,4399658,,False,15.0,1,4,1,3,0,1,0,0,0,0,0,0,0,0,0,0,2
401306533,Colorado State Rams,TEAM,TOTAL,TOTAL,False,,25,66,19,42,6,24,6,12,7,33,40,11,4,3,8,12,62
401306533,Colorado State Rams,K. Murphy,4068969,,True,24.0,4,5,4,5,0,0,0,0,2,3,5,1,0,0,1,3,8
401306533,Colorado State Rams,E. Boni,4704462,,True,29.0,3,10,3,8,0,2,0,2,0,3,3,1,1,0,0,0,6
401306533,Colorado State Rams,M. Hofschild,4595160,,True,29.0,4,13,1,7,3,6,3,4,0,5,5,5,2,0,1,1,14
401306533,Colorado State Rams,L. Devos,4284002,,True,22.0,0,4,0,3,0,1,1,2,2,2,4,0,0,0,2,0,1
401306533,Colorado State Rams,T. Williams,4282176,,True,30.0,2,12,1,2,1,10,0,0,1,6,7,0,0,0,0,3,5
401306533,Colorado State Rams,C. Clark,4704464,,False,16.0,4,4,4,4,0,0,0,2,1,4,5,1,0,3,1,2,8
401306533,Colorado State Rams,J. Bonnarens,4400102,,False,19.0,5,8,3,5,2,3,2,2,1,5,6,2,0,0,2,2,14
401306533,Colorado State Rams,P. Farkas,4704463,,False,11.0,2,5,2,4,0,1,0,0,0,1,1,1,0,0,0,0,4
401306533,Colorado State Rams,B. Alper,4595629,,False,5.0,0,1,0,1,0,0,0,0,0,1,1,0,1,0,1,1,0
401306533,Colorado State Rams,S. Mech,4399658,,False,15.0,1,4,1,3,0,1,0,0,0,0,0,0,0,0,0,0,2
401306533,Colorado State Rams,TEAM,TOTAL,TOTAL,False,,25,66,19,42,6,24,6,12,7,33,40,11,4,3,8,12,62
401306513,New Mexico Lobos,S. McGruder,4400149,,True,27.0,6,10,5,6,1,4,3,3,2,7,9,0,0,1,2,3,16
401306513,New Mexico Lobos,A. Anderson,4281834,,True,35.0,3,15,1,4,2,11,2,2,1,10,11,3,1,1,3,3,10
401306513,New Mexico Lobos,Lato. Duff,4704520,,True,31.0,5,7,3,3,2,4,0,0,0,4,4,2,1,0,2,2,12
401306513,New Mexico Lobos,A. Hurst,4400147,,True,35.0,4,8,0,2,4,6,1,2,0,3,3,1,2,0,2,0,13
401306513,New Mexico Lobos,J. De La Cerda,4281833,,True,26.0,4,12,3,10,1,2,4,5,0,4,4,4,0,0,2,1,13
401306513,New Mexico Lobos,C. Dupont,4595646,,False,1.0,0,0,0,0,0,0,0,0,0,0,0,0,0,0,0,0,0
401306513,New Mexico Lobos,A. Watts,4433688,,False,12.0,1,3,1,1,0,2,0,0,0,3,3,0,0,0,0,4,2
401306513,New Mexico Lobos,A. Robinson,4432993,,False,1.0,1,1,1,1,0,0,0,0,0,0,0,0,0,0,0,0,2
401306513,New Mexico Lobos,K. van Bennekom,4704522,,False,1.0,0,0,0,0,0,0,0,0,0,0,0,0,0,0,0,0,0
401306513,New Mexico Lobos,Lata. Duff,4704519,,False,22.0,0,5,0,2,0,3,0,0,0,3,3,3,2,0,1,2,0
401306513,New Mexico Lobos,C. Carter,4433646,,False,9.0,0,2,0,0,0,2,0,0,0,3,3,2,0,0,0,3,0
401306513,New Mexico Lobos,TEAM,TOTAL,TOTAL,False,,24,63,14,29,10,34,10,12,5,41,46,15,6,2,12,18,68
401306513,New Mexico Lobos,S. McGruder,4400149,,True,27.0,6,10,5,6,1,4,3,3,2,7,9,0,0,1,2,3,16
401306513,New Mexico Lobos,A. Anderson,4281834,,True,35.0,3,15,1,4,2,11,2,2,1,10,11,3,1,1,3,3,10
401306513,New Mexico Lobos,Lato. Duff,4704520,,True,31.0,5,7,3,3,2,4,0,0,0,4,4,2,1,0,2,2,12
401306513,New Mexico Lobos,A. Hurst,4400147,,True,35.0,4,8,0,2,4,6,1,2,0,3,3,1,2,0,2,0,13
401306513,New Mexico Lobos,J. De La Cerda,4281833,,True,26.0,4,12,3,10,1,2,4,5,0,4,4,4,0,0,2,1,13
401306513,New Mexico Lobos,C. Dupont,4595646,,False,1.0,0,0,0,0,0,0,0,0,0,0,0,0,0,0,0,0,0
401306513,New Mexico Lobos,A. Watts,4433688,,False,12.0,1,3,1,1,0,2,0,0,0,3,3,0,0,0,0,4,2
401306513,New Mexico Lobos,A. Robinson,4432993,,False,1.0,1,1,1,1,0,0,0,0,0,0,0,0,0,0,0,0,2
401306513,New Mexico Lobos,K. van Bennekom,4704522,,False,1.0,0,0,0,0,0,0,0,0,0,0,0,0,0,0,0,0,0
401306513,New Mexico Lobos,Lata. Duff,4704519,,False,22.0,0,5,0,2,0,3,0,0,0,3,3,3,2,0,1,2,0
401306513,New Mexico Lobos,C. Carter,4433646,,False,9.0,0,2,0,0,0,2,0,0,0,3,3,2,0,0,0,3,0
401306513,New Mexico Lobos,TEAM,TOTAL,TOTAL,False,,24,63,14,29,10,34,10,12,5,41,46,15,6,2,12,18,68
401306513,Colorado State Rams,K. Murphy,4068969,,True,28.0,3,8,3,8,0,0,3,4,5,4,9,0,1,1,2,2,9
401306513,Colorado State Rams,E. Boni,4704462,,True,29.0,3,7,3,6,0,1,2,2,0,3,3,0,0,1,1,1,8
401306513,Colorado State Rams,M. Hofschild,4595160,,True,28.0,4,11,4,9,0,2,4,6,0,2,2,3,1,0,2,0,12
401306513,Colorado State Rams,L. Devos,4284002,,True,19.0,1,7,1,5,0,2,0,0,0,6,6,4,0,1,1,0,2
401306513,Colorado State Rams,T. Williams,4282176,,True,36.0,2,12,0,0,2,12,0,0,0,10,10,0,2,0,0,1,6
401306513,Colorado State Rams,C. Clark,4704464,,False,9.0,0,2,0,2,0,0,2,2,2,1,3,1,0,0,1,2,2
401306513,Colorado State Rams,J. Bonnarens,4400102,,False,16.0,2,12,1,8,1,4,0,0,1,2,3,0,0,0,0,0,5
401306513,Colorado State Rams,P. Farkas,4704463,,False,10.0,3,5,2,3,1,2,0,0,0,3,3,0,0,0,1,1,7
401306513,Colorado State Rams,B. Alper,4595629,,False,3.0,1,1,1,1,0,0,0,0,0,0,0,0,0,0,0,0,2
401306513,Colorado State Rams,S. Mech,4399658,,False,22.0,1,2,1,2,0,0,0,1,1,1,2,1,0,0,0,2,2
401306513,Colorado State Rams,TEAM,TOTAL,TOTAL,False,,20,67,16,44,4,23,11,15,9,35,44,9,4,3,9,9,55
401306513,Colorado State Rams,K. Murphy,4068969,,True,28.0,3,8,3,8,0,0,3,4,5,4,9,0,1,1,2,2,9
401306513,Colorado State Rams,E. Boni,4704462,,True,29.0,3,7,3,6,0,1,2,2,0,3,3,0,0,1,1,1,8
401306513,Colorado State Rams,M. Hofschild,4595160,,True,28.0,4,11,4,9,0,2,4,6,0,2,2,3,1,0,2,0,12
401306513,Colorado State Rams,L. Devos,4284002,,True,19.0,1,7,1,5,0,2,0,0,0,6,6,4,0,1,1,0,2
401306513,Colorado State Rams,T. Williams,4282176,,True,36.0,2,12,0,0,2,12,0,0,0,10,10,0,2,0,0,1,6
401306513,Colorado State Rams,C. Clark,4704464,,False,9.0,0,2,0,2,0,0,2,2,2,1,3,1,0,0,1,2,2
401306513,Colorado State Rams,J. Bonnarens,4400102,,False,16.0,2,12,1,8,1,4,0,0,1,2,3,0,0,0,0,0,5
401306513,Colorado State Rams,P. Farkas,4704463,,False,10.0,3,5,2,3,1,2,0,0,0,3,3,0,0,0,1,1,7
401306513,Colorado State Rams,B. Alper,4595629,,False,3.0,1,1,1,1,0,0,0,0,0,0,0,0,0,0,0,0,2
401306513,Colorado State Rams,S. Mech,4399658,,False,22.0,1,2,1,2,0,0,0,1,1,1,2,1,0,0,0,2,2
401306513,Colorado State Rams,TEAM,TOTAL,TOTAL,False,,20,67,16,44,4,23,11,15,9,35,44,9,4,3,9,9,55
401306493,Nevada Wolf Pack,M. Ormiston,4400072,,True,27.0,6,11,5,10,1,1,1,2,4,2,6,1,3,1,1,2,14
401306493,Nevada Wolf Pack,L. Johnson,4595634,,True,30.0,2,6,2,6,0,0,0,0,1,1,2,1,1,0,3,2,4
401306493,Nevada Wolf Pack,A. West,4400134,,True,27.0,2,6,0,3,2,3,5,6,0,3,3,0,1,0,4,1,11
401306493,Nevada Wolf Pack,D. Hamilton,4400132,,True,30.0,7,17,4,11,3,6,0,0,0,9,9,3,1,0,4,2,17
401306493,Nevada Wolf Pack,N. Alexander,4068433,,True,28.0,6,11,6,9,0,2,2,2,5,2,7,1,2,0,1,2,14
401306493,Nevada Wolf Pack,L. Otuafi,4704508,,False,15.0,3,7,2,6,1,1,0,0,4,0,4,1,0,0,1,4,7
401306493,Nevada Wolf Pack,L. Givens,4704506,,False,14.0,1,2,1,2,0,0,0,0,3,1,4,0,0,0,0,0,2
401306493,Nevada Wolf Pack,D. Phillips,4595638,,False,6.0,0,0,0,0,0,0,0,0,0,3,3,0,1,0,1,1,0
401306493,Nevada Wolf Pack,G. Rones,4704505,,False,8.0,0,1,0,1,0,0,0,0,0,1,1,0,0,0,0,1,0
401306493,Nevada Wolf Pack,K. Holt,4704503,,False,15.0,0,2,0,2,0,0,0,0,1,1,2,0,1,0,3,3,0
401306493,Nevada Wolf Pack,TEAM,TOTAL,TOTAL,False,,27,63,20,50,7,13,8,10,22,25,47,7,10,1,18,18,69
401306493,Nevada Wolf Pack,M. Ormiston,4400072,,True,27.0,6,11,5,10,1,1,1,2,4,2,6,1,3,1,1,2,14
401306493,Nevada Wolf Pack,L. Johnson,4595634,,True,30.0,2,6,2,6,0,0,0,0,1,1,2,1,1,0,3,2,4
401306493,Nevada Wolf Pack,A. West,4400134,,True,27.0,2,6,0,3,2,3,5,6,0,3,3,0,1,0,4,1,11
401306493,Nevada Wolf Pack,D. Hamilton,4400132,,True,30.0,7,17,4,11,3,6,0,0,0,9,9,3,1,0,4,2,17
401306493,Nevada Wolf Pack,N. Alexander,4068433,,True,28.0,6,11,6,9,0,2,2,2,5,2,7,1,2,0,1,2,14
401306493,Nevada Wolf Pack,L. Otuafi,4704508,,False,15.0,3,7,2,6,1,1,0,0,4,0,4,1,0,0,1,4,7
401306493,Nevada Wolf Pack,L. Givens,4704506,,False,14.0,1,2,1,2,0,0,0,0,3,1,4,0,0,0,0,0,2
401306493,Nevada Wolf Pack,D. Phillips,4595638,,False,6.0,0,0,0,0,0,0,0,0,0,3,3,0,1,0,1,1,0
401306493,Nevada Wolf Pack,G. Rones,4704505,,False,8.0,0,1,0,1,0,0,0,0,0,1,1,0,0,0,0,1,0
401306493,Nevada Wolf Pack,K. Holt,4704503,,False,15.0,0,2,0,2,0,0,0,0,1,1,2,0,1,0,3,3,0
401306493,Nevada Wolf Pack,TEAM,TOTAL,TOTAL,False,,27,63,20,50,7,13,8,10,22,25,47,7,10,1,18,18,69
401306493,Air Force Falcons,R. Snyder,4399409,,True,33.0,7,21,5,16,2,5,0,0,1,2,3,1,0,1,3,3,16
401306493,Air Force Falcons,K. Huffman,4068225,,True,24.0,2,4,2,4,0,0,0,0,2,1,3,2,1,2,1,0,4
401306493,Air Force Falcons,B. Autrey-Thompson,4399404,,True,33.0,4,9,4,8,0,1,6,6,1,1,2,6,3,0,6,3,14
401306493,Air Force Falcons,K. Immel,4281743,,True,31.0,4,12,2,8,2,4,2,4,1,2,3,2,0,0,1,0,12
401306493,Air Force Falcons,E. Conroe,4281737,,True,19.0,2,2,2,2,0,0,0,0,3,1,4,1,0,0,1,3,4
401306493,Air Force Falcons,K. Jones,4704416,,False,8.0,2,4,2,4,0,0,0,0,1,0,1,0,0,1,0,0,4
401306493,Air Force Falcons,D. MacMillan,4704414,,False,12.0,0,1,0,0,0,1,0,0,0,1,1,0,1,0,1,1,0
401306493,Air Force Falcons,N. McDonald,4595618,,False,9.0,0,2,0,1,0,1,0,0,0,1,1,0,0,0,0,0,0
401306493,Air Force Falcons,K. Pilson,4704411,,False,23.0,2,4,2,3,0,1,0,2,4,3,7,0,1,0,2,3,4
401306493,Air Force Falcons,K. Heath,4595614,,False,6.0,0,0,0,0,0,0,0,0,0,0,0,0,0,0,0,0,0
401306493,Air Force Falcons,C. Winters,4399406,,False,2.0,0,0,0,0,0,0,0,0,0,1,1,0,0,0,0,0,0
401306493,Air Force Falcons,TEAM,TOTAL,TOTAL,False,,23,59,19,46,4,13,8,12,13,14,27,12,6,4,15,13,58
401306493,Air Force Falcons,R. Snyder,4399409,,True,33.0,7,21,5,16,2,5,0,0,1,2,3,1,0,1,3,3,16
401306493,Air Force Falcons,K. Huffman,4068225,,True,24.0,2,4,2,4,0,0,0,0,2,1,3,2,1,2,1,0,4
401306493,Air Force Falcons,B. Autrey-Thompson,4399404,,True,33.0,4,9,4,8,0,1,6,6,1,1,2,6,3,0,6,3,14
401306493,Air Force Falcons,K. Immel,4281743,,True,31.0,4,12,2,8,2,4,2,4,1,2,3,2,0,0,1,0,12
401306493,Air Force Falcons,E. Conroe,4281737,,True,19.0,2,2,2,2,0,0,0,0,3,1,4,1,0,0,1,3,4
401306493,Air Force Falcons,K. Jones,4704416,,False,8.0,2,4,2,4,0,0,0,0,1,0,1,0,0,1,0,0,4
401306493,Air Force Falcons,D. MacMillan,4704414,,False,12.0,0,1,0,0,0,1,0,0,0,1,1,0,1,0,1,1,0
401306493,Air Force Falcons,N. McDonald,4595618,,False,9.0,0,2,0,1,0,1,0,0,0,1,1,0,0,0,0,0,0
401306493,Air Force Falcons,K. Pilson,4704411,,False,23.0,2,4,2,3,0,1,0,2,4,3,7,0,1,0,2,3,4
401306493,Air Force Falcons,K. Heath,4595614,,False,6.0,0,0,0,0,0,0,0,0,0,0,0,0,0,0,0,0,0
401306493,Air Force Falcons,C. Winters,4399406,,False,2.0,0,0,0,0,0,0,0,0,0,1,1,0,0,0,0,0,0
401306493,Air Force Falcons,TEAM,TOTAL,TOTAL,False,,23,59,19,46,4,13,8,12,13,14,27,12,6,4,15,13,58
401306473,Nevada Wolf Pack,M. Ormiston,4400072,,True,25.0,5,7,5,7,0,0,0,1,1,2,3,0,1,0,3,2,10
401306473,Nevada Wolf Pack,L. Johnson,4595634,,True,22.0,0,2,0,2,0,0,1,2,0,4,4,1,1,0,3,0,1
401306473,Nevada Wolf Pack,A. West,4400134,,True,35.0,3,8,3,7,0,1,2,2,0,3,3,1,1,1,1,4,8
401306473,Nevada Wolf Pack,D. Hamilton,4400132,,True,33.0,5,9,5,7,0,2,2,2,0,3,3,1,0,0,7,1,12
401306473,Nevada Wolf Pack,N. Alexander,4068433,,True,29.0,9,13,8,10,1,3,1,1,1,1,2,2,3,1,0,3,20
401306473,Nevada Wolf Pack,L. Otuafi,4704508,,False,18.0,0,5,0,4,0,1,1,2,1,2,3,0,0,0,2,1,1
401306473,Nevada Wolf Pack,L. Givens,4704506,,False,7.0,0,0,0,0,0,0,0,0,0,1,1,0,0,0,0,1,0
401306473,Nevada Wolf Pack,D. Phillips,4595638,,False,8.0,1,2,1,2,0,0,0,0,1,1,2,0,0,0,4,3,2
401306473,Nevada Wolf Pack,G. Rones,4704505,,False,2.0,0,0,0,0,0,0,0,0,0,0,0,0,0,0,0,0,0
401306473,Nevada Wolf Pack,K. Holt,4704503,,False,21.0,1,2,1,2,0,0,3,4,1,3,4,2,2,0,1,3,5
401306473,Nevada Wolf Pack,TEAM,TOTAL,TOTAL,False,,24,48,23,41,1,7,10,14,5,23,28,7,8,2,21,18,59
401306473,Nevada Wolf Pack,M. Ormiston,4400072,,True,25.0,5,7,5,7,0,0,0,1,1,2,3,0,1,0,3,2,10
401306473,Nevada Wolf Pack,L. Johnson,4595634,,True,22.0,0,2,0,2,0,0,1,2,0,4,4,1,1,0,3,0,1
401306473,Nevada Wolf Pack,A. West,4400134,,True,35.0,3,8,3,7,0,1,2,2,0,3,3,1,1,1,1,4,8
401306473,Nevada Wolf Pack,D. Hamilton,4400132,,True,33.0,5,9,5,7,0,2,2,2,0,3,3,1,0,0,7,1,12
401306473,Nevada Wolf Pack,N. Alexander,4068433,,True,29.0,9,13,8,10,1,3,1,1,1,1,2,2,3,1,0,3,20
401306473,Nevada Wolf Pack,L. Otuafi,4704508,,False,18.0,0,5,0,4,0,1,1,2,1,2,3,0,0,0,2,1,1
401306473,Nevada Wolf Pack,L. Givens,4704506,,False,7.0,0,0,0,0,0,0,0,0,0,1,1,0,0,0,0,1,0
401306473,Nevada Wolf Pack,D. Phillips,4595638,,False,8.0,1,2,1,2,0,0,0,0,1,1,2,0,0,0,4,3,2
401306473,Nevada Wolf Pack,G. Rones,4704505,,False,2.0,0,0,0,0,0,0,0,0,0,0,0,0,0,0,0,0,0
401306473,Nevada Wolf Pack,K. Holt,4704503,,False,21.0,1,2,1,2,0,0,3,4,1,3,4,2,2,0,1,3,5
401306473,Nevada Wolf Pack,TEAM,TOTAL,TOTAL,False,,24,48,23,41,1,7,10,14,5,23,28,7,8,2,21,18,59
401306473,Air Force Falcons,R. Snyder,4399409,,True,31.0,9,18,7,13,2,5,0,0,2,2,4,1,1,0,2,2,20
401306473,Air Force Falcons,K. Huffman,4068225,,True,17.0,0,0,0,0,0,0,1,2,2,2,4,1,0,0,1,4,1
401306473,Air Force Falcons,B. Autrey-Thompson,4399404,,True,28.0,4,9,4,9,0,0,6,6,0,1,1,3,1,0,3,3,14
401306473,Air Force Falcons,K. Immel,4281743,,True,31.0,4,12,4,9,0,3,0,1,0,4,4,0,1,0,5,1,8
401306473,Air Force Falcons,E. Conroe,4281737,,True,24.0,0,4,0,4,0,0,4,4,6,2,8,2,3,0,2,1,4
401306473,Air Force Falcons,D. MacMillan,4704414,,False,12.0,1,3,0,2,1,1,0,0,0,1,1,0,0,0,0,1,3
401306473,Air Force Falcons,N. McDonald,4595618,,False,23.0,1,2,1,1,0,1,0,0,1,4,5,0,2,0,1,3,2
401306473,Air Force Falcons,K. Pilson,4704411,,False,15.0,1,2,1,2,0,0,0,0,0,3,3,1,1,0,1,0,2
401306473,Air Force Falcons,K. Heath,4595614,,False,9.0,1,4,1,4,0,0,0,0,1,0,1,0,1,0,0,1,2
401306473,Air Force Falcons,C. Winters,4399406,,False,10.0,0,3,0,2,0,1,0,0,1,0,1,0,1,0,2,1,0
401306473,Air Force Falcons,TEAM,TOTAL,TOTAL,False,,21,57,18,46,3,11,11,13,15,22,37,8,11,0,20,17,56
401306473,Air Force Falcons,R. Snyder,4399409,,True,31.0,9,18,7,13,2,5,0,0,2,2,4,1,1,0,2,2,20
401306473,Air Force Falcons,K. Huffman,4068225,,True,17.0,0,0,0,0,0,0,1,2,2,2,4,1,0,0,1,4,1
401306473,Air Force Falcons,B. Autrey-Thompson,4399404,,True,28.0,4,9,4,9,0,0,6,6,0,1,1,3,1,0,3,3,14
401306473,Air Force Falcons,K. Immel,4281743,,True,31.0,4,12,4,9,0,3,0,1,0,4,4,0,1,0,5,1,8
401306473,Air Force Falcons,E. Conroe,4281737,,True,24.0,0,4,0,4,0,0,4,4,6,2,8,2,3,0,2,1,4
401306473,Air Force Falcons,D. MacMillan,4704414,,False,12.0,1,3,0,2,1,1,0,0,0,1,1,0,0,0,0,1,3
401306473,Air Force Falcons,N. McDonald,4595618,,False,23.0,1,2,1,1,0,1,0,0,1,4,5,0,2,0,1,3,2
401306473,Air Force Falcons,K. Pilson,4704411,,False,15.0,1,2,1,2,0,0,0,0,0,3,3,1,1,0,1,0,2
401306473,Air Force Falcons,K. Heath,4595614,,False,9.0,1,4,1,4,0,0,0,0,1,0,1,0,1,0,0,1,2
401306473,Air Force Falcons,C. Winters,4399406,,False,10.0,0,3,0,2,0,1,0,0,1,0,1,0,1,0,2,1,0
401306473,Air Force Falcons,TEAM,TOTAL,TOTAL,False,,21,57,18,46,3,11,11,13,15,22,37,8,11,0,20,17,56
401299333,Colorado Christian Cougars,B. Hurlbut,4598874,,True,32.0,5,9,5,9,0,0,2,2,3,3,6,0,0,1,5,1,12
401299333,Colorado Christian Cougars,M. VandenBrink,4598873,,True,15.0,1,2,1,2,0,0,0,2,0,1,1,0,1,0,2,1,2
401299333,Colorado Christian Cougars,L. Gonzalez,4598872,,True,26.0,0,4,0,4,0,0,0,2,0,2,2,0,1,1,1,0,0
401299333,Colorado Christian Cougars,S. Nunez,4598871,,True,30.0,3,10,1,4,2,6,2,2,0,3,3,2,2,1,2,0,10
401299333,Colorado Christian Cougars,O. Christy,4598869,,True,20.0,0,4,0,3,0,1,0,0,0,1,1,1,0,0,5,2,0
401299333,Colorado Christian Cougars,G. Field,4718734,,False,4.0,0,0,0,0,0,0,0,0,0,0,0,0,0,0,1,0,0
401299333,Colorado Christian Cougars,B. Gumber,4706712,,False,18.0,1,3,1,3,0,0,0,0,0,1,1,0,0,0,0,1,2
401299333,Colorado Christian Cougars,C. Curry,4706710,,False,12.0,0,2,0,2,0,0,0,0,0,1,1,1,1,0,2,1,0
401299333,Colorado Christian Cougars,D. Morgan,4706709,,False,8.0,0,3,0,2,0,1,2,2,0,0,0,0,1,0,1,1,2
401299333,Colorado Christian Cougars,M. Walker,4598879,,False,17.0,0,0,0,0,0,0,4,4,0,1,1,0,0,0,5,0,4
401299333,Colorado Christian Cougars,M. Kemmer,4293452,,False,18.0,0,2,0,1,0,1,0,0,0,5,5,0,2,0,1,0,0
401299333,Colorado Christian Cougars,TEAM,TOTAL,TOTAL,False,,10,39,8,30,2,9,10,14,4,22,26,4,8,3,25,7,32
401299333,Air Force Falcons,K. Huffman,4068225,,True,20.0,3,3,3,3,0,0,2,2,1,3,4,1,0,0,5,3,8
401299333,Air Force Falcons,C. Winters,4399406,,True,24.0,4,7,4,6,0,1,0,0,0,2,2,2,5,0,1,2,8
401299333,Air Force Falcons,B. Autrey-Thompson,4399404,,True,20.0,1,6,1,6,0,0,1,2,0,3,3,1,3,0,3,0,3
401299333,Air Force Falcons,K. Immel,4281743,,True,22.0,4,12,3,8,1,4,0,0,0,2,2,3,2,0,2,1,9
401299333,Air Force Falcons,E. Conroe,4281737,,True,25.0,2,7,2,6,0,1,0,0,3,3,6,1,3,0,2,1,4
401299333,Air Force Falcons,K. Jones,4704416,,False,4.0,1,3,1,3,0,0,0,0,0,2,2,0,0,0,0,0,2
401299333,Air Force Falcons,D. MacMillan,4704414,,False,12.0,0,4,0,0,0,4,0,0,0,2,2,2,0,0,0,3,0
401299333,Air Force Falcons,N. McDonald,4595618,,False,17.0,3,5,1,2,2,3,0,0,0,1,1,1,1,0,0,0,8
401299333,Air Force Falcons,S. Thomas,4704413,,False,3.0,1,2,1,1,0,1,0,0,0,0,0,0,0,0,1,0,2
401299333,Air Force Falcons,K. Pilson,4704411,,False,21.0,1,4,1,4,0,0,0,0,2,4,6,1,3,0,0,2,2
401299333,Air Force Falcons,J. Goodwin,4704410,,False,3.0,0,0,0,0,0,0,0,0,0,0,0,0,0,0,0,0,0
401299333,Air Force Falcons,K. Heath,4595614,,False,16.0,5,7,5,7,0,0,0,0,2,2,4,0,0,0,0,1,10
401299333,Air Force Falcons,A. Gadison,4399405,,False,13.0,1,2,0,0,1,2,0,0,0,0,0,2,0,0,1,0,3
401299333,Air Force Falcons,TEAM,TOTAL,TOTAL,False,,26,62,22,46,4,16,3,4,10,27,37,14,17,0,17,13,59
401287031,Wyoming Cowgirls,D. Davidsdottir,4068870,,True,22.0,3,7,3,7,0,0,1,2,2,3,5,1,1,1,1,0,7
401287031,Wyoming Cowgirls,J. Johnson,4595683,,True,21.0,2,3,1,2,1,1,0,0,0,1,1,1,0,0,2,1,5
401287031,Wyoming Cowgirls,Q. Weidemann,4400207,,True,37.0,4,9,0,2,4,7,2,2,0,4,4,4,0,0,4,1,14
401287031,Wyoming Cowgirls,A. Sanchez Ramos,4400204,,True,33.0,4,11,4,8,0,3,0,0,1,6,7,4,1,1,2,2,8
401287031,Wyoming Cowgirls,T. Olson,4400203,,True,38.0,1,4,0,1,1,3,0,0,4,2,6,4,1,0,3,4,3
401287031,Wyoming Cowgirls,G. Ellis,4704657,,False,18.0,3,5,3,4,0,1,3,5,1,4,5,0,0,0,0,2,9
401287031,Wyoming Cowgirls,O. Ustowska,4704662,,False,5.0,0,2,0,0,0,2,0,0,0,1,1,1,1,0,0,1,0
401287031,Wyoming Cowgirls,M. Bradshaw,4595681,,False,26.0,4,12,1,5,3,7,2,2,1,7,8,1,0,0,2,0,13
401287031,Wyoming Cowgirls,TEAM,TOTAL,TOTAL,False,,21,53,12,29,9,24,8,11,10,32,42,16,4,2,15,11,59
401287031,Wyoming Cowgirls,D. Davidsdottir,4068870,,True,22.0,3,7,3,7,0,0,1,2,2,3,5,1,1,1,1,0,7
401287031,Wyoming Cowgirls,J. Johnson,4595683,,True,21.0,2,3,1,2,1,1,0,0,0,1,1,1,0,0,2,1,5
401287031,Wyoming Cowgirls,Q. Weidemann,4400207,,True,37.0,4,9,0,2,4,7,2,2,0,4,4,4,0,0,4,1,14
401287031,Wyoming Cowgirls,A. Sanchez Ramos,4400204,,True,33.0,4,11,4,8,0,3,0,0,1,6,7,4,1,1,2,2,8
401287031,Wyoming Cowgirls,T. Olson,4400203,,True,38.0,1,4,0,1,1,3,0,0,4,2,6,4,1,0,3,4,3
401287031,Wyoming Cowgirls,G. Ellis,4704657,,False,18.0,3,5,3,4,0,1,3,5,1,4,5,0,0,0,0,2,9
401287031,Wyoming Cowgirls,O. Ustowska,4704662,,False,5.0,0,2,0,0,0,2,0,0,0,1,1,1,1,0,0,1,0
401287031,Wyoming Cowgirls,M. Bradshaw,4595681,,False,26.0,4,12,1,5,3,7,2,2,1,7,8,1,0,0,2,0,13
401287031,Wyoming Cowgirls,TEAM,TOTAL,TOTAL,False,,21,53,12,29,9,24,8,11,10,32,42,16,4,2,15,11,59
401287031,Fresno State Bulldogs,W. Motta,4595631,,True,24.0,4,8,4,8,0,0,2,2,2,3,5,0,0,0,1,3,10
401287031,Fresno State Bulldogs,M. Utti,4281828,,True,40.0,3,10,2,9,1,1,0,0,3,6,9,2,0,1,0,2,7
401287031,Fresno State Bulldogs,Hal. Cavinder,4433658,,True,38.0,5,16,5,11,0,5,2,2,0,3,3,2,0,1,5,1,12
401287031,Fresno State Bulldogs,Han. Cavinder,4433372,,True,38.0,6,15,6,14,0,1,0,0,1,4,5,3,2,1,0,0,12
401287031,Fresno State Bulldogs,A. Gamez,4281826,,True,31.0,5,9,2,4,3,5,2,2,0,3,3,0,3,0,1,4,15
401287031,Fresno State Bulldogs,K. Kinzer,4595630,,False,5.0,0,2,0,0,0,2,0,0,0,1,1,0,0,0,0,0,0
401287031,Fresno State Bulldogs,B. Walling,4595632,,False,16.0,0,1,0,1,0,0,0,0,0,1,1,0,0,3,0,0,0
401287031,Fresno State Bulldogs,B. Delaney,4281825,,False,8.0,0,2,0,1,0,1,0,0,1,1,2,0,0,0,0,3,0
401287031,Fresno State Bulldogs,TEAM,TOTAL,TOTAL,False,,23,63,19,48,4,15,6,6,8,24,32,7,5,6,7,13,56
401287031,Fresno State Bulldogs,W. Motta,4595631,,True,24.0,4,8,4,8,0,0,2,2,2,3,5,0,0,0,1,3,10
401287031,Fresno State Bulldogs,M. Utti,4281828,,True,40.0,3,10,2,9,1,1,0,0,3,6,9,2,0,1,0,2,7
401287031,Fresno State Bulldogs,Hal. Cavinder,4433658,,True,38.0,5,16,5,11,0,5,2,2,0,3,3,2,0,1,5,1,12
401287031,Fresno State Bulldogs,Han. Cavinder,4433372,,True,38.0,6,15,6,14,0,1,0,0,1,4,5,3,2,1,0,0,12
401287031,Fresno State Bulldogs,A. Gamez,4281826,,True,31.0,5,9,2,4,3,5,2,2,0,3,3,0,3,0,1,4,15
401287031,Fresno State Bulldogs,K. Kinzer,4595630,,False,5.0,0,2,0,0,0,2,0,0,0,1,1,0,0,0,0,0,0
401287031,Fresno State Bulldogs,B. Walling,4595632,,False,16.0,0,1,0,1,0,0,0,0,0,1,1,0,0,3,0,0,0
401287031,Fresno State Bulldogs,B. Delaney,4281825,,False,8.0,0,2,0,1,0,1,0,0,1,1,2,0,0,0,0,3,0
401287031,Fresno State Bulldogs,TEAM,TOTAL,TOTAL,False,,23,63,19,48,4,15,6,6,8,24,32,7,5,6,7,13,56
401287030,New Mexico Lobos,S. McGruder,4400149,,True,23.0,6,10,6,10,0,0,1,2,4,5,9,1,0,1,2,2,13
401287030,New Mexico Lobos,A. Anderson,4281834,,True,29.0,7,19,6,16,1,3,0,0,4,3,7,5,2,1,0,5,15
401287030,New Mexico Lobos,Lato. Duff,4704520,,True,37.0,0,6,0,0,0,6,1,2,0,6,6,8,3,0,2,2,1
401287030,New Mexico Lobos,A. Hurst,4400147,,True,38.0,3,9,1,3,2,6,0,0,0,7,7,2,5,1,3,3,8
401287030,New Mexico Lobos,J. De La Cerda,4281833,,True,26.0,8,13,3,4,5,9,2,2,2,1,3,1,0,0,3,4,23
401287030,New Mexico Lobos,A. Watts,4433688,,False,17.0,0,3,0,3,0,0,0,0,2,1,3,1,1,0,1,3,0
401287030,New Mexico Lobos,Lata. Duff,4704519,,False,24.0,4,9,2,4,2,5,0,0,0,0,0,1,0,0,3,1,10
401287030,New Mexico Lobos,C. Carter,4433646,,False,6.0,1,4,1,1,0,3,0,0,0,0,0,0,0,0,0,0,2
401287030,New Mexico Lobos,TEAM,TOTAL,TOTAL,False,,29,73,19,41,10,32,4,6,14,24,38,19,11,3,14,20,72
401287030,New Mexico Lobos,S. McGruder,4400149,,True,23.0,6,10,6,10,0,0,1,2,4,5,9,1,0,1,2,2,13
401287030,New Mexico Lobos,A. Anderson,4281834,,True,29.0,7,19,6,16,1,3,0,0,4,3,7,5,2,1,0,5,15
401287030,New Mexico Lobos,Lato. Duff,4704520,,True,37.0,0,6,0,0,0,6,1,2,0,6,6,8,3,0,2,2,1
401287030,New Mexico Lobos,A. Hurst,4400147,,True,38.0,3,9,1,3,2,6,0,0,0,7,7,2,5,1,3,3,8
401287030,New Mexico Lobos,J. De La Cerda,4281833,,True,26.0,8,13,3,4,5,9,2,2,2,1,3,1,0,0,3,4,23
401287030,New Mexico Lobos,A. Watts,4433688,,False,17.0,0,3,0,3,0,0,0,0,2,1,3,1,1,0,1,3,0
401287030,New Mexico Lobos,Lata. Duff,4704519,,False,24.0,4,9,2,4,2,5,0,0,0,0,0,1,0,0,3,1,10
401287030,New Mexico Lobos,C. Carter,4433646,,False,6.0,1,4,1,1,0,3,0,0,0,0,0,0,0,0,0,0,2
401287030,New Mexico Lobos,TEAM,TOTAL,TOTAL,False,,29,73,19,41,10,32,4,6,14,24,38,19,11,3,14,20,72
401287030,Fresno State Bulldogs,W. Motta,4595631,,True,15.0,3,5,3,5,0,0,2,2,2,1,3,0,0,0,1,3,8
401287030,Fresno State Bulldogs,M. Utti,4281828,,True,40.0,7,15,6,11,1,4,2,4,3,9,12,2,3,0,2,2,17
401287030,Fresno State Bulldogs,Hal. Cavinder,4433658,,True,38.0,8,21,5,13,3,8,3,3,4,3,7,4,2,1,3,2,22
401287030,Fresno State Bulldogs,Han. Cavinder,4433372,,True,33.0,6,14,6,10,0,4,1,4,3,2,5,7,4,0,6,2,13
401287030,Fresno State Bulldogs,A. Gamez,4281826,,True,35.0,4,8,2,5,2,3,4,5,1,7,8,3,0,0,2,0,14
401287030,Fresno State Bulldogs,K. Kinzer,4595630,,False,7.0,0,0,0,0,0,0,0,0,0,0,0,0,0,0,1,0,0
401287030,Fresno State Bulldogs,B. Walling,4595632,,False,13.0,1,1,1,1,0,0,1,2,3,4,7,0,0,2,2,0,3
401287030,Fresno State Bulldogs,B. Delaney,4281825,,False,19.0,0,2,0,1,0,1,0,0,0,2,2,2,0,0,0,1,0
401287030,Fresno State Bulldogs,TEAM,TOTAL,TOTAL,False,,29,66,23,46,6,20,13,20,18,31,49,18,9,3,17,10,77
401287030,Fresno State Bulldogs,W. Motta,4595631,,True,15.0,3,5,3,5,0,0,2,2,2,1,3,0,0,0,1,3,8
401287030,Fresno State Bulldogs,M. Utti,4281828,,True,40.0,7,15,6,11,1,4,2,4,3,9,12,2,3,0,2,2,17
401287030,Fresno State Bulldogs,Hal. Cavinder,4433658,,True,38.0,8,21,5,13,3,8,3,3,4,3,7,4,2,1,3,2,22
401287030,Fresno State Bulldogs,Han. Cavinder,4433372,,True,33.0,6,14,6,10,0,4,1,4,3,2,5,7,4,0,6,2,13
401287030,Fresno State Bulldogs,A. Gamez,4281826,,True,35.0,4,8,2,5,2,3,4,5,1,7,8,3,0,0,2,0,14
401287030,Fresno State Bulldogs,K. Kinzer,4595630,,False,7.0,0,0,0,0,0,0,0,0,0,0,0,0,0,0,1,0,0
401287030,Fresno State Bulldogs,B. Walling,4595632,,False,13.0,1,1,1,1,0,0,1,2,3,4,7,0,0,2,2,0,3
401287030,Fresno State Bulldogs,B. Delaney,4281825,,False,19.0,0,2,0,1,0,1,0,0,0,2,2,2,0,0,0,1,0
401287030,Fresno State Bulldogs,TEAM,TOTAL,TOTAL,False,,29,66,23,46,6,20,13,20,18,31,49,18,9,3,17,10,77
401287029,Wyoming Cowgirls,D. Davidsdottir,4068870,,True,32.0,7,10,7,10,0,0,1,2,0,4,4,2,1,0,2,2,15
401287029,Wyoming Cowgirls,J. Johnson,4595683,,True,22.0,1,2,0,0,1,2,0,0,0,6,6,0,1,0,1,2,3
401287029,Wyoming Cowgirls,Q. Weidemann,4400207,,True,31.0,4,11,2,8,2,3,0,0,0,3,3,2,1,0,3,2,10
401287029,Wyoming Cowgirls,A. Sanchez Ramos,4400204,,True,31.0,3,12,2,7,1,5,2,3,1,4,5,2,0,0,4,1,9
401287029,Wyoming Cowgirls,T. Olson,4400203,,True,38.0,2,6,2,6,0,0,0,0,3,3,6,4,9,0,1,1,4
401287029,Wyoming Cowgirls,M. Savic,4704660,,False,1.0,0,0,0,0,0,0,0,0,0,0,0,0,0,0,0,0,0
401287029,Wyoming Cowgirls,P. Salazar,4704659,,False,1.0,0,1,0,0,0,1,0,0,0,0,0,0,0,0,0,0,0
401287029,Wyoming Cowgirls,G. Ellis,4704657,,False,15.0,1,5,0,1,1,4,3,4,0,1,1,1,0,1,0,0,6
401287029,Wyoming Cowgirls,L. Bull,4704655,,False,1.0,0,0,0,0,0,0,0,0,0,0,0,0,1,0,0,0,0
401287029,Wyoming Cowgirls,O. Ustowska,4704662,,False,12.0,1,2,0,0,1,2,0,0,0,1,1,1,0,0,1,1,3
401287029,Wyoming Cowgirls,L. Hudson,4704658,,False,1.0,0,0,0,0,0,0,0,0,0,0,0,0,0,0,0,0,0
401287029,Wyoming Cowgirls,M. Bradshaw,4595681,,False,15.0,1,5,1,5,0,0,1,2,0,2,2,0,0,0,3,1,3
401287029,Wyoming Cowgirls,TEAM,TOTAL,TOTAL,False,,20,54,14,37,6,17,7,11,10,26,36,12,13,1,15,10,53
401287029,Wyoming Cowgirls,D. Davidsdottir,4068870,,True,32.0,7,10,7,10,0,0,1,2,0,4,4,2,1,0,2,2,15
401287029,Wyoming Cowgirls,J. Johnson,4595683,,True,22.0,1,2,0,0,1,2,0,0,0,6,6,0,1,0,1,2,3
401287029,Wyoming Cowgirls,Q. Weidemann,4400207,,True,31.0,4,11,2,8,2,3,0,0,0,3,3,2,1,0,3,2,10
401287029,Wyoming Cowgirls,A. Sanchez Ramos,4400204,,True,31.0,3,12,2,7,1,5,2,3,1,4,5,2,0,0,4,1,9
401287029,Wyoming Cowgirls,T. Olson,4400203,,True,38.0,2,6,2,6,0,0,0,0,3,3,6,4,9,0,1,1,4
401287029,Wyoming Cowgirls,M. Savic,4704660,,False,1.0,0,0,0,0,0,0,0,0,0,0,0,0,0,0,0,0,0
401287029,Wyoming Cowgirls,P. Salazar,4704659,,False,1.0,0,1,0,0,0,1,0,0,0,0,0,0,0,0,0,0,0
401287029,Wyoming Cowgirls,G. Ellis,4704657,,False,15.0,1,5,0,1,1,4,3,4,0,1,1,1,0,1,0,0,6
401287029,Wyoming Cowgirls,L. Bull,4704655,,False,1.0,0,0,0,0,0,0,0,0,0,0,0,0,1,0,0,0,0
401287029,Wyoming Cowgirls,O. Ustowska,4704662,,False,12.0,1,2,0,0,1,2,0,0,0,1,1,1,0,0,1,1,3
401287029,Wyoming Cowgirls,L. Hudson,4704658,,False,1.0,0,0,0,0,0,0,0,0,0,0,0,0,0,0,0,0,0
401287029,Wyoming Cowgirls,M. Bradshaw,4595681,,False,15.0,1,5,1,5,0,0,1,2,0,2,2,0,0,0,3,1,3
401287029,Wyoming Cowgirls,TEAM,TOTAL,TOTAL,False,,20,54,14,37,6,17,7,11,10,26,36,12,13,1,15,10,53
401287029,Boise State Broncos,A. Mark,4606930,,True,26.0,6,10,6,10,0,0,0,0,1,3,4,1,3,0,2,2,12
401287029,Boise State Broncos,A. Muse,4583056,,True,21.0,2,5,2,5,0,0,0,1,2,2,4,0,1,3,5,1,4
401287029,Boise State Broncos,M. McGwire,4066535,,True,30.0,0,6,0,4,0,2,2,2,1,10,11,2,2,0,2,3,2
401287029,Boise State Broncos,M. Naro,4705625,,True,32.0,0,6,0,5,0,1,0,0,1,2,3,1,1,2,6,0,0
401287029,Boise State Broncos,J. Loville,4400537,,True,29.0,3,11,3,10,0,1,2,2,0,1,1,1,2,1,1,1,8
401287029,Boise State Broncos,E. Lalotte,4705630,,False,7.0,0,1,0,1,0,0,0,0,0,0,0,0,0,0,1,1,0
401287029,Boise State Broncos,K. Sykes,4595619,,False,9.0,0,1,0,0,0,1,0,0,0,0,0,0,0,0,0,1,0
401287029,Boise State Broncos,R. Bowers,4400536,,False,10.0,1,2,1,2,0,0,0,0,2,2,4,0,0,1,2,0,2
401287029,Boise State Broncos,M. Machalova,4705628,,False,7.0,1,2,1,2,0,0,1,1,0,1,1,0,0,0,0,0,3
401287029,Boise State Broncos,C. Gil,4705627,,False,14.0,0,1,0,0,0,1,2,2,0,2,2,0,0,1,1,1,2
401287029,Boise State Broncos,A. Ostlie,4705626,,False,15.0,1,5,1,1,0,4,3,3,0,1,1,1,1,0,2,0,5
401287029,Boise State Broncos,TEAM,TOTAL,TOTAL,False,,14,50,14,40,0,10,10,11,10,27,37,6,10,8,23,10,38
401287029,Boise State Broncos,A. Mark,4606930,,True,26.0,6,10,6,10,0,0,0,0,1,3,4,1,3,0,2,2,12
401287029,Boise State Broncos,A. Muse,4583056,,True,21.0,2,5,2,5,0,0,0,1,2,2,4,0,1,3,5,1,4
401287029,Boise State Broncos,M. McGwire,4066535,,True,30.0,0,6,0,4,0,2,2,2,1,10,11,2,2,0,2,3,2
401287029,Boise State Broncos,M. Naro,4705625,,True,32.0,0,6,0,5,0,1,0,0,1,2,3,1,1,2,6,0,0
401287029,Boise State Broncos,J. Loville,4400537,,True,29.0,3,11,3,10,0,1,2,2,0,1,1,1,2,1,1,1,8
401287029,Boise State Broncos,E. Lalotte,4705630,,False,7.0,0,1,0,1,0,0,0,0,0,0,0,0,0,0,1,1,0
401287029,Boise State Broncos,K. Sykes,4595619,,False,9.0,0,1,0,0,0,1,0,0,0,0,0,0,0,0,0,1,0
401287029,Boise State Broncos,R. Bowers,4400536,,False,10.0,1,2,1,2,0,0,0,0,2,2,4,0,0,1,2,0,2
401287029,Boise State Broncos,M. Machalova,4705628,,False,7.0,1,2,1,2,0,0,1,1,0,1,1,0,0,0,0,0,3
401287029,Boise State Broncos,C. Gil,4705627,,False,14.0,0,1,0,0,0,1,2,2,0,2,2,0,0,1,1,1,2
401287029,Boise State Broncos,A. Ostlie,4705626,,False,15.0,1,5,1,1,0,4,3,3,0,1,1,1,1,0,2,0,5
401287029,Boise State Broncos,TEAM,TOTAL,TOTAL,False,,14,50,14,40,0,10,10,11,10,27,37,6,10,8,23,10,38
401287028,New Mexico Lobos,S. McGruder,4400149,,True,19.0,4,8,4,8,0,0,2,2,2,2,4,1,1,1,2,1,10
401287028,New Mexico Lobos,A. Anderson,4281834,,True,34.0,4,10,4,7,0,3,1,4,2,8,10,2,2,1,3,1,9
401287028,New Mexico Lobos,Lato. Duff,4704520,,True,24.0,1,5,1,3,0,2,0,0,0,1,1,3,0,0,2,0,2
401287028,New Mexico Lobos,A. Hurst,4400147,,True,33.0,3,10,2,5,1,5,0,0,0,3,3,4,1,2,0,1,7
401287028,New Mexico Lobos,J. De La Cerda,4281833,,True,24.0,5,12,4,8,1,4,0,0,1,1,2,1,0,0,2,0,11
401287028,New Mexico Lobos,A. Watts,4433688,,False,24.0,2,3,2,3,0,0,0,0,3,2,5,1,1,2,1,1,4
401287028,New Mexico Lobos,K. van Bennekom,4704522,,False,1.0,0,0,0,0,0,0,0,0,0,0,0,0,0,0,0,0,0
401287028,New Mexico Lobos,Lata. Duff,4704519,,False,22.0,5,6,3,4,2,2,2,2,0,2,2,0,1,0,1,2,14
401287028,New Mexico Lobos,C. Carter,4433646,,False,19.0,4,7,3,4,1,3,1,1,0,5,5,2,0,0,2,0,10
401287028,New Mexico Lobos,TEAM,TOTAL,TOTAL,False,,28,61,23,42,5,19,6,9,9,28,37,14,6,6,13,6,67
401287028,New Mexico Lobos,S. McGruder,4400149,,True,19.0,4,8,4,8,0,0,2,2,2,2,4,1,1,1,2,1,10
401287028,New Mexico Lobos,A. Anderson,4281834,,True,34.0,4,10,4,7,0,3,1,4,2,8,10,2,2,1,3,1,9
401287028,New Mexico Lobos,Lato. Duff,4704520,,True,24.0,1,5,1,3,0,2,0,0,0,1,1,3,0,0,2,0,2
401287028,New Mexico Lobos,A. Hurst,4400147,,True,33.0,3,10,2,5,1,5,0,0,0,3,3,4,1,2,0,1,7
401287028,New Mexico Lobos,J. De La Cerda,4281833,,True,24.0,5,12,4,8,1,4,0,0,1,1,2,1,0,0,2,0,11
401287028,New Mexico Lobos,A. Watts,4433688,,False,24.0,2,3,2,3,0,0,0,0,3,2,5,1,1,2,1,1,4
401287028,New Mexico Lobos,K. van Bennekom,4704522,,False,1.0,0,0,0,0,0,0,0,0,0,0,0,0,0,0,0,0,0
401287028,New Mexico Lobos,Lata. Duff,4704519,,False,22.0,5,6,3,4,2,2,2,2,0,2,2,0,1,0,1,2,14
401287028,New Mexico Lobos,C. Carter,4433646,,False,19.0,4,7,3,4,1,3,1,1,0,5,5,2,0,0,2,0,10
401287028,New Mexico Lobos,TEAM,TOTAL,TOTAL,False,,28,61,23,42,5,19,6,9,9,28,37,14,6,6,13,6,67
401287028,Air Force Falcons,R. Snyder,4399409,,True,36.0,8,20,6,15,2,5,5,6,0,5,5,1,0,0,4,0,23
401287028,Air Force Falcons,K. Huffman,4068225,,True,27.0,1,3,1,3,0,0,0,0,2,3,5,0,1,1,1,1,2
401287028,Air Force Falcons,B. Autrey-Thompson,4399404,,True,19.0,1,4,1,4,0,0,0,0,0,2,2,1,0,0,1,4,2
401287028,Air Force Falcons,K. Immel,4281743,,True,35.0,4,15,4,11,0,4,0,0,0,6,6,2,3,2,1,2,8
401287028,Air Force Falcons,E. Conroe,4281737,,True,23.0,3,5,3,4,0,1,0,0,2,1,3,4,0,0,2,2,6
401287028,Air Force Falcons,K. Jones,4704416,,False,2.0,0,0,0,0,0,0,0,0,0,0,0,0,0,0,0,0,0
401287028,Air Force Falcons,D. MacMillan,4704414,,False,1.0,0,0,0,0,0,0,0,0,0,0,0,0,0,0,0,1,0
401287028,Air Force Falcons,N. McDonald,4595618,,False,11.0,0,1,0,0,0,1,0,0,0,3,3,0,0,0,0,0,0
401287028,Air Force Falcons,K. Pilson,4704411,,False,12.0,2,4,2,4,0,0,0,0,3,2,5,1,0,0,2,0,4
401287028,Air Force Falcons,K. Heath,4595614,,False,9.0,1,5,1,5,0,0,0,0,2,2,4,1,1,0,0,0,2
401287028,Air Force Falcons,C. Winters,4399406,,False,23.0,2,4,2,4,0,0,0,0,1,1,2,1,2,0,1,3,4
401287028,Air Force Falcons,A. Gadison,4399405,,False,2.0,0,0,0,0,0,0,0,0,0,0,0,0,0,0,1,0,0
401287028,Air Force Falcons,TEAM,TOTAL,TOTAL,False,,22,61,20,50,2,11,5,6,12,26,38,11,7,3,14,13,51
401287028,Air Force Falcons,R. Snyder,4399409,,True,36.0,8,20,6,15,2,5,5,6,0,5,5,1,0,0,4,0,23
401287028,Air Force Falcons,K. Huffman,4068225,,True,27.0,1,3,1,3,0,0,0,0,2,3,5,0,1,1,1,1,2
401287028,Air Force Falcons,B. Autrey-Thompson,4399404,,True,19.0,1,4,1,4,0,0,0,0,0,2,2,1,0,0,1,4,2
401287028,Air Force Falcons,K. Immel,4281743,,True,35.0,4,15,4,11,0,4,0,0,0,6,6,2,3,2,1,2,8
401287028,Air Force Falcons,E. Conroe,4281737,,True,23.0,3,5,3,4,0,1,0,0,2,1,3,4,0,0,2,2,6
401287028,Air Force Falcons,K. Jones,4704416,,False,2.0,0,0,0,0,0,0,0,0,0,0,0,0,0,0,0,0,0
401287028,Air Force Falcons,D. MacMillan,4704414,,False,1.0,0,0,0,0,0,0,0,0,0,0,0,0,0,0,0,1,0
401287028,Air Force Falcons,N. McDonald,4595618,,False,11.0,0,1,0,0,0,1,0,0,0,3,3,0,0,0,0,0,0
401287028,Air Force Falcons,K. Pilson,4704411,,False,12.0,2,4,2,4,0,0,0,0,3,2,5,1,0,0,2,0,4
401287028,Air Force Falcons,K. Heath,4595614,,False,9.0,1,5,1,5,0,0,0,0,2,2,4,1,1,0,0,0,2
401287028,Air Force Falcons,C. Winters,4399406,,False,23.0,2,4,2,4,0,0,0,0,1,1,2,1,2,0,1,3,4
401287028,Air Force Falcons,A. Gadison,4399405,,False,2.0,0,0,0,0,0,0,0,0,0,0,0,0,0,0,1,0,0
401287028,Air Force Falcons,TEAM,TOTAL,TOTAL,False,,22,61,20,50,2,11,5,6,12,26,38,11,7,3,14,13,51
401287027,Nevada Wolf Pack,M. Ormiston,4400072,,True,21.0,3,7,3,7,0,0,0,0,1,6,7,0,0,0,0,3,6
401287027,Nevada Wolf Pack,L. Johnson,4595634,,True,17.0,1,5,1,5,0,0,1,2,0,3,3,3,0,2,2,3,3
401287027,Nevada Wolf Pack,A. West,4400134,,True,33.0,4,11,1,5,3,6,4,4,1,5,6,0,1,1,3,2,15
401287027,Nevada Wolf Pack,D. Hamilton,4400132,,True,22.0,1,9,1,6,0,3,0,0,0,3,3,1,0,0,2,0,2
401287027,Nevada Wolf Pack,N. Alexander,4068433,,True,27.0,7,17,6,12,1,5,0,0,2,1,3,1,1,0,3,3,15
401287027,Nevada Wolf Pack,L. Otuafi,4704508,,False,27.0,0,10,0,9,0,1,1,2,2,5,7,0,0,0,0,0,1
401287027,Nevada Wolf Pack,L. Givens,4704506,,False,1.0,0,1,0,1,0,0,0,0,0,0,0,0,0,0,0,1,0
401287027,Nevada Wolf Pack,D. Phillips,4595638,,False,10.0,2,3,2,2,0,1,0,0,1,1,2,0,1,0,1,1,4
401287027,Nevada Wolf Pack,G. Rones,4704505,,False,13.0,0,2,0,0,0,2,0,0,0,2,2,1,0,0,0,1,0
401287027,Nevada Wolf Pack,K. Holt,4704503,,False,29.0,0,2,0,2,0,0,0,0,0,3,3,4,2,0,2,4,0
401287027,Nevada Wolf Pack,TEAM,TOTAL,TOTAL,False,,18,67,14,49,4,18,6,8,8,31,39,10,5,3,14,18,46
401287027,Nevada Wolf Pack,M. Ormiston,4400072,,True,21.0,3,7,3,7,0,0,0,0,1,6,7,0,0,0,0,3,6
401287027,Nevada Wolf Pack,L. Johnson,4595634,,True,17.0,1,5,1,5,0,0,1,2,0,3,3,3,0,2,2,3,3
401287027,Nevada Wolf Pack,A. West,4400134,,True,33.0,4,11,1,5,3,6,4,4,1,5,6,0,1,1,3,2,15
401287027,Nevada Wolf Pack,D. Hamilton,4400132,,True,22.0,1,9,1,6,0,3,0,0,0,3,3,1,0,0,2,0,2
401287027,Nevada Wolf Pack,N. Alexander,4068433,,True,27.0,7,17,6,12,1,5,0,0,2,1,3,1,1,0,3,3,15
401287027,Nevada Wolf Pack,L. Otuafi,4704508,,False,27.0,0,10,0,9,0,1,1,2,2,5,7,0,0,0,0,0,1
401287027,Nevada Wolf Pack,L. Givens,4704506,,False,1.0,0,1,0,1,0,0,0,0,0,0,0,0,0,0,0,1,0
401287027,Nevada Wolf Pack,D. Phillips,4595638,,False,10.0,2,3,2,2,0,1,0,0,1,1,2,0,1,0,1,1,4
401287027,Nevada Wolf Pack,G. Rones,4704505,,False,13.0,0,2,0,0,0,2,0,0,0,2,2,1,0,0,0,1,0
401287027,Nevada Wolf Pack,K. Holt,4704503,,False,29.0,0,2,0,2,0,0,0,0,0,3,3,4,2,0,2,4,0
401287027,Nevada Wolf Pack,TEAM,TOTAL,TOTAL,False,,18,67,14,49,4,18,6,8,8,31,39,10,5,3,14,18,46
401287027,Fresno State Bulldogs,W. Motta,4595631,,True,11.0,2,2,2,2,0,0,0,1,0,1,1,0,0,0,1,2,4
401287027,Fresno State Bulldogs,M. Utti,4281828,,True,29.0,2,8,2,7,0,1,3,6,2,6,8,1,1,0,2,0,7
401287027,Fresno State Bulldogs,Hal. Cavinder,4433658,,True,34.0,6,17,5,11,1,6,4,5,0,9,9,0,1,1,1,0,17
401287027,Fresno State Bulldogs,Han. Cavinder,4433372,,True,33.0,6,15,5,14,1,1,0,0,0,3,3,4,3,0,2,1,13
401287027,Fresno State Bulldogs,A. Gamez,4281826,,True,28.0,4,6,3,3,1,3,5,6,0,2,2,1,2,0,1,1,14
401287027,Fresno State Bulldogs,C. Fairley,4704474,,False,1.0,0,0,0,0,0,0,0,0,0,0,0,0,0,0,0,0,0
401287027,Fresno State Bulldogs,K. Kinzer,4595630,,False,9.0,0,3,0,0,0,3,0,0,0,1,1,2,0,0,0,0,0
401287027,Fresno State Bulldogs,G. Ogier,4281827,,False,1.0,0,0,0,0,0,0,2,2,0,1,1,0,0,0,0,0,2
401287027,Fresno State Bulldogs,B. Walling,4595632,,False,27.0,1,6,1,5,0,1,2,3,3,2,5,0,1,0,1,3,4
401287027,Fresno State Bulldogs,Y. Todorova,4704475,,False,3.0,0,0,0,0,0,0,0,0,0,0,0,0,0,0,1,0,0
401287027,Fresno State Bulldogs,K. Brown,4704473,,False,6.0,0,0,0,0,0,0,0,0,0,0,0,0,0,0,1,0,0
401287027,Fresno State Bulldogs,D. Dunn,4433511,,False,1.0,0,0,0,0,0,0,0,0,0,1,1,0,0,0,0,0,0
401287027,Fresno State Bulldogs,B. Delaney,4281825,,False,17.0,3,4,0,1,3,3,0,0,0,10,10,2,1,0,1,2,9
401287027,Fresno State Bulldogs,TEAM,TOTAL,TOTAL,False,,24,61,18,43,6,18,16,23,8,40,48,10,9,1,12,9,70
401287027,Fresno State Bulldogs,W. Motta,4595631,,True,11.0,2,2,2,2,0,0,0,1,0,1,1,0,0,0,1,2,4
401287027,Fresno State Bulldogs,M. Utti,4281828,,True,29.0,2,8,2,7,0,1,3,6,2,6,8,1,1,0,2,0,7
401287027,Fresno State Bulldogs,Hal. Cavinder,4433658,,True,34.0,6,17,5,11,1,6,4,5,0,9,9,0,1,1,1,0,17
401287027,Fresno State Bulldogs,Han. Cavinder,4433372,,True,33.0,6,15,5,14,1,1,0,0,0,3,3,4,3,0,2,1,13
401287027,Fresno State Bulldogs,A. Gamez,4281826,,True,28.0,4,6,3,3,1,3,5,6,0,2,2,1,2,0,1,1,14
401287027,Fresno State Bulldogs,C. Fairley,4704474,,False,1.0,0,0,0,0,0,0,0,0,0,0,0,0,0,0,0,0,0
401287027,Fresno State Bulldogs,K. Kinzer,4595630,,False,9.0,0,3,0,0,0,3,0,0,0,1,1,2,0,0,0,0,0
401287027,Fresno State Bulldogs,G. Ogier,4281827,,False,1.0,0,0,0,0,0,0,2,2,0,1,1,0,0,0,0,0,2
401287027,Fresno State Bulldogs,B. Walling,4595632,,False,27.0,1,6,1,5,0,1,2,3,3,2,5,0,1,0,1,3,4
401287027,Fresno State Bulldogs,Y. Todorova,4704475,,False,3.0,0,0,0,0,0,0,0,0,0,0,0,0,0,0,1,0,0
401287027,Fresno State Bulldogs,K. Brown,4704473,,False,6.0,0,0,0,0,0,0,0,0,0,0,0,0,0,0,1,0,0
401287027,Fresno State Bulldogs,D. Dunn,4433511,,False,1.0,0,0,0,0,0,0,0,0,0,1,1,0,0,0,0,0,0
401287027,Fresno State Bulldogs,B. Delaney,4281825,,False,17.0,3,4,0,1,3,3,0,0,0,10,10,2,1,0,1,2,9
401287027,Fresno State Bulldogs,TEAM,TOTAL,TOTAL,False,,24,61,18,43,6,18,16,23,8,40,48,10,9,1,12,9,70
401287026,Wyoming Cowgirls,D. Davidsdottir,4068870,,True,16.0,2,6,2,5,0,1,0,0,1,1,2,1,0,0,0,4,4
401287026,Wyoming Cowgirls,J. Johnson,4595683,,True,9.0,0,0,0,0,0,0,0,0,0,2,2,1,0,0,0,0,0
401287026,Wyoming Cowgirls,Q. Weidemann,4400207,,True,35.0,7,11,3,4,4,7,0,0,0,2,2,3,0,0,1,0,18
401287026,Wyoming Cowgirls,A. Sanchez Ramos,4400204,,True,36.0,3,8,2,4,1,4,0,1,1,5,6,4,1,1,3,3,7
401287026,Wyoming Cowgirls,T. Olson,4400203,,True,37.0,6,14,2,3,4,11,0,0,0,4,4,2,3,1,1,0,16
401287026,Wyoming Cowgirls,M. Savic,4704660,,False,2.0,0,0,0,0,0,0,0,0,0,0,0,0,0,0,1,3,0
401287026,Wyoming Cowgirls,G. Ellis,4704657,,False,24.0,2,3,0,1,2,2,0,0,1,2,3,2,0,0,1,2,6
401287026,Wyoming Cowgirls,O. Ustowska,4704662,,False,13.0,2,4,0,0,2,4,0,0,0,0,0,1,0,0,0,1,6
401287026,Wyoming Cowgirls,M. Bradshaw,4595681,,False,28.0,4,6,2,3,2,3,5,6,3,6,9,3,1,0,3,1,15
401287026,Wyoming Cowgirls,TEAM,TOTAL,TOTAL,False,,26,52,11,20,15,32,5,7,6,24,30,17,5,2,10,14,72
401287026,Wyoming Cowgirls,D. Davidsdottir,4068870,,True,16.0,2,6,2,5,0,1,0,0,1,1,2,1,0,0,0,4,4
401287026,Wyoming Cowgirls,J. Johnson,4595683,,True,9.0,0,0,0,0,0,0,0,0,0,2,2,1,0,0,0,0,0
401287026,Wyoming Cowgirls,Q. Weidemann,4400207,,True,35.0,7,11,3,4,4,7,0,0,0,2,2,3,0,0,1,0,18
401287026,Wyoming Cowgirls,A. Sanchez Ramos,4400204,,True,36.0,3,8,2,4,1,4,0,1,1,5,6,4,1,1,3,3,7
401287026,Wyoming Cowgirls,T. Olson,4400203,,True,37.0,6,14,2,3,4,11,0,0,0,4,4,2,3,1,1,0,16
401287026,Wyoming Cowgirls,M. Savic,4704660,,False,2.0,0,0,0,0,0,0,0,0,0,0,0,0,0,0,1,3,0
401287026,Wyoming Cowgirls,G. Ellis,4704657,,False,24.0,2,3,0,1,2,2,0,0,1,2,3,2,0,0,1,2,6
401287026,Wyoming Cowgirls,O. Ustowska,4704662,,False,13.0,2,4,0,0,2,4,0,0,0,0,0,1,0,0,0,1,6
401287026,Wyoming Cowgirls,M. Bradshaw,4595681,,False,28.0,4,6,2,3,2,3,5,6,3,6,9,3,1,0,3,1,15
401287026,Wyoming Cowgirls,TEAM,TOTAL,TOTAL,False,,26,52,11,20,15,32,5,7,6,24,30,17,5,2,10,14,72
401287026,UNLV Lady Rebels,D. Byrne,4398924,,True,37.0,4,11,3,5,1,6,0,0,5,6,11,2,0,0,1,2,9
401287026,UNLV Lady Rebels,D. Young,4704625,,True,34.0,7,10,7,10,0,0,7,11,6,2,8,0,0,0,4,1,21
401287026,UNLV Lady Rebels,J. Thomas,4704624,,True,40.0,4,12,2,6,2,6,0,0,0,8,8,2,3,0,1,0,10
401287026,UNLV Lady Rebels,N. Johnson,4400108,,True,23.0,1,9,0,4,1,5,0,0,0,2,2,1,0,0,2,2,3
401287026,UNLV Lady Rebels,B. Thomas,4068210,,True,39.0,3,8,2,5,1,3,2,2,0,1,1,2,2,1,0,0,9
401287026,UNLV Lady Rebels,A. Blount,4595640,,False,7.0,1,2,1,2,0,0,0,0,0,0,0,0,0,0,2,0,2
401287026,UNLV Lady Rebels,K. Wilfred,4595641,,False,2.0,0,0,0,0,0,0,0,0,0,0,0,0,0,0,0,0,0
401287026,UNLV Lady Rebels,J. Singleton,4704623,,False,12.0,0,1,0,1,0,0,0,0,0,0,0,1,1,0,0,2,0
401287026,UNLV Lady Rebels,J. Buckley,4595639,,False,6.0,1,2,1,2,0,0,0,0,0,0,0,0,0,0,0,1,2
401287026,UNLV Lady Rebels,TEAM,TOTAL,TOTAL,False,,21,55,16,35,5,20,9,13,12,20,32,8,6,1,11,8,56
401287026,UNLV Lady Rebels,D. Byrne,4398924,,True,37.0,4,11,3,5,1,6,0,0,5,6,11,2,0,0,1,2,9
401287026,UNLV Lady Rebels,D. Young,4704625,,True,34.0,7,10,7,10,0,0,7,11,6,2,8,0,0,0,4,1,21
401287026,UNLV Lady Rebels,J. Thomas,4704624,,True,40.0,4,12,2,6,2,6,0,0,0,8,8,2,3,0,1,0,10
401287026,UNLV Lady Rebels,N. Johnson,4400108,,True,23.0,1,9,0,4,1,5,0,0,0,2,2,1,0,0,2,2,3
401287026,UNLV Lady Rebels,B. Thomas,4068210,,True,39.0,3,8,2,5,1,3,2,2,0,1,1,2,2,1,0,0,9
401287026,UNLV Lady Rebels,A. Blount,4595640,,False,7.0,1,2,1,2,0,0,0,0,0,0,0,0,0,0,2,0,2
401287026,UNLV Lady Rebels,K. Wilfred,4595641,,False,2.0,0,0,0,0,0,0,0,0,0,0,0,0,0,0,0,0,0
401287026,UNLV Lady Rebels,J. Singleton,4704623,,False,12.0,0,1,0,1,0,0,0,0,0,0,0,1,1,0,0,2,0
401287026,UNLV Lady Rebels,J. Buckley,4595639,,False,6.0,1,2,1,2,0,0,0,0,0,0,0,0,0,0,0,1,2
401287026,UNLV Lady Rebels,TEAM,TOTAL,TOTAL,False,,21,55,16,35,5,20,9,13,12,20,32,8,6,1,11,8,56
401287025,Colorado State Rams,K. Murphy,4068969,,True,18.0,1,8,1,8,0,0,0,0,3,3,6,0,0,0,0,1,2
401287025,Colorado State Rams,E. Boni,4704462,,True,27.0,3,9,3,7,0,2,0,0,1,3,4,2,1,1,1,2,6
401287025,Colorado State Rams,M. Hofschild,4595160,,True,29.0,2,3,2,3,0,0,0,0,0,2,2,2,1,1,3,5,4
401287025,Colorado State Rams,L. Devos,4284002,,True,31.0,11,17,7,11,4,6,0,1,2,4,6,0,0,0,2,1,26
401287025,Colorado State Rams,T. Williams,4282176,,True,39.0,4,16,1,9,3,7,3,4,1,4,5,8,2,0,1,2,14
401287025,Colorado State Rams,C. Clark,4704464,,False,11.0,1,5,1,5,0,0,0,0,0,2,2,0,0,0,0,2,2
401287025,Colorado State Rams,J. Bonnarens,4400102,,False,20.0,3,8,2,4,1,4,0,2,0,2,2,1,1,0,0,3,7
401287025,Colorado State Rams,P. Farkas,4704463,,False,13.0,2,4,2,4,0,0,0,0,0,1,1,4,0,0,0,0,4
401287025,Colorado State Rams,S. Mech,4399658,,False,12.0,0,1,0,0,0,1,0,0,0,2,2,0,0,0,1,1,0
401287025,Colorado State Rams,TEAM,TOTAL,TOTAL,False,,27,71,19,51,8,20,3,7,9,24,33,17,5,2,8,17,65
401287025,Colorado State Rams,K. Murphy,4068969,,True,18.0,1,8,1,8,0,0,0,0,3,3,6,0,0,0,0,1,2
401287025,Colorado State Rams,E. Boni,4704462,,True,27.0,3,9,3,7,0,2,0,0,1,3,4,2,1,1,1,2,6
401287025,Colorado State Rams,M. Hofschild,4595160,,True,29.0,2,3,2,3,0,0,0,0,0,2,2,2,1,1,3,5,4
401287025,Colorado State Rams,L. Devos,4284002,,True,31.0,11,17,7,11,4,6,0,1,2,4,6,0,0,0,2,1,26
401287025,Colorado State Rams,T. Williams,4282176,,True,39.0,4,16,1,9,3,7,3,4,1,4,5,8,2,0,1,2,14
401287025,Colorado State Rams,C. Clark,4704464,,False,11.0,1,5,1,5,0,0,0,0,0,2,2,0,0,0,0,2,2
401287025,Colorado State Rams,J. Bonnarens,4400102,,False,20.0,3,8,2,4,1,4,0,2,0,2,2,1,1,0,0,3,7
401287025,Colorado State Rams,P. Farkas,4704463,,False,13.0,2,4,2,4,0,0,0,0,0,1,1,4,0,0,0,0,4
401287025,Colorado State Rams,S. Mech,4399658,,False,12.0,0,1,0,0,0,1,0,0,0,2,2,0,0,0,1,1,0
401287025,Colorado State Rams,TEAM,TOTAL,TOTAL,False,,27,71,19,51,8,20,3,7,9,24,33,17,5,2,8,17,65
401287025,Boise State Broncos,A. Mark,4606930,,True,33.0,5,13,5,13,0,0,1,2,4,9,13,2,1,1,3,2,11
401287025,Boise State Broncos,A. Muse,4583056,,True,12.0,3,4,3,4,0,0,0,0,1,2,3,0,0,0,1,2,6
401287025,Boise State Broncos,M. McGwire,4066535,,True,23.0,2,3,1,2,1,1,0,0,1,5,6,1,0,5,3,2,5
401287025,Boise State Broncos,M. Naro,4705625,,True,36.0,2,7,2,7,0,0,4,7,4,3,7,5,1,0,0,1,8
401287025,Boise State Broncos,J. Loville,4400537,,True,38.0,12,25,12,24,0,1,5,9,0,3,3,4,0,1,2,3,29
401287025,Boise State Broncos,E. Lalotte,4705630,,False,9.0,0,1,0,1,0,0,0,0,0,2,2,1,0,0,0,0,0
401287025,Boise State Broncos,K. Sykes,4595619,,False,7.0,1,3,1,1,0,2,0,0,1,1,2,0,0,0,0,0,2
401287025,Boise State Broncos,R. Bowers,4400536,,False,11.0,2,4,2,4,0,0,0,0,0,3,3,1,0,1,0,0,4
401287025,Boise State Broncos,C. Gil,4705627,,False,4.0,1,1,1,1,0,0,0,0,1,2,3,0,1,0,0,0,2
401287025,Boise State Broncos,A. Ostlie,4705626,,False,27.0,3,7,0,2,3,5,2,4,1,5,6,1,2,0,0,0,11
401287025,Boise State Broncos,TEAM,TOTAL,TOTAL,False,,31,68,27,59,4,9,12,22,13,38,51,15,5,8,9,10,78
401287025,Boise State Broncos,A. Mark,4606930,,True,33.0,5,13,5,13,0,0,1,2,4,9,13,2,1,1,3,2,11
401287025,Boise State Broncos,A. Muse,4583056,,True,12.0,3,4,3,4,0,0,0,0,1,2,3,0,0,0,1,2,6
401287025,Boise State Broncos,M. McGwire,4066535,,True,23.0,2,3,1,2,1,1,0,0,1,5,6,1,0,5,3,2,5
401287025,Boise State Broncos,M. Naro,4705625,,True,36.0,2,7,2,7,0,0,4,7,4,3,7,5,1,0,0,1,8
401287025,Boise State Broncos,J. Loville,4400537,,True,38.0,12,25,12,24,0,1,5,9,0,3,3,4,0,1,2,3,29
401287025,Boise State Broncos,E. Lalotte,4705630,,False,9.0,0,1,0,1,0,0,0,0,0,2,2,1,0,0,0,0,0
401287025,Boise State Broncos,K. Sykes,4595619,,False,7.0,1,3,1,1,0,2,0,0,1,1,2,0,0,0,0,0,2
401287025,Boise State Broncos,R. Bowers,4400536,,False,11.0,2,4,2,4,0,0,0,0,0,3,3,1,0,1,0,0,4
401287025,Boise State Broncos,C. Gil,4705627,,False,4.0,1,1,1,1,0,0,0,0,1,2,3,0,1,0,0,0,2
401287025,Boise State Broncos,A. Ostlie,4705626,,False,27.0,3,7,0,2,3,5,2,4,1,5,6,1,2,0,0,0,11
401287025,Boise State Broncos,TEAM,TOTAL,TOTAL,False,,31,68,27,59,4,9,12,22,13,38,51,15,5,8,9,10,78
401287024,San Diego State Aztecs,K. Edwards,4281879,,True,3.0,0,0,0,0,0,0,0,0,1,1,2,0,0,0,0,0,0
401287024,San Diego State Aztecs,S. Ramos,4400168,,True,33.0,3,13,2,9,1,4,6,6,0,3,3,1,1,0,2,4,13
401287024,San Diego State Aztecs,A. Crain,4399223,,True,30.0,2,8,2,7,0,1,0,0,2,3,5,1,1,0,2,4,4
401287024,San Diego State Aztecs,M. Staples,4398925,,True,35.0,2,12,2,10,0,2,3,3,0,8,8,3,1,0,3,0,7
401287024,San Diego State Aztecs,T. Adams,4281876,,True,27.0,5,15,5,15,0,0,3,5,3,3,6,1,1,0,3,2,13
401287024,San Diego State Aztecs,K. Gipson,4704563,,False,13.0,1,1,1,1,0,0,0,2,1,1,2,0,0,1,1,4,2
401287024,San Diego State Aztecs,F. Vinerte,4704564,,False,20.0,1,2,1,2,0,0,1,2,1,7,8,0,3,1,2,3,3
401287024,San Diego State Aztecs,K. Villalobos,4704565,,False,16.0,1,4,1,4,0,0,2,3,1,2,3,1,1,1,3,1,4
401287024,San Diego State Aztecs,B. Chynoweth,4704562,,False,2.0,1,1,1,1,0,0,0,0,0,0,0,0,0,0,0,0,2
401287024,San Diego State Aztecs,I. Hernandez,4595647,,False,21.0,0,2,0,0,0,2,0,0,0,1,1,0,0,1,0,0,0
401287024,San Diego State Aztecs,TEAM,TOTAL,TOTAL,False,,16,58,15,49,1,9,15,21,13,32,45,7,8,4,16,18,48
401287024,San Diego State Aztecs,K. Edwards,4281879,,True,3.0,0,0,0,0,0,0,0,0,1,1,2,0,0,0,0,0,0
401287024,San Diego State Aztecs,S. Ramos,4400168,,True,33.0,3,13,2,9,1,4,6,6,0,3,3,1,1,0,2,4,13
401287024,San Diego State Aztecs,A. Crain,4399223,,True,30.0,2,8,2,7,0,1,0,0,2,3,5,1,1,0,2,4,4
401287024,San Diego State Aztecs,M. Staples,4398925,,True,35.0,2,12,2,10,0,2,3,3,0,8,8,3,1,0,3,0,7
401287024,San Diego State Aztecs,T. Adams,4281876,,True,27.0,5,15,5,15,0,0,3,5,3,3,6,1,1,0,3,2,13
401287024,San Diego State Aztecs,K. Gipson,4704563,,False,13.0,1,1,1,1,0,0,0,2,1,1,2,0,0,1,1,4,2
401287024,San Diego State Aztecs,F. Vinerte,4704564,,False,20.0,1,2,1,2,0,0,1,2,1,7,8,0,3,1,2,3,3
401287024,San Diego State Aztecs,K. Villalobos,4704565,,False,16.0,1,4,1,4,0,0,2,3,1,2,3,1,1,1,3,1,4
401287024,San Diego State Aztecs,B. Chynoweth,4704562,,False,2.0,1,1,1,1,0,0,0,0,0,0,0,0,0,0,0,0,2
401287024,San Diego State Aztecs,I. Hernandez,4595647,,False,21.0,0,2,0,0,0,2,0,0,0,1,1,0,0,1,0,0,0
401287024,San Diego State Aztecs,TEAM,TOTAL,TOTAL,False,,16,58,15,49,1,9,15,21,13,32,45,7,8,4,16,18,48
401287024,Air Force Falcons,R. Snyder,4399409,,True,35.0,5,14,4,9,1,5,5,5,3,4,7,2,1,0,0,2,16
401287024,Air Force Falcons,K. Huffman,4068225,,True,25.0,0,1,0,1,0,0,0,0,1,5,6,2,0,4,2,1,0
401287024,Air Force Falcons,B. Autrey-Thompson,4399404,,True,31.0,3,12,2,10,1,2,2,4,0,7,7,1,0,0,5,1,9
401287024,Air Force Falcons,K. Immel,4281743,,True,34.0,7,20,4,12,3,8,0,1,0,5,5,2,0,1,2,2,17
401287024,Air Force Falcons,E. Conroe,4281737,,True,24.0,2,5,1,4,1,1,0,0,4,3,7,3,2,1,1,3,5
401287024,Air Force Falcons,K. Jones,4704416,,False,3.0,0,0,0,0,0,0,0,2,1,1,2,0,0,0,1,1,0
401287024,Air Force Falcons,D. MacMillan,4704414,,False,6.0,0,2,0,0,0,2,0,0,0,2,2,0,0,0,0,1,0
401287024,Air Force Falcons,N. McDonald,4595618,,False,12.0,0,1,0,0,0,1,0,0,0,0,0,0,0,0,0,0,0
401287024,Air Force Falcons,K. Pilson,4704411,,False,5.0,0,2,0,2,0,0,0,0,0,0,0,0,0,0,0,0,0
401287024,Air Force Falcons,K. Heath,4595614,,False,5.0,0,1,0,1,0,0,0,0,0,0,0,2,1,0,1,0,0
401287024,Air Force Falcons,C. Winters,4399406,,False,14.0,2,3,2,3,0,0,2,4,2,1,3,1,2,0,0,4,6
401287024,Air Force Falcons,A. Gadison,4399405,,False,6.0,1,3,0,0,1,3,0,0,1,0,1,0,0,0,0,1,3
401287024,Air Force Falcons,TEAM,TOTAL,TOTAL,False,,20,64,13,42,7,22,9,16,14,32,46,13,6,6,14,16,56
401287024,Air Force Falcons,R. Snyder,4399409,,True,35.0,5,14,4,9,1,5,5,5,3,4,7,2,1,0,0,2,16
401287024,Air Force Falcons,K. Huffman,4068225,,True,25.0,0,1,0,1,0,0,0,0,1,5,6,2,0,4,2,1,0
401287024,Air Force Falcons,B. Autrey-Thompson,4399404,,True,31.0,3,12,2,10,1,2,2,4,0,7,7,1,0,0,5,1,9
401287024,Air Force Falcons,K. Immel,4281743,,True,34.0,7,20,4,12,3,8,0,1,0,5,5,2,0,1,2,2,17
401287024,Air Force Falcons,E. Conroe,4281737,,True,24.0,2,5,1,4,1,1,0,0,4,3,7,3,2,1,1,3,5
401287024,Air Force Falcons,K. Jones,4704416,,False,3.0,0,0,0,0,0,0,0,2,1,1,2,0,0,0,1,1,0
401287024,Air Force Falcons,D. MacMillan,4704414,,False,6.0,0,2,0,0,0,2,0,0,0,2,2,0,0,0,0,1,0
401287024,Air Force Falcons,N. McDonald,4595618,,False,12.0,0,1,0,0,0,1,0,0,0,0,0,0,0,0,0,0,0
401287024,Air Force Falcons,K. Pilson,4704411,,False,5.0,0,2,0,2,0,0,0,0,0,0,0,0,0,0,0,0,0
401287024,Air Force Falcons,K. Heath,4595614,,False,5.0,0,1,0,1,0,0,0,0,0,0,0,2,1,0,1,0,0
401287024,Air Force Falcons,C. Winters,4399406,,False,14.0,2,3,2,3,0,0,2,4,2,1,3,1,2,0,0,4,6
401287024,Air Force Falcons,A. Gadison,4399405,,False,6.0,1,3,0,0,1,3,0,0,1,0,1,0,0,0,0,1,3
401287024,Air Force Falcons,TEAM,TOTAL,TOTAL,False,,20,64,13,42,7,22,9,16,14,32,46,13,6,6,14,16,56
401287023,Wyoming Cowgirls,D. Davidsdottir,4068870,,True,24.0,8,10,8,9,0,1,1,3,1,5,6,2,0,0,1,2,17
401287023,Wyoming Cowgirls,J. Johnson,4595683,,True,22.0,1,3,1,3,0,0,0,0,2,8,10,2,2,2,2,1,2
401287023,Wyoming Cowgirls,Q. Weidemann,4400207,,True,31.0,4,8,2,3,2,5,2,2,0,2,2,6,2,0,0,1,12
401287023,Wyoming Cowgirls,A. Sanchez Ramos,4400204,,True,25.0,6,9,5,7,1,2,0,0,1,5,6,1,0,1,4,1,13
401287023,Wyoming Cowgirls,T. Olson,4400203,,True,31.0,1,4,1,2,0,2,0,0,0,1,1,7,4,0,0,2,2
401287023,Wyoming Cowgirls,M. Savic,4704660,,False,8.0,2,2,2,2,0,0,0,0,0,1,1,0,0,0,2,3,4
401287023,Wyoming Cowgirls,P. Salazar,4704659,,False,4.0,0,0,0,0,0,0,0,0,0,1,1,0,0,2,2,0,0
401287023,Wyoming Cowgirls,G. Ellis,4704657,,False,10.0,0,3,0,2,0,1,0,0,2,0,2,1,1,0,2,0,0
401287023,Wyoming Cowgirls,L. Bull,4704655,,False,4.0,0,0,0,0,0,0,0,0,0,2,2,1,0,0,0,0,0
401287023,Wyoming Cowgirls,O. Ustowska,4704662,,False,16.0,1,5,0,1,1,4,0,0,0,1,1,1,0,1,2,1,3
401287023,Wyoming Cowgirls,L. Hudson,4704658,,False,4.0,0,1,0,0,0,1,0,0,1,0,1,0,0,0,0,0,0
401287023,Wyoming Cowgirls,M. Bradshaw,4595681,,False,21.0,6,11,5,7,1,4,3,6,1,5,6,2,1,0,2,1,16
401287023,Wyoming Cowgirls,TEAM,TOTAL,TOTAL,False,,29,56,24,36,5,20,6,11,9,35,44,23,10,6,17,12,69
401287023,Wyoming Cowgirls,D. Davidsdottir,4068870,,True,24.0,8,10,8,9,0,1,1,3,1,5,6,2,0,0,1,2,17
401287023,Wyoming Cowgirls,J. Johnson,4595683,,True,22.0,1,3,1,3,0,0,0,0,2,8,10,2,2,2,2,1,2
401287023,Wyoming Cowgirls,Q. Weidemann,4400207,,True,31.0,4,8,2,3,2,5,2,2,0,2,2,6,2,0,0,1,12
401287023,Wyoming Cowgirls,A. Sanchez Ramos,4400204,,True,25.0,6,9,5,7,1,2,0,0,1,5,6,1,0,1,4,1,13
401287023,Wyoming Cowgirls,T. Olson,4400203,,True,31.0,1,4,1,2,0,2,0,0,0,1,1,7,4,0,0,2,2
401287023,Wyoming Cowgirls,M. Savic,4704660,,False,8.0,2,2,2,2,0,0,0,0,0,1,1,0,0,0,2,3,4
401287023,Wyoming Cowgirls,P. Salazar,4704659,,False,4.0,0,0,0,0,0,0,0,0,0,1,1,0,0,2,2,0,0
401287023,Wyoming Cowgirls,G. Ellis,4704657,,False,10.0,0,3,0,2,0,1,0,0,2,0,2,1,1,0,2,0,0
401287023,Wyoming Cowgirls,L. Bull,4704655,,False,4.0,0,0,0,0,0,0,0,0,0,2,2,1,0,0,0,0,0
401287023,Wyoming Cowgirls,O. Ustowska,4704662,,False,16.0,1,5,0,1,1,4,0,0,0,1,1,1,0,1,2,1,3
401287023,Wyoming Cowgirls,L. Hudson,4704658,,False,4.0,0,1,0,0,0,1,0,0,1,0,1,0,0,0,0,0,0
401287023,Wyoming Cowgirls,M. Bradshaw,4595681,,False,21.0,6,11,5,7,1,4,3,6,1,5,6,2,1,0,2,1,16
401287023,Wyoming Cowgirls,TEAM,TOTAL,TOTAL,False,,29,56,24,36,5,20,6,11,9,35,44,23,10,6,17,12,69
401287023,Utah State Aggies,T. Franson,4281892,,True,20.0,1,5,1,3,0,2,2,2,1,0,1,0,0,1,1,1,4
401287023,Utah State Aggies,J. Chatman,4068281,,True,27.0,1,8,1,7,0,1,0,0,0,2,2,1,2,0,0,0,2
401287023,Utah State Aggies,F. Brantley,4595669,,True,27.0,1,6,1,6,0,0,3,3,2,3,5,2,2,0,2,2,5
401287023,Utah State Aggies,S. Latone,4399209,,True,14.0,2,5,2,5,0,0,0,0,0,0,0,0,0,0,3,0,4
401287023,Utah State Aggies,E. Harris,4281891,,True,26.0,1,9,1,5,0,4,2,2,4,3,7,2,1,0,2,0,4
401287023,Utah State Aggies,M. Pruitt,4704651,,False,13.0,1,5,1,4,0,1,1,2,0,2,2,0,1,0,2,0,3
401287023,Utah State Aggies,K. Falslev,4704648,,False,20.0,3,10,1,3,2,7,2,2,0,1,1,0,1,0,1,1,10
401287023,Utah State Aggies,M. Mendazona,4704647,,False,23.0,1,3,1,2,0,1,2,2,1,2,3,0,1,0,0,1,4
401287023,Utah State Aggies,E. Emrich,4595671,,False,12.0,0,2,0,2,0,0,0,0,0,2,2,1,0,0,2,1,0
401287023,Utah State Aggies,K. Kamakawiwo'ole,4595670,,False,18.0,2,7,2,7,0,0,1,2,2,1,3,1,0,1,2,2,5
401287023,Utah State Aggies,TEAM,TOTAL,TOTAL,False,,13,60,11,44,2,16,13,15,13,20,33,7,8,2,15,8,41
401287023,Utah State Aggies,T. Franson,4281892,,True,20.0,1,5,1,3,0,2,2,2,1,0,1,0,0,1,1,1,4
401287023,Utah State Aggies,J. Chatman,4068281,,True,27.0,1,8,1,7,0,1,0,0,0,2,2,1,2,0,0,0,2
401287023,Utah State Aggies,F. Brantley,4595669,,True,27.0,1,6,1,6,0,0,3,3,2,3,5,2,2,0,2,2,5
401287023,Utah State Aggies,S. Latone,4399209,,True,14.0,2,5,2,5,0,0,0,0,0,0,0,0,0,0,3,0,4
401287023,Utah State Aggies,E. Harris,4281891,,True,26.0,1,9,1,5,0,4,2,2,4,3,7,2,1,0,2,0,4
401287023,Utah State Aggies,M. Pruitt,4704651,,False,13.0,1,5,1,4,0,1,1,2,0,2,2,0,1,0,2,0,3
401287023,Utah State Aggies,K. Falslev,4704648,,False,20.0,3,10,1,3,2,7,2,2,0,1,1,0,1,0,1,1,10
401287023,Utah State Aggies,M. Mendazona,4704647,,False,23.0,1,3,1,2,0,1,2,2,1,2,3,0,1,0,0,1,4
401287023,Utah State Aggies,E. Emrich,4595671,,False,12.0,0,2,0,2,0,0,0,0,0,2,2,1,0,0,2,1,0
401287023,Utah State Aggies,K. Kamakawiwo'ole,4595670,,False,18.0,2,7,2,7,0,0,1,2,2,1,3,1,0,1,2,2,5
401287023,Utah State Aggies,TEAM,TOTAL,TOTAL,False,,13,60,11,44,2,16,13,15,13,20,33,7,8,2,15,8,41
401283305,Utah State Aggies,T. Franson,4281892,,True,28.0,0,3,0,3,0,0,2,2,3,4,7,1,0,0,5,0,2
401283305,Utah State Aggies,J. Chatman,4068281,,True,33.0,9,18,7,13,2,5,1,2,1,10,11,2,0,0,3,2,21
401283305,Utah State Aggies,F. Brantley,4595669,,True,30.0,0,2,0,2,0,0,0,0,2,4,6,5,0,0,4,2,0
401283305,Utah State Aggies,S. Latone,4399209,,True,35.0,11,25,2,8,9,17,2,2,0,3,3,2,2,0,1,3,33
401283305,Utah State Aggies,E. Harris,4281891,,True,32.0,0,4,0,0,0,4,0,0,1,1,2,6,1,0,1,1,0
401283305,Utah State Aggies,E. Jarrell,4704653,,False,2.0,0,2,0,2,0,0,0,0,0,0,0,0,0,0,0,0,0
401283305,Utah State Aggies,M. Pruitt,4704651,,False,5.0,0,2,0,2,0,0,0,0,0,0,0,0,0,0,0,2,0
401283305,Utah State Aggies,K. Falslev,4704648,,False,15.0,2,5,0,0,2,5,1,1,0,0,0,0,0,0,1,1,7
401283305,Utah State Aggies,E. Emrich,4595671,,False,8.0,0,1,0,1,0,0,0,2,0,1,1,0,0,1,1,1,0
401283305,Utah State Aggies,K. Kamakawiwo'ole,4595670,,False,12.0,1,4,1,3,0,1,0,0,0,2,2,1,2,0,0,0,2
401283305,Utah State Aggies,TEAM,TOTAL,TOTAL,False,,23,66,10,34,13,32,6,9,8,25,33,17,5,1,16,12,65
401283305,Utah State Aggies,T. Franson,4281892,,True,28.0,0,3,0,3,0,0,2,2,3,4,7,1,0,0,5,0,2
401283305,Utah State Aggies,J. Chatman,4068281,,True,33.0,9,18,7,13,2,5,1,2,1,10,11,2,0,0,3,2,21
401283305,Utah State Aggies,F. Brantley,4595669,,True,30.0,0,2,0,2,0,0,0,0,2,4,6,5,0,0,4,2,0
401283305,Utah State Aggies,S. Latone,4399209,,True,35.0,11,25,2,8,9,17,2,2,0,3,3,2,2,0,1,3,33
401283305,Utah State Aggies,E. Harris,4281891,,True,32.0,0,4,0,0,0,4,0,0,1,1,2,6,1,0,1,1,0
401283305,Utah State Aggies,E. Jarrell,4704653,,False,2.0,0,2,0,2,0,0,0,0,0,0,0,0,0,0,0,0,0
401283305,Utah State Aggies,M. Pruitt,4704651,,False,5.0,0,2,0,2,0,0,0,0,0,0,0,0,0,0,0,2,0
401283305,Utah State Aggies,K. Falslev,4704648,,False,15.0,2,5,0,0,2,5,1,1,0,0,0,0,0,0,1,1,7
401283305,Utah State Aggies,E. Emrich,4595671,,False,8.0,0,1,0,1,0,0,0,2,0,1,1,0,0,1,1,1,0
401283305,Utah State Aggies,K. Kamakawiwo'ole,4595670,,False,12.0,1,4,1,3,0,1,0,0,0,2,2,1,2,0,0,0,2
401283305,Utah State Aggies,TEAM,TOTAL,TOTAL,False,,23,66,10,34,13,32,6,9,8,25,33,17,5,1,16,12,65
401283305,New Mexico Lobos,S. McGruder,4400149,,True,13.0,2,4,2,4,0,0,1,2,1,5,6,1,2,1,2,2,5
401283305,New Mexico Lobos,A. Anderson,4281834,,True,25.0,7,12,4,5,3,7,2,4,0,6,6,0,2,0,3,1,19
401283305,New Mexico Lobos,Lato. Duff,4704520,,True,29.0,1,3,0,0,1,3,0,0,0,4,4,9,0,0,0,2,3
401283305,New Mexico Lobos,Lata. Duff,4704519,,True,28.0,8,13,2,6,6,7,3,3,0,4,4,4,1,0,1,2,25
401283305,New Mexico Lobos,J. De La Cerda,4281833,,True,25.0,8,15,6,11,2,4,4,4,1,2,3,0,1,0,0,2,22
401283305,New Mexico Lobos,C. Dupont,4595646,,False,6.0,0,2,0,0,0,2,0,0,0,0,0,0,0,0,1,0,0
401283305,New Mexico Lobos,A. Watts,4433688,,False,22.0,0,1,0,0,0,1,0,0,1,5,6,1,1,2,0,2,0
401283305,New Mexico Lobos,A. Robinson,4432993,,False,7.0,3,3,3,3,0,0,0,0,1,0,1,0,0,0,0,0,6
401283305,New Mexico Lobos,N. Parkinson,4704523,,False,3.0,0,2,0,1,0,1,0,0,0,2,2,0,0,0,0,0,0
401283305,New Mexico Lobos,K. van Bennekom,4704522,,False,9.0,1,1,1,1,0,0,1,2,0,2,2,0,0,0,0,0,3
401283305,New Mexico Lobos,C. Carter,4433646,,False,11.0,1,1,0,0,1,1,0,0,0,2,2,2,0,0,1,0,3
401283305,New Mexico Lobos,A. Hurst,4400147,,False,22.0,4,7,3,4,1,3,2,2,0,2,2,2,3,0,2,2,11
401283305,New Mexico Lobos,TEAM,TOTAL,TOTAL,False,,35,64,21,35,14,29,13,17,6,37,43,19,10,3,10,13,97
401283305,New Mexico Lobos,S. McGruder,4400149,,True,13.0,2,4,2,4,0,0,1,2,1,5,6,1,2,1,2,2,5
401283305,New Mexico Lobos,A. Anderson,4281834,,True,25.0,7,12,4,5,3,7,2,4,0,6,6,0,2,0,3,1,19
401283305,New Mexico Lobos,Lato. Duff,4704520,,True,29.0,1,3,0,0,1,3,0,0,0,4,4,9,0,0,0,2,3
401283305,New Mexico Lobos,Lata. Duff,4704519,,True,28.0,8,13,2,6,6,7,3,3,0,4,4,4,1,0,1,2,25
401283305,New Mexico Lobos,J. De La Cerda,4281833,,True,25.0,8,15,6,11,2,4,4,4,1,2,3,0,1,0,0,2,22
401283305,New Mexico Lobos,C. Dupont,4595646,,False,6.0,0,2,0,0,0,2,0,0,0,0,0,0,0,0,1,0,0
401283305,New Mexico Lobos,A. Watts,4433688,,False,22.0,0,1,0,0,0,1,0,0,1,5,6,1,1,2,0,2,0
401283305,New Mexico Lobos,A. Robinson,4432993,,False,7.0,3,3,3,3,0,0,0,0,1,0,1,0,0,0,0,0,6
401283305,New Mexico Lobos,N. Parkinson,4704523,,False,3.0,0,2,0,1,0,1,0,0,0,2,2,0,0,0,0,0,0
401283305,New Mexico Lobos,K. van Bennekom,4704522,,False,9.0,1,1,1,1,0,0,1,2,0,2,2,0,0,0,0,0,3
401283305,New Mexico Lobos,C. Carter,4433646,,False,11.0,1,1,0,0,1,1,0,0,0,2,2,2,0,0,1,0,3
401283305,New Mexico Lobos,A. Hurst,4400147,,False,22.0,4,7,3,4,1,3,2,2,0,2,2,2,3,0,2,2,11
401283305,New Mexico Lobos,TEAM,TOTAL,TOTAL,False,,35,64,21,35,14,29,13,17,6,37,43,19,10,3,10,13,97
401283304,Utah State Aggies,T. Franson,4281892,,True,28.0,7,13,7,13,0,0,0,1,3,10,13,2,0,1,2,2,14
401283304,Utah State Aggies,J. Chatman,4068281,,True,27.0,3,8,3,7,0,1,7,8,1,1,2,0,1,0,3,1,13
401283304,Utah State Aggies,F. Brantley,4595669,,True,12.0,1,4,1,3,0,1,3,3,0,1,1,1,1,0,0,2,5
401283304,Utah State Aggies,S. Latone,4399209,,True,19.0,1,11,0,3,1,8,2,2,2,3,5,2,0,0,2,1,5
401283304,Utah State Aggies,E. Harris,4281891,,True,28.0,2,5,1,4,1,1,0,0,0,1,1,2,0,0,2,0,5
401283304,Utah State Aggies,E. Jarrell,4704653,,False,10.0,1,3,1,3,0,0,0,0,1,1,2,0,0,1,0,1,2
401283304,Utah State Aggies,M. Pruitt,4704651,,False,5.0,0,2,0,2,0,0,0,0,0,0,0,0,0,1,1,0,0
401283304,Utah State Aggies,A. Lustgarten,4704649,,False,3.0,0,0,0,0,0,0,0,0,0,1,1,0,0,0,0,0,0
401283304,Utah State Aggies,K. Falslev,4704648,,False,17.0,1,8,0,0,1,8,0,0,0,1,1,1,0,0,0,2,3
401283304,Utah State Aggies,M. Mendazona,4704647,,False,15.0,1,2,1,2,0,0,0,0,0,3,3,2,0,0,1,0,2
401283304,Utah State Aggies,J. Polansky,4595673,,False,5.0,0,2,0,0,0,2,0,0,0,0,0,0,0,0,0,0,0
401283304,Utah State Aggies,E. Emrich,4595671,,False,15.0,3,3,3,3,0,0,0,1,0,0,0,0,0,1,2,2,6
401283304,Utah State Aggies,K. Kamakawiwo'ole,4595670,,False,16.0,0,2,0,1,0,1,0,0,1,4,5,2,0,0,4,0,0
401283304,Utah State Aggies,TEAM,TOTAL,TOTAL,False,,20,63,17,41,3,22,12,15,11,30,41,12,2,4,17,11,55
401283304,Utah State Aggies,T. Franson,4281892,,True,28.0,7,13,7,13,0,0,0,1,3,10,13,2,0,1,2,2,14
401283304,Utah State Aggies,J. Chatman,4068281,,True,27.0,3,8,3,7,0,1,7,8,1,1,2,0,1,0,3,1,13
401283304,Utah State Aggies,F. Brantley,4595669,,True,12.0,1,4,1,3,0,1,3,3,0,1,1,1,1,0,0,2,5
401283304,Utah State Aggies,S. Latone,4399209,,True,19.0,1,11,0,3,1,8,2,2,2,3,5,2,0,0,2,1,5
401283304,Utah State Aggies,E. Harris,4281891,,True,28.0,2,5,1,4,1,1,0,0,0,1,1,2,0,0,2,0,5
401283304,Utah State Aggies,E. Jarrell,4704653,,False,10.0,1,3,1,3,0,0,0,0,1,1,2,0,0,1,0,1,2
401283304,Utah State Aggies,M. Pruitt,4704651,,False,5.0,0,2,0,2,0,0,0,0,0,0,0,0,0,1,1,0,0
401283304,Utah State Aggies,A. Lustgarten,4704649,,False,3.0,0,0,0,0,0,0,0,0,0,1,1,0,0,0,0,0,0
401283304,Utah State Aggies,K. Falslev,4704648,,False,17.0,1,8,0,0,1,8,0,0,0,1,1,1,0,0,0,2,3
401283304,Utah State Aggies,M. Mendazona,4704647,,False,15.0,1,2,1,2,0,0,0,0,0,3,3,2,0,0,1,0,2
401283304,Utah State Aggies,J. Polansky,4595673,,False,5.0,0,2,0,0,0,2,0,0,0,0,0,0,0,0,0,0,0
401283304,Utah State Aggies,E. Emrich,4595671,,False,15.0,3,3,3,3,0,0,0,1,0,0,0,0,0,1,2,2,6
401283304,Utah State Aggies,K. Kamakawiwo'ole,4595670,,False,16.0,0,2,0,1,0,1,0,0,1,4,5,2,0,0,4,0,0
401283304,Utah State Aggies,TEAM,TOTAL,TOTAL,False,,20,63,17,41,3,22,12,15,11,30,41,12,2,4,17,11,55
401283304,New Mexico Lobos,S. McGruder,4400149,,True,20.0,2,4,2,3,0,1,0,0,1,2,3,0,1,1,1,3,4
401283304,New Mexico Lobos,A. Anderson,4281834,,True,23.0,4,13,3,9,1,4,0,0,2,7,9,4,1,2,1,1,9
401283304,New Mexico Lobos,Lato. Duff,4704520,,True,21.0,4,6,1,2,3,4,0,1,0,4,4,5,0,0,0,2,11
401283304,New Mexico Lobos,Lata. Duff,4704519,,True,23.0,9,12,3,3,6,9,4,4,0,2,2,4,1,0,1,3,28
401283304,New Mexico Lobos,J. De La Cerda,4281833,,True,21.0,4,12,3,8,1,4,2,2,3,4,7,2,1,0,1,1,11
401283304,New Mexico Lobos,C. Dupont,4595646,,False,5.0,0,2,0,1,0,1,0,0,0,0,0,0,0,0,0,0,0
401283304,New Mexico Lobos,A. Watts,4433688,,False,16.0,1,2,1,2,0,0,0,0,2,3,5,2,1,1,0,0,2
401283304,New Mexico Lobos,A. Robinson,4432993,,False,8.0,2,2,2,2,0,0,0,0,0,0,0,0,0,1,0,1,4
401283304,New Mexico Lobos,N. Parkinson,4704523,,False,3.0,0,2,0,1,0,1,0,0,0,0,0,0,0,0,0,0,0
401283304,New Mexico Lobos,K. van Bennekom,4704522,,False,12.0,0,1,0,1,0,0,0,2,0,0,0,0,2,0,0,3,0
401283304,New Mexico Lobos,C. Carter,4433646,,False,25.0,5,10,3,4,2,6,0,0,0,4,4,2,0,0,1,0,12
401283304,New Mexico Lobos,A. Hurst,4400147,,False,23.0,5,11,3,4,2,7,0,0,1,2,3,3,1,0,1,0,12
401283304,New Mexico Lobos,TEAM,TOTAL,TOTAL,False,,36,77,21,40,15,37,6,9,12,34,46,22,8,5,6,14,93
401283304,New Mexico Lobos,S. McGruder,4400149,,True,20.0,2,4,2,3,0,1,0,0,1,2,3,0,1,1,1,3,4
401283304,New Mexico Lobos,A. Anderson,4281834,,True,23.0,4,13,3,9,1,4,0,0,2,7,9,4,1,2,1,1,9
401283304,New Mexico Lobos,Lato. Duff,4704520,,True,21.0,4,6,1,2,3,4,0,1,0,4,4,5,0,0,0,2,11
401283304,New Mexico Lobos,Lata. Duff,4704519,,True,23.0,9,12,3,3,6,9,4,4,0,2,2,4,1,0,1,3,28
401283304,New Mexico Lobos,J. De La Cerda,4281833,,True,21.0,4,12,3,8,1,4,2,2,3,4,7,2,1,0,1,1,11
401283304,New Mexico Lobos,C. Dupont,4595646,,False,5.0,0,2,0,1,0,1,0,0,0,0,0,0,0,0,0,0,0
401283304,New Mexico Lobos,A. Watts,4433688,,False,16.0,1,2,1,2,0,0,0,0,2,3,5,2,1,1,0,0,2
401283304,New Mexico Lobos,A. Robinson,4432993,,False,8.0,2,2,2,2,0,0,0,0,0,0,0,0,0,1,0,1,4
401283304,New Mexico Lobos,N. Parkinson,4704523,,False,3.0,0,2,0,1,0,1,0,0,0,0,0,0,0,0,0,0,0
401283304,New Mexico Lobos,K. van Bennekom,4704522,,False,12.0,0,1,0,1,0,0,0,2,0,0,0,0,2,0,0,3,0
401283304,New Mexico Lobos,C. Carter,4433646,,False,25.0,5,10,3,4,2,6,0,0,0,4,4,2,0,0,1,0,12
401283304,New Mexico Lobos,A. Hurst,4400147,,False,23.0,5,11,3,4,2,7,0,0,1,2,3,3,1,0,1,0,12
401283304,New Mexico Lobos,TEAM,TOTAL,TOTAL,False,,36,77,21,40,15,37,6,9,12,34,46,22,8,5,6,14,93
401283303,UNLV Lady Rebels,D. Byrne,4398924,,True,32.0,3,7,0,3,3,4,2,2,1,8,9,0,0,2,1,2,11
401283303,UNLV Lady Rebels,D. Young,4704625,,True,31.0,7,22,7,22,0,0,6,8,6,6,12,1,0,0,2,1,20
401283303,UNLV Lady Rebels,J. Thomas,4704624,,True,37.0,4,9,3,5,1,4,4,4,0,3,3,1,0,0,0,1,13
401283303,UNLV Lady Rebels,N. Johnson,4400108,,True,31.0,3,13,1,7,2,6,4,4,1,9,10,2,0,0,1,2,12
401283303,UNLV Lady Rebels,B. Thomas,4068210,,True,40.0,3,6,1,3,2,3,4,6,1,2,3,7,1,0,2,0,12
401283303,UNLV Lady Rebels,A. Blount,4595640,,False,14.0,1,4,1,4,0,0,3,3,2,3,5,0,0,0,2,4,5
401283303,UNLV Lady Rebels,K. Wilfred,4595641,,False,3.0,0,0,0,0,0,0,0,0,0,0,0,0,0,0,1,0,0
401283303,UNLV Lady Rebels,J. Singleton,4704623,,False,6.0,0,0,0,0,0,0,0,0,0,0,0,0,0,0,1,0,0
401283303,UNLV Lady Rebels,J. Buckley,4595639,,False,6.0,0,1,0,0,0,1,0,0,0,1,1,0,0,0,1,0,0
401283303,UNLV Lady Rebels,TEAM,TOTAL,TOTAL,False,,21,62,13,44,8,18,23,27,17,35,52,11,1,2,12,10,73
401283303,UNLV Lady Rebels,D. Byrne,4398924,,True,32.0,3,7,0,3,3,4,2,2,1,8,9,0,0,2,1,2,11
401283303,UNLV Lady Rebels,D. Young,4704625,,True,31.0,7,22,7,22,0,0,6,8,6,6,12,1,0,0,2,1,20
401283303,UNLV Lady Rebels,J. Thomas,4704624,,True,37.0,4,9,3,5,1,4,4,4,0,3,3,1,0,0,0,1,13
401283303,UNLV Lady Rebels,N. Johnson,4400108,,True,31.0,3,13,1,7,2,6,4,4,1,9,10,2,0,0,1,2,12
401283303,UNLV Lady Rebels,B. Thomas,4068210,,True,40.0,3,6,1,3,2,3,4,6,1,2,3,7,1,0,2,0,12
401283303,UNLV Lady Rebels,A. Blount,4595640,,False,14.0,1,4,1,4,0,0,3,3,2,3,5,0,0,0,2,4,5
401283303,UNLV Lady Rebels,K. Wilfred,4595641,,False,3.0,0,0,0,0,0,0,0,0,0,0,0,0,0,0,1,0,0
401283303,UNLV Lady Rebels,J. Singleton,4704623,,False,6.0,0,0,0,0,0,0,0,0,0,0,0,0,0,0,1,0,0
401283303,UNLV Lady Rebels,J. Buckley,4595639,,False,6.0,0,1,0,0,0,1,0,0,0,1,1,0,0,0,1,0,0
401283303,UNLV Lady Rebels,TEAM,TOTAL,TOTAL,False,,21,62,13,44,8,18,23,27,17,35,52,11,1,2,12,10,73
401283303,San Diego State Aztecs,K. Gipson,4704563,,True,22.0,2,3,2,3,0,0,0,4,3,7,10,2,1,2,2,4,4
401283303,San Diego State Aztecs,M. Adams,4400169,,True,17.0,3,11,1,4,2,7,0,0,0,1,1,0,0,0,0,2,8
401283303,San Diego State Aztecs,S. Ramos,4400168,,True,37.0,3,9,3,6,0,3,0,0,0,3,3,10,0,0,1,2,6
401283303,San Diego State Aztecs,M. Staples,4398925,,True,31.0,7,14,5,10,2,4,0,0,0,3,3,1,0,0,0,1,16
401283303,San Diego State Aztecs,T. Adams,4281876,,True,27.0,4,6,3,4,1,2,3,4,0,3,3,4,1,0,0,5,12
401283303,San Diego State Aztecs,F. Vinerte,4704564,,False,9.0,1,2,1,2,0,0,0,0,0,0,0,1,0,1,0,3,2
401283303,San Diego State Aztecs,K. Edwards,4281879,,False,8.0,2,4,2,4,0,0,0,0,1,0,1,0,1,0,0,4,4
401283303,San Diego State Aztecs,K. Villalobos,4704565,,False,13.0,2,6,2,5,0,1,3,4,2,1,3,1,1,0,0,0,7
401283303,San Diego State Aztecs,I. Hernandez,4595647,,False,22.0,2,5,0,1,2,4,0,0,0,1,1,1,0,0,0,1,6
401283303,San Diego State Aztecs,A. Crain,4399223,,False,14.0,3,7,3,5,0,2,0,0,0,0,0,3,1,0,1,0,6
401283303,San Diego State Aztecs,TEAM,TOTAL,TOTAL,False,,29,67,22,44,7,23,6,12,7,24,31,23,5,3,4,22,71
401283303,San Diego State Aztecs,K. Gipson,4704563,,True,22.0,2,3,2,3,0,0,0,4,3,7,10,2,1,2,2,4,4
401283303,San Diego State Aztecs,M. Adams,4400169,,True,17.0,3,11,1,4,2,7,0,0,0,1,1,0,0,0,0,2,8
401283303,San Diego State Aztecs,S. Ramos,4400168,,True,37.0,3,9,3,6,0,3,0,0,0,3,3,10,0,0,1,2,6
401283303,San Diego State Aztecs,M. Staples,4398925,,True,31.0,7,14,5,10,2,4,0,0,0,3,3,1,0,0,0,1,16
401283303,San Diego State Aztecs,T. Adams,4281876,,True,27.0,4,6,3,4,1,2,3,4,0,3,3,4,1,0,0,5,12
401283303,San Diego State Aztecs,F. Vinerte,4704564,,False,9.0,1,2,1,2,0,0,0,0,0,0,0,1,0,1,0,3,2
401283303,San Diego State Aztecs,K. Edwards,4281879,,False,8.0,2,4,2,4,0,0,0,0,1,0,1,0,1,0,0,4,4
401283303,San Diego State Aztecs,K. Villalobos,4704565,,False,13.0,2,6,2,5,0,1,3,4,2,1,3,1,1,0,0,0,7
401283303,San Diego State Aztecs,I. Hernandez,4595647,,False,22.0,2,5,0,1,2,4,0,0,0,1,1,1,0,0,0,1,6
401283303,San Diego State Aztecs,A. Crain,4399223,,False,14.0,3,7,3,5,0,2,0,0,0,0,0,3,1,0,1,0,6
401283303,San Diego State Aztecs,TEAM,TOTAL,TOTAL,False,,29,67,22,44,7,23,6,12,7,24,31,23,5,3,4,22,71
401283301,UNLV Lady Rebels,D. Byrne,4398924,,True,30.0,5,12,3,7,2,5,3,4,1,7,8,1,0,3,3,1,15
401283301,UNLV Lady Rebels,D. Young,4704625,,True,22.0,4,6,4,6,0,0,4,6,3,6,9,0,0,0,2,3,12
401283301,UNLV Lady Rebels,J. Thomas,4704624,,True,32.0,0,3,0,0,0,3,0,0,0,6,6,5,2,0,1,1,0
401283301,UNLV Lady Rebels,N. Johnson,4400108,,True,33.0,9,22,5,13,4,9,0,0,1,4,5,0,3,0,1,1,22
401283301,UNLV Lady Rebels,B. Thomas,4068210,,True,28.0,1,2,0,1,1,1,4,6,1,1,2,8,0,0,0,2,7
401283301,UNLV Lady Rebels,T. Carter,4595642,,False,5.0,1,1,1,1,0,0,1,2,0,1,1,0,0,0,0,0,3
401283301,UNLV Lady Rebels,A. Blount,4595640,,False,13.0,5,7,5,7,0,0,1,1,0,2,2,0,0,0,0,2,11
401283301,UNLV Lady Rebels,K. Wilfred,4595641,,False,10.0,2,3,2,3,0,0,0,0,1,0,1,0,0,1,0,2,4
401283301,UNLV Lady Rebels,J. Singleton,4704623,,False,14.0,0,1,0,1,0,0,0,0,0,3,3,3,0,0,1,2,0
401283301,UNLV Lady Rebels,C. Gurrola,4595644,,False,1.0,0,1,0,0,0,1,0,0,0,0,0,0,0,0,0,0,0
401283301,UNLV Lady Rebels,J. Buckley,4595639,,False,12.0,2,3,0,0,2,3,0,0,0,3,3,3,0,1,1,1,6
401283301,UNLV Lady Rebels,TEAM,TOTAL,TOTAL,False,,29,61,20,39,9,22,13,19,8,35,43,20,5,5,9,15,80
401283301,UNLV Lady Rebels,D. Byrne,4398924,,True,30.0,5,12,3,7,2,5,3,4,1,7,8,1,0,3,3,1,15
401283301,UNLV Lady Rebels,D. Young,4704625,,True,22.0,4,6,4,6,0,0,4,6,3,6,9,0,0,0,2,3,12
401283301,UNLV Lady Rebels,J. Thomas,4704624,,True,32.0,0,3,0,0,0,3,0,0,0,6,6,5,2,0,1,1,0
401283301,UNLV Lady Rebels,N. Johnson,4400108,,True,33.0,9,22,5,13,4,9,0,0,1,4,5,0,3,0,1,1,22
401283301,UNLV Lady Rebels,B. Thomas,4068210,,True,28.0,1,2,0,1,1,1,4,6,1,1,2,8,0,0,0,2,7
401283301,UNLV Lady Rebels,T. Carter,4595642,,False,5.0,1,1,1,1,0,0,1,2,0,1,1,0,0,0,0,0,3
401283301,UNLV Lady Rebels,A. Blount,4595640,,False,13.0,5,7,5,7,0,0,1,1,0,2,2,0,0,0,0,2,11
401283301,UNLV Lady Rebels,K. Wilfred,4595641,,False,10.0,2,3,2,3,0,0,0,0,1,0,1,0,0,1,0,2,4
401283301,UNLV Lady Rebels,J. Singleton,4704623,,False,14.0,0,1,0,1,0,0,0,0,0,3,3,3,0,0,1,2,0
401283301,UNLV Lady Rebels,C. Gurrola,4595644,,False,1.0,0,1,0,0,0,1,0,0,0,0,0,0,0,0,0,0,0
401283301,UNLV Lady Rebels,J. Buckley,4595639,,False,12.0,2,3,0,0,2,3,0,0,0,3,3,3,0,1,1,1,6
401283301,UNLV Lady Rebels,TEAM,TOTAL,TOTAL,False,,29,61,20,39,9,22,13,19,8,35,43,20,5,5,9,15,80
401283301,San Diego State Aztecs,K. Gipson,4704563,,True,7.0,0,1,0,1,0,0,0,0,0,2,2,0,0,0,0,4,0
401283301,San Diego State Aztecs,M. Adams,4400169,,True,24.0,3,8,3,6,0,2,2,2,0,3,3,0,0,0,0,0,8
401283301,San Diego State Aztecs,I. Hernandez,4595647,,True,19.0,1,4,1,2,0,2,1,2,0,1,1,1,0,0,1,1,3
401283301,San Diego State Aztecs,M. Staples,4398925,,True,28.0,6,11,4,9,2,2,0,0,0,3,3,1,2,0,1,2,14
401283301,San Diego State Aztecs,T. Adams,4281876,,True,24.0,5,13,5,10,0,3,1,1,0,1,1,3,1,1,1,4,11
401283301,San Diego State Aztecs,I. Murillo,4704566,,False,5.0,0,4,0,4,0,0,0,0,1,1,2,1,0,0,0,0,0
401283301,San Diego State Aztecs,F. Vinerte,4704564,,False,15.0,3,3,2,2,1,1,0,0,1,3,4,1,1,1,2,4,7
401283301,San Diego State Aztecs,K. Edwards,4281879,,False,9.0,0,0,0,0,0,0,0,0,0,1,1,0,0,0,0,3,0
401283301,San Diego State Aztecs,K. Villalobos,4704565,,False,14.0,4,7,4,7,0,0,2,4,0,1,1,0,0,0,1,1,10
401283301,San Diego State Aztecs,S. Ramos,4400168,,False,34.0,3,8,3,6,0,2,6,6,0,5,5,1,0,0,2,2,12
401283301,San Diego State Aztecs,A. Crain,4399223,,False,21.0,0,4,0,1,0,3,0,0,0,2,2,2,0,0,0,1,0
401283301,San Diego State Aztecs,TEAM,TOTAL,TOTAL,False,,25,63,22,48,3,15,12,15,6,27,33,10,4,2,8,22,65
401283301,San Diego State Aztecs,K. Gipson,4704563,,True,7.0,0,1,0,1,0,0,0,0,0,2,2,0,0,0,0,4,0
401283301,San Diego State Aztecs,M. Adams,4400169,,True,24.0,3,8,3,6,0,2,2,2,0,3,3,0,0,0,0,0,8
401283301,San Diego State Aztecs,I. Hernandez,4595647,,True,19.0,1,4,1,2,0,2,1,2,0,1,1,1,0,0,1,1,3
401283301,San Diego State Aztecs,M. Staples,4398925,,True,28.0,6,11,4,9,2,2,0,0,0,3,3,1,2,0,1,2,14
401283301,San Diego State Aztecs,T. Adams,4281876,,True,24.0,5,13,5,10,0,3,1,1,0,1,1,3,1,1,1,4,11
401283301,San Diego State Aztecs,I. Murillo,4704566,,False,5.0,0,4,0,4,0,0,0,0,1,1,2,1,0,0,0,0,0
401283301,San Diego State Aztecs,F. Vinerte,4704564,,False,15.0,3,3,2,2,1,1,0,0,1,3,4,1,1,1,2,4,7
401283301,San Diego State Aztecs,K. Edwards,4281879,,False,9.0,0,0,0,0,0,0,0,0,0,1,1,0,0,0,0,3,0
401283301,San Diego State Aztecs,K. Villalobos,4704565,,False,14.0,4,7,4,7,0,0,2,4,0,1,1,0,0,0,1,1,10
401283301,San Diego State Aztecs,S. Ramos,4400168,,False,34.0,3,8,3,6,0,2,6,6,0,5,5,1,0,0,2,2,12
401283301,San Diego State Aztecs,A. Crain,4399223,,False,21.0,0,4,0,1,0,3,0,0,0,2,2,2,0,0,0,1,0
401283301,San Diego State Aztecs,TEAM,TOTAL,TOTAL,False,,25,63,22,48,3,15,12,15,6,27,33,10,4,2,8,22,65
401277133,Fresno State Bulldogs,W. Motta,4595631,,True,24.0,6,10,6,10,0,0,1,2,2,1,3,0,2,0,1,1,13
401277133,Fresno State Bulldogs,B. Walling,4595632,,True,28.0,2,6,2,5,0,1,6,6,4,2,6,3,1,3,0,5,10
401277133,Fresno State Bulldogs,Y. Todorova,4704475,,True,29.0,1,9,1,3,0,6,1,2,3,0,3,1,1,0,0,0,3
401277133,Fresno State Bulldogs,Hal. Cavinder,4433658,,True,38.0,6,18,5,9,1,9,2,2,2,6,8,1,3,0,4,3,15
401277133,Fresno State Bulldogs,Han. Cavinder,4433372,,True,38.0,5,16,4,12,1,4,5,5,0,3,3,5,1,0,1,3,16
401277133,Fresno State Bulldogs,K. Kinzer,4595630,,False,17.0,3,5,0,0,3,5,0,2,1,2,3,1,1,0,0,0,9
401277133,Fresno State Bulldogs,A. James,4433292,,False,5.0,0,2,0,1,0,1,0,0,0,0,0,1,0,0,0,0,0
401277133,Fresno State Bulldogs,G. Ogier,4281827,,False,13.0,1,1,1,1,0,0,1,2,4,2,6,0,0,0,2,3,3
401277133,Fresno State Bulldogs,M. Guimaraes,4704476,,False,8.0,0,2,0,2,0,0,0,0,1,3,4,0,0,0,0,0,0
401277133,Fresno State Bulldogs,TEAM,TOTAL,TOTAL,False,,24,69,19,43,5,26,16,21,17,19,36,12,9,3,8,15,69
401277133,Cal State Bakersfield Roadrunners,J. Eggleston,4282084,,True,35.0,3,5,3,5,0,0,7,8,5,8,13,4,0,0,0,0,13
401277133,Cal State Bakersfield Roadrunners,V. Austin,4282306,,True,18.0,4,8,4,8,0,0,0,0,2,2,4,0,0,0,2,3,8
401277133,Cal State Bakersfield Roadrunners,M. Saxon,4400107,,True,33.0,5,10,4,6,1,4,2,3,1,3,4,1,3,1,3,2,13
401277133,Cal State Bakersfield Roadrunners,L. Green,4595878,,True,33.0,5,11,3,5,2,6,2,4,0,7,7,6,0,1,5,0,14
401277133,Cal State Bakersfield Roadrunners,A. Easley,3911834,,True,28.0,4,11,0,4,4,7,0,0,1,1,2,3,0,0,0,4,12
401277133,Cal State Bakersfield Roadrunners,M. Bond,4595877,,False,10.0,3,3,3,3,0,0,0,0,3,3,6,0,0,0,0,1,6
401277133,Cal State Bakersfield Roadrunners,S. Herrera,4704358,,False,6.0,1,1,1,1,0,0,0,0,0,0,0,0,0,1,1,2,2
401277133,Cal State Bakersfield Roadrunners,S. Bridges,4704359,,False,20.0,1,4,1,3,0,1,2,2,0,5,5,1,0,0,1,2,4
401277133,Cal State Bakersfield Roadrunners,S. Tougas,4704357,,False,17.0,3,7,0,0,3,7,0,0,0,1,1,1,1,0,0,2,9
401277133,Cal State Bakersfield Roadrunners,A. Seuell,4704356,,False,0.0,0,0,0,0,0,0,0,0,0,0,0,0,0,0,0,0,0
401277133,Cal State Bakersfield Roadrunners,TEAM,TOTAL,TOTAL,False,,29,60,19,35,10,25,13,17,13,31,44,16,4,3,15,16,81
401273016,Portland State Vikings,M. Canzobre,4594854,,True,16.0,2,2,2,2,0,0,0,0,0,0,0,0,0,1,0,0,4
401273016,Portland State Vikings,T. Streun,4068737,,True,26.0,3,6,2,5,1,1,6,12,4,7,11,1,2,0,5,2,13
401273016,Portland State Vikings,J. Kilty,4704914,,True,14.0,0,1,0,0,0,1,0,0,0,0,0,0,1,0,2,1,0
401273016,Portland State Vikings,D. Hansen,4399933,,True,25.0,6,13,4,7,2,6,2,2,0,6,6,1,0,3,4,1,16
401273016,Portland State Vikings,K. Jimenez,4281683,,True,33.0,2,5,0,1,2,4,5,6,0,0,0,3,3,0,2,0,11
401273016,Portland State Vikings,R. Kelty,4704915,,False,4.0,0,1,0,1,0,0,0,0,0,0,0,0,0,0,0,1,0
401273016,Portland State Vikings,S. Schultz,4594857,,False,16.0,0,0,0,0,0,0,0,0,0,1,1,0,3,1,3,1,0
401273016,Portland State Vikings,N. Boston,4704917,,False,22.0,2,9,2,7,0,2,7,10,0,1,1,2,1,0,5,2,11
401273016,Portland State Vikings,I. Ugarte,4704916,,False,17.0,1,4,1,3,0,1,1,2,3,0,3,0,1,0,1,1,3
401273016,Portland State Vikings,J. Lewis,4594856,,False,14.0,2,6,2,5,0,1,1,1,0,0,0,1,1,0,0,2,5
401273016,Portland State Vikings,R. Walton,4281682,,False,6.0,0,2,0,1,0,1,0,0,1,0,1,0,0,0,0,1,0
401273016,Portland State Vikings,L. Denson,4281680,,False,7.0,1,4,1,4,0,0,0,0,0,1,1,0,0,0,1,0,2
401273016,Portland State Vikings,TEAM,TOTAL,TOTAL,False,,19,53,14,36,5,17,22,33,9,17,26,8,12,5,24,12,65
401273016,Air Force Falcons,N. McDonald,4595618,,True,16.0,4,6,4,5,0,1,2,3,2,1,3,1,0,0,0,4,10
401273016,Air Force Falcons,R. Snyder,4399409,,True,26.0,11,16,6,9,5,7,0,0,2,3,5,1,3,0,3,2,27
401273016,Air Force Falcons,C. Winters,4399406,,True,19.0,3,3,2,2,1,1,0,0,0,2,2,2,0,1,2,3,7
401273016,Air Force Falcons,B. Autrey-Thompson,4399404,,True,29.0,3,10,3,10,0,0,3,4,0,3,3,8,3,0,5,3,9
401273016,Air Force Falcons,E. Conroe,4281737,,True,25.0,2,4,2,4,0,0,0,0,0,4,4,1,2,0,2,2,4
401273016,Air Force Falcons,K. Jones,4704416,,False,4.0,2,2,2,2,0,0,1,2,0,2,2,1,0,0,0,1,5
401273016,Air Force Falcons,D. MacMillan,4704414,,False,15.0,2,3,2,2,0,1,0,0,0,3,3,2,0,0,1,2,4
401273016,Air Force Falcons,K. Huffman,4068225,,False,19.0,4,7,4,7,0,0,0,0,1,1,2,3,0,3,2,2,8
401273016,Air Force Falcons,S. Thomas,4704413,,False,5.0,0,1,0,1,0,0,0,0,0,1,1,0,0,0,1,1,0
401273016,Air Force Falcons,K. Pilson,4704411,,False,20.0,5,6,5,5,0,1,2,2,0,1,1,1,2,0,0,3,12
401273016,Air Force Falcons,J. Goodwin,4704410,,False,2.0,0,0,0,0,0,0,0,0,0,1,1,1,0,0,0,0,0
401273016,Air Force Falcons,K. Heath,4595614,,False,5.0,1,1,1,1,0,0,0,0,0,1,1,0,0,0,2,2,2
401273016,Air Force Falcons,A. Gadison,4399405,,False,15.0,2,5,0,1,2,4,0,0,1,2,3,1,0,0,1,0,6
401273016,Air Force Falcons,TEAM,TOTAL,TOTAL,False,,39,64,31,49,8,15,8,11,8,28,36,22,10,4,22,25,94
401270513,New Mexico Lobos,S. McGruder,4400149,,True,17.0,3,7,3,7,0,0,3,4,3,4,7,1,2,0,1,0,9
401270513,New Mexico Lobos,A. Anderson,4281834,,True,19.0,5,6,3,3,2,3,1,2,1,3,4,3,0,1,2,2,13
401270513,New Mexico Lobos,Lato. Duff,4704520,,True,25.0,4,9,1,2,3,7,2,2,1,3,4,4,1,0,1,1,13
401270513,New Mexico Lobos,A. Hurst,4400147,,True,22.0,5,10,2,2,3,8,3,3,0,4,4,4,0,0,2,1,16
401270513,New Mexico Lobos,J. De La Cerda,4281833,,True,25.0,5,15,4,10,1,5,2,2,6,5,11,6,3,0,0,2,13
401270513,New Mexico Lobos,C. Dupont,4595646,,False,7.0,0,0,0,0,0,0,0,0,0,1,1,0,0,0,1,0,0
401270513,New Mexico Lobos,A. Watts,4433688,,False,12.0,0,1,0,1,0,0,0,0,0,1,1,1,2,1,0,1,0
401270513,New Mexico Lobos,A. Robinson,4432993,,False,6.0,0,0,0,0,0,0,0,0,0,0,0,0,0,0,0,3,0
401270513,New Mexico Lobos,N. Parkinson,4704523,,False,7.0,2,2,1,1,1,1,0,0,0,2,2,0,0,1,1,4,5
401270513,New Mexico Lobos,K. van Bennekom,4704522,,False,13.0,1,3,1,1,0,2,3,4,3,2,5,0,0,0,0,3,5
401270513,New Mexico Lobos,Lata. Duff,4704519,,False,25.0,10,11,6,6,4,5,4,5,1,6,7,3,0,0,1,1,28
401270513,New Mexico Lobos,C. Carter,4433646,,False,22.0,6,13,3,5,3,8,3,4,0,3,3,5,2,0,1,3,18
401270513,New Mexico Lobos,TEAM,TOTAL,TOTAL,False,,41,77,24,38,17,39,21,26,15,38,53,27,10,3,10,21,120
401270513,Arkansas-Pine Bluff Golden Lions,N. Sam-Grant,4596272,,True,17.0,1,1,1,1,0,0,0,2,1,4,5,0,2,1,2,1,2
401270513,Arkansas-Pine Bluff Golden Lions,K. Brown,4072555,,True,34.0,7,15,7,13,0,2,8,9,4,8,12,2,0,4,0,3,22
401270513,Arkansas-Pine Bluff Golden Lions,K. Walker,4704060,,True,38.0,6,16,5,11,1,5,4,6,0,5,5,5,1,0,6,1,17
401270513,Arkansas-Pine Bluff Golden Lions,J. Bethea,4704058,,True,21.0,1,6,1,5,0,1,4,7,3,3,6,1,2,0,4,5,6
401270513,Arkansas-Pine Bluff Golden Lions,T. Pyburn,4596269,,True,25.0,1,10,0,5,1,5,0,0,0,1,1,2,0,0,3,2,3
401270513,Arkansas-Pine Bluff Golden Lions,M. Peat,4704064,,False,13.0,2,5,2,5,0,0,0,0,1,0,1,0,0,1,0,0,4
401270513,Arkansas-Pine Bluff Golden Lions,M. Cotton,4704063,,False,7.0,0,0,0,0,0,0,0,0,0,0,0,0,0,0,0,1,0
401270513,Arkansas-Pine Bluff Golden Lions,A. Green,4704057,,False,34.0,3,8,2,3,1,5,5,9,0,1,1,2,1,0,0,3,12
401270513,Arkansas-Pine Bluff Golden Lions,J. Anderson,4596271,,False,11.0,0,4,0,2,0,2,0,0,0,0,0,2,0,0,0,0,0
401270513,Arkansas-Pine Bluff Golden Lions,TEAM,TOTAL,TOTAL,False,,21,65,18,45,3,20,21,33,12,25,37,14,6,6,15,16,66
401269073,Sacramento State Hornets,N. Munguia,4704913,,True,27.0,0,6,0,6,0,0,1,2,0,5,5,1,0,2,2,5,1
401269073,Sacramento State Hornets,J. Rios,4704911,,True,32.0,2,7,1,3,1,4,0,0,2,0,2,1,1,0,2,0,5
401269073,Sacramento State Hornets,S. Abney,4399940,,True,37.0,3,5,2,2,1,3,0,0,0,4,4,3,1,0,1,1,7
401269073,Sacramento State Hornets,E. Enochs,4399939,,True,37.0,5,13,2,8,3,5,1,2,2,3,5,2,2,0,8,1,14
401269073,Sacramento State Hornets,S. Menke,4399937,,True,39.0,9,18,6,14,3,4,0,2,2,11,13,1,1,1,3,2,21
401269073,Sacramento State Hornets,B. Panfili,4399936,,False,28.0,2,7,1,2,1,5,0,0,0,2,2,1,0,0,1,0,5
401269073,Sacramento State Hornets,TEAM,TOTAL,TOTAL,False,,21,56,12,35,9,21,2,6,9,28,37,9,5,3,18,9,53
401269073,Nevada Wolf Pack,A. Jimenez,4595635,,True,33.0,2,9,1,4,1,5,0,0,3,5,8,2,1,2,1,2,5
401269073,Nevada Wolf Pack,L. Johnson,4595634,,True,14.0,2,4,1,3,1,1,1,1,0,4,4,3,0,1,2,3,6
401269073,Nevada Wolf Pack,A. West,4400134,,True,30.0,6,14,6,13,0,1,1,1,1,5,6,1,0,2,1,1,13
401269073,Nevada Wolf Pack,D. Hamilton,4400132,,True,34.0,3,12,3,8,0,4,3,5,2,6,8,3,2,0,0,4,9
401269073,Nevada Wolf Pack,N. Alexander,4068433,,True,26.0,9,17,9,17,0,0,0,0,2,1,3,2,1,0,0,3,18
401269073,Nevada Wolf Pack,E. Stebetakova,4704509,,False,5.0,0,1,0,1,0,0,0,0,0,0,0,0,0,0,1,1,0
401269073,Nevada Wolf Pack,L. Givens,4704506,,False,18.0,3,8,3,7,0,1,0,0,4,2,6,1,0,2,1,1,6
401269073,Nevada Wolf Pack,G. Rones,4704505,,False,15.0,1,3,1,1,0,2,0,0,1,0,1,1,1,0,0,0,2
401269073,Nevada Wolf Pack,K. Holt,4704503,,False,25.0,1,6,0,1,1,5,0,0,2,2,4,5,3,0,3,0,3
401269073,Nevada Wolf Pack,TEAM,TOTAL,TOTAL,False,,27,74,24,55,3,19,5,7,18,27,45,18,8,7,12,15,62
401269013,Western Colorado Mountaineers,M. Parker,4599561,,True,20.0,7,9,7,9,0,0,1,3,2,5,7,0,1,0,2,2,15
401269013,Western Colorado Mountaineers,J. Erickson,4599558,,True,32.0,3,6,3,5,0,1,1,2,1,9,10,7,1,0,7,3,7
401269013,Western Colorado Mountaineers,S. Coleman,4599565,,True,28.0,5,12,2,3,3,9,2,3,1,3,4,2,1,0,4,2,15
401269013,Western Colorado Mountaineers,T. Coleman,4599564,,True,28.0,0,2,0,0,0,2,0,0,0,0,0,0,2,1,0,0,0
401269013,Western Colorado Mountaineers,H. Cooper,4599556,,True,24.0,2,6,2,5,0,1,5,6,0,2,2,3,0,0,4,3,9
401269013,Western Colorado Mountaineers,J. Kanzler,4599567,,False,19.0,6,8,6,8,0,0,1,2,1,3,4,1,1,0,0,2,13
401269013,Western Colorado Mountaineers,N. Trevizo-Medina,4706383,,False,4.0,0,0,0,0,0,0,0,0,0,1,1,0,0,0,1,1,0
401269013,Western Colorado Mountaineers,E. Wagstaff,4706382,,False,23.0,4,6,0,2,4,4,2,2,0,0,0,1,0,0,1,1,14
401269013,Western Colorado Mountaineers,C. Humbarger,4599566,,False,8.0,0,1,0,1,0,0,4,4,1,3,4,0,0,0,3,1,4
401269013,Western Colorado Mountaineers,P. Bacon,4599555,,False,14.0,0,0,0,0,0,0,0,0,0,2,2,1,0,0,3,2,0
401269013,Western Colorado Mountaineers,TEAM,TOTAL,TOTAL,False,,27,50,20,33,7,17,16,22,7,31,38,15,6,1,26,17,77
401269013,Air Force Falcons,R. Snyder,4399409,,True,39.0,8,23,5,17,3,6,5,6,4,5,9,0,2,1,4,3,24
401269013,Air Force Falcons,K. Huffman,4068225,,True,31.0,3,4,3,4,0,0,2,5,2,4,6,0,1,3,2,4,8
401269013,Air Force Falcons,C. Winters,4399406,,True,24.0,1,9,1,6,0,3,0,0,1,3,4,4,5,0,1,5,2
401269013,Air Force Falcons,A. Gadison,4399405,,True,32.0,0,4,0,1,0,3,0,0,0,1,1,1,2,0,3,3,0
401269013,Air Force Falcons,B. Autrey-Thompson,4399404,,True,35.0,11,16,11,15,0,1,4,4,0,4,4,5,7,0,3,5,26
401269013,Air Force Falcons,K. Pilson,4704411,,False,31.0,3,6,3,4,0,2,2,2,0,1,1,0,2,0,1,3,8
401269013,Air Force Falcons,J. Goodwin,4704410,,False,8.0,1,3,1,3,0,0,0,0,0,1,1,0,0,0,0,1,2
401269013,Air Force Falcons,TEAM,TOTAL,TOTAL,False,,27,65,24,50,3,15,13,17,8,20,28,10,19,4,14,24,70
401267148,UNLV Lady Rebels,D. Byrne,4398924,,True,30.0,1,9,0,4,1,5,1,4,0,3,3,2,0,1,2,1,4
401267148,UNLV Lady Rebels,K. Wilfred,4595641,,True,14.0,0,2,0,2,0,0,0,0,0,1,1,0,0,0,3,0,0
401267148,UNLV Lady Rebels,J. Thomas,4704624,,True,22.0,1,3,0,1,1,2,0,0,0,1,1,1,1,0,5,4,3
401267148,UNLV Lady Rebels,N. Johnson,4400108,,True,18.0,3,11,0,5,3,6,3,4,1,4,5,0,0,0,1,1,12
401267148,UNLV Lady Rebels,B. Thomas,4068210,,True,38.0,3,9,2,8,1,1,3,4,0,0,0,1,1,0,3,0,10
401267148,UNLV Lady Rebels,T. Carter,4595642,,False,2.0,0,2,0,0,0,2,0,0,1,1,2,1,0,0,0,0,0
401267148,UNLV Lady Rebels,A. Blount,4595640,,False,12.0,1,4,1,3,0,1,4,4,0,0,0,0,0,0,0,3,6
401267148,UNLV Lady Rebels,D. Young,4704625,,False,22.0,2,5,2,5,0,0,6,9,2,2,4,0,2,0,2,3,10
401267148,UNLV Lady Rebels,J. Singleton,4704623,,False,22.0,1,2,1,2,0,0,3,4,1,2,3,0,2,0,1,1,5
401267148,UNLV Lady Rebels,J. Buckley,4595639,,False,20.0,2,5,2,4,0,1,0,0,3,2,5,1,0,0,2,0,4
401267148,UNLV Lady Rebels,TEAM,TOTAL,TOTAL,False,,14,52,8,34,6,18,20,29,9,22,31,6,6,1,19,13,54
401267148,Stanford Cardinal,F. Belibi,4432843,,True,16.0,7,10,7,10,0,0,1,2,2,5,7,1,3,0,0,3,15
401267148,Stanford Cardinal,H. Jones,4595910,,True,25.0,12,17,12,16,0,1,1,1,1,6,7,7,2,2,0,1,25
401267148,Stanford Cardinal,Le. Hull,4398829,,True,18.0,4,7,2,3,2,4,3,3,3,6,9,3,1,0,1,3,13
401267148,Stanford Cardinal,K. Williams,4282168,,True,26.0,3,5,2,3,1,2,0,0,0,0,0,5,3,1,1,2,7
401267148,Stanford Cardinal,A. Wilson,4066545,,True,18.0,3,4,1,1,2,3,1,1,0,2,2,2,0,0,0,2,9
401267148,Stanford Cardinal,A. Prechtel,4433634,,False,11.0,3,4,2,3,1,1,0,0,2,0,2,0,1,3,2,4,7
401267148,Stanford Cardinal,C. Brink,4433404,,False,16.0,5,9,5,7,0,2,0,0,1,6,7,0,0,4,3,2,10
401267148,Stanford Cardinal,A. Jerome,4282165,,False,12.0,1,4,0,1,1,3,1,2,1,2,3,2,0,0,1,0,4
401267148,Stanford Cardinal,A. Emma-Nnopu,4703591,,False,9.0,0,1,0,1,0,0,0,0,1,1,2,0,0,0,2,1,0
401267148,Stanford Cardinal,J. Van Gytenbeek,4433434,,False,14.0,0,1,0,0,0,1,0,0,0,0,0,2,0,0,0,2,0
401267148,Stanford Cardinal,H. Jump,4432868,,False,21.0,2,8,1,2,1,6,0,0,0,4,4,1,3,0,1,0,5
401267148,Stanford Cardinal,La. Hull,4398830,,False,14.0,3,5,3,4,0,1,0,2,1,2,3,0,1,0,0,2,6
401267148,Stanford Cardinal,TEAM,TOTAL,TOTAL,False,,43,75,35,51,8,24,7,11,12,34,46,23,14,10,12,22,101
401266780,New Mexico Lobos,S. McGruder,4400149,,True,10.0,1,2,1,2,0,0,0,0,2,2,4,0,2,0,1,3,2
401266780,New Mexico Lobos,A. Anderson,4281834,,True,19.0,5,5,5,5,0,0,3,4,1,1,2,1,0,1,3,4,13
401266780,New Mexico Lobos,Lato. Duff,4704520,,True,34.0,4,8,4,7,0,1,6,9,0,4,4,5,4,1,2,1,14
401266780,New Mexico Lobos,A. Hurst,4400147,,True,27.0,5,11,0,1,5,10,3,4,0,1,1,2,3,0,3,2,18
401266780,New Mexico Lobos,J. De La Cerda,4281833,,True,24.0,5,12,2,3,3,9,3,4,2,3,5,3,2,1,2,4,16
401266780,New Mexico Lobos,C. Dupont,4595646,,False,9.0,0,3,0,0,0,3,0,0,0,0,0,0,0,0,0,2,0
401266780,New Mexico Lobos,A. Watts,4433688,,False,16.0,1,2,0,0,1,2,0,0,2,2,4,0,0,0,1,5,3
401266780,New Mexico Lobos,A. Robinson,4432993,,False,8.0,1,3,1,3,0,0,0,0,1,3,4,0,0,0,0,2,2
401266780,New Mexico Lobos,N. Parkinson,4704523,,False,2.0,0,1,0,1,0,0,0,2,0,1,1,0,0,0,0,0,0
401266780,New Mexico Lobos,K. van Bennekom,4704522,,False,19.0,1,5,0,1,1,4,6,8,1,2,3,1,0,0,1,3,9
401266780,New Mexico Lobos,Lata. Duff,4704519,,False,31.0,4,13,1,3,3,10,5,7,3,2,5,6,2,1,0,4,16
401266780,New Mexico Lobos,A. Avent,4595645,,False,1.0,0,0,0,0,0,0,0,0,0,0,0,0,0,0,0,0,0
401266780,New Mexico Lobos,TEAM,TOTAL,TOTAL,False,,27,65,14,26,13,39,26,38,13,22,35,18,13,4,13,30,93
401266780,Midwestern State Mustangs,H. Reynolds,4706461,,True,26.0,3,7,3,7,0,0,2,2,0,3,3,3,1,0,3,2,8
401266780,Midwestern State Mustangs,S. Millar,4706455,,True,20.0,4,10,3,7,1,3,4,5,1,1,2,0,1,0,1,3,13
401266780,Midwestern State Mustangs,H. Risley,4706465,,True,22.0,3,4,3,4,0,0,0,0,3,3,6,3,0,1,7,1,6
401266780,Midwestern State Mustangs,F. King,4706460,,True,12.0,2,4,1,3,1,1,2,2,0,2,2,2,1,0,2,5,7
401266780,Midwestern State Mustangs,M. Lenahan,4069351,,True,27.0,0,2,0,2,0,0,2,2,0,6,6,1,3,0,2,3,2
401266780,Midwestern State Mustangs,M. Withey,4706466,,False,12.0,0,1,0,1,0,0,6,6,2,3,5,1,1,1,2,2,6
401266780,Midwestern State Mustangs,K. Diaz,4706464,,False,22.0,2,5,2,4,0,1,2,8,0,2,2,3,1,1,0,4,6
401266780,Midwestern State Mustangs,B. Fields,4706463,,False,8.0,1,4,1,4,0,0,2,5,1,0,1,0,0,0,1,0,4
401266780,Midwestern State Mustangs,M. Taylor,18271,,False,3.0,0,0,0,0,0,0,0,0,0,0,0,0,0,0,0,0,0
401266780,Midwestern State Mustangs,M. Kendall,4706458,,False,12.0,0,1,0,0,0,1,0,0,1,2,3,0,0,0,4,4,0
401266780,Midwestern State Mustangs,S. Bostic,4706457,,False,13.0,1,3,0,0,1,3,2,2,0,3,3,0,0,0,1,1,5
401266780,Midwestern State Mustangs,E. Jackson,4706456,,False,23.0,2,5,0,2,2,3,2,2,1,2,3,0,1,0,1,2,8
401266780,Midwestern State Mustangs,TEAM,TOTAL,TOTAL,False,,18,46,13,34,5,12,24,34,10,29,39,13,9,3,25,27,65
401266743,Sam Houston Bearkats,M. Batista,4595756,,True,25.0,4,7,4,7,0,0,3,3,5,5,10,1,0,0,1,5,11
401266743,Sam Houston Bearkats,C. Cleveland,4595754,,True,31.0,11,13,11,13,0,0,4,4,0,5,5,0,1,2,4,5,26
401266743,Sam Houston Bearkats,A. Leggett,4400397,,True,39.0,9,24,9,23,0,1,11,17,1,2,3,1,3,0,4,5,29
401266743,Sam Houston Bearkats,K. Jefferson,4418429,,True,24.0,0,5,0,4,0,1,1,2,3,0,3,0,1,0,3,5,1
401266743,Sam Houston Bearkats,F. Cook,4069133,,True,38.0,3,11,2,4,1,7,2,2,1,3,4,6,1,0,4,4,9
401266743,Sam Houston Bearkats,D. Young,4705038,,False,1.0,0,0,0,0,0,0,0,0,0,0,0,0,0,0,0,0,0
401266743,Sam Houston Bearkats,A. Essex,4595758,,False,6.0,1,2,0,0,1,2,0,0,0,1,1,0,0,0,0,1,3
401266743,Sam Houston Bearkats,J. Levay,4705036,,False,14.0,0,2,0,2,0,0,1,2,0,2,2,1,0,0,4,2,1
401266743,Sam Houston Bearkats,D. Hunter,4705035,,False,5.0,2,4,2,4,0,0,0,0,0,2,2,1,1,0,0,1,4
401266743,Sam Houston Bearkats,J. Williams,4705034,,False,13.0,2,3,1,1,1,2,0,2,2,1,3,1,0,0,0,4,5
401266743,Sam Houston Bearkats,S. Kemp,4595751,,False,3.0,0,1,0,1,0,0,0,0,0,0,0,0,0,0,1,2,0
401266743,Sam Houston Bearkats,A. Osborne,4282374,,False,1.0,0,0,0,0,0,0,0,0,0,0,0,0,0,0,0,0,0
401266743,Sam Houston Bearkats,TEAM,TOTAL,TOTAL,False,,32,72,29,59,3,13,22,32,18,23,41,11,7,2,22,34,89
401266743,New Mexico Lobos,S. McGruder,4400149,,True,34.0,7,10,5,7,2,3,1,3,4,9,13,0,3,5,5,3,17
401266743,New Mexico Lobos,A. Anderson,4281834,,True,20.0,2,6,1,3,1,3,5,6,1,4,5,2,0,0,2,5,10
401266743,New Mexico Lobos,Lato. Duff,4704520,,True,27.0,5,10,4,8,1,2,4,6,2,2,4,5,1,1,5,3,15
401266743,New Mexico Lobos,A. Hurst,4400147,,True,22.0,1,5,0,3,1,2,0,0,0,2,2,1,2,1,2,5,3
401266743,New Mexico Lobos,J. De La Cerda,4281833,,True,36.0,5,9,5,6,0,3,14,15,5,1,6,5,1,1,2,2,24
401266743,New Mexico Lobos,A. Watts,4433688,,False,5.0,1,1,1,1,0,0,0,0,1,1,2,0,1,0,0,2,2
401266743,New Mexico Lobos,A. Robinson,4432993,,False,1.0,0,0,0,0,0,0,0,0,0,0,0,0,0,0,0,0,0
401266743,New Mexico Lobos,K. van Bennekom,4704522,,False,14.0,0,2,0,0,0,2,2,2,1,2,3,0,0,0,0,2,2
401266743,New Mexico Lobos,Lata. Duff,4704519,,False,20.0,3,7,2,3,1,4,8,10,0,0,0,0,0,0,3,2,15
401266743,New Mexico Lobos,C. Carter,4433646,,False,21.0,3,10,1,5,2,5,2,4,0,1,1,2,1,0,2,3,10
401266743,New Mexico Lobos,TEAM,TOTAL,TOTAL,False,,27,60,19,36,8,24,36,46,16,27,43,15,9,8,21,27,98
401266535,College of Idaho Yotes,K. Rasmussen,4708528,,True,21.0,4,6,4,6,0,0,1,2,1,3,4,1,0,0,3,2,9
401266535,College of Idaho Yotes,A. Cannon,4708519,,True,35.0,2,9,1,5,1,4,0,1,1,8,9,2,0,0,4,3,5
401266535,College of Idaho Yotes,K. Renfro,4708517,,True,25.0,0,8,0,5,0,3,0,0,1,2,3,2,0,0,3,1,0
401266535,College of Idaho Yotes,S. Jackson,4708516,,True,21.0,2,5,1,2,1,3,0,0,0,3,3,2,0,0,4,0,5
401266535,College of Idaho Yotes,L. Mitchell,4708513,,True,23.0,5,12,5,11,0,1,2,2,1,2,3,1,0,0,2,1,12
401266535,College of Idaho Yotes,S. Riggle,4708527,,False,22.0,1,8,1,8,0,0,1,2,3,1,4,0,0,0,2,2,3
401266535,College of Idaho Yotes,E. Anderson,4708518,,False,20.0,1,3,1,3,0,0,2,2,2,0,2,0,0,0,4,0,4
401266535,College of Idaho Yotes,C. Shepherd,4708523,,False,15.0,1,3,1,2,0,1,0,1,0,2,2,0,0,0,2,0,2
401266535,College of Idaho Yotes,K. French,4708522,,False,18.0,1,6,0,0,1,6,0,0,0,1,1,0,0,0,1,1,3
401266535,College of Idaho Yotes,TEAM,TOTAL,TOTAL,False,,17,60,14,42,3,18,6,10,12,25,37,8,0,0,25,10,43
401266535,Boise State Broncos,A. Mark,4606930,,True,26.0,8,12,8,12,0,0,0,1,4,2,6,1,1,1,1,1,16
401266535,Boise State Broncos,A. Muse,4583056,,True,21.0,1,4,1,4,0,0,0,0,1,3,4,0,1,1,0,4,2
401266535,Boise State Broncos,R. Bowers,4400536,,True,24.0,9,16,9,13,0,3,0,0,5,3,8,0,2,3,1,2,18
401266535,Boise State Broncos,M. Naro,4705625,,True,30.0,2,8,2,6,0,2,1,2,2,8,10,7,3,1,1,1,5
401266535,Boise State Broncos,J. Loville,4400537,,True,30.0,10,19,10,14,0,5,2,2,0,2,2,5,1,0,2,1,22
401266535,Boise State Broncos,E. Lalotte,4705630,,False,17.0,1,4,1,4,0,0,0,0,0,2,2,1,2,0,0,1,2
401266535,Boise State Broncos,C. Njoku,4595621,,False,19.0,5,5,5,5,0,0,4,4,3,5,8,1,0,0,0,2,14
401266535,Boise State Broncos,K. Sykes,4595619,,False,19.0,2,8,2,4,0,4,0,0,0,2,2,2,3,1,0,2,4
401266535,Boise State Broncos,M. Machalova,4705628,,False,14.0,3,4,2,3,1,1,0,0,0,1,1,0,1,0,2,2,7
401266535,Boise State Broncos,TEAM,TOTAL,TOTAL,False,,41,80,40,65,1,15,7,9,15,33,48,17,14,7,7,16,90
401265344,UC Irvine Anteaters,S. Locandro,4595211,,True,23.0,2,6,2,6,0,0,2,2,0,2,2,0,1,1,4,5,6
401265344,UC Irvine Anteaters,K. Williams,4595209,,True,31.0,5,13,4,7,1,6,4,6,0,5,5,6,4,0,5,3,15
401265344,UC Irvine Anteaters,H. Talbert,4281717,,True,8.0,0,0,0,0,0,0,0,0,0,2,2,1,0,0,0,0,0
401265344,UC Irvine Anteaters,D. Guglielmo,4281716,,True,12.0,0,2,0,0,0,2,0,0,1,1,2,0,0,0,0,0,0
401265344,UC Irvine Anteaters,A. Seaton,4281715,,True,20.0,0,2,0,2,0,0,1,2,0,1,1,2,3,0,2,0,1
401265344,UC Irvine Anteaters,C. Kaupu,4704426,,False,8.0,2,3,2,3,0,0,0,0,0,0,0,0,0,0,2,3,4
401265344,UC Irvine Anteaters,J. Akaegbu-Cleveland,4068413,,False,4.0,0,0,0,0,0,0,0,0,0,1,1,0,0,0,0,0,0
401265344,UC Irvine Anteaters,T. Garza,4281713,,False,18.0,3,3,3,3,0,0,2,3,1,4,5,1,1,0,3,5,8
401265344,UC Irvine Anteaters,V. Baker,4704425,,False,27.0,6,10,5,7,1,3,4,4,2,3,5,3,1,0,2,3,17
401265344,UC Irvine Anteaters,J. Cadee,4595210,,False,35.0,5,13,0,0,5,13,0,0,0,5,5,0,1,1,3,3,15
401265344,UC Irvine Anteaters,C. Webb,4595208,,False,14.0,0,0,0,0,0,0,0,0,1,1,2,0,2,0,2,3,0
401265344,UC Irvine Anteaters,TEAM,TOTAL,TOTAL,False,,23,52,16,28,7,24,13,17,10,27,37,13,13,2,25,25,66
401265344,San Diego State Aztecs,K. Gipson,4704563,,True,19.0,2,3,2,3,0,0,1,2,2,3,5,0,1,0,2,1,5
401265344,San Diego State Aztecs,K. Villalobos,4704565,,True,12.0,1,4,1,4,0,0,0,0,2,0,2,2,3,0,4,3,2
401265344,San Diego State Aztecs,A. Crain,4399223,,True,13.0,0,4,0,3,0,1,0,0,0,1,1,0,1,0,1,3,0
401265344,San Diego State Aztecs,M. Staples,4398925,,True,39.0,4,12,3,10,1,2,3,3,1,5,6,2,4,0,5,2,12
401265344,San Diego State Aztecs,T. Adams,4281876,,True,37.0,2,7,1,5,1,2,4,6,0,3,3,5,3,0,5,4,9
401265344,San Diego State Aztecs,I. Murillo,4704566,,False,12.0,1,1,1,1,0,0,3,6,2,1,3,1,0,0,1,2,5
401265344,San Diego State Aztecs,F. Vinerte,4704564,,False,20.0,1,1,1,1,0,0,3,6,2,4,6,1,0,0,2,1,5
401265344,San Diego State Aztecs,B. Chynoweth,4704562,,False,24.0,5,12,0,0,5,12,0,0,0,0,0,0,1,0,0,0,15
401265344,San Diego State Aztecs,T. Sireni,4595648,,False,7.0,0,1,0,0,0,1,2,2,1,1,2,1,0,0,2,0,2
401265344,San Diego State Aztecs,I. Hernandez,4595647,,False,17.0,0,6,0,2,0,4,0,0,0,1,1,0,0,0,4,1,0
401265344,San Diego State Aztecs,TEAM,TOTAL,TOTAL,False,,16,51,9,29,7,22,16,25,13,22,35,12,13,0,26,17,55
401265341,San Francisco Dons,L. Kostic,4400509,,True,28.0,3,3,3,3,0,0,0,0,0,7,7,4,0,3,2,5,6
401265341,San Francisco Dons,A. Rathbun,4400511,,True,34.0,3,5,3,5,0,0,0,0,3,4,7,3,2,0,4,2,6
401265341,San Francisco Dons,I. Krimili,4595863,,True,50.0,7,19,4,10,3,9,5,6,0,4,4,4,1,2,2,2,22
401265341,San Francisco Dons,L. Hoskova,4595862,,True,45.0,7,16,5,12,2,4,8,10,3,6,9,1,1,0,5,4,24
401265341,San Francisco Dons,A. Langer,4400507,,True,40.0,4,8,3,6,1,2,6,7,0,1,1,3,4,1,1,4,15
401265341,San Francisco Dons,J. Nielacna,4400510,,False,16.0,3,6,2,4,1,2,2,2,1,4,5,2,1,0,4,3,9
401265341,San Francisco Dons,S. Persson,4703850,,False,1.0,0,0,0,0,0,0,0,0,0,0,0,0,0,1,0,0,0
401265341,San Francisco Dons,R. Sheh,4703849,,False,4.0,0,1,0,1,0,0,0,0,1,0,1,0,0,0,0,2,0
401265341,San Francisco Dons,Marta Galic,4400505,,False,28.0,6,13,3,7,3,6,5,7,3,7,10,1,2,0,4,2,20
401265341,San Francisco Dons,K. Vaalavirta,4400504,,False,4.0,0,0,0,0,0,0,0,0,0,0,0,0,0,0,2,1,0
401265341,San Francisco Dons,TEAM,TOTAL,TOTAL,False,,33,71,23,48,10,23,26,32,13,35,48,18,11,7,24,25,102
401265341,Fresno State Bulldogs,W. Motta,4595631,,True,38.0,3,10,3,10,0,0,4,8,7,6,13,1,0,1,1,3,10
401265341,Fresno State Bulldogs,K. Kinzer,4595630,,True,26.0,2,7,0,2,2,5,0,0,1,2,3,0,0,0,1,3,6
401265341,Fresno State Bulldogs,Hal. Cavinder,4433658,,True,43.0,6,20,6,11,0,9,8,10,1,4,5,5,3,1,2,1,20
401265341,Fresno State Bulldogs,Han. Cavinder,4433372,,True,39.0,5,12,5,9,0,3,0,1,2,3,5,2,1,0,5,3,10
401265341,Fresno State Bulldogs,A. Gamez,4281826,,True,41.0,6,12,5,7,1,5,6,8,2,4,6,1,3,0,2,4,19
401265341,Fresno State Bulldogs,Y. Todorova,4704475,,False,32.0,6,10,2,4,4,6,4,4,1,6,7,3,0,0,1,3,20
401265341,Fresno State Bulldogs,K. Brown,4704473,,False,27.0,2,8,2,7,0,1,1,2,2,1,3,0,0,2,3,4,5
401265341,Fresno State Bulldogs,B. Delaney,4281825,,False,4.0,1,2,0,0,1,2,0,0,0,1,1,0,0,0,1,2,3
401265341,Fresno State Bulldogs,TEAM,TOTAL,TOTAL,False,,31,81,23,50,8,31,23,33,19,28,47,12,7,4,16,23,93
401265340,Denver Pioneers,U. Ezeudu,4595918,,True,28.0,4,7,3,5,1,2,1,2,2,6,8,1,0,0,3,3,10
401265340,Denver Pioneers,E. Counsel,4704225,,True,33.0,2,7,2,4,0,3,0,0,0,2,2,0,1,0,2,1,4
401265340,Denver Pioneers,M. Boyd,4595914,,True,23.0,2,10,0,2,2,8,4,4,0,1,1,2,2,1,3,3,10
401265340,Denver Pioneers,T. Malonga,4399659,,True,21.0,4,8,3,5,1,3,4,6,0,3,3,0,0,0,2,3,13
401265340,Denver Pioneers,A. Jackson,4399656,,True,33.0,4,9,1,3,3,6,0,0,2,9,11,0,1,1,0,3,11
401265340,Denver Pioneers,C. Forney,4704228,,False,2.0,0,0,0,0,0,0,0,0,0,1,1,0,0,0,0,0,0
401265340,Denver Pioneers,J. Jeffcoat,4282517,,False,10.0,0,0,0,0,0,0,1,4,1,1,2,0,0,0,2,3,1
401265340,Denver Pioneers,R. Hein,4704226,,False,20.0,0,6,0,0,0,6,0,2,0,1,1,3,0,0,0,3,0
401265340,Denver Pioneers,S. Deem,4595917,,False,13.0,1,2,1,1,0,1,3,4,0,1,1,1,0,0,0,2,5
401265340,Denver Pioneers,A. Foster,4595916,,False,5.0,0,1,0,0,0,1,0,0,0,1,1,0,0,0,0,0,0
401265340,Denver Pioneers,C. Gritt,4282516,,False,12.0,2,8,1,3,1,5,2,4,0,5,5,1,0,0,0,1,7
401265340,Denver Pioneers,TEAM,TOTAL,TOTAL,False,,19,58,11,23,8,35,15,26,6,31,37,8,4,2,12,22,61
401265340,Colorado State Rams,C. Clark,4704464,,True,8.0,0,0,0,0,0,0,0,2,0,1,1,0,0,1,1,5,0
401265340,Colorado State Rams,P. Farkas,4704463,,True,35.0,2,7,2,5,0,2,3,4,1,4,5,1,0,0,0,3,7
401265340,Colorado State Rams,M. Hofschild,4595160,,True,32.0,7,15,6,9,1,6,2,3,1,5,6,5,0,0,1,3,17
401265340,Colorado State Rams,L. Devos,4284002,,True,28.0,7,15,7,12,0,3,4,4,4,6,10,0,2,1,4,5,18
401265340,Colorado State Rams,T. Williams,4282176,,True,27.0,5,13,4,7,1,6,3,3,1,7,8,1,0,0,1,4,14
401265340,Colorado State Rams,M. Torres,4704466,,False,2.0,0,0,0,0,0,0,0,0,0,0,0,0,0,0,0,0,0
401265340,Colorado State Rams,J. Bonnarens,4400102,,False,28.0,6,13,3,7,3,6,0,2,2,2,4,0,3,1,0,1,15
401265340,Colorado State Rams,M. Hemingway,4704465,,False,5.0,0,0,0,0,0,0,0,0,0,3,3,0,0,1,0,0,0
401265340,Colorado State Rams,B. Alper,4595629,,False,9.0,1,5,0,3,1,2,1,4,0,2,2,0,1,0,0,1,4
401265340,Colorado State Rams,K. Stamatelopoulos,4595627,,False,6.0,0,0,0,0,0,0,0,0,0,0,0,0,0,0,0,0,0
401265340,Colorado State Rams,S. Mech,4399658,,False,20.0,2,6,2,6,0,0,0,0,3,3,6,1,1,1,1,1,4
401265340,Colorado State Rams,TEAM,TOTAL,TOTAL,False,,30,74,24,49,6,25,13,22,13,36,49,8,7,5,8,23,79
401265339,Denver Pioneers,U. Ezeudu,4595918,,True,25.0,3,11,3,8,0,3,3,4,2,1,3,4,0,0,2,2,9
401265339,Denver Pioneers,J. Jeffcoat,4282517,,True,14.0,1,1,1,1,0,0,1,2,4,1,5,1,1,0,2,2,3
401265339,Denver Pioneers,R. Hein,4704226,,True,13.0,1,2,1,1,0,1,0,0,0,0,0,2,0,0,2,1,2
401265339,Denver Pioneers,M. Boyd,4595914,,True,31.0,4,19,2,9,2,10,3,3,1,8,9,3,1,0,3,0,13
401265339,Denver Pioneers,A. Jackson,4399656,,True,28.0,2,9,2,4,0,5,0,0,3,4,7,1,1,0,2,0,4
401265339,Denver Pioneers,C. Forney,4704228,,False,12.0,2,3,1,2,1,1,0,0,0,1,1,1,0,0,0,0,5
401265339,Denver Pioneers,M. Johanson,4704224,,False,1.0,0,0,0,0,0,0,0,0,0,0,0,0,0,0,0,0,0
401265339,Denver Pioneers,C. Levison,4704227,,False,1.0,0,0,0,0,0,0,0,0,0,0,0,0,0,0,0,0,0
401265339,Denver Pioneers,E. Counsel,4704225,,False,20.0,3,6,2,5,1,1,0,0,0,2,2,0,0,0,3,2,7
401265339,Denver Pioneers,S. Deem,4595917,,False,5.0,0,0,0,0,0,0,0,0,0,1,1,0,0,0,1,1,0
401265339,Denver Pioneers,A. Foster,4595916,,False,4.0,1,2,1,2,0,0,0,0,1,0,1,0,0,0,1,2,2
401265339,Denver Pioneers,T. Malonga,4399659,,False,29.0,5,8,3,4,2,4,2,2,2,2,4,1,0,0,0,2,14
401265339,Denver Pioneers,C. Gritt,4282516,,False,17.0,1,5,0,2,1,3,0,0,1,1,2,0,0,0,0,0,3
401265339,Denver Pioneers,TEAM,TOTAL,TOTAL,False,,23,66,16,38,7,28,9,11,17,23,40,13,3,0,18,12,62
401265339,Colorado State Rams,S. Mech,4399658,,True,22.0,2,5,2,4,0,1,0,0,2,1,3,0,0,1,0,4,4
401265339,Colorado State Rams,P. Farkas,4704463,,True,32.0,4,8,0,2,4,6,0,0,1,3,4,1,2,0,2,0,12
401265339,Colorado State Rams,M. Hofschild,4595160,,True,20.0,3,4,2,2,1,2,0,0,0,1,1,7,0,0,0,2,7
401265339,Colorado State Rams,L. Devos,4284002,,True,31.0,4,13,4,10,0,3,2,2,1,10,11,5,1,2,3,2,10
401265339,Colorado State Rams,T. Williams,4282176,,True,32.0,5,10,1,2,4,8,0,0,0,4,4,5,2,0,2,2,14
401265339,Colorado State Rams,C. Clark,4704464,,False,15.0,4,4,4,4,0,0,2,2,1,0,1,1,1,1,5,4,10
401265339,Colorado State Rams,M. Torres,4704466,,False,2.0,0,0,0,0,0,0,0,0,0,0,0,0,0,0,0,0,0
401265339,Colorado State Rams,J. Bonnarens,4400102,,False,18.0,6,8,5,6,1,2,2,2,0,1,1,0,0,0,1,0,15
401265339,Colorado State Rams,L. Davis,4068248,,False,1.0,1,1,1,1,0,0,0,0,0,0,0,0,0,0,0,0,2
401265339,Colorado State Rams,M. Hemingway,4704465,,False,3.0,0,0,0,0,0,0,1,2,0,0,0,0,0,0,0,0,1
401265339,Colorado State Rams,B. Alper,4595629,,False,16.0,3,5,2,3,1,2,1,3,0,2,2,4,0,1,1,0,8
401265339,Colorado State Rams,A. Eberhardt,4595628,,False,1.0,0,0,0,0,0,0,0,0,0,0,0,0,0,0,0,0,0
401265339,Colorado State Rams,K. Stamatelopoulos,4595627,,False,6.0,1,1,1,1,0,0,0,0,0,0,0,0,0,0,0,0,2
401265339,Colorado State Rams,L. Brocke,4281823,,False,1.0,0,0,0,0,0,0,0,0,0,0,0,1,0,0,0,0,0
401265339,Colorado State Rams,TEAM,TOTAL,TOTAL,False,,33,59,22,35,11,24,8,11,5,28,33,24,6,5,14,14,85
401265338,Fresno State Bulldogs,K. Kinzer,4595630,,True,23.0,1,4,1,1,0,3,0,0,0,3,3,0,2,0,0,1,2
401265338,Fresno State Bulldogs,M. Utti,4281828,,True,35.0,6,12,4,8,2,4,2,2,0,5,5,1,1,2,3,0,16
401265338,Fresno State Bulldogs,Hal. Cavinder,4433658,,True,38.0,5,15,3,10,2,5,7,8,3,10,13,3,1,1,2,2,19
401265338,Fresno State Bulldogs,Han. Cavinder,4433372,,True,38.0,7,16,7,15,0,1,5,6,1,2,3,4,1,0,2,1,19
401265338,Fresno State Bulldogs,A. Gamez,4281826,,True,30.0,3,6,3,4,0,2,4,6,3,7,10,1,0,0,2,4,10
401265338,Fresno State Bulldogs,W. Motta,4595631,,False,4.0,1,2,1,2,0,0,0,0,0,0,0,0,0,0,1,1,2
401265338,Fresno State Bulldogs,B. Walling,4595632,,False,5.0,0,0,0,0,0,0,0,0,0,0,0,0,0,0,0,0,0
401265338,Fresno State Bulldogs,Y. Todorova,4704475,,False,5.0,1,2,1,1,0,1,0,0,0,0,0,0,0,0,0,0,2
401265338,Fresno State Bulldogs,K. Brown,4704473,,False,22.0,3,4,1,2,2,2,0,0,0,3,3,0,1,0,1,2,8
401265338,Fresno State Bulldogs,TEAM,TOTAL,TOTAL,False,,27,61,21,43,6,18,18,22,9,31,40,9,6,3,11,11,78
401265338,Fresno State Bulldogs,K. Kinzer,4595630,,True,23.0,1,4,1,1,0,3,0,0,0,3,3,0,2,0,0,1,2
401265338,Fresno State Bulldogs,M. Utti,4281828,,True,35.0,6,12,4,8,2,4,2,2,0,5,5,1,1,2,3,0,16
401265338,Fresno State Bulldogs,Hal. Cavinder,4433658,,True,38.0,5,15,3,10,2,5,7,8,3,10,13,3,1,1,2,2,19
401265338,Fresno State Bulldogs,Han. Cavinder,4433372,,True,38.0,7,16,7,15,0,1,5,6,1,2,3,4,1,0,2,1,19
401265338,Fresno State Bulldogs,A. Gamez,4281826,,True,30.0,3,6,3,4,0,2,4,6,3,7,10,1,0,0,2,4,10
401265338,Fresno State Bulldogs,W. Motta,4595631,,False,4.0,1,2,1,2,0,0,0,0,0,0,0,0,0,0,1,1,2
401265338,Fresno State Bulldogs,B. Walling,4595632,,False,5.0,0,0,0,0,0,0,0,0,0,0,0,0,0,0,0,0,0
401265338,Fresno State Bulldogs,Y. Todorova,4704475,,False,5.0,1,2,1,1,0,1,0,0,0,0,0,0,0,0,0,0,2
401265338,Fresno State Bulldogs,K. Brown,4704473,,False,22.0,3,4,1,2,2,2,0,0,0,3,3,0,1,0,1,2,8
401265338,Fresno State Bulldogs,TEAM,TOTAL,TOTAL,False,,27,61,21,43,6,18,18,22,9,31,40,9,6,3,11,11,78
401265338,Colorado State Rams,E. Boni,4704462,,True,37.0,5,16,3,11,2,5,0,0,0,5,5,4,0,2,1,3,12
401265338,Colorado State Rams,M. Hofschild,4595160,,True,37.0,2,6,2,4,0,2,2,2,0,2,2,7,1,0,2,3,6
401265338,Colorado State Rams,S. Mech,4399658,,True,32.0,10,14,8,11,2,3,2,2,2,3,5,2,0,0,1,2,24
401265338,Colorado State Rams,L. Devos,4284002,,True,33.0,5,12,4,10,1,2,0,0,3,5,8,1,1,1,2,3,11
401265338,Colorado State Rams,T. Williams,4282176,,True,38.0,5,14,1,3,4,11,0,0,0,5,5,2,1,0,1,2,14
401265338,Colorado State Rams,C. Clark,4704464,,False,7.0,1,2,1,2,0,0,0,0,1,3,4,0,0,0,1,0,2
401265338,Colorado State Rams,J. Bonnarens,4400102,,False,8.0,2,3,1,2,1,1,0,0,1,0,1,0,0,0,1,2,5
401265338,Colorado State Rams,M. Hemingway,4704465,,False,2.0,0,1,0,1,0,0,0,0,0,0,0,0,0,0,0,0,0
401265338,Colorado State Rams,P. Farkas,4704463,,False,3.0,0,2,0,0,0,2,0,0,0,1,1,0,0,0,2,1,0
401265338,Colorado State Rams,B. Alper,4595629,,False,3.0,0,0,0,0,0,0,0,0,0,0,0,1,0,0,0,1,0
401265338,Colorado State Rams,TEAM,TOTAL,TOTAL,False,,30,70,20,44,10,26,4,4,9,25,34,17,3,3,11,17,74
401265338,Colorado State Rams,E. Boni,4704462,,True,37.0,5,16,3,11,2,5,0,0,0,5,5,4,0,2,1,3,12
401265338,Colorado State Rams,M. Hofschild,4595160,,True,37.0,2,6,2,4,0,2,2,2,0,2,2,7,1,0,2,3,6
401265338,Colorado State Rams,S. Mech,4399658,,True,32.0,10,14,8,11,2,3,2,2,2,3,5,2,0,0,1,2,24
401265338,Colorado State Rams,L. Devos,4284002,,True,33.0,5,12,4,10,1,2,0,0,3,5,8,1,1,1,2,3,11
401265338,Colorado State Rams,T. Williams,4282176,,True,38.0,5,14,1,3,4,11,0,0,0,5,5,2,1,0,1,2,14
401265338,Colorado State Rams,C. Clark,4704464,,False,7.0,1,2,1,2,0,0,0,0,1,3,4,0,0,0,1,0,2
401265338,Colorado State Rams,J. Bonnarens,4400102,,False,8.0,2,3,1,2,1,1,0,0,1,0,1,0,0,0,1,2,5
401265338,Colorado State Rams,M. Hemingway,4704465,,False,2.0,0,1,0,1,0,0,0,0,0,0,0,0,0,0,0,0,0
401265338,Colorado State Rams,P. Farkas,4704463,,False,3.0,0,2,0,0,0,2,0,0,0,1,1,0,0,0,2,1,0
401265338,Colorado State Rams,B. Alper,4595629,,False,3.0,0,0,0,0,0,0,0,0,0,0,0,1,0,0,0,1,0
401265338,Colorado State Rams,TEAM,TOTAL,TOTAL,False,,30,70,20,44,10,26,4,4,9,25,34,17,3,3,11,17,74
401265337,Fresno State Bulldogs,M. Utti,4281828,,True,35.0,6,10,6,8,0,2,4,5,0,7,7,3,2,0,2,2,16
401265337,Fresno State Bulldogs,B. Walling,4595632,,True,12.0,1,4,1,3,0,1,0,0,1,0,1,0,0,1,0,0,2
401265337,Fresno State Bulldogs,Hal. Cavinder,4433658,,True,39.0,8,20,5,10,3,10,5,6,0,8,8,4,2,0,1,3,24
401265337,Fresno State Bulldogs,Han. Cavinder,4433372,,True,37.0,9,17,7,13,2,4,2,2,1,3,4,3,3,0,2,2,22
401265337,Fresno State Bulldogs,A. Gamez,4281826,,True,24.0,3,7,3,5,0,2,0,0,1,0,1,2,0,1,1,3,6
401265337,Fresno State Bulldogs,W. Motta,4595631,,False,18.0,1,3,1,3,0,0,0,2,2,4,6,0,0,0,0,3,2
401265337,Fresno State Bulldogs,K. Kinzer,4595630,,False,21.0,4,6,2,3,2,3,1,2,0,2,2,0,0,1,0,1,11
401265337,Fresno State Bulldogs,Y. Todorova,4704475,,False,4.0,0,0,0,0,0,0,0,0,0,0,0,0,0,0,0,0,0
401265337,Fresno State Bulldogs,K. Brown,4704473,,False,6.0,0,2,0,1,0,1,0,0,0,0,0,0,0,0,0,0,0
401265337,Fresno State Bulldogs,B. Delaney,4281825,,False,4.0,0,0,0,0,0,0,0,2,0,0,0,0,0,0,0,2,0
401265337,Fresno State Bulldogs,TEAM,TOTAL,TOTAL,False,,32,69,25,46,7,23,12,19,8,24,32,12,7,3,6,16,83
401265337,Fresno State Bulldogs,M. Utti,4281828,,True,35.0,6,10,6,8,0,2,4,5,0,7,7,3,2,0,2,2,16
401265337,Fresno State Bulldogs,B. Walling,4595632,,True,12.0,1,4,1,3,0,1,0,0,1,0,1,0,0,1,0,0,2
401265337,Fresno State Bulldogs,Hal. Cavinder,4433658,,True,39.0,8,20,5,10,3,10,5,6,0,8,8,4,2,0,1,3,24
401265337,Fresno State Bulldogs,Han. Cavinder,4433372,,True,37.0,9,17,7,13,2,4,2,2,1,3,4,3,3,0,2,2,22
401265337,Fresno State Bulldogs,A. Gamez,4281826,,True,24.0,3,7,3,5,0,2,0,0,1,0,1,2,0,1,1,3,6
401265337,Fresno State Bulldogs,W. Motta,4595631,,False,18.0,1,3,1,3,0,0,0,2,2,4,6,0,0,0,0,3,2
401265337,Fresno State Bulldogs,K. Kinzer,4595630,,False,21.0,4,6,2,3,2,3,1,2,0,2,2,0,0,1,0,1,11
401265337,Fresno State Bulldogs,Y. Todorova,4704475,,False,4.0,0,0,0,0,0,0,0,0,0,0,0,0,0,0,0,0,0
401265337,Fresno State Bulldogs,K. Brown,4704473,,False,6.0,0,2,0,1,0,1,0,0,0,0,0,0,0,0,0,0,0
401265337,Fresno State Bulldogs,B. Delaney,4281825,,False,4.0,0,0,0,0,0,0,0,2,0,0,0,0,0,0,0,2,0
401265337,Fresno State Bulldogs,TEAM,TOTAL,TOTAL,False,,32,69,25,46,7,23,12,19,8,24,32,12,7,3,6,16,83
401265337,Colorado State Rams,C. Clark,4704464,,True,6.0,0,0,0,0,0,0,0,0,0,1,1,0,0,0,0,0,0
401265337,Colorado State Rams,E. Boni,4704462,,True,31.0,5,11,3,7,2,4,2,2,0,4,4,2,0,1,0,2,14
401265337,Colorado State Rams,M. Hofschild,4595160,,True,37.0,5,11,3,7,2,4,1,2,1,3,4,5,2,1,4,5,13
401265337,Colorado State Rams,L. Devos,4284002,,True,32.0,8,17,7,13,1,4,2,2,4,6,10,2,0,1,2,1,19
401265337,Colorado State Rams,T. Williams,4282176,,True,35.0,6,13,2,3,4,10,0,0,0,7,7,3,1,0,1,2,16
401265337,Colorado State Rams,K. Murphy,4068969,,False,16.0,4,4,4,4,0,0,0,0,2,2,4,1,0,0,0,1,8
401265337,Colorado State Rams,J. Bonnarens,4400102,,False,4.0,0,1,0,0,0,1,1,2,0,2,2,0,0,0,0,0,1
401265337,Colorado State Rams,M. Hemingway,4704465,,False,0.0,0,0,0,0,0,0,0,0,1,0,1,0,0,0,0,0,0
401265337,Colorado State Rams,P. Farkas,4704463,,False,9.0,0,3,0,1,0,2,0,0,0,1,1,0,0,0,1,0,0
401265337,Colorado State Rams,K. Stamatelopoulos,4595627,,False,0.0,0,0,0,0,0,0,3,4,0,0,0,0,1,0,0,0,3
401265337,Colorado State Rams,S. Mech,4399658,,False,30.0,6,9,5,8,1,1,2,2,2,5,7,5,0,1,2,4,15
401265337,Colorado State Rams,TEAM,TOTAL,TOTAL,False,,34,69,24,43,10,26,11,14,12,32,44,18,4,4,10,15,89
401265337,Colorado State Rams,C. Clark,4704464,,True,6.0,0,0,0,0,0,0,0,0,0,1,1,0,0,0,0,0,0
401265337,Colorado State Rams,E. Boni,4704462,,True,31.0,5,11,3,7,2,4,2,2,0,4,4,2,0,1,0,2,14
401265337,Colorado State Rams,M. Hofschild,4595160,,True,37.0,5,11,3,7,2,4,1,2,1,3,4,5,2,1,4,5,13
401265337,Colorado State Rams,L. Devos,4284002,,True,32.0,8,17,7,13,1,4,2,2,4,6,10,2,0,1,2,1,19
401265337,Colorado State Rams,T. Williams,4282176,,True,35.0,6,13,2,3,4,10,0,0,0,7,7,3,1,0,1,2,16
401265337,Colorado State Rams,K. Murphy,4068969,,False,16.0,4,4,4,4,0,0,0,0,2,2,4,1,0,0,0,1,8
401265337,Colorado State Rams,J. Bonnarens,4400102,,False,4.0,0,1,0,0,0,1,1,2,0,2,2,0,0,0,0,0,1
401265337,Colorado State Rams,M. Hemingway,4704465,,False,0.0,0,0,0,0,0,0,0,0,1,0,1,0,0,0,0,0,0
401265337,Colorado State Rams,P. Farkas,4704463,,False,9.0,0,3,0,1,0,2,0,0,0,1,1,0,0,0,1,0,0
401265337,Colorado State Rams,K. Stamatelopoulos,4595627,,False,0.0,0,0,0,0,0,0,3,4,0,0,0,0,1,0,0,0,3
401265337,Colorado State Rams,S. Mech,4399658,,False,30.0,6,9,5,8,1,1,2,2,2,5,7,5,0,1,2,4,15
401265337,Colorado State Rams,TEAM,TOTAL,TOTAL,False,,34,69,24,43,10,26,11,14,12,32,44,18,4,4,10,15,89
401265336,Colorado State Rams,C. Clark,4704464,,True,13.0,4,6,4,6,0,0,1,2,2,5,7,0,0,0,2,0,9
401265336,Colorado State Rams,S. Mech,4399658,,True,16.0,3,4,2,3,1,1,0,0,0,0,0,4,0,2,0,0,7
401265336,Colorado State Rams,E. Boni,4704462,,True,15.0,2,3,2,3,0,0,1,1,0,0,0,0,0,0,2,1,5
401265336,Colorado State Rams,M. Hofschild,4595160,,True,15.0,4,4,1,1,3,3,1,2,0,1,1,3,0,0,0,0,12
401265336,Colorado State Rams,L. Devos,4284002,,True,17.0,4,7,4,7,0,0,2,2,0,4,4,2,1,2,0,1,10
401265336,Colorado State Rams,K. Murphy,4068969,,False,16.0,5,5,5,5,0,0,2,2,4,4,8,1,1,0,0,0,12
401265336,Colorado State Rams,M. Torres,4704466,,False,10.0,1,4,1,3,0,1,0,0,0,0,0,0,0,1,0,1,2
401265336,Colorado State Rams,J. Bonnarens,4400102,,False,12.0,2,4,1,1,1,3,0,0,0,3,3,0,1,0,1,0,5
401265336,Colorado State Rams,L. Davis,4068248,,False,10.0,3,3,3,3,0,0,0,0,1,2,3,0,0,1,0,2,6
401265336,Colorado State Rams,M. Hemingway,4704465,,False,11.0,2,4,2,3,0,1,0,0,0,2,2,2,0,1,0,0,4
401265336,Colorado State Rams,P. Farkas,4704463,,False,15.0,3,5,1,2,2,3,0,0,0,1,1,1,1,0,0,0,8
401265336,Colorado State Rams,B. Alper,4595629,,False,14.0,0,4,0,4,0,0,0,0,0,1,1,2,0,0,1,1,0
401265336,Colorado State Rams,A. Eberhardt,4595628,,False,4.0,0,0,0,0,0,0,0,0,0,0,0,0,0,0,0,1,0
401265336,Colorado State Rams,K. Stamatelopoulos,4595627,,False,11.0,2,3,1,2,1,1,0,0,0,2,2,1,0,0,3,0,5
401265336,Colorado State Rams,T. Williams,4282176,,False,13.0,4,4,1,1,3,3,0,0,0,0,0,2,3,1,0,2,11
401265336,Colorado State Rams,L. Brocke,4281823,,False,8.0,0,2,0,0,0,2,0,0,0,0,0,0,1,0,1,1,0
401265336,Colorado State Rams,TEAM,TOTAL,TOTAL,False,,39,62,28,44,11,18,7,9,8,28,36,18,8,8,10,10,96
401265336,Colorado Christian Cougars,B. Hurlbut,4598874,,True,30.0,5,9,4,7,1,2,3,4,2,1,3,2,6,0,4,0,14
401265336,Colorado Christian Cougars,L. Gonzalez,4598872,,True,34.0,4,8,4,8,0,0,1,2,1,2,3,0,0,1,0,1,9
401265336,Colorado Christian Cougars,B. Gumber,4706712,,True,14.0,0,1,0,1,0,0,0,0,0,0,0,0,0,1,0,2,0
401265336,Colorado Christian Cougars,O. Christy,4598869,,True,23.0,2,9,1,4,1,5,0,0,0,1,1,1,0,0,3,2,5
401265336,Colorado Christian Cougars,M. Kemmer,4293452,,True,15.0,0,2,0,0,0,2,0,0,1,2,3,0,0,0,0,0,0
401265336,Colorado Christian Cougars,M. VandenBrink,4598873,,False,5.0,0,0,0,0,0,0,2,2,0,0,0,0,0,0,1,0,2
401265336,Colorado Christian Cougars,T. Ferris,4598868,,False,26.0,1,4,0,3,1,1,0,2,0,3,3,0,0,0,1,1,3
401265336,Colorado Christian Cougars,C. Curry,4706710,,False,8.0,1,3,1,3,0,0,0,0,0,0,0,1,0,0,2,3,2
401265336,Colorado Christian Cougars,D. Morgan,4706709,,False,5.0,1,1,1,1,0,0,0,0,0,0,0,0,0,0,2,0,2
401265336,Colorado Christian Cougars,R. Wade,4706708,,False,13.0,0,3,0,2,0,1,0,0,0,1,1,0,0,0,0,0,0
401265336,Colorado Christian Cougars,M. Walker,4598879,,False,17.0,4,7,1,3,3,4,2,2,0,2,2,0,0,0,0,0,13
401265336,Colorado Christian Cougars,S. Nunez,4598871,,False,10.0,2,6,2,4,0,2,0,0,0,1,1,0,0,0,0,1,4
401265336,Colorado Christian Cougars,TEAM,TOTAL,TOTAL,False,,20,53,14,36,6,17,8,12,6,15,21,4,6,2,15,10,54
401265335,Regis (CO) Rangers,W. Jacob,4706393,,True,34.0,6,11,5,7,1,4,1,2,1,4,5,0,0,0,5,0,14
401265335,Regis (CO) Rangers,S. Speights,4706386,,True,20.0,2,6,2,6,0,0,4,4,0,0,0,2,0,0,0,3,8
401265335,Regis (CO) Rangers,T. Burrell,4706398,,True,28.0,2,9,1,5,1,4,8,8,1,0,1,0,0,0,0,2,13
401265335,Regis (CO) Rangers,E. Sterkel,4706392,,True,17.0,1,3,1,2,0,1,2,2,1,0,1,1,0,0,0,1,4
401265335,Regis (CO) Rangers,E. Fry,4706387,,True,28.0,4,10,4,10,0,0,2,2,1,1,2,1,1,0,3,3,10
401265335,Regis (CO) Rangers,G. O'Neill,4706397,,False,19.0,2,5,2,5,0,0,0,1,1,0,1,0,0,2,2,2,4
401265335,Regis (CO) Rangers,K. Murphy,4706394,,False,4.0,0,0,0,0,0,0,0,0,0,0,0,0,0,0,2,2,0
401265335,Regis (CO) Rangers,Ml. Smith,4706388,,False,15.0,1,5,1,5,0,0,1,2,2,4,6,0,0,0,0,3,3
401265335,Regis (CO) Rangers,Mr. Smith,4706396,,False,22.0,3,9,1,1,2,8,0,0,0,1,1,0,0,0,1,3,8
401265335,Regis (CO) Rangers,M. Diercks,4706390,,False,7.0,0,0,0,0,0,0,0,0,0,0,0,1,0,0,0,1,0
401265335,Regis (CO) Rangers,S. Daniels,4706385,,False,6.0,0,0,0,0,0,0,0,0,0,0,0,0,0,0,0,4,0
401265335,Regis (CO) Rangers,TEAM,TOTAL,TOTAL,False,,21,58,17,41,4,17,18,21,12,17,29,5,1,2,14,24,64
401265335,Colorado State Rams,C. Clark,4704464,,True,16.0,5,5,4,4,1,1,0,0,2,5,7,2,0,1,1,1,11
401265335,Colorado State Rams,E. Boni,4704462,,True,20.0,2,3,1,2,1,1,2,2,2,1,3,0,0,0,0,3,7
401265335,Colorado State Rams,M. Hofschild,4595160,,True,17.0,2,4,2,2,0,2,4,5,0,2,2,10,0,0,0,0,8
401265335,Colorado State Rams,L. Devos,4284002,,True,8.0,3,4,3,4,0,0,0,0,0,3,3,1,0,0,0,2,6
401265335,Colorado State Rams,T. Williams,4282176,,True,16.0,11,13,2,2,9,11,0,0,0,1,1,1,0,0,0,1,31
401265335,Colorado State Rams,K. Murphy,4068969,,False,15.0,2,5,2,5,0,0,10,10,5,1,6,1,0,0,3,3,14
401265335,Colorado State Rams,M. Torres,4704466,,False,11.0,4,5,4,4,0,1,0,0,0,0,0,0,1,2,1,0,8
401265335,Colorado State Rams,J. Bonnarens,4400102,,False,13.0,1,3,0,0,1,3,0,0,0,0,0,0,0,0,0,1,3
401265335,Colorado State Rams,L. Davis,4068248,,False,7.0,1,2,1,2,0,0,0,0,1,2,3,0,0,1,0,1,2
401265335,Colorado State Rams,M. Hemingway,4704465,,False,11.0,2,4,1,1,1,3,0,4,0,1,1,0,2,2,0,4,5
401265335,Colorado State Rams,P. Farkas,4704463,,False,13.0,1,3,1,2,0,1,0,0,1,3,4,0,0,0,0,2,2
401265335,Colorado State Rams,B. Alper,4595629,,False,9.0,1,6,1,6,0,0,4,5,0,1,1,0,0,0,0,0,6
401265335,Colorado State Rams,A. Eberhardt,4595628,,False,4.0,0,1,0,1,0,0,1,2,0,0,0,0,0,0,1,0,1
401265335,Colorado State Rams,K. Stamatelopoulos,4595627,,False,13.0,1,2,1,2,0,0,1,2,0,2,2,2,3,1,1,0,3
401265335,Colorado State Rams,S. Mech,4399658,,False,19.0,2,4,2,2,0,2,0,0,0,0,0,3,0,1,0,1,4
401265335,Colorado State Rams,L. Brocke,4281823,,False,8.0,0,0,0,0,0,0,0,0,0,1,1,1,0,0,1,2,0
401265335,Colorado State Rams,TEAM,TOTAL,TOTAL,False,,38,64,25,39,13,25,22,30,14,25,39,21,6,8,8,21,111
401265334,Denver Pioneers,U. Ezeudu,4595918,,True,8.0,0,2,0,1,0,1,2,2,0,0,0,0,0,0,0,3,2
401265334,Denver Pioneers,E. Counsel,4704225,,True,24.0,3,7,2,4,1,3,5,5,0,0,0,1,2,0,2,2,12
401265334,Denver Pioneers,M. Boyd,4595914,,True,36.0,5,9,3,6,2,3,6,6,2,6,8,4,0,0,6,2,18
401265334,Denver Pioneers,T. Malonga,4399659,,True,23.0,4,4,4,4,0,0,3,4,1,4,5,2,0,1,1,0,11
401265334,Denver Pioneers,A. Jackson,4399656,,True,30.0,6,11,3,5,3,6,0,2,2,10,12,1,1,2,3,2,15
401265334,Denver Pioneers,C. Forney,4704228,,False,4.0,1,2,1,2,0,0,0,0,2,0,2,1,0,0,1,0,2
401265334,Denver Pioneers,J. Jeffcoat,4282517,,False,16.0,1,3,1,2,0,1,0,0,1,4,5,3,0,0,1,5,2
401265334,Denver Pioneers,R. Hein,4704226,,False,6.0,1,1,1,1,0,0,0,0,0,2,2,0,0,0,2,1,2
401265334,Denver Pioneers,S. Deem,4595917,,False,13.0,1,2,1,2,0,0,0,0,0,3,3,0,0,0,1,0,2
401265334,Denver Pioneers,A. Foster,4595916,,False,11.0,1,3,0,0,1,3,0,0,0,0,0,0,0,0,0,0,3
401265334,Denver Pioneers,C. Gritt,4282516,,False,29.0,3,8,2,4,1,4,3,4,2,2,4,2,2,0,4,1,10
401265334,Denver Pioneers,TEAM,TOTAL,TOTAL,False,,26,52,18,31,8,21,19,23,10,33,43,14,5,3,21,16,79
401265334,Air Force Falcons,R. Snyder,4399409,,True,39.0,12,24,11,18,1,6,3,3,2,3,5,2,3,0,3,2,28
401265334,Air Force Falcons,K. Huffman,4068225,,True,35.0,1,5,1,5,0,0,3,4,7,5,12,2,0,1,1,1,5
401265334,Air Force Falcons,C. Winters,4399406,,True,21.0,4,6,4,6,0,0,0,0,0,1,1,0,0,1,1,4,8
401265334,Air Force Falcons,A. Gadison,4399405,,True,13.0,2,4,0,0,2,4,0,0,0,0,0,0,1,0,0,4,6
401265334,Air Force Falcons,B. Autrey-Thompson,4399404,,True,35.0,6,18,4,14,2,4,2,4,2,1,3,8,5,0,0,2,16
401265334,Air Force Falcons,K. Pilson,4704411,,False,30.0,3,8,1,3,2,5,0,0,0,2,2,1,1,0,1,1,8
401265334,Air Force Falcons,J. Goodwin,4704410,,False,2.0,0,0,0,0,0,0,0,0,0,0,0,0,0,0,0,0,0
401265334,Air Force Falcons,E. Conroe,4281737,,False,25.0,5,12,4,9,1,3,0,0,2,2,4,1,3,0,2,3,11
401265334,Air Force Falcons,TEAM,TOTAL,TOTAL,False,,33,77,25,55,8,22,8,11,13,17,30,14,13,2,8,17,82
401265332,Denver Pioneers,J. Jeffcoat,4282517,,True,15.0,1,3,1,2,0,1,0,0,0,7,7,1,1,0,6,4,2
401265332,Denver Pioneers,S. Deem,4595917,,True,20.0,1,2,1,2,0,0,3,4,1,5,6,0,1,0,0,1,5
401265332,Denver Pioneers,M. Boyd,4595914,,True,32.0,7,16,3,8,4,8,2,2,0,5,5,2,2,0,5,4,20
401265332,Denver Pioneers,T. Malonga,4399659,,True,31.0,4,12,3,7,1,5,2,7,3,6,9,4,0,0,5,3,11
401265332,Denver Pioneers,C. Gritt,4282516,,True,26.0,1,6,0,1,1,5,2,4,0,3,3,0,0,0,2,4,5
401265332,Denver Pioneers,C. Forney,4704228,,False,1.0,0,0,0,0,0,0,0,0,0,0,0,0,0,0,0,0,0
401265332,Denver Pioneers,M. Johanson,4704224,,False,1.0,0,0,0,0,0,0,0,0,0,0,0,0,0,0,0,1,0
401265332,Denver Pioneers,U. Ezeudu,4595918,,False,29.0,4,4,4,4,0,0,8,8,1,4,5,3,4,0,0,0,16
401265332,Denver Pioneers,C. Levison,4704227,,False,1.0,0,0,0,0,0,0,0,0,0,0,0,0,0,0,1,1,0
401265332,Denver Pioneers,R. Hein,4704226,,False,18.0,2,2,2,2,0,0,1,4,0,2,2,2,0,0,0,2,5
401265332,Denver Pioneers,A. Foster,4595916,,False,1.0,0,0,0,0,0,0,0,0,0,0,0,0,0,0,0,0,0
401265332,Denver Pioneers,A. Jackson,4399656,,False,25.0,3,6,1,1,2,5,0,0,1,3,4,0,0,0,0,2,8
401265332,Denver Pioneers,TEAM,TOTAL,TOTAL,False,,23,51,15,27,8,24,18,29,8,39,47,12,8,0,20,22,72
401265332,Air Force Falcons,N. McDonald,4595618,,True,27.0,2,4,2,3,0,1,0,0,2,5,7,0,2,0,2,2,4
401265332,Air Force Falcons,R. Snyder,4399409,,True,25.0,1,8,1,5,0,3,1,2,0,2,2,2,1,0,2,4,3
401265332,Air Force Falcons,B. Autrey-Thompson,4399404,,True,31.0,8,16,7,13,1,3,8,11,0,2,2,3,4,0,3,2,25
401265332,Air Force Falcons,K. Immel,4281743,,True,31.0,3,11,3,6,0,5,0,1,1,3,4,0,1,0,1,1,6
401265332,Air Force Falcons,E. Conroe,4281737,,True,16.0,1,5,1,4,0,1,0,0,4,2,6,1,3,0,1,3,2
401265332,Air Force Falcons,T. Siler,4704415,,False,4.0,0,1,0,1,0,0,0,0,0,1,1,0,0,0,0,1,0
401265332,Air Force Falcons,D. MacMillan,4704414,,False,20.0,1,7,0,2,1,5,0,0,1,2,3,1,0,0,0,1,3
401265332,Air Force Falcons,H. Jones,4399403,,False,4.0,0,0,0,0,0,0,0,0,0,0,0,0,0,0,0,2,0
401265332,Air Force Falcons,K. Huffman,4068225,,False,9.0,2,3,2,3,0,0,0,0,2,0,2,0,0,0,1,4,4
401265332,Air Force Falcons,S. Thomas,4704413,,False,7.0,0,1,0,1,0,0,0,0,0,1,1,1,0,0,0,1,0
401265332,Air Force Falcons,K. Pilson,4704411,,False,6.0,1,2,1,1,0,1,0,0,0,0,0,0,0,0,1,0,2
401265332,Air Force Falcons,A. Marlett,4595617,,False,9.0,1,3,1,2,0,1,0,0,0,1,1,1,1,0,1,1,2
401265332,Air Force Falcons,K. Heath,4595614,,False,1.0,0,1,0,1,0,0,0,0,0,0,0,0,0,0,0,0,0
401265332,Air Force Falcons,C. Winters,4399406,,False,8.0,1,3,1,2,0,1,3,4,0,1,1,0,0,0,1,1,5
401265332,Air Force Falcons,A. Gadison,4399405,,False,2.0,0,1,0,0,0,1,0,0,0,0,0,0,0,0,0,1,0
401265332,Air Force Falcons,TEAM,TOTAL,TOTAL,False,,21,66,19,44,2,22,12,18,10,25,35,9,12,0,13,24,56
401264810,San Diego Toreros,K. Bird,4282108,,True,22.0,3,7,3,7,0,0,1,1,1,3,4,1,0,0,1,1,7
401264810,San Diego Toreros,E. Martinsen,4595849,,True,14.0,2,7,0,0,2,7,0,0,0,1,1,0,0,0,2,2,6
401264810,San Diego Toreros,A. Khalfani,4595847,,True,22.0,0,7,0,6,0,1,0,0,3,2,5,0,2,0,3,2,0
401264810,San Diego Toreros,S. Hunter,4282109,,True,35.0,6,9,6,9,0,0,1,2,2,6,8,2,1,0,1,2,13
401264810,San Diego Toreros,J. Edwards,4068245,,True,32.0,4,17,2,9,2,8,1,2,2,5,7,3,3,0,1,5,11
401264810,San Diego Toreros,L. Erikstrup,4703852,,False,12.0,3,6,3,6,0,0,2,4,2,1,3,0,0,0,2,3,8
401264810,San Diego Toreros,A. Olinger,4595850,,False,20.0,1,3,1,2,0,1,0,0,0,7,7,0,0,1,1,2,2
401264810,San Diego Toreros,N. Blakes,4400503,,False,14.0,1,2,1,2,0,0,0,0,1,2,3,0,2,0,1,1,2
401264810,San Diego Toreros,G. Giuffre,4703853,,False,16.0,2,6,2,4,0,2,0,0,0,1,1,0,0,0,2,3,4
401264810,San Diego Toreros,K. Martinez,4400501,,False,13.0,1,5,0,2,1,3,0,0,0,0,0,0,0,0,1,1,3
401264810,San Diego Toreros,TEAM,TOTAL,TOTAL,False,,23,69,18,47,5,22,5,9,15,29,44,6,8,1,17,22,56
401264810,San Diego State Aztecs,K. Edwards,4281879,,True,17.0,2,4,2,4,0,0,3,4,0,0,0,0,0,1,0,0,7
401264810,San Diego State Aztecs,S. Ramos,4400168,,True,38.0,5,16,5,13,0,3,5,5,0,10,10,4,5,1,2,2,15
401264810,San Diego State Aztecs,A. Crain,4399223,,True,19.0,1,5,1,3,0,2,1,2,1,1,2,1,2,0,1,3,3
401264810,San Diego State Aztecs,M. Staples,4398925,,True,30.0,3,9,1,2,2,7,4,4,0,7,7,0,0,0,1,2,12
401264810,San Diego State Aztecs,T. Adams,4281876,,True,25.0,9,10,8,8,1,2,0,0,0,2,2,2,2,0,5,0,19
401264810,San Diego State Aztecs,K. Gipson,4704563,,False,18.0,1,4,1,4,0,0,0,0,3,4,7,1,0,0,3,3,2
401264810,San Diego State Aztecs,F. Vinerte,4704564,,False,2.0,0,0,0,0,0,0,0,0,0,0,0,0,0,0,1,1,0
401264810,San Diego State Aztecs,K. Villalobos,4704565,,False,18.0,1,5,1,5,0,0,1,3,2,2,4,1,1,0,0,1,3
401264810,San Diego State Aztecs,T. Sireni,4595648,,False,3.0,0,0,0,0,0,0,1,2,0,0,0,0,0,0,0,0,1
401264810,San Diego State Aztecs,I. Hernandez,4595647,,False,30.0,1,5,1,2,0,3,0,0,0,1,1,1,0,0,2,2,2
401264810,San Diego State Aztecs,TEAM,TOTAL,TOTAL,False,,23,58,20,41,3,17,15,20,8,31,39,10,10,2,20,14,64
401264553,Washington Huskies,Q. Miller,4433122,,True,34.0,8,23,7,15,1,8,2,2,4,6,10,2,0,0,1,1,19
401264553,Washington Huskies,H. Van Dyke,4398875,,True,36.0,6,17,5,14,1,3,0,2,4,3,7,1,2,0,3,0,13
401264553,Washington Huskies,K. Rooks,4282188,,True,32.0,2,6,1,2,1,4,0,0,1,3,4,3,2,0,2,1,5
401264553,Washington Huskies,T. Sadler,4595340,,True,25.0,5,12,5,10,0,2,2,2,1,2,3,2,0,0,2,2,12
401264553,Washington Huskies,J. Noble,4433765,,True,26.0,4,6,4,4,0,2,0,0,2,7,9,1,2,0,0,3,8
401264553,Washington Huskies,A. Whitfield,4433776,,False,13.0,2,3,2,3,0,0,0,0,2,1,3,0,1,0,2,0,4
401264553,Washington Huskies,C. Lind,4603331,,False,20.0,0,2,0,0,0,2,0,0,1,1,2,0,0,0,1,1,0
401264553,Washington Huskies,N. Lowery,4433385,,False,14.0,0,2,0,0,0,2,0,0,0,0,0,2,1,0,2,1,0
401264553,Washington Huskies,TEAM,TOTAL,TOTAL,False,,27,71,24,48,3,23,4,6,18,24,42,11,8,0,13,9,61
401264553,San Diego State Aztecs,K. Edwards,4281879,,True,24.0,1,1,1,1,0,0,0,0,1,1,2,0,0,0,2,3,2
401264553,San Diego State Aztecs,S. Ramos,4400168,,True,38.0,6,12,5,8,1,4,4,4,0,7,7,3,1,0,5,2,17
401264553,San Diego State Aztecs,A. Crain,4399223,,True,32.0,5,7,4,5,1,2,1,2,0,3,3,1,2,0,2,0,12
401264553,San Diego State Aztecs,M. Staples,4398925,,True,34.0,3,10,3,9,0,1,2,2,0,8,8,2,3,0,2,2,8
401264553,San Diego State Aztecs,T. Adams,4281876,,True,32.0,3,8,2,6,1,2,0,2,0,3,3,4,2,1,2,0,7
401264553,San Diego State Aztecs,K. Gipson,4704563,,False,2.0,0,0,0,0,0,0,0,0,0,0,0,1,0,0,0,0,0
401264553,San Diego State Aztecs,T. Sireni,4595648,,False,13.0,1,2,0,1,1,1,0,0,0,0,0,0,0,0,0,0,3
401264553,San Diego State Aztecs,I. Hernandez,4595647,,False,25.0,4,9,2,6,2,3,0,0,0,2,2,0,1,0,0,1,10
401264553,San Diego State Aztecs,TEAM,TOTAL,TOTAL,False,,23,49,17,36,6,13,7,10,2,28,30,11,9,1,14,8,59
401264483,Colorado State Rams,K. Murphy,4068969,,True,24.0,7,10,7,10,0,0,5,6,4,5,9,1,0,0,2,0,19
401264483,Colorado State Rams,E. Boni,4704462,,True,36.0,4,9,3,8,1,1,1,2,0,1,1,1,1,0,1,2,10
401264483,Colorado State Rams,M. Hofschild,4595160,,True,38.0,5,10,4,9,1,1,4,6,0,1,1,5,1,0,6,2,15
401264483,Colorado State Rams,L. Devos,4284002,,True,27.0,2,11,2,9,0,2,0,0,2,3,5,2,4,0,1,2,4
401264483,Colorado State Rams,T. Williams,4282176,,True,40.0,6,14,3,5,3,9,0,1,0,5,5,0,0,0,1,1,15
401264483,Colorado State Rams,J. Bonnarens,4400102,,False,12.0,0,2,0,2,0,0,0,0,1,2,3,0,0,0,1,2,0
401264483,Colorado State Rams,B. Alper,4595629,,False,1.0,0,0,0,0,0,0,0,0,0,0,0,0,0,0,0,0,0
401264483,Colorado State Rams,S. Mech,4399658,,False,22.0,2,2,1,1,1,1,0,0,0,1,1,2,0,0,1,2,5
401264483,Colorado State Rams,TEAM,TOTAL,TOTAL,False,,26,58,20,44,6,14,10,15,12,23,35,11,6,0,13,11,68
401264483,Colorado State Rams,K. Murphy,4068969,,True,24.0,7,10,7,10,0,0,5,6,4,5,9,1,0,0,2,0,19
401264483,Colorado State Rams,E. Boni,4704462,,True,36.0,4,9,3,8,1,1,1,2,0,1,1,1,1,0,1,2,10
401264483,Colorado State Rams,M. Hofschild,4595160,,True,38.0,5,10,4,9,1,1,4,6,0,1,1,5,1,0,6,2,15
401264483,Colorado State Rams,L. Devos,4284002,,True,27.0,2,11,2,9,0,2,0,0,2,3,5,2,4,0,1,2,4
401264483,Colorado State Rams,T. Williams,4282176,,True,40.0,6,14,3,5,3,9,0,1,0,5,5,0,0,0,1,1,15
401264483,Colorado State Rams,J. Bonnarens,4400102,,False,12.0,0,2,0,2,0,0,0,0,1,2,3,0,0,0,1,2,0
401264483,Colorado State Rams,B. Alper,4595629,,False,1.0,0,0,0,0,0,0,0,0,0,0,0,0,0,0,0,0,0
401264483,Colorado State Rams,S. Mech,4399658,,False,22.0,2,2,1,1,1,1,0,0,0,1,1,2,0,0,1,2,5
401264483,Colorado State Rams,TEAM,TOTAL,TOTAL,False,,26,58,20,44,6,14,10,15,12,23,35,11,6,0,13,11,68
401264483,Air Force Falcons,R. Snyder,4399409,,True,31.0,8,14,4,9,4,5,2,3,0,4,4,1,0,1,2,1,22
401264483,Air Force Falcons,K. Huffman,4068225,,True,19.0,0,1,0,1,0,0,0,0,4,3,7,2,0,2,0,2,0
401264483,Air Force Falcons,B. Autrey-Thompson,4399404,,True,23.0,6,12,6,11,0,1,1,2,0,2,2,4,1,0,3,4,13
401264483,Air Force Falcons,K. Immel,4281743,,True,36.0,4,9,4,9,0,0,0,0,0,3,3,4,0,0,1,1,8
401264483,Air Force Falcons,E. Conroe,4281737,,True,9.0,0,0,0,0,0,0,0,0,1,1,2,1,0,1,0,2,0
401264483,Air Force Falcons,D. MacMillan,4704414,,False,26.0,4,6,1,1,3,5,0,0,0,4,4,2,0,0,0,1,11
401264483,Air Force Falcons,N. McDonald,4595618,,False,21.0,1,3,0,0,1,3,2,2,1,3,4,1,1,0,1,0,5
401264483,Air Force Falcons,K. Pilson,4704411,,False,14.0,3,6,2,5,1,1,2,2,0,0,0,0,1,0,1,0,9
401264483,Air Force Falcons,K. Heath,4595614,,False,4.0,1,1,1,1,0,0,0,0,0,0,0,0,1,0,1,2,2
401264483,Air Force Falcons,C. Winters,4399406,,False,17.0,1,9,1,9,0,0,3,4,3,1,4,0,1,2,0,1,5
401264483,Air Force Falcons,TEAM,TOTAL,TOTAL,False,,28,61,19,46,9,15,10,13,11,24,35,15,5,6,9,14,75
401264483,Air Force Falcons,R. Snyder,4399409,,True,31.0,8,14,4,9,4,5,2,3,0,4,4,1,0,1,2,1,22
401264483,Air Force Falcons,K. Huffman,4068225,,True,19.0,0,1,0,1,0,0,0,0,4,3,7,2,0,2,0,2,0
401264483,Air Force Falcons,B. Autrey-Thompson,4399404,,True,23.0,6,12,6,11,0,1,1,2,0,2,2,4,1,0,3,4,13
401264483,Air Force Falcons,K. Immel,4281743,,True,36.0,4,9,4,9,0,0,0,0,0,3,3,4,0,0,1,1,8
401264483,Air Force Falcons,E. Conroe,4281737,,True,9.0,0,0,0,0,0,0,0,0,1,1,2,1,0,1,0,2,0
401264483,Air Force Falcons,D. MacMillan,4704414,,False,26.0,4,6,1,1,3,5,0,0,0,4,4,2,0,0,0,1,11
401264483,Air Force Falcons,N. McDonald,4595618,,False,21.0,1,3,0,0,1,3,2,2,1,3,4,1,1,0,1,0,5
401264483,Air Force Falcons,K. Pilson,4704411,,False,14.0,3,6,2,5,1,1,2,2,0,0,0,0,1,0,1,0,9
401264483,Air Force Falcons,K. Heath,4595614,,False,4.0,1,1,1,1,0,0,0,0,0,0,0,0,1,0,1,2,2
401264483,Air Force Falcons,C. Winters,4399406,,False,17.0,1,9,1,9,0,0,3,4,3,1,4,0,1,2,0,1,5
401264483,Air Force Falcons,TEAM,TOTAL,TOTAL,False,,28,61,19,46,9,15,10,13,11,24,35,15,5,6,9,14,75
401263485,Saint Mary's Gaels,F. Tonga,4595843,,True,16.0,3,8,3,8,0,0,0,0,4,4,8,0,2,0,3,3,6
401263485,Saint Mary's Gaels,T. Dalton,4703841,,True,20.0,4,11,1,4,3,7,0,0,0,1,1,0,0,0,2,2,11
401263485,Saint Mary's Gaels,J. Kirisome,4400618,,True,34.0,7,14,3,5,4,9,0,0,2,1,3,4,1,0,4,2,18
401263485,Saint Mary's Gaels,T. Wedin,4400497,,True,35.0,7,19,2,2,5,17,0,0,2,0,2,1,1,0,2,0,19
401263485,Saint Mary's Gaels,B. Simonich,4282103,,True,31.0,2,5,2,3,0,2,0,0,5,8,13,4,1,1,3,2,4
401263485,Saint Mary's Gaels,E. Croco,4703842,,False,14.0,1,2,1,2,0,0,1,2,2,5,7,0,0,0,2,3,3
401263485,Saint Mary's Gaels,M. Grizelj,4595842,,False,14.0,1,4,1,3,0,1,0,0,1,2,3,2,1,0,1,3,2
401263485,Saint Mary's Gaels,J. Boesel,4282101,,False,20.0,2,7,2,4,0,3,0,0,1,0,1,1,0,0,2,1,4
401263485,Saint Mary's Gaels,M. Holland,4282100,,False,16.0,2,4,2,3,0,1,0,0,1,0,1,1,1,0,0,4,4
401263485,Saint Mary's Gaels,TEAM,TOTAL,TOTAL,False,,29,74,17,34,12,40,1,2,22,22,44,13,7,1,19,20,71
401263485,Fresno State Bulldogs,W. Motta,4595631,,True,20.0,1,6,1,6,0,0,2,2,1,6,7,0,0,0,2,0,4
401263485,Fresno State Bulldogs,K. Kinzer,4595630,,True,23.0,2,7,0,2,2,5,2,2,2,0,2,2,0,0,0,0,8
401263485,Fresno State Bulldogs,Hal. Cavinder,4433658,,True,37.0,8,14,5,10,3,4,0,0,0,7,7,2,0,1,0,0,19
401263485,Fresno State Bulldogs,Han. Cavinder,4433372,,True,33.0,8,12,8,10,0,2,5,6,1,1,2,5,2,0,4,2,21
401263485,Fresno State Bulldogs,A. Gamez,4281826,,True,29.0,4,8,2,4,2,4,6,7,2,3,5,4,3,0,0,0,16
401263485,Fresno State Bulldogs,C. Fairley,4704474,,False,1.0,0,1,0,1,0,0,0,0,0,0,0,0,0,0,0,1,0
401263485,Fresno State Bulldogs,M. Guimaraes,4704476,,False,9.0,1,1,1,1,0,0,1,2,1,2,3,0,0,0,3,1,3
401263485,Fresno State Bulldogs,Y. Todorova,4704475,,False,16.0,3,3,2,2,1,1,0,0,0,1,1,0,0,0,0,1,7
401263485,Fresno State Bulldogs,K. Brown,4704473,,False,27.0,5,6,3,3,2,3,0,1,1,3,4,0,2,0,3,2,12
401263485,Fresno State Bulldogs,D. Dunn,4433511,,False,5.0,0,1,0,1,0,0,0,0,0,0,0,0,0,0,0,0,0
401263485,Fresno State Bulldogs,TEAM,TOTAL,TOTAL,False,,32,59,22,40,10,19,16,20,8,23,31,13,7,1,12,7,90
401263153,Colorado Buffaloes,P. Tuitele,4595865,,True,15.0,3,3,3,3,0,0,1,4,1,1,2,0,1,0,2,2,7
401263153,Colorado Buffaloes,M. Hollingshed,4281923,,True,31.0,8,9,8,8,0,1,1,2,3,8,11,1,0,1,4,1,17
401263153,Colorado Buffaloes,J. Sherrod,4433386,,True,24.0,5,10,5,10,0,0,1,3,0,3,3,5,6,0,2,2,11
401263153,Colorado Buffaloes,L. Finau,4398760,,True,16.0,0,4,0,4,0,0,0,0,1,6,7,5,0,0,0,2,0
401263153,Colorado Buffaloes,A. Knight,4281925,,True,16.0,4,4,4,4,0,0,2,2,1,4,5,1,1,0,2,3,10
401263153,Colorado Buffaloes,K. Blacksten,4703587,,False,12.0,2,2,2,2,0,0,0,1,0,1,1,1,1,0,0,1,4
401263153,Colorado Buffaloes,C. Whittaker,4595866,,False,17.0,4,7,4,6,0,1,2,2,1,1,2,0,0,0,4,4,10
401263153,Colorado Buffaloes,A. Jank,4281926,,False,16.0,1,1,1,1,0,0,0,2,1,1,2,0,1,0,1,1,2
401263153,Colorado Buffaloes,F. Formann,4703586,,False,24.0,5,10,4,7,1,3,2,2,2,2,4,2,0,0,1,2,13
401263153,Colorado Buffaloes,M. Buford,4703585,,False,13.0,2,6,2,5,0,1,1,1,2,1,3,0,1,1,2,3,5
401263153,Colorado Buffaloes,Z. Kulinska,4595864,,False,9.0,0,0,0,0,0,0,4,6,0,0,0,0,3,0,0,0,4
401263153,Colorado Buffaloes,A. Lafontaine,4595355,,False,7.0,2,2,2,2,0,0,1,2,0,1,1,2,1,0,0,0,5
401263153,Colorado Buffaloes,TEAM,TOTAL,TOTAL,False,,36,58,35,52,1,6,15,27,15,31,46,17,15,2,18,21,88
401263153,Air Force Falcons,N. McDonald,4595618,,True,26.0,0,3,0,3,0,0,0,0,1,1,2,0,3,0,2,0,0
401263153,Air Force Falcons,R. Snyder,4399409,,True,32.0,3,11,1,5,2,6,6,6,0,1,1,0,1,1,1,3,14
401263153,Air Force Falcons,B. Autrey-Thompson,4399404,,True,29.0,2,7,2,7,0,0,2,2,0,1,1,0,2,0,7,4,6
401263153,Air Force Falcons,K. Immel,4281743,,True,28.0,5,18,3,10,2,8,4,4,3,2,5,4,1,0,3,4,16
401263153,Air Force Falcons,E. Conroe,4281737,,True,22.0,1,7,1,4,0,3,0,0,4,2,6,0,1,0,1,2,2
401263153,Air Force Falcons,D. MacMillan,4704414,,False,6.0,0,0,0,0,0,0,0,0,1,0,1,0,0,0,0,0,0
401263153,Air Force Falcons,H. Jones,4399403,,False,15.0,1,2,1,2,0,0,0,0,0,2,2,0,1,0,2,5,2
401263153,Air Force Falcons,K. Huffman,4068225,,False,8.0,0,0,0,0,0,0,0,0,0,1,1,0,0,0,0,0,0
401263153,Air Force Falcons,S. Thomas,4704413,,False,2.0,0,0,0,0,0,0,0,0,0,0,0,0,0,0,1,0,0
401263153,Air Force Falcons,K. Pilson,4704411,,False,4.0,0,0,0,0,0,0,0,0,0,0,0,0,0,0,0,0,0
401263153,Air Force Falcons,A. Marlett,4595617,,False,8.0,1,2,1,2,0,0,0,1,1,0,1,0,0,0,3,3,2
401263153,Air Force Falcons,K. Heath,4595614,,False,3.0,0,1,0,1,0,0,0,0,0,0,0,0,1,0,2,0,0
401263153,Air Force Falcons,C. Winters,4399406,,False,9.0,0,3,0,3,0,0,1,2,0,1,1,0,1,0,0,0,1
401263153,Air Force Falcons,A. Gadison,4399405,,False,8.0,1,2,0,0,1,2,0,0,0,0,0,0,0,0,1,2,3
401263153,Air Force Falcons,TEAM,TOTAL,TOTAL,False,,14,56,9,37,5,19,13,15,12,14,26,4,11,1,23,23,46
401263103,Utah State Aggies,J. Chatman,4068281,,True,41.0,6,15,5,9,1,6,5,7,2,11,13,2,0,0,3,4,18
401263103,Utah State Aggies,M. Mendazona,4704647,,True,29.0,4,11,4,8,0,3,0,0,2,7,9,2,0,1,3,3,8
401263103,Utah State Aggies,K. Kamakawiwo'ole,4595670,,True,29.0,6,11,5,8,1,3,4,7,6,4,10,0,1,1,0,4,17
401263103,Utah State Aggies,F. Brantley,4595669,,True,33.0,3,11,2,6,1,5,2,4,0,5,5,3,0,0,3,4,9
401263103,Utah State Aggies,E. Harris,4281891,,True,35.0,1,14,0,6,1,8,3,6,0,3,3,2,2,1,6,3,6
401263103,Utah State Aggies,T. Franson,4281892,,False,6.0,0,0,0,0,0,0,0,0,0,2,2,0,0,0,0,0,0
401263103,Utah State Aggies,M. Pruitt,4704651,,False,13.0,2,6,2,5,0,1,1,2,0,1,1,1,1,0,0,4,5
401263103,Utah State Aggies,A. Lustgarten,4704649,,False,1.0,0,0,0,0,0,0,0,0,0,0,0,0,0,0,0,0,0
401263103,Utah State Aggies,K. Falslev,4704648,,False,8.0,1,3,0,0,1,3,0,0,0,1,1,0,0,0,0,1,3
401263103,Utah State Aggies,E. Emrich,4595671,,False,25.0,1,2,1,2,0,0,0,0,1,1,2,3,1,0,2,1,2
401263103,Utah State Aggies,S. Latone,4399209,,False,5.0,1,3,1,1,0,2,2,2,0,0,0,0,0,0,0,0,4
401263103,Utah State Aggies,TEAM,TOTAL,TOTAL,False,,25,76,20,45,5,31,17,28,12,37,49,13,5,3,17,24,72
401263103,Seattle U Redhawks,M. Phillips,4595650,,True,18.0,3,8,2,5,1,3,0,0,1,1,2,1,1,0,1,1,7
401263103,Seattle U Redhawks,C. Ezeonu,4281883,,True,27.0,1,10,1,10,0,0,1,2,3,8,11,0,3,0,2,2,3
401263103,Seattle U Redhawks,H. Vice-Neat,4281746,,True,38.0,4,13,0,3,4,10,1,2,3,8,11,0,0,1,0,2,13
401263103,Seattle U Redhawks,B. Calhoun,4703934,,True,27.0,1,11,0,5,1,6,1,2,5,3,8,5,0,0,1,4,4
401263103,Seattle U Redhawks,M. Williams,4282325,,True,32.0,2,10,2,7,0,3,6,6,4,9,13,3,0,1,5,4,10
401263103,Seattle U Redhawks,I. Korolenko,4703935,,False,1.0,0,0,0,0,0,0,0,0,0,0,0,0,0,0,0,0,0
401263103,Seattle U Redhawks,G. Kehoe,4400003,,False,20.0,4,8,4,8,0,0,5,7,1,4,5,2,4,1,3,3,13
401263103,Seattle U Redhawks,P. Howard,4703932,,False,24.0,1,7,1,4,0,3,5,6,1,3,4,1,0,1,4,5,7
401263103,Seattle U Redhawks,M. DuBois,4595649,,False,10.0,0,2,0,0,0,2,2,2,1,0,1,0,0,0,0,2,2
401263103,Seattle U Redhawks,C. Murphy,4400002,,False,22.0,5,10,3,4,2,6,3,3,0,5,5,0,2,1,1,2,15
401263103,Seattle U Redhawks,M. Schoenhofer,4282328,,False,6.0,0,2,0,2,0,0,1,2,1,0,1,0,0,0,1,1,1
401263103,Seattle U Redhawks,TEAM,TOTAL,TOTAL,False,,21,81,13,48,8,33,25,32,24,42,66,12,10,5,18,26,75
401263102,Utah State Aggies,J. Chatman,4068281,,True,28.0,4,8,3,7,1,1,1,2,2,5,7,2,0,0,4,4,10
401263102,Utah State Aggies,H. Nelson,4704652,,True,13.0,0,4,0,1,0,3,0,0,1,3,4,0,0,0,1,4,0
401263102,Utah State Aggies,M. Mendazona,4704647,,True,24.0,5,10,4,8,1,2,5,6,1,5,6,0,0,0,0,2,16
401263102,Utah State Aggies,F. Brantley,4595669,,True,24.0,2,4,1,2,1,2,0,0,0,3,3,0,0,0,1,3,5
401263102,Utah State Aggies,E. Harris,4281891,,True,29.0,2,9,2,5,0,4,6,6,1,10,11,2,0,0,3,2,10
401263102,Utah State Aggies,B. Mathews,4400146,,False,2.0,0,0,0,0,0,0,0,0,0,0,0,0,0,0,0,0,0
401263102,Utah State Aggies,T. Franson,4281892,,False,12.0,2,4,2,4,0,0,3,5,1,1,2,0,1,0,0,1,7
401263102,Utah State Aggies,M. Pruitt,4704651,,False,15.0,1,7,0,5,1,2,2,2,0,1,1,0,1,1,1,2,5
401263102,Utah State Aggies,P. Williams,4704650,,False,9.0,0,4,0,3,0,1,0,0,0,0,0,1,0,0,0,3,0
401263102,Utah State Aggies,A. Lustgarten,4704649,,False,2.0,0,0,0,0,0,0,0,0,0,0,0,0,0,0,0,1,0
401263102,Utah State Aggies,K. Falslev,4704648,,False,9.0,1,2,0,0,1,2,0,0,0,0,0,0,0,0,1,0,3
401263102,Utah State Aggies,E. Emrich,4595671,,False,17.0,1,2,1,2,0,0,0,2,0,1,1,0,0,0,1,1,2
401263102,Utah State Aggies,K. Kamakawiwo'ole,4595670,,False,8.0,0,1,0,1,0,0,0,0,0,0,0,1,1,0,1,0,0
401263102,Utah State Aggies,S. Latone,4399209,,False,8.0,1,4,0,1,1,3,0,0,0,2,2,0,0,0,0,1,3
401263102,Utah State Aggies,TEAM,TOTAL,TOTAL,False,,19,59,13,39,6,20,17,23,8,32,40,6,3,1,13,24,61
401263102,Idaho State Bengals,E. Smith,4281638,,True,6.0,0,1,0,1,0,0,0,0,0,0,0,0,0,0,0,5,0
401263102,Idaho State Bengals,D. Konate,4410113,,True,26.0,4,8,3,6,1,2,8,11,0,4,4,3,0,0,2,2,17
401263102,Idaho State Bengals,C. Bourne,4399905,,True,16.0,1,2,1,1,0,1,2,2,0,8,8,3,1,0,1,4,4
401263102,Idaho State Bengals,D. Goles,4281636,,True,23.0,10,14,7,10,3,4,1,1,1,3,4,3,2,0,1,1,24
401263102,Idaho State Bengals,E. Ors,4068698,,True,22.0,3,10,1,5,2,5,0,0,0,9,9,2,0,0,2,1,8
401263102,Idaho State Bengals,M. Oltrogge,4399907,,False,14.0,1,5,1,3,0,2,0,0,0,3,3,0,1,0,2,1,2
401263102,Idaho State Bengals,D. Moore,4281639,,False,22.0,3,8,3,7,0,1,0,0,1,3,4,1,0,0,0,0,6
401263102,Idaho State Bengals,F. Garnett,4704767,,False,15.0,2,4,1,2,1,2,1,2,0,2,2,1,0,0,0,4,6
401263102,Idaho State Bengals,L. Bevao,4704765,,False,10.0,2,2,2,2,0,0,2,4,1,1,2,0,0,0,0,1,6
401263102,Idaho State Bengals,J. Sweeney,4594833,,False,14.0,1,2,1,1,0,1,1,2,0,1,1,0,1,0,0,2,3
401263102,Idaho State Bengals,C. Boswell,4594832,,False,13.0,0,2,0,0,0,2,2,2,1,0,1,1,1,0,0,0,2
401263102,Idaho State Bengals,T. Whitman,4594829,,False,19.0,3,10,2,6,1,4,0,0,1,0,1,0,0,0,1,3,7
401263102,Idaho State Bengals,TEAM,TOTAL,TOTAL,False,,30,68,22,44,8,24,17,24,7,35,42,14,6,0,9,24,85
401263085,UNLV Lady Rebels,D. Byrne,4398924,,True,36.0,7,12,2,5,5,7,5,5,3,8,11,2,0,0,1,0,24
401263085,UNLV Lady Rebels,D. Young,4704625,,True,27.0,4,10,4,10,0,0,7,7,3,2,5,1,1,0,3,3,15
401263085,UNLV Lady Rebels,J. Thomas,4704624,,True,39.0,8,12,1,2,7,10,1,2,3,4,7,2,2,0,1,1,24
401263085,UNLV Lady Rebels,N. Johnson,4400108,,True,23.0,2,9,2,5,0,4,5,6,1,3,4,2,3,0,1,3,9
401263085,UNLV Lady Rebels,B. Thomas,4068210,,True,37.0,1,5,0,1,1,4,4,4,2,5,7,7,2,0,2,2,7
401263085,UNLV Lady Rebels,T. Carter,4595642,,False,4.0,0,0,0,0,0,0,1,2,0,0,0,0,0,1,0,0,1
401263085,UNLV Lady Rebels,A. Blount,4595640,,False,5.0,1,1,1,1,0,0,2,2,1,0,1,0,0,0,1,1,4
401263085,UNLV Lady Rebels,K. Wilfred,4595641,,False,8.0,0,3,0,3,0,0,0,2,2,0,2,1,0,0,0,0,0
401263085,UNLV Lady Rebels,J. Singleton,4704623,,False,5.0,1,1,1,1,0,0,0,0,0,2,2,0,1,0,3,1,2
401263085,UNLV Lady Rebels,C. Gurrola,4595644,,False,1.0,0,1,0,0,0,1,0,0,0,0,0,0,0,0,0,0,0
401263085,UNLV Lady Rebels,J. Buckley,4595639,,False,15.0,3,5,1,2,2,3,0,0,0,1,1,2,0,1,2,1,8
401263085,UNLV Lady Rebels,TEAM,TOTAL,TOTAL,False,,27,59,12,30,15,29,25,30,17,32,49,17,9,2,18,12,94
401263085,Loyola Marymount Lions,K. Clark,4595789,,True,29.0,2,11,2,11,0,0,2,2,4,6,10,1,0,2,1,3,6
401263085,Loyola Marymount Lions,M. Mandel,4068084,,True,15.0,1,1,1,1,0,0,0,0,1,2,3,2,1,2,2,4,2
401263085,Loyola Marymount Lions,C. Ellington,4433051,,True,25.0,5,10,5,9,0,1,3,4,0,1,1,1,2,0,0,3,13
401263085,Loyola Marymount Lions,N. Rodriguez,4703866,,True,34.0,5,9,1,1,4,8,0,0,1,2,3,4,0,0,4,2,14
401263085,Loyola Marymount Lions,A. Johnson,4398632,,True,28.0,5,13,5,11,0,2,0,0,3,1,4,4,4,0,3,2,10
401263085,Loyola Marymount Lions,L. Vaida,4595787,,False,9.0,1,2,1,2,0,0,0,0,2,0,2,1,0,0,1,3,2
401263085,Loyola Marymount Lions,N. Klimek,4595788,,False,23.0,0,6,0,1,0,5,2,2,0,1,1,2,0,0,1,1,2
401263085,Loyola Marymount Lions,C. Gordon,4399350,,False,27.0,2,7,2,6,0,1,0,0,0,3,3,1,0,0,1,2,4
401263085,Loyola Marymount Lions,C. Gipson,4282012,,False,10.0,2,7,0,2,2,5,0,0,0,1,1,0,1,0,0,1,6
401263085,Loyola Marymount Lions,TEAM,TOTAL,TOTAL,False,,23,66,17,44,6,22,7,8,12,18,30,16,8,4,15,21,59
401263084,UNLV Lady Rebels,D. Byrne,4398924,,True,38.0,7,14,3,5,4,9,0,0,0,10,10,0,0,0,4,2,18
401263084,UNLV Lady Rebels,D. Young,4704625,,True,21.0,3,8,3,8,0,0,3,4,2,5,7,0,2,0,3,5,9
401263084,UNLV Lady Rebels,J. Thomas,4704624,,True,45.0,3,8,1,2,2,6,2,2,0,1,1,2,0,0,1,0,10
401263084,UNLV Lady Rebels,N. Johnson,4400108,,True,46.0,5,14,4,8,1,6,8,10,6,6,12,3,1,0,2,1,19
401263084,UNLV Lady Rebels,B. Thomas,4068210,,True,50.0,4,12,2,3,2,9,3,3,1,4,5,6,1,0,3,4,13
401263084,UNLV Lady Rebels,T. Carter,4595642,,False,7.0,0,2,0,0,0,2,0,0,0,2,2,0,0,0,0,0,0
401263084,UNLV Lady Rebels,A. Blount,4595640,,False,8.0,1,2,1,2,0,0,0,0,2,1,3,0,0,0,3,3,2
401263084,UNLV Lady Rebels,K. Wilfred,4595641,,False,26.0,2,4,2,4,0,0,0,2,0,3,3,2,0,0,5,5,4
401263084,UNLV Lady Rebels,J. Singleton,4704623,,False,5.0,0,1,0,1,0,0,0,0,0,2,2,0,0,0,2,0,0
401263084,UNLV Lady Rebels,J. Buckley,4595639,,False,4.0,0,3,0,2,0,1,0,0,0,0,0,1,0,0,0,0,0
401263084,UNLV Lady Rebels,TEAM,TOTAL,TOTAL,False,,25,68,16,35,9,33,16,21,11,39,50,14,4,0,24,20,75
401263084,Pacific Tigers,B. McDavid,4282041,,True,36.0,5,18,5,18,0,0,0,2,7,2,9,2,0,0,1,4,10
401263084,Pacific Tigers,J. Millard,4400484,,True,29.0,2,4,2,3,0,1,1,1,0,1,1,1,1,0,1,2,5
401263084,Pacific Tigers,J. Cruz,4282175,,True,21.0,1,3,1,1,0,2,0,0,0,1,1,0,0,0,2,3,2
401263084,Pacific Tigers,V. Higgins,4282045,,True,39.0,7,17,7,15,0,2,10,13,1,10,11,4,8,0,1,2,24
401263084,Pacific Tigers,L. Tillman,4282044,,True,44.0,4,10,1,3,3,7,0,0,0,4,4,3,2,0,5,1,11
401263084,Pacific Tigers,M. Ennis,4595811,,False,4.0,1,1,1,1,0,0,0,0,0,1,1,0,1,0,0,0,2
401263084,Pacific Tigers,R. Schweizer,4412217,,False,32.0,7,16,5,11,2,5,5,5,3,5,8,1,2,0,1,2,21
401263084,Pacific Tigers,S. Whitehead,4282043,,False,12.0,0,3,0,3,0,0,0,0,1,0,1,2,1,0,1,2,0
401263084,Pacific Tigers,C. Johnson,4400485,,False,3.0,0,2,0,2,0,0,0,0,0,0,0,0,0,0,0,0,0
401263084,Pacific Tigers,S. Ashby,4595810,,False,30.0,0,4,0,0,0,4,2,2,1,5,6,0,0,0,5,2,2
401263084,Pacific Tigers,TEAM,TOTAL,TOTAL,False,,27,78,22,57,5,21,18,23,15,32,47,13,15,0,17,18,77
401263071,San José State Spartans,C. Lewis,4281885,,True,27.0,5,15,5,11,0,4,0,0,1,4,5,0,0,1,2,3,10
401263071,San José State Spartans,T. Whitehead,4065888,,True,36.0,6,13,6,13,0,0,0,0,4,6,10,2,5,2,0,4,12
401263071,San José State Spartans,D. Marquez,4281886,,True,27.0,3,6,2,3,1,3,0,0,1,1,2,2,0,0,0,0,7
401263071,San José State Spartans,C. Clark,4281882,,True,18.0,2,6,0,3,2,3,0,0,5,2,7,1,2,1,1,3,6
401263071,San José State Spartans,A. Basallo,4281446,,True,30.0,1,12,1,7,0,5,8,8,2,3,5,3,1,0,0,3,10
401263071,San José State Spartans,M. Lewis-Hampton,4400184,,False,4.0,0,1,0,1,0,0,0,0,0,0,0,0,0,0,1,0,0
401263071,San José State Spartans,M. Oberg,4068575,,False,14.0,0,1,0,1,0,0,0,0,3,1,4,2,2,0,0,0,0
401263071,San José State Spartans,A. Mendez,4704578,,False,10.0,0,5,0,1,0,4,0,0,0,1,1,0,0,1,0,0,0
401263071,San José State Spartans,R. Potter,4400182,,False,17.0,4,9,4,9,0,0,0,0,1,1,2,4,3,0,4,3,8
401263071,San José State Spartans,A. Benally,4068388,,False,17.0,1,8,0,1,1,7,0,0,0,2,2,0,0,0,0,1,3
401263071,San José State Spartans,TEAM,TOTAL,TOTAL,False,,22,76,18,50,4,26,8,8,21,25,46,14,13,5,8,17,56
401263071,California Golden Bears,E. Lutje Schipholt,4595859,,True,28.0,2,8,2,8,0,0,6,8,1,6,7,1,1,0,1,3,10
401263071,California Golden Bears,D. Daniels,4433417,,True,35.0,4,9,3,5,1,4,1,2,2,10,12,1,0,1,5,3,10
401263071,California Golden Bears,F. Samb,4433477,,True,25.0,0,4,0,4,0,0,0,0,1,3,4,0,0,1,5,1,0
401263071,California Golden Bears,O. Muca,4601069,,True,32.0,2,10,0,4,2,6,0,0,1,5,6,1,0,0,2,2,6
401263071,California Golden Bears,L. McIntosh,4595857,,True,38.0,4,10,4,7,0,3,2,3,0,2,2,4,2,1,1,5,10
401263071,California Golden Bears,S. Heide,4583090,,False,7.0,2,3,2,3,0,0,0,0,0,4,4,1,0,2,1,0,4
401263071,California Golden Bears,U. Onyiah,4433744,,False,8.0,1,4,1,4,0,0,2,2,2,2,4,0,0,0,0,0,4
401263071,California Golden Bears,A. Olson,4281920,,False,27.0,1,4,0,3,1,1,1,2,1,0,1,2,0,0,6,0,4
401263071,California Golden Bears,TEAM,TOTAL,TOTAL,False,,16,52,12,38,4,14,12,17,13,33,46,10,3,5,23,14,48
401263070,Saint Mary's Gaels,F. Tonga,4595843,,True,27.0,7,12,7,12,0,0,1,2,3,7,10,0,0,1,2,4,15
401263070,Saint Mary's Gaels,J. Kirisome,4400618,,True,27.0,2,7,1,4,1,3,2,4,1,2,3,2,1,0,2,2,7
401263070,Saint Mary's Gaels,T. Wedin,4400497,,True,34.0,4,13,2,7,2,6,6,6,0,1,1,1,0,0,1,2,16
401263070,Saint Mary's Gaels,B. Simonich,4282103,,True,37.0,3,7,3,7,0,0,4,6,2,10,12,5,5,2,5,3,10
401263070,Saint Mary's Gaels,M. Holland,4282100,,True,19.0,5,5,5,5,0,0,3,3,0,6,6,1,1,0,3,5,13
401263070,Saint Mary's Gaels,E. Croco,4703842,,False,9.0,0,1,0,1,0,0,0,0,1,2,3,1,0,1,1,1,0
401263070,Saint Mary's Gaels,M. Grizelj,4595842,,False,7.0,0,0,0,0,0,0,0,0,0,1,1,0,0,1,0,1,0
401263070,Saint Mary's Gaels,T. Dalton,4703841,,False,27.0,7,9,5,7,2,2,2,3,0,2,2,3,1,0,3,2,18
401263070,Saint Mary's Gaels,J. Boesel,4282101,,False,13.0,1,1,1,1,0,0,2,4,1,2,3,1,1,0,0,1,4
401263070,Saint Mary's Gaels,TEAM,TOTAL,TOTAL,False,,29,55,24,44,5,11,20,28,10,36,46,14,9,5,20,21,83
401263070,Nevada Wolf Pack,L. Otuafi,4704508,,True,19.0,1,4,1,3,0,1,0,0,1,5,6,0,0,0,0,5,2
401263070,Nevada Wolf Pack,M. Ormiston,4400072,,True,27.0,6,12,6,12,0,0,6,9,4,3,7,0,0,0,1,4,18
401263070,Nevada Wolf Pack,L. Johnson,4595634,,True,26.0,2,7,2,7,0,0,2,2,2,2,4,0,0,0,3,4,6
401263070,Nevada Wolf Pack,D. Hamilton,4400132,,True,25.0,7,17,6,12,1,5,2,4,0,1,1,2,1,0,2,2,17
401263070,Nevada Wolf Pack,N. Alexander,4068433,,True,36.0,3,9,3,8,0,1,4,5,4,0,4,3,2,1,1,1,10
401263070,Nevada Wolf Pack,E. Stebetakova,4704509,,False,8.0,2,4,2,4,0,0,0,0,1,0,1,0,0,1,2,3,4
401263070,Nevada Wolf Pack,K. Holt,4704503,,False,31.0,0,4,0,3,0,1,3,4,0,2,2,2,1,0,3,4,3
401263070,Nevada Wolf Pack,B. Carstens,4597039,,False,28.0,3,11,1,2,2,9,0,1,0,0,0,1,2,0,2,1,8
401263070,Nevada Wolf Pack,TEAM,TOTAL,TOTAL,False,,24,68,21,51,3,17,17,25,13,15,28,8,6,2,14,24,68
401263069,Nevada Wolf Pack,L. Otuafi,4704508,,True,18.0,2,6,2,6,0,0,2,2,3,1,4,0,0,1,4,1,6
401263069,Nevada Wolf Pack,L. Johnson,4595634,,True,31.0,4,11,4,11,0,0,4,4,3,4,7,3,2,1,2,2,12
401263069,Nevada Wolf Pack,A. West,4400134,,True,33.0,1,5,1,4,0,1,0,0,0,1,1,1,1,1,0,3,2
401263069,Nevada Wolf Pack,D. Hamilton,4400132,,True,33.0,8,18,6,14,2,4,6,7,1,3,4,5,2,0,3,1,24
401263069,Nevada Wolf Pack,N. Alexander,4068433,,True,29.0,1,6,1,5,0,1,0,0,0,7,7,1,0,0,1,1,2
401263069,Nevada Wolf Pack,E. Stebetakova,4704509,,False,6.0,2,4,2,4,0,0,1,2,1,0,1,0,1,0,2,0,5
401263069,Nevada Wolf Pack,L. Givens,4704506,,False,2.0,1,2,1,2,0,0,0,0,1,0,1,0,0,0,1,1,2
401263069,Nevada Wolf Pack,M. Ormiston,4400072,,False,27.0,6,12,6,12,0,0,4,4,5,4,9,0,1,0,2,1,16
401263069,Nevada Wolf Pack,G. Rones,4704505,,False,1.0,0,0,0,0,0,0,0,0,0,0,0,0,0,0,0,0,0
401263069,Nevada Wolf Pack,K. Holt,4704503,,False,19.0,0,2,0,1,0,1,2,2,0,2,2,0,1,0,0,3,2
401263069,Nevada Wolf Pack,B. Carstens,4597039,,False,1.0,0,1,0,0,0,1,0,0,0,0,0,0,0,0,0,1,0
401263069,Nevada Wolf Pack,TEAM,TOTAL,TOTAL,False,,25,67,23,59,2,8,19,21,18,25,43,10,8,3,15,14,71
401263069,Fresno Pacific Sunbirds,B. Hurt,4706287,,True,24.0,4,5,4,4,0,1,0,0,1,2,3,1,0,0,2,4,8
401263069,Fresno Pacific Sunbirds,M. Sheret,4600837,,True,19.0,1,1,1,1,0,0,0,2,1,4,5,0,0,0,0,0,2
401263069,Fresno Pacific Sunbirds,R. Berry,4600834,,True,28.0,4,13,4,11,0,2,3,4,3,2,5,1,2,0,6,5,11
401263069,Fresno Pacific Sunbirds,J. Malazarte,4600831,,True,33.0,7,14,6,12,1,2,5,6,1,4,5,4,1,0,2,2,20
401263069,Fresno Pacific Sunbirds,F. Dourva,4600829,,True,25.0,2,6,2,5,0,1,0,0,0,1,1,1,0,0,3,2,4
401263069,Fresno Pacific Sunbirds,M. Rix,4399938,,False,8.0,3,3,3,3,0,0,0,0,1,1,2,0,0,0,0,1,6
401263069,Fresno Pacific Sunbirds,L. Moody,4600841,,False,5.0,0,0,0,0,0,0,0,0,0,0,0,0,1,0,0,0,0
401263069,Fresno Pacific Sunbirds,B. McClard,3057416,,False,20.0,1,6,1,4,0,2,1,2,1,3,4,0,1,1,2,2,3
401263069,Fresno Pacific Sunbirds,V. Cochrane,4706288,,False,11.0,2,4,0,0,2,4,0,0,0,1,1,0,0,0,1,0,6
401263069,Fresno Pacific Sunbirds,J. Corona,4706286,,False,1.0,0,0,0,0,0,0,0,0,0,0,0,0,0,0,0,0,0
401263069,Fresno Pacific Sunbirds,A. Rillo,4706285,,False,25.0,3,7,2,6,1,1,0,0,1,3,4,0,1,0,1,1,7
401263069,Fresno Pacific Sunbirds,L. Manu,4706284,,False,1.0,0,1,0,0,0,1,0,0,0,1,1,0,0,0,0,0,0
401263069,Fresno Pacific Sunbirds,TEAM,TOTAL,TOTAL,False,,27,60,23,46,4,14,9,14,11,25,36,7,6,1,19,17,67
401263068,Nevada Wolf Pack,L. Otuafi,4704508,,True,31.0,4,15,4,13,0,2,5,6,4,8,12,0,0,0,4,1,13
401263068,Nevada Wolf Pack,A. Jimenez,4595635,,True,18.0,1,1,1,1,0,0,0,0,0,2,2,1,2,0,0,3,2
401263068,Nevada Wolf Pack,A. West,4400134,,True,35.0,6,13,6,11,0,2,0,0,3,2,5,3,0,1,1,0,12
401263068,Nevada Wolf Pack,D. Hamilton,4400132,,True,30.0,4,9,2,6,2,3,5,6,0,2,2,5,2,0,4,2,15
401263068,Nevada Wolf Pack,N. Alexander,4068433,,True,15.0,2,8,1,6,1,2,0,0,2,1,3,0,1,1,3,1,5
401263068,Nevada Wolf Pack,E. Stebetakova,4704509,,False,5.0,1,2,1,2,0,0,0,0,1,2,3,0,0,0,1,2,2
401263068,Nevada Wolf Pack,L. Givens,4704506,,False,10.0,2,4,2,3,0,1,1,2,1,1,2,0,1,0,3,0,5
401263068,Nevada Wolf Pack,K. Holt,4704503,,False,25.0,0,3,0,1,0,2,0,0,3,0,3,6,3,0,1,5,0
401263068,Nevada Wolf Pack,L. Johnson,4595634,,False,31.0,4,7,3,6,1,1,3,4,0,2,2,1,4,1,3,2,12
401263068,Nevada Wolf Pack,TEAM,TOTAL,TOTAL,False,,24,62,20,49,4,13,14,18,17,22,39,16,13,3,20,16,66
401263068,Jessup University Warriors,M. Zaragoza,4606451,,True,26.0,5,9,5,8,0,1,0,0,4,7,11,0,0,1,1,1,10
401263068,Jessup University Warriors,K. Campana,4706717,,True,28.0,3,7,2,6,1,1,1,1,0,4,4,2,1,0,4,2,8
401263068,Jessup University Warriors,B. Purify,4706716,,True,19.0,3,5,3,5,0,0,2,4,0,0,0,0,0,0,5,4,8
401263068,Jessup University Warriors,C. Jankulovski,4706714,,True,31.0,3,6,3,5,0,1,0,0,0,0,0,1,2,0,1,2,6
401263068,Jessup University Warriors,J. Stirton,4606449,,True,18.0,0,5,0,1,0,4,1,2,0,3,3,0,1,0,6,1,1
401263068,Jessup University Warriors,P. Winter,4706723,,False,15.0,1,1,1,1,0,0,0,0,0,4,4,0,1,1,1,2,2
401263068,Jessup University Warriors,V. Delacroix,4706720,,False,18.0,4,6,0,0,4,6,0,0,0,3,3,0,0,1,1,2,12
401263068,Jessup University Warriors,A. Watson,4706718,,False,3.0,0,1,0,1,0,0,0,0,0,0,0,0,0,0,0,1,0
401263068,Jessup University Warriors,M. Lepolo,4706715,,False,11.0,1,4,0,3,1,1,0,0,0,0,0,1,1,0,5,0,3
401263068,Jessup University Warriors,A. Willis,4606457,,False,22.0,5,8,4,7,1,1,4,4,1,1,2,0,2,0,3,1,15
401263068,Jessup University Warriors,J. Caughey,4606455,,False,9.0,0,1,0,0,0,1,0,0,0,1,1,0,1,0,0,1,0
401263068,Jessup University Warriors,TEAM,TOTAL,TOTAL,False,,25,53,18,37,7,16,8,11,8,23,31,4,9,3,27,17,65
401263022,Utah State Aggies,J. Chatman,4068281,,True,36.0,5,15,4,8,1,7,3,4,3,5,8,0,0,0,1,2,14
401263022,Utah State Aggies,M. Mendazona,4704647,,True,27.0,3,8,2,5,1,3,0,0,2,2,4,2,1,0,1,1,7
401263022,Utah State Aggies,K. Kamakawiwo'ole,4595670,,True,12.0,0,2,0,1,0,1,1,2,0,1,1,2,0,0,0,4,1
401263022,Utah State Aggies,F. Brantley,4595669,,True,36.0,2,5,1,3,1,2,2,2,0,5,5,6,1,0,2,4,7
401263022,Utah State Aggies,E. Harris,4281891,,True,36.0,3,15,0,5,3,10,0,0,0,6,6,2,1,0,0,0,9
401263022,Utah State Aggies,E. Jarrell,4704653,,False,2.0,0,1,0,1,0,0,0,0,0,0,0,0,0,0,0,0,0
401263022,Utah State Aggies,B. Mathews,4400146,,False,23.0,9,12,8,11,1,1,3,4,3,3,6,0,1,1,1,2,22
401263022,Utah State Aggies,T. Franson,4281892,,False,6.0,0,1,0,1,0,0,0,0,1,1,2,0,0,0,0,2,0
401263022,Utah State Aggies,M. Pruitt,4704651,,False,2.0,0,1,0,1,0,0,0,2,0,0,0,0,0,0,1,1,0
401263022,Utah State Aggies,P. Williams,4704650,,False,4.0,0,2,0,2,0,0,0,0,0,0,0,1,0,0,1,0,0
401263022,Utah State Aggies,K. Falslev,4704648,,False,2.0,0,1,0,0,0,1,0,0,0,0,0,0,0,0,0,1,0
401263022,Utah State Aggies,S. Latone,4399209,,False,14.0,5,12,4,7,1,5,2,4,0,3,3,0,0,0,2,1,13
401263022,Utah State Aggies,TEAM,TOTAL,TOTAL,False,,27,75,19,45,8,30,11,18,15,32,47,13,4,1,10,18,73
401263022,Utah State Aggies,J. Chatman,4068281,,True,36.0,5,15,4,8,1,7,3,4,3,5,8,0,0,0,1,2,14
401263022,Utah State Aggies,M. Mendazona,4704647,,True,27.0,3,8,2,5,1,3,0,0,2,2,4,2,1,0,1,1,7
401263022,Utah State Aggies,K. Kamakawiwo'ole,4595670,,True,12.0,0,2,0,1,0,1,1,2,0,1,1,2,0,0,0,4,1
401263022,Utah State Aggies,F. Brantley,4595669,,True,36.0,2,5,1,3,1,2,2,2,0,5,5,6,1,0,2,4,7
401263022,Utah State Aggies,E. Harris,4281891,,True,36.0,3,15,0,5,3,10,0,0,0,6,6,2,1,0,0,0,9
401263022,Utah State Aggies,E. Jarrell,4704653,,False,2.0,0,1,0,1,0,0,0,0,0,0,0,0,0,0,0,0,0
401263022,Utah State Aggies,B. Mathews,4400146,,False,23.0,9,12,8,11,1,1,3,4,3,3,6,0,1,1,1,2,22
401263022,Utah State Aggies,T. Franson,4281892,,False,6.0,0,1,0,1,0,0,0,0,1,1,2,0,0,0,0,2,0
401263022,Utah State Aggies,M. Pruitt,4704651,,False,2.0,0,1,0,1,0,0,0,2,0,0,0,0,0,0,1,1,0
401263022,Utah State Aggies,P. Williams,4704650,,False,4.0,0,2,0,2,0,0,0,0,0,0,0,1,0,0,1,0,0
401263022,Utah State Aggies,K. Falslev,4704648,,False,2.0,0,1,0,0,0,1,0,0,0,0,0,0,0,0,0,1,0
401263022,Utah State Aggies,S. Latone,4399209,,False,14.0,5,12,4,7,1,5,2,4,0,3,3,0,0,0,2,1,13
401263022,Utah State Aggies,TEAM,TOTAL,TOTAL,False,,27,75,19,45,8,30,11,18,15,32,47,13,4,1,10,18,73
401263022,San José State Spartans,C. Lewis,4281885,,True,19.0,0,6,0,3,0,3,3,4,2,4,6,1,0,1,2,1,3
401263022,San José State Spartans,T. Whitehead,4065888,,True,33.0,8,15,8,15,0,0,2,3,1,9,10,5,2,2,1,2,18
401263022,San José State Spartans,R. Potter,4400182,,True,26.0,5,10,4,8,1,2,0,3,2,5,7,3,0,2,5,3,11
401263022,San José State Spartans,D. Marquez,4281886,,True,31.0,4,8,1,1,3,7,1,2,1,1,2,1,1,0,3,0,12
401263022,San José State Spartans,A. Basallo,4281446,,True,6.0,0,0,0,0,0,0,2,2,0,1,1,2,0,0,2,0,2
401263022,San José State Spartans,A. Fluker,4704579,,False,1.0,0,0,0,0,0,0,0,0,0,0,0,0,0,0,0,0,0
401263022,San José State Spartans,M. Oberg,4068575,,False,26.0,6,8,2,3,4,5,2,3,0,7,7,0,0,2,1,1,18
401263022,San José State Spartans,A. Mendez,4704578,,False,9.0,2,3,0,0,2,3,0,0,0,3,3,0,0,0,1,3,6
401263022,San José State Spartans,S. Jones,4433780,,False,13.0,1,4,1,2,0,2,1,2,0,1,1,3,0,0,1,0,3
401263022,San José State Spartans,C. Clark,4281882,,False,19.0,0,4,0,2,0,2,3,4,1,2,3,2,0,0,0,3,3
401263022,San José State Spartans,A. Benally,4068388,,False,17.0,1,3,1,2,0,1,0,0,0,1,1,1,0,1,0,0,2
401263022,San José State Spartans,TEAM,TOTAL,TOTAL,False,,27,61,17,36,10,25,14,23,9,36,45,18,3,8,16,13,78
401263022,San José State Spartans,C. Lewis,4281885,,True,19.0,0,6,0,3,0,3,3,4,2,4,6,1,0,1,2,1,3
401263022,San José State Spartans,T. Whitehead,4065888,,True,33.0,8,15,8,15,0,0,2,3,1,9,10,5,2,2,1,2,18
401263022,San José State Spartans,R. Potter,4400182,,True,26.0,5,10,4,8,1,2,0,3,2,5,7,3,0,2,5,3,11
401263022,San José State Spartans,D. Marquez,4281886,,True,31.0,4,8,1,1,3,7,1,2,1,1,2,1,1,0,3,0,12
401263022,San José State Spartans,A. Basallo,4281446,,True,6.0,0,0,0,0,0,0,2,2,0,1,1,2,0,0,2,0,2
401263022,San José State Spartans,A. Fluker,4704579,,False,1.0,0,0,0,0,0,0,0,0,0,0,0,0,0,0,0,0,0
401263022,San José State Spartans,M. Oberg,4068575,,False,26.0,6,8,2,3,4,5,2,3,0,7,7,0,0,2,1,1,18
401263022,San José State Spartans,A. Mendez,4704578,,False,9.0,2,3,0,0,2,3,0,0,0,3,3,0,0,0,1,3,6
401263022,San José State Spartans,S. Jones,4433780,,False,13.0,1,4,1,2,0,2,1,2,0,1,1,3,0,0,1,0,3
401263022,San José State Spartans,C. Clark,4281882,,False,19.0,0,4,0,2,0,2,3,4,1,2,3,2,0,0,0,3,3
401263022,San José State Spartans,A. Benally,4068388,,False,17.0,1,3,1,2,0,1,0,0,0,1,1,1,0,1,0,0,2
401263022,San José State Spartans,TEAM,TOTAL,TOTAL,False,,27,61,17,36,10,25,14,23,9,36,45,18,3,8,16,13,78
401262965,UNLV Lady Rebels,D. Byrne,4398924,,True,26.0,2,5,1,1,1,4,4,4,2,1,3,2,0,1,1,3,9
401262965,UNLV Lady Rebels,K. Wilfred,4595641,,True,9.0,0,2,0,2,0,0,0,0,2,1,3,0,1,1,3,4,0
401262965,UNLV Lady Rebels,J. Thomas,4704624,,True,37.0,4,9,0,4,4,5,4,8,1,2,3,1,1,0,1,1,16
401262965,UNLV Lady Rebels,N. Johnson,4400108,,True,16.0,1,9,0,4,1,5,0,0,1,3,4,1,1,0,1,2,3
401262965,UNLV Lady Rebels,B. Thomas,4068210,,True,39.0,8,8,2,2,6,6,4,6,0,3,3,2,4,0,1,4,26
401262965,UNLV Lady Rebels,T. Carter,4595642,,False,12.0,0,3,0,2,0,1,2,2,0,3,3,1,1,0,1,0,2
401262965,UNLV Lady Rebels,A. Blount,4595640,,False,21.0,3,6,3,6,0,0,6,8,1,4,5,1,1,0,2,3,12
401262965,UNLV Lady Rebels,D. Young,4704625,,False,11.0,4,6,4,6,0,0,2,5,2,2,4,2,0,0,3,5,10
401262965,UNLV Lady Rebels,J. Singleton,4704623,,False,15.0,0,1,0,0,0,1,1,2,1,1,2,2,2,0,4,2,1
401262965,UNLV Lady Rebels,J. Buckley,4595639,,False,14.0,1,9,1,7,0,2,0,0,2,1,3,0,1,1,0,1,2
401262965,UNLV Lady Rebels,TEAM,TOTAL,TOTAL,False,,23,58,11,34,12,24,23,35,12,21,33,12,12,3,17,25,81
401262965,Cal State Fullerton Titans,M. Nieto,4595190,,True,17.0,2,3,2,3,0,0,3,8,1,3,4,1,0,0,4,3,7
401262965,Cal State Fullerton Titans,A. Book,4400031,,True,32.0,6,13,4,8,2,5,2,3,1,3,4,1,1,1,3,2,16
401262965,Cal State Fullerton Titans,J. Krupa,4400030,,True,36.0,3,12,3,10,0,2,6,8,2,10,12,7,2,4,2,4,12
401262965,Cal State Fullerton Titans,A. Frey,4595187,,True,38.0,4,6,3,3,1,3,2,3,0,2,2,5,0,0,8,1,11
401262965,Cal State Fullerton Titans,C. Rodarte,4400029,,True,20.0,0,3,0,3,0,0,2,2,0,0,0,0,0,0,3,3,2
401262965,Cal State Fullerton Titans,K. Neff,4595189,,False,13.0,2,2,0,0,2,2,0,0,0,0,0,0,0,0,1,2,6
401262965,Cal State Fullerton Titans,M. Freemon,4400033,,False,16.0,2,4,2,4,0,0,0,0,0,1,1,0,0,0,0,1,4
401262965,Cal State Fullerton Titans,A. Lewis,4704361,,False,8.0,2,3,2,3,0,0,0,0,0,3,3,0,0,0,2,5,4
401262965,Cal State Fullerton Titans,B. Stratford,4704362,,False,5.0,0,0,0,0,0,0,0,0,0,2,2,0,0,0,0,0,0
401262965,Cal State Fullerton Titans,G. Vidmar,4704360,,False,14.0,2,4,1,1,1,3,0,0,0,1,1,1,1,0,2,3,5
401262965,Cal State Fullerton Titans,TEAM,TOTAL,TOTAL,False,,23,50,17,35,6,15,15,24,4,25,29,15,4,5,25,24,67
401262955,Utah State Aggies,J. Chatman,4068281,,True,31.0,5,9,5,8,0,1,3,3,1,9,10,0,0,0,3,1,13
401262955,Utah State Aggies,M. Mendazona,4704647,,True,20.0,2,6,1,4,1,2,0,0,1,2,3,3,0,0,2,1,5
401262955,Utah State Aggies,K. Kamakawiwo'ole,4595670,,True,21.0,3,4,2,2,1,2,2,2,4,3,7,2,0,0,3,4,9
401262955,Utah State Aggies,F. Brantley,4595669,,True,29.0,3,6,2,4,1,2,1,2,0,4,4,5,2,0,5,3,8
401262955,Utah State Aggies,E. Harris,4281891,,True,39.0,4,11,0,3,4,8,1,4,1,8,9,5,2,1,3,2,13
401262955,Utah State Aggies,B. Mathews,4400146,,False,16.0,3,4,3,4,0,0,1,2,1,4,5,1,4,0,1,1,7
401262955,Utah State Aggies,T. Franson,4281892,,False,8.0,2,3,2,3,0,0,0,0,1,0,1,0,0,0,0,3,4
401262955,Utah State Aggies,M. Pruitt,4704651,,False,16.0,2,10,1,7,1,3,1,2,1,5,6,0,2,1,5,2,6
401262955,Utah State Aggies,P. Williams,4704650,,False,8.0,0,0,0,0,0,0,0,0,0,1,1,1,0,0,0,1,0
401262955,Utah State Aggies,S. Latone,4399209,,False,12.0,1,5,1,3,0,2,1,1,1,0,1,0,0,0,1,1,3
401262955,Utah State Aggies,TEAM,TOTAL,TOTAL,False,,25,58,17,38,8,20,10,16,12,37,49,17,10,2,23,19,68
401262955,UTEP Miners,E. Arike,4704572,,True,10.0,0,4,0,2,0,2,0,0,0,1,1,1,0,0,2,1,0
401262955,UTEP Miners,D. Roebuck,4595248,,True,34.0,3,7,1,3,2,4,1,2,1,2,3,1,2,3,0,2,9
401262955,UTEP Miners,A. Crouse,4595247,,True,29.0,2,8,2,6,0,2,1,2,0,3,3,2,4,0,2,4,5
401262955,UTEP Miners,K. Gallegos,4595246,,True,40.0,7,11,5,6,2,5,3,4,2,4,6,5,1,0,4,2,19
401262955,UTEP Miners,T. Bradshaw,4595245,,True,9.0,0,1,0,1,0,0,0,0,0,0,0,0,0,0,1,0,0
401262955,UTEP Miners,B. Fontana,4704573,,False,4.0,0,1,0,0,0,1,0,0,0,0,0,1,0,0,0,1,0
401262955,UTEP Miners,T. Modawar,4595249,,False,21.0,3,5,2,4,1,1,1,2,3,4,7,2,0,0,2,0,8
401262955,UTEP Miners,M. Pruitt,4281295,,False,10.0,1,3,1,3,0,0,3,4,1,2,3,0,0,0,1,0,5
401262955,UTEP Miners,D. Thurman,4704574,,False,34.0,5,18,2,8,3,10,1,2,1,4,5,1,1,0,1,3,14
401262955,UTEP Miners,A. Khlopkova,4595244,,False,9.0,2,6,2,3,0,3,1,2,0,0,0,0,0,0,0,1,5
401262955,UTEP Miners,TEAM,TOTAL,TOTAL,False,,23,64,15,36,8,28,11,18,9,24,33,13,8,3,13,14,65
401262943,Weber State Wildcats,J. Matthews,4594879,,True,20.0,2,10,1,8,1,2,1,2,0,3,3,0,0,0,2,3,6
401262943,Weber State Wildcats,D. Hickok,4594877,,True,20.0,1,2,1,1,0,1,2,2,0,1,1,2,1,0,3,0,4
401262943,Weber State Wildcats,D. Williams,4068781,,True,28.0,6,11,6,10,0,1,0,0,2,3,5,1,0,0,0,2,12
401262943,Weber State Wildcats,A. Solovi,4594878,,True,30.0,2,5,1,4,1,1,0,2,0,1,1,2,0,0,5,1,5
401262943,Weber State Wildcats,U. Chamberlin,4594874,,True,25.0,1,6,1,5,0,1,0,0,1,3,4,0,0,0,1,2,2
401262943,Weber State Wildcats,M. Peterson,4704894,,False,8.0,0,3,0,3,0,0,4,4,0,3,3,0,0,0,1,0,4
401262943,Weber State Wildcats,E. Torbert,4400135,,False,23.0,2,13,2,10,0,3,6,7,2,6,8,0,2,0,3,3,10
401262943,Weber State Wildcats,K. Pentzer,4399951,,False,20.0,2,3,1,1,1,2,2,2,1,2,3,0,2,0,4,1,7
401262943,Weber State Wildcats,A. Thoms,4399949,,False,10.0,0,3,0,2,0,1,0,0,0,1,1,1,1,0,2,0,0
401262943,Weber State Wildcats,S. Johnson,4281695,,False,16.0,2,5,2,4,0,1,4,4,0,1,1,2,0,0,0,2,8
401262943,Weber State Wildcats,TEAM,TOTAL,TOTAL,False,,18,61,15,48,3,13,19,23,10,26,36,8,6,0,21,14,58
401262943,Boise State Broncos,A. Mark,4606930,,True,30.0,6,12,6,12,0,0,1,2,2,3,5,3,3,0,2,3,13
401262943,Boise State Broncos,R. Bowers,4400536,,True,23.0,4,7,3,5,1,2,1,3,1,5,6,0,1,1,1,3,10
401262943,Boise State Broncos,M. McGwire,4066535,,True,16.0,5,8,4,6,1,2,0,0,1,10,11,1,2,1,2,2,11
401262943,Boise State Broncos,M. Naro,4705625,,True,30.0,4,12,3,9,1,3,0,2,0,1,1,6,2,1,4,4,9
401262943,Boise State Broncos,J. Loville,4400537,,True,31.0,7,18,6,14,1,4,1,1,0,2,2,2,0,0,2,0,16
401262943,Boise State Broncos,E. Lalotte,4705630,,False,9.0,3,7,3,7,0,0,0,0,3,2,5,1,0,0,0,2,6
401262943,Boise State Broncos,C. Njoku,4595621,,False,15.0,3,5,3,5,0,0,1,4,7,4,11,0,0,1,1,4,7
401262943,Boise State Broncos,K. Sykes,4595619,,False,21.0,2,4,0,1,2,3,0,0,0,3,3,0,4,0,2,0,6
401262943,Boise State Broncos,A. Muse,4583056,,False,18.0,2,5,2,5,0,0,2,2,2,3,5,0,0,2,1,2,6
401262943,Boise State Broncos,M. Machalova,4705628,,False,7.0,0,1,0,1,0,0,0,0,0,1,1,1,0,0,1,1,0
401262943,Boise State Broncos,TEAM,TOTAL,TOTAL,False,,36,79,30,65,6,14,6,14,19,36,55,14,12,6,16,21,84
401262934,Sacramento State Hornets,N. Munguia,4704913,,True,25.0,0,5,0,5,0,0,3,4,3,6,9,1,0,0,3,2,3
401262934,Sacramento State Hornets,E. Enochs,4399939,,True,35.0,4,11,4,8,0,3,2,4,1,0,1,3,0,0,2,1,10
401262934,Sacramento State Hornets,S. Menke,4399937,,True,30.0,4,9,4,8,0,1,7,8,2,9,11,1,2,1,6,4,15
401262934,Sacramento State Hornets,B. Panfili,4399936,,True,30.0,3,10,3,7,0,3,2,2,0,2,2,0,1,0,1,0,8
401262934,Sacramento State Hornets,M. Enger,4399935,,True,10.0,2,3,2,3,0,0,2,2,1,1,2,0,0,0,4,0,6
401262934,Sacramento State Hornets,J. Rios,4704911,,False,35.0,4,12,1,5,3,7,2,2,2,2,4,1,0,0,1,1,13
401262934,Sacramento State Hornets,S. Abney,4399940,,False,35.0,3,8,3,4,0,4,0,0,0,4,4,1,1,0,0,4,6
401262934,Sacramento State Hornets,TEAM,TOTAL,TOTAL,False,,20,58,17,40,3,18,18,22,11,27,38,7,4,1,17,12,61
401262934,Nevada Wolf Pack,A. Jimenez,4595635,,True,30.0,3,9,1,5,2,4,0,0,2,4,6,4,2,1,1,3,8
401262934,Nevada Wolf Pack,L. Johnson,4595634,,True,27.0,5,12,5,10,0,2,0,0,0,3,3,4,0,0,3,4,10
401262934,Nevada Wolf Pack,A. West,4400134,,True,34.0,5,14,5,13,0,1,4,4,4,5,9,3,1,1,2,3,14
401262934,Nevada Wolf Pack,D. Hamilton,4400132,,True,37.0,6,14,3,8,3,6,2,2,0,5,5,6,2,0,1,0,17
401262934,Nevada Wolf Pack,N. Alexander,4068433,,True,9.0,2,4,2,4,0,0,0,0,1,1,2,0,0,0,1,4,4
401262934,Nevada Wolf Pack,E. Stebetakova,4704509,,False,23.0,10,13,10,13,0,0,0,0,2,4,6,0,1,2,1,2,20
401262934,Nevada Wolf Pack,L. Givens,4704506,,False,9.0,0,3,0,3,0,0,1,2,1,1,2,0,1,2,0,2,1
401262934,Nevada Wolf Pack,G. Rones,4704505,,False,6.0,0,2,0,0,0,2,0,0,0,0,0,1,1,0,0,1,0
401262934,Nevada Wolf Pack,K. Holt,4704503,,False,22.0,0,3,0,3,0,0,0,0,4,2,6,3,4,0,1,4,0
401262934,Nevada Wolf Pack,A. Jovicevic,4704502,,False,3.0,0,2,0,1,0,1,0,0,1,1,2,0,0,0,1,0,0
401262934,Nevada Wolf Pack,TEAM,TOTAL,TOTAL,False,,31,76,26,60,5,16,7,8,18,28,46,21,12,6,12,23,74
401262927,UNLV Lady Rebels,D. Byrne,4398924,,True,30.0,6,14,2,2,4,12,2,4,4,6,10,1,2,1,2,1,18
401262927,UNLV Lady Rebels,K. Wilfred,4595641,,True,19.0,3,5,3,5,0,0,5,7,4,6,10,1,0,0,3,2,11
401262927,UNLV Lady Rebels,J. Thomas,4704624,,True,38.0,5,15,4,7,1,8,0,0,1,2,3,2,1,1,0,1,11
401262927,UNLV Lady Rebels,N. Johnson,4400108,,True,16.0,0,9,0,6,0,3,0,0,1,4,5,1,0,0,2,4,0
401262927,UNLV Lady Rebels,B. Thomas,4068210,,True,30.0,4,9,2,4,2,5,0,0,1,2,3,5,1,0,2,5,10
401262927,UNLV Lady Rebels,T. Carter,4595642,,False,5.0,0,1,0,1,0,0,0,0,0,0,0,0,0,0,0,0,0
401262927,UNLV Lady Rebels,A. Blount,4595640,,False,15.0,0,3,0,3,0,0,5,6,0,2,2,3,0,0,3,3,5
401262927,UNLV Lady Rebels,D. Young,4704625,,False,12.0,4,4,4,4,0,0,3,3,2,4,6,0,0,3,0,4,11
401262927,UNLV Lady Rebels,J. Singleton,4704623,,False,18.0,1,1,0,0,1,1,2,2,0,0,0,3,2,0,4,2,5
401262927,UNLV Lady Rebels,J. Buckley,4595639,,False,17.0,2,7,2,5,0,2,0,0,2,2,4,0,1,0,1,1,4
401262927,UNLV Lady Rebels,TEAM,TOTAL,TOTAL,False,,25,68,17,37,8,31,17,22,17,28,45,16,7,5,17,23,75
401262927,Northern Arizona Lumberjacks,N. Moran,4704920,,True,24.0,2,11,2,10,0,1,0,0,1,1,2,3,1,0,1,4,4
401262927,Northern Arizona Lumberjacks,J. Nakai,4595637,,True,40.0,9,17,7,14,2,3,2,2,0,1,1,3,2,0,3,4,22
401262927,Northern Arizona Lumberjacks,E. Rodabaugh,4594845,,True,36.0,11,17,7,11,4,6,1,1,3,4,7,0,0,2,3,3,27
401262927,Northern Arizona Lumberjacks,R. Schenck,4399923,,True,40.0,1,5,1,3,0,2,5,6,7,11,18,6,1,0,4,3,7
401262927,Northern Arizona Lumberjacks,J. Bailey,4068302,,True,38.0,5,15,2,4,3,11,5,10,0,5,5,3,1,0,2,2,18
401262927,Northern Arizona Lumberjacks,S. Ramesh,4594846,,False,6.0,0,0,0,0,0,0,0,0,1,1,2,0,0,0,0,2,0
401262927,Northern Arizona Lumberjacks,O. Moran,4704921,,False,14.0,0,3,0,2,0,1,1,2,2,3,5,1,1,0,0,3,1
401262927,Northern Arizona Lumberjacks,A. Simmons,4282219,,False,2.0,0,0,0,0,0,0,0,0,0,0,0,0,0,0,1,0,0
401262927,Northern Arizona Lumberjacks,TEAM,TOTAL,TOTAL,False,,28,68,19,44,9,24,14,21,15,28,43,16,6,2,14,21,79
401262912,West Virginia Mountaineers,E. Martinez,4433353,,True,24.0,6,15,6,14,0,1,2,4,7,8,15,4,0,2,2,4,14
401262912,West Virginia Mountaineers,K. Niblack,4398995,,True,20.0,1,6,1,6,0,0,0,2,2,4,6,1,0,1,1,4,2
401262912,West Virginia Mountaineers,K. Deans,4433316,,True,31.0,5,7,2,4,3,3,2,2,1,2,3,3,0,0,1,3,15
401262912,West Virginia Mountaineers,M. Smith,4398996,,True,36.0,5,16,3,10,2,6,0,0,1,4,5,4,1,1,6,2,12
401262912,West Virginia Mountaineers,K. Gondrezick,4065820,,True,37.0,8,16,3,7,5,9,2,2,3,1,4,3,0,0,0,1,23
401262912,West Virginia Mountaineers,A. Cummings,4703577,,False,1.0,0,0,0,0,0,0,0,0,0,0,0,0,0,0,0,0,0
401262912,West Virginia Mountaineers,J. Cunningham,4597333,,False,1.0,0,0,0,0,0,0,0,0,0,1,1,0,0,0,0,0,0
401262912,West Virginia Mountaineers,R. Norris,4398997,,False,12.0,0,2,0,2,0,0,1,2,1,4,5,0,0,0,1,3,1
401262912,West Virginia Mountaineers,B. Ejiofor,4280899,,False,17.0,4,5,4,5,0,0,0,0,4,5,9,0,1,0,1,2,8
401262912,West Virginia Mountaineers,A. Ogle,4703578,,False,2.0,0,0,0,0,0,0,0,0,0,0,0,0,0,0,0,0,0
401262912,West Virginia Mountaineers,T. Jenks,4594272,,False,4.0,0,1,0,1,0,0,0,0,0,0,0,0,0,0,0,0,0
401262912,West Virginia Mountaineers,J. Hemingway,4432991,,False,15.0,3,9,3,8,0,1,2,2,5,1,6,0,1,0,3,1,8
401262912,West Virginia Mountaineers,TEAM,TOTAL,TOTAL,False,,32,77,22,57,10,20,9,14,24,30,54,15,3,4,15,20,83
401262912,Fresno State Bulldogs,M. Utti,4281828,,True,34.0,4,9,3,6,1,3,3,3,3,4,7,2,1,1,3,0,12
401262912,Fresno State Bulldogs,B. Walling,4595632,,True,16.0,0,0,0,0,0,0,0,0,1,2,3,1,0,0,0,2,0
401262912,Fresno State Bulldogs,Hal. Cavinder,4433658,,True,31.0,5,16,3,8,2,8,3,3,1,5,6,3,2,0,2,2,15
401262912,Fresno State Bulldogs,Han. Cavinder,4433372,,True,37.0,8,14,6,9,2,5,1,4,0,2,2,3,0,0,2,1,19
401262912,Fresno State Bulldogs,A. Gamez,4281826,,True,30.0,2,7,2,6,0,1,3,5,1,1,2,2,1,0,2,0,7
401262912,Fresno State Bulldogs,C. Fairley,4704474,,False,2.0,0,0,0,0,0,0,0,0,0,0,0,0,0,0,0,0,0
401262912,Fresno State Bulldogs,W. Motta,4595631,,False,13.0,1,4,1,4,0,0,1,1,0,2,2,0,0,0,2,5,3
401262912,Fresno State Bulldogs,K. Kinzer,4595630,,False,12.0,0,5,0,0,0,5,0,0,0,1,1,0,0,0,1,2,0
401262912,Fresno State Bulldogs,M. Guimaraes,4704476,,False,5.0,0,1,0,1,0,0,0,0,0,0,0,0,1,0,0,1,0
401262912,Fresno State Bulldogs,Y. Todorova,4704475,,False,2.0,0,0,0,0,0,0,0,0,0,0,0,0,0,0,0,1,0
401262912,Fresno State Bulldogs,K. Brown,4704473,,False,17.0,2,4,2,2,0,2,2,2,0,1,1,0,2,0,0,0,6
401262912,Fresno State Bulldogs,D. Dunn,4433511,,False,1.0,0,0,0,0,0,0,0,0,0,0,0,0,0,0,0,0,0
401262912,Fresno State Bulldogs,TEAM,TOTAL,TOTAL,False,,22,60,17,36,5,24,13,18,6,18,24,11,7,1,12,14,62
401262819,Wyoming Cowgirls,D. Davidsdottir,4068870,,True,15.0,2,5,2,5,0,0,0,0,3,1,4,0,0,1,1,2,4
401262819,Wyoming Cowgirls,J. Johnson,4595683,,True,21.0,1,4,0,0,1,4,0,0,0,3,3,2,0,0,1,0,3
401262819,Wyoming Cowgirls,Q. Weidemann,4400207,,True,28.0,8,11,3,5,5,6,0,0,0,0,0,3,2,1,1,0,21
401262819,Wyoming Cowgirls,A. Sanchez Ramos,4400204,,True,23.0,2,5,1,1,1,4,2,4,1,3,4,2,0,0,1,3,7
401262819,Wyoming Cowgirls,T. Olson,4400203,,True,30.0,2,7,0,4,2,3,0,0,1,6,7,3,6,0,0,1,6
401262819,Wyoming Cowgirls,M. Savic,4704660,,False,11.0,1,2,1,2,0,0,2,2,0,4,4,2,0,0,1,3,4
401262819,Wyoming Cowgirls,P. Salazar,4704659,,False,10.0,1,4,1,3,0,1,0,2,0,2,2,1,0,0,0,4,2
401262819,Wyoming Cowgirls,G. Ellis,4704657,,False,7.0,1,2,0,1,1,1,0,0,0,3,3,1,0,0,1,1,3
401262819,Wyoming Cowgirls,L. Bull,4704655,,False,5.0,0,0,0,0,0,0,0,0,0,0,0,0,0,0,1,0,0
401262819,Wyoming Cowgirls,O. Ustowska,4704662,,False,24.0,2,7,0,2,2,5,0,0,1,3,4,2,1,0,3,2,6
401262819,Wyoming Cowgirls,L. Hudson,4704658,,False,5.0,0,2,0,1,0,1,0,0,0,0,0,0,0,0,0,0,0
401262819,Wyoming Cowgirls,M. Bradshaw,4595681,,False,21.0,8,10,3,3,5,7,2,3,1,1,2,3,0,0,1,2,23
401262819,Wyoming Cowgirls,TEAM,TOTAL,TOTAL,False,,28,59,11,27,17,32,6,11,9,27,36,19,9,2,12,18,79
401262819,Wyoming Cowgirls,D. Davidsdottir,4068870,,True,15.0,2,5,2,5,0,0,0,0,3,1,4,0,0,1,1,2,4
401262819,Wyoming Cowgirls,J. Johnson,4595683,,True,21.0,1,4,0,0,1,4,0,0,0,3,3,2,0,0,1,0,3
401262819,Wyoming Cowgirls,Q. Weidemann,4400207,,True,28.0,8,11,3,5,5,6,0,0,0,0,0,3,2,1,1,0,21
401262819,Wyoming Cowgirls,A. Sanchez Ramos,4400204,,True,23.0,2,5,1,1,1,4,2,4,1,3,4,2,0,0,1,3,7
401262819,Wyoming Cowgirls,T. Olson,4400203,,True,30.0,2,7,0,4,2,3,0,0,1,6,7,3,6,0,0,1,6
401262819,Wyoming Cowgirls,M. Savic,4704660,,False,11.0,1,2,1,2,0,0,2,2,0,4,4,2,0,0,1,3,4
401262819,Wyoming Cowgirls,P. Salazar,4704659,,False,10.0,1,4,1,3,0,1,0,2,0,2,2,1,0,0,0,4,2
401262819,Wyoming Cowgirls,G. Ellis,4704657,,False,7.0,1,2,0,1,1,1,0,0,0,3,3,1,0,0,1,1,3
401262819,Wyoming Cowgirls,L. Bull,4704655,,False,5.0,0,0,0,0,0,0,0,0,0,0,0,0,0,0,1,0,0
401262819,Wyoming Cowgirls,O. Ustowska,4704662,,False,24.0,2,7,0,2,2,5,0,0,1,3,4,2,1,0,3,2,6
401262819,Wyoming Cowgirls,L. Hudson,4704658,,False,5.0,0,2,0,1,0,1,0,0,0,0,0,0,0,0,0,0,0
401262819,Wyoming Cowgirls,M. Bradshaw,4595681,,False,21.0,8,10,3,3,5,7,2,3,1,1,2,3,0,0,1,2,23
401262819,Wyoming Cowgirls,TEAM,TOTAL,TOTAL,False,,28,59,11,27,17,32,6,11,9,27,36,19,9,2,12,18,79
401262819,Utah State Aggies,T. Franson,4281892,,True,15.0,0,4,0,4,0,0,0,0,2,2,4,1,1,0,2,1,0
401262819,Utah State Aggies,J. Chatman,4068281,,True,27.0,2,8,2,6,0,2,1,2,2,5,7,0,1,0,4,1,5
401262819,Utah State Aggies,M. Mendazona,4704647,,True,28.0,2,5,2,5,0,0,1,2,1,3,4,2,0,1,2,3,5
401262819,Utah State Aggies,F. Brantley,4595669,,True,10.0,0,4,0,3,0,1,0,0,1,0,1,0,1,0,3,1,0
401262819,Utah State Aggies,S. Latone,4399209,,True,23.0,4,6,4,5,0,1,0,0,0,3,3,1,1,0,3,2,8
401262819,Utah State Aggies,E. Jarrell,4704653,,False,7.0,1,1,1,1,0,0,0,0,1,0,1,0,0,0,1,1,2
401262819,Utah State Aggies,H. Nelson,4704652,,False,16.0,1,6,0,2,1,4,2,6,2,1,3,0,0,0,0,1,5
401262819,Utah State Aggies,A. Lustgarten,4704649,,False,6.0,0,0,0,0,0,0,0,0,0,0,0,0,0,0,1,1,0
401262819,Utah State Aggies,K. Falslev,4704648,,False,12.0,0,3,0,0,0,3,0,0,0,0,0,0,0,0,1,1,0
401262819,Utah State Aggies,J. Polansky,4595673,,False,6.0,0,0,0,0,0,0,0,0,0,1,1,0,0,0,0,0,0
401262819,Utah State Aggies,K. Kamakawiwo'ole,4595670,,False,22.0,2,5,2,5,0,0,2,4,0,5,5,0,1,0,0,1,6
401262819,Utah State Aggies,E. Harris,4281891,,False,29.0,3,6,2,4,1,2,4,5,0,3,3,0,1,0,3,1,11
401262819,Utah State Aggies,TEAM,TOTAL,TOTAL,False,,15,48,13,35,2,13,10,19,11,24,35,4,6,1,21,14,42
401262819,Utah State Aggies,T. Franson,4281892,,True,15.0,0,4,0,4,0,0,0,0,2,2,4,1,1,0,2,1,0
401262819,Utah State Aggies,J. Chatman,4068281,,True,27.0,2,8,2,6,0,2,1,2,2,5,7,0,1,0,4,1,5
401262819,Utah State Aggies,M. Mendazona,4704647,,True,28.0,2,5,2,5,0,0,1,2,1,3,4,2,0,1,2,3,5
401262819,Utah State Aggies,F. Brantley,4595669,,True,10.0,0,4,0,3,0,1,0,0,1,0,1,0,1,0,3,1,0
401262819,Utah State Aggies,S. Latone,4399209,,True,23.0,4,6,4,5,0,1,0,0,0,3,3,1,1,0,3,2,8
401262819,Utah State Aggies,E. Jarrell,4704653,,False,7.0,1,1,1,1,0,0,0,0,1,0,1,0,0,0,1,1,2
401262819,Utah State Aggies,H. Nelson,4704652,,False,16.0,1,6,0,2,1,4,2,6,2,1,3,0,0,0,0,1,5
401262819,Utah State Aggies,A. Lustgarten,4704649,,False,6.0,0,0,0,0,0,0,0,0,0,0,0,0,0,0,1,1,0
401262819,Utah State Aggies,K. Falslev,4704648,,False,12.0,0,3,0,0,0,3,0,0,0,0,0,0,0,0,1,1,0
401262819,Utah State Aggies,J. Polansky,4595673,,False,6.0,0,0,0,0,0,0,0,0,0,1,1,0,0,0,0,0,0
401262819,Utah State Aggies,K. Kamakawiwo'ole,4595670,,False,22.0,2,5,2,5,0,0,2,4,0,5,5,0,1,0,0,1,6
401262819,Utah State Aggies,E. Harris,4281891,,False,29.0,3,6,2,4,1,2,4,5,0,3,3,0,1,0,3,1,11
401262819,Utah State Aggies,TEAM,TOTAL,TOTAL,False,,15,48,13,35,2,13,10,19,11,24,35,4,6,1,21,14,42
401262818,Wyoming Cowgirls,D. Davidsdottir,4068870,,True,22.0,5,13,5,13,0,0,4,4,2,6,8,0,2,0,0,3,14
401262818,Wyoming Cowgirls,J. Johnson,4595683,,True,20.0,1,4,1,2,0,2,1,1,1,5,6,2,0,0,1,2,3
401262818,Wyoming Cowgirls,Q. Weidemann,4400207,,True,35.0,2,11,0,4,2,7,0,0,1,2,3,6,1,0,2,0,6
401262818,Wyoming Cowgirls,A. Sanchez Ramos,4400204,,True,31.0,2,7,0,3,2,4,0,0,0,13,13,1,1,1,1,1,6
401262818,Wyoming Cowgirls,T. Olson,4400203,,True,29.0,2,3,2,3,0,0,0,0,3,1,4,5,3,0,2,0,4
401262818,Wyoming Cowgirls,M. Savic,4704660,,False,6.0,4,9,4,9,0,0,1,3,2,1,3,0,0,1,0,4,9
401262818,Wyoming Cowgirls,P. Salazar,4704659,,False,4.0,0,1,0,0,0,1,0,0,0,0,0,0,0,0,0,1,0
401262818,Wyoming Cowgirls,G. Ellis,4704657,,False,10.0,1,3,1,2,0,1,0,0,1,0,1,1,0,0,0,1,2
401262818,Wyoming Cowgirls,L. Bull,4704655,,False,1.0,1,1,0,0,1,1,0,0,0,0,0,0,0,0,0,0,3
401262818,Wyoming Cowgirls,O. Ustowska,4704662,,False,18.0,1,5,0,2,1,3,0,0,0,0,0,2,0,0,0,1,3
401262818,Wyoming Cowgirls,L. Hudson,4704658,,False,1.0,0,0,0,0,0,0,0,0,0,0,0,0,0,0,0,0,0
401262818,Wyoming Cowgirls,M. Bradshaw,4595681,,False,23.0,7,15,5,7,2,8,2,2,0,2,2,1,0,0,3,0,18
401262818,Wyoming Cowgirls,TEAM,TOTAL,TOTAL,False,,26,72,18,45,8,27,8,10,13,32,45,18,7,2,10,13,68
401262818,Wyoming Cowgirls,D. Davidsdottir,4068870,,True,22.0,5,13,5,13,0,0,4,4,2,6,8,0,2,0,0,3,14
401262818,Wyoming Cowgirls,J. Johnson,4595683,,True,20.0,1,4,1,2,0,2,1,1,1,5,6,2,0,0,1,2,3
401262818,Wyoming Cowgirls,Q. Weidemann,4400207,,True,35.0,2,11,0,4,2,7,0,0,1,2,3,6,1,0,2,0,6
401262818,Wyoming Cowgirls,A. Sanchez Ramos,4400204,,True,31.0,2,7,0,3,2,4,0,0,0,13,13,1,1,1,1,1,6
401262818,Wyoming Cowgirls,T. Olson,4400203,,True,29.0,2,3,2,3,0,0,0,0,3,1,4,5,3,0,2,0,4
401262818,Wyoming Cowgirls,M. Savic,4704660,,False,6.0,4,9,4,9,0,0,1,3,2,1,3,0,0,1,0,4,9
401262818,Wyoming Cowgirls,P. Salazar,4704659,,False,4.0,0,1,0,0,0,1,0,0,0,0,0,0,0,0,0,1,0
401262818,Wyoming Cowgirls,G. Ellis,4704657,,False,10.0,1,3,1,2,0,1,0,0,1,0,1,1,0,0,0,1,2
401262818,Wyoming Cowgirls,L. Bull,4704655,,False,1.0,1,1,0,0,1,1,0,0,0,0,0,0,0,0,0,0,3
401262818,Wyoming Cowgirls,O. Ustowska,4704662,,False,18.0,1,5,0,2,1,3,0,0,0,0,0,2,0,0,0,1,3
401262818,Wyoming Cowgirls,L. Hudson,4704658,,False,1.0,0,0,0,0,0,0,0,0,0,0,0,0,0,0,0,0,0
401262818,Wyoming Cowgirls,M. Bradshaw,4595681,,False,23.0,7,15,5,7,2,8,2,2,0,2,2,1,0,0,3,0,18
401262818,Wyoming Cowgirls,TEAM,TOTAL,TOTAL,False,,26,72,18,45,8,27,8,10,13,32,45,18,7,2,10,13,68
401262818,Utah State Aggies,J. Chatman,4068281,,True,31.0,8,19,4,12,4,7,1,1,4,6,10,0,0,0,2,3,21
401262818,Utah State Aggies,H. Nelson,4704652,,True,9.0,0,4,0,2,0,2,0,0,0,2,2,0,0,0,0,0,0
401262818,Utah State Aggies,F. Brantley,4595669,,True,32.0,3,6,3,6,0,0,1,1,1,3,4,2,0,0,3,2,7
401262818,Utah State Aggies,S. Latone,4399209,,True,11.0,0,4,0,4,0,0,0,0,0,2,2,1,1,0,3,2,0
401262818,Utah State Aggies,E. Harris,4281891,,True,25.0,0,4,0,2,0,2,3,4,0,3,3,1,0,0,1,0,3
401262818,Utah State Aggies,E. Jarrell,4704653,,False,2.0,0,0,0,0,0,0,0,0,0,1,1,0,0,0,0,1,0
401262818,Utah State Aggies,T. Franson,4281892,,False,5.0,0,0,0,0,0,0,0,0,1,2,3,0,0,0,0,1,0
401262818,Utah State Aggies,M. Pruitt,4704651,,False,20.0,6,12,6,11,0,1,1,1,0,5,5,0,1,1,1,0,13
401262818,Utah State Aggies,K. Falslev,4704648,,False,17.0,1,4,0,0,1,4,0,0,0,0,0,0,0,0,0,0,3
401262818,Utah State Aggies,M. Mendazona,4704647,,False,21.0,1,5,1,4,0,1,0,0,2,3,5,1,0,0,2,2,2
401262818,Utah State Aggies,E. Emrich,4595671,,False,12.0,0,1,0,1,0,0,0,0,0,0,0,0,0,1,3,0,0
401262818,Utah State Aggies,K. Kamakawiwo'ole,4595670,,False,15.0,2,2,1,1,1,1,2,2,0,4,4,1,0,0,0,1,7
401262818,Utah State Aggies,TEAM,TOTAL,TOTAL,False,,21,61,15,43,6,18,8,9,9,34,43,6,2,2,16,12,56
401262818,Utah State Aggies,J. Chatman,4068281,,True,31.0,8,19,4,12,4,7,1,1,4,6,10,0,0,0,2,3,21
401262818,Utah State Aggies,H. Nelson,4704652,,True,9.0,0,4,0,2,0,2,0,0,0,2,2,0,0,0,0,0,0
401262818,Utah State Aggies,F. Brantley,4595669,,True,32.0,3,6,3,6,0,0,1,1,1,3,4,2,0,0,3,2,7
401262818,Utah State Aggies,S. Latone,4399209,,True,11.0,0,4,0,4,0,0,0,0,0,2,2,1,1,0,3,2,0
401262818,Utah State Aggies,E. Harris,4281891,,True,25.0,0,4,0,2,0,2,3,4,0,3,3,1,0,0,1,0,3
401262818,Utah State Aggies,E. Jarrell,4704653,,False,2.0,0,0,0,0,0,0,0,0,0,1,1,0,0,0,0,1,0
401262818,Utah State Aggies,T. Franson,4281892,,False,5.0,0,0,0,0,0,0,0,0,1,2,3,0,0,0,0,1,0
401262818,Utah State Aggies,M. Pruitt,4704651,,False,20.0,6,12,6,11,0,1,1,1,0,5,5,0,1,1,1,0,13
401262818,Utah State Aggies,K. Falslev,4704648,,False,17.0,1,4,0,0,1,4,0,0,0,0,0,0,0,0,0,0,3
401262818,Utah State Aggies,M. Mendazona,4704647,,False,21.0,1,5,1,4,0,1,0,0,2,3,5,1,0,0,2,2,2
401262818,Utah State Aggies,E. Emrich,4595671,,False,12.0,0,1,0,1,0,0,0,0,0,0,0,0,0,1,3,0,0
401262818,Utah State Aggies,K. Kamakawiwo'ole,4595670,,False,15.0,2,2,1,1,1,1,2,2,0,4,4,1,0,0,0,1,7
401262818,Utah State Aggies,TEAM,TOTAL,TOTAL,False,,21,61,15,43,6,18,8,9,9,34,43,6,2,2,16,12,56
401262817,Utah State Aggies,J. Chatman,4068281,,True,40.0,3,13,3,9,0,4,2,3,7,6,13,4,2,0,1,4,8
401262817,Utah State Aggies,H. Nelson,4704652,,True,27.0,5,9,4,7,1,2,0,2,4,4,8,2,3,0,1,4,11
401262817,Utah State Aggies,E. Emrich,4595671,,True,33.0,2,5,2,4,0,1,1,2,1,1,2,1,0,0,5,3,5
401262817,Utah State Aggies,F. Brantley,4595669,,True,30.0,3,5,2,3,1,2,0,2,0,4,4,0,0,0,3,5,7
401262817,Utah State Aggies,S. Latone,4399209,,True,34.0,8,25,7,18,1,7,7,7,1,3,4,2,2,0,5,5,24
401262817,Utah State Aggies,T. Franson,4281892,,False,11.0,1,1,0,0,1,1,2,2,0,2,2,0,0,0,2,1,5
401262817,Utah State Aggies,K. Falslev,4704648,,False,2.0,0,0,0,0,0,0,0,0,0,0,0,0,0,0,0,0,0
401262817,Utah State Aggies,M. Pruitt,4704651,,False,1.0,0,0,0,0,0,0,0,0,0,1,1,0,0,0,3,1,0
401262817,Utah State Aggies,M. Mendazona,4704647,,False,15.0,0,4,0,3,0,1,2,2,3,0,3,0,0,0,4,3,2
401262817,Utah State Aggies,K. Kamakawiwo'ole,4595670,,False,7.0,0,0,0,0,0,0,0,0,1,0,1,0,0,0,0,2,0
401262817,Utah State Aggies,TEAM,TOTAL,TOTAL,False,,22,62,18,44,4,18,14,20,18,24,42,9,7,0,24,28,62
401262817,Utah State Aggies,J. Chatman,4068281,,True,40.0,3,13,3,9,0,4,2,3,7,6,13,4,2,0,1,4,8
401262817,Utah State Aggies,H. Nelson,4704652,,True,27.0,5,9,4,7,1,2,0,2,4,4,8,2,3,0,1,4,11
401262817,Utah State Aggies,E. Emrich,4595671,,True,33.0,2,5,2,4,0,1,1,2,1,1,2,1,0,0,5,3,5
401262817,Utah State Aggies,F. Brantley,4595669,,True,30.0,3,5,2,3,1,2,0,2,0,4,4,0,0,0,3,5,7
401262817,Utah State Aggies,S. Latone,4399209,,True,34.0,8,25,7,18,1,7,7,7,1,3,4,2,2,0,5,5,24
401262817,Utah State Aggies,T. Franson,4281892,,False,11.0,1,1,0,0,1,1,2,2,0,2,2,0,0,0,2,1,5
401262817,Utah State Aggies,K. Falslev,4704648,,False,2.0,0,0,0,0,0,0,0,0,0,0,0,0,0,0,0,0,0
401262817,Utah State Aggies,M. Pruitt,4704651,,False,1.0,0,0,0,0,0,0,0,0,0,1,1,0,0,0,3,1,0
401262817,Utah State Aggies,M. Mendazona,4704647,,False,15.0,0,4,0,3,0,1,2,2,3,0,3,0,0,0,4,3,2
401262817,Utah State Aggies,K. Kamakawiwo'ole,4595670,,False,7.0,0,0,0,0,0,0,0,0,1,0,1,0,0,0,0,2,0
401262817,Utah State Aggies,TEAM,TOTAL,TOTAL,False,,22,62,18,44,4,18,14,20,18,24,42,9,7,0,24,28,62
401262817,UNLV Lady Rebels,D. Byrne,4398924,,True,24.0,2,5,0,0,2,5,2,2,1,2,3,0,0,1,5,3,8
401262817,UNLV Lady Rebels,D. Young,4704625,,True,27.0,6,11,6,11,0,0,3,7,5,6,11,1,3,0,4,4,15
401262817,UNLV Lady Rebels,J. Thomas,4704624,,True,36.0,5,9,3,4,2,5,1,2,0,6,6,1,3,1,0,3,13
401262817,UNLV Lady Rebels,N. Johnson,4400108,,True,27.0,3,10,2,6,1,4,3,6,1,1,2,4,2,0,2,2,10
401262817,UNLV Lady Rebels,B. Thomas,4068210,,True,38.0,0,7,0,2,0,5,6,8,0,2,2,7,5,1,2,0,6
401262817,UNLV Lady Rebels,A. Blount,4595640,,False,13.0,2,6,2,6,0,0,3,4,1,2,3,0,0,0,1,2,7
401262817,UNLV Lady Rebels,K. Wilfred,4595641,,False,16.0,4,6,4,6,0,0,4,4,4,2,6,0,0,1,1,1,12
401262817,UNLV Lady Rebels,J. Singleton,4704623,,False,6.0,1,1,1,1,0,0,0,0,0,0,0,1,2,1,1,0,2
401262817,UNLV Lady Rebels,J. Buckley,4595639,,False,13.0,0,1,0,0,0,1,0,0,0,0,0,0,0,0,1,2,0
401262817,UNLV Lady Rebels,TEAM,TOTAL,TOTAL,False,,23,56,18,36,5,20,22,33,13,25,38,14,15,5,17,17,73
401262817,UNLV Lady Rebels,D. Byrne,4398924,,True,24.0,2,5,0,0,2,5,2,2,1,2,3,0,0,1,5,3,8
401262817,UNLV Lady Rebels,D. Young,4704625,,True,27.0,6,11,6,11,0,0,3,7,5,6,11,1,3,0,4,4,15
401262817,UNLV Lady Rebels,J. Thomas,4704624,,True,36.0,5,9,3,4,2,5,1,2,0,6,6,1,3,1,0,3,13
401262817,UNLV Lady Rebels,N. Johnson,4400108,,True,27.0,3,10,2,6,1,4,3,6,1,1,2,4,2,0,2,2,10
401262817,UNLV Lady Rebels,B. Thomas,4068210,,True,38.0,0,7,0,2,0,5,6,8,0,2,2,7,5,1,2,0,6
401262817,UNLV Lady Rebels,A. Blount,4595640,,False,13.0,2,6,2,6,0,0,3,4,1,2,3,0,0,0,1,2,7
401262817,UNLV Lady Rebels,K. Wilfred,4595641,,False,16.0,4,6,4,6,0,0,4,4,4,2,6,0,0,1,1,1,12
401262817,UNLV Lady Rebels,J. Singleton,4704623,,False,6.0,1,1,1,1,0,0,0,0,0,0,0,1,2,1,1,0,2
401262817,UNLV Lady Rebels,J. Buckley,4595639,,False,13.0,0,1,0,0,0,1,0,0,0,0,0,0,0,0,1,2,0
401262817,UNLV Lady Rebels,TEAM,TOTAL,TOTAL,False,,23,56,18,36,5,20,22,33,13,25,38,14,15,5,17,17,73
401262816,Utah State Aggies,J. Chatman,4068281,,True,23.0,2,10,2,7,0,3,0,0,1,2,3,0,1,0,0,4,4
401262816,Utah State Aggies,H. Nelson,4704652,,True,23.0,4,9,3,5,1,4,0,0,0,3,3,2,0,0,0,4,9
401262816,Utah State Aggies,E. Emrich,4595671,,True,13.0,1,2,1,2,0,0,0,0,1,2,3,0,0,0,0,1,2
401262816,Utah State Aggies,F. Brantley,4595669,,True,27.0,4,8,4,7,0,1,1,2,0,1,1,2,0,0,3,2,9
401262816,Utah State Aggies,E. Harris,4281891,,True,34.0,3,6,2,3,1,3,3,4,1,4,5,4,0,0,0,1,10
401262816,Utah State Aggies,E. Jarrell,4704653,,False,7.0,0,2,0,2,0,0,1,2,0,4,4,0,0,2,0,3,1
401262816,Utah State Aggies,T. Franson,4281892,,False,13.0,1,3,1,3,0,0,1,2,0,3,3,1,1,0,0,2,3
401262816,Utah State Aggies,K. Falslev,4704648,,False,5.0,1,2,0,0,1,2,0,0,0,0,0,0,0,0,0,1,3
401262816,Utah State Aggies,M. Mendazona,4704647,,False,21.0,1,8,1,6,0,2,0,0,0,1,1,1,1,3,1,3,2
401262816,Utah State Aggies,K. Kamakawiwo'ole,4595670,,False,14.0,2,6,2,5,0,1,0,0,0,2,2,1,0,1,2,2,4
401262816,Utah State Aggies,S. Latone,4399209,,False,20.0,4,11,2,4,2,7,2,2,1,5,6,0,0,0,0,1,12
401262816,Utah State Aggies,TEAM,TOTAL,TOTAL,False,,23,67,18,44,5,23,8,12,5,32,37,11,3,6,6,24,59
401262816,Utah State Aggies,J. Chatman,4068281,,True,23.0,2,10,2,7,0,3,0,0,1,2,3,0,1,0,0,4,4
401262816,Utah State Aggies,H. Nelson,4704652,,True,23.0,4,9,3,5,1,4,0,0,0,3,3,2,0,0,0,4,9
401262816,Utah State Aggies,E. Emrich,4595671,,True,13.0,1,2,1,2,0,0,0,0,1,2,3,0,0,0,0,1,2
401262816,Utah State Aggies,F. Brantley,4595669,,True,27.0,4,8,4,7,0,1,1,2,0,1,1,2,0,0,3,2,9
401262816,Utah State Aggies,E. Harris,4281891,,True,34.0,3,6,2,3,1,3,3,4,1,4,5,4,0,0,0,1,10
401262816,Utah State Aggies,E. Jarrell,4704653,,False,7.0,0,2,0,2,0,0,1,2,0,4,4,0,0,2,0,3,1
401262816,Utah State Aggies,T. Franson,4281892,,False,13.0,1,3,1,3,0,0,1,2,0,3,3,1,1,0,0,2,3
401262816,Utah State Aggies,K. Falslev,4704648,,False,5.0,1,2,0,0,1,2,0,0,0,0,0,0,0,0,0,1,3
401262816,Utah State Aggies,M. Mendazona,4704647,,False,21.0,1,8,1,6,0,2,0,0,0,1,1,1,1,3,1,3,2
401262816,Utah State Aggies,K. Kamakawiwo'ole,4595670,,False,14.0,2,6,2,5,0,1,0,0,0,2,2,1,0,1,2,2,4
401262816,Utah State Aggies,S. Latone,4399209,,False,20.0,4,11,2,4,2,7,2,2,1,5,6,0,0,0,0,1,12
401262816,Utah State Aggies,TEAM,TOTAL,TOTAL,False,,23,67,18,44,5,23,8,12,5,32,37,11,3,6,6,24,59
401262816,UNLV Lady Rebels,D. Byrne,4398924,,True,33.0,5,15,3,8,2,7,6,6,8,5,13,1,0,0,1,0,18
401262816,UNLV Lady Rebels,D. Young,4704625,,True,19.0,6,6,6,6,0,0,2,2,0,7,7,1,0,0,2,2,14
401262816,UNLV Lady Rebels,J. Thomas,4704624,,True,33.0,5,15,3,5,2,10,1,2,1,8,9,1,0,0,0,1,13
401262816,UNLV Lady Rebels,N. Johnson,4400108,,True,24.0,5,12,4,10,1,2,2,4,1,3,4,1,0,0,0,0,13
401262816,UNLV Lady Rebels,B. Thomas,4068210,,True,33.0,3,10,0,2,3,8,0,0,1,7,8,8,1,0,0,2,9
401262816,UNLV Lady Rebels,T. Carter,4595642,,False,7.0,0,4,0,2,0,2,5,6,2,1,3,0,1,0,1,0,5
401262816,UNLV Lady Rebels,A. Blount,4595640,,False,7.0,0,2,0,2,0,0,2,4,1,2,3,2,0,0,0,2,2
401262816,UNLV Lady Rebels,K. Wilfred,4595641,,False,14.0,2,5,2,5,0,0,4,4,3,1,4,0,0,1,0,0,8
401262816,UNLV Lady Rebels,J. Singleton,4704623,,False,10.0,0,2,0,2,0,0,0,0,0,2,2,0,0,0,0,1,0
401262816,UNLV Lady Rebels,C. Gurrola,4595644,,False,3.0,0,0,0,0,0,0,0,0,0,0,0,0,0,0,0,0,0
401262816,UNLV Lady Rebels,J. Buckley,4595639,,False,17.0,2,5,1,4,1,1,2,2,0,4,4,2,0,0,1,1,7
401262816,UNLV Lady Rebels,TEAM,TOTAL,TOTAL,False,,28,76,19,46,9,30,24,30,20,41,61,16,2,1,5,9,89
401262816,UNLV Lady Rebels,D. Byrne,4398924,,True,33.0,5,15,3,8,2,7,6,6,8,5,13,1,0,0,1,0,18
401262816,UNLV Lady Rebels,D. Young,4704625,,True,19.0,6,6,6,6,0,0,2,2,0,7,7,1,0,0,2,2,14
401262816,UNLV Lady Rebels,J. Thomas,4704624,,True,33.0,5,15,3,5,2,10,1,2,1,8,9,1,0,0,0,1,13
401262816,UNLV Lady Rebels,N. Johnson,4400108,,True,24.0,5,12,4,10,1,2,2,4,1,3,4,1,0,0,0,0,13
401262816,UNLV Lady Rebels,B. Thomas,4068210,,True,33.0,3,10,0,2,3,8,0,0,1,7,8,8,1,0,0,2,9
401262816,UNLV Lady Rebels,T. Carter,4595642,,False,7.0,0,4,0,2,0,2,5,6,2,1,3,0,1,0,1,0,5
401262816,UNLV Lady Rebels,A. Blount,4595640,,False,7.0,0,2,0,2,0,0,2,4,1,2,3,2,0,0,0,2,2
401262816,UNLV Lady Rebels,K. Wilfred,4595641,,False,14.0,2,5,2,5,0,0,4,4,3,1,4,0,0,1,0,0,8
401262816,UNLV Lady Rebels,J. Singleton,4704623,,False,10.0,0,2,0,2,0,0,0,0,0,2,2,0,0,0,0,1,0
401262816,UNLV Lady Rebels,C. Gurrola,4595644,,False,3.0,0,0,0,0,0,0,0,0,0,0,0,0,0,0,0,0,0
401262816,UNLV Lady Rebels,J. Buckley,4595639,,False,17.0,2,5,1,4,1,1,2,2,0,4,4,2,0,0,1,1,7
401262816,UNLV Lady Rebels,TEAM,TOTAL,TOTAL,False,,28,76,19,46,9,30,24,30,20,41,61,16,2,1,5,9,89
401262815,Wyoming Cowgirls,D. Davidsdottir,4068870,,True,16.0,4,6,4,5,0,1,0,2,0,3,3,2,1,0,0,4,8
401262815,Wyoming Cowgirls,M. Bradshaw,4595681,,True,29.0,3,6,2,4,1,2,6,7,0,5,5,1,0,0,3,2,13
401262815,Wyoming Cowgirls,Q. Weidemann,4400207,,True,38.0,2,8,0,3,2,5,4,4,1,3,4,3,0,0,1,0,10
401262815,Wyoming Cowgirls,A. Sanchez Ramos,4400204,,True,32.0,8,15,6,7,2,8,2,2,0,6,6,0,0,0,0,4,20
401262815,Wyoming Cowgirls,T. Olson,4400203,,True,34.0,1,4,1,2,0,2,2,4,1,0,1,3,2,0,1,0,4
401262815,Wyoming Cowgirls,M. Savic,4704660,,False,3.0,0,1,0,1,0,0,1,2,0,0,0,0,0,0,0,1,1
401262815,Wyoming Cowgirls,P. Salazar,4704659,,False,5.0,0,3,0,2,0,1,0,0,0,0,0,0,0,0,0,1,0
401262815,Wyoming Cowgirls,G. Ellis,4704657,,False,13.0,2,4,1,2,1,2,4,4,2,2,4,0,0,0,0,4,9
401262815,Wyoming Cowgirls,O. Ustowska,4704662,,False,20.0,1,3,1,3,0,0,0,0,1,2,3,0,0,0,2,0,2
401262815,Wyoming Cowgirls,J. Johnson,4595683,,False,10.0,0,2,0,0,0,2,0,0,0,0,0,1,0,0,1,1,0
401262815,Wyoming Cowgirls,TEAM,TOTAL,TOTAL,False,,21,52,15,29,6,23,19,25,7,22,29,10,3,0,9,17,67
401262815,Wyoming Cowgirls,D. Davidsdottir,4068870,,True,16.0,4,6,4,5,0,1,0,2,0,3,3,2,1,0,0,4,8
401262815,Wyoming Cowgirls,M. Bradshaw,4595681,,True,29.0,3,6,2,4,1,2,6,7,0,5,5,1,0,0,3,2,13
401262815,Wyoming Cowgirls,Q. Weidemann,4400207,,True,38.0,2,8,0,3,2,5,4,4,1,3,4,3,0,0,1,0,10
401262815,Wyoming Cowgirls,A. Sanchez Ramos,4400204,,True,32.0,8,15,6,7,2,8,2,2,0,6,6,0,0,0,0,4,20
401262815,Wyoming Cowgirls,T. Olson,4400203,,True,34.0,1,4,1,2,0,2,2,4,1,0,1,3,2,0,1,0,4
401262815,Wyoming Cowgirls,M. Savic,4704660,,False,3.0,0,1,0,1,0,0,1,2,0,0,0,0,0,0,0,1,1
401262815,Wyoming Cowgirls,P. Salazar,4704659,,False,5.0,0,3,0,2,0,1,0,0,0,0,0,0,0,0,0,1,0
401262815,Wyoming Cowgirls,G. Ellis,4704657,,False,13.0,2,4,1,2,1,2,4,4,2,2,4,0,0,0,0,4,9
401262815,Wyoming Cowgirls,O. Ustowska,4704662,,False,20.0,1,3,1,3,0,0,0,0,1,2,3,0,0,0,2,0,2
401262815,Wyoming Cowgirls,J. Johnson,4595683,,False,10.0,0,2,0,0,0,2,0,0,0,0,0,1,0,0,1,1,0
401262815,Wyoming Cowgirls,TEAM,TOTAL,TOTAL,False,,21,52,15,29,6,23,19,25,7,22,29,10,3,0,9,17,67
401262815,UNLV Lady Rebels,D. Byrne,4398924,,True,31.0,2,8,2,5,0,3,3,4,3,3,6,0,2,1,2,2,7
401262815,UNLV Lady Rebels,D. Young,4704625,,True,23.0,9,13,9,13,0,0,2,4,2,1,3,0,0,0,2,1,20
401262815,UNLV Lady Rebels,J. Thomas,4704624,,True,40.0,2,8,0,3,2,5,0,0,2,3,5,1,1,0,1,4,6
401262815,UNLV Lady Rebels,N. Johnson,4400108,,True,27.0,4,10,2,4,2,6,2,2,0,0,0,0,1,0,1,5,12
401262815,UNLV Lady Rebels,B. Thomas,4068210,,True,35.0,0,5,0,3,0,2,0,0,1,4,5,3,1,0,4,3,0
401262815,UNLV Lady Rebels,T. Carter,4595642,,False,7.0,1,3,1,1,0,2,1,2,0,3,3,0,0,0,1,0,3
401262815,UNLV Lady Rebels,A. Blount,4595640,,False,1.0,0,0,0,0,0,0,0,0,0,0,0,0,0,0,0,0,0
401262815,UNLV Lady Rebels,K. Wilfred,4595641,,False,17.0,5,7,5,7,0,0,1,2,4,2,6,0,0,0,2,2,11
401262815,UNLV Lady Rebels,J. Singleton,4704623,,False,10.0,0,1,0,1,0,0,1,2,0,2,2,2,0,0,0,1,1
401262815,UNLV Lady Rebels,J. Buckley,4595639,,False,9.0,0,1,0,1,0,0,2,2,0,3,3,0,0,0,0,2,2
401262815,UNLV Lady Rebels,TEAM,TOTAL,TOTAL,False,,23,56,19,38,4,18,12,18,14,26,40,6,5,1,13,20,62
401262815,UNLV Lady Rebels,D. Byrne,4398924,,True,31.0,2,8,2,5,0,3,3,4,3,3,6,0,2,1,2,2,7
401262815,UNLV Lady Rebels,D. Young,4704625,,True,23.0,9,13,9,13,0,0,2,4,2,1,3,0,0,0,2,1,20
401262815,UNLV Lady Rebels,J. Thomas,4704624,,True,40.0,2,8,0,3,2,5,0,0,2,3,5,1,1,0,1,4,6
401262815,UNLV Lady Rebels,N. Johnson,4400108,,True,27.0,4,10,2,4,2,6,2,2,0,0,0,0,1,0,1,5,12
401262815,UNLV Lady Rebels,B. Thomas,4068210,,True,35.0,0,5,0,3,0,2,0,0,1,4,5,3,1,0,4,3,0
401262815,UNLV Lady Rebels,T. Carter,4595642,,False,7.0,1,3,1,1,0,2,1,2,0,3,3,0,0,0,1,0,3
401262815,UNLV Lady Rebels,A. Blount,4595640,,False,1.0,0,0,0,0,0,0,0,0,0,0,0,0,0,0,0,0,0
401262815,UNLV Lady Rebels,K. Wilfred,4595641,,False,17.0,5,7,5,7,0,0,1,2,4,2,6,0,0,0,2,2,11
401262815,UNLV Lady Rebels,J. Singleton,4704623,,False,10.0,0,1,0,1,0,0,1,2,0,2,2,2,0,0,0,1,1
401262815,UNLV Lady Rebels,J. Buckley,4595639,,False,9.0,0,1,0,1,0,0,2,2,0,3,3,0,0,0,0,2,2
401262815,UNLV Lady Rebels,TEAM,TOTAL,TOTAL,False,,23,56,19,38,4,18,12,18,14,26,40,6,5,1,13,20,62
401262814,Wyoming Cowgirls,D. Davidsdottir,4068870,,True,30.0,3,9,3,8,0,1,3,4,2,1,3,0,0,1,2,4,9
401262814,Wyoming Cowgirls,M. Bradshaw,4595681,,True,29.0,5,18,3,11,2,7,2,4,2,2,4,0,1,0,1,0,14
401262814,Wyoming Cowgirls,Q. Weidemann,4400207,,True,36.0,2,5,2,4,0,1,0,0,0,1,1,4,1,0,0,2,4
401262814,Wyoming Cowgirls,A. Sanchez Ramos,4400204,,True,28.0,3,11,2,5,1,6,0,0,1,4,5,0,0,0,0,2,7
401262814,Wyoming Cowgirls,T. Olson,4400203,,True,34.0,1,5,1,4,0,1,2,3,3,5,8,2,4,0,3,4,4
401262814,Wyoming Cowgirls,M. Savic,4704660,,False,2.0,0,0,0,0,0,0,0,0,0,0,0,0,0,0,0,0,0
401262814,Wyoming Cowgirls,P. Salazar,4704659,,False,9.0,2,4,1,1,1,3,1,2,2,0,2,0,2,1,2,0,6
401262814,Wyoming Cowgirls,G. Ellis,4704657,,False,4.0,0,1,0,1,0,0,0,0,0,0,0,0,0,0,0,2,0
401262814,Wyoming Cowgirls,O. Ustowska,4704662,,False,9.0,0,4,0,1,0,3,0,0,0,1,1,1,0,0,2,2,0
401262814,Wyoming Cowgirls,J. Johnson,4595683,,False,19.0,1,4,1,1,0,3,0,0,1,2,3,1,0,0,1,0,2
401262814,Wyoming Cowgirls,TEAM,TOTAL,TOTAL,False,,17,61,13,36,4,25,8,13,16,17,33,8,8,2,11,16,46
401262814,Wyoming Cowgirls,D. Davidsdottir,4068870,,True,30.0,3,9,3,8,0,1,3,4,2,1,3,0,0,1,2,4,9
401262814,Wyoming Cowgirls,M. Bradshaw,4595681,,True,29.0,5,18,3,11,2,7,2,4,2,2,4,0,1,0,1,0,14
401262814,Wyoming Cowgirls,Q. Weidemann,4400207,,True,36.0,2,5,2,4,0,1,0,0,0,1,1,4,1,0,0,2,4
401262814,Wyoming Cowgirls,A. Sanchez Ramos,4400204,,True,28.0,3,11,2,5,1,6,0,0,1,4,5,0,0,0,0,2,7
401262814,Wyoming Cowgirls,T. Olson,4400203,,True,34.0,1,5,1,4,0,1,2,3,3,5,8,2,4,0,3,4,4
401262814,Wyoming Cowgirls,M. Savic,4704660,,False,2.0,0,0,0,0,0,0,0,0,0,0,0,0,0,0,0,0,0
401262814,Wyoming Cowgirls,P. Salazar,4704659,,False,9.0,2,4,1,1,1,3,1,2,2,0,2,0,2,1,2,0,6
401262814,Wyoming Cowgirls,G. Ellis,4704657,,False,4.0,0,1,0,1,0,0,0,0,0,0,0,0,0,0,0,2,0
401262814,Wyoming Cowgirls,O. Ustowska,4704662,,False,9.0,0,4,0,1,0,3,0,0,0,1,1,1,0,0,2,2,0
401262814,Wyoming Cowgirls,J. Johnson,4595683,,False,19.0,1,4,1,1,0,3,0,0,1,2,3,1,0,0,1,0,2
401262814,Wyoming Cowgirls,TEAM,TOTAL,TOTAL,False,,17,61,13,36,4,25,8,13,16,17,33,8,8,2,11,16,46
401262814,UNLV Lady Rebels,D. Byrne,4398924,,True,36.0,3,7,1,3,2,4,1,2,1,10,11,0,0,2,0,3,9
401262814,UNLV Lady Rebels,D. Young,4704625,,True,17.0,4,8,4,8,0,0,1,2,2,6,8,0,0,0,4,1,9
401262814,UNLV Lady Rebels,J. Thomas,4704624,,True,35.0,2,5,1,1,1,4,0,0,0,1,1,2,1,1,1,2,5
401262814,UNLV Lady Rebels,N. Johnson,4400108,,True,17.0,2,6,1,1,1,5,2,2,0,3,3,1,0,1,3,4,7
401262814,UNLV Lady Rebels,B. Thomas,4068210,,True,40.0,0,4,0,2,0,2,0,0,0,2,2,4,2,1,2,0,0
401262814,UNLV Lady Rebels,A. Blount,4595640,,False,3.0,0,0,0,0,0,0,0,0,0,1,1,0,0,0,2,0,0
401262814,UNLV Lady Rebels,K. Wilfred,4595641,,False,24.0,7,10,7,10,0,0,6,8,2,3,5,0,1,0,3,3,20
401262814,UNLV Lady Rebels,J. Singleton,4704623,,False,12.0,0,0,0,0,0,0,1,4,2,1,3,3,0,0,2,0,1
401262814,UNLV Lady Rebels,J. Buckley,4595639,,False,16.0,1,2,0,0,1,2,0,0,1,2,3,2,0,1,0,2,3
401262814,UNLV Lady Rebels,TEAM,TOTAL,TOTAL,False,,19,42,14,25,5,17,11,18,9,31,40,12,4,6,20,15,54
401262814,UNLV Lady Rebels,D. Byrne,4398924,,True,36.0,3,7,1,3,2,4,1,2,1,10,11,0,0,2,0,3,9
401262814,UNLV Lady Rebels,D. Young,4704625,,True,17.0,4,8,4,8,0,0,1,2,2,6,8,0,0,0,4,1,9
401262814,UNLV Lady Rebels,J. Thomas,4704624,,True,35.0,2,5,1,1,1,4,0,0,0,1,1,2,1,1,1,2,5
401262814,UNLV Lady Rebels,N. Johnson,4400108,,True,17.0,2,6,1,1,1,5,2,2,0,3,3,1,0,1,3,4,7
401262814,UNLV Lady Rebels,B. Thomas,4068210,,True,40.0,0,4,0,2,0,2,0,0,0,2,2,4,2,1,2,0,0
401262814,UNLV Lady Rebels,A. Blount,4595640,,False,3.0,0,0,0,0,0,0,0,0,0,1,1,0,0,0,2,0,0
401262814,UNLV Lady Rebels,K. Wilfred,4595641,,False,24.0,7,10,7,10,0,0,6,8,2,3,5,0,1,0,3,3,20
401262814,UNLV Lady Rebels,J. Singleton,4704623,,False,12.0,0,0,0,0,0,0,1,4,2,1,3,3,0,0,2,0,1
401262814,UNLV Lady Rebels,J. Buckley,4595639,,False,16.0,1,2,0,0,1,2,0,0,1,2,3,2,0,1,0,2,3
401262814,UNLV Lady Rebels,TEAM,TOTAL,TOTAL,False,,19,42,14,25,5,17,11,18,9,31,40,12,4,6,20,15,54
401262806,Wyoming Cowgirls,D. Davidsdottir,4068870,,True,25.0,1,6,1,5,0,1,0,0,3,4,7,1,0,1,0,2,2
401262806,Wyoming Cowgirls,J. Johnson,4595683,,True,23.0,4,7,2,3,2,4,0,0,0,1,1,2,0,1,4,1,10
401262806,Wyoming Cowgirls,Q. Weidemann,4400207,,True,30.0,4,8,3,5,1,3,0,0,0,0,0,3,0,0,0,0,9
401262806,Wyoming Cowgirls,A. Sanchez Ramos,4400204,,True,30.0,3,6,1,3,2,3,0,0,0,5,5,2,0,0,1,2,8
401262806,Wyoming Cowgirls,T. Olson,4400203,,True,29.0,3,6,3,4,0,2,0,0,0,6,6,4,4,0,2,0,6
401262806,Wyoming Cowgirls,M. Savic,4704660,,False,13.0,3,3,3,3,0,0,0,0,2,3,5,0,0,0,0,1,6
401262806,Wyoming Cowgirls,P. Salazar,4704659,,False,5.0,1,3,1,2,0,1,0,0,0,1,1,0,0,0,1,1,2
401262806,Wyoming Cowgirls,G. Ellis,4704657,,False,6.0,0,1,0,0,0,1,0,0,0,1,1,1,0,0,0,0,0
401262806,Wyoming Cowgirls,L. Bull,4704655,,False,2.0,0,0,0,0,0,0,0,0,0,1,1,0,0,0,1,0,0
401262806,Wyoming Cowgirls,O. Ustowska,4704662,,False,17.0,2,4,1,2,1,2,0,0,0,4,4,0,0,0,1,0,5
401262806,Wyoming Cowgirls,L. Hudson,4704658,,False,3.0,1,1,0,0,1,1,0,0,0,0,0,0,0,0,0,0,3
401262806,Wyoming Cowgirls,M. Bradshaw,4595681,,False,17.0,4,9,1,4,3,5,0,0,1,4,5,0,1,0,0,0,11
401262806,Wyoming Cowgirls,TEAM,TOTAL,TOTAL,False,,26,54,16,31,10,23,0,0,6,31,37,13,5,2,10,7,62
401262806,Wyoming Cowgirls,D. Davidsdottir,4068870,,True,25.0,1,6,1,5,0,1,0,0,3,4,7,1,0,1,0,2,2
401262806,Wyoming Cowgirls,J. Johnson,4595683,,True,23.0,4,7,2,3,2,4,0,0,0,1,1,2,0,1,4,1,10
401262806,Wyoming Cowgirls,Q. Weidemann,4400207,,True,30.0,4,8,3,5,1,3,0,0,0,0,0,3,0,0,0,0,9
401262806,Wyoming Cowgirls,A. Sanchez Ramos,4400204,,True,30.0,3,6,1,3,2,3,0,0,0,5,5,2,0,0,1,2,8
401262806,Wyoming Cowgirls,T. Olson,4400203,,True,29.0,3,6,3,4,0,2,0,0,0,6,6,4,4,0,2,0,6
401262806,Wyoming Cowgirls,M. Savic,4704660,,False,13.0,3,3,3,3,0,0,0,0,2,3,5,0,0,0,0,1,6
401262806,Wyoming Cowgirls,P. Salazar,4704659,,False,5.0,1,3,1,2,0,1,0,0,0,1,1,0,0,0,1,1,2
401262806,Wyoming Cowgirls,G. Ellis,4704657,,False,6.0,0,1,0,0,0,1,0,0,0,1,1,1,0,0,0,0,0
401262806,Wyoming Cowgirls,L. Bull,4704655,,False,2.0,0,0,0,0,0,0,0,0,0,1,1,0,0,0,1,0,0
401262806,Wyoming Cowgirls,O. Ustowska,4704662,,False,17.0,2,4,1,2,1,2,0,0,0,4,4,0,0,0,1,0,5
401262806,Wyoming Cowgirls,L. Hudson,4704658,,False,3.0,1,1,0,0,1,1,0,0,0,0,0,0,0,0,0,0,3
401262806,Wyoming Cowgirls,M. Bradshaw,4595681,,False,17.0,4,9,1,4,3,5,0,0,1,4,5,0,1,0,0,0,11
401262806,Wyoming Cowgirls,TEAM,TOTAL,TOTAL,False,,26,54,16,31,10,23,0,0,6,31,37,13,5,2,10,7,62
401262806,San Diego State Aztecs,K. Gipson,4704563,,True,24.0,1,2,1,2,0,0,0,0,0,3,3,0,0,0,2,2,2
401262806,San Diego State Aztecs,K. Villalobos,4704565,,True,23.0,1,4,1,4,0,0,2,2,1,1,2,1,2,3,2,1,4
401262806,San Diego State Aztecs,I. Hernandez,4595647,,True,28.0,2,5,0,0,2,5,0,0,0,4,4,1,1,0,0,0,6
401262806,San Diego State Aztecs,M. Staples,4398925,,True,26.0,5,11,5,10,0,1,1,2,0,2,2,2,1,0,1,0,11
401262806,San Diego State Aztecs,T. Adams,4281876,,True,26.0,0,8,0,7,0,1,2,2,0,3,3,1,0,0,0,0,2
401262806,San Diego State Aztecs,F. Vinerte,4704564,,False,5.0,0,1,0,1,0,0,0,0,1,0,1,0,0,0,1,3,0
401262806,San Diego State Aztecs,K. Edwards,4281879,,False,11.0,2,3,2,3,0,0,0,0,1,2,3,0,0,0,0,1,4
401262806,San Diego State Aztecs,M. Adams,4400169,,False,18.0,2,5,0,1,2,4,2,2,0,1,1,0,0,0,1,0,8
401262806,San Diego State Aztecs,B. Chynoweth,4704562,,False,10.0,0,2,0,0,0,2,0,0,0,0,0,0,1,0,1,0,0
401262806,San Diego State Aztecs,T. Sireni,4595648,,False,2.0,0,1,0,1,0,0,0,0,0,0,0,0,0,0,0,0,0
401262806,San Diego State Aztecs,A. Crain,4399223,,False,27.0,2,6,2,5,0,1,0,0,0,5,5,2,0,0,2,0,4
401262806,San Diego State Aztecs,TEAM,TOTAL,TOTAL,False,,15,48,11,34,4,14,7,8,3,22,25,7,5,3,10,7,41
401262806,San Diego State Aztecs,K. Gipson,4704563,,True,24.0,1,2,1,2,0,0,0,0,0,3,3,0,0,0,2,2,2
401262806,San Diego State Aztecs,K. Villalobos,4704565,,True,23.0,1,4,1,4,0,0,2,2,1,1,2,1,2,3,2,1,4
401262806,San Diego State Aztecs,I. Hernandez,4595647,,True,28.0,2,5,0,0,2,5,0,0,0,4,4,1,1,0,0,0,6
401262806,San Diego State Aztecs,M. Staples,4398925,,True,26.0,5,11,5,10,0,1,1,2,0,2,2,2,1,0,1,0,11
401262806,San Diego State Aztecs,T. Adams,4281876,,True,26.0,0,8,0,7,0,1,2,2,0,3,3,1,0,0,0,0,2
401262806,San Diego State Aztecs,F. Vinerte,4704564,,False,5.0,0,1,0,1,0,0,0,0,1,0,1,0,0,0,1,3,0
401262806,San Diego State Aztecs,K. Edwards,4281879,,False,11.0,2,3,2,3,0,0,0,0,1,2,3,0,0,0,0,1,4
401262806,San Diego State Aztecs,M. Adams,4400169,,False,18.0,2,5,0,1,2,4,2,2,0,1,1,0,0,0,1,0,8
401262806,San Diego State Aztecs,B. Chynoweth,4704562,,False,10.0,0,2,0,0,0,2,0,0,0,0,0,0,1,0,1,0,0
401262806,San Diego State Aztecs,T. Sireni,4595648,,False,2.0,0,1,0,1,0,0,0,0,0,0,0,0,0,0,0,0,0
401262806,San Diego State Aztecs,A. Crain,4399223,,False,27.0,2,6,2,5,0,1,0,0,0,5,5,2,0,0,2,0,4
401262806,San Diego State Aztecs,TEAM,TOTAL,TOTAL,False,,15,48,11,34,4,14,7,8,3,22,25,7,5,3,10,7,41
401262805,Wyoming Cowgirls,D. Davidsdottir,4068870,,True,24.0,8,15,8,15,0,0,3,6,5,3,8,0,2,0,1,1,19
401262805,Wyoming Cowgirls,J. Johnson,4595683,,True,16.0,0,5,0,1,0,4,0,0,0,5,5,0,0,0,0,2,0
401262805,Wyoming Cowgirls,Q. Weidemann,4400207,,True,28.0,2,10,2,5,0,5,0,0,0,4,4,2,3,0,1,0,4
401262805,Wyoming Cowgirls,A. Sanchez Ramos,4400204,,True,24.0,2,7,2,4,0,3,1,1,2,5,7,1,1,1,1,1,5
401262805,Wyoming Cowgirls,T. Olson,4400203,,True,34.0,2,6,1,5,1,1,0,0,4,4,8,6,1,0,3,1,5
401262805,Wyoming Cowgirls,M. Savic,4704660,,False,9.0,6,6,6,6,0,0,0,0,1,1,2,0,0,0,0,0,12
401262805,Wyoming Cowgirls,P. Salazar,4704659,,False,8.0,0,2,0,2,0,0,0,0,0,2,2,0,0,0,0,0,0
401262805,Wyoming Cowgirls,G. Ellis,4704657,,False,14.0,0,2,0,0,0,2,0,0,0,1,1,2,0,0,0,0,0
401262805,Wyoming Cowgirls,L. Bull,4704655,,False,2.0,0,0,0,0,0,0,0,0,0,0,0,0,0,0,0,0,0
401262805,Wyoming Cowgirls,O. Ustowska,4704662,,False,16.0,3,5,3,3,0,2,0,1,0,0,0,2,0,0,1,2,6
401262805,Wyoming Cowgirls,L. Hudson,4704658,,False,5.0,0,0,0,0,0,0,0,0,0,0,0,0,0,0,0,0,0
401262805,Wyoming Cowgirls,M. Bradshaw,4595681,,False,20.0,1,7,1,3,0,4,1,1,1,3,4,1,0,0,0,2,3
401262805,Wyoming Cowgirls,TEAM,TOTAL,TOTAL,False,,24,65,23,44,1,21,5,9,15,29,44,14,7,1,8,9,54
401262805,Wyoming Cowgirls,D. Davidsdottir,4068870,,True,24.0,8,15,8,15,0,0,3,6,5,3,8,0,2,0,1,1,19
401262805,Wyoming Cowgirls,J. Johnson,4595683,,True,16.0,0,5,0,1,0,4,0,0,0,5,5,0,0,0,0,2,0
401262805,Wyoming Cowgirls,Q. Weidemann,4400207,,True,28.0,2,10,2,5,0,5,0,0,0,4,4,2,3,0,1,0,4
401262805,Wyoming Cowgirls,A. Sanchez Ramos,4400204,,True,24.0,2,7,2,4,0,3,1,1,2,5,7,1,1,1,1,1,5
401262805,Wyoming Cowgirls,T. Olson,4400203,,True,34.0,2,6,1,5,1,1,0,0,4,4,8,6,1,0,3,1,5
401262805,Wyoming Cowgirls,M. Savic,4704660,,False,9.0,6,6,6,6,0,0,0,0,1,1,2,0,0,0,0,0,12
401262805,Wyoming Cowgirls,P. Salazar,4704659,,False,8.0,0,2,0,2,0,0,0,0,0,2,2,0,0,0,0,0,0
401262805,Wyoming Cowgirls,G. Ellis,4704657,,False,14.0,0,2,0,0,0,2,0,0,0,1,1,2,0,0,0,0,0
401262805,Wyoming Cowgirls,L. Bull,4704655,,False,2.0,0,0,0,0,0,0,0,0,0,0,0,0,0,0,0,0,0
401262805,Wyoming Cowgirls,O. Ustowska,4704662,,False,16.0,3,5,3,3,0,2,0,1,0,0,0,2,0,0,1,2,6
401262805,Wyoming Cowgirls,L. Hudson,4704658,,False,5.0,0,0,0,0,0,0,0,0,0,0,0,0,0,0,0,0,0
401262805,Wyoming Cowgirls,M. Bradshaw,4595681,,False,20.0,1,7,1,3,0,4,1,1,1,3,4,1,0,0,0,2,3
401262805,Wyoming Cowgirls,TEAM,TOTAL,TOTAL,False,,24,65,23,44,1,21,5,9,15,29,44,14,7,1,8,9,54
401262805,San Diego State Aztecs,K. Villalobos,4704565,,True,17.0,3,6,3,6,0,0,1,3,0,3,3,0,0,0,3,1,7
401262805,San Diego State Aztecs,F. Vinerte,4704564,,True,13.0,1,3,1,3,0,0,0,1,2,1,3,1,0,1,3,2,2
401262805,San Diego State Aztecs,I. Hernandez,4595647,,True,27.0,0,1,0,0,0,1,0,0,0,3,3,2,0,0,2,0,0
401262805,San Diego State Aztecs,M. Staples,4398925,,True,34.0,2,11,0,8,2,3,1,2,0,7,7,1,1,0,2,0,7
401262805,San Diego State Aztecs,T. Adams,4281876,,True,27.0,1,5,1,4,0,1,0,0,0,3,3,2,0,1,7,2,2
401262805,San Diego State Aztecs,K. Gipson,4704563,,False,17.0,1,2,1,2,0,0,0,0,0,5,5,0,0,3,0,3,2
401262805,San Diego State Aztecs,K. Edwards,4281879,,False,14.0,1,5,1,4,0,1,0,0,1,1,2,0,0,0,0,0,2
401262805,San Diego State Aztecs,M. Adams,4400169,,False,25.0,4,7,1,2,3,5,1,2,1,3,4,1,1,0,1,0,12
401262805,San Diego State Aztecs,B. Chynoweth,4704562,,False,2.0,0,0,0,0,0,0,0,0,0,0,0,0,0,0,0,0,0
401262805,San Diego State Aztecs,T. Sireni,4595648,,False,6.0,0,1,0,0,0,1,2,2,0,0,0,0,0,0,0,1,2
401262805,San Diego State Aztecs,A. Crain,4399223,,False,18.0,0,2,0,1,0,1,0,2,1,3,4,1,0,0,0,1,0
401262805,San Diego State Aztecs,TEAM,TOTAL,TOTAL,False,,13,43,8,30,5,13,5,12,5,29,34,8,2,5,19,10,36
401262805,San Diego State Aztecs,K. Villalobos,4704565,,True,17.0,3,6,3,6,0,0,1,3,0,3,3,0,0,0,3,1,7
401262805,San Diego State Aztecs,F. Vinerte,4704564,,True,13.0,1,3,1,3,0,0,0,1,2,1,3,1,0,1,3,2,2
401262805,San Diego State Aztecs,I. Hernandez,4595647,,True,27.0,0,1,0,0,0,1,0,0,0,3,3,2,0,0,2,0,0
401262805,San Diego State Aztecs,M. Staples,4398925,,True,34.0,2,11,0,8,2,3,1,2,0,7,7,1,1,0,2,0,7
401262805,San Diego State Aztecs,T. Adams,4281876,,True,27.0,1,5,1,4,0,1,0,0,0,3,3,2,0,1,7,2,2
401262805,San Diego State Aztecs,K. Gipson,4704563,,False,17.0,1,2,1,2,0,0,0,0,0,5,5,0,0,3,0,3,2
401262805,San Diego State Aztecs,K. Edwards,4281879,,False,14.0,1,5,1,4,0,1,0,0,1,1,2,0,0,0,0,0,2
401262805,San Diego State Aztecs,M. Adams,4400169,,False,25.0,4,7,1,2,3,5,1,2,1,3,4,1,1,0,1,0,12
401262805,San Diego State Aztecs,B. Chynoweth,4704562,,False,2.0,0,0,0,0,0,0,0,0,0,0,0,0,0,0,0,0,0
401262805,San Diego State Aztecs,T. Sireni,4595648,,False,6.0,0,1,0,0,0,1,2,2,0,0,0,0,0,0,0,1,2
401262805,San Diego State Aztecs,A. Crain,4399223,,False,18.0,0,2,0,1,0,1,0,2,1,3,4,1,0,0,0,1,0
401262805,San Diego State Aztecs,TEAM,TOTAL,TOTAL,False,,13,43,8,30,5,13,5,12,5,29,34,8,2,5,19,10,36
401262803,Utah State Aggies,J. Chatman,4068281,,True,32.0,2,6,2,5,0,1,1,4,2,8,10,2,1,3,1,1,5
401262803,Utah State Aggies,M. Pruitt,4704651,,True,25.0,1,5,1,5,0,0,1,2,3,9,12,3,2,1,3,0,3
401262803,Utah State Aggies,M. Mendazona,4704647,,True,34.0,3,9,3,7,0,2,0,0,1,1,2,1,1,1,0,5,6
401262803,Utah State Aggies,F. Brantley,4595669,,True,34.0,1,7,1,6,0,1,2,2,0,3,3,2,0,0,5,2,4
401262803,Utah State Aggies,S. Latone,4399209,,True,32.0,11,22,5,9,6,13,2,2,2,3,5,3,1,0,1,4,30
401262803,Utah State Aggies,B. Mathews,4400146,,False,18.0,4,12,4,10,0,2,2,2,1,1,2,0,0,0,0,2,10
401262803,Utah State Aggies,H. Nelson,4704652,,False,5.0,0,2,0,0,0,2,0,0,0,1,1,0,0,1,2,1,0
401262803,Utah State Aggies,P. Williams,4704650,,False,6.0,1,2,1,2,0,0,0,0,0,2,2,0,0,0,0,1,2
401262803,Utah State Aggies,K. Falslev,4704648,,False,0.0,0,0,0,0,0,0,0,0,0,0,0,0,0,0,0,0,0
401262803,Utah State Aggies,E. Emrich,4595671,,False,3.0,0,0,0,0,0,0,0,0,0,0,0,0,1,0,1,0,0
401262803,Utah State Aggies,K. Kamakawiwo'ole,4595670,,False,3.0,0,0,0,0,0,0,0,0,0,0,0,0,0,0,0,0,0
401262803,Utah State Aggies,E. Harris,4281891,,False,8.0,0,0,0,0,0,0,0,0,0,0,0,1,0,0,0,0,0
401262803,Utah State Aggies,TEAM,TOTAL,TOTAL,False,,23,65,17,44,6,21,8,12,12,31,43,12,6,6,13,16,60
401262803,Utah State Aggies,J. Chatman,4068281,,True,32.0,2,6,2,5,0,1,1,4,2,8,10,2,1,3,1,1,5
401262803,Utah State Aggies,M. Pruitt,4704651,,True,25.0,1,5,1,5,0,0,1,2,3,9,12,3,2,1,3,0,3
401262803,Utah State Aggies,M. Mendazona,4704647,,True,34.0,3,9,3,7,0,2,0,0,1,1,2,1,1,1,0,5,6
401262803,Utah State Aggies,F. Brantley,4595669,,True,34.0,1,7,1,6,0,1,2,2,0,3,3,2,0,0,5,2,4
401262803,Utah State Aggies,S. Latone,4399209,,True,32.0,11,22,5,9,6,13,2,2,2,3,5,3,1,0,1,4,30
401262803,Utah State Aggies,B. Mathews,4400146,,False,18.0,4,12,4,10,0,2,2,2,1,1,2,0,0,0,0,2,10
401262803,Utah State Aggies,H. Nelson,4704652,,False,5.0,0,2,0,0,0,2,0,0,0,1,1,0,0,1,2,1,0
401262803,Utah State Aggies,P. Williams,4704650,,False,6.0,1,2,1,2,0,0,0,0,0,2,2,0,0,0,0,1,2
401262803,Utah State Aggies,K. Falslev,4704648,,False,0.0,0,0,0,0,0,0,0,0,0,0,0,0,0,0,0,0,0
401262803,Utah State Aggies,E. Emrich,4595671,,False,3.0,0,0,0,0,0,0,0,0,0,0,0,0,1,0,1,0,0
401262803,Utah State Aggies,K. Kamakawiwo'ole,4595670,,False,3.0,0,0,0,0,0,0,0,0,0,0,0,0,0,0,0,0,0
401262803,Utah State Aggies,E. Harris,4281891,,False,8.0,0,0,0,0,0,0,0,0,0,0,0,1,0,0,0,0,0
401262803,Utah State Aggies,TEAM,TOTAL,TOTAL,False,,23,65,17,44,6,21,8,12,12,31,43,12,6,6,13,16,60
401262803,San Diego State Aztecs,K. Gipson,4704563,,True,22.0,3,8,3,8,0,0,0,0,3,5,8,0,0,0,1,1,6
401262803,San Diego State Aztecs,K. Villalobos,4704565,,True,27.0,3,12,3,12,0,0,4,6,4,4,8,3,1,1,4,0,10
401262803,San Diego State Aztecs,I. Hernandez,4595647,,True,28.0,1,1,1,1,0,0,0,0,0,3,3,3,3,0,1,1,2
401262803,San Diego State Aztecs,M. Staples,4398925,,True,35.0,9,17,7,12,2,5,4,6,1,9,10,2,0,1,1,3,24
401262803,San Diego State Aztecs,T. Adams,4281876,,True,26.0,2,8,1,5,1,3,2,2,0,2,2,6,1,0,0,1,7
401262803,San Diego State Aztecs,F. Vinerte,4704564,,False,12.0,4,5,4,5,0,0,2,2,2,1,3,0,0,2,0,1,10
401262803,San Diego State Aztecs,K. Edwards,4281879,,False,6.0,1,3,1,3,0,0,1,2,0,0,0,0,0,0,1,0,3
401262803,San Diego State Aztecs,M. Adams,4400169,,False,19.0,0,6,0,4,0,2,2,2,1,4,5,0,1,0,1,0,2
401262803,San Diego State Aztecs,A. Crain,4399223,,False,25.0,1,5,1,5,0,0,2,2,0,3,3,2,1,0,1,2,4
401262803,San Diego State Aztecs,TEAM,TOTAL,TOTAL,False,,24,65,21,55,3,10,17,22,13,33,46,16,7,4,10,9,68
401262803,San Diego State Aztecs,K. Gipson,4704563,,True,22.0,3,8,3,8,0,0,0,0,3,5,8,0,0,0,1,1,6
401262803,San Diego State Aztecs,K. Villalobos,4704565,,True,27.0,3,12,3,12,0,0,4,6,4,4,8,3,1,1,4,0,10
401262803,San Diego State Aztecs,I. Hernandez,4595647,,True,28.0,1,1,1,1,0,0,0,0,0,3,3,3,3,0,1,1,2
401262803,San Diego State Aztecs,M. Staples,4398925,,True,35.0,9,17,7,12,2,5,4,6,1,9,10,2,0,1,1,3,24
401262803,San Diego State Aztecs,T. Adams,4281876,,True,26.0,2,8,1,5,1,3,2,2,0,2,2,6,1,0,0,1,7
401262803,San Diego State Aztecs,F. Vinerte,4704564,,False,12.0,4,5,4,5,0,0,2,2,2,1,3,0,0,2,0,1,10
401262803,San Diego State Aztecs,K. Edwards,4281879,,False,6.0,1,3,1,3,0,0,1,2,0,0,0,0,0,0,1,0,3
401262803,San Diego State Aztecs,M. Adams,4400169,,False,19.0,0,6,0,4,0,2,2,2,1,4,5,0,1,0,1,0,2
401262803,San Diego State Aztecs,A. Crain,4399223,,False,25.0,1,5,1,5,0,0,2,2,0,3,3,2,1,0,1,2,4
401262803,San Diego State Aztecs,TEAM,TOTAL,TOTAL,False,,24,65,21,55,3,10,17,22,13,33,46,16,7,4,10,9,68
401262798,San Diego State Aztecs,K. Villalobos,4704565,,True,15.0,3,7,3,6,0,1,2,4,1,1,2,3,0,0,2,5,8
401262798,San Diego State Aztecs,K. Edwards,4281879,,True,15.0,2,4,2,4,0,0,1,1,1,1,2,0,0,0,2,2,5
401262798,San Diego State Aztecs,I. Hernandez,4595647,,True,36.0,2,5,0,0,2,5,0,0,0,9,9,1,3,0,1,1,6
401262798,San Diego State Aztecs,A. Crain,4399223,,True,31.0,0,3,0,2,0,1,0,0,0,0,0,2,3,0,2,4,0
401262798,San Diego State Aztecs,M. Staples,4398925,,True,38.0,3,12,2,9,1,3,2,2,1,4,5,1,1,0,7,2,9
401262798,San Diego State Aztecs,K. Gipson,4704563,,False,19.0,0,3,0,3,0,0,0,2,1,5,6,0,0,0,2,4,0
401262798,San Diego State Aztecs,I. Murillo,4704566,,False,4.0,2,3,2,3,0,0,0,0,0,0,0,0,0,0,0,0,4
401262798,San Diego State Aztecs,F. Vinerte,4704564,,False,7.0,0,0,0,0,0,0,0,0,1,0,1,2,0,0,0,2,0
401262798,San Diego State Aztecs,M. Adams,4400169,,False,27.0,4,9,3,6,1,3,7,8,0,2,2,2,2,0,2,1,16
401262798,San Diego State Aztecs,B. Chynoweth,4704562,,False,8.0,0,2,0,0,0,2,0,0,0,0,0,0,0,0,0,0,0
401262798,San Diego State Aztecs,TEAM,TOTAL,TOTAL,False,,16,48,12,33,4,15,12,17,7,24,31,11,9,0,21,21,48
401262798,San Diego State Aztecs,K. Villalobos,4704565,,True,15.0,3,7,3,6,0,1,2,4,1,1,2,3,0,0,2,5,8
401262798,San Diego State Aztecs,K. Edwards,4281879,,True,15.0,2,4,2,4,0,0,1,1,1,1,2,0,0,0,2,2,5
401262798,San Diego State Aztecs,I. Hernandez,4595647,,True,36.0,2,5,0,0,2,5,0,0,0,9,9,1,3,0,1,1,6
401262798,San Diego State Aztecs,A. Crain,4399223,,True,31.0,0,3,0,2,0,1,0,0,0,0,0,2,3,0,2,4,0
401262798,San Diego State Aztecs,M. Staples,4398925,,True,38.0,3,12,2,9,1,3,2,2,1,4,5,1,1,0,7,2,9
401262798,San Diego State Aztecs,K. Gipson,4704563,,False,19.0,0,3,0,3,0,0,0,2,1,5,6,0,0,0,2,4,0
401262798,San Diego State Aztecs,I. Murillo,4704566,,False,4.0,2,3,2,3,0,0,0,0,0,0,0,0,0,0,0,0,4
401262798,San Diego State Aztecs,F. Vinerte,4704564,,False,7.0,0,0,0,0,0,0,0,0,1,0,1,2,0,0,0,2,0
401262798,San Diego State Aztecs,M. Adams,4400169,,False,27.0,4,9,3,6,1,3,7,8,0,2,2,2,2,0,2,1,16
401262798,San Diego State Aztecs,B. Chynoweth,4704562,,False,8.0,0,2,0,0,0,2,0,0,0,0,0,0,0,0,0,0,0
401262798,San Diego State Aztecs,TEAM,TOTAL,TOTAL,False,,16,48,12,33,4,15,12,17,7,24,31,11,9,0,21,21,48
401262798,New Mexico Lobos,S. McGruder,4400149,,True,17.0,5,7,4,6,1,1,0,0,1,3,4,0,0,1,0,3,11
401262798,New Mexico Lobos,A. Anderson,4281834,,True,30.0,4,8,3,6,1,2,3,6,3,5,8,4,2,2,4,4,12
401262798,New Mexico Lobos,Lato. Duff,4704520,,True,26.0,1,5,0,1,1,4,0,0,0,1,1,2,3,0,2,1,3
401262798,New Mexico Lobos,A. Hurst,4400147,,True,34.0,4,14,2,6,2,8,3,6,0,2,2,6,0,1,3,1,13
401262798,New Mexico Lobos,J. De La Cerda,4281833,,True,23.0,3,4,1,1,2,3,2,2,0,0,0,0,1,0,4,1,10
401262798,New Mexico Lobos,A. Watts,4433688,,False,23.0,3,5,3,5,0,0,0,1,5,4,9,0,0,1,1,2,6
401262798,New Mexico Lobos,K. van Bennekom,4704522,,False,10.0,0,2,0,1,0,1,0,0,2,5,7,1,0,0,0,0,0
401262798,New Mexico Lobos,Lata. Duff,4704519,,False,22.0,1,9,0,1,1,8,2,2,0,3,3,0,0,0,2,2,5
401262798,New Mexico Lobos,C. Carter,4433646,,False,15.0,1,2,0,1,1,1,2,2,0,1,1,3,1,0,1,1,5
401262798,New Mexico Lobos,TEAM,TOTAL,TOTAL,False,,22,56,13,28,9,28,12,19,12,27,39,16,7,5,17,15,65
401262798,New Mexico Lobos,S. McGruder,4400149,,True,17.0,5,7,4,6,1,1,0,0,1,3,4,0,0,1,0,3,11
401262798,New Mexico Lobos,A. Anderson,4281834,,True,30.0,4,8,3,6,1,2,3,6,3,5,8,4,2,2,4,4,12
401262798,New Mexico Lobos,Lato. Duff,4704520,,True,26.0,1,5,0,1,1,4,0,0,0,1,1,2,3,0,2,1,3
401262798,New Mexico Lobos,A. Hurst,4400147,,True,34.0,4,14,2,6,2,8,3,6,0,2,2,6,0,1,3,1,13
401262798,New Mexico Lobos,J. De La Cerda,4281833,,True,23.0,3,4,1,1,2,3,2,2,0,0,0,0,1,0,4,1,10
401262798,New Mexico Lobos,A. Watts,4433688,,False,23.0,3,5,3,5,0,0,0,1,5,4,9,0,0,1,1,2,6
401262798,New Mexico Lobos,K. van Bennekom,4704522,,False,10.0,0,2,0,1,0,1,0,0,2,5,7,1,0,0,0,0,0
401262798,New Mexico Lobos,Lata. Duff,4704519,,False,22.0,1,9,0,1,1,8,2,2,0,3,3,0,0,0,2,2,5
401262798,New Mexico Lobos,C. Carter,4433646,,False,15.0,1,2,0,1,1,1,2,2,0,1,1,3,1,0,1,1,5
401262798,New Mexico Lobos,TEAM,TOTAL,TOTAL,False,,22,56,13,28,9,28,12,19,12,27,39,16,7,5,17,15,65
401262797,San Diego State Aztecs,K. Villalobos,4704565,,True,21.0,4,5,4,5,0,0,2,4,1,3,4,3,2,0,3,2,10
401262797,San Diego State Aztecs,K. Edwards,4281879,,True,17.0,4,5,4,5,0,0,1,2,1,2,3,0,0,0,1,2,9
401262797,San Diego State Aztecs,I. Hernandez,4595647,,True,30.0,1,4,0,2,1,2,0,0,0,2,2,2,0,1,1,2,3
401262797,San Diego State Aztecs,A. Crain,4399223,,True,28.0,2,6,1,4,1,2,0,0,0,2,2,1,0,0,1,2,5
401262797,San Diego State Aztecs,M. Staples,4398925,,True,32.0,4,11,3,7,1,4,2,2,1,4,5,5,0,0,2,2,11
401262797,San Diego State Aztecs,K. Gipson,4704563,,False,15.0,1,4,1,4,0,0,0,0,1,2,3,0,0,0,1,1,2
401262797,San Diego State Aztecs,I. Murillo,4704566,,False,13.0,1,2,1,2,0,0,3,4,2,0,2,1,0,0,1,1,5
401262797,San Diego State Aztecs,F. Vinerte,4704564,,False,8.0,0,5,0,5,0,0,0,0,0,3,3,0,1,0,1,1,0
401262797,San Diego State Aztecs,M. Adams,4400169,,False,19.0,1,4,0,1,1,3,0,0,2,3,5,0,0,0,2,1,3
401262797,San Diego State Aztecs,B. Chynoweth,4704562,,False,11.0,0,1,0,0,0,1,0,0,0,0,0,0,0,0,1,0,0
401262797,San Diego State Aztecs,T. Sireni,4595648,,False,6.0,0,0,0,0,0,0,0,0,0,0,0,0,0,0,1,1,0
401262797,San Diego State Aztecs,TEAM,TOTAL,TOTAL,False,,18,47,14,35,4,12,8,12,9,23,32,12,3,1,16,15,48
401262797,San Diego State Aztecs,K. Villalobos,4704565,,True,21.0,4,5,4,5,0,0,2,4,1,3,4,3,2,0,3,2,10
401262797,San Diego State Aztecs,K. Edwards,4281879,,True,17.0,4,5,4,5,0,0,1,2,1,2,3,0,0,0,1,2,9
401262797,San Diego State Aztecs,I. Hernandez,4595647,,True,30.0,1,4,0,2,1,2,0,0,0,2,2,2,0,1,1,2,3
401262797,San Diego State Aztecs,A. Crain,4399223,,True,28.0,2,6,1,4,1,2,0,0,0,2,2,1,0,0,1,2,5
401262797,San Diego State Aztecs,M. Staples,4398925,,True,32.0,4,11,3,7,1,4,2,2,1,4,5,5,0,0,2,2,11
401262797,San Diego State Aztecs,K. Gipson,4704563,,False,15.0,1,4,1,4,0,0,0,0,1,2,3,0,0,0,1,1,2
401262797,San Diego State Aztecs,I. Murillo,4704566,,False,13.0,1,2,1,2,0,0,3,4,2,0,2,1,0,0,1,1,5
401262797,San Diego State Aztecs,F. Vinerte,4704564,,False,8.0,0,5,0,5,0,0,0,0,0,3,3,0,1,0,1,1,0
401262797,San Diego State Aztecs,M. Adams,4400169,,False,19.0,1,4,0,1,1,3,0,0,2,3,5,0,0,0,2,1,3
401262797,San Diego State Aztecs,B. Chynoweth,4704562,,False,11.0,0,1,0,0,0,1,0,0,0,0,0,0,0,0,1,0,0
401262797,San Diego State Aztecs,T. Sireni,4595648,,False,6.0,0,0,0,0,0,0,0,0,0,0,0,0,0,0,1,1,0
401262797,San Diego State Aztecs,TEAM,TOTAL,TOTAL,False,,18,47,14,35,4,12,8,12,9,23,32,12,3,1,16,15,48
401262797,New Mexico Lobos,S. McGruder,4400149,,True,24.0,6,6,5,5,1,1,2,2,6,3,9,0,2,1,1,2,15
401262797,New Mexico Lobos,A. Anderson,4281834,,True,30.0,8,16,6,12,2,4,0,3,1,7,8,0,3,1,1,3,18
401262797,New Mexico Lobos,Lato. Duff,4704520,,True,23.0,1,4,0,2,1,2,0,0,0,0,0,4,1,0,0,1,3
401262797,New Mexico Lobos,A. Hurst,4400147,,True,28.0,6,12,5,6,1,6,6,8,0,1,1,1,1,0,1,1,19
401262797,New Mexico Lobos,J. De La Cerda,4281833,,True,23.0,0,4,0,1,0,3,0,0,1,1,2,2,0,0,1,1,0
401262797,New Mexico Lobos,C. Dupont,4595646,,False,2.0,0,1,0,1,0,0,0,0,0,0,0,0,0,0,0,1,0
401262797,New Mexico Lobos,A. Watts,4433688,,False,18.0,2,2,1,1,1,1,0,0,0,4,4,4,1,2,1,1,5
401262797,New Mexico Lobos,A. Robinson,4432993,,False,4.0,0,0,0,0,0,0,0,0,0,0,0,0,0,0,0,1,0
401262797,New Mexico Lobos,N. Parkinson,4704523,,False,2.0,0,1,0,0,0,1,0,0,0,1,1,0,0,0,0,0,0
401262797,New Mexico Lobos,K. van Bennekom,4704522,,False,4.0,1,1,0,0,1,1,0,0,0,0,0,0,0,0,0,0,3
401262797,New Mexico Lobos,Lata. Duff,4704519,,False,22.0,6,9,0,0,6,9,1,2,0,2,2,0,0,0,0,3,19
401262797,New Mexico Lobos,C. Carter,4433646,,False,20.0,1,4,1,2,0,2,0,0,0,2,2,6,1,0,1,1,2
401262797,New Mexico Lobos,TEAM,TOTAL,TOTAL,False,,31,60,18,30,13,30,9,15,10,22,32,17,9,4,6,15,84
401262797,New Mexico Lobos,S. McGruder,4400149,,True,24.0,6,6,5,5,1,1,2,2,6,3,9,0,2,1,1,2,15
401262797,New Mexico Lobos,A. Anderson,4281834,,True,30.0,8,16,6,12,2,4,0,3,1,7,8,0,3,1,1,3,18
401262797,New Mexico Lobos,Lato. Duff,4704520,,True,23.0,1,4,0,2,1,2,0,0,0,0,0,4,1,0,0,1,3
401262797,New Mexico Lobos,A. Hurst,4400147,,True,28.0,6,12,5,6,1,6,6,8,0,1,1,1,1,0,1,1,19
401262797,New Mexico Lobos,J. De La Cerda,4281833,,True,23.0,0,4,0,1,0,3,0,0,1,1,2,2,0,0,1,1,0
401262797,New Mexico Lobos,C. Dupont,4595646,,False,2.0,0,1,0,1,0,0,0,0,0,0,0,0,0,0,0,1,0
401262797,New Mexico Lobos,A. Watts,4433688,,False,18.0,2,2,1,1,1,1,0,0,0,4,4,4,1,2,1,1,5
401262797,New Mexico Lobos,A. Robinson,4432993,,False,4.0,0,0,0,0,0,0,0,0,0,0,0,0,0,0,0,1,0
401262797,New Mexico Lobos,N. Parkinson,4704523,,False,2.0,0,1,0,0,0,1,0,0,0,1,1,0,0,0,0,0,0
401262797,New Mexico Lobos,K. van Bennekom,4704522,,False,4.0,1,1,0,0,1,1,0,0,0,0,0,0,0,0,0,0,3
401262797,New Mexico Lobos,Lata. Duff,4704519,,False,22.0,6,9,0,0,6,9,1,2,0,2,2,0,0,0,0,3,19
401262797,New Mexico Lobos,C. Carter,4433646,,False,20.0,1,4,1,2,0,2,0,0,0,2,2,6,1,0,1,1,2
401262797,New Mexico Lobos,TEAM,TOTAL,TOTAL,False,,31,60,18,30,13,30,9,15,10,22,32,17,9,4,6,15,84
401262794,UNLV Lady Rebels,D. Byrne,4398924,,True,30.0,7,16,4,7,3,9,6,6,1,6,7,2,3,0,2,1,23
401262794,UNLV Lady Rebels,D. Young,4704625,,True,16.0,6,7,6,7,0,0,3,6,0,1,1,2,1,0,3,2,15
401262794,UNLV Lady Rebels,J. Thomas,4704624,,True,33.0,1,7,1,2,0,5,2,2,0,5,5,0,1,0,4,2,4
401262794,UNLV Lady Rebels,N. Johnson,4400108,,True,11.0,1,4,1,3,0,1,0,0,0,2,2,1,1,0,2,1,2
401262794,UNLV Lady Rebels,B. Thomas,4068210,,True,40.0,4,10,3,5,1,5,0,0,3,5,8,6,2,0,1,1,9
401262794,UNLV Lady Rebels,T. Carter,4595642,,False,2.0,0,0,0,0,0,0,0,0,0,0,0,0,0,0,1,1,0
401262794,UNLV Lady Rebels,A. Blount,4595640,,False,14.0,5,9,5,9,0,0,0,0,3,2,5,0,1,0,1,3,10
401262794,UNLV Lady Rebels,K. Wilfred,4595641,,False,13.0,1,4,1,4,0,0,0,0,3,2,5,1,1,0,2,0,2
401262794,UNLV Lady Rebels,J. Singleton,4704623,,False,20.0,2,5,1,2,1,3,1,1,0,2,2,2,1,0,2,1,6
401262794,UNLV Lady Rebels,J. Buckley,4595639,,False,21.0,1,5,1,4,0,1,0,0,1,1,2,1,0,0,0,2,2
401262794,UNLV Lady Rebels,TEAM,TOTAL,TOTAL,False,,28,67,23,43,5,24,12,15,15,26,41,15,11,0,20,14,73
401262794,UNLV Lady Rebels,D. Byrne,4398924,,True,30.0,7,16,4,7,3,9,6,6,1,6,7,2,3,0,2,1,23
401262794,UNLV Lady Rebels,D. Young,4704625,,True,16.0,6,7,6,7,0,0,3,6,0,1,1,2,1,0,3,2,15
401262794,UNLV Lady Rebels,J. Thomas,4704624,,True,33.0,1,7,1,2,0,5,2,2,0,5,5,0,1,0,4,2,4
401262794,UNLV Lady Rebels,N. Johnson,4400108,,True,11.0,1,4,1,3,0,1,0,0,0,2,2,1,1,0,2,1,2
401262794,UNLV Lady Rebels,B. Thomas,4068210,,True,40.0,4,10,3,5,1,5,0,0,3,5,8,6,2,0,1,1,9
401262794,UNLV Lady Rebels,T. Carter,4595642,,False,2.0,0,0,0,0,0,0,0,0,0,0,0,0,0,0,1,1,0
401262794,UNLV Lady Rebels,A. Blount,4595640,,False,14.0,5,9,5,9,0,0,0,0,3,2,5,0,1,0,1,3,10
401262794,UNLV Lady Rebels,K. Wilfred,4595641,,False,13.0,1,4,1,4,0,0,0,0,3,2,5,1,1,0,2,0,2
401262794,UNLV Lady Rebels,J. Singleton,4704623,,False,20.0,2,5,1,2,1,3,1,1,0,2,2,2,1,0,2,1,6
401262794,UNLV Lady Rebels,J. Buckley,4595639,,False,21.0,1,5,1,4,0,1,0,0,1,1,2,1,0,0,0,2,2
401262794,UNLV Lady Rebels,TEAM,TOTAL,TOTAL,False,,28,67,23,43,5,24,12,15,15,26,41,15,11,0,20,14,73
401262794,New Mexico Lobos,S. McGruder,4400149,,True,28.0,1,3,1,3,0,0,1,2,1,3,4,0,1,2,0,3,3
401262794,New Mexico Lobos,A. Anderson,4281834,,True,36.0,12,17,8,11,4,6,1,1,2,6,8,2,0,1,3,4,29
401262794,New Mexico Lobos,Lato. Duff,4704520,,True,33.0,6,11,3,4,3,7,0,0,0,3,3,3,3,0,8,0,15
401262794,New Mexico Lobos,A. Hurst,4400147,,True,36.0,0,9,0,2,0,7,2,2,0,4,4,5,4,1,1,2,2
401262794,New Mexico Lobos,J. De La Cerda,4281833,,True,30.0,9,13,4,4,5,9,5,5,1,4,5,0,2,1,3,0,28
401262794,New Mexico Lobos,A. Watts,4433688,,False,16.0,0,2,0,1,0,1,0,0,1,0,1,0,0,0,2,4,0
401262794,New Mexico Lobos,Lata. Duff,4704519,,False,16.0,2,7,2,3,0,4,0,2,3,3,6,4,1,0,1,0,4
401262794,New Mexico Lobos,C. Carter,4433646,,False,5.0,0,2,0,1,0,1,0,0,0,0,0,0,1,0,1,1,0
401262794,New Mexico Lobos,TEAM,TOTAL,TOTAL,False,,30,64,18,29,12,35,9,12,9,25,34,14,12,5,19,14,81
401262794,New Mexico Lobos,S. McGruder,4400149,,True,28.0,1,3,1,3,0,0,1,2,1,3,4,0,1,2,0,3,3
401262794,New Mexico Lobos,A. Anderson,4281834,,True,36.0,12,17,8,11,4,6,1,1,2,6,8,2,0,1,3,4,29
401262794,New Mexico Lobos,Lato. Duff,4704520,,True,33.0,6,11,3,4,3,7,0,0,0,3,3,3,3,0,8,0,15
401262794,New Mexico Lobos,A. Hurst,4400147,,True,36.0,0,9,0,2,0,7,2,2,0,4,4,5,4,1,1,2,2
401262794,New Mexico Lobos,J. De La Cerda,4281833,,True,30.0,9,13,4,4,5,9,5,5,1,4,5,0,2,1,3,0,28
401262794,New Mexico Lobos,A. Watts,4433688,,False,16.0,0,2,0,1,0,1,0,0,1,0,1,0,0,0,2,4,0
401262794,New Mexico Lobos,Lata. Duff,4704519,,False,16.0,2,7,2,3,0,4,0,2,3,3,6,4,1,0,1,0,4
401262794,New Mexico Lobos,C. Carter,4433646,,False,5.0,0,2,0,1,0,1,0,0,0,0,0,0,1,0,1,1,0
401262794,New Mexico Lobos,TEAM,TOTAL,TOTAL,False,,30,64,18,29,12,35,9,12,9,25,34,14,12,5,19,14,81
401262793,UNLV Lady Rebels,D. Byrne,4398924,,True,31.0,7,10,3,4,4,6,3,5,1,4,5,2,0,1,1,0,21
401262793,UNLV Lady Rebels,D. Young,4704625,,True,19.0,2,10,2,10,0,0,3,4,1,6,7,3,2,0,2,0,7
401262793,UNLV Lady Rebels,J. Thomas,4704624,,True,30.0,4,12,3,6,1,6,0,0,3,1,4,1,0,1,2,1,9
401262793,UNLV Lady Rebels,N. Johnson,4400108,,True,27.0,3,12,2,9,1,3,0,0,2,5,7,3,3,0,1,2,7
401262793,UNLV Lady Rebels,B. Thomas,4068210,,True,35.0,3,9,2,4,1,5,1,2,3,3,6,4,1,0,2,1,8
401262793,UNLV Lady Rebels,T. Carter,4595642,,False,4.0,2,2,2,2,0,0,2,3,0,1,1,0,0,0,0,0,6
401262793,UNLV Lady Rebels,A. Blount,4595640,,False,5.0,1,3,1,3,0,0,1,2,1,0,1,0,0,0,1,1,3
401262793,UNLV Lady Rebels,K. Wilfred,4595641,,False,21.0,4,7,4,7,0,0,4,4,3,4,7,3,1,0,2,1,12
401262793,UNLV Lady Rebels,J. Singleton,4704623,,False,17.0,1,3,1,3,0,0,1,2,0,3,3,1,3,0,1,0,3
401262793,UNLV Lady Rebels,J. Buckley,4595639,,False,11.0,1,4,1,3,0,1,0,0,2,6,8,1,0,0,1,1,2
401262793,UNLV Lady Rebels,TEAM,TOTAL,TOTAL,False,,28,72,21,51,7,21,15,22,16,33,49,18,10,2,13,7,78
401262793,UNLV Lady Rebels,D. Byrne,4398924,,True,31.0,7,10,3,4,4,6,3,5,1,4,5,2,0,1,1,0,21
401262793,UNLV Lady Rebels,D. Young,4704625,,True,19.0,2,10,2,10,0,0,3,4,1,6,7,3,2,0,2,0,7
401262793,UNLV Lady Rebels,J. Thomas,4704624,,True,30.0,4,12,3,6,1,6,0,0,3,1,4,1,0,1,2,1,9
401262793,UNLV Lady Rebels,N. Johnson,4400108,,True,27.0,3,12,2,9,1,3,0,0,2,5,7,3,3,0,1,2,7
401262793,UNLV Lady Rebels,B. Thomas,4068210,,True,35.0,3,9,2,4,1,5,1,2,3,3,6,4,1,0,2,1,8
401262793,UNLV Lady Rebels,T. Carter,4595642,,False,4.0,2,2,2,2,0,0,2,3,0,1,1,0,0,0,0,0,6
401262793,UNLV Lady Rebels,A. Blount,4595640,,False,5.0,1,3,1,3,0,0,1,2,1,0,1,0,0,0,1,1,3
401262793,UNLV Lady Rebels,K. Wilfred,4595641,,False,21.0,4,7,4,7,0,0,4,4,3,4,7,3,1,0,2,1,12
401262793,UNLV Lady Rebels,J. Singleton,4704623,,False,17.0,1,3,1,3,0,0,1,2,0,3,3,1,3,0,1,0,3
401262793,UNLV Lady Rebels,J. Buckley,4595639,,False,11.0,1,4,1,3,0,1,0,0,2,6,8,1,0,0,1,1,2
401262793,UNLV Lady Rebels,TEAM,TOTAL,TOTAL,False,,28,72,21,51,7,21,15,22,16,33,49,18,10,2,13,7,78
401262793,New Mexico Lobos,S. McGruder,4400149,,True,21.0,1,3,1,2,0,1,0,0,0,4,4,0,1,4,1,2,2
401262793,New Mexico Lobos,A. Anderson,4281834,,True,11.0,3,5,1,1,2,4,0,0,1,3,4,0,0,0,1,5,8
401262793,New Mexico Lobos,Lato. Duff,4704520,,True,26.0,4,7,3,4,1,3,0,0,1,2,3,2,1,0,2,1,9
401262793,New Mexico Lobos,A. Hurst,4400147,,True,28.0,6,18,2,5,4,13,0,0,0,2,2,1,1,0,3,3,16
401262793,New Mexico Lobos,J. De La Cerda,4281833,,True,30.0,2,11,2,7,0,4,0,2,2,6,8,4,1,0,5,2,4
401262793,New Mexico Lobos,C. Dupont,4595646,,False,2.0,0,1,0,1,0,0,0,0,0,0,0,0,0,0,0,0,0
401262793,New Mexico Lobos,A. Watts,4433688,,False,24.0,0,4,0,1,0,3,0,0,2,4,6,2,2,2,1,5,0
401262793,New Mexico Lobos,A. Robinson,4432993,,False,9.0,1,1,1,1,0,0,0,0,0,2,2,0,0,1,1,1,2
401262793,New Mexico Lobos,N. Parkinson,4704523,,False,1.0,0,0,0,0,0,0,0,0,0,0,0,0,0,0,0,0,0
401262793,New Mexico Lobos,K. van Bennekom,4704522,,False,6.0,0,0,0,0,0,0,0,0,0,1,1,1,0,0,1,1,0
401262793,New Mexico Lobos,Lata. Duff,4704519,,False,25.0,5,10,1,2,4,8,3,3,0,4,4,2,1,0,0,2,17
401262793,New Mexico Lobos,C. Carter,4433646,,False,17.0,1,6,1,2,0,4,0,0,0,0,0,3,1,0,3,1,2
401262793,New Mexico Lobos,TEAM,TOTAL,TOTAL,False,,23,66,12,26,11,40,3,5,6,28,34,15,8,7,18,23,60
401262793,New Mexico Lobos,S. McGruder,4400149,,True,21.0,1,3,1,2,0,1,0,0,0,4,4,0,1,4,1,2,2
401262793,New Mexico Lobos,A. Anderson,4281834,,True,11.0,3,5,1,1,2,4,0,0,1,3,4,0,0,0,1,5,8
401262793,New Mexico Lobos,Lato. Duff,4704520,,True,26.0,4,7,3,4,1,3,0,0,1,2,3,2,1,0,2,1,9
401262793,New Mexico Lobos,A. Hurst,4400147,,True,28.0,6,18,2,5,4,13,0,0,0,2,2,1,1,0,3,3,16
401262793,New Mexico Lobos,J. De La Cerda,4281833,,True,30.0,2,11,2,7,0,4,0,2,2,6,8,4,1,0,5,2,4
401262793,New Mexico Lobos,C. Dupont,4595646,,False,2.0,0,1,0,1,0,0,0,0,0,0,0,0,0,0,0,0,0
401262793,New Mexico Lobos,A. Watts,4433688,,False,24.0,0,4,0,1,0,3,0,0,2,4,6,2,2,2,1,5,0
401262793,New Mexico Lobos,A. Robinson,4432993,,False,9.0,1,1,1,1,0,0,0,0,0,2,2,0,0,1,1,1,2
401262793,New Mexico Lobos,N. Parkinson,4704523,,False,1.0,0,0,0,0,0,0,0,0,0,0,0,0,0,0,0,0,0
401262793,New Mexico Lobos,K. van Bennekom,4704522,,False,6.0,0,0,0,0,0,0,0,0,0,1,1,1,0,0,1,1,0
401262793,New Mexico Lobos,Lata. Duff,4704519,,False,25.0,5,10,1,2,4,8,3,3,0,4,4,2,1,0,0,2,17
401262793,New Mexico Lobos,C. Carter,4433646,,False,17.0,1,6,1,2,0,4,0,0,0,0,0,3,1,0,3,1,2
401262793,New Mexico Lobos,TEAM,TOTAL,TOTAL,False,,23,66,12,26,11,40,3,5,6,28,34,15,8,7,18,23,60
401262790,Utah State Aggies,J. Chatman,4068281,,True,29.0,1,4,1,3,0,1,2,2,1,4,5,0,0,2,1,1,4
401262790,Utah State Aggies,K. Kamakawiwo'ole,4595670,,True,17.0,0,3,0,3,0,0,0,0,1,1,2,0,0,0,0,0,0
401262790,Utah State Aggies,F. Brantley,4595669,,True,27.0,1,7,1,3,0,4,1,2,0,2,2,1,2,0,1,3,3
401262790,Utah State Aggies,S. Latone,4399209,,True,30.0,3,13,2,6,1,7,2,2,1,3,4,1,0,1,2,2,9
401262790,Utah State Aggies,E. Harris,4281891,,True,39.0,8,16,5,9,3,7,0,0,0,3,3,2,1,0,3,0,19
401262790,Utah State Aggies,E. Jarrell,4704653,,False,4.0,1,3,1,3,0,0,0,0,1,1,2,0,0,0,0,0,2
401262790,Utah State Aggies,T. Franson,4281892,,False,22.0,0,1,0,1,0,0,0,0,0,3,3,0,0,0,1,1,0
401262790,Utah State Aggies,M. Pruitt,4704651,,False,13.0,0,7,0,5,0,2,3,4,1,4,5,0,0,0,1,0,3
401262790,Utah State Aggies,K. Falslev,4704648,,False,19.0,0,4,0,0,0,4,0,0,1,0,1,1,0,0,0,1,0
401262790,Utah State Aggies,TEAM,TOTAL,TOTAL,False,,14,58,10,33,4,25,8,10,7,24,31,5,3,3,9,8,40
401262790,Utah State Aggies,J. Chatman,4068281,,True,29.0,1,4,1,3,0,1,2,2,1,4,5,0,0,2,1,1,4
401262790,Utah State Aggies,K. Kamakawiwo'ole,4595670,,True,17.0,0,3,0,3,0,0,0,0,1,1,2,0,0,0,0,0,0
401262790,Utah State Aggies,F. Brantley,4595669,,True,27.0,1,7,1,3,0,4,1,2,0,2,2,1,2,0,1,3,3
401262790,Utah State Aggies,S. Latone,4399209,,True,30.0,3,13,2,6,1,7,2,2,1,3,4,1,0,1,2,2,9
401262790,Utah State Aggies,E. Harris,4281891,,True,39.0,8,16,5,9,3,7,0,0,0,3,3,2,1,0,3,0,19
401262790,Utah State Aggies,E. Jarrell,4704653,,False,4.0,1,3,1,3,0,0,0,0,1,1,2,0,0,0,0,0,2
401262790,Utah State Aggies,T. Franson,4281892,,False,22.0,0,1,0,1,0,0,0,0,0,3,3,0,0,0,1,1,0
401262790,Utah State Aggies,M. Pruitt,4704651,,False,13.0,0,7,0,5,0,2,3,4,1,4,5,0,0,0,1,0,3
401262790,Utah State Aggies,K. Falslev,4704648,,False,19.0,0,4,0,0,0,4,0,0,1,0,1,1,0,0,0,1,0
401262790,Utah State Aggies,TEAM,TOTAL,TOTAL,False,,14,58,10,33,4,25,8,10,7,24,31,5,3,3,9,8,40
401262790,Nevada Wolf Pack,M. Ormiston,4400072,,True,17.0,1,8,1,8,0,0,1,2,2,4,6,1,0,1,2,1,3
401262790,Nevada Wolf Pack,L. Johnson,4595634,,True,18.0,1,5,0,3,1,2,1,2,2,2,4,1,1,0,2,3,4
401262790,Nevada Wolf Pack,A. West,4400134,,True,26.0,4,10,3,5,1,5,0,0,1,5,6,3,0,0,0,0,9
401262790,Nevada Wolf Pack,D. Hamilton,4400132,,True,26.0,4,10,3,6,1,4,0,0,1,3,4,6,0,0,1,1,9
401262790,Nevada Wolf Pack,N. Alexander,4068433,,True,12.0,0,2,0,1,0,1,0,0,0,1,1,0,0,0,2,1,0
401262790,Nevada Wolf Pack,L. Otuafi,4704508,,False,15.0,7,8,7,8,0,0,2,2,2,6,8,2,0,1,1,1,16
401262790,Nevada Wolf Pack,L. Givens,4704506,,False,20.0,1,5,1,3,0,2,0,0,2,5,7,2,0,0,1,2,2
401262790,Nevada Wolf Pack,A. Elquist,4704504,,False,4.0,0,1,0,0,0,1,0,0,0,1,1,0,0,1,0,0,0
401262790,Nevada Wolf Pack,D. Phillips,4595638,,False,17.0,4,6,4,5,0,1,0,0,0,4,4,0,0,0,1,2,8
401262790,Nevada Wolf Pack,T. Siu,4704507,,False,1.0,0,0,0,0,0,0,0,0,0,0,0,1,0,0,0,0,0
401262790,Nevada Wolf Pack,G. Rones,4704505,,False,15.0,2,3,1,1,1,2,0,0,0,0,0,0,1,0,0,0,5
401262790,Nevada Wolf Pack,K. Holt,4704503,,False,23.0,1,5,1,1,0,4,0,0,1,3,4,2,2,0,0,1,2
401262790,Nevada Wolf Pack,A. Jovicevic,4704502,,False,5.0,1,4,0,1,1,3,2,2,4,0,4,0,0,0,0,0,5
401262790,Nevada Wolf Pack,B. Carstens,4597039,,False,1.0,0,0,0,0,0,0,0,0,0,0,0,0,0,0,0,0,0
401262790,Nevada Wolf Pack,TEAM,TOTAL,TOTAL,False,,26,67,21,42,5,25,6,8,18,38,56,18,4,3,11,12,63
401262790,Nevada Wolf Pack,M. Ormiston,4400072,,True,17.0,1,8,1,8,0,0,1,2,2,4,6,1,0,1,2,1,3
401262790,Nevada Wolf Pack,L. Johnson,4595634,,True,18.0,1,5,0,3,1,2,1,2,2,2,4,1,1,0,2,3,4
401262790,Nevada Wolf Pack,A. West,4400134,,True,26.0,4,10,3,5,1,5,0,0,1,5,6,3,0,0,0,0,9
401262790,Nevada Wolf Pack,D. Hamilton,4400132,,True,26.0,4,10,3,6,1,4,0,0,1,3,4,6,0,0,1,1,9
401262790,Nevada Wolf Pack,N. Alexander,4068433,,True,12.0,0,2,0,1,0,1,0,0,0,1,1,0,0,0,2,1,0
401262790,Nevada Wolf Pack,L. Otuafi,4704508,,False,15.0,7,8,7,8,0,0,2,2,2,6,8,2,0,1,1,1,16
401262790,Nevada Wolf Pack,L. Givens,4704506,,False,20.0,1,5,1,3,0,2,0,0,2,5,7,2,0,0,1,2,2
401262790,Nevada Wolf Pack,A. Elquist,4704504,,False,4.0,0,1,0,0,0,1,0,0,0,1,1,0,0,1,0,0,0
401262790,Nevada Wolf Pack,D. Phillips,4595638,,False,17.0,4,6,4,5,0,1,0,0,0,4,4,0,0,0,1,2,8
401262790,Nevada Wolf Pack,T. Siu,4704507,,False,1.0,0,0,0,0,0,0,0,0,0,0,0,1,0,0,0,0,0
401262790,Nevada Wolf Pack,G. Rones,4704505,,False,15.0,2,3,1,1,1,2,0,0,0,0,0,0,1,0,0,0,5
401262790,Nevada Wolf Pack,K. Holt,4704503,,False,23.0,1,5,1,1,0,4,0,0,1,3,4,2,2,0,0,1,2
401262790,Nevada Wolf Pack,A. Jovicevic,4704502,,False,5.0,1,4,0,1,1,3,2,2,4,0,4,0,0,0,0,0,5
401262790,Nevada Wolf Pack,B. Carstens,4597039,,False,1.0,0,0,0,0,0,0,0,0,0,0,0,0,0,0,0,0,0
401262790,Nevada Wolf Pack,TEAM,TOTAL,TOTAL,False,,26,67,21,42,5,25,6,8,18,38,56,18,4,3,11,12,63
401262789,Utah State Aggies,T. Franson,4281892,,True,11.0,1,2,1,2,0,0,0,0,0,2,2,1,0,0,1,1,2
401262789,Utah State Aggies,J. Chatman,4068281,,True,38.0,4,14,4,11,0,3,3,3,1,8,9,2,0,0,2,3,11
401262789,Utah State Aggies,F. Brantley,4595669,,True,33.0,6,11,4,7,2,4,1,1,2,4,6,0,2,0,2,4,15
401262789,Utah State Aggies,S. Latone,4399209,,True,32.0,4,14,2,7,2,7,0,0,3,1,4,3,1,0,3,1,10
401262789,Utah State Aggies,E. Harris,4281891,,True,38.0,2,6,1,2,1,4,5,6,0,5,5,4,0,0,2,2,10
401262789,Utah State Aggies,M. Pruitt,4704651,,False,17.0,2,7,2,6,0,1,0,0,2,3,5,0,4,0,3,3,4
401262789,Utah State Aggies,K. Falslev,4704648,,False,12.0,2,6,0,0,2,6,0,0,0,0,0,0,0,0,0,2,6
401262789,Utah State Aggies,K. Kamakawiwo'ole,4595670,,False,19.0,1,5,1,5,0,0,0,0,3,1,4,2,0,1,1,1,2
401262789,Utah State Aggies,TEAM,TOTAL,TOTAL,False,,22,65,15,40,7,25,9,10,14,28,42,12,7,1,14,17,60
401262789,Utah State Aggies,T. Franson,4281892,,True,11.0,1,2,1,2,0,0,0,0,0,2,2,1,0,0,1,1,2
401262789,Utah State Aggies,J. Chatman,4068281,,True,38.0,4,14,4,11,0,3,3,3,1,8,9,2,0,0,2,3,11
401262789,Utah State Aggies,F. Brantley,4595669,,True,33.0,6,11,4,7,2,4,1,1,2,4,6,0,2,0,2,4,15
401262789,Utah State Aggies,S. Latone,4399209,,True,32.0,4,14,2,7,2,7,0,0,3,1,4,3,1,0,3,1,10
401262789,Utah State Aggies,E. Harris,4281891,,True,38.0,2,6,1,2,1,4,5,6,0,5,5,4,0,0,2,2,10
401262789,Utah State Aggies,M. Pruitt,4704651,,False,17.0,2,7,2,6,0,1,0,0,2,3,5,0,4,0,3,3,4
401262789,Utah State Aggies,K. Falslev,4704648,,False,12.0,2,6,0,0,2,6,0,0,0,0,0,0,0,0,0,2,6
401262789,Utah State Aggies,K. Kamakawiwo'ole,4595670,,False,19.0,1,5,1,5,0,0,0,0,3,1,4,2,0,1,1,1,2
401262789,Utah State Aggies,TEAM,TOTAL,TOTAL,False,,22,65,15,40,7,25,9,10,14,28,42,12,7,1,14,17,60
401262789,Nevada Wolf Pack,M. Ormiston,4400072,,True,7.0,1,2,1,2,0,0,0,0,0,1,1,0,1,0,0,0,2
401262789,Nevada Wolf Pack,L. Johnson,4595634,,True,25.0,6,13,3,10,3,3,3,4,1,1,2,0,0,0,2,2,18
401262789,Nevada Wolf Pack,A. West,4400134,,True,29.0,3,6,2,3,1,3,0,0,2,4,6,2,0,2,2,3,7
401262789,Nevada Wolf Pack,D. Hamilton,4400132,,True,25.0,1,9,0,5,1,4,6,6,2,1,3,2,2,0,2,3,9
401262789,Nevada Wolf Pack,N. Alexander,4068433,,True,29.0,3,8,2,6,1,2,1,1,2,6,8,5,0,0,1,0,8
401262789,Nevada Wolf Pack,L. Otuafi,4704508,,False,27.0,4,9,4,9,0,0,5,5,1,3,4,1,3,0,1,0,13
401262789,Nevada Wolf Pack,L. Givens,4704506,,False,9.0,2,4,2,4,0,0,1,1,1,2,3,0,0,0,0,0,5
401262789,Nevada Wolf Pack,A. Elquist,4704504,,False,0.0,0,0,0,0,0,0,0,0,0,0,0,0,0,0,0,0,0
401262789,Nevada Wolf Pack,D. Phillips,4595638,,False,18.0,4,11,4,8,0,3,0,0,3,7,10,2,0,0,2,0,8
401262789,Nevada Wolf Pack,T. Siu,4704507,,False,0.0,0,0,0,0,0,0,0,0,0,0,0,0,0,0,0,0,0
401262789,Nevada Wolf Pack,G. Rones,4704505,,False,5.0,0,2,0,1,0,1,0,0,0,0,0,0,0,0,0,0,0
401262789,Nevada Wolf Pack,K. Holt,4704503,,False,23.0,1,4,1,2,0,2,1,2,3,0,3,5,1,0,0,3,3
401262789,Nevada Wolf Pack,A. Jovicevic,4704502,,False,0.0,0,0,0,0,0,0,0,0,0,0,0,0,0,0,0,0,0
401262789,Nevada Wolf Pack,B. Carstens,4597039,,False,3.0,0,1,0,0,0,1,0,0,1,0,1,0,0,0,0,0,0
401262789,Nevada Wolf Pack,TEAM,TOTAL,TOTAL,False,,25,69,19,50,6,19,17,19,17,29,46,17,7,2,10,11,73
401262789,Nevada Wolf Pack,M. Ormiston,4400072,,True,7.0,1,2,1,2,0,0,0,0,0,1,1,0,1,0,0,0,2
401262789,Nevada Wolf Pack,L. Johnson,4595634,,True,25.0,6,13,3,10,3,3,3,4,1,1,2,0,0,0,2,2,18
401262789,Nevada Wolf Pack,A. West,4400134,,True,29.0,3,6,2,3,1,3,0,0,2,4,6,2,0,2,2,3,7
401262789,Nevada Wolf Pack,D. Hamilton,4400132,,True,25.0,1,9,0,5,1,4,6,6,2,1,3,2,2,0,2,3,9
401262789,Nevada Wolf Pack,N. Alexander,4068433,,True,29.0,3,8,2,6,1,2,1,1,2,6,8,5,0,0,1,0,8
401262789,Nevada Wolf Pack,L. Otuafi,4704508,,False,27.0,4,9,4,9,0,0,5,5,1,3,4,1,3,0,1,0,13
401262789,Nevada Wolf Pack,L. Givens,4704506,,False,9.0,2,4,2,4,0,0,1,1,1,2,3,0,0,0,0,0,5
401262789,Nevada Wolf Pack,A. Elquist,4704504,,False,0.0,0,0,0,0,0,0,0,0,0,0,0,0,0,0,0,0,0
401262789,Nevada Wolf Pack,D. Phillips,4595638,,False,18.0,4,11,4,8,0,3,0,0,3,7,10,2,0,0,2,0,8
401262789,Nevada Wolf Pack,T. Siu,4704507,,False,0.0,0,0,0,0,0,0,0,0,0,0,0,0,0,0,0,0,0
401262789,Nevada Wolf Pack,G. Rones,4704505,,False,5.0,0,2,0,1,0,1,0,0,0,0,0,0,0,0,0,0,0
401262789,Nevada Wolf Pack,K. Holt,4704503,,False,23.0,1,4,1,2,0,2,1,2,3,0,3,5,1,0,0,3,3
401262789,Nevada Wolf Pack,A. Jovicevic,4704502,,False,0.0,0,0,0,0,0,0,0,0,0,0,0,0,0,0,0,0,0
401262789,Nevada Wolf Pack,B. Carstens,4597039,,False,3.0,0,1,0,0,0,1,0,0,1,0,1,0,0,0,0,0,0
401262789,Nevada Wolf Pack,TEAM,TOTAL,TOTAL,False,,25,69,19,50,6,19,17,19,17,29,46,17,7,2,10,11,73
401262786,UNLV Lady Rebels,D. Byrne,4398924,,True,26.0,1,6,1,4,0,2,0,0,0,4,4,1,0,0,1,2,2
401262786,UNLV Lady Rebels,D. Young,4704625,,True,23.0,5,9,5,9,0,0,4,6,1,3,4,2,1,0,3,2,14
401262786,UNLV Lady Rebels,J. Thomas,4704624,,True,34.0,3,8,0,1,3,7,2,2,0,4,4,3,1,0,1,3,11
401262786,UNLV Lady Rebels,N. Johnson,4400108,,True,35.0,8,14,2,4,6,10,6,6,1,3,4,2,1,0,7,2,28
401262786,UNLV Lady Rebels,B. Thomas,4068210,,True,31.0,1,5,0,0,1,5,2,4,0,3,3,4,0,0,2,1,5
401262786,UNLV Lady Rebels,A. Blount,4595640,,False,16.0,1,4,1,4,0,0,2,4,0,4,4,0,0,1,1,0,4
401262786,UNLV Lady Rebels,K. Wilfred,4595641,,False,15.0,1,1,1,1,0,0,4,6,3,3,6,2,0,0,0,3,6
401262786,UNLV Lady Rebels,J. Singleton,4704623,,False,13.0,0,1,0,0,0,1,0,2,0,0,0,3,1,0,0,2,0
401262786,UNLV Lady Rebels,J. Buckley,4595639,,False,7.0,0,1,0,0,0,1,0,0,0,2,2,0,0,0,0,0,0
401262786,UNLV Lady Rebels,TEAM,TOTAL,TOTAL,False,,20,49,10,23,10,26,20,30,6,27,33,17,4,1,16,15,70
401262786,UNLV Lady Rebels,D. Byrne,4398924,,True,26.0,1,6,1,4,0,2,0,0,0,4,4,1,0,0,1,2,2
401262786,UNLV Lady Rebels,D. Young,4704625,,True,23.0,5,9,5,9,0,0,4,6,1,3,4,2,1,0,3,2,14
401262786,UNLV Lady Rebels,J. Thomas,4704624,,True,34.0,3,8,0,1,3,7,2,2,0,4,4,3,1,0,1,3,11
401262786,UNLV Lady Rebels,N. Johnson,4400108,,True,35.0,8,14,2,4,6,10,6,6,1,3,4,2,1,0,7,2,28
401262786,UNLV Lady Rebels,B. Thomas,4068210,,True,31.0,1,5,0,0,1,5,2,4,0,3,3,4,0,0,2,1,5
401262786,UNLV Lady Rebels,A. Blount,4595640,,False,16.0,1,4,1,4,0,0,2,4,0,4,4,0,0,1,1,0,4
401262786,UNLV Lady Rebels,K. Wilfred,4595641,,False,15.0,1,1,1,1,0,0,4,6,3,3,6,2,0,0,0,3,6
401262786,UNLV Lady Rebels,J. Singleton,4704623,,False,13.0,0,1,0,0,0,1,0,2,0,0,0,3,1,0,0,2,0
401262786,UNLV Lady Rebels,J. Buckley,4595639,,False,7.0,0,1,0,0,0,1,0,0,0,2,2,0,0,0,0,0,0
401262786,UNLV Lady Rebels,TEAM,TOTAL,TOTAL,False,,20,49,10,23,10,26,20,30,6,27,33,17,4,1,16,15,70
401262786,Nevada Wolf Pack,M. Ormiston,4400072,,True,24.0,2,5,2,5,0,0,0,0,0,4,4,1,0,0,0,3,4
401262786,Nevada Wolf Pack,L. Johnson,4595634,,True,30.0,2,5,2,5,0,0,2,2,0,2,2,4,3,0,1,4,6
401262786,Nevada Wolf Pack,A. West,4400134,,True,31.0,3,10,2,5,1,5,2,2,0,3,3,5,2,0,0,4,9
401262786,Nevada Wolf Pack,D. Hamilton,4400132,,True,30.0,12,23,8,16,4,7,4,5,1,3,4,0,2,0,2,2,32
401262786,Nevada Wolf Pack,N. Alexander,4068433,,True,32.0,4,8,2,6,2,2,3,4,0,3,3,0,0,0,1,1,13
401262786,Nevada Wolf Pack,E. Stebetakova,4704509,,False,1.0,0,1,0,1,0,0,0,0,0,0,0,0,0,0,0,2,0
401262786,Nevada Wolf Pack,L. Givens,4704506,,False,13.0,0,1,0,0,0,1,2,4,0,2,2,0,0,0,2,4,2
401262786,Nevada Wolf Pack,G. Rones,4704505,,False,8.0,1,1,0,0,1,1,0,0,0,0,0,0,0,0,0,0,3
401262786,Nevada Wolf Pack,K. Holt,4704503,,False,18.0,0,1,0,0,0,1,0,0,3,4,7,0,0,1,3,3,0
401262786,Nevada Wolf Pack,B. Carstens,4597039,,False,13.0,1,4,1,3,0,1,2,2,1,2,3,0,0,0,3,0,4
401262786,Nevada Wolf Pack,TEAM,TOTAL,TOTAL,False,,25,59,17,41,8,18,15,19,7,28,35,10,7,1,13,23,73
401262786,Nevada Wolf Pack,M. Ormiston,4400072,,True,24.0,2,5,2,5,0,0,0,0,0,4,4,1,0,0,0,3,4
401262786,Nevada Wolf Pack,L. Johnson,4595634,,True,30.0,2,5,2,5,0,0,2,2,0,2,2,4,3,0,1,4,6
401262786,Nevada Wolf Pack,A. West,4400134,,True,31.0,3,10,2,5,1,5,2,2,0,3,3,5,2,0,0,4,9
401262786,Nevada Wolf Pack,D. Hamilton,4400132,,True,30.0,12,23,8,16,4,7,4,5,1,3,4,0,2,0,2,2,32
401262786,Nevada Wolf Pack,N. Alexander,4068433,,True,32.0,4,8,2,6,2,2,3,4,0,3,3,0,0,0,1,1,13
401262786,Nevada Wolf Pack,E. Stebetakova,4704509,,False,1.0,0,1,0,1,0,0,0,0,0,0,0,0,0,0,0,2,0
401262786,Nevada Wolf Pack,L. Givens,4704506,,False,13.0,0,1,0,0,0,1,2,4,0,2,2,0,0,0,2,4,2
401262786,Nevada Wolf Pack,G. Rones,4704505,,False,8.0,1,1,0,0,1,1,0,0,0,0,0,0,0,0,0,0,3
401262786,Nevada Wolf Pack,K. Holt,4704503,,False,18.0,0,1,0,0,0,1,0,0,3,4,7,0,0,1,3,3,0
401262786,Nevada Wolf Pack,B. Carstens,4597039,,False,13.0,1,4,1,3,0,1,2,2,1,2,3,0,0,0,3,0,4
401262786,Nevada Wolf Pack,TEAM,TOTAL,TOTAL,False,,25,59,17,41,8,18,15,19,7,28,35,10,7,1,13,23,73
401262785,UNLV Lady Rebels,D. Byrne,4398924,,True,36.0,4,12,2,6,2,6,0,0,1,8,9,1,2,6,1,1,10
401262785,UNLV Lady Rebels,D. Young,4704625,,True,28.0,3,7,3,7,0,0,1,4,2,3,5,2,0,0,1,3,7
401262785,UNLV Lady Rebels,J. Thomas,4704624,,True,35.0,1,7,0,1,1,6,1,2,1,6,7,1,1,0,2,2,4
401262785,UNLV Lady Rebels,N. Johnson,4400108,,True,33.0,10,19,4,8,6,11,2,2,2,4,6,3,1,1,0,1,28
401262785,UNLV Lady Rebels,B. Thomas,4068210,,True,40.0,2,7,1,3,1,4,8,8,1,4,5,5,0,0,1,1,13
401262785,UNLV Lady Rebels,A. Blount,4595640,,False,8.0,0,1,0,1,0,0,0,0,1,2,3,0,0,0,1,1,0
401262785,UNLV Lady Rebels,K. Wilfred,4595641,,False,8.0,0,1,0,0,0,1,0,0,0,2,2,0,0,0,1,0,0
401262785,UNLV Lady Rebels,J. Buckley,4595639,,False,12.0,0,3,0,0,0,3,0,0,0,1,1,0,1,0,1,2,0
401262785,UNLV Lady Rebels,TEAM,TOTAL,TOTAL,False,,20,57,10,26,10,31,12,16,9,31,40,12,5,7,9,11,62
401262785,UNLV Lady Rebels,D. Byrne,4398924,,True,36.0,4,12,2,6,2,6,0,0,1,8,9,1,2,6,1,1,10
401262785,UNLV Lady Rebels,D. Young,4704625,,True,28.0,3,7,3,7,0,0,1,4,2,3,5,2,0,0,1,3,7
401262785,UNLV Lady Rebels,J. Thomas,4704624,,True,35.0,1,7,0,1,1,6,1,2,1,6,7,1,1,0,2,2,4
401262785,UNLV Lady Rebels,N. Johnson,4400108,,True,33.0,10,19,4,8,6,11,2,2,2,4,6,3,1,1,0,1,28
401262785,UNLV Lady Rebels,B. Thomas,4068210,,True,40.0,2,7,1,3,1,4,8,8,1,4,5,5,0,0,1,1,13
401262785,UNLV Lady Rebels,A. Blount,4595640,,False,8.0,0,1,0,1,0,0,0,0,1,2,3,0,0,0,1,1,0
401262785,UNLV Lady Rebels,K. Wilfred,4595641,,False,8.0,0,1,0,0,0,1,0,0,0,2,2,0,0,0,1,0,0
401262785,UNLV Lady Rebels,J. Buckley,4595639,,False,12.0,0,3,0,0,0,3,0,0,0,1,1,0,1,0,1,2,0
401262785,UNLV Lady Rebels,TEAM,TOTAL,TOTAL,False,,20,57,10,26,10,31,12,16,9,31,40,12,5,7,9,11,62
401262785,Nevada Wolf Pack,M. Ormiston,4400072,,True,20.0,3,8,3,7,0,1,0,0,1,5,6,0,0,1,1,4,6
401262785,Nevada Wolf Pack,L. Johnson,4595634,,True,23.0,3,6,3,6,0,0,2,5,3,2,5,1,0,1,2,3,8
401262785,Nevada Wolf Pack,A. West,4400134,,True,32.0,2,11,1,5,1,6,2,2,3,6,9,2,0,1,2,4,7
401262785,Nevada Wolf Pack,D. Hamilton,4400132,,True,30.0,6,16,3,10,3,6,4,4,0,3,3,1,0,0,1,0,19
401262785,Nevada Wolf Pack,N. Alexander,4068433,,True,31.0,0,6,0,3,0,3,0,0,2,4,6,3,0,0,2,2,0
401262785,Nevada Wolf Pack,E. Stebetakova,4704509,,False,5.0,0,3,0,3,0,0,0,0,1,0,1,0,0,0,0,1,0
401262785,Nevada Wolf Pack,L. Givens,4704506,,False,21.0,3,7,0,2,3,5,0,0,1,4,5,2,0,0,2,4,9
401262785,Nevada Wolf Pack,K. Holt,4704503,,False,30.0,2,4,1,3,1,1,0,0,2,2,4,1,2,0,1,3,5
401262785,Nevada Wolf Pack,B. Carstens,4597039,,False,8.0,1,4,0,2,1,2,0,0,1,1,2,1,0,0,0,0,3
401262785,Nevada Wolf Pack,TEAM,TOTAL,TOTAL,False,,20,65,11,41,9,24,8,11,16,29,45,11,2,3,11,21,57
401262785,Nevada Wolf Pack,M. Ormiston,4400072,,True,20.0,3,8,3,7,0,1,0,0,1,5,6,0,0,1,1,4,6
401262785,Nevada Wolf Pack,L. Johnson,4595634,,True,23.0,3,6,3,6,0,0,2,5,3,2,5,1,0,1,2,3,8
401262785,Nevada Wolf Pack,A. West,4400134,,True,32.0,2,11,1,5,1,6,2,2,3,6,9,2,0,1,2,4,7
401262785,Nevada Wolf Pack,D. Hamilton,4400132,,True,30.0,6,16,3,10,3,6,4,4,0,3,3,1,0,0,1,0,19
401262785,Nevada Wolf Pack,N. Alexander,4068433,,True,31.0,0,6,0,3,0,3,0,0,2,4,6,3,0,0,2,2,0
401262785,Nevada Wolf Pack,E. Stebetakova,4704509,,False,5.0,0,3,0,3,0,0,0,0,1,0,1,0,0,0,0,1,0
401262785,Nevada Wolf Pack,L. Givens,4704506,,False,21.0,3,7,0,2,3,5,0,0,1,4,5,2,0,0,2,4,9
401262785,Nevada Wolf Pack,K. Holt,4704503,,False,30.0,2,4,1,3,1,1,0,0,2,2,4,1,2,0,1,3,5
401262785,Nevada Wolf Pack,B. Carstens,4597039,,False,8.0,1,4,0,2,1,2,0,0,1,1,2,1,0,0,0,0,3
401262785,Nevada Wolf Pack,TEAM,TOTAL,TOTAL,False,,20,65,11,41,9,24,8,11,16,29,45,11,2,3,11,21,57
401262784,Wyoming Cowgirls,D. Davidsdottir,4068870,,True,25.0,2,6,2,6,0,0,0,0,0,1,1,0,0,0,1,1,4
401262784,Wyoming Cowgirls,J. Johnson,4595683,,True,14.0,1,4,1,2,0,2,0,0,0,0,0,1,1,0,1,2,2
401262784,Wyoming Cowgirls,Q. Weidemann,4400207,,True,31.0,5,13,2,7,3,6,5,5,0,2,2,2,3,0,1,4,18
401262784,Wyoming Cowgirls,A. Sanchez Ramos,4400204,,True,39.0,3,13,3,7,0,6,1,2,4,8,12,0,1,1,0,2,7
401262784,Wyoming Cowgirls,T. Olson,4400203,,True,37.0,4,10,4,9,0,1,0,2,3,3,6,3,2,0,2,5,8
401262784,Wyoming Cowgirls,M. Savic,4704660,,False,3.0,0,0,0,0,0,0,0,0,0,0,0,0,0,0,0,0,0
401262784,Wyoming Cowgirls,G. Ellis,4704657,,False,11.0,1,2,1,2,0,0,0,0,0,1,1,1,0,0,0,0,2
401262784,Wyoming Cowgirls,O. Ustowska,4704662,,False,12.0,1,2,1,2,0,0,0,0,0,1,1,0,0,0,1,0,2
401262784,Wyoming Cowgirls,L. Hudson,4704658,,False,0.0,0,0,0,0,0,0,0,0,0,0,0,0,0,0,0,0,0
401262784,Wyoming Cowgirls,M. Bradshaw,4595681,,False,28.0,2,9,1,3,1,6,2,2,1,1,2,0,0,0,1,1,7
401262784,Wyoming Cowgirls,TEAM,TOTAL,TOTAL,False,,19,59,15,38,4,21,8,11,11,21,32,7,7,1,8,15,50
401262784,Wyoming Cowgirls,D. Davidsdottir,4068870,,True,25.0,2,6,2,6,0,0,0,0,0,1,1,0,0,0,1,1,4
401262784,Wyoming Cowgirls,J. Johnson,4595683,,True,14.0,1,4,1,2,0,2,0,0,0,0,0,1,1,0,1,2,2
401262784,Wyoming Cowgirls,Q. Weidemann,4400207,,True,31.0,5,13,2,7,3,6,5,5,0,2,2,2,3,0,1,4,18
401262784,Wyoming Cowgirls,A. Sanchez Ramos,4400204,,True,39.0,3,13,3,7,0,6,1,2,4,8,12,0,1,1,0,2,7
401262784,Wyoming Cowgirls,T. Olson,4400203,,True,37.0,4,10,4,9,0,1,0,2,3,3,6,3,2,0,2,5,8
401262784,Wyoming Cowgirls,M. Savic,4704660,,False,3.0,0,0,0,0,0,0,0,0,0,0,0,0,0,0,0,0,0
401262784,Wyoming Cowgirls,G. Ellis,4704657,,False,11.0,1,2,1,2,0,0,0,0,0,1,1,1,0,0,0,0,2
401262784,Wyoming Cowgirls,O. Ustowska,4704662,,False,12.0,1,2,1,2,0,0,0,0,0,1,1,0,0,0,1,0,2
401262784,Wyoming Cowgirls,L. Hudson,4704658,,False,0.0,0,0,0,0,0,0,0,0,0,0,0,0,0,0,0,0,0
401262784,Wyoming Cowgirls,M. Bradshaw,4595681,,False,28.0,2,9,1,3,1,6,2,2,1,1,2,0,0,0,1,1,7
401262784,Wyoming Cowgirls,TEAM,TOTAL,TOTAL,False,,19,59,15,38,4,21,8,11,11,21,32,7,7,1,8,15,50
401262784,Nevada Wolf Pack,M. Ormiston,4400072,,True,27.0,2,10,2,9,0,1,0,2,0,6,6,0,0,3,1,2,4
401262784,Nevada Wolf Pack,L. Johnson,4595634,,True,29.0,0,4,0,3,0,1,4,4,1,6,7,1,0,0,3,1,4
401262784,Nevada Wolf Pack,A. West,4400134,,True,25.0,7,10,5,5,2,5,2,2,0,2,2,2,0,0,0,2,18
401262784,Nevada Wolf Pack,D. Hamilton,4400132,,True,28.0,1,5,1,2,0,3,0,0,0,4,4,3,0,0,1,1,2
401262784,Nevada Wolf Pack,N. Alexander,4068433,,True,30.0,2,5,1,4,1,1,4,4,1,3,4,1,1,0,1,1,9
401262784,Nevada Wolf Pack,E. Stebetakova,4704509,,False,1.0,1,1,1,1,0,0,0,0,0,0,0,0,0,0,0,0,2
401262784,Nevada Wolf Pack,L. Otuafi,4704508,,False,14.0,3,4,3,3,0,1,2,2,1,1,2,1,0,0,1,2,8
401262784,Nevada Wolf Pack,L. Givens,4704506,,False,11.0,2,5,1,4,1,1,1,2,1,1,2,0,0,0,0,0,6
401262784,Nevada Wolf Pack,K. Holt,4704503,,False,28.0,2,3,2,2,0,1,0,0,2,1,3,2,3,0,4,2,4
401262784,Nevada Wolf Pack,B. Carstens,4597039,,False,7.0,0,0,0,0,0,0,0,0,0,0,0,0,0,0,0,0,0
401262784,Nevada Wolf Pack,TEAM,TOTAL,TOTAL,False,,20,47,16,33,4,14,13,16,7,29,36,10,4,3,11,11,57
401262784,Nevada Wolf Pack,M. Ormiston,4400072,,True,27.0,2,10,2,9,0,1,0,2,0,6,6,0,0,3,1,2,4
401262784,Nevada Wolf Pack,L. Johnson,4595634,,True,29.0,0,4,0,3,0,1,4,4,1,6,7,1,0,0,3,1,4
401262784,Nevada Wolf Pack,A. West,4400134,,True,25.0,7,10,5,5,2,5,2,2,0,2,2,2,0,0,0,2,18
401262784,Nevada Wolf Pack,D. Hamilton,4400132,,True,28.0,1,5,1,2,0,3,0,0,0,4,4,3,0,0,1,1,2
401262784,Nevada Wolf Pack,N. Alexander,4068433,,True,30.0,2,5,1,4,1,1,4,4,1,3,4,1,1,0,1,1,9
401262784,Nevada Wolf Pack,E. Stebetakova,4704509,,False,1.0,1,1,1,1,0,0,0,0,0,0,0,0,0,0,0,0,2
401262784,Nevada Wolf Pack,L. Otuafi,4704508,,False,14.0,3,4,3,3,0,1,2,2,1,1,2,1,0,0,1,2,8
401262784,Nevada Wolf Pack,L. Givens,4704506,,False,11.0,2,5,1,4,1,1,1,2,1,1,2,0,0,0,0,0,6
401262784,Nevada Wolf Pack,K. Holt,4704503,,False,28.0,2,3,2,2,0,1,0,0,2,1,3,2,3,0,4,2,4
401262784,Nevada Wolf Pack,B. Carstens,4597039,,False,7.0,0,0,0,0,0,0,0,0,0,0,0,0,0,0,0,0,0
401262784,Nevada Wolf Pack,TEAM,TOTAL,TOTAL,False,,20,47,16,33,4,14,13,16,7,29,36,10,4,3,11,11,57
401262783,Wyoming Cowgirls,D. Davidsdottir,4068870,,True,27.0,4,9,4,9,0,0,1,1,0,2,2,0,0,0,4,3,9
401262783,Wyoming Cowgirls,J. Johnson,4595683,,True,27.0,0,6,0,1,0,5,0,0,1,2,3,3,1,1,0,1,0
401262783,Wyoming Cowgirls,Q. Weidemann,4400207,,True,34.0,4,11,2,4,2,7,0,0,0,3,3,2,0,0,1,3,10
401262783,Wyoming Cowgirls,A. Sanchez Ramos,4400204,,True,32.0,4,8,3,6,1,2,6,6,0,2,2,1,1,1,2,1,15
401262783,Wyoming Cowgirls,T. Olson,4400203,,True,39.0,0,4,0,1,0,3,1,2,2,1,3,3,3,0,3,2,1
401262783,Wyoming Cowgirls,M. Savic,4704660,,False,8.0,3,3,3,3,0,0,0,0,0,1,1,0,1,0,2,0,6
401262783,Wyoming Cowgirls,G. Ellis,4704657,,False,4.0,0,0,0,0,0,0,1,2,0,0,0,0,0,0,1,0,1
401262783,Wyoming Cowgirls,O. Ustowska,4704662,,False,7.0,0,1,0,0,0,1,0,0,0,0,0,0,0,0,1,1,0
401262783,Wyoming Cowgirls,M. Bradshaw,4595681,,False,22.0,5,10,5,7,0,3,0,0,2,3,5,1,1,0,0,2,10
401262783,Wyoming Cowgirls,TEAM,TOTAL,TOTAL,False,,20,52,17,31,3,21,9,11,6,18,24,10,7,2,15,13,52
401262783,Wyoming Cowgirls,D. Davidsdottir,4068870,,True,27.0,4,9,4,9,0,0,1,1,0,2,2,0,0,0,4,3,9
401262783,Wyoming Cowgirls,J. Johnson,4595683,,True,27.0,0,6,0,1,0,5,0,0,1,2,3,3,1,1,0,1,0
401262783,Wyoming Cowgirls,Q. Weidemann,4400207,,True,34.0,4,11,2,4,2,7,0,0,0,3,3,2,0,0,1,3,10
401262783,Wyoming Cowgirls,A. Sanchez Ramos,4400204,,True,32.0,4,8,3,6,1,2,6,6,0,2,2,1,1,1,2,1,15
401262783,Wyoming Cowgirls,T. Olson,4400203,,True,39.0,0,4,0,1,0,3,1,2,2,1,3,3,3,0,3,2,1
401262783,Wyoming Cowgirls,M. Savic,4704660,,False,8.0,3,3,3,3,0,0,0,0,0,1,1,0,1,0,2,0,6
401262783,Wyoming Cowgirls,G. Ellis,4704657,,False,4.0,0,0,0,0,0,0,1,2,0,0,0,0,0,0,1,0,1
401262783,Wyoming Cowgirls,O. Ustowska,4704662,,False,7.0,0,1,0,0,0,1,0,0,0,0,0,0,0,0,1,1,0
401262783,Wyoming Cowgirls,M. Bradshaw,4595681,,False,22.0,5,10,5,7,0,3,0,0,2,3,5,1,1,0,0,2,10
401262783,Wyoming Cowgirls,TEAM,TOTAL,TOTAL,False,,20,52,17,31,3,21,9,11,6,18,24,10,7,2,15,13,52
401262783,Nevada Wolf Pack,M. Ormiston,4400072,,True,24.0,6,12,6,12,0,0,2,2,1,4,5,1,1,1,2,1,14
401262783,Nevada Wolf Pack,L. Johnson,4595634,,True,24.0,2,4,2,4,0,0,0,0,0,0,0,2,1,0,0,2,4
401262783,Nevada Wolf Pack,A. West,4400134,,True,34.0,2,7,1,3,1,4,0,0,2,3,5,0,1,0,4,3,5
401262783,Nevada Wolf Pack,D. Hamilton,4400132,,True,30.0,2,3,2,3,0,0,4,4,1,3,4,2,0,1,0,0,8
401262783,Nevada Wolf Pack,N. Alexander,4068433,,True,28.0,5,9,4,6,1,3,0,0,0,3,3,2,1,0,4,2,11
401262783,Nevada Wolf Pack,E. Stebetakova,4704509,,False,3.0,1,2,1,2,0,0,0,0,0,0,0,0,0,0,0,0,2
401262783,Nevada Wolf Pack,L. Otuafi,4704508,,False,13.0,3,7,2,5,1,2,2,2,0,2,2,0,0,0,3,1,9
401262783,Nevada Wolf Pack,L. Givens,4704506,,False,3.0,0,1,0,0,0,1,0,0,0,0,0,1,0,0,1,1,0
401262783,Nevada Wolf Pack,K. Holt,4704503,,False,22.0,2,3,2,3,0,0,1,2,2,5,7,1,2,0,1,2,5
401262783,Nevada Wolf Pack,A. Jovicevic,4704502,,False,5.0,0,1,0,0,0,1,0,0,0,0,0,0,0,0,2,0,0
401262783,Nevada Wolf Pack,B. Carstens,4597039,,False,14.0,1,2,1,2,0,0,0,0,1,1,2,1,0,0,1,1,2
401262783,Nevada Wolf Pack,TEAM,TOTAL,TOTAL,False,,24,51,21,40,3,11,9,10,10,26,36,10,6,2,19,13,60
401262783,Nevada Wolf Pack,M. Ormiston,4400072,,True,24.0,6,12,6,12,0,0,2,2,1,4,5,1,1,1,2,1,14
401262783,Nevada Wolf Pack,L. Johnson,4595634,,True,24.0,2,4,2,4,0,0,0,0,0,0,0,2,1,0,0,2,4
401262783,Nevada Wolf Pack,A. West,4400134,,True,34.0,2,7,1,3,1,4,0,0,2,3,5,0,1,0,4,3,5
401262783,Nevada Wolf Pack,D. Hamilton,4400132,,True,30.0,2,3,2,3,0,0,4,4,1,3,4,2,0,1,0,0,8
401262783,Nevada Wolf Pack,N. Alexander,4068433,,True,28.0,5,9,4,6,1,3,0,0,0,3,3,2,1,0,4,2,11
401262783,Nevada Wolf Pack,E. Stebetakova,4704509,,False,3.0,1,2,1,2,0,0,0,0,0,0,0,0,0,0,0,0,2
401262783,Nevada Wolf Pack,L. Otuafi,4704508,,False,13.0,3,7,2,5,1,2,2,2,0,2,2,0,0,0,3,1,9
401262783,Nevada Wolf Pack,L. Givens,4704506,,False,3.0,0,1,0,0,0,1,0,0,0,0,0,1,0,0,1,1,0
401262783,Nevada Wolf Pack,K. Holt,4704503,,False,22.0,2,3,2,3,0,0,1,2,2,5,7,1,2,0,1,2,5
401262783,Nevada Wolf Pack,A. Jovicevic,4704502,,False,5.0,0,1,0,0,0,1,0,0,0,0,0,0,0,0,2,0,0
401262783,Nevada Wolf Pack,B. Carstens,4597039,,False,14.0,1,2,1,2,0,0,0,0,1,1,2,1,0,0,1,1,2
401262783,Nevada Wolf Pack,TEAM,TOTAL,TOTAL,False,,24,51,21,40,3,11,9,10,10,26,36,10,6,2,19,13,60
401262782,San Diego State Aztecs,K. Edwards,4281879,,True,11.0,0,3,0,3,0,0,0,0,1,1,2,0,0,0,0,0,0
401262782,San Diego State Aztecs,I. Hernandez,4595647,,True,30.0,2,6,0,1,2,5,0,0,0,4,4,0,0,0,1,2,6
401262782,San Diego State Aztecs,A. Crain,4399223,,True,31.0,1,7,1,5,0,2,0,0,0,6,6,0,0,0,0,1,2
401262782,San Diego State Aztecs,M. Staples,4398925,,True,31.0,3,9,3,6,0,3,2,2,1,8,9,1,0,0,1,2,8
401262782,San Diego State Aztecs,T. Adams,4281876,,True,28.0,5,9,5,8,0,1,2,3,0,0,0,2,1,0,3,5,12
401262782,San Diego State Aztecs,K. Gipson,4704563,,False,22.0,4,6,4,6,0,0,0,2,2,1,3,0,0,0,1,4,8
401262782,San Diego State Aztecs,F. Vinerte,4704564,,False,7.0,3,3,3,3,0,0,1,3,0,0,0,0,0,1,1,5,7
401262782,San Diego State Aztecs,K. Villalobos,4704565,,False,24.0,5,11,5,11,0,0,1,4,5,1,6,3,0,0,1,1,11
401262782,San Diego State Aztecs,M. Adams,4400169,,False,14.0,1,4,1,3,0,1,3,3,1,0,1,1,0,0,2,2,5
401262782,San Diego State Aztecs,T. Sireni,4595648,,False,2.0,0,1,0,1,0,0,0,0,0,0,0,0,0,0,0,0,0
401262782,San Diego State Aztecs,TEAM,TOTAL,TOTAL,False,,24,59,22,47,2,12,9,17,13,24,37,7,1,1,12,22,59
401262782,San Diego State Aztecs,K. Edwards,4281879,,True,11.0,0,3,0,3,0,0,0,0,1,1,2,0,0,0,0,0,0
401262782,San Diego State Aztecs,I. Hernandez,4595647,,True,30.0,2,6,0,1,2,5,0,0,0,4,4,0,0,0,1,2,6
401262782,San Diego State Aztecs,A. Crain,4399223,,True,31.0,1,7,1,5,0,2,0,0,0,6,6,0,0,0,0,1,2
401262782,San Diego State Aztecs,M. Staples,4398925,,True,31.0,3,9,3,6,0,3,2,2,1,8,9,1,0,0,1,2,8
401262782,San Diego State Aztecs,T. Adams,4281876,,True,28.0,5,9,5,8,0,1,2,3,0,0,0,2,1,0,3,5,12
401262782,San Diego State Aztecs,K. Gipson,4704563,,False,22.0,4,6,4,6,0,0,0,2,2,1,3,0,0,0,1,4,8
401262782,San Diego State Aztecs,F. Vinerte,4704564,,False,7.0,3,3,3,3,0,0,1,3,0,0,0,0,0,1,1,5,7
401262782,San Diego State Aztecs,K. Villalobos,4704565,,False,24.0,5,11,5,11,0,0,1,4,5,1,6,3,0,0,1,1,11
401262782,San Diego State Aztecs,M. Adams,4400169,,False,14.0,1,4,1,3,0,1,3,3,1,0,1,1,0,0,2,2,5
401262782,San Diego State Aztecs,T. Sireni,4595648,,False,2.0,0,1,0,1,0,0,0,0,0,0,0,0,0,0,0,0,0
401262782,San Diego State Aztecs,TEAM,TOTAL,TOTAL,False,,24,59,22,47,2,12,9,17,13,24,37,7,1,1,12,22,59
401262782,Nevada Wolf Pack,M. Ormiston,4400072,,True,21.0,4,9,4,9,0,0,0,0,1,3,4,1,0,0,0,3,8
401262782,Nevada Wolf Pack,L. Johnson,4595634,,True,22.0,0,3,0,1,0,2,0,0,3,2,5,0,1,1,2,2,0
401262782,Nevada Wolf Pack,A. West,4400134,,True,30.0,3,5,3,4,0,1,8,9,3,5,8,3,0,0,1,2,14
401262782,Nevada Wolf Pack,D. Hamilton,4400132,,True,28.0,5,15,3,7,2,8,4,6,0,4,4,3,0,0,2,3,16
401262782,Nevada Wolf Pack,N. Alexander,4068433,,True,31.0,2,9,2,4,0,5,4,4,2,4,6,3,1,0,1,2,8
401262782,Nevada Wolf Pack,L. Otuafi,4704508,,False,22.0,2,8,2,8,0,0,3,4,1,6,7,0,0,0,2,2,7
401262782,Nevada Wolf Pack,K. Holt,4704503,,False,30.0,3,7,1,3,2,4,0,0,1,1,2,2,0,0,0,3,8
401262782,Nevada Wolf Pack,B. Carstens,4597039,,False,16.0,1,6,0,3,1,3,2,2,0,2,2,0,1,0,0,0,5
401262782,Nevada Wolf Pack,TEAM,TOTAL,TOTAL,False,,20,62,15,39,5,23,21,25,16,27,43,12,3,1,9,17,66
401262782,Nevada Wolf Pack,M. Ormiston,4400072,,True,21.0,4,9,4,9,0,0,0,0,1,3,4,1,0,0,0,3,8
401262782,Nevada Wolf Pack,L. Johnson,4595634,,True,22.0,0,3,0,1,0,2,0,0,3,2,5,0,1,1,2,2,0
401262782,Nevada Wolf Pack,A. West,4400134,,True,30.0,3,5,3,4,0,1,8,9,3,5,8,3,0,0,1,2,14
401262782,Nevada Wolf Pack,D. Hamilton,4400132,,True,28.0,5,15,3,7,2,8,4,6,0,4,4,3,0,0,2,3,16
401262782,Nevada Wolf Pack,N. Alexander,4068433,,True,31.0,2,9,2,4,0,5,4,4,2,4,6,3,1,0,1,2,8
401262782,Nevada Wolf Pack,L. Otuafi,4704508,,False,22.0,2,8,2,8,0,0,3,4,1,6,7,0,0,0,2,2,7
401262782,Nevada Wolf Pack,K. Holt,4704503,,False,30.0,3,7,1,3,2,4,0,0,1,1,2,2,0,0,0,3,8
401262782,Nevada Wolf Pack,B. Carstens,4597039,,False,16.0,1,6,0,3,1,3,2,2,0,2,2,0,1,0,0,0,5
401262782,Nevada Wolf Pack,TEAM,TOTAL,TOTAL,False,,20,62,15,39,5,23,21,25,16,27,43,12,3,1,9,17,66
401262781,San Diego State Aztecs,K. Edwards,4281879,,True,13.0,0,2,0,2,0,0,2,2,0,1,1,0,0,0,1,2,2
401262781,San Diego State Aztecs,I. Hernandez,4595647,,True,27.0,1,10,0,8,1,2,0,0,1,3,4,1,1,0,1,1,3
401262781,San Diego State Aztecs,A. Crain,4399223,,True,28.0,1,6,1,6,0,0,0,0,1,5,6,2,1,0,1,2,2
401262781,San Diego State Aztecs,M. Staples,4398925,,True,34.0,4,6,4,5,0,1,1,1,3,5,8,4,1,0,2,3,9
401262781,San Diego State Aztecs,T. Adams,4281876,,True,29.0,9,16,8,13,1,3,5,6,0,3,3,1,2,0,3,2,24
401262781,San Diego State Aztecs,K. Gipson,4704563,,False,21.0,3,5,3,5,0,0,0,0,2,4,6,1,2,2,0,0,6
401262781,San Diego State Aztecs,I. Murillo,4704566,,False,2.0,0,0,0,0,0,0,0,0,0,0,0,0,0,0,0,0,0
401262781,San Diego State Aztecs,F. Vinerte,4704564,,False,5.0,0,0,0,0,0,0,0,0,0,1,1,1,0,0,0,0,0
401262781,San Diego State Aztecs,K. Villalobos,4704565,,False,16.0,3,9,3,9,0,0,3,6,3,3,6,0,2,0,0,2,9
401262781,San Diego State Aztecs,M. Adams,4400169,,False,16.0,1,5,1,4,0,1,2,2,2,2,4,0,0,0,0,2,4
401262781,San Diego State Aztecs,B. Chynoweth,4704562,,False,7.0,0,3,0,0,0,3,0,0,0,0,0,0,0,0,0,2,0
401262781,San Diego State Aztecs,T. Sireni,4595648,,False,2.0,0,0,0,0,0,0,0,0,0,0,0,0,0,0,0,1,0
401262781,San Diego State Aztecs,TEAM,TOTAL,TOTAL,False,,22,62,20,52,2,10,13,17,14,28,42,10,9,2,8,17,59
401262781,San Diego State Aztecs,K. Edwards,4281879,,True,13.0,0,2,0,2,0,0,2,2,0,1,1,0,0,0,1,2,2
401262781,San Diego State Aztecs,I. Hernandez,4595647,,True,27.0,1,10,0,8,1,2,0,0,1,3,4,1,1,0,1,1,3
401262781,San Diego State Aztecs,A. Crain,4399223,,True,28.0,1,6,1,6,0,0,0,0,1,5,6,2,1,0,1,2,2
401262781,San Diego State Aztecs,M. Staples,4398925,,True,34.0,4,6,4,5,0,1,1,1,3,5,8,4,1,0,2,3,9
401262781,San Diego State Aztecs,T. Adams,4281876,,True,29.0,9,16,8,13,1,3,5,6,0,3,3,1,2,0,3,2,24
401262781,San Diego State Aztecs,K. Gipson,4704563,,False,21.0,3,5,3,5,0,0,0,0,2,4,6,1,2,2,0,0,6
401262781,San Diego State Aztecs,I. Murillo,4704566,,False,2.0,0,0,0,0,0,0,0,0,0,0,0,0,0,0,0,0,0
401262781,San Diego State Aztecs,F. Vinerte,4704564,,False,5.0,0,0,0,0,0,0,0,0,0,1,1,1,0,0,0,0,0
401262781,San Diego State Aztecs,K. Villalobos,4704565,,False,16.0,3,9,3,9,0,0,3,6,3,3,6,0,2,0,0,2,9
401262781,San Diego State Aztecs,M. Adams,4400169,,False,16.0,1,5,1,4,0,1,2,2,2,2,4,0,0,0,0,2,4
401262781,San Diego State Aztecs,B. Chynoweth,4704562,,False,7.0,0,3,0,0,0,3,0,0,0,0,0,0,0,0,0,2,0
401262781,San Diego State Aztecs,T. Sireni,4595648,,False,2.0,0,0,0,0,0,0,0,0,0,0,0,0,0,0,0,1,0
401262781,San Diego State Aztecs,TEAM,TOTAL,TOTAL,False,,22,62,20,52,2,10,13,17,14,28,42,10,9,2,8,17,59
401262781,Nevada Wolf Pack,M. Ormiston,4400072,,True,29.0,3,11,3,11,0,0,1,1,6,5,11,1,0,2,2,3,7
401262781,Nevada Wolf Pack,L. Johnson,4595634,,True,35.0,1,7,1,5,0,2,4,4,2,5,7,2,1,0,1,2,6
401262781,Nevada Wolf Pack,A. West,4400134,,True,29.0,1,5,1,4,0,1,2,3,3,3,6,1,1,0,2,3,4
401262781,Nevada Wolf Pack,D. Hamilton,4400132,,True,35.0,4,14,2,7,2,7,3,4,2,4,6,3,1,0,5,1,13
401262781,Nevada Wolf Pack,N. Alexander,4068433,,True,24.0,1,7,1,5,0,2,1,2,3,4,7,0,1,0,2,4,3
401262781,Nevada Wolf Pack,E. Stebetakova,4704509,,False,3.0,0,1,0,1,0,0,0,0,0,0,0,0,0,0,0,0,0
401262781,Nevada Wolf Pack,L. Otuafi,4704508,,False,14.0,1,4,1,3,0,1,2,2,1,1,2,0,0,0,1,1,4
401262781,Nevada Wolf Pack,L. Givens,4704506,,False,2.0,0,1,0,0,0,1,0,0,0,1,1,0,0,0,0,1,0
401262781,Nevada Wolf Pack,K. Holt,4704503,,False,9.0,1,4,0,1,1,3,0,0,0,1,1,0,0,0,0,0,3
401262781,Nevada Wolf Pack,A. Jovicevic,4704502,,False,1.0,0,0,0,0,0,0,0,0,0,0,0,0,0,0,0,0,0
401262781,Nevada Wolf Pack,B. Carstens,4597039,,False,20.0,1,7,0,1,1,6,0,0,0,1,1,0,0,0,1,1,3
401262781,Nevada Wolf Pack,TEAM,TOTAL,TOTAL,False,,13,61,9,38,4,23,13,16,21,29,50,7,4,2,16,16,43
401262781,Nevada Wolf Pack,M. Ormiston,4400072,,True,29.0,3,11,3,11,0,0,1,1,6,5,11,1,0,2,2,3,7
401262781,Nevada Wolf Pack,L. Johnson,4595634,,True,35.0,1,7,1,5,0,2,4,4,2,5,7,2,1,0,1,2,6
401262781,Nevada Wolf Pack,A. West,4400134,,True,29.0,1,5,1,4,0,1,2,3,3,3,6,1,1,0,2,3,4
401262781,Nevada Wolf Pack,D. Hamilton,4400132,,True,35.0,4,14,2,7,2,7,3,4,2,4,6,3,1,0,5,1,13
401262781,Nevada Wolf Pack,N. Alexander,4068433,,True,24.0,1,7,1,5,0,2,1,2,3,4,7,0,1,0,2,4,3
401262781,Nevada Wolf Pack,E. Stebetakova,4704509,,False,3.0,0,1,0,1,0,0,0,0,0,0,0,0,0,0,0,0,0
401262781,Nevada Wolf Pack,L. Otuafi,4704508,,False,14.0,1,4,1,3,0,1,2,2,1,1,2,0,0,0,1,1,4
401262781,Nevada Wolf Pack,L. Givens,4704506,,False,2.0,0,1,0,0,0,1,0,0,0,1,1,0,0,0,0,1,0
401262781,Nevada Wolf Pack,K. Holt,4704503,,False,9.0,1,4,0,1,1,3,0,0,0,1,1,0,0,0,0,0,3
401262781,Nevada Wolf Pack,A. Jovicevic,4704502,,False,1.0,0,0,0,0,0,0,0,0,0,0,0,0,0,0,0,0,0
401262781,Nevada Wolf Pack,B. Carstens,4597039,,False,20.0,1,7,0,1,1,6,0,0,0,1,1,0,0,0,1,1,3
401262781,Nevada Wolf Pack,TEAM,TOTAL,TOTAL,False,,13,61,9,38,4,23,13,16,21,29,50,7,4,2,16,16,43
401262780,New Mexico Lobos,S. McGruder,4400149,,True,26.0,4,6,4,5,0,1,0,0,0,2,2,0,3,1,1,2,8
401262780,New Mexico Lobos,A. Anderson,4281834,,True,14.0,3,5,3,4,0,1,2,2,0,2,2,0,0,0,0,5,8
401262780,New Mexico Lobos,Lato. Duff,4704520,,True,29.0,5,9,5,9,0,0,0,0,0,7,7,4,1,0,3,2,10
401262780,New Mexico Lobos,A. Hurst,4400147,,True,37.0,7,15,4,9,3,6,3,4,0,2,2,0,3,0,1,2,20
401262780,New Mexico Lobos,J. De La Cerda,4281833,,True,26.0,4,10,4,7,0,3,4,4,2,4,6,1,0,0,0,1,12
401262780,New Mexico Lobos,A. Watts,4433688,,False,29.0,3,8,3,5,0,3,1,2,6,3,9,1,1,0,1,1,7
401262780,New Mexico Lobos,K. van Bennekom,4704522,,False,5.0,0,0,0,0,0,0,0,0,0,0,0,0,0,0,0,0,0
401262780,New Mexico Lobos,Lata. Duff,4704519,,False,23.0,4,10,3,6,1,4,1,3,1,2,3,1,0,0,0,1,10
401262780,New Mexico Lobos,C. Carter,4433646,,False,11.0,1,2,1,1,0,1,1,2,0,0,0,1,2,0,2,2,3
401262780,New Mexico Lobos,TEAM,TOTAL,TOTAL,False,,31,65,27,46,4,19,12,17,9,23,32,8,10,1,8,16,78
401262780,New Mexico Lobos,S. McGruder,4400149,,True,26.0,4,6,4,5,0,1,0,0,0,2,2,0,3,1,1,2,8
401262780,New Mexico Lobos,A. Anderson,4281834,,True,14.0,3,5,3,4,0,1,2,2,0,2,2,0,0,0,0,5,8
401262780,New Mexico Lobos,Lato. Duff,4704520,,True,29.0,5,9,5,9,0,0,0,0,0,7,7,4,1,0,3,2,10
401262780,New Mexico Lobos,A. Hurst,4400147,,True,37.0,7,15,4,9,3,6,3,4,0,2,2,0,3,0,1,2,20
401262780,New Mexico Lobos,J. De La Cerda,4281833,,True,26.0,4,10,4,7,0,3,4,4,2,4,6,1,0,0,0,1,12
401262780,New Mexico Lobos,A. Watts,4433688,,False,29.0,3,8,3,5,0,3,1,2,6,3,9,1,1,0,1,1,7
401262780,New Mexico Lobos,K. van Bennekom,4704522,,False,5.0,0,0,0,0,0,0,0,0,0,0,0,0,0,0,0,0,0
401262780,New Mexico Lobos,Lata. Duff,4704519,,False,23.0,4,10,3,6,1,4,1,3,1,2,3,1,0,0,0,1,10
401262780,New Mexico Lobos,C. Carter,4433646,,False,11.0,1,2,1,1,0,1,1,2,0,0,0,1,2,0,2,2,3
401262780,New Mexico Lobos,TEAM,TOTAL,TOTAL,False,,31,65,27,46,4,19,12,17,9,23,32,8,10,1,8,16,78
401262780,Nevada Wolf Pack,M. Ormiston,4400072,,True,18.0,1,2,1,2,0,0,0,0,0,1,1,0,1,1,1,2,2
401262780,Nevada Wolf Pack,G. Rones,4704505,,True,22.0,1,4,1,2,0,2,2,2,0,1,1,0,0,0,1,0,4
401262780,Nevada Wolf Pack,B. Carstens,4597039,,True,23.0,4,8,2,4,2,4,0,0,1,4,5,3,2,0,3,5,10
401262780,Nevada Wolf Pack,L. Johnson,4595634,,True,29.0,4,7,3,6,1,1,8,8,0,7,7,3,1,0,7,1,17
401262780,Nevada Wolf Pack,N. Alexander,4068433,,True,27.0,4,7,4,6,0,1,2,4,2,1,3,0,0,0,2,0,10
401262780,Nevada Wolf Pack,E. Stebetakova,4704509,,False,4.0,0,1,0,0,0,1,0,0,0,1,1,0,0,0,0,1,0
401262780,Nevada Wolf Pack,L. Otuafi,4704508,,False,20.0,7,9,6,7,1,2,1,2,2,3,5,2,0,0,3,0,16
401262780,Nevada Wolf Pack,L. Givens,4704506,,False,9.0,1,2,0,0,1,2,0,0,0,1,1,1,0,0,0,1,3
401262780,Nevada Wolf Pack,K. Holt,4704503,,False,14.0,0,1,0,1,0,0,0,0,0,1,1,0,0,0,0,4,0
401262780,Nevada Wolf Pack,A. Jovicevic,4704502,,False,15.0,0,4,0,2,0,2,0,0,0,2,2,0,0,0,0,2,0
401262780,Nevada Wolf Pack,D. Hamilton,4400132,,False,19.0,2,7,1,3,1,4,0,0,0,0,0,3,0,0,2,1,5
401262780,Nevada Wolf Pack,TEAM,TOTAL,TOTAL,False,,24,52,18,33,6,19,13,16,5,26,31,12,4,1,19,17,67
401262780,Nevada Wolf Pack,M. Ormiston,4400072,,True,18.0,1,2,1,2,0,0,0,0,0,1,1,0,1,1,1,2,2
401262780,Nevada Wolf Pack,G. Rones,4704505,,True,22.0,1,4,1,2,0,2,2,2,0,1,1,0,0,0,1,0,4
401262780,Nevada Wolf Pack,B. Carstens,4597039,,True,23.0,4,8,2,4,2,4,0,0,1,4,5,3,2,0,3,5,10
401262780,Nevada Wolf Pack,L. Johnson,4595634,,True,29.0,4,7,3,6,1,1,8,8,0,7,7,3,1,0,7,1,17
401262780,Nevada Wolf Pack,N. Alexander,4068433,,True,27.0,4,7,4,6,0,1,2,4,2,1,3,0,0,0,2,0,10
401262780,Nevada Wolf Pack,E. Stebetakova,4704509,,False,4.0,0,1,0,0,0,1,0,0,0,1,1,0,0,0,0,1,0
401262780,Nevada Wolf Pack,L. Otuafi,4704508,,False,20.0,7,9,6,7,1,2,1,2,2,3,5,2,0,0,3,0,16
401262780,Nevada Wolf Pack,L. Givens,4704506,,False,9.0,1,2,0,0,1,2,0,0,0,1,1,1,0,0,0,1,3
401262780,Nevada Wolf Pack,K. Holt,4704503,,False,14.0,0,1,0,1,0,0,0,0,0,1,1,0,0,0,0,4,0
401262780,Nevada Wolf Pack,A. Jovicevic,4704502,,False,15.0,0,4,0,2,0,2,0,0,0,2,2,0,0,0,0,2,0
401262780,Nevada Wolf Pack,D. Hamilton,4400132,,False,19.0,2,7,1,3,1,4,0,0,0,0,0,3,0,0,2,1,5
401262780,Nevada Wolf Pack,TEAM,TOTAL,TOTAL,False,,24,52,18,33,6,19,13,16,5,26,31,12,4,1,19,17,67
401262779,New Mexico Lobos,S. McGruder,4400149,,True,22.0,7,11,6,9,1,2,0,0,2,4,6,0,3,0,0,3,15
401262779,New Mexico Lobos,A. Anderson,4281834,,True,16.0,0,2,0,2,0,0,0,0,0,3,3,0,0,1,2,3,0
401262779,New Mexico Lobos,Lato. Duff,4704520,,True,26.0,5,8,2,3,3,5,0,0,1,0,1,5,0,1,1,4,13
401262779,New Mexico Lobos,A. Hurst,4400147,,True,31.0,4,12,1,4,3,8,2,2,0,1,1,1,1,0,1,1,13
401262779,New Mexico Lobos,J. De La Cerda,4281833,,True,29.0,9,13,6,8,3,5,0,2,0,9,9,5,0,0,2,3,21
401262779,New Mexico Lobos,C. Dupont,4595646,,False,6.0,0,1,0,0,0,1,0,0,0,0,0,0,0,0,0,0,0
401262779,New Mexico Lobos,A. Watts,4433688,,False,17.0,1,4,1,4,0,0,0,0,2,3,5,1,0,1,2,1,2
401262779,New Mexico Lobos,A. Robinson,4432993,,False,3.0,0,0,0,0,0,0,0,0,0,0,0,0,0,0,0,1,0
401262779,New Mexico Lobos,K. van Bennekom,4704522,,False,5.0,1,2,1,1,0,1,0,0,0,1,1,0,0,0,0,0,2
401262779,New Mexico Lobos,Lata. Duff,4704519,,False,22.0,4,9,1,2,3,7,2,2,0,2,2,0,0,0,1,3,13
401262779,New Mexico Lobos,C. Carter,4433646,,False,23.0,4,5,3,4,1,1,0,0,0,2,2,4,0,0,1,1,9
401262779,New Mexico Lobos,TEAM,TOTAL,TOTAL,False,,35,67,21,37,14,30,4,6,6,30,36,16,4,3,11,20,88
401262779,New Mexico Lobos,S. McGruder,4400149,,True,22.0,7,11,6,9,1,2,0,0,2,4,6,0,3,0,0,3,15
401262779,New Mexico Lobos,A. Anderson,4281834,,True,16.0,0,2,0,2,0,0,0,0,0,3,3,0,0,1,2,3,0
401262779,New Mexico Lobos,Lato. Duff,4704520,,True,26.0,5,8,2,3,3,5,0,0,1,0,1,5,0,1,1,4,13
401262779,New Mexico Lobos,A. Hurst,4400147,,True,31.0,4,12,1,4,3,8,2,2,0,1,1,1,1,0,1,1,13
401262779,New Mexico Lobos,J. De La Cerda,4281833,,True,29.0,9,13,6,8,3,5,0,2,0,9,9,5,0,0,2,3,21
401262779,New Mexico Lobos,C. Dupont,4595646,,False,6.0,0,1,0,0,0,1,0,0,0,0,0,0,0,0,0,0,0
401262779,New Mexico Lobos,A. Watts,4433688,,False,17.0,1,4,1,4,0,0,0,0,2,3,5,1,0,1,2,1,2
401262779,New Mexico Lobos,A. Robinson,4432993,,False,3.0,0,0,0,0,0,0,0,0,0,0,0,0,0,0,0,1,0
401262779,New Mexico Lobos,K. van Bennekom,4704522,,False,5.0,1,2,1,1,0,1,0,0,0,1,1,0,0,0,0,0,2
401262779,New Mexico Lobos,Lata. Duff,4704519,,False,22.0,4,9,1,2,3,7,2,2,0,2,2,0,0,0,1,3,13
401262779,New Mexico Lobos,C. Carter,4433646,,False,23.0,4,5,3,4,1,1,0,0,0,2,2,4,0,0,1,1,9
401262779,New Mexico Lobos,TEAM,TOTAL,TOTAL,False,,35,67,21,37,14,30,4,6,6,30,36,16,4,3,11,20,88
401262779,Nevada Wolf Pack,L. Otuafi,4704508,,True,20.0,1,7,1,7,0,0,0,0,0,2,2,1,0,1,2,3,2
401262779,Nevada Wolf Pack,M. Ormiston,4400072,,True,31.0,4,10,4,10,0,0,3,5,6,3,9,0,1,0,3,3,11
401262779,Nevada Wolf Pack,L. Johnson,4595634,,True,18.0,4,5,4,5,0,0,1,1,0,3,3,1,1,0,1,0,9
401262779,Nevada Wolf Pack,D. Hamilton,4400132,,True,30.0,5,23,3,15,2,8,0,3,4,1,5,2,1,0,1,0,12
401262779,Nevada Wolf Pack,N. Alexander,4068433,,True,31.0,6,11,6,10,0,1,4,5,5,2,7,0,1,0,1,2,16
401262779,Nevada Wolf Pack,E. Stebetakova,4704509,,False,4.0,0,0,0,0,0,0,2,2,0,2,2,0,0,0,0,0,2
401262779,Nevada Wolf Pack,L. Givens,4704506,,False,16.0,1,4,1,3,0,1,2,2,1,4,5,0,0,0,3,0,4
401262779,Nevada Wolf Pack,G. Rones,4704505,,False,22.0,2,3,1,1,1,2,0,0,0,3,3,2,0,0,1,1,5
401262779,Nevada Wolf Pack,K. Holt,4704503,,False,18.0,1,4,1,3,0,1,0,0,1,1,2,3,1,0,0,1,2
401262779,Nevada Wolf Pack,A. Jovicevic,4704502,,False,2.0,2,2,1,1,1,1,0,0,0,1,1,0,0,0,1,1,5
401262779,Nevada Wolf Pack,B. Carstens,4597039,,False,8.0,0,2,0,1,0,1,1,2,0,0,0,0,1,0,1,0,1
401262779,Nevada Wolf Pack,TEAM,TOTAL,TOTAL,False,,26,71,22,56,4,15,13,20,19,26,45,9,6,1,14,11,69
401262779,Nevada Wolf Pack,L. Otuafi,4704508,,True,20.0,1,7,1,7,0,0,0,0,0,2,2,1,0,1,2,3,2
401262779,Nevada Wolf Pack,M. Ormiston,4400072,,True,31.0,4,10,4,10,0,0,3,5,6,3,9,0,1,0,3,3,11
401262779,Nevada Wolf Pack,L. Johnson,4595634,,True,18.0,4,5,4,5,0,0,1,1,0,3,3,1,1,0,1,0,9
401262779,Nevada Wolf Pack,D. Hamilton,4400132,,True,30.0,5,23,3,15,2,8,0,3,4,1,5,2,1,0,1,0,12
401262779,Nevada Wolf Pack,N. Alexander,4068433,,True,31.0,6,11,6,10,0,1,4,5,5,2,7,0,1,0,1,2,16
401262779,Nevada Wolf Pack,E. Stebetakova,4704509,,False,4.0,0,0,0,0,0,0,2,2,0,2,2,0,0,0,0,0,2
401262779,Nevada Wolf Pack,L. Givens,4704506,,False,16.0,1,4,1,3,0,1,2,2,1,4,5,0,0,0,3,0,4
401262779,Nevada Wolf Pack,G. Rones,4704505,,False,22.0,2,3,1,1,1,2,0,0,0,3,3,2,0,0,1,1,5
401262779,Nevada Wolf Pack,K. Holt,4704503,,False,18.0,1,4,1,3,0,1,0,0,1,1,2,3,1,0,0,1,2
401262779,Nevada Wolf Pack,A. Jovicevic,4704502,,False,2.0,2,2,1,1,1,1,0,0,0,1,1,0,0,0,1,1,5
401262779,Nevada Wolf Pack,B. Carstens,4597039,,False,8.0,0,2,0,1,0,1,1,2,0,0,0,0,1,0,1,0,1
401262779,Nevada Wolf Pack,TEAM,TOTAL,TOTAL,False,,26,71,22,56,4,15,13,20,19,26,45,9,6,1,14,11,69
401262778,UNLV Lady Rebels,D. Byrne,4398924,,True,36.0,3,11,1,7,2,4,1,1,2,3,5,1,1,1,0,1,9
401262778,UNLV Lady Rebels,D. Young,4704625,,True,30.0,7,11,7,11,0,0,4,11,6,4,10,0,2,1,3,2,18
401262778,UNLV Lady Rebels,J. Thomas,4704624,,True,40.0,5,7,2,3,3,4,4,4,0,12,12,0,2,0,3,2,17
401262778,UNLV Lady Rebels,N. Johnson,4400108,,True,25.0,5,12,3,7,2,5,0,0,1,2,3,2,0,0,5,3,12
401262778,UNLV Lady Rebels,B. Thomas,4068210,,True,40.0,2,5,0,2,2,3,1,2,1,1,2,2,2,0,3,2,7
401262778,UNLV Lady Rebels,A. Blount,4595640,,False,14.0,4,7,4,7,0,0,1,2,1,1,2,0,0,0,3,1,9
401262778,UNLV Lady Rebels,J. Singleton,4704623,,False,9.0,1,1,0,0,1,1,0,0,0,0,0,0,0,0,1,1,3
401262778,UNLV Lady Rebels,J. Buckley,4595639,,False,6.0,0,2,0,1,0,1,0,0,0,1,1,0,0,0,1,0,0
401262778,UNLV Lady Rebels,TEAM,TOTAL,TOTAL,False,,27,56,17,38,10,18,11,20,12,28,40,5,7,2,19,12,75
401262778,UNLV Lady Rebels,D. Byrne,4398924,,True,36.0,3,11,1,7,2,4,1,1,2,3,5,1,1,1,0,1,9
401262778,UNLV Lady Rebels,D. Young,4704625,,True,30.0,7,11,7,11,0,0,4,11,6,4,10,0,2,1,3,2,18
401262778,UNLV Lady Rebels,J. Thomas,4704624,,True,40.0,5,7,2,3,3,4,4,4,0,12,12,0,2,0,3,2,17
401262778,UNLV Lady Rebels,N. Johnson,4400108,,True,25.0,5,12,3,7,2,5,0,0,1,2,3,2,0,0,5,3,12
401262778,UNLV Lady Rebels,B. Thomas,4068210,,True,40.0,2,5,0,2,2,3,1,2,1,1,2,2,2,0,3,2,7
401262778,UNLV Lady Rebels,A. Blount,4595640,,False,14.0,4,7,4,7,0,0,1,2,1,1,2,0,0,0,3,1,9
401262778,UNLV Lady Rebels,J. Singleton,4704623,,False,9.0,1,1,0,0,1,1,0,0,0,0,0,0,0,0,1,1,3
401262778,UNLV Lady Rebels,J. Buckley,4595639,,False,6.0,0,2,0,1,0,1,0,0,0,1,1,0,0,0,1,0,0
401262778,UNLV Lady Rebels,TEAM,TOTAL,TOTAL,False,,27,56,17,38,10,18,11,20,12,28,40,5,7,2,19,12,75
401262778,Fresno State Bulldogs,W. Motta,4595631,,True,23.0,2,5,2,5,0,0,0,0,1,6,7,1,2,0,0,4,4
401262778,Fresno State Bulldogs,M. Utti,4281828,,True,36.0,1,5,0,2,1,3,0,0,1,7,8,1,1,0,3,1,3
401262778,Fresno State Bulldogs,G. Ogier,4281827,,True,2.0,0,0,0,0,0,0,0,0,0,0,0,0,0,0,1,0,0
401262778,Fresno State Bulldogs,A. Gamez,4281826,,True,36.0,3,7,1,1,2,6,2,2,1,0,1,3,4,0,1,3,10
401262778,Fresno State Bulldogs,B. Delaney,4281825,,True,18.0,2,2,1,1,1,1,0,0,1,2,3,1,1,0,2,1,5
401262778,Fresno State Bulldogs,K. Kinzer,4595630,,False,8.0,0,4,0,1,0,3,0,0,0,0,0,0,0,0,0,1,0
401262778,Fresno State Bulldogs,B. Walling,4595632,,False,3.0,0,0,0,0,0,0,0,0,0,0,0,0,0,0,1,1,0
401262778,Fresno State Bulldogs,K. Brown,4704473,,False,4.0,0,2,0,1,0,1,0,0,0,0,0,0,0,0,0,0,0
401262778,Fresno State Bulldogs,Hal. Cavinder,4433658,,False,32.0,9,18,7,13,2,5,0,0,0,7,7,3,0,0,2,3,20
401262778,Fresno State Bulldogs,Han. Cavinder,4433372,,False,38.0,13,20,9,15,4,5,2,4,0,2,2,3,4,1,1,3,32
401262778,Fresno State Bulldogs,TEAM,TOTAL,TOTAL,False,,30,63,20,39,10,24,4,6,6,25,31,12,12,1,12,17,74
401262778,Fresno State Bulldogs,W. Motta,4595631,,True,23.0,2,5,2,5,0,0,0,0,1,6,7,1,2,0,0,4,4
401262778,Fresno State Bulldogs,M. Utti,4281828,,True,36.0,1,5,0,2,1,3,0,0,1,7,8,1,1,0,3,1,3
401262778,Fresno State Bulldogs,G. Ogier,4281827,,True,2.0,0,0,0,0,0,0,0,0,0,0,0,0,0,0,1,0,0
401262778,Fresno State Bulldogs,A. Gamez,4281826,,True,36.0,3,7,1,1,2,6,2,2,1,0,1,3,4,0,1,3,10
401262778,Fresno State Bulldogs,B. Delaney,4281825,,True,18.0,2,2,1,1,1,1,0,0,1,2,3,1,1,0,2,1,5
401262778,Fresno State Bulldogs,K. Kinzer,4595630,,False,8.0,0,4,0,1,0,3,0,0,0,0,0,0,0,0,0,1,0
401262778,Fresno State Bulldogs,B. Walling,4595632,,False,3.0,0,0,0,0,0,0,0,0,0,0,0,0,0,0,1,1,0
401262778,Fresno State Bulldogs,K. Brown,4704473,,False,4.0,0,2,0,1,0,1,0,0,0,0,0,0,0,0,0,0,0
401262778,Fresno State Bulldogs,Hal. Cavinder,4433658,,False,32.0,9,18,7,13,2,5,0,0,0,7,7,3,0,0,2,3,20
401262778,Fresno State Bulldogs,Han. Cavinder,4433372,,False,38.0,13,20,9,15,4,5,2,4,0,2,2,3,4,1,1,3,32
401262778,Fresno State Bulldogs,TEAM,TOTAL,TOTAL,False,,30,63,20,39,10,24,4,6,6,25,31,12,12,1,12,17,74
401262777,UNLV Lady Rebels,D. Byrne,4398924,,True,34.0,6,14,6,13,0,1,1,1,6,6,12,0,0,1,2,1,13
401262777,UNLV Lady Rebels,D. Young,4704625,,True,17.0,5,9,5,9,0,0,2,6,2,2,4,0,0,0,4,3,12
401262777,UNLV Lady Rebels,J. Thomas,4704624,,True,37.0,1,6,0,1,1,5,0,0,0,8,8,2,0,0,0,2,3
401262777,UNLV Lady Rebels,N. Johnson,4400108,,True,36.0,4,15,2,10,2,5,4,7,1,3,4,2,3,0,1,1,14
401262777,UNLV Lady Rebels,B. Thomas,4068210,,True,40.0,4,8,2,4,2,4,2,4,2,4,6,1,3,0,2,3,12
401262777,UNLV Lady Rebels,A. Blount,4595640,,False,24.0,4,8,4,8,0,0,4,6,3,5,8,2,0,0,1,0,12
401262777,UNLV Lady Rebels,K. Wilfred,4595641,,False,5.0,0,4,0,4,0,0,0,0,1,1,2,0,0,0,1,0,0
401262777,UNLV Lady Rebels,J. Buckley,4595639,,False,7.0,1,1,1,1,0,0,0,0,0,0,0,0,0,0,1,2,2
401262777,UNLV Lady Rebels,TEAM,TOTAL,TOTAL,False,,25,65,20,50,5,15,13,24,17,32,49,7,6,1,13,12,68
401262777,UNLV Lady Rebels,D. Byrne,4398924,,True,34.0,6,14,6,13,0,1,1,1,6,6,12,0,0,1,2,1,13
401262777,UNLV Lady Rebels,D. Young,4704625,,True,17.0,5,9,5,9,0,0,2,6,2,2,4,0,0,0,4,3,12
401262777,UNLV Lady Rebels,J. Thomas,4704624,,True,37.0,1,6,0,1,1,5,0,0,0,8,8,2,0,0,0,2,3
401262777,UNLV Lady Rebels,N. Johnson,4400108,,True,36.0,4,15,2,10,2,5,4,7,1,3,4,2,3,0,1,1,14
401262777,UNLV Lady Rebels,B. Thomas,4068210,,True,40.0,4,8,2,4,2,4,2,4,2,4,6,1,3,0,2,3,12
401262777,UNLV Lady Rebels,A. Blount,4595640,,False,24.0,4,8,4,8,0,0,4,6,3,5,8,2,0,0,1,0,12
401262777,UNLV Lady Rebels,K. Wilfred,4595641,,False,5.0,0,4,0,4,0,0,0,0,1,1,2,0,0,0,1,0,0
401262777,UNLV Lady Rebels,J. Buckley,4595639,,False,7.0,1,1,1,1,0,0,0,0,0,0,0,0,0,0,1,2,2
401262777,UNLV Lady Rebels,TEAM,TOTAL,TOTAL,False,,25,65,20,50,5,15,13,24,17,32,49,7,6,1,13,12,68
401262777,Fresno State Bulldogs,W. Motta,4595631,,True,15.0,2,9,2,9,0,0,2,2,3,1,4,0,0,1,1,3,6
401262777,Fresno State Bulldogs,M. Utti,4281828,,True,40.0,3,11,3,7,0,4,0,0,5,10,15,4,3,1,1,1,6
401262777,Fresno State Bulldogs,Hal. Cavinder,4433658,,True,40.0,9,20,5,13,4,7,4,4,1,6,7,3,1,1,2,0,26
401262777,Fresno State Bulldogs,Han. Cavinder,4433372,,True,31.0,3,13,2,9,1,4,0,0,1,4,5,2,1,0,4,3,7
401262777,Fresno State Bulldogs,A. Gamez,4281826,,True,31.0,3,6,0,1,3,5,0,0,1,1,2,1,0,0,2,3,9
401262777,Fresno State Bulldogs,K. Kinzer,4595630,,False,15.0,3,7,1,1,2,6,0,0,0,0,0,0,0,0,0,0,8
401262777,Fresno State Bulldogs,G. Ogier,4281827,,False,1.0,0,0,0,0,0,0,0,0,1,1,2,0,0,0,1,0,0
401262777,Fresno State Bulldogs,B. Walling,4595632,,False,13.0,1,1,1,1,0,0,0,0,0,2,2,0,0,1,1,4,2
401262777,Fresno State Bulldogs,K. Brown,4704473,,False,0.0,0,0,0,0,0,0,0,0,0,0,0,0,0,0,0,0,0
401262777,Fresno State Bulldogs,B. Delaney,4281825,,False,14.0,1,4,1,3,0,1,0,0,2,1,3,0,3,0,0,3,2
401262777,Fresno State Bulldogs,TEAM,TOTAL,TOTAL,False,,25,71,15,44,10,27,6,6,14,28,42,10,8,4,12,17,66
401262777,Fresno State Bulldogs,W. Motta,4595631,,True,15.0,2,9,2,9,0,0,2,2,3,1,4,0,0,1,1,3,6
401262777,Fresno State Bulldogs,M. Utti,4281828,,True,40.0,3,11,3,7,0,4,0,0,5,10,15,4,3,1,1,1,6
401262777,Fresno State Bulldogs,Hal. Cavinder,4433658,,True,40.0,9,20,5,13,4,7,4,4,1,6,7,3,1,1,2,0,26
401262777,Fresno State Bulldogs,Han. Cavinder,4433372,,True,31.0,3,13,2,9,1,4,0,0,1,4,5,2,1,0,4,3,7
401262777,Fresno State Bulldogs,A. Gamez,4281826,,True,31.0,3,6,0,1,3,5,0,0,1,1,2,1,0,0,2,3,9
401262777,Fresno State Bulldogs,K. Kinzer,4595630,,False,15.0,3,7,1,1,2,6,0,0,0,0,0,0,0,0,0,0,8
401262777,Fresno State Bulldogs,G. Ogier,4281827,,False,1.0,0,0,0,0,0,0,0,0,1,1,2,0,0,0,1,0,0
401262777,Fresno State Bulldogs,B. Walling,4595632,,False,13.0,1,1,1,1,0,0,0,0,0,2,2,0,0,1,1,4,2
401262777,Fresno State Bulldogs,K. Brown,4704473,,False,0.0,0,0,0,0,0,0,0,0,0,0,0,0,0,0,0,0,0
401262777,Fresno State Bulldogs,B. Delaney,4281825,,False,14.0,1,4,1,3,0,1,0,0,2,1,3,0,3,0,0,3,2
401262777,Fresno State Bulldogs,TEAM,TOTAL,TOTAL,False,,25,71,15,44,10,27,6,6,14,28,42,10,8,4,12,17,66
401262776,San Diego State Aztecs,K. Gipson,4704563,,True,26.0,4,5,4,5,0,0,0,2,2,6,8,2,0,1,0,3,8
401262776,San Diego State Aztecs,M. Adams,4400169,,True,25.0,3,9,2,4,1,5,0,0,0,3,3,0,1,0,1,1,7
401262776,San Diego State Aztecs,S. Ramos,4400168,,True,39.0,9,18,6,11,3,7,1,1,1,1,2,7,2,0,2,2,22
401262776,San Diego State Aztecs,M. Staples,4398925,,True,34.0,8,13,4,8,4,5,0,0,0,3,3,3,1,0,1,2,20
401262776,San Diego State Aztecs,T. Adams,4281876,,True,27.0,3,7,2,3,1,4,4,4,1,5,6,6,3,0,3,1,11
401262776,San Diego State Aztecs,F. Vinerte,4704564,,False,9.0,1,3,1,3,0,0,0,0,1,1,2,2,0,0,1,1,2
401262776,San Diego State Aztecs,K. Edwards,4281879,,False,5.0,1,3,1,3,0,0,0,0,1,1,2,0,0,0,0,1,2
401262776,San Diego State Aztecs,K. Villalobos,4704565,,False,7.0,0,4,0,4,0,0,0,0,0,2,2,0,0,0,0,0,0
401262776,San Diego State Aztecs,I. Hernandez,4595647,,False,12.0,0,1,0,1,0,0,0,0,0,0,0,0,0,0,1,0,0
401262776,San Diego State Aztecs,A. Crain,4399223,,False,16.0,3,5,2,3,1,2,0,0,0,1,1,1,1,0,0,1,7
401262776,San Diego State Aztecs,TEAM,TOTAL,TOTAL,False,,32,68,22,45,10,23,5,7,8,25,33,21,8,1,9,12,79
401262776,San Diego State Aztecs,K. Gipson,4704563,,True,26.0,4,5,4,5,0,0,0,2,2,6,8,2,0,1,0,3,8
401262776,San Diego State Aztecs,M. Adams,4400169,,True,25.0,3,9,2,4,1,5,0,0,0,3,3,0,1,0,1,1,7
401262776,San Diego State Aztecs,S. Ramos,4400168,,True,39.0,9,18,6,11,3,7,1,1,1,1,2,7,2,0,2,2,22
401262776,San Diego State Aztecs,M. Staples,4398925,,True,34.0,8,13,4,8,4,5,0,0,0,3,3,3,1,0,1,2,20
401262776,San Diego State Aztecs,T. Adams,4281876,,True,27.0,3,7,2,3,1,4,4,4,1,5,6,6,3,0,3,1,11
401262776,San Diego State Aztecs,F. Vinerte,4704564,,False,9.0,1,3,1,3,0,0,0,0,1,1,2,2,0,0,1,1,2
401262776,San Diego State Aztecs,K. Edwards,4281879,,False,5.0,1,3,1,3,0,0,0,0,1,1,2,0,0,0,0,1,2
401262776,San Diego State Aztecs,K. Villalobos,4704565,,False,7.0,0,4,0,4,0,0,0,0,0,2,2,0,0,0,0,0,0
401262776,San Diego State Aztecs,I. Hernandez,4595647,,False,12.0,0,1,0,1,0,0,0,0,0,0,0,0,0,0,1,0,0
401262776,San Diego State Aztecs,A. Crain,4399223,,False,16.0,3,5,2,3,1,2,0,0,0,1,1,1,1,0,0,1,7
401262776,San Diego State Aztecs,TEAM,TOTAL,TOTAL,False,,32,68,22,45,10,23,5,7,8,25,33,21,8,1,9,12,79
401262776,Fresno State Bulldogs,W. Motta,4595631,,True,16.0,1,3,1,3,0,0,0,0,1,1,2,0,0,0,1,2,2
401262776,Fresno State Bulldogs,M. Utti,4281828,,True,36.0,2,7,2,5,0,2,4,5,0,6,6,1,0,0,0,1,8
401262776,Fresno State Bulldogs,Hal. Cavinder,4433658,,True,36.0,10,18,4,10,6,8,1,1,0,4,4,2,1,0,4,3,27
401262776,Fresno State Bulldogs,Han. Cavinder,4433372,,True,34.0,4,15,4,9,0,6,2,2,2,4,6,6,1,0,2,4,10
401262776,Fresno State Bulldogs,A. Gamez,4281826,,True,30.0,2,5,0,1,2,4,2,2,1,7,8,4,1,0,2,1,8
401262776,Fresno State Bulldogs,K. Kinzer,4595630,,False,11.0,3,4,1,1,2,3,0,0,1,1,2,0,1,1,0,0,8
401262776,Fresno State Bulldogs,B. Walling,4595632,,False,21.0,3,9,1,5,2,4,3,4,2,2,4,0,1,0,1,1,11
401262776,Fresno State Bulldogs,K. Brown,4704473,,False,3.0,0,0,0,0,0,0,0,0,0,0,0,1,0,0,1,0,0
401262776,Fresno State Bulldogs,B. Delaney,4281825,,False,15.0,1,2,0,0,1,2,0,0,0,1,1,1,1,0,2,1,3
401262776,Fresno State Bulldogs,TEAM,TOTAL,TOTAL,False,,26,63,13,34,13,29,12,14,8,28,36,15,6,1,13,13,77
401262776,Fresno State Bulldogs,W. Motta,4595631,,True,16.0,1,3,1,3,0,0,0,0,1,1,2,0,0,0,1,2,2
401262776,Fresno State Bulldogs,M. Utti,4281828,,True,36.0,2,7,2,5,0,2,4,5,0,6,6,1,0,0,0,1,8
401262776,Fresno State Bulldogs,Hal. Cavinder,4433658,,True,36.0,10,18,4,10,6,8,1,1,0,4,4,2,1,0,4,3,27
401262776,Fresno State Bulldogs,Han. Cavinder,4433372,,True,34.0,4,15,4,9,0,6,2,2,2,4,6,6,1,0,2,4,10
401262776,Fresno State Bulldogs,A. Gamez,4281826,,True,30.0,2,5,0,1,2,4,2,2,1,7,8,4,1,0,2,1,8
401262776,Fresno State Bulldogs,K. Kinzer,4595630,,False,11.0,3,4,1,1,2,3,0,0,1,1,2,0,1,1,0,0,8
401262776,Fresno State Bulldogs,B. Walling,4595632,,False,21.0,3,9,1,5,2,4,3,4,2,2,4,0,1,0,1,1,11
401262776,Fresno State Bulldogs,K. Brown,4704473,,False,3.0,0,0,0,0,0,0,0,0,0,0,0,1,0,0,1,0,0
401262776,Fresno State Bulldogs,B. Delaney,4281825,,False,15.0,1,2,0,0,1,2,0,0,0,1,1,1,1,0,2,1,3
401262776,Fresno State Bulldogs,TEAM,TOTAL,TOTAL,False,,26,63,13,34,13,29,12,14,8,28,36,15,6,1,13,13,77
401262775,San Diego State Aztecs,K. Gipson,4704563,,True,23.0,2,6,2,6,0,0,1,1,3,8,11,0,0,0,2,3,5
401262775,San Diego State Aztecs,M. Adams,4400169,,True,28.0,6,10,3,3,3,7,0,0,1,4,5,0,2,0,1,0,15
401262775,San Diego State Aztecs,S. Ramos,4400168,,True,30.0,5,14,5,13,0,1,2,2,2,0,2,3,1,0,5,1,12
401262775,San Diego State Aztecs,M. Staples,4398925,,True,27.0,3,12,2,7,1,5,0,0,0,3,3,2,0,0,0,0,7
401262775,San Diego State Aztecs,T. Adams,4281876,,True,32.0,1,5,1,3,0,2,2,2,0,2,2,3,0,0,5,2,4
401262775,San Diego State Aztecs,F. Vinerte,4704564,,False,13.0,2,6,2,6,0,0,0,1,3,3,6,0,0,0,0,2,4
401262775,San Diego State Aztecs,K. Villalobos,4704565,,False,15.0,4,6,4,6,0,0,1,2,4,2,6,1,0,0,0,2,9
401262775,San Diego State Aztecs,I. Hernandez,4595647,,False,17.0,2,7,1,3,1,4,0,0,0,2,2,0,0,0,1,0,5
401262775,San Diego State Aztecs,A. Crain,4399223,,False,15.0,0,3,0,1,0,2,0,0,0,2,2,2,0,0,1,1,0
401262775,San Diego State Aztecs,TEAM,TOTAL,TOTAL,False,,25,69,20,48,5,21,6,8,14,26,40,11,3,0,15,11,61
401262775,San Diego State Aztecs,K. Gipson,4704563,,True,23.0,2,6,2,6,0,0,1,1,3,8,11,0,0,0,2,3,5
401262775,San Diego State Aztecs,M. Adams,4400169,,True,28.0,6,10,3,3,3,7,0,0,1,4,5,0,2,0,1,0,15
401262775,San Diego State Aztecs,S. Ramos,4400168,,True,30.0,5,14,5,13,0,1,2,2,2,0,2,3,1,0,5,1,12
401262775,San Diego State Aztecs,M. Staples,4398925,,True,27.0,3,12,2,7,1,5,0,0,0,3,3,2,0,0,0,0,7
401262775,San Diego State Aztecs,T. Adams,4281876,,True,32.0,1,5,1,3,0,2,2,2,0,2,2,3,0,0,5,2,4
401262775,San Diego State Aztecs,F. Vinerte,4704564,,False,13.0,2,6,2,6,0,0,0,1,3,3,6,0,0,0,0,2,4
401262775,San Diego State Aztecs,K. Villalobos,4704565,,False,15.0,4,6,4,6,0,0,1,2,4,2,6,1,0,0,0,2,9
401262775,San Diego State Aztecs,I. Hernandez,4595647,,False,17.0,2,7,1,3,1,4,0,0,0,2,2,0,0,0,1,0,5
401262775,San Diego State Aztecs,A. Crain,4399223,,False,15.0,0,3,0,1,0,2,0,0,0,2,2,2,0,0,1,1,0
401262775,San Diego State Aztecs,TEAM,TOTAL,TOTAL,False,,25,69,20,48,5,21,6,8,14,26,40,11,3,0,15,11,61
401262775,Fresno State Bulldogs,W. Motta,4595631,,True,21.0,3,8,3,8,0,0,1,3,0,3,3,0,0,0,0,1,7
401262775,Fresno State Bulldogs,M. Utti,4281828,,True,38.0,9,13,8,10,1,3,0,0,1,6,7,4,3,1,1,0,19
401262775,Fresno State Bulldogs,Hal. Cavinder,4433658,,True,36.0,9,17,7,10,2,7,3,3,1,5,6,4,5,2,0,0,23
401262775,Fresno State Bulldogs,Han. Cavinder,4433372,,True,35.0,5,13,5,10,0,3,4,4,0,4,4,2,2,0,5,4,14
401262775,Fresno State Bulldogs,A. Gamez,4281826,,True,27.0,3,4,2,3,1,1,0,0,1,1,2,5,1,0,1,2,7
401262775,Fresno State Bulldogs,K. Kinzer,4595630,,False,23.0,2,4,0,0,2,4,0,0,0,2,2,0,0,1,0,0,6
401262775,Fresno State Bulldogs,G. Ogier,4281827,,False,2.0,0,0,0,0,0,0,0,0,0,0,0,0,0,0,0,0,0
401262775,Fresno State Bulldogs,M. Guimaraes,4704476,,False,4.0,0,1,0,1,0,0,0,0,0,2,2,0,0,0,1,1,0
401262775,Fresno State Bulldogs,B. Walling,4595632,,False,2.0,1,1,1,1,0,0,0,0,0,1,1,0,0,0,0,0,2
401262775,Fresno State Bulldogs,Y. Todorova,4704475,,False,2.0,0,0,0,0,0,0,0,0,0,0,0,0,0,0,0,0,0
401262775,Fresno State Bulldogs,K. Brown,4704473,,False,3.0,0,0,0,0,0,0,2,2,0,1,1,0,0,0,0,0,2
401262775,Fresno State Bulldogs,B. Delaney,4281825,,False,6.0,0,1,0,0,0,1,2,2,0,3,3,0,0,0,1,2,2
401262775,Fresno State Bulldogs,TEAM,TOTAL,TOTAL,False,,32,62,26,43,6,19,12,14,4,30,34,15,11,4,9,10,82
401262775,Fresno State Bulldogs,W. Motta,4595631,,True,21.0,3,8,3,8,0,0,1,3,0,3,3,0,0,0,0,1,7
401262775,Fresno State Bulldogs,M. Utti,4281828,,True,38.0,9,13,8,10,1,3,0,0,1,6,7,4,3,1,1,0,19
401262775,Fresno State Bulldogs,Hal. Cavinder,4433658,,True,36.0,9,17,7,10,2,7,3,3,1,5,6,4,5,2,0,0,23
401262775,Fresno State Bulldogs,Han. Cavinder,4433372,,True,35.0,5,13,5,10,0,3,4,4,0,4,4,2,2,0,5,4,14
401262775,Fresno State Bulldogs,A. Gamez,4281826,,True,27.0,3,4,2,3,1,1,0,0,1,1,2,5,1,0,1,2,7
401262775,Fresno State Bulldogs,K. Kinzer,4595630,,False,23.0,2,4,0,0,2,4,0,0,0,2,2,0,0,1,0,0,6
401262775,Fresno State Bulldogs,G. Ogier,4281827,,False,2.0,0,0,0,0,0,0,0,0,0,0,0,0,0,0,0,0,0
401262775,Fresno State Bulldogs,M. Guimaraes,4704476,,False,4.0,0,1,0,1,0,0,0,0,0,2,2,0,0,0,1,1,0
401262775,Fresno State Bulldogs,B. Walling,4595632,,False,2.0,1,1,1,1,0,0,0,0,0,1,1,0,0,0,0,0,2
401262775,Fresno State Bulldogs,Y. Todorova,4704475,,False,2.0,0,0,0,0,0,0,0,0,0,0,0,0,0,0,0,0,0
401262775,Fresno State Bulldogs,K. Brown,4704473,,False,3.0,0,0,0,0,0,0,2,2,0,1,1,0,0,0,0,0,2
401262775,Fresno State Bulldogs,B. Delaney,4281825,,False,6.0,0,1,0,0,0,1,2,2,0,3,3,0,0,0,1,2,2
401262775,Fresno State Bulldogs,TEAM,TOTAL,TOTAL,False,,32,62,26,43,6,19,12,14,4,30,34,15,11,4,9,10,82
401262774,Utah State Aggies,J. Chatman,4068281,,True,36.0,10,18,10,17,0,1,6,7,0,2,2,1,1,0,1,0,26
401262774,Utah State Aggies,K. Kamakawiwo'ole,4595670,,True,28.0,4,9,3,7,1,2,0,0,0,1,1,7,0,1,2,1,9
401262774,Utah State Aggies,F. Brantley,4595669,,True,30.0,1,3,1,3,0,0,0,0,0,2,2,7,2,0,1,3,2
401262774,Utah State Aggies,S. Latone,4399209,,True,36.0,6,13,3,6,3,7,0,1,1,4,5,4,0,0,2,1,15
401262774,Utah State Aggies,E. Harris,4281891,,True,12.0,0,1,0,0,0,1,0,0,1,1,2,3,0,0,2,2,0
401262774,Utah State Aggies,E. Jarrell,4704653,,False,2.0,0,1,0,1,0,0,0,0,0,0,0,0,0,0,0,1,0
401262774,Utah State Aggies,T. Franson,4281892,,False,10.0,2,3,2,3,0,0,0,0,1,3,4,1,0,0,0,2,4
401262774,Utah State Aggies,H. Nelson,4704652,,False,17.0,4,4,4,4,0,0,2,2,3,3,6,1,0,0,0,1,10
401262774,Utah State Aggies,K. Falslev,4704648,,False,12.0,5,8,1,2,4,6,0,0,0,1,1,1,0,0,0,0,14
401262774,Utah State Aggies,M. Mendazona,4704647,,False,15.0,2,4,2,3,0,1,1,2,2,2,4,4,1,0,2,2,5
401262774,Utah State Aggies,J. Polansky,4595673,,False,0.0,0,0,0,0,0,0,0,0,0,0,0,0,0,0,0,0,0
401262774,Utah State Aggies,E. Emrich,4595671,,False,2.0,0,0,0,0,0,0,0,0,0,0,0,0,0,0,0,0,0
401262774,Utah State Aggies,TEAM,TOTAL,TOTAL,False,,34,64,26,46,8,18,9,12,8,22,30,29,4,1,10,13,85
401262774,Utah State Aggies,J. Chatman,4068281,,True,36.0,10,18,10,17,0,1,6,7,0,2,2,1,1,0,1,0,26
401262774,Utah State Aggies,K. Kamakawiwo'ole,4595670,,True,28.0,4,9,3,7,1,2,0,0,0,1,1,7,0,1,2,1,9
401262774,Utah State Aggies,F. Brantley,4595669,,True,30.0,1,3,1,3,0,0,0,0,0,2,2,7,2,0,1,3,2
401262774,Utah State Aggies,S. Latone,4399209,,True,36.0,6,13,3,6,3,7,0,1,1,4,5,4,0,0,2,1,15
401262774,Utah State Aggies,E. Harris,4281891,,True,12.0,0,1,0,0,0,1,0,0,1,1,2,3,0,0,2,2,0
401262774,Utah State Aggies,E. Jarrell,4704653,,False,2.0,0,1,0,1,0,0,0,0,0,0,0,0,0,0,0,1,0
401262774,Utah State Aggies,T. Franson,4281892,,False,10.0,2,3,2,3,0,0,0,0,1,3,4,1,0,0,0,2,4
401262774,Utah State Aggies,H. Nelson,4704652,,False,17.0,4,4,4,4,0,0,2,2,3,3,6,1,0,0,0,1,10
401262774,Utah State Aggies,K. Falslev,4704648,,False,12.0,5,8,1,2,4,6,0,0,0,1,1,1,0,0,0,0,14
401262774,Utah State Aggies,M. Mendazona,4704647,,False,15.0,2,4,2,3,0,1,1,2,2,2,4,4,1,0,2,2,5
401262774,Utah State Aggies,J. Polansky,4595673,,False,0.0,0,0,0,0,0,0,0,0,0,0,0,0,0,0,0,0,0
401262774,Utah State Aggies,E. Emrich,4595671,,False,2.0,0,0,0,0,0,0,0,0,0,0,0,0,0,0,0,0,0
401262774,Utah State Aggies,TEAM,TOTAL,TOTAL,False,,34,64,26,46,8,18,9,12,8,22,30,29,4,1,10,13,85
401262774,Fresno State Bulldogs,W. Motta,4595631,,True,10.0,2,5,2,5,0,0,4,6,3,2,5,0,0,0,0,3,8
401262774,Fresno State Bulldogs,M. Utti,4281828,,True,28.0,7,12,6,11,1,1,1,2,4,2,6,7,2,2,0,1,16
401262774,Fresno State Bulldogs,Hal. Cavinder,4433658,,True,38.0,9,17,6,11,3,6,0,0,2,3,5,5,0,0,2,0,21
401262774,Fresno State Bulldogs,Han. Cavinder,4433372,,True,28.0,8,15,6,9,2,6,3,3,0,2,2,5,0,0,3,2,21
401262774,Fresno State Bulldogs,A. Gamez,4281826,,True,21.0,4,8,1,3,3,5,2,2,2,1,3,5,3,0,0,1,13
401262774,Fresno State Bulldogs,C. Fairley,4704474,,False,1.0,0,0,0,0,0,0,0,0,0,1,1,0,0,0,0,0,0
401262774,Fresno State Bulldogs,K. Kinzer,4595630,,False,13.0,0,5,0,1,0,4,0,0,1,1,2,0,0,0,0,2,0
401262774,Fresno State Bulldogs,A. James,4433292,,False,1.0,0,0,0,0,0,0,0,0,0,0,0,0,0,0,1,0,0
401262774,Fresno State Bulldogs,G. Ogier,4281827,,False,1.0,0,0,0,0,0,0,0,0,0,0,0,0,0,0,0,0,0
401262774,Fresno State Bulldogs,M. Guimaraes,4704476,,False,5.0,0,2,0,2,0,0,0,0,0,0,0,0,0,0,0,0,0
401262774,Fresno State Bulldogs,B. Walling,4595632,,False,23.0,2,3,2,3,0,0,1,1,3,6,9,0,1,2,1,0,5
401262774,Fresno State Bulldogs,Y. Todorova,4704475,,False,5.0,0,1,0,1,0,0,0,0,0,0,0,0,0,0,1,1,0
401262774,Fresno State Bulldogs,K. Brown,4704473,,False,5.0,0,2,0,1,0,1,0,0,0,0,0,1,0,0,0,0,0
401262774,Fresno State Bulldogs,D. Dunn,4433511,,False,5.0,2,3,2,2,0,1,0,0,0,0,0,0,0,0,0,0,4
401262774,Fresno State Bulldogs,B. Delaney,4281825,,False,16.0,2,3,1,1,1,2,0,0,1,4,5,3,0,0,0,1,5
401262774,Fresno State Bulldogs,TEAM,TOTAL,TOTAL,False,,36,76,26,50,10,26,11,14,19,23,42,26,6,4,11,11,93
401262774,Fresno State Bulldogs,W. Motta,4595631,,True,10.0,2,5,2,5,0,0,4,6,3,2,5,0,0,0,0,3,8
401262774,Fresno State Bulldogs,M. Utti,4281828,,True,28.0,7,12,6,11,1,1,1,2,4,2,6,7,2,2,0,1,16
401262774,Fresno State Bulldogs,Hal. Cavinder,4433658,,True,38.0,9,17,6,11,3,6,0,0,2,3,5,5,0,0,2,0,21
401262774,Fresno State Bulldogs,Han. Cavinder,4433372,,True,28.0,8,15,6,9,2,6,3,3,0,2,2,5,0,0,3,2,21
401262774,Fresno State Bulldogs,A. Gamez,4281826,,True,21.0,4,8,1,3,3,5,2,2,2,1,3,5,3,0,0,1,13
401262774,Fresno State Bulldogs,C. Fairley,4704474,,False,1.0,0,0,0,0,0,0,0,0,0,1,1,0,0,0,0,0,0
401262774,Fresno State Bulldogs,K. Kinzer,4595630,,False,13.0,0,5,0,1,0,4,0,0,1,1,2,0,0,0,0,2,0
401262774,Fresno State Bulldogs,A. James,4433292,,False,1.0,0,0,0,0,0,0,0,0,0,0,0,0,0,0,1,0,0
401262774,Fresno State Bulldogs,G. Ogier,4281827,,False,1.0,0,0,0,0,0,0,0,0,0,0,0,0,0,0,0,0,0
401262774,Fresno State Bulldogs,M. Guimaraes,4704476,,False,5.0,0,2,0,2,0,0,0,0,0,0,0,0,0,0,0,0,0
401262774,Fresno State Bulldogs,B. Walling,4595632,,False,23.0,2,3,2,3,0,0,1,1,3,6,9,0,1,2,1,0,5
401262774,Fresno State Bulldogs,Y. Todorova,4704475,,False,5.0,0,1,0,1,0,0,0,0,0,0,0,0,0,0,1,1,0
401262774,Fresno State Bulldogs,K. Brown,4704473,,False,5.0,0,2,0,1,0,1,0,0,0,0,0,1,0,0,0,0,0
401262774,Fresno State Bulldogs,D. Dunn,4433511,,False,5.0,2,3,2,2,0,1,0,0,0,0,0,0,0,0,0,0,4
401262774,Fresno State Bulldogs,B. Delaney,4281825,,False,16.0,2,3,1,1,1,2,0,0,1,4,5,3,0,0,0,1,5
401262774,Fresno State Bulldogs,TEAM,TOTAL,TOTAL,False,,36,76,26,50,10,26,11,14,19,23,42,26,6,4,11,11,93
401262773,Utah State Aggies,J. Chatman,4068281,,True,32.0,6,13,6,13,0,0,1,2,5,6,11,0,0,0,0,0,13
401262773,Utah State Aggies,E. Emrich,4595671,,True,12.0,1,2,1,1,0,1,1,2,0,0,0,0,0,0,1,2,3
401262773,Utah State Aggies,K. Kamakawiwo'ole,4595670,,True,21.0,4,13,3,11,1,2,0,0,1,5,6,4,0,2,1,2,9
401262773,Utah State Aggies,F. Brantley,4595669,,True,25.0,4,4,3,3,1,1,1,1,0,2,2,1,1,0,6,3,10
401262773,Utah State Aggies,S. Latone,4399209,,True,36.0,3,17,2,10,1,7,1,2,3,6,9,7,0,0,3,0,8
401262773,Utah State Aggies,T. Franson,4281892,,False,8.0,0,1,0,1,0,0,1,2,0,0,0,0,1,0,0,1,1
401262773,Utah State Aggies,H. Nelson,4704652,,False,15.0,2,6,1,5,1,1,0,0,1,3,4,0,0,1,2,0,5
401262773,Utah State Aggies,K. Falslev,4704648,,False,9.0,1,4,0,0,1,4,0,0,1,0,1,0,0,0,0,0,3
401262773,Utah State Aggies,M. Mendazona,4704647,,False,16.0,0,4,0,2,0,2,0,0,0,3,3,1,0,0,0,0,0
401262773,Utah State Aggies,E. Harris,4281891,,False,26.0,4,11,2,7,2,4,0,1,1,3,4,3,1,0,1,3,10
401262773,Utah State Aggies,TEAM,TOTAL,TOTAL,False,,25,75,18,53,7,22,5,10,13,30,43,16,3,3,14,11,62
401262773,Utah State Aggies,J. Chatman,4068281,,True,32.0,6,13,6,13,0,0,1,2,5,6,11,0,0,0,0,0,13
401262773,Utah State Aggies,E. Emrich,4595671,,True,12.0,1,2,1,1,0,1,1,2,0,0,0,0,0,0,1,2,3
401262773,Utah State Aggies,K. Kamakawiwo'ole,4595670,,True,21.0,4,13,3,11,1,2,0,0,1,5,6,4,0,2,1,2,9
401262773,Utah State Aggies,F. Brantley,4595669,,True,25.0,4,4,3,3,1,1,1,1,0,2,2,1,1,0,6,3,10
401262773,Utah State Aggies,S. Latone,4399209,,True,36.0,3,17,2,10,1,7,1,2,3,6,9,7,0,0,3,0,8
401262773,Utah State Aggies,T. Franson,4281892,,False,8.0,0,1,0,1,0,0,1,2,0,0,0,0,1,0,0,1,1
401262773,Utah State Aggies,H. Nelson,4704652,,False,15.0,2,6,1,5,1,1,0,0,1,3,4,0,0,1,2,0,5
401262773,Utah State Aggies,K. Falslev,4704648,,False,9.0,1,4,0,0,1,4,0,0,1,0,1,0,0,0,0,0,3
401262773,Utah State Aggies,M. Mendazona,4704647,,False,16.0,0,4,0,2,0,2,0,0,0,3,3,1,0,0,0,0,0
401262773,Utah State Aggies,E. Harris,4281891,,False,26.0,4,11,2,7,2,4,0,1,1,3,4,3,1,0,1,3,10
401262773,Utah State Aggies,TEAM,TOTAL,TOTAL,False,,25,75,18,53,7,22,5,10,13,30,43,16,3,3,14,11,62
401262773,Fresno State Bulldogs,W. Motta,4595631,,True,11.0,3,4,3,4,0,0,1,2,0,3,3,0,0,0,0,2,7
401262773,Fresno State Bulldogs,M. Utti,4281828,,True,29.0,7,11,5,8,2,3,0,0,1,6,7,5,1,0,2,1,16
401262773,Fresno State Bulldogs,Hal. Cavinder,4433658,,True,34.0,3,16,3,11,0,5,5,6,2,12,14,6,4,0,2,1,11
401262773,Fresno State Bulldogs,Han. Cavinder,4433372,,True,29.0,7,12,4,7,3,5,1,2,1,3,4,7,3,0,2,2,18
401262773,Fresno State Bulldogs,A. Gamez,4281826,,True,21.0,2,2,1,1,1,1,0,0,0,1,1,1,0,0,1,3,5
401262773,Fresno State Bulldogs,C. Fairley,4704474,,False,1.0,1,3,1,1,0,2,0,0,0,0,0,0,0,0,0,0,2
401262773,Fresno State Bulldogs,K. Kinzer,4595630,,False,17.0,2,8,1,2,1,6,1,1,0,4,4,0,0,2,0,0,6
401262773,Fresno State Bulldogs,G. Ogier,4281827,,False,2.0,0,0,0,0,0,0,0,0,2,0,2,1,0,0,0,0,0
401262773,Fresno State Bulldogs,M. Guimaraes,4704476,,False,2.0,0,0,0,0,0,0,1,2,0,0,0,0,0,0,0,0,1
401262773,Fresno State Bulldogs,B. Walling,4595632,,False,22.0,3,3,3,3,0,0,0,0,1,3,4,1,0,0,2,2,6
401262773,Fresno State Bulldogs,Y. Todorova,4704475,,False,5.0,0,1,0,0,0,1,0,0,0,0,0,2,0,0,0,0,0
401262773,Fresno State Bulldogs,K. Brown,4704473,,False,10.0,2,2,2,2,0,0,0,0,0,1,1,0,0,0,1,1,4
401262773,Fresno State Bulldogs,D. Dunn,4433511,,False,2.0,0,1,0,1,0,0,0,0,0,0,0,0,1,0,0,0,0
401262773,Fresno State Bulldogs,B. Delaney,4281825,,False,15.0,5,8,2,3,3,5,1,2,0,5,5,2,0,0,0,1,14
401262773,Fresno State Bulldogs,TEAM,TOTAL,TOTAL,False,,35,71,25,43,10,28,10,15,9,41,50,25,9,2,10,13,90
401262773,Fresno State Bulldogs,W. Motta,4595631,,True,11.0,3,4,3,4,0,0,1,2,0,3,3,0,0,0,0,2,7
401262773,Fresno State Bulldogs,M. Utti,4281828,,True,29.0,7,11,5,8,2,3,0,0,1,6,7,5,1,0,2,1,16
401262773,Fresno State Bulldogs,Hal. Cavinder,4433658,,True,34.0,3,16,3,11,0,5,5,6,2,12,14,6,4,0,2,1,11
401262773,Fresno State Bulldogs,Han. Cavinder,4433372,,True,29.0,7,12,4,7,3,5,1,2,1,3,4,7,3,0,2,2,18
401262773,Fresno State Bulldogs,A. Gamez,4281826,,True,21.0,2,2,1,1,1,1,0,0,0,1,1,1,0,0,1,3,5
401262773,Fresno State Bulldogs,C. Fairley,4704474,,False,1.0,1,3,1,1,0,2,0,0,0,0,0,0,0,0,0,0,2
401262773,Fresno State Bulldogs,K. Kinzer,4595630,,False,17.0,2,8,1,2,1,6,1,1,0,4,4,0,0,2,0,0,6
401262773,Fresno State Bulldogs,G. Ogier,4281827,,False,2.0,0,0,0,0,0,0,0,0,2,0,2,1,0,0,0,0,0
401262773,Fresno State Bulldogs,M. Guimaraes,4704476,,False,2.0,0,0,0,0,0,0,1,2,0,0,0,0,0,0,0,0,1
401262773,Fresno State Bulldogs,B. Walling,4595632,,False,22.0,3,3,3,3,0,0,0,0,1,3,4,1,0,0,2,2,6
401262773,Fresno State Bulldogs,Y. Todorova,4704475,,False,5.0,0,1,0,0,0,1,0,0,0,0,0,2,0,0,0,0,0
401262773,Fresno State Bulldogs,K. Brown,4704473,,False,10.0,2,2,2,2,0,0,0,0,0,1,1,0,0,0,1,1,4
401262773,Fresno State Bulldogs,D. Dunn,4433511,,False,2.0,0,1,0,1,0,0,0,0,0,0,0,0,1,0,0,0,0
401262773,Fresno State Bulldogs,B. Delaney,4281825,,False,15.0,5,8,2,3,3,5,1,2,0,5,5,2,0,0,0,1,14
401262773,Fresno State Bulldogs,TEAM,TOTAL,TOTAL,False,,35,71,25,43,10,28,10,15,9,41,50,25,9,2,10,13,90
401262772,New Mexico Lobos,S. McGruder,4400149,,True,31.0,7,8,7,8,0,0,0,0,2,1,3,2,0,0,0,1,14
401262772,New Mexico Lobos,A. Anderson,4281834,,True,25.0,4,7,4,7,0,0,0,0,2,3,5,4,0,2,2,5,8
401262772,New Mexico Lobos,Lato. Duff,4704520,,True,25.0,3,6,2,3,1,3,2,2,0,4,4,3,3,0,1,1,9
401262772,New Mexico Lobos,A. Hurst,4400147,,True,25.0,3,13,1,3,2,10,0,0,0,2,2,4,0,0,3,2,8
401262772,New Mexico Lobos,J. De La Cerda,4281833,,True,35.0,6,22,4,13,2,9,0,0,2,6,8,2,3,0,3,3,14
401262772,New Mexico Lobos,C. Dupont,4595646,,False,2.0,0,1,0,0,0,1,0,0,0,0,0,1,1,0,0,0,0
401262772,New Mexico Lobos,A. Watts,4433688,,False,12.0,3,3,3,3,0,0,0,0,0,0,0,0,0,0,2,0,6
401262772,New Mexico Lobos,A. Robinson,4432993,,False,4.0,0,0,0,0,0,0,0,0,0,1,1,0,0,0,0,2,0
401262772,New Mexico Lobos,N. Parkinson,4704523,,False,1.0,0,0,0,0,0,0,0,0,0,0,0,0,0,0,0,0,0
401262772,New Mexico Lobos,K. van Bennekom,4704522,,False,3.0,0,1,0,0,0,1,0,0,0,1,1,0,0,0,0,0,0
401262772,New Mexico Lobos,Lata. Duff,4704519,,False,22.0,2,9,1,3,1,6,0,0,2,2,4,1,0,0,1,1,5
401262772,New Mexico Lobos,C. Carter,4433646,,False,15.0,2,6,1,2,1,4,0,1,0,1,1,1,0,0,1,0,5
401262772,New Mexico Lobos,TEAM,TOTAL,TOTAL,False,,30,76,23,42,7,34,2,3,12,22,34,18,7,2,13,15,69
401262772,New Mexico Lobos,S. McGruder,4400149,,True,31.0,7,8,7,8,0,0,0,0,2,1,3,2,0,0,0,1,14
401262772,New Mexico Lobos,A. Anderson,4281834,,True,25.0,4,7,4,7,0,0,0,0,2,3,5,4,0,2,2,5,8
401262772,New Mexico Lobos,Lato. Duff,4704520,,True,25.0,3,6,2,3,1,3,2,2,0,4,4,3,3,0,1,1,9
401262772,New Mexico Lobos,A. Hurst,4400147,,True,25.0,3,13,1,3,2,10,0,0,0,2,2,4,0,0,3,2,8
401262772,New Mexico Lobos,J. De La Cerda,4281833,,True,35.0,6,22,4,13,2,9,0,0,2,6,8,2,3,0,3,3,14
401262772,New Mexico Lobos,C. Dupont,4595646,,False,2.0,0,1,0,0,0,1,0,0,0,0,0,1,1,0,0,0,0
401262772,New Mexico Lobos,A. Watts,4433688,,False,12.0,3,3,3,3,0,0,0,0,0,0,0,0,0,0,2,0,6
401262772,New Mexico Lobos,A. Robinson,4432993,,False,4.0,0,0,0,0,0,0,0,0,0,1,1,0,0,0,0,2,0
401262772,New Mexico Lobos,N. Parkinson,4704523,,False,1.0,0,0,0,0,0,0,0,0,0,0,0,0,0,0,0,0,0
401262772,New Mexico Lobos,K. van Bennekom,4704522,,False,3.0,0,1,0,0,0,1,0,0,0,1,1,0,0,0,0,0,0
401262772,New Mexico Lobos,Lata. Duff,4704519,,False,22.0,2,9,1,3,1,6,0,0,2,2,4,1,0,0,1,1,5
401262772,New Mexico Lobos,C. Carter,4433646,,False,15.0,2,6,1,2,1,4,0,1,0,1,1,1,0,0,1,0,5
401262772,New Mexico Lobos,TEAM,TOTAL,TOTAL,False,,30,76,23,42,7,34,2,3,12,22,34,18,7,2,13,15,69
401262772,Fresno State Bulldogs,W. Motta,4595631,,True,10.0,1,2,1,2,0,0,1,2,1,2,3,0,0,0,1,2,3
401262772,Fresno State Bulldogs,M. Utti,4281828,,True,29.0,5,9,4,6,1,3,1,2,1,4,5,3,2,0,2,0,12
401262772,Fresno State Bulldogs,Hal. Cavinder,4433658,,True,35.0,8,15,5,8,3,7,2,3,4,10,14,6,1,1,3,2,21
401262772,Fresno State Bulldogs,Han. Cavinder,4433372,,True,32.0,5,10,5,9,0,1,3,4,0,4,4,5,3,0,4,2,13
401262772,Fresno State Bulldogs,A. Gamez,4281826,,True,17.0,2,4,2,2,0,2,0,0,0,0,0,2,0,1,0,1,4
401262772,Fresno State Bulldogs,C. Fairley,4704474,,False,2.0,1,2,1,1,0,1,0,0,0,0,0,0,0,0,0,0,2
401262772,Fresno State Bulldogs,K. Kinzer,4595630,,False,27.0,3,7,0,0,3,7,0,0,0,1,1,2,0,0,0,0,9
401262772,Fresno State Bulldogs,A. James,4433292,,False,3.0,0,0,0,0,0,0,2,2,0,1,1,0,0,0,2,0,2
401262772,Fresno State Bulldogs,G. Ogier,4281827,,False,2.0,0,0,0,0,0,0,0,0,0,1,1,0,0,0,0,0,0
401262772,Fresno State Bulldogs,M. Guimaraes,4704476,,False,1.0,0,0,0,0,0,0,0,0,0,0,0,0,0,0,0,0,0
401262772,Fresno State Bulldogs,B. Walling,4595632,,False,11.0,2,2,2,2,0,0,0,0,1,1,2,0,0,0,2,0,4
401262772,Fresno State Bulldogs,Y. Todorova,4704475,,False,4.0,0,1,0,1,0,0,0,0,0,0,0,1,0,0,0,1,0
401262772,Fresno State Bulldogs,K. Brown,4704473,,False,4.0,0,0,0,0,0,0,2,2,0,0,0,0,0,0,1,0,2
401262772,Fresno State Bulldogs,D. Dunn,4433511,,False,3.0,0,0,0,0,0,0,0,0,0,1,1,0,0,0,0,1,0
401262772,Fresno State Bulldogs,B. Delaney,4281825,,False,20.0,7,8,3,3,4,5,1,2,1,3,4,1,3,1,1,1,19
401262772,Fresno State Bulldogs,TEAM,TOTAL,TOTAL,False,,34,60,23,34,11,26,12,17,8,35,43,20,9,3,16,10,91
401262772,Fresno State Bulldogs,W. Motta,4595631,,True,10.0,1,2,1,2,0,0,1,2,1,2,3,0,0,0,1,2,3
401262772,Fresno State Bulldogs,M. Utti,4281828,,True,29.0,5,9,4,6,1,3,1,2,1,4,5,3,2,0,2,0,12
401262772,Fresno State Bulldogs,Hal. Cavinder,4433658,,True,35.0,8,15,5,8,3,7,2,3,4,10,14,6,1,1,3,2,21
401262772,Fresno State Bulldogs,Han. Cavinder,4433372,,True,32.0,5,10,5,9,0,1,3,4,0,4,4,5,3,0,4,2,13
401262772,Fresno State Bulldogs,A. Gamez,4281826,,True,17.0,2,4,2,2,0,2,0,0,0,0,0,2,0,1,0,1,4
401262772,Fresno State Bulldogs,C. Fairley,4704474,,False,2.0,1,2,1,1,0,1,0,0,0,0,0,0,0,0,0,0,2
401262772,Fresno State Bulldogs,K. Kinzer,4595630,,False,27.0,3,7,0,0,3,7,0,0,0,1,1,2,0,0,0,0,9
401262772,Fresno State Bulldogs,A. James,4433292,,False,3.0,0,0,0,0,0,0,2,2,0,1,1,0,0,0,2,0,2
401262772,Fresno State Bulldogs,G. Ogier,4281827,,False,2.0,0,0,0,0,0,0,0,0,0,1,1,0,0,0,0,0,0
401262772,Fresno State Bulldogs,M. Guimaraes,4704476,,False,1.0,0,0,0,0,0,0,0,0,0,0,0,0,0,0,0,0,0
401262772,Fresno State Bulldogs,B. Walling,4595632,,False,11.0,2,2,2,2,0,0,0,0,1,1,2,0,0,0,2,0,4
401262772,Fresno State Bulldogs,Y. Todorova,4704475,,False,4.0,0,1,0,1,0,0,0,0,0,0,0,1,0,0,0,1,0
401262772,Fresno State Bulldogs,K. Brown,4704473,,False,4.0,0,0,0,0,0,0,2,2,0,0,0,0,0,0,1,0,2
401262772,Fresno State Bulldogs,D. Dunn,4433511,,False,3.0,0,0,0,0,0,0,0,0,0,1,1,0,0,0,0,1,0
401262772,Fresno State Bulldogs,B. Delaney,4281825,,False,20.0,7,8,3,3,4,5,1,2,1,3,4,1,3,1,1,1,19
401262772,Fresno State Bulldogs,TEAM,TOTAL,TOTAL,False,,34,60,23,34,11,26,12,17,8,35,43,20,9,3,16,10,91
401262771,New Mexico Lobos,S. McGruder,4400149,,True,33.0,7,9,7,9,0,0,0,0,1,6,7,4,4,1,1,1,14
401262771,New Mexico Lobos,A. Anderson,4281834,,True,37.0,8,12,8,10,0,2,0,1,0,5,5,4,0,4,2,1,16
401262771,New Mexico Lobos,Lato. Duff,4704520,,True,23.0,2,8,2,5,0,3,0,0,1,6,7,3,1,0,0,1,4
401262771,New Mexico Lobos,A. Hurst,4400147,,True,35.0,6,14,3,4,3,10,0,0,0,3,3,5,1,0,0,1,15
401262771,New Mexico Lobos,J. De La Cerda,4281833,,True,30.0,5,15,5,10,0,5,4,4,2,4,6,2,0,0,2,1,14
401262771,New Mexico Lobos,A. Watts,4433688,,False,9.0,0,0,0,0,0,0,0,0,1,1,2,2,1,1,0,0,0
401262771,New Mexico Lobos,Lata. Duff,4704519,,False,21.0,3,11,2,4,1,7,6,7,0,1,1,2,0,0,2,4,13
401262771,New Mexico Lobos,C. Carter,4433646,,False,12.0,2,4,0,1,2,3,0,0,0,2,2,2,3,1,0,3,6
401262771,New Mexico Lobos,TEAM,TOTAL,TOTAL,False,,33,73,27,43,6,30,10,12,6,29,35,24,10,7,7,12,82
401262771,New Mexico Lobos,S. McGruder,4400149,,True,33.0,7,9,7,9,0,0,0,0,1,6,7,4,4,1,1,1,14
401262771,New Mexico Lobos,A. Anderson,4281834,,True,37.0,8,12,8,10,0,2,0,1,0,5,5,4,0,4,2,1,16
401262771,New Mexico Lobos,Lato. Duff,4704520,,True,23.0,2,8,2,5,0,3,0,0,1,6,7,3,1,0,0,1,4
401262771,New Mexico Lobos,A. Hurst,4400147,,True,35.0,6,14,3,4,3,10,0,0,0,3,3,5,1,0,0,1,15
401262771,New Mexico Lobos,J. De La Cerda,4281833,,True,30.0,5,15,5,10,0,5,4,4,2,4,6,2,0,0,2,1,14
401262771,New Mexico Lobos,A. Watts,4433688,,False,9.0,0,0,0,0,0,0,0,0,1,1,2,2,1,1,0,0,0
401262771,New Mexico Lobos,Lata. Duff,4704519,,False,21.0,3,11,2,4,1,7,6,7,0,1,1,2,0,0,2,4,13
401262771,New Mexico Lobos,C. Carter,4433646,,False,12.0,2,4,0,1,2,3,0,0,0,2,2,2,3,1,0,3,6
401262771,New Mexico Lobos,TEAM,TOTAL,TOTAL,False,,33,73,27,43,6,30,10,12,6,29,35,24,10,7,7,12,82
401262771,Fresno State Bulldogs,W. Motta,4595631,,True,4.0,0,2,0,2,0,0,0,0,1,1,2,0,0,0,0,0,0
401262771,Fresno State Bulldogs,M. Utti,4281828,,True,39.0,7,12,6,9,1,3,0,0,3,7,10,2,1,0,1,2,15
401262771,Fresno State Bulldogs,Hal. Cavinder,4433658,,True,35.0,6,19,5,12,1,7,3,4,1,7,8,2,2,0,4,0,16
401262771,Fresno State Bulldogs,Han. Cavinder,4433372,,True,39.0,7,15,5,12,2,3,4,4,1,8,9,4,0,1,4,2,20
401262771,Fresno State Bulldogs,A. Gamez,4281826,,True,36.0,4,10,4,9,0,1,0,1,4,5,9,3,0,0,5,3,8
401262771,Fresno State Bulldogs,K. Kinzer,4595630,,False,26.0,6,8,0,1,6,7,0,0,0,2,2,2,1,1,0,2,18
401262771,Fresno State Bulldogs,B. Walling,4595632,,False,7.0,0,0,0,0,0,0,0,0,0,0,0,1,0,0,0,0,0
401262771,Fresno State Bulldogs,K. Brown,4704473,,False,3.0,0,0,0,0,0,0,0,0,0,0,0,0,0,0,0,1,0
401262771,Fresno State Bulldogs,B. Delaney,4281825,,False,11.0,1,5,0,1,1,4,0,0,1,2,3,1,0,0,2,2,3
401262771,Fresno State Bulldogs,TEAM,TOTAL,TOTAL,False,,31,71,20,46,11,25,7,9,12,34,46,15,4,2,16,12,80
401262771,Fresno State Bulldogs,W. Motta,4595631,,True,4.0,0,2,0,2,0,0,0,0,1,1,2,0,0,0,0,0,0
401262771,Fresno State Bulldogs,M. Utti,4281828,,True,39.0,7,12,6,9,1,3,0,0,3,7,10,2,1,0,1,2,15
401262771,Fresno State Bulldogs,Hal. Cavinder,4433658,,True,35.0,6,19,5,12,1,7,3,4,1,7,8,2,2,0,4,0,16
401262771,Fresno State Bulldogs,Han. Cavinder,4433372,,True,39.0,7,15,5,12,2,3,4,4,1,8,9,4,0,1,4,2,20
401262771,Fresno State Bulldogs,A. Gamez,4281826,,True,36.0,4,10,4,9,0,1,0,1,4,5,9,3,0,0,5,3,8
401262771,Fresno State Bulldogs,K. Kinzer,4595630,,False,26.0,6,8,0,1,6,7,0,0,0,2,2,2,1,1,0,2,18
401262771,Fresno State Bulldogs,B. Walling,4595632,,False,7.0,0,0,0,0,0,0,0,0,0,0,0,1,0,0,0,0,0
401262771,Fresno State Bulldogs,K. Brown,4704473,,False,3.0,0,0,0,0,0,0,0,0,0,0,0,0,0,0,0,1,0
401262771,Fresno State Bulldogs,B. Delaney,4281825,,False,11.0,1,5,0,1,1,4,0,0,1,2,3,1,0,0,2,2,3
401262771,Fresno State Bulldogs,TEAM,TOTAL,TOTAL,False,,31,71,20,46,11,25,7,9,12,34,46,15,4,2,16,12,80
401262770,Nevada Wolf Pack,M. Ormiston,4400072,,True,28.0,6,10,6,10,0,0,1,2,4,0,4,0,0,1,2,2,13
401262770,Nevada Wolf Pack,L. Johnson,4595634,,True,30.0,5,8,5,8,0,0,3,4,0,4,4,0,0,0,4,3,13
401262770,Nevada Wolf Pack,A. West,4400134,,True,26.0,1,6,1,5,0,1,0,0,0,5,5,0,1,0,4,2,2
401262770,Nevada Wolf Pack,D. Hamilton,4400132,,True,29.0,5,13,5,9,0,4,4,4,0,3,3,2,1,0,3,1,14
401262770,Nevada Wolf Pack,N. Alexander,4068433,,True,33.0,4,8,4,8,0,0,1,2,1,1,2,1,1,0,0,2,9
401262770,Nevada Wolf Pack,L. Otuafi,4704508,,False,22.0,3,8,3,8,0,0,2,2,3,1,4,1,1,0,1,1,8
401262770,Nevada Wolf Pack,G. Rones,4704505,,False,1.0,0,0,0,0,0,0,0,0,0,0,0,0,0,0,0,0,0
401262770,Nevada Wolf Pack,K. Holt,4704503,,False,31.0,1,7,1,4,0,3,0,0,2,5,7,1,3,0,0,4,2
401262770,Nevada Wolf Pack,TEAM,TOTAL,TOTAL,False,,25,60,25,52,0,8,11,14,12,22,34,5,7,1,15,15,61
401262770,Nevada Wolf Pack,M. Ormiston,4400072,,True,28.0,6,10,6,10,0,0,1,2,4,0,4,0,0,1,2,2,13
401262770,Nevada Wolf Pack,L. Johnson,4595634,,True,30.0,5,8,5,8,0,0,3,4,0,4,4,0,0,0,4,3,13
401262770,Nevada Wolf Pack,A. West,4400134,,True,26.0,1,6,1,5,0,1,0,0,0,5,5,0,1,0,4,2,2
401262770,Nevada Wolf Pack,D. Hamilton,4400132,,True,29.0,5,13,5,9,0,4,4,4,0,3,3,2,1,0,3,1,14
401262770,Nevada Wolf Pack,N. Alexander,4068433,,True,33.0,4,8,4,8,0,0,1,2,1,1,2,1,1,0,0,2,9
401262770,Nevada Wolf Pack,L. Otuafi,4704508,,False,22.0,3,8,3,8,0,0,2,2,3,1,4,1,1,0,1,1,8
401262770,Nevada Wolf Pack,G. Rones,4704505,,False,1.0,0,0,0,0,0,0,0,0,0,0,0,0,0,0,0,0,0
401262770,Nevada Wolf Pack,K. Holt,4704503,,False,31.0,1,7,1,4,0,3,0,0,2,5,7,1,3,0,0,4,2
401262770,Nevada Wolf Pack,TEAM,TOTAL,TOTAL,False,,25,60,25,52,0,8,11,14,12,22,34,5,7,1,15,15,61
401262770,Fresno State Bulldogs,M. Utti,4281828,,True,37.0,5,11,5,10,0,1,2,2,4,8,12,6,1,0,1,1,12
401262770,Fresno State Bulldogs,B. Walling,4595632,,True,12.0,1,1,1,1,0,0,0,0,0,1,1,1,0,0,0,2,2
401262770,Fresno State Bulldogs,Hal. Cavinder,4433658,,True,37.0,5,15,4,8,1,7,0,0,1,7,8,5,3,0,5,2,11
401262770,Fresno State Bulldogs,Han. Cavinder,4433372,,True,38.0,9,17,9,14,0,3,3,4,3,1,4,3,0,0,0,1,21
401262770,Fresno State Bulldogs,A. Gamez,4281826,,True,28.0,6,8,3,4,3,4,3,4,0,0,0,1,2,1,0,1,18
401262770,Fresno State Bulldogs,W. Motta,4595631,,False,14.0,0,1,0,1,0,0,2,4,2,0,2,0,1,2,2,1,2
401262770,Fresno State Bulldogs,K. Kinzer,4595630,,False,7.0,1,3,0,0,1,3,0,0,0,0,0,0,0,0,1,0,3
401262770,Fresno State Bulldogs,G. Ogier,4281827,,False,2.0,0,0,0,0,0,0,0,0,0,0,0,1,0,0,1,0,0
401262770,Fresno State Bulldogs,M. Guimaraes,4704476,,False,12.0,2,2,2,2,0,0,0,0,1,2,3,0,0,0,0,2,4
401262770,Fresno State Bulldogs,Y. Todorova,4704475,,False,2.0,0,0,0,0,0,0,0,0,0,0,0,0,0,0,0,0,0
401262770,Fresno State Bulldogs,K. Brown,4704473,,False,5.0,1,3,1,3,0,0,0,0,1,1,2,0,0,1,0,0,2
401262770,Fresno State Bulldogs,B. Delaney,4281825,,False,6.0,0,2,0,0,0,2,0,0,0,1,1,1,0,0,2,0,0
401262770,Fresno State Bulldogs,TEAM,TOTAL,TOTAL,False,,30,63,25,43,5,20,10,14,14,23,37,18,7,4,14,10,75
401262770,Fresno State Bulldogs,M. Utti,4281828,,True,37.0,5,11,5,10,0,1,2,2,4,8,12,6,1,0,1,1,12
401262770,Fresno State Bulldogs,B. Walling,4595632,,True,12.0,1,1,1,1,0,0,0,0,0,1,1,1,0,0,0,2,2
401262770,Fresno State Bulldogs,Hal. Cavinder,4433658,,True,37.0,5,15,4,8,1,7,0,0,1,7,8,5,3,0,5,2,11
401262770,Fresno State Bulldogs,Han. Cavinder,4433372,,True,38.0,9,17,9,14,0,3,3,4,3,1,4,3,0,0,0,1,21
401262770,Fresno State Bulldogs,A. Gamez,4281826,,True,28.0,6,8,3,4,3,4,3,4,0,0,0,1,2,1,0,1,18
401262770,Fresno State Bulldogs,W. Motta,4595631,,False,14.0,0,1,0,1,0,0,2,4,2,0,2,0,1,2,2,1,2
401262770,Fresno State Bulldogs,K. Kinzer,4595630,,False,7.0,1,3,0,0,1,3,0,0,0,0,0,0,0,0,1,0,3
401262770,Fresno State Bulldogs,G. Ogier,4281827,,False,2.0,0,0,0,0,0,0,0,0,0,0,0,1,0,0,1,0,0
401262770,Fresno State Bulldogs,M. Guimaraes,4704476,,False,12.0,2,2,2,2,0,0,0,0,1,2,3,0,0,0,0,2,4
401262770,Fresno State Bulldogs,Y. Todorova,4704475,,False,2.0,0,0,0,0,0,0,0,0,0,0,0,0,0,0,0,0,0
401262770,Fresno State Bulldogs,K. Brown,4704473,,False,5.0,1,3,1,3,0,0,0,0,1,1,2,0,0,1,0,0,2
401262770,Fresno State Bulldogs,B. Delaney,4281825,,False,6.0,0,2,0,0,0,2,0,0,0,1,1,1,0,0,2,0,0
401262770,Fresno State Bulldogs,TEAM,TOTAL,TOTAL,False,,30,63,25,43,5,20,10,14,14,23,37,18,7,4,14,10,75
401262769,Nevada Wolf Pack,M. Ormiston,4400072,,True,18.0,1,6,1,6,0,0,0,0,0,1,1,0,0,0,0,0,2
401262769,Nevada Wolf Pack,L. Johnson,4595634,,True,29.0,5,11,5,10,0,1,3,5,1,5,6,1,4,0,2,3,13
401262769,Nevada Wolf Pack,A. West,4400134,,True,35.0,5,14,5,12,0,2,1,2,3,3,6,0,3,3,4,2,11
401262769,Nevada Wolf Pack,D. Hamilton,4400132,,True,32.0,6,12,4,9,2,3,3,4,0,3,3,3,1,1,3,5,17
401262769,Nevada Wolf Pack,N. Alexander,4068433,,True,31.0,8,16,8,14,0,2,2,5,4,5,9,1,3,0,4,3,18
401262769,Nevada Wolf Pack,L. Otuafi,4704508,,False,23.0,3,5,3,5,0,0,1,4,1,4,5,2,1,0,0,1,7
401262769,Nevada Wolf Pack,G. Rones,4704505,,False,2.0,0,0,0,0,0,0,0,0,0,0,0,0,0,0,1,0,0
401262769,Nevada Wolf Pack,K. Holt,4704503,,False,25.0,1,5,1,3,0,2,0,0,3,0,3,0,1,0,0,2,2
401262769,Nevada Wolf Pack,B. Carstens,4597039,,False,5.0,0,0,0,0,0,0,0,0,0,0,0,1,0,0,0,1,0
401262769,Nevada Wolf Pack,TEAM,TOTAL,TOTAL,False,,29,69,27,59,2,10,10,20,17,22,39,8,13,4,14,17,70
401262769,Nevada Wolf Pack,M. Ormiston,4400072,,True,18.0,1,6,1,6,0,0,0,0,0,1,1,0,0,0,0,0,2
401262769,Nevada Wolf Pack,L. Johnson,4595634,,True,29.0,5,11,5,10,0,1,3,5,1,5,6,1,4,0,2,3,13
401262769,Nevada Wolf Pack,A. West,4400134,,True,35.0,5,14,5,12,0,2,1,2,3,3,6,0,3,3,4,2,11
401262769,Nevada Wolf Pack,D. Hamilton,4400132,,True,32.0,6,12,4,9,2,3,3,4,0,3,3,3,1,1,3,5,17
401262769,Nevada Wolf Pack,N. Alexander,4068433,,True,31.0,8,16,8,14,0,2,2,5,4,5,9,1,3,0,4,3,18
401262769,Nevada Wolf Pack,L. Otuafi,4704508,,False,23.0,3,5,3,5,0,0,1,4,1,4,5,2,1,0,0,1,7
401262769,Nevada Wolf Pack,G. Rones,4704505,,False,2.0,0,0,0,0,0,0,0,0,0,0,0,0,0,0,1,0,0
401262769,Nevada Wolf Pack,K. Holt,4704503,,False,25.0,1,5,1,3,0,2,0,0,3,0,3,0,1,0,0,2,2
401262769,Nevada Wolf Pack,B. Carstens,4597039,,False,5.0,0,0,0,0,0,0,0,0,0,0,0,1,0,0,0,1,0
401262769,Nevada Wolf Pack,TEAM,TOTAL,TOTAL,False,,29,69,27,59,2,10,10,20,17,22,39,8,13,4,14,17,70
401262769,Fresno State Bulldogs,K. Kinzer,4595630,,True,15.0,1,3,0,1,1,2,0,0,0,3,3,0,0,0,0,0,3
401262769,Fresno State Bulldogs,M. Utti,4281828,,True,38.0,7,12,5,8,2,4,2,2,4,7,11,0,1,1,3,0,18
401262769,Fresno State Bulldogs,B. Walling,4595632,,True,12.0,0,0,0,0,0,0,0,0,0,1,1,0,0,0,2,1,0
401262769,Fresno State Bulldogs,Hal. Cavinder,4433658,,True,38.0,9,19,6,13,3,6,11,12,0,4,4,2,2,0,5,1,32
401262769,Fresno State Bulldogs,Han. Cavinder,4433372,,True,36.0,5,13,4,11,1,2,4,6,0,3,3,3,1,1,3,1,15
401262769,Fresno State Bulldogs,W. Motta,4595631,,False,17.0,1,4,1,4,0,0,0,0,3,1,4,0,3,0,1,2,2
401262769,Fresno State Bulldogs,G. Ogier,4281827,,False,2.0,1,1,1,1,0,0,0,0,0,0,0,0,0,0,0,1,2
401262769,Fresno State Bulldogs,M. Guimaraes,4704476,,False,9.0,1,1,1,1,0,0,0,0,0,3,3,0,1,0,0,3,2
401262769,Fresno State Bulldogs,K. Brown,4704473,,False,5.0,0,1,0,1,0,0,0,0,0,0,0,0,1,0,0,1,0
401262769,Fresno State Bulldogs,A. Gamez,4281826,,False,19.0,1,5,1,4,0,1,0,0,2,1,3,1,0,0,2,4,2
401262769,Fresno State Bulldogs,B. Delaney,4281825,,False,9.0,1,1,1,1,0,0,0,0,1,3,4,1,0,0,2,1,2
401262769,Fresno State Bulldogs,TEAM,TOTAL,TOTAL,False,,27,60,20,45,7,15,17,20,13,28,41,7,9,2,19,15,78
401262769,Fresno State Bulldogs,K. Kinzer,4595630,,True,15.0,1,3,0,1,1,2,0,0,0,3,3,0,0,0,0,0,3
401262769,Fresno State Bulldogs,M. Utti,4281828,,True,38.0,7,12,5,8,2,4,2,2,4,7,11,0,1,1,3,0,18
401262769,Fresno State Bulldogs,B. Walling,4595632,,True,12.0,0,0,0,0,0,0,0,0,0,1,1,0,0,0,2,1,0
401262769,Fresno State Bulldogs,Hal. Cavinder,4433658,,True,38.0,9,19,6,13,3,6,11,12,0,4,4,2,2,0,5,1,32
401262769,Fresno State Bulldogs,Han. Cavinder,4433372,,True,36.0,5,13,4,11,1,2,4,6,0,3,3,3,1,1,3,1,15
401262769,Fresno State Bulldogs,W. Motta,4595631,,False,17.0,1,4,1,4,0,0,0,0,3,1,4,0,3,0,1,2,2
401262769,Fresno State Bulldogs,G. Ogier,4281827,,False,2.0,1,1,1,1,0,0,0,0,0,0,0,0,0,0,0,1,2
401262769,Fresno State Bulldogs,M. Guimaraes,4704476,,False,9.0,1,1,1,1,0,0,0,0,0,3,3,0,1,0,0,3,2
401262769,Fresno State Bulldogs,K. Brown,4704473,,False,5.0,0,1,0,1,0,0,0,0,0,0,0,0,1,0,0,1,0
401262769,Fresno State Bulldogs,A. Gamez,4281826,,False,19.0,1,5,1,4,0,1,0,0,2,1,3,1,0,0,2,4,2
401262769,Fresno State Bulldogs,B. Delaney,4281825,,False,9.0,1,1,1,1,0,0,0,0,1,3,4,1,0,0,2,1,2
401262769,Fresno State Bulldogs,TEAM,TOTAL,TOTAL,False,,27,60,20,45,7,15,17,20,13,28,41,7,9,2,19,15,78
401262766,Wyoming Cowgirls,D. Davidsdottir,4068870,,True,32.0,2,8,2,8,0,0,3,4,4,8,12,2,0,0,2,1,7
401262766,Wyoming Cowgirls,J. Johnson,4595683,,True,36.0,4,10,0,2,4,8,0,0,4,3,7,0,0,0,1,1,12
401262766,Wyoming Cowgirls,Q. Weidemann,4400207,,True,43.0,6,17,2,10,4,7,0,0,2,0,2,6,0,2,1,0,16
401262766,Wyoming Cowgirls,A. Sanchez Ramos,4400204,,True,38.0,9,18,4,10,5,8,4,4,2,7,9,4,3,0,2,4,27
401262766,Wyoming Cowgirls,T. Olson,4400203,,True,42.0,1,7,1,3,0,4,1,1,1,5,6,6,0,0,2,4,3
401262766,Wyoming Cowgirls,M. Savic,4704660,,False,10.0,4,7,4,7,0,0,0,0,5,1,6,0,0,0,2,3,8
401262766,Wyoming Cowgirls,P. Salazar,4704659,,False,2.0,0,0,0,0,0,0,0,0,0,0,0,0,0,0,0,0,0
401262766,Wyoming Cowgirls,G. Ellis,4704657,,False,2.0,0,0,0,0,0,0,0,0,0,0,0,0,0,0,1,1,0
401262766,Wyoming Cowgirls,O. Ustowska,4704662,,False,8.0,1,3,0,1,1,2,0,0,0,0,0,1,0,0,2,1,3
401262766,Wyoming Cowgirls,M. Bradshaw,4595681,,False,12.0,1,6,0,4,1,2,1,2,1,4,5,0,0,0,0,2,4
401262766,Wyoming Cowgirls,TEAM,TOTAL,TOTAL,False,,28,76,13,45,15,31,9,11,21,28,49,19,3,2,14,17,80
401262766,Wyoming Cowgirls,D. Davidsdottir,4068870,,True,32.0,2,8,2,8,0,0,3,4,4,8,12,2,0,0,2,1,7
401262766,Wyoming Cowgirls,J. Johnson,4595683,,True,36.0,4,10,0,2,4,8,0,0,4,3,7,0,0,0,1,1,12
401262766,Wyoming Cowgirls,Q. Weidemann,4400207,,True,43.0,6,17,2,10,4,7,0,0,2,0,2,6,0,2,1,0,16
401262766,Wyoming Cowgirls,A. Sanchez Ramos,4400204,,True,38.0,9,18,4,10,5,8,4,4,2,7,9,4,3,0,2,4,27
401262766,Wyoming Cowgirls,T. Olson,4400203,,True,42.0,1,7,1,3,0,4,1,1,1,5,6,6,0,0,2,4,3
401262766,Wyoming Cowgirls,M. Savic,4704660,,False,10.0,4,7,4,7,0,0,0,0,5,1,6,0,0,0,2,3,8
401262766,Wyoming Cowgirls,P. Salazar,4704659,,False,2.0,0,0,0,0,0,0,0,0,0,0,0,0,0,0,0,0,0
401262766,Wyoming Cowgirls,G. Ellis,4704657,,False,2.0,0,0,0,0,0,0,0,0,0,0,0,0,0,0,1,1,0
401262766,Wyoming Cowgirls,O. Ustowska,4704662,,False,8.0,1,3,0,1,1,2,0,0,0,0,0,1,0,0,2,1,3
401262766,Wyoming Cowgirls,M. Bradshaw,4595681,,False,12.0,1,6,0,4,1,2,1,2,1,4,5,0,0,0,0,2,4
401262766,Wyoming Cowgirls,TEAM,TOTAL,TOTAL,False,,28,76,13,45,15,31,9,11,21,28,49,19,3,2,14,17,80
401262766,Fresno State Bulldogs,M. Utti,4281828,,True,42.0,7,13,2,8,5,5,4,4,1,9,10,4,2,1,2,1,23
401262766,Fresno State Bulldogs,B. Walling,4595632,,True,39.0,6,9,6,9,0,0,1,3,2,4,6,1,0,4,2,4,13
401262766,Fresno State Bulldogs,Hal. Cavinder,4433658,,True,44.0,9,20,7,16,2,4,4,5,0,6,6,2,2,1,1,3,24
401262766,Fresno State Bulldogs,Han. Cavinder,4433372,,True,42.0,7,13,7,12,0,1,4,5,0,2,2,2,4,0,4,1,18
401262766,Fresno State Bulldogs,A. Gamez,4281826,,True,37.0,1,4,0,1,1,3,0,0,0,3,3,1,0,2,1,1,3
401262766,Fresno State Bulldogs,Y. Todorova,4704475,,False,11.0,0,1,0,1,0,0,0,0,0,0,0,0,0,0,0,1,0
401262766,Fresno State Bulldogs,K. Brown,4704473,,False,10.0,1,2,1,1,0,1,0,0,0,1,1,0,0,0,0,0,2
401262766,Fresno State Bulldogs,TEAM,TOTAL,TOTAL,False,,31,62,23,48,8,14,13,17,4,28,32,10,8,8,10,11,83
401262766,Fresno State Bulldogs,M. Utti,4281828,,True,42.0,7,13,2,8,5,5,4,4,1,9,10,4,2,1,2,1,23
401262766,Fresno State Bulldogs,B. Walling,4595632,,True,39.0,6,9,6,9,0,0,1,3,2,4,6,1,0,4,2,4,13
401262766,Fresno State Bulldogs,Hal. Cavinder,4433658,,True,44.0,9,20,7,16,2,4,4,5,0,6,6,2,2,1,1,3,24
401262766,Fresno State Bulldogs,Han. Cavinder,4433372,,True,42.0,7,13,7,12,0,1,4,5,0,2,2,2,4,0,4,1,18
401262766,Fresno State Bulldogs,A. Gamez,4281826,,True,37.0,1,4,0,1,1,3,0,0,0,3,3,1,0,2,1,1,3
401262766,Fresno State Bulldogs,Y. Todorova,4704475,,False,11.0,0,1,0,1,0,0,0,0,0,0,0,0,0,0,0,1,0
401262766,Fresno State Bulldogs,K. Brown,4704473,,False,10.0,1,2,1,1,0,1,0,0,0,1,1,0,0,0,0,0,2
401262766,Fresno State Bulldogs,TEAM,TOTAL,TOTAL,False,,31,62,23,48,8,14,13,17,4,28,32,10,8,8,10,11,83
401262765,Wyoming Cowgirls,D. Davidsdottir,4068870,,True,22.0,2,3,2,3,0,0,0,0,0,4,4,0,0,2,0,2,4
401262765,Wyoming Cowgirls,J. Johnson,4595683,,True,26.0,3,11,1,2,2,9,0,0,1,2,3,1,1,1,1,1,8
401262765,Wyoming Cowgirls,Q. Weidemann,4400207,,True,38.0,6,18,2,5,4,13,0,0,0,3,3,2,4,1,1,1,16
401262765,Wyoming Cowgirls,A. Sanchez Ramos,4400204,,True,34.0,5,12,4,8,1,4,3,3,2,3,5,4,0,0,2,1,14
401262765,Wyoming Cowgirls,T. Olson,4400203,,True,37.0,2,6,0,1,2,5,0,0,3,5,8,6,2,0,4,2,6
401262765,Wyoming Cowgirls,M. Savic,4704660,,False,12.0,3,4,3,4,0,0,2,2,2,2,4,0,0,1,2,1,8
401262765,Wyoming Cowgirls,P. Salazar,4704659,,False,6.0,0,1,0,1,0,0,0,0,0,1,1,1,0,0,0,1,0
401262765,Wyoming Cowgirls,G. Ellis,4704657,,False,6.0,0,1,0,1,0,0,0,0,0,3,3,0,0,0,0,1,0
401262765,Wyoming Cowgirls,O. Ustowska,4704662,,False,19.0,3,7,1,1,2,6,1,2,0,4,4,0,1,0,1,1,9
401262765,Wyoming Cowgirls,TEAM,TOTAL,TOTAL,False,,24,63,13,26,11,37,6,7,9,29,38,14,8,5,11,11,65
401262765,Wyoming Cowgirls,D. Davidsdottir,4068870,,True,22.0,2,3,2,3,0,0,0,0,0,4,4,0,0,2,0,2,4
401262765,Wyoming Cowgirls,J. Johnson,4595683,,True,26.0,3,11,1,2,2,9,0,0,1,2,3,1,1,1,1,1,8
401262765,Wyoming Cowgirls,Q. Weidemann,4400207,,True,38.0,6,18,2,5,4,13,0,0,0,3,3,2,4,1,1,1,16
401262765,Wyoming Cowgirls,A. Sanchez Ramos,4400204,,True,34.0,5,12,4,8,1,4,3,3,2,3,5,4,0,0,2,1,14
401262765,Wyoming Cowgirls,T. Olson,4400203,,True,37.0,2,6,0,1,2,5,0,0,3,5,8,6,2,0,4,2,6
401262765,Wyoming Cowgirls,M. Savic,4704660,,False,12.0,3,4,3,4,0,0,2,2,2,2,4,0,0,1,2,1,8
401262765,Wyoming Cowgirls,P. Salazar,4704659,,False,6.0,0,1,0,1,0,0,0,0,0,1,1,1,0,0,0,1,0
401262765,Wyoming Cowgirls,G. Ellis,4704657,,False,6.0,0,1,0,1,0,0,0,0,0,3,3,0,0,0,0,1,0
401262765,Wyoming Cowgirls,O. Ustowska,4704662,,False,19.0,3,7,1,1,2,6,1,2,0,4,4,0,1,0,1,1,9
401262765,Wyoming Cowgirls,TEAM,TOTAL,TOTAL,False,,24,63,13,26,11,37,6,7,9,29,38,14,8,5,11,11,65
401262765,Fresno State Bulldogs,M. Utti,4281828,,True,25.0,1,5,1,4,0,1,0,0,1,10,11,0,0,0,2,3,2
401262765,Fresno State Bulldogs,B. Walling,4595632,,True,37.0,3,5,2,2,1,3,0,2,0,6,6,0,2,0,2,3,7
401262765,Fresno State Bulldogs,Hal. Cavinder,4433658,,True,38.0,11,20,7,15,4,5,2,2,2,6,8,3,0,0,2,0,28
401262765,Fresno State Bulldogs,Han. Cavinder,4433372,,True,37.0,5,14,3,11,2,3,0,0,1,1,2,4,2,0,3,2,12
401262765,Fresno State Bulldogs,A. Gamez,4281826,,True,34.0,3,7,3,5,0,2,4,5,1,3,4,0,2,1,3,2,10
401262765,Fresno State Bulldogs,C. Fairley,4704474,,False,4.0,1,2,1,1,0,1,0,0,1,0,1,0,0,0,0,0,2
401262765,Fresno State Bulldogs,Y. Todorova,4704475,,False,11.0,0,2,0,0,0,2,0,0,0,1,1,1,1,0,0,0,0
401262765,Fresno State Bulldogs,K. Brown,4704473,,False,14.0,1,4,1,3,0,1,0,0,0,2,2,1,0,0,0,3,2
401262765,Fresno State Bulldogs,TEAM,TOTAL,TOTAL,False,,25,59,18,41,7,18,6,9,6,31,37,9,7,1,12,13,63
401262765,Fresno State Bulldogs,M. Utti,4281828,,True,25.0,1,5,1,4,0,1,0,0,1,10,11,0,0,0,2,3,2
401262765,Fresno State Bulldogs,B. Walling,4595632,,True,37.0,3,5,2,2,1,3,0,2,0,6,6,0,2,0,2,3,7
401262765,Fresno State Bulldogs,Hal. Cavinder,4433658,,True,38.0,11,20,7,15,4,5,2,2,2,6,8,3,0,0,2,0,28
401262765,Fresno State Bulldogs,Han. Cavinder,4433372,,True,37.0,5,14,3,11,2,3,0,0,1,1,2,4,2,0,3,2,12
401262765,Fresno State Bulldogs,A. Gamez,4281826,,True,34.0,3,7,3,5,0,2,4,5,1,3,4,0,2,1,3,2,10
401262765,Fresno State Bulldogs,C. Fairley,4704474,,False,4.0,1,2,1,1,0,1,0,0,1,0,1,0,0,0,0,0,2
401262765,Fresno State Bulldogs,Y. Todorova,4704475,,False,11.0,0,2,0,0,0,2,0,0,0,1,1,1,1,0,0,0,0
401262765,Fresno State Bulldogs,K. Brown,4704473,,False,14.0,1,4,1,3,0,1,0,0,0,2,2,1,0,0,0,3,2
401262765,Fresno State Bulldogs,TEAM,TOTAL,TOTAL,False,,25,59,18,41,7,18,6,9,6,31,37,9,7,1,12,13,63
401262760,Wyoming Cowgirls,D. Davidsdottir,4068870,,True,14.0,3,5,3,5,0,0,2,2,0,3,3,0,0,2,0,4,8
401262760,Wyoming Cowgirls,J. Johnson,4595683,,True,19.0,2,3,2,2,0,1,2,2,0,0,0,4,0,1,0,1,6
401262760,Wyoming Cowgirls,Q. Weidemann,4400207,,True,37.0,5,10,3,6,2,4,2,3,0,2,2,2,0,0,3,1,14
401262760,Wyoming Cowgirls,A. Sanchez Ramos,4400204,,True,34.0,3,7,3,6,0,1,2,4,0,12,12,1,0,1,1,3,8
401262760,Wyoming Cowgirls,T. Olson,4400203,,True,24.0,2,6,2,5,0,1,0,2,1,3,4,4,1,0,4,1,4
401262760,Wyoming Cowgirls,M. Savic,4704660,,False,16.0,2,4,2,4,0,0,0,0,0,4,4,0,1,1,2,3,4
401262760,Wyoming Cowgirls,G. Ellis,4704657,,False,7.0,0,1,0,0,0,1,0,0,0,0,0,0,0,0,1,1,0
401262760,Wyoming Cowgirls,O. Ustowska,4704662,,False,20.0,3,8,0,0,3,8,0,0,0,0,0,0,1,0,0,1,9
401262760,Wyoming Cowgirls,M. Bradshaw,4595681,,False,29.0,4,6,2,3,2,3,2,2,0,3,3,2,1,1,1,1,12
401262760,Wyoming Cowgirls,TEAM,TOTAL,TOTAL,False,,24,50,17,31,7,19,10,15,3,28,31,13,4,6,12,16,65
401262760,Wyoming Cowgirls,D. Davidsdottir,4068870,,True,14.0,3,5,3,5,0,0,2,2,0,3,3,0,0,2,0,4,8
401262760,Wyoming Cowgirls,J. Johnson,4595683,,True,19.0,2,3,2,2,0,1,2,2,0,0,0,4,0,1,0,1,6
401262760,Wyoming Cowgirls,Q. Weidemann,4400207,,True,37.0,5,10,3,6,2,4,2,3,0,2,2,2,0,0,3,1,14
401262760,Wyoming Cowgirls,A. Sanchez Ramos,4400204,,True,34.0,3,7,3,6,0,1,2,4,0,12,12,1,0,1,1,3,8
401262760,Wyoming Cowgirls,T. Olson,4400203,,True,24.0,2,6,2,5,0,1,0,2,1,3,4,4,1,0,4,1,4
401262760,Wyoming Cowgirls,M. Savic,4704660,,False,16.0,2,4,2,4,0,0,0,0,0,4,4,0,1,1,2,3,4
401262760,Wyoming Cowgirls,G. Ellis,4704657,,False,7.0,0,1,0,0,0,1,0,0,0,0,0,0,0,0,1,1,0
401262760,Wyoming Cowgirls,O. Ustowska,4704662,,False,20.0,3,8,0,0,3,8,0,0,0,0,0,0,1,0,0,1,9
401262760,Wyoming Cowgirls,M. Bradshaw,4595681,,False,29.0,4,6,2,3,2,3,2,2,0,3,3,2,1,1,1,1,12
401262760,Wyoming Cowgirls,TEAM,TOTAL,TOTAL,False,,24,50,17,31,7,19,10,15,3,28,31,13,4,6,12,16,65
401262760,Colorado State Rams,K. Murphy,4068969,,True,27.0,8,13,8,13,0,0,1,1,2,8,10,0,0,1,3,2,17
401262760,Colorado State Rams,E. Boni,4704462,,True,31.0,0,2,0,2,0,0,0,0,0,3,3,1,0,0,1,2,0
401262760,Colorado State Rams,M. Hofschild,4595160,,True,35.0,6,12,5,11,1,1,9,10,1,2,3,0,1,0,2,1,22
401262760,Colorado State Rams,L. Devos,4284002,,True,40.0,5,17,5,16,0,1,2,2,2,5,7,0,3,1,0,2,12
401262760,Colorado State Rams,T. Williams,4282176,,True,29.0,1,6,1,4,0,2,1,2,2,2,4,1,4,0,0,3,3
401262760,Colorado State Rams,C. Clark,4704464,,False,1.0,0,1,0,1,0,0,0,0,0,0,0,0,0,0,0,0,0
401262760,Colorado State Rams,J. Bonnarens,4400102,,False,20.0,5,9,4,7,1,2,1,1,1,4,5,0,0,0,0,3,12
401262760,Colorado State Rams,P. Farkas,4704463,,False,11.0,0,1,0,1,0,0,0,0,0,0,0,0,0,0,0,0,0
401262760,Colorado State Rams,B. Alper,4595629,,False,6.0,1,1,1,1,0,0,0,0,0,1,1,0,0,0,0,0,2
401262760,Colorado State Rams,TEAM,TOTAL,TOTAL,False,,26,62,24,56,2,6,14,16,9,26,35,2,8,2,6,13,68
401262760,Colorado State Rams,K. Murphy,4068969,,True,27.0,8,13,8,13,0,0,1,1,2,8,10,0,0,1,3,2,17
401262760,Colorado State Rams,E. Boni,4704462,,True,31.0,0,2,0,2,0,0,0,0,0,3,3,1,0,0,1,2,0
401262760,Colorado State Rams,M. Hofschild,4595160,,True,35.0,6,12,5,11,1,1,9,10,1,2,3,0,1,0,2,1,22
401262760,Colorado State Rams,L. Devos,4284002,,True,40.0,5,17,5,16,0,1,2,2,2,5,7,0,3,1,0,2,12
401262760,Colorado State Rams,T. Williams,4282176,,True,29.0,1,6,1,4,0,2,1,2,2,2,4,1,4,0,0,3,3
401262760,Colorado State Rams,C. Clark,4704464,,False,1.0,0,1,0,1,0,0,0,0,0,0,0,0,0,0,0,0,0
401262760,Colorado State Rams,J. Bonnarens,4400102,,False,20.0,5,9,4,7,1,2,1,1,1,4,5,0,0,0,0,3,12
401262760,Colorado State Rams,P. Farkas,4704463,,False,11.0,0,1,0,1,0,0,0,0,0,0,0,0,0,0,0,0,0
401262760,Colorado State Rams,B. Alper,4595629,,False,6.0,1,1,1,1,0,0,0,0,0,1,1,0,0,0,0,0,2
401262760,Colorado State Rams,TEAM,TOTAL,TOTAL,False,,26,62,24,56,2,6,14,16,9,26,35,2,8,2,6,13,68
401262759,Wyoming Cowgirls,D. Davidsdottir,4068870,,True,26.0,2,5,2,5,0,0,0,0,1,3,4,0,0,0,0,2,4
401262759,Wyoming Cowgirls,J. Johnson,4595683,,True,22.0,0,3,0,2,0,1,0,0,0,0,0,0,0,0,0,0,0
401262759,Wyoming Cowgirls,Q. Weidemann,4400207,,True,37.0,6,13,4,10,2,3,1,2,1,2,3,4,2,0,1,3,15
401262759,Wyoming Cowgirls,A. Sanchez Ramos,4400204,,True,31.0,2,5,0,3,2,2,5,6,0,10,10,1,0,1,1,2,11
401262759,Wyoming Cowgirls,T. Olson,4400203,,True,35.0,6,13,5,9,1,4,1,2,1,8,9,1,0,0,0,2,14
401262759,Wyoming Cowgirls,M. Savic,4704660,,False,11.0,2,4,2,4,0,0,0,2,0,1,1,2,1,0,0,2,4
401262759,Wyoming Cowgirls,G. Ellis,4704657,,False,4.0,1,2,1,1,0,1,0,0,0,1,1,0,0,0,1,2,2
401262759,Wyoming Cowgirls,O. Ustowska,4704662,,False,11.0,0,2,0,2,0,0,0,0,0,0,0,0,0,0,0,0,0
401262759,Wyoming Cowgirls,M. Bradshaw,4595681,,False,23.0,4,7,4,6,0,1,3,4,0,0,0,2,0,0,0,1,11
401262759,Wyoming Cowgirls,TEAM,TOTAL,TOTAL,False,,23,54,18,42,5,12,10,16,5,26,31,10,3,1,3,14,61
401262759,Wyoming Cowgirls,D. Davidsdottir,4068870,,True,26.0,2,5,2,5,0,0,0,0,1,3,4,0,0,0,0,2,4
401262759,Wyoming Cowgirls,J. Johnson,4595683,,True,22.0,0,3,0,2,0,1,0,0,0,0,0,0,0,0,0,0,0
401262759,Wyoming Cowgirls,Q. Weidemann,4400207,,True,37.0,6,13,4,10,2,3,1,2,1,2,3,4,2,0,1,3,15
401262759,Wyoming Cowgirls,A. Sanchez Ramos,4400204,,True,31.0,2,5,0,3,2,2,5,6,0,10,10,1,0,1,1,2,11
401262759,Wyoming Cowgirls,T. Olson,4400203,,True,35.0,6,13,5,9,1,4,1,2,1,8,9,1,0,0,0,2,14
401262759,Wyoming Cowgirls,M. Savic,4704660,,False,11.0,2,4,2,4,0,0,0,2,0,1,1,2,1,0,0,2,4
401262759,Wyoming Cowgirls,G. Ellis,4704657,,False,4.0,1,2,1,1,0,1,0,0,0,1,1,0,0,0,1,2,2
401262759,Wyoming Cowgirls,O. Ustowska,4704662,,False,11.0,0,2,0,2,0,0,0,0,0,0,0,0,0,0,0,0,0
401262759,Wyoming Cowgirls,M. Bradshaw,4595681,,False,23.0,4,7,4,6,0,1,3,4,0,0,0,2,0,0,0,1,11
401262759,Wyoming Cowgirls,TEAM,TOTAL,TOTAL,False,,23,54,18,42,5,12,10,16,5,26,31,10,3,1,3,14,61
401262759,Colorado State Rams,C. Clark,4704464,,True,12.0,1,8,1,7,0,1,0,0,0,5,5,0,0,0,0,0,2
401262759,Colorado State Rams,E. Boni,4704462,,True,24.0,2,2,1,1,1,1,2,2,0,1,1,0,0,1,0,3,7
401262759,Colorado State Rams,M. Hofschild,4595160,,True,36.0,5,14,4,12,1,2,4,4,0,3,3,4,0,1,2,1,15
401262759,Colorado State Rams,L. Devos,4284002,,True,37.0,8,13,6,11,2,2,3,4,1,8,9,1,1,0,1,1,21
401262759,Colorado State Rams,T. Williams,4282176,,True,34.0,3,5,1,3,2,2,0,0,0,6,6,0,0,0,2,2,8
401262759,Colorado State Rams,K. Murphy,4068969,,False,25.0,6,11,6,11,0,0,0,0,3,4,7,0,0,1,1,2,12
401262759,Colorado State Rams,J. Bonnarens,4400102,,False,10.0,0,0,0,0,0,0,2,2,0,0,0,0,0,1,0,0,2
401262759,Colorado State Rams,P. Farkas,4704463,,False,16.0,0,2,0,1,0,1,0,0,0,1,1,0,0,0,0,3,0
401262759,Colorado State Rams,B. Alper,4595629,,False,4.0,1,2,1,2,0,0,0,0,0,0,0,0,0,0,0,0,2
401262759,Colorado State Rams,TEAM,TOTAL,TOTAL,False,,26,57,20,48,6,9,11,12,4,28,32,5,1,4,6,12,69
401262759,Colorado State Rams,C. Clark,4704464,,True,12.0,1,8,1,7,0,1,0,0,0,5,5,0,0,0,0,0,2
401262759,Colorado State Rams,E. Boni,4704462,,True,24.0,2,2,1,1,1,1,2,2,0,1,1,0,0,1,0,3,7
401262759,Colorado State Rams,M. Hofschild,4595160,,True,36.0,5,14,4,12,1,2,4,4,0,3,3,4,0,1,2,1,15
401262759,Colorado State Rams,L. Devos,4284002,,True,37.0,8,13,6,11,2,2,3,4,1,8,9,1,1,0,1,1,21
401262759,Colorado State Rams,T. Williams,4282176,,True,34.0,3,5,1,3,2,2,0,0,0,6,6,0,0,0,2,2,8
401262759,Colorado State Rams,K. Murphy,4068969,,False,25.0,6,11,6,11,0,0,0,0,3,4,7,0,0,1,1,2,12
401262759,Colorado State Rams,J. Bonnarens,4400102,,False,10.0,0,0,0,0,0,0,2,2,0,0,0,0,0,1,0,0,2
401262759,Colorado State Rams,P. Farkas,4704463,,False,16.0,0,2,0,1,0,1,0,0,0,1,1,0,0,0,0,3,0
401262759,Colorado State Rams,B. Alper,4595629,,False,4.0,1,2,1,2,0,0,0,0,0,0,0,0,0,0,0,0,2
401262759,Colorado State Rams,TEAM,TOTAL,TOTAL,False,,26,57,20,48,6,9,11,12,4,28,32,5,1,4,6,12,69
401262758,Utah State Aggies,J. Chatman,4068281,,True,26.0,1,7,1,3,0,4,1,2,1,3,4,0,0,0,5,2,3
401262758,Utah State Aggies,H. Nelson,4704652,,True,21.0,4,8,4,6,0,2,0,0,3,3,6,1,1,2,0,5,8
401262758,Utah State Aggies,E. Emrich,4595671,,True,13.0,0,1,0,1,0,0,0,0,2,2,4,1,0,0,1,1,0
401262758,Utah State Aggies,F. Brantley,4595669,,True,35.0,5,14,2,7,3,7,1,2,0,1,1,3,1,0,5,3,14
401262758,Utah State Aggies,E. Harris,4281891,,True,34.0,3,8,1,3,2,5,4,4,1,10,11,4,1,0,2,3,12
401262758,Utah State Aggies,T. Franson,4281892,,False,8.0,1,1,1,1,0,0,0,0,1,1,2,0,0,0,2,1,2
401262758,Utah State Aggies,K. Falslev,4704648,,False,2.0,1,3,0,1,1,2,0,0,0,1,1,0,0,0,0,0,3
401262758,Utah State Aggies,M. Mendazona,4704647,,False,28.0,7,13,6,12,1,1,1,2,0,4,4,2,2,0,1,2,16
401262758,Utah State Aggies,K. Kamakawiwo'ole,4595670,,False,8.0,1,3,1,2,0,1,0,0,0,4,4,0,0,0,2,4,2
401262758,Utah State Aggies,S. Latone,4399209,,False,25.0,4,9,2,5,2,4,3,4,2,2,4,2,0,0,0,1,13
401262758,Utah State Aggies,TEAM,TOTAL,TOTAL,False,,27,67,18,41,9,26,10,14,10,32,42,13,5,2,18,22,73
401262758,Utah State Aggies,J. Chatman,4068281,,True,26.0,1,7,1,3,0,4,1,2,1,3,4,0,0,0,5,2,3
401262758,Utah State Aggies,H. Nelson,4704652,,True,21.0,4,8,4,6,0,2,0,0,3,3,6,1,1,2,0,5,8
401262758,Utah State Aggies,E. Emrich,4595671,,True,13.0,0,1,0,1,0,0,0,0,2,2,4,1,0,0,1,1,0
401262758,Utah State Aggies,F. Brantley,4595669,,True,35.0,5,14,2,7,3,7,1,2,0,1,1,3,1,0,5,3,14
401262758,Utah State Aggies,E. Harris,4281891,,True,34.0,3,8,1,3,2,5,4,4,1,10,11,4,1,0,2,3,12
401262758,Utah State Aggies,T. Franson,4281892,,False,8.0,1,1,1,1,0,0,0,0,1,1,2,0,0,0,2,1,2
401262758,Utah State Aggies,K. Falslev,4704648,,False,2.0,1,3,0,1,1,2,0,0,0,1,1,0,0,0,0,0,3
401262758,Utah State Aggies,M. Mendazona,4704647,,False,28.0,7,13,6,12,1,1,1,2,0,4,4,2,2,0,1,2,16
401262758,Utah State Aggies,K. Kamakawiwo'ole,4595670,,False,8.0,1,3,1,2,0,1,0,0,0,4,4,0,0,0,2,4,2
401262758,Utah State Aggies,S. Latone,4399209,,False,25.0,4,9,2,5,2,4,3,4,2,2,4,2,0,0,0,1,13
401262758,Utah State Aggies,TEAM,TOTAL,TOTAL,False,,27,67,18,41,9,26,10,14,10,32,42,13,5,2,18,22,73
401262758,Colorado State Rams,C. Clark,4704464,,True,20.0,5,8,5,8,0,0,4,4,3,4,7,0,1,0,3,2,14
401262758,Colorado State Rams,E. Boni,4704462,,True,18.0,4,8,3,7,1,1,0,1,1,0,1,3,0,0,0,1,9
401262758,Colorado State Rams,M. Hofschild,4595160,,True,29.0,4,8,4,6,0,2,3,4,0,3,3,6,1,0,1,1,11
401262758,Colorado State Rams,L. Devos,4284002,,True,31.0,4,10,3,7,1,3,3,4,0,3,3,2,2,0,1,2,12
401262758,Colorado State Rams,T. Williams,4282176,,True,27.0,5,11,2,3,3,8,0,0,0,10,10,3,6,0,2,2,13
401262758,Colorado State Rams,K. Murphy,4068969,,False,18.0,5,8,5,8,0,0,3,3,1,2,3,0,1,0,0,2,13
401262758,Colorado State Rams,M. Torres,4704466,,False,2.0,0,1,0,0,0,1,0,0,0,0,0,0,0,0,0,1,0
401262758,Colorado State Rams,J. Bonnarens,4400102,,False,18.0,1,4,0,1,1,3,0,0,0,3,3,2,0,1,0,0,3
401262758,Colorado State Rams,L. Davis,4068248,,False,2.0,0,2,0,2,0,0,1,2,0,1,1,0,0,0,0,0,1
401262758,Colorado State Rams,M. Hemingway,4704465,,False,2.0,0,0,0,0,0,0,0,0,0,0,0,0,0,1,0,0,0
401262758,Colorado State Rams,P. Farkas,4704463,,False,20.0,4,6,2,2,2,4,0,0,0,3,3,0,0,0,2,1,10
401262758,Colorado State Rams,B. Alper,4595629,,False,11.0,1,2,1,2,0,0,0,0,0,1,1,1,0,0,2,2,2
401262758,Colorado State Rams,K. Stamatelopoulos,4595627,,False,2.0,0,0,0,0,0,0,0,0,0,0,0,0,0,0,0,0,0
401262758,Colorado State Rams,TEAM,TOTAL,TOTAL,False,,33,68,25,46,8,22,14,18,5,30,35,17,11,2,11,14,88
401262758,Colorado State Rams,C. Clark,4704464,,True,20.0,5,8,5,8,0,0,4,4,3,4,7,0,1,0,3,2,14
401262758,Colorado State Rams,E. Boni,4704462,,True,18.0,4,8,3,7,1,1,0,1,1,0,1,3,0,0,0,1,9
401262758,Colorado State Rams,M. Hofschild,4595160,,True,29.0,4,8,4,6,0,2,3,4,0,3,3,6,1,0,1,1,11
401262758,Colorado State Rams,L. Devos,4284002,,True,31.0,4,10,3,7,1,3,3,4,0,3,3,2,2,0,1,2,12
401262758,Colorado State Rams,T. Williams,4282176,,True,27.0,5,11,2,3,3,8,0,0,0,10,10,3,6,0,2,2,13
401262758,Colorado State Rams,K. Murphy,4068969,,False,18.0,5,8,5,8,0,0,3,3,1,2,3,0,1,0,0,2,13
401262758,Colorado State Rams,M. Torres,4704466,,False,2.0,0,1,0,0,0,1,0,0,0,0,0,0,0,0,0,1,0
401262758,Colorado State Rams,J. Bonnarens,4400102,,False,18.0,1,4,0,1,1,3,0,0,0,3,3,2,0,1,0,0,3
401262758,Colorado State Rams,L. Davis,4068248,,False,2.0,0,2,0,2,0,0,1,2,0,1,1,0,0,0,0,0,1
401262758,Colorado State Rams,M. Hemingway,4704465,,False,2.0,0,0,0,0,0,0,0,0,0,0,0,0,0,1,0,0,0
401262758,Colorado State Rams,P. Farkas,4704463,,False,20.0,4,6,2,2,2,4,0,0,0,3,3,0,0,0,2,1,10
401262758,Colorado State Rams,B. Alper,4595629,,False,11.0,1,2,1,2,0,0,0,0,0,1,1,1,0,0,2,2,2
401262758,Colorado State Rams,K. Stamatelopoulos,4595627,,False,2.0,0,0,0,0,0,0,0,0,0,0,0,0,0,0,0,0,0
401262758,Colorado State Rams,TEAM,TOTAL,TOTAL,False,,33,68,25,46,8,22,14,18,5,30,35,17,11,2,11,14,88
401262757,Utah State Aggies,B. Mathews,4400146,,True,19.0,4,10,4,8,0,2,2,2,0,3,3,1,0,0,2,1,10
401262757,Utah State Aggies,J. Chatman,4068281,,True,29.0,3,10,3,10,0,0,0,0,0,2,2,2,1,0,1,1,6
401262757,Utah State Aggies,M. Mendazona,4704647,,True,17.0,0,1,0,1,0,0,0,0,0,5,5,0,0,0,1,2,0
401262757,Utah State Aggies,F. Brantley,4595669,,True,26.0,4,9,4,7,0,2,0,0,0,3,3,1,2,0,0,0,8
401262757,Utah State Aggies,E. Harris,4281891,,True,24.0,0,4,0,2,0,2,1,2,0,4,4,1,0,0,0,0,1
401262757,Utah State Aggies,T. Franson,4281892,,False,8.0,0,1,0,1,0,0,0,0,0,2,2,0,0,1,0,0,0
401262757,Utah State Aggies,H. Nelson,4704652,,False,17.0,3,7,2,5,1,2,2,2,2,1,3,1,2,0,0,3,9
401262757,Utah State Aggies,P. Williams,4704650,,False,16.0,3,7,2,5,1,2,0,2,0,0,0,1,2,0,1,1,7
401262757,Utah State Aggies,K. Falslev,4704648,,False,4.0,0,2,0,0,0,2,0,0,0,0,0,0,0,0,0,0,0
401262757,Utah State Aggies,E. Emrich,4595671,,False,16.0,1,3,1,3,0,0,2,2,0,2,2,0,0,0,0,1,4
401262757,Utah State Aggies,K. Kamakawiwo'ole,4595670,,False,9.0,1,2,1,2,0,0,3,4,1,0,1,0,0,0,2,0,5
401262757,Utah State Aggies,S. Latone,4399209,,False,15.0,4,13,3,6,1,7,0,0,1,1,2,1,0,0,1,1,9
401262757,Utah State Aggies,TEAM,TOTAL,TOTAL,False,,23,69,20,50,3,19,10,14,7,27,34,8,7,1,8,10,59
401262757,Utah State Aggies,B. Mathews,4400146,,True,19.0,4,10,4,8,0,2,2,2,0,3,3,1,0,0,2,1,10
401262757,Utah State Aggies,J. Chatman,4068281,,True,29.0,3,10,3,10,0,0,0,0,0,2,2,2,1,0,1,1,6
401262757,Utah State Aggies,M. Mendazona,4704647,,True,17.0,0,1,0,1,0,0,0,0,0,5,5,0,0,0,1,2,0
401262757,Utah State Aggies,F. Brantley,4595669,,True,26.0,4,9,4,7,0,2,0,0,0,3,3,1,2,0,0,0,8
401262757,Utah State Aggies,E. Harris,4281891,,True,24.0,0,4,0,2,0,2,1,2,0,4,4,1,0,0,0,0,1
401262757,Utah State Aggies,T. Franson,4281892,,False,8.0,0,1,0,1,0,0,0,0,0,2,2,0,0,1,0,0,0
401262757,Utah State Aggies,H. Nelson,4704652,,False,17.0,3,7,2,5,1,2,2,2,2,1,3,1,2,0,0,3,9
401262757,Utah State Aggies,P. Williams,4704650,,False,16.0,3,7,2,5,1,2,0,2,0,0,0,1,2,0,1,1,7
401262757,Utah State Aggies,K. Falslev,4704648,,False,4.0,0,2,0,0,0,2,0,0,0,0,0,0,0,0,0,0,0
401262757,Utah State Aggies,E. Emrich,4595671,,False,16.0,1,3,1,3,0,0,2,2,0,2,2,0,0,0,0,1,4
401262757,Utah State Aggies,K. Kamakawiwo'ole,4595670,,False,9.0,1,2,1,2,0,0,3,4,1,0,1,0,0,0,2,0,5
401262757,Utah State Aggies,S. Latone,4399209,,False,15.0,4,13,3,6,1,7,0,0,1,1,2,1,0,0,1,1,9
401262757,Utah State Aggies,TEAM,TOTAL,TOTAL,False,,23,69,20,50,3,19,10,14,7,27,34,8,7,1,8,10,59
401262757,Colorado State Rams,C. Clark,4704464,,True,15.0,5,10,5,10,0,0,1,2,2,6,8,0,0,0,2,0,11
401262757,Colorado State Rams,E. Boni,4704462,,True,24.0,0,4,0,3,0,1,0,0,1,5,6,0,0,1,1,2,0
401262757,Colorado State Rams,M. Hofschild,4595160,,True,27.0,2,7,1,4,1,3,4,4,0,1,1,9,1,0,0,1,9
401262757,Colorado State Rams,L. Devos,4284002,,True,27.0,6,16,6,14,0,2,3,3,3,5,8,2,2,2,1,1,15
401262757,Colorado State Rams,T. Williams,4282176,,True,28.0,2,7,0,1,2,6,0,0,0,7,7,3,0,0,1,2,6
401262757,Colorado State Rams,K. Murphy,4068969,,False,21.0,8,12,8,12,0,0,3,4,6,8,14,0,0,0,0,0,19
401262757,Colorado State Rams,M. Torres,4704466,,False,4.0,0,0,0,0,0,0,0,0,0,1,1,1,1,1,0,0,0
401262757,Colorado State Rams,J. Bonnarens,4400102,,False,18.0,3,8,0,1,3,7,0,0,0,3,3,1,1,1,1,0,9
401262757,Colorado State Rams,L. Davis,4068248,,False,3.0,1,1,1,1,0,0,0,0,0,0,0,0,0,0,0,1,2
401262757,Colorado State Rams,M. Hemingway,4704465,,False,4.0,1,1,0,0,1,1,0,0,0,0,0,0,0,0,1,0,3
401262757,Colorado State Rams,P. Farkas,4704463,,False,12.0,2,5,0,1,2,4,0,0,0,2,2,2,0,1,1,0,6
401262757,Colorado State Rams,B. Alper,4595629,,False,10.0,2,3,2,2,0,1,0,0,0,0,0,2,0,0,0,2,4
401262757,Colorado State Rams,A. Eberhardt,4595628,,False,1.0,1,1,0,0,1,1,0,0,0,1,1,0,0,0,0,0,3
401262757,Colorado State Rams,K. Stamatelopoulos,4595627,,False,4.0,0,0,0,0,0,0,0,0,0,0,0,2,0,0,1,1,0
401262757,Colorado State Rams,L. Brocke,4281823,,False,2.0,1,1,0,0,1,1,0,0,0,0,0,0,0,0,0,1,3
401262757,Colorado State Rams,TEAM,TOTAL,TOTAL,False,,34,76,23,49,11,27,11,13,13,40,53,22,5,6,9,11,90
401262757,Colorado State Rams,C. Clark,4704464,,True,15.0,5,10,5,10,0,0,1,2,2,6,8,0,0,0,2,0,11
401262757,Colorado State Rams,E. Boni,4704462,,True,24.0,0,4,0,3,0,1,0,0,1,5,6,0,0,1,1,2,0
401262757,Colorado State Rams,M. Hofschild,4595160,,True,27.0,2,7,1,4,1,3,4,4,0,1,1,9,1,0,0,1,9
401262757,Colorado State Rams,L. Devos,4284002,,True,27.0,6,16,6,14,0,2,3,3,3,5,8,2,2,2,1,1,15
401262757,Colorado State Rams,T. Williams,4282176,,True,28.0,2,7,0,1,2,6,0,0,0,7,7,3,0,0,1,2,6
401262757,Colorado State Rams,K. Murphy,4068969,,False,21.0,8,12,8,12,0,0,3,4,6,8,14,0,0,0,0,0,19
401262757,Colorado State Rams,M. Torres,4704466,,False,4.0,0,0,0,0,0,0,0,0,0,1,1,1,1,1,0,0,0
401262757,Colorado State Rams,J. Bonnarens,4400102,,False,18.0,3,8,0,1,3,7,0,0,0,3,3,1,1,1,1,0,9
401262757,Colorado State Rams,L. Davis,4068248,,False,3.0,1,1,1,1,0,0,0,0,0,0,0,0,0,0,0,1,2
401262757,Colorado State Rams,M. Hemingway,4704465,,False,4.0,1,1,0,0,1,1,0,0,0,0,0,0,0,0,1,0,3
401262757,Colorado State Rams,P. Farkas,4704463,,False,12.0,2,5,0,1,2,4,0,0,0,2,2,2,0,1,1,0,6
401262757,Colorado State Rams,B. Alper,4595629,,False,10.0,2,3,2,2,0,1,0,0,0,0,0,2,0,0,0,2,4
401262757,Colorado State Rams,A. Eberhardt,4595628,,False,1.0,1,1,0,0,1,1,0,0,0,1,1,0,0,0,0,0,3
401262757,Colorado State Rams,K. Stamatelopoulos,4595627,,False,4.0,0,0,0,0,0,0,0,0,0,0,0,2,0,0,1,1,0
401262757,Colorado State Rams,L. Brocke,4281823,,False,2.0,1,1,0,0,1,1,0,0,0,0,0,0,0,0,0,1,3
401262757,Colorado State Rams,TEAM,TOTAL,TOTAL,False,,34,76,23,49,11,27,11,13,13,40,53,22,5,6,9,11,90
401262754,UNLV Lady Rebels,D. Byrne,4398924,,True,32.0,4,9,2,5,2,4,0,0,2,4,6,0,0,1,2,2,10
401262754,UNLV Lady Rebels,D. Young,4704625,,True,25.0,2,10,2,10,0,0,0,2,2,6,8,0,2,0,1,2,4
401262754,UNLV Lady Rebels,J. Thomas,4704624,,True,36.0,2,8,0,1,2,7,0,0,0,1,1,3,1,0,1,1,6
401262754,UNLV Lady Rebels,N. Johnson,4400108,,True,30.0,4,15,4,11,0,4,2,2,1,3,4,0,0,0,1,4,10
401262754,UNLV Lady Rebels,B. Thomas,4068210,,True,37.0,5,16,3,8,2,8,0,2,1,7,8,1,1,0,2,1,12
401262754,UNLV Lady Rebels,T. Carter,4595642,,False,5.0,0,1,0,0,0,1,0,0,0,0,0,0,1,0,1,0,0
401262754,UNLV Lady Rebels,K. Wilfred,4595641,,False,18.0,7,10,7,10,0,0,1,1,3,1,4,1,0,0,0,0,15
401262754,UNLV Lady Rebels,J. Singleton,4704623,,False,14.0,0,1,0,1,0,0,1,2,3,4,7,6,1,0,1,2,1
401262754,UNLV Lady Rebels,J. Buckley,4595639,,False,3.0,0,0,0,0,0,0,0,0,0,0,0,0,0,0,0,0,0
401262754,UNLV Lady Rebels,TEAM,TOTAL,TOTAL,False,,24,70,18,46,6,24,4,9,14,28,42,11,6,1,9,12,58
401262754,UNLV Lady Rebels,D. Byrne,4398924,,True,32.0,4,9,2,5,2,4,0,0,2,4,6,0,0,1,2,2,10
401262754,UNLV Lady Rebels,D. Young,4704625,,True,25.0,2,10,2,10,0,0,0,2,2,6,8,0,2,0,1,2,4
401262754,UNLV Lady Rebels,J. Thomas,4704624,,True,36.0,2,8,0,1,2,7,0,0,0,1,1,3,1,0,1,1,6
401262754,UNLV Lady Rebels,N. Johnson,4400108,,True,30.0,4,15,4,11,0,4,2,2,1,3,4,0,0,0,1,4,10
401262754,UNLV Lady Rebels,B. Thomas,4068210,,True,37.0,5,16,3,8,2,8,0,2,1,7,8,1,1,0,2,1,12
401262754,UNLV Lady Rebels,T. Carter,4595642,,False,5.0,0,1,0,0,0,1,0,0,0,0,0,0,1,0,1,0,0
401262754,UNLV Lady Rebels,K. Wilfred,4595641,,False,18.0,7,10,7,10,0,0,1,1,3,1,4,1,0,0,0,0,15
401262754,UNLV Lady Rebels,J. Singleton,4704623,,False,14.0,0,1,0,1,0,0,1,2,3,4,7,6,1,0,1,2,1
401262754,UNLV Lady Rebels,J. Buckley,4595639,,False,3.0,0,0,0,0,0,0,0,0,0,0,0,0,0,0,0,0,0
401262754,UNLV Lady Rebels,TEAM,TOTAL,TOTAL,False,,24,70,18,46,6,24,4,9,14,28,42,11,6,1,9,12,58
401262754,Colorado State Rams,K. Murphy,4068969,,True,26.0,2,7,2,7,0,0,0,0,3,8,11,0,1,1,2,3,4
401262754,Colorado State Rams,P. Farkas,4704463,,True,20.0,1,6,0,4,1,2,0,0,0,3,3,0,0,0,0,0,3
401262754,Colorado State Rams,M. Hofschild,4595160,,True,35.0,8,15,2,7,6,8,2,2,0,2,2,2,2,0,2,1,24
401262754,Colorado State Rams,L. Devos,4284002,,True,27.0,4,12,3,9,1,3,0,0,1,5,6,2,0,0,1,3,9
401262754,Colorado State Rams,T. Williams,4282176,,True,25.0,4,7,2,3,2,4,1,2,0,4,4,3,0,0,4,4,11
401262754,Colorado State Rams,C. Clark,4704464,,False,14.0,4,6,4,6,0,0,0,0,4,4,8,1,0,1,0,0,8
401262754,Colorado State Rams,J. Bonnarens,4400102,,False,21.0,1,5,1,2,0,3,0,0,0,3,3,2,1,0,0,0,2
401262754,Colorado State Rams,E. Boni,4704462,,False,27.0,2,5,2,4,0,1,0,0,0,2,2,1,0,1,0,2,4
401262754,Colorado State Rams,B. Alper,4595629,,False,5.0,1,1,1,1,0,0,0,0,0,3,3,1,0,0,1,0,2
401262754,Colorado State Rams,TEAM,TOTAL,TOTAL,False,,27,64,17,43,10,21,3,4,9,36,45,12,4,3,10,13,67
401262754,Colorado State Rams,K. Murphy,4068969,,True,26.0,2,7,2,7,0,0,0,0,3,8,11,0,1,1,2,3,4
401262754,Colorado State Rams,P. Farkas,4704463,,True,20.0,1,6,0,4,1,2,0,0,0,3,3,0,0,0,0,0,3
401262754,Colorado State Rams,M. Hofschild,4595160,,True,35.0,8,15,2,7,6,8,2,2,0,2,2,2,2,0,2,1,24
401262754,Colorado State Rams,L. Devos,4284002,,True,27.0,4,12,3,9,1,3,0,0,1,5,6,2,0,0,1,3,9
401262754,Colorado State Rams,T. Williams,4282176,,True,25.0,4,7,2,3,2,4,1,2,0,4,4,3,0,0,4,4,11
401262754,Colorado State Rams,C. Clark,4704464,,False,14.0,4,6,4,6,0,0,0,0,4,4,8,1,0,1,0,0,8
401262754,Colorado State Rams,J. Bonnarens,4400102,,False,21.0,1,5,1,2,0,3,0,0,0,3,3,2,1,0,0,0,2
401262754,Colorado State Rams,E. Boni,4704462,,False,27.0,2,5,2,4,0,1,0,0,0,2,2,1,0,1,0,2,4
401262754,Colorado State Rams,B. Alper,4595629,,False,5.0,1,1,1,1,0,0,0,0,0,3,3,1,0,0,1,0,2
401262754,Colorado State Rams,TEAM,TOTAL,TOTAL,False,,27,64,17,43,10,21,3,4,9,36,45,12,4,3,10,13,67
401262753,UNLV Lady Rebels,D. Byrne,4398924,,True,40.0,4,5,2,3,2,2,0,0,2,4,6,1,1,1,1,0,10
401262753,UNLV Lady Rebels,D. Young,4704625,,True,24.0,6,8,6,8,0,0,4,7,3,9,12,1,1,0,2,3,16
401262753,UNLV Lady Rebels,J. Thomas,4704624,,True,40.0,2,6,0,2,2,4,0,0,1,5,6,5,2,0,2,0,6
401262753,UNLV Lady Rebels,N. Johnson,4400108,,True,38.0,5,13,3,8,2,5,4,5,0,6,6,2,1,0,3,4,16
401262753,UNLV Lady Rebels,B. Thomas,4068210,,True,40.0,10,25,5,11,5,14,4,5,2,3,5,6,3,1,6,2,29
401262753,UNLV Lady Rebels,T. Carter,4595642,,False,8.0,0,1,0,0,0,1,0,0,1,3,4,0,0,0,1,1,0
401262753,UNLV Lady Rebels,K. Wilfred,4595641,,False,8.0,0,2,0,2,0,0,0,0,0,1,1,0,0,0,0,1,0
401262753,UNLV Lady Rebels,J. Buckley,4595639,,False,2.0,1,1,0,0,1,1,0,0,0,0,0,0,0,0,0,0,3
401262753,UNLV Lady Rebels,TEAM,TOTAL,TOTAL,False,,28,61,16,34,12,27,12,17,10,33,43,15,8,2,16,11,80
401262753,UNLV Lady Rebels,D. Byrne,4398924,,True,40.0,4,5,2,3,2,2,0,0,2,4,6,1,1,1,1,0,10
401262753,UNLV Lady Rebels,D. Young,4704625,,True,24.0,6,8,6,8,0,0,4,7,3,9,12,1,1,0,2,3,16
401262753,UNLV Lady Rebels,J. Thomas,4704624,,True,40.0,2,6,0,2,2,4,0,0,1,5,6,5,2,0,2,0,6
401262753,UNLV Lady Rebels,N. Johnson,4400108,,True,38.0,5,13,3,8,2,5,4,5,0,6,6,2,1,0,3,4,16
401262753,UNLV Lady Rebels,B. Thomas,4068210,,True,40.0,10,25,5,11,5,14,4,5,2,3,5,6,3,1,6,2,29
401262753,UNLV Lady Rebels,T. Carter,4595642,,False,8.0,0,1,0,0,0,1,0,0,1,3,4,0,0,0,1,1,0
401262753,UNLV Lady Rebels,K. Wilfred,4595641,,False,8.0,0,2,0,2,0,0,0,0,0,1,1,0,0,0,0,1,0
401262753,UNLV Lady Rebels,J. Buckley,4595639,,False,2.0,1,1,0,0,1,1,0,0,0,0,0,0,0,0,0,0,3
401262753,UNLV Lady Rebels,TEAM,TOTAL,TOTAL,False,,28,61,16,34,12,27,12,17,10,33,43,15,8,2,16,11,80
401262753,Colorado State Rams,C. Clark,4704464,,True,5.0,1,3,1,2,0,1,0,0,0,1,1,0,1,0,0,3,2
401262753,Colorado State Rams,P. Farkas,4704463,,True,32.0,4,9,1,1,3,8,0,0,1,5,6,0,0,1,2,2,11
401262753,Colorado State Rams,M. Hofschild,4595160,,True,36.0,8,19,6,14,2,5,2,3,0,4,4,8,0,0,3,1,20
401262753,Colorado State Rams,L. Devos,4284002,,True,38.0,4,7,2,5,2,2,0,0,0,6,6,3,0,4,2,2,10
401262753,Colorado State Rams,T. Williams,4282176,,True,38.0,3,12,1,2,2,10,1,1,0,4,4,6,6,0,2,3,9
401262753,Colorado State Rams,K. Murphy,4068969,,False,12.0,3,4,3,4,0,0,1,1,0,3,3,0,1,0,1,5,7
401262753,Colorado State Rams,J. Bonnarens,4400102,,False,24.0,4,6,2,4,2,2,2,2,0,1,1,1,0,0,0,2,12
401262753,Colorado State Rams,E. Boni,4704462,,False,10.0,1,3,1,1,0,2,0,0,0,1,1,0,0,0,1,1,2
401262753,Colorado State Rams,B. Alper,4595629,,False,4.0,1,2,0,1,1,1,0,0,0,0,0,0,0,0,0,0,3
401262753,Colorado State Rams,TEAM,TOTAL,TOTAL,False,,29,65,17,34,12,31,6,7,4,25,29,18,8,5,11,19,76
401262753,Colorado State Rams,C. Clark,4704464,,True,5.0,1,3,1,2,0,1,0,0,0,1,1,0,1,0,0,3,2
401262753,Colorado State Rams,P. Farkas,4704463,,True,32.0,4,9,1,1,3,8,0,0,1,5,6,0,0,1,2,2,11
401262753,Colorado State Rams,M. Hofschild,4595160,,True,36.0,8,19,6,14,2,5,2,3,0,4,4,8,0,0,3,1,20
401262753,Colorado State Rams,L. Devos,4284002,,True,38.0,4,7,2,5,2,2,0,0,0,6,6,3,0,4,2,2,10
401262753,Colorado State Rams,T. Williams,4282176,,True,38.0,3,12,1,2,2,10,1,1,0,4,4,6,6,0,2,3,9
401262753,Colorado State Rams,K. Murphy,4068969,,False,12.0,3,4,3,4,0,0,1,1,0,3,3,0,1,0,1,5,7
401262753,Colorado State Rams,J. Bonnarens,4400102,,False,24.0,4,6,2,4,2,2,2,2,0,1,1,1,0,0,0,2,12
401262753,Colorado State Rams,E. Boni,4704462,,False,10.0,1,3,1,1,0,2,0,0,0,1,1,0,0,0,1,1,2
401262753,Colorado State Rams,B. Alper,4595629,,False,4.0,1,2,0,1,1,1,0,0,0,0,0,0,0,0,0,0,3
401262753,Colorado State Rams,TEAM,TOTAL,TOTAL,False,,29,65,17,34,12,31,6,7,4,25,29,18,8,5,11,19,76
401262750,San Diego State Aztecs,K. Edwards,4281879,,True,10.0,1,1,1,1,0,0,0,0,0,0,0,0,0,0,0,0,2
401262750,San Diego State Aztecs,S. Ramos,4400168,,True,2.0,0,0,0,0,0,0,0,0,0,1,1,1,0,0,0,0,0
401262750,San Diego State Aztecs,A. Crain,4399223,,True,44.0,3,16,3,12,0,4,4,6,3,3,6,0,1,1,2,3,10
401262750,San Diego State Aztecs,M. Staples,4398925,,True,49.0,6,15,5,13,1,2,3,3,1,12,13,3,2,0,2,1,16
401262750,San Diego State Aztecs,T. Adams,4281876,,True,38.0,9,19,6,15,3,4,3,3,0,4,4,3,0,1,7,4,24
401262750,San Diego State Aztecs,K. Gipson,4704563,,False,24.0,4,7,4,7,0,0,2,2,6,4,10,0,2,0,1,4,10
401262750,San Diego State Aztecs,I. Murillo,4704566,,False,4.0,0,1,0,1,0,0,0,0,0,0,0,0,0,0,1,0,0
401262750,San Diego State Aztecs,F. Vinerte,4704564,,False,7.0,0,0,0,0,0,0,0,0,1,2,3,0,0,0,0,0,0
401262750,San Diego State Aztecs,K. Villalobos,4704565,,False,34.0,2,13,2,11,0,2,4,8,3,3,6,0,0,1,0,3,8
401262750,San Diego State Aztecs,T. Sireni,4595648,,False,7.0,2,2,2,2,0,0,1,1,0,0,0,0,0,0,0,0,5
401262750,San Diego State Aztecs,I. Hernandez,4595647,,False,31.0,1,9,1,6,0,3,0,0,3,2,5,0,0,1,1,0,2
401262750,San Diego State Aztecs,TEAM,TOTAL,TOTAL,False,,28,83,24,68,4,15,17,23,23,37,60,7,5,4,14,15,77
401262750,San Diego State Aztecs,K. Edwards,4281879,,True,10.0,1,1,1,1,0,0,0,0,0,0,0,0,0,0,0,0,2
401262750,San Diego State Aztecs,S. Ramos,4400168,,True,2.0,0,0,0,0,0,0,0,0,0,1,1,1,0,0,0,0,0
401262750,San Diego State Aztecs,A. Crain,4399223,,True,44.0,3,16,3,12,0,4,4,6,3,3,6,0,1,1,2,3,10
401262750,San Diego State Aztecs,M. Staples,4398925,,True,49.0,6,15,5,13,1,2,3,3,1,12,13,3,2,0,2,1,16
401262750,San Diego State Aztecs,T. Adams,4281876,,True,38.0,9,19,6,15,3,4,3,3,0,4,4,3,0,1,7,4,24
401262750,San Diego State Aztecs,K. Gipson,4704563,,False,24.0,4,7,4,7,0,0,2,2,6,4,10,0,2,0,1,4,10
401262750,San Diego State Aztecs,I. Murillo,4704566,,False,4.0,0,1,0,1,0,0,0,0,0,0,0,0,0,0,1,0,0
401262750,San Diego State Aztecs,F. Vinerte,4704564,,False,7.0,0,0,0,0,0,0,0,0,1,2,3,0,0,0,0,0,0
401262750,San Diego State Aztecs,K. Villalobos,4704565,,False,34.0,2,13,2,11,0,2,4,8,3,3,6,0,0,1,0,3,8
401262750,San Diego State Aztecs,T. Sireni,4595648,,False,7.0,2,2,2,2,0,0,1,1,0,0,0,0,0,0,0,0,5
401262750,San Diego State Aztecs,I. Hernandez,4595647,,False,31.0,1,9,1,6,0,3,0,0,3,2,5,0,0,1,1,0,2
401262750,San Diego State Aztecs,TEAM,TOTAL,TOTAL,False,,28,83,24,68,4,15,17,23,23,37,60,7,5,4,14,15,77
401262750,Colorado State Rams,S. Mech,4399658,,True,46.0,3,11,2,8,1,3,2,2,3,1,4,2,2,7,1,4,9
401262750,Colorado State Rams,E. Boni,4704462,,True,28.0,1,7,1,5,0,2,2,2,0,3,3,2,0,1,0,1,4
401262750,Colorado State Rams,M. Hofschild,4595160,,True,38.0,7,11,6,8,1,3,3,4,0,3,3,7,1,0,3,4,18
401262750,Colorado State Rams,L. Devos,4284002,,True,47.0,9,18,8,14,1,4,4,4,2,10,12,1,0,4,4,2,23
401262750,Colorado State Rams,T. Williams,4282176,,True,45.0,4,14,3,6,1,8,1,2,0,10,10,6,0,0,0,3,10
401262750,Colorado State Rams,C. Clark,4704464,,False,2.0,0,0,0,0,0,0,0,0,1,1,2,1,0,0,0,0,0
401262750,Colorado State Rams,J. Bonnarens,4400102,,False,26.0,6,9,3,6,3,3,0,0,0,4,4,0,1,0,0,0,15
401262750,Colorado State Rams,P. Farkas,4704463,,False,10.0,2,5,1,2,1,3,0,0,0,1,1,0,0,0,0,0,5
401262750,Colorado State Rams,B. Alper,4595629,,False,8.0,0,0,0,0,0,0,0,0,0,2,2,0,0,0,2,0,0
401262750,Colorado State Rams,TEAM,TOTAL,TOTAL,False,,32,75,24,49,8,26,12,14,6,36,42,19,4,12,11,14,84
401262750,Colorado State Rams,S. Mech,4399658,,True,46.0,3,11,2,8,1,3,2,2,3,1,4,2,2,7,1,4,9
401262750,Colorado State Rams,E. Boni,4704462,,True,28.0,1,7,1,5,0,2,2,2,0,3,3,2,0,1,0,1,4
401262750,Colorado State Rams,M. Hofschild,4595160,,True,38.0,7,11,6,8,1,3,3,4,0,3,3,7,1,0,3,4,18
401262750,Colorado State Rams,L. Devos,4284002,,True,47.0,9,18,8,14,1,4,4,4,2,10,12,1,0,4,4,2,23
401262750,Colorado State Rams,T. Williams,4282176,,True,45.0,4,14,3,6,1,8,1,2,0,10,10,6,0,0,0,3,10
401262750,Colorado State Rams,C. Clark,4704464,,False,2.0,0,0,0,0,0,0,0,0,1,1,2,1,0,0,0,0,0
401262750,Colorado State Rams,J. Bonnarens,4400102,,False,26.0,6,9,3,6,3,3,0,0,0,4,4,0,1,0,0,0,15
401262750,Colorado State Rams,P. Farkas,4704463,,False,10.0,2,5,1,2,1,3,0,0,0,1,1,0,0,0,0,0,5
401262750,Colorado State Rams,B. Alper,4595629,,False,8.0,0,0,0,0,0,0,0,0,0,2,2,0,0,0,2,0,0
401262750,Colorado State Rams,TEAM,TOTAL,TOTAL,False,,32,75,24,49,8,26,12,14,6,36,42,19,4,12,11,14,84
401262749,San Diego State Aztecs,K. Edwards,4281879,,True,13.0,4,5,4,5,0,0,0,0,1,3,4,0,0,0,1,1,8
401262749,San Diego State Aztecs,S. Ramos,4400168,,True,37.0,8,27,6,21,2,6,3,3,0,7,7,3,3,0,1,1,21
401262749,San Diego State Aztecs,A. Crain,4399223,,True,20.0,2,4,2,4,0,0,0,2,0,2,2,0,0,0,3,5,4
401262749,San Diego State Aztecs,M. Staples,4398925,,True,32.0,5,9,4,7,1,2,0,0,3,7,10,3,1,1,3,2,11
401262749,San Diego State Aztecs,T. Adams,4281876,,True,25.0,5,8,5,8,0,0,1,2,0,2,2,3,0,1,3,3,11
401262749,San Diego State Aztecs,K. Gipson,4704563,,False,10.0,1,2,1,2,0,0,0,0,2,2,4,0,0,0,0,0,2
401262749,San Diego State Aztecs,I. Murillo,4704566,,False,2.0,0,0,0,0,0,0,0,0,0,0,0,0,0,0,0,1,0
401262749,San Diego State Aztecs,F. Vinerte,4704564,,False,8.0,0,0,0,0,0,0,0,0,1,0,1,0,0,0,1,0,0
401262749,San Diego State Aztecs,K. Villalobos,4704565,,False,26.0,6,9,5,8,1,1,3,4,3,4,7,0,0,0,1,3,16
401262749,San Diego State Aztecs,T. Sireni,4595648,,False,7.0,0,2,0,2,0,0,2,2,0,0,0,0,0,0,1,1,2
401262749,San Diego State Aztecs,I. Hernandez,4595647,,False,20.0,1,1,1,1,0,0,0,0,1,1,2,0,0,0,1,1,2
401262749,San Diego State Aztecs,TEAM,TOTAL,TOTAL,False,,32,67,28,58,4,9,9,13,11,30,41,9,4,2,16,18,77
401262749,San Diego State Aztecs,K. Edwards,4281879,,True,13.0,4,5,4,5,0,0,0,0,1,3,4,0,0,0,1,1,8
401262749,San Diego State Aztecs,S. Ramos,4400168,,True,37.0,8,27,6,21,2,6,3,3,0,7,7,3,3,0,1,1,21
401262749,San Diego State Aztecs,A. Crain,4399223,,True,20.0,2,4,2,4,0,0,0,2,0,2,2,0,0,0,3,5,4
401262749,San Diego State Aztecs,M. Staples,4398925,,True,32.0,5,9,4,7,1,2,0,0,3,7,10,3,1,1,3,2,11
401262749,San Diego State Aztecs,T. Adams,4281876,,True,25.0,5,8,5,8,0,0,1,2,0,2,2,3,0,1,3,3,11
401262749,San Diego State Aztecs,K. Gipson,4704563,,False,10.0,1,2,1,2,0,0,0,0,2,2,4,0,0,0,0,0,2
401262749,San Diego State Aztecs,I. Murillo,4704566,,False,2.0,0,0,0,0,0,0,0,0,0,0,0,0,0,0,0,1,0
401262749,San Diego State Aztecs,F. Vinerte,4704564,,False,8.0,0,0,0,0,0,0,0,0,1,0,1,0,0,0,1,0,0
401262749,San Diego State Aztecs,K. Villalobos,4704565,,False,26.0,6,9,5,8,1,1,3,4,3,4,7,0,0,0,1,3,16
401262749,San Diego State Aztecs,T. Sireni,4595648,,False,7.0,0,2,0,2,0,0,2,2,0,0,0,0,0,0,1,1,2
401262749,San Diego State Aztecs,I. Hernandez,4595647,,False,20.0,1,1,1,1,0,0,0,0,1,1,2,0,0,0,1,1,2
401262749,San Diego State Aztecs,TEAM,TOTAL,TOTAL,False,,32,67,28,58,4,9,9,13,11,30,41,9,4,2,16,18,77
401262749,Colorado State Rams,C. Clark,4704464,,True,10.0,0,2,0,1,0,1,0,0,0,4,4,1,0,1,0,0,0
401262749,Colorado State Rams,S. Mech,4399658,,True,35.0,3,6,2,3,1,3,1,2,0,4,4,2,1,1,0,3,8
401262749,Colorado State Rams,E. Boni,4704462,,True,34.0,3,3,3,3,0,0,0,0,0,4,4,3,1,1,3,2,6
401262749,Colorado State Rams,M. Hofschild,4595160,,True,32.0,7,18,5,12,2,6,3,6,0,2,2,7,1,0,0,0,19
401262749,Colorado State Rams,T. Williams,4282176,,True,35.0,5,12,1,4,4,8,3,4,0,3,3,2,1,0,1,1,17
401262749,Colorado State Rams,J. Bonnarens,4400102,,False,5.0,2,2,1,1,1,1,2,2,0,0,0,0,0,0,0,0,7
401262749,Colorado State Rams,P. Farkas,4704463,,False,6.0,0,3,0,1,0,2,0,0,0,1,1,0,0,0,1,0,0
401262749,Colorado State Rams,B. Alper,4595629,,False,8.0,2,5,2,5,0,0,0,0,0,0,0,0,0,0,1,2,4
401262749,Colorado State Rams,K. Stamatelopoulos,4595627,,False,0.0,0,0,0,0,0,0,0,0,0,0,0,0,0,0,0,0,0
401262749,Colorado State Rams,L. Devos,4284002,,False,35.0,9,14,5,9,4,5,3,4,4,7,11,0,2,2,3,2,25
401262749,Colorado State Rams,TEAM,TOTAL,TOTAL,False,,31,65,19,39,12,26,12,18,5,27,32,15,6,5,9,10,86
401262749,Colorado State Rams,C. Clark,4704464,,True,10.0,0,2,0,1,0,1,0,0,0,4,4,1,0,1,0,0,0
401262749,Colorado State Rams,S. Mech,4399658,,True,35.0,3,6,2,3,1,3,1,2,0,4,4,2,1,1,0,3,8
401262749,Colorado State Rams,E. Boni,4704462,,True,34.0,3,3,3,3,0,0,0,0,0,4,4,3,1,1,3,2,6
401262749,Colorado State Rams,M. Hofschild,4595160,,True,32.0,7,18,5,12,2,6,3,6,0,2,2,7,1,0,0,0,19
401262749,Colorado State Rams,T. Williams,4282176,,True,35.0,5,12,1,4,4,8,3,4,0,3,3,2,1,0,1,1,17
401262749,Colorado State Rams,J. Bonnarens,4400102,,False,5.0,2,2,1,1,1,1,2,2,0,0,0,0,0,0,0,0,7
401262749,Colorado State Rams,P. Farkas,4704463,,False,6.0,0,3,0,1,0,2,0,0,0,1,1,0,0,0,1,0,0
401262749,Colorado State Rams,B. Alper,4595629,,False,8.0,2,5,2,5,0,0,0,0,0,0,0,0,0,0,1,2,4
401262749,Colorado State Rams,K. Stamatelopoulos,4595627,,False,0.0,0,0,0,0,0,0,0,0,0,0,0,0,0,0,0,0,0
401262749,Colorado State Rams,L. Devos,4284002,,False,35.0,9,14,5,9,4,5,3,4,4,7,11,0,2,2,3,2,25
401262749,Colorado State Rams,TEAM,TOTAL,TOTAL,False,,31,65,19,39,12,26,12,18,5,27,32,15,6,5,9,10,86
401262748,San Diego State Aztecs,K. Gipson,4704563,,True,7.0,0,0,0,0,0,0,0,0,0,1,1,0,0,2,2,2,0
401262748,San Diego State Aztecs,M. Adams,4400169,,True,24.0,7,14,3,6,4,8,0,0,1,5,6,0,1,1,1,1,18
401262748,San Diego State Aztecs,S. Ramos,4400168,,True,34.0,3,10,1,8,2,2,7,10,1,4,5,5,0,0,2,1,15
401262748,San Diego State Aztecs,M. Staples,4398925,,True,22.0,2,9,2,6,0,3,0,0,0,5,5,1,0,0,1,1,4
401262748,San Diego State Aztecs,T. Adams,4281876,,True,25.0,4,7,3,6,1,1,0,0,0,1,1,3,1,0,1,1,9
401262748,San Diego State Aztecs,I. Murillo,4704566,,False,5.0,0,0,0,0,0,0,0,0,0,1,1,1,0,0,1,3,0
401262748,San Diego State Aztecs,F. Vinerte,4704564,,False,16.0,3,5,3,5,0,0,2,2,3,5,8,0,0,0,2,0,8
401262748,San Diego State Aztecs,K. Edwards,4281879,,False,13.0,1,5,0,2,1,3,0,0,1,0,1,0,0,0,2,1,3
401262748,San Diego State Aztecs,K. Villalobos,4704565,,False,15.0,2,3,2,3,0,0,1,2,1,2,3,0,0,0,1,1,5
401262748,San Diego State Aztecs,I. Hernandez,4595647,,False,18.0,2,6,0,4,2,2,0,0,0,0,0,4,0,0,0,2,6
401262748,San Diego State Aztecs,A. Crain,4399223,,False,21.0,2,2,0,0,2,2,0,0,0,1,1,1,0,0,0,1,6
401262748,San Diego State Aztecs,TEAM,TOTAL,TOTAL,False,,26,61,14,40,12,21,10,14,10,30,40,15,2,3,13,14,74
401262748,San Diego State Aztecs,K. Gipson,4704563,,True,7.0,0,0,0,0,0,0,0,0,0,1,1,0,0,2,2,2,0
401262748,San Diego State Aztecs,M. Adams,4400169,,True,24.0,7,14,3,6,4,8,0,0,1,5,6,0,1,1,1,1,18
401262748,San Diego State Aztecs,S. Ramos,4400168,,True,34.0,3,10,1,8,2,2,7,10,1,4,5,5,0,0,2,1,15
401262748,San Diego State Aztecs,M. Staples,4398925,,True,22.0,2,9,2,6,0,3,0,0,0,5,5,1,0,0,1,1,4
401262748,San Diego State Aztecs,T. Adams,4281876,,True,25.0,4,7,3,6,1,1,0,0,0,1,1,3,1,0,1,1,9
401262748,San Diego State Aztecs,I. Murillo,4704566,,False,5.0,0,0,0,0,0,0,0,0,0,1,1,1,0,0,1,3,0
401262748,San Diego State Aztecs,F. Vinerte,4704564,,False,16.0,3,5,3,5,0,0,2,2,3,5,8,0,0,0,2,0,8
401262748,San Diego State Aztecs,K. Edwards,4281879,,False,13.0,1,5,0,2,1,3,0,0,1,0,1,0,0,0,2,1,3
401262748,San Diego State Aztecs,K. Villalobos,4704565,,False,15.0,2,3,2,3,0,0,1,2,1,2,3,0,0,0,1,1,5
401262748,San Diego State Aztecs,I. Hernandez,4595647,,False,18.0,2,6,0,4,2,2,0,0,0,0,0,4,0,0,0,2,6
401262748,San Diego State Aztecs,A. Crain,4399223,,False,21.0,2,2,0,0,2,2,0,0,0,1,1,1,0,0,0,1,6
401262748,San Diego State Aztecs,TEAM,TOTAL,TOTAL,False,,26,61,14,40,12,21,10,14,10,30,40,15,2,3,13,14,74
401262748,Boise State Broncos,A. Mark,4606930,,True,32.0,3,8,3,8,0,0,0,0,5,6,11,7,1,0,2,2,6
401262748,Boise State Broncos,A. Muse,4583056,,True,24.0,7,13,7,13,0,0,2,3,3,1,4,0,1,2,0,0,16
401262748,Boise State Broncos,M. McGwire,4066535,,True,31.0,8,15,3,6,5,9,0,0,1,8,9,2,0,1,1,5,21
401262748,Boise State Broncos,M. Naro,4705625,,True,34.0,1,4,0,1,1,3,1,2,0,0,0,3,2,1,1,1,4
401262748,Boise State Broncos,J. Loville,4400537,,True,36.0,7,22,7,22,0,0,3,4,1,2,3,4,1,0,0,1,17
401262748,Boise State Broncos,E. Lalotte,4705630,,False,12.0,2,4,2,4,0,0,0,0,0,2,2,0,0,0,0,0,4
401262748,Boise State Broncos,K. Sykes,4595619,,False,10.0,0,3,0,1,0,2,0,0,1,1,2,0,0,0,1,1,0
401262748,Boise State Broncos,C. Gil,4705627,,False,3.0,0,1,0,0,0,1,0,0,0,1,1,1,0,0,0,0,0
401262748,Boise State Broncos,A. Ostlie,4705626,,False,18.0,1,5,1,1,0,4,2,2,0,3,3,0,1,0,2,2,4
401262748,Boise State Broncos,TEAM,TOTAL,TOTAL,False,,29,75,23,56,6,19,8,11,14,24,38,17,6,4,7,12,72
401262748,Boise State Broncos,A. Mark,4606930,,True,32.0,3,8,3,8,0,0,0,0,5,6,11,7,1,0,2,2,6
401262748,Boise State Broncos,A. Muse,4583056,,True,24.0,7,13,7,13,0,0,2,3,3,1,4,0,1,2,0,0,16
401262748,Boise State Broncos,M. McGwire,4066535,,True,31.0,8,15,3,6,5,9,0,0,1,8,9,2,0,1,1,5,21
401262748,Boise State Broncos,M. Naro,4705625,,True,34.0,1,4,0,1,1,3,1,2,0,0,0,3,2,1,1,1,4
401262748,Boise State Broncos,J. Loville,4400537,,True,36.0,7,22,7,22,0,0,3,4,1,2,3,4,1,0,0,1,17
401262748,Boise State Broncos,E. Lalotte,4705630,,False,12.0,2,4,2,4,0,0,0,0,0,2,2,0,0,0,0,0,4
401262748,Boise State Broncos,K. Sykes,4595619,,False,10.0,0,3,0,1,0,2,0,0,1,1,2,0,0,0,1,1,0
401262748,Boise State Broncos,C. Gil,4705627,,False,3.0,0,1,0,0,0,1,0,0,0,1,1,1,0,0,0,0,0
401262748,Boise State Broncos,A. Ostlie,4705626,,False,18.0,1,5,1,1,0,4,2,2,0,3,3,0,1,0,2,2,4
401262748,Boise State Broncos,TEAM,TOTAL,TOTAL,False,,29,75,23,56,6,19,8,11,14,24,38,17,6,4,7,12,72
401262747,San Diego State Aztecs,K. Gipson,4704563,,True,8.0,0,0,0,0,0,0,0,2,0,0,0,0,0,0,2,4,0
401262747,San Diego State Aztecs,M. Adams,4400169,,True,23.0,2,8,1,3,1,5,0,0,0,3,3,0,0,0,2,1,5
401262747,San Diego State Aztecs,S. Ramos,4400168,,True,29.0,8,10,5,7,3,3,4,6,0,1,1,0,4,0,6,2,23
401262747,San Diego State Aztecs,M. Staples,4398925,,True,24.0,1,7,1,5,0,2,0,0,0,2,2,0,1,0,2,1,2
401262747,San Diego State Aztecs,T. Adams,4281876,,True,27.0,3,8,3,7,0,1,3,5,1,4,5,1,0,0,3,3,9
401262747,San Diego State Aztecs,I. Murillo,4704566,,False,5.0,0,1,0,0,0,1,0,0,0,0,0,0,0,0,1,0,0
401262747,San Diego State Aztecs,F. Vinerte,4704564,,False,15.0,1,4,1,4,0,0,2,2,1,0,1,1,0,0,1,0,4
401262747,San Diego State Aztecs,K. Edwards,4281879,,False,9.0,0,4,0,4,0,0,1,2,2,0,2,1,0,0,1,0,1
401262747,San Diego State Aztecs,K. Villalobos,4704565,,False,18.0,0,8,0,8,0,0,0,0,2,2,4,1,0,1,0,0,0
401262747,San Diego State Aztecs,I. Hernandez,4595647,,False,25.0,0,3,0,0,0,3,0,0,2,3,5,0,0,0,2,2,0
401262747,San Diego State Aztecs,A. Crain,4399223,,False,17.0,0,4,0,2,0,2,0,0,0,0,0,0,0,1,0,2,0
401262747,San Diego State Aztecs,TEAM,TOTAL,TOTAL,False,,15,57,11,40,4,17,10,17,14,20,34,4,5,2,20,15,44
401262747,San Diego State Aztecs,K. Gipson,4704563,,True,8.0,0,0,0,0,0,0,0,2,0,0,0,0,0,0,2,4,0
401262747,San Diego State Aztecs,M. Adams,4400169,,True,23.0,2,8,1,3,1,5,0,0,0,3,3,0,0,0,2,1,5
401262747,San Diego State Aztecs,S. Ramos,4400168,,True,29.0,8,10,5,7,3,3,4,6,0,1,1,0,4,0,6,2,23
401262747,San Diego State Aztecs,M. Staples,4398925,,True,24.0,1,7,1,5,0,2,0,0,0,2,2,0,1,0,2,1,2
401262747,San Diego State Aztecs,T. Adams,4281876,,True,27.0,3,8,3,7,0,1,3,5,1,4,5,1,0,0,3,3,9
401262747,San Diego State Aztecs,I. Murillo,4704566,,False,5.0,0,1,0,0,0,1,0,0,0,0,0,0,0,0,1,0,0
401262747,San Diego State Aztecs,F. Vinerte,4704564,,False,15.0,1,4,1,4,0,0,2,2,1,0,1,1,0,0,1,0,4
401262747,San Diego State Aztecs,K. Edwards,4281879,,False,9.0,0,4,0,4,0,0,1,2,2,0,2,1,0,0,1,0,1
401262747,San Diego State Aztecs,K. Villalobos,4704565,,False,18.0,0,8,0,8,0,0,0,0,2,2,4,1,0,1,0,0,0
401262747,San Diego State Aztecs,I. Hernandez,4595647,,False,25.0,0,3,0,0,0,3,0,0,2,3,5,0,0,0,2,2,0
401262747,San Diego State Aztecs,A. Crain,4399223,,False,17.0,0,4,0,2,0,2,0,0,0,0,0,0,0,1,0,2,0
401262747,San Diego State Aztecs,TEAM,TOTAL,TOTAL,False,,15,57,11,40,4,17,10,17,14,20,34,4,5,2,20,15,44
401262747,Boise State Broncos,A. Mark,4606930,,True,30.0,5,9,5,9,0,0,4,4,0,3,3,4,3,0,4,2,14
401262747,Boise State Broncos,A. Muse,4583056,,True,27.0,2,8,2,8,0,0,3,4,2,10,12,2,3,3,0,1,7
401262747,Boise State Broncos,M. McGwire,4066535,,True,25.0,8,10,6,7,2,3,0,0,0,7,7,1,2,3,0,2,18
401262747,Boise State Broncos,M. Naro,4705625,,True,30.0,0,4,0,1,0,3,0,0,1,2,3,6,0,0,3,1,0
401262747,Boise State Broncos,J. Loville,4400537,,True,31.0,8,13,8,13,0,0,5,6,2,0,2,2,1,0,1,3,21
401262747,Boise State Broncos,E. Lalotte,4705630,,False,17.0,3,7,3,7,0,0,0,0,1,5,6,1,0,0,0,3,6
401262747,Boise State Broncos,K. Sykes,4595619,,False,11.0,4,6,1,1,3,5,0,0,1,2,3,0,1,0,0,1,11
401262747,Boise State Broncos,M. Machalova,4705628,,False,5.0,1,2,1,1,0,1,0,0,1,0,1,0,0,0,0,0,2
401262747,Boise State Broncos,C. Gil,4705627,,False,7.0,1,1,0,0,1,1,0,0,0,0,0,0,0,0,0,0,3
401262747,Boise State Broncos,A. Ostlie,4705626,,False,17.0,1,5,1,1,0,4,1,2,0,0,0,2,1,0,2,2,3
401262747,Boise State Broncos,TEAM,TOTAL,TOTAL,False,,33,65,27,48,6,17,13,16,12,30,42,18,11,6,10,15,85
401262747,Boise State Broncos,A. Mark,4606930,,True,30.0,5,9,5,9,0,0,4,4,0,3,3,4,3,0,4,2,14
401262747,Boise State Broncos,A. Muse,4583056,,True,27.0,2,8,2,8,0,0,3,4,2,10,12,2,3,3,0,1,7
401262747,Boise State Broncos,M. McGwire,4066535,,True,25.0,8,10,6,7,2,3,0,0,0,7,7,1,2,3,0,2,18
401262747,Boise State Broncos,M. Naro,4705625,,True,30.0,0,4,0,1,0,3,0,0,1,2,3,6,0,0,3,1,0
401262747,Boise State Broncos,J. Loville,4400537,,True,31.0,8,13,8,13,0,0,5,6,2,0,2,2,1,0,1,3,21
401262747,Boise State Broncos,E. Lalotte,4705630,,False,17.0,3,7,3,7,0,0,0,0,1,5,6,1,0,0,0,3,6
401262747,Boise State Broncos,K. Sykes,4595619,,False,11.0,4,6,1,1,3,5,0,0,1,2,3,0,1,0,0,1,11
401262747,Boise State Broncos,M. Machalova,4705628,,False,5.0,1,2,1,1,0,1,0,0,1,0,1,0,0,0,0,0,2
401262747,Boise State Broncos,C. Gil,4705627,,False,7.0,1,1,0,0,1,1,0,0,0,0,0,0,0,0,0,0,3
401262747,Boise State Broncos,A. Ostlie,4705626,,False,17.0,1,5,1,1,0,4,1,2,0,0,0,2,1,0,2,2,3
401262747,Boise State Broncos,TEAM,TOTAL,TOTAL,False,,33,65,27,48,6,17,13,16,12,30,42,18,11,6,10,15,85
401262746,Utah State Aggies,J. Chatman,4068281,,True,26.0,5,11,3,7,2,4,0,0,0,3,3,2,1,0,3,4,12
401262746,Utah State Aggies,M. Pruitt,4704651,,True,27.0,7,18,7,15,0,3,1,2,2,11,13,1,5,1,4,3,15
401262746,Utah State Aggies,K. Falslev,4704648,,True,11.0,0,0,0,0,0,0,0,0,0,2,2,1,0,0,2,0,0
401262746,Utah State Aggies,S. Latone,4399209,,True,31.0,4,11,1,3,3,8,2,3,0,2,2,2,1,2,0,2,13
401262746,Utah State Aggies,E. Harris,4281891,,True,37.0,6,13,3,6,3,7,1,5,0,1,1,5,2,0,3,2,16
401262746,Utah State Aggies,E. Jarrell,4704653,,False,4.0,1,3,1,3,0,0,0,0,0,0,0,0,0,0,1,2,2
401262746,Utah State Aggies,T. Franson,4281892,,False,22.0,2,6,2,6,0,0,0,0,4,7,11,1,1,0,0,4,4
401262746,Utah State Aggies,K. Kamakawiwo'ole,4595670,,False,17.0,0,6,0,4,0,2,0,0,0,3,3,1,0,0,0,0,0
401262746,Utah State Aggies,F. Brantley,4595669,,False,25.0,3,6,2,5,1,1,3,3,0,1,1,2,0,0,3,2,10
401262746,Utah State Aggies,TEAM,TOTAL,TOTAL,False,,28,74,19,49,9,25,7,13,8,35,43,15,10,3,16,19,72
401262746,Utah State Aggies,J. Chatman,4068281,,True,26.0,5,11,3,7,2,4,0,0,0,3,3,2,1,0,3,4,12
401262746,Utah State Aggies,M. Pruitt,4704651,,True,27.0,7,18,7,15,0,3,1,2,2,11,13,1,5,1,4,3,15
401262746,Utah State Aggies,K. Falslev,4704648,,True,11.0,0,0,0,0,0,0,0,0,0,2,2,1,0,0,2,0,0
401262746,Utah State Aggies,S. Latone,4399209,,True,31.0,4,11,1,3,3,8,2,3,0,2,2,2,1,2,0,2,13
401262746,Utah State Aggies,E. Harris,4281891,,True,37.0,6,13,3,6,3,7,1,5,0,1,1,5,2,0,3,2,16
401262746,Utah State Aggies,E. Jarrell,4704653,,False,4.0,1,3,1,3,0,0,0,0,0,0,0,0,0,0,1,2,2
401262746,Utah State Aggies,T. Franson,4281892,,False,22.0,2,6,2,6,0,0,0,0,4,7,11,1,1,0,0,4,4
401262746,Utah State Aggies,K. Kamakawiwo'ole,4595670,,False,17.0,0,6,0,4,0,2,0,0,0,3,3,1,0,0,0,0,0
401262746,Utah State Aggies,F. Brantley,4595669,,False,25.0,3,6,2,5,1,1,3,3,0,1,1,2,0,0,3,2,10
401262746,Utah State Aggies,TEAM,TOTAL,TOTAL,False,,28,74,19,49,9,25,7,13,8,35,43,15,10,3,16,19,72
401262746,Boise State Broncos,A. Mark,4606930,,True,27.0,3,8,3,8,0,0,1,2,3,10,13,2,2,1,1,2,7
401262746,Boise State Broncos,A. Muse,4583056,,True,16.0,5,5,5,5,0,0,0,2,2,4,6,1,1,2,2,4,10
401262746,Boise State Broncos,M. McGwire,4066535,,True,26.0,5,15,3,9,2,6,3,5,0,10,10,2,1,0,1,0,15
401262746,Boise State Broncos,M. Naro,4705625,,True,26.0,1,6,1,4,0,2,4,6,1,2,3,9,2,1,2,2,6
401262746,Boise State Broncos,J. Loville,4400537,,True,28.0,7,15,7,15,0,0,4,4,0,2,2,2,0,1,3,1,18
401262746,Boise State Broncos,E. Lalotte,4705630,,False,16.0,3,9,3,9,0,0,1,2,2,1,3,0,0,1,0,0,7
401262746,Boise State Broncos,K. Sykes,4595619,,False,15.0,0,2,0,1,0,1,0,0,1,1,2,1,0,0,0,1,0
401262746,Boise State Broncos,M. Machalova,4705628,,False,8.0,0,0,0,0,0,0,0,0,0,1,1,0,0,0,0,1,0
401262746,Boise State Broncos,C. Gil,4705627,,False,17.0,2,4,0,1,2,3,0,0,1,2,3,1,1,1,5,3,6
401262746,Boise State Broncos,A. Ostlie,4705626,,False,21.0,4,9,0,0,4,9,0,0,0,2,2,6,0,0,1,2,12
401262746,Boise State Broncos,TEAM,TOTAL,TOTAL,False,,30,73,22,52,8,21,13,21,12,41,53,24,7,7,15,16,81
401262746,Boise State Broncos,A. Mark,4606930,,True,27.0,3,8,3,8,0,0,1,2,3,10,13,2,2,1,1,2,7
401262746,Boise State Broncos,A. Muse,4583056,,True,16.0,5,5,5,5,0,0,0,2,2,4,6,1,1,2,2,4,10
401262746,Boise State Broncos,M. McGwire,4066535,,True,26.0,5,15,3,9,2,6,3,5,0,10,10,2,1,0,1,0,15
401262746,Boise State Broncos,M. Naro,4705625,,True,26.0,1,6,1,4,0,2,4,6,1,2,3,9,2,1,2,2,6
401262746,Boise State Broncos,J. Loville,4400537,,True,28.0,7,15,7,15,0,0,4,4,0,2,2,2,0,1,3,1,18
401262746,Boise State Broncos,E. Lalotte,4705630,,False,16.0,3,9,3,9,0,0,1,2,2,1,3,0,0,1,0,0,7
401262746,Boise State Broncos,K. Sykes,4595619,,False,15.0,0,2,0,1,0,1,0,0,1,1,2,1,0,0,0,1,0
401262746,Boise State Broncos,M. Machalova,4705628,,False,8.0,0,0,0,0,0,0,0,0,0,1,1,0,0,0,0,1,0
401262746,Boise State Broncos,C. Gil,4705627,,False,17.0,2,4,0,1,2,3,0,0,1,2,3,1,1,1,5,3,6
401262746,Boise State Broncos,A. Ostlie,4705626,,False,21.0,4,9,0,0,4,9,0,0,0,2,2,6,0,0,1,2,12
401262746,Boise State Broncos,TEAM,TOTAL,TOTAL,False,,30,73,22,52,8,21,13,21,12,41,53,24,7,7,15,16,81
401262745,Utah State Aggies,J. Chatman,4068281,,True,36.0,4,9,2,4,2,5,2,4,2,4,6,4,0,1,2,4,12
401262745,Utah State Aggies,H. Nelson,4704652,,True,6.0,0,1,0,1,0,0,0,0,2,1,3,0,0,0,1,0,0
401262745,Utah State Aggies,M. Mendazona,4704647,,True,13.0,2,5,1,3,1,2,1,2,0,1,1,1,0,0,3,0,6
401262745,Utah State Aggies,S. Latone,4399209,,True,29.0,1,14,1,7,0,7,0,0,0,2,2,4,1,1,4,1,2
401262745,Utah State Aggies,E. Harris,4281891,,True,37.0,6,12,4,8,2,4,0,0,0,4,4,6,2,0,6,1,14
401262745,Utah State Aggies,E. Jarrell,4704653,,False,5.0,1,1,1,1,0,0,1,1,0,0,0,0,0,1,0,0,3
401262745,Utah State Aggies,T. Franson,4281892,,False,22.0,3,5,3,5,0,0,0,0,2,4,6,1,1,1,0,3,6
401262745,Utah State Aggies,M. Pruitt,4704651,,False,18.0,5,9,4,8,1,1,1,3,0,3,3,1,1,1,3,4,12
401262745,Utah State Aggies,K. Falslev,4704648,,False,33.0,5,11,2,3,3,8,1,2,0,2,2,0,0,0,1,2,14
401262745,Utah State Aggies,J. Polansky,4595673,,False,1.0,0,0,0,0,0,0,0,0,0,0,0,0,1,0,0,0,0
401262745,Utah State Aggies,TEAM,TOTAL,TOTAL,False,,27,67,18,40,9,27,6,12,12,24,36,17,6,5,20,15,69
401262745,Utah State Aggies,J. Chatman,4068281,,True,36.0,4,9,2,4,2,5,2,4,2,4,6,4,0,1,2,4,12
401262745,Utah State Aggies,H. Nelson,4704652,,True,6.0,0,1,0,1,0,0,0,0,2,1,3,0,0,0,1,0,0
401262745,Utah State Aggies,M. Mendazona,4704647,,True,13.0,2,5,1,3,1,2,1,2,0,1,1,1,0,0,3,0,6
401262745,Utah State Aggies,S. Latone,4399209,,True,29.0,1,14,1,7,0,7,0,0,0,2,2,4,1,1,4,1,2
401262745,Utah State Aggies,E. Harris,4281891,,True,37.0,6,12,4,8,2,4,0,0,0,4,4,6,2,0,6,1,14
401262745,Utah State Aggies,E. Jarrell,4704653,,False,5.0,1,1,1,1,0,0,1,1,0,0,0,0,0,1,0,0,3
401262745,Utah State Aggies,T. Franson,4281892,,False,22.0,3,5,3,5,0,0,0,0,2,4,6,1,1,1,0,3,6
401262745,Utah State Aggies,M. Pruitt,4704651,,False,18.0,5,9,4,8,1,1,1,3,0,3,3,1,1,1,3,4,12
401262745,Utah State Aggies,K. Falslev,4704648,,False,33.0,5,11,2,3,3,8,1,2,0,2,2,0,0,0,1,2,14
401262745,Utah State Aggies,J. Polansky,4595673,,False,1.0,0,0,0,0,0,0,0,0,0,0,0,0,1,0,0,0,0
401262745,Utah State Aggies,TEAM,TOTAL,TOTAL,False,,27,67,18,40,9,27,6,12,12,24,36,17,6,5,20,15,69
401262745,Boise State Broncos,A. Mark,4606930,,True,29.0,7,10,7,9,0,1,2,2,5,5,10,2,1,1,3,3,16
401262745,Boise State Broncos,A. Muse,4583056,,True,16.0,4,7,4,7,0,0,2,2,1,6,7,1,1,3,2,1,10
401262745,Boise State Broncos,M. McGwire,4066535,,True,29.0,8,15,7,9,1,6,0,3,2,5,7,2,2,1,1,2,17
401262745,Boise State Broncos,M. Naro,4705625,,True,35.0,1,6,1,3,0,3,1,1,3,2,5,16,1,0,2,0,3
401262745,Boise State Broncos,J. Loville,4400537,,True,29.0,9,16,9,15,0,1,2,2,3,7,10,2,2,2,1,4,20
401262745,Boise State Broncos,E. Lalotte,4705630,,False,16.0,4,8,4,8,0,0,1,2,0,3,3,0,1,1,3,5,9
401262745,Boise State Broncos,K. Sykes,4595619,,False,15.0,0,3,0,2,0,1,0,0,1,0,1,1,1,0,0,0,0
401262745,Boise State Broncos,M. Machalova,4705628,,False,3.0,0,0,0,0,0,0,0,0,0,0,0,0,0,0,0,0,0
401262745,Boise State Broncos,C. Gil,4705627,,False,8.0,0,3,0,1,0,2,0,0,1,0,1,2,0,0,0,2,0
401262745,Boise State Broncos,A. Ostlie,4705626,,False,20.0,4,9,0,0,4,9,0,0,0,2,2,2,1,0,2,3,12
401262745,Boise State Broncos,TEAM,TOTAL,TOTAL,False,,37,77,32,54,5,23,8,12,17,33,50,28,10,8,14,20,87
401262745,Boise State Broncos,A. Mark,4606930,,True,29.0,7,10,7,9,0,1,2,2,5,5,10,2,1,1,3,3,16
401262745,Boise State Broncos,A. Muse,4583056,,True,16.0,4,7,4,7,0,0,2,2,1,6,7,1,1,3,2,1,10
401262745,Boise State Broncos,M. McGwire,4066535,,True,29.0,8,15,7,9,1,6,0,3,2,5,7,2,2,1,1,2,17
401262745,Boise State Broncos,M. Naro,4705625,,True,35.0,1,6,1,3,0,3,1,1,3,2,5,16,1,0,2,0,3
401262745,Boise State Broncos,J. Loville,4400537,,True,29.0,9,16,9,15,0,1,2,2,3,7,10,2,2,2,1,4,20
401262745,Boise State Broncos,E. Lalotte,4705630,,False,16.0,4,8,4,8,0,0,1,2,0,3,3,0,1,1,3,5,9
401262745,Boise State Broncos,K. Sykes,4595619,,False,15.0,0,3,0,2,0,1,0,0,1,0,1,1,1,0,0,0,0
401262745,Boise State Broncos,M. Machalova,4705628,,False,3.0,0,0,0,0,0,0,0,0,0,0,0,0,0,0,0,0,0
401262745,Boise State Broncos,C. Gil,4705627,,False,8.0,0,3,0,1,0,2,0,0,1,0,1,2,0,0,0,2,0
401262745,Boise State Broncos,A. Ostlie,4705626,,False,20.0,4,9,0,0,4,9,0,0,0,2,2,2,1,0,2,3,12
401262745,Boise State Broncos,TEAM,TOTAL,TOTAL,False,,37,77,32,54,5,23,8,12,17,33,50,28,10,8,14,20,87
401262744,UNLV Lady Rebels,D. Byrne,4398924,,True,26.0,3,9,3,4,0,5,0,0,0,6,6,2,3,3,2,0,6
401262744,UNLV Lady Rebels,D. Young,4704625,,True,20.0,3,11,3,11,0,0,2,3,1,0,1,1,0,0,0,3,8
401262744,UNLV Lady Rebels,J. Thomas,4704624,,True,32.0,1,2,0,0,1,2,2,2,0,0,0,1,1,0,1,0,5
401262744,UNLV Lady Rebels,N. Johnson,4400108,,True,22.0,4,15,3,9,1,6,3,6,0,3,3,3,2,0,1,2,12
401262744,UNLV Lady Rebels,B. Thomas,4068210,,True,29.0,1,5,1,2,0,3,1,2,2,1,3,2,0,0,3,0,3
401262744,UNLV Lady Rebels,T. Carter,4595642,,False,13.0,0,3,0,3,0,0,0,0,1,3,4,1,3,1,1,0,0
401262744,UNLV Lady Rebels,A. Blount,4595640,,False,13.0,2,3,2,3,0,0,3,4,2,3,5,0,0,2,1,1,7
401262744,UNLV Lady Rebels,K. Wilfred,4595641,,False,7.0,2,3,2,3,0,0,0,0,1,0,1,0,0,1,1,0,4
401262744,UNLV Lady Rebels,J. Singleton,4704623,,False,17.0,1,4,1,4,0,0,5,8,0,2,2,1,1,0,1,1,7
401262744,UNLV Lady Rebels,C. Gurrola,4595644,,False,2.0,0,0,0,0,0,0,0,0,0,0,0,1,0,0,0,0,0
401262744,UNLV Lady Rebels,J. Buckley,4595639,,False,18.0,2,8,1,4,1,4,2,2,1,2,3,0,0,0,1,0,7
401262744,UNLV Lady Rebels,TEAM,TOTAL,TOTAL,False,,19,63,16,43,3,20,18,27,11,22,33,12,10,7,13,7,59
401262744,UNLV Lady Rebels,D. Byrne,4398924,,True,26.0,3,9,3,4,0,5,0,0,0,6,6,2,3,3,2,0,6
401262744,UNLV Lady Rebels,D. Young,4704625,,True,20.0,3,11,3,11,0,0,2,3,1,0,1,1,0,0,0,3,8
401262744,UNLV Lady Rebels,J. Thomas,4704624,,True,32.0,1,2,0,0,1,2,2,2,0,0,0,1,1,0,1,0,5
401262744,UNLV Lady Rebels,N. Johnson,4400108,,True,22.0,4,15,3,9,1,6,3,6,0,3,3,3,2,0,1,2,12
401262744,UNLV Lady Rebels,B. Thomas,4068210,,True,29.0,1,5,1,2,0,3,1,2,2,1,3,2,0,0,3,0,3
401262744,UNLV Lady Rebels,T. Carter,4595642,,False,13.0,0,3,0,3,0,0,0,0,1,3,4,1,3,1,1,0,0
401262744,UNLV Lady Rebels,A. Blount,4595640,,False,13.0,2,3,2,3,0,0,3,4,2,3,5,0,0,2,1,1,7
401262744,UNLV Lady Rebels,K. Wilfred,4595641,,False,7.0,2,3,2,3,0,0,0,0,1,0,1,0,0,1,1,0,4
401262744,UNLV Lady Rebels,J. Singleton,4704623,,False,17.0,1,4,1,4,0,0,5,8,0,2,2,1,1,0,1,1,7
401262744,UNLV Lady Rebels,C. Gurrola,4595644,,False,2.0,0,0,0,0,0,0,0,0,0,0,0,1,0,0,0,0,0
401262744,UNLV Lady Rebels,J. Buckley,4595639,,False,18.0,2,8,1,4,1,4,2,2,1,2,3,0,0,0,1,0,7
401262744,UNLV Lady Rebels,TEAM,TOTAL,TOTAL,False,,19,63,16,43,3,20,18,27,11,22,33,12,10,7,13,7,59
401262744,Boise State Broncos,A. Mark,4606930,,True,23.0,6,7,6,7,0,0,0,0,4,10,14,3,2,0,3,1,12
401262744,Boise State Broncos,A. Muse,4583056,,True,24.0,1,8,1,8,0,0,0,0,0,3,3,2,0,3,0,1,2
401262744,Boise State Broncos,M. McGwire,4066535,,True,27.0,2,6,1,3,1,3,0,0,1,10,11,4,1,1,2,3,5
401262744,Boise State Broncos,M. Naro,4705625,,True,31.0,1,5,1,4,0,1,0,0,1,2,3,11,2,0,3,4,2
401262744,Boise State Broncos,J. Loville,4400537,,True,30.0,19,28,19,27,0,1,2,4,0,4,4,1,0,0,2,1,40
401262744,Boise State Broncos,E. Lalotte,4705630,,False,17.0,2,6,2,6,0,0,1,2,4,3,7,1,2,1,1,1,5
401262744,Boise State Broncos,K. Sykes,4595619,,False,16.0,3,4,1,1,2,3,0,0,2,0,2,0,0,0,1,4,8
401262744,Boise State Broncos,R. Bowers,4400536,,False,4.0,2,2,1,1,1,1,0,0,0,1,1,0,0,0,0,0,5
401262744,Boise State Broncos,M. Machalova,4705628,,False,10.0,0,3,0,2,0,1,0,0,1,0,1,0,1,0,1,1,0
401262744,Boise State Broncos,C. Gil,4705627,,False,8.0,1,2,0,1,1,1,0,0,0,0,0,2,0,0,1,2,3
401262744,Boise State Broncos,A. Ostlie,4705626,,False,10.0,1,3,1,2,0,1,1,2,0,1,1,1,0,0,0,4,3
401262744,Boise State Broncos,TEAM,TOTAL,TOTAL,False,,38,74,33,62,5,12,4,8,16,36,52,25,8,5,15,22,85
401262744,Boise State Broncos,A. Mark,4606930,,True,23.0,6,7,6,7,0,0,0,0,4,10,14,3,2,0,3,1,12
401262744,Boise State Broncos,A. Muse,4583056,,True,24.0,1,8,1,8,0,0,0,0,0,3,3,2,0,3,0,1,2
401262744,Boise State Broncos,M. McGwire,4066535,,True,27.0,2,6,1,3,1,3,0,0,1,10,11,4,1,1,2,3,5
401262744,Boise State Broncos,M. Naro,4705625,,True,31.0,1,5,1,4,0,1,0,0,1,2,3,11,2,0,3,4,2
401262744,Boise State Broncos,J. Loville,4400537,,True,30.0,19,28,19,27,0,1,2,4,0,4,4,1,0,0,2,1,40
401262744,Boise State Broncos,E. Lalotte,4705630,,False,17.0,2,6,2,6,0,0,1,2,4,3,7,1,2,1,1,1,5
401262744,Boise State Broncos,K. Sykes,4595619,,False,16.0,3,4,1,1,2,3,0,0,2,0,2,0,0,0,1,4,8
401262744,Boise State Broncos,R. Bowers,4400536,,False,4.0,2,2,1,1,1,1,0,0,0,1,1,0,0,0,0,0,5
401262744,Boise State Broncos,M. Machalova,4705628,,False,10.0,0,3,0,2,0,1,0,0,1,0,1,0,1,0,1,1,0
401262744,Boise State Broncos,C. Gil,4705627,,False,8.0,1,2,0,1,1,1,0,0,0,0,0,2,0,0,1,2,3
401262744,Boise State Broncos,A. Ostlie,4705626,,False,10.0,1,3,1,2,0,1,1,2,0,1,1,1,0,0,0,4,3
401262744,Boise State Broncos,TEAM,TOTAL,TOTAL,False,,38,74,33,62,5,12,4,8,16,36,52,25,8,5,15,22,85
401262743,UNLV Lady Rebels,D. Byrne,4398924,,True,38.0,4,9,3,4,1,5,5,6,3,7,10,4,0,1,2,1,14
401262743,UNLV Lady Rebels,D. Young,4704625,,True,26.0,5,13,5,13,0,0,4,6,5,5,10,0,2,0,1,3,14
401262743,UNLV Lady Rebels,J. Thomas,4704624,,True,39.0,3,12,2,6,1,6,0,2,0,5,5,2,4,0,0,3,7
401262743,UNLV Lady Rebels,N. Johnson,4400108,,True,34.0,5,18,4,13,1,5,2,2,0,2,2,2,3,0,3,2,13
401262743,UNLV Lady Rebels,B. Thomas,4068210,,True,31.0,5,9,3,4,2,5,6,9,0,3,3,3,3,0,3,4,18
401262743,UNLV Lady Rebels,A. Blount,4595640,,False,9.0,2,3,2,3,0,0,4,5,1,1,2,0,0,0,0,5,8
401262743,UNLV Lady Rebels,K. Wilfred,4595641,,False,7.0,0,1,0,1,0,0,0,0,0,0,0,0,1,0,1,2,0
401262743,UNLV Lady Rebels,J. Singleton,4704623,,False,10.0,0,1,0,1,0,0,0,0,0,0,0,1,2,0,0,0,0
401262743,UNLV Lady Rebels,J. Buckley,4595639,,False,6.0,0,1,0,0,0,1,0,0,2,0,2,1,0,0,0,1,0
401262743,UNLV Lady Rebels,TEAM,TOTAL,TOTAL,False,,24,67,19,45,5,22,21,30,15,24,39,13,15,1,10,21,74
401262743,UNLV Lady Rebels,D. Byrne,4398924,,True,38.0,4,9,3,4,1,5,5,6,3,7,10,4,0,1,2,1,14
401262743,UNLV Lady Rebels,D. Young,4704625,,True,26.0,5,13,5,13,0,0,4,6,5,5,10,0,2,0,1,3,14
401262743,UNLV Lady Rebels,J. Thomas,4704624,,True,39.0,3,12,2,6,1,6,0,2,0,5,5,2,4,0,0,3,7
401262743,UNLV Lady Rebels,N. Johnson,4400108,,True,34.0,5,18,4,13,1,5,2,2,0,2,2,2,3,0,3,2,13
401262743,UNLV Lady Rebels,B. Thomas,4068210,,True,31.0,5,9,3,4,2,5,6,9,0,3,3,3,3,0,3,4,18
401262743,UNLV Lady Rebels,A. Blount,4595640,,False,9.0,2,3,2,3,0,0,4,5,1,1,2,0,0,0,0,5,8
401262743,UNLV Lady Rebels,K. Wilfred,4595641,,False,7.0,0,1,0,1,0,0,0,0,0,0,0,0,1,0,1,2,0
401262743,UNLV Lady Rebels,J. Singleton,4704623,,False,10.0,0,1,0,1,0,0,0,0,0,0,0,1,2,0,0,0,0
401262743,UNLV Lady Rebels,J. Buckley,4595639,,False,6.0,0,1,0,0,0,1,0,0,2,0,2,1,0,0,0,1,0
401262743,UNLV Lady Rebels,TEAM,TOTAL,TOTAL,False,,24,67,19,45,5,22,21,30,15,24,39,13,15,1,10,21,74
401262743,Boise State Broncos,A. Mark,4606930,,True,33.0,3,10,3,10,0,0,1,6,5,2,7,4,2,0,2,0,7
401262743,Boise State Broncos,A. Muse,4583056,,True,10.0,1,1,1,1,0,0,0,0,0,4,4,1,0,1,0,4,2
401262743,Boise State Broncos,M. McGwire,4066535,,True,27.0,8,13,6,10,2,3,1,1,6,14,20,3,0,2,4,5,19
401262743,Boise State Broncos,M. Naro,4705625,,True,29.0,0,3,0,1,0,2,0,0,1,1,2,4,0,2,5,2,0
401262743,Boise State Broncos,J. Loville,4400537,,True,33.0,4,14,4,13,0,1,6,6,0,0,0,1,2,0,2,4,14
401262743,Boise State Broncos,E. Lalotte,4705630,,False,17.0,5,5,5,5,0,0,1,3,1,1,2,1,0,2,3,3,11
401262743,Boise State Broncos,K. Sykes,4595619,,False,19.0,1,6,0,2,1,4,0,0,2,1,3,2,0,0,2,2,3
401262743,Boise State Broncos,M. Machalova,4705628,,False,5.0,1,1,1,1,0,0,2,2,0,0,0,0,0,0,1,1,4
401262743,Boise State Broncos,C. Gil,4705627,,False,12.0,0,0,0,0,0,0,0,0,0,0,0,1,1,0,1,1,0
401262743,Boise State Broncos,A. Ostlie,4705626,,False,15.0,1,6,1,1,0,5,0,1,0,3,3,1,1,0,2,2,2
401262743,Boise State Broncos,TEAM,TOTAL,TOTAL,False,,24,59,21,44,3,15,11,19,16,32,48,18,6,7,22,24,62
401262743,Boise State Broncos,A. Mark,4606930,,True,33.0,3,10,3,10,0,0,1,6,5,2,7,4,2,0,2,0,7
401262743,Boise State Broncos,A. Muse,4583056,,True,10.0,1,1,1,1,0,0,0,0,0,4,4,1,0,1,0,4,2
401262743,Boise State Broncos,M. McGwire,4066535,,True,27.0,8,13,6,10,2,3,1,1,6,14,20,3,0,2,4,5,19
401262743,Boise State Broncos,M. Naro,4705625,,True,29.0,0,3,0,1,0,2,0,0,1,1,2,4,0,2,5,2,0
401262743,Boise State Broncos,J. Loville,4400537,,True,33.0,4,14,4,13,0,1,6,6,0,0,0,1,2,0,2,4,14
401262743,Boise State Broncos,E. Lalotte,4705630,,False,17.0,5,5,5,5,0,0,1,3,1,1,2,1,0,2,3,3,11
401262743,Boise State Broncos,K. Sykes,4595619,,False,19.0,1,6,0,2,1,4,0,0,2,1,3,2,0,0,2,2,3
401262743,Boise State Broncos,M. Machalova,4705628,,False,5.0,1,1,1,1,0,0,2,2,0,0,0,0,0,0,1,1,4
401262743,Boise State Broncos,C. Gil,4705627,,False,12.0,0,0,0,0,0,0,0,0,0,0,0,1,1,0,1,1,0
401262743,Boise State Broncos,A. Ostlie,4705626,,False,15.0,1,6,1,1,0,5,0,1,0,3,3,1,1,0,2,2,2
401262743,Boise State Broncos,TEAM,TOTAL,TOTAL,False,,24,59,21,44,3,15,11,19,16,32,48,18,6,7,22,24,62
401262742,Nevada Wolf Pack,M. Ormiston,4400072,,True,15.0,2,10,2,10,0,0,0,0,5,1,6,2,0,0,1,3,4
401262742,Nevada Wolf Pack,L. Johnson,4595634,,True,24.0,4,5,4,5,0,0,0,0,0,4,4,0,1,0,2,0,8
401262742,Nevada Wolf Pack,A. West,4400134,,True,30.0,6,12,4,6,2,6,0,0,2,2,4,0,1,2,1,1,14
401262742,Nevada Wolf Pack,D. Hamilton,4400132,,True,29.0,6,9,4,6,2,3,4,5,0,5,5,3,2,1,3,2,18
401262742,Nevada Wolf Pack,N. Alexander,4068433,,True,29.0,2,10,2,9,0,1,4,4,3,3,6,0,3,0,0,1,8
401262742,Nevada Wolf Pack,L. Otuafi,4704508,,False,22.0,2,4,2,4,0,0,0,0,2,4,6,0,0,0,4,3,4
401262742,Nevada Wolf Pack,L. Givens,4704506,,False,21.0,2,7,2,5,0,2,2,4,2,4,6,1,0,1,4,1,6
401262742,Nevada Wolf Pack,D. Phillips,4595638,,False,6.0,1,3,1,3,0,0,0,0,0,0,0,0,0,0,0,1,2
401262742,Nevada Wolf Pack,K. Holt,4704503,,False,20.0,0,2,0,1,0,1,0,0,2,0,2,1,0,0,1,2,0
401262742,Nevada Wolf Pack,B. Carstens,4597039,,False,4.0,0,1,0,1,0,0,0,0,0,0,0,0,0,0,0,0,0
401262742,Nevada Wolf Pack,TEAM,TOTAL,TOTAL,False,,25,63,21,50,4,13,10,13,18,27,45,7,7,4,16,14,64
401262742,Nevada Wolf Pack,M. Ormiston,4400072,,True,15.0,2,10,2,10,0,0,0,0,5,1,6,2,0,0,1,3,4
401262742,Nevada Wolf Pack,L. Johnson,4595634,,True,24.0,4,5,4,5,0,0,0,0,0,4,4,0,1,0,2,0,8
401262742,Nevada Wolf Pack,A. West,4400134,,True,30.0,6,12,4,6,2,6,0,0,2,2,4,0,1,2,1,1,14
401262742,Nevada Wolf Pack,D. Hamilton,4400132,,True,29.0,6,9,4,6,2,3,4,5,0,5,5,3,2,1,3,2,18
401262742,Nevada Wolf Pack,N. Alexander,4068433,,True,29.0,2,10,2,9,0,1,4,4,3,3,6,0,3,0,0,1,8
401262742,Nevada Wolf Pack,L. Otuafi,4704508,,False,22.0,2,4,2,4,0,0,0,0,2,4,6,0,0,0,4,3,4
401262742,Nevada Wolf Pack,L. Givens,4704506,,False,21.0,2,7,2,5,0,2,2,4,2,4,6,1,0,1,4,1,6
401262742,Nevada Wolf Pack,D. Phillips,4595638,,False,6.0,1,3,1,3,0,0,0,0,0,0,0,0,0,0,0,1,2
401262742,Nevada Wolf Pack,K. Holt,4704503,,False,20.0,0,2,0,1,0,1,0,0,2,0,2,1,0,0,1,2,0
401262742,Nevada Wolf Pack,B. Carstens,4597039,,False,4.0,0,1,0,1,0,0,0,0,0,0,0,0,0,0,0,0,0
401262742,Nevada Wolf Pack,TEAM,TOTAL,TOTAL,False,,25,63,21,50,4,13,10,13,18,27,45,7,7,4,16,14,64
401262742,Boise State Broncos,A. Mark,4606930,,True,22.0,1,6,1,5,0,1,4,5,2,3,5,0,2,1,1,3,6
401262742,Boise State Broncos,A. Muse,4583056,,True,23.0,0,1,0,1,0,0,0,0,2,3,5,2,0,3,2,1,0
401262742,Boise State Broncos,M. McGwire,4066535,,True,23.0,5,10,5,7,0,3,2,2,1,4,5,0,2,1,1,2,12
401262742,Boise State Broncos,M. Naro,4705625,,True,34.0,1,11,0,7,1,4,0,0,3,1,4,7,1,0,5,2,3
401262742,Boise State Broncos,J. Loville,4400537,,True,30.0,3,13,3,11,0,2,0,0,1,1,2,0,0,0,3,2,6
401262742,Boise State Broncos,E. Lalotte,4705630,,False,11.0,1,2,1,2,0,0,0,0,0,1,1,0,0,0,0,1,2
401262742,Boise State Broncos,K. Sykes,4595619,,False,14.0,0,4,0,2,0,2,0,0,0,3,3,0,1,0,0,1,0
401262742,Boise State Broncos,R. Bowers,4400536,,False,16.0,2,4,2,3,0,1,2,3,2,4,6,0,0,2,1,2,6
401262742,Boise State Broncos,M. Machalova,4705628,,False,9.0,2,4,2,3,0,1,2,2,0,0,0,0,0,0,0,2,6
401262742,Boise State Broncos,C. Gil,4705627,,False,6.0,0,1,0,0,0,1,0,0,0,0,0,0,0,0,2,0,0
401262742,Boise State Broncos,A. Ostlie,4705626,,False,12.0,1,4,0,0,1,4,0,0,0,2,2,0,0,0,1,0,3
401262742,Boise State Broncos,TEAM,TOTAL,TOTAL,False,,16,60,14,41,2,19,10,12,16,22,38,9,6,7,16,16,44
401262742,Boise State Broncos,A. Mark,4606930,,True,22.0,1,6,1,5,0,1,4,5,2,3,5,0,2,1,1,3,6
401262742,Boise State Broncos,A. Muse,4583056,,True,23.0,0,1,0,1,0,0,0,0,2,3,5,2,0,3,2,1,0
401262742,Boise State Broncos,M. McGwire,4066535,,True,23.0,5,10,5,7,0,3,2,2,1,4,5,0,2,1,1,2,12
401262742,Boise State Broncos,M. Naro,4705625,,True,34.0,1,11,0,7,1,4,0,0,3,1,4,7,1,0,5,2,3
401262742,Boise State Broncos,J. Loville,4400537,,True,30.0,3,13,3,11,0,2,0,0,1,1,2,0,0,0,3,2,6
401262742,Boise State Broncos,E. Lalotte,4705630,,False,11.0,1,2,1,2,0,0,0,0,0,1,1,0,0,0,0,1,2
401262742,Boise State Broncos,K. Sykes,4595619,,False,14.0,0,4,0,2,0,2,0,0,0,3,3,0,1,0,0,1,0
401262742,Boise State Broncos,R. Bowers,4400536,,False,16.0,2,4,2,3,0,1,2,3,2,4,6,0,0,2,1,2,6
401262742,Boise State Broncos,M. Machalova,4705628,,False,9.0,2,4,2,3,0,1,2,2,0,0,0,0,0,0,0,2,6
401262742,Boise State Broncos,C. Gil,4705627,,False,6.0,0,1,0,0,0,1,0,0,0,0,0,0,0,0,2,0,0
401262742,Boise State Broncos,A. Ostlie,4705626,,False,12.0,1,4,0,0,1,4,0,0,0,2,2,0,0,0,1,0,3
401262742,Boise State Broncos,TEAM,TOTAL,TOTAL,False,,16,60,14,41,2,19,10,12,16,22,38,9,6,7,16,16,44
401262741,Nevada Wolf Pack,M. Ormiston,4400072,,True,29.0,2,11,2,11,0,0,2,2,3,3,6,0,0,0,1,0,6
401262741,Nevada Wolf Pack,L. Johnson,4595634,,True,20.0,3,5,3,5,0,0,2,2,0,3,3,1,0,0,2,3,8
401262741,Nevada Wolf Pack,A. West,4400134,,True,26.0,4,8,3,6,1,2,2,2,1,3,4,2,1,0,1,0,11
401262741,Nevada Wolf Pack,D. Hamilton,4400132,,True,33.0,9,22,8,15,1,7,0,0,1,5,6,2,0,0,4,1,19
401262741,Nevada Wolf Pack,N. Alexander,4068433,,True,25.0,3,7,3,6,0,1,4,4,3,4,7,0,1,0,3,2,10
401262741,Nevada Wolf Pack,L. Otuafi,4704508,,False,17.0,2,4,2,4,0,0,0,0,1,0,1,1,1,0,2,1,4
401262741,Nevada Wolf Pack,L. Givens,4704506,,False,7.0,2,3,2,3,0,0,0,1,0,1,1,0,0,0,0,0,4
401262741,Nevada Wolf Pack,D. Phillips,4595638,,False,10.0,0,4,0,3,0,1,0,0,0,0,0,0,1,0,0,1,0
401262741,Nevada Wolf Pack,G. Rones,4704505,,False,5.0,0,0,0,0,0,0,0,0,0,0,0,0,0,0,0,0,0
401262741,Nevada Wolf Pack,K. Holt,4704503,,False,24.0,0,3,0,3,0,0,1,2,2,2,4,1,1,0,1,3,1
401262741,Nevada Wolf Pack,B. Carstens,4597039,,False,4.0,0,2,0,0,0,2,0,0,0,0,0,0,0,0,1,0,0
401262741,Nevada Wolf Pack,TEAM,TOTAL,TOTAL,False,,25,69,23,56,2,13,11,13,20,24,44,7,5,0,15,11,63
401262741,Nevada Wolf Pack,M. Ormiston,4400072,,True,29.0,2,11,2,11,0,0,2,2,3,3,6,0,0,0,1,0,6
401262741,Nevada Wolf Pack,L. Johnson,4595634,,True,20.0,3,5,3,5,0,0,2,2,0,3,3,1,0,0,2,3,8
401262741,Nevada Wolf Pack,A. West,4400134,,True,26.0,4,8,3,6,1,2,2,2,1,3,4,2,1,0,1,0,11
401262741,Nevada Wolf Pack,D. Hamilton,4400132,,True,33.0,9,22,8,15,1,7,0,0,1,5,6,2,0,0,4,1,19
401262741,Nevada Wolf Pack,N. Alexander,4068433,,True,25.0,3,7,3,6,0,1,4,4,3,4,7,0,1,0,3,2,10
401262741,Nevada Wolf Pack,L. Otuafi,4704508,,False,17.0,2,4,2,4,0,0,0,0,1,0,1,1,1,0,2,1,4
401262741,Nevada Wolf Pack,L. Givens,4704506,,False,7.0,2,3,2,3,0,0,0,1,0,1,1,0,0,0,0,0,4
401262741,Nevada Wolf Pack,D. Phillips,4595638,,False,10.0,0,4,0,3,0,1,0,0,0,0,0,0,1,0,0,1,0
401262741,Nevada Wolf Pack,G. Rones,4704505,,False,5.0,0,0,0,0,0,0,0,0,0,0,0,0,0,0,0,0,0
401262741,Nevada Wolf Pack,K. Holt,4704503,,False,24.0,0,3,0,3,0,0,1,2,2,2,4,1,1,0,1,3,1
401262741,Nevada Wolf Pack,B. Carstens,4597039,,False,4.0,0,2,0,0,0,2,0,0,0,0,0,0,0,0,1,0,0
401262741,Nevada Wolf Pack,TEAM,TOTAL,TOTAL,False,,25,69,23,56,2,13,11,13,20,24,44,7,5,0,15,11,63
401262741,Boise State Broncos,A. Mark,4606930,,True,11.0,2,3,2,3,0,0,0,0,1,1,2,1,1,1,0,3,4
401262741,Boise State Broncos,A. Muse,4583056,,True,26.0,4,7,4,7,0,0,2,2,1,1,2,1,0,0,2,4,10
401262741,Boise State Broncos,M. McGwire,4066535,,True,21.0,3,7,2,5,1,2,5,6,2,1,3,4,1,2,3,2,12
401262741,Boise State Broncos,M. Naro,4705625,,True,36.0,3,9,2,5,1,4,1,2,0,4,4,4,1,2,2,0,8
401262741,Boise State Broncos,J. Loville,4400537,,True,32.0,10,17,10,17,0,0,0,0,1,1,2,1,1,0,1,0,20
401262741,Boise State Broncos,E. Lalotte,4705630,,False,13.0,2,2,2,2,0,0,0,0,1,1,2,0,1,1,0,0,4
401262741,Boise State Broncos,K. Sykes,4595619,,False,23.0,2,7,2,3,0,4,0,0,2,4,6,2,0,1,1,0,4
401262741,Boise State Broncos,R. Bowers,4400536,,False,18.0,1,3,1,3,0,0,0,0,1,4,5,0,0,0,0,3,2
401262741,Boise State Broncos,C. Gil,4705627,,False,4.0,0,1,0,0,0,1,0,0,0,0,0,0,0,0,0,1,0
401262741,Boise State Broncos,A. Ostlie,4705626,,False,16.0,3,7,0,1,3,6,0,0,1,0,1,0,0,0,1,1,9
401262741,Boise State Broncos,TEAM,TOTAL,TOTAL,False,,30,63,25,46,5,17,8,10,10,22,32,13,5,7,10,14,73
401262741,Boise State Broncos,A. Mark,4606930,,True,11.0,2,3,2,3,0,0,0,0,1,1,2,1,1,1,0,3,4
401262741,Boise State Broncos,A. Muse,4583056,,True,26.0,4,7,4,7,0,0,2,2,1,1,2,1,0,0,2,4,10
401262741,Boise State Broncos,M. McGwire,4066535,,True,21.0,3,7,2,5,1,2,5,6,2,1,3,4,1,2,3,2,12
401262741,Boise State Broncos,M. Naro,4705625,,True,36.0,3,9,2,5,1,4,1,2,0,4,4,4,1,2,2,0,8
401262741,Boise State Broncos,J. Loville,4400537,,True,32.0,10,17,10,17,0,0,0,0,1,1,2,1,1,0,1,0,20
401262741,Boise State Broncos,E. Lalotte,4705630,,False,13.0,2,2,2,2,0,0,0,0,1,1,2,0,1,1,0,0,4
401262741,Boise State Broncos,K. Sykes,4595619,,False,23.0,2,7,2,3,0,4,0,0,2,4,6,2,0,1,1,0,4
401262741,Boise State Broncos,R. Bowers,4400536,,False,18.0,1,3,1,3,0,0,0,0,1,4,5,0,0,0,0,3,2
401262741,Boise State Broncos,C. Gil,4705627,,False,4.0,0,1,0,0,0,1,0,0,0,0,0,0,0,0,0,1,0
401262741,Boise State Broncos,A. Ostlie,4705626,,False,16.0,3,7,0,1,3,6,0,0,1,0,1,0,0,0,1,1,9
401262741,Boise State Broncos,TEAM,TOTAL,TOTAL,False,,30,63,25,46,5,17,8,10,10,22,32,13,5,7,10,14,73
401262740,Colorado State Rams,C. Clark,4704464,,True,20.0,2,7,2,6,0,1,2,2,2,7,9,2,0,1,1,4,6
401262740,Colorado State Rams,E. Boni,4704462,,True,29.0,5,8,4,6,1,2,0,1,0,4,4,0,0,0,0,0,11
401262740,Colorado State Rams,M. Hofschild,4595160,,True,36.0,6,14,5,10,1,4,3,4,0,1,1,6,4,0,7,1,16
401262740,Colorado State Rams,L. Devos,4284002,,True,36.0,7,12,4,8,3,4,0,0,1,8,9,2,1,2,5,1,17
401262740,Colorado State Rams,T. Williams,4282176,,True,31.0,2,10,1,3,1,7,2,2,1,8,9,3,2,0,4,1,7
401262740,Colorado State Rams,K. Murphy,4068969,,False,17.0,4,7,4,7,0,0,0,0,5,4,9,0,2,0,1,4,8
401262740,Colorado State Rams,M. Torres,4704466,,False,1.0,0,0,0,0,0,0,0,0,0,0,0,0,0,0,0,0,0
401262740,Colorado State Rams,J. Bonnarens,4400102,,False,14.0,4,10,3,6,1,4,0,0,1,5,6,0,1,0,0,0,9
401262740,Colorado State Rams,M. Hemingway,4704465,,False,1.0,0,0,0,0,0,0,0,0,0,0,0,0,0,0,0,0,0
401262740,Colorado State Rams,P. Farkas,4704463,,False,11.0,0,0,0,0,0,0,0,0,0,2,2,0,0,0,0,0,0
401262740,Colorado State Rams,B. Alper,4595629,,False,4.0,0,1,0,1,0,0,1,2,0,0,0,0,0,0,0,0,1
401262740,Colorado State Rams,TEAM,TOTAL,TOTAL,False,,30,69,23,47,7,22,8,11,11,41,52,13,10,3,18,11,75
401262740,Colorado State Rams,C. Clark,4704464,,True,20.0,2,7,2,6,0,1,2,2,2,7,9,2,0,1,1,4,6
401262740,Colorado State Rams,E. Boni,4704462,,True,29.0,5,8,4,6,1,2,0,1,0,4,4,0,0,0,0,0,11
401262740,Colorado State Rams,M. Hofschild,4595160,,True,36.0,6,14,5,10,1,4,3,4,0,1,1,6,4,0,7,1,16
401262740,Colorado State Rams,L. Devos,4284002,,True,36.0,7,12,4,8,3,4,0,0,1,8,9,2,1,2,5,1,17
401262740,Colorado State Rams,T. Williams,4282176,,True,31.0,2,10,1,3,1,7,2,2,1,8,9,3,2,0,4,1,7
401262740,Colorado State Rams,K. Murphy,4068969,,False,17.0,4,7,4,7,0,0,0,0,5,4,9,0,2,0,1,4,8
401262740,Colorado State Rams,M. Torres,4704466,,False,1.0,0,0,0,0,0,0,0,0,0,0,0,0,0,0,0,0,0
401262740,Colorado State Rams,J. Bonnarens,4400102,,False,14.0,4,10,3,6,1,4,0,0,1,5,6,0,1,0,0,0,9
401262740,Colorado State Rams,M. Hemingway,4704465,,False,1.0,0,0,0,0,0,0,0,0,0,0,0,0,0,0,0,0,0
401262740,Colorado State Rams,P. Farkas,4704463,,False,11.0,0,0,0,0,0,0,0,0,0,2,2,0,0,0,0,0,0
401262740,Colorado State Rams,B. Alper,4595629,,False,4.0,0,1,0,1,0,0,1,2,0,0,0,0,0,0,0,0,1
401262740,Colorado State Rams,TEAM,TOTAL,TOTAL,False,,30,69,23,47,7,22,8,11,11,41,52,13,10,3,18,11,75
401262740,Boise State Broncos,A. Mark,4606930,,True,20.0,1,3,1,3,0,0,0,0,0,3,3,1,1,0,4,2,2
401262740,Boise State Broncos,A. Muse,4583056,,True,18.0,4,5,4,5,0,0,0,0,2,4,6,0,2,1,0,1,8
401262740,Boise State Broncos,M. McGwire,4066535,,True,23.0,1,8,1,8,0,0,0,0,1,7,8,2,1,1,1,0,2
401262740,Boise State Broncos,M. Naro,4705625,,True,24.0,1,5,1,4,0,1,0,0,1,2,3,1,1,0,3,0,2
401262740,Boise State Broncos,J. Loville,4400537,,True,22.0,5,15,5,15,0,0,3,4,1,3,4,1,0,0,2,1,13
401262740,Boise State Broncos,E. Lalotte,4705630,,False,11.0,0,0,0,0,0,0,0,0,1,4,5,0,0,1,1,3,0
401262740,Boise State Broncos,K. Sykes,4595619,,False,9.0,0,4,0,1,0,3,1,2,0,1,1,0,0,0,0,0,1
401262740,Boise State Broncos,R. Bowers,4400536,,False,7.0,0,2,0,2,0,0,0,0,0,1,1,0,1,0,0,1,0
401262740,Boise State Broncos,R. Reed,4705629,,False,11.0,1,3,1,2,0,1,0,0,0,0,0,0,1,0,3,0,2
401262740,Boise State Broncos,M. Machalova,4705628,,False,18.0,3,6,2,4,1,2,0,1,1,2,3,1,1,0,1,2,7
401262740,Boise State Broncos,C. Gil,4705627,,False,20.0,4,9,2,6,2,3,0,0,0,1,1,2,1,0,1,3,10
401262740,Boise State Broncos,A. Ostlie,4705626,,False,17.0,2,9,0,0,2,9,0,0,0,1,1,0,0,0,1,2,6
401262740,Boise State Broncos,TEAM,TOTAL,TOTAL,False,,22,69,17,50,5,19,4,7,8,30,38,8,9,3,17,15,53
401262740,Boise State Broncos,A. Mark,4606930,,True,20.0,1,3,1,3,0,0,0,0,0,3,3,1,1,0,4,2,2
401262740,Boise State Broncos,A. Muse,4583056,,True,18.0,4,5,4,5,0,0,0,0,2,4,6,0,2,1,0,1,8
401262740,Boise State Broncos,M. McGwire,4066535,,True,23.0,1,8,1,8,0,0,0,0,1,7,8,2,1,1,1,0,2
401262740,Boise State Broncos,M. Naro,4705625,,True,24.0,1,5,1,4,0,1,0,0,1,2,3,1,1,0,3,0,2
401262740,Boise State Broncos,J. Loville,4400537,,True,22.0,5,15,5,15,0,0,3,4,1,3,4,1,0,0,2,1,13
401262740,Boise State Broncos,E. Lalotte,4705630,,False,11.0,0,0,0,0,0,0,0,0,1,4,5,0,0,1,1,3,0
401262740,Boise State Broncos,K. Sykes,4595619,,False,9.0,0,4,0,1,0,3,1,2,0,1,1,0,0,0,0,0,1
401262740,Boise State Broncos,R. Bowers,4400536,,False,7.0,0,2,0,2,0,0,0,0,0,1,1,0,1,0,0,1,0
401262740,Boise State Broncos,R. Reed,4705629,,False,11.0,1,3,1,2,0,1,0,0,0,0,0,0,1,0,3,0,2
401262740,Boise State Broncos,M. Machalova,4705628,,False,18.0,3,6,2,4,1,2,0,1,1,2,3,1,1,0,1,2,7
401262740,Boise State Broncos,C. Gil,4705627,,False,20.0,4,9,2,6,2,3,0,0,0,1,1,2,1,0,1,3,10
401262740,Boise State Broncos,A. Ostlie,4705626,,False,17.0,2,9,0,0,2,9,0,0,0,1,1,0,0,0,1,2,6
401262740,Boise State Broncos,TEAM,TOTAL,TOTAL,False,,22,69,17,50,5,19,4,7,8,30,38,8,9,3,17,15,53
401262739,Colorado State Rams,C. Clark,4704464,,True,24.0,4,9,4,8,0,1,2,2,4,4,8,1,0,0,1,1,10
401262739,Colorado State Rams,E. Boni,4704462,,True,30.0,7,10,6,8,1,2,4,4,0,9,9,0,0,0,1,1,19
401262739,Colorado State Rams,M. Hofschild,4595160,,True,35.0,2,9,1,5,1,4,2,2,1,5,6,8,1,0,3,1,7
401262739,Colorado State Rams,L. Devos,4284002,,True,26.0,4,14,3,11,1,3,4,4,0,3,3,0,0,0,2,0,13
401262739,Colorado State Rams,T. Williams,4282176,,True,33.0,2,9,0,3,2,6,2,2,0,4,4,2,3,0,1,1,8
401262739,Colorado State Rams,K. Murphy,4068969,,False,17.0,1,6,1,6,0,0,2,2,3,4,7,0,1,0,2,3,4
401262739,Colorado State Rams,J. Bonnarens,4400102,,False,21.0,4,6,2,3,2,3,0,0,0,3,3,0,0,0,1,2,10
401262739,Colorado State Rams,P. Farkas,4704463,,False,10.0,0,2,0,1,0,1,0,0,0,1,1,1,0,0,0,0,0
401262739,Colorado State Rams,B. Alper,4595629,,False,4.0,0,0,0,0,0,0,0,0,0,1,1,0,0,0,1,1,0
401262739,Colorado State Rams,TEAM,TOTAL,TOTAL,False,,24,65,17,45,7,20,16,16,10,36,46,12,5,0,12,10,71
401262739,Colorado State Rams,C. Clark,4704464,,True,24.0,4,9,4,8,0,1,2,2,4,4,8,1,0,0,1,1,10
401262739,Colorado State Rams,E. Boni,4704462,,True,30.0,7,10,6,8,1,2,4,4,0,9,9,0,0,0,1,1,19
401262739,Colorado State Rams,M. Hofschild,4595160,,True,35.0,2,9,1,5,1,4,2,2,1,5,6,8,1,0,3,1,7
401262739,Colorado State Rams,L. Devos,4284002,,True,26.0,4,14,3,11,1,3,4,4,0,3,3,0,0,0,2,0,13
401262739,Colorado State Rams,T. Williams,4282176,,True,33.0,2,9,0,3,2,6,2,2,0,4,4,2,3,0,1,1,8
401262739,Colorado State Rams,K. Murphy,4068969,,False,17.0,1,6,1,6,0,0,2,2,3,4,7,0,1,0,2,3,4
401262739,Colorado State Rams,J. Bonnarens,4400102,,False,21.0,4,6,2,3,2,3,0,0,0,3,3,0,0,0,1,2,10
401262739,Colorado State Rams,P. Farkas,4704463,,False,10.0,0,2,0,1,0,1,0,0,0,1,1,1,0,0,0,0,0
401262739,Colorado State Rams,B. Alper,4595629,,False,4.0,0,0,0,0,0,0,0,0,0,1,1,0,0,0,1,1,0
401262739,Colorado State Rams,TEAM,TOTAL,TOTAL,False,,24,65,17,45,7,20,16,16,10,36,46,12,5,0,12,10,71
401262739,Boise State Broncos,A. Mark,4606930,,True,24.0,2,8,2,8,0,0,0,0,3,1,4,0,0,0,1,1,4
401262739,Boise State Broncos,A. Muse,4583056,,True,23.0,0,5,0,5,0,0,0,0,1,2,3,0,1,1,0,0,0
401262739,Boise State Broncos,M. McGwire,4066535,,True,17.0,3,4,3,4,0,0,1,2,2,4,6,1,0,2,4,5,7
401262739,Boise State Broncos,M. Naro,4705625,,True,33.0,4,11,3,7,1,4,0,0,4,3,7,2,2,0,4,2,9
401262739,Boise State Broncos,J. Loville,4400537,,True,27.0,5,21,5,19,0,2,3,3,1,5,6,0,0,0,0,1,13
401262739,Boise State Broncos,E. Lalotte,4705630,,False,13.0,3,4,3,4,0,0,0,1,1,4,5,0,0,1,0,3,6
401262739,Boise State Broncos,K. Sykes,4595619,,False,19.0,2,8,1,2,1,6,2,2,1,1,2,1,1,0,1,0,7
401262739,Boise State Broncos,R. Reed,4705629,,False,15.0,1,4,0,1,1,3,2,2,1,3,4,0,1,0,2,4,5
401262739,Boise State Broncos,M. Machalova,4705628,,False,6.0,0,0,0,0,0,0,0,0,0,0,0,0,0,0,1,0,0
401262739,Boise State Broncos,C. Gil,4705627,,False,8.0,0,3,0,2,0,1,0,0,0,0,0,1,0,0,0,0,0
401262739,Boise State Broncos,A. Ostlie,4705626,,False,15.0,0,3,0,2,0,1,0,0,0,3,3,0,0,0,1,1,0
401262739,Boise State Broncos,TEAM,TOTAL,TOTAL,False,,20,71,17,54,3,17,8,10,15,31,46,5,5,4,14,17,51
401262739,Boise State Broncos,A. Mark,4606930,,True,24.0,2,8,2,8,0,0,0,0,3,1,4,0,0,0,1,1,4
401262739,Boise State Broncos,A. Muse,4583056,,True,23.0,0,5,0,5,0,0,0,0,1,2,3,0,1,1,0,0,0
401262739,Boise State Broncos,M. McGwire,4066535,,True,17.0,3,4,3,4,0,0,1,2,2,4,6,1,0,2,4,5,7
401262739,Boise State Broncos,M. Naro,4705625,,True,33.0,4,11,3,7,1,4,0,0,4,3,7,2,2,0,4,2,9
401262739,Boise State Broncos,J. Loville,4400537,,True,27.0,5,21,5,19,0,2,3,3,1,5,6,0,0,0,0,1,13
401262739,Boise State Broncos,E. Lalotte,4705630,,False,13.0,3,4,3,4,0,0,0,1,1,4,5,0,0,1,0,3,6
401262739,Boise State Broncos,K. Sykes,4595619,,False,19.0,2,8,1,2,1,6,2,2,1,1,2,1,1,0,1,0,7
401262739,Boise State Broncos,R. Reed,4705629,,False,15.0,1,4,0,1,1,3,2,2,1,3,4,0,1,0,2,4,5
401262739,Boise State Broncos,M. Machalova,4705628,,False,6.0,0,0,0,0,0,0,0,0,0,0,0,0,0,0,1,0,0
401262739,Boise State Broncos,C. Gil,4705627,,False,8.0,0,3,0,2,0,1,0,0,0,0,0,1,0,0,0,0,0
401262739,Boise State Broncos,A. Ostlie,4705626,,False,15.0,0,3,0,2,0,1,0,0,0,3,3,0,0,0,1,1,0
401262739,Boise State Broncos,TEAM,TOTAL,TOTAL,False,,20,71,17,54,3,17,8,10,15,31,46,5,5,4,14,17,51
401262738,Fresno State Bulldogs,W. Motta,4595631,,True,17.0,3,9,3,8,0,1,0,0,1,3,4,0,1,1,2,2,6
401262738,Fresno State Bulldogs,M. Utti,4281828,,True,34.0,9,12,9,11,0,1,2,4,2,2,4,1,1,0,1,1,20
401262738,Fresno State Bulldogs,Hal. Cavinder,4433658,,True,36.0,7,15,4,8,3,7,1,2,0,8,8,5,3,0,7,2,18
401262738,Fresno State Bulldogs,Han. Cavinder,4433372,,True,33.0,3,11,3,10,0,1,3,4,0,1,1,1,1,0,6,0,9
401262738,Fresno State Bulldogs,A. Gamez,4281826,,True,31.0,3,4,3,3,0,1,1,1,0,2,2,2,1,0,1,3,7
401262738,Fresno State Bulldogs,K. Kinzer,4595630,,False,8.0,1,2,0,0,1,2,0,0,0,2,2,0,0,0,0,0,3
401262738,Fresno State Bulldogs,G. Ogier,4281827,,False,5.0,0,2,0,1,0,1,0,0,0,1,1,0,1,0,0,0,0
401262738,Fresno State Bulldogs,M. Guimaraes,4704476,,False,6.0,0,1,0,1,0,0,0,0,1,0,1,0,0,0,1,1,0
401262738,Fresno State Bulldogs,B. Walling,4595632,,False,7.0,0,0,0,0,0,0,0,0,0,2,2,1,0,0,0,0,0
401262738,Fresno State Bulldogs,K. Brown,4704473,,False,11.0,0,0,0,0,0,0,1,2,1,1,2,1,1,0,0,0,1
401262738,Fresno State Bulldogs,B. Delaney,4281825,,False,12.0,1,3,0,0,1,3,0,0,0,4,4,0,1,0,0,2,3
401262738,Fresno State Bulldogs,TEAM,TOTAL,TOTAL,False,,27,59,22,42,5,17,8,13,10,28,38,11,10,1,19,11,67
401262738,Fresno State Bulldogs,W. Motta,4595631,,True,17.0,3,9,3,8,0,1,0,0,1,3,4,0,1,1,2,2,6
401262738,Fresno State Bulldogs,M. Utti,4281828,,True,34.0,9,12,9,11,0,1,2,4,2,2,4,1,1,0,1,1,20
401262738,Fresno State Bulldogs,Hal. Cavinder,4433658,,True,36.0,7,15,4,8,3,7,1,2,0,8,8,5,3,0,7,2,18
401262738,Fresno State Bulldogs,Han. Cavinder,4433372,,True,33.0,3,11,3,10,0,1,3,4,0,1,1,1,1,0,6,0,9
401262738,Fresno State Bulldogs,A. Gamez,4281826,,True,31.0,3,4,3,3,0,1,1,1,0,2,2,2,1,0,1,3,7
401262738,Fresno State Bulldogs,K. Kinzer,4595630,,False,8.0,1,2,0,0,1,2,0,0,0,2,2,0,0,0,0,0,3
401262738,Fresno State Bulldogs,G. Ogier,4281827,,False,5.0,0,2,0,1,0,1,0,0,0,1,1,0,1,0,0,0,0
401262738,Fresno State Bulldogs,M. Guimaraes,4704476,,False,6.0,0,1,0,1,0,0,0,0,1,0,1,0,0,0,1,1,0
401262738,Fresno State Bulldogs,B. Walling,4595632,,False,7.0,0,0,0,0,0,0,0,0,0,2,2,1,0,0,0,0,0
401262738,Fresno State Bulldogs,K. Brown,4704473,,False,11.0,0,0,0,0,0,0,1,2,1,1,2,1,1,0,0,0,1
401262738,Fresno State Bulldogs,B. Delaney,4281825,,False,12.0,1,3,0,0,1,3,0,0,0,4,4,0,1,0,0,2,3
401262738,Fresno State Bulldogs,TEAM,TOTAL,TOTAL,False,,27,59,22,42,5,17,8,13,10,28,38,11,10,1,19,11,67
401262738,Boise State Broncos,A. Mark,4606930,,True,23.0,1,6,1,6,0,0,3,4,0,6,6,2,0,2,4,0,5
401262738,Boise State Broncos,A. Muse,4583056,,True,28.0,5,8,5,8,0,0,1,3,5,3,8,3,3,2,0,2,11
401262738,Boise State Broncos,M. McGwire,4066535,,True,28.0,12,20,11,15,1,5,1,2,4,5,9,3,2,2,1,0,26
401262738,Boise State Broncos,M. Naro,4705625,,True,34.0,0,6,0,4,0,2,0,0,0,2,2,0,2,1,3,2,0
401262738,Boise State Broncos,J. Loville,4400537,,True,37.0,5,18,5,16,0,2,2,2,2,1,3,3,0,1,2,4,12
401262738,Boise State Broncos,E. Lalotte,4705630,,False,12.0,1,4,1,4,0,0,0,0,1,1,2,0,0,0,0,2,2
401262738,Boise State Broncos,K. Sykes,4595619,,False,15.0,1,1,1,1,0,0,0,0,2,1,3,0,2,1,2,2,2
401262738,Boise State Broncos,R. Reed,4705629,,False,8.0,0,1,0,0,0,1,0,0,0,1,1,0,0,0,0,0,0
401262738,Boise State Broncos,A. Ostlie,4705626,,False,15.0,2,6,0,0,2,6,0,0,0,0,0,0,2,0,2,2,6
401262738,Boise State Broncos,TEAM,TOTAL,TOTAL,False,,27,70,24,54,3,16,7,11,17,22,39,11,11,9,14,14,64
401262738,Boise State Broncos,A. Mark,4606930,,True,23.0,1,6,1,6,0,0,3,4,0,6,6,2,0,2,4,0,5
401262738,Boise State Broncos,A. Muse,4583056,,True,28.0,5,8,5,8,0,0,1,3,5,3,8,3,3,2,0,2,11
401262738,Boise State Broncos,M. McGwire,4066535,,True,28.0,12,20,11,15,1,5,1,2,4,5,9,3,2,2,1,0,26
401262738,Boise State Broncos,M. Naro,4705625,,True,34.0,0,6,0,4,0,2,0,0,0,2,2,0,2,1,3,2,0
401262738,Boise State Broncos,J. Loville,4400537,,True,37.0,5,18,5,16,0,2,2,2,2,1,3,3,0,1,2,4,12
401262738,Boise State Broncos,E. Lalotte,4705630,,False,12.0,1,4,1,4,0,0,0,0,1,1,2,0,0,0,0,2,2
401262738,Boise State Broncos,K. Sykes,4595619,,False,15.0,1,1,1,1,0,0,0,0,2,1,3,0,2,1,2,2,2
401262738,Boise State Broncos,R. Reed,4705629,,False,8.0,0,1,0,0,0,1,0,0,0,1,1,0,0,0,0,0,0
401262738,Boise State Broncos,A. Ostlie,4705626,,False,15.0,2,6,0,0,2,6,0,0,0,0,0,0,2,0,2,2,6
401262738,Boise State Broncos,TEAM,TOTAL,TOTAL,False,,27,70,24,54,3,16,7,11,17,22,39,11,11,9,14,14,64
401262737,Fresno State Bulldogs,W. Motta,4595631,,True,15.0,4,7,4,7,0,0,1,2,1,7,8,0,2,0,1,4,9
401262737,Fresno State Bulldogs,M. Utti,4281828,,True,24.0,2,7,1,5,1,2,0,0,2,2,4,2,2,0,1,1,5
401262737,Fresno State Bulldogs,Hal. Cavinder,4433658,,True,34.0,5,15,4,10,1,5,4,4,2,7,9,5,2,0,1,0,15
401262737,Fresno State Bulldogs,Han. Cavinder,4433372,,True,28.0,9,17,9,16,0,1,1,3,0,1,1,8,2,0,1,0,19
401262737,Fresno State Bulldogs,A. Gamez,4281826,,True,20.0,3,7,2,4,1,3,0,0,2,0,2,1,0,0,0,0,7
401262737,Fresno State Bulldogs,C. Fairley,4704474,,False,3.0,0,1,0,1,0,0,0,0,0,0,0,0,0,0,0,0,0
401262737,Fresno State Bulldogs,K. Kinzer,4595630,,False,14.0,3,3,0,0,3,3,0,0,0,0,0,1,0,0,0,0,9
401262737,Fresno State Bulldogs,A. James,4433292,,False,3.0,1,2,1,2,0,0,0,0,0,0,0,2,0,0,1,0,2
401262737,Fresno State Bulldogs,G. Ogier,4281827,,False,5.0,3,3,3,3,0,0,0,0,0,0,0,0,1,0,0,1,6
401262737,Fresno State Bulldogs,M. Guimaraes,4704476,,False,8.0,2,2,2,2,0,0,0,0,3,2,5,0,0,0,0,1,4
401262737,Fresno State Bulldogs,B. Walling,4595632,,False,14.0,1,3,1,2,0,1,0,0,0,1,1,0,0,0,0,1,2
401262737,Fresno State Bulldogs,Y. Todorova,4704475,,False,7.0,0,0,0,0,0,0,0,0,0,0,0,0,2,0,0,0,0
401262737,Fresno State Bulldogs,K. Brown,4704473,,False,9.0,0,1,0,1,0,0,0,2,0,0,0,1,2,0,1,1,0
401262737,Fresno State Bulldogs,D. Dunn,4433511,,False,4.0,1,1,1,1,0,0,0,0,0,0,0,0,0,0,0,0,2
401262737,Fresno State Bulldogs,B. Delaney,4281825,,False,12.0,4,5,0,1,4,4,0,0,0,5,5,1,0,1,1,0,12
401262737,Fresno State Bulldogs,TEAM,TOTAL,TOTAL,False,,38,74,28,55,10,19,6,11,14,27,41,21,13,1,8,9,92
401262737,Fresno State Bulldogs,W. Motta,4595631,,True,15.0,4,7,4,7,0,0,1,2,1,7,8,0,2,0,1,4,9
401262737,Fresno State Bulldogs,M. Utti,4281828,,True,24.0,2,7,1,5,1,2,0,0,2,2,4,2,2,0,1,1,5
401262737,Fresno State Bulldogs,Hal. Cavinder,4433658,,True,34.0,5,15,4,10,1,5,4,4,2,7,9,5,2,0,1,0,15
401262737,Fresno State Bulldogs,Han. Cavinder,4433372,,True,28.0,9,17,9,16,0,1,1,3,0,1,1,8,2,0,1,0,19
401262737,Fresno State Bulldogs,A. Gamez,4281826,,True,20.0,3,7,2,4,1,3,0,0,2,0,2,1,0,0,0,0,7
401262737,Fresno State Bulldogs,C. Fairley,4704474,,False,3.0,0,1,0,1,0,0,0,0,0,0,0,0,0,0,0,0,0
401262737,Fresno State Bulldogs,K. Kinzer,4595630,,False,14.0,3,3,0,0,3,3,0,0,0,0,0,1,0,0,0,0,9
401262737,Fresno State Bulldogs,A. James,4433292,,False,3.0,1,2,1,2,0,0,0,0,0,0,0,2,0,0,1,0,2
401262737,Fresno State Bulldogs,G. Ogier,4281827,,False,5.0,3,3,3,3,0,0,0,0,0,0,0,0,1,0,0,1,6
401262737,Fresno State Bulldogs,M. Guimaraes,4704476,,False,8.0,2,2,2,2,0,0,0,0,3,2,5,0,0,0,0,1,4
401262737,Fresno State Bulldogs,B. Walling,4595632,,False,14.0,1,3,1,2,0,1,0,0,0,1,1,0,0,0,0,1,2
401262737,Fresno State Bulldogs,Y. Todorova,4704475,,False,7.0,0,0,0,0,0,0,0,0,0,0,0,0,2,0,0,0,0
401262737,Fresno State Bulldogs,K. Brown,4704473,,False,9.0,0,1,0,1,0,0,0,2,0,0,0,1,2,0,1,1,0
401262737,Fresno State Bulldogs,D. Dunn,4433511,,False,4.0,1,1,1,1,0,0,0,0,0,0,0,0,0,0,0,0,2
401262737,Fresno State Bulldogs,B. Delaney,4281825,,False,12.0,4,5,0,1,4,4,0,0,0,5,5,1,0,1,1,0,12
401262737,Fresno State Bulldogs,TEAM,TOTAL,TOTAL,False,,38,74,28,55,10,19,6,11,14,27,41,21,13,1,8,9,92
401262737,Boise State Broncos,A. Mark,4606930,,True,22.0,7,8,7,8,0,0,0,0,4,3,7,2,0,1,2,2,14
401262737,Boise State Broncos,R. Bowers,4400536,,True,17.0,5,7,5,7,0,0,0,0,1,4,5,0,0,1,2,2,10
401262737,Boise State Broncos,M. McGwire,4066535,,True,17.0,0,5,0,2,0,3,1,2,1,4,5,1,0,2,3,3,1
401262737,Boise State Broncos,M. Naro,4705625,,True,24.0,1,2,1,2,0,0,0,0,0,1,1,2,0,1,2,0,2
401262737,Boise State Broncos,J. Loville,4400537,,True,22.0,1,11,1,10,0,1,0,0,2,3,5,0,0,0,0,1,2
401262737,Boise State Broncos,E. Lalotte,4705630,,False,17.0,1,6,1,6,0,0,4,4,2,1,3,1,1,1,0,0,6
401262737,Boise State Broncos,K. Sykes,4595619,,False,21.0,1,4,0,0,1,4,0,2,3,1,4,0,0,0,1,1,3
401262737,Boise State Broncos,A. Muse,4583056,,False,14.0,3,10,3,10,0,0,0,0,3,2,5,0,0,3,2,2,6
401262737,Boise State Broncos,R. Reed,4705629,,False,13.0,2,6,1,4,1,2,0,0,0,1,1,0,1,0,1,0,5
401262737,Boise State Broncos,M. Machalova,4705628,,False,8.0,1,1,1,1,0,0,1,2,2,0,2,0,1,0,0,0,3
401262737,Boise State Broncos,C. Gil,4705627,,False,12.0,1,4,1,2,0,2,0,0,0,2,2,1,0,0,1,2,2
401262737,Boise State Broncos,A. Ostlie,4705626,,False,13.0,1,5,0,2,1,3,0,0,1,2,3,1,0,0,3,1,3
401262737,Boise State Broncos,TEAM,TOTAL,TOTAL,False,,24,69,21,54,3,15,6,10,19,25,44,8,3,9,17,14,57
401262737,Boise State Broncos,A. Mark,4606930,,True,22.0,7,8,7,8,0,0,0,0,4,3,7,2,0,1,2,2,14
401262737,Boise State Broncos,R. Bowers,4400536,,True,17.0,5,7,5,7,0,0,0,0,1,4,5,0,0,1,2,2,10
401262737,Boise State Broncos,M. McGwire,4066535,,True,17.0,0,5,0,2,0,3,1,2,1,4,5,1,0,2,3,3,1
401262737,Boise State Broncos,M. Naro,4705625,,True,24.0,1,2,1,2,0,0,0,0,0,1,1,2,0,1,2,0,2
401262737,Boise State Broncos,J. Loville,4400537,,True,22.0,1,11,1,10,0,1,0,0,2,3,5,0,0,0,0,1,2
401262737,Boise State Broncos,E. Lalotte,4705630,,False,17.0,1,6,1,6,0,0,4,4,2,1,3,1,1,1,0,0,6
401262737,Boise State Broncos,K. Sykes,4595619,,False,21.0,1,4,0,0,1,4,0,2,3,1,4,0,0,0,1,1,3
401262737,Boise State Broncos,A. Muse,4583056,,False,14.0,3,10,3,10,0,0,0,0,3,2,5,0,0,3,2,2,6
401262737,Boise State Broncos,R. Reed,4705629,,False,13.0,2,6,1,4,1,2,0,0,0,1,1,0,1,0,1,0,5
401262737,Boise State Broncos,M. Machalova,4705628,,False,8.0,1,1,1,1,0,0,1,2,2,0,2,0,1,0,0,0,3
401262737,Boise State Broncos,C. Gil,4705627,,False,12.0,1,4,1,2,0,2,0,0,0,2,2,1,0,0,1,2,2
401262737,Boise State Broncos,A. Ostlie,4705626,,False,13.0,1,5,0,2,1,3,0,0,1,2,3,1,0,0,3,1,3
401262737,Boise State Broncos,TEAM,TOTAL,TOTAL,False,,24,69,21,54,3,15,6,10,19,25,44,8,3,9,17,14,57
401262736,Wyoming Cowgirls,D. Davidsdottir,4068870,,True,18.0,4,9,4,8,0,1,4,4,2,4,6,0,1,0,1,3,12
401262736,Wyoming Cowgirls,J. Johnson,4595683,,True,19.0,1,6,0,2,1,4,1,2,0,0,0,0,0,0,0,1,4
401262736,Wyoming Cowgirls,Q. Weidemann,4400207,,True,35.0,1,14,0,7,1,7,0,0,0,3,3,2,0,1,0,1,3
401262736,Wyoming Cowgirls,A. Sanchez Ramos,4400204,,True,34.0,7,12,5,9,2,3,1,2,1,5,6,2,0,0,1,2,17
401262736,Wyoming Cowgirls,T. Olson,4400203,,True,34.0,2,4,2,4,0,0,1,2,0,5,5,5,0,0,1,4,5
401262736,Wyoming Cowgirls,M. Savic,4704660,,False,6.0,1,4,1,4,0,0,0,0,1,2,3,0,1,0,0,2,2
401262736,Wyoming Cowgirls,P. Salazar,4704659,,False,2.0,0,2,0,1,0,1,0,0,0,0,0,1,0,0,0,0,0
401262736,Wyoming Cowgirls,G. Ellis,4704657,,False,15.0,1,3,0,2,1,1,2,2,1,0,1,0,0,0,0,0,5
401262736,Wyoming Cowgirls,O. Ustowska,4704662,,False,11.0,0,0,0,0,0,0,0,0,0,0,0,0,0,1,1,1,0
401262736,Wyoming Cowgirls,M. Bradshaw,4595681,,False,26.0,5,8,3,6,2,2,2,2,1,5,6,1,0,0,5,1,14
401262736,Wyoming Cowgirls,TEAM,TOTAL,TOTAL,False,,22,62,15,43,7,19,11,14,10,25,35,11,2,2,9,15,62
401262736,Wyoming Cowgirls,D. Davidsdottir,4068870,,True,18.0,4,9,4,8,0,1,4,4,2,4,6,0,1,0,1,3,12
401262736,Wyoming Cowgirls,J. Johnson,4595683,,True,19.0,1,6,0,2,1,4,1,2,0,0,0,0,0,0,0,1,4
401262736,Wyoming Cowgirls,Q. Weidemann,4400207,,True,35.0,1,14,0,7,1,7,0,0,0,3,3,2,0,1,0,1,3
401262736,Wyoming Cowgirls,A. Sanchez Ramos,4400204,,True,34.0,7,12,5,9,2,3,1,2,1,5,6,2,0,0,1,2,17
401262736,Wyoming Cowgirls,T. Olson,4400203,,True,34.0,2,4,2,4,0,0,1,2,0,5,5,5,0,0,1,4,5
401262736,Wyoming Cowgirls,M. Savic,4704660,,False,6.0,1,4,1,4,0,0,0,0,1,2,3,0,1,0,0,2,2
401262736,Wyoming Cowgirls,P. Salazar,4704659,,False,2.0,0,2,0,1,0,1,0,0,0,0,0,1,0,0,0,0,0
401262736,Wyoming Cowgirls,G. Ellis,4704657,,False,15.0,1,3,0,2,1,1,2,2,1,0,1,0,0,0,0,0,5
401262736,Wyoming Cowgirls,O. Ustowska,4704662,,False,11.0,0,0,0,0,0,0,0,0,0,0,0,0,0,1,1,1,0
401262736,Wyoming Cowgirls,M. Bradshaw,4595681,,False,26.0,5,8,3,6,2,2,2,2,1,5,6,1,0,0,5,1,14
401262736,Wyoming Cowgirls,TEAM,TOTAL,TOTAL,False,,22,62,15,43,7,19,11,14,10,25,35,11,2,2,9,15,62
401262736,Boise State Broncos,A. Mark,4606930,,True,35.0,5,8,5,8,0,0,2,2,2,6,8,0,1,0,0,1,12
401262736,Boise State Broncos,R. Bowers,4400536,,True,10.0,0,1,0,1,0,0,1,2,0,3,3,0,0,1,2,3,1
401262736,Boise State Broncos,M. McGwire,4066535,,True,25.0,2,5,0,3,2,2,3,5,0,8,8,2,2,1,4,4,9
401262736,Boise State Broncos,M. Naro,4705625,,True,33.0,2,4,2,4,0,0,3,4,0,4,4,4,0,1,1,1,7
401262736,Boise State Broncos,J. Loville,4400537,,True,35.0,8,14,8,14,0,0,6,6,0,2,2,2,0,0,0,1,22
401262736,Boise State Broncos,E. Lalotte,4705630,,False,6.0,0,1,0,1,0,0,0,0,0,2,2,1,0,0,0,2,0
401262736,Boise State Broncos,K. Sykes,4595619,,False,18.0,1,4,1,2,0,2,0,0,1,0,1,0,1,1,0,0,2
401262736,Boise State Broncos,A. Muse,4583056,,False,13.0,2,4,2,4,0,0,0,0,0,2,2,0,0,0,0,1,4
401262736,Boise State Broncos,R. Reed,4705629,,False,8.0,1,4,1,2,0,2,0,0,1,0,1,0,1,0,2,1,2
401262736,Boise State Broncos,M. Machalova,4705628,,False,2.0,0,0,0,0,0,0,0,0,0,0,0,0,0,0,0,1,0
401262736,Boise State Broncos,C. Gil,4705627,,False,1.0,0,1,0,0,0,1,0,0,0,0,0,0,0,0,1,0,0
401262736,Boise State Broncos,A. Ostlie,4705626,,False,14.0,3,7,2,3,1,4,2,2,0,1,1,1,0,0,0,0,9
401262736,Boise State Broncos,TEAM,TOTAL,TOTAL,False,,24,53,21,42,3,11,17,21,4,30,34,10,5,4,10,15,68
401262736,Boise State Broncos,A. Mark,4606930,,True,35.0,5,8,5,8,0,0,2,2,2,6,8,0,1,0,0,1,12
401262736,Boise State Broncos,R. Bowers,4400536,,True,10.0,0,1,0,1,0,0,1,2,0,3,3,0,0,1,2,3,1
401262736,Boise State Broncos,M. McGwire,4066535,,True,25.0,2,5,0,3,2,2,3,5,0,8,8,2,2,1,4,4,9
401262736,Boise State Broncos,M. Naro,4705625,,True,33.0,2,4,2,4,0,0,3,4,0,4,4,4,0,1,1,1,7
401262736,Boise State Broncos,J. Loville,4400537,,True,35.0,8,14,8,14,0,0,6,6,0,2,2,2,0,0,0,1,22
401262736,Boise State Broncos,E. Lalotte,4705630,,False,6.0,0,1,0,1,0,0,0,0,0,2,2,1,0,0,0,2,0
401262736,Boise State Broncos,K. Sykes,4595619,,False,18.0,1,4,1,2,0,2,0,0,1,0,1,0,1,1,0,0,2
401262736,Boise State Broncos,A. Muse,4583056,,False,13.0,2,4,2,4,0,0,0,0,0,2,2,0,0,0,0,1,4
401262736,Boise State Broncos,R. Reed,4705629,,False,8.0,1,4,1,2,0,2,0,0,1,0,1,0,1,0,2,1,2
401262736,Boise State Broncos,M. Machalova,4705628,,False,2.0,0,0,0,0,0,0,0,0,0,0,0,0,0,0,0,1,0
401262736,Boise State Broncos,C. Gil,4705627,,False,1.0,0,1,0,0,0,1,0,0,0,0,0,0,0,0,1,0,0
401262736,Boise State Broncos,A. Ostlie,4705626,,False,14.0,3,7,2,3,1,4,2,2,0,1,1,1,0,0,0,0,9
401262736,Boise State Broncos,TEAM,TOTAL,TOTAL,False,,24,53,21,42,3,11,17,21,4,30,34,10,5,4,10,15,68
401262735,Wyoming Cowgirls,D. Davidsdottir,4068870,,True,28.0,4,8,4,8,0,0,0,0,1,7,8,0,0,0,0,2,8
401262735,Wyoming Cowgirls,J. Johnson,4595683,,True,13.0,2,6,1,4,1,2,0,0,0,0,0,0,0,0,2,0,5
401262735,Wyoming Cowgirls,Q. Weidemann,4400207,,True,35.0,3,6,3,5,0,1,0,1,0,3,3,2,0,0,2,2,6
401262735,Wyoming Cowgirls,A. Sanchez Ramos,4400204,,True,27.0,3,8,3,4,0,4,0,0,0,1,1,0,1,0,2,3,6
401262735,Wyoming Cowgirls,T. Olson,4400203,,True,31.0,0,2,0,1,0,1,2,6,1,4,5,5,0,0,1,4,2
401262735,Wyoming Cowgirls,M. Savic,4704660,,False,12.0,2,4,2,4,0,0,1,3,0,0,0,0,1,0,1,0,5
401262735,Wyoming Cowgirls,G. Ellis,4704657,,False,13.0,0,2,0,0,0,2,0,0,0,3,3,1,0,0,1,1,0
401262735,Wyoming Cowgirls,O. Ustowska,4704662,,False,14.0,1,3,1,2,0,1,0,0,0,1,1,0,0,0,0,0,2
401262735,Wyoming Cowgirls,M. Bradshaw,4595681,,False,27.0,10,12,6,7,4,5,3,4,1,3,4,0,3,0,6,0,27
401262735,Wyoming Cowgirls,TEAM,TOTAL,TOTAL,False,,25,51,20,35,5,16,6,14,7,23,30,8,5,0,16,12,61
401262735,Wyoming Cowgirls,D. Davidsdottir,4068870,,True,28.0,4,8,4,8,0,0,0,0,1,7,8,0,0,0,0,2,8
401262735,Wyoming Cowgirls,J. Johnson,4595683,,True,13.0,2,6,1,4,1,2,0,0,0,0,0,0,0,0,2,0,5
401262735,Wyoming Cowgirls,Q. Weidemann,4400207,,True,35.0,3,6,3,5,0,1,0,1,0,3,3,2,0,0,2,2,6
401262735,Wyoming Cowgirls,A. Sanchez Ramos,4400204,,True,27.0,3,8,3,4,0,4,0,0,0,1,1,0,1,0,2,3,6
401262735,Wyoming Cowgirls,T. Olson,4400203,,True,31.0,0,2,0,1,0,1,2,6,1,4,5,5,0,0,1,4,2
401262735,Wyoming Cowgirls,M. Savic,4704660,,False,12.0,2,4,2,4,0,0,1,3,0,0,0,0,1,0,1,0,5
401262735,Wyoming Cowgirls,G. Ellis,4704657,,False,13.0,0,2,0,0,0,2,0,0,0,3,3,1,0,0,1,1,0
401262735,Wyoming Cowgirls,O. Ustowska,4704662,,False,14.0,1,3,1,2,0,1,0,0,0,1,1,0,0,0,0,0,2
401262735,Wyoming Cowgirls,M. Bradshaw,4595681,,False,27.0,10,12,6,7,4,5,3,4,1,3,4,0,3,0,6,0,27
401262735,Wyoming Cowgirls,TEAM,TOTAL,TOTAL,False,,25,51,20,35,5,16,6,14,7,23,30,8,5,0,16,12,61
401262735,Boise State Broncos,A. Mark,4606930,,True,27.0,6,9,6,9,0,0,0,0,3,0,3,0,3,1,4,2,12
401262735,Boise State Broncos,R. Bowers,4400536,,True,17.0,1,4,1,3,0,1,2,2,0,1,1,1,0,2,1,2,4
401262735,Boise State Broncos,M. McGwire,4066535,,True,32.0,9,20,4,9,5,11,2,4,5,10,15,1,2,1,1,1,25
401262735,Boise State Broncos,M. Naro,4705625,,True,34.0,1,4,1,3,0,1,3,4,1,2,3,6,0,0,1,3,5
401262735,Boise State Broncos,J. Loville,4400537,,True,19.0,1,9,1,9,0,0,0,0,1,2,3,0,0,0,0,2,2
401262735,Boise State Broncos,E. Lalotte,4705630,,False,11.0,2,4,2,4,0,0,0,0,3,1,4,0,0,2,2,1,4
401262735,Boise State Broncos,K. Sykes,4595619,,False,19.0,1,2,1,1,0,1,1,2,0,2,2,1,2,0,0,0,3
401262735,Boise State Broncos,A. Muse,4583056,,False,11.0,1,1,1,1,0,0,0,0,1,0,1,0,0,1,1,0,2
401262735,Boise State Broncos,R. Reed,4705629,,False,11.0,1,2,0,1,1,1,1,2,0,1,1,0,0,0,0,1,4
401262735,Boise State Broncos,M. Machalova,4705628,,False,4.0,0,1,0,0,0,1,0,0,0,0,0,0,0,0,0,2,0
401262735,Boise State Broncos,C. Gil,4705627,,False,2.0,0,0,0,0,0,0,0,0,0,0,0,0,0,0,1,0,0
401262735,Boise State Broncos,A. Ostlie,4705626,,False,13.0,2,3,0,0,2,3,1,2,0,1,1,1,0,0,0,1,7
401262735,Boise State Broncos,TEAM,TOTAL,TOTAL,False,,25,59,17,40,8,19,10,16,14,22,36,10,7,7,12,15,68
401262735,Boise State Broncos,A. Mark,4606930,,True,27.0,6,9,6,9,0,0,0,0,3,0,3,0,3,1,4,2,12
401262735,Boise State Broncos,R. Bowers,4400536,,True,17.0,1,4,1,3,0,1,2,2,0,1,1,1,0,2,1,2,4
401262735,Boise State Broncos,M. McGwire,4066535,,True,32.0,9,20,4,9,5,11,2,4,5,10,15,1,2,1,1,1,25
401262735,Boise State Broncos,M. Naro,4705625,,True,34.0,1,4,1,3,0,1,3,4,1,2,3,6,0,0,1,3,5
401262735,Boise State Broncos,J. Loville,4400537,,True,19.0,1,9,1,9,0,0,0,0,1,2,3,0,0,0,0,2,2
401262735,Boise State Broncos,E. Lalotte,4705630,,False,11.0,2,4,2,4,0,0,0,0,3,1,4,0,0,2,2,1,4
401262735,Boise State Broncos,K. Sykes,4595619,,False,19.0,1,2,1,1,0,1,1,2,0,2,2,1,2,0,0,0,3
401262735,Boise State Broncos,A. Muse,4583056,,False,11.0,1,1,1,1,0,0,0,0,1,0,1,0,0,1,1,0,2
401262735,Boise State Broncos,R. Reed,4705629,,False,11.0,1,2,0,1,1,1,1,2,0,1,1,0,0,0,0,1,4
401262735,Boise State Broncos,M. Machalova,4705628,,False,4.0,0,1,0,0,0,1,0,0,0,0,0,0,0,0,0,2,0
401262735,Boise State Broncos,C. Gil,4705627,,False,2.0,0,0,0,0,0,0,0,0,0,0,0,0,0,0,1,0,0
401262735,Boise State Broncos,A. Ostlie,4705626,,False,13.0,2,3,0,0,2,3,1,2,0,1,1,1,0,0,0,1,7
401262735,Boise State Broncos,TEAM,TOTAL,TOTAL,False,,25,59,17,40,8,19,10,16,14,22,36,10,7,7,12,15,68
401262734,San José State Spartans,C. Lewis,4281885,,True,26.0,3,12,2,7,1,5,3,6,2,3,5,0,0,1,1,2,10
401262734,San José State Spartans,M. Oberg,4068575,,True,32.0,2,9,1,3,1,6,1,1,3,5,8,2,0,1,2,1,6
401262734,San José State Spartans,R. Potter,4400182,,True,27.0,6,12,6,10,0,2,2,3,0,0,0,1,1,0,3,4,14
401262734,San José State Spartans,C. Clark,4281882,,True,22.0,0,4,0,3,0,1,0,0,1,1,2,1,1,0,3,4,0
401262734,San José State Spartans,A. Benally,4068388,,True,11.0,0,2,0,1,0,1,0,0,0,0,0,0,0,0,0,0,0
401262734,San José State Spartans,T. Whitehead,4065888,,False,22.0,5,12,5,11,0,1,4,6,1,7,8,1,1,1,2,1,14
401262734,San José State Spartans,A. Mendez,4704578,,False,23.0,1,5,0,2,1,3,0,2,3,1,4,0,0,1,1,1,3
401262734,San José State Spartans,S. Jones,4433780,,False,12.0,0,1,0,0,0,1,1,2,0,0,0,0,1,0,0,0,1
401262734,San José State Spartans,D. Marquez,4281886,,False,25.0,2,7,1,2,1,5,0,0,0,3,3,1,2,0,2,0,5
401262734,San José State Spartans,TEAM,TOTAL,TOTAL,False,,19,64,15,39,4,25,11,20,13,23,36,6,6,4,14,13,53
401262734,San José State Spartans,C. Lewis,4281885,,True,26.0,3,12,2,7,1,5,3,6,2,3,5,0,0,1,1,2,10
401262734,San José State Spartans,M. Oberg,4068575,,True,32.0,2,9,1,3,1,6,1,1,3,5,8,2,0,1,2,1,6
401262734,San José State Spartans,R. Potter,4400182,,True,27.0,6,12,6,10,0,2,2,3,0,0,0,1,1,0,3,4,14
401262734,San José State Spartans,C. Clark,4281882,,True,22.0,0,4,0,3,0,1,0,0,1,1,2,1,1,0,3,4,0
401262734,San José State Spartans,A. Benally,4068388,,True,11.0,0,2,0,1,0,1,0,0,0,0,0,0,0,0,0,0,0
401262734,San José State Spartans,T. Whitehead,4065888,,False,22.0,5,12,5,11,0,1,4,6,1,7,8,1,1,1,2,1,14
401262734,San José State Spartans,A. Mendez,4704578,,False,23.0,1,5,0,2,1,3,0,2,3,1,4,0,0,1,1,1,3
401262734,San José State Spartans,S. Jones,4433780,,False,12.0,0,1,0,0,0,1,1,2,0,0,0,0,1,0,0,0,1
401262734,San José State Spartans,D. Marquez,4281886,,False,25.0,2,7,1,2,1,5,0,0,0,3,3,1,2,0,2,0,5
401262734,San José State Spartans,TEAM,TOTAL,TOTAL,False,,19,64,15,39,4,25,11,20,13,23,36,6,6,4,14,13,53
401262734,Boise State Broncos,A. Mark,4606930,,True,20.0,2,7,2,6,0,1,0,0,1,0,1,1,1,0,3,1,4
401262734,Boise State Broncos,R. Bowers,4400536,,True,28.0,6,11,6,9,0,2,2,2,5,7,12,0,1,2,2,3,14
401262734,Boise State Broncos,M. McGwire,4066535,,True,30.0,6,12,5,7,1,5,2,2,2,14,16,5,3,0,2,3,15
401262734,Boise State Broncos,M. Naro,4705625,,True,35.0,3,6,2,4,1,2,0,0,0,4,4,2,1,0,3,2,7
401262734,Boise State Broncos,J. Loville,4400537,,True,36.0,6,16,6,14,0,2,10,12,0,5,5,4,0,0,3,2,22
401262734,Boise State Broncos,E. Lalotte,4705630,,False,10.0,2,6,2,6,0,0,0,0,1,2,3,0,0,0,0,0,4
401262734,Boise State Broncos,K. Sykes,4595619,,False,10.0,0,0,0,0,0,0,0,0,0,1,1,0,0,0,0,1,0
401262734,Boise State Broncos,A. Muse,4583056,,False,10.0,0,0,0,0,0,0,2,2,1,1,2,0,0,0,0,2,2
401262734,Boise State Broncos,R. Reed,4705629,,False,16.0,1,2,1,1,0,1,0,0,0,0,0,2,0,0,0,0,2
401262734,Boise State Broncos,M. Machalova,4705628,,False,2.0,0,0,0,0,0,0,0,0,0,0,0,0,0,0,1,0,0
401262734,Boise State Broncos,A. Ostlie,4705626,,False,3.0,0,1,0,0,0,1,0,0,0,0,0,0,0,0,0,0,0
401262734,Boise State Broncos,TEAM,TOTAL,TOTAL,False,,26,61,24,47,2,14,16,18,13,35,48,14,6,2,14,14,70
401262734,Boise State Broncos,A. Mark,4606930,,True,20.0,2,7,2,6,0,1,0,0,1,0,1,1,1,0,3,1,4
401262734,Boise State Broncos,R. Bowers,4400536,,True,28.0,6,11,6,9,0,2,2,2,5,7,12,0,1,2,2,3,14
401262734,Boise State Broncos,M. McGwire,4066535,,True,30.0,6,12,5,7,1,5,2,2,2,14,16,5,3,0,2,3,15
401262734,Boise State Broncos,M. Naro,4705625,,True,35.0,3,6,2,4,1,2,0,0,0,4,4,2,1,0,3,2,7
401262734,Boise State Broncos,J. Loville,4400537,,True,36.0,6,16,6,14,0,2,10,12,0,5,5,4,0,0,3,2,22
401262734,Boise State Broncos,E. Lalotte,4705630,,False,10.0,2,6,2,6,0,0,0,0,1,2,3,0,0,0,0,0,4
401262734,Boise State Broncos,K. Sykes,4595619,,False,10.0,0,0,0,0,0,0,0,0,0,1,1,0,0,0,0,1,0
401262734,Boise State Broncos,A. Muse,4583056,,False,10.0,0,0,0,0,0,0,2,2,1,1,2,0,0,0,0,2,2
401262734,Boise State Broncos,R. Reed,4705629,,False,16.0,1,2,1,1,0,1,0,0,0,0,0,2,0,0,0,0,2
401262734,Boise State Broncos,M. Machalova,4705628,,False,2.0,0,0,0,0,0,0,0,0,0,0,0,0,0,0,1,0,0
401262734,Boise State Broncos,A. Ostlie,4705626,,False,3.0,0,1,0,0,0,1,0,0,0,0,0,0,0,0,0,0,0
401262734,Boise State Broncos,TEAM,TOTAL,TOTAL,False,,26,61,24,47,2,14,16,18,13,35,48,14,6,2,14,14,70
401262733,San José State Spartans,C. Lewis,4281885,,True,28.0,7,14,6,11,1,3,5,5,2,11,13,1,1,1,0,0,20
401262733,San José State Spartans,M. Oberg,4068575,,True,23.0,1,5,1,4,0,1,0,0,6,2,8,2,0,1,0,4,2
401262733,San José State Spartans,R. Potter,4400182,,True,27.0,6,16,5,15,1,1,4,8,4,1,5,3,2,0,3,5,17
401262733,San José State Spartans,C. Clark,4281882,,True,20.0,2,9,1,6,1,3,0,0,0,1,1,0,2,0,4,4,5
401262733,San José State Spartans,A. Benally,4068388,,True,21.0,0,3,0,1,0,2,0,0,0,3,3,1,0,2,1,2,0
401262733,San José State Spartans,A. Fluker,4704579,,False,1.0,0,0,0,0,0,0,0,0,0,0,0,0,0,0,1,1,0
401262733,San José State Spartans,T. Whitehead,4065888,,False,24.0,7,18,7,18,0,0,2,4,5,4,9,1,2,0,3,4,16
401262733,San José State Spartans,A. Mendez,4704578,,False,20.0,1,5,0,3,1,2,0,0,0,1,1,3,1,0,0,0,3
401262733,San José State Spartans,S. Jones,4433780,,False,10.0,1,3,0,1,1,2,1,3,0,0,0,0,1,0,0,0,4
401262733,San José State Spartans,D. Marquez,4281886,,False,26.0,3,8,1,3,2,5,0,0,0,3,3,4,1,0,1,1,8
401262733,San José State Spartans,TEAM,TOTAL,TOTAL,False,,28,81,21,62,7,19,12,20,22,29,51,15,10,4,13,21,75
401262733,San José State Spartans,C. Lewis,4281885,,True,28.0,7,14,6,11,1,3,5,5,2,11,13,1,1,1,0,0,20
401262733,San José State Spartans,M. Oberg,4068575,,True,23.0,1,5,1,4,0,1,0,0,6,2,8,2,0,1,0,4,2
401262733,San José State Spartans,R. Potter,4400182,,True,27.0,6,16,5,15,1,1,4,8,4,1,5,3,2,0,3,5,17
401262733,San José State Spartans,C. Clark,4281882,,True,20.0,2,9,1,6,1,3,0,0,0,1,1,0,2,0,4,4,5
401262733,San José State Spartans,A. Benally,4068388,,True,21.0,0,3,0,1,0,2,0,0,0,3,3,1,0,2,1,2,0
401262733,San José State Spartans,A. Fluker,4704579,,False,1.0,0,0,0,0,0,0,0,0,0,0,0,0,0,0,1,1,0
401262733,San José State Spartans,T. Whitehead,4065888,,False,24.0,7,18,7,18,0,0,2,4,5,4,9,1,2,0,3,4,16
401262733,San José State Spartans,A. Mendez,4704578,,False,20.0,1,5,0,3,1,2,0,0,0,1,1,3,1,0,0,0,3
401262733,San José State Spartans,S. Jones,4433780,,False,10.0,1,3,0,1,1,2,1,3,0,0,0,0,1,0,0,0,4
401262733,San José State Spartans,D. Marquez,4281886,,False,26.0,3,8,1,3,2,5,0,0,0,3,3,4,1,0,1,1,8
401262733,San José State Spartans,TEAM,TOTAL,TOTAL,False,,28,81,21,62,7,19,12,20,22,29,51,15,10,4,13,21,75
401262733,Boise State Broncos,A. Mark,4606930,,True,30.0,4,12,4,11,0,1,0,0,0,3,3,0,1,1,3,2,8
401262733,Boise State Broncos,A. Muse,4583056,,True,32.0,7,13,7,13,0,0,0,3,6,12,18,2,1,2,3,3,14
401262733,Boise State Broncos,R. Bowers,4400536,,True,11.0,0,0,0,0,0,0,0,0,0,2,2,1,0,0,2,4,0
401262733,Boise State Broncos,M. Naro,4705625,,True,35.0,3,9,0,5,3,4,1,2,0,2,2,8,0,0,4,2,10
401262733,Boise State Broncos,J. Loville,4400537,,True,40.0,12,23,10,16,2,7,5,6,2,3,5,2,0,1,1,2,31
401262733,Boise State Broncos,E. Lalotte,4705630,,False,18.0,1,4,1,4,0,0,2,2,1,5,6,0,0,3,3,4,4
401262733,Boise State Broncos,C. Njoku,4595621,,False,1.0,0,0,0,0,0,0,0,0,0,0,0,0,0,0,0,0,0
401262733,Boise State Broncos,K. Sykes,4595619,,False,9.0,0,3,0,1,0,2,0,0,1,0,1,1,0,0,2,1,0
401262733,Boise State Broncos,R. Reed,4705629,,False,19.0,3,6,0,1,3,5,1,2,1,4,5,1,1,0,1,0,10
401262733,Boise State Broncos,M. Machalova,4705628,,False,5.0,0,0,0,0,0,0,0,0,0,0,0,0,0,0,0,0,0
401262733,Boise State Broncos,TEAM,TOTAL,TOTAL,False,,30,70,22,51,8,19,9,15,13,31,44,15,3,7,19,18,77
401262733,Boise State Broncos,A. Mark,4606930,,True,30.0,4,12,4,11,0,1,0,0,0,3,3,0,1,1,3,2,8
401262733,Boise State Broncos,A. Muse,4583056,,True,32.0,7,13,7,13,0,0,0,3,6,12,18,2,1,2,3,3,14
401262733,Boise State Broncos,R. Bowers,4400536,,True,11.0,0,0,0,0,0,0,0,0,0,2,2,1,0,0,2,4,0
401262733,Boise State Broncos,M. Naro,4705625,,True,35.0,3,9,0,5,3,4,1,2,0,2,2,8,0,0,4,2,10
401262733,Boise State Broncos,J. Loville,4400537,,True,40.0,12,23,10,16,2,7,5,6,2,3,5,2,0,1,1,2,31
401262733,Boise State Broncos,E. Lalotte,4705630,,False,18.0,1,4,1,4,0,0,2,2,1,5,6,0,0,3,3,4,4
401262733,Boise State Broncos,C. Njoku,4595621,,False,1.0,0,0,0,0,0,0,0,0,0,0,0,0,0,0,0,0,0
401262733,Boise State Broncos,K. Sykes,4595619,,False,9.0,0,3,0,1,0,2,0,0,1,0,1,1,0,0,2,1,0
401262733,Boise State Broncos,R. Reed,4705629,,False,19.0,3,6,0,1,3,5,1,2,1,4,5,1,1,0,1,0,10
401262733,Boise State Broncos,M. Machalova,4705628,,False,5.0,0,0,0,0,0,0,0,0,0,0,0,0,0,0,0,0,0
401262733,Boise State Broncos,TEAM,TOTAL,TOTAL,False,,30,70,22,51,8,19,9,15,13,31,44,15,3,7,19,18,77
401262732,Colorado State Rams,K. Murphy,4068969,,True,17.0,3,7,3,7,0,0,6,6,6,4,10,1,0,1,2,3,12
401262732,Colorado State Rams,E. Boni,4704462,,True,18.0,2,3,2,2,0,1,0,0,0,2,2,1,1,0,1,2,4
401262732,Colorado State Rams,M. Hofschild,4595160,,True,34.0,3,11,2,7,1,4,4,4,1,3,4,5,4,0,3,2,11
401262732,Colorado State Rams,L. Devos,4284002,,True,28.0,4,8,4,8,0,0,0,0,2,4,6,0,2,0,2,0,8
401262732,Colorado State Rams,T. Williams,4282176,,True,29.0,4,12,0,2,4,10,0,0,1,8,9,1,2,0,1,1,12
401262732,Colorado State Rams,C. Clark,4704464,,False,13.0,4,6,4,6,0,0,0,0,0,1,1,0,0,0,1,1,8
401262732,Colorado State Rams,M. Torres,4704466,,False,2.0,0,0,0,0,0,0,0,0,0,0,0,0,0,0,1,2,0
401262732,Colorado State Rams,J. Bonnarens,4400102,,False,18.0,4,8,2,4,2,4,0,0,1,1,2,1,0,1,1,0,10
401262732,Colorado State Rams,L. Davis,4068248,,False,2.0,0,1,0,1,0,0,0,0,0,0,0,0,0,0,0,0,0
401262732,Colorado State Rams,M. Hemingway,4704465,,False,2.0,0,0,0,0,0,0,0,0,0,1,1,0,0,0,0,0,0
401262732,Colorado State Rams,P. Farkas,4704463,,False,11.0,1,1,0,0,1,1,0,0,0,1,1,0,0,0,0,0,3
401262732,Colorado State Rams,B. Alper,4595629,,False,4.0,0,1,0,1,0,0,0,0,0,1,1,2,0,0,1,0,0
401262732,Colorado State Rams,A. Eberhardt,4595628,,False,1.0,0,0,0,0,0,0,0,0,0,0,0,0,0,0,0,0,0
401262732,Colorado State Rams,S. Mech,4399658,,False,18.0,2,4,2,2,0,2,0,0,1,2,3,2,0,0,0,2,4
401262732,Colorado State Rams,L. Brocke,4281823,,False,2.0,0,0,0,0,0,0,0,0,0,0,0,0,0,0,0,0,0
401262732,Colorado State Rams,TEAM,TOTAL,TOTAL,False,,27,62,19,40,8,22,10,10,13,30,43,13,9,2,13,13,72
401262732,Colorado State Rams,K. Murphy,4068969,,True,17.0,3,7,3,7,0,0,6,6,6,4,10,1,0,1,2,3,12
401262732,Colorado State Rams,E. Boni,4704462,,True,18.0,2,3,2,2,0,1,0,0,0,2,2,1,1,0,1,2,4
401262732,Colorado State Rams,M. Hofschild,4595160,,True,34.0,3,11,2,7,1,4,4,4,1,3,4,5,4,0,3,2,11
401262732,Colorado State Rams,L. Devos,4284002,,True,28.0,4,8,4,8,0,0,0,0,2,4,6,0,2,0,2,0,8
401262732,Colorado State Rams,T. Williams,4282176,,True,29.0,4,12,0,2,4,10,0,0,1,8,9,1,2,0,1,1,12
401262732,Colorado State Rams,C. Clark,4704464,,False,13.0,4,6,4,6,0,0,0,0,0,1,1,0,0,0,1,1,8
401262732,Colorado State Rams,M. Torres,4704466,,False,2.0,0,0,0,0,0,0,0,0,0,0,0,0,0,0,1,2,0
401262732,Colorado State Rams,J. Bonnarens,4400102,,False,18.0,4,8,2,4,2,4,0,0,1,1,2,1,0,1,1,0,10
401262732,Colorado State Rams,L. Davis,4068248,,False,2.0,0,1,0,1,0,0,0,0,0,0,0,0,0,0,0,0,0
401262732,Colorado State Rams,M. Hemingway,4704465,,False,2.0,0,0,0,0,0,0,0,0,0,1,1,0,0,0,0,0,0
401262732,Colorado State Rams,P. Farkas,4704463,,False,11.0,1,1,0,0,1,1,0,0,0,1,1,0,0,0,0,0,3
401262732,Colorado State Rams,B. Alper,4595629,,False,4.0,0,1,0,1,0,0,0,0,0,1,1,2,0,0,1,0,0
401262732,Colorado State Rams,A. Eberhardt,4595628,,False,1.0,0,0,0,0,0,0,0,0,0,0,0,0,0,0,0,0,0
401262732,Colorado State Rams,S. Mech,4399658,,False,18.0,2,4,2,2,0,2,0,0,1,2,3,2,0,0,0,2,4
401262732,Colorado State Rams,L. Brocke,4281823,,False,2.0,0,0,0,0,0,0,0,0,0,0,0,0,0,0,0,0,0
401262732,Colorado State Rams,TEAM,TOTAL,TOTAL,False,,27,62,19,40,8,22,10,10,13,30,43,13,9,2,13,13,72
401262732,Air Force Falcons,R. Snyder,4399409,,True,25.0,4,9,1,4,3,5,0,0,0,3,3,0,1,1,1,4,11
401262732,Air Force Falcons,K. Huffman,4068225,,True,20.0,0,4,0,4,0,0,0,0,1,5,6,1,1,1,1,1,0
401262732,Air Force Falcons,B. Autrey-Thompson,4399404,,True,16.0,4,11,2,9,2,2,0,0,0,0,0,2,1,0,5,2,10
401262732,Air Force Falcons,K. Immel,4281743,,True,28.0,0,2,0,2,0,0,0,0,2,1,3,1,0,0,3,2,0
401262732,Air Force Falcons,E. Conroe,4281737,,True,17.0,1,2,1,2,0,0,0,0,2,2,4,0,0,0,0,2,2
401262732,Air Force Falcons,D. MacMillan,4704414,,False,19.0,3,7,2,5,1,2,2,2,0,1,1,1,0,0,1,1,9
401262732,Air Force Falcons,N. McDonald,4595618,,False,16.0,1,2,0,0,1,2,0,0,1,2,3,1,0,0,0,0,3
401262732,Air Force Falcons,S. Thomas,4704413,,False,3.0,0,3,0,2,0,1,2,2,0,0,0,0,0,0,0,0,2
401262732,Air Force Falcons,K. Pilson,4704411,,False,16.0,1,6,0,0,1,6,2,2,1,2,3,0,0,0,2,1,5
401262732,Air Force Falcons,K. Heath,4595614,,False,23.0,2,6,2,6,0,0,1,1,1,2,3,3,3,1,3,1,5
401262732,Air Force Falcons,C. Winters,4399406,,False,7.0,0,1,0,1,0,0,1,2,0,1,1,0,1,0,0,0,1
401262732,Air Force Falcons,A. Gadison,4399405,,False,11.0,0,4,0,1,0,3,0,0,2,0,2,3,3,0,1,0,0
401262732,Air Force Falcons,TEAM,TOTAL,TOTAL,False,,16,57,8,36,8,21,8,9,11,22,33,12,10,3,17,14,48
401262732,Air Force Falcons,R. Snyder,4399409,,True,25.0,4,9,1,4,3,5,0,0,0,3,3,0,1,1,1,4,11
401262732,Air Force Falcons,K. Huffman,4068225,,True,20.0,0,4,0,4,0,0,0,0,1,5,6,1,1,1,1,1,0
401262732,Air Force Falcons,B. Autrey-Thompson,4399404,,True,16.0,4,11,2,9,2,2,0,0,0,0,0,2,1,0,5,2,10
401262732,Air Force Falcons,K. Immel,4281743,,True,28.0,0,2,0,2,0,0,0,0,2,1,3,1,0,0,3,2,0
401262732,Air Force Falcons,E. Conroe,4281737,,True,17.0,1,2,1,2,0,0,0,0,2,2,4,0,0,0,0,2,2
401262732,Air Force Falcons,D. MacMillan,4704414,,False,19.0,3,7,2,5,1,2,2,2,0,1,1,1,0,0,1,1,9
401262732,Air Force Falcons,N. McDonald,4595618,,False,16.0,1,2,0,0,1,2,0,0,1,2,3,1,0,0,0,0,3
401262732,Air Force Falcons,S. Thomas,4704413,,False,3.0,0,3,0,2,0,1,2,2,0,0,0,0,0,0,0,0,2
401262732,Air Force Falcons,K. Pilson,4704411,,False,16.0,1,6,0,0,1,6,2,2,1,2,3,0,0,0,2,1,5
401262732,Air Force Falcons,K. Heath,4595614,,False,23.0,2,6,2,6,0,0,1,1,1,2,3,3,3,1,3,1,5
401262732,Air Force Falcons,C. Winters,4399406,,False,7.0,0,1,0,1,0,0,1,2,0,1,1,0,1,0,0,0,1
401262732,Air Force Falcons,A. Gadison,4399405,,False,11.0,0,4,0,1,0,3,0,0,2,0,2,3,3,0,1,0,0
401262732,Air Force Falcons,TEAM,TOTAL,TOTAL,False,,16,57,8,36,8,21,8,9,11,22,33,12,10,3,17,14,48
401262731,New Mexico Lobos,S. McGruder,4400149,,True,30.0,2,5,2,4,0,1,0,0,1,2,3,1,0,1,3,2,4
401262731,New Mexico Lobos,A. Anderson,4281834,,True,26.0,6,15,6,12,0,3,1,2,2,3,5,0,3,0,2,5,13
401262731,New Mexico Lobos,Lato. Duff,4704520,,True,28.0,3,9,2,3,1,6,1,2,0,4,4,0,1,0,3,0,8
401262731,New Mexico Lobos,Lata. Duff,4704519,,True,37.0,6,16,3,10,3,6,5,5,1,6,7,3,2,0,1,0,20
401262731,New Mexico Lobos,J. De La Cerda,4281833,,True,32.0,7,8,5,5,2,3,0,0,0,3,3,1,0,0,1,3,16
401262731,New Mexico Lobos,A. Watts,4433688,,False,13.0,2,2,2,2,0,0,0,0,0,1,1,2,0,0,0,1,4
401262731,New Mexico Lobos,K. van Bennekom,4704522,,False,6.0,0,0,0,0,0,0,0,0,1,1,2,0,0,0,1,0,0
401262731,New Mexico Lobos,C. Carter,4433646,,False,28.0,2,4,1,2,1,2,3,4,0,2,2,7,1,0,2,1,8
401262731,New Mexico Lobos,TEAM,TOTAL,TOTAL,False,,28,59,21,38,7,21,10,13,6,23,29,14,7,1,13,12,73
401262731,New Mexico Lobos,S. McGruder,4400149,,True,30.0,2,5,2,4,0,1,0,0,1,2,3,1,0,1,3,2,4
401262731,New Mexico Lobos,A. Anderson,4281834,,True,26.0,6,15,6,12,0,3,1,2,2,3,5,0,3,0,2,5,13
401262731,New Mexico Lobos,Lato. Duff,4704520,,True,28.0,3,9,2,3,1,6,1,2,0,4,4,0,1,0,3,0,8
401262731,New Mexico Lobos,Lata. Duff,4704519,,True,37.0,6,16,3,10,3,6,5,5,1,6,7,3,2,0,1,0,20
401262731,New Mexico Lobos,J. De La Cerda,4281833,,True,32.0,7,8,5,5,2,3,0,0,0,3,3,1,0,0,1,3,16
401262731,New Mexico Lobos,A. Watts,4433688,,False,13.0,2,2,2,2,0,0,0,0,0,1,1,2,0,0,0,1,4
401262731,New Mexico Lobos,K. van Bennekom,4704522,,False,6.0,0,0,0,0,0,0,0,0,1,1,2,0,0,0,1,0,0
401262731,New Mexico Lobos,C. Carter,4433646,,False,28.0,2,4,1,2,1,2,3,4,0,2,2,7,1,0,2,1,8
401262731,New Mexico Lobos,TEAM,TOTAL,TOTAL,False,,28,59,21,38,7,21,10,13,6,23,29,14,7,1,13,12,73
401262731,Air Force Falcons,R. Snyder,4399409,,True,29.0,7,14,2,6,5,8,2,2,0,4,4,4,1,0,3,4,21
401262731,Air Force Falcons,K. Huffman,4068225,,True,27.0,1,1,1,1,0,0,0,0,0,4,4,1,0,2,3,3,2
401262731,Air Force Falcons,B. Autrey-Thompson,4399404,,True,33.0,4,10,4,8,0,2,3,4,2,1,3,5,1,0,3,1,11
401262731,Air Force Falcons,K. Immel,4281743,,True,31.0,5,13,3,6,2,7,2,2,1,2,3,3,1,0,2,1,14
401262731,Air Force Falcons,E. Conroe,4281737,,True,22.0,3,6,3,5,0,1,2,2,2,4,6,4,3,0,0,0,8
401262731,Air Force Falcons,D. MacMillan,4704414,,False,18.0,3,6,1,4,2,2,0,0,0,2,2,1,0,0,0,1,8
401262731,Air Force Falcons,N. McDonald,4595618,,False,13.0,2,3,1,1,1,2,0,0,0,1,1,2,1,0,0,1,5
401262731,Air Force Falcons,K. Pilson,4704411,,False,15.0,1,2,1,2,0,0,0,0,1,4,5,0,0,0,0,1,2
401262731,Air Force Falcons,K. Heath,4595614,,False,10.0,2,3,2,3,0,0,0,0,0,1,1,0,0,0,0,1,4
401262731,Air Force Falcons,A. Gadison,4399405,,False,2.0,0,1,0,0,0,1,0,0,0,0,0,0,0,0,0,0,0
401262731,Air Force Falcons,TEAM,TOTAL,TOTAL,False,,28,59,18,36,10,23,9,10,8,27,35,20,7,2,13,13,75
401262731,Air Force Falcons,R. Snyder,4399409,,True,29.0,7,14,2,6,5,8,2,2,0,4,4,4,1,0,3,4,21
401262731,Air Force Falcons,K. Huffman,4068225,,True,27.0,1,1,1,1,0,0,0,0,0,4,4,1,0,2,3,3,2
401262731,Air Force Falcons,B. Autrey-Thompson,4399404,,True,33.0,4,10,4,8,0,2,3,4,2,1,3,5,1,0,3,1,11
401262731,Air Force Falcons,K. Immel,4281743,,True,31.0,5,13,3,6,2,7,2,2,1,2,3,3,1,0,2,1,14
401262731,Air Force Falcons,E. Conroe,4281737,,True,22.0,3,6,3,5,0,1,2,2,2,4,6,4,3,0,0,0,8
401262731,Air Force Falcons,D. MacMillan,4704414,,False,18.0,3,6,1,4,2,2,0,0,0,2,2,1,0,0,0,1,8
401262731,Air Force Falcons,N. McDonald,4595618,,False,13.0,2,3,1,1,1,2,0,0,0,1,1,2,1,0,0,1,5
401262731,Air Force Falcons,K. Pilson,4704411,,False,15.0,1,2,1,2,0,0,0,0,1,4,5,0,0,0,0,1,2
401262731,Air Force Falcons,K. Heath,4595614,,False,10.0,2,3,2,3,0,0,0,0,0,1,1,0,0,0,0,1,4
401262731,Air Force Falcons,A. Gadison,4399405,,False,2.0,0,1,0,0,0,1,0,0,0,0,0,0,0,0,0,0,0
401262731,Air Force Falcons,TEAM,TOTAL,TOTAL,False,,28,59,18,36,10,23,9,10,8,27,35,20,7,2,13,13,75
401262730,New Mexico Lobos,S. McGruder,4400149,,True,31.0,2,4,2,3,0,1,0,0,0,3,3,2,2,1,2,1,4
401262730,New Mexico Lobos,A. Anderson,4281834,,True,24.0,6,8,6,6,0,2,2,2,1,9,10,0,1,0,3,3,14
401262730,New Mexico Lobos,Lato. Duff,4704520,,True,28.0,1,4,1,3,0,1,0,0,0,2,2,4,1,0,4,2,2
401262730,New Mexico Lobos,Lata. Duff,4704519,,True,38.0,11,20,5,8,6,12,3,5,1,2,3,1,5,0,1,1,31
401262730,New Mexico Lobos,J. De La Cerda,4281833,,True,34.0,5,13,3,6,2,7,4,4,0,3,3,2,0,0,0,0,16
401262730,New Mexico Lobos,C. Dupont,4595646,,False,1.0,0,0,0,0,0,0,0,0,0,0,0,0,0,0,0,0,0
401262730,New Mexico Lobos,A. Watts,4433688,,False,14.0,0,1,0,1,0,0,0,0,1,0,1,0,1,0,2,5,0
401262730,New Mexico Lobos,A. Robinson,4432993,,False,3.0,0,0,0,0,0,0,0,0,0,0,0,0,0,0,0,0,0
401262730,New Mexico Lobos,N. Parkinson,4704523,,False,1.0,0,1,0,0,0,1,0,0,0,0,0,0,0,0,0,0,0
401262730,New Mexico Lobos,K. van Bennekom,4704522,,False,7.0,0,1,0,1,0,0,1,2,2,2,4,1,0,0,1,0,1
401262730,New Mexico Lobos,C. Carter,4433646,,False,19.0,5,8,3,5,2,3,0,0,0,2,2,2,1,0,1,2,12
401262730,New Mexico Lobos,TEAM,TOTAL,TOTAL,False,,30,60,20,33,10,27,10,13,7,26,33,12,11,1,14,14,80
401262730,New Mexico Lobos,S. McGruder,4400149,,True,31.0,2,4,2,3,0,1,0,0,0,3,3,2,2,1,2,1,4
401262730,New Mexico Lobos,A. Anderson,4281834,,True,24.0,6,8,6,6,0,2,2,2,1,9,10,0,1,0,3,3,14
401262730,New Mexico Lobos,Lato. Duff,4704520,,True,28.0,1,4,1,3,0,1,0,0,0,2,2,4,1,0,4,2,2
401262730,New Mexico Lobos,Lata. Duff,4704519,,True,38.0,11,20,5,8,6,12,3,5,1,2,3,1,5,0,1,1,31
401262730,New Mexico Lobos,J. De La Cerda,4281833,,True,34.0,5,13,3,6,2,7,4,4,0,3,3,2,0,0,0,0,16
401262730,New Mexico Lobos,C. Dupont,4595646,,False,1.0,0,0,0,0,0,0,0,0,0,0,0,0,0,0,0,0,0
401262730,New Mexico Lobos,A. Watts,4433688,,False,14.0,0,1,0,1,0,0,0,0,1,0,1,0,1,0,2,5,0
401262730,New Mexico Lobos,A. Robinson,4432993,,False,3.0,0,0,0,0,0,0,0,0,0,0,0,0,0,0,0,0,0
401262730,New Mexico Lobos,N. Parkinson,4704523,,False,1.0,0,1,0,0,0,1,0,0,0,0,0,0,0,0,0,0,0
401262730,New Mexico Lobos,K. van Bennekom,4704522,,False,7.0,0,1,0,1,0,0,1,2,2,2,4,1,0,0,1,0,1
401262730,New Mexico Lobos,C. Carter,4433646,,False,19.0,5,8,3,5,2,3,0,0,0,2,2,2,1,0,1,2,12
401262730,New Mexico Lobos,TEAM,TOTAL,TOTAL,False,,30,60,20,33,10,27,10,13,7,26,33,12,11,1,14,14,80
401262730,Air Force Falcons,R. Snyder,4399409,,True,32.0,8,20,4,12,4,8,0,0,1,3,4,1,0,0,3,0,20
401262730,Air Force Falcons,K. Huffman,4068225,,True,19.0,1,4,1,4,0,0,0,0,2,5,7,1,0,1,0,3,2
401262730,Air Force Falcons,B. Autrey-Thompson,4399404,,True,27.0,3,6,3,5,0,1,2,2,0,1,1,5,2,0,6,2,8
401262730,Air Force Falcons,K. Immel,4281743,,True,33.0,13,23,12,20,1,3,1,2,1,2,3,3,0,0,2,1,28
401262730,Air Force Falcons,E. Conroe,4281737,,True,28.0,1,3,1,3,0,0,0,0,2,5,7,3,1,0,2,2,2
401262730,Air Force Falcons,K. Jones,4704416,,False,1.0,0,0,0,0,0,0,0,0,0,0,0,0,0,0,0,0,0
401262730,Air Force Falcons,N. McDonald,4595618,,False,19.0,1,1,1,1,0,0,0,0,0,1,1,0,0,0,1,1,2
401262730,Air Force Falcons,K. Pilson,4704411,,False,19.0,1,5,1,3,0,2,0,0,2,3,5,1,1,0,3,0,2
401262730,Air Force Falcons,C. Winters,4399406,,False,14.0,1,2,1,2,0,0,0,0,1,1,2,2,0,1,0,2,2
401262730,Air Force Falcons,A. Gadison,4399405,,False,8.0,0,2,0,0,0,2,0,0,0,2,2,0,0,0,0,0,0
401262730,Air Force Falcons,TEAM,TOTAL,TOTAL,False,,29,66,24,50,5,16,3,4,11,23,34,16,4,2,17,11,66
401262730,Air Force Falcons,R. Snyder,4399409,,True,32.0,8,20,4,12,4,8,0,0,1,3,4,1,0,0,3,0,20
401262730,Air Force Falcons,K. Huffman,4068225,,True,19.0,1,4,1,4,0,0,0,0,2,5,7,1,0,1,0,3,2
401262730,Air Force Falcons,B. Autrey-Thompson,4399404,,True,27.0,3,6,3,5,0,1,2,2,0,1,1,5,2,0,6,2,8
401262730,Air Force Falcons,K. Immel,4281743,,True,33.0,13,23,12,20,1,3,1,2,1,2,3,3,0,0,2,1,28
401262730,Air Force Falcons,E. Conroe,4281737,,True,28.0,1,3,1,3,0,0,0,0,2,5,7,3,1,0,2,2,2
401262730,Air Force Falcons,K. Jones,4704416,,False,1.0,0,0,0,0,0,0,0,0,0,0,0,0,0,0,0,0,0
401262730,Air Force Falcons,N. McDonald,4595618,,False,19.0,1,1,1,1,0,0,0,0,0,1,1,0,0,0,1,1,2
401262730,Air Force Falcons,K. Pilson,4704411,,False,19.0,1,5,1,3,0,2,0,0,2,3,5,1,1,0,3,0,2
401262730,Air Force Falcons,C. Winters,4399406,,False,14.0,1,2,1,2,0,0,0,0,1,1,2,2,0,1,0,2,2
401262730,Air Force Falcons,A. Gadison,4399405,,False,8.0,0,2,0,0,0,2,0,0,0,2,2,0,0,0,0,0,0
401262730,Air Force Falcons,TEAM,TOTAL,TOTAL,False,,29,66,24,50,5,16,3,4,11,23,34,16,4,2,17,11,66
401262729,Fresno State Bulldogs,W. Motta,4595631,,True,13.0,2,3,2,3,0,0,2,2,0,2,2,0,0,0,0,2,6
401262729,Fresno State Bulldogs,M. Utti,4281828,,True,33.0,3,6,2,5,1,1,0,0,2,7,9,4,4,0,3,1,7
401262729,Fresno State Bulldogs,Hal. Cavinder,4433658,,True,33.0,6,16,5,11,1,5,2,4,2,4,6,4,0,0,1,0,15
401262729,Fresno State Bulldogs,Han. Cavinder,4433372,,True,34.0,10,18,9,14,1,4,3,3,0,2,2,3,2,0,0,1,24
401262729,Fresno State Bulldogs,A. Gamez,4281826,,True,29.0,5,7,1,2,4,5,0,0,1,1,2,3,3,1,2,2,14
401262729,Fresno State Bulldogs,K. Kinzer,4595630,,False,10.0,0,1,0,0,0,1,0,0,0,1,1,1,0,0,0,1,0
401262729,Fresno State Bulldogs,M. Guimaraes,4704476,,False,7.0,2,4,2,4,0,0,0,0,0,2,2,0,0,0,0,1,4
401262729,Fresno State Bulldogs,B. Walling,4595632,,False,16.0,1,1,1,1,0,0,2,4,2,0,2,0,0,2,1,0,4
401262729,Fresno State Bulldogs,Y. Todorova,4704475,,False,3.0,0,0,0,0,0,0,0,0,0,1,1,0,0,0,0,0,0
401262729,Fresno State Bulldogs,K. Brown,4704473,,False,6.0,0,1,0,1,0,0,0,0,0,0,0,0,0,0,0,1,0
401262729,Fresno State Bulldogs,B. Delaney,4281825,,False,16.0,1,4,1,2,0,2,0,1,1,2,3,1,0,1,1,1,2
401262729,Fresno State Bulldogs,TEAM,TOTAL,TOTAL,False,,30,61,23,43,7,18,9,14,9,22,31,16,9,4,9,10,76
401262729,Fresno State Bulldogs,W. Motta,4595631,,True,13.0,2,3,2,3,0,0,2,2,0,2,2,0,0,0,0,2,6
401262729,Fresno State Bulldogs,M. Utti,4281828,,True,33.0,3,6,2,5,1,1,0,0,2,7,9,4,4,0,3,1,7
401262729,Fresno State Bulldogs,Hal. Cavinder,4433658,,True,33.0,6,16,5,11,1,5,2,4,2,4,6,4,0,0,1,0,15
401262729,Fresno State Bulldogs,Han. Cavinder,4433372,,True,34.0,10,18,9,14,1,4,3,3,0,2,2,3,2,0,0,1,24
401262729,Fresno State Bulldogs,A. Gamez,4281826,,True,29.0,5,7,1,2,4,5,0,0,1,1,2,3,3,1,2,2,14
401262729,Fresno State Bulldogs,K. Kinzer,4595630,,False,10.0,0,1,0,0,0,1,0,0,0,1,1,1,0,0,0,1,0
401262729,Fresno State Bulldogs,M. Guimaraes,4704476,,False,7.0,2,4,2,4,0,0,0,0,0,2,2,0,0,0,0,1,4
401262729,Fresno State Bulldogs,B. Walling,4595632,,False,16.0,1,1,1,1,0,0,2,4,2,0,2,0,0,2,1,0,4
401262729,Fresno State Bulldogs,Y. Todorova,4704475,,False,3.0,0,0,0,0,0,0,0,0,0,1,1,0,0,0,0,0,0
401262729,Fresno State Bulldogs,K. Brown,4704473,,False,6.0,0,1,0,1,0,0,0,0,0,0,0,0,0,0,0,1,0
401262729,Fresno State Bulldogs,B. Delaney,4281825,,False,16.0,1,4,1,2,0,2,0,1,1,2,3,1,0,1,1,1,2
401262729,Fresno State Bulldogs,TEAM,TOTAL,TOTAL,False,,30,61,23,43,7,18,9,14,9,22,31,16,9,4,9,10,76
401262729,Air Force Falcons,R. Snyder,4399409,,True,33.0,4,13,1,7,3,6,2,2,0,4,4,1,0,0,2,1,13
401262729,Air Force Falcons,K. Huffman,4068225,,True,18.0,1,2,1,2,0,0,0,0,1,4,5,0,0,2,4,2,2
401262729,Air Force Falcons,B. Autrey-Thompson,4399404,,True,29.0,7,12,7,10,0,2,2,4,1,2,3,0,0,0,4,3,16
401262729,Air Force Falcons,K. Immel,4281743,,True,31.0,3,14,2,11,1,3,2,2,1,3,4,5,0,2,1,1,9
401262729,Air Force Falcons,E. Conroe,4281737,,True,31.0,3,7,3,7,0,0,0,0,2,7,9,1,0,1,1,3,6
401262729,Air Force Falcons,D. MacMillan,4704414,,False,5.0,0,0,0,0,0,0,0,0,0,0,0,0,0,0,0,0,0
401262729,Air Force Falcons,N. McDonald,4595618,,False,26.0,1,2,1,1,0,1,0,0,2,3,5,0,1,0,1,1,2
401262729,Air Force Falcons,K. Heath,4595614,,False,10.0,3,4,3,4,0,0,0,0,1,0,1,0,0,0,1,2,6
401262729,Air Force Falcons,C. Winters,4399406,,False,10.0,2,3,2,3,0,0,0,2,1,1,2,0,1,0,0,2,4
401262729,Air Force Falcons,A. Gadison,4399405,,False,7.0,0,0,0,0,0,0,0,0,0,0,0,0,0,0,1,0,0
401262729,Air Force Falcons,TEAM,TOTAL,TOTAL,False,,24,57,20,45,4,12,6,10,11,24,35,7,2,5,17,15,58
401262729,Air Force Falcons,R. Snyder,4399409,,True,33.0,4,13,1,7,3,6,2,2,0,4,4,1,0,0,2,1,13
401262729,Air Force Falcons,K. Huffman,4068225,,True,18.0,1,2,1,2,0,0,0,0,1,4,5,0,0,2,4,2,2
401262729,Air Force Falcons,B. Autrey-Thompson,4399404,,True,29.0,7,12,7,10,0,2,2,4,1,2,3,0,0,0,4,3,16
401262729,Air Force Falcons,K. Immel,4281743,,True,31.0,3,14,2,11,1,3,2,2,1,3,4,5,0,2,1,1,9
401262729,Air Force Falcons,E. Conroe,4281737,,True,31.0,3,7,3,7,0,0,0,0,2,7,9,1,0,1,1,3,6
401262729,Air Force Falcons,D. MacMillan,4704414,,False,5.0,0,0,0,0,0,0,0,0,0,0,0,0,0,0,0,0,0
401262729,Air Force Falcons,N. McDonald,4595618,,False,26.0,1,2,1,1,0,1,0,0,2,3,5,0,1,0,1,1,2
401262729,Air Force Falcons,K. Heath,4595614,,False,10.0,3,4,3,4,0,0,0,0,1,0,1,0,0,0,1,2,6
401262729,Air Force Falcons,C. Winters,4399406,,False,10.0,2,3,2,3,0,0,0,2,1,1,2,0,1,0,0,2,4
401262729,Air Force Falcons,A. Gadison,4399405,,False,7.0,0,0,0,0,0,0,0,0,0,0,0,0,0,0,1,0,0
401262729,Air Force Falcons,TEAM,TOTAL,TOTAL,False,,24,57,20,45,4,12,6,10,11,24,35,7,2,5,17,15,58
401262728,Fresno State Bulldogs,W. Motta,4595631,,True,21.0,3,5,3,5,0,0,2,4,4,2,6,0,2,0,1,3,8
401262728,Fresno State Bulldogs,M. Utti,4281828,,True,36.0,2,4,1,3,1,1,0,2,1,3,4,1,3,1,1,1,5
401262728,Fresno State Bulldogs,Hal. Cavinder,4433658,,True,38.0,9,21,8,15,1,6,3,4,2,5,7,3,2,1,1,0,22
401262728,Fresno State Bulldogs,Han. Cavinder,4433372,,True,38.0,7,20,7,18,0,2,3,6,2,2,4,1,1,0,2,2,17
401262728,Fresno State Bulldogs,A. Gamez,4281826,,True,35.0,1,3,1,1,0,2,2,4,1,2,3,1,4,0,4,2,4
401262728,Fresno State Bulldogs,K. Kinzer,4595630,,False,7.0,1,2,0,1,1,1,0,0,0,0,0,0,0,0,1,0,3
401262728,Fresno State Bulldogs,B. Walling,4595632,,False,16.0,0,1,0,1,0,0,0,0,0,1,1,0,0,0,0,0,0
401262728,Fresno State Bulldogs,B. Delaney,4281825,,False,9.0,1,3,0,1,1,2,0,0,1,2,3,0,1,1,0,0,3
401262728,Fresno State Bulldogs,TEAM,TOTAL,TOTAL,False,,24,59,20,45,4,14,10,20,13,22,35,6,13,3,10,8,62
401262728,Fresno State Bulldogs,W. Motta,4595631,,True,21.0,3,5,3,5,0,0,2,4,4,2,6,0,2,0,1,3,8
401262728,Fresno State Bulldogs,M. Utti,4281828,,True,36.0,2,4,1,3,1,1,0,2,1,3,4,1,3,1,1,1,5
401262728,Fresno State Bulldogs,Hal. Cavinder,4433658,,True,38.0,9,21,8,15,1,6,3,4,2,5,7,3,2,1,1,0,22
401262728,Fresno State Bulldogs,Han. Cavinder,4433372,,True,38.0,7,20,7,18,0,2,3,6,2,2,4,1,1,0,2,2,17
401262728,Fresno State Bulldogs,A. Gamez,4281826,,True,35.0,1,3,1,1,0,2,2,4,1,2,3,1,4,0,4,2,4
401262728,Fresno State Bulldogs,K. Kinzer,4595630,,False,7.0,1,2,0,1,1,1,0,0,0,0,0,0,0,0,1,0,3
401262728,Fresno State Bulldogs,B. Walling,4595632,,False,16.0,0,1,0,1,0,0,0,0,0,1,1,0,0,0,0,0,0
401262728,Fresno State Bulldogs,B. Delaney,4281825,,False,9.0,1,3,0,1,1,2,0,0,1,2,3,0,1,1,0,0,3
401262728,Fresno State Bulldogs,TEAM,TOTAL,TOTAL,False,,24,59,20,45,4,14,10,20,13,22,35,6,13,3,10,8,62
401262728,Air Force Falcons,R. Snyder,4399409,,True,33.0,2,12,1,5,1,7,0,0,2,2,4,2,1,1,5,2,5
401262728,Air Force Falcons,K. Huffman,4068225,,True,32.0,1,1,1,1,0,0,3,4,1,8,9,1,0,0,3,3,5
401262728,Air Force Falcons,B. Autrey-Thompson,4399404,,True,25.0,11,16,10,13,1,3,1,1,0,3,3,3,2,0,4,4,24
401262728,Air Force Falcons,K. Immel,4281743,,True,31.0,3,7,0,1,3,6,1,2,0,0,0,1,0,0,3,3,10
401262728,Air Force Falcons,E. Conroe,4281737,,True,34.0,1,5,1,5,0,0,0,0,2,9,11,0,1,0,2,1,2
401262728,Air Force Falcons,N. McDonald,4595618,,False,9.0,0,2,0,2,0,0,0,0,1,0,1,0,0,0,0,2,0
401262728,Air Force Falcons,K. Heath,4595614,,False,4.0,0,2,0,2,0,0,0,0,0,0,0,0,0,0,0,0,0
401262728,Air Force Falcons,C. Winters,4399406,,False,19.0,1,4,1,4,0,0,0,0,0,1,1,0,0,0,1,1,2
401262728,Air Force Falcons,A. Gadison,4399405,,False,13.0,2,4,0,0,2,4,0,0,1,2,3,0,0,0,0,2,6
401262728,Air Force Falcons,TEAM,TOTAL,TOTAL,False,,21,53,14,33,7,20,5,7,10,26,36,7,4,1,22,18,54
401262728,Air Force Falcons,R. Snyder,4399409,,True,33.0,2,12,1,5,1,7,0,0,2,2,4,2,1,1,5,2,5
401262728,Air Force Falcons,K. Huffman,4068225,,True,32.0,1,1,1,1,0,0,3,4,1,8,9,1,0,0,3,3,5
401262728,Air Force Falcons,B. Autrey-Thompson,4399404,,True,25.0,11,16,10,13,1,3,1,1,0,3,3,3,2,0,4,4,24
401262728,Air Force Falcons,K. Immel,4281743,,True,31.0,3,7,0,1,3,6,1,2,0,0,0,1,0,0,3,3,10
401262728,Air Force Falcons,E. Conroe,4281737,,True,34.0,1,5,1,5,0,0,0,0,2,9,11,0,1,0,2,1,2
401262728,Air Force Falcons,N. McDonald,4595618,,False,9.0,0,2,0,2,0,0,0,0,1,0,1,0,0,0,0,2,0
401262728,Air Force Falcons,K. Heath,4595614,,False,4.0,0,2,0,2,0,0,0,0,0,0,0,0,0,0,0,0,0
401262728,Air Force Falcons,C. Winters,4399406,,False,19.0,1,4,1,4,0,0,0,0,0,1,1,0,0,0,1,1,2
401262728,Air Force Falcons,A. Gadison,4399405,,False,13.0,2,4,0,0,2,4,0,0,1,2,3,0,0,0,0,2,6
401262728,Air Force Falcons,TEAM,TOTAL,TOTAL,False,,21,53,14,33,7,20,5,7,10,26,36,7,4,1,22,18,54
401262727,UNLV Lady Rebels,D. Byrne,4398924,,True,37.0,4,12,3,8,1,4,4,4,1,9,10,1,0,4,4,2,13
401262727,UNLV Lady Rebels,D. Young,4704625,,True,19.0,3,6,3,6,0,0,2,3,1,2,3,0,0,2,2,4,8
401262727,UNLV Lady Rebels,J. Thomas,4704624,,True,38.0,2,6,1,1,1,5,2,2,1,5,6,2,0,0,2,1,7
401262727,UNLV Lady Rebels,N. Johnson,4400108,,True,28.0,7,10,6,9,1,1,2,3,0,4,4,1,2,0,2,1,17
401262727,UNLV Lady Rebels,B. Thomas,4068210,,True,37.0,4,8,4,7,0,1,1,2,0,4,4,4,2,0,6,2,9
401262727,UNLV Lady Rebels,A. Blount,4595640,,False,17.0,5,7,5,7,0,0,2,2,0,1,1,1,1,0,2,2,12
401262727,UNLV Lady Rebels,K. Wilfred,4595641,,False,7.0,1,1,1,1,0,0,0,0,1,2,3,0,0,0,0,0,2
401262727,UNLV Lady Rebels,J. Singleton,4704623,,False,7.0,0,0,0,0,0,0,0,0,0,3,3,1,0,0,2,0,0
401262727,UNLV Lady Rebels,J. Buckley,4595639,,False,10.0,0,2,0,1,0,1,0,0,1,1,2,0,0,0,0,1,0
401262727,UNLV Lady Rebels,TEAM,TOTAL,TOTAL,False,,26,52,23,40,3,12,13,16,9,32,41,10,5,6,20,13,68
401262727,UNLV Lady Rebels,D. Byrne,4398924,,True,37.0,4,12,3,8,1,4,4,4,1,9,10,1,0,4,4,2,13
401262727,UNLV Lady Rebels,D. Young,4704625,,True,19.0,3,6,3,6,0,0,2,3,1,2,3,0,0,2,2,4,8
401262727,UNLV Lady Rebels,J. Thomas,4704624,,True,38.0,2,6,1,1,1,5,2,2,1,5,6,2,0,0,2,1,7
401262727,UNLV Lady Rebels,N. Johnson,4400108,,True,28.0,7,10,6,9,1,1,2,3,0,4,4,1,2,0,2,1,17
401262727,UNLV Lady Rebels,B. Thomas,4068210,,True,37.0,4,8,4,7,0,1,1,2,0,4,4,4,2,0,6,2,9
401262727,UNLV Lady Rebels,A. Blount,4595640,,False,17.0,5,7,5,7,0,0,2,2,0,1,1,1,1,0,2,2,12
401262727,UNLV Lady Rebels,K. Wilfred,4595641,,False,7.0,1,1,1,1,0,0,0,0,1,2,3,0,0,0,0,0,2
401262727,UNLV Lady Rebels,J. Singleton,4704623,,False,7.0,0,0,0,0,0,0,0,0,0,3,3,1,0,0,2,0,0
401262727,UNLV Lady Rebels,J. Buckley,4595639,,False,10.0,0,2,0,1,0,1,0,0,1,1,2,0,0,0,0,1,0
401262727,UNLV Lady Rebels,TEAM,TOTAL,TOTAL,False,,26,52,23,40,3,12,13,16,9,32,41,10,5,6,20,13,68
401262727,Air Force Falcons,R. Snyder,4399409,,True,21.0,4,10,3,6,1,4,0,0,1,0,1,0,0,0,2,4,9
401262727,Air Force Falcons,K. Huffman,4068225,,True,27.0,1,4,1,4,0,0,2,2,3,5,8,3,1,3,0,1,4
401262727,Air Force Falcons,C. Winters,4399406,,True,18.0,1,5,1,4,0,1,0,0,2,0,2,0,0,0,0,2,2
401262727,Air Force Falcons,B. Autrey-Thompson,4399404,,True,34.0,2,16,2,13,0,3,2,2,0,1,1,8,5,0,4,3,6
401262727,Air Force Falcons,E. Conroe,4281737,,True,33.0,4,9,3,7,1,2,3,4,6,3,9,4,3,2,1,4,12
401262727,Air Force Falcons,N. McDonald,4595618,,False,20.0,2,6,0,1,2,5,0,0,0,0,0,2,2,0,2,2,6
401262727,Air Force Falcons,K. Pilson,4704411,,False,6.0,1,3,1,2,0,1,0,0,0,2,2,0,0,0,0,0,2
401262727,Air Force Falcons,K. Heath,4595614,,False,3.0,0,0,0,0,0,0,0,0,0,1,1,0,1,0,0,0,0
401262727,Air Force Falcons,A. Gadison,4399405,,False,9.0,1,3,1,1,0,2,1,2,0,0,0,0,0,0,0,0,3
401262727,Air Force Falcons,K. Immel,4281743,,False,29.0,4,11,2,6,2,5,3,3,0,3,3,1,2,0,2,1,13
401262727,Air Force Falcons,TEAM,TOTAL,TOTAL,False,,20,67,14,44,6,23,11,13,15,18,33,18,14,5,12,17,57
401262727,Air Force Falcons,R. Snyder,4399409,,True,21.0,4,10,3,6,1,4,0,0,1,0,1,0,0,0,2,4,9
401262727,Air Force Falcons,K. Huffman,4068225,,True,27.0,1,4,1,4,0,0,2,2,3,5,8,3,1,3,0,1,4
401262727,Air Force Falcons,C. Winters,4399406,,True,18.0,1,5,1,4,0,1,0,0,2,0,2,0,0,0,0,2,2
401262727,Air Force Falcons,B. Autrey-Thompson,4399404,,True,34.0,2,16,2,13,0,3,2,2,0,1,1,8,5,0,4,3,6
401262727,Air Force Falcons,E. Conroe,4281737,,True,33.0,4,9,3,7,1,2,3,4,6,3,9,4,3,2,1,4,12
401262727,Air Force Falcons,N. McDonald,4595618,,False,20.0,2,6,0,1,2,5,0,0,0,0,0,2,2,0,2,2,6
401262727,Air Force Falcons,K. Pilson,4704411,,False,6.0,1,3,1,2,0,1,0,0,0,2,2,0,0,0,0,0,2
401262727,Air Force Falcons,K. Heath,4595614,,False,3.0,0,0,0,0,0,0,0,0,0,1,1,0,1,0,0,0,0
401262727,Air Force Falcons,A. Gadison,4399405,,False,9.0,1,3,1,1,0,2,1,2,0,0,0,0,0,0,0,0,3
401262727,Air Force Falcons,K. Immel,4281743,,False,29.0,4,11,2,6,2,5,3,3,0,3,3,1,2,0,2,1,13
401262727,Air Force Falcons,TEAM,TOTAL,TOTAL,False,,20,67,14,44,6,23,11,13,15,18,33,18,14,5,12,17,57
401262726,UNLV Lady Rebels,D. Byrne,4398924,,True,25.0,1,8,1,5,0,3,2,2,1,3,4,0,1,0,3,0,4
401262726,UNLV Lady Rebels,D. Young,4704625,,True,31.0,5,9,5,9,0,0,5,8,2,7,9,0,1,1,1,2,15
401262726,UNLV Lady Rebels,J. Thomas,4704624,,True,28.0,2,5,1,2,1,3,2,2,1,5,6,0,0,0,4,1,7
401262726,UNLV Lady Rebels,N. Johnson,4400108,,True,28.0,3,13,2,7,1,6,2,2,2,3,5,3,0,0,2,3,9
401262726,UNLV Lady Rebels,B. Thomas,4068210,,True,29.0,1,5,1,4,0,1,4,6,1,1,2,2,2,0,1,1,6
401262726,UNLV Lady Rebels,A. Blount,4595640,,False,16.0,2,2,2,2,0,0,1,2,0,2,2,0,0,0,0,3,5
401262726,UNLV Lady Rebels,K. Wilfred,4595641,,False,6.0,1,4,1,4,0,0,0,0,0,2,2,0,0,1,0,0,2
401262726,UNLV Lady Rebels,J. Singleton,4704623,,False,17.0,0,5,0,5,0,0,0,2,0,2,2,1,0,0,3,2,0
401262726,UNLV Lady Rebels,J. Buckley,4595639,,False,20.0,2,3,2,3,0,0,0,1,1,7,8,0,0,0,0,1,4
401262726,UNLV Lady Rebels,TEAM,TOTAL,TOTAL,False,,17,54,15,41,2,13,16,25,13,34,47,6,4,2,14,13,52
401262726,UNLV Lady Rebels,D. Byrne,4398924,,True,25.0,1,8,1,5,0,3,2,2,1,3,4,0,1,0,3,0,4
401262726,UNLV Lady Rebels,D. Young,4704625,,True,31.0,5,9,5,9,0,0,5,8,2,7,9,0,1,1,1,2,15
401262726,UNLV Lady Rebels,J. Thomas,4704624,,True,28.0,2,5,1,2,1,3,2,2,1,5,6,0,0,0,4,1,7
401262726,UNLV Lady Rebels,N. Johnson,4400108,,True,28.0,3,13,2,7,1,6,2,2,2,3,5,3,0,0,2,3,9
401262726,UNLV Lady Rebels,B. Thomas,4068210,,True,29.0,1,5,1,4,0,1,4,6,1,1,2,2,2,0,1,1,6
401262726,UNLV Lady Rebels,A. Blount,4595640,,False,16.0,2,2,2,2,0,0,1,2,0,2,2,0,0,0,0,3,5
401262726,UNLV Lady Rebels,K. Wilfred,4595641,,False,6.0,1,4,1,4,0,0,0,0,0,2,2,0,0,1,0,0,2
401262726,UNLV Lady Rebels,J. Singleton,4704623,,False,17.0,0,5,0,5,0,0,0,2,0,2,2,1,0,0,3,2,0
401262726,UNLV Lady Rebels,J. Buckley,4595639,,False,20.0,2,3,2,3,0,0,0,1,1,7,8,0,0,0,0,1,4
401262726,UNLV Lady Rebels,TEAM,TOTAL,TOTAL,False,,17,54,15,41,2,13,16,25,13,34,47,6,4,2,14,13,52
401262726,Air Force Falcons,R. Snyder,4399409,,True,36.0,7,22,4,12,3,10,0,0,0,3,3,1,2,0,2,2,17
401262726,Air Force Falcons,K. Huffman,4068225,,True,33.0,2,3,2,3,0,0,0,0,3,4,7,2,4,7,1,5,4
401262726,Air Force Falcons,C. Winters,4399406,,True,26.0,6,8,6,7,0,1,3,5,0,2,2,2,1,0,1,5,15
401262726,Air Force Falcons,K. Immel,4281743,,True,31.0,2,12,2,8,0,4,0,0,1,3,4,4,1,0,1,2,4
401262726,Air Force Falcons,E. Conroe,4281737,,True,29.0,1,9,1,5,0,4,0,0,3,6,9,1,1,5,3,3,2
401262726,Air Force Falcons,N. McDonald,4595618,,False,18.0,1,4,0,3,1,1,0,0,2,4,6,1,0,0,0,4,3
401262726,Air Force Falcons,K. Pilson,4704411,,False,9.0,1,4,1,4,0,0,0,0,2,1,3,0,0,0,0,0,2
401262726,Air Force Falcons,A. Gadison,4399405,,False,18.0,1,6,1,2,0,4,0,0,2,2,4,0,1,0,0,2,2
401262726,Air Force Falcons,TEAM,TOTAL,TOTAL,False,,21,68,17,44,4,24,3,5,14,31,45,11,10,12,11,23,49
401262726,Air Force Falcons,R. Snyder,4399409,,True,36.0,7,22,4,12,3,10,0,0,0,3,3,1,2,0,2,2,17
401262726,Air Force Falcons,K. Huffman,4068225,,True,33.0,2,3,2,3,0,0,0,0,3,4,7,2,4,7,1,5,4
401262726,Air Force Falcons,C. Winters,4399406,,True,26.0,6,8,6,7,0,1,3,5,0,2,2,2,1,0,1,5,15
401262726,Air Force Falcons,K. Immel,4281743,,True,31.0,2,12,2,8,0,4,0,0,1,3,4,4,1,0,1,2,4
401262726,Air Force Falcons,E. Conroe,4281737,,True,29.0,1,9,1,5,0,4,0,0,3,6,9,1,1,5,3,3,2
401262726,Air Force Falcons,N. McDonald,4595618,,False,18.0,1,4,0,3,1,1,0,0,2,4,6,1,0,0,0,4,3
401262726,Air Force Falcons,K. Pilson,4704411,,False,9.0,1,4,1,4,0,0,0,0,2,1,3,0,0,0,0,0,2
401262726,Air Force Falcons,A. Gadison,4399405,,False,18.0,1,6,1,2,0,4,0,0,2,2,4,0,1,0,0,2,2
401262726,Air Force Falcons,TEAM,TOTAL,TOTAL,False,,21,68,17,44,4,24,3,5,14,31,45,11,10,12,11,23,49
401262723,San Diego State Aztecs,K. Gipson,4704563,,True,24.0,2,4,2,4,0,0,2,2,2,4,6,0,0,0,4,3,6
401262723,San Diego State Aztecs,K. Villalobos,4704565,,True,27.0,1,11,1,11,0,0,3,4,5,5,10,0,1,2,4,1,5
401262723,San Diego State Aztecs,I. Hernandez,4595647,,True,36.0,3,9,0,4,3,5,0,0,0,1,1,0,0,0,0,2,9
401262723,San Diego State Aztecs,M. Staples,4398925,,True,33.0,6,10,4,6,2,4,2,3,0,7,7,1,1,0,1,4,16
401262723,San Diego State Aztecs,T. Adams,4281876,,True,32.0,4,11,4,10,0,1,3,7,0,1,1,7,5,0,4,3,11
401262723,San Diego State Aztecs,F. Vinerte,4704564,,False,13.0,2,3,2,3,0,0,1,2,2,2,4,0,1,2,1,1,5
401262723,San Diego State Aztecs,K. Edwards,4281879,,False,3.0,0,0,0,0,0,0,0,0,0,1,1,0,0,0,0,0,0
401262723,San Diego State Aztecs,M. Adams,4400169,,False,13.0,1,5,0,4,1,1,0,0,1,1,2,0,0,0,3,2,3
401262723,San Diego State Aztecs,B. Chynoweth,4704562,,False,2.0,0,0,0,0,0,0,0,0,0,0,0,0,0,0,0,0,0
401262723,San Diego State Aztecs,A. Crain,4399223,,False,17.0,0,3,0,3,0,0,0,0,0,2,2,0,0,0,2,2,0
401262723,San Diego State Aztecs,TEAM,TOTAL,TOTAL,False,,19,56,13,45,6,11,11,18,14,26,40,8,8,4,19,18,55
401262723,San Diego State Aztecs,K. Gipson,4704563,,True,24.0,2,4,2,4,0,0,2,2,2,4,6,0,0,0,4,3,6
401262723,San Diego State Aztecs,K. Villalobos,4704565,,True,27.0,1,11,1,11,0,0,3,4,5,5,10,0,1,2,4,1,5
401262723,San Diego State Aztecs,I. Hernandez,4595647,,True,36.0,3,9,0,4,3,5,0,0,0,1,1,0,0,0,0,2,9
401262723,San Diego State Aztecs,M. Staples,4398925,,True,33.0,6,10,4,6,2,4,2,3,0,7,7,1,1,0,1,4,16
401262723,San Diego State Aztecs,T. Adams,4281876,,True,32.0,4,11,4,10,0,1,3,7,0,1,1,7,5,0,4,3,11
401262723,San Diego State Aztecs,F. Vinerte,4704564,,False,13.0,2,3,2,3,0,0,1,2,2,2,4,0,1,2,1,1,5
401262723,San Diego State Aztecs,K. Edwards,4281879,,False,3.0,0,0,0,0,0,0,0,0,0,1,1,0,0,0,0,0,0
401262723,San Diego State Aztecs,M. Adams,4400169,,False,13.0,1,5,0,4,1,1,0,0,1,1,2,0,0,0,3,2,3
401262723,San Diego State Aztecs,B. Chynoweth,4704562,,False,2.0,0,0,0,0,0,0,0,0,0,0,0,0,0,0,0,0,0
401262723,San Diego State Aztecs,A. Crain,4399223,,False,17.0,0,3,0,3,0,0,0,0,0,2,2,0,0,0,2,2,0
401262723,San Diego State Aztecs,TEAM,TOTAL,TOTAL,False,,19,56,13,45,6,11,11,18,14,26,40,8,8,4,19,18,55
401262723,Air Force Falcons,R. Snyder,4399409,,True,38.0,5,11,4,7,1,4,4,4,1,5,6,3,2,1,2,2,15
401262723,Air Force Falcons,K. Huffman,4068225,,True,26.0,1,4,1,4,0,0,0,0,3,6,9,0,0,4,0,3,2
401262723,Air Force Falcons,B. Autrey-Thompson,4399404,,True,33.0,6,15,6,12,0,3,6,7,0,5,5,5,0,0,5,2,18
401262723,Air Force Falcons,K. Immel,4281743,,True,21.0,2,7,2,4,0,3,0,0,1,0,1,1,2,0,3,0,4
401262723,Air Force Falcons,E. Conroe,4281737,,True,30.0,1,6,1,3,0,3,0,0,3,7,10,0,1,1,3,1,2
401262723,Air Force Falcons,N. McDonald,4595618,,False,24.0,2,7,0,4,2,3,0,0,1,2,3,1,1,0,0,1,6
401262723,Air Force Falcons,K. Heath,4595614,,False,2.0,0,1,0,1,0,0,0,0,0,0,0,0,0,0,0,0,0
401262723,Air Force Falcons,C. Winters,4399406,,False,11.0,0,0,0,0,0,0,2,2,0,0,0,1,2,0,1,3,2
401262723,Air Force Falcons,A. Gadison,4399405,,False,15.0,3,6,0,0,3,6,0,0,0,0,0,1,1,0,0,0,9
401262723,Air Force Falcons,TEAM,TOTAL,TOTAL,False,,20,57,14,35,6,22,12,13,11,26,37,12,9,6,17,12,58
401262723,Air Force Falcons,R. Snyder,4399409,,True,38.0,5,11,4,7,1,4,4,4,1,5,6,3,2,1,2,2,15
401262723,Air Force Falcons,K. Huffman,4068225,,True,26.0,1,4,1,4,0,0,0,0,3,6,9,0,0,4,0,3,2
401262723,Air Force Falcons,B. Autrey-Thompson,4399404,,True,33.0,6,15,6,12,0,3,6,7,0,5,5,5,0,0,5,2,18
401262723,Air Force Falcons,K. Immel,4281743,,True,21.0,2,7,2,4,0,3,0,0,1,0,1,1,2,0,3,0,4
401262723,Air Force Falcons,E. Conroe,4281737,,True,30.0,1,6,1,3,0,3,0,0,3,7,10,0,1,1,3,1,2
401262723,Air Force Falcons,N. McDonald,4595618,,False,24.0,2,7,0,4,2,3,0,0,1,2,3,1,1,0,0,1,6
401262723,Air Force Falcons,K. Heath,4595614,,False,2.0,0,1,0,1,0,0,0,0,0,0,0,0,0,0,0,0,0
401262723,Air Force Falcons,C. Winters,4399406,,False,11.0,0,0,0,0,0,0,2,2,0,0,0,1,2,0,1,3,2
401262723,Air Force Falcons,A. Gadison,4399405,,False,15.0,3,6,0,0,3,6,0,0,0,0,0,1,1,0,0,0,9
401262723,Air Force Falcons,TEAM,TOTAL,TOTAL,False,,20,57,14,35,6,22,12,13,11,26,37,12,9,6,17,12,58
401262722,San Diego State Aztecs,K. Gipson,4704563,,True,30.0,4,6,4,6,0,0,2,4,2,3,5,1,2,1,0,2,10
401262722,San Diego State Aztecs,K. Villalobos,4704565,,True,23.0,2,4,2,4,0,0,2,2,1,2,3,2,0,0,6,3,6
401262722,San Diego State Aztecs,I. Hernandez,4595647,,True,27.0,2,5,1,2,1,3,0,0,0,2,2,1,1,0,1,1,5
401262722,San Diego State Aztecs,M. Staples,4398925,,True,38.0,10,16,6,9,4,7,0,0,0,6,6,6,1,1,1,1,24
401262722,San Diego State Aztecs,T. Adams,4281876,,True,30.0,3,9,3,8,0,1,1,3,0,4,4,5,2,1,4,2,7
401262722,San Diego State Aztecs,F. Vinerte,4704564,,False,3.0,0,1,0,1,0,0,0,0,0,0,0,0,0,0,0,0,0
401262722,San Diego State Aztecs,K. Edwards,4281879,,False,7.0,0,1,0,1,0,0,0,0,0,1,1,0,0,0,0,0,0
401262722,San Diego State Aztecs,M. Adams,4400169,,False,15.0,0,3,0,3,0,0,0,0,1,2,3,0,0,0,3,0,0
401262722,San Diego State Aztecs,A. Crain,4399223,,False,27.0,2,6,0,2,2,4,1,2,0,3,3,2,0,0,1,1,7
401262722,San Diego State Aztecs,TEAM,TOTAL,TOTAL,False,,23,51,16,36,7,15,6,11,4,29,33,17,6,3,17,10,59
401262722,San Diego State Aztecs,K. Gipson,4704563,,True,30.0,4,6,4,6,0,0,2,4,2,3,5,1,2,1,0,2,10
401262722,San Diego State Aztecs,K. Villalobos,4704565,,True,23.0,2,4,2,4,0,0,2,2,1,2,3,2,0,0,6,3,6
401262722,San Diego State Aztecs,I. Hernandez,4595647,,True,27.0,2,5,1,2,1,3,0,0,0,2,2,1,1,0,1,1,5
401262722,San Diego State Aztecs,M. Staples,4398925,,True,38.0,10,16,6,9,4,7,0,0,0,6,6,6,1,1,1,1,24
401262722,San Diego State Aztecs,T. Adams,4281876,,True,30.0,3,9,3,8,0,1,1,3,0,4,4,5,2,1,4,2,7
401262722,San Diego State Aztecs,F. Vinerte,4704564,,False,3.0,0,1,0,1,0,0,0,0,0,0,0,0,0,0,0,0,0
401262722,San Diego State Aztecs,K. Edwards,4281879,,False,7.0,0,1,0,1,0,0,0,0,0,1,1,0,0,0,0,0,0
401262722,San Diego State Aztecs,M. Adams,4400169,,False,15.0,0,3,0,3,0,0,0,0,1,2,3,0,0,0,3,0,0
401262722,San Diego State Aztecs,A. Crain,4399223,,False,27.0,2,6,0,2,2,4,1,2,0,3,3,2,0,0,1,1,7
401262722,San Diego State Aztecs,TEAM,TOTAL,TOTAL,False,,23,51,16,36,7,15,6,11,4,29,33,17,6,3,17,10,59
401262722,Air Force Falcons,N. McDonald,4595618,,True,32.0,1,6,1,3,0,3,1,2,5,1,6,5,1,0,0,0,3
401262722,Air Force Falcons,R. Snyder,4399409,,True,35.0,3,13,2,3,1,10,2,2,0,4,4,0,0,1,3,2,9
401262722,Air Force Falcons,K. Huffman,4068225,,True,17.0,0,4,0,4,0,0,0,0,5,3,8,0,0,3,1,1,0
401262722,Air Force Falcons,B. Autrey-Thompson,4399404,,True,27.0,3,13,3,10,0,3,0,1,0,2,2,4,0,0,6,2,6
401262722,Air Force Falcons,K. Immel,4281743,,True,30.0,6,13,3,5,3,8,0,0,0,4,4,2,3,0,3,3,15
401262722,Air Force Falcons,K. Heath,4595614,,False,5.0,1,1,1,1,0,0,0,0,0,0,0,0,0,0,1,1,2
401262722,Air Force Falcons,C. Winters,4399406,,False,16.0,1,4,1,3,0,1,0,0,0,1,1,2,0,0,0,2,2
401262722,Air Force Falcons,A. Gadison,4399405,,False,9.0,2,5,0,0,2,5,0,0,0,1,1,0,0,1,0,0,6
401262722,Air Force Falcons,E. Conroe,4281737,,False,29.0,3,4,0,0,3,4,2,2,2,6,8,4,3,0,1,3,11
401262722,Air Force Falcons,TEAM,TOTAL,TOTAL,False,,20,63,11,29,9,34,5,7,14,25,39,17,7,5,16,14,54
401262722,Air Force Falcons,N. McDonald,4595618,,True,32.0,1,6,1,3,0,3,1,2,5,1,6,5,1,0,0,0,3
401262722,Air Force Falcons,R. Snyder,4399409,,True,35.0,3,13,2,3,1,10,2,2,0,4,4,0,0,1,3,2,9
401262722,Air Force Falcons,K. Huffman,4068225,,True,17.0,0,4,0,4,0,0,0,0,5,3,8,0,0,3,1,1,0
401262722,Air Force Falcons,B. Autrey-Thompson,4399404,,True,27.0,3,13,3,10,0,3,0,1,0,2,2,4,0,0,6,2,6
401262722,Air Force Falcons,K. Immel,4281743,,True,30.0,6,13,3,5,3,8,0,0,0,4,4,2,3,0,3,3,15
401262722,Air Force Falcons,K. Heath,4595614,,False,5.0,1,1,1,1,0,0,0,0,0,0,0,0,0,0,1,1,2
401262722,Air Force Falcons,C. Winters,4399406,,False,16.0,1,4,1,3,0,1,0,0,0,1,1,2,0,0,0,2,2
401262722,Air Force Falcons,A. Gadison,4399405,,False,9.0,2,5,0,0,2,5,0,0,0,1,1,0,0,1,0,0,6
401262722,Air Force Falcons,E. Conroe,4281737,,False,29.0,3,4,0,0,3,4,2,2,2,6,8,4,3,0,1,3,11
401262722,Air Force Falcons,TEAM,TOTAL,TOTAL,False,,20,63,11,29,9,34,5,7,14,25,39,17,7,5,16,14,54
401262721,Wyoming Cowgirls,D. Davidsdottir,4068870,,True,29.0,8,12,8,11,0,1,0,0,1,11,12,0,0,2,0,3,16
401262721,Wyoming Cowgirls,J. Johnson,4595683,,True,33.0,4,6,2,3,2,3,1,2,0,1,1,0,2,0,1,1,11
401262721,Wyoming Cowgirls,Q. Weidemann,4400207,,True,35.0,1,4,0,2,1,2,2,2,0,2,2,4,1,0,4,1,5
401262721,Wyoming Cowgirls,A. Sanchez Ramos,4400204,,True,32.0,4,9,3,6,1,3,1,2,0,3,3,3,1,0,0,0,10
401262721,Wyoming Cowgirls,T. Olson,4400203,,True,34.0,3,5,3,5,0,0,2,4,0,3,3,6,3,0,4,1,8
401262721,Wyoming Cowgirls,M. Savic,4704660,,False,3.0,0,0,0,0,0,0,0,0,0,1,1,0,0,0,1,0,0
401262721,Wyoming Cowgirls,P. Salazar,4704659,,False,7.0,1,5,1,5,0,0,0,0,1,1,2,0,0,2,1,0,2
401262721,Wyoming Cowgirls,G. Ellis,4704657,,False,1.0,0,0,0,0,0,0,0,0,0,0,0,0,0,0,0,0,0
401262721,Wyoming Cowgirls,L. Bull,4704655,,False,1.0,0,0,0,0,0,0,0,0,0,0,0,0,0,0,0,0,0
401262721,Wyoming Cowgirls,O. Ustowska,4704662,,False,11.0,1,3,0,1,1,2,0,0,0,2,2,0,1,0,2,1,3
401262721,Wyoming Cowgirls,L. Hudson,4704658,,False,1.0,0,0,0,0,0,0,0,0,0,0,0,1,1,0,2,0,0
401262721,Wyoming Cowgirls,M. Bradshaw,4595681,,False,13.0,1,4,1,3,0,1,2,2,0,2,2,1,1,0,1,1,4
401262721,Wyoming Cowgirls,TEAM,TOTAL,TOTAL,False,,23,48,18,36,5,12,8,12,6,29,35,15,10,4,16,8,59
401262721,Wyoming Cowgirls,D. Davidsdottir,4068870,,True,29.0,8,12,8,11,0,1,0,0,1,11,12,0,0,2,0,3,16
401262721,Wyoming Cowgirls,J. Johnson,4595683,,True,33.0,4,6,2,3,2,3,1,2,0,1,1,0,2,0,1,1,11
401262721,Wyoming Cowgirls,Q. Weidemann,4400207,,True,35.0,1,4,0,2,1,2,2,2,0,2,2,4,1,0,4,1,5
401262721,Wyoming Cowgirls,A. Sanchez Ramos,4400204,,True,32.0,4,9,3,6,1,3,1,2,0,3,3,3,1,0,0,0,10
401262721,Wyoming Cowgirls,T. Olson,4400203,,True,34.0,3,5,3,5,0,0,2,4,0,3,3,6,3,0,4,1,8
401262721,Wyoming Cowgirls,M. Savic,4704660,,False,3.0,0,0,0,0,0,0,0,0,0,1,1,0,0,0,1,0,0
401262721,Wyoming Cowgirls,P. Salazar,4704659,,False,7.0,1,5,1,5,0,0,0,0,1,1,2,0,0,2,1,0,2
401262721,Wyoming Cowgirls,G. Ellis,4704657,,False,1.0,0,0,0,0,0,0,0,0,0,0,0,0,0,0,0,0,0
401262721,Wyoming Cowgirls,L. Bull,4704655,,False,1.0,0,0,0,0,0,0,0,0,0,0,0,0,0,0,0,0,0
401262721,Wyoming Cowgirls,O. Ustowska,4704662,,False,11.0,1,3,0,1,1,2,0,0,0,2,2,0,1,0,2,1,3
401262721,Wyoming Cowgirls,L. Hudson,4704658,,False,1.0,0,0,0,0,0,0,0,0,0,0,0,1,1,0,2,0,0
401262721,Wyoming Cowgirls,M. Bradshaw,4595681,,False,13.0,1,4,1,3,0,1,2,2,0,2,2,1,1,0,1,1,4
401262721,Wyoming Cowgirls,TEAM,TOTAL,TOTAL,False,,23,48,18,36,5,12,8,12,6,29,35,15,10,4,16,8,59
401262721,Air Force Falcons,R. Snyder,4399409,,True,32.0,5,15,4,12,1,3,2,2,0,0,0,1,1,0,1,2,13
401262721,Air Force Falcons,K. Huffman,4068225,,True,24.0,0,2,0,2,0,0,1,4,3,3,6,0,0,3,1,1,1
401262721,Air Force Falcons,C. Winters,4399406,,True,26.0,0,4,0,3,0,1,0,0,2,2,4,0,2,0,0,2,0
401262721,Air Force Falcons,B. Autrey-Thompson,4399404,,True,24.0,0,9,0,6,0,3,2,2,4,1,5,4,3,0,4,5,2
401262721,Air Force Falcons,E. Conroe,4281737,,True,29.0,2,11,2,7,0,4,1,1,2,7,9,0,2,0,0,2,5
401262721,Air Force Falcons,N. McDonald,4595618,,False,23.0,3,5,0,1,3,4,0,0,1,2,3,1,1,0,0,2,9
401262721,Air Force Falcons,K. Pilson,4704411,,False,9.0,0,2,0,2,0,0,0,0,1,0,1,0,1,0,0,0,0
401262721,Air Force Falcons,A. Gadison,4399405,,False,12.0,2,5,0,1,2,4,2,2,0,1,1,1,1,0,3,0,8
401262721,Air Force Falcons,K. Immel,4281743,,False,21.0,3,5,1,2,2,3,0,0,0,2,2,1,2,1,7,0,8
401262721,Air Force Falcons,TEAM,TOTAL,TOTAL,False,,15,58,7,36,8,22,8,11,15,20,35,8,13,4,17,15,46
401262721,Air Force Falcons,R. Snyder,4399409,,True,32.0,5,15,4,12,1,3,2,2,0,0,0,1,1,0,1,2,13
401262721,Air Force Falcons,K. Huffman,4068225,,True,24.0,0,2,0,2,0,0,1,4,3,3,6,0,0,3,1,1,1
401262721,Air Force Falcons,C. Winters,4399406,,True,26.0,0,4,0,3,0,1,0,0,2,2,4,0,2,0,0,2,0
401262721,Air Force Falcons,B. Autrey-Thompson,4399404,,True,24.0,0,9,0,6,0,3,2,2,4,1,5,4,3,0,4,5,2
401262721,Air Force Falcons,E. Conroe,4281737,,True,29.0,2,11,2,7,0,4,1,1,2,7,9,0,2,0,0,2,5
401262721,Air Force Falcons,N. McDonald,4595618,,False,23.0,3,5,0,1,3,4,0,0,1,2,3,1,1,0,0,2,9
401262721,Air Force Falcons,K. Pilson,4704411,,False,9.0,0,2,0,2,0,0,0,0,1,0,1,0,1,0,0,0,0
401262721,Air Force Falcons,A. Gadison,4399405,,False,12.0,2,5,0,1,2,4,2,2,0,1,1,1,1,0,3,0,8
401262721,Air Force Falcons,K. Immel,4281743,,False,21.0,3,5,1,2,2,3,0,0,0,2,2,1,2,1,7,0,8
401262721,Air Force Falcons,TEAM,TOTAL,TOTAL,False,,15,58,7,36,8,22,8,11,15,20,35,8,13,4,17,15,46
401262720,Wyoming Cowgirls,D. Davidsdottir,4068870,,True,29.0,7,8,7,8,0,0,2,2,1,2,3,0,0,2,1,3,16
401262720,Wyoming Cowgirls,J. Johnson,4595683,,True,29.0,1,4,0,3,1,1,2,2,1,1,2,1,0,1,1,0,5
401262720,Wyoming Cowgirls,Q. Weidemann,4400207,,True,36.0,3,10,1,5,2,5,4,4,0,2,2,1,0,1,2,2,12
401262720,Wyoming Cowgirls,A. Sanchez Ramos,4400204,,True,32.0,3,9,3,5,0,4,0,1,1,6,7,1,0,0,2,0,6
401262720,Wyoming Cowgirls,T. Olson,4400203,,True,37.0,4,8,4,7,0,1,2,2,3,8,11,8,1,2,4,1,10
401262720,Wyoming Cowgirls,M. Savic,4704660,,False,4.0,1,2,1,2,0,0,0,0,1,0,1,0,0,0,0,0,2
401262720,Wyoming Cowgirls,G. Ellis,4704657,,False,7.0,0,2,0,2,0,0,0,0,0,0,0,0,0,0,0,0,0
401262720,Wyoming Cowgirls,O. Ustowska,4704662,,False,9.0,1,2,1,1,0,1,0,0,0,0,0,0,0,0,3,0,2
401262720,Wyoming Cowgirls,M. Bradshaw,4595681,,False,17.0,1,5,1,4,0,1,0,0,0,2,2,0,0,0,1,0,2
401262720,Wyoming Cowgirls,TEAM,TOTAL,TOTAL,False,,21,50,18,37,3,13,10,11,10,22,32,11,1,6,14,6,55
401262720,Wyoming Cowgirls,D. Davidsdottir,4068870,,True,29.0,7,8,7,8,0,0,2,2,1,2,3,0,0,2,1,3,16
401262720,Wyoming Cowgirls,J. Johnson,4595683,,True,29.0,1,4,0,3,1,1,2,2,1,1,2,1,0,1,1,0,5
401262720,Wyoming Cowgirls,Q. Weidemann,4400207,,True,36.0,3,10,1,5,2,5,4,4,0,2,2,1,0,1,2,2,12
401262720,Wyoming Cowgirls,A. Sanchez Ramos,4400204,,True,32.0,3,9,3,5,0,4,0,1,1,6,7,1,0,0,2,0,6
401262720,Wyoming Cowgirls,T. Olson,4400203,,True,37.0,4,8,4,7,0,1,2,2,3,8,11,8,1,2,4,1,10
401262720,Wyoming Cowgirls,M. Savic,4704660,,False,4.0,1,2,1,2,0,0,0,0,1,0,1,0,0,0,0,0,2
401262720,Wyoming Cowgirls,G. Ellis,4704657,,False,7.0,0,2,0,2,0,0,0,0,0,0,0,0,0,0,0,0,0
401262720,Wyoming Cowgirls,O. Ustowska,4704662,,False,9.0,1,2,1,1,0,1,0,0,0,0,0,0,0,0,3,0,2
401262720,Wyoming Cowgirls,M. Bradshaw,4595681,,False,17.0,1,5,1,4,0,1,0,0,0,2,2,0,0,0,1,0,2
401262720,Wyoming Cowgirls,TEAM,TOTAL,TOTAL,False,,21,50,18,37,3,13,10,11,10,22,32,11,1,6,14,6,55
401262720,Air Force Falcons,N. McDonald,4595618,,True,26.0,3,10,2,5,1,5,0,0,0,6,6,0,0,0,0,2,7
401262720,Air Force Falcons,R. Snyder,4399409,,True,32.0,3,7,3,7,0,0,0,0,2,1,3,1,1,0,3,1,6
401262720,Air Force Falcons,K. Huffman,4068225,,True,24.0,0,3,0,3,0,0,0,0,1,4,5,0,1,3,2,1,0
401262720,Air Force Falcons,C. Winters,4399406,,True,29.0,2,4,2,4,0,0,2,2,1,2,3,1,1,0,1,5,6
401262720,Air Force Falcons,B. Autrey-Thompson,4399404,,True,33.0,7,18,7,14,0,4,3,5,3,3,6,5,3,0,3,1,17
401262720,Air Force Falcons,K. Pilson,4704411,,False,2.0,0,0,0,0,0,0,0,0,0,0,0,0,0,0,2,0,0
401262720,Air Force Falcons,A. Gadison,4399405,,False,5.0,1,2,0,0,1,2,0,0,1,0,1,0,0,0,1,1,3
401262720,Air Force Falcons,K. Immel,4281743,,False,21.0,2,9,1,7,1,2,0,0,0,2,2,0,0,0,0,1,5
401262720,Air Force Falcons,E. Conroe,4281737,,False,28.0,2,4,1,2,1,2,0,0,3,2,5,0,1,0,1,2,5
401262720,Air Force Falcons,TEAM,TOTAL,TOTAL,False,,20,57,16,42,4,15,5,7,15,20,35,7,7,3,14,14,49
401262720,Air Force Falcons,N. McDonald,4595618,,True,26.0,3,10,2,5,1,5,0,0,0,6,6,0,0,0,0,2,7
401262720,Air Force Falcons,R. Snyder,4399409,,True,32.0,3,7,3,7,0,0,0,0,2,1,3,1,1,0,3,1,6
401262720,Air Force Falcons,K. Huffman,4068225,,True,24.0,0,3,0,3,0,0,0,0,1,4,5,0,1,3,2,1,0
401262720,Air Force Falcons,C. Winters,4399406,,True,29.0,2,4,2,4,0,0,2,2,1,2,3,1,1,0,1,5,6
401262720,Air Force Falcons,B. Autrey-Thompson,4399404,,True,33.0,7,18,7,14,0,4,3,5,3,3,6,5,3,0,3,1,17
401262720,Air Force Falcons,K. Pilson,4704411,,False,2.0,0,0,0,0,0,0,0,0,0,0,0,0,0,0,2,0,0
401262720,Air Force Falcons,A. Gadison,4399405,,False,5.0,1,2,0,0,1,2,0,0,1,0,1,0,0,0,1,1,3
401262720,Air Force Falcons,K. Immel,4281743,,False,21.0,2,9,1,7,1,2,0,0,0,2,2,0,0,0,0,1,5
401262720,Air Force Falcons,E. Conroe,4281737,,False,28.0,2,4,1,2,1,2,0,0,3,2,5,0,1,0,1,2,5
401262720,Air Force Falcons,TEAM,TOTAL,TOTAL,False,,20,57,16,42,4,15,5,7,15,20,35,7,7,3,14,14,49
401262719,Boise State Broncos,A. Mark,4606930,,True,26.0,5,7,5,7,0,0,0,0,4,3,7,3,1,1,0,3,10
401262719,Boise State Broncos,R. Bowers,4400536,,True,11.0,3,5,3,5,0,0,2,2,0,1,1,1,0,0,1,3,8
401262719,Boise State Broncos,M. McGwire,4066535,,True,16.0,3,6,2,3,1,3,0,0,1,2,3,2,2,2,2,3,7
401262719,Boise State Broncos,M. Naro,4705625,,True,33.0,6,9,6,8,0,1,2,4,2,1,3,6,1,0,4,2,14
401262719,Boise State Broncos,J. Loville,4400537,,True,32.0,9,18,9,16,0,2,0,0,0,2,2,1,1,1,1,0,18
401262719,Boise State Broncos,E. Lalotte,4705630,,False,8.0,0,1,0,1,0,0,0,0,0,1,1,0,0,0,0,0,0
401262719,Boise State Broncos,K. Sykes,4595619,,False,14.0,0,2,0,0,0,2,0,0,0,1,1,1,1,1,4,2,0
401262719,Boise State Broncos,A. Muse,4583056,,False,28.0,0,2,0,2,0,0,1,2,2,6,8,1,0,7,1,0,1
401262719,Boise State Broncos,R. Reed,4705629,,False,9.0,0,1,0,0,0,1,0,0,0,0,0,0,1,0,1,0,0
401262719,Boise State Broncos,M. Machalova,4705628,,False,2.0,0,0,0,0,0,0,0,0,0,0,0,0,0,0,0,0,0
401262719,Boise State Broncos,C. Gil,4705627,,False,4.0,1,1,1,1,0,0,0,0,0,0,0,0,0,0,1,2,2
401262719,Boise State Broncos,A. Ostlie,4705626,,False,17.0,4,9,2,2,2,7,1,2,1,2,3,3,2,0,0,1,11
401262719,Boise State Broncos,TEAM,TOTAL,TOTAL,False,,31,61,28,45,3,16,6,10,10,23,33,18,9,12,16,16,71
401262719,Boise State Broncos,A. Mark,4606930,,True,26.0,5,7,5,7,0,0,0,0,4,3,7,3,1,1,0,3,10
401262719,Boise State Broncos,R. Bowers,4400536,,True,11.0,3,5,3,5,0,0,2,2,0,1,1,1,0,0,1,3,8
401262719,Boise State Broncos,M. McGwire,4066535,,True,16.0,3,6,2,3,1,3,0,0,1,2,3,2,2,2,2,3,7
401262719,Boise State Broncos,M. Naro,4705625,,True,33.0,6,9,6,8,0,1,2,4,2,1,3,6,1,0,4,2,14
401262719,Boise State Broncos,J. Loville,4400537,,True,32.0,9,18,9,16,0,2,0,0,0,2,2,1,1,1,1,0,18
401262719,Boise State Broncos,E. Lalotte,4705630,,False,8.0,0,1,0,1,0,0,0,0,0,1,1,0,0,0,0,0,0
401262719,Boise State Broncos,K. Sykes,4595619,,False,14.0,0,2,0,0,0,2,0,0,0,1,1,1,1,1,4,2,0
401262719,Boise State Broncos,A. Muse,4583056,,False,28.0,0,2,0,2,0,0,1,2,2,6,8,1,0,7,1,0,1
401262719,Boise State Broncos,R. Reed,4705629,,False,9.0,0,1,0,0,0,1,0,0,0,0,0,0,1,0,1,0,0
401262719,Boise State Broncos,M. Machalova,4705628,,False,2.0,0,0,0,0,0,0,0,0,0,0,0,0,0,0,0,0,0
401262719,Boise State Broncos,C. Gil,4705627,,False,4.0,1,1,1,1,0,0,0,0,0,0,0,0,0,0,1,2,2
401262719,Boise State Broncos,A. Ostlie,4705626,,False,17.0,4,9,2,2,2,7,1,2,1,2,3,3,2,0,0,1,11
401262719,Boise State Broncos,TEAM,TOTAL,TOTAL,False,,31,61,28,45,3,16,6,10,10,23,33,18,9,12,16,16,71
401262719,Air Force Falcons,R. Snyder,4399409,,True,30.0,3,15,3,11,0,4,0,0,2,3,5,2,3,0,4,2,6
401262719,Air Force Falcons,K. Huffman,4068225,,True,20.0,1,1,1,1,0,0,3,4,1,5,6,1,0,1,3,3,5
401262719,Air Force Falcons,C. Winters,4399406,,True,17.0,0,2,0,2,0,0,2,2,0,2,2,1,0,0,2,1,2
401262719,Air Force Falcons,B. Autrey-Thompson,4399404,,True,32.0,7,13,6,12,1,1,4,4,1,1,2,1,1,0,7,2,19
401262719,Air Force Falcons,E. Conroe,4281737,,True,30.0,2,7,1,3,1,4,0,0,3,4,7,1,4,1,2,3,5
401262719,Air Force Falcons,D. MacMillan,4704414,,False,7.0,0,0,0,0,0,0,0,0,0,0,0,0,1,0,0,0,0
401262719,Air Force Falcons,N. McDonald,4595618,,False,20.0,0,1,0,1,0,0,0,0,2,2,4,1,0,0,0,0,0
401262719,Air Force Falcons,K. Pilson,4704411,,False,13.0,1,4,1,3,0,1,0,0,0,1,1,0,2,0,0,0,2
401262719,Air Force Falcons,A. Gadison,4399405,,False,2.0,0,0,0,0,0,0,0,0,0,0,0,0,0,0,0,1,0
401262719,Air Force Falcons,K. Immel,4281743,,False,29.0,3,11,2,6,1,5,3,4,0,2,2,0,2,1,2,0,10
401262719,Air Force Falcons,TEAM,TOTAL,TOTAL,False,,17,54,14,39,3,15,12,14,12,21,33,7,13,3,21,12,49
401262719,Air Force Falcons,R. Snyder,4399409,,True,30.0,3,15,3,11,0,4,0,0,2,3,5,2,3,0,4,2,6
401262719,Air Force Falcons,K. Huffman,4068225,,True,20.0,1,1,1,1,0,0,3,4,1,5,6,1,0,1,3,3,5
401262719,Air Force Falcons,C. Winters,4399406,,True,17.0,0,2,0,2,0,0,2,2,0,2,2,1,0,0,2,1,2
401262719,Air Force Falcons,B. Autrey-Thompson,4399404,,True,32.0,7,13,6,12,1,1,4,4,1,1,2,1,1,0,7,2,19
401262719,Air Force Falcons,E. Conroe,4281737,,True,30.0,2,7,1,3,1,4,0,0,3,4,7,1,4,1,2,3,5
401262719,Air Force Falcons,D. MacMillan,4704414,,False,7.0,0,0,0,0,0,0,0,0,0,0,0,0,1,0,0,0,0
401262719,Air Force Falcons,N. McDonald,4595618,,False,20.0,0,1,0,1,0,0,0,0,2,2,4,1,0,0,0,0,0
401262719,Air Force Falcons,K. Pilson,4704411,,False,13.0,1,4,1,3,0,1,0,0,0,1,1,0,2,0,0,0,2
401262719,Air Force Falcons,A. Gadison,4399405,,False,2.0,0,0,0,0,0,0,0,0,0,0,0,0,0,0,0,1,0
401262719,Air Force Falcons,K. Immel,4281743,,False,29.0,3,11,2,6,1,5,3,4,0,2,2,0,2,1,2,0,10
401262719,Air Force Falcons,TEAM,TOTAL,TOTAL,False,,17,54,14,39,3,15,12,14,12,21,33,7,13,3,21,12,49
401262718,Boise State Broncos,A. Mark,4606930,,True,23.0,3,8,3,8,0,0,1,2,1,0,1,3,1,3,2,1,7
401262718,Boise State Broncos,R. Bowers,4400536,,True,21.0,2,2,2,2,0,0,0,0,3,4,7,0,1,0,3,3,4
401262718,Boise State Broncos,M. McGwire,4066535,,True,18.0,1,4,1,4,0,0,0,0,1,2,3,1,0,4,2,2,2
401262718,Boise State Broncos,M. Naro,4705625,,True,24.0,2,2,2,2,0,0,0,0,0,2,2,2,1,0,6,1,4
401262718,Boise State Broncos,J. Loville,4400537,,True,27.0,8,15,8,12,0,3,0,0,0,2,2,0,2,0,2,1,16
401262718,Boise State Broncos,E. Lalotte,4705630,,False,15.0,2,5,2,5,0,0,1,4,2,7,9,1,0,0,0,1,5
401262718,Boise State Broncos,K. Sykes,4595619,,False,13.0,0,3,0,1,0,2,0,0,1,1,2,1,0,0,2,3,0
401262718,Boise State Broncos,A. Muse,4583056,,False,17.0,2,4,2,4,0,0,1,2,2,2,4,0,1,0,0,0,5
401262718,Boise State Broncos,R. Reed,4705629,,False,12.0,1,5,1,2,0,3,3,5,0,2,2,0,1,0,5,1,5
401262718,Boise State Broncos,M. Machalova,4705628,,False,10.0,1,4,1,4,0,0,0,0,2,0,2,0,0,0,0,0,2
401262718,Boise State Broncos,C. Gil,4705627,,False,7.0,0,1,0,1,0,0,0,0,0,0,0,1,1,0,1,2,0
401262718,Boise State Broncos,A. Ostlie,4705626,,False,13.0,1,6,1,2,0,4,0,0,0,1,1,0,0,0,2,1,2
401262718,Boise State Broncos,TEAM,TOTAL,TOTAL,False,,23,59,23,47,0,12,6,13,12,26,38,9,8,7,25,16,52
401262718,Boise State Broncos,A. Mark,4606930,,True,23.0,3,8,3,8,0,0,1,2,1,0,1,3,1,3,2,1,7
401262718,Boise State Broncos,R. Bowers,4400536,,True,21.0,2,2,2,2,0,0,0,0,3,4,7,0,1,0,3,3,4
401262718,Boise State Broncos,M. McGwire,4066535,,True,18.0,1,4,1,4,0,0,0,0,1,2,3,1,0,4,2,2,2
401262718,Boise State Broncos,M. Naro,4705625,,True,24.0,2,2,2,2,0,0,0,0,0,2,2,2,1,0,6,1,4
401262718,Boise State Broncos,J. Loville,4400537,,True,27.0,8,15,8,12,0,3,0,0,0,2,2,0,2,0,2,1,16
401262718,Boise State Broncos,E. Lalotte,4705630,,False,15.0,2,5,2,5,0,0,1,4,2,7,9,1,0,0,0,1,5
401262718,Boise State Broncos,K. Sykes,4595619,,False,13.0,0,3,0,1,0,2,0,0,1,1,2,1,0,0,2,3,0
401262718,Boise State Broncos,A. Muse,4583056,,False,17.0,2,4,2,4,0,0,1,2,2,2,4,0,1,0,0,0,5
401262718,Boise State Broncos,R. Reed,4705629,,False,12.0,1,5,1,2,0,3,3,5,0,2,2,0,1,0,5,1,5
401262718,Boise State Broncos,M. Machalova,4705628,,False,10.0,1,4,1,4,0,0,0,0,2,0,2,0,0,0,0,0,2
401262718,Boise State Broncos,C. Gil,4705627,,False,7.0,0,1,0,1,0,0,0,0,0,0,0,1,1,0,1,2,0
401262718,Boise State Broncos,A. Ostlie,4705626,,False,13.0,1,6,1,2,0,4,0,0,0,1,1,0,0,0,2,1,2
401262718,Boise State Broncos,TEAM,TOTAL,TOTAL,False,,23,59,23,47,0,12,6,13,12,26,38,9,8,7,25,16,52
401262718,Air Force Falcons,R. Snyder,4399409,,True,29.0,4,15,2,10,2,5,3,4,1,1,2,2,1,0,1,0,13
401262718,Air Force Falcons,K. Huffman,4068225,,True,17.0,0,1,0,1,0,0,0,0,1,4,5,0,1,0,3,2,0
401262718,Air Force Falcons,C. Winters,4399406,,True,21.0,2,3,2,3,0,0,0,0,1,3,4,0,2,0,0,3,4
401262718,Air Force Falcons,B. Autrey-Thompson,4399404,,True,23.0,4,12,4,10,0,2,4,5,1,6,7,5,4,0,3,3,12
401262718,Air Force Falcons,E. Conroe,4281737,,True,23.0,7,8,7,7,0,1,0,0,1,2,3,2,4,1,0,1,14
401262718,Air Force Falcons,K. Jones,4704416,,False,2.0,0,0,0,0,0,0,0,0,0,2,2,0,0,0,0,1,0
401262718,Air Force Falcons,D. MacMillan,4704414,,False,6.0,0,1,0,0,0,1,0,0,0,0,0,0,0,0,1,0,0
401262718,Air Force Falcons,N. McDonald,4595618,,False,21.0,4,6,2,3,2,3,0,0,1,2,3,0,3,0,0,0,10
401262718,Air Force Falcons,S. Thomas,4704413,,False,2.0,0,1,0,1,0,0,1,2,0,0,0,0,0,0,0,0,1
401262718,Air Force Falcons,K. Pilson,4704411,,False,19.0,1,6,1,5,0,1,2,2,0,1,1,2,0,0,2,0,4
401262718,Air Force Falcons,J. Goodwin,4704410,,False,2.0,0,0,0,0,0,0,0,0,0,0,0,0,0,0,0,1,0
401262718,Air Force Falcons,K. Heath,4595614,,False,2.0,0,1,0,1,0,0,0,0,0,0,0,0,0,0,1,1,0
401262718,Air Force Falcons,A. Gadison,4399405,,False,15.0,4,5,0,1,4,4,0,0,0,2,2,2,0,0,2,1,12
401262718,Air Force Falcons,K. Immel,4281743,,False,18.0,0,3,0,3,0,0,6,6,0,3,3,0,1,0,3,1,6
401262718,Air Force Falcons,TEAM,TOTAL,TOTAL,False,,26,62,18,45,8,17,16,19,11,27,38,13,16,1,17,14,76
401262718,Air Force Falcons,R. Snyder,4399409,,True,29.0,4,15,2,10,2,5,3,4,1,1,2,2,1,0,1,0,13
401262718,Air Force Falcons,K. Huffman,4068225,,True,17.0,0,1,0,1,0,0,0,0,1,4,5,0,1,0,3,2,0
401262718,Air Force Falcons,C. Winters,4399406,,True,21.0,2,3,2,3,0,0,0,0,1,3,4,0,2,0,0,3,4
401262718,Air Force Falcons,B. Autrey-Thompson,4399404,,True,23.0,4,12,4,10,0,2,4,5,1,6,7,5,4,0,3,3,12
401262718,Air Force Falcons,E. Conroe,4281737,,True,23.0,7,8,7,7,0,1,0,0,1,2,3,2,4,1,0,1,14
401262718,Air Force Falcons,K. Jones,4704416,,False,2.0,0,0,0,0,0,0,0,0,0,2,2,0,0,0,0,1,0
401262718,Air Force Falcons,D. MacMillan,4704414,,False,6.0,0,1,0,0,0,1,0,0,0,0,0,0,0,0,1,0,0
401262718,Air Force Falcons,N. McDonald,4595618,,False,21.0,4,6,2,3,2,3,0,0,1,2,3,0,3,0,0,0,10
401262718,Air Force Falcons,S. Thomas,4704413,,False,2.0,0,1,0,1,0,0,1,2,0,0,0,0,0,0,0,0,1
401262718,Air Force Falcons,K. Pilson,4704411,,False,19.0,1,6,1,5,0,1,2,2,0,1,1,2,0,0,2,0,4
401262718,Air Force Falcons,J. Goodwin,4704410,,False,2.0,0,0,0,0,0,0,0,0,0,0,0,0,0,0,0,1,0
401262718,Air Force Falcons,K. Heath,4595614,,False,2.0,0,1,0,1,0,0,0,0,0,0,0,0,0,0,1,1,0
401262718,Air Force Falcons,A. Gadison,4399405,,False,15.0,4,5,0,1,4,4,0,0,0,2,2,2,0,0,2,1,12
401262718,Air Force Falcons,K. Immel,4281743,,False,18.0,0,3,0,3,0,0,6,6,0,3,3,0,1,0,3,1,6
401262718,Air Force Falcons,TEAM,TOTAL,TOTAL,False,,26,62,18,45,8,17,16,19,11,27,38,13,16,1,17,14,76
401262717,Utah State Aggies,B. Mathews,4400146,,True,29.0,7,15,7,13,0,2,1,2,6,3,9,1,1,0,4,2,15
401262717,Utah State Aggies,J. Chatman,4068281,,True,33.0,5,13,5,9,0,4,1,3,1,4,5,1,2,3,3,2,11
401262717,Utah State Aggies,M. Mendazona,4704647,,True,20.0,2,5,1,2,1,3,4,4,2,5,7,2,0,2,0,3,9
401262717,Utah State Aggies,F. Brantley,4595669,,True,37.0,1,9,0,6,1,3,2,2,0,3,3,4,2,0,3,3,5
401262717,Utah State Aggies,E. Harris,4281891,,True,10.0,1,3,0,1,1,2,0,0,0,3,3,0,1,0,5,1,3
401262717,Utah State Aggies,H. Nelson,4704652,,False,13.0,1,2,1,2,0,0,0,2,2,3,5,0,1,1,1,2,2
401262717,Utah State Aggies,M. Pruitt,4704651,,False,6.0,1,1,1,1,0,0,0,0,0,0,0,0,0,0,3,4,2
401262717,Utah State Aggies,E. Emrich,4595671,,False,28.0,1,2,1,2,0,0,3,6,1,2,3,1,1,1,1,1,5
401262717,Utah State Aggies,K. Kamakawiwo'ole,4595670,,False,13.0,1,2,0,1,1,1,0,0,0,2,2,0,0,1,0,3,3
401262717,Utah State Aggies,S. Latone,4399209,,False,11.0,2,6,0,0,2,6,0,0,0,2,2,0,0,0,1,1,6
401262717,Utah State Aggies,TEAM,TOTAL,TOTAL,False,,22,58,16,37,6,21,11,19,14,30,44,9,8,8,21,22,61
401262717,Utah State Aggies,B. Mathews,4400146,,True,29.0,7,15,7,13,0,2,1,2,6,3,9,1,1,0,4,2,15
401262717,Utah State Aggies,J. Chatman,4068281,,True,33.0,5,13,5,9,0,4,1,3,1,4,5,1,2,3,3,2,11
401262717,Utah State Aggies,M. Mendazona,4704647,,True,20.0,2,5,1,2,1,3,4,4,2,5,7,2,0,2,0,3,9
401262717,Utah State Aggies,F. Brantley,4595669,,True,37.0,1,9,0,6,1,3,2,2,0,3,3,4,2,0,3,3,5
401262717,Utah State Aggies,E. Harris,4281891,,True,10.0,1,3,0,1,1,2,0,0,0,3,3,0,1,0,5,1,3
401262717,Utah State Aggies,H. Nelson,4704652,,False,13.0,1,2,1,2,0,0,0,2,2,3,5,0,1,1,1,2,2
401262717,Utah State Aggies,M. Pruitt,4704651,,False,6.0,1,1,1,1,0,0,0,0,0,0,0,0,0,0,3,4,2
401262717,Utah State Aggies,E. Emrich,4595671,,False,28.0,1,2,1,2,0,0,3,6,1,2,3,1,1,1,1,1,5
401262717,Utah State Aggies,K. Kamakawiwo'ole,4595670,,False,13.0,1,2,0,1,1,1,0,0,0,2,2,0,0,1,0,3,3
401262717,Utah State Aggies,S. Latone,4399209,,False,11.0,2,6,0,0,2,6,0,0,0,2,2,0,0,0,1,1,6
401262717,Utah State Aggies,TEAM,TOTAL,TOTAL,False,,22,58,16,37,6,21,11,19,14,30,44,9,8,8,21,22,61
401262717,Air Force Falcons,R. Snyder,4399409,,True,37.0,5,18,2,8,3,10,5,7,2,2,4,1,0,0,3,4,18
401262717,Air Force Falcons,K. Huffman,4068225,,True,21.0,0,3,0,3,0,0,0,0,0,0,0,2,1,2,0,3,0
401262717,Air Force Falcons,C. Winters,4399406,,True,28.0,4,11,4,10,0,1,0,0,1,4,5,0,2,0,2,4,8
401262717,Air Force Falcons,B. Autrey-Thompson,4399404,,True,34.0,2,10,1,7,1,3,3,5,1,3,4,4,6,0,6,3,8
401262717,Air Force Falcons,E. Conroe,4281737,,True,33.0,3,10,2,6,1,4,4,5,7,6,13,0,3,1,2,3,11
401262717,Air Force Falcons,D. MacMillan,4704414,,False,6.0,1,4,0,1,1,3,0,0,1,2,3,0,0,0,0,0,3
401262717,Air Force Falcons,N. McDonald,4595618,,False,19.0,0,5,0,2,0,3,1,2,2,4,6,1,0,0,1,0,1
401262717,Air Force Falcons,S. Thomas,4704413,,False,1.0,0,0,0,0,0,0,0,0,0,0,0,0,0,0,0,0,0
401262717,Air Force Falcons,K. Pilson,4704411,,False,11.0,1,2,0,1,1,1,1,2,1,1,2,0,0,0,1,3,4
401262717,Air Force Falcons,K. Heath,4595614,,False,2.0,0,0,0,0,0,0,0,0,0,0,0,0,0,0,0,0,0
401262717,Air Force Falcons,A. Gadison,4399405,,False,8.0,0,1,0,0,0,1,2,2,1,1,2,0,0,0,1,1,2
401262717,Air Force Falcons,TEAM,TOTAL,TOTAL,False,,16,64,9,38,7,26,16,23,20,26,46,8,12,3,17,21,55
401262717,Air Force Falcons,R. Snyder,4399409,,True,37.0,5,18,2,8,3,10,5,7,2,2,4,1,0,0,3,4,18
401262717,Air Force Falcons,K. Huffman,4068225,,True,21.0,0,3,0,3,0,0,0,0,0,0,0,2,1,2,0,3,0
401262717,Air Force Falcons,C. Winters,4399406,,True,28.0,4,11,4,10,0,1,0,0,1,4,5,0,2,0,2,4,8
401262717,Air Force Falcons,B. Autrey-Thompson,4399404,,True,34.0,2,10,1,7,1,3,3,5,1,3,4,4,6,0,6,3,8
401262717,Air Force Falcons,E. Conroe,4281737,,True,33.0,3,10,2,6,1,4,4,5,7,6,13,0,3,1,2,3,11
401262717,Air Force Falcons,D. MacMillan,4704414,,False,6.0,1,4,0,1,1,3,0,0,1,2,3,0,0,0,0,0,3
401262717,Air Force Falcons,N. McDonald,4595618,,False,19.0,0,5,0,2,0,3,1,2,2,4,6,1,0,0,1,0,1
401262717,Air Force Falcons,S. Thomas,4704413,,False,1.0,0,0,0,0,0,0,0,0,0,0,0,0,0,0,0,0,0
401262717,Air Force Falcons,K. Pilson,4704411,,False,11.0,1,2,0,1,1,1,1,2,1,1,2,0,0,0,1,3,4
401262717,Air Force Falcons,K. Heath,4595614,,False,2.0,0,0,0,0,0,0,0,0,0,0,0,0,0,0,0,0,0
401262717,Air Force Falcons,A. Gadison,4399405,,False,8.0,0,1,0,0,0,1,2,2,1,1,2,0,0,0,1,1,2
401262717,Air Force Falcons,TEAM,TOTAL,TOTAL,False,,16,64,9,38,7,26,16,23,20,26,46,8,12,3,17,21,55
401262716,Utah State Aggies,B. Mathews,4400146,,True,24.0,4,11,3,7,1,4,3,4,1,2,3,0,1,0,0,2,12
401262716,Utah State Aggies,J. Chatman,4068281,,True,33.0,2,11,2,9,0,2,4,8,2,6,8,1,1,1,2,3,8
401262716,Utah State Aggies,M. Mendazona,4704647,,True,34.0,2,9,1,8,1,1,2,2,2,2,4,1,1,0,4,1,7
401262716,Utah State Aggies,K. Kamakawiwo'ole,4595670,,True,14.0,2,4,1,3,1,1,0,0,1,1,2,1,2,0,1,2,5
401262716,Utah State Aggies,F. Brantley,4595669,,True,29.0,7,9,6,8,1,1,2,2,3,5,8,2,1,0,3,3,17
401262716,Utah State Aggies,T. Franson,4281892,,False,2.0,0,0,0,0,0,0,0,0,0,0,0,0,0,0,0,0,0
401262716,Utah State Aggies,H. Nelson,4704652,,False,2.0,0,0,0,0,0,0,0,0,0,2,2,0,0,0,0,0,0
401262716,Utah State Aggies,M. Pruitt,4704651,,False,18.0,5,8,5,8,0,0,6,10,1,6,7,0,1,1,1,5,16
401262716,Utah State Aggies,A. Lustgarten,4704649,,False,1.0,0,0,0,0,0,0,0,0,0,0,0,0,0,0,1,1,0
401262716,Utah State Aggies,K. Falslev,4704648,,False,4.0,0,1,0,1,0,0,0,0,0,0,0,0,0,0,1,0,0
401262716,Utah State Aggies,J. Polansky,4595673,,False,3.0,0,0,0,0,0,0,0,0,0,0,0,0,0,0,0,1,0
401262716,Utah State Aggies,E. Emrich,4595671,,False,22.0,0,2,0,2,0,0,0,0,0,4,4,3,0,0,3,3,0
401262716,Utah State Aggies,S. Latone,4399209,,False,14.0,2,7,2,4,0,3,1,1,0,2,2,1,1,0,2,2,5
401262716,Utah State Aggies,TEAM,TOTAL,TOTAL,False,,24,62,20,50,4,12,18,27,13,33,46,9,8,2,18,23,70
401262716,Utah State Aggies,B. Mathews,4400146,,True,24.0,4,11,3,7,1,4,3,4,1,2,3,0,1,0,0,2,12
401262716,Utah State Aggies,J. Chatman,4068281,,True,33.0,2,11,2,9,0,2,4,8,2,6,8,1,1,1,2,3,8
401262716,Utah State Aggies,M. Mendazona,4704647,,True,34.0,2,9,1,8,1,1,2,2,2,2,4,1,1,0,4,1,7
401262716,Utah State Aggies,K. Kamakawiwo'ole,4595670,,True,14.0,2,4,1,3,1,1,0,0,1,1,2,1,2,0,1,2,5
401262716,Utah State Aggies,F. Brantley,4595669,,True,29.0,7,9,6,8,1,1,2,2,3,5,8,2,1,0,3,3,17
401262716,Utah State Aggies,T. Franson,4281892,,False,2.0,0,0,0,0,0,0,0,0,0,0,0,0,0,0,0,0,0
401262716,Utah State Aggies,H. Nelson,4704652,,False,2.0,0,0,0,0,0,0,0,0,0,2,2,0,0,0,0,0,0
401262716,Utah State Aggies,M. Pruitt,4704651,,False,18.0,5,8,5,8,0,0,6,10,1,6,7,0,1,1,1,5,16
401262716,Utah State Aggies,A. Lustgarten,4704649,,False,1.0,0,0,0,0,0,0,0,0,0,0,0,0,0,0,1,1,0
401262716,Utah State Aggies,K. Falslev,4704648,,False,4.0,0,1,0,1,0,0,0,0,0,0,0,0,0,0,1,0,0
401262716,Utah State Aggies,J. Polansky,4595673,,False,3.0,0,0,0,0,0,0,0,0,0,0,0,0,0,0,0,1,0
401262716,Utah State Aggies,E. Emrich,4595671,,False,22.0,0,2,0,2,0,0,0,0,0,4,4,3,0,0,3,3,0
401262716,Utah State Aggies,S. Latone,4399209,,False,14.0,2,7,2,4,0,3,1,1,0,2,2,1,1,0,2,2,5
401262716,Utah State Aggies,TEAM,TOTAL,TOTAL,False,,24,62,20,50,4,12,18,27,13,33,46,9,8,2,18,23,70
401262716,Air Force Falcons,R. Snyder,4399409,,True,36.0,10,23,6,14,4,9,1,2,0,2,2,3,0,1,4,3,25
401262716,Air Force Falcons,K. Huffman,4068225,,True,29.0,1,4,1,4,0,0,3,4,3,4,7,1,2,2,0,2,5
401262716,Air Force Falcons,C. Winters,4399406,,True,19.0,2,5,2,5,0,0,0,1,1,4,5,2,3,1,0,5,4
401262716,Air Force Falcons,B. Autrey-Thompson,4399404,,True,29.0,1,6,1,6,0,0,2,6,1,3,4,3,0,0,5,4,4
401262716,Air Force Falcons,E. Conroe,4281737,,True,33.0,5,12,5,8,0,4,3,6,4,6,10,1,3,0,2,4,13
401262716,Air Force Falcons,D. MacMillan,4704414,,False,4.0,2,3,2,2,0,1,0,0,1,0,1,0,0,0,1,0,4
401262716,Air Force Falcons,N. McDonald,4595618,,False,17.0,0,3,0,2,0,1,0,0,1,1,2,0,0,0,0,2,0
401262716,Air Force Falcons,K. Pilson,4704411,,False,21.0,2,7,2,4,0,3,4,6,2,1,3,0,2,0,2,1,8
401262716,Air Force Falcons,K. Heath,4595614,,False,3.0,0,1,0,1,0,0,0,0,0,0,0,1,1,0,0,0,0
401262716,Air Force Falcons,A. Gadison,4399405,,False,9.0,1,3,0,0,1,3,0,0,2,3,5,0,0,0,1,1,3
401262716,Air Force Falcons,TEAM,TOTAL,TOTAL,False,,24,67,19,46,5,21,13,25,17,27,44,11,11,4,15,22,66
401262716,Air Force Falcons,R. Snyder,4399409,,True,36.0,10,23,6,14,4,9,1,2,0,2,2,3,0,1,4,3,25
401262716,Air Force Falcons,K. Huffman,4068225,,True,29.0,1,4,1,4,0,0,3,4,3,4,7,1,2,2,0,2,5
401262716,Air Force Falcons,C. Winters,4399406,,True,19.0,2,5,2,5,0,0,0,1,1,4,5,2,3,1,0,5,4
401262716,Air Force Falcons,B. Autrey-Thompson,4399404,,True,29.0,1,6,1,6,0,0,2,6,1,3,4,3,0,0,5,4,4
401262716,Air Force Falcons,E. Conroe,4281737,,True,33.0,5,12,5,8,0,4,3,6,4,6,10,1,3,0,2,4,13
401262716,Air Force Falcons,D. MacMillan,4704414,,False,4.0,2,3,2,2,0,1,0,0,1,0,1,0,0,0,1,0,4
401262716,Air Force Falcons,N. McDonald,4595618,,False,17.0,0,3,0,2,0,1,0,0,1,1,2,0,0,0,0,2,0
401262716,Air Force Falcons,K. Pilson,4704411,,False,21.0,2,7,2,4,0,3,4,6,2,1,3,0,2,0,2,1,8
401262716,Air Force Falcons,K. Heath,4595614,,False,3.0,0,1,0,1,0,0,0,0,0,0,0,1,1,0,0,0,0
401262716,Air Force Falcons,A. Gadison,4399405,,False,9.0,1,3,0,0,1,3,0,0,2,3,5,0,0,0,1,1,3
401262716,Air Force Falcons,TEAM,TOTAL,TOTAL,False,,24,67,19,46,5,21,13,25,17,27,44,11,11,4,15,22,66
401262496,Wyoming Cowgirls,D. Davidsdottir,4068870,,True,24.0,3,7,3,5,0,2,1,2,1,5,6,0,0,0,1,2,7
401262496,Wyoming Cowgirls,M. Bradshaw,4595681,,True,30.0,3,6,2,3,1,3,0,0,0,1,1,2,0,0,2,1,7
401262496,Wyoming Cowgirls,Q. Weidemann,4400207,,True,29.0,3,9,1,6,2,3,0,0,0,1,1,1,0,0,1,0,8
401262496,Wyoming Cowgirls,A. Sanchez Ramos,4400204,,True,20.0,2,7,1,3,1,4,2,2,0,0,0,3,1,0,1,4,7
401262496,Wyoming Cowgirls,T. Olson,4400203,,True,29.0,2,2,1,1,1,1,0,0,0,2,2,4,1,0,1,0,5
401262496,Wyoming Cowgirls,M. Savic,4704660,,False,10.0,1,2,1,2,0,0,3,6,2,2,4,0,0,0,0,1,5
401262496,Wyoming Cowgirls,P. Salazar,4704659,,False,11.0,2,7,2,4,0,3,0,0,0,1,1,0,0,1,0,4,4
401262496,Wyoming Cowgirls,G. Ellis,4704657,,False,12.0,0,3,0,2,0,1,1,2,0,0,0,0,0,0,1,1,1
401262496,Wyoming Cowgirls,L. Bull,4704655,,False,3.0,0,0,0,0,0,0,0,0,0,0,0,1,0,0,0,0,0
401262496,Wyoming Cowgirls,O. Ustowska,4704662,,False,15.0,0,3,0,1,0,2,0,0,0,0,0,0,0,0,1,1,0
401262496,Wyoming Cowgirls,L. Hudson,4704658,,False,3.0,0,1,0,0,0,1,0,0,0,0,0,0,0,0,0,0,0
401262496,Wyoming Cowgirls,J. Johnson,4595683,,False,14.0,2,5,0,1,2,4,0,0,0,1,1,0,0,0,0,2,6
401262496,Wyoming Cowgirls,TEAM,TOTAL,TOTAL,False,,18,52,11,28,7,24,7,12,4,15,19,11,2,1,10,16,50
401262496,Gonzaga Bulldogs,L. Wirth,4281997,,True,20.0,4,7,4,7,0,0,2,2,1,4,5,2,0,3,3,1,10
401262496,Gonzaga Bulldogs,J. Wirth,4281996,,True,19.0,7,8,7,8,0,0,2,2,4,6,10,3,0,1,1,0,16
401262496,Gonzaga Bulldogs,Kayle. Truong,4433148,,True,19.0,2,4,1,3,1,1,2,2,0,1,1,3,1,0,1,0,7
401262496,Gonzaga Bulldogs,J. Townsend,4282001,,True,22.0,2,6,2,4,0,2,0,0,0,3,3,1,1,1,0,1,4
401262496,Gonzaga Bulldogs,C. Walker,4065787,,True,17.0,4,4,0,0,4,4,0,0,0,1,1,0,0,0,0,1,12
401262496,Gonzaga Bulldogs,Y. Ejim,4703874,,False,8.0,2,7,2,7,0,0,2,2,5,2,7,2,0,1,1,3,6
401262496,Gonzaga Bulldogs,M. Kempton,4400478,,False,14.0,3,5,3,5,0,0,0,0,1,2,3,3,0,0,1,1,6
401262496,Gonzaga Bulldogs,A. Virjoghe,4400477,,False,12.0,0,0,0,0,0,0,0,0,0,2,2,2,0,2,2,3,0
401262496,Gonzaga Bulldogs,G. Barfield,4281999,,False,6.0,0,0,0,0,0,0,1,2,0,1,1,2,0,0,0,0,1
401262496,Gonzaga Bulldogs,L. Scanlon,4703873,,False,13.0,2,6,1,4,1,2,2,2,0,1,1,1,0,0,1,2,7
401262496,Gonzaga Bulldogs,M. Williams,4433490,,False,13.0,0,3,0,1,0,2,0,0,0,2,2,1,0,0,0,1,0
401262496,Gonzaga Bulldogs,Kayly. Truong,4433365,,False,16.0,3,4,1,1,2,3,0,0,0,1,1,1,0,0,0,2,8
401262496,Gonzaga Bulldogs,A. O'Connor,4282263,,False,11.0,3,4,0,0,3,4,0,0,0,1,1,0,0,0,0,0,9
401262496,Gonzaga Bulldogs,L. Forsyth,4281998,,False,10.0,1,2,0,0,1,2,0,0,0,1,1,0,0,0,0,2,3
401262496,Gonzaga Bulldogs,TEAM,TOTAL,TOTAL,False,,33,60,21,40,12,20,11,12,12,32,44,21,2,8,10,17,89
401262495,Wyoming Cowgirls,D. Davidsdottir,4068870,,True,31.0,5,7,5,7,0,0,4,6,2,9,11,0,0,2,1,2,14
401262495,Wyoming Cowgirls,M. Bradshaw,4595681,,True,24.0,7,15,4,10,3,5,1,1,1,4,5,1,1,0,0,2,18
401262495,Wyoming Cowgirls,Q. Weidemann,4400207,,True,38.0,5,14,4,11,1,3,0,0,0,2,2,3,1,0,0,1,11
401262495,Wyoming Cowgirls,A. Sanchez Ramos,4400204,,True,29.0,5,13,3,7,2,6,0,0,1,2,3,4,1,1,0,1,12
401262495,Wyoming Cowgirls,T. Olson,4400203,,True,32.0,4,4,4,4,0,0,0,0,2,7,9,4,1,1,2,2,8
401262495,Wyoming Cowgirls,G. Ellis,4704657,,False,11.0,1,2,1,2,0,0,0,0,0,1,1,0,0,1,0,1,2
401262495,Wyoming Cowgirls,O. Ustowska,4704662,,False,16.0,3,5,0,0,3,5,0,0,0,3,3,2,0,0,3,1,9
401262495,Wyoming Cowgirls,J. Johnson,4595683,,False,20.0,2,5,1,1,1,4,0,0,0,2,2,0,0,0,3,1,5
401262495,Wyoming Cowgirls,TEAM,TOTAL,TOTAL,False,,32,65,22,42,10,23,5,7,6,32,38,14,4,5,9,11,79
401262495,Denver Pioneers,R. Hein,4704226,,True,23.0,0,3,0,1,0,2,0,0,0,5,5,2,0,0,4,1,0
401262495,Denver Pioneers,S. Deem,4595917,,True,21.0,2,6,0,3,2,3,2,2,1,1,2,2,0,0,1,0,8
401262495,Denver Pioneers,M. Boyd,4595914,,True,34.0,5,11,4,9,1,2,0,0,0,5,5,1,0,0,2,4,11
401262495,Denver Pioneers,T. Malonga,4399659,,True,31.0,2,12,2,8,0,4,1,2,2,5,7,1,0,0,2,0,5
401262495,Denver Pioneers,A. Jackson,4399656,,True,19.0,3,6,1,1,2,5,0,0,0,1,1,1,1,1,0,3,8
401262495,Denver Pioneers,U. Ezeudu,4595918,,False,28.0,10,15,5,7,5,8,1,2,2,4,6,2,0,0,3,3,26
401262495,Denver Pioneers,A. Foster,4595916,,False,16.0,2,6,0,1,2,5,0,0,0,0,0,0,1,0,0,0,6
401262495,Denver Pioneers,C. Gritt,4282516,,False,28.0,1,5,1,4,0,1,1,1,2,5,7,2,2,0,1,1,3
401262495,Denver Pioneers,TEAM,TOTAL,TOTAL,False,,25,64,13,34,12,30,5,7,8,27,35,11,4,1,13,12,67
401259980,Utah State Aggies,J. Chatman,4068281,,True,29.0,6,11,4,8,2,3,2,2,0,7,7,1,0,0,1,4,16
401259980,Utah State Aggies,M. Mendazona,4704647,,True,22.0,0,4,0,2,0,2,0,0,1,3,4,2,1,0,3,2,0
401259980,Utah State Aggies,K. Kamakawiwo'ole,4595670,,True,17.0,3,6,2,3,1,3,1,1,1,1,2,1,0,0,2,3,8
401259980,Utah State Aggies,F. Brantley,4595669,,True,25.0,2,6,2,4,0,2,0,0,2,0,2,3,1,0,2,1,4
401259980,Utah State Aggies,E. Harris,4281891,,True,27.0,4,7,1,1,3,6,0,0,0,1,1,2,2,0,1,2,11
401259980,Utah State Aggies,B. Mathews,4400146,,False,15.0,2,8,2,7,0,1,1,1,3,1,4,2,0,0,1,1,5
401259980,Utah State Aggies,T. Franson,4281892,,False,10.0,0,0,0,0,0,0,0,0,0,3,3,1,0,0,2,1,0
401259980,Utah State Aggies,M. Pruitt,4704651,,False,17.0,3,8,1,5,2,3,3,4,1,5,6,0,1,0,2,3,11
401259980,Utah State Aggies,P. Williams,4704650,,False,6.0,0,5,0,2,0,3,0,0,1,1,2,0,0,0,0,0,0
401259980,Utah State Aggies,K. Falslev,4704648,,False,6.0,1,5,1,2,0,3,0,0,0,0,0,0,0,0,1,0,2
401259980,Utah State Aggies,E. Emrich,4595671,,False,19.0,3,5,3,5,0,0,0,0,3,3,6,0,0,0,0,3,6
401259980,Utah State Aggies,S. Latone,4399209,,False,7.0,1,2,1,1,0,1,1,2,1,1,2,0,0,0,0,0,3
401259980,Utah State Aggies,TEAM,TOTAL,TOTAL,False,,25,67,17,40,8,27,8,10,13,26,39,12,5,0,15,20,66
401259980,BYU Cougars,L. Gustin,4595746,,True,31.0,7,15,7,15,0,0,7,10,7,10,17,3,0,0,2,2,21
401259980,BYU Cougars,S. Hamson,4281976,,True,12.0,1,2,1,2,0,0,0,0,0,1,1,0,0,0,1,4,2
401259980,BYU Cougars,S. Gonzales,4400473,,True,30.0,11,17,8,12,3,5,2,2,0,4,4,3,4,0,3,2,27
401259980,BYU Cougars,P. Johnson Harding,4281977,,True,25.0,6,13,6,10,0,3,2,3,1,3,4,3,0,0,0,0,14
401259980,BYU Cougars,M. Albiero,4281974,,True,34.0,2,5,1,2,1,3,2,2,1,5,6,2,1,0,2,3,7
401259980,BYU Cougars,M. Perri,4703877,,False,8.0,2,4,1,1,1,3,0,0,1,2,3,0,0,0,0,2,5
401259980,BYU Cougars,K. Beckman,4595745,,False,3.0,0,1,0,1,0,0,0,0,0,1,1,0,0,0,1,0,0
401259980,BYU Cougars,B. Ugwu,4400475,,False,5.0,1,3,1,3,0,0,0,0,1,1,2,0,0,0,0,0,2
401259980,BYU Cougars,T. White,4400476,,False,6.0,0,0,0,0,0,0,0,0,0,0,0,0,0,0,0,1,0
401259980,BYU Cougars,D. Millett,4595747,,False,1.0,1,1,1,1,0,0,0,0,0,0,0,0,1,0,0,0,2
401259980,BYU Cougars,K. Smiler,4400474,,False,19.0,0,3,0,0,0,3,0,0,0,2,2,2,0,0,0,2,0
401259980,BYU Cougars,T. Graham,4068250,,False,26.0,3,6,2,3,1,3,0,0,0,1,1,3,0,0,2,2,7
401259980,BYU Cougars,TEAM,TOTAL,TOTAL,False,,34,70,28,50,6,20,13,17,14,31,45,16,6,0,11,18,87
401259966,San Diego State Aztecs,K. Edwards,4281879,,True,16.0,2,3,1,2,1,1,0,0,1,2,3,0,1,0,1,0,5
401259966,San Diego State Aztecs,S. Ramos,4400168,,True,36.0,9,23,6,14,3,9,5,6,1,3,4,3,3,0,3,1,26
401259966,San Diego State Aztecs,A. Crain,4399223,,True,37.0,3,8,3,7,0,1,3,4,0,3,3,3,0,0,0,5,9
401259966,San Diego State Aztecs,M. Staples,4398925,,True,32.0,4,13,4,10,0,3,0,0,1,9,10,2,1,1,4,0,8
401259966,San Diego State Aztecs,T. Adams,4281876,,True,29.0,3,4,1,2,2,2,3,6,0,2,2,2,0,0,1,2,11
401259966,San Diego State Aztecs,K. Gipson,4704563,,False,23.0,3,6,3,6,0,0,1,2,2,5,7,0,3,0,1,3,7
401259966,San Diego State Aztecs,F. Vinerte,4704564,,False,1.0,0,0,0,0,0,0,0,0,0,0,0,0,0,0,1,1,0
401259966,San Diego State Aztecs,K. Villalobos,4704565,,False,18.0,1,3,1,3,0,0,3,4,2,5,7,0,0,0,1,2,5
401259966,San Diego State Aztecs,T. Sireni,4595648,,False,0.0,0,0,0,0,0,0,0,0,0,0,0,0,0,0,0,0,0
401259966,San Diego State Aztecs,I. Hernandez,4595647,,False,8.0,0,2,0,2,0,0,0,0,0,0,0,0,0,0,0,0,0
401259966,San Diego State Aztecs,TEAM,TOTAL,TOTAL,False,,25,62,19,46,6,16,15,22,10,31,41,10,8,1,12,14,71
401259966,California Baptist Lancers,B. Thomas,4419353,,True,26.0,12,14,12,14,0,0,2,3,2,10,12,0,0,0,1,3,26
401259966,California Baptist Lancers,T. Neale,4598110,,True,15.0,2,4,2,2,0,2,0,0,1,2,3,1,0,0,0,1,4
401259966,California Baptist Lancers,T. Wu,4598112,,True,19.0,1,6,1,3,0,3,0,0,0,0,0,1,0,0,0,3,2
401259966,California Baptist Lancers,S. Palma,4419349,,True,32.0,0,3,0,0,0,3,3,4,0,3,3,7,2,0,2,3,3
401259966,California Baptist Lancers,A. Olaeta,4419341,,True,34.0,9,16,7,11,2,5,5,6,0,2,2,4,1,0,5,3,25
401259966,California Baptist Lancers,C. Harper,4419354,,False,14.0,2,6,2,6,0,0,0,0,1,3,4,0,1,0,3,1,4
401259966,California Baptist Lancers,N. Avila-Ambrosi,4703947,,False,30.0,2,8,1,3,1,5,0,0,1,1,2,1,2,1,1,2,5
401259966,California Baptist Lancers,D. Wu,4703946,,False,21.0,2,6,0,1,2,5,0,0,0,5,5,1,1,1,2,0,6
401259966,California Baptist Lancers,B. Klaman,4281618,,False,9.0,0,2,0,0,0,2,0,0,1,1,2,2,0,0,0,1,0
401259966,California Baptist Lancers,TEAM,TOTAL,TOTAL,False,,30,65,25,40,5,25,10,13,7,31,38,17,7,2,14,17,75
401259851,Eastern Washington Eagles,M. Knowles,4399898,,True,26.0,0,2,0,2,0,0,0,0,2,3,5,0,1,2,1,0,0
401259851,Eastern Washington Eagles,K. Dickie,4594824,,True,30.0,5,10,3,8,2,2,4,4,0,1,1,1,0,1,3,1,16
401259851,Eastern Washington Eagles,A. Newman,4594822,,True,20.0,3,8,3,7,0,1,0,0,1,4,5,2,0,0,3,4,6
401259851,Eastern Washington Eagles,A. Alexander,4704751,,True,31.0,3,13,1,10,2,3,0,0,0,2,2,2,0,0,5,5,8
401259851,Eastern Washington Eagles,G. Kirscher,4399900,,True,26.0,3,4,0,0,3,4,0,0,0,1,1,2,0,0,2,1,9
401259851,Eastern Washington Eagles,N. Cunill,4704747,,False,23.0,2,6,2,6,0,0,1,2,2,4,6,2,2,0,0,1,5
401259851,Eastern Washington Eagles,M. Burnham,4704748,,False,19.0,4,7,3,4,1,3,3,4,2,2,4,0,2,1,3,4,12
401259851,Eastern Washington Eagles,J. Dick,4594823,,False,25.0,4,7,4,4,0,3,0,0,0,1,1,3,4,0,2,0,8
401259851,Eastern Washington Eagles,TEAM,TOTAL,TOTAL,False,,24,57,16,41,8,16,8,10,9,21,30,12,9,4,20,16,64
401259851,Boise State Broncos,A. Mark,4606930,,True,24.0,7,15,7,14,0,1,1,3,2,0,2,2,3,0,3,2,15
401259851,Boise State Broncos,R. Bowers,4400536,,True,18.0,2,6,2,6,0,0,2,2,4,4,8,2,0,0,0,1,6
401259851,Boise State Broncos,M. McGwire,4066535,,True,24.0,7,11,6,9,1,2,3,3,3,5,8,0,1,1,1,0,18
401259851,Boise State Broncos,M. Naro,4705625,,True,32.0,3,7,1,4,2,3,0,0,0,2,2,5,3,1,2,2,8
401259851,Boise State Broncos,J. Loville,4400537,,True,34.0,5,11,3,8,2,3,0,0,0,2,2,3,0,1,2,3,12
401259851,Boise State Broncos,E. Lalotte,4705630,,False,16.0,4,6,4,6,0,0,2,4,3,5,8,3,0,0,0,0,10
401259851,Boise State Broncos,C. Njoku,4595621,,False,9.0,0,1,0,1,0,0,0,0,0,1,1,0,0,0,2,0,0
401259851,Boise State Broncos,K. Sykes,4595619,,False,18.0,3,7,0,2,3,5,2,2,0,1,1,1,0,0,1,1,11
401259851,Boise State Broncos,A. Muse,4583056,,False,12.0,1,3,1,3,0,0,0,0,0,0,0,1,0,0,0,0,2
401259851,Boise State Broncos,R. Reed,4705629,,False,4.0,0,0,0,0,0,0,0,0,0,0,0,0,0,0,3,0,0
401259851,Boise State Broncos,M. Machalova,4705628,,False,6.0,1,1,1,1,0,0,0,0,1,0,1,1,0,0,0,0,2
401259851,Boise State Broncos,C. Gil,4705627,,False,3.0,0,1,0,0,0,1,0,0,0,0,0,0,0,0,0,0,0
401259851,Boise State Broncos,TEAM,TOTAL,TOTAL,False,,33,69,25,54,8,15,10,14,17,24,41,18,7,3,14,9,84
401259254,Wyoming Cowgirls,D. Davidsdottir,4068870,,True,25.0,1,3,1,3,0,0,0,0,0,4,4,1,1,0,0,0,2
401259254,Wyoming Cowgirls,J. Johnson,4595683,,True,39.0,3,8,2,4,1,4,2,2,0,3,3,1,0,0,1,1,9
401259254,Wyoming Cowgirls,Q. Weidemann,4400207,,True,39.0,4,13,1,5,3,8,2,2,0,3,3,1,1,0,3,3,13
401259254,Wyoming Cowgirls,A. Sanchez Ramos,4400204,,True,39.0,1,5,1,4,0,1,0,0,1,4,5,4,1,0,3,1,2
401259254,Wyoming Cowgirls,T. Olson,4400203,,True,29.0,3,6,1,3,2,3,2,2,0,4,4,6,4,0,3,5,10
401259254,Wyoming Cowgirls,G. Ellis,4704657,,False,22.0,2,6,1,3,1,3,1,2,0,3,3,0,0,0,0,0,6
401259254,Wyoming Cowgirls,O. Ustowska,4704662,,False,32.0,4,6,3,3,1,3,2,4,1,2,3,0,0,1,1,1,11
401259254,Wyoming Cowgirls,TEAM,TOTAL,TOTAL,False,,18,47,10,25,8,22,9,12,4,24,28,13,7,1,13,11,53
401259254,Northern Colorado Bears,A. Davis,4594851,,True,41.0,4,14,4,14,0,0,4,6,1,11,12,3,1,5,1,0,12
401259254,Northern Colorado Bears,M. Finau,4594847,,True,22.0,0,3,0,2,0,1,0,0,0,2,2,0,0,0,0,1,0
401259254,Northern Colorado Bears,O. Wikstrom,4705488,,True,11.0,0,0,0,0,0,0,0,0,0,1,1,1,0,0,3,0,0
401259254,Northern Colorado Bears,A. Whyte,4594850,,True,37.0,3,8,3,8,0,0,1,2,2,3,5,1,2,0,4,3,7
401259254,Northern Colorado Bears,A. Wiggins,4281312,,True,19.0,0,4,0,4,0,0,0,0,0,1,1,2,2,0,0,1,0
401259254,Northern Colorado Bears,R. Soos,4705492,,False,4.0,1,2,1,2,0,0,0,0,1,1,2,0,0,0,0,0,2
401259254,Northern Colorado Bears,J. Gayles,4594849,,False,29.0,2,8,2,4,0,4,2,3,3,0,3,1,1,0,3,2,6
401259254,Northern Colorado Bears,M. Isenbart,4399928,,False,24.0,7,8,4,5,3,3,0,0,3,1,4,0,0,0,0,0,17
401259254,Northern Colorado Bears,B. Evans,4399927,,False,12.0,1,1,1,1,0,0,0,0,0,2,2,0,0,0,0,0,2
401259254,Northern Colorado Bears,A. Chapman,4281679,,False,26.0,2,8,2,5,0,3,0,0,0,1,1,0,0,0,2,4,4
401259254,Northern Colorado Bears,TEAM,TOTAL,TOTAL,False,,20,56,17,45,3,11,7,11,12,26,38,8,6,5,14,11,50
401259222,Utah State Aggies,J. Chatman,4068281,,True,32.0,5,8,2,3,3,5,1,2,3,4,7,1,2,1,0,2,14
401259222,Utah State Aggies,H. Nelson,4704652,,True,18.0,3,4,3,3,0,1,0,0,1,5,6,0,3,1,4,2,6
401259222,Utah State Aggies,M. Mendazona,4704647,,True,28.0,8,13,6,10,2,3,0,0,0,7,7,5,4,4,1,1,18
401259222,Utah State Aggies,F. Brantley,4595669,,True,33.0,3,6,1,1,2,5,3,4,1,3,4,6,2,0,6,1,11
401259222,Utah State Aggies,E. Harris,4281891,,True,29.0,3,10,3,6,0,4,6,7,0,4,4,4,0,0,2,1,12
401259222,Utah State Aggies,T. Franson,4281892,,False,8.0,2,2,2,2,0,0,0,0,1,1,2,0,0,0,1,2,4
401259222,Utah State Aggies,M. Pruitt,4704651,,False,12.0,3,7,3,6,0,1,0,0,1,3,4,1,0,1,1,2,6
401259222,Utah State Aggies,P. Williams,4704650,,False,7.0,1,3,1,1,0,2,0,0,0,1,1,0,1,0,1,2,2
401259222,Utah State Aggies,K. Falslev,4704648,,False,2.0,0,2,0,1,0,1,0,0,0,0,0,0,0,0,0,0,0
401259222,Utah State Aggies,E. Emrich,4595671,,False,14.0,3,4,3,4,0,0,0,0,0,1,1,2,0,0,2,0,6
401259222,Utah State Aggies,K. Kamakawiwo'ole,4595670,,False,10.0,1,5,1,3,0,2,0,0,1,2,3,0,0,0,1,2,2
401259222,Utah State Aggies,S. Latone,4399209,,False,7.0,0,2,0,0,0,2,0,0,0,0,0,0,0,0,1,1,0
401259222,Utah State Aggies,TEAM,TOTAL,TOTAL,False,,32,66,25,40,7,26,10,13,10,32,42,19,12,7,20,16,81
401259222,Montana Lady Griz,H. Thurmon,4704795,,True,25.0,2,7,1,5,1,2,0,0,0,4,4,1,0,0,0,0,5
401259222,Montana Lady Griz,C. Gfeller,4399911,,True,24.0,8,13,8,12,0,1,5,6,2,4,6,1,0,1,5,4,21
401259222,Montana Lady Griz,A. Anderson,4281646,,True,19.0,5,8,5,8,0,0,0,0,0,2,2,1,2,1,3,3,10
401259222,Montana Lady Griz,M. Schoening,4068703,,True,22.0,2,9,1,4,1,5,2,4,2,4,6,3,1,0,3,2,7
401259222,Montana Lady Griz,S. Stiles,4281645,,True,29.0,1,5,1,4,0,1,2,3,0,3,3,8,4,1,2,3,4
401259222,Montana Lady Griz,K. Murphy,4704800,,False,8.0,0,2,0,2,0,0,0,0,1,1,2,0,0,0,0,1,0
401259222,Montana Lady Griz,L. Mills,4398800,,False,3.0,0,0,0,0,0,0,1,2,0,0,0,0,0,0,0,0,1
401259222,Montana Lady Griz,W. Albrecht,4704798,,False,17.0,5,8,1,3,4,5,0,0,1,0,1,1,0,0,1,3,14
401259222,Montana Lady Griz,J. Momberg,4704799,,False,3.0,0,0,0,0,0,0,0,0,0,0,0,0,0,0,0,0,0
401259222,Montana Lady Griz,B. Dixson,4704797,,False,17.0,3,7,1,1,2,6,0,0,1,3,4,3,0,0,3,1,8
401259222,Montana Lady Griz,K. Keller,4704796,,False,11.0,0,1,0,1,0,0,2,2,0,1,1,1,0,0,0,1,2
401259222,Montana Lady Griz,N. Morris-Nelson,4704794,,False,22.0,1,4,1,3,0,1,0,0,0,1,1,1,1,0,3,1,2
401259222,Montana Lady Griz,TEAM,TOTAL,TOTAL,False,,27,64,19,43,8,21,12,17,9,24,33,20,8,3,20,19,74
401257783,Lamar Cardinals,B. Galloway,4704880,,True,30.0,4,6,4,6,0,0,0,0,2,1,3,0,1,0,0,1,8
401257783,Lamar Cardinals,A. Gibbs,4704878,,True,24.0,1,9,0,4,1,5,0,0,2,2,4,1,1,0,1,3,3
401257783,Lamar Cardinals,M. Malone,4704876,,True,13.0,1,7,1,3,0,4,0,0,1,1,2,1,1,0,2,0,2
401257783,Lamar Cardinals,A. Hastings,4400297,,True,26.0,1,10,1,4,0,6,4,4,0,1,1,1,0,0,2,1,6
401257783,Lamar Cardinals,J. Pimentel,4282351,,True,15.0,0,3,0,2,0,1,1,2,0,2,2,2,0,0,2,4,1
401257783,Lamar Cardinals,M. Wilson,4281303,,False,16.0,2,11,2,11,0,0,0,0,3,1,4,0,1,0,3,1,4
401257783,Lamar Cardinals,U. Collins,4400299,,False,9.0,0,1,0,1,0,0,2,2,0,1,1,0,0,0,1,4,2
401257783,Lamar Cardinals,D. Flowers,4704879,,False,3.0,0,3,0,1,0,2,0,0,0,0,0,0,0,0,0,0,0
401257783,Lamar Cardinals,S. Dean,4704875,,False,26.0,4,6,4,6,0,0,0,0,1,2,3,1,0,0,1,1,8
401257783,Lamar Cardinals,M. McQueen,4595699,,False,21.0,3,7,3,7,0,0,2,2,0,1,1,0,1,0,1,1,8
401257783,Lamar Cardinals,K. Mitchell,4595698,,False,17.0,2,4,2,3,0,1,3,4,0,1,1,1,0,0,1,5,7
401257783,Lamar Cardinals,TEAM,TOTAL,TOTAL,False,,18,67,17,48,1,19,12,14,9,13,22,7,5,0,14,21,49
401257783,Fresno State Bulldogs,M. Utti,4281828,,True,20.0,5,9,5,8,0,1,5,6,1,5,6,2,1,0,5,3,15
401257783,Fresno State Bulldogs,B. Walling,4595632,,True,15.0,0,1,0,0,0,1,0,0,0,0,0,0,0,1,1,2,0
401257783,Fresno State Bulldogs,Hal. Cavinder,4433658,,True,30.0,5,10,4,6,1,4,6,7,0,10,10,8,1,0,2,1,17
401257783,Fresno State Bulldogs,Han. Cavinder,4433372,,True,26.0,9,12,7,7,2,5,4,7,0,5,5,4,1,0,4,3,24
401257783,Fresno State Bulldogs,A. Gamez,4281826,,True,26.0,7,11,7,9,0,2,1,1,1,1,2,3,3,0,0,2,15
401257783,Fresno State Bulldogs,C. Fairley,4704474,,False,6.0,1,1,0,0,1,1,0,0,0,1,1,0,0,0,0,0,3
401257783,Fresno State Bulldogs,W. Motta,4595631,,False,11.0,1,2,1,2,0,0,4,4,1,2,3,0,0,0,0,4,6
401257783,Fresno State Bulldogs,K. Kinzer,4595630,,False,14.0,0,1,0,0,0,1,0,0,0,2,2,3,0,0,1,0,0
401257783,Fresno State Bulldogs,M. Guimaraes,4704476,,False,10.0,1,1,1,1,0,0,0,0,0,2,2,0,0,0,0,0,2
401257783,Fresno State Bulldogs,Y. Todorova,4704475,,False,13.0,3,4,1,1,2,3,0,0,0,0,0,1,0,0,0,2,8
401257783,Fresno State Bulldogs,K. Brown,4704473,,False,13.0,2,4,0,2,2,2,0,0,0,5,5,2,1,0,0,2,6
401257783,Fresno State Bulldogs,D. Dunn,4433511,,False,5.0,1,1,0,0,1,1,0,0,0,0,0,0,0,0,0,1,3
401257783,Fresno State Bulldogs,B. Delaney,4281825,,False,11.0,0,1,0,0,0,1,0,0,1,1,2,4,0,0,3,2,0
401257783,Fresno State Bulldogs,TEAM,TOTAL,TOTAL,False,,35,58,26,36,9,22,20,25,4,34,38,27,7,1,16,22,99
401257782,San Diego State Aztecs,K. Edwards,4281879,,True,27.0,2,4,2,4,0,0,0,0,0,2,2,0,1,0,1,2,4
401257782,San Diego State Aztecs,S. Ramos,4400168,,True,40.0,6,14,4,8,2,6,8,11,1,11,12,4,1,3,4,1,22
401257782,San Diego State Aztecs,A. Crain,4399223,,True,34.0,2,7,2,6,0,1,3,4,1,1,2,1,1,0,4,4,7
401257782,San Diego State Aztecs,M. Staples,4398925,,True,31.0,4,10,3,5,1,5,0,2,0,5,5,0,0,0,1,4,9
401257782,San Diego State Aztecs,T. Adams,4281876,,True,29.0,4,6,2,3,2,3,0,0,0,4,4,3,1,1,4,1,10
401257782,San Diego State Aztecs,B. Chynoweth,4704562,,False,2.0,0,0,0,0,0,0,0,0,0,0,0,0,0,0,0,0,0
401257782,San Diego State Aztecs,T. Sireni,4595648,,False,13.0,0,1,0,0,0,1,0,0,1,3,4,0,0,0,1,2,0
401257782,San Diego State Aztecs,I. Hernandez,4595647,,False,24.0,3,6,1,3,2,3,0,0,0,4,4,0,0,0,1,2,8
401257782,San Diego State Aztecs,TEAM,TOTAL,TOTAL,False,,21,48,14,29,7,19,11,17,3,30,33,8,4,4,16,16,60
401257782,Lamar Cardinals,B. Galloway,4704880,,True,20.0,1,2,1,2,0,0,0,0,3,3,6,0,1,0,1,1,2
401257782,Lamar Cardinals,A. Gibbs,4704878,,True,38.0,4,10,1,3,3,7,2,2,6,6,12,0,3,0,2,1,13
401257782,Lamar Cardinals,M. Malone,4704876,,True,29.0,5,13,4,12,1,1,2,2,1,1,2,0,1,0,3,1,13
401257782,Lamar Cardinals,A. Hastings,4400297,,True,25.0,3,18,1,7,2,11,0,0,0,2,2,0,0,0,1,4,8
401257782,Lamar Cardinals,J. Pimentel,4282351,,True,23.0,4,6,4,6,0,0,1,2,0,3,3,2,1,0,2,4,9
401257782,Lamar Cardinals,M. Wilson,4281303,,False,22.0,2,9,1,5,1,4,2,4,1,4,5,0,2,0,0,3,7
401257782,Lamar Cardinals,U. Collins,4400299,,False,1.0,0,0,0,0,0,0,0,0,0,0,0,0,0,0,0,0,0
401257782,Lamar Cardinals,S. Dean,4704875,,False,16.0,0,4,0,4,0,0,2,2,0,0,0,2,0,0,1,2,2
401257782,Lamar Cardinals,M. McQueen,4595699,,False,13.0,0,2,0,1,0,1,0,0,2,4,6,2,1,0,0,1,0
401257782,Lamar Cardinals,K. Mitchell,4595698,,False,13.0,0,2,0,1,0,1,0,0,0,1,1,2,0,0,1,3,0
401257782,Lamar Cardinals,TEAM,TOTAL,TOTAL,False,,19,66,12,41,7,25,9,12,13,24,37,8,9,0,11,20,54
401255777,San Diego State Aztecs,K. Gipson,4704563,,True,23.0,0,3,0,3,0,0,0,0,1,4,5,0,1,0,0,2,0
401255777,San Diego State Aztecs,B. Chynoweth,4704562,,True,31.0,3,11,0,0,3,11,0,0,0,0,0,0,1,0,0,0,9
401255777,San Diego State Aztecs,I. Hernandez,4595647,,True,36.0,3,8,1,4,2,4,0,0,0,0,0,0,3,0,1,0,8
401255777,San Diego State Aztecs,M. Staples,4398925,,True,36.0,3,11,1,6,2,5,2,2,1,8,9,3,0,0,4,4,10
401255777,San Diego State Aztecs,T. Adams,4281876,,True,31.0,3,7,3,5,0,2,4,6,0,4,4,7,1,0,5,4,10
401255777,San Diego State Aztecs,F. Vinerte,4704564,,False,16.0,3,4,3,4,0,0,3,3,2,4,6,0,0,0,0,1,9
401255777,San Diego State Aztecs,K. Villalobos,4704565,,False,14.0,3,7,3,7,0,0,1,2,1,3,4,0,1,0,1,2,7
401255777,San Diego State Aztecs,T. Sireni,4595648,,False,13.0,3,3,1,1,2,2,2,2,0,0,0,0,0,0,1,2,10
401255777,San Diego State Aztecs,TEAM,TOTAL,TOTAL,False,,21,54,12,30,9,24,12,15,6,24,30,10,7,0,12,15,63
401255777,Cal Poly Mustangs,K. Brown,4281448,,True,28.0,3,5,3,5,0,0,0,0,2,2,4,0,0,0,1,4,6
401255777,Cal Poly Mustangs,S. Campisano,4066536,,True,36.0,3,12,3,11,0,1,1,2,2,10,12,4,1,2,4,3,7
401255777,Cal Poly Mustangs,A. Ellis,4595183,,True,35.0,13,25,5,14,8,11,5,6,2,2,4,1,3,0,1,2,39
401255777,Cal Poly Mustangs,M. Willett,4400024,,True,36.0,2,8,0,3,2,5,1,2,0,6,6,4,0,1,0,0,7
401255777,Cal Poly Mustangs,M. Holt,4281447,,True,16.0,0,1,0,0,0,1,0,0,1,1,2,2,0,0,2,1,0
401255777,Cal Poly Mustangs,N. Ackerman,4704345,,False,2.0,0,0,0,0,0,0,0,0,0,0,0,1,1,1,0,0,0
401255777,Cal Poly Mustangs,H. Scanlan,4281948,,False,14.0,1,1,1,1,0,0,0,0,2,4,6,0,0,0,0,1,2
401255777,Cal Poly Mustangs,L. Hunter,4595186,,False,2.0,0,1,0,1,0,0,0,0,0,0,0,1,0,0,0,0,0
401255777,Cal Poly Mustangs,L. Svetich,4595185,,False,3.0,1,1,1,1,0,0,0,0,0,0,0,0,1,0,0,1,2
401255777,Cal Poly Mustangs,H. Peterson,4400020,,False,1.0,0,0,0,0,0,0,0,0,0,0,0,0,0,0,1,0,0
401255777,Cal Poly Mustangs,M. Vick,4400018,,False,27.0,4,6,2,3,2,3,0,0,0,0,0,7,0,0,2,4,10
401255777,Cal Poly Mustangs,TEAM,TOTAL,TOTAL,False,,27,60,15,39,12,21,7,10,9,28,37,20,6,4,11,16,73
401527968,Maryland Terrapins,F. Masonius,4433653,,True,19.0,5,7,5,7,0,0,0,1,2,1,3,0,3,0,1,0,10
401527968,Maryland Terrapins,S. Sellers,4433808,,True,22.0,5,8,5,7,0,1,3,4,0,2,2,8,2,1,1,2,13
401527968,Maryland Terrapins,D. Miller,4433635,,True,23.0,6,12,6,10,0,2,1,2,2,6,8,1,0,0,1,2,13
401527968,Maryland Terrapins,E. Pinzan,4399238,,True,32.0,2,5,2,5,0,0,0,0,1,1,2,6,2,0,3,1,4
401527968,Maryland Terrapins,A. Meyers,4281402,,True,22.0,5,13,3,8,2,5,4,6,2,2,4,2,3,2,1,0,16
401527968,Maryland Terrapins,B. McDaniel,5107845,,False,19.0,1,3,0,2,1,1,0,0,0,2,2,0,2,0,2,2,3
401527968,Maryland Terrapins,A. Sciolla,4858669,,False,7.0,1,1,1,1,0,0,0,0,0,0,0,0,0,0,0,1,2
401527968,Maryland Terrapins,G. Cooke,4607456,,False,7.0,2,4,2,4,0,0,2,2,0,2,2,0,0,0,1,1,6
401527968,Maryland Terrapins,L. Briggs,4433315,,False,24.0,3,6,1,3,2,3,0,0,1,2,3,4,0,1,2,2,8
401527968,Maryland Terrapins,B. Alexander,4398774,,False,25.0,6,10,2,3,4,7,2,2,2,4,6,0,1,0,0,3,18
401527968,Maryland Terrapins,TEAM,TOTAL,TOTAL,False,,36,69,27,50,9,19,12,17,10,25,35,21,13,4,12,14,93
401527968,Holy Cross Crusaders,L. Berger,4900539,,True,20.0,2,3,2,3,0,0,1,2,2,4,6,1,0,1,0,1,5
401527968,Holy Cross Crusaders,J. Allen,4704714,,True,25.0,3,7,3,7,0,0,1,2,0,2,2,1,0,0,3,1,7
401527968,Holy Cross Crusaders,K. Flanagan,5109211,,True,24.0,2,2,1,1,1,1,0,0,1,4,5,1,3,0,3,3,5
401527968,Holy Cross Crusaders,B. Power-Cassidy,4704715,,True,28.0,1,7,0,4,1,3,0,0,0,3,3,0,1,0,5,2,3
401527968,Holy Cross Crusaders,A. Cross,4595975,,True,29.0,3,5,2,2,1,3,1,2,0,4,4,3,1,0,4,3,8
401527968,Holy Cross Crusaders,M. Cahalan,5109210,,False,3.0,0,0,0,0,0,0,0,0,0,0,0,0,0,0,0,0,0
401527968,Holy Cross Crusaders,C. Wright,4703660,,False,6.0,0,1,0,1,0,0,0,0,0,0,0,0,0,0,0,0,0
401527968,Holy Cross Crusaders,M. Donnelly,5109213,,False,14.0,4,6,3,4,1,2,1,1,1,0,1,0,1,0,2,2,10
401527968,Holy Cross Crusaders,S. Foreman,5109212,,False,22.0,4,10,4,10,0,0,5,6,1,2,3,2,2,0,3,0,13
401527968,Holy Cross Crusaders,L. Huber,4900538,,False,3.0,0,0,0,0,0,0,0,0,0,0,0,1,0,0,0,0,0
401527968,Holy Cross Crusaders,G. Munt,4900537,,False,8.0,1,6,1,4,0,2,0,0,0,0,0,0,0,0,0,0,2
401527968,Holy Cross Crusaders,C. McCormack,4704716,,False,18.0,3,8,1,2,2,6,0,0,0,0,0,3,0,0,2,0,8
401527968,Holy Cross Crusaders,TEAM,TOTAL,TOTAL,False,,23,55,17,38,6,17,9,13,7,22,29,12,8,1,24,12,61
401526925,Rhode Island Rams,M. Toure,4704153,,True,25.0,4,15,4,15,0,0,0,0,0,4,4,0,1,2,1,3,8
401526925,Rhode Island Rams,E. Squires,4399456,,True,12.0,0,6,0,1,0,5,0,0,1,2,3,1,1,0,0,0,0
401526925,Rhode Island Rams,D. Cairns,4898523,,True,14.0,3,7,2,3,1,4,0,0,0,5,5,1,2,0,1,1,7
401526925,Rhode Island Rams,M. Hattix-Covington,4281906,,True,21.0,0,7,0,5,0,2,4,4,1,0,1,0,3,1,0,2,4
401526925,Rhode Island Rams,S. Lassiter,4281174,,True,22.0,1,4,1,2,0,2,3,4,0,2,2,3,6,0,1,2,5
401526925,Rhode Island Rams,A. Dutat,5110056,,False,23.0,1,3,1,3,0,0,0,0,6,5,11,0,1,0,0,1,2
401526925,Rhode Island Rams,H. Komara,4898524,,False,2.0,0,0,0,0,0,0,0,0,0,0,0,0,0,0,0,0,0
401526925,Rhode Island Rams,T. Magassa,4703739,,False,19.0,5,9,5,9,0,0,2,5,5,3,8,0,0,1,2,2,12
401526925,Rhode Island Rams,I. Debroise,5110058,,False,18.0,0,6,0,3,0,3,0,0,0,3,3,2,1,0,0,0,0
401526925,Rhode Island Rams,E. Rinat,4898525,,False,19.0,1,8,1,5,0,3,0,0,2,2,4,1,1,0,2,1,2
401526925,Rhode Island Rams,S. Phillips,4898522,,False,25.0,2,10,0,1,2,9,0,0,1,1,2,0,2,0,0,0,6
401526925,Rhode Island Rams,TEAM,TOTAL,TOTAL,False,,17,75,14,47,3,28,9,13,18,30,48,8,18,4,9,12,46
401526925,Boston University Terriers,C. Weimar,4704495,,True,37.0,6,15,6,15,0,0,1,2,3,12,15,2,0,4,4,3,13
401526925,Boston University Terriers,M. Durant,4599732,,True,25.0,3,7,3,6,0,1,0,0,3,4,7,1,1,1,3,2,6
401526925,Boston University Terriers,L. Davenport,4899718,,True,28.0,0,8,0,5,0,3,2,3,1,5,6,1,0,1,3,0,2
401526925,Boston University Terriers,M. Pina,4599731,,True,31.0,1,7,0,1,1,6,1,2,1,5,6,3,1,0,2,2,4
401526925,Boston University Terriers,S. Johnson,4599729,,True,34.0,3,11,3,7,0,4,2,2,1,7,8,3,0,0,5,1,8
401526925,Boston University Terriers,S. Crispe,5109197,,False,18.0,2,4,2,3,0,1,0,0,0,1,1,0,1,0,2,1,4
401526925,Boston University Terriers,S. Beneventine,4704699,,False,3.0,0,0,0,0,0,0,0,0,0,1,1,0,0,0,2,0,0
401526925,Boston University Terriers,K. Mingo,4704698,,False,12.0,1,4,1,1,0,3,1,2,0,0,0,0,0,0,1,1,3
401526925,Boston University Terriers,L. Shean,4599727,,False,12.0,0,2,0,1,0,1,0,0,0,0,0,0,0,0,2,0,0
401526925,Boston University Terriers,TEAM,TOTAL,TOTAL,False,,16,58,15,39,1,19,7,11,14,42,56,10,3,6,25,10,40
401519461,Holy Cross Crusaders,L. Berger,4900539,,True,27.0,3,5,3,5,0,0,5,5,1,6,7,1,1,0,3,4,11
401519461,Holy Cross Crusaders,J. Allen,4704714,,True,29.0,7,11,7,11,0,0,2,2,1,4,5,1,0,1,2,3,16
401519461,Holy Cross Crusaders,K. Flanagan,5109211,,True,34.0,1,3,1,2,0,1,0,0,1,2,3,2,0,1,3,0,2
401519461,Holy Cross Crusaders,B. Power-Cassidy,4704715,,True,36.0,7,10,5,6,2,4,5,5,1,4,5,5,1,1,3,1,21
401519461,Holy Cross Crusaders,A. Cross,4595975,,True,21.0,1,5,0,1,1,4,0,0,0,0,0,1,0,0,1,4,3
401519461,Holy Cross Crusaders,C. Wright,4703660,,False,11.0,1,1,1,1,0,0,0,0,1,1,2,0,0,0,0,1,2
401519461,Holy Cross Crusaders,S. Foreman,5109212,,False,19.0,0,2,0,2,0,0,0,0,0,7,7,0,0,0,1,1,0
401519461,Holy Cross Crusaders,C. McCormack,4704716,,False,23.0,3,7,2,4,1,3,4,4,0,2,2,2,1,0,2,1,11
401519461,Holy Cross Crusaders,TEAM,TOTAL,TOTAL,False,,23,44,19,32,4,12,16,16,6,29,35,12,3,3,18,15,66
401519461,Holy Cross Crusaders,L. Berger,4900539,,True,27.0,3,5,3,5,0,0,5,5,1,6,7,1,1,0,3,4,11
401519461,Holy Cross Crusaders,J. Allen,4704714,,True,29.0,7,11,7,11,0,0,2,2,1,4,5,1,0,1,2,3,16
401519461,Holy Cross Crusaders,K. Flanagan,5109211,,True,34.0,1,3,1,2,0,1,0,0,1,2,3,2,0,1,3,0,2
401519461,Holy Cross Crusaders,B. Power-Cassidy,4704715,,True,36.0,7,10,5,6,2,4,5,5,1,4,5,5,1,1,3,1,21
401519461,Holy Cross Crusaders,A. Cross,4595975,,True,21.0,1,5,0,1,1,4,0,0,0,0,0,1,0,0,1,4,3
401519461,Holy Cross Crusaders,C. Wright,4703660,,False,11.0,1,1,1,1,0,0,0,0,1,1,2,0,0,0,0,1,2
401519461,Holy Cross Crusaders,S. Foreman,5109212,,False,19.0,0,2,0,2,0,0,0,0,0,7,7,0,0,0,1,1,0
401519461,Holy Cross Crusaders,C. McCormack,4704716,,False,23.0,3,7,2,4,1,3,4,4,0,2,2,2,1,0,2,1,11
401519461,Holy Cross Crusaders,TEAM,TOTAL,TOTAL,False,,23,44,19,32,4,12,16,16,6,29,35,12,3,3,18,15,66
401519461,Boston University Terriers,C. Weimar,4704495,,True,33.0,4,7,4,7,0,0,2,4,0,0,0,0,3,1,1,4,10
401519461,Boston University Terriers,M. Durant,4599732,,True,27.0,3,9,3,9,0,0,0,0,2,2,4,2,2,1,1,5,6
401519461,Boston University Terriers,A. Giannaros,4899717,,True,34.0,2,7,2,4,0,3,0,0,0,1,1,1,1,0,0,1,4
401519461,Boston University Terriers,M. Pina,4599731,,True,30.0,1,7,0,4,1,3,1,2,0,2,2,1,2,0,1,2,4
401519461,Boston University Terriers,S. Johnson,4599729,,True,29.0,5,11,2,4,3,7,6,6,0,2,2,1,1,0,1,3,19
401519461,Boston University Terriers,S. Crispe,5109197,,False,6.0,1,1,1,1,0,0,0,0,1,0,1,0,1,0,1,2,2
401519461,Boston University Terriers,L. Davenport,4899718,,False,27.0,5,11,4,9,1,2,1,2,0,6,6,1,1,1,1,2,12
401519461,Boston University Terriers,S. Beneventine,4704699,,False,12.0,1,1,0,0,1,1,1,2,0,0,0,1,0,0,0,1,4
401519461,Boston University Terriers,L. Shean,4599727,,False,2.0,0,1,0,0,0,1,0,0,0,0,0,0,0,0,0,0,0
401519461,Boston University Terriers,TEAM,TOTAL,TOTAL,False,,22,55,16,38,6,17,11,16,6,13,19,7,11,3,6,20,61
401519461,Boston University Terriers,C. Weimar,4704495,,True,33.0,4,7,4,7,0,0,2,4,0,0,0,0,3,1,1,4,10
401519461,Boston University Terriers,M. Durant,4599732,,True,27.0,3,9,3,9,0,0,0,0,2,2,4,2,2,1,1,5,6
401519461,Boston University Terriers,A. Giannaros,4899717,,True,34.0,2,7,2,4,0,3,0,0,0,1,1,1,1,0,0,1,4
401519461,Boston University Terriers,M. Pina,4599731,,True,30.0,1,7,0,4,1,3,1,2,0,2,2,1,2,0,1,2,4
401519461,Boston University Terriers,S. Johnson,4599729,,True,29.0,5,11,2,4,3,7,6,6,0,2,2,1,1,0,1,3,19
401519461,Boston University Terriers,S. Crispe,5109197,,False,6.0,1,1,1,1,0,0,0,0,1,0,1,0,1,0,1,2,2
401519461,Boston University Terriers,L. Davenport,4899718,,False,27.0,5,11,4,9,1,2,1,2,0,6,6,1,1,1,1,2,12
401519461,Boston University Terriers,S. Beneventine,4704699,,False,12.0,1,1,0,0,1,1,1,2,0,0,0,1,0,0,0,1,4
401519461,Boston University Terriers,L. Shean,4599727,,False,2.0,0,1,0,0,0,1,0,0,0,0,0,0,0,0,0,0,0
401519461,Boston University Terriers,TEAM,TOTAL,TOTAL,False,,22,55,16,38,6,17,11,16,6,13,19,7,11,3,6,20,61
401519460,Boston University Terriers,C. Weimar,4704495,,True,38.0,9,14,9,14,0,0,3,5,3,11,14,5,0,1,4,4,21
401519460,Boston University Terriers,M. Durant,4599732,,True,42.0,8,13,8,13,0,0,2,4,2,8,10,5,1,0,0,3,18
401519460,Boston University Terriers,A. Giannaros,4899717,,True,37.0,6,9,4,5,2,4,1,1,0,5,5,3,1,0,1,2,15
401519460,Boston University Terriers,M. Pina,4599731,,True,42.0,3,5,2,2,1,3,0,0,0,0,0,3,3,0,0,2,7
401519460,Boston University Terriers,S. Johnson,4599729,,True,39.0,7,18,4,11,3,7,0,0,0,1,1,3,3,1,2,2,17
401519460,Boston University Terriers,S. Crispe,5109197,,False,7.0,0,3,0,3,0,0,0,0,3,2,5,2,0,0,1,0,0
401519460,Boston University Terriers,L. Davenport,4899718,,False,13.0,1,4,1,4,0,0,1,1,1,3,4,0,0,0,1,1,3
401519460,Boston University Terriers,S. Beneventine,4704699,,False,2.0,0,2,0,0,0,2,0,0,0,0,0,0,0,0,1,0,0
401519460,Boston University Terriers,L. Shean,4599727,,False,5.0,1,2,0,1,1,1,0,0,0,1,1,0,0,0,0,0,3
401519460,Boston University Terriers,TEAM,TOTAL,TOTAL,False,,35,70,28,53,7,17,7,11,12,34,46,21,8,2,11,14,84
401519460,Boston University Terriers,C. Weimar,4704495,,True,38.0,9,14,9,14,0,0,3,5,3,11,14,5,0,1,4,4,21
401519460,Boston University Terriers,M. Durant,4599732,,True,42.0,8,13,8,13,0,0,2,4,2,8,10,5,1,0,0,3,18
401519460,Boston University Terriers,A. Giannaros,4899717,,True,37.0,6,9,4,5,2,4,1,1,0,5,5,3,1,0,1,2,15
401519460,Boston University Terriers,M. Pina,4599731,,True,42.0,3,5,2,2,1,3,0,0,0,0,0,3,3,0,0,2,7
401519460,Boston University Terriers,S. Johnson,4599729,,True,39.0,7,18,4,11,3,7,0,0,0,1,1,3,3,1,2,2,17
401519460,Boston University Terriers,S. Crispe,5109197,,False,7.0,0,3,0,3,0,0,0,0,3,2,5,2,0,0,1,0,0
401519460,Boston University Terriers,L. Davenport,4899718,,False,13.0,1,4,1,4,0,0,1,1,1,3,4,0,0,0,1,1,3
401519460,Boston University Terriers,S. Beneventine,4704699,,False,2.0,0,2,0,0,0,2,0,0,0,0,0,0,0,0,1,0,0
401519460,Boston University Terriers,L. Shean,4599727,,False,5.0,1,2,0,1,1,1,0,0,0,1,1,0,0,0,0,0,3
401519460,Boston University Terriers,TEAM,TOTAL,TOTAL,False,,35,70,28,53,7,17,7,11,12,34,46,21,8,2,11,14,84
401519460,Army Black Knights,S. Hunter,4595466,,True,36.0,5,7,5,7,0,0,3,5,5,8,13,2,3,1,3,3,13
401519460,Army Black Knights,K. Hall,4595465,,True,42.0,3,13,3,13,0,0,0,0,4,3,7,3,1,1,4,2,6
401519460,Army Black Knights,R. Ericson,5109190,,True,41.0,7,18,2,5,5,13,0,0,0,2,2,5,1,0,4,0,19
401519460,Army Black Knights,L. Lithgow,4704696,,True,23.0,0,6,0,1,0,5,3,3,0,0,0,0,0,0,1,1,3
401519460,Army Black Knights,H. Brown,4595467,,True,25.0,4,11,0,4,4,7,0,4,3,3,6,1,0,1,0,5,12
401519460,Army Black Knights,T. Hardy,4899714,,False,8.0,0,3,0,2,0,1,0,0,0,2,2,1,0,0,0,3,0
401519460,Army Black Knights,S. McNaughton,4704694,,False,26.0,3,7,1,5,2,2,0,0,2,1,3,0,0,0,2,2,8
401519460,Army Black Knights,N. Rhine,4595464,,False,24.0,2,4,0,1,2,3,1,2,0,2,2,1,0,0,0,1,7
401519460,Army Black Knights,TEAM,TOTAL,TOTAL,False,,24,69,11,38,13,31,7,14,15,23,38,13,5,3,14,17,68
401519460,Army Black Knights,S. Hunter,4595466,,True,36.0,5,7,5,7,0,0,3,5,5,8,13,2,3,1,3,3,13
401519460,Army Black Knights,K. Hall,4595465,,True,42.0,3,13,3,13,0,0,0,0,4,3,7,3,1,1,4,2,6
401519460,Army Black Knights,R. Ericson,5109190,,True,41.0,7,18,2,5,5,13,0,0,0,2,2,5,1,0,4,0,19
401519460,Army Black Knights,L. Lithgow,4704696,,True,23.0,0,6,0,1,0,5,3,3,0,0,0,0,0,0,1,1,3
401519460,Army Black Knights,H. Brown,4595467,,True,25.0,4,11,0,4,4,7,0,4,3,3,6,1,0,1,0,5,12
401519460,Army Black Knights,T. Hardy,4899714,,False,8.0,0,3,0,2,0,1,0,0,0,2,2,1,0,0,0,3,0
401519460,Army Black Knights,S. McNaughton,4704694,,False,26.0,3,7,1,5,2,2,0,0,2,1,3,0,0,0,2,2,8
401519460,Army Black Knights,N. Rhine,4595464,,False,24.0,2,4,0,1,2,3,1,2,0,2,2,1,0,0,0,1,7
401519460,Army Black Knights,TEAM,TOTAL,TOTAL,False,,24,69,11,38,13,31,7,14,15,23,38,13,5,3,14,17,68
401519459,Lehigh Mountain Hawks,L. Fandre,5109220,,True,29.0,6,9,3,4,3,5,1,2,1,5,6,1,1,1,3,2,16
401519459,Lehigh Mountain Hawks,F. Hottinger,4595613,,True,35.0,5,16,5,15,0,1,2,3,5,2,7,2,0,1,2,4,12
401519459,Lehigh Mountain Hawks,K. Van Eps,4900545,,True,12.0,1,2,1,2,0,0,2,2,0,0,0,0,0,0,1,0,4
401519459,Lehigh Mountain Hawks,M. Kramer,4704762,,True,37.0,1,12,1,9,0,3,1,2,1,3,4,2,1,0,0,1,3
401519459,Lehigh Mountain Hawks,A. Harvey,4595612,,True,38.0,1,7,0,2,1,5,0,0,0,2,2,7,1,0,1,1,3
401519459,Lehigh Mountain Hawks,M. O'Brien,4900547,,False,8.0,2,2,2,2,0,0,0,0,1,3,4,1,0,0,1,0,4
401519459,Lehigh Mountain Hawks,E. Stemmer,4900544,,False,22.0,2,4,0,2,2,2,0,0,0,3,3,0,0,0,0,2,6
401519459,Lehigh Mountain Hawks,M. Albrecht,4704763,,False,8.0,0,0,0,0,0,0,0,0,0,1,1,0,0,1,0,0,0
401519459,Lehigh Mountain Hawks,J. Behar,4433782,,False,11.0,2,5,0,1,2,4,0,0,1,3,4,1,1,0,6,2,6
401519459,Lehigh Mountain Hawks,TEAM,TOTAL,TOTAL,False,,20,57,12,37,8,20,6,9,10,24,34,14,4,3,14,12,54
401519459,Lehigh Mountain Hawks,L. Fandre,5109220,,True,29.0,6,9,3,4,3,5,1,2,1,5,6,1,1,1,3,2,16
401519459,Lehigh Mountain Hawks,F. Hottinger,4595613,,True,35.0,5,16,5,15,0,1,2,3,5,2,7,2,0,1,2,4,12
401519459,Lehigh Mountain Hawks,K. Van Eps,4900545,,True,12.0,1,2,1,2,0,0,2,2,0,0,0,0,0,0,1,0,4
401519459,Lehigh Mountain Hawks,M. Kramer,4704762,,True,37.0,1,12,1,9,0,3,1,2,1,3,4,2,1,0,0,1,3
401519459,Lehigh Mountain Hawks,A. Harvey,4595612,,True,38.0,1,7,0,2,1,5,0,0,0,2,2,7,1,0,1,1,3
401519459,Lehigh Mountain Hawks,M. O'Brien,4900547,,False,8.0,2,2,2,2,0,0,0,0,1,3,4,1,0,0,1,0,4
401519459,Lehigh Mountain Hawks,E. Stemmer,4900544,,False,22.0,2,4,0,2,2,2,0,0,0,3,3,0,0,0,0,2,6
401519459,Lehigh Mountain Hawks,M. Albrecht,4704763,,False,8.0,0,0,0,0,0,0,0,0,0,1,1,0,0,1,0,0,0
401519459,Lehigh Mountain Hawks,J. Behar,4433782,,False,11.0,2,5,0,1,2,4,0,0,1,3,4,1,1,0,6,2,6
401519459,Lehigh Mountain Hawks,TEAM,TOTAL,TOTAL,False,,20,57,12,37,8,20,6,9,10,24,34,14,4,3,14,12,54
401519459,Holy Cross Crusaders,L. Berger,4900539,,True,28.0,2,5,2,5,0,0,0,0,2,4,6,5,1,0,2,1,4
401519459,Holy Cross Crusaders,J. Allen,4704714,,True,22.0,3,10,3,10,0,0,1,2,6,4,10,4,0,0,3,2,7
401519459,Holy Cross Crusaders,K. Flanagan,5109211,,True,34.0,3,8,3,7,0,1,0,0,1,5,6,3,1,0,2,2,6
401519459,Holy Cross Crusaders,B. Power-Cassidy,4704715,,True,29.0,10,16,5,6,5,10,2,2,1,6,7,1,0,4,2,4,27
401519459,Holy Cross Crusaders,A. Cross,4595975,,True,35.0,1,3,1,1,0,2,0,0,0,5,5,3,0,0,0,2,2
401519459,Holy Cross Crusaders,C. Wright,4703660,,False,2.0,0,0,0,0,0,0,0,0,0,0,0,0,1,0,0,0,0
401519459,Holy Cross Crusaders,M. Donnelly,5109213,,False,7.0,0,3,0,1,0,2,0,0,1,1,2,0,1,0,0,0,0
401519459,Holy Cross Crusaders,S. Foreman,5109212,,False,18.0,5,9,5,9,0,0,5,5,0,1,1,0,0,0,2,1,15
401519459,Holy Cross Crusaders,C. McCormack,4704716,,False,25.0,4,10,2,7,2,3,0,0,1,2,3,1,0,0,0,3,10
401519459,Holy Cross Crusaders,TEAM,TOTAL,TOTAL,False,,28,64,21,46,7,18,8,9,13,29,42,17,4,4,11,15,71
401519459,Holy Cross Crusaders,L. Berger,4900539,,True,28.0,2,5,2,5,0,0,0,0,2,4,6,5,1,0,2,1,4
401519459,Holy Cross Crusaders,J. Allen,4704714,,True,22.0,3,10,3,10,0,0,1,2,6,4,10,4,0,0,3,2,7
401519459,Holy Cross Crusaders,K. Flanagan,5109211,,True,34.0,3,8,3,7,0,1,0,0,1,5,6,3,1,0,2,2,6
401519459,Holy Cross Crusaders,B. Power-Cassidy,4704715,,True,29.0,10,16,5,6,5,10,2,2,1,6,7,1,0,4,2,4,27
401519459,Holy Cross Crusaders,A. Cross,4595975,,True,35.0,1,3,1,1,0,2,0,0,0,5,5,3,0,0,0,2,2
401519459,Holy Cross Crusaders,C. Wright,4703660,,False,2.0,0,0,0,0,0,0,0,0,0,0,0,0,1,0,0,0,0
401519459,Holy Cross Crusaders,M. Donnelly,5109213,,False,7.0,0,3,0,1,0,2,0,0,1,1,2,0,1,0,0,0,0
401519459,Holy Cross Crusaders,S. Foreman,5109212,,False,18.0,5,9,5,9,0,0,5,5,0,1,1,0,0,0,2,1,15
401519459,Holy Cross Crusaders,C. McCormack,4704716,,False,25.0,4,10,2,7,2,3,0,0,1,2,3,1,0,0,0,3,10
401519459,Holy Cross Crusaders,TEAM,TOTAL,TOTAL,False,,28,64,21,46,7,18,8,9,13,29,42,17,4,4,11,15,71
401519458,Loyola Maryland Greyhounds,L. Therien,4900552,,True,28.0,3,9,3,9,0,0,2,2,2,9,11,1,2,0,2,4,8
401519458,Loyola Maryland Greyhounds,K. Ratigan,5109222,,True,31.0,3,7,1,3,2,4,0,0,1,6,7,0,1,0,2,1,8
401519458,Loyola Maryland Greyhounds,B. Rozzi,4596306,,True,37.0,3,7,2,4,1,3,2,2,0,5,5,3,0,0,1,0,9
401519458,Loyola Maryland Greyhounds,T. Dixon,4400209,,True,34.0,4,10,3,8,1,2,2,2,0,3,3,1,1,0,1,1,11
401519458,Loyola Maryland Greyhounds,D. Newman,4399474,,True,33.0,5,17,4,14,1,3,0,0,1,1,2,1,1,0,1,2,11
401519458,Loyola Maryland Greyhounds,M. Espinal,5109228,,False,12.0,0,2,0,2,0,0,0,0,1,2,3,0,0,0,4,3,0
401519458,Loyola Maryland Greyhounds,A. Therien,4596307,,False,1.0,0,0,0,0,0,0,0,0,0,0,0,0,0,0,0,1,0
401519458,Loyola Maryland Greyhounds,C. Orza,5109227,,False,0.0,0,0,0,0,0,0,0,0,0,0,0,0,0,0,0,0,0
401519458,Loyola Maryland Greyhounds,C. Garcia,5109224,,False,10.0,1,3,1,3,0,0,0,0,0,0,0,0,0,0,0,2,2
401519458,Loyola Maryland Greyhounds,L. Salmeron,4900549,,False,1.0,0,0,0,0,0,0,0,0,0,0,0,0,0,0,0,0,0
401519458,Loyola Maryland Greyhounds,C. Tanedo,4704774,,False,13.0,1,3,0,2,1,1,0,0,2,0,2,0,1,0,1,0,3
401519458,Loyola Maryland Greyhounds,TEAM,TOTAL,TOTAL,False,,20,58,14,45,6,13,6,6,10,28,38,6,6,0,14,14,52
401519458,Loyola Maryland Greyhounds,L. Therien,4900552,,True,28.0,3,9,3,9,0,0,2,2,2,9,11,1,2,0,2,4,8
401519458,Loyola Maryland Greyhounds,K. Ratigan,5109222,,True,31.0,3,7,1,3,2,4,0,0,1,6,7,0,1,0,2,1,8
401519458,Loyola Maryland Greyhounds,B. Rozzi,4596306,,True,37.0,3,7,2,4,1,3,2,2,0,5,5,3,0,0,1,0,9
401519458,Loyola Maryland Greyhounds,T. Dixon,4400209,,True,34.0,4,10,3,8,1,2,2,2,0,3,3,1,1,0,1,1,11
401519458,Loyola Maryland Greyhounds,D. Newman,4399474,,True,33.0,5,17,4,14,1,3,0,0,1,1,2,1,1,0,1,2,11
401519458,Loyola Maryland Greyhounds,M. Espinal,5109228,,False,12.0,0,2,0,2,0,0,0,0,1,2,3,0,0,0,4,3,0
401519458,Loyola Maryland Greyhounds,A. Therien,4596307,,False,1.0,0,0,0,0,0,0,0,0,0,0,0,0,0,0,0,1,0
401519458,Loyola Maryland Greyhounds,C. Orza,5109227,,False,0.0,0,0,0,0,0,0,0,0,0,0,0,0,0,0,0,0,0
401519458,Loyola Maryland Greyhounds,C. Garcia,5109224,,False,10.0,1,3,1,3,0,0,0,0,0,0,0,0,0,0,0,2,2
401519458,Loyola Maryland Greyhounds,L. Salmeron,4900549,,False,1.0,0,0,0,0,0,0,0,0,0,0,0,0,0,0,0,0,0
401519458,Loyola Maryland Greyhounds,C. Tanedo,4704774,,False,13.0,1,3,0,2,1,1,0,0,2,0,2,0,1,0,1,0,3
401519458,Loyola Maryland Greyhounds,TEAM,TOTAL,TOTAL,False,,20,58,14,45,6,13,6,6,10,28,38,6,6,0,14,14,52
401519458,Boston University Terriers,M. Durant,4599732,,True,37.0,5,6,5,6,0,0,2,3,1,14,15,2,2,6,1,2,12
401519458,Boston University Terriers,L. Davenport,4899718,,True,26.0,5,13,1,6,4,7,0,1,0,3,3,0,1,0,1,2,14
401519458,Boston University Terriers,A. Giannaros,4899717,,True,31.0,6,14,0,2,6,12,0,0,0,3,3,4,1,0,1,0,18
401519458,Boston University Terriers,M. Pina,4599731,,True,23.0,1,6,1,3,0,3,0,0,0,0,0,2,2,0,1,1,2
401519458,Boston University Terriers,S. Johnson,4599729,,True,37.0,4,9,3,5,1,4,2,5,2,1,3,8,1,0,0,2,11
401519458,Boston University Terriers,S. Crispe,5109197,,False,17.0,3,5,3,4,0,1,0,0,1,3,4,2,0,0,2,3,6
401519458,Boston University Terriers,A. Semenova,5109196,,False,2.0,0,0,0,0,0,0,0,0,0,0,0,0,0,0,0,0,0
401519458,Boston University Terriers,S. Beneventine,4704699,,False,18.0,1,3,0,1,1,2,0,0,0,0,0,2,1,0,1,0,3
401519458,Boston University Terriers,K. Mingo,4704698,,False,2.0,0,0,0,0,0,0,0,0,0,0,0,0,0,0,0,0,0
401519458,Boston University Terriers,L. Shean,4599727,,False,7.0,0,0,0,0,0,0,0,0,1,2,3,0,0,0,3,0,0
401519458,Boston University Terriers,TEAM,TOTAL,TOTAL,False,,25,56,13,27,12,29,4,9,5,27,32,20,8,6,10,10,66
401519458,Boston University Terriers,M. Durant,4599732,,True,37.0,5,6,5,6,0,0,2,3,1,14,15,2,2,6,1,2,12
401519458,Boston University Terriers,L. Davenport,4899718,,True,26.0,5,13,1,6,4,7,0,1,0,3,3,0,1,0,1,2,14
401519458,Boston University Terriers,A. Giannaros,4899717,,True,31.0,6,14,0,2,6,12,0,0,0,3,3,4,1,0,1,0,18
401519458,Boston University Terriers,M. Pina,4599731,,True,23.0,1,6,1,3,0,3,0,0,0,0,0,2,2,0,1,1,2
401519458,Boston University Terriers,S. Johnson,4599729,,True,37.0,4,9,3,5,1,4,2,5,2,1,3,8,1,0,0,2,11
401519458,Boston University Terriers,S. Crispe,5109197,,False,17.0,3,5,3,4,0,1,0,0,1,3,4,2,0,0,2,3,6
401519458,Boston University Terriers,A. Semenova,5109196,,False,2.0,0,0,0,0,0,0,0,0,0,0,0,0,0,0,0,0,0
401519458,Boston University Terriers,S. Beneventine,4704699,,False,18.0,1,3,0,1,1,2,0,0,0,0,0,2,1,0,1,0,3
401519458,Boston University Terriers,K. Mingo,4704698,,False,2.0,0,0,0,0,0,0,0,0,0,0,0,0,0,0,0,0,0
401519458,Boston University Terriers,L. Shean,4599727,,False,7.0,0,0,0,0,0,0,0,0,1,2,3,0,0,0,3,0,0
401519458,Boston University Terriers,TEAM,TOTAL,TOTAL,False,,25,56,13,27,12,29,4,9,5,27,32,20,8,6,10,10,66
401519456,Colgate Raiders,T. McMillan,4704704,,True,38.0,4,10,4,10,0,0,6,6,2,6,8,1,0,1,2,2,14
401519456,Colgate Raiders,C. Midgette,5109204,,True,16.0,0,1,0,1,0,0,1,2,0,0,0,1,0,0,2,2,1
401519456,Colgate Raiders,M. Schiller,5109205,,True,34.0,0,1,0,1,0,0,0,0,2,6,8,2,1,0,1,3,0
401519456,Colgate Raiders,T. Golembiewski,4900535,,True,30.0,5,13,4,11,1,2,1,2,1,4,5,0,2,1,3,4,12
401519456,Colgate Raiders,A. Brodie,4595550,,True,34.0,1,11,0,9,1,2,5,6,0,0,0,4,0,0,2,3,8
401519456,Colgate Raiders,S. Diehl,4900536,,False,13.0,1,4,1,3,0,1,1,2,0,2,2,1,0,0,0,1,3
401519456,Colgate Raiders,L. Blackmore,4704706,,False,8.0,0,1,0,1,0,0,0,0,2,0,2,0,0,0,0,0,0
401519456,Colgate Raiders,L. Cook,5109207,,False,9.0,2,2,2,2,0,0,0,0,1,2,3,0,0,0,1,0,4
401519456,Colgate Raiders,M. McMahon,4900534,,False,15.0,3,8,3,8,0,0,2,3,0,1,1,2,0,0,2,4,8
401519456,Colgate Raiders,J. Paul,4595552,,False,3.0,0,0,0,0,0,0,0,0,0,1,1,0,1,0,0,0,0
401519456,Colgate Raiders,TEAM,TOTAL,TOTAL,False,,16,51,14,46,2,5,16,21,9,24,33,11,4,2,13,19,50
401519456,Colgate Raiders,T. McMillan,4704704,,True,38.0,4,10,4,10,0,0,6,6,2,6,8,1,0,1,2,2,14
401519456,Colgate Raiders,C. Midgette,5109204,,True,16.0,0,1,0,1,0,0,1,2,0,0,0,1,0,0,2,2,1
401519456,Colgate Raiders,M. Schiller,5109205,,True,34.0,0,1,0,1,0,0,0,0,2,6,8,2,1,0,1,3,0
401519456,Colgate Raiders,T. Golembiewski,4900535,,True,30.0,5,13,4,11,1,2,1,2,1,4,5,0,2,1,3,4,12
401519456,Colgate Raiders,A. Brodie,4595550,,True,34.0,1,11,0,9,1,2,5,6,0,0,0,4,0,0,2,3,8
401519456,Colgate Raiders,S. Diehl,4900536,,False,13.0,1,4,1,3,0,1,1,2,0,2,2,1,0,0,0,1,3
401519456,Colgate Raiders,L. Blackmore,4704706,,False,8.0,0,1,0,1,0,0,0,0,2,0,2,0,0,0,0,0,0
401519456,Colgate Raiders,L. Cook,5109207,,False,9.0,2,2,2,2,0,0,0,0,1,2,3,0,0,0,1,0,4
401519456,Colgate Raiders,M. McMahon,4900534,,False,15.0,3,8,3,8,0,0,2,3,0,1,1,2,0,0,2,4,8
401519456,Colgate Raiders,J. Paul,4595552,,False,3.0,0,0,0,0,0,0,0,0,0,1,1,0,1,0,0,0,0
401519456,Colgate Raiders,TEAM,TOTAL,TOTAL,False,,16,51,14,46,2,5,16,21,9,24,33,11,4,2,13,19,50
401519456,Army Black Knights,S. Hunter,4595466,,True,31.0,4,6,4,6,0,0,8,10,4,9,13,0,1,1,4,4,16
401519456,Army Black Knights,K. Hall,4595465,,True,27.0,1,7,1,7,0,0,2,4,1,5,6,3,0,1,2,4,4
401519456,Army Black Knights,R. Ericson,5109190,,True,39.0,7,14,3,8,4,6,1,2,0,4,4,0,1,0,2,3,19
401519456,Army Black Knights,L. Lithgow,4704696,,True,18.0,0,1,0,1,0,0,0,0,0,0,0,0,0,0,2,2,0
401519456,Army Black Knights,H. Brown,4595467,,True,29.0,2,6,2,5,0,1,2,4,0,4,4,1,1,0,2,2,6
401519456,Army Black Knights,T. Hardy,4899714,,False,26.0,0,5,0,4,0,1,3,4,1,3,4,2,3,1,4,0,3
401519456,Army Black Knights,S. McNaughton,4704694,,False,12.0,0,0,0,0,0,0,4,4,0,1,1,1,0,0,0,2,4
401519456,Army Black Knights,N. Rhine,4595464,,False,18.0,1,6,0,2,1,4,0,0,0,1,1,0,0,0,0,1,3
401519456,Army Black Knights,TEAM,TOTAL,TOTAL,False,,15,45,10,33,5,12,20,28,8,29,37,7,6,3,16,18,55
401519456,Army Black Knights,S. Hunter,4595466,,True,31.0,4,6,4,6,0,0,8,10,4,9,13,0,1,1,4,4,16
401519456,Army Black Knights,K. Hall,4595465,,True,27.0,1,7,1,7,0,0,2,4,1,5,6,3,0,1,2,4,4
401519456,Army Black Knights,R. Ericson,5109190,,True,39.0,7,14,3,8,4,6,1,2,0,4,4,0,1,0,2,3,19
401519456,Army Black Knights,L. Lithgow,4704696,,True,18.0,0,1,0,1,0,0,0,0,0,0,0,0,0,0,2,2,0
401519456,Army Black Knights,H. Brown,4595467,,True,29.0,2,6,2,5,0,1,2,4,0,4,4,1,1,0,2,2,6
401519456,Army Black Knights,T. Hardy,4899714,,False,26.0,0,5,0,4,0,1,3,4,1,3,4,2,3,1,4,0,3
401519456,Army Black Knights,S. McNaughton,4704694,,False,12.0,0,0,0,0,0,0,4,4,0,1,1,1,0,0,0,2,4
401519456,Army Black Knights,N. Rhine,4595464,,False,18.0,1,6,0,2,1,4,0,0,0,1,1,0,0,0,0,1,3
401519456,Army Black Knights,TEAM,TOTAL,TOTAL,False,,15,45,10,33,5,12,20,28,8,29,37,7,6,3,16,18,55
401519455,Lehigh Mountain Hawks,L. Fandre,5109220,,True,29.0,2,5,0,1,2,4,0,0,0,4,4,4,1,2,1,1,6
401519455,Lehigh Mountain Hawks,F. Hottinger,4595613,,True,35.0,8,16,6,12,2,4,7,8,4,6,10,0,0,0,4,1,25
401519455,Lehigh Mountain Hawks,K. Van Eps,4900545,,True,9.0,0,0,0,0,0,0,0,0,0,1,1,0,0,0,2,2,0
401519455,Lehigh Mountain Hawks,M. Kramer,4704762,,True,39.0,11,21,9,16,2,5,6,6,0,6,6,3,1,0,2,1,30
401519455,Lehigh Mountain Hawks,A. Harvey,4595612,,True,40.0,0,5,0,2,0,3,0,0,0,6,6,2,0,0,0,2,0
401519455,Lehigh Mountain Hawks,M. O'Brien,4900547,,False,10.0,0,1,0,0,0,1,0,0,0,2,2,1,0,0,0,0,0
401519455,Lehigh Mountain Hawks,E. Stemmer,4900544,,False,25.0,1,5,1,1,0,4,0,0,0,2,2,1,0,1,0,4,2
401519455,Lehigh Mountain Hawks,M. Albrecht,4704763,,False,7.0,0,0,0,0,0,0,0,0,0,0,0,0,0,1,1,0,0
401519455,Lehigh Mountain Hawks,J. Behar,4433782,,False,6.0,0,2,0,1,0,1,0,0,0,1,1,0,0,0,1,2,0
401519455,Lehigh Mountain Hawks,TEAM,TOTAL,TOTAL,False,,22,55,16,33,6,22,13,14,7,28,35,11,2,4,11,13,63
401519455,Lehigh Mountain Hawks,L. Fandre,5109220,,True,29.0,2,5,0,1,2,4,0,0,0,4,4,4,1,2,1,1,6
401519455,Lehigh Mountain Hawks,F. Hottinger,4595613,,True,35.0,8,16,6,12,2,4,7,8,4,6,10,0,0,0,4,1,25
401519455,Lehigh Mountain Hawks,K. Van Eps,4900545,,True,9.0,0,0,0,0,0,0,0,0,0,1,1,0,0,0,2,2,0
401519455,Lehigh Mountain Hawks,M. Kramer,4704762,,True,39.0,11,21,9,16,2,5,6,6,0,6,6,3,1,0,2,1,30
401519455,Lehigh Mountain Hawks,A. Harvey,4595612,,True,40.0,0,5,0,2,0,3,0,0,0,6,6,2,0,0,0,2,0
401519455,Lehigh Mountain Hawks,M. O'Brien,4900547,,False,10.0,0,1,0,0,0,1,0,0,0,2,2,1,0,0,0,0,0
401519455,Lehigh Mountain Hawks,E. Stemmer,4900544,,False,25.0,1,5,1,1,0,4,0,0,0,2,2,1,0,1,0,4,2
401519455,Lehigh Mountain Hawks,M. Albrecht,4704763,,False,7.0,0,0,0,0,0,0,0,0,0,0,0,0,0,1,1,0,0
401519455,Lehigh Mountain Hawks,J. Behar,4433782,,False,6.0,0,2,0,1,0,1,0,0,0,1,1,0,0,0,1,2,0
401519455,Lehigh Mountain Hawks,TEAM,TOTAL,TOTAL,False,,22,55,16,33,6,22,13,14,7,28,35,11,2,4,11,13,63
401519455,Bucknell Bison,I. King,4900533,,True,35.0,3,7,3,3,0,4,0,0,0,1,1,2,0,0,1,3,6
401519455,Bucknell Bison,E. Shaffer,4595535,,True,30.0,5,12,5,12,0,0,1,2,2,5,7,2,2,0,1,3,11
401519455,Bucknell Bison,E. Theodorsson,5109199,,True,22.0,4,6,3,5,1,1,0,0,0,4,4,0,0,0,2,3,9
401519455,Bucknell Bison,C. Collins,4900532,,True,34.0,8,17,6,14,2,3,3,3,0,6,6,2,1,2,0,2,21
401519455,Bucknell Bison,T. Johnson,4595533,,True,37.0,1,9,1,9,0,0,0,0,0,4,4,0,0,0,3,4,2
401519455,Bucknell Bison,R. Sisselman,4900531,,False,18.0,1,5,1,2,0,3,0,0,0,3,3,0,0,0,2,0,2
401519455,Bucknell Bison,J. Kulesza,4704702,,False,5.0,0,1,0,0,0,1,0,0,0,0,0,0,0,0,0,0,0
401519455,Bucknell Bison,C. Dingler,4577540,,False,19.0,2,3,2,3,0,0,0,0,1,2,3,1,0,0,0,0,4
401519455,Bucknell Bison,TEAM,TOTAL,TOTAL,False,,24,60,21,48,3,12,4,5,6,26,32,7,3,2,9,15,55
401519455,Bucknell Bison,I. King,4900533,,True,35.0,3,7,3,3,0,4,0,0,0,1,1,2,0,0,1,3,6
401519455,Bucknell Bison,E. Shaffer,4595535,,True,30.0,5,12,5,12,0,0,1,2,2,5,7,2,2,0,1,3,11
401519455,Bucknell Bison,E. Theodorsson,5109199,,True,22.0,4,6,3,5,1,1,0,0,0,4,4,0,0,0,2,3,9
401519455,Bucknell Bison,C. Collins,4900532,,True,34.0,8,17,6,14,2,3,3,3,0,6,6,2,1,2,0,2,21
401519455,Bucknell Bison,T. Johnson,4595533,,True,37.0,1,9,1,9,0,0,0,0,0,4,4,0,0,0,3,4,2
401519455,Bucknell Bison,R. Sisselman,4900531,,False,18.0,1,5,1,2,0,3,0,0,0,3,3,0,0,0,2,0,2
401519455,Bucknell Bison,J. Kulesza,4704702,,False,5.0,0,1,0,0,0,1,0,0,0,0,0,0,0,0,0,0,0
401519455,Bucknell Bison,C. Dingler,4577540,,False,19.0,2,3,2,3,0,0,0,0,1,2,3,1,0,0,0,0,4
401519455,Bucknell Bison,TEAM,TOTAL,TOTAL,False,,24,60,21,48,3,12,4,5,6,26,32,7,3,2,9,15,55
401519454,Holy Cross Crusaders,L. Berger,4900539,,True,22.0,2,4,2,4,0,0,0,0,0,3,3,0,0,0,0,4,4
401519454,Holy Cross Crusaders,J. Allen,4704714,,True,28.0,6,11,6,11,0,0,7,10,3,4,7,3,1,0,2,2,19
401519454,Holy Cross Crusaders,K. Flanagan,5109211,,True,27.0,2,4,1,2,1,2,0,0,0,2,2,2,1,0,1,1,5
401519454,Holy Cross Crusaders,B. Power-Cassidy,4704715,,True,26.0,4,10,2,6,2,4,2,2,0,3,3,2,2,0,3,3,12
401519454,Holy Cross Crusaders,A. Cross,4595975,,True,22.0,1,2,1,1,0,1,0,0,0,2,2,0,2,0,2,1,2
401519454,Holy Cross Crusaders,M. Cahalan,5109210,,False,2.0,1,1,1,1,0,0,0,0,0,0,0,0,0,0,0,0,2
401519454,Holy Cross Crusaders,C. Wright,4703660,,False,13.0,1,1,1,1,0,0,0,0,0,0,0,0,1,0,1,4,2
401519454,Holy Cross Crusaders,M. Donnelly,5109213,,False,11.0,3,4,2,2,1,2,0,0,0,5,5,2,0,1,2,0,7
401519454,Holy Cross Crusaders,S. Foreman,5109212,,False,16.0,4,4,4,4,0,0,0,0,0,5,5,1,1,0,2,1,8
401519454,Holy Cross Crusaders,L. Huber,4900538,,False,2.0,0,0,0,0,0,0,0,0,0,1,1,1,0,0,0,0,0
401519454,Holy Cross Crusaders,G. Munt,4900537,,False,4.0,0,0,0,0,0,0,0,0,0,1,1,0,0,0,0,0,0
401519454,Holy Cross Crusaders,C. McCormack,4704716,,False,27.0,4,5,2,2,2,3,2,4,0,2,2,1,1,0,2,3,12
401519454,Holy Cross Crusaders,TEAM,TOTAL,TOTAL,False,,28,46,22,34,6,12,11,16,5,28,33,12,9,1,15,19,73
401519454,Holy Cross Crusaders,L. Berger,4900539,,True,22.0,2,4,2,4,0,0,0,0,0,3,3,0,0,0,0,4,4
401519454,Holy Cross Crusaders,J. Allen,4704714,,True,28.0,6,11,6,11,0,0,7,10,3,4,7,3,1,0,2,2,19
401519454,Holy Cross Crusaders,K. Flanagan,5109211,,True,27.0,2,4,1,2,1,2,0,0,0,2,2,2,1,0,1,1,5
401519454,Holy Cross Crusaders,B. Power-Cassidy,4704715,,True,26.0,4,10,2,6,2,4,2,2,0,3,3,2,2,0,3,3,12
401519454,Holy Cross Crusaders,A. Cross,4595975,,True,22.0,1,2,1,1,0,1,0,0,0,2,2,0,2,0,2,1,2
401519454,Holy Cross Crusaders,M. Cahalan,5109210,,False,2.0,1,1,1,1,0,0,0,0,0,0,0,0,0,0,0,0,2
401519454,Holy Cross Crusaders,C. Wright,4703660,,False,13.0,1,1,1,1,0,0,0,0,0,0,0,0,1,0,1,4,2
401519454,Holy Cross Crusaders,M. Donnelly,5109213,,False,11.0,3,4,2,2,1,2,0,0,0,5,5,2,0,1,2,0,7
401519454,Holy Cross Crusaders,S. Foreman,5109212,,False,16.0,4,4,4,4,0,0,0,0,0,5,5,1,1,0,2,1,8
401519454,Holy Cross Crusaders,L. Huber,4900538,,False,2.0,0,0,0,0,0,0,0,0,0,1,1,1,0,0,0,0,0
401519454,Holy Cross Crusaders,G. Munt,4900537,,False,4.0,0,0,0,0,0,0,0,0,0,1,1,0,0,0,0,0,0
401519454,Holy Cross Crusaders,C. McCormack,4704716,,False,27.0,4,5,2,2,2,3,2,4,0,2,2,1,1,0,2,3,12
401519454,Holy Cross Crusaders,TEAM,TOTAL,TOTAL,False,,28,46,22,34,6,12,11,16,5,28,33,12,9,1,15,19,73
401519454,American University Eagles,E. Johns,4704688,,True,11.0,1,7,1,6,0,1,0,0,0,0,0,1,1,0,6,5,2
401519454,American University Eagles,L. Stack,4595455,,True,38.0,6,13,5,12,1,1,3,6,6,5,11,1,2,0,1,3,16
401519454,American University Eagles,K. Henning,4704686,,True,28.0,1,4,1,4,0,0,3,4,0,0,0,2,1,0,2,1,5
401519454,American University Eagles,I. Bales,4704685,,True,31.0,2,5,2,5,0,0,2,2,2,4,6,1,3,0,5,2,6
401519454,American University Eagles,S. Stetson,4595453,,True,32.0,2,8,1,4,1,4,1,1,0,3,3,2,4,0,1,1,6
401519454,American University Eagles,M. Lavin,5109188,,False,19.0,0,4,0,2,0,2,0,0,1,2,3,0,0,0,1,0,0
401519454,American University Eagles,M. Lee,4704592,,False,5.0,0,1,0,1,0,0,0,0,0,1,1,0,0,0,0,1,0
401519454,American University Eagles,L. Nogues,5109187,,False,6.0,0,1,0,0,0,1,0,0,0,0,0,0,0,0,0,1,0
401519454,American University Eagles,A. Rescifina,5109186,,False,4.0,2,3,2,3,0,0,1,1,1,0,1,0,0,0,1,0,5
401519454,American University Eagles,B. Garbee,4899710,,False,9.0,0,1,0,0,0,1,0,0,0,0,0,0,0,0,0,1,0
401519454,American University Eagles,A. LeMaster,4703737,,False,17.0,1,5,0,1,1,4,1,2,0,1,1,0,1,0,0,5,4
401519454,American University Eagles,TEAM,TOTAL,TOTAL,False,,15,52,12,38,3,14,11,16,12,17,29,7,12,0,17,20,44
401519454,American University Eagles,E. Johns,4704688,,True,11.0,1,7,1,6,0,1,0,0,0,0,0,1,1,0,6,5,2
401519454,American University Eagles,L. Stack,4595455,,True,38.0,6,13,5,12,1,1,3,6,6,5,11,1,2,0,1,3,16
401519454,American University Eagles,K. Henning,4704686,,True,28.0,1,4,1,4,0,0,3,4,0,0,0,2,1,0,2,1,5
401519454,American University Eagles,I. Bales,4704685,,True,31.0,2,5,2,5,0,0,2,2,2,4,6,1,3,0,5,2,6
401519454,American University Eagles,S. Stetson,4595453,,True,32.0,2,8,1,4,1,4,1,1,0,3,3,2,4,0,1,1,6
401519454,American University Eagles,M. Lavin,5109188,,False,19.0,0,4,0,2,0,2,0,0,1,2,3,0,0,0,1,0,0
401519454,American University Eagles,M. Lee,4704592,,False,5.0,0,1,0,1,0,0,0,0,0,1,1,0,0,0,0,1,0
401519454,American University Eagles,L. Nogues,5109187,,False,6.0,0,1,0,0,0,1,0,0,0,0,0,0,0,0,0,1,0
401519454,American University Eagles,A. Rescifina,5109186,,False,4.0,2,3,2,3,0,0,1,1,1,0,1,0,0,0,1,0,5
401519454,American University Eagles,B. Garbee,4899710,,False,9.0,0,1,0,0,0,1,0,0,0,0,0,0,0,0,0,1,0
401519454,American University Eagles,A. LeMaster,4703737,,False,17.0,1,5,0,1,1,4,1,2,0,1,1,0,1,0,0,5,4
401519454,American University Eagles,TEAM,TOTAL,TOTAL,False,,15,52,12,38,3,14,11,16,12,17,29,7,12,0,17,20,44
401519452,Loyola Maryland Greyhounds,L. Therien,4900552,,True,37.0,6,13,6,12,0,1,5,9,3,18,21,3,2,0,5,3,17
401519452,Loyola Maryland Greyhounds,K. Ratigan,5109222,,True,38.0,4,8,2,4,2,4,0,1,0,1,1,3,0,0,1,2,10
401519452,Loyola Maryland Greyhounds,B. Rozzi,4596306,,True,36.0,1,4,0,1,1,3,2,2,0,2,2,5,1,0,2,3,5
401519452,Loyola Maryland Greyhounds,T. Dixon,4400209,,True,35.0,3,9,1,3,2,6,4,4,0,2,2,2,0,0,1,1,12
401519452,Loyola Maryland Greyhounds,D. Newman,4399474,,True,33.0,8,13,7,12,1,1,0,0,2,3,5,3,1,0,1,0,17
401519452,Loyola Maryland Greyhounds,M. Espinal,5109228,,False,4.0,0,2,0,2,0,0,0,0,1,1,2,0,0,0,0,1,0
401519452,Loyola Maryland Greyhounds,C. Garcia,5109224,,False,11.0,0,2,0,1,0,1,0,0,0,0,0,1,0,0,0,2,0
401519452,Loyola Maryland Greyhounds,L. Salmeron,4900549,,False,1.0,0,0,0,0,0,0,0,0,0,0,0,0,0,0,0,0,0
401519452,Loyola Maryland Greyhounds,C. Tanedo,4704774,,False,5.0,0,0,0,0,0,0,0,0,1,0,1,1,0,0,0,0,0
401519452,Loyola Maryland Greyhounds,TEAM,TOTAL,TOTAL,False,,22,51,16,35,6,16,11,16,8,28,36,18,4,0,10,12,61
401519452,Loyola Maryland Greyhounds,L. Therien,4900552,,True,37.0,6,13,6,12,0,1,5,9,3,18,21,3,2,0,5,3,17
401519452,Loyola Maryland Greyhounds,K. Ratigan,5109222,,True,38.0,4,8,2,4,2,4,0,1,0,1,1,3,0,0,1,2,10
401519452,Loyola Maryland Greyhounds,B. Rozzi,4596306,,True,36.0,1,4,0,1,1,3,2,2,0,2,2,5,1,0,2,3,5
401519452,Loyola Maryland Greyhounds,T. Dixon,4400209,,True,35.0,3,9,1,3,2,6,4,4,0,2,2,2,0,0,1,1,12
401519452,Loyola Maryland Greyhounds,D. Newman,4399474,,True,33.0,8,13,7,12,1,1,0,0,2,3,5,3,1,0,1,0,17
401519452,Loyola Maryland Greyhounds,M. Espinal,5109228,,False,4.0,0,2,0,2,0,0,0,0,1,1,2,0,0,0,0,1,0
401519452,Loyola Maryland Greyhounds,C. Garcia,5109224,,False,11.0,0,2,0,1,0,1,0,0,0,0,0,1,0,0,0,2,0
401519452,Loyola Maryland Greyhounds,L. Salmeron,4900549,,False,1.0,0,0,0,0,0,0,0,0,0,0,0,0,0,0,0,0,0
401519452,Loyola Maryland Greyhounds,C. Tanedo,4704774,,False,5.0,0,0,0,0,0,0,0,0,1,0,1,1,0,0,0,0,0
401519452,Loyola Maryland Greyhounds,TEAM,TOTAL,TOTAL,False,,22,51,16,35,6,16,11,16,8,28,36,18,4,0,10,12,61
401519452,Lafayette Leopards,A. Matthews,4703689,,True,32.0,2,6,2,6,0,0,0,0,2,5,7,1,1,2,1,4,4
401519452,Lafayette Leopards,S. Ntaconayigize,5109216,,True,34.0,2,5,1,2,1,3,0,0,0,1,1,3,0,0,2,0,5
401519452,Lafayette Leopards,K. Donahue,5109215,,True,33.0,4,14,1,6,3,8,0,0,0,6,6,1,0,1,3,3,11
401519452,Lafayette Leopards,A. Antognoli,4900540,,True,40.0,5,12,4,6,1,6,2,2,1,2,3,5,2,0,0,1,13
401519452,Lafayette Leopards,M. Andrews,4704756,,True,35.0,6,13,6,12,0,1,2,2,1,7,8,0,0,1,4,3,14
401519452,Lafayette Leopards,K. Favours,4900541,,False,26.0,2,4,1,2,1,2,0,0,0,1,1,0,1,0,1,3,5
401519452,Lafayette Leopards,TEAM,TOTAL,TOTAL,False,,21,54,15,34,6,20,4,4,5,24,29,10,4,4,11,14,52
401519452,Lafayette Leopards,A. Matthews,4703689,,True,32.0,2,6,2,6,0,0,0,0,2,5,7,1,1,2,1,4,4
401519452,Lafayette Leopards,S. Ntaconayigize,5109216,,True,34.0,2,5,1,2,1,3,0,0,0,1,1,3,0,0,2,0,5
401519452,Lafayette Leopards,K. Donahue,5109215,,True,33.0,4,14,1,6,3,8,0,0,0,6,6,1,0,1,3,3,11
401519452,Lafayette Leopards,A. Antognoli,4900540,,True,40.0,5,12,4,6,1,6,2,2,1,2,3,5,2,0,0,1,13
401519452,Lafayette Leopards,M. Andrews,4704756,,True,35.0,6,13,6,12,0,1,2,2,1,7,8,0,0,1,4,3,14
401519452,Lafayette Leopards,K. Favours,4900541,,False,26.0,2,4,1,2,1,2,0,0,0,1,1,0,1,0,1,3,5
401519452,Lafayette Leopards,TEAM,TOTAL,TOTAL,False,,21,54,15,34,6,20,4,4,5,24,29,10,4,4,11,14,52
401519451,Navy Midshipmen,M. Andrews,4704780,,True,25.0,0,2,0,2,0,0,0,0,2,2,4,2,1,0,2,2,0
401519451,Navy Midshipmen,L. Llewellyn,4595625,,True,26.0,7,18,5,10,2,8,3,3,0,3,3,1,1,0,2,4,19
401519451,Navy Midshipmen,K. Samson,5109237,,True,26.0,3,6,3,6,0,0,0,1,4,4,8,2,0,2,0,2,6
401519451,Navy Midshipmen,M. Louridas,5109236,,True,31.0,4,8,2,3,2,5,0,0,0,3,3,2,1,0,3,3,10
401519451,Navy Midshipmen,M. Schrader,4595622,,True,12.0,1,2,1,1,0,1,0,0,0,0,0,2,1,0,1,1,2
401519451,Navy Midshipmen,M. Demos,5109235,,False,13.0,2,3,2,3,0,0,2,2,2,2,4,1,0,0,1,2,6
401519451,Navy Midshipmen,B. Coleman,5109233,,False,5.0,0,0,0,0,0,0,0,0,0,0,0,0,0,0,1,0,0
401519451,Navy Midshipmen,K. Giuliani,5109230,,False,0.0,0,0,0,0,0,0,0,0,0,0,0,0,0,0,0,0,0
401519451,Navy Midshipmen,S. Watts,4704782,,False,30.0,6,12,3,4,3,8,2,2,0,4,4,1,1,0,1,3,17
401519451,Navy Midshipmen,S. Schofield,4704779,,False,32.0,4,11,1,3,3,8,0,0,0,1,1,4,1,0,2,2,11
401519451,Navy Midshipmen,TEAM,TOTAL,TOTAL,False,,27,62,17,32,10,30,7,8,10,21,31,15,6,2,13,19,71
401519451,Navy Midshipmen,M. Andrews,4704780,,True,25.0,0,2,0,2,0,0,0,0,2,2,4,2,1,0,2,2,0
401519451,Navy Midshipmen,L. Llewellyn,4595625,,True,26.0,7,18,5,10,2,8,3,3,0,3,3,1,1,0,2,4,19
401519451,Navy Midshipmen,K. Samson,5109237,,True,26.0,3,6,3,6,0,0,0,1,4,4,8,2,0,2,0,2,6
401519451,Navy Midshipmen,M. Louridas,5109236,,True,31.0,4,8,2,3,2,5,0,0,0,3,3,2,1,0,3,3,10
401519451,Navy Midshipmen,M. Schrader,4595622,,True,12.0,1,2,1,1,0,1,0,0,0,0,0,2,1,0,1,1,2
401519451,Navy Midshipmen,M. Demos,5109235,,False,13.0,2,3,2,3,0,0,2,2,2,2,4,1,0,0,1,2,6
401519451,Navy Midshipmen,B. Coleman,5109233,,False,5.0,0,0,0,0,0,0,0,0,0,0,0,0,0,0,1,0,0
401519451,Navy Midshipmen,K. Giuliani,5109230,,False,0.0,0,0,0,0,0,0,0,0,0,0,0,0,0,0,0,0,0
401519451,Navy Midshipmen,S. Watts,4704782,,False,30.0,6,12,3,4,3,8,2,2,0,4,4,1,1,0,1,3,17
401519451,Navy Midshipmen,S. Schofield,4704779,,False,32.0,4,11,1,3,3,8,0,0,0,1,1,4,1,0,2,2,11
401519451,Navy Midshipmen,TEAM,TOTAL,TOTAL,False,,27,62,17,32,10,30,7,8,10,21,31,15,6,2,13,19,71
401519451,American University Eagles,E. Johns,4704688,,True,33.0,8,12,8,11,0,1,0,0,1,8,9,2,2,1,1,3,16
401519451,American University Eagles,L. Stack,4595455,,True,40.0,7,11,7,11,0,0,3,5,2,6,8,2,1,1,3,3,17
401519451,American University Eagles,K. Henning,4704686,,True,36.0,8,9,7,8,1,1,2,2,0,3,3,3,1,0,2,1,19
401519451,American University Eagles,I. Bales,4704685,,True,35.0,4,11,3,7,1,4,4,4,1,4,5,9,2,0,2,1,13
401519451,American University Eagles,S. Stetson,4595453,,True,29.0,2,7,1,2,1,5,2,2,0,1,1,0,2,0,1,2,7
401519451,American University Eagles,M. Lavin,5109188,,False,7.0,0,1,0,0,0,1,0,0,0,1,1,0,0,0,0,2,0
401519451,American University Eagles,L. Nogues,5109187,,False,2.0,0,1,0,1,0,0,0,0,0,0,0,0,0,0,1,0,0
401519451,American University Eagles,B. Garbee,4899710,,False,2.0,0,1,0,1,0,0,0,0,0,0,0,0,0,0,0,0,0
401519451,American University Eagles,A. LeMaster,4703737,,False,16.0,2,5,1,2,1,3,1,2,1,1,2,1,0,0,1,2,6
401519451,American University Eagles,TEAM,TOTAL,TOTAL,False,,31,58,27,43,4,15,12,15,7,26,33,17,8,2,12,14,78
401519451,American University Eagles,E. Johns,4704688,,True,33.0,8,12,8,11,0,1,0,0,1,8,9,2,2,1,1,3,16
401519451,American University Eagles,L. Stack,4595455,,True,40.0,7,11,7,11,0,0,3,5,2,6,8,2,1,1,3,3,17
401519451,American University Eagles,K. Henning,4704686,,True,36.0,8,9,7,8,1,1,2,2,0,3,3,3,1,0,2,1,19
401519451,American University Eagles,I. Bales,4704685,,True,35.0,4,11,3,7,1,4,4,4,1,4,5,9,2,0,2,1,13
401519451,American University Eagles,S. Stetson,4595453,,True,29.0,2,7,1,2,1,5,2,2,0,1,1,0,2,0,1,2,7
401519451,American University Eagles,M. Lavin,5109188,,False,7.0,0,1,0,0,0,1,0,0,0,1,1,0,0,0,0,2,0
401519451,American University Eagles,L. Nogues,5109187,,False,2.0,0,1,0,1,0,0,0,0,0,0,0,0,0,0,1,0,0
401519451,American University Eagles,B. Garbee,4899710,,False,2.0,0,1,0,1,0,0,0,0,0,0,0,0,0,0,0,0,0
401519451,American University Eagles,A. LeMaster,4703737,,False,16.0,2,5,1,2,1,3,1,2,1,1,2,1,0,0,1,2,6
401519451,American University Eagles,TEAM,TOTAL,TOTAL,False,,31,58,27,43,4,15,12,15,7,26,33,17,8,2,12,14,78
401498239,Lafayette Leopards,A. Matthews,4703689,,True,18.0,1,3,1,3,0,0,0,0,2,3,5,2,1,1,1,4,2
401498239,Lafayette Leopards,A. Antognoli,4900540,,True,39.0,7,13,5,9,2,4,5,5,0,3,3,2,2,0,5,1,21
401498239,Lafayette Leopards,M. Andrews,4704756,,True,32.0,5,15,5,14,0,1,6,8,5,7,12,1,1,1,2,3,16
401498239,Lafayette Leopards,H. Smith,4704553,,True,31.0,6,9,5,6,1,3,2,2,2,11,13,3,0,0,1,2,15
401498239,Lafayette Leopards,J. Booth,4433381,,True,0.0,0,0,0,0,0,0,0,0,0,0,0,0,0,0,0,0,0
401498239,Lafayette Leopards,S. Ntaconayigize,5109216,,False,30.0,1,2,0,1,1,1,1,2,0,7,7,2,0,0,1,3,4
401498239,Lafayette Leopards,K. Donahue,5109215,,False,32.0,5,10,4,8,1,2,0,0,0,2,2,2,0,1,2,0,11
401498239,Lafayette Leopards,K. Favours,4900541,,False,18.0,0,3,0,2,0,1,0,0,0,0,0,0,0,1,3,1,0
401498239,Lafayette Leopards,TEAM,TOTAL,TOTAL,False,,25,55,20,43,5,12,14,17,10,36,46,12,4,4,17,14,69
401498239,Lafayette Leopards,A. Matthews,4703689,,True,18.0,1,3,1,3,0,0,0,0,2,3,5,2,1,1,1,4,2
401498239,Lafayette Leopards,A. Antognoli,4900540,,True,39.0,7,13,5,9,2,4,5,5,0,3,3,2,2,0,5,1,21
401498239,Lafayette Leopards,M. Andrews,4704756,,True,32.0,5,15,5,14,0,1,6,8,5,7,12,1,1,1,2,3,16
401498239,Lafayette Leopards,H. Smith,4704553,,True,31.0,6,9,5,6,1,3,2,2,2,11,13,3,0,0,1,2,15
401498239,Lafayette Leopards,J. Booth,4433381,,True,0.0,0,0,0,0,0,0,0,0,0,0,0,0,0,0,0,0,0
401498239,Lafayette Leopards,S. Ntaconayigize,5109216,,False,30.0,1,2,0,1,1,1,1,2,0,7,7,2,0,0,1,3,4
401498239,Lafayette Leopards,K. Donahue,5109215,,False,32.0,5,10,4,8,1,2,0,0,0,2,2,2,0,1,2,0,11
401498239,Lafayette Leopards,K. Favours,4900541,,False,18.0,0,3,0,2,0,1,0,0,0,0,0,0,0,1,3,1,0
401498239,Lafayette Leopards,TEAM,TOTAL,TOTAL,False,,25,55,20,43,5,12,14,17,10,36,46,12,4,4,17,14,69
401498239,Bucknell Bison,I. King,4900533,,True,26.0,5,9,1,1,4,8,0,0,0,2,2,1,0,0,1,4,14
401498239,Bucknell Bison,E. Shaffer,4595535,,True,30.0,3,10,3,10,0,0,5,12,3,8,11,3,3,0,3,2,11
401498239,Bucknell Bison,E. Theodorsson,5109199,,True,27.0,1,8,1,3,0,5,2,2,0,2,2,3,1,0,0,2,4
401498239,Bucknell Bison,C. Collins,4900532,,True,30.0,5,12,4,9,1,3,0,0,1,2,3,3,1,0,1,2,11
401498239,Bucknell Bison,T. Johnson,4595533,,True,36.0,6,10,6,9,0,1,0,0,1,2,3,3,2,0,2,2,12
401498239,Bucknell Bison,G. Sullivan,5109201,,False,10.0,3,9,3,9,0,0,0,0,4,2,6,1,1,0,0,1,6
401498239,Bucknell Bison,R. Sisselman,4900531,,False,19.0,1,7,0,2,1,5,0,0,1,2,3,0,0,0,1,3,3
401498239,Bucknell Bison,J. Kulesza,4704702,,False,12.0,0,3,0,0,0,3,0,0,1,0,1,0,0,0,1,1,0
401498239,Bucknell Bison,C. Dingler,4577540,,False,10.0,0,2,0,0,0,2,0,0,1,0,1,1,0,0,0,0,0
401498239,Bucknell Bison,TEAM,TOTAL,TOTAL,False,,24,70,18,43,6,27,7,14,15,21,36,15,8,0,9,17,61
401498239,Bucknell Bison,I. King,4900533,,True,26.0,5,9,1,1,4,8,0,0,0,2,2,1,0,0,1,4,14
401498239,Bucknell Bison,E. Shaffer,4595535,,True,30.0,3,10,3,10,0,0,5,12,3,8,11,3,3,0,3,2,11
401498239,Bucknell Bison,E. Theodorsson,5109199,,True,27.0,1,8,1,3,0,5,2,2,0,2,2,3,1,0,0,2,4
401498239,Bucknell Bison,C. Collins,4900532,,True,30.0,5,12,4,9,1,3,0,0,1,2,3,3,1,0,1,2,11
401498239,Bucknell Bison,T. Johnson,4595533,,True,36.0,6,10,6,9,0,1,0,0,1,2,3,3,2,0,2,2,12
401498239,Bucknell Bison,G. Sullivan,5109201,,False,10.0,3,9,3,9,0,0,0,0,4,2,6,1,1,0,0,1,6
401498239,Bucknell Bison,R. Sisselman,4900531,,False,19.0,1,7,0,2,1,5,0,0,1,2,3,0,0,0,1,3,3
401498239,Bucknell Bison,J. Kulesza,4704702,,False,12.0,0,3,0,0,0,3,0,0,1,0,1,0,0,0,1,1,0
401498239,Bucknell Bison,C. Dingler,4577540,,False,10.0,0,2,0,0,0,2,0,0,1,0,1,1,0,0,0,0,0
401498239,Bucknell Bison,TEAM,TOTAL,TOTAL,False,,24,70,18,43,6,27,7,14,15,21,36,15,8,0,9,17,61
401498238,Lafayette Leopards,K. Drummond,4704754,,True,33.0,6,11,6,11,0,0,0,0,2,5,7,0,1,2,0,2,12
401498238,Lafayette Leopards,A. Antognoli,4900540,,True,33.0,3,10,3,7,0,3,0,0,0,2,2,2,3,0,0,1,6
401498238,Lafayette Leopards,M. Andrews,4704756,,True,32.0,5,14,4,12,1,2,2,4,3,1,4,0,1,1,2,3,13
401498238,Lafayette Leopards,H. Smith,4704553,,True,24.0,0,1,0,0,0,1,0,0,1,1,2,2,0,1,1,3,0
401498238,Lafayette Leopards,J. Booth,4433381,,True,32.0,4,11,2,6,2,5,3,4,0,1,1,4,3,1,4,1,13
401498238,Lafayette Leopards,A. Matthews,4703689,,False,6.0,0,1,0,1,0,0,0,0,1,1,2,0,0,1,0,0,0
401498238,Lafayette Leopards,S. Ntaconayigize,5109216,,False,13.0,0,1,0,0,0,1,0,0,0,1,1,0,0,0,1,0,0
401498238,Lafayette Leopards,K. Donahue,5109215,,False,7.0,0,1,0,0,0,1,0,0,0,3,3,0,0,0,0,3,0
401498238,Lafayette Leopards,K. Favours,4900541,,False,20.0,0,5,0,2,0,3,0,0,1,1,2,0,0,0,1,0,0
401498238,Lafayette Leopards,TEAM,TOTAL,TOTAL,False,,18,55,15,39,3,16,5,8,11,17,28,8,8,6,12,13,44
401498238,Lafayette Leopards,K. Drummond,4704754,,True,33.0,6,11,6,11,0,0,0,0,2,5,7,0,1,2,0,2,12
401498238,Lafayette Leopards,A. Antognoli,4900540,,True,33.0,3,10,3,7,0,3,0,0,0,2,2,2,3,0,0,1,6
401498238,Lafayette Leopards,M. Andrews,4704756,,True,32.0,5,14,4,12,1,2,2,4,3,1,4,0,1,1,2,3,13
401498238,Lafayette Leopards,H. Smith,4704553,,True,24.0,0,1,0,0,0,1,0,0,1,1,2,2,0,1,1,3,0
401498238,Lafayette Leopards,J. Booth,4433381,,True,32.0,4,11,2,6,2,5,3,4,0,1,1,4,3,1,4,1,13
401498238,Lafayette Leopards,A. Matthews,4703689,,False,6.0,0,1,0,1,0,0,0,0,1,1,2,0,0,1,0,0,0
401498238,Lafayette Leopards,S. Ntaconayigize,5109216,,False,13.0,0,1,0,0,0,1,0,0,0,1,1,0,0,0,1,0,0
401498238,Lafayette Leopards,K. Donahue,5109215,,False,7.0,0,1,0,0,0,1,0,0,0,3,3,0,0,0,0,3,0
401498238,Lafayette Leopards,K. Favours,4900541,,False,20.0,0,5,0,2,0,3,0,0,1,1,2,0,0,0,1,0,0
401498238,Lafayette Leopards,TEAM,TOTAL,TOTAL,False,,18,55,15,39,3,16,5,8,11,17,28,8,8,6,12,13,44
401498238,Bucknell Bison,I. King,4900533,,True,19.0,3,6,2,3,1,3,0,0,0,5,5,0,0,0,3,1,7
401498238,Bucknell Bison,E. Shaffer,4595535,,True,17.0,0,3,0,3,0,0,1,2,4,3,7,2,1,0,0,0,1
401498238,Bucknell Bison,E. Theodorsson,5109199,,True,29.0,9,11,7,8,2,3,3,4,0,4,4,1,0,0,1,2,23
401498238,Bucknell Bison,T. Johnson,4595533,,True,35.0,5,11,5,10,0,1,0,0,0,3,3,2,1,0,4,0,10
401498238,Bucknell Bison,C. Dingler,4577540,,True,33.0,1,3,0,2,1,1,0,0,0,4,4,1,1,0,2,1,3
401498238,Bucknell Bison,G. Sullivan,5109201,,False,23.0,2,4,2,4,0,0,0,0,0,2,2,3,0,2,0,0,4
401498238,Bucknell Bison,R. Sisselman,4900531,,False,17.0,0,1,0,0,0,1,0,0,0,2,2,0,1,1,1,1,0
401498238,Bucknell Bison,B. Matthews,5109200,,False,12.0,0,4,0,2,0,2,2,2,1,2,3,0,0,0,2,0,2
401498238,Bucknell Bison,J. Kulesza,4704702,,False,15.0,2,3,2,2,0,1,2,2,0,0,0,0,0,0,1,2,6
401498238,Bucknell Bison,TEAM,TOTAL,TOTAL,False,,22,46,18,34,4,12,8,10,8,27,35,9,4,3,17,7,56
401498238,Bucknell Bison,I. King,4900533,,True,19.0,3,6,2,3,1,3,0,0,0,5,5,0,0,0,3,1,7
401498238,Bucknell Bison,E. Shaffer,4595535,,True,17.0,0,3,0,3,0,0,1,2,4,3,7,2,1,0,0,0,1
401498238,Bucknell Bison,E. Theodorsson,5109199,,True,29.0,9,11,7,8,2,3,3,4,0,4,4,1,0,0,1,2,23
401498238,Bucknell Bison,T. Johnson,4595533,,True,35.0,5,11,5,10,0,1,0,0,0,3,3,2,1,0,4,0,10
401498238,Bucknell Bison,C. Dingler,4577540,,True,33.0,1,3,0,2,1,1,0,0,0,4,4,1,1,0,2,1,3
401498238,Bucknell Bison,G. Sullivan,5109201,,False,23.0,2,4,2,4,0,0,0,0,0,2,2,3,0,2,0,0,4
401498238,Bucknell Bison,R. Sisselman,4900531,,False,17.0,0,1,0,0,0,1,0,0,0,2,2,0,1,1,1,1,0
401498238,Bucknell Bison,B. Matthews,5109200,,False,12.0,0,4,0,2,0,2,2,2,1,2,3,0,0,0,2,0,2
401498238,Bucknell Bison,J. Kulesza,4704702,,False,15.0,2,3,2,2,0,1,2,2,0,0,0,0,0,0,1,2,6
401498238,Bucknell Bison,TEAM,TOTAL,TOTAL,False,,22,46,18,34,4,12,8,10,8,27,35,9,4,3,17,7,56
401497465,Arizona State Sun Devils,K. Mokwuah,4399082,,True,11.0,1,2,1,2,0,0,0,0,1,2,3,0,1,0,0,2,2
401497465,Arizona State Sun Devils,T. Skinner,4704510,,True,33.0,9,18,9,14,0,4,6,7,3,2,5,0,2,0,4,3,24
401497465,Arizona State Sun Devils,S. Erikstrup,4597599,,True,10.0,0,2,0,0,0,2,0,0,0,0,0,0,1,0,1,3,0
401497465,Arizona State Sun Devils,J. Simmons,4595338,,True,34.0,4,11,4,10,0,1,4,4,1,4,5,2,1,0,0,4,12
401497465,Arizona State Sun Devils,T. Hunt,4433430,,True,37.0,2,17,1,10,1,7,1,4,2,3,5,0,1,0,1,0,6
401497465,Arizona State Sun Devils,J. Thompson,5105723,,False,5.0,0,1,0,1,0,0,0,0,0,0,0,0,1,1,1,0,0
401497465,Arizona State Sun Devils,M. Newman,4433997,,False,28.0,5,9,5,9,0,0,0,0,7,1,8,2,0,1,0,2,10
401497465,Arizona State Sun Devils,I. Greenslade,4703583,,False,2.0,0,0,0,0,0,0,0,0,0,0,0,0,0,0,0,0,0
401497465,Arizona State Sun Devils,T. Crisp,5105721,,False,13.0,4,6,3,4,1,2,3,5,0,1,1,0,0,0,1,0,12
401497465,Arizona State Sun Devils,I. Sousa,4899066,,False,27.0,2,6,2,4,0,2,0,0,5,7,12,1,1,1,0,0,4
401497465,Arizona State Sun Devils,TEAM,TOTAL,TOTAL,False,,27,72,25,54,2,18,14,20,23,25,48,5,8,3,8,14,70
401497465,American University Eagles,E. Johns,4704688,,True,31.0,8,14,8,12,0,2,2,4,2,3,5,0,0,1,2,3,18
401497465,American University Eagles,L. Stack,4595455,,True,36.0,8,10,8,10,0,0,2,2,2,1,3,0,4,0,1,3,18
401497465,American University Eagles,K. Henning,4704686,,True,29.0,0,6,0,4,0,2,0,0,0,3,3,5,0,0,3,1,0
401497465,American University Eagles,I. Bales,4704685,,True,36.0,2,7,2,6,0,1,1,1,0,4,4,4,1,0,2,1,5
401497465,American University Eagles,R. DeRubbo,4703746,,True,32.0,5,11,3,4,2,7,2,2,1,3,4,4,0,0,0,4,14
401497465,American University Eagles,M. Lavin,5109188,,False,9.0,1,3,1,2,0,1,0,0,1,2,3,0,0,1,1,0,2
401497465,American University Eagles,M. Lee,4704592,,False,3.0,0,0,0,0,0,0,0,0,0,1,1,0,0,0,0,0,0
401497465,American University Eagles,L. Nogues,5109187,,False,7.0,2,3,2,2,0,1,0,0,0,2,2,0,0,0,1,2,4
401497465,American University Eagles,A. Rescifina,5109186,,False,2.0,0,1,0,1,0,0,0,0,0,1,1,0,0,0,1,1,0
401497465,American University Eagles,B. Garbee,4899710,,False,3.0,0,0,0,0,0,0,0,0,0,0,0,0,0,0,0,1,0
401497465,American University Eagles,A. LeMaster,4703737,,False,5.0,0,1,0,1,0,0,0,0,0,1,1,0,0,0,0,1,0
401497465,American University Eagles,S. Stetson,4595453,,False,7.0,0,1,0,0,0,1,0,0,0,0,0,0,1,0,1,1,0
401497465,American University Eagles,TEAM,TOTAL,TOTAL,False,,26,57,24,42,2,15,7,9,8,27,35,13,6,2,13,18,61
401497461,Quinnipiac Bobcats,E. O'Donnell,5109311,,True,30.0,5,10,5,9,0,1,4,7,3,2,5,2,0,0,4,2,14
401497461,Quinnipiac Bobcats,M. Morris,4433677,,True,22.0,4,10,4,10,0,0,2,3,2,3,5,1,0,0,1,1,10
401497461,Quinnipiac Bobcats,C. Haywood,4595389,,True,25.0,5,9,4,6,1,3,0,0,1,4,5,0,1,1,2,5,11
401497461,Quinnipiac Bobcats,J. Grisdale,4899865,,True,40.0,3,5,3,4,0,1,2,2,1,2,3,1,1,0,0,1,8
401497461,Quinnipiac Bobcats,R. Caverly,4399294,,True,34.0,5,11,4,7,1,4,4,5,0,2,2,8,2,1,2,3,15
401497461,Quinnipiac Bobcats,G. LaBarge,4899864,,False,3.0,0,0,0,0,0,0,0,0,0,0,0,0,0,0,0,0,0
401497461,Quinnipiac Bobcats,M. Baskerville,4399373,,False,18.0,3,4,3,4,0,0,1,2,1,5,6,0,1,1,1,3,7
401497461,Quinnipiac Bobcats,R. Douglas,4899866,,False,6.0,1,2,1,1,0,1,0,0,0,0,0,0,0,0,1,0,2
401497461,Quinnipiac Bobcats,M. Helms,4433084,,False,22.0,0,4,0,1,0,3,0,0,0,2,2,2,0,0,3,3,0
401497461,Quinnipiac Bobcats,TEAM,TOTAL,TOTAL,False,,26,55,24,42,2,13,13,19,9,23,32,14,5,3,14,18,67
401497461,Lehigh Mountain Hawks,L. Fandre,5109220,,True,32.0,4,8,0,0,4,8,0,0,1,6,7,0,0,0,2,2,12
401497461,Lehigh Mountain Hawks,M. O'Brien,4900547,,True,11.0,1,4,1,1,0,3,0,0,0,1,1,1,1,0,1,1,2
401497461,Lehigh Mountain Hawks,F. Hottinger,4595613,,True,32.0,3,8,2,4,1,4,5,6,2,3,5,0,0,0,3,3,12
401497461,Lehigh Mountain Hawks,M. Kramer,4704762,,True,37.0,2,10,2,9,0,1,1,2,0,1,1,2,1,0,2,1,5
401497461,Lehigh Mountain Hawks,A. Harvey,4595612,,True,27.0,3,8,1,2,2,6,0,0,0,1,1,5,0,0,2,2,8
401497461,Lehigh Mountain Hawks,J. Vargas-Bines,4900546,,False,14.0,1,1,1,1,0,0,1,2,1,4,5,1,0,1,1,3,3
401497461,Lehigh Mountain Hawks,K. Van Eps,4900545,,False,19.0,3,7,2,4,1,3,6,7,1,2,3,2,0,0,0,4,13
401497461,Lehigh Mountain Hawks,E. Stemmer,4900544,,False,17.0,3,6,1,2,2,4,1,2,1,0,1,1,2,0,1,1,9
401497461,Lehigh Mountain Hawks,M. Albrecht,4704763,,False,10.0,0,1,0,1,0,0,0,0,0,1,1,0,2,0,1,0,0
401497461,Lehigh Mountain Hawks,F. Eggenschwiler,4704761,,False,0.0,0,0,0,0,0,0,0,0,0,0,0,0,0,0,0,0,0
401497461,Lehigh Mountain Hawks,J. Behar,4433782,,False,1.0,0,0,0,0,0,0,0,0,0,0,0,0,0,0,1,1,0
401497461,Lehigh Mountain Hawks,TEAM,TOTAL,TOTAL,False,,20,53,10,24,10,29,14,19,9,24,33,12,6,1,16,18,64
401495323,Lafayette Leopards,K. Drummond,4704754,,True,30.0,4,6,4,6,0,0,1,4,5,3,8,1,0,1,1,3,9
401495323,Lafayette Leopards,K. Favours,4900541,,True,38.0,4,8,1,2,3,6,1,2,1,1,2,0,3,0,3,0,12
401495323,Lafayette Leopards,M. Andrews,4704756,,True,33.0,9,18,8,13,1,5,4,4,2,5,7,0,2,1,6,3,23
401495323,Lafayette Leopards,H. Smith,4704553,,True,22.0,0,4,0,2,0,2,0,0,0,2,2,0,2,0,0,2,0
401495323,Lafayette Leopards,J. Booth,4433381,,True,36.0,5,10,5,10,0,0,1,4,0,0,0,13,0,0,3,3,11
401495323,Lafayette Leopards,E. Shields,5109214,,False,6.0,0,0,0,0,0,0,0,0,0,0,0,0,0,0,1,1,0
401495323,Lafayette Leopards,A. Matthews,4703689,,False,10.0,1,1,1,1,0,0,0,0,0,0,0,0,0,0,0,0,2
401495323,Lafayette Leopards,S. Ntaconayigize,5109216,,False,11.0,1,1,0,0,1,1,0,0,0,0,0,1,1,0,0,1,3
401495323,Lafayette Leopards,K. Donahue,5109215,,False,14.0,2,4,1,2,1,2,0,0,1,2,3,0,0,1,2,1,5
401495323,Lafayette Leopards,TEAM,TOTAL,TOTAL,False,,26,52,20,36,6,16,7,14,9,13,22,15,8,3,16,14,65
401495323,Lafayette Leopards,K. Drummond,4704754,,True,30.0,4,6,4,6,0,0,1,4,5,3,8,1,0,1,1,3,9
401495323,Lafayette Leopards,K. Favours,4900541,,True,38.0,4,8,1,2,3,6,1,2,1,1,2,0,3,0,3,0,12
401495323,Lafayette Leopards,M. Andrews,4704756,,True,33.0,9,18,8,13,1,5,4,4,2,5,7,0,2,1,6,3,23
401495323,Lafayette Leopards,H. Smith,4704553,,True,22.0,0,4,0,2,0,2,0,0,0,2,2,0,2,0,0,2,0
401495323,Lafayette Leopards,J. Booth,4433381,,True,36.0,5,10,5,10,0,0,1,4,0,0,0,13,0,0,3,3,11
401495323,Lafayette Leopards,E. Shields,5109214,,False,6.0,0,0,0,0,0,0,0,0,0,0,0,0,0,0,1,1,0
401495323,Lafayette Leopards,A. Matthews,4703689,,False,10.0,1,1,1,1,0,0,0,0,0,0,0,0,0,0,0,0,2
401495323,Lafayette Leopards,S. Ntaconayigize,5109216,,False,11.0,1,1,0,0,1,1,0,0,0,0,0,1,1,0,0,1,3
401495323,Lafayette Leopards,K. Donahue,5109215,,False,14.0,2,4,1,2,1,2,0,0,1,2,3,0,0,1,2,1,5
401495323,Lafayette Leopards,TEAM,TOTAL,TOTAL,False,,26,52,20,36,6,16,7,14,9,13,22,15,8,3,16,14,65
401495323,American University Eagles,E. Johns,4704688,,True,38.0,6,8,6,7,0,1,2,2,1,4,5,3,1,0,1,4,14
401495323,American University Eagles,L. Stack,4595455,,True,37.0,7,8,7,8,0,0,0,0,4,3,7,3,0,2,2,3,14
401495323,American University Eagles,I. Bales,4704685,,True,34.0,5,12,3,8,2,4,1,2,1,3,4,6,6,0,3,2,13
401495323,American University Eagles,R. DeRubbo,4703746,,True,32.0,4,11,1,2,3,9,1,2,0,2,2,3,1,0,2,2,12
401495323,American University Eagles,S. Stetson,4595453,,True,25.0,1,5,0,2,1,3,0,0,2,4,6,3,1,0,2,4,3
401495323,American University Eagles,M. Lavin,5109188,,False,2.0,1,1,1,1,0,0,0,0,0,0,0,0,0,0,0,0,2
401495323,American University Eagles,L. Nogues,5109187,,False,1.0,0,1,0,0,0,1,0,0,0,0,0,0,0,0,0,0,0
401495323,American University Eagles,B. Garbee,4899710,,False,8.0,2,2,1,1,1,1,0,0,1,0,1,2,0,0,1,1,5
401495323,American University Eagles,K. Henning,4704686,,False,18.0,6,7,6,7,0,0,0,0,0,1,1,3,0,0,3,4,12
401495323,American University Eagles,A. LeMaster,4703737,,False,5.0,0,2,0,1,0,1,0,0,0,0,0,0,0,0,1,0,0
401495323,American University Eagles,TEAM,TOTAL,TOTAL,False,,32,57,25,37,7,20,4,6,9,17,26,23,9,2,15,20,75
401495323,American University Eagles,E. Johns,4704688,,True,38.0,6,8,6,7,0,1,2,2,1,4,5,3,1,0,1,4,14
401495323,American University Eagles,L. Stack,4595455,,True,37.0,7,8,7,8,0,0,0,0,4,3,7,3,0,2,2,3,14
401495323,American University Eagles,I. Bales,4704685,,True,34.0,5,12,3,8,2,4,1,2,1,3,4,6,6,0,3,2,13
401495323,American University Eagles,R. DeRubbo,4703746,,True,32.0,4,11,1,2,3,9,1,2,0,2,2,3,1,0,2,2,12
401495323,American University Eagles,S. Stetson,4595453,,True,25.0,1,5,0,2,1,3,0,0,2,4,6,3,1,0,2,4,3
401495323,American University Eagles,M. Lavin,5109188,,False,2.0,1,1,1,1,0,0,0,0,0,0,0,0,0,0,0,0,2
401495323,American University Eagles,L. Nogues,5109187,,False,1.0,0,1,0,0,0,1,0,0,0,0,0,0,0,0,0,0,0
401495323,American University Eagles,B. Garbee,4899710,,False,8.0,2,2,1,1,1,1,0,0,1,0,1,2,0,0,1,1,5
401495323,American University Eagles,K. Henning,4704686,,False,18.0,6,7,6,7,0,0,0,0,0,1,1,3,0,0,3,4,12
401495323,American University Eagles,A. LeMaster,4703737,,False,5.0,0,2,0,1,0,1,0,0,0,0,0,0,0,0,1,0,0
401495323,American University Eagles,TEAM,TOTAL,TOTAL,False,,32,57,25,37,7,20,4,6,9,17,26,23,9,2,15,20,75
401495109,Lehigh Mountain Hawks,L. Fandre,5109220,,True,26.0,5,10,1,3,4,7,2,2,0,6,6,2,0,0,0,3,16
401495109,Lehigh Mountain Hawks,F. Hottinger,4595613,,True,37.0,5,15,5,11,0,4,8,9,1,5,6,1,2,0,3,3,18
401495109,Lehigh Mountain Hawks,E. Stemmer,4900544,,True,29.0,2,7,0,1,2,6,0,0,0,1,1,3,1,0,1,1,6
401495109,Lehigh Mountain Hawks,M. Kramer,4704762,,True,39.0,11,17,6,10,5,7,4,6,0,5,5,4,1,0,0,0,31
401495109,Lehigh Mountain Hawks,A. Harvey,4595612,,True,40.0,0,2,0,0,0,2,6,6,0,1,1,3,2,0,0,3,6
401495109,Lehigh Mountain Hawks,M. O'Brien,4900547,,False,7.0,1,2,0,1,1,1,0,0,3,1,4,1,0,0,0,1,3
401495109,Lehigh Mountain Hawks,K. Van Eps,4900545,,False,8.0,1,1,1,1,0,0,0,0,1,0,1,0,1,0,0,1,2
401495109,Lehigh Mountain Hawks,M. Albrecht,4704763,,False,2.0,0,0,0,0,0,0,0,0,0,0,0,0,0,0,0,0,0
401495109,Lehigh Mountain Hawks,F. Eggenschwiler,4704761,,False,0.0,0,0,0,0,0,0,0,0,0,0,0,0,0,0,0,0,0
401495109,Lehigh Mountain Hawks,J. Behar,4433782,,False,12.0,1,7,1,3,0,4,0,0,0,2,2,0,0,0,0,3,2
401495109,Lehigh Mountain Hawks,TEAM,TOTAL,TOTAL,False,,26,61,14,30,12,31,20,23,6,21,27,14,7,0,4,15,84
401495109,Lehigh Mountain Hawks,L. Fandre,5109220,,True,26.0,5,10,1,3,4,7,2,2,0,6,6,2,0,0,0,3,16
401495109,Lehigh Mountain Hawks,F. Hottinger,4595613,,True,37.0,5,15,5,11,0,4,8,9,1,5,6,1,2,0,3,3,18
401495109,Lehigh Mountain Hawks,E. Stemmer,4900544,,True,29.0,2,7,0,1,2,6,0,0,0,1,1,3,1,0,1,1,6
401495109,Lehigh Mountain Hawks,M. Kramer,4704762,,True,39.0,11,17,6,10,5,7,4,6,0,5,5,4,1,0,0,0,31
401495109,Lehigh Mountain Hawks,A. Harvey,4595612,,True,40.0,0,2,0,0,0,2,6,6,0,1,1,3,2,0,0,3,6
401495109,Lehigh Mountain Hawks,M. O'Brien,4900547,,False,7.0,1,2,0,1,1,1,0,0,3,1,4,1,0,0,0,1,3
401495109,Lehigh Mountain Hawks,K. Van Eps,4900545,,False,8.0,1,1,1,1,0,0,0,0,1,0,1,0,1,0,0,1,2
401495109,Lehigh Mountain Hawks,M. Albrecht,4704763,,False,2.0,0,0,0,0,0,0,0,0,0,0,0,0,0,0,0,0,0
401495109,Lehigh Mountain Hawks,F. Eggenschwiler,4704761,,False,0.0,0,0,0,0,0,0,0,0,0,0,0,0,0,0,0,0,0
401495109,Lehigh Mountain Hawks,J. Behar,4433782,,False,12.0,1,7,1,3,0,4,0,0,0,2,2,0,0,0,0,3,2
401495109,Lehigh Mountain Hawks,TEAM,TOTAL,TOTAL,False,,26,61,14,30,12,31,20,23,6,21,27,14,7,0,4,15,84
401495109,Bucknell Bison,I. King,4900533,,True,26.0,2,6,1,3,1,3,3,4,0,1,1,1,0,0,1,2,8
401495109,Bucknell Bison,E. Shaffer,4595535,,True,27.0,5,8,5,8,0,0,4,7,3,9,12,4,0,0,5,4,14
401495109,Bucknell Bison,E. Theodorsson,5109199,,True,15.0,3,6,2,4,1,2,0,0,0,2,2,2,1,0,1,3,7
401495109,Bucknell Bison,C. Collins,4900532,,True,32.0,6,15,4,12,2,3,5,6,1,1,2,4,0,0,2,3,19
401495109,Bucknell Bison,T. Johnson,4595533,,True,37.0,7,8,7,8,0,0,0,0,0,6,6,1,0,0,0,3,14
401495109,Bucknell Bison,G. Klag,5109202,,False,0.0,0,0,0,0,0,0,0,0,0,0,0,0,0,0,0,0,0
401495109,Bucknell Bison,G. Sullivan,5109201,,False,7.0,1,2,1,2,0,0,1,1,3,1,4,1,0,0,2,0,3
401495109,Bucknell Bison,N. Davis,4704701,,False,5.0,0,1,0,1,0,0,0,0,0,0,0,1,1,0,0,0,0
401495109,Bucknell Bison,R. Sisselman,4900531,,False,27.0,2,8,0,2,2,6,1,2,0,3,3,0,0,0,0,1,7
401495109,Bucknell Bison,B. Matthews,5109200,,False,1.0,0,0,0,0,0,0,0,0,0,0,0,0,0,0,0,0,0
401495109,Bucknell Bison,J. Kulesza,4704702,,False,12.0,0,1,0,0,0,1,0,0,0,1,1,0,0,1,0,0,0
401495109,Bucknell Bison,C. Dingler,4577540,,False,11.0,0,0,0,0,0,0,0,0,0,4,4,1,1,0,1,3,0
401495109,Bucknell Bison,TEAM,TOTAL,TOTAL,False,,26,55,20,40,6,15,14,20,7,28,35,15,3,1,12,19,72
401495109,Bucknell Bison,I. King,4900533,,True,26.0,2,6,1,3,1,3,3,4,0,1,1,1,0,0,1,2,8
401495109,Bucknell Bison,E. Shaffer,4595535,,True,27.0,5,8,5,8,0,0,4,7,3,9,12,4,0,0,5,4,14
401495109,Bucknell Bison,E. Theodorsson,5109199,,True,15.0,3,6,2,4,1,2,0,0,0,2,2,2,1,0,1,3,7
401495109,Bucknell Bison,C. Collins,4900532,,True,32.0,6,15,4,12,2,3,5,6,1,1,2,4,0,0,2,3,19
401495109,Bucknell Bison,T. Johnson,4595533,,True,37.0,7,8,7,8,0,0,0,0,0,6,6,1,0,0,0,3,14
401495109,Bucknell Bison,G. Klag,5109202,,False,0.0,0,0,0,0,0,0,0,0,0,0,0,0,0,0,0,0,0
401495109,Bucknell Bison,G. Sullivan,5109201,,False,7.0,1,2,1,2,0,0,1,1,3,1,4,1,0,0,2,0,3
401495109,Bucknell Bison,N. Davis,4704701,,False,5.0,0,1,0,1,0,0,0,0,0,0,0,1,1,0,0,0,0
401495109,Bucknell Bison,R. Sisselman,4900531,,False,27.0,2,8,0,2,2,6,1,2,0,3,3,0,0,0,0,1,7
401495109,Bucknell Bison,B. Matthews,5109200,,False,1.0,0,0,0,0,0,0,0,0,0,0,0,0,0,0,0,0,0
401495109,Bucknell Bison,J. Kulesza,4704702,,False,12.0,0,1,0,0,0,1,0,0,0,1,1,0,0,1,0,0,0
401495109,Bucknell Bison,C. Dingler,4577540,,False,11.0,0,0,0,0,0,0,0,0,0,4,4,1,1,0,1,3,0
401495109,Bucknell Bison,TEAM,TOTAL,TOTAL,False,,26,55,20,40,6,15,14,20,7,28,35,15,3,1,12,19,72
401495108,Lehigh Mountain Hawks,L. Fandre,5109220,,True,23.0,1,4,0,2,1,2,1,2,1,2,3,4,0,0,1,0,4
401495108,Lehigh Mountain Hawks,M. O'Brien,4900547,,True,22.0,2,5,1,2,1,3,0,0,0,4,4,1,0,1,2,2,5
401495108,Lehigh Mountain Hawks,F. Hottinger,4595613,,True,30.0,10,16,5,9,5,7,3,4,3,1,4,2,0,0,2,0,28
401495108,Lehigh Mountain Hawks,M. Kramer,4704762,,True,29.0,5,14,4,8,1,6,6,6,1,3,4,5,0,0,3,0,17
401495108,Lehigh Mountain Hawks,A. Harvey,4595612,,True,23.0,1,2,0,1,1,1,1,2,0,2,2,2,3,0,3,3,4
401495108,Lehigh Mountain Hawks,J. Vargas-Bines,4900546,,False,2.0,0,0,0,0,0,0,0,0,0,2,2,0,0,1,0,0,0
401495108,Lehigh Mountain Hawks,M. Brown,4433751,,False,5.0,0,1,0,1,0,0,0,0,0,0,0,2,0,0,1,0,0
401495108,Lehigh Mountain Hawks,K. Hurt,5109219,,False,2.0,0,0,0,0,0,0,0,0,0,0,0,0,0,0,0,0,0
401495108,Lehigh Mountain Hawks,K. St.Paul,5109218,,False,1.0,0,0,0,0,0,0,0,0,0,0,0,0,0,0,0,0,0
401495108,Lehigh Mountain Hawks,K. Van Eps,4900545,,False,11.0,1,1,1,1,0,0,0,0,1,3,4,1,0,0,0,2,2
401495108,Lehigh Mountain Hawks,E. Stemmer,4900544,,False,20.0,3,4,1,1,2,3,0,0,1,1,2,2,1,0,0,1,8
401495108,Lehigh Mountain Hawks,M. Albrecht,4704763,,False,7.0,0,1,0,1,0,0,0,0,0,1,1,0,0,0,0,0,0
401495108,Lehigh Mountain Hawks,F. Eggenschwiler,4704761,,False,5.0,2,4,2,3,0,1,0,0,1,1,2,0,0,0,1,0,4
401495108,Lehigh Mountain Hawks,J. Behar,4433782,,False,20.0,3,8,2,4,1,4,0,0,2,8,10,1,0,0,2,1,7
401495108,Lehigh Mountain Hawks,TEAM,TOTAL,TOTAL,False,,28,60,16,33,12,27,11,14,13,32,45,20,4,2,15,9,79
401495108,Lehigh Mountain Hawks,L. Fandre,5109220,,True,23.0,1,4,0,2,1,2,1,2,1,2,3,4,0,0,1,0,4
401495108,Lehigh Mountain Hawks,M. O'Brien,4900547,,True,22.0,2,5,1,2,1,3,0,0,0,4,4,1,0,1,2,2,5
401495108,Lehigh Mountain Hawks,F. Hottinger,4595613,,True,30.0,10,16,5,9,5,7,3,4,3,1,4,2,0,0,2,0,28
401495108,Lehigh Mountain Hawks,M. Kramer,4704762,,True,29.0,5,14,4,8,1,6,6,6,1,3,4,5,0,0,3,0,17
401495108,Lehigh Mountain Hawks,A. Harvey,4595612,,True,23.0,1,2,0,1,1,1,1,2,0,2,2,2,3,0,3,3,4
401495108,Lehigh Mountain Hawks,J. Vargas-Bines,4900546,,False,2.0,0,0,0,0,0,0,0,0,0,2,2,0,0,1,0,0,0
401495108,Lehigh Mountain Hawks,M. Brown,4433751,,False,5.0,0,1,0,1,0,0,0,0,0,0,0,2,0,0,1,0,0
401495108,Lehigh Mountain Hawks,K. Hurt,5109219,,False,2.0,0,0,0,0,0,0,0,0,0,0,0,0,0,0,0,0,0
401495108,Lehigh Mountain Hawks,K. St.Paul,5109218,,False,1.0,0,0,0,0,0,0,0,0,0,0,0,0,0,0,0,0,0
401495108,Lehigh Mountain Hawks,K. Van Eps,4900545,,False,11.0,1,1,1,1,0,0,0,0,1,3,4,1,0,0,0,2,2
401495108,Lehigh Mountain Hawks,E. Stemmer,4900544,,False,20.0,3,4,1,1,2,3,0,0,1,1,2,2,1,0,0,1,8
401495108,Lehigh Mountain Hawks,M. Albrecht,4704763,,False,7.0,0,1,0,1,0,0,0,0,0,1,1,0,0,0,0,0,0
401495108,Lehigh Mountain Hawks,F. Eggenschwiler,4704761,,False,5.0,2,4,2,3,0,1,0,0,1,1,2,0,0,0,1,0,4
401495108,Lehigh Mountain Hawks,J. Behar,4433782,,False,20.0,3,8,2,4,1,4,0,0,2,8,10,1,0,0,2,1,7
401495108,Lehigh Mountain Hawks,TEAM,TOTAL,TOTAL,False,,28,60,16,33,12,27,11,14,13,32,45,20,4,2,15,9,79
401495108,Lafayette Leopards,K. Drummond,4704754,,True,28.0,0,1,0,1,0,0,0,0,3,5,8,0,0,0,2,2,0
401495108,Lafayette Leopards,A. Matthews,4703689,,True,8.0,1,2,1,2,0,0,0,0,0,0,0,0,0,1,0,0,2
401495108,Lafayette Leopards,A. Antognoli,4900540,,True,38.0,4,13,3,10,1,3,1,2,0,4,4,3,2,0,3,1,10
401495108,Lafayette Leopards,H. Smith,4704553,,True,36.0,8,17,6,13,2,4,0,0,1,4,5,2,0,0,2,3,18
401495108,Lafayette Leopards,S. Ntaconayigize,5109216,,False,24.0,2,2,1,1,1,1,0,0,0,3,3,1,1,2,2,2,5
401495108,Lafayette Leopards,K. Donahue,5109215,,False,19.0,2,5,2,3,0,2,0,0,0,0,0,0,0,0,1,3,4
401495108,Lafayette Leopards,K. Favours,4900541,,False,28.0,1,7,1,4,0,3,1,2,0,1,1,0,0,1,1,1,3
401495108,Lafayette Leopards,M. Andrews,4704756,,False,19.0,2,8,2,8,0,0,2,2,0,1,1,0,1,1,3,5,6
401495108,Lafayette Leopards,TEAM,TOTAL,TOTAL,False,,20,55,16,42,4,13,4,6,4,22,26,6,4,5,14,17,48
401495108,Lafayette Leopards,K. Drummond,4704754,,True,28.0,0,1,0,1,0,0,0,0,3,5,8,0,0,0,2,2,0
401495108,Lafayette Leopards,A. Matthews,4703689,,True,8.0,1,2,1,2,0,0,0,0,0,0,0,0,0,1,0,0,2
401495108,Lafayette Leopards,A. Antognoli,4900540,,True,38.0,4,13,3,10,1,3,1,2,0,4,4,3,2,0,3,1,10
401495108,Lafayette Leopards,H. Smith,4704553,,True,36.0,8,17,6,13,2,4,0,0,1,4,5,2,0,0,2,3,18
401495108,Lafayette Leopards,S. Ntaconayigize,5109216,,False,24.0,2,2,1,1,1,1,0,0,0,3,3,1,1,2,2,2,5
401495108,Lafayette Leopards,K. Donahue,5109215,,False,19.0,2,5,2,3,0,2,0,0,0,0,0,0,0,0,1,3,4
401495108,Lafayette Leopards,K. Favours,4900541,,False,28.0,1,7,1,4,0,3,1,2,0,1,1,0,0,1,1,1,3
401495108,Lafayette Leopards,M. Andrews,4704756,,False,19.0,2,8,2,8,0,0,2,2,0,1,1,0,1,1,3,5,6
401495108,Lafayette Leopards,TEAM,TOTAL,TOTAL,False,,20,55,16,42,4,13,4,6,4,22,26,6,4,5,14,17,48
401495107,Lehigh Mountain Hawks,L. Fandre,5109220,,True,26.0,1,3,1,2,0,1,0,0,0,4,4,2,0,0,0,2,2
401495107,Lehigh Mountain Hawks,F. Hottinger,4595613,,True,37.0,7,18,6,13,1,5,6,7,5,9,14,0,0,1,4,3,21
401495107,Lehigh Mountain Hawks,E. Stemmer,4900544,,True,28.0,1,4,0,0,1,4,2,2,1,2,3,1,1,0,4,2,5
401495107,Lehigh Mountain Hawks,M. Kramer,4704762,,True,35.0,4,12,4,9,0,3,0,0,0,5,5,9,1,0,1,2,8
401495107,Lehigh Mountain Hawks,A. Harvey,4595612,,True,25.0,3,6,3,4,0,2,1,2,1,3,4,0,0,0,1,1,7
401495107,Lehigh Mountain Hawks,M. O'Brien,4900547,,False,6.0,2,3,2,2,0,1,0,0,0,1,1,0,0,1,0,1,4
401495107,Lehigh Mountain Hawks,K. Van Eps,4900545,,False,6.0,0,3,0,1,0,2,0,0,0,2,2,0,0,0,1,0,0
401495107,Lehigh Mountain Hawks,M. Albrecht,4704763,,False,11.0,0,2,0,0,0,2,0,0,0,0,0,0,1,0,2,0,0
401495107,Lehigh Mountain Hawks,F. Eggenschwiler,4704761,,False,1.0,0,0,0,0,0,0,0,0,0,0,0,0,0,0,0,0,0
401495107,Lehigh Mountain Hawks,J. Behar,4433782,,False,25.0,5,9,2,3,3,6,0,0,0,4,4,1,2,0,2,0,13
401495107,Lehigh Mountain Hawks,TEAM,TOTAL,TOTAL,False,,23,60,18,34,5,26,9,11,9,35,44,13,5,2,15,11,60
401495107,Lehigh Mountain Hawks,L. Fandre,5109220,,True,26.0,1,3,1,2,0,1,0,0,0,4,4,2,0,0,0,2,2
401495107,Lehigh Mountain Hawks,F. Hottinger,4595613,,True,37.0,7,18,6,13,1,5,6,7,5,9,14,0,0,1,4,3,21
401495107,Lehigh Mountain Hawks,E. Stemmer,4900544,,True,28.0,1,4,0,0,1,4,2,2,1,2,3,1,1,0,4,2,5
401495107,Lehigh Mountain Hawks,M. Kramer,4704762,,True,35.0,4,12,4,9,0,3,0,0,0,5,5,9,1,0,1,2,8
401495107,Lehigh Mountain Hawks,A. Harvey,4595612,,True,25.0,3,6,3,4,0,2,1,2,1,3,4,0,0,0,1,1,7
401495107,Lehigh Mountain Hawks,M. O'Brien,4900547,,False,6.0,2,3,2,2,0,1,0,0,0,1,1,0,0,1,0,1,4
401495107,Lehigh Mountain Hawks,K. Van Eps,4900545,,False,6.0,0,3,0,1,0,2,0,0,0,2,2,0,0,0,1,0,0
401495107,Lehigh Mountain Hawks,M. Albrecht,4704763,,False,11.0,0,2,0,0,0,2,0,0,0,0,0,0,1,0,2,0,0
401495107,Lehigh Mountain Hawks,F. Eggenschwiler,4704761,,False,1.0,0,0,0,0,0,0,0,0,0,0,0,0,0,0,0,0,0
401495107,Lehigh Mountain Hawks,J. Behar,4433782,,False,25.0,5,9,2,3,3,6,0,0,0,4,4,1,2,0,2,0,13
401495107,Lehigh Mountain Hawks,TEAM,TOTAL,TOTAL,False,,23,60,18,34,5,26,9,11,9,35,44,13,5,2,15,11,60
401495107,Lafayette Leopards,K. Drummond,4704754,,True,35.0,2,5,2,5,0,0,0,0,3,5,8,1,0,0,1,1,4
401495107,Lafayette Leopards,K. Favours,4900541,,True,31.0,2,8,1,2,1,6,0,0,0,1,1,1,0,0,3,0,5
401495107,Lafayette Leopards,A. Antognoli,4900540,,True,39.0,6,18,4,11,2,7,2,2,0,6,6,8,4,0,0,1,16
401495107,Lafayette Leopards,M. Andrews,4704756,,True,33.0,9,18,9,17,0,1,3,3,1,7,8,0,0,0,3,4,21
401495107,Lafayette Leopards,H. Smith,4704553,,True,27.0,4,7,3,5,1,2,0,1,2,0,2,2,1,0,2,3,9
401495107,Lafayette Leopards,A. Matthews,4703689,,False,4.0,0,0,0,0,0,0,0,0,0,0,0,0,1,0,0,1,0
401495107,Lafayette Leopards,S. Ntaconayigize,5109216,,False,27.0,3,8,1,3,2,5,0,0,0,2,2,1,0,0,1,0,8
401495107,Lafayette Leopards,K. Donahue,5109215,,False,4.0,0,2,0,2,0,0,0,0,0,1,1,0,1,0,0,3,0
401495107,Lafayette Leopards,TEAM,TOTAL,TOTAL,False,,26,66,20,45,6,21,5,6,6,29,35,13,7,0,10,13,63
401495107,Lafayette Leopards,K. Drummond,4704754,,True,35.0,2,5,2,5,0,0,0,0,3,5,8,1,0,0,1,1,4
401495107,Lafayette Leopards,K. Favours,4900541,,True,31.0,2,8,1,2,1,6,0,0,0,1,1,1,0,0,3,0,5
401495107,Lafayette Leopards,A. Antognoli,4900540,,True,39.0,6,18,4,11,2,7,2,2,0,6,6,8,4,0,0,1,16
401495107,Lafayette Leopards,M. Andrews,4704756,,True,33.0,9,18,9,17,0,1,3,3,1,7,8,0,0,0,3,4,21
401495107,Lafayette Leopards,H. Smith,4704553,,True,27.0,4,7,3,5,1,2,0,1,2,0,2,2,1,0,2,3,9
401495107,Lafayette Leopards,A. Matthews,4703689,,False,4.0,0,0,0,0,0,0,0,0,0,0,0,0,1,0,0,1,0
401495107,Lafayette Leopards,S. Ntaconayigize,5109216,,False,27.0,3,8,1,3,2,5,0,0,0,2,2,1,0,0,1,0,8
401495107,Lafayette Leopards,K. Donahue,5109215,,False,4.0,0,2,0,2,0,0,0,0,0,1,1,0,1,0,0,3,0
401495107,Lafayette Leopards,TEAM,TOTAL,TOTAL,False,,26,66,20,45,6,21,5,6,6,29,35,13,7,0,10,13,63
401495106,Lehigh Mountain Hawks,L. Fandre,5109220,,True,21.0,2,3,0,0,2,3,0,0,0,1,1,1,0,0,2,2,6
401495106,Lehigh Mountain Hawks,F. Hottinger,4595613,,True,28.0,8,18,7,14,1,4,5,5,5,6,11,1,0,0,0,2,22
401495106,Lehigh Mountain Hawks,K. Van Eps,4900545,,True,19.0,1,5,1,1,0,4,0,0,1,1,2,2,1,0,0,1,2
401495106,Lehigh Mountain Hawks,M. Kramer,4704762,,True,30.0,6,11,3,7,3,4,0,0,0,2,2,2,1,0,2,0,15
401495106,Lehigh Mountain Hawks,A. Harvey,4595612,,True,12.0,0,2,0,0,0,2,0,0,1,1,2,1,0,0,0,2,0
401495106,Lehigh Mountain Hawks,M. O'Brien,4900547,,False,11.0,0,2,0,0,0,2,0,0,0,2,2,1,0,0,0,0,0
401495106,Lehigh Mountain Hawks,M. Brown,4433751,,False,3.0,0,1,0,0,0,1,0,0,0,1,1,0,0,0,0,0,0
401495106,Lehigh Mountain Hawks,K. Hurt,5109219,,False,1.0,0,1,0,0,0,1,0,0,0,0,0,0,0,0,0,0,0
401495106,Lehigh Mountain Hawks,E. Stemmer,4900544,,False,34.0,6,14,5,7,1,7,0,0,0,4,4,3,1,0,1,1,13
401495106,Lehigh Mountain Hawks,M. Albrecht,4704763,,False,15.0,1,3,0,1,1,2,0,0,1,0,1,0,0,0,1,2,3
401495106,Lehigh Mountain Hawks,F. Eggenschwiler,4704761,,False,8.0,0,0,0,0,0,0,0,0,0,1,1,0,0,0,0,1,0
401495106,Lehigh Mountain Hawks,J. Behar,4433782,,False,18.0,1,3,0,0,1,3,0,0,0,7,7,2,0,0,1,1,3
401495106,Lehigh Mountain Hawks,TEAM,TOTAL,TOTAL,False,,25,63,16,30,9,33,5,5,10,29,39,13,3,0,7,12,64
401495106,Lehigh Mountain Hawks,L. Fandre,5109220,,True,21.0,2,3,0,0,2,3,0,0,0,1,1,1,0,0,2,2,6
401495106,Lehigh Mountain Hawks,F. Hottinger,4595613,,True,28.0,8,18,7,14,1,4,5,5,5,6,11,1,0,0,0,2,22
401495106,Lehigh Mountain Hawks,K. Van Eps,4900545,,True,19.0,1,5,1,1,0,4,0,0,1,1,2,2,1,0,0,1,2
401495106,Lehigh Mountain Hawks,M. Kramer,4704762,,True,30.0,6,11,3,7,3,4,0,0,0,2,2,2,1,0,2,0,15
401495106,Lehigh Mountain Hawks,A. Harvey,4595612,,True,12.0,0,2,0,0,0,2,0,0,1,1,2,1,0,0,0,2,0
401495106,Lehigh Mountain Hawks,M. O'Brien,4900547,,False,11.0,0,2,0,0,0,2,0,0,0,2,2,1,0,0,0,0,0
401495106,Lehigh Mountain Hawks,M. Brown,4433751,,False,3.0,0,1,0,0,0,1,0,0,0,1,1,0,0,0,0,0,0
401495106,Lehigh Mountain Hawks,K. Hurt,5109219,,False,1.0,0,1,0,0,0,1,0,0,0,0,0,0,0,0,0,0,0
401495106,Lehigh Mountain Hawks,E. Stemmer,4900544,,False,34.0,6,14,5,7,1,7,0,0,0,4,4,3,1,0,1,1,13
401495106,Lehigh Mountain Hawks,M. Albrecht,4704763,,False,15.0,1,3,0,1,1,2,0,0,1,0,1,0,0,0,1,2,3
401495106,Lehigh Mountain Hawks,F. Eggenschwiler,4704761,,False,8.0,0,0,0,0,0,0,0,0,0,1,1,0,0,0,0,1,0
401495106,Lehigh Mountain Hawks,J. Behar,4433782,,False,18.0,1,3,0,0,1,3,0,0,0,7,7,2,0,0,1,1,3
401495106,Lehigh Mountain Hawks,TEAM,TOTAL,TOTAL,False,,25,63,16,30,9,33,5,5,10,29,39,13,3,0,7,12,64
401495106,Bucknell Bison,E. Shaffer,4595535,,True,18.0,3,6,3,6,0,0,3,5,2,2,4,0,0,0,1,2,9
401495106,Bucknell Bison,E. Theodorsson,5109199,,True,29.0,3,10,3,8,0,2,0,0,0,6,6,0,0,0,1,1,6
401495106,Bucknell Bison,R. Sisselman,4900531,,True,24.0,1,2,1,1,0,1,0,0,0,2,2,0,0,0,1,0,2
401495106,Bucknell Bison,T. Johnson,4595533,,True,29.0,6,13,6,12,0,1,2,2,1,5,6,2,0,1,3,2,14
401495106,Bucknell Bison,C. Dingler,4577540,,True,36.0,1,5,1,4,0,1,1,2,1,4,5,3,0,0,0,1,3
401495106,Bucknell Bison,G. Sullivan,5109201,,False,21.0,3,7,3,7,0,0,1,2,0,1,1,0,2,1,0,0,7
401495106,Bucknell Bison,I. King,4900533,,False,28.0,1,5,0,2,1,3,0,0,0,3,3,3,1,0,0,1,3
401495106,Bucknell Bison,B. Matthews,5109200,,False,11.0,2,4,2,4,0,0,0,0,0,1,1,0,0,0,1,0,4
401495106,Bucknell Bison,J. Kulesza,4704702,,False,4.0,1,1,0,0,1,1,0,0,0,0,0,1,0,0,0,0,3
401495106,Bucknell Bison,TEAM,TOTAL,TOTAL,False,,21,53,19,44,2,9,7,11,5,28,33,9,3,2,8,7,51
401495106,Bucknell Bison,E. Shaffer,4595535,,True,18.0,3,6,3,6,0,0,3,5,2,2,4,0,0,0,1,2,9
401495106,Bucknell Bison,E. Theodorsson,5109199,,True,29.0,3,10,3,8,0,2,0,0,0,6,6,0,0,0,1,1,6
401495106,Bucknell Bison,R. Sisselman,4900531,,True,24.0,1,2,1,1,0,1,0,0,0,2,2,0,0,0,1,0,2
401495106,Bucknell Bison,T. Johnson,4595533,,True,29.0,6,13,6,12,0,1,2,2,1,5,6,2,0,1,3,2,14
401495106,Bucknell Bison,C. Dingler,4577540,,True,36.0,1,5,1,4,0,1,1,2,1,4,5,3,0,0,0,1,3
401495106,Bucknell Bison,G. Sullivan,5109201,,False,21.0,3,7,3,7,0,0,1,2,0,1,1,0,2,1,0,0,7
401495106,Bucknell Bison,I. King,4900533,,False,28.0,1,5,0,2,1,3,0,0,0,3,3,3,1,0,0,1,3
401495106,Bucknell Bison,B. Matthews,5109200,,False,11.0,2,4,2,4,0,0,0,0,0,1,1,0,0,0,1,0,4
401495106,Bucknell Bison,J. Kulesza,4704702,,False,4.0,1,1,0,0,1,1,0,0,0,0,0,1,0,0,0,0,3
401495106,Bucknell Bison,TEAM,TOTAL,TOTAL,False,,21,53,19,44,2,9,7,11,5,28,33,9,3,2,8,7,51
401495105,Southern Illinois Salukis,L. Randle,4664773,,True,28.0,5,7,5,7,0,0,3,6,5,5,10,0,4,0,2,3,13
401495105,Southern Illinois Salukis,P. Taylor,4280873,,True,17.0,4,7,4,7,0,0,3,3,2,4,6,1,0,2,2,3,11
401495105,Southern Illinois Salukis,T. Brown,4900092,,True,20.0,2,9,0,3,2,6,2,2,2,1,3,0,2,0,1,0,8
401495105,Southern Illinois Salukis,Q. Love,4704868,,True,20.0,1,4,1,3,0,1,2,2,0,2,2,3,1,0,0,4,4
401495105,Southern Illinois Salukis,A. Jones,12038,,True,32.0,5,21,2,14,3,7,3,5,0,7,7,8,4,0,1,4,16
401495105,Southern Illinois Salukis,S. Hughes,5109368,,False,3.0,0,0,0,0,0,0,0,0,0,1,1,0,0,1,0,1,0
401495105,Southern Illinois Salukis,Z. Belcher,4900094,,False,6.0,0,0,0,0,0,0,0,0,0,2,2,0,0,0,1,1,0
401495105,Southern Illinois Salukis,T. Nard,4898623,,False,17.0,4,7,4,7,0,0,3,5,3,4,7,0,0,1,2,0,11
401495105,Southern Illinois Salukis,J. Mason,5109369,,False,22.0,5,9,4,6,1,3,2,2,1,1,2,4,6,1,1,3,13
401495105,Southern Illinois Salukis,S. Prochaska,4704869,,False,14.0,1,4,0,0,1,4,0,0,0,1,1,0,1,0,0,2,3
401495105,Southern Illinois Salukis,A. Holmes,4433756,,False,21.0,3,7,2,2,1,5,1,1,0,1,1,0,0,0,1,2,8
401495105,Southern Illinois Salukis,TEAM,TOTAL,TOTAL,False,,30,75,22,49,8,26,19,26,15,30,45,16,18,5,11,23,87
401495105,Lehigh Mountain Hawks,L. Fandre,5109220,,True,27.0,4,7,3,3,1,4,0,0,1,3,4,2,0,2,2,4,9
401495105,Lehigh Mountain Hawks,M. O'Brien,4900547,,True,20.0,2,6,0,2,2,4,0,0,3,9,12,3,0,0,3,2,6
401495105,Lehigh Mountain Hawks,F. Hottinger,4595613,,True,34.0,6,13,6,9,0,4,9,12,7,7,14,2,0,0,6,3,21
401495105,Lehigh Mountain Hawks,M. Kramer,4704762,,True,36.0,10,19,3,9,7,10,1,2,0,4,4,1,0,0,5,3,28
401495105,Lehigh Mountain Hawks,A. Harvey,4595612,,True,30.0,1,7,0,4,1,3,1,2,0,3,3,6,1,0,2,1,4
401495105,Lehigh Mountain Hawks,J. Vargas-Bines,4900546,,False,8.0,1,3,1,2,0,1,0,0,0,1,1,0,0,1,1,3,2
401495105,Lehigh Mountain Hawks,K. Van Eps,4900545,,False,18.0,0,7,0,3,0,4,0,0,1,1,2,5,1,1,0,2,0
401495105,Lehigh Mountain Hawks,E. Stemmer,4900544,,False,20.0,3,8,0,1,3,7,2,2,2,3,5,1,0,0,2,2,11
401495105,Lehigh Mountain Hawks,M. Albrecht,4704763,,False,3.0,0,0,0,0,0,0,0,0,0,0,0,0,0,0,1,0,0
401495105,Lehigh Mountain Hawks,F. Eggenschwiler,4704761,,False,1.0,0,0,0,0,0,0,0,0,0,0,0,0,0,0,0,0,0
401495105,Lehigh Mountain Hawks,J. Behar,4433782,,False,3.0,0,0,0,0,0,0,0,0,0,1,1,0,0,0,0,0,0
401495105,Lehigh Mountain Hawks,TEAM,TOTAL,TOTAL,False,,27,70,13,33,14,37,13,18,16,34,50,20,2,4,22,20,81
401495104,Lehigh Mountain Hawks,L. Fandre,5109220,,True,18.0,2,2,0,0,2,2,0,0,0,4,4,1,0,0,2,1,6
401495104,Lehigh Mountain Hawks,M. O'Brien,4900547,,True,18.0,3,4,3,3,0,1,0,0,0,3,3,1,2,0,0,1,6
401495104,Lehigh Mountain Hawks,F. Hottinger,4595613,,True,13.0,8,11,6,9,2,2,0,0,2,2,4,0,1,0,3,3,18
401495104,Lehigh Mountain Hawks,M. Kramer,4704762,,True,15.0,5,6,0,0,5,6,3,3,0,0,0,2,1,0,2,1,18
401495104,Lehigh Mountain Hawks,A. Harvey,4595612,,True,18.0,0,2,0,2,0,0,0,0,1,4,5,11,1,0,0,0,0
401495104,Lehigh Mountain Hawks,J. Vargas-Bines,4900546,,False,12.0,2,3,2,3,0,0,0,0,1,1,2,1,0,3,0,0,4
401495104,Lehigh Mountain Hawks,M. Brown,4433751,,False,12.0,2,3,1,2,1,1,0,0,1,4,5,1,0,0,0,1,5
401495104,Lehigh Mountain Hawks,K. Hurt,5109219,,False,12.0,0,2,0,1,0,1,0,0,0,0,0,1,0,0,1,0,0
401495104,Lehigh Mountain Hawks,K. St.Paul,5109218,,False,4.0,0,0,0,0,0,0,0,0,0,1,1,0,0,0,1,1,0
401495104,Lehigh Mountain Hawks,K. Van Eps,4900545,,False,18.0,3,3,2,2,1,1,0,0,0,2,2,2,0,0,2,1,7
401495104,Lehigh Mountain Hawks,E. Stemmer,4900544,,False,14.0,5,6,3,3,2,3,2,2,0,1,1,1,4,0,0,2,14
401495104,Lehigh Mountain Hawks,M. Albrecht,4704763,,False,15.0,0,3,0,3,0,0,4,4,0,2,2,0,0,0,3,1,4
401495104,Lehigh Mountain Hawks,F. Eggenschwiler,4704761,,False,20.0,3,6,1,2,2,4,2,2,1,2,3,3,1,0,2,0,10
401495104,Lehigh Mountain Hawks,J. Behar,4433782,,False,11.0,1,2,0,0,1,2,2,2,0,2,2,3,0,1,1,0,5
401495104,Lehigh Mountain Hawks,TEAM,TOTAL,TOTAL,False,,34,53,18,30,16,23,13,13,6,28,34,27,10,4,17,12,97
401495104,Bloomsburg Huskies,A. Brown,5110937,,True,26.0,2,4,2,4,0,0,0,0,1,1,2,0,1,0,1,2,4
401495104,Bloomsburg Huskies,K. Starr,5110934,,True,14.0,2,3,2,3,0,0,0,0,0,1,1,0,0,0,1,3,4
401495104,Bloomsburg Huskies,E. Gochnauer,4599642,,True,20.0,4,8,4,8,0,0,0,2,0,0,0,2,0,0,1,1,8
401495104,Bloomsburg Huskies,E. Kale,5110935,,True,17.0,2,6,1,5,1,1,0,0,1,1,2,1,0,0,3,1,5
401495104,Bloomsburg Huskies,M. Fisher,4599635,,True,22.0,0,4,0,3,0,1,0,0,0,1,1,1,1,0,0,1,0
401495104,Bloomsburg Huskies,M. Lefrance,5113325,,False,12.0,2,7,0,1,2,6,2,2,0,0,0,1,2,0,0,0,8
401495104,Bloomsburg Huskies,H. Hudak,5110940,,False,20.0,1,3,1,2,0,1,1,2,1,1,2,1,1,1,0,1,3
401495104,Bloomsburg Huskies,N. Schmidt,5110936,,False,10.0,1,2,1,2,0,0,0,0,0,2,2,0,1,0,1,0,2
401495104,Bloomsburg Huskies,L. Kirsch,5110933,,False,23.0,3,6,0,2,3,4,0,0,0,0,0,1,0,0,2,1,9
401495104,Bloomsburg Huskies,K. Leszcynski,5110932,,False,15.0,3,6,1,3,2,3,0,0,0,0,0,0,0,0,2,1,8
401495104,Bloomsburg Huskies,A. Hileman,5110930,,False,14.0,0,3,0,0,0,3,0,2,0,2,2,1,1,0,3,1,0
401495104,Bloomsburg Huskies,J. Wheeler,5110931,,False,7.0,0,1,0,1,0,0,3,4,0,2,2,1,0,0,1,0,3
401495104,Bloomsburg Huskies,TEAM,TOTAL,TOTAL,False,,20,53,12,34,8,19,6,12,3,11,14,9,7,1,15,12,54
401494269,Merrimack Warriors,M. Hamilton,4282089,,True,28.0,7,15,6,12,1,3,9,10,1,7,8,1,1,0,0,1,24
401494269,Merrimack Warriors,A. Owens,4900512,,True,19.0,0,2,0,2,0,0,1,2,0,2,2,0,2,1,2,5,1
401494269,Merrimack Warriors,M. Manion,4900515,,True,29.0,1,3,1,2,0,1,0,0,1,3,4,0,0,1,2,1,2
401494269,Merrimack Warriors,K. Thomas,4597022,,True,27.0,2,5,1,2,1,3,0,1,1,3,4,3,0,0,2,3,5
401494269,Merrimack Warriors,J. DeCesare,4597019,,True,38.0,4,15,3,6,1,9,2,2,1,5,6,2,2,0,2,2,11
401494269,Merrimack Warriors,J. Powell,4900513,,False,0.0,0,0,0,0,0,0,0,0,0,0,0,0,0,0,0,0,0
401494269,Merrimack Warriors,A. Staton,4704140,,False,14.0,2,4,2,4,0,0,0,0,3,2,5,1,2,0,2,4,4
401494269,Merrimack Warriors,A. Fursman,4597025,,False,20.0,2,4,1,1,1,3,0,0,1,3,4,0,0,0,1,2,5
401494269,Merrimack Warriors,M. Bray,4598238,,False,25.0,4,4,2,2,2,2,3,4,0,1,1,1,0,0,1,0,13
401494269,Merrimack Warriors,TEAM,TOTAL,TOTAL,False,,22,52,16,31,6,21,15,19,9,28,37,8,7,2,13,18,65
401494269,Colgate Raiders,A. Ferguson,5109209,,True,22.0,1,5,1,5,0,0,0,0,1,2,3,2,1,0,0,3,2
401494269,Colgate Raiders,C. Midgette,5109204,,True,14.0,1,3,1,3,0,0,0,0,1,1,2,1,0,0,0,4,2
401494269,Colgate Raiders,T. Golembiewski,4900535,,True,25.0,3,9,1,2,2,7,6,8,0,5,5,0,0,1,2,2,14
401494269,Colgate Raiders,M. McMahon,4900534,,True,27.0,2,9,2,6,0,3,0,0,0,1,1,1,0,0,2,3,4
401494269,Colgate Raiders,A. Brodie,4595550,,True,22.0,1,5,1,2,0,3,0,0,1,3,4,0,0,0,0,1,2
401494269,Colgate Raiders,N. Parks,5109206,,False,4.0,0,1,0,1,0,0,0,2,0,1,1,0,0,0,1,0,0
401494269,Colgate Raiders,S. Diehl,4900536,,False,7.0,1,2,1,1,0,1,2,2,2,0,2,0,0,0,1,1,4
401494269,Colgate Raiders,L. Blackmore,4704706,,False,9.0,0,2,0,0,0,2,2,2,1,2,3,0,0,0,0,3,2
401494269,Colgate Raiders,T. McMillan,4704704,,False,22.0,1,5,1,5,0,0,0,0,2,0,2,1,0,0,1,1,2
401494269,Colgate Raiders,M. Schiller,5109205,,False,27.0,4,7,3,4,1,3,0,0,2,0,2,2,2,0,4,0,9
401494269,Colgate Raiders,J. Paul,4595552,,False,21.0,5,8,1,1,4,7,1,1,0,5,5,0,0,0,0,1,15
401494269,Colgate Raiders,TEAM,TOTAL,TOTAL,False,,19,56,12,30,7,26,11,15,10,23,33,7,3,1,11,19,56
401494083,Rider Broncs,R. Toussaint,4704617,,True,37.0,7,13,6,9,1,4,2,3,1,5,6,1,2,1,2,3,17
401494083,Rider Broncs,V. Toomey,4595396,,True,29.0,2,8,2,8,0,0,0,0,2,5,7,0,3,0,5,3,4
401494083,Rider Broncs,M. Firebaugh,4704621,,True,28.0,5,12,2,2,3,10,1,1,0,4,4,3,1,0,1,4,14
401494083,Rider Broncs,J. Schiffer,4595239,,True,37.0,7,14,2,5,5,9,0,0,0,3,3,3,1,0,2,0,19
401494083,Rider Broncs,A. Mobley,4399137,,True,35.0,2,8,1,3,1,5,0,2,0,0,0,8,1,0,1,1,5
401494083,Rider Broncs,T. Blanford,4705295,,False,14.0,1,1,1,1,0,0,0,1,1,2,3,0,0,0,1,2,2
401494083,Rider Broncs,D. Wentz,5109354,,False,1.0,0,0,0,0,0,0,0,0,0,0,0,0,0,0,0,1,0
401494083,Rider Broncs,M. Lynch,4704616,,False,5.0,1,1,0,0,1,1,0,0,0,0,0,0,0,0,0,0,3
401494083,Rider Broncs,M. Hyacienth,4595394,,False,14.0,1,3,0,1,1,2,0,0,0,2,2,0,0,1,0,1,3
401494083,Rider Broncs,TEAM,TOTAL,TOTAL,False,,26,60,14,29,12,31,3,7,5,22,27,15,8,2,12,15,67
401494083,Lehigh Mountain Hawks,L. Fandre,5109220,,True,23.0,2,4,1,1,1,3,1,1,1,2,3,1,0,1,1,1,6
401494083,Lehigh Mountain Hawks,M. O'Brien,4900547,,True,19.0,1,4,1,2,0,2,0,0,1,3,4,3,0,0,1,1,2
401494083,Lehigh Mountain Hawks,F. Hottinger,4595613,,True,36.0,12,21,9,15,3,6,7,8,4,9,13,2,1,0,2,2,34
401494083,Lehigh Mountain Hawks,M. Kramer,4704762,,True,37.0,11,15,7,11,4,4,0,0,0,5,5,4,0,0,1,1,26
401494083,Lehigh Mountain Hawks,A. Harvey,4595612,,True,34.0,2,6,1,3,1,3,0,0,0,3,3,4,0,1,2,0,5
401494083,Lehigh Mountain Hawks,J. Vargas-Bines,4900546,,False,7.0,0,1,0,0,0,1,0,0,0,2,2,0,0,0,1,0,0
401494083,Lehigh Mountain Hawks,M. Brown,4433751,,False,0.0,0,0,0,0,0,0,0,0,0,0,0,0,0,0,0,0,0
401494083,Lehigh Mountain Hawks,K. Van Eps,4900545,,False,29.0,2,7,0,1,2,6,0,0,1,2,3,4,0,0,2,0,6
401494083,Lehigh Mountain Hawks,E. Stemmer,4900544,,False,5.0,0,1,0,0,0,1,0,0,0,1,1,0,0,0,0,0,0
401494083,Lehigh Mountain Hawks,M. Albrecht,4704763,,False,7.0,1,1,1,1,0,0,0,0,0,2,2,2,0,0,1,0,2
401494083,Lehigh Mountain Hawks,F. Eggenschwiler,4704761,,False,0.0,0,0,0,0,0,0,0,0,0,0,0,0,0,0,0,1,0
401494083,Lehigh Mountain Hawks,J. Behar,4433782,,False,3.0,0,1,0,0,0,1,0,0,0,0,0,0,0,0,0,0,0
401494083,Lehigh Mountain Hawks,TEAM,TOTAL,TOTAL,False,,31,61,20,34,11,27,8,9,8,30,38,20,1,2,11,6,81
401493987,Minnesota Golden Gophers,A. Micheaux,4899054,,True,24.0,5,14,5,14,0,0,3,3,6,4,10,1,2,1,3,3,13
401493987,Minnesota Golden Gophers,M. Heyer,4858655,,True,29.0,5,10,3,5,2,5,0,0,2,2,4,0,0,0,2,2,12
401493987,Minnesota Golden Gophers,I. Gradwell,4399213,,True,22.0,0,5,0,2,0,3,0,0,1,4,5,4,0,0,1,0,0
401493987,Minnesota Golden Gophers,M. Braun,4858666,,True,38.0,12,26,7,13,5,13,5,6,1,2,3,1,4,0,1,1,34
401493987,Minnesota Golden Gophers,K. Borowicz,4711805,,True,20.0,3,12,1,7,2,5,4,4,1,3,4,4,5,0,1,4,12
401493987,Minnesota Golden Gophers,D. Oberg,4433678,,False,10.0,1,3,1,3,0,0,1,2,1,1,2,0,1,0,1,0,3
401493987,Minnesota Golden Gophers,M. Czinano,4899053,,False,15.0,3,6,3,6,0,0,2,3,5,2,7,1,0,0,1,0,8
401493987,Minnesota Golden Gophers,A. Battle,4682766,,False,32.0,8,18,8,17,0,1,1,2,4,5,9,2,2,2,0,4,17
401493987,Minnesota Golden Gophers,A. Hammond,4399154,,False,2.0,0,1,0,1,0,0,0,0,0,0,0,0,0,0,0,0,0
401493987,Minnesota Golden Gophers,M. Cayton,4066525,,False,8.0,0,1,0,0,0,1,2,2,0,1,1,4,1,0,1,0,2
401493987,Minnesota Golden Gophers,TEAM,TOTAL,TOTAL,False,,37,96,28,68,9,28,18,22,26,25,51,17,15,3,11,14,101
401493987,Lehigh Mountain Hawks,L. Fandre,5109220,,True,23.0,1,4,0,2,1,2,0,0,0,1,1,2,1,1,0,3,3
401493987,Lehigh Mountain Hawks,M. O'Brien,4900547,,True,28.0,6,10,4,6,2,4,0,0,0,8,8,1,2,1,2,2,14
401493987,Lehigh Mountain Hawks,F. Hottinger,4595613,,True,33.0,11,20,9,15,2,5,1,2,2,10,12,2,2,1,2,4,25
401493987,Lehigh Mountain Hawks,M. Kramer,4704762,,True,40.0,10,15,6,10,4,5,2,2,0,3,3,11,3,1,5,1,26
401493987,Lehigh Mountain Hawks,A. Harvey,4595612,,True,19.0,2,3,2,2,0,1,5,6,1,1,2,4,0,0,6,4,9
401493987,Lehigh Mountain Hawks,J. Vargas-Bines,4900546,,False,1.0,0,0,0,0,0,0,0,0,0,2,2,0,0,0,2,1,0
401493987,Lehigh Mountain Hawks,K. Van Eps,4900545,,False,24.0,5,6,3,3,2,3,2,3,0,3,3,5,0,0,2,4,14
401493987,Lehigh Mountain Hawks,E. Stemmer,4900544,,False,20.0,3,7,1,1,2,6,0,0,1,2,3,0,1,0,1,0,8
401493987,Lehigh Mountain Hawks,M. Albrecht,4704763,,False,6.0,0,0,0,0,0,0,0,0,0,0,0,0,0,0,1,0,0
401493987,Lehigh Mountain Hawks,J. Behar,4433782,,False,6.0,0,3,0,1,0,2,0,0,0,1,1,0,1,1,1,0,0
401493987,Lehigh Mountain Hawks,TEAM,TOTAL,TOTAL,False,,38,68,25,40,13,28,10,13,6,34,40,25,10,5,22,19,99
401493102,Yale Bulldogs,H. Sabol,4899334,,True,31.0,1,7,1,6,0,1,0,0,1,5,6,1,0,0,0,2,2
401493102,Yale Bulldogs,K. Capstraw,5108958,,True,36.0,8,14,7,11,1,3,5,6,1,3,4,1,1,0,1,3,22
401493102,Yale Bulldogs,N. McGill,4899339,,True,40.0,2,5,2,5,0,0,1,2,5,5,10,2,6,0,2,0,5
401493102,Yale Bulldogs,M. Egger,4899338,,True,16.0,1,5,0,3,1,2,2,4,2,1,3,0,1,0,1,0,5
401493102,Yale Bulldogs,J. Clark,4594954,,True,37.0,6,16,1,9,5,7,0,0,1,3,4,6,1,0,4,4,17
401493102,Yale Bulldogs,B. McDonald,4899337,,False,6.0,1,2,1,2,0,0,0,0,0,1,1,0,0,0,0,1,2
401493102,Yale Bulldogs,G. Thybulle,4899336,,False,7.0,2,2,2,2,0,0,0,0,2,1,3,0,1,0,6,3,4
401493102,Yale Bulldogs,E. van der Maas,4899335,,False,19.0,2,12,0,6,2,6,0,0,0,2,2,0,0,0,0,1,6
401493102,Yale Bulldogs,A. Lee,4899333,,False,3.0,0,1,0,1,0,0,0,0,0,1,1,0,0,0,0,0,0
401493102,Yale Bulldogs,C. McCann,4899332,,False,5.0,0,1,0,1,0,0,0,0,0,1,1,0,0,0,0,1,0
401493102,Yale Bulldogs,TEAM,TOTAL,TOTAL,False,,23,65,14,46,9,19,8,12,16,26,42,10,10,0,15,15,63
401493102,Lehigh Mountain Hawks,L. Fandre,5109220,,True,12.0,0,1,0,1,0,0,3,3,0,3,3,0,0,0,2,1,3
401493102,Lehigh Mountain Hawks,M. O'Brien,4900547,,True,24.0,1,2,0,1,1,1,1,2,0,2,2,1,0,0,0,2,4
401493102,Lehigh Mountain Hawks,F. Hottinger,4595613,,True,39.0,6,14,6,12,0,2,9,9,3,6,9,1,1,0,1,1,21
401493102,Lehigh Mountain Hawks,M. Kramer,4704762,,True,39.0,7,14,4,9,3,5,1,2,0,4,4,3,1,1,6,0,18
401493102,Lehigh Mountain Hawks,A. Harvey,4595612,,True,35.0,3,5,3,4,0,1,0,0,0,1,1,4,1,1,0,0,6
401493102,Lehigh Mountain Hawks,K. Van Eps,4900545,,False,13.0,1,4,1,2,0,2,0,0,0,1,1,1,2,1,2,3,2
401493102,Lehigh Mountain Hawks,E. Stemmer,4900544,,False,7.0,0,3,0,1,0,2,0,0,0,0,0,0,0,0,1,0,0
401493102,Lehigh Mountain Hawks,M. Albrecht,4704763,,False,8.0,1,2,1,1,0,1,0,0,0,0,0,1,1,0,0,2,2
401493102,Lehigh Mountain Hawks,J. Behar,4433782,,False,23.0,5,8,1,2,4,6,0,0,0,4,4,2,0,1,2,1,14
401493102,Lehigh Mountain Hawks,TEAM,TOTAL,TOTAL,False,,24,53,16,33,8,20,14,16,4,28,32,13,6,4,14,10,70
401492597,UMass Lowell River Hawks,A. Dowdy,4898981,,True,22.0,7,8,7,8,0,0,0,1,2,1,3,0,0,1,0,5,14
401492597,UMass Lowell River Hawks,I. Finley,4898983,,True,35.0,6,14,4,8,2,6,3,6,3,6,9,2,3,1,4,4,17
401492597,UMass Lowell River Hawks,J. Edmonds,4704207,,True,34.0,3,10,1,4,2,6,0,0,0,3,3,5,1,1,3,1,8
401492597,UMass Lowell River Hawks,M. Carrera,4605757,,True,18.0,0,4,0,1,0,3,0,0,0,0,0,2,0,0,2,0,0
401492597,UMass Lowell River Hawks,J. Sanchez,4594358,,True,35.0,1,3,1,1,0,2,0,0,0,1,1,4,1,0,4,4,2
401492597,UMass Lowell River Hawks,S. Coombs,4704206,,False,12.0,1,2,1,2,0,0,1,2,1,3,4,1,0,0,0,1,3
401492597,UMass Lowell River Hawks,E. Ner,5107651,,False,22.0,1,4,0,1,1,3,0,0,1,0,1,0,0,0,1,1,3
401492597,UMass Lowell River Hawks,K. Banwareesingh,4594359,,False,22.0,4,6,2,3,2,3,0,0,0,6,6,2,1,0,4,2,10
401492597,UMass Lowell River Hawks,TEAM,TOTAL,TOTAL,False,,23,51,16,28,7,23,4,9,8,25,33,16,6,3,20,18,57
401492597,Holy Cross Crusaders,L. Berger,4900539,,True,27.0,6,8,6,8,0,0,6,6,1,3,4,5,0,0,2,1,18
401492597,Holy Cross Crusaders,J. Allen,4704714,,True,21.0,5,11,5,11,0,0,1,3,1,4,5,1,0,0,3,0,11
401492597,Holy Cross Crusaders,K. Flanagan,5109211,,True,30.0,3,7,3,7,0,0,3,4,1,2,3,3,1,0,3,3,9
401492597,Holy Cross Crusaders,B. Power-Cassidy,4704715,,True,26.0,3,9,2,5,1,4,0,0,2,1,3,2,1,0,0,1,7
401492597,Holy Cross Crusaders,A. Cross,4595975,,True,31.0,0,4,0,3,0,1,0,0,1,0,1,1,3,0,1,1,0
401492597,Holy Cross Crusaders,C. Wright,4703660,,False,10.0,1,2,1,2,0,0,0,0,0,0,0,1,0,0,0,0,2
401492597,Holy Cross Crusaders,M. Donnelly,5109213,,False,26.0,1,4,0,1,1,3,0,0,1,4,5,1,1,0,0,3,3
401492597,Holy Cross Crusaders,S. Foreman,5109212,,False,3.0,0,1,0,1,0,0,0,0,0,1,1,0,0,0,0,0,0
401492597,Holy Cross Crusaders,C. McCormack,4704716,,False,26.0,4,10,2,6,2,4,2,2,1,4,5,3,0,0,3,1,12
401492597,Holy Cross Crusaders,TEAM,TOTAL,TOTAL,False,,23,56,19,44,4,12,12,15,9,21,30,17,6,0,13,10,62
401492517,Lehigh Mountain Hawks,M. O'Brien,4900547,,True,22.0,0,7,0,4,0,3,2,2,1,1,2,1,0,2,1,0,2
401492517,Lehigh Mountain Hawks,F. Hottinger,4595613,,True,30.0,2,10,2,6,0,4,5,5,2,9,11,1,0,0,2,0,9
401492517,Lehigh Mountain Hawks,K. Van Eps,4900545,,True,25.0,1,5,1,4,0,1,0,0,1,2,3,2,0,0,2,3,2
401492517,Lehigh Mountain Hawks,M. Kramer,4704762,,True,33.0,7,12,2,3,5,9,1,2,0,2,2,2,1,0,5,3,20
401492517,Lehigh Mountain Hawks,A. Harvey,4595612,,True,21.0,2,5,1,2,1,3,0,0,0,1,1,1,0,0,1,1,5
401492517,Lehigh Mountain Hawks,L. Fandre,5109220,,False,25.0,4,7,1,3,3,4,2,2,1,4,5,2,0,1,0,1,13
401492517,Lehigh Mountain Hawks,J. Vargas-Bines,4900546,,False,5.0,1,1,1,1,0,0,0,0,0,0,0,0,0,1,0,0,2
401492517,Lehigh Mountain Hawks,E. Stemmer,4900544,,False,18.0,2,6,1,3,1,3,0,0,0,3,3,2,0,0,1,2,5
401492517,Lehigh Mountain Hawks,M. Albrecht,4704763,,False,13.0,1,3,0,0,1,3,0,0,0,0,0,2,0,0,0,0,3
401492517,Lehigh Mountain Hawks,F. Eggenschwiler,4704761,,False,2.0,0,0,0,0,0,0,0,0,0,0,0,0,0,0,0,0,0
401492517,Lehigh Mountain Hawks,J. Behar,4433782,,False,6.0,0,2,0,1,0,1,0,0,0,1,1,1,0,1,0,0,0
401492517,Lehigh Mountain Hawks,TEAM,TOTAL,TOTAL,False,,20,58,9,27,11,31,10,11,8,25,33,14,1,5,12,10,61
401492517,Drexel Dragons,K. Lavelle,5108782,,True,29.0,9,11,8,10,1,1,1,4,0,3,3,0,1,0,1,3,20
401492517,Drexel Dragons,H. Saatman,4594714,,True,27.0,5,5,4,4,1,1,0,0,2,5,7,0,0,1,0,1,11
401492517,Drexel Dragons,G. O'Neill,5108781,,True,36.0,0,0,0,0,0,0,0,0,1,2,3,2,2,0,0,1,0
401492517,Drexel Dragons,M. Hendrixson,4399845,,True,32.0,4,11,0,3,4,8,0,0,0,7,7,8,2,0,2,1,12
401492517,Drexel Dragons,K. Washington,4399843,,True,35.0,11,26,8,19,3,7,8,9,0,3,3,10,1,0,1,0,33
401492517,Drexel Dragons,J. Valentine,4704570,,False,22.0,3,6,3,6,0,0,0,0,1,6,7,0,0,0,0,2,6
401492517,Drexel Dragons,B. Borcky,4594717,,False,11.0,0,1,0,1,0,0,0,0,1,2,3,4,0,0,1,2,0
401492517,Drexel Dragons,C. Hodges,4704567,,False,2.0,0,1,0,1,0,0,0,0,0,0,0,0,0,0,0,0,0
401492517,Drexel Dragons,J. Martin,5108783,,False,2.0,0,0,0,0,0,0,0,0,0,0,0,0,0,0,0,0,0
401492517,Drexel Dragons,E. Sweeney,4704568,,False,2.0,0,1,0,1,0,0,0,0,1,0,1,0,0,0,0,0,0
401492517,Drexel Dragons,T. Hyduke,4399080,,False,2.0,1,2,1,2,0,0,0,0,0,1,1,0,1,0,0,0,2
401492517,Drexel Dragons,TEAM,TOTAL,TOTAL,False,,33,64,24,47,9,17,9,13,7,30,37,24,7,1,5,10,84
401492513,Lehigh Mountain Hawks,L. Fandre,5109220,,True,17.0,0,4,0,0,0,4,2,2,1,1,2,0,0,0,1,5,2
401492513,Lehigh Mountain Hawks,M. O'Brien,4900547,,True,21.0,2,5,2,2,0,3,0,0,0,2,2,3,3,1,0,2,4
401492513,Lehigh Mountain Hawks,F. Hottinger,4595613,,True,29.0,7,15,5,12,2,3,4,6,4,7,11,0,0,0,3,4,20
401492513,Lehigh Mountain Hawks,M. Kramer,4704762,,True,37.0,3,14,1,3,2,11,3,4,0,7,7,1,1,0,4,1,11
401492513,Lehigh Mountain Hawks,A. Harvey,4595612,,True,29.0,1,1,0,0,1,1,0,0,0,3,3,4,2,0,4,0,3
401492513,Lehigh Mountain Hawks,J. Vargas-Bines,4900546,,False,3.0,0,1,0,0,0,1,0,0,0,0,0,0,0,0,0,1,0
401492513,Lehigh Mountain Hawks,K. Van Eps,4900545,,False,19.0,0,4,0,1,0,3,2,2,0,1,1,3,0,0,2,1,2
401492513,Lehigh Mountain Hawks,E. Stemmer,4900544,,False,28.0,5,10,1,1,4,9,0,1,1,2,3,3,0,0,2,2,14
401492513,Lehigh Mountain Hawks,M. Albrecht,4704763,,False,2.0,0,0,0,0,0,0,1,2,1,0,1,0,0,0,1,0,1
401492513,Lehigh Mountain Hawks,J. Behar,4433782,,False,15.0,4,9,2,3,2,6,0,0,1,3,4,1,2,0,1,1,10
401492513,Lehigh Mountain Hawks,TEAM,TOTAL,TOTAL,False,,22,63,11,22,11,41,12,17,8,26,34,15,8,1,18,17,67
401492513,Delaware Blue Hens,M. Pippin,4703429,,True,30.0,7,13,7,13,0,0,0,0,1,12,13,2,2,0,5,0,14
401492513,Delaware Blue Hens,K. Sconiers,4433683,,True,31.0,10,12,10,12,0,0,9,13,4,7,11,0,0,1,3,1,29
401492513,Delaware Blue Hens,T. Cousins,4704511,,True,31.0,5,13,3,11,2,2,3,4,0,7,7,3,0,0,1,3,15
401492513,Delaware Blue Hens,J. Smalls,4400634,,True,30.0,4,10,1,3,3,7,2,2,0,2,2,2,2,0,1,3,13
401492513,Delaware Blue Hens,K. Idom,4399260,,True,27.0,1,7,1,6,0,1,0,0,0,2,2,2,1,0,7,3,2
401492513,Delaware Blue Hens,M. Ojo,4898513,,False,13.0,1,3,1,3,0,0,0,0,2,2,4,0,1,0,2,5,2
401492513,Delaware Blue Hens,N. Mays-Prince,5108758,,False,19.0,2,7,2,6,0,1,0,0,2,4,6,5,3,0,1,1,4
401492513,Delaware Blue Hens,M. Yanogacio,4899570,,False,18.0,0,0,0,0,0,0,0,0,0,0,0,2,0,0,0,3,0
401492513,Delaware Blue Hens,J. Reid,4704514,,False,1.0,0,0,0,0,0,0,0,0,0,0,0,0,0,0,0,0,0
401492513,Delaware Blue Hens,TEAM,TOTAL,TOTAL,False,,30,65,25,54,5,11,14,19,9,36,45,16,9,1,20,19,79
401492412,Holy Cross Crusaders,L. Berger,4900539,,True,31.0,5,12,5,12,0,0,5,7,5,7,12,4,1,1,4,2,15
401492412,Holy Cross Crusaders,J. Allen,4704714,,True,17.0,1,4,1,3,0,1,0,0,0,1,1,1,0,0,6,3,2
401492412,Holy Cross Crusaders,K. Flanagan,5109211,,True,38.0,1,5,1,3,0,2,2,2,0,1,1,7,1,0,3,2,4
401492412,Holy Cross Crusaders,B. Power-Cassidy,4704715,,True,23.0,7,12,6,9,1,3,2,2,0,1,1,1,1,0,1,4,17
401492412,Holy Cross Crusaders,A. Cross,4595975,,True,34.0,3,5,2,3,1,2,0,0,0,1,1,2,1,0,4,3,7
401492412,Holy Cross Crusaders,C. Wright,4703660,,False,19.0,3,3,3,3,0,0,1,4,1,2,3,1,2,1,0,1,7
401492412,Holy Cross Crusaders,M. Donnelly,5109213,,False,30.0,6,10,4,5,2,5,0,0,1,7,8,3,0,0,2,0,14
401492412,Holy Cross Crusaders,L. Huber,4900538,,False,6.0,1,1,1,1,0,0,0,0,1,2,3,0,0,0,2,0,2
401492412,Holy Cross Crusaders,G. Munt,4900537,,False,2.0,0,0,0,0,0,0,0,0,0,0,0,0,0,0,0,0,0
401492412,Holy Cross Crusaders,TEAM,TOTAL,TOTAL,False,,27,52,23,39,4,13,10,15,10,24,34,19,6,2,22,15,68
401492412,Dartmouth Big Green,O. Lawlor,5108940,,True,35.0,8,16,8,16,0,0,4,6,3,3,6,0,3,0,3,2,20
401492412,Dartmouth Big Green,E. Koch,4594967,,True,19.0,1,5,1,4,0,1,0,0,1,3,4,1,2,0,2,5,2
401492412,Dartmouth Big Green,V. Page,4899314,,True,31.0,4,7,4,5,0,2,0,0,0,2,2,4,1,0,4,3,8
401492412,Dartmouth Big Green,M. Curtis,4705219,,True,16.0,2,4,1,3,1,1,1,2,1,0,1,0,1,0,2,3,6
401492412,Dartmouth Big Green,M. Boyd,4703759,,True,37.0,1,8,1,6,0,2,0,0,3,4,7,3,5,0,2,2,2
401492412,Dartmouth Big Green,C. Meyer,5108941,,False,4.0,0,2,0,2,0,0,0,0,0,2,2,0,0,0,2,0,0
401492412,Dartmouth Big Green,G. Niekelski,4899312,,False,17.0,1,7,1,4,0,3,1,2,0,2,2,2,2,0,4,3,3
401492412,Dartmouth Big Green,C. Washburn,4705221,,False,6.0,1,1,1,1,0,0,1,2,1,0,1,0,0,0,1,1,3
401492412,Dartmouth Big Green,A. Nelson,5108943,,False,8.0,0,0,0,0,0,0,0,0,0,0,0,0,0,0,0,0,0
401492412,Dartmouth Big Green,L. Stuart,4704724,,False,12.0,1,2,0,1,1,1,0,0,0,0,0,0,0,0,1,0,3
401492412,Dartmouth Big Green,A. Harland,4594965,,False,13.0,1,2,0,0,1,2,3,3,1,0,1,1,1,0,1,2,6
401492412,Dartmouth Big Green,K. Mitchell,4594964,,False,2.0,1,2,1,2,0,0,0,0,0,0,0,0,0,0,0,0,2
401492412,Dartmouth Big Green,TEAM,TOTAL,TOTAL,False,,21,56,18,44,3,12,10,15,14,18,32,11,15,0,22,21,55
401492008,Bucknell Bison,I. King,4900533,,True,27.0,0,1,0,0,0,1,2,4,0,2,2,1,0,0,1,0,2
401492008,Bucknell Bison,E. Shaffer,4595535,,True,34.0,11,17,11,17,0,0,2,2,2,9,11,2,1,0,0,2,24
401492008,Bucknell Bison,E. Theodorsson,5109199,,True,27.0,1,6,1,5,0,1,0,0,1,1,2,1,0,1,2,4,2
401492008,Bucknell Bison,C. Collins,4900532,,True,27.0,2,8,2,7,0,1,8,9,1,2,3,1,0,0,3,3,12
401492008,Bucknell Bison,T. Johnson,4595533,,True,32.0,5,9,5,9,0,0,2,4,0,4,4,5,0,0,3,2,12
401492008,Bucknell Bison,G. Sullivan,5109201,,False,5.0,2,2,2,2,0,0,1,1,1,1,2,0,0,1,0,2,5
401492008,Bucknell Bison,R. Sisselman,4900531,,False,16.0,3,4,0,1,3,3,0,0,0,3,3,0,0,0,1,1,9
401492008,Bucknell Bison,J. Kulesza,4704702,,False,10.0,0,0,0,0,0,0,1,2,0,1,1,2,0,0,0,2,1
401492008,Bucknell Bison,C. Dingler,4577540,,False,22.0,1,2,1,1,0,1,0,0,0,0,0,3,1,0,1,1,2
401492008,Bucknell Bison,TEAM,TOTAL,TOTAL,False,,25,49,22,42,3,7,16,22,5,25,30,15,2,2,11,17,69
401492008,Bucknell Bison,I. King,4900533,,True,27.0,0,1,0,0,0,1,2,4,0,2,2,1,0,0,1,0,2
401492008,Bucknell Bison,E. Shaffer,4595535,,True,34.0,11,17,11,17,0,0,2,2,2,9,11,2,1,0,0,2,24
401492008,Bucknell Bison,E. Theodorsson,5109199,,True,27.0,1,6,1,5,0,1,0,0,1,1,2,1,0,1,2,4,2
401492008,Bucknell Bison,C. Collins,4900532,,True,27.0,2,8,2,7,0,1,8,9,1,2,3,1,0,0,3,3,12
401492008,Bucknell Bison,T. Johnson,4595533,,True,32.0,5,9,5,9,0,0,2,4,0,4,4,5,0,0,3,2,12
401492008,Bucknell Bison,G. Sullivan,5109201,,False,5.0,2,2,2,2,0,0,1,1,1,1,2,0,0,1,0,2,5
401492008,Bucknell Bison,R. Sisselman,4900531,,False,16.0,3,4,0,1,3,3,0,0,0,3,3,0,0,0,1,1,9
401492008,Bucknell Bison,J. Kulesza,4704702,,False,10.0,0,0,0,0,0,0,1,2,0,1,1,2,0,0,0,2,1
401492008,Bucknell Bison,C. Dingler,4577540,,False,22.0,1,2,1,1,0,1,0,0,0,0,0,3,1,0,1,1,2
401492008,Bucknell Bison,TEAM,TOTAL,TOTAL,False,,25,49,22,42,3,7,16,22,5,25,30,15,2,2,11,17,69
401492008,American University Eagles,E. Johns,4704688,,True,24.0,6,12,6,11,0,1,1,2,2,2,4,0,2,1,1,4,13
401492008,American University Eagles,L. Stack,4595455,,True,38.0,6,10,6,9,0,1,2,2,0,4,4,1,0,0,1,4,14
401492008,American University Eagles,K. Henning,4704686,,True,30.0,2,9,1,7,1,2,0,0,0,4,4,6,0,0,3,1,5
401492008,American University Eagles,I. Bales,4704685,,True,34.0,7,8,5,5,2,3,1,2,1,2,3,4,1,0,3,5,17
401492008,American University Eagles,S. Stetson,4595453,,True,31.0,4,9,3,7,1,2,0,2,0,1,1,0,0,0,0,3,9
401492008,American University Eagles,M. Lavin,5109188,,False,14.0,0,2,0,0,0,2,1,2,1,5,6,0,0,0,1,2,1
401492008,American University Eagles,L. Nogues,5109187,,False,3.0,0,1,0,0,0,1,0,0,0,1,1,1,1,0,0,1,0
401492008,American University Eagles,A. Rescifina,5109186,,False,4.0,0,1,0,0,0,1,0,0,1,0,1,1,0,0,0,1,0
401492008,American University Eagles,B. Garbee,4899710,,False,7.0,0,0,0,0,0,0,2,2,0,0,0,0,0,0,0,2,2
401492008,American University Eagles,A. LeMaster,4703737,,False,14.0,1,4,0,2,1,2,2,2,0,2,2,1,0,0,1,0,5
401492008,American University Eagles,L. Graytok,4400159,,False,1.0,0,0,0,0,0,0,0,0,0,0,0,0,0,0,0,0,0
401492008,American University Eagles,TEAM,TOTAL,TOTAL,False,,26,56,21,41,5,15,9,14,5,21,26,14,4,1,11,23,66
401492008,American University Eagles,E. Johns,4704688,,True,24.0,6,12,6,11,0,1,1,2,2,2,4,0,2,1,1,4,13
401492008,American University Eagles,L. Stack,4595455,,True,38.0,6,10,6,9,0,1,2,2,0,4,4,1,0,0,1,4,14
401492008,American University Eagles,K. Henning,4704686,,True,30.0,2,9,1,7,1,2,0,0,0,4,4,6,0,0,3,1,5
401492008,American University Eagles,I. Bales,4704685,,True,34.0,7,8,5,5,2,3,1,2,1,2,3,4,1,0,3,5,17
401492008,American University Eagles,S. Stetson,4595453,,True,31.0,4,9,3,7,1,2,0,2,0,1,1,0,0,0,0,3,9
401492008,American University Eagles,M. Lavin,5109188,,False,14.0,0,2,0,0,0,2,1,2,1,5,6,0,0,0,1,2,1
401492008,American University Eagles,L. Nogues,5109187,,False,3.0,0,1,0,0,0,1,0,0,0,1,1,1,1,0,0,1,0
401492008,American University Eagles,A. Rescifina,5109186,,False,4.0,0,1,0,0,0,1,0,0,1,0,1,1,0,0,0,1,0
401492008,American University Eagles,B. Garbee,4899710,,False,7.0,0,0,0,0,0,0,2,2,0,0,0,0,0,0,0,2,2
401492008,American University Eagles,A. LeMaster,4703737,,False,14.0,1,4,0,2,1,2,2,2,0,2,2,1,0,0,1,0,5
401492008,American University Eagles,L. Graytok,4400159,,False,1.0,0,0,0,0,0,0,0,0,0,0,0,0,0,0,0,0,0
401492008,American University Eagles,TEAM,TOTAL,TOTAL,False,,26,56,21,41,5,15,9,14,5,21,26,14,4,1,11,23,66
401492007,Lehigh Mountain Hawks,L. Fandre,5109220,,True,22.0,1,6,0,0,1,6,0,2,0,10,10,1,0,0,1,3,3
401492007,Lehigh Mountain Hawks,F. Hottinger,4595613,,True,35.0,6,15,6,10,0,5,5,8,1,5,6,1,5,1,2,4,17
401492007,Lehigh Mountain Hawks,E. Stemmer,4900544,,True,24.0,1,6,1,1,0,5,0,0,0,1,1,1,0,0,1,2,2
401492007,Lehigh Mountain Hawks,M. Kramer,4704762,,True,36.0,6,15,4,9,2,6,0,1,1,3,4,3,1,0,2,0,14
401492007,Lehigh Mountain Hawks,A. Harvey,4595612,,True,40.0,4,6,1,2,3,4,2,3,0,6,6,4,0,0,3,1,13
401492007,Lehigh Mountain Hawks,M. O'Brien,4900547,,False,6.0,0,1,0,0,0,1,0,0,0,0,0,2,0,0,1,2,0
401492007,Lehigh Mountain Hawks,K. Van Eps,4900545,,False,11.0,0,0,0,0,0,0,0,0,0,1,1,1,0,0,1,0,0
401492007,Lehigh Mountain Hawks,M. Albrecht,4704763,,False,3.0,0,0,0,0,0,0,0,0,0,0,0,1,0,1,0,0,0
401492007,Lehigh Mountain Hawks,J. Behar,4433782,,False,23.0,5,12,2,4,3,8,4,5,4,4,8,0,0,0,3,1,17
401492007,Lehigh Mountain Hawks,TEAM,TOTAL,TOTAL,False,,23,61,14,26,9,35,11,19,6,38,44,14,6,2,14,13,66
401492007,Lehigh Mountain Hawks,L. Fandre,5109220,,True,22.0,1,6,0,0,1,6,0,2,0,10,10,1,0,0,1,3,3
401492007,Lehigh Mountain Hawks,F. Hottinger,4595613,,True,35.0,6,15,6,10,0,5,5,8,1,5,6,1,5,1,2,4,17
401492007,Lehigh Mountain Hawks,E. Stemmer,4900544,,True,24.0,1,6,1,1,0,5,0,0,0,1,1,1,0,0,1,2,2
401492007,Lehigh Mountain Hawks,M. Kramer,4704762,,True,36.0,6,15,4,9,2,6,0,1,1,3,4,3,1,0,2,0,14
401492007,Lehigh Mountain Hawks,A. Harvey,4595612,,True,40.0,4,6,1,2,3,4,2,3,0,6,6,4,0,0,3,1,13
401492007,Lehigh Mountain Hawks,M. O'Brien,4900547,,False,6.0,0,1,0,0,0,1,0,0,0,0,0,2,0,0,1,2,0
401492007,Lehigh Mountain Hawks,K. Van Eps,4900545,,False,11.0,0,0,0,0,0,0,0,0,0,1,1,1,0,0,1,0,0
401492007,Lehigh Mountain Hawks,M. Albrecht,4704763,,False,3.0,0,0,0,0,0,0,0,0,0,0,0,1,0,1,0,0,0
401492007,Lehigh Mountain Hawks,J. Behar,4433782,,False,23.0,5,12,2,4,3,8,4,5,4,4,8,0,0,0,3,1,17
401492007,Lehigh Mountain Hawks,TEAM,TOTAL,TOTAL,False,,23,61,14,26,9,35,11,19,6,38,44,14,6,2,14,13,66
401492007,American University Eagles,E. Johns,4704688,,True,27.0,3,7,3,7,0,0,3,4,0,4,4,0,0,0,3,1,9
401492007,American University Eagles,L. Stack,4595455,,True,31.0,4,11,4,11,0,0,2,2,2,3,5,1,2,0,2,3,10
401492007,American University Eagles,B. Garbee,4899710,,True,22.0,1,5,0,2,1,3,0,2,0,3,3,0,0,1,1,1,3
401492007,American University Eagles,K. Henning,4704686,,True,29.0,7,13,7,13,0,0,0,0,0,3,3,4,3,0,1,2,14
401492007,American University Eagles,I. Bales,4704685,,True,27.0,1,7,1,5,0,2,0,0,1,6,7,1,0,0,1,2,2
401492007,American University Eagles,M. Lavin,5109188,,False,19.0,2,8,2,6,0,2,0,0,1,5,6,2,0,1,3,3,4
401492007,American University Eagles,L. Nogues,5109187,,False,14.0,2,2,1,1,1,1,0,0,0,2,2,2,0,0,2,4,5
401492007,American University Eagles,A. Rescifina,5109186,,False,16.0,0,2,0,1,0,1,0,0,0,1,1,0,1,0,2,0,0
401492007,American University Eagles,A. LeMaster,4703737,,False,15.0,1,7,1,3,0,4,0,0,0,2,2,0,0,0,2,4,2
401492007,American University Eagles,TEAM,TOTAL,TOTAL,False,,21,62,19,49,2,13,5,8,5,34,39,10,6,2,17,20,49
401492007,American University Eagles,E. Johns,4704688,,True,27.0,3,7,3,7,0,0,3,4,0,4,4,0,0,0,3,1,9
401492007,American University Eagles,L. Stack,4595455,,True,31.0,4,11,4,11,0,0,2,2,2,3,5,1,2,0,2,3,10
401492007,American University Eagles,B. Garbee,4899710,,True,22.0,1,5,0,2,1,3,0,2,0,3,3,0,0,1,1,1,3
401492007,American University Eagles,K. Henning,4704686,,True,29.0,7,13,7,13,0,0,0,0,0,3,3,4,3,0,1,2,14
401492007,American University Eagles,I. Bales,4704685,,True,27.0,1,7,1,5,0,2,0,0,1,6,7,1,0,0,1,2,2
401492007,American University Eagles,M. Lavin,5109188,,False,19.0,2,8,2,6,0,2,0,0,1,5,6,2,0,1,3,3,4
401492007,American University Eagles,L. Nogues,5109187,,False,14.0,2,2,1,1,1,1,0,0,0,2,2,2,0,0,2,4,5
401492007,American University Eagles,A. Rescifina,5109186,,False,16.0,0,2,0,1,0,1,0,0,0,1,1,0,1,0,2,0,0
401492007,American University Eagles,A. LeMaster,4703737,,False,15.0,1,7,1,3,0,4,0,0,0,2,2,0,0,0,2,4,2
401492007,American University Eagles,TEAM,TOTAL,TOTAL,False,,21,62,19,49,2,13,5,8,5,34,39,10,6,2,17,20,49
401492006,Bucknell Bison,I. King,4900533,,True,20.0,1,5,1,1,0,4,0,0,0,1,1,0,0,0,1,2,2
401492006,Bucknell Bison,E. Shaffer,4595535,,True,35.0,3,10,3,10,0,0,6,8,7,14,21,3,1,1,3,2,12
401492006,Bucknell Bison,E. Theodorsson,5109199,,True,27.0,7,12,5,6,2,6,0,0,0,1,1,1,2,0,2,0,16
401492006,Bucknell Bison,C. Collins,4900532,,True,32.0,3,8,3,6,0,2,2,2,0,3,3,2,0,0,3,3,8
401492006,Bucknell Bison,T. Johnson,4595533,,True,34.0,3,6,2,5,1,1,0,0,0,5,5,1,0,0,2,3,7
401492006,Bucknell Bison,G. Klag,5109202,,False,1.0,1,1,1,1,0,0,0,0,0,0,0,0,0,0,0,0,2
401492006,Bucknell Bison,N. Davis,4704701,,False,4.0,0,1,0,1,0,0,0,0,0,0,0,0,0,0,1,1,0
401492006,Bucknell Bison,R. Sisselman,4900531,,False,13.0,4,7,1,1,3,6,1,1,0,0,0,1,0,0,0,1,12
401492006,Bucknell Bison,B. Matthews,5109200,,False,1.0,0,0,0,0,0,0,0,0,0,0,0,1,0,0,0,0,0
401492006,Bucknell Bison,J. Kulesza,4704702,,False,20.0,2,4,1,1,1,3,0,0,0,2,2,2,1,0,1,1,5
401492006,Bucknell Bison,C. Dingler,4577540,,False,13.0,0,1,0,0,0,1,0,0,0,1,1,1,0,0,1,0,0
401492006,Bucknell Bison,TEAM,TOTAL,TOTAL,False,,24,55,17,32,7,23,9,11,7,29,36,12,4,1,14,13,64
401492006,Bucknell Bison,I. King,4900533,,True,20.0,1,5,1,1,0,4,0,0,0,1,1,0,0,0,1,2,2
401492006,Bucknell Bison,E. Shaffer,4595535,,True,35.0,3,10,3,10,0,0,6,8,7,14,21,3,1,1,3,2,12
401492006,Bucknell Bison,E. Theodorsson,5109199,,True,27.0,7,12,5,6,2,6,0,0,0,1,1,1,2,0,2,0,16
401492006,Bucknell Bison,C. Collins,4900532,,True,32.0,3,8,3,6,0,2,2,2,0,3,3,2,0,0,3,3,8
401492006,Bucknell Bison,T. Johnson,4595533,,True,34.0,3,6,2,5,1,1,0,0,0,5,5,1,0,0,2,3,7
401492006,Bucknell Bison,G. Klag,5109202,,False,1.0,1,1,1,1,0,0,0,0,0,0,0,0,0,0,0,0,2
401492006,Bucknell Bison,N. Davis,4704701,,False,4.0,0,1,0,1,0,0,0,0,0,0,0,0,0,0,1,1,0
401492006,Bucknell Bison,R. Sisselman,4900531,,False,13.0,4,7,1,1,3,6,1,1,0,0,0,1,0,0,0,1,12
401492006,Bucknell Bison,B. Matthews,5109200,,False,1.0,0,0,0,0,0,0,0,0,0,0,0,1,0,0,0,0,0
401492006,Bucknell Bison,J. Kulesza,4704702,,False,20.0,2,4,1,1,1,3,0,0,0,2,2,2,1,0,1,1,5
401492006,Bucknell Bison,C. Dingler,4577540,,False,13.0,0,1,0,0,0,1,0,0,0,1,1,1,0,0,1,0,0
401492006,Bucknell Bison,TEAM,TOTAL,TOTAL,False,,24,55,17,32,7,23,9,11,7,29,36,12,4,1,14,13,64
401492006,American University Eagles,E. Johns,4704688,,True,19.0,3,8,2,6,1,2,4,4,0,3,3,0,0,0,1,4,11
401492006,American University Eagles,L. Stack,4595455,,True,37.0,7,11,7,11,0,0,4,6,2,1,3,1,4,0,0,3,18
401492006,American University Eagles,K. Henning,4704686,,True,30.0,3,7,3,7,0,0,0,0,0,3,3,2,0,0,0,0,6
401492006,American University Eagles,I. Bales,4704685,,True,34.0,5,11,5,11,0,0,0,0,1,7,8,4,0,0,5,2,10
401492006,American University Eagles,S. Stetson,4595453,,True,36.0,2,5,1,3,1,2,0,0,0,3,3,1,3,1,0,2,5
401492006,American University Eagles,M. Lavin,5109188,,False,19.0,1,4,1,2,0,2,0,0,1,6,7,1,0,0,2,4,2
401492006,American University Eagles,M. Lee,4704592,,False,3.0,0,0,0,0,0,0,0,2,1,0,1,0,0,0,0,0,0
401492006,American University Eagles,L. Nogues,5109187,,False,9.0,0,4,0,4,0,0,0,0,0,0,0,1,0,0,2,0,0
401492006,American University Eagles,A. Rescifina,5109186,,False,2.0,0,0,0,0,0,0,0,0,0,0,0,0,0,0,0,0,0
401492006,American University Eagles,B. Garbee,4899710,,False,4.0,0,0,0,0,0,0,0,0,0,0,0,0,0,0,0,0,0
401492006,American University Eagles,A. LeMaster,4703737,,False,7.0,0,4,0,2,0,2,0,0,0,1,1,1,0,0,1,2,0
401492006,American University Eagles,TEAM,TOTAL,TOTAL,False,,21,54,19,46,2,8,8,12,5,25,30,11,7,1,11,17,52
401492006,American University Eagles,E. Johns,4704688,,True,19.0,3,8,2,6,1,2,4,4,0,3,3,0,0,0,1,4,11
401492006,American University Eagles,L. Stack,4595455,,True,37.0,7,11,7,11,0,0,4,6,2,1,3,1,4,0,0,3,18
401492006,American University Eagles,K. Henning,4704686,,True,30.0,3,7,3,7,0,0,0,0,0,3,3,2,0,0,0,0,6
401492006,American University Eagles,I. Bales,4704685,,True,34.0,5,11,5,11,0,0,0,0,1,7,8,4,0,0,5,2,10
401492006,American University Eagles,S. Stetson,4595453,,True,36.0,2,5,1,3,1,2,0,0,0,3,3,1,3,1,0,2,5
401492006,American University Eagles,M. Lavin,5109188,,False,19.0,1,4,1,2,0,2,0,0,1,6,7,1,0,0,2,4,2
401492006,American University Eagles,M. Lee,4704592,,False,3.0,0,0,0,0,0,0,0,2,1,0,1,0,0,0,0,0,0
401492006,American University Eagles,L. Nogues,5109187,,False,9.0,0,4,0,4,0,0,0,0,0,0,0,1,0,0,2,0,0
401492006,American University Eagles,A. Rescifina,5109186,,False,2.0,0,0,0,0,0,0,0,0,0,0,0,0,0,0,0,0,0
401492006,American University Eagles,B. Garbee,4899710,,False,4.0,0,0,0,0,0,0,0,0,0,0,0,0,0,0,0,0,0
401492006,American University Eagles,A. LeMaster,4703737,,False,7.0,0,4,0,2,0,2,0,0,0,1,1,1,0,0,1,2,0
401492006,American University Eagles,TEAM,TOTAL,TOTAL,False,,21,54,19,46,2,8,8,12,5,25,30,11,7,1,11,17,52
401492005,Lafayette Leopards,K. Drummond,4704754,,True,29.0,0,1,0,1,0,0,4,4,2,6,8,0,0,1,0,4,4
401492005,Lafayette Leopards,K. Favours,4900541,,True,34.0,2,9,0,2,2,7,0,0,0,5,5,0,1,0,0,2,6
401492005,Lafayette Leopards,A. Antognoli,4900540,,True,38.0,3,12,2,8,1,4,5,6,3,6,9,5,1,0,8,2,12
401492005,Lafayette Leopards,M. Andrews,4704756,,True,36.0,7,12,7,11,0,1,5,6,1,4,5,4,0,3,5,3,19
401492005,Lafayette Leopards,H. Smith,4704553,,True,33.0,3,11,3,7,0,4,3,4,1,4,5,0,3,0,2,2,9
401492005,Lafayette Leopards,A. Matthews,4703689,,False,11.0,0,2,0,2,0,0,0,0,0,1,1,0,0,0,1,3,0
401492005,Lafayette Leopards,S. Ntaconayigize,5109216,,False,8.0,1,1,0,0,1,1,2,2,1,0,1,0,1,0,1,0,5
401492005,Lafayette Leopards,K. Donahue,5109215,,False,11.0,2,3,2,3,0,0,0,0,1,0,1,0,2,0,1,2,4
401492005,Lafayette Leopards,TEAM,TOTAL,TOTAL,False,,18,51,14,34,4,17,19,22,11,29,40,9,8,4,21,18,59
401492005,Lafayette Leopards,K. Drummond,4704754,,True,29.0,0,1,0,1,0,0,4,4,2,6,8,0,0,1,0,4,4
401492005,Lafayette Leopards,K. Favours,4900541,,True,34.0,2,9,0,2,2,7,0,0,0,5,5,0,1,0,0,2,6
401492005,Lafayette Leopards,A. Antognoli,4900540,,True,38.0,3,12,2,8,1,4,5,6,3,6,9,5,1,0,8,2,12
401492005,Lafayette Leopards,M. Andrews,4704756,,True,36.0,7,12,7,11,0,1,5,6,1,4,5,4,0,3,5,3,19
401492005,Lafayette Leopards,H. Smith,4704553,,True,33.0,3,11,3,7,0,4,3,4,1,4,5,0,3,0,2,2,9
401492005,Lafayette Leopards,A. Matthews,4703689,,False,11.0,0,2,0,2,0,0,0,0,0,1,1,0,0,0,1,3,0
401492005,Lafayette Leopards,S. Ntaconayigize,5109216,,False,8.0,1,1,0,0,1,1,2,2,1,0,1,0,1,0,1,0,5
401492005,Lafayette Leopards,K. Donahue,5109215,,False,11.0,2,3,2,3,0,0,0,0,1,0,1,0,2,0,1,2,4
401492005,Lafayette Leopards,TEAM,TOTAL,TOTAL,False,,18,51,14,34,4,17,19,22,11,29,40,9,8,4,21,18,59
401492005,American University Eagles,E. Johns,4704688,,True,34.0,6,10,6,10,0,0,3,5,2,5,7,1,1,0,1,1,15
401492005,American University Eagles,L. Stack,4595455,,True,25.0,3,4,3,4,0,0,2,2,1,2,3,0,1,0,2,4,8
401492005,American University Eagles,A. Rescifina,5109186,,True,21.0,1,6,1,4,0,2,2,2,2,2,4,1,2,0,0,1,4
401492005,American University Eagles,K. Henning,4704686,,True,25.0,1,6,1,6,0,0,1,2,1,0,1,3,1,0,2,2,3
401492005,American University Eagles,I. Bales,4704685,,True,21.0,0,7,0,6,0,1,0,0,0,4,4,4,3,0,3,4,0
401492005,American University Eagles,M. Lavin,5109188,,False,20.0,2,8,0,2,2,6,5,6,5,2,7,1,2,0,2,0,11
401492005,American University Eagles,M. Lee,4704592,,False,1.0,0,0,0,0,0,0,0,0,0,0,0,0,0,0,0,0,0
401492005,American University Eagles,L. Nogues,5109187,,False,21.0,3,6,3,3,0,3,0,0,0,2,2,2,1,0,4,5,6
401492005,American University Eagles,B. Garbee,4899710,,False,13.0,0,1,0,1,0,0,0,0,0,1,1,2,0,0,0,1,0
401492005,American University Eagles,A. LeMaster,4703737,,False,16.0,3,9,0,1,3,8,1,2,0,2,2,2,2,1,1,1,10
401492005,American University Eagles,L. Graytok,4400159,,False,3.0,0,0,0,0,0,0,0,0,0,1,1,0,0,0,0,0,0
401492005,American University Eagles,TEAM,TOTAL,TOTAL,False,,19,57,14,37,5,20,14,19,12,23,35,16,13,1,16,19,57
401492005,American University Eagles,E. Johns,4704688,,True,34.0,6,10,6,10,0,0,3,5,2,5,7,1,1,0,1,1,15
401492005,American University Eagles,L. Stack,4595455,,True,25.0,3,4,3,4,0,0,2,2,1,2,3,0,1,0,2,4,8
401492005,American University Eagles,A. Rescifina,5109186,,True,21.0,1,6,1,4,0,2,2,2,2,2,4,1,2,0,0,1,4
401492005,American University Eagles,K. Henning,4704686,,True,25.0,1,6,1,6,0,0,1,2,1,0,1,3,1,0,2,2,3
401492005,American University Eagles,I. Bales,4704685,,True,21.0,0,7,0,6,0,1,0,0,0,4,4,4,3,0,3,4,0
401492005,American University Eagles,M. Lavin,5109188,,False,20.0,2,8,0,2,2,6,5,6,5,2,7,1,2,0,2,0,11
401492005,American University Eagles,M. Lee,4704592,,False,1.0,0,0,0,0,0,0,0,0,0,0,0,0,0,0,0,0,0
401492005,American University Eagles,L. Nogues,5109187,,False,21.0,3,6,3,3,0,3,0,0,0,2,2,2,1,0,4,5,6
401492005,American University Eagles,B. Garbee,4899710,,False,13.0,0,1,0,1,0,0,0,0,0,1,1,2,0,0,0,1,0
401492005,American University Eagles,A. LeMaster,4703737,,False,16.0,3,9,0,1,3,8,1,2,0,2,2,2,2,1,1,1,10
401492005,American University Eagles,L. Graytok,4400159,,False,3.0,0,0,0,0,0,0,0,0,0,1,1,0,0,0,0,0,0
401492005,American University Eagles,TEAM,TOTAL,TOTAL,False,,19,57,14,37,5,20,14,19,12,23,35,16,13,1,16,19,57
401492004,Lehigh Mountain Hawks,L. Fandre,5109220,,True,11.0,1,2,0,0,1,2,0,0,0,3,3,0,0,0,0,1,3
401492004,Lehigh Mountain Hawks,F. Hottinger,4595613,,True,34.0,6,16,6,10,0,6,14,17,4,6,10,2,0,1,4,3,26
401492004,Lehigh Mountain Hawks,E. Stemmer,4900544,,True,38.0,2,7,1,1,1,6,4,4,0,2,2,2,2,0,1,1,9
401492004,Lehigh Mountain Hawks,M. Kramer,4704762,,True,39.0,6,16,4,9,2,7,1,5,2,2,4,3,0,0,5,3,15
401492004,Lehigh Mountain Hawks,A. Harvey,4595612,,True,21.0,0,3,0,1,0,2,4,4,0,1,1,2,0,0,0,3,4
401492004,Lehigh Mountain Hawks,M. O'Brien,4900547,,False,8.0,1,3,1,3,0,0,0,0,0,0,0,1,1,0,0,0,2
401492004,Lehigh Mountain Hawks,K. Van Eps,4900545,,False,12.0,1,2,0,0,1,2,2,2,2,0,2,4,0,0,2,2,5
401492004,Lehigh Mountain Hawks,M. Albrecht,4704763,,False,11.0,2,2,2,2,0,0,0,0,1,1,2,1,1,0,0,3,4
401492004,Lehigh Mountain Hawks,F. Eggenschwiler,4704761,,False,0.0,0,0,0,0,0,0,0,0,0,0,0,0,0,0,0,0,0
401492004,Lehigh Mountain Hawks,J. Behar,4433782,,False,26.0,3,8,1,3,2,5,3,4,1,3,4,3,4,0,0,2,11
401492004,Lehigh Mountain Hawks,TEAM,TOTAL,TOTAL,False,,22,59,15,29,7,30,28,36,11,19,30,18,8,1,13,18,79
401492004,Lehigh Mountain Hawks,L. Fandre,5109220,,True,11.0,1,2,0,0,1,2,0,0,0,3,3,0,0,0,0,1,3
401492004,Lehigh Mountain Hawks,F. Hottinger,4595613,,True,34.0,6,16,6,10,0,6,14,17,4,6,10,2,0,1,4,3,26
401492004,Lehigh Mountain Hawks,E. Stemmer,4900544,,True,38.0,2,7,1,1,1,6,4,4,0,2,2,2,2,0,1,1,9
401492004,Lehigh Mountain Hawks,M. Kramer,4704762,,True,39.0,6,16,4,9,2,7,1,5,2,2,4,3,0,0,5,3,15
401492004,Lehigh Mountain Hawks,A. Harvey,4595612,,True,21.0,0,3,0,1,0,2,4,4,0,1,1,2,0,0,0,3,4
401492004,Lehigh Mountain Hawks,M. O'Brien,4900547,,False,8.0,1,3,1,3,0,0,0,0,0,0,0,1,1,0,0,0,2
401492004,Lehigh Mountain Hawks,K. Van Eps,4900545,,False,12.0,1,2,0,0,1,2,2,2,2,0,2,4,0,0,2,2,5
401492004,Lehigh Mountain Hawks,M. Albrecht,4704763,,False,11.0,2,2,2,2,0,0,0,0,1,1,2,1,1,0,0,3,4
401492004,Lehigh Mountain Hawks,F. Eggenschwiler,4704761,,False,0.0,0,0,0,0,0,0,0,0,0,0,0,0,0,0,0,0,0
401492004,Lehigh Mountain Hawks,J. Behar,4433782,,False,26.0,3,8,1,3,2,5,3,4,1,3,4,3,4,0,0,2,11
401492004,Lehigh Mountain Hawks,TEAM,TOTAL,TOTAL,False,,22,59,15,29,7,30,28,36,11,19,30,18,8,1,13,18,79
401492004,American University Eagles,E. Johns,4704688,,True,26.0,8,11,7,10,1,1,3,3,0,2,2,3,0,0,2,3,20
401492004,American University Eagles,L. Stack,4595455,,True,35.0,7,9,7,9,0,0,3,4,3,4,7,1,1,0,4,5,17
401492004,American University Eagles,K. Henning,4704686,,True,27.0,4,7,4,7,0,0,2,4,0,1,1,1,0,0,2,3,10
401492004,American University Eagles,I. Bales,4704685,,True,28.0,2,4,2,2,0,2,1,2,0,12,12,6,3,1,0,4,5
401492004,American University Eagles,S. Stetson,4595453,,True,14.0,0,2,0,2,0,0,0,0,0,0,0,0,0,0,3,3,0
401492004,American University Eagles,M. Lavin,5109188,,False,16.0,3,4,2,3,1,1,1,2,1,7,8,0,0,0,1,2,8
401492004,American University Eagles,L. Nogues,5109187,,False,31.0,2,5,1,2,1,3,4,4,0,4,4,5,1,0,5,3,9
401492004,American University Eagles,A. Rescifina,5109186,,False,20.0,2,5,2,4,0,1,4,6,1,1,2,1,0,0,3,4,8
401492004,American University Eagles,A. LeMaster,4703737,,False,3.0,0,1,0,0,0,1,0,0,0,0,0,0,0,0,1,0,0
401492004,American University Eagles,TEAM,TOTAL,TOTAL,False,,28,48,25,39,3,9,18,25,5,31,36,17,5,1,22,27,77
401492004,American University Eagles,E. Johns,4704688,,True,26.0,8,11,7,10,1,1,3,3,0,2,2,3,0,0,2,3,20
401492004,American University Eagles,L. Stack,4595455,,True,35.0,7,9,7,9,0,0,3,4,3,4,7,1,1,0,4,5,17
401492004,American University Eagles,K. Henning,4704686,,True,27.0,4,7,4,7,0,0,2,4,0,1,1,1,0,0,2,3,10
401492004,American University Eagles,I. Bales,4704685,,True,28.0,2,4,2,2,0,2,1,2,0,12,12,6,3,1,0,4,5
401492004,American University Eagles,S. Stetson,4595453,,True,14.0,0,2,0,2,0,0,0,0,0,0,0,0,0,0,3,3,0
401492004,American University Eagles,M. Lavin,5109188,,False,16.0,3,4,2,3,1,1,1,2,1,7,8,0,0,0,1,2,8
401492004,American University Eagles,L. Nogues,5109187,,False,31.0,2,5,1,2,1,3,4,4,0,4,4,5,1,0,5,3,9
401492004,American University Eagles,A. Rescifina,5109186,,False,20.0,2,5,2,4,0,1,4,6,1,1,2,1,0,0,3,4,8
401492004,American University Eagles,A. LeMaster,4703737,,False,3.0,0,1,0,0,0,1,0,0,0,0,0,0,0,0,1,0,0
401492004,American University Eagles,TEAM,TOTAL,TOTAL,False,,28,48,25,39,3,9,18,25,5,31,36,17,5,1,22,27,77
401492001,Holy Cross Crusaders,L. Berger,4900539,,True,26.0,4,8,4,8,0,0,1,2,2,4,6,1,2,0,2,3,9
401492001,Holy Cross Crusaders,K. Flanagan,5109211,,True,37.0,4,7,4,6,0,1,1,1,0,3,3,2,0,0,2,1,9
401492001,Holy Cross Crusaders,C. McCormack,4704716,,True,33.0,3,12,2,4,1,8,4,5,1,2,3,1,2,0,3,1,11
401492001,Holy Cross Crusaders,B. Power-Cassidy,4704715,,True,40.0,5,14,2,5,3,9,3,4,0,5,5,4,0,0,2,1,16
401492001,Holy Cross Crusaders,A. Cross,4595975,,True,35.0,2,3,1,2,1,1,0,0,0,4,4,3,1,0,2,4,5
401492001,Holy Cross Crusaders,M. Cahalan,5109210,,False,1.0,0,0,0,0,0,0,0,0,0,0,0,0,0,0,0,0,0
401492001,Holy Cross Crusaders,J. Allen,4704714,,False,32.0,6,14,6,14,0,0,3,4,0,2,2,3,1,2,2,2,15
401492001,Holy Cross Crusaders,M. Donnelly,5109213,,False,6.0,0,1,0,1,0,0,0,0,0,0,0,1,0,0,0,2,0
401492001,Holy Cross Crusaders,S. Foreman,5109212,,False,11.0,0,4,0,4,0,0,0,0,1,4,5,0,1,0,2,2,0
401492001,Holy Cross Crusaders,G. Munt,4900537,,False,4.0,0,1,0,1,0,0,0,0,0,2,2,0,0,0,0,0,0
401492001,Holy Cross Crusaders,TEAM,TOTAL,TOTAL,False,,24,64,19,45,5,19,12,16,6,27,33,15,7,2,15,16,65
401492001,Holy Cross Crusaders,L. Berger,4900539,,True,26.0,4,8,4,8,0,0,1,2,2,4,6,1,2,0,2,3,9
401492001,Holy Cross Crusaders,K. Flanagan,5109211,,True,37.0,4,7,4,6,0,1,1,1,0,3,3,2,0,0,2,1,9
401492001,Holy Cross Crusaders,C. McCormack,4704716,,True,33.0,3,12,2,4,1,8,4,5,1,2,3,1,2,0,3,1,11
401492001,Holy Cross Crusaders,B. Power-Cassidy,4704715,,True,40.0,5,14,2,5,3,9,3,4,0,5,5,4,0,0,2,1,16
401492001,Holy Cross Crusaders,A. Cross,4595975,,True,35.0,2,3,1,2,1,1,0,0,0,4,4,3,1,0,2,4,5
401492001,Holy Cross Crusaders,M. Cahalan,5109210,,False,1.0,0,0,0,0,0,0,0,0,0,0,0,0,0,0,0,0,0
401492001,Holy Cross Crusaders,J. Allen,4704714,,False,32.0,6,14,6,14,0,0,3,4,0,2,2,3,1,2,2,2,15
401492001,Holy Cross Crusaders,M. Donnelly,5109213,,False,6.0,0,1,0,1,0,0,0,0,0,0,0,1,0,0,0,2,0
401492001,Holy Cross Crusaders,S. Foreman,5109212,,False,11.0,0,4,0,4,0,0,0,0,1,4,5,0,1,0,2,2,0
401492001,Holy Cross Crusaders,G. Munt,4900537,,False,4.0,0,1,0,1,0,0,0,0,0,2,2,0,0,0,0,0,0
401492001,Holy Cross Crusaders,TEAM,TOTAL,TOTAL,False,,24,64,19,45,5,19,12,16,6,27,33,15,7,2,15,16,65
401492001,American University Eagles,E. Johns,4704688,,True,27.0,4,9,4,7,0,2,4,4,0,6,6,2,0,0,3,5,12
401492001,American University Eagles,L. Stack,4595455,,True,35.0,8,13,8,12,0,1,1,2,2,4,6,1,0,0,2,2,17
401492001,American University Eagles,K. Henning,4704686,,True,37.0,4,10,3,8,1,2,7,8,0,2,2,3,3,0,4,1,16
401492001,American University Eagles,I. Bales,4704685,,True,24.0,3,8,3,8,0,0,0,0,0,5,5,1,0,0,6,3,6
401492001,American University Eagles,S. Stetson,4595453,,True,34.0,3,8,1,5,2,3,0,0,0,2,2,2,3,0,0,3,8
401492001,American University Eagles,M. Lavin,5109188,,False,21.0,3,6,3,6,0,0,1,1,0,6,6,1,0,0,0,1,7
401492001,American University Eagles,M. Lee,4704592,,False,14.0,0,0,0,0,0,0,0,0,0,0,0,0,0,0,0,0,0
401492001,American University Eagles,L. Nogues,5109187,,False,15.0,0,1,0,1,0,0,0,0,1,1,2,4,1,0,3,0,0
401492001,American University Eagles,A. Rescifina,5109186,,False,3.0,0,0,0,0,0,0,0,0,0,0,0,0,0,0,0,0,0
401492001,American University Eagles,B. Garbee,4899710,,False,6.0,0,0,0,0,0,0,0,0,0,1,1,0,0,0,1,1,0
401492001,American University Eagles,A. LeMaster,4703737,,False,9.0,0,0,0,0,0,0,1,4,0,1,1,1,1,0,0,1,1
401492001,American University Eagles,TEAM,TOTAL,TOTAL,False,,25,55,22,47,3,8,14,19,5,32,37,15,8,0,19,17,67
401492001,American University Eagles,E. Johns,4704688,,True,27.0,4,9,4,7,0,2,4,4,0,6,6,2,0,0,3,5,12
401492001,American University Eagles,L. Stack,4595455,,True,35.0,8,13,8,12,0,1,1,2,2,4,6,1,0,0,2,2,17
401492001,American University Eagles,K. Henning,4704686,,True,37.0,4,10,3,8,1,2,7,8,0,2,2,3,3,0,4,1,16
401492001,American University Eagles,I. Bales,4704685,,True,24.0,3,8,3,8,0,0,0,0,0,5,5,1,0,0,6,3,6
401492001,American University Eagles,S. Stetson,4595453,,True,34.0,3,8,1,5,2,3,0,0,0,2,2,2,3,0,0,3,8
401492001,American University Eagles,M. Lavin,5109188,,False,21.0,3,6,3,6,0,0,1,1,0,6,6,1,0,0,0,1,7
401492001,American University Eagles,M. Lee,4704592,,False,14.0,0,0,0,0,0,0,0,0,0,0,0,0,0,0,0,0,0
401492001,American University Eagles,L. Nogues,5109187,,False,15.0,0,1,0,1,0,0,0,0,1,1,2,4,1,0,3,0,0
401492001,American University Eagles,A. Rescifina,5109186,,False,3.0,0,0,0,0,0,0,0,0,0,0,0,0,0,0,0,0,0
401492001,American University Eagles,B. Garbee,4899710,,False,6.0,0,0,0,0,0,0,0,0,0,1,1,0,0,0,1,1,0
401492001,American University Eagles,A. LeMaster,4703737,,False,9.0,0,0,0,0,0,0,1,4,0,1,1,1,1,0,0,1,1
401492001,American University Eagles,TEAM,TOTAL,TOTAL,False,,25,55,22,47,3,8,14,19,5,32,37,15,8,0,19,17,67
401492000,Lafayette Leopards,A. Matthews,4703689,,True,29.0,2,5,2,5,0,0,1,2,1,3,4,3,0,2,1,1,5
401492000,Lafayette Leopards,K. Donahue,5109215,,True,35.0,3,10,2,8,1,2,0,0,2,3,5,2,1,2,2,2,7
401492000,Lafayette Leopards,K. Favours,4900541,,True,35.0,1,9,0,5,1,4,0,0,2,1,3,1,1,0,4,2,3
401492000,Lafayette Leopards,M. Andrews,4704756,,True,39.0,10,17,10,15,0,2,2,3,2,3,5,1,0,0,1,3,22
401492000,Lafayette Leopards,H. Smith,4704553,,True,33.0,2,10,1,7,1,3,0,0,0,6,6,2,0,0,1,1,5
401492000,Lafayette Leopards,S. Ntaconayigize,5109216,,False,30.0,3,4,2,3,1,1,0,0,0,2,2,2,3,0,2,2,7
401492000,Lafayette Leopards,TEAM,TOTAL,TOTAL,False,,21,55,17,43,4,12,3,5,7,20,27,11,5,4,11,11,49
401492000,Lafayette Leopards,A. Matthews,4703689,,True,29.0,2,5,2,5,0,0,1,2,1,3,4,3,0,2,1,1,5
401492000,Lafayette Leopards,K. Donahue,5109215,,True,35.0,3,10,2,8,1,2,0,0,2,3,5,2,1,2,2,2,7
401492000,Lafayette Leopards,K. Favours,4900541,,True,35.0,1,9,0,5,1,4,0,0,2,1,3,1,1,0,4,2,3
401492000,Lafayette Leopards,M. Andrews,4704756,,True,39.0,10,17,10,15,0,2,2,3,2,3,5,1,0,0,1,3,22
401492000,Lafayette Leopards,H. Smith,4704553,,True,33.0,2,10,1,7,1,3,0,0,0,6,6,2,0,0,1,1,5
401492000,Lafayette Leopards,S. Ntaconayigize,5109216,,False,30.0,3,4,2,3,1,1,0,0,0,2,2,2,3,0,2,2,7
401492000,Lafayette Leopards,TEAM,TOTAL,TOTAL,False,,21,55,17,43,4,12,3,5,7,20,27,11,5,4,11,11,49
401492000,Holy Cross Crusaders,L. Berger,4900539,,True,17.0,6,11,6,11,0,0,0,1,2,7,9,1,1,0,1,3,12
401492000,Holy Cross Crusaders,K. Flanagan,5109211,,True,31.0,2,7,1,3,1,4,0,0,0,4,4,3,2,0,2,0,5
401492000,Holy Cross Crusaders,C. McCormack,4704716,,True,23.0,5,10,2,3,3,7,0,0,1,1,2,3,2,0,2,2,13
401492000,Holy Cross Crusaders,B. Power-Cassidy,4704715,,True,32.0,9,14,5,8,4,6,0,0,2,2,4,4,2,1,0,1,22
401492000,Holy Cross Crusaders,A. Cross,4595975,,True,24.0,1,3,1,1,0,2,0,0,1,0,1,5,1,0,1,2,2
401492000,Holy Cross Crusaders,M. Cahalan,5109210,,False,3.0,1,1,1,1,0,0,2,2,0,0,0,0,0,0,1,0,4
401492000,Holy Cross Crusaders,J. Allen,4704714,,False,21.0,2,6,2,6,0,0,1,2,2,5,7,0,0,1,1,2,5
401492000,Holy Cross Crusaders,M. Donnelly,5109213,,False,14.0,0,3,0,1,0,2,0,0,2,2,4,0,0,0,1,1,0
401492000,Holy Cross Crusaders,S. Foreman,5109212,,False,23.0,1,6,1,4,0,2,2,2,2,5,7,2,1,0,2,0,4
401492000,Holy Cross Crusaders,L. Huber,4900538,,False,2.0,0,0,0,0,0,0,0,0,0,0,0,0,0,1,0,0,0
401492000,Holy Cross Crusaders,G. Munt,4900537,,False,11.0,0,2,0,1,0,1,0,0,1,0,1,1,1,1,0,1,0
401492000,Holy Cross Crusaders,TEAM,TOTAL,TOTAL,False,,27,63,19,39,8,24,5,7,17,29,46,19,10,4,12,12,67
401492000,Holy Cross Crusaders,L. Berger,4900539,,True,17.0,6,11,6,11,0,0,0,1,2,7,9,1,1,0,1,3,12
401492000,Holy Cross Crusaders,K. Flanagan,5109211,,True,31.0,2,7,1,3,1,4,0,0,0,4,4,3,2,0,2,0,5
401492000,Holy Cross Crusaders,C. McCormack,4704716,,True,23.0,5,10,2,3,3,7,0,0,1,1,2,3,2,0,2,2,13
401492000,Holy Cross Crusaders,B. Power-Cassidy,4704715,,True,32.0,9,14,5,8,4,6,0,0,2,2,4,4,2,1,0,1,22
401492000,Holy Cross Crusaders,A. Cross,4595975,,True,24.0,1,3,1,1,0,2,0,0,1,0,1,5,1,0,1,2,2
401492000,Holy Cross Crusaders,M. Cahalan,5109210,,False,3.0,1,1,1,1,0,0,2,2,0,0,0,0,0,0,1,0,4
401492000,Holy Cross Crusaders,J. Allen,4704714,,False,21.0,2,6,2,6,0,0,1,2,2,5,7,0,0,1,1,2,5
401492000,Holy Cross Crusaders,M. Donnelly,5109213,,False,14.0,0,3,0,1,0,2,0,0,2,2,4,0,0,0,1,1,0
401492000,Holy Cross Crusaders,S. Foreman,5109212,,False,23.0,1,6,1,4,0,2,2,2,2,5,7,2,1,0,2,0,4
401492000,Holy Cross Crusaders,L. Huber,4900538,,False,2.0,0,0,0,0,0,0,0,0,0,0,0,0,0,1,0,0,0
401492000,Holy Cross Crusaders,G. Munt,4900537,,False,11.0,0,2,0,1,0,1,0,0,1,0,1,1,1,1,0,1,0
401492000,Holy Cross Crusaders,TEAM,TOTAL,TOTAL,False,,27,63,19,39,8,24,5,7,17,29,46,19,10,4,12,12,67
401491999,Lehigh Mountain Hawks,L. Fandre,5109220,,True,36.0,3,4,2,2,1,2,2,2,1,0,1,1,0,2,0,3,9
401491999,Lehigh Mountain Hawks,F. Hottinger,4595613,,True,39.0,12,20,8,14,4,6,2,2,4,7,11,1,0,1,9,4,30
401491999,Lehigh Mountain Hawks,M. Kramer,4704762,,True,39.0,8,18,3,11,5,7,0,0,1,4,5,0,1,0,1,0,21
401491999,Lehigh Mountain Hawks,A. Harvey,4595612,,True,34.0,3,7,2,4,1,3,0,0,0,5,5,9,0,0,2,0,7
401491999,Lehigh Mountain Hawks,J. Behar,4433782,,True,12.0,1,4,1,1,0,3,2,2,0,4,4,0,0,0,1,1,4
401491999,Lehigh Mountain Hawks,M. O'Brien,4900547,,False,9.0,0,0,0,0,0,0,0,0,0,0,0,2,0,0,0,0,0
401491999,Lehigh Mountain Hawks,K. Van Eps,4900545,,False,5.0,0,0,0,0,0,0,0,0,0,0,0,0,0,0,0,0,0
401491999,Lehigh Mountain Hawks,E. Stemmer,4900544,,False,27.0,0,3,0,1,0,2,4,4,0,0,0,0,2,0,3,1,4
401491999,Lehigh Mountain Hawks,M. Albrecht,4704763,,False,24.0,0,1,0,0,0,1,1,2,0,2,2,2,1,2,1,1,1
401491999,Lehigh Mountain Hawks,F. Eggenschwiler,4704761,,False,0.0,0,0,0,0,0,0,0,0,0,0,0,0,0,0,0,0,0
401491999,Lehigh Mountain Hawks,TEAM,TOTAL,TOTAL,False,,27,57,16,33,11,24,11,12,9,23,32,15,4,5,17,10,76
401491999,Lehigh Mountain Hawks,L. Fandre,5109220,,True,36.0,3,4,2,2,1,2,2,2,1,0,1,1,0,2,0,3,9
401491999,Lehigh Mountain Hawks,F. Hottinger,4595613,,True,39.0,12,20,8,14,4,6,2,2,4,7,11,1,0,1,9,4,30
401491999,Lehigh Mountain Hawks,M. Kramer,4704762,,True,39.0,8,18,3,11,5,7,0,0,1,4,5,0,1,0,1,0,21
401491999,Lehigh Mountain Hawks,A. Harvey,4595612,,True,34.0,3,7,2,4,1,3,0,0,0,5,5,9,0,0,2,0,7
401491999,Lehigh Mountain Hawks,J. Behar,4433782,,True,12.0,1,4,1,1,0,3,2,2,0,4,4,0,0,0,1,1,4
401491999,Lehigh Mountain Hawks,M. O'Brien,4900547,,False,9.0,0,0,0,0,0,0,0,0,0,0,0,2,0,0,0,0,0
401491999,Lehigh Mountain Hawks,K. Van Eps,4900545,,False,5.0,0,0,0,0,0,0,0,0,0,0,0,0,0,0,0,0,0
401491999,Lehigh Mountain Hawks,E. Stemmer,4900544,,False,27.0,0,3,0,1,0,2,4,4,0,0,0,0,2,0,3,1,4
401491999,Lehigh Mountain Hawks,M. Albrecht,4704763,,False,24.0,0,1,0,0,0,1,1,2,0,2,2,2,1,2,1,1,1
401491999,Lehigh Mountain Hawks,F. Eggenschwiler,4704761,,False,0.0,0,0,0,0,0,0,0,0,0,0,0,0,0,0,0,0,0
401491999,Lehigh Mountain Hawks,TEAM,TOTAL,TOTAL,False,,27,57,16,33,11,24,11,12,9,23,32,15,4,5,17,10,76
401491999,Holy Cross Crusaders,L. Berger,4900539,,True,31.0,8,15,8,15,0,0,1,2,4,8,12,1,0,0,2,3,17
401491999,Holy Cross Crusaders,K. Flanagan,5109211,,True,39.0,6,13,6,11,0,2,2,2,1,0,1,2,2,0,1,1,14
401491999,Holy Cross Crusaders,C. McCormack,4704716,,True,37.0,3,12,1,5,2,7,1,2,0,3,3,4,0,0,2,2,9
401491999,Holy Cross Crusaders,B. Power-Cassidy,4704715,,True,41.0,8,14,7,12,1,2,1,4,3,4,7,0,2,1,3,4,18
401491999,Holy Cross Crusaders,A. Cross,4595975,,True,38.0,3,7,1,2,2,5,1,2,1,2,3,1,3,0,1,1,9
401491999,Holy Cross Crusaders,C. Wright,4703660,,False,9.0,1,3,1,3,0,0,0,0,2,1,3,0,0,0,0,0,2
401491999,Holy Cross Crusaders,M. Donnelly,5109213,,False,11.0,1,3,0,0,1,3,0,0,0,0,0,2,0,0,0,0,3
401491999,Holy Cross Crusaders,S. Foreman,5109212,,False,19.0,1,3,1,3,0,0,0,0,1,2,3,0,1,0,2,1,2
401491999,Holy Cross Crusaders,TEAM,TOTAL,TOTAL,False,,31,70,25,51,6,19,6,12,15,22,37,10,8,1,12,12,74
401491999,Holy Cross Crusaders,L. Berger,4900539,,True,31.0,8,15,8,15,0,0,1,2,4,8,12,1,0,0,2,3,17
401491999,Holy Cross Crusaders,K. Flanagan,5109211,,True,39.0,6,13,6,11,0,2,2,2,1,0,1,2,2,0,1,1,14
401491999,Holy Cross Crusaders,C. McCormack,4704716,,True,37.0,3,12,1,5,2,7,1,2,0,3,3,4,0,0,2,2,9
401491999,Holy Cross Crusaders,B. Power-Cassidy,4704715,,True,41.0,8,14,7,12,1,2,1,4,3,4,7,0,2,1,3,4,18
401491999,Holy Cross Crusaders,A. Cross,4595975,,True,38.0,3,7,1,2,2,5,1,2,1,2,3,1,3,0,1,1,9
401491999,Holy Cross Crusaders,C. Wright,4703660,,False,9.0,1,3,1,3,0,0,0,0,2,1,3,0,0,0,0,0,2
401491999,Holy Cross Crusaders,M. Donnelly,5109213,,False,11.0,1,3,0,0,1,3,0,0,0,0,0,2,0,0,0,0,3
401491999,Holy Cross Crusaders,S. Foreman,5109212,,False,19.0,1,3,1,3,0,0,0,0,1,2,3,0,1,0,2,1,2
401491999,Holy Cross Crusaders,TEAM,TOTAL,TOTAL,False,,31,70,25,51,6,19,6,12,15,22,37,10,8,1,12,12,74
401491998,Holy Cross Crusaders,L. Berger,4900539,,True,29.0,5,8,5,8,0,0,1,2,3,7,10,2,2,3,0,0,11
401491998,Holy Cross Crusaders,K. Flanagan,5109211,,True,22.0,1,3,1,3,0,0,0,0,0,1,1,2,0,0,0,1,2
401491998,Holy Cross Crusaders,C. McCormack,4704716,,True,30.0,7,13,2,5,5,8,1,2,0,1,1,3,2,0,2,1,20
401491998,Holy Cross Crusaders,B. Power-Cassidy,4704715,,True,31.0,3,9,3,8,0,1,6,6,1,0,1,4,0,0,1,3,12
401491998,Holy Cross Crusaders,A. Cross,4595975,,True,28.0,3,6,2,4,1,2,2,2,0,4,4,1,3,0,1,2,9
401491998,Holy Cross Crusaders,M. Cahalan,5109210,,False,4.0,1,2,1,2,0,0,0,0,0,0,0,0,0,0,0,0,2
401491998,Holy Cross Crusaders,C. Wright,4703660,,False,11.0,2,3,2,3,0,0,0,0,2,2,4,0,0,0,0,2,4
401491998,Holy Cross Crusaders,M. Donnelly,5109213,,False,9.0,0,3,0,1,0,2,0,0,0,1,1,0,0,0,1,0,0
401491998,Holy Cross Crusaders,S. Foreman,5109212,,False,25.0,3,7,3,7,0,0,1,1,1,5,6,1,2,0,1,0,7
401491998,Holy Cross Crusaders,L. Huber,4900538,,False,3.0,0,0,0,0,0,0,0,0,0,1,1,1,0,0,0,0,0
401491998,Holy Cross Crusaders,G. Munt,4900537,,False,8.0,1,1,1,1,0,0,0,0,0,0,0,0,0,0,0,0,2
401491998,Holy Cross Crusaders,TEAM,TOTAL,TOTAL,False,,26,55,20,42,6,13,11,13,9,25,34,14,9,3,6,9,69
401491998,Holy Cross Crusaders,L. Berger,4900539,,True,29.0,5,8,5,8,0,0,1,2,3,7,10,2,2,3,0,0,11
401491998,Holy Cross Crusaders,K. Flanagan,5109211,,True,22.0,1,3,1,3,0,0,0,0,0,1,1,2,0,0,0,1,2
401491998,Holy Cross Crusaders,C. McCormack,4704716,,True,30.0,7,13,2,5,5,8,1,2,0,1,1,3,2,0,2,1,20
401491998,Holy Cross Crusaders,B. Power-Cassidy,4704715,,True,31.0,3,9,3,8,0,1,6,6,1,0,1,4,0,0,1,3,12
401491998,Holy Cross Crusaders,A. Cross,4595975,,True,28.0,3,6,2,4,1,2,2,2,0,4,4,1,3,0,1,2,9
401491998,Holy Cross Crusaders,M. Cahalan,5109210,,False,4.0,1,2,1,2,0,0,0,0,0,0,0,0,0,0,0,0,2
401491998,Holy Cross Crusaders,C. Wright,4703660,,False,11.0,2,3,2,3,0,0,0,0,2,2,4,0,0,0,0,2,4
401491998,Holy Cross Crusaders,M. Donnelly,5109213,,False,9.0,0,3,0,1,0,2,0,0,0,1,1,0,0,0,1,0,0
401491998,Holy Cross Crusaders,S. Foreman,5109212,,False,25.0,3,7,3,7,0,0,1,1,1,5,6,1,2,0,1,0,7
401491998,Holy Cross Crusaders,L. Huber,4900538,,False,3.0,0,0,0,0,0,0,0,0,0,1,1,1,0,0,0,0,0
401491998,Holy Cross Crusaders,G. Munt,4900537,,False,8.0,1,1,1,1,0,0,0,0,0,0,0,0,0,0,0,0,2
401491998,Holy Cross Crusaders,TEAM,TOTAL,TOTAL,False,,26,55,20,42,6,13,11,13,9,25,34,14,9,3,6,9,69
401491998,Bucknell Bison,I. King,4900533,,True,27.0,5,6,3,3,2,3,0,0,0,0,0,2,0,0,1,1,12
401491998,Bucknell Bison,E. Shaffer,4595535,,True,15.0,1,4,1,4,0,0,2,3,1,2,3,1,0,0,2,3,4
401491998,Bucknell Bison,E. Theodorsson,5109199,,True,29.0,2,7,1,6,1,1,0,0,1,6,7,0,0,0,1,1,5
401491998,Bucknell Bison,T. Johnson,4595533,,True,33.0,7,12,7,12,0,0,0,0,0,5,5,1,0,0,5,2,14
401491998,Bucknell Bison,C. Dingler,4577540,,True,18.0,0,2,0,2,0,0,0,0,0,1,1,2,0,0,0,1,0
401491998,Bucknell Bison,G. Sullivan,5109201,,False,24.0,2,4,2,4,0,0,2,2,1,3,4,0,1,1,1,1,6
401491998,Bucknell Bison,N. Davis,4704701,,False,1.0,0,0,0,0,0,0,0,0,0,0,0,0,0,0,0,0,0
401491998,Bucknell Bison,K. Reinbeau,4704700,,False,8.0,1,2,0,0,1,2,0,0,0,0,0,0,0,0,0,1,3
401491998,Bucknell Bison,R. Sisselman,4900531,,False,23.0,2,9,2,5,0,4,0,0,1,2,3,0,1,0,2,3,4
401491998,Bucknell Bison,J. Kulesza,4704702,,False,22.0,1,3,1,3,0,0,0,0,0,1,1,1,0,0,0,0,2
401491998,Bucknell Bison,TEAM,TOTAL,TOTAL,False,,21,49,17,39,4,10,4,5,4,20,24,7,2,1,12,13,50
401491998,Bucknell Bison,I. King,4900533,,True,27.0,5,6,3,3,2,3,0,0,0,0,0,2,0,0,1,1,12
401491998,Bucknell Bison,E. Shaffer,4595535,,True,15.0,1,4,1,4,0,0,2,3,1,2,3,1,0,0,2,3,4
401491998,Bucknell Bison,E. Theodorsson,5109199,,True,29.0,2,7,1,6,1,1,0,0,1,6,7,0,0,0,1,1,5
401491998,Bucknell Bison,T. Johnson,4595533,,True,33.0,7,12,7,12,0,0,0,0,0,5,5,1,0,0,5,2,14
401491998,Bucknell Bison,C. Dingler,4577540,,True,18.0,0,2,0,2,0,0,0,0,0,1,1,2,0,0,0,1,0
401491998,Bucknell Bison,G. Sullivan,5109201,,False,24.0,2,4,2,4,0,0,2,2,1,3,4,0,1,1,1,1,6
401491998,Bucknell Bison,N. Davis,4704701,,False,1.0,0,0,0,0,0,0,0,0,0,0,0,0,0,0,0,0,0
401491998,Bucknell Bison,K. Reinbeau,4704700,,False,8.0,1,2,0,0,1,2,0,0,0,0,0,0,0,0,0,1,3
401491998,Bucknell Bison,R. Sisselman,4900531,,False,23.0,2,9,2,5,0,4,0,0,1,2,3,0,1,0,2,3,4
401491998,Bucknell Bison,J. Kulesza,4704702,,False,22.0,1,3,1,3,0,0,0,0,0,1,1,1,0,0,0,0,2
401491998,Bucknell Bison,TEAM,TOTAL,TOTAL,False,,21,49,17,39,4,10,4,5,4,20,24,7,2,1,12,13,50
401491997,Lafayette Leopards,K. Drummond,4704754,,True,31.0,2,4,2,4,0,0,1,2,2,4,6,1,2,0,1,2,5
401491997,Lafayette Leopards,K. Favours,4900541,,True,27.0,3,11,2,5,1,6,0,0,0,0,0,0,1,0,0,1,7
401491997,Lafayette Leopards,A. Antognoli,4900540,,True,39.0,5,14,5,10,0,4,5,5,2,2,4,3,0,0,1,1,15
401491997,Lafayette Leopards,M. Andrews,4704756,,True,36.0,4,15,4,13,0,2,2,2,5,5,10,0,0,0,6,2,10
401491997,Lafayette Leopards,H. Smith,4704553,,True,25.0,2,7,2,6,0,1,2,3,0,2,2,0,1,0,0,3,6
401491997,Lafayette Leopards,A. Matthews,4703689,,False,8.0,0,0,0,0,0,0,0,0,0,2,2,0,0,0,0,1,0
401491997,Lafayette Leopards,S. Ntaconayigize,5109216,,False,23.0,1,4,0,1,1,3,2,2,0,2,2,0,1,0,1,1,5
401491997,Lafayette Leopards,K. Donahue,5109215,,False,11.0,0,3,0,2,0,1,2,2,1,0,1,1,2,0,0,2,2
401491997,Lafayette Leopards,TEAM,TOTAL,TOTAL,False,,17,58,15,41,2,17,14,16,14,18,32,5,7,0,10,13,50
401491997,Lafayette Leopards,K. Drummond,4704754,,True,31.0,2,4,2,4,0,0,1,2,2,4,6,1,2,0,1,2,5
401491997,Lafayette Leopards,K. Favours,4900541,,True,27.0,3,11,2,5,1,6,0,0,0,0,0,0,1,0,0,1,7
401491997,Lafayette Leopards,A. Antognoli,4900540,,True,39.0,5,14,5,10,0,4,5,5,2,2,4,3,0,0,1,1,15
401491997,Lafayette Leopards,M. Andrews,4704756,,True,36.0,4,15,4,13,0,2,2,2,5,5,10,0,0,0,6,2,10
401491997,Lafayette Leopards,H. Smith,4704553,,True,25.0,2,7,2,6,0,1,2,3,0,2,2,0,1,0,0,3,6
401491997,Lafayette Leopards,A. Matthews,4703689,,False,8.0,0,0,0,0,0,0,0,0,0,2,2,0,0,0,0,1,0
401491997,Lafayette Leopards,S. Ntaconayigize,5109216,,False,23.0,1,4,0,1,1,3,2,2,0,2,2,0,1,0,1,1,5
401491997,Lafayette Leopards,K. Donahue,5109215,,False,11.0,0,3,0,2,0,1,2,2,1,0,1,1,2,0,0,2,2
401491997,Lafayette Leopards,TEAM,TOTAL,TOTAL,False,,17,58,15,41,2,17,14,16,14,18,32,5,7,0,10,13,50
401491997,Holy Cross Crusaders,J. Allen,4704714,,True,16.0,5,9,5,9,0,0,1,2,0,2,2,2,0,0,1,0,11
401491997,Holy Cross Crusaders,K. Flanagan,5109211,,True,16.0,0,2,0,1,0,1,0,0,0,2,2,2,1,0,2,2,0
401491997,Holy Cross Crusaders,C. McCormack,4704716,,True,28.0,4,6,2,2,2,4,0,0,1,0,1,1,0,0,1,2,10
401491997,Holy Cross Crusaders,B. Power-Cassidy,4704715,,True,28.0,2,6,2,4,0,2,0,0,1,3,4,2,1,1,1,2,4
401491997,Holy Cross Crusaders,A. Cross,4595975,,True,21.0,1,3,1,1,0,2,0,0,0,1,1,2,1,0,1,4,2
401491997,Holy Cross Crusaders,M. Cahalan,5109210,,False,2.0,2,2,2,2,0,0,0,0,0,0,0,0,0,0,0,0,4
401491997,Holy Cross Crusaders,L. Berger,4900539,,False,21.0,3,4,3,4,0,0,3,4,2,2,4,0,0,1,3,1,9
401491997,Holy Cross Crusaders,C. Wright,4703660,,False,12.0,2,2,2,2,0,0,4,4,2,1,3,1,0,0,1,0,8
401491997,Holy Cross Crusaders,M. Donnelly,5109213,,False,24.0,3,6,3,4,0,2,0,0,0,7,7,2,0,0,1,1,6
401491997,Holy Cross Crusaders,S. Foreman,5109212,,False,22.0,4,10,4,10,0,0,0,0,0,6,6,0,0,0,0,3,8
401491997,Holy Cross Crusaders,L. Huber,4900538,,False,2.0,0,0,0,0,0,0,0,0,0,0,0,0,0,0,0,0,0
401491997,Holy Cross Crusaders,G. Munt,4900537,,False,8.0,2,3,2,3,0,0,0,0,0,2,2,0,0,0,2,1,4
401491997,Holy Cross Crusaders,TEAM,TOTAL,TOTAL,False,,28,53,26,42,2,11,8,10,8,29,37,12,3,2,13,16,66
401491997,Holy Cross Crusaders,J. Allen,4704714,,True,16.0,5,9,5,9,0,0,1,2,0,2,2,2,0,0,1,0,11
401491997,Holy Cross Crusaders,K. Flanagan,5109211,,True,16.0,0,2,0,1,0,1,0,0,0,2,2,2,1,0,2,2,0
401491997,Holy Cross Crusaders,C. McCormack,4704716,,True,28.0,4,6,2,2,2,4,0,0,1,0,1,1,0,0,1,2,10
401491997,Holy Cross Crusaders,B. Power-Cassidy,4704715,,True,28.0,2,6,2,4,0,2,0,0,1,3,4,2,1,1,1,2,4
401491997,Holy Cross Crusaders,A. Cross,4595975,,True,21.0,1,3,1,1,0,2,0,0,0,1,1,2,1,0,1,4,2
401491997,Holy Cross Crusaders,M. Cahalan,5109210,,False,2.0,2,2,2,2,0,0,0,0,0,0,0,0,0,0,0,0,4
401491997,Holy Cross Crusaders,L. Berger,4900539,,False,21.0,3,4,3,4,0,0,3,4,2,2,4,0,0,1,3,1,9
401491997,Holy Cross Crusaders,C. Wright,4703660,,False,12.0,2,2,2,2,0,0,4,4,2,1,3,1,0,0,1,0,8
401491997,Holy Cross Crusaders,M. Donnelly,5109213,,False,24.0,3,6,3,4,0,2,0,0,0,7,7,2,0,0,1,1,6
401491997,Holy Cross Crusaders,S. Foreman,5109212,,False,22.0,4,10,4,10,0,0,0,0,0,6,6,0,0,0,0,3,8
401491997,Holy Cross Crusaders,L. Huber,4900538,,False,2.0,0,0,0,0,0,0,0,0,0,0,0,0,0,0,0,0,0
401491997,Holy Cross Crusaders,G. Munt,4900537,,False,8.0,2,3,2,3,0,0,0,0,0,2,2,0,0,0,2,1,4
401491997,Holy Cross Crusaders,TEAM,TOTAL,TOTAL,False,,28,53,26,42,2,11,8,10,8,29,37,12,3,2,13,16,66
401491996,Lehigh Mountain Hawks,L. Fandre,5109220,,True,23.0,0,4,0,0,0,4,0,0,0,3,3,1,2,1,2,0,0
401491996,Lehigh Mountain Hawks,F. Hottinger,4595613,,True,35.0,8,26,6,18,2,8,5,8,4,3,7,1,2,1,5,1,23
401491996,Lehigh Mountain Hawks,K. Van Eps,4900545,,True,26.0,2,3,1,1,1,2,3,3,1,4,5,2,0,0,3,1,8
401491996,Lehigh Mountain Hawks,E. Stemmer,4900544,,True,36.0,8,14,2,4,6,10,0,0,1,1,2,1,0,0,0,2,22
401491996,Lehigh Mountain Hawks,A. Harvey,4595612,,True,34.0,1,2,1,1,0,1,2,2,1,6,7,6,1,0,1,0,4
401491996,Lehigh Mountain Hawks,M. O'Brien,4900547,,False,11.0,0,2,0,1,0,1,0,0,0,2,2,1,1,1,1,0,0
401491996,Lehigh Mountain Hawks,M. Albrecht,4704763,,False,21.0,1,3,1,1,0,2,0,2,0,3,3,0,1,1,3,2,2
401491996,Lehigh Mountain Hawks,J. Behar,4433782,,False,14.0,2,5,1,4,1,1,0,0,0,2,2,0,1,0,1,3,5
401491996,Lehigh Mountain Hawks,TEAM,TOTAL,TOTAL,False,,22,59,12,30,10,29,10,15,11,25,36,12,8,4,16,9,64
401491996,Lehigh Mountain Hawks,L. Fandre,5109220,,True,23.0,0,4,0,0,0,4,0,0,0,3,3,1,2,1,2,0,0
401491996,Lehigh Mountain Hawks,F. Hottinger,4595613,,True,35.0,8,26,6,18,2,8,5,8,4,3,7,1,2,1,5,1,23
401491996,Lehigh Mountain Hawks,K. Van Eps,4900545,,True,26.0,2,3,1,1,1,2,3,3,1,4,5,2,0,0,3,1,8
401491996,Lehigh Mountain Hawks,E. Stemmer,4900544,,True,36.0,8,14,2,4,6,10,0,0,1,1,2,1,0,0,0,2,22
401491996,Lehigh Mountain Hawks,A. Harvey,4595612,,True,34.0,1,2,1,1,0,1,2,2,1,6,7,6,1,0,1,0,4
401491996,Lehigh Mountain Hawks,M. O'Brien,4900547,,False,11.0,0,2,0,1,0,1,0,0,0,2,2,1,1,1,1,0,0
401491996,Lehigh Mountain Hawks,M. Albrecht,4704763,,False,21.0,1,3,1,1,0,2,0,2,0,3,3,0,1,1,3,2,2
401491996,Lehigh Mountain Hawks,J. Behar,4433782,,False,14.0,2,5,1,4,1,1,0,0,0,2,2,0,1,0,1,3,5
401491996,Lehigh Mountain Hawks,TEAM,TOTAL,TOTAL,False,,22,59,12,30,10,29,10,15,11,25,36,12,8,4,16,9,64
401491996,Holy Cross Crusaders,J. Allen,4704714,,True,18.0,5,7,5,7,0,0,0,0,3,2,5,2,0,2,7,4,10
401491996,Holy Cross Crusaders,K. Flanagan,5109211,,True,34.0,4,11,3,8,1,3,0,0,1,7,8,2,1,1,3,3,9
401491996,Holy Cross Crusaders,C. McCormack,4704716,,True,23.0,4,12,4,9,0,3,2,2,0,3,3,1,1,0,0,2,10
401491996,Holy Cross Crusaders,B. Power-Cassidy,4704715,,True,33.0,7,15,4,8,3,7,1,2,3,2,5,3,0,4,2,1,18
401491996,Holy Cross Crusaders,A. Cross,4595975,,True,34.0,2,5,0,2,2,3,0,0,1,3,4,2,1,1,1,3,6
401491996,Holy Cross Crusaders,L. Berger,4900539,,False,19.0,2,5,2,5,0,0,0,0,1,3,4,3,2,0,1,2,4
401491996,Holy Cross Crusaders,M. Donnelly,5109213,,False,9.0,0,1,0,0,0,1,0,0,0,3,3,1,1,0,2,0,0
401491996,Holy Cross Crusaders,S. Foreman,5109212,,False,22.0,3,6,2,5,1,1,0,1,0,4,4,1,1,0,0,0,7
401491996,Holy Cross Crusaders,G. Munt,4900537,,False,8.0,1,1,1,1,0,0,0,2,1,0,1,0,0,0,1,0,2
401491996,Holy Cross Crusaders,TEAM,TOTAL,TOTAL,False,,28,63,21,45,7,18,3,7,13,29,42,15,7,8,17,15,66
401491996,Holy Cross Crusaders,J. Allen,4704714,,True,18.0,5,7,5,7,0,0,0,0,3,2,5,2,0,2,7,4,10
401491996,Holy Cross Crusaders,K. Flanagan,5109211,,True,34.0,4,11,3,8,1,3,0,0,1,7,8,2,1,1,3,3,9
401491996,Holy Cross Crusaders,C. McCormack,4704716,,True,23.0,4,12,4,9,0,3,2,2,0,3,3,1,1,0,0,2,10
401491996,Holy Cross Crusaders,B. Power-Cassidy,4704715,,True,33.0,7,15,4,8,3,7,1,2,3,2,5,3,0,4,2,1,18
401491996,Holy Cross Crusaders,A. Cross,4595975,,True,34.0,2,5,0,2,2,3,0,0,1,3,4,2,1,1,1,3,6
401491996,Holy Cross Crusaders,L. Berger,4900539,,False,19.0,2,5,2,5,0,0,0,0,1,3,4,3,2,0,1,2,4
401491996,Holy Cross Crusaders,M. Donnelly,5109213,,False,9.0,0,1,0,0,0,1,0,0,0,3,3,1,1,0,2,0,0
401491996,Holy Cross Crusaders,S. Foreman,5109212,,False,22.0,3,6,2,5,1,1,0,1,0,4,4,1,1,0,0,0,7
401491996,Holy Cross Crusaders,G. Munt,4900537,,False,8.0,1,1,1,1,0,0,0,2,1,0,1,0,0,0,1,0,2
401491996,Holy Cross Crusaders,TEAM,TOTAL,TOTAL,False,,28,63,21,45,7,18,3,7,13,29,42,15,7,8,17,15,66
401491995,Holy Cross Crusaders,J. Allen,4704714,,True,27.0,6,12,6,12,0,0,4,4,4,6,10,0,0,1,2,1,16
401491995,Holy Cross Crusaders,K. Flanagan,5109211,,True,33.0,3,7,3,6,0,1,0,0,0,1,1,6,1,0,2,1,6
401491995,Holy Cross Crusaders,C. McCormack,4704716,,True,26.0,2,3,0,0,2,3,1,2,1,2,3,3,0,0,5,2,7
401491995,Holy Cross Crusaders,B. Power-Cassidy,4704715,,True,31.0,7,11,2,3,5,8,4,5,1,4,5,0,0,1,5,3,23
401491995,Holy Cross Crusaders,A. Cross,4595975,,True,29.0,0,1,0,0,0,1,2,2,0,6,6,2,1,1,1,1,2
401491995,Holy Cross Crusaders,L. Berger,4900539,,False,19.0,1,2,1,2,0,0,1,2,1,2,3,1,0,1,1,1,3
401491995,Holy Cross Crusaders,C. Wright,4703660,,False,1.0,0,0,0,0,0,0,0,0,0,0,0,0,0,0,0,0,0
401491995,Holy Cross Crusaders,M. Donnelly,5109213,,False,18.0,1,4,0,1,1,3,0,0,1,5,6,3,0,0,1,2,3
401491995,Holy Cross Crusaders,S. Foreman,5109212,,False,15.0,1,4,1,2,0,2,0,0,0,3,3,0,2,0,0,0,2
401491995,Holy Cross Crusaders,G. Munt,4900537,,False,1.0,0,0,0,0,0,0,0,0,0,0,0,0,0,0,1,0,0
401491995,Holy Cross Crusaders,TEAM,TOTAL,TOTAL,False,,21,44,13,26,8,18,12,15,10,29,39,15,4,4,19,11,62
401491995,Holy Cross Crusaders,J. Allen,4704714,,True,27.0,6,12,6,12,0,0,4,4,4,6,10,0,0,1,2,1,16
401491995,Holy Cross Crusaders,K. Flanagan,5109211,,True,33.0,3,7,3,6,0,1,0,0,0,1,1,6,1,0,2,1,6
401491995,Holy Cross Crusaders,C. McCormack,4704716,,True,26.0,2,3,0,0,2,3,1,2,1,2,3,3,0,0,5,2,7
401491995,Holy Cross Crusaders,B. Power-Cassidy,4704715,,True,31.0,7,11,2,3,5,8,4,5,1,4,5,0,0,1,5,3,23
401491995,Holy Cross Crusaders,A. Cross,4595975,,True,29.0,0,1,0,0,0,1,2,2,0,6,6,2,1,1,1,1,2
401491995,Holy Cross Crusaders,L. Berger,4900539,,False,19.0,1,2,1,2,0,0,1,2,1,2,3,1,0,1,1,1,3
401491995,Holy Cross Crusaders,C. Wright,4703660,,False,1.0,0,0,0,0,0,0,0,0,0,0,0,0,0,0,0,0,0
401491995,Holy Cross Crusaders,M. Donnelly,5109213,,False,18.0,1,4,0,1,1,3,0,0,1,5,6,3,0,0,1,2,3
401491995,Holy Cross Crusaders,S. Foreman,5109212,,False,15.0,1,4,1,2,0,2,0,0,0,3,3,0,2,0,0,0,2
401491995,Holy Cross Crusaders,G. Munt,4900537,,False,1.0,0,0,0,0,0,0,0,0,0,0,0,0,0,0,1,0,0
401491995,Holy Cross Crusaders,TEAM,TOTAL,TOTAL,False,,21,44,13,26,8,18,12,15,10,29,39,15,4,4,19,11,62
401491995,American University Eagles,E. Johns,4704688,,True,17.0,1,9,1,7,0,2,0,0,0,2,2,0,1,0,3,3,2
401491995,American University Eagles,L. Stack,4595455,,True,34.0,4,13,4,13,0,0,1,2,4,2,6,1,3,0,1,4,9
401491995,American University Eagles,I. Bales,4704685,,True,16.0,0,3,0,1,0,2,0,0,1,1,2,2,1,0,2,5,0
401491995,American University Eagles,R. DeRubbo,4703746,,True,17.0,1,3,1,3,0,0,0,0,1,0,1,0,1,0,1,2,2
401491995,American University Eagles,S. Stetson,4595453,,True,33.0,1,3,1,3,0,0,1,1,1,3,4,1,2,0,0,1,3
401491995,American University Eagles,M. Lavin,5109188,,False,22.0,5,8,2,2,3,6,2,2,1,3,4,0,1,0,2,2,15
401491995,American University Eagles,M. Lee,4704592,,False,1.0,0,0,0,0,0,0,0,0,0,0,0,0,1,0,0,0,0
401491995,American University Eagles,L. Nogues,5109187,,False,6.0,2,4,2,2,0,2,0,1,1,0,1,1,0,0,2,0,4
401491995,American University Eagles,A. Rescifina,5109186,,False,3.0,0,0,0,0,0,0,2,2,0,0,0,0,0,0,0,1,2
401491995,American University Eagles,B. Garbee,4899710,,False,11.0,0,0,0,0,0,0,0,0,1,0,1,0,0,0,1,0,0
401491995,American University Eagles,K. Henning,4704686,,False,28.0,2,12,2,11,0,1,1,2,0,1,1,4,2,0,0,0,5
401491995,American University Eagles,A. LeMaster,4703737,,False,12.0,1,3,0,1,1,2,0,0,0,1,1,1,0,0,2,2,3
401491995,American University Eagles,TEAM,TOTAL,TOTAL,False,,17,58,13,43,4,15,7,10,14,14,28,10,12,0,14,20,45
401491995,American University Eagles,E. Johns,4704688,,True,17.0,1,9,1,7,0,2,0,0,0,2,2,0,1,0,3,3,2
401491995,American University Eagles,L. Stack,4595455,,True,34.0,4,13,4,13,0,0,1,2,4,2,6,1,3,0,1,4,9
401491995,American University Eagles,I. Bales,4704685,,True,16.0,0,3,0,1,0,2,0,0,1,1,2,2,1,0,2,5,0
401491995,American University Eagles,R. DeRubbo,4703746,,True,17.0,1,3,1,3,0,0,0,0,1,0,1,0,1,0,1,2,2
401491995,American University Eagles,S. Stetson,4595453,,True,33.0,1,3,1,3,0,0,1,1,1,3,4,1,2,0,0,1,3
401491995,American University Eagles,M. Lavin,5109188,,False,22.0,5,8,2,2,3,6,2,2,1,3,4,0,1,0,2,2,15
401491995,American University Eagles,M. Lee,4704592,,False,1.0,0,0,0,0,0,0,0,0,0,0,0,0,1,0,0,0,0
401491995,American University Eagles,L. Nogues,5109187,,False,6.0,2,4,2,2,0,2,0,1,1,0,1,1,0,0,2,0,4
401491995,American University Eagles,A. Rescifina,5109186,,False,3.0,0,0,0,0,0,0,2,2,0,0,0,0,0,0,0,1,2
401491995,American University Eagles,B. Garbee,4899710,,False,11.0,0,0,0,0,0,0,0,0,1,0,1,0,0,0,1,0,0
401491995,American University Eagles,K. Henning,4704686,,False,28.0,2,12,2,11,0,1,1,2,0,1,1,4,2,0,0,0,5
401491995,American University Eagles,A. LeMaster,4703737,,False,12.0,1,3,0,1,1,2,0,0,0,1,1,1,0,0,2,2,3
401491995,American University Eagles,TEAM,TOTAL,TOTAL,False,,17,58,13,43,4,15,7,10,14,14,28,10,12,0,14,20,45
401491994,Holy Cross Crusaders,J. Allen,4704714,,True,13.0,3,5,3,5,0,0,0,0,0,3,3,1,0,1,1,4,6
401491994,Holy Cross Crusaders,K. Flanagan,5109211,,True,33.0,2,6,1,4,1,2,2,2,0,1,1,5,0,1,2,2,7
401491994,Holy Cross Crusaders,C. McCormack,4704716,,True,29.0,3,13,2,8,1,5,0,0,0,3,3,1,0,0,2,3,7
401491994,Holy Cross Crusaders,B. Power-Cassidy,4704715,,True,29.0,5,9,1,3,4,6,1,2,1,3,4,1,2,1,0,1,15
401491994,Holy Cross Crusaders,A. Cross,4595975,,True,19.0,1,3,0,0,1,3,1,2,0,4,4,0,1,0,1,2,4
401491994,Holy Cross Crusaders,M. Cahalan,5109210,,False,1.0,0,0,0,0,0,0,0,0,0,0,0,0,0,0,0,1,0
401491994,Holy Cross Crusaders,L. Berger,4900539,,False,23.0,5,6,5,6,0,0,0,0,4,3,7,2,1,0,3,3,10
401491994,Holy Cross Crusaders,C. Wright,4703660,,False,4.0,1,1,1,1,0,0,0,0,0,2,2,0,0,0,0,0,2
401491994,Holy Cross Crusaders,M. Donnelly,5109213,,False,20.0,1,5,1,3,0,2,0,0,1,5,6,1,0,1,0,1,2
401491994,Holy Cross Crusaders,S. Foreman,5109212,,False,18.0,4,6,4,6,0,0,1,2,1,1,2,1,1,0,0,2,9
401491994,Holy Cross Crusaders,L. Huber,4900538,,False,1.0,0,0,0,0,0,0,0,0,0,0,0,0,0,0,0,0,0
401491994,Holy Cross Crusaders,G. Munt,4900537,,False,10.0,0,2,0,1,0,1,0,0,1,1,2,1,1,0,1,0,0
401491994,Holy Cross Crusaders,TEAM,TOTAL,TOTAL,False,,25,56,18,37,7,19,5,8,9,26,35,13,6,4,11,19,62
401491994,Holy Cross Crusaders,J. Allen,4704714,,True,13.0,3,5,3,5,0,0,0,0,0,3,3,1,0,1,1,4,6
401491994,Holy Cross Crusaders,K. Flanagan,5109211,,True,33.0,2,6,1,4,1,2,2,2,0,1,1,5,0,1,2,2,7
401491994,Holy Cross Crusaders,C. McCormack,4704716,,True,29.0,3,13,2,8,1,5,0,0,0,3,3,1,0,0,2,3,7
401491994,Holy Cross Crusaders,B. Power-Cassidy,4704715,,True,29.0,5,9,1,3,4,6,1,2,1,3,4,1,2,1,0,1,15
401491994,Holy Cross Crusaders,A. Cross,4595975,,True,19.0,1,3,0,0,1,3,1,2,0,4,4,0,1,0,1,2,4
401491994,Holy Cross Crusaders,M. Cahalan,5109210,,False,1.0,0,0,0,0,0,0,0,0,0,0,0,0,0,0,0,1,0
401491994,Holy Cross Crusaders,L. Berger,4900539,,False,23.0,5,6,5,6,0,0,0,0,4,3,7,2,1,0,3,3,10
401491994,Holy Cross Crusaders,C. Wright,4703660,,False,4.0,1,1,1,1,0,0,0,0,0,2,2,0,0,0,0,0,2
401491994,Holy Cross Crusaders,M. Donnelly,5109213,,False,20.0,1,5,1,3,0,2,0,0,1,5,6,1,0,1,0,1,2
401491994,Holy Cross Crusaders,S. Foreman,5109212,,False,18.0,4,6,4,6,0,0,1,2,1,1,2,1,1,0,0,2,9
401491994,Holy Cross Crusaders,L. Huber,4900538,,False,1.0,0,0,0,0,0,0,0,0,0,0,0,0,0,0,0,0,0
401491994,Holy Cross Crusaders,G. Munt,4900537,,False,10.0,0,2,0,1,0,1,0,0,1,1,2,1,1,0,1,0,0
401491994,Holy Cross Crusaders,TEAM,TOTAL,TOTAL,False,,25,56,18,37,7,19,5,8,9,26,35,13,6,4,11,19,62
401491994,Bucknell Bison,I. King,4900533,,True,29.0,1,3,1,2,0,1,2,2,1,2,3,0,0,0,2,1,4
401491994,Bucknell Bison,E. Shaffer,4595535,,True,29.0,2,7,2,7,0,0,1,8,6,3,9,2,1,2,0,2,5
401491994,Bucknell Bison,E. Theodorsson,5109199,,True,28.0,2,12,2,7,0,5,2,2,1,6,7,0,0,1,1,0,6
401491994,Bucknell Bison,R. Sisselman,4900531,,True,30.0,3,9,1,4,2,5,0,2,1,4,5,1,0,0,1,0,8
401491994,Bucknell Bison,C. Collins,4900532,,True,37.0,5,10,5,9,0,1,6,10,0,4,4,2,1,0,3,3,16
401491994,Bucknell Bison,G. Sullivan,5109201,,False,6.0,1,2,1,2,0,0,0,0,1,2,3,0,0,0,1,3,2
401491994,Bucknell Bison,N. Davis,4704701,,False,5.0,0,0,0,0,0,0,0,2,0,0,0,0,1,0,0,0,0
401491994,Bucknell Bison,B. Matthews,5109200,,False,1.0,0,0,0,0,0,0,1,2,0,2,2,1,0,0,0,0,1
401491994,Bucknell Bison,J. Kulesza,4704702,,False,11.0,0,1,0,0,0,1,0,0,0,0,0,0,0,0,0,2,0
401491994,Bucknell Bison,T. Johnson,4595533,,False,12.0,1,2,1,2,0,0,0,0,0,0,0,0,0,0,1,0,2
401491994,Bucknell Bison,C. Dingler,4577540,,False,12.0,0,0,0,0,0,0,1,2,0,0,0,1,0,0,2,0,1
401491994,Bucknell Bison,TEAM,TOTAL,TOTAL,False,,15,46,13,33,2,13,13,30,11,24,35,7,3,3,13,11,45
401491994,Bucknell Bison,I. King,4900533,,True,29.0,1,3,1,2,0,1,2,2,1,2,3,0,0,0,2,1,4
401491994,Bucknell Bison,E. Shaffer,4595535,,True,29.0,2,7,2,7,0,0,1,8,6,3,9,2,1,2,0,2,5
401491994,Bucknell Bison,E. Theodorsson,5109199,,True,28.0,2,12,2,7,0,5,2,2,1,6,7,0,0,1,1,0,6
401491994,Bucknell Bison,R. Sisselman,4900531,,True,30.0,3,9,1,4,2,5,0,2,1,4,5,1,0,0,1,0,8
401491994,Bucknell Bison,C. Collins,4900532,,True,37.0,5,10,5,9,0,1,6,10,0,4,4,2,1,0,3,3,16
401491994,Bucknell Bison,G. Sullivan,5109201,,False,6.0,1,2,1,2,0,0,0,0,1,2,3,0,0,0,1,3,2
401491994,Bucknell Bison,N. Davis,4704701,,False,5.0,0,0,0,0,0,0,0,2,0,0,0,0,1,0,0,0,0
401491994,Bucknell Bison,B. Matthews,5109200,,False,1.0,0,0,0,0,0,0,1,2,0,2,2,1,0,0,0,0,1
401491994,Bucknell Bison,J. Kulesza,4704702,,False,11.0,0,1,0,0,0,1,0,0,0,0,0,0,0,0,0,2,0
401491994,Bucknell Bison,T. Johnson,4595533,,False,12.0,1,2,1,2,0,0,0,0,0,0,0,0,0,0,1,0,2
401491994,Bucknell Bison,C. Dingler,4577540,,False,12.0,0,0,0,0,0,0,1,2,0,0,0,1,0,0,2,0,1
401491994,Bucknell Bison,TEAM,TOTAL,TOTAL,False,,15,46,13,33,2,13,13,30,11,24,35,7,3,3,13,11,45
401491993,Northeastern Huskies,A. Parker,4899586,,True,20.0,1,3,1,3,0,0,0,0,0,4,4,0,0,1,1,2,2
401491993,Northeastern Huskies,H. Idowu,4705388,,True,27.0,2,7,2,6,0,1,0,0,5,7,12,4,1,0,2,3,4
401491993,Northeastern Huskies,A. Webb,5108856,,True,21.0,4,5,3,4,1,1,2,2,1,4,5,0,1,0,3,3,11
401491993,Northeastern Huskies,G. Motema,4899585,,True,35.0,3,7,3,6,0,1,6,6,0,7,7,2,1,0,4,2,12
401491993,Northeastern Huskies,D. Erdogan,4703579,,True,38.0,5,16,4,11,1,5,2,2,0,3,3,6,1,0,2,3,13
401491993,Northeastern Huskies,O. Kiefer,5108855,,False,19.0,2,5,2,4,0,1,1,2,1,2,3,0,0,1,0,1,5
401491993,Northeastern Huskies,I. Larsen,4705028,,False,7.0,0,3,0,1,0,2,0,0,1,0,1,0,0,0,0,0,0
401491993,Northeastern Huskies,D. Bristol,4704182,,False,7.0,1,2,1,2,0,0,1,2,1,0,1,0,0,0,0,3,3
401491993,Northeastern Huskies,M. Turnbull,5108857,,False,3.0,0,0,0,0,0,0,0,0,0,0,0,0,0,0,0,0,0
401491993,Northeastern Huskies,C. Clement,4899583,,False,21.0,1,8,0,2,1,6,2,2,0,3,3,0,1,0,1,1,5
401491993,Northeastern Huskies,A. Sapenter,4710685,,False,2.0,0,0,0,0,0,0,0,0,0,0,0,0,0,0,0,0,0
401491993,Northeastern Huskies,TEAM,TOTAL,TOTAL,False,,19,56,16,39,3,17,14,16,10,31,41,12,5,2,14,18,55
401491993,Holy Cross Crusaders,L. Berger,4900539,,True,22.0,1,2,1,2,0,0,3,4,0,6,6,0,1,0,2,3,5
401491993,Holy Cross Crusaders,J. Allen,4704714,,True,28.0,4,12,4,12,0,0,3,4,1,5,6,3,2,1,1,2,11
401491993,Holy Cross Crusaders,K. Flanagan,5109211,,True,28.0,2,5,1,3,1,2,3,4,0,1,1,4,0,0,2,1,8
401491993,Holy Cross Crusaders,B. Power-Cassidy,4704715,,True,31.0,5,13,2,6,3,7,2,2,1,3,4,2,0,0,1,2,15
401491993,Holy Cross Crusaders,A. Cross,4595975,,True,31.0,2,5,0,3,2,2,1,2,0,2,2,2,0,0,1,4,7
401491993,Holy Cross Crusaders,C. Wright,4703660,,False,7.0,1,2,1,2,0,0,0,0,0,1,1,0,0,0,1,0,2
401491993,Holy Cross Crusaders,M. Donnelly,5109213,,False,18.0,1,3,0,0,1,3,0,0,0,4,4,3,0,0,1,0,3
401491993,Holy Cross Crusaders,S. Foreman,5109212,,False,10.0,1,3,1,2,0,1,0,0,2,2,4,1,1,0,0,0,2
401491993,Holy Cross Crusaders,C. McCormack,4704716,,False,25.0,2,9,0,2,2,7,1,2,0,0,0,1,0,0,2,2,7
401491993,Holy Cross Crusaders,TEAM,TOTAL,TOTAL,False,,19,54,10,32,9,22,13,18,6,26,32,16,4,1,11,14,60
401491992,Holy Cross Crusaders,L. Berger,4900539,,True,33.0,5,14,5,14,0,0,2,2,4,5,9,4,1,0,4,2,12
401491992,Holy Cross Crusaders,J. Allen,4704714,,True,34.0,4,8,4,8,0,0,8,9,0,8,8,7,0,0,6,1,16
401491992,Holy Cross Crusaders,M. Donnelly,5109213,,True,35.0,3,6,0,1,3,5,2,2,1,14,15,1,1,2,3,2,11
401491992,Holy Cross Crusaders,K. Flanagan,5109211,,True,37.0,0,6,0,4,0,2,0,0,0,3,3,4,0,0,0,0,0
401491992,Holy Cross Crusaders,B. Power-Cassidy,4704715,,True,31.0,4,8,1,3,3,5,0,0,2,2,4,0,0,0,2,3,11
401491992,Holy Cross Crusaders,C. Wright,4703660,,False,11.0,2,3,2,3,0,0,2,4,0,1,1,0,0,0,2,1,6
401491992,Holy Cross Crusaders,S. Foreman,5109212,,False,2.0,0,0,0,0,0,0,0,0,0,1,1,0,0,0,1,0,0
401491992,Holy Cross Crusaders,L. Huber,4900538,,False,16.0,1,3,0,1,1,2,1,1,0,4,4,0,1,0,1,1,4
401491992,Holy Cross Crusaders,G. Munt,4900537,,False,1.0,0,0,0,0,0,0,0,0,0,0,0,0,0,0,1,0,0
401491992,Holy Cross Crusaders,TEAM,TOTAL,TOTAL,False,,19,48,12,34,7,14,15,18,9,38,47,16,3,2,20,10,60
401491992,Brown Bears,G. Aiello,4899279,,True,29.0,2,5,2,5,0,0,0,3,3,4,7,0,6,2,4,4,4
401491992,Brown Bears,M. Leahy,5108928,,True,16.0,1,6,1,2,0,4,0,0,1,0,1,1,0,1,1,1,2
401491992,Brown Bears,G. Arnolie,5108926,,True,26.0,1,9,1,4,0,5,2,2,0,2,2,2,3,1,0,1,4
401491992,Brown Bears,K. Jones,4705206,,True,19.0,2,10,1,7,1,3,0,0,0,2,2,2,0,0,1,0,5
401491992,Brown Bears,C. Jewell,4705205,,True,19.0,1,5,1,4,0,1,0,0,0,4,4,1,1,0,0,0,2
401491992,Brown Bears,A. Anamekwe,5108929,,False,5.0,1,2,1,2,0,0,0,0,0,1,1,0,1,1,1,0,2
401491992,Brown Bears,E. Nelson,5108924,,False,25.0,3,4,2,3,1,1,0,0,4,1,5,2,0,2,0,2,7
401491992,Brown Bears,A. Moreland,5108921,,False,17.0,1,3,1,2,0,1,1,2,3,3,6,2,1,0,0,1,3
401491992,Brown Bears,M. Murray,4705210,,False,6.0,0,2,0,1,0,1,0,0,0,3,3,0,0,1,1,4,0
401491992,Brown Bears,P. Greenburg,5108932,,False,12.0,2,6,0,1,2,5,0,0,0,0,0,0,0,0,0,0,6
401491992,Brown Bears,I. Mauricio,4899277,,False,26.0,4,15,2,5,2,10,0,0,0,0,0,2,2,0,0,2,10
401491992,Brown Bears,TEAM,TOTAL,TOTAL,False,,18,67,12,36,6,31,3,7,11,22,33,12,14,8,8,15,45
401491991,Holy Cross Crusaders,L. Berger,4900539,,True,26.0,5,10,5,10,0,0,3,3,5,4,9,2,2,0,1,0,13
401491991,Holy Cross Crusaders,J. Allen,4704714,,True,21.0,5,14,5,14,0,0,3,5,4,0,4,1,1,0,3,3,13
401491991,Holy Cross Crusaders,K. Flanagan,5109211,,True,26.0,0,5,0,2,0,3,4,4,0,3,3,4,3,0,1,0,4
401491991,Holy Cross Crusaders,B. Power-Cassidy,4704715,,True,29.0,6,14,3,7,3,7,1,2,3,3,6,1,2,0,2,3,16
401491991,Holy Cross Crusaders,A. Cross,4595975,,True,30.0,4,7,3,4,1,3,3,4,4,3,7,2,5,0,1,3,12
401491991,Holy Cross Crusaders,M. Cahalan,5109210,,False,5.0,1,3,1,3,0,0,0,0,1,3,4,1,1,0,0,2,2
401491991,Holy Cross Crusaders,C. Wright,4703660,,False,15.0,1,4,1,4,0,0,1,2,4,4,8,0,0,0,1,1,3
401491991,Holy Cross Crusaders,M. Donnelly,5109213,,False,19.0,1,6,1,3,0,3,0,0,2,4,6,1,2,0,1,1,2
401491991,Holy Cross Crusaders,L. Huber,4900538,,False,14.0,0,6,0,2,0,4,0,0,0,2,2,1,0,0,0,0,0
401491991,Holy Cross Crusaders,G. Munt,4900537,,False,15.0,0,8,0,5,0,3,0,0,0,0,0,0,2,1,0,0,0
401491991,Holy Cross Crusaders,TEAM,TOTAL,TOTAL,False,,23,77,19,54,4,23,15,20,27,27,54,13,18,1,10,13,65
401491991,Connecticut College Camels,R. Oberman-Levine,4905823,,True,31.0,2,5,1,4,1,1,1,3,2,8,10,3,0,4,2,3,6
401491991,Connecticut College Camels,J. Rojik,4905826,,True,24.0,5,11,3,8,2,3,1,4,2,3,5,0,1,0,2,3,13
401491991,Connecticut College Camels,C. Donadio,4905822,,True,30.0,1,2,1,2,0,0,1,1,0,5,5,2,1,0,5,2,3
401491991,Connecticut College Camels,M. Cronin,4905817,,True,33.0,3,7,1,1,2,6,0,0,0,1,1,3,2,0,6,2,8
401491991,Connecticut College Camels,A. Ilusorio,4905815,,True,19.0,1,4,1,2,0,2,0,0,0,0,0,1,0,0,2,1,2
401491991,Connecticut College Camels,R. Nnabuife,5115832,,False,6.0,0,1,0,1,0,0,2,4,0,1,1,0,0,0,1,0,2
401491991,Connecticut College Camels,H. O'Toole,5115829,,False,17.0,2,9,2,6,0,3,0,0,0,2,2,1,1,0,2,1,4
401491991,Connecticut College Camels,M. Iannici,5115834,,False,2.0,1,1,0,0,1,1,0,0,0,1,1,0,0,0,0,0,3
401491991,Connecticut College Camels,A. Burns,5115828,,False,6.0,0,1,0,0,0,1,0,0,0,1,1,1,0,0,1,1,0
401491991,Connecticut College Camels,S. Feeney,5115827,,False,3.0,0,0,0,0,0,0,0,0,0,1,1,1,0,0,0,0,0
401491991,Connecticut College Camels,T. Poissant,5115826,,False,4.0,0,0,0,0,0,0,0,0,0,0,0,0,0,0,0,0,0
401491991,Connecticut College Camels,A. McMahon,4905821,,False,25.0,2,4,0,0,2,4,2,2,0,2,2,0,0,1,2,2,8
401491991,Connecticut College Camels,TEAM,TOTAL,TOTAL,False,,17,45,9,24,8,21,7,14,5,30,35,12,5,5,24,15,49
401491990,New Hampshire Wildcats,B. Morales Lopez,5107637,,True,23.0,3,7,3,7,0,0,2,3,1,3,4,0,0,0,4,5,8
401491990,New Hampshire Wildcats,A. O'Connor,5107640,,True,25.0,2,11,1,5,1,6,2,2,1,3,4,0,2,1,0,3,7
401491990,New Hampshire Wildcats,B. Williams,5107638,,True,36.0,5,12,5,10,0,2,1,2,1,2,3,1,4,0,4,3,11
401491990,New Hampshire Wildcats,A. Groman,4704607,,True,28.0,2,9,1,7,1,2,4,4,1,1,2,2,2,0,0,3,9
401491990,New Hampshire Wildcats,B. Kane,4594367,,True,37.0,4,11,3,8,1,3,1,2,2,8,10,2,2,1,3,2,10
401491990,New Hampshire Wildcats,P. Cote,4704608,,False,9.0,0,2,0,2,0,0,0,0,0,0,0,0,0,1,2,3,0
401491990,New Hampshire Wildcats,K. Andersson,5107641,,False,24.0,0,5,0,3,0,2,2,2,1,0,1,0,0,0,0,1,2
401491990,New Hampshire Wildcats,D. Eliasson,5107639,,False,18.0,0,2,0,1,0,1,2,2,2,2,4,0,1,0,2,1,2
401491990,New Hampshire Wildcats,TEAM,TOTAL,TOTAL,False,,16,59,13,43,3,16,14,17,9,22,31,5,11,3,15,21,49
401491990,Holy Cross Crusaders,L. Berger,4900539,,True,29.0,6,9,6,9,0,0,5,6,2,12,14,1,0,4,2,2,17
401491990,Holy Cross Crusaders,J. Allen,4704714,,True,24.0,3,9,3,9,0,0,4,6,1,3,4,2,2,2,5,4,10
401491990,Holy Cross Crusaders,K. Flanagan,5109211,,True,34.0,4,5,2,2,2,3,2,4,2,3,5,4,0,0,5,3,12
401491990,Holy Cross Crusaders,B. Power-Cassidy,4704715,,True,32.0,3,10,3,6,0,4,3,4,2,3,5,0,1,1,4,2,9
401491990,Holy Cross Crusaders,A. Cross,4595975,,True,27.0,1,4,1,1,0,3,0,0,0,5,5,3,0,0,3,3,2
401491990,Holy Cross Crusaders,C. Wright,4703660,,False,1.0,0,0,0,0,0,0,0,0,0,0,0,1,0,0,0,0,0
401491990,Holy Cross Crusaders,M. Donnelly,5109213,,False,26.0,2,6,0,1,2,5,0,0,0,2,2,3,0,0,3,1,6
401491990,Holy Cross Crusaders,S. Foreman,5109212,,False,13.0,0,4,0,3,0,1,0,0,2,1,3,0,1,0,1,2,0
401491990,Holy Cross Crusaders,L. Huber,4900538,,False,5.0,0,1,0,0,0,1,0,0,0,1,1,0,0,0,0,2,0
401491990,Holy Cross Crusaders,G. Munt,4900537,,False,9.0,0,3,0,2,0,1,0,0,1,0,1,1,0,0,1,0,0
401491990,Holy Cross Crusaders,TEAM,TOTAL,TOTAL,False,,19,51,15,33,4,18,14,20,13,36,49,15,4,7,24,19,56
401491989,Merrimack Warriors,A. Staton,4704140,,True,25.0,2,8,2,7,0,1,1,2,2,2,4,0,1,1,2,3,5
401491989,Merrimack Warriors,A. Fursman,4597025,,True,25.0,1,4,1,2,0,2,0,0,1,1,2,1,3,0,2,2,2
401491989,Merrimack Warriors,M. Hamilton,4282089,,True,32.0,5,14,4,10,1,4,0,0,1,2,3,0,2,0,2,0,11
401491989,Merrimack Warriors,K. Thomas,4597022,,True,32.0,4,10,3,4,1,6,0,0,2,2,4,0,1,0,2,0,9
401491989,Merrimack Warriors,J. DeCesare,4597019,,True,33.0,4,13,3,4,1,9,1,2,2,1,3,2,3,0,4,0,10
401491989,Merrimack Warriors,J. Powell,4900513,,False,12.0,1,4,1,4,0,0,0,0,0,2,2,0,0,0,3,3,2
401491989,Merrimack Warriors,M. Manion,4900515,,False,10.0,0,1,0,1,0,0,0,0,0,1,1,0,0,0,2,1,0
401491989,Merrimack Warriors,A. Owens,4900512,,False,21.0,0,0,0,0,0,0,0,2,2,3,5,1,1,0,4,3,0
401491989,Merrimack Warriors,M. Bray,4598238,,False,10.0,0,1,0,1,0,0,0,0,0,1,1,0,0,0,0,1,0
401491989,Merrimack Warriors,TEAM,TOTAL,TOTAL,False,,17,55,14,33,3,22,2,6,13,17,30,4,11,1,23,13,39
401491989,Holy Cross Crusaders,L. Berger,4900539,,True,24.0,1,2,1,2,0,0,4,4,0,4,4,5,3,0,3,3,6
401491989,Holy Cross Crusaders,M. Donnelly,5109213,,True,20.0,2,6,2,3,0,3,0,0,1,3,4,2,0,0,1,1,4
401491989,Holy Cross Crusaders,K. Flanagan,5109211,,True,23.0,2,5,1,4,1,1,0,0,1,0,1,1,2,0,1,0,5
401491989,Holy Cross Crusaders,B. Power-Cassidy,4704715,,True,26.0,8,14,5,8,3,6,0,0,2,1,3,1,3,1,3,1,19
401491989,Holy Cross Crusaders,A. Cross,4595975,,True,23.0,1,4,0,2,1,2,0,0,3,5,8,3,2,0,1,3,3
401491989,Holy Cross Crusaders,M. Cahalan,5109210,,False,10.0,2,4,2,4,0,0,0,0,0,1,1,0,0,0,2,1,4
401491989,Holy Cross Crusaders,J. Allen,4704714,,False,15.0,3,6,3,6,0,0,1,4,4,2,6,1,3,1,4,2,7
401491989,Holy Cross Crusaders,C. Wright,4703660,,False,12.0,2,5,2,5,0,0,0,0,1,1,2,1,0,1,0,2,4
401491989,Holy Cross Crusaders,S. Foreman,5109212,,False,17.0,4,5,4,5,0,0,1,1,1,6,7,1,0,0,1,0,9
401491989,Holy Cross Crusaders,L. Huber,4900538,,False,20.0,2,3,2,2,0,1,0,0,0,0,0,0,0,0,3,0,4
401491989,Holy Cross Crusaders,G. Munt,4900537,,False,10.0,1,2,1,2,0,0,0,0,0,0,0,0,0,0,0,0,2
401491989,Holy Cross Crusaders,TEAM,TOTAL,TOTAL,False,,28,56,23,43,5,13,6,9,13,27,40,15,13,3,19,13,67
401488175,Stonehill Skyhawks,S. Glidden,5106114,,True,33.0,5,14,5,11,0,3,0,0,2,4,6,1,0,0,2,3,10
401488175,Stonehill Skyhawks,C. Ward,5106108,,True,24.0,4,5,3,3,1,2,0,0,1,4,5,3,2,0,1,3,9
401488175,Stonehill Skyhawks,E. Bramanti,5106112,,True,40.0,5,15,3,8,2,7,1,2,2,3,5,3,1,0,1,1,13
401488175,Stonehill Skyhawks,M. Kelly,5106107,,True,26.0,2,5,2,4,0,1,1,1,3,2,5,1,0,0,3,4,5
401488175,Stonehill Skyhawks,M. Loder,4399081,,True,36.0,6,15,4,8,2,7,2,2,1,2,3,4,2,1,3,2,16
401488175,Stonehill Skyhawks,M. Stapleton,5106115,,False,21.0,2,4,1,1,1,3,2,2,2,0,2,1,0,0,1,2,7
401488175,Stonehill Skyhawks,C. McCullagh,5106111,,False,1.0,0,0,0,0,0,0,0,0,0,0,0,0,0,0,0,1,0
401488175,Stonehill Skyhawks,S. Hayward,5106110,,False,8.0,0,2,0,0,0,2,2,2,0,0,0,1,0,0,1,1,2
401488175,Stonehill Skyhawks,J. Thornton,5106106,,False,11.0,0,3,0,3,0,0,0,0,0,0,0,0,0,0,0,1,0
401488175,Stonehill Skyhawks,TEAM,TOTAL,TOTAL,False,,24,63,18,38,6,25,8,9,13,17,30,14,5,1,13,18,62
401488175,Holy Cross Crusaders,L. Berger,4900539,,True,16.0,4,7,4,7,0,0,2,2,3,3,6,1,0,0,1,3,10
401488175,Holy Cross Crusaders,J. Allen,4704714,,True,25.0,6,11,6,11,0,0,4,6,1,3,4,3,0,0,4,4,16
401488175,Holy Cross Crusaders,K. Flanagan,5109211,,True,32.0,4,4,4,4,0,0,3,3,2,1,3,6,4,1,5,3,11
401488175,Holy Cross Crusaders,B. Power-Cassidy,4704715,,True,37.0,8,13,7,9,1,4,0,0,0,3,3,2,0,0,1,1,17
401488175,Holy Cross Crusaders,A. Cross,4595975,,True,28.0,2,6,0,3,2,3,0,0,0,1,1,2,1,1,3,3,6
401488175,Holy Cross Crusaders,C. Wright,4703660,,False,7.0,1,2,1,2,0,0,0,0,1,2,3,0,0,1,0,1,2
401488175,Holy Cross Crusaders,M. Donnelly,5109213,,False,23.0,1,4,1,2,0,2,0,0,0,8,8,2,0,2,0,1,2
401488175,Holy Cross Crusaders,S. Foreman,5109212,,False,9.0,0,1,0,1,0,0,0,0,1,0,1,0,1,0,1,1,0
401488175,Holy Cross Crusaders,C. McCormack,4704716,,False,23.0,4,7,2,3,2,4,0,0,0,4,4,7,1,0,1,2,10
401488175,Holy Cross Crusaders,TEAM,TOTAL,TOTAL,False,,30,55,25,42,5,13,9,11,8,27,35,23,7,5,16,19,74
401488170,Stonehill Skyhawks,S. Glidden,5106114,,True,34.0,4,10,4,10,0,0,0,0,3,9,12,2,3,0,3,3,8
401488170,Stonehill Skyhawks,E. Bramanti,5106112,,True,35.0,4,14,1,4,3,10,0,0,0,5,5,4,0,0,1,1,11
401488170,Stonehill Skyhawks,M. Kelly,5106107,,True,34.0,4,14,1,8,3,6,0,0,2,3,5,0,2,0,5,3,11
401488170,Stonehill Skyhawks,J. Thornton,5106106,,True,22.0,0,2,0,1,0,1,0,0,1,0,1,1,1,0,5,2,0
401488170,Stonehill Skyhawks,M. Loder,4399081,,True,30.0,2,10,1,4,1,6,5,6,0,3,3,1,1,0,2,0,10
401488170,Stonehill Skyhawks,M. Stapleton,5106115,,False,21.0,0,4,0,2,0,2,0,0,1,9,10,2,0,0,3,3,0
401488170,Stonehill Skyhawks,C. McCullagh,5106111,,False,9.0,0,2,0,2,0,0,1,2,0,1,1,0,0,0,0,1,1
401488170,Stonehill Skyhawks,C. Ward,5106108,,False,9.0,1,2,1,2,0,0,0,0,1,1,2,0,0,1,1,2,2
401488170,Stonehill Skyhawks,S. Hayward,5106110,,False,2.0,0,1,0,0,0,1,0,0,0,0,0,0,0,0,0,0,0
401488170,Stonehill Skyhawks,C. Graiver,5106109,,False,4.0,0,3,0,2,0,1,0,0,0,0,0,0,0,0,3,0,0
401488170,Stonehill Skyhawks,TEAM,TOTAL,TOTAL,False,,15,62,8,35,7,27,6,8,8,31,39,10,7,1,23,15,43
401488170,Lehigh Mountain Hawks,M. O'Brien,4900547,,True,25.0,3,11,3,7,0,4,0,0,2,3,5,3,2,3,2,1,6
401488170,Lehigh Mountain Hawks,F. Hottinger,4595613,,True,32.0,9,23,8,18,1,5,2,4,8,10,18,2,4,0,2,0,21
401488170,Lehigh Mountain Hawks,M. Kramer,4704762,,True,32.0,4,15,1,6,3,9,2,4,0,3,3,1,1,0,1,1,13
401488170,Lehigh Mountain Hawks,A. Harvey,4595612,,True,33.0,0,1,0,0,0,1,0,0,0,1,1,4,3,0,2,1,0
401488170,Lehigh Mountain Hawks,J. Behar,4433782,,True,11.0,2,4,1,1,1,3,0,0,0,3,3,0,2,0,1,0,5
401488170,Lehigh Mountain Hawks,L. Fandre,5109220,,False,18.0,1,4,0,1,1,3,1,2,0,2,2,1,0,2,1,2,4
401488170,Lehigh Mountain Hawks,M. Brown,4433751,,False,2.0,0,0,0,0,0,0,0,0,0,0,0,0,0,0,0,0,0
401488170,Lehigh Mountain Hawks,K. Van Eps,4900545,,False,18.0,1,3,0,0,1,3,0,0,1,6,7,1,0,1,2,3,3
401488170,Lehigh Mountain Hawks,E. Stemmer,4900544,,False,13.0,1,7,1,1,0,6,0,0,0,2,2,0,2,0,0,1,2
401488170,Lehigh Mountain Hawks,M. Albrecht,4704763,,False,16.0,2,2,2,2,0,0,2,2,1,2,3,1,0,2,1,3,6
401488170,Lehigh Mountain Hawks,TEAM,TOTAL,TOTAL,False,,23,70,16,36,7,34,7,12,12,32,44,13,14,8,12,12,60
401488111,Navy Midshipmen,M. Andrews,4704780,,True,31.0,1,6,1,6,0,0,0,0,2,5,7,2,2,0,2,0,2
401488111,Navy Midshipmen,L. Llewellyn,4595625,,True,38.0,4,16,3,11,1,5,2,4,1,5,6,1,2,0,1,3,11
401488111,Navy Midshipmen,K. Samson,5109237,,True,25.0,5,8,5,8,0,0,5,9,2,8,10,1,0,1,1,1,15
401488111,Navy Midshipmen,M. Louridas,5109236,,True,27.0,3,10,2,4,1,6,4,5,1,2,3,3,1,0,1,5,11
401488111,Navy Midshipmen,M. Schrader,4595622,,True,23.0,1,4,1,3,0,1,0,0,0,0,0,5,0,0,1,1,2
401488111,Navy Midshipmen,M. Demos,5109235,,False,3.0,0,0,0,0,0,0,0,0,0,0,0,1,1,0,0,1,0
401488111,Navy Midshipmen,B. Coleman,5109233,,False,9.0,0,0,0,0,0,0,2,2,0,1,1,0,0,1,0,3,2
401488111,Navy Midshipmen,S. Watts,4704782,,False,19.0,3,9,2,3,1,6,0,0,0,1,1,1,1,0,0,2,7
401488111,Navy Midshipmen,S. Schofield,4704779,,False,25.0,5,9,1,2,4,7,0,0,0,3,3,2,0,0,2,1,14
401488111,Navy Midshipmen,TEAM,TOTAL,TOTAL,False,,22,62,15,37,7,25,13,20,9,26,35,16,7,2,8,17,64
401488111,Navy Midshipmen,M. Andrews,4704780,,True,31.0,1,6,1,6,0,0,0,0,2,5,7,2,2,0,2,0,2
401488111,Navy Midshipmen,L. Llewellyn,4595625,,True,38.0,4,16,3,11,1,5,2,4,1,5,6,1,2,0,1,3,11
401488111,Navy Midshipmen,K. Samson,5109237,,True,25.0,5,8,5,8,0,0,5,9,2,8,10,1,0,1,1,1,15
401488111,Navy Midshipmen,M. Louridas,5109236,,True,27.0,3,10,2,4,1,6,4,5,1,2,3,3,1,0,1,5,11
401488111,Navy Midshipmen,M. Schrader,4595622,,True,23.0,1,4,1,3,0,1,0,0,0,0,0,5,0,0,1,1,2
401488111,Navy Midshipmen,M. Demos,5109235,,False,3.0,0,0,0,0,0,0,0,0,0,0,0,1,1,0,0,1,0
401488111,Navy Midshipmen,B. Coleman,5109233,,False,9.0,0,0,0,0,0,0,2,2,0,1,1,0,0,1,0,3,2
401488111,Navy Midshipmen,S. Watts,4704782,,False,19.0,3,9,2,3,1,6,0,0,0,1,1,1,1,0,0,2,7
401488111,Navy Midshipmen,S. Schofield,4704779,,False,25.0,5,9,1,2,4,7,0,0,0,3,3,2,0,0,2,1,14
401488111,Navy Midshipmen,TEAM,TOTAL,TOTAL,False,,22,62,15,37,7,25,13,20,9,26,35,16,7,2,8,17,64
401488111,Lafayette Leopards,A. Matthews,4703689,,True,25.0,1,3,1,3,0,0,0,0,2,4,6,0,0,0,1,4,2
401488111,Lafayette Leopards,S. Ntaconayigize,5109216,,True,34.0,5,8,0,0,5,8,0,0,2,5,7,2,0,0,0,2,15
401488111,Lafayette Leopards,K. Donahue,5109215,,True,37.0,3,13,1,5,2,8,3,6,1,4,5,2,2,2,2,3,11
401488111,Lafayette Leopards,A. Antognoli,4900540,,True,40.0,5,9,4,6,1,3,6,6,0,4,4,6,2,1,3,1,17
401488111,Lafayette Leopards,M. Andrews,4704756,,True,40.0,9,19,9,19,0,0,9,11,4,13,17,1,0,1,3,3,27
401488111,Lafayette Leopards,K. Favours,4900541,,False,24.0,1,7,1,2,0,5,0,0,1,1,2,1,0,0,3,4,2
401488111,Lafayette Leopards,TEAM,TOTAL,TOTAL,False,,24,59,16,35,8,24,18,23,13,32,45,12,4,4,12,17,74
401488111,Lafayette Leopards,A. Matthews,4703689,,True,25.0,1,3,1,3,0,0,0,0,2,4,6,0,0,0,1,4,2
401488111,Lafayette Leopards,S. Ntaconayigize,5109216,,True,34.0,5,8,0,0,5,8,0,0,2,5,7,2,0,0,0,2,15
401488111,Lafayette Leopards,K. Donahue,5109215,,True,37.0,3,13,1,5,2,8,3,6,1,4,5,2,2,2,2,3,11
401488111,Lafayette Leopards,A. Antognoli,4900540,,True,40.0,5,9,4,6,1,3,6,6,0,4,4,6,2,1,3,1,17
401488111,Lafayette Leopards,M. Andrews,4704756,,True,40.0,9,19,9,19,0,0,9,11,4,13,17,1,0,1,3,3,27
401488111,Lafayette Leopards,K. Favours,4900541,,False,24.0,1,7,1,2,0,5,0,0,1,1,2,1,0,0,3,4,2
401488111,Lafayette Leopards,TEAM,TOTAL,TOTAL,False,,24,59,16,35,8,24,18,23,13,32,45,12,4,4,12,17,74
401488110,Navy Midshipmen,M. Andrews,4704780,,True,39.0,3,5,3,5,0,0,0,1,6,13,19,2,0,1,2,2,6
401488110,Navy Midshipmen,L. Llewellyn,4595625,,True,39.0,6,20,3,8,3,12,0,0,2,2,4,2,1,0,4,2,15
401488110,Navy Midshipmen,K. Samson,5109237,,True,12.0,0,2,0,2,0,0,0,0,2,0,2,1,0,0,0,4,0
401488110,Navy Midshipmen,M. Louridas,5109236,,True,37.0,4,18,3,10,1,8,2,2,0,5,5,1,0,1,1,0,11
401488110,Navy Midshipmen,M. Schrader,4595622,,True,22.0,1,4,0,2,1,2,0,0,0,1,1,2,0,0,1,0,3
401488110,Navy Midshipmen,M. Demos,5109235,,False,1.0,0,0,0,0,0,0,0,0,0,0,0,0,0,0,0,1,0
401488110,Navy Midshipmen,K. Giuliani,5109230,,False,3.0,0,0,0,0,0,0,0,0,0,0,0,0,0,1,0,0,0
401488110,Navy Midshipmen,S. Watts,4704782,,False,25.0,3,10,3,5,0,5,0,0,0,2,2,1,0,0,2,4,6
401488110,Navy Midshipmen,S. Schofield,4704779,,False,22.0,3,8,1,2,2,6,0,0,0,1,1,0,0,0,1,4,8
401488110,Navy Midshipmen,TEAM,TOTAL,TOTAL,False,,20,67,13,34,7,33,2,3,13,27,40,9,1,3,13,17,49
401488110,Navy Midshipmen,M. Andrews,4704780,,True,39.0,3,5,3,5,0,0,0,1,6,13,19,2,0,1,2,2,6
401488110,Navy Midshipmen,L. Llewellyn,4595625,,True,39.0,6,20,3,8,3,12,0,0,2,2,4,2,1,0,4,2,15
401488110,Navy Midshipmen,K. Samson,5109237,,True,12.0,0,2,0,2,0,0,0,0,2,0,2,1,0,0,0,4,0
401488110,Navy Midshipmen,M. Louridas,5109236,,True,37.0,4,18,3,10,1,8,2,2,0,5,5,1,0,1,1,0,11
401488110,Navy Midshipmen,M. Schrader,4595622,,True,22.0,1,4,0,2,1,2,0,0,0,1,1,2,0,0,1,0,3
401488110,Navy Midshipmen,M. Demos,5109235,,False,1.0,0,0,0,0,0,0,0,0,0,0,0,0,0,0,0,1,0
401488110,Navy Midshipmen,K. Giuliani,5109230,,False,3.0,0,0,0,0,0,0,0,0,0,0,0,0,0,1,0,0,0
401488110,Navy Midshipmen,S. Watts,4704782,,False,25.0,3,10,3,5,0,5,0,0,0,2,2,1,0,0,2,4,6
401488110,Navy Midshipmen,S. Schofield,4704779,,False,22.0,3,8,1,2,2,6,0,0,0,1,1,0,0,0,1,4,8
401488110,Navy Midshipmen,TEAM,TOTAL,TOTAL,False,,20,67,13,34,7,33,2,3,13,27,40,9,1,3,13,17,49
401488110,American University Eagles,E. Johns,4704688,,True,22.0,3,7,3,6,0,1,2,2,0,1,1,0,0,0,1,1,8
401488110,American University Eagles,L. Stack,4595455,,True,36.0,7,11,7,11,0,0,1,3,0,7,7,1,0,0,2,1,15
401488110,American University Eagles,K. Henning,4704686,,True,16.0,1,5,1,5,0,0,0,0,0,1,1,3,2,0,0,0,2
401488110,American University Eagles,I. Bales,4704685,,True,31.0,3,7,3,7,0,0,2,2,0,7,7,6,1,2,2,1,8
401488110,American University Eagles,S. Stetson,4595453,,True,26.0,4,8,2,4,2,4,0,0,1,3,4,1,2,1,1,0,10
401488110,American University Eagles,M. Lavin,5109188,,False,15.0,0,4,0,4,0,0,0,0,2,5,7,1,0,0,1,3,0
401488110,American University Eagles,M. Lee,4704592,,False,3.0,1,1,1,1,0,0,0,0,0,1,1,0,0,0,0,1,2
401488110,American University Eagles,L. Nogues,5109187,,False,13.0,3,6,3,6,0,0,1,2,0,2,2,0,0,0,0,0,7
401488110,American University Eagles,A. Rescifina,5109186,,False,8.0,0,1,0,1,0,0,0,0,0,0,0,1,0,0,1,1,0
401488110,American University Eagles,B. Garbee,4899710,,False,8.0,0,0,0,0,0,0,0,0,0,0,0,1,0,0,2,1,0
401488110,American University Eagles,A. LeMaster,4703737,,False,22.0,3,8,1,2,2,6,1,2,2,5,7,0,0,0,0,2,9
401488110,American University Eagles,TEAM,TOTAL,TOTAL,False,,25,58,21,47,4,11,7,11,8,35,43,14,5,3,10,11,61
401488110,American University Eagles,E. Johns,4704688,,True,22.0,3,7,3,6,0,1,2,2,0,1,1,0,0,0,1,1,8
401488110,American University Eagles,L. Stack,4595455,,True,36.0,7,11,7,11,0,0,1,3,0,7,7,1,0,0,2,1,15
401488110,American University Eagles,K. Henning,4704686,,True,16.0,1,5,1,5,0,0,0,0,0,1,1,3,2,0,0,0,2
401488110,American University Eagles,I. Bales,4704685,,True,31.0,3,7,3,7,0,0,2,2,0,7,7,6,1,2,2,1,8
401488110,American University Eagles,S. Stetson,4595453,,True,26.0,4,8,2,4,2,4,0,0,1,3,4,1,2,1,1,0,10
401488110,American University Eagles,M. Lavin,5109188,,False,15.0,0,4,0,4,0,0,0,0,2,5,7,1,0,0,1,3,0
401488110,American University Eagles,M. Lee,4704592,,False,3.0,1,1,1,1,0,0,0,0,0,1,1,0,0,0,0,1,2
401488110,American University Eagles,L. Nogues,5109187,,False,13.0,3,6,3,6,0,0,1,2,0,2,2,0,0,0,0,0,7
401488110,American University Eagles,A. Rescifina,5109186,,False,8.0,0,1,0,1,0,0,0,0,0,0,0,1,0,0,1,1,0
401488110,American University Eagles,B. Garbee,4899710,,False,8.0,0,0,0,0,0,0,0,0,0,0,0,1,0,0,2,1,0
401488110,American University Eagles,A. LeMaster,4703737,,False,22.0,3,8,1,2,2,6,1,2,2,5,7,0,0,0,0,2,9
401488110,American University Eagles,TEAM,TOTAL,TOTAL,False,,25,58,21,47,4,11,7,11,8,35,43,14,5,3,10,11,61
401488109,Navy Midshipmen,M. Andrews,4704780,,True,29.0,3,6,3,6,0,0,1,2,2,8,10,2,2,0,2,4,7
401488109,Navy Midshipmen,L. Llewellyn,4595625,,True,37.0,6,22,4,15,2,7,1,2,1,3,4,1,0,0,4,0,15
401488109,Navy Midshipmen,S. Watts,4704782,,True,15.0,2,4,2,3,0,1,0,0,0,2,2,0,0,0,4,3,4
401488109,Navy Midshipmen,M. Louridas,5109236,,True,33.0,2,11,2,6,0,5,0,0,1,1,2,1,1,0,2,1,4
401488109,Navy Midshipmen,M. Schrader,4595622,,True,28.0,0,3,0,3,0,0,0,0,2,4,6,2,1,0,2,2,0
401488109,Navy Midshipmen,M. Demos,5109235,,False,8.0,0,0,0,0,0,0,0,0,2,0,2,0,1,0,2,2,0
401488109,Navy Midshipmen,K. Samson,5109237,,False,14.0,1,6,1,6,0,0,0,0,3,3,6,1,0,0,2,2,2
401488109,Navy Midshipmen,B. Coleman,5109233,,False,18.0,0,1,0,1,0,0,0,0,0,2,2,1,1,0,3,1,0
401488109,Navy Midshipmen,K. Giuliani,5109230,,False,3.0,0,0,0,0,0,0,0,0,0,0,0,0,0,0,0,0,0
401488109,Navy Midshipmen,S. Schofield,4704779,,False,15.0,2,6,0,0,2,6,0,2,0,2,2,0,1,0,1,1,6
401488109,Navy Midshipmen,TEAM,TOTAL,TOTAL,False,,16,59,12,40,4,19,2,6,13,26,39,8,7,0,23,16,38
401488109,Navy Midshipmen,M. Andrews,4704780,,True,29.0,3,6,3,6,0,0,1,2,2,8,10,2,2,0,2,4,7
401488109,Navy Midshipmen,L. Llewellyn,4595625,,True,37.0,6,22,4,15,2,7,1,2,1,3,4,1,0,0,4,0,15
401488109,Navy Midshipmen,S. Watts,4704782,,True,15.0,2,4,2,3,0,1,0,0,0,2,2,0,0,0,4,3,4
401488109,Navy Midshipmen,M. Louridas,5109236,,True,33.0,2,11,2,6,0,5,0,0,1,1,2,1,1,0,2,1,4
401488109,Navy Midshipmen,M. Schrader,4595622,,True,28.0,0,3,0,3,0,0,0,0,2,4,6,2,1,0,2,2,0
401488109,Navy Midshipmen,M. Demos,5109235,,False,8.0,0,0,0,0,0,0,0,0,2,0,2,0,1,0,2,2,0
401488109,Navy Midshipmen,K. Samson,5109237,,False,14.0,1,6,1,6,0,0,0,0,3,3,6,1,0,0,2,2,2
401488109,Navy Midshipmen,B. Coleman,5109233,,False,18.0,0,1,0,1,0,0,0,0,0,2,2,1,1,0,3,1,0
401488109,Navy Midshipmen,K. Giuliani,5109230,,False,3.0,0,0,0,0,0,0,0,0,0,0,0,0,0,0,0,0,0
401488109,Navy Midshipmen,S. Schofield,4704779,,False,15.0,2,6,0,0,2,6,0,2,0,2,2,0,1,0,1,1,6
401488109,Navy Midshipmen,TEAM,TOTAL,TOTAL,False,,16,59,12,40,4,19,2,6,13,26,39,8,7,0,23,16,38
401488109,Lehigh Mountain Hawks,L. Fandre,5109220,,True,18.0,4,6,3,5,1,1,2,2,1,6,7,2,2,0,1,2,11
401488109,Lehigh Mountain Hawks,F. Hottinger,4595613,,True,29.0,4,15,3,13,1,2,6,7,3,12,15,1,0,0,3,1,15
401488109,Lehigh Mountain Hawks,K. Van Eps,4900545,,True,13.0,1,3,1,2,0,1,4,4,0,1,1,0,1,0,2,0,6
401488109,Lehigh Mountain Hawks,E. Stemmer,4900544,,True,28.0,2,6,1,2,1,4,1,2,1,3,4,3,3,0,1,2,6
401488109,Lehigh Mountain Hawks,A. Harvey,4595612,,True,35.0,0,2,0,2,0,0,0,0,1,1,2,9,2,0,1,0,0
401488109,Lehigh Mountain Hawks,M. O'Brien,4900547,,False,9.0,0,0,0,0,0,0,0,0,0,1,1,0,0,3,1,0,0
401488109,Lehigh Mountain Hawks,J. Vargas-Bines,4900546,,False,4.0,0,0,0,0,0,0,0,0,0,0,0,1,0,0,0,0,0
401488109,Lehigh Mountain Hawks,M. Brown,4433751,,False,3.0,0,0,0,0,0,0,0,0,0,1,1,0,1,0,0,0,0
401488109,Lehigh Mountain Hawks,K. Hurt,5109219,,False,3.0,1,1,1,1,0,0,0,0,0,0,0,0,0,0,0,0,2
401488109,Lehigh Mountain Hawks,K. St.Paul,5109218,,False,2.0,0,0,0,0,0,0,0,0,0,0,0,0,0,0,0,0,0
401488109,Lehigh Mountain Hawks,M. Albrecht,4704763,,False,14.0,1,1,0,0,1,1,0,0,0,2,2,1,1,0,3,1,3
401488109,Lehigh Mountain Hawks,M. Kramer,4704762,,False,30.0,7,15,5,10,2,5,2,2,0,0,0,1,1,0,1,1,18
401488109,Lehigh Mountain Hawks,J. Behar,4433782,,False,12.0,4,7,1,2,3,5,0,0,0,3,3,1,1,0,2,2,11
401488109,Lehigh Mountain Hawks,TEAM,TOTAL,TOTAL,False,,24,56,15,37,9,19,15,17,7,33,40,19,12,3,15,9,72
401488109,Lehigh Mountain Hawks,L. Fandre,5109220,,True,18.0,4,6,3,5,1,1,2,2,1,6,7,2,2,0,1,2,11
401488109,Lehigh Mountain Hawks,F. Hottinger,4595613,,True,29.0,4,15,3,13,1,2,6,7,3,12,15,1,0,0,3,1,15
401488109,Lehigh Mountain Hawks,K. Van Eps,4900545,,True,13.0,1,3,1,2,0,1,4,4,0,1,1,0,1,0,2,0,6
401488109,Lehigh Mountain Hawks,E. Stemmer,4900544,,True,28.0,2,6,1,2,1,4,1,2,1,3,4,3,3,0,1,2,6
401488109,Lehigh Mountain Hawks,A. Harvey,4595612,,True,35.0,0,2,0,2,0,0,0,0,1,1,2,9,2,0,1,0,0
401488109,Lehigh Mountain Hawks,M. O'Brien,4900547,,False,9.0,0,0,0,0,0,0,0,0,0,1,1,0,0,3,1,0,0
401488109,Lehigh Mountain Hawks,J. Vargas-Bines,4900546,,False,4.0,0,0,0,0,0,0,0,0,0,0,0,1,0,0,0,0,0
401488109,Lehigh Mountain Hawks,M. Brown,4433751,,False,3.0,0,0,0,0,0,0,0,0,0,1,1,0,1,0,0,0,0
401488109,Lehigh Mountain Hawks,K. Hurt,5109219,,False,3.0,1,1,1,1,0,0,0,0,0,0,0,0,0,0,0,0,2
401488109,Lehigh Mountain Hawks,K. St.Paul,5109218,,False,2.0,0,0,0,0,0,0,0,0,0,0,0,0,0,0,0,0,0
401488109,Lehigh Mountain Hawks,M. Albrecht,4704763,,False,14.0,1,1,0,0,1,1,0,0,0,2,2,1,1,0,3,1,3
401488109,Lehigh Mountain Hawks,M. Kramer,4704762,,False,30.0,7,15,5,10,2,5,2,2,0,0,0,1,1,0,1,1,18
401488109,Lehigh Mountain Hawks,J. Behar,4433782,,False,12.0,4,7,1,2,3,5,0,0,0,3,3,1,1,0,2,2,11
401488109,Lehigh Mountain Hawks,TEAM,TOTAL,TOTAL,False,,24,56,15,37,9,19,15,17,7,33,40,19,12,3,15,9,72
401488108,Navy Midshipmen,M. Andrews,4704780,,True,28.0,4,10,4,10,0,0,0,1,1,4,5,0,0,0,1,2,8
401488108,Navy Midshipmen,L. Llewellyn,4595625,,True,32.0,3,13,2,12,1,1,2,2,0,4,4,1,1,0,2,5,9
401488108,Navy Midshipmen,K. Samson,5109237,,True,10.0,0,2,0,2,0,0,0,0,2,1,3,0,1,0,1,1,0
401488108,Navy Midshipmen,M. Louridas,5109236,,True,29.0,4,11,3,7,1,4,0,0,0,2,2,1,1,1,2,2,9
401488108,Navy Midshipmen,M. Schrader,4595622,,True,26.0,0,5,0,4,0,1,0,0,0,1,1,3,1,0,1,2,0
401488108,Navy Midshipmen,M. Demos,5109235,,False,9.0,0,1,0,1,0,0,0,0,1,3,4,1,0,1,0,3,0
401488108,Navy Midshipmen,G. Pissott,5109232,,False,10.0,1,3,1,3,0,0,3,3,2,1,3,0,0,0,1,3,5
401488108,Navy Midshipmen,B. Coleman,5109233,,False,18.0,0,3,0,2,0,1,0,0,0,1,1,2,0,0,2,1,0
401488108,Navy Midshipmen,K. Giuliani,5109230,,False,1.0,0,0,0,0,0,0,0,0,1,0,1,0,0,0,0,0,0
401488108,Navy Midshipmen,S. Watts,4704782,,False,28.0,6,15,4,9,2,6,1,2,2,7,9,0,1,0,0,0,15
401488108,Navy Midshipmen,S. Schofield,4704779,,False,9.0,1,1,0,0,1,1,0,0,0,0,0,0,0,0,1,0,3
401488108,Navy Midshipmen,TEAM,TOTAL,TOTAL,False,,19,64,14,50,5,14,6,8,10,25,35,8,5,2,11,19,49
401488108,Navy Midshipmen,M. Andrews,4704780,,True,28.0,4,10,4,10,0,0,0,1,1,4,5,0,0,0,1,2,8
401488108,Navy Midshipmen,L. Llewellyn,4595625,,True,32.0,3,13,2,12,1,1,2,2,0,4,4,1,1,0,2,5,9
401488108,Navy Midshipmen,K. Samson,5109237,,True,10.0,0,2,0,2,0,0,0,0,2,1,3,0,1,0,1,1,0
401488108,Navy Midshipmen,M. Louridas,5109236,,True,29.0,4,11,3,7,1,4,0,0,0,2,2,1,1,1,2,2,9
401488108,Navy Midshipmen,M. Schrader,4595622,,True,26.0,0,5,0,4,0,1,0,0,0,1,1,3,1,0,1,2,0
401488108,Navy Midshipmen,M. Demos,5109235,,False,9.0,0,1,0,1,0,0,0,0,1,3,4,1,0,1,0,3,0
401488108,Navy Midshipmen,G. Pissott,5109232,,False,10.0,1,3,1,3,0,0,3,3,2,1,3,0,0,0,1,3,5
401488108,Navy Midshipmen,B. Coleman,5109233,,False,18.0,0,3,0,2,0,1,0,0,0,1,1,2,0,0,2,1,0
401488108,Navy Midshipmen,K. Giuliani,5109230,,False,1.0,0,0,0,0,0,0,0,0,1,0,1,0,0,0,0,0,0
401488108,Navy Midshipmen,S. Watts,4704782,,False,28.0,6,15,4,9,2,6,1,2,2,7,9,0,1,0,0,0,15
401488108,Navy Midshipmen,S. Schofield,4704779,,False,9.0,1,1,0,0,1,1,0,0,0,0,0,0,0,0,1,0,3
401488108,Navy Midshipmen,TEAM,TOTAL,TOTAL,False,,19,64,14,50,5,14,6,8,10,25,35,8,5,2,11,19,49
401488108,Bucknell Bison,I. King,4900533,,True,29.0,3,7,3,3,0,4,1,1,0,4,4,1,2,0,0,2,7
401488108,Bucknell Bison,E. Shaffer,4595535,,True,25.0,6,7,6,7,0,0,1,2,2,2,4,7,2,0,3,3,13
401488108,Bucknell Bison,E. Theodorsson,5109199,,True,28.0,3,11,2,6,1,5,2,2,0,6,6,0,0,1,1,2,9
401488108,Bucknell Bison,C. Collins,4900532,,True,31.0,8,11,7,9,1,2,3,3,0,3,3,5,1,0,1,2,20
401488108,Bucknell Bison,T. Johnson,4595533,,True,32.0,4,8,4,7,0,1,4,6,0,4,4,1,0,0,1,1,12
401488108,Bucknell Bison,G. Sullivan,5109201,,False,14.0,1,2,1,2,0,0,4,4,2,5,7,1,2,1,2,0,6
401488108,Bucknell Bison,N. Davis,4704701,,False,1.0,0,0,0,0,0,0,1,2,0,0,0,1,0,0,0,0,1
401488108,Bucknell Bison,K. Reinbeau,4704700,,False,1.0,1,1,1,1,0,0,0,0,0,0,0,0,0,0,0,0,2
401488108,Bucknell Bison,R. Sisselman,4900531,,False,15.0,0,3,0,2,0,1,0,0,0,2,2,0,0,0,2,1,0
401488108,Bucknell Bison,J. Kulesza,4704702,,False,9.0,0,1,0,0,0,1,0,0,0,2,2,0,0,0,1,0,0
401488108,Bucknell Bison,C. Dingler,4577540,,False,15.0,0,0,0,0,0,0,0,0,0,2,2,1,0,0,0,1,0
401488108,Bucknell Bison,TEAM,TOTAL,TOTAL,False,,26,51,24,37,2,14,16,20,4,32,36,17,7,2,11,12,70
401488108,Bucknell Bison,I. King,4900533,,True,29.0,3,7,3,3,0,4,1,1,0,4,4,1,2,0,0,2,7
401488108,Bucknell Bison,E. Shaffer,4595535,,True,25.0,6,7,6,7,0,0,1,2,2,2,4,7,2,0,3,3,13
401488108,Bucknell Bison,E. Theodorsson,5109199,,True,28.0,3,11,2,6,1,5,2,2,0,6,6,0,0,1,1,2,9
401488108,Bucknell Bison,C. Collins,4900532,,True,31.0,8,11,7,9,1,2,3,3,0,3,3,5,1,0,1,2,20
401488108,Bucknell Bison,T. Johnson,4595533,,True,32.0,4,8,4,7,0,1,4,6,0,4,4,1,0,0,1,1,12
401488108,Bucknell Bison,G. Sullivan,5109201,,False,14.0,1,2,1,2,0,0,4,4,2,5,7,1,2,1,2,0,6
401488108,Bucknell Bison,N. Davis,4704701,,False,1.0,0,0,0,0,0,0,1,2,0,0,0,1,0,0,0,0,1
401488108,Bucknell Bison,K. Reinbeau,4704700,,False,1.0,1,1,1,1,0,0,0,0,0,0,0,0,0,0,0,0,2
401488108,Bucknell Bison,R. Sisselman,4900531,,False,15.0,0,3,0,2,0,1,0,0,0,2,2,0,0,0,2,1,0
401488108,Bucknell Bison,J. Kulesza,4704702,,False,9.0,0,1,0,0,0,1,0,0,0,2,2,0,0,0,1,0,0
401488108,Bucknell Bison,C. Dingler,4577540,,False,15.0,0,0,0,0,0,0,0,0,0,2,2,1,0,0,0,1,0
401488108,Bucknell Bison,TEAM,TOTAL,TOTAL,False,,26,51,24,37,2,14,16,20,4,32,36,17,7,2,11,12,70
401488107,Navy Midshipmen,M. Andrews,4704780,,True,31.0,5,10,5,10,0,0,0,0,7,6,13,2,2,0,0,3,10
401488107,Navy Midshipmen,L. Llewellyn,4595625,,True,28.0,4,10,3,7,1,3,0,0,1,5,6,0,3,1,2,0,9
401488107,Navy Midshipmen,K. Samson,5109237,,True,7.0,2,4,2,4,0,0,0,0,1,0,1,0,0,0,0,3,4
401488107,Navy Midshipmen,M. Louridas,5109236,,True,33.0,4,17,3,13,1,4,1,1,3,6,9,6,0,1,4,5,10
401488107,Navy Midshipmen,M. Schrader,4595622,,True,19.0,1,6,1,5,0,1,0,0,1,1,2,0,1,0,5,4,2
401488107,Navy Midshipmen,M. Demos,5109235,,False,4.0,0,0,0,0,0,0,0,2,1,1,2,0,0,0,0,0,0
401488107,Navy Midshipmen,G. Pissott,5109232,,False,19.0,1,3,1,3,0,0,0,2,2,0,2,1,1,0,3,2,2
401488107,Navy Midshipmen,B. Coleman,5109233,,False,24.0,2,4,1,2,1,2,0,0,0,2,2,0,0,0,2,3,5
401488107,Navy Midshipmen,S. Watts,4704782,,False,32.0,5,11,5,10,0,1,0,0,1,3,4,1,1,0,2,2,10
401488107,Navy Midshipmen,S. Schofield,4704779,,False,3.0,0,0,0,0,0,0,0,0,0,1,1,1,0,0,0,0,0
401488107,Navy Midshipmen,TEAM,TOTAL,TOTAL,False,,24,65,21,54,3,11,1,5,17,27,44,11,8,2,19,22,52
401488107,Navy Midshipmen,M. Andrews,4704780,,True,31.0,5,10,5,10,0,0,0,0,7,6,13,2,2,0,0,3,10
401488107,Navy Midshipmen,L. Llewellyn,4595625,,True,28.0,4,10,3,7,1,3,0,0,1,5,6,0,3,1,2,0,9
401488107,Navy Midshipmen,K. Samson,5109237,,True,7.0,2,4,2,4,0,0,0,0,1,0,1,0,0,0,0,3,4
401488107,Navy Midshipmen,M. Louridas,5109236,,True,33.0,4,17,3,13,1,4,1,1,3,6,9,6,0,1,4,5,10
401488107,Navy Midshipmen,M. Schrader,4595622,,True,19.0,1,6,1,5,0,1,0,0,1,1,2,0,1,0,5,4,2
401488107,Navy Midshipmen,M. Demos,5109235,,False,4.0,0,0,0,0,0,0,0,2,1,1,2,0,0,0,0,0,0
401488107,Navy Midshipmen,G. Pissott,5109232,,False,19.0,1,3,1,3,0,0,0,2,2,0,2,1,1,0,3,2,2
401488107,Navy Midshipmen,B. Coleman,5109233,,False,24.0,2,4,1,2,1,2,0,0,0,2,2,0,0,0,2,3,5
401488107,Navy Midshipmen,S. Watts,4704782,,False,32.0,5,11,5,10,0,1,0,0,1,3,4,1,1,0,2,2,10
401488107,Navy Midshipmen,S. Schofield,4704779,,False,3.0,0,0,0,0,0,0,0,0,0,1,1,1,0,0,0,0,0
401488107,Navy Midshipmen,TEAM,TOTAL,TOTAL,False,,24,65,21,54,3,11,1,5,17,27,44,11,8,2,19,22,52
401488107,Holy Cross Crusaders,L. Berger,4900539,,True,17.0,3,8,3,8,0,0,3,3,2,3,5,0,0,0,0,1,9
401488107,Holy Cross Crusaders,K. Flanagan,5109211,,True,26.0,0,3,0,2,0,1,2,2,0,3,3,1,0,0,3,2,2
401488107,Holy Cross Crusaders,C. McCormack,4704716,,True,25.0,2,7,2,3,0,4,0,0,0,5,5,2,1,0,2,0,4
401488107,Holy Cross Crusaders,B. Power-Cassidy,4704715,,True,29.0,7,14,5,8,2,6,4,4,0,3,3,2,1,0,0,1,20
401488107,Holy Cross Crusaders,A. Cross,4595975,,True,21.0,2,4,1,1,1,3,2,2,0,1,1,1,2,0,0,3,7
401488107,Holy Cross Crusaders,M. Cahalan,5109210,,False,2.0,0,0,0,0,0,0,0,0,0,0,0,0,0,0,0,0,0
401488107,Holy Cross Crusaders,J. Allen,4704714,,False,18.0,2,5,2,5,0,0,3,4,0,3,3,3,0,0,0,1,7
401488107,Holy Cross Crusaders,C. Wright,4703660,,False,9.0,0,0,0,0,0,0,0,0,0,2,2,0,0,0,1,0,0
401488107,Holy Cross Crusaders,M. Donnelly,5109213,,False,16.0,1,2,1,1,0,1,0,0,0,1,1,1,1,0,0,0,2
401488107,Holy Cross Crusaders,S. Foreman,5109212,,False,19.0,4,8,4,8,0,0,8,10,3,4,7,1,1,1,3,1,16
401488107,Holy Cross Crusaders,L. Huber,4900538,,False,3.0,0,0,0,0,0,0,0,0,0,0,0,0,0,0,0,0,0
401488107,Holy Cross Crusaders,G. Munt,4900537,,False,15.0,2,4,2,3,0,1,0,0,0,0,0,0,0,1,3,1,4
401488107,Holy Cross Crusaders,TEAM,TOTAL,TOTAL,False,,23,55,20,39,3,16,22,25,7,26,33,11,6,2,12,10,71
401488107,Holy Cross Crusaders,L. Berger,4900539,,True,17.0,3,8,3,8,0,0,3,3,2,3,5,0,0,0,0,1,9
401488107,Holy Cross Crusaders,K. Flanagan,5109211,,True,26.0,0,3,0,2,0,1,2,2,0,3,3,1,0,0,3,2,2
401488107,Holy Cross Crusaders,C. McCormack,4704716,,True,25.0,2,7,2,3,0,4,0,0,0,5,5,2,1,0,2,0,4
401488107,Holy Cross Crusaders,B. Power-Cassidy,4704715,,True,29.0,7,14,5,8,2,6,4,4,0,3,3,2,1,0,0,1,20
401488107,Holy Cross Crusaders,A. Cross,4595975,,True,21.0,2,4,1,1,1,3,2,2,0,1,1,1,2,0,0,3,7
401488107,Holy Cross Crusaders,M. Cahalan,5109210,,False,2.0,0,0,0,0,0,0,0,0,0,0,0,0,0,0,0,0,0
401488107,Holy Cross Crusaders,J. Allen,4704714,,False,18.0,2,5,2,5,0,0,3,4,0,3,3,3,0,0,0,1,7
401488107,Holy Cross Crusaders,C. Wright,4703660,,False,9.0,0,0,0,0,0,0,0,0,0,2,2,0,0,0,1,0,0
401488107,Holy Cross Crusaders,M. Donnelly,5109213,,False,16.0,1,2,1,1,0,1,0,0,0,1,1,1,1,0,0,0,2
401488107,Holy Cross Crusaders,S. Foreman,5109212,,False,19.0,4,8,4,8,0,0,8,10,3,4,7,1,1,1,3,1,16
401488107,Holy Cross Crusaders,L. Huber,4900538,,False,3.0,0,0,0,0,0,0,0,0,0,0,0,0,0,0,0,0,0
401488107,Holy Cross Crusaders,G. Munt,4900537,,False,15.0,2,4,2,3,0,1,0,0,0,0,0,0,0,1,3,1,4
401488107,Holy Cross Crusaders,TEAM,TOTAL,TOTAL,False,,23,55,20,39,3,16,22,25,7,26,33,11,6,2,12,10,71
401488106,Navy Midshipmen,M. Andrews,4704780,,True,39.0,4,8,4,8,0,0,0,2,5,12,17,2,4,1,1,3,8
401488106,Navy Midshipmen,K. Samson,5109237,,True,25.0,5,6,5,6,0,0,0,0,3,2,5,2,0,1,3,3,10
401488106,Navy Midshipmen,S. Watts,4704782,,True,20.0,3,6,2,3,1,3,0,0,0,1,1,3,0,0,3,2,7
401488106,Navy Midshipmen,M. Louridas,5109236,,True,38.0,4,16,1,6,3,10,1,2,0,4,4,2,1,1,4,3,12
401488106,Navy Midshipmen,M. Schrader,4595622,,True,34.0,1,8,1,5,0,3,0,0,0,2,2,2,1,0,5,2,2
401488106,Navy Midshipmen,G. Pissott,5109232,,False,13.0,1,2,1,2,0,0,0,0,2,1,3,2,0,0,1,3,2
401488106,Navy Midshipmen,L. Llewellyn,4595625,,False,29.0,6,16,4,11,2,5,0,0,1,4,5,1,1,1,2,3,14
401488106,Navy Midshipmen,B. Coleman,5109233,,False,2.0,0,0,0,0,0,0,0,0,0,0,0,0,0,0,1,0,0
401488106,Navy Midshipmen,K. Giuliani,5109230,,False,0.0,0,0,0,0,0,0,0,0,0,0,0,0,0,0,0,2,0
401488106,Navy Midshipmen,TEAM,TOTAL,TOTAL,False,,24,62,18,41,6,21,1,4,12,29,41,14,7,4,22,21,55
401488106,Navy Midshipmen,M. Andrews,4704780,,True,39.0,4,8,4,8,0,0,0,2,5,12,17,2,4,1,1,3,8
401488106,Navy Midshipmen,K. Samson,5109237,,True,25.0,5,6,5,6,0,0,0,0,3,2,5,2,0,1,3,3,10
401488106,Navy Midshipmen,S. Watts,4704782,,True,20.0,3,6,2,3,1,3,0,0,0,1,1,3,0,0,3,2,7
401488106,Navy Midshipmen,M. Louridas,5109236,,True,38.0,4,16,1,6,3,10,1,2,0,4,4,2,1,1,4,3,12
401488106,Navy Midshipmen,M. Schrader,4595622,,True,34.0,1,8,1,5,0,3,0,0,0,2,2,2,1,0,5,2,2
401488106,Navy Midshipmen,G. Pissott,5109232,,False,13.0,1,2,1,2,0,0,0,0,2,1,3,2,0,0,1,3,2
401488106,Navy Midshipmen,L. Llewellyn,4595625,,False,29.0,6,16,4,11,2,5,0,0,1,4,5,1,1,1,2,3,14
401488106,Navy Midshipmen,B. Coleman,5109233,,False,2.0,0,0,0,0,0,0,0,0,0,0,0,0,0,0,1,0,0
401488106,Navy Midshipmen,K. Giuliani,5109230,,False,0.0,0,0,0,0,0,0,0,0,0,0,0,0,0,0,0,2,0
401488106,Navy Midshipmen,TEAM,TOTAL,TOTAL,False,,24,62,18,41,6,21,1,4,12,29,41,14,7,4,22,21,55
401488106,American University Eagles,E. Johns,4704688,,True,25.0,6,9,5,7,1,2,3,4,2,2,4,0,0,0,1,2,16
401488106,American University Eagles,L. Stack,4595455,,True,34.0,0,2,0,2,0,0,2,4,0,4,4,2,1,0,2,3,2
401488106,American University Eagles,I. Bales,4704685,,True,34.0,2,10,2,8,0,2,0,2,0,6,6,2,3,1,1,1,4
401488106,American University Eagles,A. LeMaster,4703737,,True,20.0,2,8,0,3,2,5,2,3,1,2,3,1,2,0,0,3,8
401488106,American University Eagles,S. Stetson,4595453,,True,20.0,1,7,0,5,1,2,0,0,1,0,1,5,2,0,1,0,3
401488106,American University Eagles,M. Lavin,5109188,,False,20.0,3,5,2,2,1,3,2,2,2,3,5,0,0,0,3,1,9
401488106,American University Eagles,M. Lee,4704592,,False,1.0,0,1,0,1,0,0,1,2,0,0,0,0,0,1,0,0,1
401488106,American University Eagles,L. Nogues,5109187,,False,18.0,4,6,3,5,1,1,2,3,0,0,0,0,1,0,4,1,11
401488106,American University Eagles,A. Rescifina,5109186,,False,9.0,0,1,0,0,0,1,2,2,0,0,0,1,0,0,0,0,2
401488106,American University Eagles,B. Garbee,4899710,,False,17.0,2,4,2,4,0,0,2,2,0,2,2,1,1,0,1,1,6
401488106,American University Eagles,L. Graytok,4400159,,False,2.0,0,0,0,0,0,0,0,0,0,1,1,0,0,0,1,0,0
401488106,American University Eagles,TEAM,TOTAL,TOTAL,False,,20,53,14,37,6,16,16,24,7,24,31,12,10,2,14,12,62
401488106,American University Eagles,E. Johns,4704688,,True,25.0,6,9,5,7,1,2,3,4,2,2,4,0,0,0,1,2,16
401488106,American University Eagles,L. Stack,4595455,,True,34.0,0,2,0,2,0,0,2,4,0,4,4,2,1,0,2,3,2
401488106,American University Eagles,I. Bales,4704685,,True,34.0,2,10,2,8,0,2,0,2,0,6,6,2,3,1,1,1,4
401488106,American University Eagles,A. LeMaster,4703737,,True,20.0,2,8,0,3,2,5,2,3,1,2,3,1,2,0,0,3,8
401488106,American University Eagles,S. Stetson,4595453,,True,20.0,1,7,0,5,1,2,0,0,1,0,1,5,2,0,1,0,3
401488106,American University Eagles,M. Lavin,5109188,,False,20.0,3,5,2,2,1,3,2,2,2,3,5,0,0,0,3,1,9
401488106,American University Eagles,M. Lee,4704592,,False,1.0,0,1,0,1,0,0,1,2,0,0,0,0,0,1,0,0,1
401488106,American University Eagles,L. Nogues,5109187,,False,18.0,4,6,3,5,1,1,2,3,0,0,0,0,1,0,4,1,11
401488106,American University Eagles,A. Rescifina,5109186,,False,9.0,0,1,0,0,0,1,2,2,0,0,0,1,0,0,0,0,2
401488106,American University Eagles,B. Garbee,4899710,,False,17.0,2,4,2,4,0,0,2,2,0,2,2,1,1,0,1,1,6
401488106,American University Eagles,L. Graytok,4400159,,False,2.0,0,0,0,0,0,0,0,0,0,1,1,0,0,0,1,0,0
401488106,American University Eagles,TEAM,TOTAL,TOTAL,False,,20,53,14,37,6,16,16,24,7,24,31,12,10,2,14,12,62
401488105,Navy Midshipmen,M. Andrews,4704780,,True,32.0,3,5,3,5,0,0,0,0,2,5,7,0,0,1,4,2,6
401488105,Navy Midshipmen,K. Samson,5109237,,True,13.0,1,4,1,4,0,0,0,0,0,3,3,0,1,1,0,2,2
401488105,Navy Midshipmen,S. Watts,4704782,,True,35.0,3,15,3,12,0,3,2,2,3,4,7,0,0,1,0,4,8
401488105,Navy Midshipmen,M. Louridas,5109236,,True,35.0,4,14,3,8,1,6,2,2,0,7,7,0,0,0,2,4,11
401488105,Navy Midshipmen,M. Schrader,4595622,,True,31.0,1,6,1,3,0,3,0,0,0,5,5,5,2,1,3,1,2
401488105,Navy Midshipmen,M. Demos,5109235,,False,4.0,0,1,0,1,0,0,0,0,0,0,0,0,0,0,1,1,0
401488105,Navy Midshipmen,G. Pissott,5109232,,False,3.0,0,0,0,0,0,0,0,0,0,1,1,0,0,0,1,3,0
401488105,Navy Midshipmen,L. Llewellyn,4595625,,False,25.0,6,14,4,9,2,5,0,1,1,3,4,0,1,0,2,1,14
401488105,Navy Midshipmen,B. Coleman,5109233,,False,19.0,3,9,3,8,0,1,0,0,0,3,3,2,1,0,2,2,6
401488105,Navy Midshipmen,K. Giuliani,5109230,,False,2.0,0,0,0,0,0,0,0,0,0,0,0,0,0,0,1,1,0
401488105,Navy Midshipmen,TEAM,TOTAL,TOTAL,False,,21,68,18,50,3,18,4,5,9,34,43,7,5,4,16,21,49
401488105,Navy Midshipmen,M. Andrews,4704780,,True,32.0,3,5,3,5,0,0,0,0,2,5,7,0,0,1,4,2,6
401488105,Navy Midshipmen,K. Samson,5109237,,True,13.0,1,4,1,4,0,0,0,0,0,3,3,0,1,1,0,2,2
401488105,Navy Midshipmen,S. Watts,4704782,,True,35.0,3,15,3,12,0,3,2,2,3,4,7,0,0,1,0,4,8
401488105,Navy Midshipmen,M. Louridas,5109236,,True,35.0,4,14,3,8,1,6,2,2,0,7,7,0,0,0,2,4,11
401488105,Navy Midshipmen,M. Schrader,4595622,,True,31.0,1,6,1,3,0,3,0,0,0,5,5,5,2,1,3,1,2
401488105,Navy Midshipmen,M. Demos,5109235,,False,4.0,0,1,0,1,0,0,0,0,0,0,0,0,0,0,1,1,0
401488105,Navy Midshipmen,G. Pissott,5109232,,False,3.0,0,0,0,0,0,0,0,0,0,1,1,0,0,0,1,3,0
401488105,Navy Midshipmen,L. Llewellyn,4595625,,False,25.0,6,14,4,9,2,5,0,1,1,3,4,0,1,0,2,1,14
401488105,Navy Midshipmen,B. Coleman,5109233,,False,19.0,3,9,3,8,0,1,0,0,0,3,3,2,1,0,2,2,6
401488105,Navy Midshipmen,K. Giuliani,5109230,,False,2.0,0,0,0,0,0,0,0,0,0,0,0,0,0,0,1,1,0
401488105,Navy Midshipmen,TEAM,TOTAL,TOTAL,False,,21,68,18,50,3,18,4,5,9,34,43,7,5,4,16,21,49
401488105,Bucknell Bison,I. King,4900533,,True,26.0,2,9,1,3,1,6,0,0,0,3,3,2,1,0,1,1,5
401488105,Bucknell Bison,E. Shaffer,4595535,,True,24.0,5,8,5,8,0,0,4,5,2,7,9,0,0,1,0,2,14
401488105,Bucknell Bison,E. Theodorsson,5109199,,True,38.0,2,10,2,5,0,5,3,3,0,12,12,3,3,1,2,2,7
401488105,Bucknell Bison,T. Johnson,4595533,,True,37.0,4,10,4,9,0,1,4,5,0,4,4,4,0,0,5,2,12
401488105,Bucknell Bison,C. Dingler,4577540,,True,13.0,0,1,0,1,0,0,4,4,0,1,1,0,1,0,0,0,4
401488105,Bucknell Bison,G. Sullivan,5109201,,False,16.0,5,6,5,6,0,0,0,1,0,3,3,1,0,2,1,1,10
401488105,Bucknell Bison,R. Sisselman,4900531,,False,26.0,4,9,2,3,2,6,1,2,0,3,3,2,0,0,1,1,11
401488105,Bucknell Bison,J. Kulesza,4704702,,False,20.0,1,5,0,3,1,2,1,2,1,2,3,2,1,0,1,2,4
401488105,Bucknell Bison,TEAM,TOTAL,TOTAL,False,,23,58,19,38,4,20,17,22,4,39,43,14,6,4,11,11,67
401488105,Bucknell Bison,I. King,4900533,,True,26.0,2,9,1,3,1,6,0,0,0,3,3,2,1,0,1,1,5
401488105,Bucknell Bison,E. Shaffer,4595535,,True,24.0,5,8,5,8,0,0,4,5,2,7,9,0,0,1,0,2,14
401488105,Bucknell Bison,E. Theodorsson,5109199,,True,38.0,2,10,2,5,0,5,3,3,0,12,12,3,3,1,2,2,7
401488105,Bucknell Bison,T. Johnson,4595533,,True,37.0,4,10,4,9,0,1,4,5,0,4,4,4,0,0,5,2,12
401488105,Bucknell Bison,C. Dingler,4577540,,True,13.0,0,1,0,1,0,0,4,4,0,1,1,0,1,0,0,0,4
401488105,Bucknell Bison,G. Sullivan,5109201,,False,16.0,5,6,5,6,0,0,0,1,0,3,3,1,0,2,1,1,10
401488105,Bucknell Bison,R. Sisselman,4900531,,False,26.0,4,9,2,3,2,6,1,2,0,3,3,2,0,0,1,1,11
401488105,Bucknell Bison,J. Kulesza,4704702,,False,20.0,1,5,0,3,1,2,1,2,1,2,3,2,1,0,1,2,4
401488105,Bucknell Bison,TEAM,TOTAL,TOTAL,False,,23,58,19,38,4,20,17,22,4,39,43,14,6,4,11,11,67
401488104,Navy Midshipmen,M. Andrews,4704780,,True,25.0,2,5,2,5,0,0,0,0,1,4,5,0,0,0,1,2,4
401488104,Navy Midshipmen,K. Samson,5109237,,True,16.0,2,7,2,7,0,0,1,5,2,5,7,1,0,2,3,2,5
401488104,Navy Midshipmen,S. Watts,4704782,,True,40.0,5,18,4,12,1,6,2,4,1,6,7,1,0,1,5,3,13
401488104,Navy Midshipmen,M. Louridas,5109236,,True,32.0,4,14,3,6,1,8,0,0,1,4,5,3,3,0,3,3,9
401488104,Navy Midshipmen,M. Schrader,4595622,,True,33.0,7,10,3,4,4,6,0,0,1,7,8,0,0,0,3,3,18
401488104,Navy Midshipmen,G. Pissott,5109232,,False,20.0,0,1,0,1,0,0,0,0,0,2,2,1,0,0,1,3,0
401488104,Navy Midshipmen,L. Llewellyn,4595625,,False,28.0,2,6,1,3,1,3,3,4,2,3,5,1,0,0,3,4,8
401488104,Navy Midshipmen,K. Giuliani,5109230,,False,6.0,0,0,0,0,0,0,0,0,0,0,0,2,0,0,0,3,0
401488104,Navy Midshipmen,TEAM,TOTAL,TOTAL,False,,22,61,15,38,7,23,6,13,9,32,41,9,3,3,19,23,57
401488104,Navy Midshipmen,M. Andrews,4704780,,True,25.0,2,5,2,5,0,0,0,0,1,4,5,0,0,0,1,2,4
401488104,Navy Midshipmen,K. Samson,5109237,,True,16.0,2,7,2,7,0,0,1,5,2,5,7,1,0,2,3,2,5
401488104,Navy Midshipmen,S. Watts,4704782,,True,40.0,5,18,4,12,1,6,2,4,1,6,7,1,0,1,5,3,13
401488104,Navy Midshipmen,M. Louridas,5109236,,True,32.0,4,14,3,6,1,8,0,0,1,4,5,3,3,0,3,3,9
401488104,Navy Midshipmen,M. Schrader,4595622,,True,33.0,7,10,3,4,4,6,0,0,1,7,8,0,0,0,3,3,18
401488104,Navy Midshipmen,G. Pissott,5109232,,False,20.0,0,1,0,1,0,0,0,0,0,2,2,1,0,0,1,3,0
401488104,Navy Midshipmen,L. Llewellyn,4595625,,False,28.0,2,6,1,3,1,3,3,4,2,3,5,1,0,0,3,4,8
401488104,Navy Midshipmen,K. Giuliani,5109230,,False,6.0,0,0,0,0,0,0,0,0,0,0,0,2,0,0,0,3,0
401488104,Navy Midshipmen,TEAM,TOTAL,TOTAL,False,,22,61,15,38,7,23,6,13,9,32,41,9,3,3,19,23,57
401488104,Lafayette Leopards,K. Drummond,4704754,,True,28.0,4,11,4,11,0,0,0,2,7,7,14,0,1,1,0,3,8
401488104,Lafayette Leopards,A. Antognoli,4900540,,True,36.0,7,16,2,8,5,8,5,6,2,2,4,2,5,1,2,2,24
401488104,Lafayette Leopards,M. Andrews,4704756,,True,32.0,1,8,1,7,0,1,3,5,0,3,3,0,0,0,5,3,5
401488104,Lafayette Leopards,H. Smith,4704553,,True,26.0,0,1,0,1,0,0,0,0,0,8,8,2,2,0,2,2,0
401488104,Lafayette Leopards,J. Booth,4433381,,True,30.0,5,10,5,9,0,1,11,14,0,6,6,5,3,0,3,4,21
401488104,Lafayette Leopards,A. Matthews,4703689,,False,11.0,2,5,2,5,0,0,1,2,1,3,4,1,0,1,1,0,5
401488104,Lafayette Leopards,S. Ntaconayigize,5109216,,False,14.0,0,3,0,0,0,3,0,0,0,1,1,2,0,0,0,1,0
401488104,Lafayette Leopards,K. Donahue,5109215,,False,2.0,0,1,0,1,0,0,0,0,0,0,0,0,0,0,0,0,0
401488104,Lafayette Leopards,K. Favours,4900541,,False,21.0,3,9,3,5,0,4,0,0,2,0,2,0,3,0,1,2,6
401488104,Lafayette Leopards,TEAM,TOTAL,TOTAL,False,,22,64,17,47,5,17,20,29,16,33,49,12,14,3,15,17,69
401488104,Lafayette Leopards,K. Drummond,4704754,,True,28.0,4,11,4,11,0,0,0,2,7,7,14,0,1,1,0,3,8
401488104,Lafayette Leopards,A. Antognoli,4900540,,True,36.0,7,16,2,8,5,8,5,6,2,2,4,2,5,1,2,2,24
401488104,Lafayette Leopards,M. Andrews,4704756,,True,32.0,1,8,1,7,0,1,3,5,0,3,3,0,0,0,5,3,5
401488104,Lafayette Leopards,H. Smith,4704553,,True,26.0,0,1,0,1,0,0,0,0,0,8,8,2,2,0,2,2,0
401488104,Lafayette Leopards,J. Booth,4433381,,True,30.0,5,10,5,9,0,1,11,14,0,6,6,5,3,0,3,4,21
401488104,Lafayette Leopards,A. Matthews,4703689,,False,11.0,2,5,2,5,0,0,1,2,1,3,4,1,0,1,1,0,5
401488104,Lafayette Leopards,S. Ntaconayigize,5109216,,False,14.0,0,3,0,0,0,3,0,0,0,1,1,2,0,0,0,1,0
401488104,Lafayette Leopards,K. Donahue,5109215,,False,2.0,0,1,0,1,0,0,0,0,0,0,0,0,0,0,0,0,0
401488104,Lafayette Leopards,K. Favours,4900541,,False,21.0,3,9,3,5,0,4,0,0,2,0,2,0,3,0,1,2,6
401488104,Lafayette Leopards,TEAM,TOTAL,TOTAL,False,,22,64,17,47,5,17,20,29,16,33,49,12,14,3,15,17,69
401488103,Navy Midshipmen,M. Andrews,4704780,,True,25.0,1,2,1,2,0,0,0,0,1,6,7,1,0,0,3,4,2
401488103,Navy Midshipmen,K. Samson,5109237,,True,25.0,4,10,4,10,0,0,3,5,3,5,8,1,0,0,4,1,11
401488103,Navy Midshipmen,S. Watts,4704782,,True,28.0,3,19,2,9,1,10,0,0,0,0,0,3,1,0,2,1,7
401488103,Navy Midshipmen,M. Louridas,5109236,,True,37.0,6,16,3,6,3,10,0,0,2,5,7,1,0,0,1,1,15
401488103,Navy Midshipmen,M. Schrader,4595622,,True,34.0,2,7,2,6,0,1,0,0,2,2,4,3,1,0,2,2,4
401488103,Navy Midshipmen,M. Demos,5109235,,False,9.0,0,0,0,0,0,0,0,0,0,2,2,0,1,0,1,0,0
401488103,Navy Midshipmen,G. Pissott,5109232,,False,18.0,1,5,1,4,0,1,0,0,3,5,8,0,0,0,0,0,2
401488103,Navy Midshipmen,S. Lewis,4900553,,False,9.0,0,3,0,3,0,0,1,2,1,3,4,1,2,0,2,2,1
401488103,Navy Midshipmen,K. Giuliani,5109230,,False,6.0,0,0,0,0,0,0,0,0,0,0,0,0,0,0,0,0,0
401488103,Navy Midshipmen,S. Schofield,4704779,,False,9.0,0,4,0,2,0,2,0,0,1,0,1,0,0,0,0,0,0
401488103,Navy Midshipmen,TEAM,TOTAL,TOTAL,False,,17,66,13,42,4,24,4,7,16,28,44,10,5,0,17,11,42
401488103,Navy Midshipmen,M. Andrews,4704780,,True,25.0,1,2,1,2,0,0,0,0,1,6,7,1,0,0,3,4,2
401488103,Navy Midshipmen,K. Samson,5109237,,True,25.0,4,10,4,10,0,0,3,5,3,5,8,1,0,0,4,1,11
401488103,Navy Midshipmen,S. Watts,4704782,,True,28.0,3,19,2,9,1,10,0,0,0,0,0,3,1,0,2,1,7
401488103,Navy Midshipmen,M. Louridas,5109236,,True,37.0,6,16,3,6,3,10,0,0,2,5,7,1,0,0,1,1,15
401488103,Navy Midshipmen,M. Schrader,4595622,,True,34.0,2,7,2,6,0,1,0,0,2,2,4,3,1,0,2,2,4
401488103,Navy Midshipmen,M. Demos,5109235,,False,9.0,0,0,0,0,0,0,0,0,0,2,2,0,1,0,1,0,0
401488103,Navy Midshipmen,G. Pissott,5109232,,False,18.0,1,5,1,4,0,1,0,0,3,5,8,0,0,0,0,0,2
401488103,Navy Midshipmen,S. Lewis,4900553,,False,9.0,0,3,0,3,0,0,1,2,1,3,4,1,2,0,2,2,1
401488103,Navy Midshipmen,K. Giuliani,5109230,,False,6.0,0,0,0,0,0,0,0,0,0,0,0,0,0,0,0,0,0
401488103,Navy Midshipmen,S. Schofield,4704779,,False,9.0,0,4,0,2,0,2,0,0,1,0,1,0,0,0,0,0,0
401488103,Navy Midshipmen,TEAM,TOTAL,TOTAL,False,,17,66,13,42,4,24,4,7,16,28,44,10,5,0,17,11,42
401488103,Lehigh Mountain Hawks,L. Fandre,5109220,,True,10.0,2,5,1,3,1,2,0,0,1,1,2,1,0,0,0,1,5
401488103,Lehigh Mountain Hawks,F. Hottinger,4595613,,True,30.0,6,15,5,12,1,3,2,2,3,8,11,0,0,0,1,1,15
401488103,Lehigh Mountain Hawks,E. Stemmer,4900544,,True,19.0,4,11,2,6,2,5,0,0,0,4,4,2,3,0,0,1,10
401488103,Lehigh Mountain Hawks,M. Kramer,4704762,,True,15.0,3,7,1,3,2,4,0,0,0,3,3,5,0,0,0,0,8
401488103,Lehigh Mountain Hawks,A. Harvey,4595612,,True,26.0,0,1,0,1,0,0,0,0,1,3,4,6,3,0,1,0,0
401488103,Lehigh Mountain Hawks,M. O'Brien,4900547,,False,14.0,4,5,3,3,1,2,0,0,0,2,2,1,1,1,0,0,9
401488103,Lehigh Mountain Hawks,J. Vargas-Bines,4900546,,False,7.0,1,2,1,1,0,1,2,2,0,0,0,0,0,3,0,1,4
401488103,Lehigh Mountain Hawks,M. Brown,4433751,,False,3.0,0,0,0,0,0,0,0,0,0,0,0,0,0,0,0,0,0
401488103,Lehigh Mountain Hawks,K. Hurt,5109219,,False,2.0,0,1,0,1,0,0,0,0,0,0,0,0,0,0,0,0,0
401488103,Lehigh Mountain Hawks,K. St.Paul,5109218,,False,1.0,0,0,0,0,0,0,0,0,0,0,0,0,0,0,1,0,0
401488103,Lehigh Mountain Hawks,K. Van Eps,4900545,,False,15.0,1,2,0,0,1,2,0,0,0,2,2,0,0,0,0,0,3
401488103,Lehigh Mountain Hawks,M. Albrecht,4704763,,False,20.0,3,4,1,2,2,2,0,0,0,1,1,0,4,2,2,1,8
401488103,Lehigh Mountain Hawks,F. Eggenschwiler,4704761,,False,18.0,0,2,0,1,0,1,0,0,0,1,1,3,1,1,1,2,0
401488103,Lehigh Mountain Hawks,J. Behar,4433782,,False,20.0,4,8,1,3,3,5,4,4,0,3,3,1,0,1,1,1,15
401488103,Lehigh Mountain Hawks,TEAM,TOTAL,TOTAL,False,,28,63,15,36,13,27,8,8,6,32,38,19,12,8,7,8,77
401488103,Lehigh Mountain Hawks,L. Fandre,5109220,,True,10.0,2,5,1,3,1,2,0,0,1,1,2,1,0,0,0,1,5
401488103,Lehigh Mountain Hawks,F. Hottinger,4595613,,True,30.0,6,15,5,12,1,3,2,2,3,8,11,0,0,0,1,1,15
401488103,Lehigh Mountain Hawks,E. Stemmer,4900544,,True,19.0,4,11,2,6,2,5,0,0,0,4,4,2,3,0,0,1,10
401488103,Lehigh Mountain Hawks,M. Kramer,4704762,,True,15.0,3,7,1,3,2,4,0,0,0,3,3,5,0,0,0,0,8
401488103,Lehigh Mountain Hawks,A. Harvey,4595612,,True,26.0,0,1,0,1,0,0,0,0,1,3,4,6,3,0,1,0,0
401488103,Lehigh Mountain Hawks,M. O'Brien,4900547,,False,14.0,4,5,3,3,1,2,0,0,0,2,2,1,1,1,0,0,9
401488103,Lehigh Mountain Hawks,J. Vargas-Bines,4900546,,False,7.0,1,2,1,1,0,1,2,2,0,0,0,0,0,3,0,1,4
401488103,Lehigh Mountain Hawks,M. Brown,4433751,,False,3.0,0,0,0,0,0,0,0,0,0,0,0,0,0,0,0,0,0
401488103,Lehigh Mountain Hawks,K. Hurt,5109219,,False,2.0,0,1,0,1,0,0,0,0,0,0,0,0,0,0,0,0,0
401488103,Lehigh Mountain Hawks,K. St.Paul,5109218,,False,1.0,0,0,0,0,0,0,0,0,0,0,0,0,0,0,1,0,0
401488103,Lehigh Mountain Hawks,K. Van Eps,4900545,,False,15.0,1,2,0,0,1,2,0,0,0,2,2,0,0,0,0,0,3
401488103,Lehigh Mountain Hawks,M. Albrecht,4704763,,False,20.0,3,4,1,2,2,2,0,0,0,1,1,0,4,2,2,1,8
401488103,Lehigh Mountain Hawks,F. Eggenschwiler,4704761,,False,18.0,0,2,0,1,0,1,0,0,0,1,1,3,1,1,1,2,0
401488103,Lehigh Mountain Hawks,J. Behar,4433782,,False,20.0,4,8,1,3,3,5,4,4,0,3,3,1,0,1,1,1,15
401488103,Lehigh Mountain Hawks,TEAM,TOTAL,TOTAL,False,,28,63,15,36,13,27,8,8,6,32,38,19,12,8,7,8,77
401488102,Navy Midshipmen,M. Andrews,4704780,,True,27.0,1,4,1,4,0,0,0,0,3,3,6,0,1,0,2,2,2
401488102,Navy Midshipmen,K. Samson,5109237,,True,13.0,5,7,5,7,0,0,1,2,1,0,1,0,0,0,1,5,11
401488102,Navy Midshipmen,S. Watts,4704782,,True,40.0,2,12,1,8,1,4,0,0,1,7,8,0,0,0,1,2,5
401488102,Navy Midshipmen,M. Louridas,5109236,,True,23.0,2,8,2,6,0,2,1,1,0,2,2,0,0,0,1,2,5
401488102,Navy Midshipmen,M. Schrader,4595622,,True,38.0,1,8,0,3,1,5,1,2,1,4,5,4,3,0,5,2,4
401488102,Navy Midshipmen,M. Demos,5109235,,False,17.0,2,4,2,4,0,0,0,0,1,4,5,1,2,0,4,2,4
401488102,Navy Midshipmen,G. Pissott,5109232,,False,20.0,1,1,0,0,1,1,0,0,1,3,4,1,0,0,5,1,3
401488102,Navy Midshipmen,S. Clarke,5109231,,False,3.0,0,0,0,0,0,0,0,0,0,0,0,0,0,0,0,0,0
401488102,Navy Midshipmen,S. Schofield,4704779,,False,19.0,2,4,0,2,2,2,0,0,0,1,1,1,0,0,2,2,6
401488102,Navy Midshipmen,TEAM,TOTAL,TOTAL,False,,16,48,11,34,5,14,3,5,10,27,37,7,6,0,23,18,40
401488102,Navy Midshipmen,M. Andrews,4704780,,True,27.0,1,4,1,4,0,0,0,0,3,3,6,0,1,0,2,2,2
401488102,Navy Midshipmen,K. Samson,5109237,,True,13.0,5,7,5,7,0,0,1,2,1,0,1,0,0,0,1,5,11
401488102,Navy Midshipmen,S. Watts,4704782,,True,40.0,2,12,1,8,1,4,0,0,1,7,8,0,0,0,1,2,5
401488102,Navy Midshipmen,M. Louridas,5109236,,True,23.0,2,8,2,6,0,2,1,1,0,2,2,0,0,0,1,2,5
401488102,Navy Midshipmen,M. Schrader,4595622,,True,38.0,1,8,0,3,1,5,1,2,1,4,5,4,3,0,5,2,4
401488102,Navy Midshipmen,M. Demos,5109235,,False,17.0,2,4,2,4,0,0,0,0,1,4,5,1,2,0,4,2,4
401488102,Navy Midshipmen,G. Pissott,5109232,,False,20.0,1,1,0,0,1,1,0,0,1,3,4,1,0,0,5,1,3
401488102,Navy Midshipmen,S. Clarke,5109231,,False,3.0,0,0,0,0,0,0,0,0,0,0,0,0,0,0,0,0,0
401488102,Navy Midshipmen,S. Schofield,4704779,,False,19.0,2,4,0,2,2,2,0,0,0,1,1,1,0,0,2,2,6
401488102,Navy Midshipmen,TEAM,TOTAL,TOTAL,False,,16,48,11,34,5,14,3,5,10,27,37,7,6,0,23,18,40
401488102,Holy Cross Crusaders,J. Allen,4704714,,True,16.0,4,7,4,7,0,0,1,3,0,1,1,0,1,0,3,4,9
401488102,Holy Cross Crusaders,K. Flanagan,5109211,,True,32.0,1,6,1,5,0,1,2,2,0,2,2,3,3,0,1,3,4
401488102,Holy Cross Crusaders,C. McCormack,4704716,,True,28.0,4,11,3,5,1,6,3,3,2,2,4,1,0,0,3,0,12
401488102,Holy Cross Crusaders,B. Power-Cassidy,4704715,,True,30.0,5,13,2,7,3,6,2,2,2,4,6,0,2,1,2,2,15
401488102,Holy Cross Crusaders,A. Cross,4595975,,True,31.0,0,5,0,2,0,3,2,2,1,5,6,0,1,0,1,0,2
401488102,Holy Cross Crusaders,M. Cahalan,5109210,,False,1.0,0,0,0,0,0,0,0,0,0,0,0,0,0,0,0,0,0
401488102,Holy Cross Crusaders,L. Berger,4900539,,False,26.0,3,7,3,7,0,0,3,4,3,2,5,2,0,2,0,1,9
401488102,Holy Cross Crusaders,C. Wright,4703660,,False,3.0,0,0,0,0,0,0,0,0,1,1,2,0,0,0,1,0,0
401488102,Holy Cross Crusaders,M. Donnelly,5109213,,False,16.0,1,5,1,2,0,3,0,0,0,0,0,1,2,0,0,0,2
401488102,Holy Cross Crusaders,S. Foreman,5109212,,False,12.0,0,1,0,1,0,0,0,0,1,3,4,0,0,0,1,2,0
401488102,Holy Cross Crusaders,L. Huber,4900538,,False,1.0,0,0,0,0,0,0,0,0,0,0,0,0,0,0,0,0,0
401488102,Holy Cross Crusaders,G. Munt,4900537,,False,4.0,0,0,0,0,0,0,0,0,0,0,0,0,0,0,0,0,0
401488102,Holy Cross Crusaders,TEAM,TOTAL,TOTAL,False,,18,55,14,36,4,19,13,16,12,24,36,7,9,3,12,12,53
401488102,Holy Cross Crusaders,J. Allen,4704714,,True,16.0,4,7,4,7,0,0,1,3,0,1,1,0,1,0,3,4,9
401488102,Holy Cross Crusaders,K. Flanagan,5109211,,True,32.0,1,6,1,5,0,1,2,2,0,2,2,3,3,0,1,3,4
401488102,Holy Cross Crusaders,C. McCormack,4704716,,True,28.0,4,11,3,5,1,6,3,3,2,2,4,1,0,0,3,0,12
401488102,Holy Cross Crusaders,B. Power-Cassidy,4704715,,True,30.0,5,13,2,7,3,6,2,2,2,4,6,0,2,1,2,2,15
401488102,Holy Cross Crusaders,A. Cross,4595975,,True,31.0,0,5,0,2,0,3,2,2,1,5,6,0,1,0,1,0,2
401488102,Holy Cross Crusaders,M. Cahalan,5109210,,False,1.0,0,0,0,0,0,0,0,0,0,0,0,0,0,0,0,0,0
401488102,Holy Cross Crusaders,L. Berger,4900539,,False,26.0,3,7,3,7,0,0,3,4,3,2,5,2,0,2,0,1,9
401488102,Holy Cross Crusaders,C. Wright,4703660,,False,3.0,0,0,0,0,0,0,0,0,1,1,2,0,0,0,1,0,0
401488102,Holy Cross Crusaders,M. Donnelly,5109213,,False,16.0,1,5,1,2,0,3,0,0,0,0,0,1,2,0,0,0,2
401488102,Holy Cross Crusaders,S. Foreman,5109212,,False,12.0,0,1,0,1,0,0,0,0,1,3,4,0,0,0,1,2,0
401488102,Holy Cross Crusaders,L. Huber,4900538,,False,1.0,0,0,0,0,0,0,0,0,0,0,0,0,0,0,0,0,0
401488102,Holy Cross Crusaders,G. Munt,4900537,,False,4.0,0,0,0,0,0,0,0,0,0,0,0,0,0,0,0,0,0
401488102,Holy Cross Crusaders,TEAM,TOTAL,TOTAL,False,,18,55,14,36,4,19,13,16,12,24,36,7,9,3,12,12,53
401488101,Rider Broncs,R. Toussaint,4704617,,True,39.0,5,15,3,9,2,6,2,4,2,4,6,0,0,0,0,3,14
401488101,Rider Broncs,V. Toomey,4595396,,True,18.0,5,7,5,7,0,0,0,0,0,3,3,1,0,1,1,3,10
401488101,Rider Broncs,M. Firebaugh,4704621,,True,37.0,2,12,0,4,2,8,3,3,0,5,5,3,0,0,2,2,9
401488101,Rider Broncs,J. Schiffer,4595239,,True,32.0,2,7,1,2,1,5,2,2,0,4,4,2,1,0,3,2,7
401488101,Rider Broncs,A. Mobley,4399137,,True,36.0,3,7,1,3,2,4,2,2,2,9,11,5,1,0,2,3,10
401488101,Rider Broncs,T. Blanford,4705295,,False,17.0,2,3,2,3,0,0,1,2,0,1,1,0,1,2,3,2,5
401488101,Rider Broncs,S. Bruintjes,4704618,,False,5.0,0,0,0,0,0,0,0,0,0,0,0,0,0,0,2,2,0
401488101,Rider Broncs,M. Lynch,4704616,,False,8.0,0,2,0,0,0,2,0,0,0,1,1,2,0,0,1,0,0
401488101,Rider Broncs,M. Hyacienth,4595394,,False,7.0,0,0,0,0,0,0,4,4,0,1,1,0,0,0,0,0,4
401488101,Rider Broncs,TEAM,TOTAL,TOTAL,False,,19,53,12,28,7,25,14,17,7,32,39,13,3,3,14,18,59
401488101,Navy Midshipmen,M. Andrews,4704780,,True,11.0,1,4,1,4,0,0,0,0,1,2,3,0,0,0,0,0,2
401488101,Navy Midshipmen,K. Samson,5109237,,True,22.0,1,3,1,3,0,0,0,0,1,3,4,0,0,1,1,3,2
401488101,Navy Midshipmen,S. Watts,4704782,,True,26.0,2,8,2,5,0,3,0,4,2,2,4,0,0,0,1,4,4
401488101,Navy Midshipmen,M. Louridas,5109236,,True,36.0,0,12,0,4,0,8,3,6,1,5,6,6,1,0,2,2,3
401488101,Navy Midshipmen,M. Schrader,4595622,,True,34.0,5,11,2,3,3,8,1,2,0,2,2,1,2,0,0,3,14
401488101,Navy Midshipmen,M. Demos,5109235,,False,16.0,0,2,0,2,0,0,1,2,2,3,5,0,1,1,0,1,1
401488101,Navy Midshipmen,G. Pissott,5109232,,False,26.0,2,5,1,4,1,1,2,2,1,7,8,0,0,1,5,2,7
401488101,Navy Midshipmen,S. Clarke,5109231,,False,27.0,3,10,3,6,0,4,4,6,3,2,5,2,2,0,2,1,10
401488101,Navy Midshipmen,S. Schofield,4704779,,False,0.0,0,0,0,0,0,0,0,0,0,0,0,0,0,0,0,0,0
401488101,Navy Midshipmen,TEAM,TOTAL,TOTAL,False,,14,55,10,31,4,24,11,22,13,28,41,9,6,3,12,16,43
401488100,Navy Midshipmen,M. Andrews,4704780,,True,12.0,1,2,1,2,0,0,0,0,0,1,1,1,0,0,0,3,2
401488100,Navy Midshipmen,K. Samson,5109237,,True,35.0,4,10,4,10,0,0,0,0,5,5,10,2,0,5,5,5,8
401488100,Navy Midshipmen,S. Watts,4704782,,True,38.0,8,16,3,7,5,9,1,2,3,1,4,1,0,0,1,3,22
401488100,Navy Midshipmen,M. Louridas,5109236,,True,39.0,5,19,1,6,4,13,0,1,3,6,9,7,0,0,4,2,14
401488100,Navy Midshipmen,M. Schrader,4595622,,True,37.0,3,8,2,2,1,6,0,0,1,1,2,5,1,0,1,1,7
401488100,Navy Midshipmen,M. Demos,5109235,,False,3.0,0,0,0,0,0,0,0,0,0,1,1,0,0,0,0,0,0
401488100,Navy Midshipmen,G. Pissott,5109232,,False,14.0,1,4,1,4,0,0,0,0,1,2,3,1,0,0,1,3,2
401488100,Navy Midshipmen,S. Clarke,5109231,,False,21.0,3,6,0,2,3,4,2,4,5,5,10,1,0,0,5,4,11
401488100,Navy Midshipmen,S. Schofield,4704779,,False,1.0,0,0,0,0,0,0,0,0,0,0,0,0,0,0,0,0,0
401488100,Navy Midshipmen,TEAM,TOTAL,TOTAL,False,,25,65,12,33,13,32,3,7,23,23,46,18,1,5,18,21,66
401488100,Maryland Eastern Shore Hawks,L. Thomas,4899959,,True,16.0,0,2,0,2,0,0,0,0,3,1,4,2,0,0,0,1,0
401488100,Maryland Eastern Shore Hawks,L. Allen,5109723,,True,10.0,1,2,1,2,0,0,1,2,2,1,3,0,1,0,0,0,3
401488100,Maryland Eastern Shore Hawks,M. Adams,4595530,,True,7.0,0,2,0,1,0,1,1,2,1,1,2,0,0,0,0,1,1
401488100,Maryland Eastern Shore Hawks,J. Bannerman,5109720,,True,28.0,5,11,1,3,4,8,3,4,1,0,1,3,1,0,2,3,17
401488100,Maryland Eastern Shore Hawks,M. Thomas,4595528,,True,31.0,4,15,2,10,2,5,2,2,1,4,5,1,1,0,0,1,12
401488100,Maryland Eastern Shore Hawks,A. Seawell,4899958,,False,23.0,4,5,4,5,0,0,2,3,2,4,6,0,2,1,1,0,10
401488100,Maryland Eastern Shore Hawks,M. Lester,4595527,,False,24.0,2,4,2,4,0,0,4,4,0,3,3,0,2,2,0,4,8
401488100,Maryland Eastern Shore Hawks,A. Lynch,5109721,,False,29.0,2,8,2,7,0,1,3,7,5,2,7,2,1,0,2,3,7
401488100,Maryland Eastern Shore Hawks,Z. Haynes,4705351,,False,32.0,5,14,5,13,0,1,4,6,2,2,4,4,4,0,0,2,14
401488100,Maryland Eastern Shore Hawks,TEAM,TOTAL,TOTAL,False,,23,63,17,47,6,16,20,30,20,21,41,12,12,3,5,15,72
401488099,Navy Midshipmen,M. Andrews,4704780,,True,14.0,1,1,1,1,0,0,0,0,0,2,2,0,0,0,5,5,2
401488099,Navy Midshipmen,K. Samson,5109237,,True,32.0,8,10,8,10,0,0,0,0,3,4,7,5,1,0,1,4,16
401488099,Navy Midshipmen,S. Watts,4704782,,True,40.0,11,21,7,14,4,7,7,7,0,6,6,1,1,1,3,2,33
401488099,Navy Midshipmen,M. Louridas,5109236,,True,40.0,8,17,5,10,3,7,1,2,0,9,9,5,0,0,1,4,20
401488099,Navy Midshipmen,M. Schrader,4595622,,True,37.0,2,8,0,3,2,5,0,0,0,3,3,7,2,0,4,2,6
401488099,Navy Midshipmen,M. Demos,5109235,,False,7.0,1,1,1,1,0,0,0,1,1,0,1,1,0,0,2,2,2
401488099,Navy Midshipmen,G. Pissott,5109232,,False,22.0,1,4,1,3,0,1,0,1,1,3,4,2,0,0,3,5,2
401488099,Navy Midshipmen,S. Lewis,4900553,,False,3.0,0,0,0,0,0,0,0,0,0,0,0,1,0,0,0,0,0
401488099,Navy Midshipmen,K. Giuliani,5109230,,False,3.0,0,0,0,0,0,0,0,0,0,0,0,1,0,0,0,0,0
401488099,Navy Midshipmen,S. Schofield,4704779,,False,2.0,1,1,0,0,1,1,0,0,0,0,0,0,0,0,0,0,3
401488099,Navy Midshipmen,TEAM,TOTAL,TOTAL,False,,33,63,23,42,10,21,8,11,6,31,37,23,4,1,19,24,84
401488099,Idaho Vandals,B. Bea,4594826,,True,40.0,11,16,11,14,0,2,12,14,2,11,13,3,3,1,3,2,34
401488099,Idaho Vandals,A. Phillips,5107650,,True,18.0,2,2,2,2,0,0,2,4,0,4,4,1,3,0,2,3,6
401488099,Idaho Vandals,R. Smith,5107648,,True,32.0,3,9,1,5,2,4,0,0,0,2,2,6,1,0,1,0,8
401488099,Idaho Vandals,S. Gandy,4704760,,True,28.0,0,5,0,2,0,3,4,6,0,3,3,3,2,0,1,2,4
401488099,Idaho Vandals,T. Johnson,4281684,,True,28.0,4,11,2,3,2,8,3,4,1,3,4,0,1,1,0,4,13
401488099,Idaho Vandals,S. Brans,5107647,,False,12.0,1,3,0,1,1,2,0,0,0,0,0,0,0,0,1,1,3
401488099,Idaho Vandals,B. Malone,4899043,,False,15.0,3,5,0,2,3,3,2,2,1,0,1,1,0,0,1,3,11
401488099,Idaho Vandals,J. Allred,4899037,,False,7.0,0,2,0,0,0,2,0,0,0,1,1,2,0,0,0,1,0
401488099,Idaho Vandals,A. Wallace,4899034,,False,20.0,4,8,3,3,1,5,2,2,0,1,1,2,2,0,1,1,11
401488099,Idaho Vandals,TEAM,TOTAL,TOTAL,False,,28,61,19,32,9,29,25,32,5,27,32,18,12,2,10,17,90
401488098,Northern Illinois Huskies,E. Carter,5109040,,True,23.0,5,10,3,6,2,4,2,3,0,1,1,2,0,0,1,1,14
401488098,Northern Illinois Huskies,A. Davis,4595300,,True,16.0,6,12,6,12,0,0,1,1,10,1,11,3,2,0,2,1,13
401488098,Northern Illinois Huskies,L. Nickel,4900077,,True,16.0,3,4,0,0,3,4,0,0,1,2,3,0,0,0,1,0,9
401488098,Northern Illinois Huskies,J. Marable,4705368,,True,19.0,1,5,0,4,1,1,0,0,0,0,0,2,1,0,0,1,3
401488098,Northern Illinois Huskies,C. Koker,4595297,,True,14.0,3,5,3,5,0,0,0,0,1,3,4,8,0,1,2,1,6
401488098,Northern Illinois Huskies,B. Stonebraker,4705370,,False,10.0,2,4,2,4,0,0,0,0,2,2,4,1,0,1,0,0,4
401488098,Northern Illinois Huskies,E. Meinert,4705369,,False,14.0,2,4,2,4,0,0,0,2,0,1,1,1,1,0,0,2,4
401488098,Northern Illinois Huskies,T. Stauffacher,4433686,,False,18.0,4,4,2,2,2,2,0,0,0,2,2,0,2,0,2,3,10
401488098,Northern Illinois Huskies,T. Hodges-Johnson,5109042,,False,15.0,1,2,1,2,0,0,2,2,0,5,5,1,1,0,2,1,4
401488098,Northern Illinois Huskies,K. Drake,5109041,,False,8.0,0,2,0,0,0,2,0,0,0,2,2,2,0,0,0,0,0
401488098,Northern Illinois Huskies,M. Prewitt,4900078,,False,10.0,1,3,0,2,1,1,1,2,0,1,1,1,0,0,1,0,4
401488098,Northern Illinois Huskies,S. McCrea,4705367,,False,6.0,1,2,0,0,1,2,0,0,0,0,0,0,0,0,0,0,3
401488098,Northern Illinois Huskies,G. Hunter,4595299,,False,14.0,1,5,0,1,1,4,0,0,0,2,2,1,0,0,1,2,3
401488098,Northern Illinois Huskies,J. Poisson,4069124,,False,17.0,4,9,3,5,1,4,1,1,0,1,1,2,1,0,1,2,10
401488098,Northern Illinois Huskies,TEAM,TOTAL,TOTAL,False,,34,71,22,47,12,24,7,11,17,27,44,24,8,2,13,14,87
401488098,Navy Midshipmen,G. Pissott,5109232,,True,15.0,1,3,1,1,0,2,0,0,0,2,2,0,0,0,2,2,2
401488098,Navy Midshipmen,K. Samson,5109237,,True,21.0,3,10,3,10,0,0,5,5,1,2,3,0,0,0,3,5,11
401488098,Navy Midshipmen,S. Watts,4704782,,True,24.0,4,11,3,6,1,5,2,2,3,1,4,0,0,1,2,1,11
401488098,Navy Midshipmen,M. Louridas,5109236,,True,32.0,3,16,1,8,2,8,0,0,1,3,4,3,1,1,3,1,8
401488098,Navy Midshipmen,K. Giuliani,5109230,,True,6.0,1,1,1,1,0,0,0,1,1,0,1,0,0,0,2,0,2
401488098,Navy Midshipmen,M. Demos,5109235,,False,9.0,1,2,1,2,0,0,0,2,1,1,2,1,1,1,2,1,2
401488098,Navy Midshipmen,S. Lewis,4900553,,False,18.0,2,2,2,2,0,0,0,0,2,2,4,0,1,0,2,1,4
401488098,Navy Midshipmen,M. Andrews,4704780,,False,17.0,1,4,1,4,0,0,0,0,1,4,5,2,0,2,3,3,2
401488098,Navy Midshipmen,S. Clarke,5109231,,False,16.0,2,8,2,5,0,3,0,2,2,2,4,3,0,0,1,2,4
401488098,Navy Midshipmen,S. Schofield,4704779,,False,11.0,1,2,1,1,0,1,0,0,0,1,1,0,0,0,0,0,2
401488098,Navy Midshipmen,M. Schrader,4595622,,False,31.0,1,3,1,1,0,2,0,0,1,2,3,4,1,0,2,2,2
401488098,Navy Midshipmen,TEAM,TOTAL,TOTAL,False,,20,62,17,41,3,21,7,12,18,22,40,13,4,5,22,18,50
401488097,Navy Midshipmen,G. Pissott,5109232,,True,28.0,2,3,2,2,0,1,1,2,1,2,3,0,2,0,3,4,5
401488097,Navy Midshipmen,K. Samson,5109237,,True,17.0,1,5,1,5,0,0,1,2,0,1,1,0,0,0,1,2,3
401488097,Navy Midshipmen,S. Watts,4704782,,True,36.0,5,16,3,10,2,6,6,6,1,4,5,2,0,0,5,1,18
401488097,Navy Midshipmen,M. Louridas,5109236,,True,37.0,9,25,3,10,6,15,0,0,1,3,4,5,0,0,1,3,24
401488097,Navy Midshipmen,K. Giuliani,5109230,,True,15.0,1,1,1,1,0,0,0,0,0,0,0,0,0,0,2,1,2
401488097,Navy Midshipmen,M. Demos,5109235,,False,8.0,0,0,0,0,0,0,0,0,0,1,1,0,1,0,0,1,0
401488097,Navy Midshipmen,S. Lewis,4900553,,False,21.0,0,3,0,3,0,0,0,0,3,3,6,2,1,2,2,3,0
401488097,Navy Midshipmen,M. Andrews,4704780,,False,7.0,1,1,1,1,0,0,0,0,0,1,1,0,0,1,0,1,2
401488097,Navy Midshipmen,S. Schofield,4704779,,False,5.0,0,0,0,0,0,0,0,0,0,0,0,0,0,0,1,0,0
401488097,Navy Midshipmen,M. Schrader,4595622,,False,26.0,1,3,1,3,0,0,0,0,3,0,3,3,1,1,1,1,2
401488097,Navy Midshipmen,TEAM,TOTAL,TOTAL,False,,20,57,12,35,8,22,8,10,12,18,30,12,5,4,16,17,56
401488097,Monmouth Hawks,L. Marsicano,4399472,,True,22.0,3,4,3,3,0,1,0,0,2,3,5,3,0,0,0,3,6
401488097,Monmouth Hawks,B. Kranbuhl,4704490,,True,20.0,4,6,4,6,0,0,2,2,0,3,3,0,2,3,1,3,10
401488097,Monmouth Hawks,A. Coleman,5108818,,True,26.0,0,2,0,0,0,2,1,2,1,3,4,6,0,1,5,4,1
401488097,Monmouth Hawks,K. Donovan,4596543,,True,25.0,7,9,4,5,3,4,0,0,2,4,6,0,1,0,2,1,17
401488097,Monmouth Hawks,B. Tinsley,4281227,,True,29.0,5,9,3,5,2,4,2,2,0,0,0,8,2,0,2,0,14
401488097,Monmouth Hawks,L. Thomas,4399177,,False,18.0,4,11,4,10,0,1,0,0,0,5,5,1,0,0,0,2,8
401488097,Monmouth Hawks,A. Carroll,5108819,,False,10.0,0,0,0,0,0,0,0,0,0,0,0,0,1,0,2,0,0
401488097,Monmouth Hawks,A. Panayides,4899852,,False,11.0,1,1,0,0,1,1,0,0,0,0,0,2,0,0,0,0,3
401488097,Monmouth Hawks,J. Hall,4704487,,False,8.0,0,2,0,1,0,1,1,2,0,0,0,1,0,0,1,0,1
401488097,Monmouth Hawks,A. Vanderhoop,4704485,,False,13.0,3,4,0,0,3,4,0,0,0,2,2,1,0,0,1,0,9
401488097,Monmouth Hawks,J. Louro,4281169,,False,18.0,2,5,0,0,2,5,1,2,1,1,2,0,1,0,0,0,7
401488097,Monmouth Hawks,TEAM,TOTAL,TOTAL,False,,29,53,18,30,11,23,7,10,8,26,34,22,7,4,16,13,76
401488096,Navy Midshipmen,G. Pissott,5109232,,True,15.0,1,2,1,2,0,0,0,0,1,1,2,1,0,0,3,3,2
401488096,Navy Midshipmen,K. Samson,5109237,,True,18.0,3,5,3,5,0,0,1,1,3,2,5,1,0,0,1,2,7
401488096,Navy Midshipmen,S. Clarke,5109231,,True,13.0,0,1,0,1,0,0,3,4,0,2,2,2,0,0,1,0,3
401488096,Navy Midshipmen,S. Watts,4704782,,True,38.0,6,16,5,12,1,4,4,5,0,6,6,1,0,2,5,3,17
401488096,Navy Midshipmen,M. Louridas,5109236,,True,29.0,3,14,1,7,2,7,4,4,2,4,6,2,1,0,1,2,12
401488096,Navy Midshipmen,S. Lewis,4900553,,False,24.0,4,4,4,4,0,0,0,1,1,4,5,1,1,0,3,1,8
401488096,Navy Midshipmen,M. Andrews,4704780,,False,21.0,2,3,2,3,0,0,0,0,1,2,3,0,1,0,1,1,4
401488096,Navy Midshipmen,K. Giuliani,5109230,,False,16.0,0,1,0,0,0,1,0,0,0,0,0,0,0,0,0,2,0
401488096,Navy Midshipmen,M. Schrader,4595622,,False,26.0,2,7,0,2,2,5,0,0,0,1,1,1,1,0,2,3,6
401488096,Navy Midshipmen,TEAM,TOTAL,TOTAL,False,,21,53,16,36,5,17,12,15,12,26,38,9,4,2,18,17,59
401488096,Mount St. Mary's Mountaineers,I. Hunt,4704996,,True,33.0,4,8,3,7,1,1,2,2,0,7,7,5,1,0,2,4,11
401488096,Mount St. Mary's Mountaineers,N. Villaflor,4399578,,True,38.0,6,11,6,8,0,3,3,3,1,0,1,0,0,0,0,3,15
401488096,Mount St. Mary's Mountaineers,Jo Raflo,4899606,,True,26.0,2,6,1,2,1,4,0,0,0,0,0,1,1,1,3,1,5
401488096,Mount St. Mary's Mountaineers,J. Tomasetti,4704999,,True,31.0,5,9,5,6,0,3,6,6,1,5,6,3,2,0,1,1,16
401488096,Mount St. Mary's Mountaineers,M. Harrison,4399572,,True,33.0,7,19,5,9,2,10,3,4,0,1,1,1,2,0,3,2,19
401488096,Mount St. Mary's Mountaineers,M. Matheny,5109008,,False,8.0,0,0,0,0,0,0,0,0,0,0,0,0,1,1,0,2,0
401488096,Mount St. Mary's Mountaineers,C. Dunham,5109010,,False,5.0,0,0,0,0,0,0,0,0,0,0,0,1,0,0,0,0,0
401488096,Mount St. Mary's Mountaineers,G. Hoddinott,5109009,,False,5.0,0,0,0,0,0,0,2,2,1,0,1,0,1,0,1,1,2
401488096,Mount St. Mary's Mountaineers,J. Lindsay-Huskey,4900509,,False,21.0,0,2,0,1,0,1,0,0,0,1,1,1,0,0,0,2,0
401488096,Mount St. Mary's Mountaineers,TEAM,TOTAL,TOTAL,False,,24,55,20,33,4,22,16,17,5,22,27,12,8,2,10,16,68
401488095,UAlbany Great Danes,T. Hanner,4594342,,True,19.0,2,6,2,6,0,0,2,2,2,1,3,1,0,0,2,3,6
401488095,UAlbany Great Danes,F. Werth,4898947,,True,30.0,2,9,2,5,0,4,2,2,2,4,6,1,0,0,1,1,6
401488095,UAlbany Great Danes,L. Phillips,4898946,,True,24.0,3,5,3,5,0,0,0,0,0,3,3,2,3,0,0,1,6
401488095,UAlbany Great Danes,G. Heeps,4594787,,True,33.0,3,7,2,2,1,5,1,1,0,10,10,2,2,0,2,1,8
401488095,UAlbany Great Danes,E. Hahne,4398744,,True,27.0,4,11,4,10,0,1,11,13,1,4,5,1,1,0,2,2,19
401488095,UAlbany Great Danes,M. Sepp,5107527,,False,12.0,0,2,0,1,0,1,1,2,0,1,1,0,1,0,0,1,1
401488095,UAlbany Great Danes,K. Sanford,5107526,,False,15.0,3,6,2,3,1,3,0,0,0,1,1,0,1,0,0,1,7
401488095,UAlbany Great Danes,T. Moffat,5107525,,False,4.0,0,0,0,0,0,0,0,0,0,0,0,0,0,0,0,0,0
401488095,UAlbany Great Danes,A. Ray,4898949,,False,20.0,0,1,0,1,0,0,0,0,2,1,3,1,0,0,0,2,0
401488095,UAlbany Great Danes,F. Lee,4595154,,False,16.0,4,5,2,2,2,3,1,2,0,1,1,1,0,0,2,0,11
401488095,UAlbany Great Danes,TEAM,TOTAL,TOTAL,False,,21,52,17,35,4,17,18,22,9,26,35,9,8,0,11,12,64
401488095,Navy Midshipmen,G. Pissott,5109232,,True,35.0,3,6,3,6,0,0,2,2,5,5,10,1,1,1,1,4,8
401488095,Navy Midshipmen,K. Samson,5109237,,True,13.0,1,3,1,3,0,0,0,0,2,3,5,1,0,1,1,5,2
401488095,Navy Midshipmen,S. Watts,4704782,,True,30.0,3,11,3,7,0,4,2,2,0,2,2,1,0,1,1,1,8
401488095,Navy Midshipmen,M. Louridas,5109236,,True,38.0,6,14,3,7,3,7,1,2,0,5,5,0,0,1,3,2,16
401488095,Navy Midshipmen,M. Schrader,4595622,,True,22.0,3,12,1,5,2,7,0,0,1,1,2,1,0,0,4,3,8
401488095,Navy Midshipmen,M. Demos,5109235,,False,8.0,0,1,0,1,0,0,0,0,1,2,3,0,0,0,1,0,0
401488095,Navy Midshipmen,S. Lewis,4900553,,False,24.0,3,3,3,3,0,0,0,0,0,4,4,2,0,1,3,4,6
401488095,Navy Midshipmen,M. Andrews,4704780,,False,2.0,0,0,0,0,0,0,0,0,1,0,1,0,0,0,0,0,0
401488095,Navy Midshipmen,S. Clarke,5109231,,False,23.0,1,6,1,4,0,2,0,0,2,0,2,0,0,1,2,3,2
401488095,Navy Midshipmen,S. Schofield,4704779,,False,5.0,0,3,0,1,0,2,0,0,0,0,0,0,0,0,0,0,0
401488095,Navy Midshipmen,TEAM,TOTAL,TOTAL,False,,20,59,15,37,5,22,5,6,13,23,36,6,1,6,16,22,50
401488094,Navy Midshipmen,G. Pissott,5109232,,True,10.0,0,0,0,0,0,0,1,2,0,1,1,0,0,0,2,1,1
401488094,Navy Midshipmen,K. Samson,5109237,,True,26.0,4,6,4,6,0,0,3,3,2,2,4,0,1,2,4,2,11
401488094,Navy Midshipmen,S. Watts,4704782,,True,24.0,2,6,1,4,1,2,0,0,1,3,4,1,0,0,6,1,5
401488094,Navy Midshipmen,M. Louridas,5109236,,True,39.0,6,11,5,9,1,2,0,0,0,2,2,1,1,0,3,1,13
401488094,Navy Midshipmen,M. Schrader,4595622,,True,19.0,2,4,2,4,0,0,2,2,0,2,2,0,0,0,3,2,6
401488094,Navy Midshipmen,M. Demos,5109235,,False,15.0,1,4,1,4,0,0,2,2,0,2,2,0,0,1,1,3,4
401488094,Navy Midshipmen,S. Lewis,4900553,,False,16.0,1,3,1,2,0,1,3,5,1,1,2,0,1,1,3,5,5
401488094,Navy Midshipmen,M. Andrews,4704780,,False,12.0,0,0,0,0,0,0,0,0,3,2,5,0,0,0,1,0,0
401488094,Navy Midshipmen,S. Clarke,5109231,,False,13.0,1,4,1,3,0,1,1,2,0,1,1,0,0,0,1,1,3
401488094,Navy Midshipmen,K. Giuliani,5109230,,False,17.0,0,1,0,1,0,0,0,0,1,0,1,1,0,0,4,2,0
401488094,Navy Midshipmen,S. Schofield,4704779,,False,9.0,1,2,1,2,0,0,0,0,0,0,0,0,0,0,1,1,2
401488094,Navy Midshipmen,TEAM,TOTAL,TOTAL,False,,18,41,16,35,2,6,12,16,8,18,26,3,3,4,29,19,50
401488094,Air Force Falcons,D. MacMillan,4704414,,True,23.0,1,8,0,4,1,4,2,2,0,3,3,3,1,0,1,0,5
401488094,Air Force Falcons,N. McDonald,4595618,,True,27.0,5,9,3,7,2,2,0,0,5,5,10,0,0,1,1,1,12
401488094,Air Force Falcons,Jo Huntimer,4899763,,True,29.0,0,1,0,0,0,1,3,4,0,1,1,6,2,0,2,2,3
401488094,Air Force Falcons,K. Pilson,4704411,,True,24.0,2,5,2,5,0,0,2,2,3,2,5,4,6,0,4,1,6
401488094,Air Force Falcons,K. Heath,4595614,,True,24.0,11,14,9,11,2,3,3,3,2,1,3,0,3,0,1,1,27
401488094,Air Force Falcons,E. Adams,5109379,,False,9.0,0,0,0,0,0,0,2,2,1,0,1,0,0,0,1,1,2
401488094,Air Force Falcons,P. Brown,5109378,,False,4.0,2,2,2,2,0,0,0,0,1,0,1,0,0,0,0,1,4
401488094,Air Force Falcons,G. Greenwood,5109377,,False,4.0,0,1,0,1,0,0,0,0,0,0,0,0,0,0,0,1,0
401488094,Air Force Falcons,F. Shelton,5109376,,False,13.0,3,5,3,4,0,1,0,0,1,2,3,1,1,1,0,3,6
401488094,Air Force Falcons,M. Perry,5109375,,False,11.0,0,7,0,3,0,4,1,2,1,0,1,1,0,0,0,0,1
401488094,Air Force Falcons,M. Le,5109374,,False,6.0,1,1,0,0,1,1,0,0,0,0,0,0,1,0,1,1,3
401488094,Air Force Falcons,M. Smith,4899759,,False,16.0,7,11,4,6,3,5,0,0,0,0,0,0,2,0,1,3,17
401488094,Air Force Falcons,T. Britt,4704412,,False,10.0,1,3,1,3,0,0,2,2,2,2,4,2,2,0,0,1,4
401488094,Air Force Falcons,TEAM,TOTAL,TOTAL,False,,33,67,24,46,9,21,15,17,17,18,35,17,18,2,13,16,90
401488093,William & Mary Tribe,B. Bellamy,4594744,,True,30.0,6,11,6,10,0,1,2,2,1,6,7,3,4,1,4,3,14
401488093,William & Mary Tribe,K. Beckwith,4705064,,True,24.0,3,8,3,8,0,0,2,4,4,5,9,1,1,1,0,3,8
401488093,William & Mary Tribe,A. Mikeska,5108904,,True,19.0,2,4,1,1,1,3,3,4,0,2,2,2,2,0,3,3,8
401488093,William & Mary Tribe,R. Casey,4281390,,True,32.0,7,16,3,8,4,8,2,6,1,1,2,2,0,0,1,2,20
401488093,William & Mary Tribe,S. Wagner,4281291,,True,31.0,4,13,1,6,3,7,2,2,0,2,2,2,4,0,0,0,13
401488093,William & Mary Tribe,K. Rolph,5108905,,False,7.0,0,2,0,0,0,2,0,0,1,0,1,1,0,0,0,3,0
401488093,William & Mary Tribe,M. Magee,4899593,,False,3.0,0,0,0,0,0,0,0,0,0,0,0,0,0,0,1,0,0
401488093,William & Mary Tribe,C. Wingertzahn,4705067,,False,10.0,0,3,0,3,0,0,2,2,1,0,1,0,0,0,0,1,2
401488093,William & Mary Tribe,R. Frisby-Smith,4705066,,False,19.0,1,5,1,3,0,2,4,6,3,1,4,1,1,0,0,2,6
401488093,William & Mary Tribe,L. Brown,4705065,,False,3.0,0,0,0,0,0,0,0,0,0,0,0,0,0,0,0,0,0
401488093,William & Mary Tribe,C. Gilliam,4594743,,False,22.0,2,5,2,4,0,1,4,5,0,2,2,1,1,0,1,2,8
401488093,William & Mary Tribe,TEAM,TOTAL,TOTAL,False,,25,67,17,43,8,24,21,31,12,22,34,13,13,2,10,19,79
401488093,Navy Midshipmen,G. Pissott,5109232,,True,25.0,2,4,2,3,0,1,0,2,1,6,7,3,0,1,4,0,4
401488093,Navy Midshipmen,K. Samson,5109237,,True,27.0,4,5,4,5,0,0,3,4,2,8,10,1,0,2,4,4,11
401488093,Navy Midshipmen,S. Watts,4704782,,True,35.0,10,17,6,10,4,7,4,4,0,2,2,0,0,0,2,2,28
401488093,Navy Midshipmen,M. Louridas,5109236,,True,28.0,4,8,1,3,3,5,0,0,0,1,1,1,0,0,4,4,11
401488093,Navy Midshipmen,M. Schrader,4595622,,True,23.0,0,2,0,1,0,1,1,2,0,2,2,3,0,0,6,4,1
401488093,Navy Midshipmen,M. Demos,5109235,,False,9.0,0,1,0,1,0,0,0,0,1,4,5,0,0,0,1,0,0
401488093,Navy Midshipmen,S. Lewis,4900553,,False,6.0,0,1,0,1,0,0,0,0,0,2,2,0,0,0,0,2,0
401488093,Navy Midshipmen,M. Andrews,4704780,,False,7.0,0,1,0,1,0,0,0,0,0,2,2,0,0,0,0,3,0
401488093,Navy Midshipmen,T. Papahronis,5109234,,False,5.0,2,3,2,3,0,0,0,0,0,1,1,1,0,0,1,0,4
401488093,Navy Midshipmen,S. Clarke,5109231,,False,18.0,1,4,1,4,0,0,3,4,0,1,1,2,0,0,4,1,5
401488093,Navy Midshipmen,K. Giuliani,5109230,,False,5.0,0,0,0,0,0,0,0,0,0,0,0,2,0,0,0,3,0
401488093,Navy Midshipmen,S. Schofield,4704779,,False,12.0,0,1,0,0,0,1,0,2,0,0,0,0,0,0,1,2,0
401488093,Navy Midshipmen,TEAM,TOTAL,TOTAL,False,,23,47,16,32,7,15,11,18,4,34,38,13,0,3,28,25,64
401488092,Loyola Maryland Greyhounds,L. Therien,4900552,,True,33.0,8,14,8,14,0,0,3,5,2,9,11,1,2,0,4,5,19
401488092,Loyola Maryland Greyhounds,K. Ratigan,5109222,,True,35.0,3,9,0,3,3,6,4,4,1,2,3,1,2,0,1,0,13
401488092,Loyola Maryland Greyhounds,B. Rozzi,4596306,,True,33.0,2,5,2,3,0,2,1,2,0,2,2,3,0,0,3,4,5
401488092,Loyola Maryland Greyhounds,T. Dixon,4400209,,True,36.0,4,13,2,6,2,7,2,3,0,2,2,2,1,0,5,3,12
401488092,Loyola Maryland Greyhounds,D. Newman,4399474,,True,19.0,1,5,0,4,1,1,0,0,0,1,1,1,0,0,3,4,3
401488092,Loyola Maryland Greyhounds,M. Espinal,5109228,,False,11.0,1,1,1,1,0,0,0,0,2,0,2,0,0,0,1,3,2
401488092,Loyola Maryland Greyhounds,C. Garcia,5109224,,False,4.0,0,1,0,1,0,0,0,0,2,0,2,1,0,0,0,1,0
401488092,Loyola Maryland Greyhounds,L. Salmeron,4900549,,False,6.0,0,0,0,0,0,0,0,0,1,1,2,0,0,0,0,0,0
401488092,Loyola Maryland Greyhounds,C. Tanedo,4704774,,False,24.0,1,2,1,1,0,1,3,4,3,2,5,0,1,1,2,5,5
401488092,Loyola Maryland Greyhounds,TEAM,TOTAL,TOTAL,False,,20,50,14,33,6,17,13,18,13,23,36,9,6,1,21,25,59
401488092,Loyola Maryland Greyhounds,L. Therien,4900552,,True,33.0,8,14,8,14,0,0,3,5,2,9,11,1,2,0,4,5,19
401488092,Loyola Maryland Greyhounds,K. Ratigan,5109222,,True,35.0,3,9,0,3,3,6,4,4,1,2,3,1,2,0,1,0,13
401488092,Loyola Maryland Greyhounds,B. Rozzi,4596306,,True,33.0,2,5,2,3,0,2,1,2,0,2,2,3,0,0,3,4,5
401488092,Loyola Maryland Greyhounds,T. Dixon,4400209,,True,36.0,4,13,2,6,2,7,2,3,0,2,2,2,1,0,5,3,12
401488092,Loyola Maryland Greyhounds,D. Newman,4399474,,True,19.0,1,5,0,4,1,1,0,0,0,1,1,1,0,0,3,4,3
401488092,Loyola Maryland Greyhounds,M. Espinal,5109228,,False,11.0,1,1,1,1,0,0,0,0,2,0,2,0,0,0,1,3,2
401488092,Loyola Maryland Greyhounds,C. Garcia,5109224,,False,4.0,0,1,0,1,0,0,0,0,2,0,2,1,0,0,0,1,0
401488092,Loyola Maryland Greyhounds,L. Salmeron,4900549,,False,6.0,0,0,0,0,0,0,0,0,1,1,2,0,0,0,0,0,0
401488092,Loyola Maryland Greyhounds,C. Tanedo,4704774,,False,24.0,1,2,1,1,0,1,3,4,3,2,5,0,1,1,2,5,5
401488092,Loyola Maryland Greyhounds,TEAM,TOTAL,TOTAL,False,,20,50,14,33,6,17,13,18,13,23,36,9,6,1,21,25,59
401488092,American University Eagles,E. Johns,4704688,,True,31.0,6,12,6,11,0,1,7,8,3,3,6,2,0,1,2,1,19
401488092,American University Eagles,L. Stack,4595455,,True,39.0,3,7,3,7,0,0,6,8,3,2,5,2,4,2,0,2,12
401488092,American University Eagles,K. Henning,4704686,,True,24.0,1,4,1,3,0,1,0,0,1,1,2,3,1,0,1,4,2
401488092,American University Eagles,I. Bales,4704685,,True,34.0,6,10,6,9,0,1,1,2,0,5,5,4,1,1,5,2,13
401488092,American University Eagles,S. Stetson,4595453,,True,33.0,2,5,0,2,2,3,0,0,0,3,3,3,1,0,2,3,6
401488092,American University Eagles,M. Lavin,5109188,,False,9.0,1,2,1,2,0,0,0,0,0,2,2,0,0,0,0,0,2
401488092,American University Eagles,L. Nogues,5109187,,False,12.0,1,2,1,2,0,0,1,2,0,0,0,0,0,0,4,4,3
401488092,American University Eagles,A. LeMaster,4703737,,False,17.0,3,9,2,4,1,5,3,3,1,0,1,0,1,0,0,1,10
401488092,American University Eagles,TEAM,TOTAL,TOTAL,False,,23,51,20,40,3,11,18,23,8,20,28,14,8,4,14,17,67
401488092,American University Eagles,E. Johns,4704688,,True,31.0,6,12,6,11,0,1,7,8,3,3,6,2,0,1,2,1,19
401488092,American University Eagles,L. Stack,4595455,,True,39.0,3,7,3,7,0,0,6,8,3,2,5,2,4,2,0,2,12
401488092,American University Eagles,K. Henning,4704686,,True,24.0,1,4,1,3,0,1,0,0,1,1,2,3,1,0,1,4,2
401488092,American University Eagles,I. Bales,4704685,,True,34.0,6,10,6,9,0,1,1,2,0,5,5,4,1,1,5,2,13
401488092,American University Eagles,S. Stetson,4595453,,True,33.0,2,5,0,2,2,3,0,0,0,3,3,3,1,0,2,3,6
401488092,American University Eagles,M. Lavin,5109188,,False,9.0,1,2,1,2,0,0,0,0,0,2,2,0,0,0,0,0,2
401488092,American University Eagles,L. Nogues,5109187,,False,12.0,1,2,1,2,0,0,1,2,0,0,0,0,0,0,4,4,3
401488092,American University Eagles,A. LeMaster,4703737,,False,17.0,3,9,2,4,1,5,3,3,1,0,1,0,1,0,0,1,10
401488092,American University Eagles,TEAM,TOTAL,TOTAL,False,,23,51,20,40,3,11,18,23,8,20,28,14,8,4,14,17,67
401488091,Loyola Maryland Greyhounds,L. Therien,4900552,,True,29.0,2,10,2,10,0,0,3,5,6,7,13,1,1,0,3,4,7
401488091,Loyola Maryland Greyhounds,K. Ratigan,5109222,,True,34.0,3,6,2,4,1,2,2,2,0,3,3,2,1,0,2,4,9
401488091,Loyola Maryland Greyhounds,B. Rozzi,4596306,,True,39.0,4,10,3,5,1,5,0,0,2,3,5,2,2,0,3,4,9
401488091,Loyola Maryland Greyhounds,T. Dixon,4400209,,True,33.0,4,10,3,6,1,4,5,8,1,3,4,2,2,0,2,2,14
401488091,Loyola Maryland Greyhounds,D. Newman,4399474,,True,29.0,2,11,2,8,0,3,0,0,1,2,3,1,1,0,0,0,4
401488091,Loyola Maryland Greyhounds,M. Espinal,5109228,,False,10.0,1,2,1,2,0,0,3,4,0,0,0,0,0,0,1,3,5
401488091,Loyola Maryland Greyhounds,C. Garcia,5109224,,False,3.0,0,0,0,0,0,0,2,2,0,0,0,0,0,0,0,0,2
401488091,Loyola Maryland Greyhounds,L. Salmeron,4900549,,False,18.0,0,1,0,1,0,0,0,0,0,0,0,0,1,0,1,0,0
401488091,Loyola Maryland Greyhounds,C. Tanedo,4704774,,False,5.0,0,0,0,0,0,0,1,2,0,2,2,0,0,0,0,0,1
401488091,Loyola Maryland Greyhounds,TEAM,TOTAL,TOTAL,False,,16,50,13,36,3,14,16,23,11,23,34,8,8,0,14,17,51
401488091,Loyola Maryland Greyhounds,L. Therien,4900552,,True,29.0,2,10,2,10,0,0,3,5,6,7,13,1,1,0,3,4,7
401488091,Loyola Maryland Greyhounds,K. Ratigan,5109222,,True,34.0,3,6,2,4,1,2,2,2,0,3,3,2,1,0,2,4,9
401488091,Loyola Maryland Greyhounds,B. Rozzi,4596306,,True,39.0,4,10,3,5,1,5,0,0,2,3,5,2,2,0,3,4,9
401488091,Loyola Maryland Greyhounds,T. Dixon,4400209,,True,33.0,4,10,3,6,1,4,5,8,1,3,4,2,2,0,2,2,14
401488091,Loyola Maryland Greyhounds,D. Newman,4399474,,True,29.0,2,11,2,8,0,3,0,0,1,2,3,1,1,0,0,0,4
401488091,Loyola Maryland Greyhounds,M. Espinal,5109228,,False,10.0,1,2,1,2,0,0,3,4,0,0,0,0,0,0,1,3,5
401488091,Loyola Maryland Greyhounds,C. Garcia,5109224,,False,3.0,0,0,0,0,0,0,2,2,0,0,0,0,0,0,0,0,2
401488091,Loyola Maryland Greyhounds,L. Salmeron,4900549,,False,18.0,0,1,0,1,0,0,0,0,0,0,0,0,1,0,1,0,0
401488091,Loyola Maryland Greyhounds,C. Tanedo,4704774,,False,5.0,0,0,0,0,0,0,1,2,0,2,2,0,0,0,0,0,1
401488091,Loyola Maryland Greyhounds,TEAM,TOTAL,TOTAL,False,,16,50,13,36,3,14,16,23,11,23,34,8,8,0,14,17,51
401488091,Holy Cross Crusaders,L. Berger,4900539,,True,18.0,1,4,1,4,0,0,2,2,2,2,4,1,0,0,0,0,4
401488091,Holy Cross Crusaders,J. Allen,4704714,,True,25.0,2,4,2,4,0,0,0,0,1,5,6,1,0,2,1,4,4
401488091,Holy Cross Crusaders,K. Flanagan,5109211,,True,35.0,4,9,3,5,1,4,2,2,0,6,6,5,1,1,1,1,11
401488091,Holy Cross Crusaders,B. Power-Cassidy,4704715,,True,36.0,6,15,3,9,3,6,0,0,2,3,5,2,0,0,4,3,15
401488091,Holy Cross Crusaders,A. Cross,4595975,,True,34.0,1,3,1,2,0,1,0,0,0,2,2,6,0,0,0,1,2
401488091,Holy Cross Crusaders,C. Wright,4703660,,False,3.0,1,1,1,1,0,0,0,0,0,1,1,0,0,0,0,1,2
401488091,Holy Cross Crusaders,M. Donnelly,5109213,,False,4.0,0,1,0,0,0,1,0,0,0,1,1,1,0,0,1,1,0
401488091,Holy Cross Crusaders,S. Foreman,5109212,,False,18.0,3,8,3,8,0,0,1,2,1,1,2,0,0,0,1,0,7
401488091,Holy Cross Crusaders,G. Munt,4900537,,False,3.0,1,1,1,1,0,0,0,0,0,0,0,0,0,1,0,2,2
401488091,Holy Cross Crusaders,C. McCormack,4704716,,False,24.0,3,6,1,1,2,5,4,4,1,3,4,1,0,0,6,3,12
401488091,Holy Cross Crusaders,TEAM,TOTAL,TOTAL,False,,22,52,16,35,6,17,9,10,7,25,32,17,1,4,14,16,59
401488091,Holy Cross Crusaders,L. Berger,4900539,,True,18.0,1,4,1,4,0,0,2,2,2,2,4,1,0,0,0,0,4
401488091,Holy Cross Crusaders,J. Allen,4704714,,True,25.0,2,4,2,4,0,0,0,0,1,5,6,1,0,2,1,4,4
401488091,Holy Cross Crusaders,K. Flanagan,5109211,,True,35.0,4,9,3,5,1,4,2,2,0,6,6,5,1,1,1,1,11
401488091,Holy Cross Crusaders,B. Power-Cassidy,4704715,,True,36.0,6,15,3,9,3,6,0,0,2,3,5,2,0,0,4,3,15
401488091,Holy Cross Crusaders,A. Cross,4595975,,True,34.0,1,3,1,2,0,1,0,0,0,2,2,6,0,0,0,1,2
401488091,Holy Cross Crusaders,C. Wright,4703660,,False,3.0,1,1,1,1,0,0,0,0,0,1,1,0,0,0,0,1,2
401488091,Holy Cross Crusaders,M. Donnelly,5109213,,False,4.0,0,1,0,0,0,1,0,0,0,1,1,1,0,0,1,1,0
401488091,Holy Cross Crusaders,S. Foreman,5109212,,False,18.0,3,8,3,8,0,0,1,2,1,1,2,0,0,0,1,0,7
401488091,Holy Cross Crusaders,G. Munt,4900537,,False,3.0,1,1,1,1,0,0,0,0,0,0,0,0,0,1,0,2,2
401488091,Holy Cross Crusaders,C. McCormack,4704716,,False,24.0,3,6,1,1,2,5,4,4,1,3,4,1,0,0,6,3,12
401488091,Holy Cross Crusaders,TEAM,TOTAL,TOTAL,False,,22,52,16,35,6,17,9,10,7,25,32,17,1,4,14,16,59
401488090,Navy Midshipmen,M. Andrews,4704780,,True,25.0,0,0,0,0,0,0,0,0,1,2,3,0,1,0,0,1,0
401488090,Navy Midshipmen,L. Llewellyn,4595625,,True,24.0,4,8,4,6,0,2,1,2,0,2,2,3,4,0,3,3,9
401488090,Navy Midshipmen,S. Watts,4704782,,True,28.0,6,12,3,6,3,6,0,0,0,0,0,1,0,0,1,1,15
401488090,Navy Midshipmen,M. Louridas,5109236,,True,35.0,5,15,4,11,1,4,1,2,0,2,2,2,0,0,1,3,12
401488090,Navy Midshipmen,M. Schrader,4595622,,True,25.0,0,5,0,3,0,2,0,0,0,3,3,2,0,0,2,1,0
401488090,Navy Midshipmen,M. Demos,5109235,,False,7.0,0,0,0,0,0,0,0,0,1,1,2,0,0,1,0,0,0
401488090,Navy Midshipmen,K. Samson,5109237,,False,20.0,1,3,1,3,0,0,1,2,1,1,2,1,1,2,0,3,3
401488090,Navy Midshipmen,B. Coleman,5109233,,False,10.0,1,3,1,2,0,1,0,0,1,0,1,1,0,0,1,2,2
401488090,Navy Midshipmen,K. Giuliani,5109230,,False,9.0,1,2,1,1,0,1,0,0,0,0,0,1,1,0,3,1,2
401488090,Navy Midshipmen,S. Schofield,4704779,,False,17.0,3,8,2,3,1,5,0,0,0,0,0,0,0,0,1,1,7
401488090,Navy Midshipmen,TEAM,TOTAL,TOTAL,False,,21,56,16,35,5,21,3,6,5,12,17,11,7,3,12,16,50
401488090,Navy Midshipmen,M. Andrews,4704780,,True,25.0,0,0,0,0,0,0,0,0,1,2,3,0,1,0,0,1,0
401488090,Navy Midshipmen,L. Llewellyn,4595625,,True,24.0,4,8,4,6,0,2,1,2,0,2,2,3,4,0,3,3,9
401488090,Navy Midshipmen,S. Watts,4704782,,True,28.0,6,12,3,6,3,6,0,0,0,0,0,1,0,0,1,1,15
401488090,Navy Midshipmen,M. Louridas,5109236,,True,35.0,5,15,4,11,1,4,1,2,0,2,2,2,0,0,1,3,12
401488090,Navy Midshipmen,M. Schrader,4595622,,True,25.0,0,5,0,3,0,2,0,0,0,3,3,2,0,0,2,1,0
401488090,Navy Midshipmen,M. Demos,5109235,,False,7.0,0,0,0,0,0,0,0,0,1,1,2,0,0,1,0,0,0
401488090,Navy Midshipmen,K. Samson,5109237,,False,20.0,1,3,1,3,0,0,1,2,1,1,2,1,1,2,0,3,3
401488090,Navy Midshipmen,B. Coleman,5109233,,False,10.0,1,3,1,2,0,1,0,0,1,0,1,1,0,0,1,2,2
401488090,Navy Midshipmen,K. Giuliani,5109230,,False,9.0,1,2,1,1,0,1,0,0,0,0,0,1,1,0,3,1,2
401488090,Navy Midshipmen,S. Schofield,4704779,,False,17.0,3,8,2,3,1,5,0,0,0,0,0,0,0,0,1,1,7
401488090,Navy Midshipmen,TEAM,TOTAL,TOTAL,False,,21,56,16,35,5,21,3,6,5,12,17,11,7,3,12,16,50
401488090,Loyola Maryland Greyhounds,L. Therien,4900552,,True,31.0,7,10,7,10,0,0,10,10,3,12,15,1,4,0,7,3,24
401488090,Loyola Maryland Greyhounds,K. Ratigan,5109222,,True,29.0,3,5,1,1,2,4,0,0,0,3,3,1,0,0,2,2,8
401488090,Loyola Maryland Greyhounds,B. Rozzi,4596306,,True,33.0,2,4,2,3,0,1,2,4,0,5,5,3,0,0,1,0,6
401488090,Loyola Maryland Greyhounds,T. Dixon,4400209,,True,26.0,5,10,4,7,1,3,1,1,0,1,1,0,1,0,2,0,12
401488090,Loyola Maryland Greyhounds,D. Newman,4399474,,True,27.0,5,8,5,7,0,1,1,1,0,2,2,4,0,0,1,0,11
401488090,Loyola Maryland Greyhounds,M. Espinal,5109228,,False,9.0,0,0,0,0,0,0,0,0,0,2,2,0,0,0,0,1,0
401488090,Loyola Maryland Greyhounds,C. Orza,5109227,,False,2.0,0,1,0,1,0,0,0,0,0,0,0,0,0,0,0,1,0
401488090,Loyola Maryland Greyhounds,C. Garcia,5109224,,False,7.0,1,1,1,1,0,0,2,2,0,1,1,1,0,0,0,4,4
401488090,Loyola Maryland Greyhounds,M. Van-Otoo,5109223,,False,10.0,0,0,0,0,0,0,0,0,0,1,1,0,0,0,3,1,0
401488090,Loyola Maryland Greyhounds,L. Salmeron,4900549,,False,21.0,3,4,3,4,0,0,1,1,0,2,2,0,0,0,0,1,7
401488090,Loyola Maryland Greyhounds,C. Tanedo,4704774,,False,5.0,0,1,0,0,0,1,2,2,0,0,0,0,3,0,1,0,2
401488090,Loyola Maryland Greyhounds,TEAM,TOTAL,TOTAL,False,,26,44,23,34,3,10,19,21,4,30,34,10,8,0,20,13,74
401488090,Loyola Maryland Greyhounds,L. Therien,4900552,,True,31.0,7,10,7,10,0,0,10,10,3,12,15,1,4,0,7,3,24
401488090,Loyola Maryland Greyhounds,K. Ratigan,5109222,,True,29.0,3,5,1,1,2,4,0,0,0,3,3,1,0,0,2,2,8
401488090,Loyola Maryland Greyhounds,B. Rozzi,4596306,,True,33.0,2,4,2,3,0,1,2,4,0,5,5,3,0,0,1,0,6
401488090,Loyola Maryland Greyhounds,T. Dixon,4400209,,True,26.0,5,10,4,7,1,3,1,1,0,1,1,0,1,0,2,0,12
401488090,Loyola Maryland Greyhounds,D. Newman,4399474,,True,27.0,5,8,5,7,0,1,1,1,0,2,2,4,0,0,1,0,11
401488090,Loyola Maryland Greyhounds,M. Espinal,5109228,,False,9.0,0,0,0,0,0,0,0,0,0,2,2,0,0,0,0,1,0
401488090,Loyola Maryland Greyhounds,C. Orza,5109227,,False,2.0,0,1,0,1,0,0,0,0,0,0,0,0,0,0,0,1,0
401488090,Loyola Maryland Greyhounds,C. Garcia,5109224,,False,7.0,1,1,1,1,0,0,2,2,0,1,1,1,0,0,0,4,4
401488090,Loyola Maryland Greyhounds,M. Van-Otoo,5109223,,False,10.0,0,0,0,0,0,0,0,0,0,1,1,0,0,0,3,1,0
401488090,Loyola Maryland Greyhounds,L. Salmeron,4900549,,False,21.0,3,4,3,4,0,0,1,1,0,2,2,0,0,0,0,1,7
401488090,Loyola Maryland Greyhounds,C. Tanedo,4704774,,False,5.0,0,1,0,0,0,1,2,2,0,0,0,0,3,0,1,0,2
401488090,Loyola Maryland Greyhounds,TEAM,TOTAL,TOTAL,False,,26,44,23,34,3,10,19,21,4,30,34,10,8,0,20,13,74
401488089,Loyola Maryland Greyhounds,L. Therien,4900552,,True,33.0,7,14,7,13,0,1,3,3,6,14,20,2,0,0,3,3,17
401488089,Loyola Maryland Greyhounds,K. Ratigan,5109222,,True,35.0,2,6,0,2,2,4,3,4,3,3,6,3,1,0,1,2,9
401488089,Loyola Maryland Greyhounds,B. Rozzi,4596306,,True,33.0,4,9,4,6,0,3,2,2,2,5,7,3,3,0,2,1,10
401488089,Loyola Maryland Greyhounds,T. Dixon,4400209,,True,34.0,7,15,4,9,3,6,3,4,0,2,2,5,0,0,0,3,20
401488089,Loyola Maryland Greyhounds,D. Newman,4399474,,True,29.0,4,9,4,8,0,1,0,0,0,2,2,3,0,0,1,1,8
401488089,Loyola Maryland Greyhounds,M. Espinal,5109228,,False,9.0,1,2,1,2,0,0,0,0,1,0,1,0,0,0,1,1,2
401488089,Loyola Maryland Greyhounds,C. Garcia,5109224,,False,9.0,0,0,0,0,0,0,0,0,0,0,0,0,0,0,1,1,0
401488089,Loyola Maryland Greyhounds,M. Van-Otoo,5109223,,False,8.0,0,1,0,1,0,0,0,2,0,0,0,2,0,0,0,2,0
401488089,Loyola Maryland Greyhounds,L. Salmeron,4900549,,False,5.0,0,3,0,0,0,3,0,0,0,0,0,1,0,0,0,0,0
401488089,Loyola Maryland Greyhounds,C. Tanedo,4704774,,False,5.0,0,0,0,0,0,0,0,0,1,1,2,1,1,0,1,0,0
401488089,Loyola Maryland Greyhounds,TEAM,TOTAL,TOTAL,False,,25,59,20,41,5,18,11,15,13,27,40,20,5,0,10,14,66
401488089,Loyola Maryland Greyhounds,L. Therien,4900552,,True,33.0,7,14,7,13,0,1,3,3,6,14,20,2,0,0,3,3,17
401488089,Loyola Maryland Greyhounds,K. Ratigan,5109222,,True,35.0,2,6,0,2,2,4,3,4,3,3,6,3,1,0,1,2,9
401488089,Loyola Maryland Greyhounds,B. Rozzi,4596306,,True,33.0,4,9,4,6,0,3,2,2,2,5,7,3,3,0,2,1,10
401488089,Loyola Maryland Greyhounds,T. Dixon,4400209,,True,34.0,7,15,4,9,3,6,3,4,0,2,2,5,0,0,0,3,20
401488089,Loyola Maryland Greyhounds,D. Newman,4399474,,True,29.0,4,9,4,8,0,1,0,0,0,2,2,3,0,0,1,1,8
401488089,Loyola Maryland Greyhounds,M. Espinal,5109228,,False,9.0,1,2,1,2,0,0,0,0,1,0,1,0,0,0,1,1,2
401488089,Loyola Maryland Greyhounds,C. Garcia,5109224,,False,9.0,0,0,0,0,0,0,0,0,0,0,0,0,0,0,1,1,0
401488089,Loyola Maryland Greyhounds,M. Van-Otoo,5109223,,False,8.0,0,1,0,1,0,0,0,2,0,0,0,2,0,0,0,2,0
401488089,Loyola Maryland Greyhounds,L. Salmeron,4900549,,False,5.0,0,3,0,0,0,3,0,0,0,0,0,1,0,0,0,0,0
401488089,Loyola Maryland Greyhounds,C. Tanedo,4704774,,False,5.0,0,0,0,0,0,0,0,0,1,1,2,1,1,0,1,0,0
401488089,Loyola Maryland Greyhounds,TEAM,TOTAL,TOTAL,False,,25,59,20,41,5,18,11,15,13,27,40,20,5,0,10,14,66
401488089,Lafayette Leopards,A. Matthews,4703689,,True,24.0,2,2,2,2,0,0,0,0,0,3,3,0,0,2,0,0,4
401488089,Lafayette Leopards,S. Ntaconayigize,5109216,,True,32.0,2,3,1,1,1,2,0,0,0,4,4,4,1,1,0,0,5
401488089,Lafayette Leopards,A. Antognoli,4900540,,True,28.0,3,9,2,6,1,3,4,4,3,1,4,1,1,0,4,3,11
401488089,Lafayette Leopards,M. Andrews,4704756,,True,34.0,7,14,7,13,0,1,2,2,2,6,8,2,0,0,5,4,16
401488089,Lafayette Leopards,H. Smith,4704553,,True,36.0,4,10,4,8,0,2,0,0,0,3,3,4,1,0,1,1,8
401488089,Lafayette Leopards,K. Donahue,5109215,,False,15.0,3,7,1,5,2,2,0,0,0,2,2,0,0,0,0,3,8
401488089,Lafayette Leopards,K. Favours,4900541,,False,31.0,1,8,0,3,1,5,0,2,0,1,1,4,3,0,1,2,3
401488089,Lafayette Leopards,TEAM,TOTAL,TOTAL,False,,22,53,17,38,5,15,6,8,5,22,27,15,6,3,11,13,55
401488089,Lafayette Leopards,A. Matthews,4703689,,True,24.0,2,2,2,2,0,0,0,0,0,3,3,0,0,2,0,0,4
401488089,Lafayette Leopards,S. Ntaconayigize,5109216,,True,32.0,2,3,1,1,1,2,0,0,0,4,4,4,1,1,0,0,5
401488089,Lafayette Leopards,A. Antognoli,4900540,,True,28.0,3,9,2,6,1,3,4,4,3,1,4,1,1,0,4,3,11
401488089,Lafayette Leopards,M. Andrews,4704756,,True,34.0,7,14,7,13,0,1,2,2,2,6,8,2,0,0,5,4,16
401488089,Lafayette Leopards,H. Smith,4704553,,True,36.0,4,10,4,8,0,2,0,0,0,3,3,4,1,0,1,1,8
401488089,Lafayette Leopards,K. Donahue,5109215,,False,15.0,3,7,1,5,2,2,0,0,0,2,2,0,0,0,0,3,8
401488089,Lafayette Leopards,K. Favours,4900541,,False,31.0,1,8,0,3,1,5,0,2,0,1,1,4,3,0,1,2,3
401488089,Lafayette Leopards,TEAM,TOTAL,TOTAL,False,,22,53,17,38,5,15,6,8,5,22,27,15,6,3,11,13,55
401488088,Loyola Maryland Greyhounds,L. Therien,4900552,,True,32.0,9,11,9,11,0,0,4,9,3,9,12,2,2,0,2,4,22
401488088,Loyola Maryland Greyhounds,K. Ratigan,5109222,,True,33.0,3,7,1,3,2,4,2,2,0,3,3,3,0,0,2,3,10
401488088,Loyola Maryland Greyhounds,B. Rozzi,4596306,,True,39.0,2,7,1,4,1,3,1,2,1,3,4,3,2,0,1,2,6
401488088,Loyola Maryland Greyhounds,T. Dixon,4400209,,True,29.0,4,18,2,12,2,6,4,4,0,1,1,1,3,0,4,4,14
401488088,Loyola Maryland Greyhounds,D. Newman,4399474,,True,27.0,2,10,1,6,1,4,1,2,2,2,4,2,1,0,3,5,6
401488088,Loyola Maryland Greyhounds,M. Espinal,5109228,,False,5.0,0,0,0,0,0,0,0,0,0,2,2,0,0,0,0,1,0
401488088,Loyola Maryland Greyhounds,C. Garcia,5109224,,False,25.0,0,3,0,2,0,1,1,2,3,2,5,0,0,1,1,3,1
401488088,Loyola Maryland Greyhounds,M. Van-Otoo,5109223,,False,1.0,0,1,0,0,0,1,0,0,0,1,1,0,0,0,0,0,0
401488088,Loyola Maryland Greyhounds,L. Salmeron,4900549,,False,5.0,0,1,0,0,0,1,0,0,0,2,2,0,0,0,1,0,0
401488088,Loyola Maryland Greyhounds,C. Tanedo,4704774,,False,4.0,0,0,0,0,0,0,0,0,0,0,0,1,0,0,0,0,0
401488088,Loyola Maryland Greyhounds,TEAM,TOTAL,TOTAL,False,,20,58,14,38,6,20,13,21,11,26,37,12,8,1,14,22,59
401488088,Loyola Maryland Greyhounds,L. Therien,4900552,,True,32.0,9,11,9,11,0,0,4,9,3,9,12,2,2,0,2,4,22
401488088,Loyola Maryland Greyhounds,K. Ratigan,5109222,,True,33.0,3,7,1,3,2,4,2,2,0,3,3,3,0,0,2,3,10
401488088,Loyola Maryland Greyhounds,B. Rozzi,4596306,,True,39.0,2,7,1,4,1,3,1,2,1,3,4,3,2,0,1,2,6
401488088,Loyola Maryland Greyhounds,T. Dixon,4400209,,True,29.0,4,18,2,12,2,6,4,4,0,1,1,1,3,0,4,4,14
401488088,Loyola Maryland Greyhounds,D. Newman,4399474,,True,27.0,2,10,1,6,1,4,1,2,2,2,4,2,1,0,3,5,6
401488088,Loyola Maryland Greyhounds,M. Espinal,5109228,,False,5.0,0,0,0,0,0,0,0,0,0,2,2,0,0,0,0,1,0
401488088,Loyola Maryland Greyhounds,C. Garcia,5109224,,False,25.0,0,3,0,2,0,1,1,2,3,2,5,0,0,1,1,3,1
401488088,Loyola Maryland Greyhounds,M. Van-Otoo,5109223,,False,1.0,0,1,0,0,0,1,0,0,0,1,1,0,0,0,0,0,0
401488088,Loyola Maryland Greyhounds,L. Salmeron,4900549,,False,5.0,0,1,0,0,0,1,0,0,0,2,2,0,0,0,1,0,0
401488088,Loyola Maryland Greyhounds,C. Tanedo,4704774,,False,4.0,0,0,0,0,0,0,0,0,0,0,0,1,0,0,0,0,0
401488088,Loyola Maryland Greyhounds,TEAM,TOTAL,TOTAL,False,,20,58,14,38,6,20,13,21,11,26,37,12,8,1,14,22,59
401488088,Lehigh Mountain Hawks,L. Fandre,5109220,,True,27.0,4,10,2,4,2,6,0,2,2,6,8,2,0,1,1,4,10
401488088,Lehigh Mountain Hawks,F. Hottinger,4595613,,True,39.0,7,21,6,15,1,6,13,17,2,11,13,3,1,0,2,0,28
401488088,Lehigh Mountain Hawks,K. Van Eps,4900545,,True,24.0,0,0,0,0,0,0,2,2,0,2,2,2,1,0,1,3,2
401488088,Lehigh Mountain Hawks,E. Stemmer,4900544,,True,32.0,1,5,0,0,1,5,4,4,0,1,1,0,0,0,1,1,7
401488088,Lehigh Mountain Hawks,A. Harvey,4595612,,True,39.0,3,6,0,1,3,5,0,0,0,4,4,5,2,0,2,3,9
401488088,Lehigh Mountain Hawks,M. O'Brien,4900547,,False,5.0,0,0,0,0,0,0,0,0,0,0,0,0,0,0,1,1,0
401488088,Lehigh Mountain Hawks,M. Albrecht,4704763,,False,13.0,1,2,1,2,0,0,1,2,1,0,1,0,0,0,1,1,3
401488088,Lehigh Mountain Hawks,F. Eggenschwiler,4704761,,False,2.0,0,0,0,0,0,0,0,0,0,0,0,0,0,0,1,0,0
401488088,Lehigh Mountain Hawks,J. Behar,4433782,,False,18.0,3,7,1,2,2,5,0,0,0,2,2,1,0,1,2,2,8
401488088,Lehigh Mountain Hawks,TEAM,TOTAL,TOTAL,False,,19,51,10,24,9,27,20,27,8,28,36,13,4,2,13,15,67
401488088,Lehigh Mountain Hawks,L. Fandre,5109220,,True,27.0,4,10,2,4,2,6,0,2,2,6,8,2,0,1,1,4,10
401488088,Lehigh Mountain Hawks,F. Hottinger,4595613,,True,39.0,7,21,6,15,1,6,13,17,2,11,13,3,1,0,2,0,28
401488088,Lehigh Mountain Hawks,K. Van Eps,4900545,,True,24.0,0,0,0,0,0,0,2,2,0,2,2,2,1,0,1,3,2
401488088,Lehigh Mountain Hawks,E. Stemmer,4900544,,True,32.0,1,5,0,0,1,5,4,4,0,1,1,0,0,0,1,1,7
401488088,Lehigh Mountain Hawks,A. Harvey,4595612,,True,39.0,3,6,0,1,3,5,0,0,0,4,4,5,2,0,2,3,9
401488088,Lehigh Mountain Hawks,M. O'Brien,4900547,,False,5.0,0,0,0,0,0,0,0,0,0,0,0,0,0,0,1,1,0
401488088,Lehigh Mountain Hawks,M. Albrecht,4704763,,False,13.0,1,2,1,2,0,0,1,2,1,0,1,0,0,0,1,1,3
401488088,Lehigh Mountain Hawks,F. Eggenschwiler,4704761,,False,2.0,0,0,0,0,0,0,0,0,0,0,0,0,0,0,1,0,0
401488088,Lehigh Mountain Hawks,J. Behar,4433782,,False,18.0,3,7,1,2,2,5,0,0,0,2,2,1,0,1,2,2,8
401488088,Lehigh Mountain Hawks,TEAM,TOTAL,TOTAL,False,,19,51,10,24,9,27,20,27,8,28,36,13,4,2,13,15,67
401488087,Loyola Maryland Greyhounds,L. Therien,4900552,,True,27.0,6,14,6,13,0,1,2,3,6,5,11,0,0,1,2,4,14
401488087,Loyola Maryland Greyhounds,K. Ratigan,5109222,,True,21.0,1,4,1,3,0,1,0,0,0,2,2,1,0,0,2,0,2
401488087,Loyola Maryland Greyhounds,B. Rozzi,4596306,,True,20.0,2,4,0,2,2,2,0,0,0,1,1,2,0,0,4,2,6
401488087,Loyola Maryland Greyhounds,T. Dixon,4400209,,True,25.0,1,10,1,6,0,4,5,6,0,2,2,3,0,0,3,3,7
401488087,Loyola Maryland Greyhounds,D. Newman,4399474,,True,16.0,1,3,1,2,0,1,0,0,0,0,0,0,0,0,0,2,2
401488087,Loyola Maryland Greyhounds,M. Espinal,5109228,,False,21.0,0,0,0,0,0,0,0,0,0,2,2,0,0,1,4,4,0
401488087,Loyola Maryland Greyhounds,C. Orza,5109227,,False,5.0,0,1,0,0,0,1,0,0,0,0,0,0,0,0,1,0,0
401488087,Loyola Maryland Greyhounds,C. Garcia,5109224,,False,19.0,0,2,0,2,0,0,0,0,2,0,2,0,0,0,1,2,0
401488087,Loyola Maryland Greyhounds,M. Van-Otoo,5109223,,False,11.0,1,4,1,4,0,0,0,2,0,1,1,0,0,0,0,1,2
401488087,Loyola Maryland Greyhounds,L. Salmeron,4900549,,False,25.0,2,6,2,5,0,1,0,0,0,3,3,0,4,0,2,0,4
401488087,Loyola Maryland Greyhounds,C. Tanedo,4704774,,False,9.0,0,1,0,1,0,0,0,0,2,0,2,1,0,0,0,0,0
401488087,Loyola Maryland Greyhounds,TEAM,TOTAL,TOTAL,False,,14,49,12,38,2,11,7,11,11,16,27,7,4,2,20,18,37
401488087,Loyola Maryland Greyhounds,L. Therien,4900552,,True,27.0,6,14,6,13,0,1,2,3,6,5,11,0,0,1,2,4,14
401488087,Loyola Maryland Greyhounds,K. Ratigan,5109222,,True,21.0,1,4,1,3,0,1,0,0,0,2,2,1,0,0,2,0,2
401488087,Loyola Maryland Greyhounds,B. Rozzi,4596306,,True,20.0,2,4,0,2,2,2,0,0,0,1,1,2,0,0,4,2,6
401488087,Loyola Maryland Greyhounds,T. Dixon,4400209,,True,25.0,1,10,1,6,0,4,5,6,0,2,2,3,0,0,3,3,7
401488087,Loyola Maryland Greyhounds,D. Newman,4399474,,True,16.0,1,3,1,2,0,1,0,0,0,0,0,0,0,0,0,2,2
401488087,Loyola Maryland Greyhounds,M. Espinal,5109228,,False,21.0,0,0,0,0,0,0,0,0,0,2,2,0,0,1,4,4,0
401488087,Loyola Maryland Greyhounds,C. Orza,5109227,,False,5.0,0,1,0,0,0,1,0,0,0,0,0,0,0,0,1,0,0
401488087,Loyola Maryland Greyhounds,C. Garcia,5109224,,False,19.0,0,2,0,2,0,0,0,0,2,0,2,0,0,0,1,2,0
401488087,Loyola Maryland Greyhounds,M. Van-Otoo,5109223,,False,11.0,1,4,1,4,0,0,0,2,0,1,1,0,0,0,0,1,2
401488087,Loyola Maryland Greyhounds,L. Salmeron,4900549,,False,25.0,2,6,2,5,0,1,0,0,0,3,3,0,4,0,2,0,4
401488087,Loyola Maryland Greyhounds,C. Tanedo,4704774,,False,9.0,0,1,0,1,0,0,0,0,2,0,2,1,0,0,0,0,0
401488087,Loyola Maryland Greyhounds,TEAM,TOTAL,TOTAL,False,,14,49,12,38,2,11,7,11,11,16,27,7,4,2,20,18,37
401488087,Bucknell Bison,I. King,4900533,,True,34.0,7,10,4,5,3,5,2,2,0,2,2,4,2,0,1,0,19
401488087,Bucknell Bison,E. Shaffer,4595535,,True,27.0,6,7,6,7,0,0,7,10,4,6,10,3,0,0,0,0,19
401488087,Bucknell Bison,E. Theodorsson,5109199,,True,18.0,3,9,1,5,2,4,2,2,0,4,4,1,1,0,1,3,10
401488087,Bucknell Bison,T. Johnson,4595533,,True,35.0,2,4,2,2,0,2,2,4,1,3,4,4,1,0,2,0,6
401488087,Bucknell Bison,C. Dingler,4577540,,True,13.0,0,0,0,0,0,0,0,0,0,2,2,1,0,0,0,0,0
401488087,Bucknell Bison,G. Klag,5109202,,False,2.0,0,0,0,0,0,0,0,0,0,0,0,0,0,0,1,0,0
401488087,Bucknell Bison,G. Sullivan,5109201,,False,11.0,1,4,1,4,0,0,2,2,2,2,4,0,0,1,4,3,4
401488087,Bucknell Bison,N. Davis,4704701,,False,2.0,0,1,0,0,0,1,0,0,0,0,0,0,0,0,0,1,0
401488087,Bucknell Bison,K. Reinbeau,4704700,,False,5.0,1,1,0,0,1,1,0,0,0,1,1,1,0,0,0,0,3
401488087,Bucknell Bison,R. Sisselman,4900531,,False,28.0,3,9,1,5,2,4,0,0,2,1,3,1,1,0,1,0,8
401488087,Bucknell Bison,J. Kulesza,4704702,,False,24.0,0,2,0,1,0,1,4,4,0,3,3,3,0,0,0,3,4
401488087,Bucknell Bison,TEAM,TOTAL,TOTAL,False,,23,47,15,29,8,18,19,24,10,25,35,18,5,1,10,10,73
401488087,Bucknell Bison,I. King,4900533,,True,34.0,7,10,4,5,3,5,2,2,0,2,2,4,2,0,1,0,19
401488087,Bucknell Bison,E. Shaffer,4595535,,True,27.0,6,7,6,7,0,0,7,10,4,6,10,3,0,0,0,0,19
401488087,Bucknell Bison,E. Theodorsson,5109199,,True,18.0,3,9,1,5,2,4,2,2,0,4,4,1,1,0,1,3,10
401488087,Bucknell Bison,T. Johnson,4595533,,True,35.0,2,4,2,2,0,2,2,4,1,3,4,4,1,0,2,0,6
401488087,Bucknell Bison,C. Dingler,4577540,,True,13.0,0,0,0,0,0,0,0,0,0,2,2,1,0,0,0,0,0
401488087,Bucknell Bison,G. Klag,5109202,,False,2.0,0,0,0,0,0,0,0,0,0,0,0,0,0,0,1,0,0
401488087,Bucknell Bison,G. Sullivan,5109201,,False,11.0,1,4,1,4,0,0,2,2,2,2,4,0,0,1,4,3,4
401488087,Bucknell Bison,N. Davis,4704701,,False,2.0,0,1,0,0,0,1,0,0,0,0,0,0,0,0,0,1,0
401488087,Bucknell Bison,K. Reinbeau,4704700,,False,5.0,1,1,0,0,1,1,0,0,0,1,1,1,0,0,0,0,3
401488087,Bucknell Bison,R. Sisselman,4900531,,False,28.0,3,9,1,5,2,4,0,0,2,1,3,1,1,0,1,0,8
401488087,Bucknell Bison,J. Kulesza,4704702,,False,24.0,0,2,0,1,0,1,4,4,0,3,3,3,0,0,0,3,4
401488087,Bucknell Bison,TEAM,TOTAL,TOTAL,False,,23,47,15,29,8,18,19,24,10,25,35,18,5,1,10,10,73
401488086,Loyola Maryland Greyhounds,L. Therien,4900552,,True,37.0,2,8,2,7,0,1,6,10,5,11,16,1,1,0,6,4,10
401488086,Loyola Maryland Greyhounds,K. Sims,4898948,,True,10.0,2,4,2,4,0,0,0,0,1,1,2,0,1,2,1,0,4
401488086,Loyola Maryland Greyhounds,K. Ratigan,5109222,,True,25.0,1,4,0,0,1,4,0,0,0,2,2,1,0,0,2,0,3
401488086,Loyola Maryland Greyhounds,B. Rozzi,4596306,,True,33.0,1,8,1,4,0,4,0,0,2,5,7,5,1,0,2,0,2
401488086,Loyola Maryland Greyhounds,T. Dixon,4400209,,True,33.0,4,11,4,9,0,2,2,2,0,2,2,0,2,0,3,1,10
401488086,Loyola Maryland Greyhounds,E. Glezen,4596304,,False,7.0,0,0,0,0,0,0,0,2,0,0,0,0,1,0,1,4,0
401488086,Loyola Maryland Greyhounds,C. Garcia,5109224,,False,16.0,1,5,1,4,0,1,0,0,3,3,6,0,1,0,0,3,2
401488086,Loyola Maryland Greyhounds,M. Van-Otoo,5109223,,False,2.0,0,0,0,0,0,0,0,0,0,0,0,0,0,0,0,0,0
401488086,Loyola Maryland Greyhounds,L. Salmeron,4900549,,False,5.0,0,0,0,0,0,0,0,0,0,0,0,0,0,0,0,0,0
401488086,Loyola Maryland Greyhounds,C. Tanedo,4704774,,False,7.0,0,0,0,0,0,0,0,0,0,0,0,1,1,0,0,0,0
401488086,Loyola Maryland Greyhounds,D. Newman,4399474,,False,25.0,2,6,2,5,0,1,0,0,0,0,0,0,0,0,2,2,4
401488086,Loyola Maryland Greyhounds,TEAM,TOTAL,TOTAL,False,,13,46,12,33,1,13,8,14,13,27,40,8,8,2,17,14,35
401488086,Loyola Maryland Greyhounds,L. Therien,4900552,,True,37.0,2,8,2,7,0,1,6,10,5,11,16,1,1,0,6,4,10
401488086,Loyola Maryland Greyhounds,K. Sims,4898948,,True,10.0,2,4,2,4,0,0,0,0,1,1,2,0,1,2,1,0,4
401488086,Loyola Maryland Greyhounds,K. Ratigan,5109222,,True,25.0,1,4,0,0,1,4,0,0,0,2,2,1,0,0,2,0,3
401488086,Loyola Maryland Greyhounds,B. Rozzi,4596306,,True,33.0,1,8,1,4,0,4,0,0,2,5,7,5,1,0,2,0,2
401488086,Loyola Maryland Greyhounds,T. Dixon,4400209,,True,33.0,4,11,4,9,0,2,2,2,0,2,2,0,2,0,3,1,10
401488086,Loyola Maryland Greyhounds,E. Glezen,4596304,,False,7.0,0,0,0,0,0,0,0,2,0,0,0,0,1,0,1,4,0
401488086,Loyola Maryland Greyhounds,C. Garcia,5109224,,False,16.0,1,5,1,4,0,1,0,0,3,3,6,0,1,0,0,3,2
401488086,Loyola Maryland Greyhounds,M. Van-Otoo,5109223,,False,2.0,0,0,0,0,0,0,0,0,0,0,0,0,0,0,0,0,0
401488086,Loyola Maryland Greyhounds,L. Salmeron,4900549,,False,5.0,0,0,0,0,0,0,0,0,0,0,0,0,0,0,0,0,0
401488086,Loyola Maryland Greyhounds,C. Tanedo,4704774,,False,7.0,0,0,0,0,0,0,0,0,0,0,0,1,1,0,0,0,0
401488086,Loyola Maryland Greyhounds,D. Newman,4399474,,False,25.0,2,6,2,5,0,1,0,0,0,0,0,0,0,0,2,2,4
401488086,Loyola Maryland Greyhounds,TEAM,TOTAL,TOTAL,False,,13,46,12,33,1,13,8,14,13,27,40,8,8,2,17,14,35
401488086,Lafayette Leopards,K. Drummond,4704754,,True,19.0,0,2,0,2,0,0,0,0,2,2,4,0,0,0,0,4,0
401488086,Lafayette Leopards,K. Favours,4900541,,True,37.0,3,6,1,3,2,3,1,3,0,3,3,3,0,0,3,2,9
401488086,Lafayette Leopards,A. Antognoli,4900540,,True,39.0,3,11,3,7,0,4,2,3,0,1,1,2,0,1,4,0,8
401488086,Lafayette Leopards,M. Andrews,4704756,,True,26.0,5,8,5,8,0,0,3,4,0,6,6,1,0,1,4,4,13
401488086,Lafayette Leopards,H. Smith,4704553,,True,31.0,2,9,2,7,0,2,0,0,0,2,2,2,2,2,1,3,4
401488086,Lafayette Leopards,A. Matthews,4703689,,False,21.0,1,2,1,2,0,0,0,0,1,1,2,1,0,1,0,2,2
401488086,Lafayette Leopards,S. Ntaconayigize,5109216,,False,20.0,0,4,0,2,0,2,0,0,1,0,1,1,0,1,1,0,0
401488086,Lafayette Leopards,K. Donahue,5109215,,False,7.0,1,2,0,1,1,1,0,0,0,1,1,0,0,0,1,2,3
401488086,Lafayette Leopards,TEAM,TOTAL,TOTAL,False,,15,44,12,32,3,12,6,10,4,20,24,10,2,6,15,17,39
401488086,Lafayette Leopards,K. Drummond,4704754,,True,19.0,0,2,0,2,0,0,0,0,2,2,4,0,0,0,0,4,0
401488086,Lafayette Leopards,K. Favours,4900541,,True,37.0,3,6,1,3,2,3,1,3,0,3,3,3,0,0,3,2,9
401488086,Lafayette Leopards,A. Antognoli,4900540,,True,39.0,3,11,3,7,0,4,2,3,0,1,1,2,0,1,4,0,8
401488086,Lafayette Leopards,M. Andrews,4704756,,True,26.0,5,8,5,8,0,0,3,4,0,6,6,1,0,1,4,4,13
401488086,Lafayette Leopards,H. Smith,4704553,,True,31.0,2,9,2,7,0,2,0,0,0,2,2,2,2,2,1,3,4
401488086,Lafayette Leopards,A. Matthews,4703689,,False,21.0,1,2,1,2,0,0,0,0,1,1,2,1,0,1,0,2,2
401488086,Lafayette Leopards,S. Ntaconayigize,5109216,,False,20.0,0,4,0,2,0,2,0,0,1,0,1,1,0,1,1,0,0
401488086,Lafayette Leopards,K. Donahue,5109215,,False,7.0,1,2,0,1,1,1,0,0,0,1,1,0,0,0,1,2,3
401488086,Lafayette Leopards,TEAM,TOTAL,TOTAL,False,,15,44,12,32,3,12,6,10,4,20,24,10,2,6,15,17,39
401488085,Loyola Maryland Greyhounds,L. Therien,4900552,,True,39.0,12,20,12,20,0,0,4,6,6,9,15,1,0,0,6,4,28
401488085,Loyola Maryland Greyhounds,K. Sims,4898948,,True,27.0,1,4,1,4,0,0,1,2,3,9,12,4,0,1,2,4,3
401488085,Loyola Maryland Greyhounds,C. Garcia,5109224,,True,19.0,0,5,0,5,0,0,1,2,3,3,6,1,0,0,4,2,1
401488085,Loyola Maryland Greyhounds,K. Ratigan,5109222,,True,37.0,1,6,0,2,1,4,0,0,3,4,7,1,0,0,2,2,3
401488085,Loyola Maryland Greyhounds,T. Dixon,4400209,,True,31.0,5,21,3,14,2,7,2,2,0,1,1,4,2,0,2,2,14
401488085,Loyola Maryland Greyhounds,L. Salmeron,4900549,,False,5.0,0,0,0,0,0,0,0,0,0,1,1,0,0,0,0,1,0
401488085,Loyola Maryland Greyhounds,C. Tanedo,4704774,,False,11.0,0,2,0,1,0,1,0,0,2,0,2,0,0,0,0,1,0
401488085,Loyola Maryland Greyhounds,B. Rozzi,4596306,,False,31.0,4,8,2,2,2,6,0,0,0,1,1,0,0,0,3,4,10
401488085,Loyola Maryland Greyhounds,D. Newman,4399474,,False,25.0,2,5,2,4,0,1,2,2,0,1,1,4,0,0,1,2,6
401488085,Loyola Maryland Greyhounds,TEAM,TOTAL,TOTAL,False,,25,71,20,52,5,19,10,14,23,29,52,15,2,1,21,22,65
401488085,Loyola Maryland Greyhounds,L. Therien,4900552,,True,39.0,12,20,12,20,0,0,4,6,6,9,15,1,0,0,6,4,28
401488085,Loyola Maryland Greyhounds,K. Sims,4898948,,True,27.0,1,4,1,4,0,0,1,2,3,9,12,4,0,1,2,4,3
401488085,Loyola Maryland Greyhounds,C. Garcia,5109224,,True,19.0,0,5,0,5,0,0,1,2,3,3,6,1,0,0,4,2,1
401488085,Loyola Maryland Greyhounds,K. Ratigan,5109222,,True,37.0,1,6,0,2,1,4,0,0,3,4,7,1,0,0,2,2,3
401488085,Loyola Maryland Greyhounds,T. Dixon,4400209,,True,31.0,5,21,3,14,2,7,2,2,0,1,1,4,2,0,2,2,14
401488085,Loyola Maryland Greyhounds,L. Salmeron,4900549,,False,5.0,0,0,0,0,0,0,0,0,0,1,1,0,0,0,0,1,0
401488085,Loyola Maryland Greyhounds,C. Tanedo,4704774,,False,11.0,0,2,0,1,0,1,0,0,2,0,2,0,0,0,0,1,0
401488085,Loyola Maryland Greyhounds,B. Rozzi,4596306,,False,31.0,4,8,2,2,2,6,0,0,0,1,1,0,0,0,3,4,10
401488085,Loyola Maryland Greyhounds,D. Newman,4399474,,False,25.0,2,5,2,4,0,1,2,2,0,1,1,4,0,0,1,2,6
401488085,Loyola Maryland Greyhounds,TEAM,TOTAL,TOTAL,False,,25,71,20,52,5,19,10,14,23,29,52,15,2,1,21,22,65
401488085,Lehigh Mountain Hawks,L. Fandre,5109220,,True,30.0,1,4,0,1,1,3,8,8,1,6,7,6,1,2,1,0,11
401488085,Lehigh Mountain Hawks,F. Hottinger,4595613,,True,34.0,5,11,5,7,0,4,5,6,0,4,4,2,2,0,3,5,15
401488085,Lehigh Mountain Hawks,E. Stemmer,4900544,,True,29.0,2,5,0,1,2,4,1,2,2,3,5,2,1,0,2,1,7
401488085,Lehigh Mountain Hawks,M. Kramer,4704762,,True,35.0,7,15,3,6,4,9,3,4,0,0,0,2,1,0,5,1,21
401488085,Lehigh Mountain Hawks,A. Harvey,4595612,,True,36.0,2,7,2,3,0,4,2,2,0,2,2,2,1,0,1,0,6
401488085,Lehigh Mountain Hawks,M. O'Brien,4900547,,False,14.0,2,4,1,3,1,1,0,0,0,2,2,0,0,0,0,1,5
401488085,Lehigh Mountain Hawks,K. Van Eps,4900545,,False,11.0,0,2,0,1,0,1,0,0,0,0,0,0,0,0,1,2,0
401488085,Lehigh Mountain Hawks,M. Albrecht,4704763,,False,17.0,1,2,1,1,0,1,0,0,0,2,2,2,0,1,2,2,2
401488085,Lehigh Mountain Hawks,F. Eggenschwiler,4704761,,False,5.0,0,1,0,0,0,1,0,0,0,0,0,0,0,0,0,0,0
401488085,Lehigh Mountain Hawks,J. Behar,4433782,,False,13.0,1,2,0,0,1,2,2,2,0,3,3,0,0,0,3,2,5
401488085,Lehigh Mountain Hawks,TEAM,TOTAL,TOTAL,False,,21,53,12,23,9,30,21,24,5,25,30,16,6,3,18,14,72
401488085,Lehigh Mountain Hawks,L. Fandre,5109220,,True,30.0,1,4,0,1,1,3,8,8,1,6,7,6,1,2,1,0,11
401488085,Lehigh Mountain Hawks,F. Hottinger,4595613,,True,34.0,5,11,5,7,0,4,5,6,0,4,4,2,2,0,3,5,15
401488085,Lehigh Mountain Hawks,E. Stemmer,4900544,,True,29.0,2,5,0,1,2,4,1,2,2,3,5,2,1,0,2,1,7
401488085,Lehigh Mountain Hawks,M. Kramer,4704762,,True,35.0,7,15,3,6,4,9,3,4,0,0,0,2,1,0,5,1,21
401488085,Lehigh Mountain Hawks,A. Harvey,4595612,,True,36.0,2,7,2,3,0,4,2,2,0,2,2,2,1,0,1,0,6
401488085,Lehigh Mountain Hawks,M. O'Brien,4900547,,False,14.0,2,4,1,3,1,1,0,0,0,2,2,0,0,0,0,1,5
401488085,Lehigh Mountain Hawks,K. Van Eps,4900545,,False,11.0,0,2,0,1,0,1,0,0,0,0,0,0,0,0,1,2,0
401488085,Lehigh Mountain Hawks,M. Albrecht,4704763,,False,17.0,1,2,1,1,0,1,0,0,0,2,2,2,0,1,2,2,2
401488085,Lehigh Mountain Hawks,F. Eggenschwiler,4704761,,False,5.0,0,1,0,0,0,1,0,0,0,0,0,0,0,0,0,0,0
401488085,Lehigh Mountain Hawks,J. Behar,4433782,,False,13.0,1,2,0,0,1,2,2,2,0,3,3,0,0,0,3,2,5
401488085,Lehigh Mountain Hawks,TEAM,TOTAL,TOTAL,False,,21,53,12,23,9,30,21,24,5,25,30,16,6,3,18,14,72
401488084,Navy Midshipmen,M. Andrews,4704780,,True,31.0,2,2,2,2,0,0,0,0,2,9,11,1,0,1,3,4,4
401488084,Navy Midshipmen,K. Samson,5109237,,True,6.0,1,1,1,1,0,0,0,0,1,2,3,0,0,0,0,2,2
401488084,Navy Midshipmen,S. Watts,4704782,,True,30.0,6,13,4,9,2,4,2,2,1,3,4,2,0,0,4,3,16
401488084,Navy Midshipmen,M. Louridas,5109236,,True,36.0,9,17,4,7,5,10,1,3,0,4,4,2,0,0,3,2,24
401488084,Navy Midshipmen,M. Schrader,4595622,,True,35.0,1,4,0,2,1,2,5,6,2,5,7,4,1,0,2,1,8
401488084,Navy Midshipmen,M. Demos,5109235,,False,11.0,0,1,0,1,0,0,0,0,0,1,1,0,1,0,0,2,0
401488084,Navy Midshipmen,G. Pissott,5109232,,False,23.0,2,2,2,2,0,0,3,4,2,3,5,0,1,0,1,2,7
401488084,Navy Midshipmen,L. Llewellyn,4595625,,False,19.0,1,8,1,4,0,4,0,0,0,1,1,2,0,0,5,2,2
401488084,Navy Midshipmen,K. Giuliani,5109230,,False,8.0,0,1,0,0,0,1,0,0,0,0,0,1,1,0,0,4,0
401488084,Navy Midshipmen,S. Schofield,4704779,,False,1.0,0,0,0,0,0,0,0,0,0,0,0,0,0,0,0,0,0
401488084,Navy Midshipmen,TEAM,TOTAL,TOTAL,False,,22,49,14,28,8,21,11,15,9,32,41,12,4,1,19,22,63
401488084,Navy Midshipmen,M. Andrews,4704780,,True,31.0,2,2,2,2,0,0,0,0,2,9,11,1,0,1,3,4,4
401488084,Navy Midshipmen,K. Samson,5109237,,True,6.0,1,1,1,1,0,0,0,0,1,2,3,0,0,0,0,2,2
401488084,Navy Midshipmen,S. Watts,4704782,,True,30.0,6,13,4,9,2,4,2,2,1,3,4,2,0,0,4,3,16
401488084,Navy Midshipmen,M. Louridas,5109236,,True,36.0,9,17,4,7,5,10,1,3,0,4,4,2,0,0,3,2,24
401488084,Navy Midshipmen,M. Schrader,4595622,,True,35.0,1,4,0,2,1,2,5,6,2,5,7,4,1,0,2,1,8
401488084,Navy Midshipmen,M. Demos,5109235,,False,11.0,0,1,0,1,0,0,0,0,0,1,1,0,1,0,0,2,0
401488084,Navy Midshipmen,G. Pissott,5109232,,False,23.0,2,2,2,2,0,0,3,4,2,3,5,0,1,0,1,2,7
401488084,Navy Midshipmen,L. Llewellyn,4595625,,False,19.0,1,8,1,4,0,4,0,0,0,1,1,2,0,0,5,2,2
401488084,Navy Midshipmen,K. Giuliani,5109230,,False,8.0,0,1,0,0,0,1,0,0,0,0,0,1,1,0,0,4,0
401488084,Navy Midshipmen,S. Schofield,4704779,,False,1.0,0,0,0,0,0,0,0,0,0,0,0,0,0,0,0,0,0
401488084,Navy Midshipmen,TEAM,TOTAL,TOTAL,False,,22,49,14,28,8,21,11,15,9,32,41,12,4,1,19,22,63
401488084,Loyola Maryland Greyhounds,L. Therien,4900552,,True,32.0,4,10,4,10,0,0,2,3,0,7,7,1,3,0,2,3,10
401488084,Loyola Maryland Greyhounds,C. Garcia,5109224,,True,25.0,2,3,2,3,0,0,1,2,0,0,0,3,2,0,5,2,5
401488084,Loyola Maryland Greyhounds,K. Ratigan,5109222,,True,23.0,1,3,1,3,0,0,0,0,0,2,2,0,0,0,1,2,2
401488084,Loyola Maryland Greyhounds,T. Dixon,4400209,,True,25.0,3,13,3,11,0,2,3,3,0,1,1,1,0,0,2,3,9
401488084,Loyola Maryland Greyhounds,D. Newman,4399474,,True,25.0,2,8,0,4,2,4,2,2,0,3,3,0,0,0,2,2,8
401488084,Loyola Maryland Greyhounds,M. Espinal,5109228,,False,5.0,0,0,0,0,0,0,0,0,1,0,1,0,0,0,1,1,0
401488084,Loyola Maryland Greyhounds,K. Sims,4898948,,False,18.0,1,5,1,5,0,0,2,2,2,3,5,0,1,0,1,1,4
401488084,Loyola Maryland Greyhounds,M. Van-Otoo,5109223,,False,4.0,0,0,0,0,0,0,0,0,0,0,0,0,0,0,0,2,0
401488084,Loyola Maryland Greyhounds,L. Salmeron,4900549,,False,11.0,0,2,0,1,0,1,3,4,0,2,2,0,0,0,0,1,3
401488084,Loyola Maryland Greyhounds,C. Tanedo,4704774,,False,22.0,0,2,0,1,0,1,0,2,0,2,2,0,0,0,1,1,0
401488084,Loyola Maryland Greyhounds,B. Rozzi,4596306,,False,10.0,0,2,0,1,0,1,2,2,1,0,1,0,0,0,0,3,2
401488084,Loyola Maryland Greyhounds,TEAM,TOTAL,TOTAL,False,,13,48,11,39,2,9,15,20,5,20,25,5,6,0,16,21,43
401488084,Loyola Maryland Greyhounds,L. Therien,4900552,,True,32.0,4,10,4,10,0,0,2,3,0,7,7,1,3,0,2,3,10
401488084,Loyola Maryland Greyhounds,C. Garcia,5109224,,True,25.0,2,3,2,3,0,0,1,2,0,0,0,3,2,0,5,2,5
401488084,Loyola Maryland Greyhounds,K. Ratigan,5109222,,True,23.0,1,3,1,3,0,0,0,0,0,2,2,0,0,0,1,2,2
401488084,Loyola Maryland Greyhounds,T. Dixon,4400209,,True,25.0,3,13,3,11,0,2,3,3,0,1,1,1,0,0,2,3,9
401488084,Loyola Maryland Greyhounds,D. Newman,4399474,,True,25.0,2,8,0,4,2,4,2,2,0,3,3,0,0,0,2,2,8
401488084,Loyola Maryland Greyhounds,M. Espinal,5109228,,False,5.0,0,0,0,0,0,0,0,0,1,0,1,0,0,0,1,1,0
401488084,Loyola Maryland Greyhounds,K. Sims,4898948,,False,18.0,1,5,1,5,0,0,2,2,2,3,5,0,1,0,1,1,4
401488084,Loyola Maryland Greyhounds,M. Van-Otoo,5109223,,False,4.0,0,0,0,0,0,0,0,0,0,0,0,0,0,0,0,2,0
401488084,Loyola Maryland Greyhounds,L. Salmeron,4900549,,False,11.0,0,2,0,1,0,1,3,4,0,2,2,0,0,0,0,1,3
401488084,Loyola Maryland Greyhounds,C. Tanedo,4704774,,False,22.0,0,2,0,1,0,1,0,2,0,2,2,0,0,0,1,1,0
401488084,Loyola Maryland Greyhounds,B. Rozzi,4596306,,False,10.0,0,2,0,1,0,1,2,2,1,0,1,0,0,0,0,3,2
401488084,Loyola Maryland Greyhounds,TEAM,TOTAL,TOTAL,False,,13,48,11,39,2,9,15,20,5,20,25,5,6,0,16,21,43
401488083,Loyola Maryland Greyhounds,L. Therien,4900552,,True,23.0,5,12,5,12,0,0,3,4,0,7,7,1,0,0,1,5,13
401488083,Loyola Maryland Greyhounds,K. Sims,4898948,,True,32.0,1,4,1,4,0,0,0,0,5,3,8,4,0,1,1,1,2
401488083,Loyola Maryland Greyhounds,K. Ratigan,5109222,,True,36.0,6,10,3,5,3,5,0,0,1,2,3,0,0,0,1,3,15
401488083,Loyola Maryland Greyhounds,T. Dixon,4400209,,True,34.0,2,11,2,9,0,2,0,0,0,0,0,5,0,0,0,0,4
401488083,Loyola Maryland Greyhounds,D. Newman,4399474,,True,28.0,6,13,6,11,0,2,0,0,2,2,4,1,0,0,0,2,12
401488083,Loyola Maryland Greyhounds,C. Garcia,5109224,,False,17.0,1,2,1,2,0,0,0,0,0,2,2,1,0,0,2,2,2
401488083,Loyola Maryland Greyhounds,L. Salmeron,4900549,,False,9.0,0,2,0,2,0,0,0,0,0,0,0,0,0,0,0,0,0
401488083,Loyola Maryland Greyhounds,C. Tanedo,4704774,,False,20.0,0,4,0,3,0,1,0,0,1,1,2,0,2,0,1,2,0
401488083,Loyola Maryland Greyhounds,B. Rozzi,4596306,,False,1.0,1,1,1,1,0,0,0,0,0,0,0,0,0,0,0,0,2
401488083,Loyola Maryland Greyhounds,TEAM,TOTAL,TOTAL,False,,22,59,19,49,3,10,3,4,11,18,29,12,2,1,7,15,50
401488083,Loyola Maryland Greyhounds,L. Therien,4900552,,True,23.0,5,12,5,12,0,0,3,4,0,7,7,1,0,0,1,5,13
401488083,Loyola Maryland Greyhounds,K. Sims,4898948,,True,32.0,1,4,1,4,0,0,0,0,5,3,8,4,0,1,1,1,2
401488083,Loyola Maryland Greyhounds,K. Ratigan,5109222,,True,36.0,6,10,3,5,3,5,0,0,1,2,3,0,0,0,1,3,15
401488083,Loyola Maryland Greyhounds,T. Dixon,4400209,,True,34.0,2,11,2,9,0,2,0,0,0,0,0,5,0,0,0,0,4
401488083,Loyola Maryland Greyhounds,D. Newman,4399474,,True,28.0,6,13,6,11,0,2,0,0,2,2,4,1,0,0,0,2,12
401488083,Loyola Maryland Greyhounds,C. Garcia,5109224,,False,17.0,1,2,1,2,0,0,0,0,0,2,2,1,0,0,2,2,2
401488083,Loyola Maryland Greyhounds,L. Salmeron,4900549,,False,9.0,0,2,0,2,0,0,0,0,0,0,0,0,0,0,0,0,0
401488083,Loyola Maryland Greyhounds,C. Tanedo,4704774,,False,20.0,0,4,0,3,0,1,0,0,1,1,2,0,2,0,1,2,0
401488083,Loyola Maryland Greyhounds,B. Rozzi,4596306,,False,1.0,1,1,1,1,0,0,0,0,0,0,0,0,0,0,0,0,2
401488083,Loyola Maryland Greyhounds,TEAM,TOTAL,TOTAL,False,,22,59,19,49,3,10,3,4,11,18,29,12,2,1,7,15,50
401488083,Bucknell Bison,I. King,4900533,,True,9.0,1,3,1,3,0,0,0,0,1,1,2,0,0,0,1,0,2
401488083,Bucknell Bison,E. Shaffer,4595535,,True,36.0,5,9,5,9,0,0,1,4,0,7,7,5,1,0,2,2,11
401488083,Bucknell Bison,E. Theodorsson,5109199,,True,31.0,4,9,4,9,0,0,0,0,0,3,3,1,0,0,1,2,8
401488083,Bucknell Bison,T. Johnson,4595533,,True,40.0,4,7,3,6,1,1,6,8,0,2,2,2,0,0,0,0,15
401488083,Bucknell Bison,C. Dingler,4577540,,True,31.0,2,2,1,1,1,1,2,2,0,2,2,4,0,1,3,2,7
401488083,Bucknell Bison,G. Sullivan,5109201,,False,4.0,0,1,0,1,0,0,0,0,0,2,2,0,0,0,1,2,0
401488083,Bucknell Bison,R. Sisselman,4900531,,False,18.0,3,5,3,4,0,1,0,0,1,3,4,0,0,1,1,0,6
401488083,Bucknell Bison,J. Kulesza,4704702,,False,31.0,2,7,1,4,1,3,2,2,1,2,3,1,0,0,1,0,7
401488083,Bucknell Bison,TEAM,TOTAL,TOTAL,False,,21,43,18,37,3,6,11,16,5,26,31,13,1,2,10,8,56
401488083,Bucknell Bison,I. King,4900533,,True,9.0,1,3,1,3,0,0,0,0,1,1,2,0,0,0,1,0,2
401488083,Bucknell Bison,E. Shaffer,4595535,,True,36.0,5,9,5,9,0,0,1,4,0,7,7,5,1,0,2,2,11
401488083,Bucknell Bison,E. Theodorsson,5109199,,True,31.0,4,9,4,9,0,0,0,0,0,3,3,1,0,0,1,2,8
401488083,Bucknell Bison,T. Johnson,4595533,,True,40.0,4,7,3,6,1,1,6,8,0,2,2,2,0,0,0,0,15
401488083,Bucknell Bison,C. Dingler,4577540,,True,31.0,2,2,1,1,1,1,2,2,0,2,2,4,0,1,3,2,7
401488083,Bucknell Bison,G. Sullivan,5109201,,False,4.0,0,1,0,1,0,0,0,0,0,2,2,0,0,0,1,2,0
401488083,Bucknell Bison,R. Sisselman,4900531,,False,18.0,3,5,3,4,0,1,0,0,1,3,4,0,0,1,1,0,6
401488083,Bucknell Bison,J. Kulesza,4704702,,False,31.0,2,7,1,4,1,3,2,2,1,2,3,1,0,0,1,0,7
401488083,Bucknell Bison,TEAM,TOTAL,TOTAL,False,,21,43,18,37,3,6,11,16,5,26,31,13,1,2,10,8,56
401488082,Loyola Maryland Greyhounds,L. Therien,4900552,,True,28.0,8,13,8,11,0,2,1,3,1,9,10,0,1,0,1,4,17
401488082,Loyola Maryland Greyhounds,K. Sims,4898948,,True,29.0,3,9,3,9,0,0,0,0,7,5,12,2,0,0,3,3,6
401488082,Loyola Maryland Greyhounds,K. Ratigan,5109222,,True,32.0,2,5,0,1,2,4,0,0,0,0,0,0,0,0,1,3,6
401488082,Loyola Maryland Greyhounds,L. Salmeron,4900549,,True,25.0,0,3,0,2,0,1,0,0,0,2,2,1,1,0,2,1,0
401488082,Loyola Maryland Greyhounds,T. Dixon,4400209,,True,34.0,5,15,3,9,2,6,0,0,1,1,2,5,1,0,2,4,12
401488082,Loyola Maryland Greyhounds,M. Espinal,5109228,,False,6.0,0,1,0,0,0,1,0,0,0,0,0,0,0,0,1,0,0
401488082,Loyola Maryland Greyhounds,C. Garcia,5109224,,False,6.0,0,0,0,0,0,0,0,0,0,0,0,0,1,0,1,0,0
401488082,Loyola Maryland Greyhounds,M. Van-Otoo,5109223,,False,6.0,0,1,0,0,0,1,0,0,0,0,0,0,1,0,0,0,0
401488082,Loyola Maryland Greyhounds,C. Tanedo,4704774,,False,19.0,1,2,0,1,1,1,0,0,0,1,1,1,1,0,0,0,3
401488082,Loyola Maryland Greyhounds,D. Newman,4399474,,False,15.0,1,4,1,4,0,0,0,0,1,0,1,0,0,0,1,0,2
401488082,Loyola Maryland Greyhounds,TEAM,TOTAL,TOTAL,False,,20,53,15,37,5,16,1,3,12,19,31,9,6,0,15,15,46
401488082,Loyola Maryland Greyhounds,L. Therien,4900552,,True,28.0,8,13,8,11,0,2,1,3,1,9,10,0,1,0,1,4,17
401488082,Loyola Maryland Greyhounds,K. Sims,4898948,,True,29.0,3,9,3,9,0,0,0,0,7,5,12,2,0,0,3,3,6
401488082,Loyola Maryland Greyhounds,K. Ratigan,5109222,,True,32.0,2,5,0,1,2,4,0,0,0,0,0,0,0,0,1,3,6
401488082,Loyola Maryland Greyhounds,L. Salmeron,4900549,,True,25.0,0,3,0,2,0,1,0,0,0,2,2,1,1,0,2,1,0
401488082,Loyola Maryland Greyhounds,T. Dixon,4400209,,True,34.0,5,15,3,9,2,6,0,0,1,1,2,5,1,0,2,4,12
401488082,Loyola Maryland Greyhounds,M. Espinal,5109228,,False,6.0,0,1,0,0,0,1,0,0,0,0,0,0,0,0,1,0,0
401488082,Loyola Maryland Greyhounds,C. Garcia,5109224,,False,6.0,0,0,0,0,0,0,0,0,0,0,0,0,1,0,1,0,0
401488082,Loyola Maryland Greyhounds,M. Van-Otoo,5109223,,False,6.0,0,1,0,0,0,1,0,0,0,0,0,0,1,0,0,0,0
401488082,Loyola Maryland Greyhounds,C. Tanedo,4704774,,False,19.0,1,2,0,1,1,1,0,0,0,1,1,1,1,0,0,0,3
401488082,Loyola Maryland Greyhounds,D. Newman,4399474,,False,15.0,1,4,1,4,0,0,0,0,1,0,1,0,0,0,1,0,2
401488082,Loyola Maryland Greyhounds,TEAM,TOTAL,TOTAL,False,,20,53,15,37,5,16,1,3,12,19,31,9,6,0,15,15,46
401488082,Holy Cross Crusaders,J. Allen,4704714,,True,26.0,3,8,3,8,0,0,2,2,5,2,7,0,0,1,1,1,8
401488082,Holy Cross Crusaders,K. Flanagan,5109211,,True,26.0,1,4,1,2,0,2,2,2,0,1,1,0,1,0,2,1,4
401488082,Holy Cross Crusaders,C. McCormack,4704716,,True,25.0,2,8,0,1,2,7,2,2,0,2,2,1,0,0,2,0,8
401488082,Holy Cross Crusaders,B. Power-Cassidy,4704715,,True,26.0,0,1,0,0,0,1,0,0,1,1,2,1,0,0,0,0,0
401488082,Holy Cross Crusaders,A. Cross,4595975,,True,31.0,4,8,4,5,0,3,0,0,0,5,5,2,1,1,2,2,8
401488082,Holy Cross Crusaders,L. Berger,4900539,,False,22.0,0,2,0,2,0,0,5,6,1,4,5,1,1,0,0,1,5
401488082,Holy Cross Crusaders,C. Wright,4703660,,False,5.0,0,1,0,1,0,0,0,0,0,0,0,0,0,0,0,0,0
401488082,Holy Cross Crusaders,M. Donnelly,5109213,,False,16.0,1,4,0,0,1,4,0,0,0,2,2,0,0,0,0,1,3
401488082,Holy Cross Crusaders,S. Foreman,5109212,,False,23.0,7,10,7,10,0,0,3,4,0,2,2,1,2,1,2,0,17
401488082,Holy Cross Crusaders,TEAM,TOTAL,TOTAL,False,,18,46,15,29,3,17,14,16,7,20,27,6,5,3,9,6,53
401488082,Holy Cross Crusaders,J. Allen,4704714,,True,26.0,3,8,3,8,0,0,2,2,5,2,7,0,0,1,1,1,8
401488082,Holy Cross Crusaders,K. Flanagan,5109211,,True,26.0,1,4,1,2,0,2,2,2,0,1,1,0,1,0,2,1,4
401488082,Holy Cross Crusaders,C. McCormack,4704716,,True,25.0,2,8,0,1,2,7,2,2,0,2,2,1,0,0,2,0,8
401488082,Holy Cross Crusaders,B. Power-Cassidy,4704715,,True,26.0,0,1,0,0,0,1,0,0,1,1,2,1,0,0,0,0,0
401488082,Holy Cross Crusaders,A. Cross,4595975,,True,31.0,4,8,4,5,0,3,0,0,0,5,5,2,1,1,2,2,8
401488082,Holy Cross Crusaders,L. Berger,4900539,,False,22.0,0,2,0,2,0,0,5,6,1,4,5,1,1,0,0,1,5
401488082,Holy Cross Crusaders,C. Wright,4703660,,False,5.0,0,1,0,1,0,0,0,0,0,0,0,0,0,0,0,0,0
401488082,Holy Cross Crusaders,M. Donnelly,5109213,,False,16.0,1,4,0,0,1,4,0,0,0,2,2,0,0,0,0,1,3
401488082,Holy Cross Crusaders,S. Foreman,5109212,,False,23.0,7,10,7,10,0,0,3,4,0,2,2,1,2,1,2,0,17
401488082,Holy Cross Crusaders,TEAM,TOTAL,TOTAL,False,,18,46,15,29,3,17,14,16,7,20,27,6,5,3,9,6,53
401488081,Loyola Maryland Greyhounds,L. Therien,4900552,,True,20.0,2,7,2,7,0,0,0,0,3,3,6,0,2,0,3,4,4
401488081,Loyola Maryland Greyhounds,K. Sims,4898948,,True,28.0,4,8,4,8,0,0,0,0,6,5,11,1,0,2,4,0,8
401488081,Loyola Maryland Greyhounds,K. Ratigan,5109222,,True,32.0,2,6,0,0,2,6,0,0,1,2,3,0,1,1,3,3,6
401488081,Loyola Maryland Greyhounds,L. Salmeron,4900549,,True,20.0,1,4,0,2,1,2,0,0,0,0,0,3,0,0,3,0,3
401488081,Loyola Maryland Greyhounds,T. Dixon,4400209,,True,28.0,2,11,1,6,1,5,1,2,0,3,3,1,2,1,3,4,6
401488081,Loyola Maryland Greyhounds,M. Espinal,5109228,,False,12.0,1,2,1,1,0,1,0,2,0,0,0,1,1,0,0,2,2
401488081,Loyola Maryland Greyhounds,E. Glezen,4596304,,False,3.0,0,1,0,1,0,0,0,0,1,0,1,0,0,0,0,0,0
401488081,Loyola Maryland Greyhounds,C. Garcia,5109224,,False,4.0,0,0,0,0,0,0,0,0,0,1,1,0,1,0,2,0,0
401488081,Loyola Maryland Greyhounds,M. Van-Otoo,5109223,,False,12.0,0,0,0,0,0,0,0,0,1,1,2,3,0,0,2,2,0
401488081,Loyola Maryland Greyhounds,C. Tanedo,4704774,,False,16.0,0,2,0,0,0,2,0,0,0,1,1,0,1,0,1,0,0
401488081,Loyola Maryland Greyhounds,D. Newman,4399474,,False,25.0,4,11,4,10,0,1,0,0,0,5,5,1,2,0,2,0,8
401488081,Loyola Maryland Greyhounds,TEAM,TOTAL,TOTAL,False,,16,52,12,35,4,17,1,4,14,21,35,10,10,4,24,15,37
401488081,Loyola Maryland Greyhounds,L. Therien,4900552,,True,20.0,2,7,2,7,0,0,0,0,3,3,6,0,2,0,3,4,4
401488081,Loyola Maryland Greyhounds,K. Sims,4898948,,True,28.0,4,8,4,8,0,0,0,0,6,5,11,1,0,2,4,0,8
401488081,Loyola Maryland Greyhounds,K. Ratigan,5109222,,True,32.0,2,6,0,0,2,6,0,0,1,2,3,0,1,1,3,3,6
401488081,Loyola Maryland Greyhounds,L. Salmeron,4900549,,True,20.0,1,4,0,2,1,2,0,0,0,0,0,3,0,0,3,0,3
401488081,Loyola Maryland Greyhounds,T. Dixon,4400209,,True,28.0,2,11,1,6,1,5,1,2,0,3,3,1,2,1,3,4,6
401488081,Loyola Maryland Greyhounds,M. Espinal,5109228,,False,12.0,1,2,1,1,0,1,0,2,0,0,0,1,1,0,0,2,2
401488081,Loyola Maryland Greyhounds,E. Glezen,4596304,,False,3.0,0,1,0,1,0,0,0,0,1,0,1,0,0,0,0,0,0
401488081,Loyola Maryland Greyhounds,C. Garcia,5109224,,False,4.0,0,0,0,0,0,0,0,0,0,1,1,0,1,0,2,0,0
401488081,Loyola Maryland Greyhounds,M. Van-Otoo,5109223,,False,12.0,0,0,0,0,0,0,0,0,1,1,2,3,0,0,2,2,0
401488081,Loyola Maryland Greyhounds,C. Tanedo,4704774,,False,16.0,0,2,0,0,0,2,0,0,0,1,1,0,1,0,1,0,0
401488081,Loyola Maryland Greyhounds,D. Newman,4399474,,False,25.0,4,11,4,10,0,1,0,0,0,5,5,1,2,0,2,0,8
401488081,Loyola Maryland Greyhounds,TEAM,TOTAL,TOTAL,False,,16,52,12,35,4,17,1,4,14,21,35,10,10,4,24,15,37
401488081,American University Eagles,E. Johns,4704688,,True,36.0,7,12,7,11,0,1,0,3,1,4,5,2,0,1,2,3,14
401488081,American University Eagles,L. Stack,4595455,,True,32.0,2,6,2,6,0,0,3,5,0,4,4,0,3,0,5,5,7
401488081,American University Eagles,I. Bales,4704685,,True,27.0,2,3,2,2,0,1,0,0,1,7,8,4,4,1,5,3,4
401488081,American University Eagles,R. DeRubbo,4703746,,True,25.0,1,9,0,6,1,3,6,6,1,1,2,1,3,0,4,2,9
401488081,American University Eagles,S. Stetson,4595453,,True,30.0,3,6,1,2,2,4,0,0,0,2,2,2,1,1,0,1,8
401488081,American University Eagles,M. Lavin,5109188,,False,10.0,1,1,1,1,0,0,0,0,1,0,1,0,0,1,1,1,2
401488081,American University Eagles,A. Rescifina,5109186,,False,1.0,0,0,0,0,0,0,0,0,0,0,0,0,0,0,1,0,0
401488081,American University Eagles,B. Garbee,4899710,,False,6.0,0,0,0,0,0,0,0,0,1,0,1,0,0,0,1,0,0
401488081,American University Eagles,K. Henning,4704686,,False,27.0,3,6,3,6,0,0,2,2,0,0,0,3,0,0,1,1,8
401488081,American University Eagles,A. LeMaster,4703737,,False,6.0,0,1,0,0,0,1,0,0,0,1,1,0,0,0,0,0,0
401488081,American University Eagles,TEAM,TOTAL,TOTAL,False,,19,44,16,34,3,10,11,16,7,22,29,12,11,4,20,16,52
401488081,American University Eagles,E. Johns,4704688,,True,36.0,7,12,7,11,0,1,0,3,1,4,5,2,0,1,2,3,14
401488081,American University Eagles,L. Stack,4595455,,True,32.0,2,6,2,6,0,0,3,5,0,4,4,0,3,0,5,5,7
401488081,American University Eagles,I. Bales,4704685,,True,27.0,2,3,2,2,0,1,0,0,1,7,8,4,4,1,5,3,4
401488081,American University Eagles,R. DeRubbo,4703746,,True,25.0,1,9,0,6,1,3,6,6,1,1,2,1,3,0,4,2,9
401488081,American University Eagles,S. Stetson,4595453,,True,30.0,3,6,1,2,2,4,0,0,0,2,2,2,1,1,0,1,8
401488081,American University Eagles,M. Lavin,5109188,,False,10.0,1,1,1,1,0,0,0,0,1,0,1,0,0,1,1,1,2
401488081,American University Eagles,A. Rescifina,5109186,,False,1.0,0,0,0,0,0,0,0,0,0,0,0,0,0,0,1,0,0
401488081,American University Eagles,B. Garbee,4899710,,False,6.0,0,0,0,0,0,0,0,0,1,0,1,0,0,0,1,0,0
401488081,American University Eagles,K. Henning,4704686,,False,27.0,3,6,3,6,0,0,2,2,0,0,0,3,0,0,1,1,8
401488081,American University Eagles,A. LeMaster,4703737,,False,6.0,0,1,0,0,0,1,0,0,0,1,1,0,0,0,0,0,0
401488081,American University Eagles,TEAM,TOTAL,TOTAL,False,,19,44,16,34,3,10,11,16,7,22,29,12,11,4,20,16,52
401488080,Loyola Maryland Greyhounds,L. Therien,4900552,,True,31.0,4,12,4,11,0,1,1,5,5,3,8,2,4,0,2,4,9
401488080,Loyola Maryland Greyhounds,K. Sims,4898948,,True,30.0,2,8,2,7,0,1,0,0,2,3,5,1,2,1,1,3,4
401488080,Loyola Maryland Greyhounds,K. Ratigan,5109222,,True,26.0,3,7,2,3,1,4,0,0,0,2,2,0,0,0,0,2,7
401488080,Loyola Maryland Greyhounds,B. Rozzi,4596306,,True,40.0,3,9,2,5,1,4,4,5,0,3,3,4,3,0,3,2,11
401488080,Loyola Maryland Greyhounds,T. Dixon,4400209,,True,41.0,5,18,2,12,3,6,8,8,0,3,3,2,1,0,1,4,21
401488080,Loyola Maryland Greyhounds,M. Espinal,5109228,,False,11.0,0,1,0,0,0,1,1,2,1,0,1,1,0,0,2,2,1
401488080,Loyola Maryland Greyhounds,A. Therien,4596307,,False,0.0,0,0,0,0,0,0,0,0,0,0,0,0,0,0,0,0,0
401488080,Loyola Maryland Greyhounds,C. Garcia,5109224,,False,1.0,0,0,0,0,0,0,0,0,0,0,0,0,0,0,1,1,0
401488080,Loyola Maryland Greyhounds,M. Van-Otoo,5109223,,False,6.0,0,0,0,0,0,0,3,3,0,1,1,1,0,0,0,1,3
401488080,Loyola Maryland Greyhounds,L. Salmeron,4900549,,False,13.0,0,3,0,0,0,3,2,2,0,3,3,0,1,0,2,1,2
401488080,Loyola Maryland Greyhounds,C. Tanedo,4704774,,False,26.0,2,3,2,2,0,1,0,2,3,2,5,0,3,0,1,0,4
401488080,Loyola Maryland Greyhounds,TEAM,TOTAL,TOTAL,False,,19,61,14,40,5,21,19,27,12,23,35,11,14,1,16,20,62
401488080,Hofstra Pride,Z. Swint,4704976,,True,35.0,7,9,7,9,0,0,0,2,2,7,9,0,0,3,4,4,14
401488080,Hofstra Pride,E. Von Essen,5108816,,True,16.0,0,3,0,1,0,2,0,0,0,0,0,2,2,0,2,0,0
401488080,Hofstra Pride,A. Knights,4704296,,True,35.0,1,10,1,4,0,6,2,2,0,2,2,3,4,1,3,4,4
401488080,Hofstra Pride,R. Nicholson,4399892,,True,36.0,6,6,5,5,1,1,4,4,2,4,6,3,1,1,5,1,17
401488080,Hofstra Pride,B. Thomas,4399567,,True,35.0,2,11,2,8,0,3,4,4,1,7,8,4,1,0,5,3,8
401488080,Hofstra Pride,K. Joseph-Bernard,5108815,,False,1.0,0,0,0,0,0,0,0,0,0,0,0,0,0,0,0,0,0
401488080,Hofstra Pride,Z. Ross-Barnes,4898976,,False,7.0,1,2,1,2,0,0,0,0,0,0,0,0,0,1,1,2,2
401488080,Hofstra Pride,A. Gooden,5108817,,False,4.0,0,0,0,0,0,0,0,0,0,1,1,1,0,0,0,3,0
401488080,Hofstra Pride,J. Fargo,4704811,,False,20.0,0,0,0,0,0,0,3,4,0,4,4,0,0,0,1,3,3
401488080,Hofstra Pride,S. Ineza,4594722,,False,32.0,4,8,1,2,3,6,2,2,0,4,4,2,0,0,1,1,13
401488080,Hofstra Pride,J. Peacock,4399031,,False,4.0,0,0,0,0,0,0,0,0,0,0,0,0,0,0,0,0,0
401488080,Hofstra Pride,TEAM,TOTAL,TOTAL,False,,21,49,17,31,4,18,15,18,6,32,38,15,8,6,23,21,61
401488079,Mount St. Mary's Mountaineers,I. Hunt,4704996,,True,35.0,4,8,4,8,0,0,2,2,5,2,7,3,7,0,2,4,10
401488079,Mount St. Mary's Mountaineers,N. Villaflor,4399578,,True,33.0,6,9,6,9,0,0,2,2,1,2,3,3,3,1,2,1,14
401488079,Mount St. Mary's Mountaineers,Jo Raflo,4899606,,True,29.0,4,12,3,7,1,5,1,2,1,1,2,2,0,1,1,2,10
401488079,Mount St. Mary's Mountaineers,J. Tomasetti,4704999,,True,36.0,5,9,5,7,0,2,3,3,1,5,6,3,1,0,0,2,13
401488079,Mount St. Mary's Mountaineers,M. Harrison,4399572,,True,34.0,6,16,3,6,3,10,4,4,0,1,1,1,0,0,4,2,19
401488079,Mount St. Mary's Mountaineers,M. Matheny,5109008,,False,6.0,0,0,0,0,0,0,0,0,0,0,0,0,0,0,0,1,0
401488079,Mount St. Mary's Mountaineers,C. Dunham,5109010,,False,7.0,1,1,1,1,0,0,0,0,0,0,0,0,0,0,0,2,2
401488079,Mount St. Mary's Mountaineers,J. Lindsay-Huskey,4900509,,False,20.0,1,4,0,2,1,2,2,2,1,0,1,0,0,0,0,3,5
401488079,Mount St. Mary's Mountaineers,TEAM,TOTAL,TOTAL,False,,27,59,22,40,5,19,14,15,11,14,25,12,11,2,9,17,73
401488079,Loyola Maryland Greyhounds,L. Therien,4900552,,True,35.0,8,14,8,14,0,0,0,0,3,7,10,3,1,1,4,0,16
401488079,Loyola Maryland Greyhounds,K. Sims,4898948,,True,29.0,4,7,4,7,0,0,3,5,4,3,7,3,0,0,3,0,11
401488079,Loyola Maryland Greyhounds,C. Tanedo,4704774,,True,33.0,2,3,0,0,2,3,0,0,0,2,2,1,1,0,1,2,6
401488079,Loyola Maryland Greyhounds,B. Rozzi,4596306,,True,32.0,5,10,3,4,2,6,0,0,0,3,3,4,0,0,6,4,12
401488079,Loyola Maryland Greyhounds,T. Dixon,4400209,,True,33.0,7,12,4,8,3,4,1,2,0,0,0,4,1,0,3,3,18
401488079,Loyola Maryland Greyhounds,M. Espinal,5109228,,False,5.0,0,0,0,0,0,0,0,0,0,1,1,0,0,0,0,2,0
401488079,Loyola Maryland Greyhounds,E. Glezen,4596304,,False,6.0,0,2,0,2,0,0,0,0,0,0,0,0,0,0,1,0,0
401488079,Loyola Maryland Greyhounds,C. Garcia,5109224,,False,3.0,0,0,0,0,0,0,0,0,0,0,0,0,0,0,0,0,0
401488079,Loyola Maryland Greyhounds,M. Van-Otoo,5109223,,False,20.0,1,1,1,1,0,0,1,2,0,1,1,2,1,0,3,3,3
401488079,Loyola Maryland Greyhounds,K. Ratigan,5109222,,False,5.0,0,1,0,1,0,0,0,0,0,0,0,0,0,0,1,0,0
401488079,Loyola Maryland Greyhounds,TEAM,TOTAL,TOTAL,False,,27,50,20,37,7,13,5,9,9,21,30,17,4,1,23,14,66
401488078,Toledo Rockets,J. Cook,4900087,,True,16.0,4,6,4,6,0,0,2,2,2,5,7,0,0,0,3,2,10
401488078,Toledo Rockets,S. Mikonowicz,4705387,,True,30.0,3,9,2,7,1,2,1,2,4,4,8,3,0,0,2,3,8
401488078,Toledo Rockets,K. Goss,4705386,,True,25.0,1,5,1,3,0,2,0,0,1,1,2,0,0,0,1,3,2
401488078,Toledo Rockets,Q. Lockett,4595303,,True,29.0,7,11,4,7,3,4,0,0,0,1,1,5,1,0,1,1,17
401488078,Toledo Rockets,S. Wiard,4595301,,True,27.0,0,5,0,2,0,3,0,0,0,3,3,5,1,1,1,2,0
401488078,Toledo Rockets,L. Brewer,4595218,,False,5.0,2,3,2,3,0,0,1,2,0,1,1,0,0,1,2,2,5
401488078,Toledo Rockets,Y. Curry,4595305,,False,10.0,0,2,0,2,0,0,0,0,0,0,0,0,0,0,0,0,0
401488078,Toledo Rockets,J. Jansen,4900086,,False,19.0,3,4,1,2,2,2,0,0,1,1,2,1,0,0,1,2,8
401488078,Toledo Rockets,N. Garcia,4703763,,False,19.0,0,5,0,4,0,1,3,4,0,3,3,0,0,1,1,1,3
401488078,Toledo Rockets,S. Barnes,4595302,,False,5.0,0,0,0,0,0,0,0,0,0,0,0,0,0,0,0,0,0
401488078,Toledo Rockets,J. King,4400052,,False,15.0,3,3,2,2,1,1,2,2,0,1,1,2,1,0,0,1,9
401488078,Toledo Rockets,TEAM,TOTAL,TOTAL,False,,23,53,16,38,7,15,9,12,8,22,30,16,3,3,12,17,62
401488078,Loyola Maryland Greyhounds,L. Therien,4900552,,True,30.0,6,14,6,13,0,1,0,1,3,7,10,1,1,0,4,4,12
401488078,Loyola Maryland Greyhounds,K. Sims,4898948,,True,29.0,3,5,3,5,0,0,0,0,2,7,9,1,0,1,6,3,6
401488078,Loyola Maryland Greyhounds,C. Garcia,5109224,,True,22.0,1,6,1,5,0,1,1,2,3,1,4,2,2,0,1,2,3
401488078,Loyola Maryland Greyhounds,C. Tanedo,4704774,,True,31.0,1,5,0,2,1,3,0,0,0,2,2,0,0,0,2,1,3
401488078,Loyola Maryland Greyhounds,B. Rozzi,4596306,,True,31.0,2,8,1,4,1,4,3,4,0,3,3,2,0,0,2,3,8
401488078,Loyola Maryland Greyhounds,M. Espinal,5109228,,False,10.0,0,0,0,0,0,0,0,0,0,1,1,0,0,0,0,0,0
401488078,Loyola Maryland Greyhounds,E. Glezen,4596304,,False,9.0,0,0,0,0,0,0,0,0,0,0,0,0,0,0,1,3,0
401488078,Loyola Maryland Greyhounds,M. Van-Otoo,5109223,,False,22.0,1,3,1,2,0,1,3,4,0,0,0,0,0,0,2,2,5
401488078,Loyola Maryland Greyhounds,K. Ratigan,5109222,,False,16.0,1,5,0,2,1,3,0,0,0,2,2,1,0,0,2,1,3
401488078,Loyola Maryland Greyhounds,TEAM,TOTAL,TOTAL,False,,15,46,12,33,3,13,7,11,9,24,33,7,3,1,22,19,40
401488077,Loyola Maryland Greyhounds,L. Therien,4900552,,True,21.0,3,10,3,10,0,0,0,0,2,2,4,0,1,0,5,5,6
401488077,Loyola Maryland Greyhounds,K. Sims,4898948,,True,30.0,2,6,2,6,0,0,0,0,4,6,10,3,2,0,3,1,4
401488077,Loyola Maryland Greyhounds,C. Tanedo,4704774,,True,20.0,0,3,0,1,0,2,0,0,0,2,2,0,0,0,1,0,0
401488077,Loyola Maryland Greyhounds,B. Rozzi,4596306,,True,23.0,2,4,1,3,1,1,2,2,0,2,2,0,1,0,1,4,7
401488077,Loyola Maryland Greyhounds,T. Dixon,4400209,,True,33.0,10,15,5,8,5,7,1,1,0,0,0,2,2,0,3,0,26
401488077,Loyola Maryland Greyhounds,M. Espinal,5109228,,False,12.0,1,1,1,1,0,0,0,0,0,0,0,0,0,1,3,2,2
401488077,Loyola Maryland Greyhounds,E. Glezen,4596304,,False,14.0,2,2,2,2,0,0,0,0,1,0,1,0,0,0,1,5,4
401488077,Loyola Maryland Greyhounds,C. Garcia,5109224,,False,27.0,1,3,1,2,0,1,2,2,2,2,4,3,0,0,2,3,4
401488077,Loyola Maryland Greyhounds,M. Van-Otoo,5109223,,False,20.0,3,5,3,4,0,1,1,2,0,2,2,3,4,1,2,2,7
401488077,Loyola Maryland Greyhounds,TEAM,TOTAL,TOTAL,False,,24,49,18,37,6,12,6,7,9,18,27,11,10,2,21,22,60
401488077,Delaware State Hornets,T. Tollie,5109714,,True,29.0,4,5,4,5,0,0,2,2,2,1,3,1,4,0,4,2,10
401488077,Delaware State Hornets,J. Martino,4703926,,True,30.0,0,1,0,1,0,0,3,4,1,5,6,0,0,1,2,3,3
401488077,Delaware State Hornets,S. Brooks,5109715,,True,39.0,3,12,2,10,1,2,4,6,1,1,2,0,0,0,3,2,11
401488077,Delaware State Hornets,D. Wilson,4704769,,True,38.0,4,7,4,7,0,0,4,4,0,1,1,2,2,0,7,3,12
401488077,Delaware State Hornets,A. Moragne,4595506,,True,36.0,4,8,2,5,2,3,3,6,0,3,3,1,0,0,3,4,13
401488077,Delaware State Hornets,B. Dodson,5109713,,False,4.0,0,1,0,1,0,0,0,0,0,0,0,0,0,0,0,0,0
401488077,Delaware State Hornets,D. Thompson,5109712,,False,1.0,0,1,0,0,0,1,0,0,0,1,1,0,0,0,0,1,0
401488077,Delaware State Hornets,N. Zulueta,5109711,,False,17.0,1,1,1,1,0,0,0,0,0,1,1,1,1,1,1,3,2
401488077,Delaware State Hornets,S. Watkins,4399127,,False,6.0,0,1,0,0,0,1,0,0,0,0,0,0,0,0,0,1,0
401488077,Delaware State Hornets,TEAM,TOTAL,TOTAL,False,,16,37,13,30,3,7,16,22,6,15,21,5,7,2,22,19,51
401488076,Loyola Maryland Greyhounds,L. Therien,4900552,,True,22.0,5,11,5,10,0,1,6,8,4,6,10,0,1,0,2,4,16
401488076,Loyola Maryland Greyhounds,K. Sims,4898948,,True,33.0,2,9,2,9,0,0,1,2,3,9,12,2,3,0,2,1,5
401488076,Loyola Maryland Greyhounds,C. Tanedo,4704774,,True,35.0,4,5,0,0,4,5,0,0,1,1,2,2,3,0,3,1,12
401488076,Loyola Maryland Greyhounds,B. Rozzi,4596306,,True,31.0,4,11,2,4,2,7,4,4,0,0,0,5,1,0,0,2,14
401488076,Loyola Maryland Greyhounds,T. Dixon,4400209,,True,34.0,4,14,2,8,2,6,4,6,0,0,0,1,2,0,1,1,14
401488076,Loyola Maryland Greyhounds,M. Espinal,5109228,,False,9.0,1,1,1,1,0,0,0,0,3,0,3,2,0,0,1,3,2
401488076,Loyola Maryland Greyhounds,E. Glezen,4596304,,False,14.0,1,1,1,1,0,0,0,0,1,2,3,3,0,0,0,2,2
401488076,Loyola Maryland Greyhounds,C. Garcia,5109224,,False,14.0,0,2,0,2,0,0,1,5,0,1,1,0,0,0,0,0,1
401488076,Loyola Maryland Greyhounds,M. Van-Otoo,5109223,,False,1.0,0,0,0,0,0,0,0,0,0,0,0,0,0,0,1,0,0
401488076,Loyola Maryland Greyhounds,K. Ratigan,5109222,,False,7.0,1,1,0,0,1,1,0,0,0,0,0,0,0,0,1,0,3
401488076,Loyola Maryland Greyhounds,TEAM,TOTAL,TOTAL,False,,22,55,13,35,9,20,16,25,14,19,33,15,10,0,11,14,69
401488076,Bryant Bulldogs,M. Planes Fortuny,4705424,,True,24.0,7,10,7,10,0,0,1,2,3,2,5,0,0,2,2,4,15
401488076,Bryant Bulldogs,M. Martinez,4900602,,True,18.0,1,4,1,4,0,0,0,0,0,2,2,1,0,0,2,4,2
401488076,Bryant Bulldogs,L. Castagne,4705423,,True,35.0,4,7,3,6,1,1,0,0,0,2,2,0,1,0,1,1,9
401488076,Bryant Bulldogs,M. Bodziony,4703744,,True,29.0,5,13,5,12,0,1,0,0,0,4,4,2,0,0,4,4,10
401488076,Bryant Bulldogs,N. Gallagher,4595707,,True,31.0,3,6,1,2,2,4,0,0,2,2,4,3,1,0,4,4,8
401488076,Bryant Bulldogs,D. Kiefer,4900604,,False,22.0,2,4,1,2,1,2,1,2,3,4,7,0,1,1,1,0,6
401488076,Bryant Bulldogs,J. Berens,4900603,,False,16.0,1,3,1,3,0,0,4,4,1,0,1,1,1,0,0,1,6
401488076,Bryant Bulldogs,K. Reynolds,4705227,,False,19.0,3,5,3,5,0,0,2,4,1,1,2,0,2,0,3,3,8
401488076,Bryant Bulldogs,A. Perkins,4595703,,False,6.0,0,2,0,0,0,2,0,0,0,1,1,0,0,0,1,0,0
401488076,Bryant Bulldogs,TEAM,TOTAL,TOTAL,False,,26,54,22,44,4,10,8,12,12,21,33,7,6,3,18,21,64
401488075,Monmouth Hawks,L. Marsicano,4399472,,True,16.0,0,3,0,1,0,2,0,0,0,0,0,2,1,0,2,4,0
401488075,Monmouth Hawks,B. Kranbuhl,4704490,,True,20.0,4,5,4,5,0,0,0,0,1,1,2,2,0,2,1,3,8
401488075,Monmouth Hawks,A. Coleman,5108818,,True,32.0,4,5,1,2,3,3,2,2,0,4,4,5,2,1,5,4,13
401488075,Monmouth Hawks,K. Donovan,4596543,,True,18.0,2,5,0,2,2,3,0,0,2,2,4,1,0,1,3,0,6
401488075,Monmouth Hawks,B. Tinsley,4281227,,True,33.0,3,8,2,3,1,5,2,2,0,4,4,4,1,0,4,0,9
401488075,Monmouth Hawks,L. Thomas,4399177,,False,25.0,6,8,5,6,1,2,1,4,1,5,6,0,0,1,1,3,14
401488075,Monmouth Hawks,A. Carroll,5108819,,False,14.0,0,4,0,2,0,2,0,0,0,4,4,0,1,0,1,1,0
401488075,Monmouth Hawks,A. Panayides,4899852,,False,26.0,0,1,0,0,0,1,0,0,0,2,2,1,1,0,0,4,0
401488075,Monmouth Hawks,J. Hall,4704487,,False,5.0,1,1,1,1,0,0,1,2,0,0,0,0,0,0,0,0,3
401488075,Monmouth Hawks,J. Louro,4281169,,False,11.0,2,3,0,0,2,3,0,0,0,1,1,0,0,0,0,1,6
401488075,Monmouth Hawks,TEAM,TOTAL,TOTAL,False,,22,43,13,22,9,21,6,10,4,24,28,15,6,5,18,20,59
401488075,Loyola Maryland Greyhounds,L. Therien,4900552,,True,36.0,7,14,7,13,0,1,5,6,0,9,9,0,3,0,1,2,19
401488075,Loyola Maryland Greyhounds,K. Sims,4898948,,True,31.0,5,12,5,12,0,0,0,3,6,3,9,3,1,0,0,0,10
401488075,Loyola Maryland Greyhounds,M. Van-Otoo,5109223,,True,6.0,0,1,0,1,0,0,0,0,0,0,0,0,0,0,1,0,0
401488075,Loyola Maryland Greyhounds,B. Rozzi,4596306,,True,35.0,1,7,0,3,1,4,0,0,1,0,1,3,1,0,2,3,3
401488075,Loyola Maryland Greyhounds,T. Dixon,4400209,,True,35.0,4,13,1,6,3,7,3,4,0,1,1,2,2,0,5,3,14
401488075,Loyola Maryland Greyhounds,M. Espinal,5109228,,False,4.0,0,0,0,0,0,0,0,0,0,1,1,0,0,0,1,0,0
401488075,Loyola Maryland Greyhounds,E. Glezen,4596304,,False,7.0,0,0,0,0,0,0,2,2,2,0,2,1,1,0,0,0,2
401488075,Loyola Maryland Greyhounds,C. Garcia,5109224,,False,8.0,1,1,1,1,0,0,0,0,1,0,1,0,0,0,0,2,2
401488075,Loyola Maryland Greyhounds,K. Ratigan,5109222,,False,4.0,0,2,0,0,0,2,0,0,0,0,0,0,0,0,1,0,0
401488075,Loyola Maryland Greyhounds,C. Tanedo,4704774,,False,34.0,3,7,1,3,2,4,3,3,3,0,3,2,1,0,1,1,11
401488075,Loyola Maryland Greyhounds,TEAM,TOTAL,TOTAL,False,,21,57,15,39,6,18,13,18,15,17,32,11,9,0,12,11,61
401488074,Morgan State Lady Bears,F. Black,4899964,,True,19.0,2,3,2,3,0,0,0,0,0,3,3,0,2,0,1,3,4
401488074,Morgan State Lady Bears,T. Addison,4399569,,True,30.0,0,5,0,3,0,2,0,0,1,1,2,1,2,0,1,1,0
401488074,Morgan State Lady Bears,C. Shepherd,4399530,,True,26.0,4,17,3,15,1,2,10,10,2,4,6,2,3,0,2,4,19
401488074,Morgan State Lady Bears,G. Johnson,5110008,,True,24.0,2,6,2,5,0,1,0,1,0,3,3,2,0,0,0,1,4
401488074,Morgan State Lady Bears,J. Henson,4595536,,True,35.0,8,15,4,7,4,8,2,2,1,3,4,4,3,0,2,1,22
401488074,Morgan State Lady Bears,S. McCrae,4594729,,False,17.0,1,3,1,3,0,0,1,2,1,2,3,0,1,0,0,1,3
401488074,Morgan State Lady Bears,J. Butler,5110007,,False,9.0,0,3,0,3,0,0,0,0,0,1,1,0,1,0,1,2,0
401488074,Morgan State Lady Bears,V. Oduah,4900417,,False,10.0,0,1,0,0,0,1,0,0,0,0,0,1,1,0,0,3,0
401488074,Morgan State Lady Bears,E. Jones,4899961,,False,22.0,3,5,2,2,1,3,0,0,0,0,0,1,1,0,2,2,7
401488074,Morgan State Lady Bears,S. Johnson,4281695,,False,8.0,0,2,0,1,0,1,0,0,0,1,1,0,0,0,0,0,0
401488074,Morgan State Lady Bears,TEAM,TOTAL,TOTAL,False,,20,60,14,42,6,18,13,15,5,20,25,11,14,0,9,18,59
401488074,Loyola Maryland Greyhounds,L. Therien,4900552,,True,35.0,10,15,10,15,0,0,0,2,1,12,13,1,3,0,6,2,20
401488074,Loyola Maryland Greyhounds,K. Sims,4898948,,True,35.0,2,6,2,6,0,0,1,2,5,10,15,3,1,2,3,3,5
401488074,Loyola Maryland Greyhounds,B. Rozzi,4596306,,True,10.0,0,2,0,2,0,0,0,0,0,2,2,0,0,0,2,1,0
401488074,Loyola Maryland Greyhounds,M. Van-Otoo,5109223,,True,25.0,1,4,1,3,0,1,1,2,0,2,2,4,1,0,4,4,3
401488074,Loyola Maryland Greyhounds,T. Dixon,4400209,,True,35.0,4,11,3,6,1,5,4,4,0,3,3,1,0,0,6,2,13
401488074,Loyola Maryland Greyhounds,A. Therien,4596307,,False,2.0,0,1,0,1,0,0,0,0,0,0,0,1,0,0,0,0,0
401488074,Loyola Maryland Greyhounds,E. Glezen,4596304,,False,7.0,0,0,0,0,0,0,0,0,0,0,0,0,0,0,1,2,0
401488074,Loyola Maryland Greyhounds,C. Garcia,5109224,,False,9.0,0,2,0,0,0,2,0,0,0,1,1,0,0,0,2,1,0
401488074,Loyola Maryland Greyhounds,K. Ratigan,5109222,,False,19.0,2,5,0,1,2,4,0,0,1,0,1,1,0,0,1,0,6
401488074,Loyola Maryland Greyhounds,C. Tanedo,4704774,,False,23.0,1,3,0,0,1,3,0,0,0,2,2,0,0,0,2,1,3
401488074,Loyola Maryland Greyhounds,TEAM,TOTAL,TOTAL,False,,20,49,16,34,4,15,6,10,9,37,46,11,5,2,27,16,50
401488073,Niagara Purple Eagles,J. Rutledge,5109310,,True,24.0,2,3,2,3,0,0,0,0,1,2,3,0,3,3,3,4,4
401488073,Niagara Purple Eagles,Aa. Parker,4899856,,True,31.0,7,13,6,10,1,3,2,3,0,5,5,1,2,1,1,3,17
401488073,Niagara Purple Eagles,L. Porter,4704527,,True,16.0,2,9,0,2,2,7,0,0,0,0,0,1,0,0,0,3,6
401488073,Niagara Purple Eagles,An. Parker,4595385,,True,23.0,4,14,4,9,0,5,6,8,1,4,5,2,2,0,3,4,14
401488073,Niagara Purple Eagles,M. Yelle,4399133,,True,31.0,5,11,4,7,1,4,1,2,0,1,1,3,2,0,5,3,12
401488073,Niagara Purple Eagles,A. Strong,5109308,,False,1.0,0,0,0,0,0,0,0,0,0,0,0,0,0,0,1,0,0
401488073,Niagara Purple Eagles,S. Faulcon,4595386,,False,16.0,3,6,3,6,0,0,0,0,1,2,3,0,0,1,1,2,6
401488073,Niagara Purple Eagles,M. Dickerson,5109309,,False,9.0,0,0,0,0,0,0,0,0,1,1,2,0,0,0,2,3,0
401488073,Niagara Purple Eagles,A. Hicks,5109307,,False,21.0,1,3,1,2,0,1,0,0,3,1,4,4,2,0,1,2,2
401488073,Niagara Purple Eagles,S. Fiddler,5109306,,False,14.0,1,3,0,0,1,3,0,0,0,1,1,3,0,0,0,1,3
401488073,Niagara Purple Eagles,B. Jones,4704525,,False,14.0,0,1,0,1,0,0,0,0,1,2,3,1,1,0,2,2,0
401488073,Niagara Purple Eagles,TEAM,TOTAL,TOTAL,False,,25,63,20,40,5,23,9,13,9,23,32,15,12,5,20,27,64
401488073,Loyola Maryland Greyhounds,L. Therien,4900552,,True,35.0,5,12,5,12,0,0,6,7,3,17,20,1,2,2,7,1,16
401488073,Loyola Maryland Greyhounds,K. Sims,4898948,,True,28.0,7,11,7,11,0,0,1,3,4,3,7,0,0,1,1,3,15
401488073,Loyola Maryland Greyhounds,C. Tanedo,4704774,,True,27.0,0,5,0,2,0,3,0,0,1,0,1,1,0,0,2,0,0
401488073,Loyola Maryland Greyhounds,B. Rozzi,4596306,,True,21.0,2,2,2,2,0,0,2,2,0,1,1,2,0,0,5,4,6
401488073,Loyola Maryland Greyhounds,T. Dixon,4400209,,True,28.0,2,9,1,6,1,3,2,4,0,4,4,2,2,0,2,1,7
401488073,Loyola Maryland Greyhounds,A. Therien,4596307,,False,2.0,0,0,0,0,0,0,1,2,0,0,0,0,0,0,0,1,1
401488073,Loyola Maryland Greyhounds,E. Glezen,4596304,,False,15.0,1,1,1,1,0,0,0,0,0,0,0,1,0,1,1,2,2
401488073,Loyola Maryland Greyhounds,C. Garcia,5109224,,False,8.0,0,2,0,1,0,1,0,0,0,0,0,1,0,0,2,1,0
401488073,Loyola Maryland Greyhounds,M. Van-Otoo,5109223,,False,20.0,3,6,3,5,0,1,0,2,1,1,2,2,0,0,5,3,6
401488073,Loyola Maryland Greyhounds,K. Ratigan,5109222,,False,16.0,0,2,0,0,0,2,2,2,0,0,0,2,1,0,7,1,2
401488073,Loyola Maryland Greyhounds,TEAM,TOTAL,TOTAL,False,,20,50,19,40,1,10,14,22,12,31,43,12,5,4,33,17,55
401488072,St. Francis Brooklyn Terriers,S. Bandoma,4900504,,True,7.0,0,3,0,3,0,0,0,0,0,2,2,0,0,0,3,1,0
401488072,St. Francis Brooklyn Terriers,B. Green,5106091,,True,24.0,1,7,1,7,0,0,2,2,4,7,11,1,1,0,6,2,4
401488072,St. Francis Brooklyn Terriers,T. Myers,5106088,,True,29.0,4,10,2,3,2,7,0,0,1,0,1,3,3,0,2,3,10
401488072,St. Francis Brooklyn Terriers,E. Varga,4705060,,True,36.0,1,6,0,1,1,5,0,0,0,5,5,7,0,0,2,2,3
401488072,St. Francis Brooklyn Terriers,A. Fisher,4595797,,True,40.0,10,22,3,6,7,16,3,3,0,3,3,0,2,0,0,0,30
401488072,St. Francis Brooklyn Terriers,P. Martin,5106089,,False,6.0,0,1,0,1,0,0,0,0,2,0,2,0,0,0,0,0,0
401488072,St. Francis Brooklyn Terriers,S. Kavanagh,4900503,,False,13.0,1,3,1,2,0,1,0,0,0,1,1,0,0,0,2,2,2
401488072,St. Francis Brooklyn Terriers,Z. Hutchinson,4705058,,False,28.0,0,6,0,6,0,0,3,6,3,1,4,2,1,0,1,4,3
401488072,St. Francis Brooklyn Terriers,A. Belloso,5106092,,False,14.0,0,2,0,0,0,2,0,0,1,3,4,0,1,0,0,0,0
401488072,St. Francis Brooklyn Terriers,K. Januszewska,5106090,,False,3.0,0,0,0,0,0,0,0,0,0,0,0,0,0,0,0,3,0
401488072,St. Francis Brooklyn Terriers,TEAM,TOTAL,TOTAL,False,,17,60,7,29,10,31,8,11,16,22,38,13,8,0,17,17,52
401488072,Lafayette Leopards,K. Drummond,4704754,,True,37.0,0,2,0,2,0,0,1,8,2,8,10,1,1,2,1,1,1
401488072,Lafayette Leopards,S. Ntaconayigize,5109216,,True,29.0,1,3,0,1,1,2,0,0,0,6,6,2,1,1,0,0,3
401488072,Lafayette Leopards,K. Favours,4900541,,True,37.0,7,12,3,4,4,8,0,0,0,2,2,0,1,0,0,3,18
401488072,Lafayette Leopards,M. Andrews,4704756,,True,23.0,4,12,4,12,0,0,0,0,0,1,1,2,3,0,6,4,8
401488072,Lafayette Leopards,J. Booth,4433381,,True,37.0,7,14,6,11,1,3,3,8,2,3,5,5,1,0,6,4,18
401488072,Lafayette Leopards,E. Shields,5109214,,False,23.0,2,2,2,2,0,0,1,2,2,5,7,0,0,0,2,3,5
401488072,Lafayette Leopards,A. Matthews,4703689,,False,1.0,0,0,0,0,0,0,0,0,0,0,0,0,0,0,0,0,0
401488072,Lafayette Leopards,K. Donahue,5109215,,False,13.0,0,1,0,1,0,0,0,0,0,0,0,1,2,0,0,0,0
401488072,Lafayette Leopards,TEAM,TOTAL,TOTAL,False,,21,46,15,33,6,13,5,18,6,28,34,11,9,3,15,15,53
401488071,Lafayette Leopards,K. Drummond,4704754,,True,36.0,1,4,1,4,0,0,0,0,2,4,6,1,0,0,0,1,2
401488071,Lafayette Leopards,A. Antognoli,4900540,,True,33.0,2,10,1,5,1,5,3,4,0,2,2,5,4,0,3,0,8
401488071,Lafayette Leopards,M. Andrews,4704756,,True,21.0,4,7,4,6,0,1,3,4,1,2,3,1,0,0,5,4,11
401488071,Lafayette Leopards,H. Smith,4704553,,True,33.0,3,11,0,6,3,5,1,2,0,3,3,0,2,0,2,1,10
401488071,Lafayette Leopards,J. Booth,4433381,,True,32.0,3,8,2,6,1,2,0,0,1,3,4,1,0,0,3,4,7
401488071,Lafayette Leopards,S. Ntaconayigize,5109216,,False,10.0,0,1,0,1,0,0,1,2,1,1,2,0,0,0,1,0,1
401488071,Lafayette Leopards,K. Donahue,5109215,,False,12.0,2,4,2,2,0,2,0,0,1,1,2,0,1,0,1,4,4
401488071,Lafayette Leopards,K. Favours,4900541,,False,23.0,0,6,0,1,0,5,0,0,1,1,2,1,1,0,3,0,0
401488071,Lafayette Leopards,TEAM,TOTAL,TOTAL,False,,15,51,10,31,5,20,8,12,9,17,26,9,8,0,19,14,43
401488071,Columbia Lions,K. Davis,4433382,,True,24.0,3,5,3,4,0,1,0,0,0,4,4,4,4,1,0,0,6
401488071,Columbia Lions,H. Pratt,4399165,,True,14.0,2,6,2,2,0,4,0,1,0,4,4,0,1,0,1,0,4
401488071,Columbia Lions,K. Henderson,4899283,,True,22.0,3,8,3,4,0,4,1,1,2,0,2,7,1,0,3,3,7
401488071,Columbia Lions,A. Hsu,4594973,,True,23.0,9,11,2,3,7,8,0,0,1,2,3,4,1,0,0,0,25
401488071,Columbia Lions,J. Patrick,4433322,,True,21.0,7,14,6,8,1,6,2,2,0,4,4,3,3,0,2,3,17
401488071,Columbia Lions,S. Rafiu,5108933,,False,11.0,3,4,2,2,1,2,0,2,0,1,1,0,0,0,0,2,7
401488071,Columbia Lions,M. Lobon,4705212,,False,2.0,0,0,0,0,0,0,0,0,0,0,0,0,0,1,0,0,0
401488071,Columbia Lions,P. Page,5108934,,False,17.0,3,4,2,2,1,2,3,3,0,4,4,2,1,0,1,0,10
401488071,Columbia Lions,C. Rivera,4594972,,False,20.0,2,3,0,0,2,3,0,0,3,3,6,6,2,0,4,0,6
401488071,Columbia Lions,P. Lauder,4433491,,False,22.0,3,6,3,5,0,1,0,0,1,2,3,0,0,0,1,1,6
401488071,Columbia Lions,L. Kennedy,4399168,,False,9.0,0,0,0,0,0,0,1,2,0,1,1,0,1,0,0,1,1
401488071,Columbia Lions,S. Durr,4399167,,False,15.0,1,2,1,1,0,1,0,0,2,2,4,3,0,0,0,0,2
401488071,Columbia Lions,TEAM,TOTAL,TOTAL,False,,36,63,24,31,12,32,7,11,12,27,39,29,14,2,12,10,91
401488070,Marist Red Foxes,Z. Shazer,5109005,,True,36.0,3,18,3,17,0,1,2,4,5,9,14,4,1,0,1,2,8
401488070,Marist Red Foxes,M. Donnelly,4594789,,True,21.0,4,7,4,7,0,0,1,5,2,0,2,1,1,3,2,1,9
401488070,Marist Red Foxes,K. Fisher,4596332,,True,31.0,1,10,1,8,0,2,3,3,0,2,2,2,1,0,2,1,5
401488070,Marist Red Foxes,J. Bonilla,4595376,,True,21.0,0,2,0,1,0,1,2,2,2,2,4,0,1,0,2,2,2
401488070,Marist Red Foxes,K. Krick,4399130,,True,34.0,3,9,2,5,1,4,1,2,1,2,3,1,6,0,1,0,8
401488070,Marist Red Foxes,C. Croker,5109006,,False,6.0,1,1,1,1,0,0,0,0,0,0,0,0,0,0,0,1,2
401488070,Marist Red Foxes,S. Bailey,4595377,,False,12.0,0,0,0,0,0,0,3,4,1,3,4,0,1,0,1,0,3
401488070,Marist Red Foxes,M. Tompkins,5109007,,False,3.0,1,2,1,1,0,1,1,2,0,0,0,0,0,0,0,1,3
401488070,Marist Red Foxes,J. Piddock,5109003,,False,26.0,4,6,3,5,1,1,3,4,0,5,5,0,1,1,3,2,12
401488070,Marist Red Foxes,C. Cunningham,4899849,,False,10.0,0,1,0,0,0,1,0,0,0,1,1,0,1,0,0,0,0
401488070,Marist Red Foxes,TEAM,TOTAL,TOTAL,False,,17,56,15,45,2,11,16,26,12,26,38,8,13,4,14,10,52
401488070,Lafayette Leopards,E. Shields,5109214,,True,22.0,1,7,0,3,1,4,0,0,1,2,3,0,0,1,3,3,3
401488070,Lafayette Leopards,A. Antognoli,4900540,,True,39.0,3,12,1,6,2,6,2,2,3,3,6,1,2,0,3,3,10
401488070,Lafayette Leopards,M. Andrews,4704756,,True,32.0,5,13,5,12,0,1,0,0,5,8,13,1,1,0,6,3,10
401488070,Lafayette Leopards,H. Smith,4704553,,True,36.0,4,9,3,4,1,5,2,2,4,4,8,1,0,0,3,4,11
401488070,Lafayette Leopards,J. Booth,4433381,,True,32.0,2,8,2,7,0,1,0,2,1,8,9,3,0,0,5,3,4
401488070,Lafayette Leopards,S. Ntaconayigize,5109216,,False,19.0,0,3,0,0,0,3,0,0,1,2,3,1,0,0,1,2,0
401488070,Lafayette Leopards,K. Donahue,5109215,,False,6.0,0,3,0,2,0,1,2,2,3,0,3,0,0,0,1,1,2
401488070,Lafayette Leopards,K. Favours,4900541,,False,14.0,1,7,1,1,0,6,0,0,0,1,1,0,2,0,1,1,2
401488070,Lafayette Leopards,TEAM,TOTAL,TOTAL,False,,16,62,12,35,4,27,6,8,21,30,51,7,5,1,23,20,42
401488069,Siena Saints,A. Brown,4899879,,True,27.0,6,9,6,9,0,0,1,2,1,8,9,0,2,3,3,4,13
401488069,Siena Saints,E. Mevius,5109410,,True,30.0,2,7,1,5,1,2,3,4,0,6,6,7,2,0,5,1,8
401488069,Siena Saints,L. Gamble,5109405,,True,31.0,3,10,3,9,0,1,0,0,3,1,4,3,1,0,3,1,6
401488069,Siena Saints,T. Seppala,5109404,,True,36.0,5,11,3,4,2,7,0,0,0,7,7,3,0,2,3,1,12
401488069,Siena Saints,A. Jackson,4704629,,True,33.0,6,16,1,7,5,9,1,1,2,2,4,1,2,0,1,1,18
401488069,Siena Saints,E. Selimovic,4899878,,False,16.0,1,5,1,4,0,1,0,0,0,4,4,0,2,0,2,1,2
401488069,Siena Saints,B. McCann,5109409,,False,2.0,0,1,0,0,0,1,0,0,1,0,1,0,0,0,0,0,0
401488069,Siena Saints,A. Jones,5109408,,False,25.0,2,5,2,5,0,0,0,0,1,2,3,3,3,0,3,0,4
401488069,Siena Saints,TEAM,TOTAL,TOTAL,False,,25,64,17,43,8,21,5,7,10,34,44,17,12,5,20,9,63
401488069,Lafayette Leopards,E. Shields,5109214,,True,28.0,0,4,0,4,0,0,0,0,0,5,5,3,3,1,1,0,0
401488069,Lafayette Leopards,A. Antognoli,4900540,,True,36.0,5,13,3,9,2,4,0,1,0,4,4,4,2,0,5,1,12
401488069,Lafayette Leopards,M. Andrews,4704756,,True,37.0,7,13,7,12,0,1,4,5,3,9,12,2,0,0,4,4,18
401488069,Lafayette Leopards,H. Smith,4704553,,True,31.0,4,11,1,5,3,6,0,0,2,4,6,1,1,0,4,0,11
401488069,Lafayette Leopards,J. Booth,4433381,,True,32.0,3,9,3,7,0,2,2,2,2,2,4,3,0,0,4,2,8
401488069,Lafayette Leopards,S. Ntaconayigize,5109216,,False,17.0,2,4,2,3,0,1,0,0,0,0,0,2,0,0,0,0,4
401488069,Lafayette Leopards,K. Donahue,5109215,,False,4.0,0,2,0,1,0,1,0,0,0,1,1,0,0,0,0,0,0
401488069,Lafayette Leopards,K. Favours,4900541,,False,15.0,1,8,1,3,0,5,0,0,0,0,0,0,0,0,2,2,2
401488069,Lafayette Leopards,TEAM,TOTAL,TOTAL,False,,22,64,17,44,5,20,6,8,9,29,38,15,6,1,20,9,55
401488068,Lafayette Leopards,E. Shields,5109214,,True,33.0,0,4,0,3,0,1,0,0,1,6,7,2,2,1,0,2,0
401488068,Lafayette Leopards,A. Antognoli,4900540,,True,36.0,6,13,4,7,2,6,2,3,0,2,2,5,2,0,2,1,16
401488068,Lafayette Leopards,M. Andrews,4704756,,True,26.0,5,7,3,5,2,2,2,3,0,5,5,0,0,1,2,5,14
401488068,Lafayette Leopards,H. Smith,4704553,,True,36.0,5,11,4,7,1,4,2,4,1,1,2,2,4,0,1,2,13
401488068,Lafayette Leopards,J. Booth,4433381,,True,30.0,3,11,3,9,0,2,0,0,0,1,1,3,1,0,6,1,6
401488068,Lafayette Leopards,S. Ntaconayigize,5109216,,False,7.0,0,0,0,0,0,0,1,2,0,2,2,0,1,0,0,0,1
401488068,Lafayette Leopards,K. Donahue,5109215,,False,3.0,0,1,0,0,0,1,0,0,0,1,1,0,1,0,0,0,0
401488068,Lafayette Leopards,K. Favours,4900541,,False,29.0,4,7,2,3,2,4,0,0,0,1,1,1,0,0,1,2,10
401488068,Lafayette Leopards,TEAM,TOTAL,TOTAL,False,,23,54,16,34,7,20,7,12,3,23,26,13,11,2,14,13,60
401488068,Cornell Big Red,E. Pape,5108938,,True,19.0,1,8,1,7,0,1,0,2,3,10,13,0,0,0,1,1,2
401488068,Cornell Big Red,S. Parker-Hall,4899288,,True,24.0,2,4,2,4,0,0,6,7,2,4,6,1,3,1,2,5,10
401488068,Cornell Big Red,K. Ingram,4705218,,True,30.0,1,9,1,6,0,3,1,4,1,0,1,3,0,0,3,2,3
401488068,Cornell Big Red,S. Mulroy,4594970,,True,36.0,3,8,2,4,1,4,2,3,2,3,5,3,0,0,2,2,9
401488068,Cornell Big Red,A. McNicholas,4594968,,True,29.0,4,14,1,5,3,9,1,2,1,6,7,3,3,0,3,1,12
401488068,Cornell Big Red,J. Davis,4899286,,False,4.0,0,0,0,0,0,0,0,0,0,1,1,0,0,0,0,1,0
401488068,Cornell Big Red,A. Hovis,4594969,,False,18.0,3,5,3,5,0,0,0,0,3,4,7,2,0,0,0,1,6
401488068,Cornell Big Red,R. Williams,5108939,,False,19.0,5,7,5,6,0,1,0,1,0,0,0,1,0,0,2,1,10
401488068,Cornell Big Red,V. Knee,5108936,,False,6.0,1,3,0,1,1,2,0,0,0,0,0,0,0,0,0,0,3
401488068,Cornell Big Red,M. Beam,4705216,,False,15.0,3,4,2,3,1,1,0,0,0,0,0,0,0,0,0,0,7
401488068,Cornell Big Red,TEAM,TOTAL,TOTAL,False,,23,62,17,41,6,21,10,19,14,28,42,13,6,1,13,14,62
401488067,Lafayette Leopards,K. Drummond,4704754,,True,24.0,2,5,2,5,0,0,2,2,5,5,10,1,1,0,0,2,6
401488067,Lafayette Leopards,A. Antognoli,4900540,,True,37.0,3,11,3,6,0,5,0,0,0,3,3,3,1,0,0,0,6
401488067,Lafayette Leopards,M. Andrews,4704756,,True,29.0,5,13,4,9,1,4,2,4,2,3,5,1,1,0,5,3,13
401488067,Lafayette Leopards,H. Smith,4704553,,True,30.0,3,5,2,3,1,2,0,0,1,1,2,1,0,1,0,1,7
401488067,Lafayette Leopards,J. Booth,4433381,,True,30.0,3,11,2,8,1,3,1,1,0,1,1,0,0,0,2,0,8
401488067,Lafayette Leopards,E. Shields,5109214,,False,14.0,1,2,1,1,0,1,0,0,1,3,4,1,0,1,3,2,2
401488067,Lafayette Leopards,S. Ntaconayigize,5109216,,False,6.0,0,3,0,1,0,2,0,0,0,1,1,0,0,0,0,1,0
401488067,Lafayette Leopards,K. Donahue,5109215,,False,11.0,0,2,0,1,0,1,0,0,0,1,1,0,0,0,0,3,0
401488067,Lafayette Leopards,K. Favours,4900541,,False,19.0,1,6,0,1,1,5,0,0,2,0,2,1,0,0,0,3,3
401488067,Lafayette Leopards,TEAM,TOTAL,TOTAL,False,,18,58,14,35,4,23,5,7,12,18,30,8,3,2,12,15,45
401488067,East Tennessee State Bucs,J. McDaniel,5107912,,True,22.0,3,6,3,5,0,1,0,0,1,4,5,2,0,0,2,5,6
401488067,East Tennessee State Bucs,K. Folley,4899217,,True,32.0,3,6,2,5,1,1,0,0,0,2,2,4,2,0,4,2,7
401488067,East Tennessee State Bucs,C. Moore,4704244,,True,18.0,2,5,0,0,2,5,0,0,0,1,1,3,1,0,3,1,6
401488067,East Tennessee State Bucs,J. Ruffus-Milner,4400490,,True,17.0,1,3,1,3,0,0,2,2,4,3,7,0,0,0,1,1,4
401488067,East Tennessee State Bucs,J. Thomas,4281572,,True,29.0,8,16,6,11,2,5,4,4,1,4,5,2,0,0,1,2,22
401488067,East Tennessee State Bucs,E. Boyle,5107915,,False,5.0,0,3,0,3,0,0,0,0,0,1,1,0,0,0,1,1,0
401488067,East Tennessee State Bucs,J. Davis,4704245,,False,18.0,6,6,6,6,0,0,4,4,2,5,7,0,1,0,0,2,16
401488067,East Tennessee State Bucs,P. McCarthy,5107911,,False,4.0,1,2,0,1,1,1,1,1,0,1,1,0,0,0,0,0,4
401488067,East Tennessee State Bucs,A. Vananda,4900392,,False,11.0,0,1,0,1,0,0,0,0,1,3,4,0,0,0,0,1,0
401488067,East Tennessee State Bucs,M. Kirtner,4900391,,False,11.0,0,3,0,0,0,3,0,0,0,0,0,1,1,0,0,0,0
401488067,East Tennessee State Bucs,N. Brown,4596341,,False,33.0,0,4,0,2,0,2,0,0,2,4,6,3,1,1,0,1,0
401488067,East Tennessee State Bucs,TEAM,TOTAL,TOTAL,False,,24,55,18,37,6,18,11,11,13,29,42,15,6,1,13,16,65
401488066,Loyola Maryland Greyhounds,L. Therien,4900552,,True,32.0,7,11,7,11,0,0,9,12,1,8,9,0,2,0,1,3,23
401488066,Loyola Maryland Greyhounds,K. Ratigan,5109222,,True,36.0,3,10,2,4,1,6,0,0,0,3,3,1,0,0,2,2,7
401488066,Loyola Maryland Greyhounds,B. Rozzi,4596306,,True,26.0,0,4,0,4,0,0,0,0,1,2,3,4,0,0,1,4,0
401488066,Loyola Maryland Greyhounds,T. Dixon,4400209,,True,35.0,4,11,4,8,0,3,0,0,0,1,1,5,4,0,1,3,8
401488066,Loyola Maryland Greyhounds,D. Newman,4399474,,True,25.0,4,6,3,4,1,2,0,0,1,1,2,0,0,0,1,0,9
401488066,Loyola Maryland Greyhounds,M. Espinal,5109228,,False,12.0,1,2,1,2,0,0,0,0,1,2,3,0,0,0,0,1,2
401488066,Loyola Maryland Greyhounds,C. Garcia,5109224,,False,14.0,0,1,0,1,0,0,0,0,1,1,2,0,0,0,2,0,0
401488066,Loyola Maryland Greyhounds,M. Van-Otoo,5109223,,False,7.0,0,0,0,0,0,0,1,2,0,0,0,0,0,0,2,0,1
401488066,Loyola Maryland Greyhounds,L. Salmeron,4900549,,False,13.0,0,0,0,0,0,0,0,0,0,0,0,1,1,0,1,1,0
401488066,Loyola Maryland Greyhounds,TEAM,TOTAL,TOTAL,False,,19,45,17,34,2,11,10,14,6,18,24,11,7,0,11,14,50
401488066,Loyola Maryland Greyhounds,L. Therien,4900552,,True,32.0,7,11,7,11,0,0,9,12,1,8,9,0,2,0,1,3,23
401488066,Loyola Maryland Greyhounds,K. Ratigan,5109222,,True,36.0,3,10,2,4,1,6,0,0,0,3,3,1,0,0,2,2,7
401488066,Loyola Maryland Greyhounds,B. Rozzi,4596306,,True,26.0,0,4,0,4,0,0,0,0,1,2,3,4,0,0,1,4,0
401488066,Loyola Maryland Greyhounds,T. Dixon,4400209,,True,35.0,4,11,4,8,0,3,0,0,0,1,1,5,4,0,1,3,8
401488066,Loyola Maryland Greyhounds,D. Newman,4399474,,True,25.0,4,6,3,4,1,2,0,0,1,1,2,0,0,0,1,0,9
401488066,Loyola Maryland Greyhounds,M. Espinal,5109228,,False,12.0,1,2,1,2,0,0,0,0,1,2,3,0,0,0,0,1,2
401488066,Loyola Maryland Greyhounds,C. Garcia,5109224,,False,14.0,0,1,0,1,0,0,0,0,1,1,2,0,0,0,2,0,0
401488066,Loyola Maryland Greyhounds,M. Van-Otoo,5109223,,False,7.0,0,0,0,0,0,0,1,2,0,0,0,0,0,0,2,0,1
401488066,Loyola Maryland Greyhounds,L. Salmeron,4900549,,False,13.0,0,0,0,0,0,0,0,0,0,0,0,1,1,0,1,1,0
401488066,Loyola Maryland Greyhounds,TEAM,TOTAL,TOTAL,False,,19,45,17,34,2,11,10,14,6,18,24,11,7,0,11,14,50
401488066,Colgate Raiders,T. McMillan,4704704,,True,29.0,5,6,5,6,0,0,0,2,1,4,5,1,2,3,4,2,10
401488066,Colgate Raiders,C. Midgette,5109204,,True,23.0,1,3,1,3,0,0,2,2,4,1,5,1,0,0,0,4,4
401488066,Colgate Raiders,M. Schiller,5109205,,True,38.0,2,6,2,6,0,0,0,0,1,2,3,1,2,0,0,2,4
401488066,Colgate Raiders,T. Golembiewski,4900535,,True,33.0,7,14,7,13,0,1,5,6,1,2,3,1,3,0,0,0,19
401488066,Colgate Raiders,A. Brodie,4595550,,True,33.0,7,14,7,14,0,0,0,0,0,5,5,1,0,0,3,0,14
401488066,Colgate Raiders,S. Diehl,4900536,,False,16.0,2,4,2,4,0,0,0,0,2,0,2,0,0,0,1,2,4
401488066,Colgate Raiders,L. Blackmore,4704706,,False,11.0,1,1,1,1,0,0,0,0,0,0,0,0,0,0,1,0,2
401488066,Colgate Raiders,A. Ferguson,5109209,,False,1.0,0,1,0,1,0,0,0,0,0,0,0,0,0,0,0,0,0
401488066,Colgate Raiders,L. Cook,5109207,,False,2.0,0,0,0,0,0,0,0,0,0,0,0,0,0,0,0,0,0
401488066,Colgate Raiders,M. McMahon,4900534,,False,12.0,2,6,2,6,0,0,3,3,2,3,5,1,0,0,0,1,7
401488066,Colgate Raiders,J. Paul,4595552,,False,2.0,0,0,0,0,0,0,0,0,0,0,0,0,0,0,0,0,0
401488066,Colgate Raiders,TEAM,TOTAL,TOTAL,False,,27,55,27,54,0,1,10,13,11,20,31,6,7,3,10,11,64
401488066,Colgate Raiders,T. McMillan,4704704,,True,29.0,5,6,5,6,0,0,0,2,1,4,5,1,2,3,4,2,10
401488066,Colgate Raiders,C. Midgette,5109204,,True,23.0,1,3,1,3,0,0,2,2,4,1,5,1,0,0,0,4,4
401488066,Colgate Raiders,M. Schiller,5109205,,True,38.0,2,6,2,6,0,0,0,0,1,2,3,1,2,0,0,2,4
401488066,Colgate Raiders,T. Golembiewski,4900535,,True,33.0,7,14,7,13,0,1,5,6,1,2,3,1,3,0,0,0,19
401488066,Colgate Raiders,A. Brodie,4595550,,True,33.0,7,14,7,14,0,0,0,0,0,5,5,1,0,0,3,0,14
401488066,Colgate Raiders,S. Diehl,4900536,,False,16.0,2,4,2,4,0,0,0,0,2,0,2,0,0,0,1,2,4
401488066,Colgate Raiders,L. Blackmore,4704706,,False,11.0,1,1,1,1,0,0,0,0,0,0,0,0,0,0,1,0,2
401488066,Colgate Raiders,A. Ferguson,5109209,,False,1.0,0,1,0,1,0,0,0,0,0,0,0,0,0,0,0,0,0
401488066,Colgate Raiders,L. Cook,5109207,,False,2.0,0,0,0,0,0,0,0,0,0,0,0,0,0,0,0,0,0
401488066,Colgate Raiders,M. McMahon,4900534,,False,12.0,2,6,2,6,0,0,3,3,2,3,5,1,0,0,0,1,7
401488066,Colgate Raiders,J. Paul,4595552,,False,2.0,0,0,0,0,0,0,0,0,0,0,0,0,0,0,0,0,0
401488066,Colgate Raiders,TEAM,TOTAL,TOTAL,False,,27,55,27,54,0,1,10,13,11,20,31,6,7,3,10,11,64
401488065,Navy Midshipmen,M. Andrews,4704780,,True,40.0,9,13,9,13,0,0,0,0,1,10,11,3,0,0,5,4,18
401488065,Navy Midshipmen,L. Llewellyn,4595625,,True,31.0,5,9,4,7,1,2,1,2,0,3,3,3,0,0,3,5,12
401488065,Navy Midshipmen,K. Samson,5109237,,True,27.0,4,11,4,11,0,0,0,0,2,2,4,1,1,0,0,2,8
401488065,Navy Midshipmen,M. Louridas,5109236,,True,36.0,0,5,0,2,0,3,1,4,0,3,3,2,0,0,1,0,1
401488065,Navy Midshipmen,M. Schrader,4595622,,True,35.0,0,2,0,1,0,1,0,0,0,1,1,1,1,0,3,1,0
401488065,Navy Midshipmen,M. Demos,5109235,,False,14.0,4,5,4,5,0,0,0,0,1,1,2,0,0,0,1,2,8
401488065,Navy Midshipmen,B. Coleman,5109233,,False,6.0,0,1,0,0,0,1,0,0,0,0,0,1,1,0,0,0,0
401488065,Navy Midshipmen,K. Giuliani,5109230,,False,0.0,0,0,0,0,0,0,0,0,0,0,0,0,0,0,0,0,0
401488065,Navy Midshipmen,S. Schofield,4704779,,False,11.0,0,4,0,2,0,2,0,0,1,1,2,0,0,0,1,1,0
401488065,Navy Midshipmen,TEAM,TOTAL,TOTAL,False,,22,50,21,41,1,9,2,6,5,24,29,11,3,0,15,15,47
401488065,Navy Midshipmen,M. Andrews,4704780,,True,40.0,9,13,9,13,0,0,0,0,1,10,11,3,0,0,5,4,18
401488065,Navy Midshipmen,L. Llewellyn,4595625,,True,31.0,5,9,4,7,1,2,1,2,0,3,3,3,0,0,3,5,12
401488065,Navy Midshipmen,K. Samson,5109237,,True,27.0,4,11,4,11,0,0,0,0,2,2,4,1,1,0,0,2,8
401488065,Navy Midshipmen,M. Louridas,5109236,,True,36.0,0,5,0,2,0,3,1,4,0,3,3,2,0,0,1,0,1
401488065,Navy Midshipmen,M. Schrader,4595622,,True,35.0,0,2,0,1,0,1,0,0,0,1,1,1,1,0,3,1,0
401488065,Navy Midshipmen,M. Demos,5109235,,False,14.0,4,5,4,5,0,0,0,0,1,1,2,0,0,0,1,2,8
401488065,Navy Midshipmen,B. Coleman,5109233,,False,6.0,0,1,0,0,0,1,0,0,0,0,0,1,1,0,0,0,0
401488065,Navy Midshipmen,K. Giuliani,5109230,,False,0.0,0,0,0,0,0,0,0,0,0,0,0,0,0,0,0,0,0
401488065,Navy Midshipmen,S. Schofield,4704779,,False,11.0,0,4,0,2,0,2,0,0,1,1,2,0,0,0,1,1,0
401488065,Navy Midshipmen,TEAM,TOTAL,TOTAL,False,,22,50,21,41,1,9,2,6,5,24,29,11,3,0,15,15,47
401488065,Colgate Raiders,T. McMillan,4704704,,True,29.0,2,4,2,4,0,0,2,4,4,1,5,2,2,0,2,2,6
401488065,Colgate Raiders,C. Midgette,5109204,,True,28.0,1,1,1,1,0,0,3,4,2,3,5,0,0,0,0,3,5
401488065,Colgate Raiders,M. Schiller,5109205,,True,35.0,3,5,2,3,1,2,0,0,0,5,5,4,1,0,1,0,7
401488065,Colgate Raiders,T. Golembiewski,4900535,,True,23.0,5,12,5,12,0,0,0,0,0,3,3,3,3,1,3,4,10
401488065,Colgate Raiders,A. Brodie,4595550,,True,34.0,4,11,4,11,0,0,5,6,1,4,5,3,1,0,0,2,13
401488065,Colgate Raiders,S. Diehl,4900536,,False,10.0,0,1,0,0,0,1,0,0,1,1,2,0,0,0,0,0,0
401488065,Colgate Raiders,L. Blackmore,4704706,,False,12.0,2,4,2,4,0,0,0,0,1,2,3,0,0,0,1,1,4
401488065,Colgate Raiders,M. McMahon,4900534,,False,22.0,4,12,4,11,0,1,0,0,1,2,3,0,1,0,2,1,8
401488065,Colgate Raiders,J. Paul,4595552,,False,7.0,0,4,0,1,0,3,0,0,0,0,0,1,1,0,0,0,0
401488065,Colgate Raiders,TEAM,TOTAL,TOTAL,False,,21,54,20,47,1,7,10,14,10,25,35,13,9,1,9,13,53
401488065,Colgate Raiders,T. McMillan,4704704,,True,29.0,2,4,2,4,0,0,2,4,4,1,5,2,2,0,2,2,6
401488065,Colgate Raiders,C. Midgette,5109204,,True,28.0,1,1,1,1,0,0,3,4,2,3,5,0,0,0,0,3,5
401488065,Colgate Raiders,M. Schiller,5109205,,True,35.0,3,5,2,3,1,2,0,0,0,5,5,4,1,0,1,0,7
401488065,Colgate Raiders,T. Golembiewski,4900535,,True,23.0,5,12,5,12,0,0,0,0,0,3,3,3,3,1,3,4,10
401488065,Colgate Raiders,A. Brodie,4595550,,True,34.0,4,11,4,11,0,0,5,6,1,4,5,3,1,0,0,2,13
401488065,Colgate Raiders,S. Diehl,4900536,,False,10.0,0,1,0,0,0,1,0,0,1,1,2,0,0,0,0,0,0
401488065,Colgate Raiders,L. Blackmore,4704706,,False,12.0,2,4,2,4,0,0,0,0,1,2,3,0,0,0,1,1,4
401488065,Colgate Raiders,M. McMahon,4900534,,False,22.0,4,12,4,11,0,1,0,0,1,2,3,0,1,0,2,1,8
401488065,Colgate Raiders,J. Paul,4595552,,False,7.0,0,4,0,1,0,3,0,0,0,0,0,1,1,0,0,0,0
401488065,Colgate Raiders,TEAM,TOTAL,TOTAL,False,,21,54,20,47,1,7,10,14,10,25,35,13,9,1,9,13,53
401488064,Lafayette Leopards,A. Matthews,4703689,,True,26.0,2,4,2,4,0,0,0,0,0,2,2,1,0,0,1,0,4
401488064,Lafayette Leopards,S. Ntaconayigize,5109216,,True,35.0,1,5,1,2,0,3,0,0,0,2,2,2,1,0,0,0,2
401488064,Lafayette Leopards,A. Antognoli,4900540,,True,37.0,7,17,4,14,3,3,1,2,2,1,3,1,2,0,2,2,18
401488064,Lafayette Leopards,M. Andrews,4704756,,True,31.0,4,11,4,11,0,0,3,4,2,1,3,1,0,0,4,5,11
401488064,Lafayette Leopards,H. Smith,4704553,,True,31.0,3,10,3,10,0,0,1,1,4,2,6,2,1,0,2,3,7
401488064,Lafayette Leopards,K. Donahue,5109215,,False,12.0,0,3,0,2,0,1,3,3,0,0,0,1,1,1,0,4,3
401488064,Lafayette Leopards,K. Favours,4900541,,False,28.0,3,7,3,7,0,0,1,2,0,0,0,1,3,0,0,0,7
401488064,Lafayette Leopards,TEAM,TOTAL,TOTAL,False,,20,57,17,50,3,7,9,12,8,12,20,9,8,1,9,14,52
401488064,Lafayette Leopards,A. Matthews,4703689,,True,26.0,2,4,2,4,0,0,0,0,0,2,2,1,0,0,1,0,4
401488064,Lafayette Leopards,S. Ntaconayigize,5109216,,True,35.0,1,5,1,2,0,3,0,0,0,2,2,2,1,0,0,0,2
401488064,Lafayette Leopards,A. Antognoli,4900540,,True,37.0,7,17,4,14,3,3,1,2,2,1,3,1,2,0,2,2,18
401488064,Lafayette Leopards,M. Andrews,4704756,,True,31.0,4,11,4,11,0,0,3,4,2,1,3,1,0,0,4,5,11
401488064,Lafayette Leopards,H. Smith,4704553,,True,31.0,3,10,3,10,0,0,1,1,4,2,6,2,1,0,2,3,7
401488064,Lafayette Leopards,K. Donahue,5109215,,False,12.0,0,3,0,2,0,1,3,3,0,0,0,1,1,1,0,4,3
401488064,Lafayette Leopards,K. Favours,4900541,,False,28.0,3,7,3,7,0,0,1,2,0,0,0,1,3,0,0,0,7
401488064,Lafayette Leopards,TEAM,TOTAL,TOTAL,False,,20,57,17,50,3,7,9,12,8,12,20,9,8,1,9,14,52
401488064,Colgate Raiders,T. McMillan,4704704,,True,28.0,7,11,7,11,0,0,0,0,2,6,8,1,1,0,2,2,14
401488064,Colgate Raiders,C. Midgette,5109204,,True,13.0,2,2,2,2,0,0,1,3,0,2,2,0,0,0,2,0,5
401488064,Colgate Raiders,M. Schiller,5109205,,True,34.0,3,8,3,7,0,1,2,2,1,6,7,6,0,0,1,2,8
401488064,Colgate Raiders,T. Golembiewski,4900535,,True,28.0,7,9,7,9,0,0,3,3,0,3,3,5,2,1,7,2,17
401488064,Colgate Raiders,A. Brodie,4595550,,True,32.0,4,5,4,5,0,0,0,0,0,2,2,8,0,0,1,2,8
401488064,Colgate Raiders,N. Parks,5109206,,False,6.0,0,0,0,0,0,0,0,0,0,2,2,0,0,0,1,3,0
401488064,Colgate Raiders,S. Diehl,4900536,,False,16.0,2,3,2,3,0,0,0,2,2,1,3,1,0,0,1,0,4
401488064,Colgate Raiders,L. Blackmore,4704706,,False,17.0,4,5,4,5,0,0,0,0,2,2,4,1,0,1,0,0,8
401488064,Colgate Raiders,A. Ferguson,5109209,,False,3.0,0,0,0,0,0,0,0,0,0,0,0,0,0,0,0,0,0
401488064,Colgate Raiders,L. Cook,5109207,,False,3.0,0,1,0,1,0,0,0,0,0,0,0,0,0,0,0,0,0
401488064,Colgate Raiders,M. McMahon,4900534,,False,14.0,3,7,3,7,0,0,1,1,1,2,3,2,0,0,2,1,7
401488064,Colgate Raiders,J. Paul,4595552,,False,6.0,0,0,0,0,0,0,0,0,0,0,0,0,0,0,0,0,0
401488064,Colgate Raiders,TEAM,TOTAL,TOTAL,False,,32,51,32,50,0,1,7,11,9,30,39,24,3,2,17,12,71
401488064,Colgate Raiders,T. McMillan,4704704,,True,28.0,7,11,7,11,0,0,0,0,2,6,8,1,1,0,2,2,14
401488064,Colgate Raiders,C. Midgette,5109204,,True,13.0,2,2,2,2,0,0,1,3,0,2,2,0,0,0,2,0,5
401488064,Colgate Raiders,M. Schiller,5109205,,True,34.0,3,8,3,7,0,1,2,2,1,6,7,6,0,0,1,2,8
401488064,Colgate Raiders,T. Golembiewski,4900535,,True,28.0,7,9,7,9,0,0,3,3,0,3,3,5,2,1,7,2,17
401488064,Colgate Raiders,A. Brodie,4595550,,True,32.0,4,5,4,5,0,0,0,0,0,2,2,8,0,0,1,2,8
401488064,Colgate Raiders,N. Parks,5109206,,False,6.0,0,0,0,0,0,0,0,0,0,2,2,0,0,0,1,3,0
401488064,Colgate Raiders,S. Diehl,4900536,,False,16.0,2,3,2,3,0,0,0,2,2,1,3,1,0,0,1,0,4
401488064,Colgate Raiders,L. Blackmore,4704706,,False,17.0,4,5,4,5,0,0,0,0,2,2,4,1,0,1,0,0,8
401488064,Colgate Raiders,A. Ferguson,5109209,,False,3.0,0,0,0,0,0,0,0,0,0,0,0,0,0,0,0,0,0
401488064,Colgate Raiders,L. Cook,5109207,,False,3.0,0,1,0,1,0,0,0,0,0,0,0,0,0,0,0,0,0
401488064,Colgate Raiders,M. McMahon,4900534,,False,14.0,3,7,3,7,0,0,1,1,1,2,3,2,0,0,2,1,7
401488064,Colgate Raiders,J. Paul,4595552,,False,6.0,0,0,0,0,0,0,0,0,0,0,0,0,0,0,0,0,0
401488064,Colgate Raiders,TEAM,TOTAL,TOTAL,False,,32,51,32,50,0,1,7,11,9,30,39,24,3,2,17,12,71
401488063,Holy Cross Crusaders,L. Berger,4900539,,True,18.0,4,6,4,6,0,0,2,2,0,1,1,2,0,0,0,2,10
401488063,Holy Cross Crusaders,K. Flanagan,5109211,,True,33.0,2,3,2,2,0,1,1,1,0,4,4,9,1,0,3,4,5
401488063,Holy Cross Crusaders,C. McCormack,4704716,,True,32.0,0,4,0,0,0,4,2,2,0,2,2,5,1,0,4,0,2
401488063,Holy Cross Crusaders,B. Power-Cassidy,4704715,,True,31.0,7,14,5,9,2,5,4,4,1,3,4,0,0,2,3,4,20
401488063,Holy Cross Crusaders,A. Cross,4595975,,True,36.0,0,4,0,1,0,3,0,0,1,4,5,2,1,0,1,2,0
401488063,Holy Cross Crusaders,J. Allen,4704714,,False,26.0,8,13,8,13,0,0,1,1,0,5,5,0,0,1,2,1,17
401488063,Holy Cross Crusaders,C. Wright,4703660,,False,2.0,0,0,0,0,0,0,0,0,0,0,0,0,0,0,0,0,0
401488063,Holy Cross Crusaders,M. Donnelly,5109213,,False,10.0,0,0,0,0,0,0,0,0,0,3,3,0,0,0,1,1,0
401488063,Holy Cross Crusaders,S. Foreman,5109212,,False,12.0,1,1,1,1,0,0,0,0,0,2,2,0,1,0,0,1,2
401488063,Holy Cross Crusaders,TEAM,TOTAL,TOTAL,False,,22,45,20,32,2,13,10,10,3,26,29,18,4,3,15,15,56
401488063,Holy Cross Crusaders,L. Berger,4900539,,True,18.0,4,6,4,6,0,0,2,2,0,1,1,2,0,0,0,2,10
401488063,Holy Cross Crusaders,K. Flanagan,5109211,,True,33.0,2,3,2,2,0,1,1,1,0,4,4,9,1,0,3,4,5
401488063,Holy Cross Crusaders,C. McCormack,4704716,,True,32.0,0,4,0,0,0,4,2,2,0,2,2,5,1,0,4,0,2
401488063,Holy Cross Crusaders,B. Power-Cassidy,4704715,,True,31.0,7,14,5,9,2,5,4,4,1,3,4,0,0,2,3,4,20
401488063,Holy Cross Crusaders,A. Cross,4595975,,True,36.0,0,4,0,1,0,3,0,0,1,4,5,2,1,0,1,2,0
401488063,Holy Cross Crusaders,J. Allen,4704714,,False,26.0,8,13,8,13,0,0,1,1,0,5,5,0,0,1,2,1,17
401488063,Holy Cross Crusaders,C. Wright,4703660,,False,2.0,0,0,0,0,0,0,0,0,0,0,0,0,0,0,0,0,0
401488063,Holy Cross Crusaders,M. Donnelly,5109213,,False,10.0,0,0,0,0,0,0,0,0,0,3,3,0,0,0,1,1,0
401488063,Holy Cross Crusaders,S. Foreman,5109212,,False,12.0,1,1,1,1,0,0,0,0,0,2,2,0,1,0,0,1,2
401488063,Holy Cross Crusaders,TEAM,TOTAL,TOTAL,False,,22,45,20,32,2,13,10,10,3,26,29,18,4,3,15,15,56
401488063,Colgate Raiders,T. McMillan,4704704,,True,37.0,7,16,7,16,0,0,1,2,4,0,4,2,2,1,0,2,15
401488063,Colgate Raiders,C. Midgette,5109204,,True,8.0,0,1,0,1,0,0,0,0,1,0,1,0,0,0,2,1,0
401488063,Colgate Raiders,M. Schiller,5109205,,True,33.0,3,4,2,3,1,1,0,0,2,3,5,3,2,0,0,3,7
401488063,Colgate Raiders,T. Golembiewski,4900535,,True,36.0,4,15,4,15,0,0,0,0,2,7,9,1,2,0,1,1,8
401488063,Colgate Raiders,A. Brodie,4595550,,True,33.0,4,9,4,9,0,0,2,4,0,1,1,2,0,0,1,1,10
401488063,Colgate Raiders,S. Diehl,4900536,,False,23.0,4,8,3,7,1,1,0,4,1,3,4,1,0,0,0,2,9
401488063,Colgate Raiders,L. Blackmore,4704706,,False,6.0,1,1,1,1,0,0,0,0,2,1,3,0,0,1,0,0,2
401488063,Colgate Raiders,M. McMahon,4900534,,False,17.0,3,8,3,7,0,1,1,2,0,1,1,0,1,0,2,0,7
401488063,Colgate Raiders,J. Paul,4595552,,False,7.0,1,2,1,1,0,1,0,0,0,0,0,0,0,0,0,1,2
401488063,Colgate Raiders,TEAM,TOTAL,TOTAL,False,,27,64,25,60,2,4,4,12,15,20,35,9,7,2,6,11,60
401488063,Colgate Raiders,T. McMillan,4704704,,True,37.0,7,16,7,16,0,0,1,2,4,0,4,2,2,1,0,2,15
401488063,Colgate Raiders,C. Midgette,5109204,,True,8.0,0,1,0,1,0,0,0,0,1,0,1,0,0,0,2,1,0
401488063,Colgate Raiders,M. Schiller,5109205,,True,33.0,3,4,2,3,1,1,0,0,2,3,5,3,2,0,0,3,7
401488063,Colgate Raiders,T. Golembiewski,4900535,,True,36.0,4,15,4,15,0,0,0,0,2,7,9,1,2,0,1,1,8
401488063,Colgate Raiders,A. Brodie,4595550,,True,33.0,4,9,4,9,0,0,2,4,0,1,1,2,0,0,1,1,10
401488063,Colgate Raiders,S. Diehl,4900536,,False,23.0,4,8,3,7,1,1,0,4,1,3,4,1,0,0,0,2,9
401488063,Colgate Raiders,L. Blackmore,4704706,,False,6.0,1,1,1,1,0,0,0,0,2,1,3,0,0,1,0,0,2
401488063,Colgate Raiders,M. McMahon,4900534,,False,17.0,3,8,3,7,0,1,1,2,0,1,1,0,1,0,2,0,7
401488063,Colgate Raiders,J. Paul,4595552,,False,7.0,1,2,1,1,0,1,0,0,0,0,0,0,0,0,0,1,2
401488063,Colgate Raiders,TEAM,TOTAL,TOTAL,False,,27,64,25,60,2,4,4,12,15,20,35,9,7,2,6,11,60
401488062,Colgate Raiders,T. McMillan,4704704,,True,30.0,5,16,5,16,0,0,0,0,3,1,4,2,1,2,2,4,10
401488062,Colgate Raiders,C. Midgette,5109204,,True,20.0,2,3,2,3,0,0,0,0,1,6,7,0,2,1,2,2,4
401488062,Colgate Raiders,M. Schiller,5109205,,True,31.0,1,2,1,1,0,1,0,0,2,1,3,1,0,0,2,4,2
401488062,Colgate Raiders,T. Golembiewski,4900535,,True,36.0,5,16,5,16,0,0,2,4,1,2,3,2,2,1,1,2,12
401488062,Colgate Raiders,A. Brodie,4595550,,True,34.0,3,11,3,11,0,0,0,0,0,5,5,4,0,0,1,3,6
401488062,Colgate Raiders,N. Parks,5109206,,False,4.0,0,1,0,1,0,0,0,0,0,0,0,0,0,0,1,1,0
401488062,Colgate Raiders,S. Diehl,4900536,,False,12.0,1,2,1,2,0,0,0,0,0,1,1,1,0,0,0,1,2
401488062,Colgate Raiders,L. Cook,5109207,,False,5.0,0,0,0,0,0,0,0,0,1,0,1,0,0,0,1,1,0
401488062,Colgate Raiders,M. McMahon,4900534,,False,26.0,3,10,3,9,0,1,2,3,0,2,2,1,2,0,0,2,8
401488062,Colgate Raiders,J. Paul,4595552,,False,2.0,0,0,0,0,0,0,0,0,0,0,0,0,0,0,0,0,0
401488062,Colgate Raiders,TEAM,TOTAL,TOTAL,False,,20,61,20,59,0,2,4,7,11,20,31,11,7,4,12,20,44
401488062,Colgate Raiders,T. McMillan,4704704,,True,30.0,5,16,5,16,0,0,0,0,3,1,4,2,1,2,2,4,10
401488062,Colgate Raiders,C. Midgette,5109204,,True,20.0,2,3,2,3,0,0,0,0,1,6,7,0,2,1,2,2,4
401488062,Colgate Raiders,M. Schiller,5109205,,True,31.0,1,2,1,1,0,1,0,0,2,1,3,1,0,0,2,4,2
401488062,Colgate Raiders,T. Golembiewski,4900535,,True,36.0,5,16,5,16,0,0,2,4,1,2,3,2,2,1,1,2,12
401488062,Colgate Raiders,A. Brodie,4595550,,True,34.0,3,11,3,11,0,0,0,0,0,5,5,4,0,0,1,3,6
401488062,Colgate Raiders,N. Parks,5109206,,False,4.0,0,1,0,1,0,0,0,0,0,0,0,0,0,0,1,1,0
401488062,Colgate Raiders,S. Diehl,4900536,,False,12.0,1,2,1,2,0,0,0,0,0,1,1,1,0,0,0,1,2
401488062,Colgate Raiders,L. Cook,5109207,,False,5.0,0,0,0,0,0,0,0,0,1,0,1,0,0,0,1,1,0
401488062,Colgate Raiders,M. McMahon,4900534,,False,26.0,3,10,3,9,0,1,2,3,0,2,2,1,2,0,0,2,8
401488062,Colgate Raiders,J. Paul,4595552,,False,2.0,0,0,0,0,0,0,0,0,0,0,0,0,0,0,0,0,0
401488062,Colgate Raiders,TEAM,TOTAL,TOTAL,False,,20,61,20,59,0,2,4,7,11,20,31,11,7,4,12,20,44
401488062,Bucknell Bison,I. King,4900533,,True,28.0,1,6,0,3,1,3,0,0,1,8,9,2,1,0,1,4,3
401488062,Bucknell Bison,E. Shaffer,4595535,,True,32.0,6,12,6,12,0,0,2,6,5,10,15,3,1,0,5,3,14
401488062,Bucknell Bison,E. Theodorsson,5109199,,True,18.0,1,5,1,4,0,1,1,2,0,2,2,0,0,0,0,2,3
401488062,Bucknell Bison,C. Collins,4900532,,True,34.0,5,10,5,10,0,0,7,9,0,2,2,1,1,0,4,2,17
401488062,Bucknell Bison,T. Johnson,4595533,,True,34.0,3,9,3,9,0,0,1,2,0,3,3,2,1,0,4,1,7
401488062,Bucknell Bison,G. Sullivan,5109201,,False,6.0,0,0,0,0,0,0,0,0,1,2,3,0,0,1,0,0,0
401488062,Bucknell Bison,R. Sisselman,4900531,,False,23.0,1,1,1,1,0,0,3,3,0,1,1,1,0,1,1,0,5
401488062,Bucknell Bison,J. Kulesza,4704702,,False,13.0,0,0,0,0,0,0,1,2,0,0,0,0,0,0,0,0,1
401488062,Bucknell Bison,C. Dingler,4577540,,False,12.0,0,0,0,0,0,0,0,0,0,1,1,1,0,0,2,1,0
401488062,Bucknell Bison,TEAM,TOTAL,TOTAL,False,,17,43,16,39,1,4,15,24,8,32,40,10,4,2,17,13,50
401488062,Bucknell Bison,I. King,4900533,,True,28.0,1,6,0,3,1,3,0,0,1,8,9,2,1,0,1,4,3
401488062,Bucknell Bison,E. Shaffer,4595535,,True,32.0,6,12,6,12,0,0,2,6,5,10,15,3,1,0,5,3,14
401488062,Bucknell Bison,E. Theodorsson,5109199,,True,18.0,1,5,1,4,0,1,1,2,0,2,2,0,0,0,0,2,3
401488062,Bucknell Bison,C. Collins,4900532,,True,34.0,5,10,5,10,0,0,7,9,0,2,2,1,1,0,4,2,17
401488062,Bucknell Bison,T. Johnson,4595533,,True,34.0,3,9,3,9,0,0,1,2,0,3,3,2,1,0,4,1,7
401488062,Bucknell Bison,G. Sullivan,5109201,,False,6.0,0,0,0,0,0,0,0,0,1,2,3,0,0,1,0,0,0
401488062,Bucknell Bison,R. Sisselman,4900531,,False,23.0,1,1,1,1,0,0,3,3,0,1,1,1,0,1,1,0,5
401488062,Bucknell Bison,J. Kulesza,4704702,,False,13.0,0,0,0,0,0,0,1,2,0,0,0,0,0,0,0,0,1
401488062,Bucknell Bison,C. Dingler,4577540,,False,12.0,0,0,0,0,0,0,0,0,0,1,1,1,0,0,2,1,0
401488062,Bucknell Bison,TEAM,TOTAL,TOTAL,False,,17,43,16,39,1,4,15,24,8,32,40,10,4,2,17,13,50
401488061,Lehigh Mountain Hawks,L. Fandre,5109220,,True,31.0,1,6,1,5,0,1,2,2,1,2,3,2,1,1,2,0,4
401488061,Lehigh Mountain Hawks,M. O'Brien,4900547,,True,10.0,0,0,0,0,0,0,0,0,0,3,3,1,0,0,2,1,0
401488061,Lehigh Mountain Hawks,F. Hottinger,4595613,,True,33.0,7,12,7,11,0,1,4,4,1,8,9,0,1,0,2,4,18
401488061,Lehigh Mountain Hawks,M. Kramer,4704762,,True,36.0,5,12,3,6,2,6,7,7,0,2,2,5,0,0,4,0,19
401488061,Lehigh Mountain Hawks,A. Harvey,4595612,,True,32.0,1,2,1,2,0,0,0,0,0,4,4,1,0,1,3,1,2
401488061,Lehigh Mountain Hawks,K. Van Eps,4900545,,False,10.0,0,2,0,1,0,1,0,0,0,1,1,1,0,0,2,2,0
401488061,Lehigh Mountain Hawks,E. Stemmer,4900544,,False,19.0,0,4,0,2,0,2,2,2,1,3,4,0,0,0,3,4,2
401488061,Lehigh Mountain Hawks,M. Albrecht,4704763,,False,6.0,0,0,0,0,0,0,0,0,0,0,0,0,0,1,1,1,0
401488061,Lehigh Mountain Hawks,F. Eggenschwiler,4704761,,False,1.0,0,0,0,0,0,0,0,0,0,0,0,0,0,0,0,1,0
401488061,Lehigh Mountain Hawks,J. Behar,4433782,,False,22.0,3,7,3,4,0,3,0,0,0,4,4,0,1,1,1,0,6
401488061,Lehigh Mountain Hawks,TEAM,TOTAL,TOTAL,False,,17,45,15,31,2,14,15,15,6,30,36,10,3,4,20,14,51
401488061,Lehigh Mountain Hawks,L. Fandre,5109220,,True,31.0,1,6,1,5,0,1,2,2,1,2,3,2,1,1,2,0,4
401488061,Lehigh Mountain Hawks,M. O'Brien,4900547,,True,10.0,0,0,0,0,0,0,0,0,0,3,3,1,0,0,2,1,0
401488061,Lehigh Mountain Hawks,F. Hottinger,4595613,,True,33.0,7,12,7,11,0,1,4,4,1,8,9,0,1,0,2,4,18
401488061,Lehigh Mountain Hawks,M. Kramer,4704762,,True,36.0,5,12,3,6,2,6,7,7,0,2,2,5,0,0,4,0,19
401488061,Lehigh Mountain Hawks,A. Harvey,4595612,,True,32.0,1,2,1,2,0,0,0,0,0,4,4,1,0,1,3,1,2
401488061,Lehigh Mountain Hawks,K. Van Eps,4900545,,False,10.0,0,2,0,1,0,1,0,0,0,1,1,1,0,0,2,2,0
401488061,Lehigh Mountain Hawks,E. Stemmer,4900544,,False,19.0,0,4,0,2,0,2,2,2,1,3,4,0,0,0,3,4,2
401488061,Lehigh Mountain Hawks,M. Albrecht,4704763,,False,6.0,0,0,0,0,0,0,0,0,0,0,0,0,0,1,1,1,0
401488061,Lehigh Mountain Hawks,F. Eggenschwiler,4704761,,False,1.0,0,0,0,0,0,0,0,0,0,0,0,0,0,0,0,1,0
401488061,Lehigh Mountain Hawks,J. Behar,4433782,,False,22.0,3,7,3,4,0,3,0,0,0,4,4,0,1,1,1,0,6
401488061,Lehigh Mountain Hawks,TEAM,TOTAL,TOTAL,False,,17,45,15,31,2,14,15,15,6,30,36,10,3,4,20,14,51
401488061,Colgate Raiders,T. McMillan,4704704,,True,31.0,3,10,3,10,0,0,0,0,1,2,3,4,0,0,1,0,6
401488061,Colgate Raiders,C. Midgette,5109204,,True,21.0,4,8,4,8,0,0,2,5,2,1,3,0,0,0,0,1,10
401488061,Colgate Raiders,M. Schiller,5109205,,True,32.0,3,3,3,3,0,0,2,2,0,2,2,2,3,0,0,3,8
401488061,Colgate Raiders,T. Golembiewski,4900535,,True,27.0,10,18,10,18,0,0,2,2,0,3,3,1,2,1,2,4,22
401488061,Colgate Raiders,A. Brodie,4595550,,True,32.0,1,8,1,8,0,0,0,0,2,1,3,0,1,0,1,1,2
401488061,Colgate Raiders,N. Parks,5109206,,False,6.0,0,2,0,2,0,0,0,0,0,1,1,0,1,0,1,0,0
401488061,Colgate Raiders,S. Diehl,4900536,,False,11.0,0,1,0,1,0,0,0,0,0,2,2,1,0,1,0,3,0
401488061,Colgate Raiders,L. Cook,5109207,,False,12.0,1,6,1,6,0,0,0,0,2,3,5,1,0,0,0,0,2
401488061,Colgate Raiders,M. McMahon,4900534,,False,17.0,4,9,4,9,0,0,3,3,0,2,2,1,2,0,0,4,11
401488061,Colgate Raiders,J. Paul,4595552,,False,11.0,1,1,1,1,0,0,0,0,0,2,2,0,1,0,0,2,2
401488061,Colgate Raiders,TEAM,TOTAL,TOTAL,False,,27,66,27,66,0,0,9,12,10,21,31,10,10,2,5,18,63
401488061,Colgate Raiders,T. McMillan,4704704,,True,31.0,3,10,3,10,0,0,0,0,1,2,3,4,0,0,1,0,6
401488061,Colgate Raiders,C. Midgette,5109204,,True,21.0,4,8,4,8,0,0,2,5,2,1,3,0,0,0,0,1,10
401488061,Colgate Raiders,M. Schiller,5109205,,True,32.0,3,3,3,3,0,0,2,2,0,2,2,2,3,0,0,3,8
401488061,Colgate Raiders,T. Golembiewski,4900535,,True,27.0,10,18,10,18,0,0,2,2,0,3,3,1,2,1,2,4,22
401488061,Colgate Raiders,A. Brodie,4595550,,True,32.0,1,8,1,8,0,0,0,0,2,1,3,0,1,0,1,1,2
401488061,Colgate Raiders,N. Parks,5109206,,False,6.0,0,2,0,2,0,0,0,0,0,1,1,0,1,0,1,0,0
401488061,Colgate Raiders,S. Diehl,4900536,,False,11.0,0,1,0,1,0,0,0,0,0,2,2,1,0,1,0,3,0
401488061,Colgate Raiders,L. Cook,5109207,,False,12.0,1,6,1,6,0,0,0,0,2,3,5,1,0,0,0,0,2
401488061,Colgate Raiders,M. McMahon,4900534,,False,17.0,4,9,4,9,0,0,3,3,0,2,2,1,2,0,0,4,11
401488061,Colgate Raiders,J. Paul,4595552,,False,11.0,1,1,1,1,0,0,0,0,0,2,2,0,1,0,0,2,2
401488061,Colgate Raiders,TEAM,TOTAL,TOTAL,False,,27,66,27,66,0,0,9,12,10,21,31,10,10,2,5,18,63
401488060,Colgate Raiders,T. McMillan,4704704,,True,31.0,4,12,4,11,0,1,2,2,2,2,4,0,1,0,0,0,10
401488060,Colgate Raiders,C. Midgette,5109204,,True,9.0,0,2,0,2,0,0,0,2,1,2,3,0,0,0,0,1,0
401488060,Colgate Raiders,M. Schiller,5109205,,True,28.0,3,4,1,2,2,2,0,0,0,3,3,1,0,0,1,2,8
401488060,Colgate Raiders,T. Golembiewski,4900535,,True,33.0,2,10,2,9,0,1,6,7,0,5,5,2,0,0,1,1,10
401488060,Colgate Raiders,A. Brodie,4595550,,True,28.0,2,7,2,6,0,1,1,1,0,0,0,5,0,0,2,0,5
401488060,Colgate Raiders,N. Parks,5109206,,False,20.0,2,5,2,5,0,0,0,0,4,1,5,0,0,0,4,1,4
401488060,Colgate Raiders,S. Diehl,4900536,,False,17.0,1,5,1,2,0,3,0,2,2,2,4,0,1,0,0,1,2
401488060,Colgate Raiders,L. Cook,5109207,,False,12.0,1,6,1,5,0,1,2,2,1,2,3,1,0,0,0,1,4
401488060,Colgate Raiders,M. McMahon,4900534,,False,14.0,2,6,2,6,0,0,5,6,2,5,7,0,1,0,3,4,9
401488060,Colgate Raiders,J. Paul,4595552,,False,8.0,0,2,0,0,0,2,0,0,0,2,2,0,1,0,0,0,0
401488060,Colgate Raiders,TEAM,TOTAL,TOTAL,False,,17,59,15,48,2,11,16,22,14,26,40,9,4,0,12,11,52
401488060,Colgate Raiders,T. McMillan,4704704,,True,31.0,4,12,4,11,0,1,2,2,2,2,4,0,1,0,0,0,10
401488060,Colgate Raiders,C. Midgette,5109204,,True,9.0,0,2,0,2,0,0,0,2,1,2,3,0,0,0,0,1,0
401488060,Colgate Raiders,M. Schiller,5109205,,True,28.0,3,4,1,2,2,2,0,0,0,3,3,1,0,0,1,2,8
401488060,Colgate Raiders,T. Golembiewski,4900535,,True,33.0,2,10,2,9,0,1,6,7,0,5,5,2,0,0,1,1,10
401488060,Colgate Raiders,A. Brodie,4595550,,True,28.0,2,7,2,6,0,1,1,1,0,0,0,5,0,0,2,0,5
401488060,Colgate Raiders,N. Parks,5109206,,False,20.0,2,5,2,5,0,0,0,0,4,1,5,0,0,0,4,1,4
401488060,Colgate Raiders,S. Diehl,4900536,,False,17.0,1,5,1,2,0,3,0,2,2,2,4,0,1,0,0,1,2
401488060,Colgate Raiders,L. Cook,5109207,,False,12.0,1,6,1,5,0,1,2,2,1,2,3,1,0,0,0,1,4
401488060,Colgate Raiders,M. McMahon,4900534,,False,14.0,2,6,2,6,0,0,5,6,2,5,7,0,1,0,3,4,9
401488060,Colgate Raiders,J. Paul,4595552,,False,8.0,0,2,0,0,0,2,0,0,0,2,2,0,1,0,0,0,0
401488060,Colgate Raiders,TEAM,TOTAL,TOTAL,False,,17,59,15,48,2,11,16,22,14,26,40,9,4,0,12,11,52
401488060,American University Eagles,E. Johns,4704688,,True,30.0,7,12,6,10,1,2,0,0,1,2,3,0,0,0,2,4,15
401488060,American University Eagles,L. Stack,4595455,,True,33.0,1,5,1,5,0,0,1,2,2,7,9,2,2,1,1,1,3
401488060,American University Eagles,I. Bales,4704685,,True,29.0,3,6,3,6,0,0,0,1,0,10,10,3,1,0,5,4,6
401488060,American University Eagles,A. LeMaster,4703737,,True,16.0,0,3,0,0,0,3,0,0,0,3,3,2,1,0,1,0,0
401488060,American University Eagles,S. Stetson,4595453,,True,25.0,3,9,2,5,1,4,0,0,0,1,1,2,0,0,1,2,7
401488060,American University Eagles,M. Lavin,5109188,,False,11.0,1,4,1,4,0,0,0,0,1,2,3,0,0,2,2,2,2
401488060,American University Eagles,M. Lee,4704592,,False,5.0,0,1,0,1,0,0,0,0,0,1,1,1,0,0,0,0,0
401488060,American University Eagles,L. Nogues,5109187,,False,14.0,1,2,1,2,0,0,0,0,0,1,1,2,0,0,4,1,2
401488060,American University Eagles,A. Rescifina,5109186,,False,8.0,1,2,1,2,0,0,0,0,0,0,0,0,0,0,0,0,2
401488060,American University Eagles,B. Garbee,4899710,,False,4.0,0,0,0,0,0,0,0,0,0,0,0,1,0,0,0,0,0
401488060,American University Eagles,K. Henning,4704686,,False,25.0,5,8,4,7,1,1,0,0,0,0,0,2,0,2,3,4,11
401488060,American University Eagles,TEAM,TOTAL,TOTAL,False,,22,52,19,42,3,10,1,3,5,30,35,15,4,5,19,18,48
401488060,American University Eagles,E. Johns,4704688,,True,30.0,7,12,6,10,1,2,0,0,1,2,3,0,0,0,2,4,15
401488060,American University Eagles,L. Stack,4595455,,True,33.0,1,5,1,5,0,0,1,2,2,7,9,2,2,1,1,1,3
401488060,American University Eagles,I. Bales,4704685,,True,29.0,3,6,3,6,0,0,0,1,0,10,10,3,1,0,5,4,6
401488060,American University Eagles,A. LeMaster,4703737,,True,16.0,0,3,0,0,0,3,0,0,0,3,3,2,1,0,1,0,0
401488060,American University Eagles,S. Stetson,4595453,,True,25.0,3,9,2,5,1,4,0,0,0,1,1,2,0,0,1,2,7
401488060,American University Eagles,M. Lavin,5109188,,False,11.0,1,4,1,4,0,0,0,0,1,2,3,0,0,2,2,2,2
401488060,American University Eagles,M. Lee,4704592,,False,5.0,0,1,0,1,0,0,0,0,0,1,1,1,0,0,0,0,0
401488060,American University Eagles,L. Nogues,5109187,,False,14.0,1,2,1,2,0,0,0,0,0,1,1,2,0,0,4,1,2
401488060,American University Eagles,A. Rescifina,5109186,,False,8.0,1,2,1,2,0,0,0,0,0,0,0,0,0,0,0,0,2
401488060,American University Eagles,B. Garbee,4899710,,False,4.0,0,0,0,0,0,0,0,0,0,0,0,1,0,0,0,0,0
401488060,American University Eagles,K. Henning,4704686,,False,25.0,5,8,4,7,1,1,0,0,0,0,0,2,0,2,3,4,11
401488060,American University Eagles,TEAM,TOTAL,TOTAL,False,,22,52,19,42,3,10,1,3,5,30,35,15,4,5,19,18,48
401488059,Lafayette Leopards,K. Drummond,4704754,,True,29.0,2,3,2,3,0,0,1,2,5,10,15,1,0,2,3,2,5
401488059,Lafayette Leopards,K. Favours,4900541,,True,21.0,0,4,0,1,0,3,0,0,0,0,0,3,1,0,5,0,0
401488059,Lafayette Leopards,A. Antognoli,4900540,,True,40.0,8,15,6,11,2,4,5,6,0,5,5,1,2,0,3,1,23
401488059,Lafayette Leopards,M. Andrews,4704756,,True,29.0,5,12,5,11,0,1,3,4,1,3,4,2,0,0,4,3,13
401488059,Lafayette Leopards,H. Smith,4704553,,True,22.0,3,5,3,5,0,0,0,0,0,4,4,0,1,0,1,5,6
401488059,Lafayette Leopards,A. Matthews,4703689,,False,11.0,1,1,1,1,0,0,0,0,0,2,2,2,0,0,2,2,2
401488059,Lafayette Leopards,S. Ntaconayigize,5109216,,False,26.0,0,2,0,0,0,2,0,0,1,4,5,1,0,2,0,2,0
401488059,Lafayette Leopards,K. Donahue,5109215,,False,22.0,2,4,2,2,0,2,0,0,1,0,1,0,2,0,3,1,4
401488059,Lafayette Leopards,TEAM,TOTAL,TOTAL,False,,21,46,19,34,2,12,9,12,8,29,37,10,6,4,21,16,53
401488059,Lafayette Leopards,K. Drummond,4704754,,True,29.0,2,3,2,3,0,0,1,2,5,10,15,1,0,2,3,2,5
401488059,Lafayette Leopards,K. Favours,4900541,,True,21.0,0,4,0,1,0,3,0,0,0,0,0,3,1,0,5,0,0
401488059,Lafayette Leopards,A. Antognoli,4900540,,True,40.0,8,15,6,11,2,4,5,6,0,5,5,1,2,0,3,1,23
401488059,Lafayette Leopards,M. Andrews,4704756,,True,29.0,5,12,5,11,0,1,3,4,1,3,4,2,0,0,4,3,13
401488059,Lafayette Leopards,H. Smith,4704553,,True,22.0,3,5,3,5,0,0,0,0,0,4,4,0,1,0,1,5,6
401488059,Lafayette Leopards,A. Matthews,4703689,,False,11.0,1,1,1,1,0,0,0,0,0,2,2,2,0,0,2,2,2
401488059,Lafayette Leopards,S. Ntaconayigize,5109216,,False,26.0,0,2,0,0,0,2,0,0,1,4,5,1,0,2,0,2,0
401488059,Lafayette Leopards,K. Donahue,5109215,,False,22.0,2,4,2,2,0,2,0,0,1,0,1,0,2,0,3,1,4
401488059,Lafayette Leopards,TEAM,TOTAL,TOTAL,False,,21,46,19,34,2,12,9,12,8,29,37,10,6,4,21,16,53
401488059,Colgate Raiders,T. McMillan,4704704,,True,23.0,0,4,0,4,0,0,1,2,0,3,3,1,0,1,1,0,1
401488059,Colgate Raiders,C. Midgette,5109204,,True,8.0,0,3,0,3,0,0,0,0,1,1,2,0,1,0,0,0,0
401488059,Colgate Raiders,M. Schiller,5109205,,True,29.0,1,7,1,4,0,3,0,0,5,4,9,1,0,1,1,4,2
401488059,Colgate Raiders,T. Golembiewski,4900535,,True,33.0,4,15,3,8,1,7,0,0,2,3,5,3,1,0,1,2,9
401488059,Colgate Raiders,A. Brodie,4595550,,True,29.0,2,8,2,4,0,4,2,2,0,1,1,2,5,0,0,3,6
401488059,Colgate Raiders,N. Parks,5109206,,False,19.0,7,7,7,7,0,0,0,0,2,2,4,0,0,0,2,3,14
401488059,Colgate Raiders,S. Diehl,4900536,,False,8.0,0,2,0,1,0,1,0,0,0,0,0,0,0,0,2,0,0
401488059,Colgate Raiders,L. Blackmore,4704706,,False,10.0,0,1,0,0,0,1,1,2,0,1,1,0,0,0,0,0,1
401488059,Colgate Raiders,A. Ferguson,5109209,,False,6.0,0,0,0,0,0,0,2,2,0,1,1,0,1,0,0,0,2
401488059,Colgate Raiders,L. Cook,5109207,,False,10.0,2,3,2,2,0,1,0,0,1,0,1,0,1,0,1,1,4
401488059,Colgate Raiders,M. McMahon,4900534,,False,16.0,1,3,1,3,0,0,2,4,0,0,0,2,0,0,4,1,4
401488059,Colgate Raiders,J. Paul,4595552,,False,9.0,1,6,1,1,0,5,0,0,1,0,1,0,1,0,2,0,2
401488059,Colgate Raiders,TEAM,TOTAL,TOTAL,False,,18,59,17,37,1,22,8,12,14,18,32,9,10,2,15,14,45
401488059,Colgate Raiders,T. McMillan,4704704,,True,23.0,0,4,0,4,0,0,1,2,0,3,3,1,0,1,1,0,1
401488059,Colgate Raiders,C. Midgette,5109204,,True,8.0,0,3,0,3,0,0,0,0,1,1,2,0,1,0,0,0,0
401488059,Colgate Raiders,M. Schiller,5109205,,True,29.0,1,7,1,4,0,3,0,0,5,4,9,1,0,1,1,4,2
401488059,Colgate Raiders,T. Golembiewski,4900535,,True,33.0,4,15,3,8,1,7,0,0,2,3,5,3,1,0,1,2,9
401488059,Colgate Raiders,A. Brodie,4595550,,True,29.0,2,8,2,4,0,4,2,2,0,1,1,2,5,0,0,3,6
401488059,Colgate Raiders,N. Parks,5109206,,False,19.0,7,7,7,7,0,0,0,0,2,2,4,0,0,0,2,3,14
401488059,Colgate Raiders,S. Diehl,4900536,,False,8.0,0,2,0,1,0,1,0,0,0,0,0,0,0,0,2,0,0
401488059,Colgate Raiders,L. Blackmore,4704706,,False,10.0,0,1,0,0,0,1,1,2,0,1,1,0,0,0,0,0,1
401488059,Colgate Raiders,A. Ferguson,5109209,,False,6.0,0,0,0,0,0,0,2,2,0,1,1,0,1,0,0,0,2
401488059,Colgate Raiders,L. Cook,5109207,,False,10.0,2,3,2,2,0,1,0,0,1,0,1,0,1,0,1,1,4
401488059,Colgate Raiders,M. McMahon,4900534,,False,16.0,1,3,1,3,0,0,2,4,0,0,0,2,0,0,4,1,4
401488059,Colgate Raiders,J. Paul,4595552,,False,9.0,1,6,1,1,0,5,0,0,1,0,1,0,1,0,2,0,2
401488059,Colgate Raiders,TEAM,TOTAL,TOTAL,False,,18,59,17,37,1,22,8,12,14,18,32,9,10,2,15,14,45
401488058,Colgate Raiders,T. McMillan,4704704,,True,35.0,3,9,3,9,0,0,0,0,1,6,7,0,1,3,3,1,6
401488058,Colgate Raiders,M. Schiller,5109205,,True,35.0,2,4,1,2,1,2,1,2,3,5,8,3,4,0,2,3,6
401488058,Colgate Raiders,T. Golembiewski,4900535,,True,22.0,6,13,6,10,0,3,4,4,1,0,1,1,0,0,1,4,16
401488058,Colgate Raiders,J. Paul,4595552,,True,10.0,0,3,0,1,0,2,0,0,0,1,1,1,0,0,1,1,0
401488058,Colgate Raiders,A. Brodie,4595550,,True,17.0,2,4,2,4,0,0,0,0,0,0,0,1,0,0,2,0,4
401488058,Colgate Raiders,N. Parks,5109206,,False,17.0,2,3,2,3,0,0,0,0,3,3,6,1,1,0,3,3,4
401488058,Colgate Raiders,S. Diehl,4900536,,False,5.0,0,0,0,0,0,0,0,0,0,2,2,0,0,0,0,0,0
401488058,Colgate Raiders,A. Ferguson,5109209,,False,12.0,2,3,2,3,0,0,0,0,1,0,1,0,0,0,1,1,4
401488058,Colgate Raiders,C. Midgette,5109204,,False,13.0,3,3,3,3,0,0,0,1,1,2,3,0,2,0,3,4,6
401488058,Colgate Raiders,L. Cook,5109207,,False,7.0,0,3,0,0,0,3,0,0,0,0,0,0,0,0,1,3,0
401488058,Colgate Raiders,M. McMahon,4900534,,False,27.0,2,11,2,11,0,0,7,8,0,2,2,2,1,1,4,3,11
401488058,Colgate Raiders,TEAM,TOTAL,TOTAL,False,,22,56,21,46,1,10,12,15,13,21,34,9,9,4,22,23,57
401488058,Colgate Raiders,T. McMillan,4704704,,True,35.0,3,9,3,9,0,0,0,0,1,6,7,0,1,3,3,1,6
401488058,Colgate Raiders,M. Schiller,5109205,,True,35.0,2,4,1,2,1,2,1,2,3,5,8,3,4,0,2,3,6
401488058,Colgate Raiders,T. Golembiewski,4900535,,True,22.0,6,13,6,10,0,3,4,4,1,0,1,1,0,0,1,4,16
401488058,Colgate Raiders,J. Paul,4595552,,True,10.0,0,3,0,1,0,2,0,0,0,1,1,1,0,0,1,1,0
401488058,Colgate Raiders,A. Brodie,4595550,,True,17.0,2,4,2,4,0,0,0,0,0,0,0,1,0,0,2,0,4
401488058,Colgate Raiders,N. Parks,5109206,,False,17.0,2,3,2,3,0,0,0,0,3,3,6,1,1,0,3,3,4
401488058,Colgate Raiders,S. Diehl,4900536,,False,5.0,0,0,0,0,0,0,0,0,0,2,2,0,0,0,0,0,0
401488058,Colgate Raiders,A. Ferguson,5109209,,False,12.0,2,3,2,3,0,0,0,0,1,0,1,0,0,0,1,1,4
401488058,Colgate Raiders,C. Midgette,5109204,,False,13.0,3,3,3,3,0,0,0,1,1,2,3,0,2,0,3,4,6
401488058,Colgate Raiders,L. Cook,5109207,,False,7.0,0,3,0,0,0,3,0,0,0,0,0,0,0,0,1,3,0
401488058,Colgate Raiders,M. McMahon,4900534,,False,27.0,2,11,2,11,0,0,7,8,0,2,2,2,1,1,4,3,11
401488058,Colgate Raiders,TEAM,TOTAL,TOTAL,False,,22,56,21,46,1,10,12,15,13,21,34,9,9,4,22,23,57
401488058,American University Eagles,E. Johns,4704688,,True,28.0,4,15,4,14,0,1,0,0,4,2,6,1,2,1,2,3,8
401488058,American University Eagles,L. Stack,4595455,,True,33.0,3,6,3,6,0,0,0,0,3,6,9,1,3,0,5,1,6
401488058,American University Eagles,K. Henning,4704686,,True,24.0,2,6,2,6,0,0,8,8,1,0,1,3,0,0,2,1,12
401488058,American University Eagles,I. Bales,4704685,,True,27.0,3,8,3,7,0,1,4,4,1,5,6,2,0,1,0,2,10
401488058,American University Eagles,A. LeMaster,4703737,,True,24.0,3,8,1,1,2,7,0,0,0,1,1,1,0,0,1,2,8
401488058,American University Eagles,M. Lavin,5109188,,False,19.0,2,5,1,3,1,2,4,4,4,5,9,0,1,1,4,2,9
401488058,American University Eagles,L. Nogues,5109187,,False,16.0,1,2,1,2,0,0,0,0,0,0,0,1,1,0,4,4,2
401488058,American University Eagles,A. Rescifina,5109186,,False,16.0,1,3,1,3,0,0,0,0,1,0,1,0,0,0,2,1,2
401488058,American University Eagles,B. Garbee,4899710,,False,13.0,0,1,0,1,0,0,2,2,0,1,1,0,1,0,1,1,2
401488058,American University Eagles,TEAM,TOTAL,TOTAL,False,,19,54,16,43,3,11,18,18,14,21,35,9,8,3,22,17,59
401488058,American University Eagles,E. Johns,4704688,,True,28.0,4,15,4,14,0,1,0,0,4,2,6,1,2,1,2,3,8
401488058,American University Eagles,L. Stack,4595455,,True,33.0,3,6,3,6,0,0,0,0,3,6,9,1,3,0,5,1,6
401488058,American University Eagles,K. Henning,4704686,,True,24.0,2,6,2,6,0,0,8,8,1,0,1,3,0,0,2,1,12
401488058,American University Eagles,I. Bales,4704685,,True,27.0,3,8,3,7,0,1,4,4,1,5,6,2,0,1,0,2,10
401488058,American University Eagles,A. LeMaster,4703737,,True,24.0,3,8,1,1,2,7,0,0,0,1,1,1,0,0,1,2,8
401488058,American University Eagles,M. Lavin,5109188,,False,19.0,2,5,1,3,1,2,4,4,4,5,9,0,1,1,4,2,9
401488058,American University Eagles,L. Nogues,5109187,,False,16.0,1,2,1,2,0,0,0,0,0,0,0,1,1,0,4,4,2
401488058,American University Eagles,A. Rescifina,5109186,,False,16.0,1,3,1,3,0,0,0,0,1,0,1,0,0,0,2,1,2
401488058,American University Eagles,B. Garbee,4899710,,False,13.0,0,1,0,1,0,0,2,2,0,1,1,0,1,0,1,1,2
401488058,American University Eagles,TEAM,TOTAL,TOTAL,False,,19,54,16,43,3,11,18,18,14,21,35,9,8,3,22,17,59
401488057,Holy Cross Crusaders,L. Berger,4900539,,True,27.0,6,10,6,10,0,0,1,3,3,7,10,2,0,1,0,1,13
401488057,Holy Cross Crusaders,K. Flanagan,5109211,,True,31.0,2,3,1,2,1,1,4,6,0,2,2,3,0,0,3,1,9
401488057,Holy Cross Crusaders,C. McCormack,4704716,,True,34.0,3,7,1,4,2,3,2,4,0,6,6,3,1,1,4,1,10
401488057,Holy Cross Crusaders,B. Power-Cassidy,4704715,,True,37.0,7,9,6,7,1,2,4,6,1,0,1,2,0,3,0,1,19
401488057,Holy Cross Crusaders,A. Cross,4595975,,True,22.0,0,3,0,2,0,1,0,0,0,2,2,3,0,0,3,3,0
401488057,Holy Cross Crusaders,C. Wright,4703660,,False,15.0,1,4,1,4,0,0,0,0,2,3,5,0,0,2,0,1,2
401488057,Holy Cross Crusaders,M. Donnelly,5109213,,False,9.0,2,2,1,1,1,1,0,0,0,1,1,0,0,0,1,0,5
401488057,Holy Cross Crusaders,S. Foreman,5109212,,False,18.0,0,3,0,3,0,0,1,2,0,6,6,0,0,0,1,0,1
401488057,Holy Cross Crusaders,L. Huber,4900538,,False,5.0,0,0,0,0,0,0,0,0,0,2,2,1,0,0,0,0,0
401488057,Holy Cross Crusaders,G. Munt,4900537,,False,2.0,0,0,0,0,0,0,0,0,0,0,0,0,0,0,0,0,0
401488057,Holy Cross Crusaders,TEAM,TOTAL,TOTAL,False,,21,41,16,33,5,8,12,21,7,33,40,14,1,7,12,8,59
401488057,Holy Cross Crusaders,L. Berger,4900539,,True,27.0,6,10,6,10,0,0,1,3,3,7,10,2,0,1,0,1,13
401488057,Holy Cross Crusaders,K. Flanagan,5109211,,True,31.0,2,3,1,2,1,1,4,6,0,2,2,3,0,0,3,1,9
401488057,Holy Cross Crusaders,C. McCormack,4704716,,True,34.0,3,7,1,4,2,3,2,4,0,6,6,3,1,1,4,1,10
401488057,Holy Cross Crusaders,B. Power-Cassidy,4704715,,True,37.0,7,9,6,7,1,2,4,6,1,0,1,2,0,3,0,1,19
401488057,Holy Cross Crusaders,A. Cross,4595975,,True,22.0,0,3,0,2,0,1,0,0,0,2,2,3,0,0,3,3,0
401488057,Holy Cross Crusaders,C. Wright,4703660,,False,15.0,1,4,1,4,0,0,0,0,2,3,5,0,0,2,0,1,2
401488057,Holy Cross Crusaders,M. Donnelly,5109213,,False,9.0,2,2,1,1,1,1,0,0,0,1,1,0,0,0,1,0,5
401488057,Holy Cross Crusaders,S. Foreman,5109212,,False,18.0,0,3,0,3,0,0,1,2,0,6,6,0,0,0,1,0,1
401488057,Holy Cross Crusaders,L. Huber,4900538,,False,5.0,0,0,0,0,0,0,0,0,0,2,2,1,0,0,0,0,0
401488057,Holy Cross Crusaders,G. Munt,4900537,,False,2.0,0,0,0,0,0,0,0,0,0,0,0,0,0,0,0,0,0
401488057,Holy Cross Crusaders,TEAM,TOTAL,TOTAL,False,,21,41,16,33,5,8,12,21,7,33,40,14,1,7,12,8,59
401488057,Colgate Raiders,T. McMillan,4704704,,True,22.0,2,7,2,7,0,0,0,0,4,4,8,4,0,0,1,4,4
401488057,Colgate Raiders,M. Schiller,5109205,,True,32.0,2,7,2,4,0,3,0,0,3,2,5,3,1,0,1,2,4
401488057,Colgate Raiders,T. Golembiewski,4900535,,True,32.0,5,10,4,7,1,3,0,0,0,4,4,1,2,0,0,2,11
401488057,Colgate Raiders,J. Paul,4595552,,True,19.0,2,5,1,2,1,3,0,0,1,0,1,1,1,1,0,1,5
401488057,Colgate Raiders,A. Brodie,4595550,,True,34.0,4,13,4,9,0,4,1,1,0,1,1,2,0,0,2,2,9
401488057,Colgate Raiders,C. Okafor,5109208,,False,2.0,0,3,0,3,0,0,0,0,0,0,0,0,0,1,0,1,0
401488057,Colgate Raiders,N. Parks,5109206,,False,11.0,1,4,1,3,0,1,0,0,2,1,3,0,1,1,0,1,2
401488057,Colgate Raiders,S. Diehl,4900536,,False,16.0,1,5,0,2,1,3,0,0,1,2,3,1,0,0,0,1,3
401488057,Colgate Raiders,A. Ferguson,5109209,,False,2.0,0,0,0,0,0,0,0,0,0,1,1,0,0,0,0,0,0
401488057,Colgate Raiders,C. Midgette,5109204,,False,2.0,0,0,0,0,0,0,0,0,0,1,1,0,0,0,0,0,0
401488057,Colgate Raiders,L. Cook,5109207,,False,6.0,2,4,0,1,2,3,1,2,0,0,0,0,0,0,0,0,7
401488057,Colgate Raiders,M. McMahon,4900534,,False,22.0,1,5,1,5,0,0,2,4,1,0,1,0,0,0,1,3,4
401488057,Colgate Raiders,TEAM,TOTAL,TOTAL,False,,20,63,15,43,5,20,4,7,12,17,29,12,5,3,5,17,49
401488057,Colgate Raiders,T. McMillan,4704704,,True,22.0,2,7,2,7,0,0,0,0,4,4,8,4,0,0,1,4,4
401488057,Colgate Raiders,M. Schiller,5109205,,True,32.0,2,7,2,4,0,3,0,0,3,2,5,3,1,0,1,2,4
401488057,Colgate Raiders,T. Golembiewski,4900535,,True,32.0,5,10,4,7,1,3,0,0,0,4,4,1,2,0,0,2,11
401488057,Colgate Raiders,J. Paul,4595552,,True,19.0,2,5,1,2,1,3,0,0,1,0,1,1,1,1,0,1,5
401488057,Colgate Raiders,A. Brodie,4595550,,True,34.0,4,13,4,9,0,4,1,1,0,1,1,2,0,0,2,2,9
401488057,Colgate Raiders,C. Okafor,5109208,,False,2.0,0,3,0,3,0,0,0,0,0,0,0,0,0,1,0,1,0
401488057,Colgate Raiders,N. Parks,5109206,,False,11.0,1,4,1,3,0,1,0,0,2,1,3,0,1,1,0,1,2
401488057,Colgate Raiders,S. Diehl,4900536,,False,16.0,1,5,0,2,1,3,0,0,1,2,3,1,0,0,0,1,3
401488057,Colgate Raiders,A. Ferguson,5109209,,False,2.0,0,0,0,0,0,0,0,0,0,1,1,0,0,0,0,0,0
401488057,Colgate Raiders,C. Midgette,5109204,,False,2.0,0,0,0,0,0,0,0,0,0,1,1,0,0,0,0,0,0
401488057,Colgate Raiders,L. Cook,5109207,,False,6.0,2,4,0,1,2,3,1,2,0,0,0,0,0,0,0,0,7
401488057,Colgate Raiders,M. McMahon,4900534,,False,22.0,1,5,1,5,0,0,2,4,1,0,1,0,0,0,1,3,4
401488057,Colgate Raiders,TEAM,TOTAL,TOTAL,False,,20,63,15,43,5,20,4,7,12,17,29,12,5,3,5,17,49
401488056,Colgate Raiders,T. McMillan,4704704,,True,30.0,4,10,4,10,0,0,0,2,1,0,1,0,1,1,1,3,8
401488056,Colgate Raiders,M. Schiller,5109205,,True,27.0,2,2,2,2,0,0,1,2,1,4,5,1,4,0,2,4,5
401488056,Colgate Raiders,T. Golembiewski,4900535,,True,36.0,5,12,5,11,0,1,2,3,0,4,4,4,4,0,4,2,12
401488056,Colgate Raiders,J. Paul,4595552,,True,11.0,0,3,0,0,0,3,1,2,1,3,4,0,0,0,0,1,1
401488056,Colgate Raiders,A. Brodie,4595550,,True,41.0,0,5,0,4,0,1,3,4,1,6,7,4,3,0,1,2,3
401488056,Colgate Raiders,C. Okafor,5109208,,False,4.0,1,4,1,4,0,0,0,0,0,0,0,0,0,3,0,0,2
401488056,Colgate Raiders,S. Diehl,4900536,,False,21.0,2,7,0,3,2,4,1,2,1,3,4,0,1,1,1,0,7
401488056,Colgate Raiders,A. Ferguson,5109209,,False,6.0,0,2,0,2,0,0,0,0,0,3,3,1,0,0,0,1,0
401488056,Colgate Raiders,C. Midgette,5109204,,False,11.0,1,4,1,4,0,0,0,0,1,2,3,0,0,0,0,1,2
401488056,Colgate Raiders,L. Cook,5109207,,False,7.0,0,0,0,0,0,0,0,0,0,0,0,0,0,0,0,0,0
401488056,Colgate Raiders,M. McMahon,4900534,,False,31.0,7,14,5,11,2,3,8,9,3,2,5,0,0,0,2,3,24
401488056,Colgate Raiders,TEAM,TOTAL,TOTAL,False,,22,63,18,51,4,12,16,24,10,27,37,10,13,5,13,17,64
401488056,Colgate Raiders,T. McMillan,4704704,,True,30.0,4,10,4,10,0,0,0,2,1,0,1,0,1,1,1,3,8
401488056,Colgate Raiders,M. Schiller,5109205,,True,27.0,2,2,2,2,0,0,1,2,1,4,5,1,4,0,2,4,5
401488056,Colgate Raiders,T. Golembiewski,4900535,,True,36.0,5,12,5,11,0,1,2,3,0,4,4,4,4,0,4,2,12
401488056,Colgate Raiders,J. Paul,4595552,,True,11.0,0,3,0,0,0,3,1,2,1,3,4,0,0,0,0,1,1
401488056,Colgate Raiders,A. Brodie,4595550,,True,41.0,0,5,0,4,0,1,3,4,1,6,7,4,3,0,1,2,3
401488056,Colgate Raiders,C. Okafor,5109208,,False,4.0,1,4,1,4,0,0,0,0,0,0,0,0,0,3,0,0,2
401488056,Colgate Raiders,S. Diehl,4900536,,False,21.0,2,7,0,3,2,4,1,2,1,3,4,0,1,1,1,0,7
401488056,Colgate Raiders,A. Ferguson,5109209,,False,6.0,0,2,0,2,0,0,0,0,0,3,3,1,0,0,0,1,0
401488056,Colgate Raiders,C. Midgette,5109204,,False,11.0,1,4,1,4,0,0,0,0,1,2,3,0,0,0,0,1,2
401488056,Colgate Raiders,L. Cook,5109207,,False,7.0,0,0,0,0,0,0,0,0,0,0,0,0,0,0,0,0,0
401488056,Colgate Raiders,M. McMahon,4900534,,False,31.0,7,14,5,11,2,3,8,9,3,2,5,0,0,0,2,3,24
401488056,Colgate Raiders,TEAM,TOTAL,TOTAL,False,,22,63,18,51,4,12,16,24,10,27,37,10,13,5,13,17,64
401488056,Bucknell Bison,I. King,4900533,,True,27.0,0,3,0,1,0,2,0,0,0,2,2,0,0,0,1,0,0
401488056,Bucknell Bison,E. Shaffer,4595535,,True,33.0,2,8,2,8,0,0,5,6,3,11,14,4,0,2,5,4,9
401488056,Bucknell Bison,E. Theodorsson,5109199,,True,41.0,5,13,4,9,1,4,1,2,0,5,5,0,1,0,4,2,12
401488056,Bucknell Bison,T. Johnson,4595533,,True,44.0,8,18,8,14,0,4,5,6,0,4,4,2,0,0,2,4,21
401488056,Bucknell Bison,C. Dingler,4577540,,True,41.0,2,5,2,5,0,0,0,0,0,5,5,1,1,1,5,2,4
401488056,Bucknell Bison,G. Sullivan,5109201,,False,12.0,2,7,2,7,0,0,0,0,0,1,1,1,1,0,0,2,4
401488056,Bucknell Bison,R. Sisselman,4900531,,False,8.0,1,2,1,1,0,1,0,0,0,3,3,1,2,0,1,2,2
401488056,Bucknell Bison,B. Matthews,5109200,,False,0.0,0,0,0,0,0,0,0,0,0,0,0,0,0,0,0,2,0
401488056,Bucknell Bison,J. Kulesza,4704702,,False,18.0,2,2,1,1,1,1,0,0,0,0,0,0,1,0,1,2,5
401488056,Bucknell Bison,TEAM,TOTAL,TOTAL,False,,22,58,20,46,2,12,11,14,7,34,41,9,6,3,22,20,57
401488056,Bucknell Bison,I. King,4900533,,True,27.0,0,3,0,1,0,2,0,0,0,2,2,0,0,0,1,0,0
401488056,Bucknell Bison,E. Shaffer,4595535,,True,33.0,2,8,2,8,0,0,5,6,3,11,14,4,0,2,5,4,9
401488056,Bucknell Bison,E. Theodorsson,5109199,,True,41.0,5,13,4,9,1,4,1,2,0,5,5,0,1,0,4,2,12
401488056,Bucknell Bison,T. Johnson,4595533,,True,44.0,8,18,8,14,0,4,5,6,0,4,4,2,0,0,2,4,21
401488056,Bucknell Bison,C. Dingler,4577540,,True,41.0,2,5,2,5,0,0,0,0,0,5,5,1,1,1,5,2,4
401488056,Bucknell Bison,G. Sullivan,5109201,,False,12.0,2,7,2,7,0,0,0,0,0,1,1,1,1,0,0,2,4
401488056,Bucknell Bison,R. Sisselman,4900531,,False,8.0,1,2,1,1,0,1,0,0,0,3,3,1,2,0,1,2,2
401488056,Bucknell Bison,B. Matthews,5109200,,False,0.0,0,0,0,0,0,0,0,0,0,0,0,0,0,0,0,2,0
401488056,Bucknell Bison,J. Kulesza,4704702,,False,18.0,2,2,1,1,1,1,0,0,0,0,0,0,1,0,1,2,5
401488056,Bucknell Bison,TEAM,TOTAL,TOTAL,False,,22,58,20,46,2,12,11,14,7,34,41,9,6,3,22,20,57
401488055,Navy Midshipmen,M. Andrews,4704780,,True,22.0,0,1,0,1,0,0,0,2,1,9,10,3,0,0,0,2,0
401488055,Navy Midshipmen,K. Samson,5109237,,True,29.0,7,17,7,17,0,0,0,0,0,3,3,2,0,0,3,4,14
401488055,Navy Midshipmen,S. Watts,4704782,,True,40.0,4,10,3,7,1,3,1,1,0,3,3,1,0,0,2,1,10
401488055,Navy Midshipmen,M. Louridas,5109236,,True,36.0,1,10,0,4,1,6,0,0,0,3,3,1,0,0,4,0,3
401488055,Navy Midshipmen,M. Schrader,4595622,,True,26.0,1,6,1,4,0,2,0,0,1,2,3,2,0,0,2,5,2
401488055,Navy Midshipmen,M. Demos,5109235,,False,3.0,1,2,1,2,0,0,0,0,1,0,1,0,0,0,0,0,2
401488055,Navy Midshipmen,G. Pissott,5109232,,False,18.0,1,1,1,1,0,0,0,0,0,6,6,0,0,0,2,4,2
401488055,Navy Midshipmen,S. Lewis,4900553,,False,8.0,0,1,0,0,0,1,0,0,0,1,1,0,1,0,0,3,0
401488055,Navy Midshipmen,K. Giuliani,5109230,,False,3.0,0,0,0,0,0,0,0,0,0,0,0,2,0,0,0,0,0
401488055,Navy Midshipmen,S. Schofield,4704779,,False,15.0,0,3,0,2,0,1,1,2,0,0,0,0,0,0,1,0,1
401488055,Navy Midshipmen,TEAM,TOTAL,TOTAL,False,,15,51,13,38,2,13,2,5,4,29,33,11,1,0,15,19,34
401488055,Navy Midshipmen,M. Andrews,4704780,,True,22.0,0,1,0,1,0,0,0,2,1,9,10,3,0,0,0,2,0
401488055,Navy Midshipmen,K. Samson,5109237,,True,29.0,7,17,7,17,0,0,0,0,0,3,3,2,0,0,3,4,14
401488055,Navy Midshipmen,S. Watts,4704782,,True,40.0,4,10,3,7,1,3,1,1,0,3,3,1,0,0,2,1,10
401488055,Navy Midshipmen,M. Louridas,5109236,,True,36.0,1,10,0,4,1,6,0,0,0,3,3,1,0,0,4,0,3
401488055,Navy Midshipmen,M. Schrader,4595622,,True,26.0,1,6,1,4,0,2,0,0,1,2,3,2,0,0,2,5,2
401488055,Navy Midshipmen,M. Demos,5109235,,False,3.0,1,2,1,2,0,0,0,0,1,0,1,0,0,0,0,0,2
401488055,Navy Midshipmen,G. Pissott,5109232,,False,18.0,1,1,1,1,0,0,0,0,0,6,6,0,0,0,2,4,2
401488055,Navy Midshipmen,S. Lewis,4900553,,False,8.0,0,1,0,0,0,1,0,0,0,1,1,0,1,0,0,3,0
401488055,Navy Midshipmen,K. Giuliani,5109230,,False,3.0,0,0,0,0,0,0,0,0,0,0,0,2,0,0,0,0,0
401488055,Navy Midshipmen,S. Schofield,4704779,,False,15.0,0,3,0,2,0,1,1,2,0,0,0,0,0,0,1,0,1
401488055,Navy Midshipmen,TEAM,TOTAL,TOTAL,False,,15,51,13,38,2,13,2,5,4,29,33,11,1,0,15,19,34
401488055,Colgate Raiders,T. McMillan,4704704,,True,27.0,2,5,2,5,0,0,0,0,1,5,6,2,1,0,1,1,4
401488055,Colgate Raiders,M. Schiller,5109205,,True,34.0,4,8,3,5,1,3,1,2,1,3,4,0,0,0,0,2,10
401488055,Colgate Raiders,T. Golembiewski,4900535,,True,20.0,4,9,3,7,1,2,1,1,0,3,3,1,2,1,0,3,10
401488055,Colgate Raiders,J. Paul,4595552,,True,21.0,4,9,3,5,1,4,1,2,1,5,6,0,1,1,0,0,10
401488055,Colgate Raiders,A. Brodie,4595550,,True,26.0,2,8,2,7,0,1,2,2,1,2,3,2,1,0,0,1,6
401488055,Colgate Raiders,C. Okafor,5109208,,False,1.0,0,0,0,0,0,0,0,0,0,0,0,0,0,0,0,0,0
401488055,Colgate Raiders,S. Diehl,4900536,,False,14.0,0,4,0,2,0,2,0,0,1,1,2,0,1,0,0,2,0
401488055,Colgate Raiders,L. Blackmore,4704706,,False,3.0,1,1,1,1,0,0,1,1,0,1,1,0,0,0,0,0,3
401488055,Colgate Raiders,A. Ferguson,5109209,,False,7.0,0,0,0,0,0,0,0,0,1,0,1,0,1,0,1,0,0
401488055,Colgate Raiders,C. Midgette,5109204,,False,11.0,1,3,1,3,0,0,0,2,1,3,4,0,0,2,0,1,2
401488055,Colgate Raiders,L. Cook,5109207,,False,12.0,1,5,1,2,0,3,2,2,1,2,3,1,1,0,1,3,4
401488055,Colgate Raiders,M. McMahon,4900534,,False,24.0,4,8,4,6,0,2,7,8,0,6,6,1,1,0,2,1,15
401488055,Colgate Raiders,TEAM,TOTAL,TOTAL,False,,23,60,20,43,3,17,15,20,10,33,43,7,9,4,5,14,64
401488055,Colgate Raiders,T. McMillan,4704704,,True,27.0,2,5,2,5,0,0,0,0,1,5,6,2,1,0,1,1,4
401488055,Colgate Raiders,M. Schiller,5109205,,True,34.0,4,8,3,5,1,3,1,2,1,3,4,0,0,0,0,2,10
401488055,Colgate Raiders,T. Golembiewski,4900535,,True,20.0,4,9,3,7,1,2,1,1,0,3,3,1,2,1,0,3,10
401488055,Colgate Raiders,J. Paul,4595552,,True,21.0,4,9,3,5,1,4,1,2,1,5,6,0,1,1,0,0,10
401488055,Colgate Raiders,A. Brodie,4595550,,True,26.0,2,8,2,7,0,1,2,2,1,2,3,2,1,0,0,1,6
401488055,Colgate Raiders,C. Okafor,5109208,,False,1.0,0,0,0,0,0,0,0,0,0,0,0,0,0,0,0,0,0
401488055,Colgate Raiders,S. Diehl,4900536,,False,14.0,0,4,0,2,0,2,0,0,1,1,2,0,1,0,0,2,0
401488055,Colgate Raiders,L. Blackmore,4704706,,False,3.0,1,1,1,1,0,0,1,1,0,1,1,0,0,0,0,0,3
401488055,Colgate Raiders,A. Ferguson,5109209,,False,7.0,0,0,0,0,0,0,0,0,1,0,1,0,1,0,1,0,0
401488055,Colgate Raiders,C. Midgette,5109204,,False,11.0,1,3,1,3,0,0,0,2,1,3,4,0,0,2,0,1,2
401488055,Colgate Raiders,L. Cook,5109207,,False,12.0,1,5,1,2,0,3,2,2,1,2,3,1,1,0,1,3,4
401488055,Colgate Raiders,M. McMahon,4900534,,False,24.0,4,8,4,6,0,2,7,8,0,6,6,1,1,0,2,1,15
401488055,Colgate Raiders,TEAM,TOTAL,TOTAL,False,,23,60,20,43,3,17,15,20,10,33,43,7,9,4,5,14,64
401488054,Lehigh Mountain Hawks,L. Fandre,5109220,,True,21.0,1,4,1,2,0,2,0,2,2,2,4,1,1,1,1,1,2
401488054,Lehigh Mountain Hawks,M. O'Brien,4900547,,True,17.0,1,3,1,2,0,1,0,0,1,5,6,2,2,0,1,2,2
401488054,Lehigh Mountain Hawks,F. Hottinger,4595613,,True,36.0,10,18,8,12,2,6,2,2,3,10,13,3,1,2,3,2,24
401488054,Lehigh Mountain Hawks,M. Kramer,4704762,,True,35.0,7,17,5,8,2,9,3,3,0,1,1,0,0,0,1,2,19
401488054,Lehigh Mountain Hawks,A. Harvey,4595612,,True,31.0,1,4,0,2,1,2,0,0,0,2,2,6,0,0,3,2,3
401488054,Lehigh Mountain Hawks,K. Van Eps,4900545,,False,17.0,0,5,0,1,0,4,0,0,0,0,0,2,0,0,1,1,0
401488054,Lehigh Mountain Hawks,E. Stemmer,4900544,,False,23.0,1,5,0,3,1,2,1,2,2,0,2,0,1,1,0,3,4
401488054,Lehigh Mountain Hawks,F. Eggenschwiler,4704761,,False,0.0,0,0,0,0,0,0,0,0,0,0,0,0,0,0,0,0,0
401488054,Lehigh Mountain Hawks,J. Behar,4433782,,False,20.0,2,5,2,2,0,3,1,2,0,2,2,2,1,0,1,0,5
401488054,Lehigh Mountain Hawks,TEAM,TOTAL,TOTAL,False,,23,61,17,32,6,29,7,11,10,24,34,16,6,4,11,13,59
401488054,Lehigh Mountain Hawks,L. Fandre,5109220,,True,21.0,1,4,1,2,0,2,0,2,2,2,4,1,1,1,1,1,2
401488054,Lehigh Mountain Hawks,M. O'Brien,4900547,,True,17.0,1,3,1,2,0,1,0,0,1,5,6,2,2,0,1,2,2
401488054,Lehigh Mountain Hawks,F. Hottinger,4595613,,True,36.0,10,18,8,12,2,6,2,2,3,10,13,3,1,2,3,2,24
401488054,Lehigh Mountain Hawks,M. Kramer,4704762,,True,35.0,7,17,5,8,2,9,3,3,0,1,1,0,0,0,1,2,19
401488054,Lehigh Mountain Hawks,A. Harvey,4595612,,True,31.0,1,4,0,2,1,2,0,0,0,2,2,6,0,0,3,2,3
401488054,Lehigh Mountain Hawks,K. Van Eps,4900545,,False,17.0,0,5,0,1,0,4,0,0,0,0,0,2,0,0,1,1,0
401488054,Lehigh Mountain Hawks,E. Stemmer,4900544,,False,23.0,1,5,0,3,1,2,1,2,2,0,2,0,1,1,0,3,4
401488054,Lehigh Mountain Hawks,F. Eggenschwiler,4704761,,False,0.0,0,0,0,0,0,0,0,0,0,0,0,0,0,0,0,0,0
401488054,Lehigh Mountain Hawks,J. Behar,4433782,,False,20.0,2,5,2,2,0,3,1,2,0,2,2,2,1,0,1,0,5
401488054,Lehigh Mountain Hawks,TEAM,TOTAL,TOTAL,False,,23,61,17,32,6,29,7,11,10,24,34,16,6,4,11,13,59
401488054,Colgate Raiders,T. McMillan,4704704,,True,26.0,3,8,3,8,0,0,0,0,2,2,4,1,2,0,3,2,6
401488054,Colgate Raiders,M. Schiller,5109205,,True,27.0,1,1,0,0,1,1,0,0,0,4,4,1,1,0,0,0,3
401488054,Colgate Raiders,T. Golembiewski,4900535,,True,28.0,3,9,3,7,0,2,3,4,2,3,5,6,1,2,2,1,9
401488054,Colgate Raiders,J. Paul,4595552,,True,18.0,4,7,3,5,1,2,0,0,0,2,2,1,0,0,0,2,9
401488054,Colgate Raiders,A. Brodie,4595550,,True,32.0,5,10,4,9,1,1,2,2,0,4,4,4,1,0,1,1,13
401488054,Colgate Raiders,S. Diehl,4900536,,False,24.0,3,9,3,5,0,4,2,4,1,5,6,2,1,0,0,2,8
401488054,Colgate Raiders,A. Ferguson,5109209,,False,4.0,0,0,0,0,0,0,0,0,0,1,1,0,0,0,0,1,0
401488054,Colgate Raiders,C. Midgette,5109204,,False,7.0,1,1,1,1,0,0,0,0,0,3,3,0,0,0,0,0,2
401488054,Colgate Raiders,L. Cook,5109207,,False,16.0,3,5,2,4,1,1,2,2,0,1,1,1,1,0,1,0,9
401488054,Colgate Raiders,M. McMahon,4900534,,False,18.0,4,8,4,8,0,0,2,2,2,0,2,1,0,0,4,2,10
401488054,Colgate Raiders,TEAM,TOTAL,TOTAL,False,,27,58,23,47,4,11,11,14,8,29,37,17,7,2,11,11,69
401488054,Colgate Raiders,T. McMillan,4704704,,True,26.0,3,8,3,8,0,0,0,0,2,2,4,1,2,0,3,2,6
401488054,Colgate Raiders,M. Schiller,5109205,,True,27.0,1,1,0,0,1,1,0,0,0,4,4,1,1,0,0,0,3
401488054,Colgate Raiders,T. Golembiewski,4900535,,True,28.0,3,9,3,7,0,2,3,4,2,3,5,6,1,2,2,1,9
401488054,Colgate Raiders,J. Paul,4595552,,True,18.0,4,7,3,5,1,2,0,0,0,2,2,1,0,0,0,2,9
401488054,Colgate Raiders,A. Brodie,4595550,,True,32.0,5,10,4,9,1,1,2,2,0,4,4,4,1,0,1,1,13
401488054,Colgate Raiders,S. Diehl,4900536,,False,24.0,3,9,3,5,0,4,2,4,1,5,6,2,1,0,0,2,8
401488054,Colgate Raiders,A. Ferguson,5109209,,False,4.0,0,0,0,0,0,0,0,0,0,1,1,0,0,0,0,1,0
401488054,Colgate Raiders,C. Midgette,5109204,,False,7.0,1,1,1,1,0,0,0,0,0,3,3,0,0,0,0,0,2
401488054,Colgate Raiders,L. Cook,5109207,,False,16.0,3,5,2,4,1,1,2,2,0,1,1,1,1,0,1,0,9
401488054,Colgate Raiders,M. McMahon,4900534,,False,18.0,4,8,4,8,0,0,2,2,2,0,2,1,0,0,4,2,10
401488054,Colgate Raiders,TEAM,TOTAL,TOTAL,False,,27,58,23,47,4,11,11,14,8,29,37,17,7,2,11,11,69
401488053,Loyola Maryland Greyhounds,L. Therien,4900552,,True,35.0,7,10,6,9,1,1,3,5,2,8,10,1,1,0,2,2,18
401488053,Loyola Maryland Greyhounds,K. Sims,4898948,,True,30.0,5,7,5,7,0,0,1,1,4,6,10,0,1,1,1,1,11
401488053,Loyola Maryland Greyhounds,K. Ratigan,5109222,,True,35.0,1,5,0,1,1,4,0,0,0,0,0,3,1,0,0,3,3
401488053,Loyola Maryland Greyhounds,L. Salmeron,4900549,,True,29.0,0,3,0,0,0,3,0,0,0,2,2,4,0,0,4,1,0
401488053,Loyola Maryland Greyhounds,T. Dixon,4400209,,True,38.0,4,12,4,9,0,3,4,4,0,0,0,4,4,0,3,1,12
401488053,Loyola Maryland Greyhounds,M. Espinal,5109228,,False,4.0,0,0,0,0,0,0,0,0,0,1,1,0,0,0,0,0,0
401488053,Loyola Maryland Greyhounds,E. Glezen,4596304,,False,8.0,0,1,0,0,0,1,0,0,0,2,2,0,0,0,0,1,0
401488053,Loyola Maryland Greyhounds,C. Garcia,5109224,,False,8.0,1,2,1,2,0,0,0,0,0,1,1,0,0,0,1,0,2
401488053,Loyola Maryland Greyhounds,M. Van-Otoo,5109223,,False,11.0,0,1,0,0,0,1,1,2,0,0,0,0,0,0,2,2,1
401488053,Loyola Maryland Greyhounds,D. Newman,4399474,,False,27.0,7,11,7,10,0,1,0,0,2,2,4,3,0,0,1,0,14
401488053,Loyola Maryland Greyhounds,TEAM,TOTAL,TOTAL,False,,25,52,23,38,2,14,9,12,8,22,30,15,7,1,14,11,61
401488053,Loyola Maryland Greyhounds,L. Therien,4900552,,True,35.0,7,10,6,9,1,1,3,5,2,8,10,1,1,0,2,2,18
401488053,Loyola Maryland Greyhounds,K. Sims,4898948,,True,30.0,5,7,5,7,0,0,1,1,4,6,10,0,1,1,1,1,11
401488053,Loyola Maryland Greyhounds,K. Ratigan,5109222,,True,35.0,1,5,0,1,1,4,0,0,0,0,0,3,1,0,0,3,3
401488053,Loyola Maryland Greyhounds,L. Salmeron,4900549,,True,29.0,0,3,0,0,0,3,0,0,0,2,2,4,0,0,4,1,0
401488053,Loyola Maryland Greyhounds,T. Dixon,4400209,,True,38.0,4,12,4,9,0,3,4,4,0,0,0,4,4,0,3,1,12
401488053,Loyola Maryland Greyhounds,M. Espinal,5109228,,False,4.0,0,0,0,0,0,0,0,0,0,1,1,0,0,0,0,0,0
401488053,Loyola Maryland Greyhounds,E. Glezen,4596304,,False,8.0,0,1,0,0,0,1,0,0,0,2,2,0,0,0,0,1,0
401488053,Loyola Maryland Greyhounds,C. Garcia,5109224,,False,8.0,1,2,1,2,0,0,0,0,0,1,1,0,0,0,1,0,2
401488053,Loyola Maryland Greyhounds,M. Van-Otoo,5109223,,False,11.0,0,1,0,0,0,1,1,2,0,0,0,0,0,0,2,2,1
401488053,Loyola Maryland Greyhounds,D. Newman,4399474,,False,27.0,7,11,7,10,0,1,0,0,2,2,4,3,0,0,1,0,14
401488053,Loyola Maryland Greyhounds,TEAM,TOTAL,TOTAL,False,,25,52,23,38,2,14,9,12,8,22,30,15,7,1,14,11,61
401488053,Colgate Raiders,T. McMillan,4704704,,True,34.0,6,8,6,8,0,0,0,0,4,3,7,0,0,0,5,2,12
401488053,Colgate Raiders,M. Schiller,5109205,,True,36.0,0,3,0,2,0,1,0,0,1,1,2,1,2,0,1,3,0
401488053,Colgate Raiders,T. Golembiewski,4900535,,True,28.0,1,8,1,3,0,5,0,0,1,0,1,7,1,0,2,4,2
401488053,Colgate Raiders,J. Paul,4595552,,True,23.0,5,9,2,2,3,7,0,0,0,0,0,1,0,0,1,0,13
401488053,Colgate Raiders,A. Brodie,4595550,,True,38.0,5,9,4,6,1,3,2,3,1,0,1,3,1,0,2,2,13
401488053,Colgate Raiders,N. Parks,5109206,,False,4.0,1,1,1,1,0,0,0,0,2,1,3,0,0,0,0,1,2
401488053,Colgate Raiders,S. Diehl,4900536,,False,20.0,4,10,3,5,1,5,2,2,1,4,5,0,1,0,2,2,11
401488053,Colgate Raiders,A. Ferguson,5109209,,False,7.0,0,1,0,1,0,0,0,0,0,1,1,0,0,0,0,0,0
401488053,Colgate Raiders,C. Midgette,5109204,,False,8.0,0,2,0,2,0,0,0,0,1,1,2,1,0,1,1,0,0
401488053,Colgate Raiders,M. McMahon,4900534,,False,27.0,1,9,0,7,1,2,0,0,1,1,2,3,0,0,1,3,3
401488053,Colgate Raiders,TEAM,TOTAL,TOTAL,False,,23,60,17,37,6,23,4,5,12,12,24,16,5,1,15,17,56
401488053,Colgate Raiders,T. McMillan,4704704,,True,34.0,6,8,6,8,0,0,0,0,4,3,7,0,0,0,5,2,12
401488053,Colgate Raiders,M. Schiller,5109205,,True,36.0,0,3,0,2,0,1,0,0,1,1,2,1,2,0,1,3,0
401488053,Colgate Raiders,T. Golembiewski,4900535,,True,28.0,1,8,1,3,0,5,0,0,1,0,1,7,1,0,2,4,2
401488053,Colgate Raiders,J. Paul,4595552,,True,23.0,5,9,2,2,3,7,0,0,0,0,0,1,0,0,1,0,13
401488053,Colgate Raiders,A. Brodie,4595550,,True,38.0,5,9,4,6,1,3,2,3,1,0,1,3,1,0,2,2,13
401488053,Colgate Raiders,N. Parks,5109206,,False,4.0,1,1,1,1,0,0,0,0,2,1,3,0,0,0,0,1,2
401488053,Colgate Raiders,S. Diehl,4900536,,False,20.0,4,10,3,5,1,5,2,2,1,4,5,0,1,0,2,2,11
401488053,Colgate Raiders,A. Ferguson,5109209,,False,7.0,0,1,0,1,0,0,0,0,0,1,1,0,0,0,0,0,0
401488053,Colgate Raiders,C. Midgette,5109204,,False,8.0,0,2,0,2,0,0,0,0,1,1,2,1,0,1,1,0,0
401488053,Colgate Raiders,M. McMahon,4900534,,False,27.0,1,9,0,7,1,2,0,0,1,1,2,3,0,0,1,3,3
401488053,Colgate Raiders,TEAM,TOTAL,TOTAL,False,,23,60,17,37,6,23,4,5,12,12,24,16,5,1,15,17,56
401488052,St. Bonaventure Bonnies,I. Lops,4595879,,True,28.0,3,11,1,8,2,3,0,0,0,5,5,0,0,1,1,3,8
401488052,St. Bonaventure Bonnies,K. Dandridge,5107535,,True,18.0,1,3,1,2,0,1,3,4,1,1,2,1,3,0,0,2,5
401488052,St. Bonaventure Bonnies,N. Laccen,5107534,,True,23.0,1,5,1,3,0,2,1,2,0,0,0,2,0,0,3,2,3
401488052,St. Bonaventure Bonnies,M. Dziezgowski,4704131,,True,32.0,3,8,1,3,2,5,0,0,1,2,3,1,3,0,1,2,8
401488052,St. Bonaventure Bonnies,K. Parker,4594797,,True,17.0,1,2,1,2,0,0,0,0,2,1,3,0,1,0,2,2,2
401488052,St. Bonaventure Bonnies,T. Napper,4898539,,False,12.0,0,2,0,2,0,0,0,0,0,1,1,1,0,0,2,3,0
401488052,St. Bonaventure Bonnies,F. Vinerte,4704564,,False,11.0,0,2,0,2,0,0,0,0,1,0,1,0,0,1,2,4,0
401488052,St. Bonaventure Bonnies,C. Cody,4594800,,False,13.0,1,3,1,2,0,1,0,0,0,0,0,0,0,0,0,0,2
401488052,St. Bonaventure Bonnies,P. Fields,5107537,,False,4.0,0,0,0,0,0,0,1,2,0,0,0,0,0,0,0,0,1
401488052,St. Bonaventure Bonnies,A. Webb,5107536,,False,3.0,2,2,2,2,0,0,0,0,0,1,1,0,1,0,0,0,4
401488052,St. Bonaventure Bonnies,B. Ware,5107533,,False,27.0,6,7,6,7,0,0,1,2,1,1,2,3,3,0,5,3,13
401488052,St. Bonaventure Bonnies,N. Oppenheimer,4281219,,False,12.0,2,3,0,0,2,3,0,0,0,0,0,0,0,0,0,0,6
401488052,St. Bonaventure Bonnies,TEAM,TOTAL,TOTAL,False,,20,48,14,33,6,15,6,10,8,13,21,8,11,2,16,21,52
401488052,Colgate Raiders,T. McMillan,4704704,,True,24.0,5,9,5,9,0,0,2,4,2,3,5,0,0,1,3,0,12
401488052,Colgate Raiders,M. Schiller,5109205,,True,24.0,2,4,2,2,0,2,0,0,1,4,5,1,1,0,3,1,4
401488052,Colgate Raiders,T. Golembiewski,4900535,,True,27.0,5,11,3,6,2,5,1,1,2,3,5,2,1,0,2,2,13
401488052,Colgate Raiders,J. Paul,4595552,,True,17.0,2,4,1,1,1,3,0,0,0,3,3,0,1,0,1,1,5
401488052,Colgate Raiders,A. Brodie,4595550,,True,25.0,1,2,1,2,0,0,5,5,0,0,0,5,0,0,3,0,7
401488052,Colgate Raiders,C. Okafor,5109208,,False,5.0,0,0,0,0,0,0,0,0,0,0,0,0,0,1,1,1,0
401488052,Colgate Raiders,N. Parks,5109206,,False,8.0,0,0,0,0,0,0,2,2,0,0,0,0,0,0,1,0,2
401488052,Colgate Raiders,S. Diehl,4900536,,False,23.0,3,5,3,4,0,1,1,1,1,3,4,1,0,0,1,2,7
401488052,Colgate Raiders,L. Blackmore,4704706,,False,3.0,0,0,0,0,0,0,0,0,0,1,1,0,0,0,0,0,0
401488052,Colgate Raiders,A. Ferguson,5109209,,False,11.0,2,2,2,2,0,0,0,0,0,0,0,0,0,0,1,1,4
401488052,Colgate Raiders,C. Midgette,5109204,,False,3.0,0,0,0,0,0,0,0,0,0,0,0,0,0,0,0,0,0
401488052,Colgate Raiders,L. Cook,5109207,,False,5.0,1,1,1,1,0,0,2,2,2,1,3,0,0,0,1,0,4
401488052,Colgate Raiders,M. McMahon,4900534,,False,25.0,3,7,3,7,0,0,2,2,0,2,2,2,2,0,0,2,8
401488052,Colgate Raiders,TEAM,TOTAL,TOTAL,False,,24,45,21,34,3,11,15,17,9,22,31,11,5,2,17,10,66
401488051,Oswego St Lakers,D. Pickett,5118595,,True,25.0,3,7,3,7,0,0,0,4,0,2,2,2,3,0,2,2,6
401488051,Oswego St Lakers,J. Logana,5118594,,True,28.0,1,4,1,4,0,0,0,0,2,3,5,0,1,0,4,0,2
401488051,Oswego St Lakers,S. Iglesias,5118596,,True,29.0,4,14,3,10,1,4,1,1,1,3,4,1,2,0,5,2,10
401488051,Oswego St Lakers,L. Castiglione,5118589,,True,17.0,0,4,0,3,0,1,0,0,0,0,0,1,0,0,3,1,0
401488051,Oswego St Lakers,K. Leo,4598039,,True,17.0,1,4,0,1,1,3,2,2,0,1,1,0,2,0,5,1,5
401488051,Oswego St Lakers,E. Johnson,5118590,,False,8.0,0,0,0,0,0,0,0,0,0,1,1,0,0,0,0,0,0
401488051,Oswego St Lakers,S. Hoefs,5118588,,False,9.0,0,1,0,0,0,1,0,0,0,1,1,0,0,0,2,2,0
401488051,Oswego St Lakers,J. Russo,5118586,,False,5.0,0,1,0,0,0,1,1,2,0,0,0,0,1,0,0,0,1
401488051,Oswego St Lakers,P. Daeffler,5118585,,False,11.0,1,2,1,2,0,0,0,0,0,0,0,1,0,0,2,2,2
401488051,Oswego St Lakers,J. Tanenblatt,5118584,,False,9.0,0,3,0,2,0,1,0,0,0,0,0,0,0,0,0,0,0
401488051,Oswego St Lakers,C. Giles,5118583,,False,11.0,1,6,0,2,1,4,0,0,0,1,1,2,0,0,3,0,3
401488051,Oswego St Lakers,G. White-Principio,5118598,,False,7.0,0,0,0,0,0,0,0,0,0,0,0,0,0,0,0,2,0
401488051,Oswego St Lakers,L. Nyemchek,5118591,,False,8.0,0,0,0,0,0,0,0,0,0,0,0,0,0,0,1,1,0
401488051,Oswego St Lakers,C. Lilly,5118587,,False,8.0,0,0,0,0,0,0,0,0,0,1,1,0,0,0,0,1,0
401488051,Oswego St Lakers,M. James,5118593,,False,3.0,0,0,0,0,0,0,1,2,0,0,0,0,0,0,0,0,1
401488051,Oswego St Lakers,C. Skowronski,5118592,,False,5.0,0,1,0,0,0,1,0,0,1,1,2,0,0,0,0,0,0
401488051,Oswego St Lakers,TEAM,TOTAL,TOTAL,False,,11,47,8,31,3,16,5,11,4,14,18,7,9,0,27,14,30
401488051,Colgate Raiders,T. McMillan,4704704,,True,14.0,2,4,2,4,0,0,0,0,1,0,1,2,0,1,0,0,4
401488051,Colgate Raiders,M. Schiller,5109205,,True,31.0,6,9,2,3,4,6,2,2,2,4,6,10,5,0,1,0,18
401488051,Colgate Raiders,T. Golembiewski,4900535,,True,22.0,4,7,2,2,2,5,0,0,0,1,1,3,2,0,4,2,10
401488051,Colgate Raiders,J. Paul,4595552,,True,12.0,2,5,1,2,1,3,0,0,0,7,7,2,0,0,0,2,5
401488051,Colgate Raiders,A. Brodie,4595550,,True,15.0,2,4,2,3,0,1,0,0,1,1,2,4,0,0,0,0,4
401488051,Colgate Raiders,C. Okafor,5109208,,False,14.0,1,2,1,2,0,0,2,2,1,1,2,1,1,2,0,1,4
401488051,Colgate Raiders,N. Parks,5109206,,False,13.0,3,4,3,4,0,0,0,0,3,6,9,2,1,1,3,1,6
401488051,Colgate Raiders,S. Diehl,4900536,,False,13.0,1,5,1,4,0,1,0,0,1,2,3,2,0,0,1,0,2
401488051,Colgate Raiders,L. Blackmore,4704706,,False,13.0,5,8,4,6,1,2,0,0,0,1,1,0,0,0,0,0,11
401488051,Colgate Raiders,A. Ferguson,5109209,,False,19.0,3,3,3,3,0,0,2,2,2,2,4,2,2,1,1,2,8
401488051,Colgate Raiders,C. Midgette,5109204,,False,8.0,3,3,3,3,0,0,0,0,0,0,0,0,0,0,1,1,6
401488051,Colgate Raiders,L. Cook,5109207,,False,9.0,1,1,1,1,0,0,1,2,1,0,1,2,0,0,2,4,3
401488051,Colgate Raiders,M. McMahon,4900534,,False,17.0,2,8,2,7,0,1,2,5,0,3,3,2,2,0,2,1,6
401488051,Colgate Raiders,TEAM,TOTAL,TOTAL,False,,35,63,27,44,8,19,9,13,12,28,40,32,13,5,15,14,87
401488050,Siena Saints,E. Selimovic,4899878,,True,14.0,1,1,1,1,0,0,1,2,1,2,3,0,0,0,1,1,3
401488050,Siena Saints,A. Brown,4899879,,True,35.0,5,9,5,9,0,0,0,3,2,10,12,1,0,1,2,2,10
401488050,Siena Saints,E. Mevius,5109410,,True,28.0,2,6,0,2,2,4,2,2,0,1,1,2,1,0,5,4,8
401488050,Siena Saints,A. Jackson,4704629,,True,25.0,4,13,2,9,2,4,2,2,0,1,1,3,1,0,0,4,12
401488050,Siena Saints,V. Fontenelle-Posson,4433552,,True,33.0,3,9,2,6,1,3,1,2,2,5,7,3,0,0,1,2,8
401488050,Siena Saints,A. Jones,5109408,,False,25.0,2,4,2,3,0,1,0,0,0,1,1,3,0,0,3,2,4
401488050,Siena Saints,L. Gamble,5109405,,False,9.0,1,2,1,1,0,1,0,0,0,2,2,2,0,0,0,1,2
401488050,Siena Saints,T. Seppala,5109404,,False,31.0,5,6,2,3,3,3,2,4,1,7,8,3,1,0,4,2,15
401488050,Siena Saints,TEAM,TOTAL,TOTAL,False,,23,50,15,34,8,16,8,15,9,32,41,17,3,1,16,18,62
401488050,Colgate Raiders,T. McMillan,4704704,,True,26.0,3,7,3,7,0,0,0,0,1,1,2,0,2,0,1,1,6
401488050,Colgate Raiders,M. Schiller,5109205,,True,27.0,1,6,1,5,0,1,0,0,0,3,3,2,1,0,0,4,2
401488050,Colgate Raiders,T. Golembiewski,4900535,,True,37.0,6,16,4,10,2,6,2,4,3,5,8,1,2,0,1,1,16
401488050,Colgate Raiders,J. Paul,4595552,,True,19.0,0,6,0,3,0,3,0,0,1,2,3,5,0,1,0,2,0
401488050,Colgate Raiders,A. Brodie,4595550,,True,26.0,5,8,5,8,0,0,2,2,1,3,4,2,0,0,2,2,12
401488050,Colgate Raiders,N. Parks,5109206,,False,4.0,0,1,0,1,0,0,0,0,2,0,2,0,0,0,0,0,0
401488050,Colgate Raiders,S. Diehl,4900536,,False,26.0,5,10,5,9,0,1,1,2,1,5,6,1,1,0,0,1,11
401488050,Colgate Raiders,A. Ferguson,5109209,,False,6.0,0,1,0,1,0,0,0,0,0,0,0,0,0,0,0,0,0
401488050,Colgate Raiders,C. Midgette,5109204,,False,2.0,0,0,0,0,0,0,0,0,0,1,1,0,0,0,0,0,0
401488050,Colgate Raiders,M. McMahon,4900534,,False,27.0,4,11,4,8,0,3,3,4,2,2,4,2,0,0,1,1,11
401488050,Colgate Raiders,TEAM,TOTAL,TOTAL,False,,24,66,22,52,2,14,8,12,12,24,36,13,6,1,5,12,58
401488049,Colgate Raiders,S. Diehl,4900536,,True,25.0,1,6,0,3,1,3,0,0,0,2,2,5,0,0,0,0,3
401488049,Colgate Raiders,M. Schiller,5109205,,True,25.0,0,3,0,1,0,2,0,2,0,0,0,1,3,0,1,4,0
401488049,Colgate Raiders,T. Golembiewski,4900535,,True,35.0,7,16,5,12,2,4,2,2,1,1,2,0,1,0,0,2,18
401488049,Colgate Raiders,J. Paul,4595552,,True,10.0,1,2,1,1,0,1,0,0,1,1,2,1,0,0,1,0,2
401488049,Colgate Raiders,A. Brodie,4595550,,True,33.0,3,9,1,4,2,5,1,2,0,4,4,1,0,0,4,0,9
401488049,Colgate Raiders,C. Okafor,5109208,,False,8.0,0,2,0,2,0,0,2,2,0,1,1,0,0,0,0,2,2
401488049,Colgate Raiders,L. Blackmore,4704706,,False,3.0,0,0,0,0,0,0,2,2,2,1,3,0,0,0,0,0,2
401488049,Colgate Raiders,T. McMillan,4704704,,False,27.0,3,4,3,4,0,0,0,0,1,5,6,0,0,2,3,2,6
401488049,Colgate Raiders,A. Ferguson,5109209,,False,7.0,0,0,0,0,0,0,0,0,1,1,2,0,0,0,0,2,0
401488049,Colgate Raiders,C. Midgette,5109204,,False,1.0,0,0,0,0,0,0,0,0,1,0,1,0,0,0,0,1,0
401488049,Colgate Raiders,M. McMahon,4900534,,False,26.0,3,10,3,7,0,3,10,12,1,3,4,3,0,0,3,4,16
401488049,Colgate Raiders,TEAM,TOTAL,TOTAL,False,,18,52,13,34,5,18,17,22,11,19,30,11,4,2,12,17,58
401488049,Canisius Golden Griffins,C. Chard Peloquin,5108967,,True,22.0,1,4,1,4,0,0,2,2,4,3,7,2,0,0,2,3,4
401488049,Canisius Golden Griffins,B. Thrash,5108963,,True,26.0,3,5,2,3,1,2,1,1,0,1,1,2,3,0,2,3,8
401488049,Canisius Golden Griffins,A. Lexa,4899743,,True,33.0,3,8,3,6,0,2,1,2,0,7,7,1,0,0,3,3,7
401488049,Canisius Golden Griffins,D. Haskell,4704422,,True,34.0,8,15,4,8,4,7,0,0,0,2,2,1,2,0,2,3,20
401488049,Canisius Golden Griffins,V. Garrelts,4399336,,True,21.0,2,8,2,6,0,2,0,0,2,3,5,6,0,0,1,3,4
401488049,Canisius Golden Griffins,S. Eleko,5108964,,False,19.0,6,9,6,9,0,0,0,2,3,3,6,1,0,1,1,2,12
401488049,Canisius Golden Griffins,R. Porter,4899747,,False,7.0,1,1,1,1,0,0,0,0,1,2,3,1,0,0,0,3,2
401488049,Canisius Golden Griffins,G. Hernandez-Boulden,4917580,,False,11.0,2,3,2,3,0,0,3,4,1,1,2,0,2,0,0,1,7
401488049,Canisius Golden Griffins,J. McCauley,4915406,,False,14.0,0,2,0,1,0,1,0,0,0,0,0,0,0,0,0,1,0
401488049,Canisius Golden Griffins,E. Paez,4899745,,False,9.0,0,1,0,1,0,0,0,0,0,0,0,1,0,0,2,1,0
401488049,Canisius Golden Griffins,L. Gattozzi,4899741,,False,4.0,0,1,0,0,0,1,0,0,0,0,0,0,0,0,0,0,0
401488049,Canisius Golden Griffins,TEAM,TOTAL,TOTAL,False,,26,57,21,42,5,15,7,11,13,25,38,15,7,1,14,23,64
401488048,UAlbany Great Danes,T. Hanner,4594342,,True,20.0,1,5,1,5,0,0,0,0,4,1,5,0,0,0,2,1,2
401488048,UAlbany Great Danes,F. Werth,4898947,,True,36.0,7,13,5,8,2,5,1,2,2,4,6,0,2,0,4,3,17
401488048,UAlbany Great Danes,L. Phillips,4898946,,True,35.0,2,9,2,5,0,4,2,2,0,3,3,2,0,0,2,2,6
401488048,UAlbany Great Danes,G. Heeps,4594787,,True,39.0,1,7,0,2,1,5,0,0,0,1,1,4,1,0,2,0,3
401488048,UAlbany Great Danes,E. Hahne,4398744,,True,38.0,3,13,3,10,0,3,2,2,2,4,6,2,0,0,2,2,8
401488048,UAlbany Great Danes,M. Sepp,5107527,,False,2.0,0,2,0,1,0,1,0,0,0,1,1,0,0,0,0,1,0
401488048,UAlbany Great Danes,K. Sanford,5107526,,False,13.0,0,1,0,0,0,1,1,2,0,2,2,0,0,0,0,0,1
401488048,UAlbany Great Danes,A. Ray,4898949,,False,4.0,0,0,0,0,0,0,0,0,0,0,0,0,0,0,0,1,0
401488048,UAlbany Great Danes,F. Lee,4595154,,False,13.0,2,7,2,4,0,3,0,1,2,1,3,1,1,0,1,0,4
401488048,UAlbany Great Danes,TEAM,TOTAL,TOTAL,False,,16,57,13,35,3,22,6,9,11,20,31,9,4,0,13,10,41
401488048,Colgate Raiders,S. Diehl,4900536,,True,27.0,3,7,2,4,1,3,0,0,1,4,5,1,1,0,1,2,7
401488048,Colgate Raiders,T. Golembiewski,4900535,,True,34.0,2,9,1,5,1,4,0,0,1,8,9,1,2,0,3,2,5
401488048,Colgate Raiders,M. McMahon,4900534,,True,37.0,6,11,4,8,2,3,4,4,0,5,5,0,2,0,5,4,18
401488048,Colgate Raiders,J. Paul,4595552,,True,15.0,1,3,1,2,0,1,0,0,0,1,1,0,0,0,0,0,2
401488048,Colgate Raiders,A. Brodie,4595550,,True,36.0,6,11,5,9,1,2,2,3,1,6,7,2,0,0,1,2,15
401488048,Colgate Raiders,C. Okafor,5109208,,False,7.0,1,2,1,2,0,0,0,0,1,0,1,0,0,0,2,1,2
401488048,Colgate Raiders,T. McMillan,4704704,,False,18.0,2,2,2,2,0,0,0,0,1,1,2,1,0,0,2,4,4
401488048,Colgate Raiders,A. Ferguson,5109209,,False,22.0,1,2,1,2,0,0,0,0,1,5,6,1,0,0,0,1,2
401488048,Colgate Raiders,C. Midgette,5109204,,False,4.0,0,1,0,1,0,0,0,0,0,0,0,0,0,0,0,0,0
401488048,Colgate Raiders,TEAM,TOTAL,TOTAL,False,,22,48,17,35,5,13,6,7,6,32,38,6,5,0,16,16,55
401488047,Niagara Purple Eagles,J. Rutledge,5109310,,True,32.0,4,8,4,8,0,0,3,8,1,2,3,1,2,0,2,4,11
401488047,Niagara Purple Eagles,Aa. Parker,4899856,,True,36.0,9,22,9,18,0,4,4,4,5,9,14,1,7,0,7,4,22
401488047,Niagara Purple Eagles,N. O'Neil,4704633,,True,19.0,0,4,0,2,0,2,0,0,2,0,2,0,1,0,1,5,0
401488047,Niagara Purple Eagles,An. Parker,4595385,,True,35.0,8,25,5,17,3,8,2,2,1,4,5,2,1,0,4,5,21
401488047,Niagara Purple Eagles,M. Yelle,4399133,,True,35.0,4,9,4,9,0,0,0,0,2,2,4,1,2,0,3,5,8
401488047,Niagara Purple Eagles,A. Strong,5109308,,False,4.0,0,1,0,1,0,0,0,0,0,0,0,0,0,0,1,1,0
401488047,Niagara Purple Eagles,S. Faulcon,4595386,,False,12.0,2,4,2,4,0,0,0,0,0,2,2,0,0,0,2,1,4
401488047,Niagara Purple Eagles,M. Dickerson,5109309,,False,17.0,0,1,0,1,0,0,2,2,3,0,3,3,0,0,1,2,2
401488047,Niagara Purple Eagles,A. Hicks,5109307,,False,12.0,0,2,0,1,0,1,0,0,0,0,0,1,1,0,1,2,0
401488047,Niagara Purple Eagles,S. Fiddler,5109306,,False,15.0,0,2,0,1,0,1,0,0,0,1,1,3,2,0,0,1,0
401488047,Niagara Purple Eagles,B. Jones,4704525,,False,8.0,0,0,0,0,0,0,0,0,1,1,2,0,0,0,0,2,0
401488047,Niagara Purple Eagles,TEAM,TOTAL,TOTAL,False,,27,78,24,62,3,16,11,16,20,24,44,12,16,0,25,32,68
401488047,Colgate Raiders,S. Diehl,4900536,,True,22.0,3,5,3,4,0,1,2,2,2,2,4,2,0,0,4,4,8
401488047,Colgate Raiders,M. Schiller,5109205,,True,30.0,1,4,1,4,0,0,4,4,0,3,3,5,2,0,2,4,6
401488047,Colgate Raiders,T. Golembiewski,4900535,,True,41.0,8,15,8,10,0,5,5,6,0,5,5,4,4,2,8,3,21
401488047,Colgate Raiders,J. Paul,4595552,,True,34.0,2,8,0,1,2,7,2,2,0,7,7,3,1,1,3,0,8
401488047,Colgate Raiders,A. Brodie,4595550,,True,32.0,3,6,2,5,1,1,6,7,0,3,3,4,0,0,3,2,13
401488047,Colgate Raiders,C. Okafor,5109208,,False,5.0,1,3,1,3,0,0,0,0,1,0,1,0,0,0,0,1,2
401488047,Colgate Raiders,T. McMillan,4704704,,False,14.0,1,4,1,3,0,1,0,0,0,3,3,0,1,2,3,2,2
401488047,Colgate Raiders,A. Ferguson,5109209,,False,22.0,3,4,3,4,0,0,0,0,1,1,2,1,0,1,1,2,6
401488047,Colgate Raiders,C. Midgette,5109204,,False,4.0,0,1,0,1,0,0,1,2,1,0,1,0,0,0,0,0,1
401488047,Colgate Raiders,M. McMahon,4900534,,False,21.0,3,6,3,4,0,2,5,6,0,3,3,1,0,0,4,0,11
401488047,Colgate Raiders,TEAM,TOTAL,TOTAL,False,,25,56,22,39,3,17,25,29,9,34,43,20,8,6,30,18,78
401488046,Cornell Big Red,S. Parker-Hall,4899288,,True,27.0,1,5,1,5,0,0,1,2,2,1,3,1,1,0,1,1,3
401488046,Cornell Big Red,K. Ingram,4705218,,True,30.0,3,8,3,8,0,0,2,2,3,3,6,4,1,0,6,4,8
401488046,Cornell Big Red,M. Beam,4705216,,True,20.0,2,6,2,3,0,3,0,0,1,0,1,0,0,0,0,1,4
401488046,Cornell Big Red,S. Mulroy,4594970,,True,40.0,5,20,4,11,1,9,2,2,1,5,6,2,2,0,4,4,13
401488046,Cornell Big Red,A. McNicholas,4594968,,True,18.0,1,6,1,6,0,0,3,4,2,2,4,1,6,0,2,4,5
401488046,Cornell Big Red,E. Pape,5108938,,False,29.0,6,15,6,11,0,4,1,2,4,3,7,2,2,0,1,1,13
401488046,Cornell Big Red,A. Hovis,4594969,,False,18.0,1,2,1,2,0,0,0,0,0,4,4,1,0,0,0,0,2
401488046,Cornell Big Red,R. Williams,5108939,,False,7.0,0,0,0,0,0,0,0,0,0,0,0,0,0,0,0,2,0
401488046,Cornell Big Red,S. Hathorn,5108937,,False,0.0,0,0,0,0,0,0,0,0,0,0,0,0,0,0,0,0,0
401488046,Cornell Big Red,V. Garcia-Martinez,4705214,,False,2.0,0,0,0,0,0,0,0,0,0,0,0,0,0,0,0,0,0
401488046,Cornell Big Red,O. Snyder,4595142,,False,9.0,0,1,0,1,0,0,0,0,0,0,0,1,0,0,1,0,0
401488046,Cornell Big Red,TEAM,TOTAL,TOTAL,False,,19,63,18,47,1,16,9,12,16,21,37,12,12,0,15,17,48
401488046,Colgate Raiders,S. Diehl,4900536,,True,16.0,3,5,3,5,0,0,0,0,0,3,3,2,0,0,2,4,6
401488046,Colgate Raiders,M. Schiller,5109205,,True,29.0,2,2,2,2,0,0,0,0,0,2,2,4,1,0,3,4,4
401488046,Colgate Raiders,T. Golembiewski,4900535,,True,36.0,8,17,4,7,4,10,2,2,0,5,5,0,1,0,4,2,22
401488046,Colgate Raiders,J. Paul,4595552,,True,20.0,0,3,0,1,0,2,0,0,1,5,6,1,1,0,1,1,0
401488046,Colgate Raiders,A. Brodie,4595550,,True,30.0,3,7,2,3,1,4,2,2,0,2,2,2,0,0,4,1,9
401488046,Colgate Raiders,C. Okafor,5109208,,False,18.0,2,5,2,5,0,0,0,0,1,1,2,1,0,2,1,1,4
401488046,Colgate Raiders,N. Parks,5109206,,False,5.0,0,0,0,0,0,0,0,0,0,1,1,0,0,0,0,1,0
401488046,Colgate Raiders,A. Ferguson,5109209,,False,8.0,2,2,2,2,0,0,0,0,0,0,0,2,0,0,0,0,4
401488046,Colgate Raiders,C. Midgette,5109204,,False,6.0,0,0,0,0,0,0,3,4,0,3,3,2,0,0,0,2,3
401488046,Colgate Raiders,M. McMahon,4900534,,False,32.0,4,9,4,7,0,2,2,2,1,2,3,3,1,0,5,2,10
401488046,Colgate Raiders,TEAM,TOTAL,TOTAL,False,,24,50,19,32,5,18,9,10,5,28,33,17,4,2,20,18,62
401488045,Buffalo Bulls,K. Salmons,4899039,,True,12.0,1,2,1,2,0,0,2,2,0,3,3,0,0,0,0,3,4
401488045,Buffalo Bulls,E. Mashaire,4898616,,True,40.0,2,8,1,5,1,3,0,0,1,2,3,4,0,0,2,2,5
401488045,Buffalo Bulls,R. Stone,5109809,,True,40.0,5,12,4,11,1,1,2,3,2,2,4,3,2,0,2,1,13
401488045,Buffalo Bulls,Z. Winfield,5109807,,True,40.0,7,17,7,17,0,0,1,1,1,12,13,3,3,0,2,0,15
401488045,Buffalo Bulls,J. Young,4400441,,True,40.0,6,12,4,9,2,3,2,2,0,2,2,1,2,0,3,2,16
401488045,Buffalo Bulls,H. Ogden,5109810,,False,4.0,0,1,0,0,0,1,0,0,0,1,1,0,0,0,1,0,0
401488045,Buffalo Bulls,L. Perkins,4399830,,False,24.0,2,3,2,2,0,1,1,1,0,0,0,1,3,0,2,2,5
401488045,Buffalo Bulls,TEAM,TOTAL,TOTAL,False,,23,55,19,46,4,9,8,9,5,24,29,12,10,0,12,10,58
401488045,Bucknell Bison,I. King,4900533,,True,30.0,3,6,0,1,3,5,0,0,0,7,7,2,1,0,1,2,9
401488045,Bucknell Bison,E. Shaffer,4595535,,True,29.0,4,6,4,6,0,0,1,2,1,6,7,2,0,0,3,1,9
401488045,Bucknell Bison,E. Theodorsson,5109199,,True,29.0,3,9,2,4,1,5,0,0,0,7,7,2,0,0,3,0,7
401488045,Bucknell Bison,B. Matthews,5109200,,True,8.0,1,3,1,2,0,1,1,1,0,1,1,0,0,0,2,1,3
401488045,Bucknell Bison,C. Collins,4900532,,True,30.0,6,9,5,7,1,2,0,0,0,3,3,4,1,0,2,3,13
401488045,Bucknell Bison,G. Sullivan,5109201,,False,11.0,1,2,1,2,0,0,0,0,0,2,2,2,0,1,1,2,2
401488045,Bucknell Bison,K. Reinbeau,4704700,,False,11.0,1,2,1,1,0,1,0,0,1,0,1,0,0,0,1,0,2
401488045,Bucknell Bison,J. Kulesza,4704702,,False,10.0,0,0,0,0,0,0,0,0,0,0,0,0,0,0,0,1,0
401488045,Bucknell Bison,T. Johnson,4595533,,False,29.0,3,10,3,8,0,2,0,0,0,1,1,1,0,0,6,0,6
401488045,Bucknell Bison,C. Dingler,4577540,,False,13.0,0,1,0,1,0,0,0,0,0,0,0,1,0,0,1,1,0
401488045,Bucknell Bison,TEAM,TOTAL,TOTAL,False,,22,48,17,32,5,16,2,3,3,27,30,14,2,1,20,11,51
401488044,Stony Brook Seawolves,S. Pittman,4899575,,True,32.0,3,10,2,7,1,3,2,2,2,1,3,5,1,0,2,5,9
401488044,Stony Brook Seawolves,N. Vargas-Reyes,4704613,,True,28.0,4,8,4,7,0,1,1,2,6,6,12,1,1,0,2,1,9
401488044,Stony Brook Seawolves,G. Gonzalez,4594370,,True,30.0,2,7,1,5,1,2,0,0,2,2,4,2,2,0,3,2,5
401488044,Stony Brook Seawolves,D. Almond,4399612,,True,22.0,3,8,3,8,0,0,1,1,0,2,2,0,0,1,1,1,7
401488044,Stony Brook Seawolves,A. Warren,4399276,,True,37.0,9,23,7,15,2,8,0,0,0,4,4,0,3,0,1,3,20
401488044,Stony Brook Seawolves,N. Toang,4704136,,False,9.0,0,0,0,0,0,0,1,2,1,0,1,1,0,0,0,1,1
401488044,Stony Brook Seawolves,K. Corley,4704615,,False,28.0,1,2,1,2,0,0,0,0,1,3,4,0,2,0,1,3,2
401488044,Stony Brook Seawolves,S. King,4704181,,False,14.0,2,6,1,1,1,5,0,0,0,2,2,1,1,0,0,3,5
401488044,Stony Brook Seawolves,TEAM,TOTAL,TOTAL,False,,24,64,19,45,5,19,5,7,14,21,35,10,10,1,11,19,58
401488044,Bucknell Bison,I. King,4900533,,True,37.0,6,11,5,7,1,4,0,0,1,3,4,1,2,0,0,1,13
401488044,Bucknell Bison,E. Shaffer,4595535,,True,27.0,5,7,5,7,0,0,4,9,4,3,7,2,1,2,3,2,14
401488044,Bucknell Bison,R. Sisselman,4900531,,True,32.0,1,5,1,3,0,2,6,6,0,3,3,1,1,0,3,3,8
401488044,Bucknell Bison,B. Matthews,5109200,,True,18.0,1,5,0,2,1,3,0,0,1,3,4,2,0,0,2,0,3
401488044,Bucknell Bison,C. Collins,4900532,,True,30.0,4,8,3,6,1,2,3,4,0,4,4,4,0,1,2,3,12
401488044,Bucknell Bison,G. Sullivan,5109201,,False,13.0,2,4,2,4,0,0,2,2,0,1,1,0,0,1,0,1,6
401488044,Bucknell Bison,K. Reinbeau,4704700,,False,11.0,0,1,0,0,0,1,0,0,0,0,0,0,0,0,1,1,0
401488044,Bucknell Bison,T. Johnson,4595533,,False,30.0,2,4,1,3,1,1,3,4,0,6,6,3,0,1,2,1,8
401488044,Bucknell Bison,C. Dingler,4577540,,False,2.0,0,0,0,0,0,0,0,0,0,0,0,0,0,0,0,0,0
401488044,Bucknell Bison,TEAM,TOTAL,TOTAL,False,,21,45,17,32,4,13,18,25,7,24,31,13,4,5,14,12,64
401488043,St. Bonaventure Bonnies,I. Lops,4595879,,True,35.0,3,18,1,12,2,6,0,0,0,4,4,0,1,7,1,2,8
401488043,St. Bonaventure Bonnies,K. Dandridge,5107535,,True,28.0,1,6,1,1,0,5,0,0,1,3,4,0,0,0,1,4,2
401488043,St. Bonaventure Bonnies,N. Laccen,5107534,,True,37.0,5,13,4,9,1,4,4,6,0,8,8,5,1,0,4,3,15
401488043,St. Bonaventure Bonnies,M. Dziezgowski,4704131,,True,14.0,1,2,0,1,1,1,0,0,1,0,1,1,1,0,1,0,3
401488043,St. Bonaventure Bonnies,N. Oppenheimer,4281219,,True,28.0,2,14,1,8,1,6,0,0,1,2,3,0,1,0,1,2,5
401488043,St. Bonaventure Bonnies,T. Napper,4898539,,False,20.0,0,2,0,2,0,0,0,0,3,3,6,0,1,0,0,2,0
401488043,St. Bonaventure Bonnies,C. Cody,4594800,,False,5.0,0,1,0,0,0,1,0,0,1,3,4,0,0,0,1,0,0
401488043,St. Bonaventure Bonnies,P. Fields,5107537,,False,3.0,0,1,0,0,0,1,0,0,0,0,0,0,0,0,0,2,0
401488043,St. Bonaventure Bonnies,A. Webb,5107536,,False,14.0,3,8,2,4,1,4,0,0,1,1,2,0,0,1,1,1,7
401488043,St. Bonaventure Bonnies,B. Ware,5107533,,False,3.0,0,0,0,0,0,0,0,0,0,0,0,0,0,0,0,1,0
401488043,St. Bonaventure Bonnies,K. Parker,4594797,,False,13.0,2,2,2,2,0,0,0,0,3,3,6,0,2,0,0,2,4
401488043,St. Bonaventure Bonnies,TEAM,TOTAL,TOTAL,False,,17,67,11,39,6,28,4,6,12,27,39,6,7,8,13,19,44
401488043,Bucknell Bison,I. King,4900533,,True,20.0,1,4,0,1,1,3,0,0,0,2,2,1,0,0,0,0,3
401488043,Bucknell Bison,E. Shaffer,4595535,,True,25.0,4,13,4,13,0,0,5,7,4,4,8,0,0,2,2,2,13
401488043,Bucknell Bison,R. Sisselman,4900531,,True,33.0,6,10,4,5,2,5,4,4,1,4,5,0,0,0,1,1,18
401488043,Bucknell Bison,B. Matthews,5109200,,True,14.0,0,1,0,1,0,0,0,0,0,8,8,1,0,0,3,0,0
401488043,Bucknell Bison,C. Collins,4900532,,True,32.0,4,9,3,7,1,2,2,5,1,3,4,2,0,1,1,2,11
401488043,Bucknell Bison,G. Sullivan,5109201,,False,14.0,0,4,0,4,0,0,0,0,1,5,6,2,0,1,1,0,0
401488043,Bucknell Bison,N. Davis,4704701,,False,1.0,0,0,0,0,0,0,0,0,0,0,0,0,0,1,0,0,0
401488043,Bucknell Bison,K. Reinbeau,4704700,,False,1.0,0,0,0,0,0,0,0,0,0,1,1,0,0,0,0,0,0
401488043,Bucknell Bison,E. Theodorsson,5109199,,False,25.0,4,6,4,5,0,1,2,2,0,4,4,0,1,0,0,0,10
401488043,Bucknell Bison,J. Kulesza,4704702,,False,1.0,0,0,0,0,0,0,0,0,0,0,0,0,0,0,0,0,0
401488043,Bucknell Bison,T. Johnson,4595533,,False,26.0,2,6,2,6,0,0,0,0,0,6,6,2,1,0,3,4,4
401488043,Bucknell Bison,C. Dingler,4577540,,False,8.0,0,0,0,0,0,0,0,2,0,0,0,0,0,0,2,0,0
401488043,Bucknell Bison,TEAM,TOTAL,TOTAL,False,,21,53,17,42,4,11,13,20,8,37,45,8,2,5,13,9,59
401488042,Iona Gaels,K. Athias,4707986,,True,30.0,7,13,7,13,0,0,1,2,2,6,8,4,0,2,4,4,15
401488042,Iona Gaels,J. Gomez,4899840,,True,15.0,0,2,0,0,0,2,0,0,0,2,2,2,1,0,1,1,0
401488042,Iona Gaels,T. Hodge-Carr,4704438,,True,37.0,4,6,3,5,1,1,0,0,0,5,5,0,1,0,0,2,9
401488042,Iona Gaels,K. Mager,4597023,,True,35.0,2,7,1,2,1,5,0,0,0,2,2,1,1,0,1,0,5
401488042,Iona Gaels,J. Camilion,4399121,,True,39.0,4,14,3,9,1,5,2,2,1,5,6,3,2,0,4,4,11
401488042,Iona Gaels,I. Lipinski,4899839,,False,13.0,2,3,2,3,0,0,0,0,0,3,3,2,0,0,1,1,4
401488042,Iona Gaels,M. Cenis,4899841,,False,4.0,0,0,0,0,0,0,0,0,0,0,0,0,0,0,0,1,0
401488042,Iona Gaels,N. Otkhmezuri,4899550,,False,27.0,3,8,1,2,2,6,0,0,0,1,1,1,0,0,1,1,8
401488042,Iona Gaels,TEAM,TOTAL,TOTAL,False,,22,53,17,34,5,19,3,4,6,25,31,13,5,2,13,14,52
401488042,Bucknell Bison,I. King,4900533,,True,35.0,3,8,2,2,1,6,0,0,1,0,1,1,0,0,3,2,7
401488042,Bucknell Bison,E. Shaffer,4595535,,True,33.0,6,13,6,13,0,0,1,2,3,5,8,2,1,1,1,1,13
401488042,Bucknell Bison,R. Sisselman,4900531,,True,36.0,5,9,2,2,3,7,3,4,1,5,6,0,1,1,1,0,16
401488042,Bucknell Bison,B. Matthews,5109200,,True,22.0,2,6,1,4,1,2,0,0,0,1,1,3,1,0,3,1,5
401488042,Bucknell Bison,C. Collins,4900532,,True,37.0,3,9,1,7,2,2,2,3,1,3,4,6,1,0,4,2,10
401488042,Bucknell Bison,G. Sullivan,5109201,,False,7.0,0,1,0,1,0,0,0,0,0,0,0,0,0,0,1,1,0
401488042,Bucknell Bison,K. Reinbeau,4704700,,False,4.0,1,1,1,1,0,0,0,0,0,1,1,0,0,0,0,0,2
401488042,Bucknell Bison,J. Kulesza,4704702,,False,5.0,0,1,0,0,0,1,0,0,0,0,0,1,0,0,0,0,0
401488042,Bucknell Bison,T. Johnson,4595533,,False,13.0,1,2,1,2,0,0,0,0,0,1,1,2,0,0,0,0,2
401488042,Bucknell Bison,C. Dingler,4577540,,False,8.0,0,2,0,2,0,0,0,0,0,2,2,0,0,0,0,0,0
401488042,Bucknell Bison,TEAM,TOTAL,TOTAL,False,,21,52,14,34,7,18,6,9,7,22,29,15,4,2,13,7,55
401488041,Cornell Big Red,S. Parker-Hall,4899288,,True,33.0,8,14,7,11,1,3,0,0,4,3,7,0,0,0,3,4,17
401488041,Cornell Big Red,A. Hovis,4594969,,True,38.0,2,9,2,8,0,1,0,1,4,4,8,2,2,0,3,2,4
401488041,Cornell Big Red,K. Ingram,4705218,,True,28.0,5,11,5,10,0,1,0,0,1,2,3,1,2,0,3,2,10
401488041,Cornell Big Red,S. Mulroy,4594970,,True,44.0,3,18,2,10,1,8,2,2,0,8,8,6,0,0,3,3,9
401488041,Cornell Big Red,A. McNicholas,4594968,,True,43.0,3,14,2,10,1,4,1,2,3,10,13,1,1,0,2,5,8
401488041,Cornell Big Red,E. Pape,5108938,,False,14.0,3,6,3,6,0,0,0,0,2,1,3,0,1,0,1,1,6
401488041,Cornell Big Red,J. Davis,4899286,,False,1.0,0,1,0,1,0,0,0,0,0,0,0,0,0,0,0,1,0
401488041,Cornell Big Red,R. Williams,5108939,,False,15.0,0,2,0,2,0,0,0,0,1,2,3,1,0,0,0,0,0
401488041,Cornell Big Red,V. Knee,5108936,,False,5.0,1,1,1,1,0,0,0,0,0,0,0,0,0,0,0,0,2
401488041,Cornell Big Red,M. Beam,4705216,,False,4.0,1,2,1,2,0,0,0,0,1,0,1,0,0,1,0,0,2
401488041,Cornell Big Red,TEAM,TOTAL,TOTAL,False,,26,78,23,61,3,17,3,5,16,30,46,11,6,1,19,18,58
401488041,Bucknell Bison,K. Reinbeau,4704700,,True,5.0,0,0,0,0,0,0,0,0,0,1,1,0,0,0,1,0,0
401488041,Bucknell Bison,E. Shaffer,4595535,,True,37.0,2,3,2,3,0,0,1,4,2,7,9,2,0,3,0,4,5
401488041,Bucknell Bison,B. Matthews,5109200,,True,16.0,1,5,1,4,0,1,0,0,0,2,2,1,2,0,0,1,2
401488041,Bucknell Bison,C. Collins,4900532,,True,45.0,7,20,5,15,2,5,6,8,1,6,7,5,2,0,5,3,22
401488041,Bucknell Bison,J. Kulesza,4704702,,True,10.0,0,4,0,1,0,3,0,0,0,0,0,0,0,0,0,0,0
401488041,Bucknell Bison,G. Sullivan,5109201,,False,8.0,0,2,0,2,0,0,0,0,0,2,2,0,0,2,2,0,0
401488041,Bucknell Bison,I. King,4900533,,False,34.0,5,8,1,1,4,7,3,3,0,2,2,4,3,0,1,2,17
401488041,Bucknell Bison,E. Theodorsson,5109199,,False,1.0,0,0,0,0,0,0,0,0,0,0,0,0,0,0,1,0,0
401488041,Bucknell Bison,R. Sisselman,4900531,,False,39.0,6,14,3,5,3,9,0,0,0,1,1,3,0,0,0,2,15
401488041,Bucknell Bison,T. Johnson,4595533,,False,18.0,2,4,2,3,0,1,0,0,0,2,2,0,0,0,0,1,4
401488041,Bucknell Bison,C. Dingler,4577540,,False,12.0,0,0,0,0,0,0,0,0,0,1,1,1,0,0,0,0,0
401488041,Bucknell Bison,TEAM,TOTAL,TOTAL,False,,23,60,14,34,9,26,10,15,3,24,27,16,7,5,11,13,65
401488040,Fairleigh Dickinson Knights,C. Wilson,4704968,,True,35.0,4,9,4,7,0,2,8,11,1,6,7,2,1,0,5,2,16
401488040,Fairleigh Dickinson Knights,S. DeAngelo,4595727,,True,34.0,4,11,1,6,3,5,0,0,0,4,4,1,0,1,3,2,11
401488040,Fairleigh Dickinson Knights,D. Forgues,4595763,,True,30.0,4,5,4,4,0,1,0,0,1,3,4,1,0,0,1,2,8
401488040,Fairleigh Dickinson Knights,C. Carbonell,4595723,,True,31.0,4,5,0,1,4,4,0,0,0,2,2,3,3,0,1,2,12
401488040,Fairleigh Dickinson Knights,M. Selvaggi,4399552,,True,35.0,0,1,0,0,0,1,0,0,1,2,3,3,2,0,3,1,0
401488040,Fairleigh Dickinson Knights,M. Elebring,4900587,,False,11.0,2,6,2,4,0,2,0,0,0,1,1,0,0,0,1,1,4
401488040,Fairleigh Dickinson Knights,E. Fajardo,4900585,,False,22.0,4,9,1,6,3,3,0,0,1,1,2,2,0,0,1,2,11
401488040,Fairleigh Dickinson Knights,A. Conklin,4704965,,False,2.0,0,0,0,0,0,0,0,0,0,0,0,0,0,0,0,0,0
401488040,Fairleigh Dickinson Knights,TEAM,TOTAL,TOTAL,False,,22,46,12,28,10,18,8,11,5,20,25,12,6,1,18,12,62
401488040,Bucknell Bison,I. King,4900533,,True,7.0,0,2,0,1,0,1,0,0,0,0,0,0,0,0,0,2,0
401488040,Bucknell Bison,E. Shaffer,4595535,,True,28.0,8,13,8,13,0,0,3,3,5,4,9,0,0,0,2,2,19
401488040,Bucknell Bison,E. Theodorsson,5109199,,True,14.0,1,4,1,2,0,2,0,0,0,2,2,1,0,1,3,4,2
401488040,Bucknell Bison,C. Collins,4900532,,True,35.0,4,12,4,10,0,2,1,2,0,2,2,4,1,0,0,3,9
401488040,Bucknell Bison,C. Dingler,4577540,,True,16.0,0,0,0,0,0,0,0,0,0,0,0,0,1,0,0,1,0
401488040,Bucknell Bison,G. Sullivan,5109201,,False,12.0,1,5,1,5,0,0,1,2,0,1,1,0,0,0,1,1,3
401488040,Bucknell Bison,K. Reinbeau,4704700,,False,26.0,2,4,0,1,2,3,0,0,0,1,1,2,2,1,2,2,6
401488040,Bucknell Bison,R. Sisselman,4900531,,False,5.0,0,0,0,0,0,0,0,0,0,0,0,0,1,0,0,0,0
401488040,Bucknell Bison,B. Matthews,5109200,,False,8.0,1,1,1,1,0,0,0,0,0,0,0,1,0,0,1,0,2
401488040,Bucknell Bison,J. Kulesza,4704702,,False,28.0,1,4,1,3,0,1,2,2,1,1,2,1,0,1,1,2,4
401488040,Bucknell Bison,T. Johnson,4595533,,False,21.0,2,3,2,2,0,1,0,0,0,2,2,1,0,0,4,1,4
401488040,Bucknell Bison,TEAM,TOTAL,TOTAL,False,,20,48,18,38,2,10,7,9,7,19,26,10,5,3,15,18,49
401488039,Virginia Tech Hokies,T. Soule,4398567,,True,26.0,2,8,2,7,0,1,2,4,4,0,4,1,1,0,0,4,6
401488039,Virginia Tech Hokies,E. Kitley,4433309,,True,35.0,10,19,10,19,0,0,2,2,6,7,13,2,1,1,1,1,22
401488039,Virginia Tech Hokies,G. Amoore,4704180,,True,27.0,3,10,1,3,2,7,3,4,0,2,2,4,1,0,2,2,11
401488039,Virginia Tech Hokies,A. Owusu,4433632,,True,28.0,2,9,1,8,1,1,4,4,3,0,3,2,1,0,2,3,9
401488039,Virginia Tech Hokies,C. King,4433089,,True,31.0,3,6,1,1,2,5,0,0,1,4,5,1,2,1,0,0,8
401488039,Virginia Tech Hokies,D. Gregg,4398592,,False,14.0,0,0,0,0,0,0,0,0,1,4,5,0,1,0,0,2,0
401488039,Virginia Tech Hokies,C. Ford,4398571,,False,2.0,0,0,0,0,0,0,0,0,0,0,0,0,0,0,0,0,0
401488039,Virginia Tech Hokies,M. Vejsicky,5107753,,False,2.0,0,1,0,0,0,1,0,0,0,0,0,0,0,0,0,0,0
401488039,Virginia Tech Hokies,C. Dunn,5107752,,False,4.0,1,3,1,1,0,2,0,0,0,0,0,0,0,0,0,0,2
401488039,Virginia Tech Hokies,T. Geiman,4433342,,False,2.0,0,0,0,0,0,0,0,0,0,0,0,0,0,0,0,0,0
401488039,Virginia Tech Hokies,K. Traylor,4398947,,False,29.0,3,7,3,5,0,2,3,4,0,4,4,2,0,0,2,4,9
401488039,Virginia Tech Hokies,TEAM,TOTAL,TOTAL,False,,24,63,19,44,5,19,14,18,16,21,37,12,7,2,7,16,67
401488039,Bucknell Bison,K. Reinbeau,4704700,,True,11.0,0,0,0,0,0,0,0,0,0,2,2,0,0,0,0,1,0
401488039,Bucknell Bison,E. Shaffer,4595535,,True,22.0,2,6,2,6,0,0,0,0,2,3,5,0,0,1,6,5,4
401488039,Bucknell Bison,C. Collins,4900532,,True,35.0,6,13,6,12,0,1,1,2,0,3,3,1,0,0,1,2,13
401488039,Bucknell Bison,J. Kulesza,4704702,,True,14.0,2,3,2,3,0,0,1,2,0,0,0,0,0,0,0,1,5
401488039,Bucknell Bison,T. Johnson,4595533,,True,13.0,1,4,1,4,0,0,0,0,0,1,1,0,0,0,1,2,2
401488039,Bucknell Bison,G. Sullivan,5109201,,False,18.0,1,3,1,3,0,0,0,0,0,4,4,1,0,1,1,4,2
401488039,Bucknell Bison,I. King,4900533,,False,16.0,1,3,1,1,0,2,0,0,0,2,2,0,0,1,1,0,2
401488039,Bucknell Bison,N. Davis,4704701,,False,0.0,0,0,0,0,0,0,0,0,0,0,0,0,0,0,0,0,0
401488039,Bucknell Bison,E. Theodorsson,5109199,,False,29.0,4,9,2,4,2,5,0,0,0,2,2,0,0,0,4,2,10
401488039,Bucknell Bison,R. Sisselman,4900531,,False,10.0,0,1,0,0,0,1,0,0,0,0,0,0,0,0,2,1,0
401488039,Bucknell Bison,B. Matthews,5109200,,False,5.0,0,0,0,0,0,0,1,2,0,0,0,0,0,0,1,0,1
401488039,Bucknell Bison,C. Dingler,4577540,,False,27.0,1,1,1,1,0,0,0,0,1,6,7,1,0,0,2,1,2
401488039,Bucknell Bison,TEAM,TOTAL,TOTAL,False,,18,43,16,34,2,9,3,6,4,24,28,3,0,3,20,19,41
401488038,Holy Cross Crusaders,L. Berger,4900539,,True,35.0,10,16,10,16,0,0,2,2,1,3,4,0,1,1,2,3,22
401488038,Holy Cross Crusaders,J. Allen,4704714,,True,25.0,3,8,3,8,0,0,3,6,2,4,6,5,0,0,2,4,9
401488038,Holy Cross Crusaders,K. Flanagan,5109211,,True,29.0,3,6,3,5,0,1,1,2,0,4,4,4,0,2,0,1,7
401488038,Holy Cross Crusaders,B. Power-Cassidy,4704715,,True,29.0,3,11,1,5,2,6,0,0,0,3,3,1,1,0,1,3,8
401488038,Holy Cross Crusaders,A. Cross,4595975,,True,26.0,0,3,0,2,0,1,0,0,0,3,3,0,1,0,1,1,0
401488038,Holy Cross Crusaders,C. Wright,4703660,,False,11.0,0,0,0,0,0,0,0,2,1,0,1,2,0,0,1,2,0
401488038,Holy Cross Crusaders,M. Donnelly,5109213,,False,3.0,0,0,0,0,0,0,0,0,0,0,0,0,0,0,0,0,0
401488038,Holy Cross Crusaders,S. Foreman,5109212,,False,15.0,1,4,1,4,0,0,5,6,2,1,3,0,2,0,0,1,7
401488038,Holy Cross Crusaders,G. Munt,4900537,,False,3.0,0,1,0,1,0,0,0,0,0,0,0,0,0,1,1,0,0
401488038,Holy Cross Crusaders,C. McCormack,4704716,,False,24.0,1,4,1,2,0,2,2,2,1,3,4,3,1,0,4,3,4
401488038,Holy Cross Crusaders,TEAM,TOTAL,TOTAL,False,,21,53,19,43,2,10,13,20,11,22,33,15,6,4,12,18,57
401488038,Holy Cross Crusaders,L. Berger,4900539,,True,35.0,10,16,10,16,0,0,2,2,1,3,4,0,1,1,2,3,22
401488038,Holy Cross Crusaders,J. Allen,4704714,,True,25.0,3,8,3,8,0,0,3,6,2,4,6,5,0,0,2,4,9
401488038,Holy Cross Crusaders,K. Flanagan,5109211,,True,29.0,3,6,3,5,0,1,1,2,0,4,4,4,0,2,0,1,7
401488038,Holy Cross Crusaders,B. Power-Cassidy,4704715,,True,29.0,3,11,1,5,2,6,0,0,0,3,3,1,1,0,1,3,8
401488038,Holy Cross Crusaders,A. Cross,4595975,,True,26.0,0,3,0,2,0,1,0,0,0,3,3,0,1,0,1,1,0
401488038,Holy Cross Crusaders,C. Wright,4703660,,False,11.0,0,0,0,0,0,0,0,2,1,0,1,2,0,0,1,2,0
401488038,Holy Cross Crusaders,M. Donnelly,5109213,,False,3.0,0,0,0,0,0,0,0,0,0,0,0,0,0,0,0,0,0
401488038,Holy Cross Crusaders,S. Foreman,5109212,,False,15.0,1,4,1,4,0,0,5,6,2,1,3,0,2,0,0,1,7
401488038,Holy Cross Crusaders,G. Munt,4900537,,False,3.0,0,1,0,1,0,0,0,0,0,0,0,0,0,1,1,0,0
401488038,Holy Cross Crusaders,C. McCormack,4704716,,False,24.0,1,4,1,2,0,2,2,2,1,3,4,3,1,0,4,3,4
401488038,Holy Cross Crusaders,TEAM,TOTAL,TOTAL,False,,21,53,19,43,2,10,13,20,11,22,33,15,6,4,12,18,57
401488038,Boston University Terriers,C. Weimar,4704495,,True,29.0,5,7,5,7,0,0,1,1,3,4,7,2,2,1,6,2,11
401488038,Boston University Terriers,M. Durant,4599732,,True,28.0,2,6,2,5,0,1,2,6,2,10,12,2,0,3,2,5,6
401488038,Boston University Terriers,A. Giannaros,4899717,,True,26.0,2,7,1,3,1,4,0,0,1,0,1,1,2,0,4,4,5
401488038,Boston University Terriers,M. Pina,4599731,,True,32.0,3,10,1,5,2,5,3,6,1,2,3,2,0,0,1,3,11
401488038,Boston University Terriers,S. Johnson,4599729,,True,37.0,3,8,2,4,1,4,2,2,0,2,2,0,1,1,2,1,9
401488038,Boston University Terriers,S. Crispe,5109197,,False,9.0,1,3,1,3,0,0,0,0,0,2,2,1,0,0,0,1,2
401488038,Boston University Terriers,L. Davenport,4899718,,False,22.0,2,6,2,5,0,1,2,2,0,1,1,0,2,1,1,0,6
401488038,Boston University Terriers,S. Beneventine,4704699,,False,7.0,0,0,0,0,0,0,0,0,0,1,1,1,0,0,3,1,0
401488038,Boston University Terriers,L. Shean,4599727,,False,10.0,1,2,0,1,1,1,0,0,0,0,0,0,0,0,0,1,3
401488038,Boston University Terriers,TEAM,TOTAL,TOTAL,False,,19,49,14,33,5,16,10,17,10,23,33,9,7,6,20,18,53
401488038,Boston University Terriers,C. Weimar,4704495,,True,29.0,5,7,5,7,0,0,1,1,3,4,7,2,2,1,6,2,11
401488038,Boston University Terriers,M. Durant,4599732,,True,28.0,2,6,2,5,0,1,2,6,2,10,12,2,0,3,2,5,6
401488038,Boston University Terriers,A. Giannaros,4899717,,True,26.0,2,7,1,3,1,4,0,0,1,0,1,1,2,0,4,4,5
401488038,Boston University Terriers,M. Pina,4599731,,True,32.0,3,10,1,5,2,5,3,6,1,2,3,2,0,0,1,3,11
401488038,Boston University Terriers,S. Johnson,4599729,,True,37.0,3,8,2,4,1,4,2,2,0,2,2,0,1,1,2,1,9
401488038,Boston University Terriers,S. Crispe,5109197,,False,9.0,1,3,1,3,0,0,0,0,0,2,2,1,0,0,0,1,2
401488038,Boston University Terriers,L. Davenport,4899718,,False,22.0,2,6,2,5,0,1,2,2,0,1,1,0,2,1,1,0,6
401488038,Boston University Terriers,S. Beneventine,4704699,,False,7.0,0,0,0,0,0,0,0,0,0,1,1,1,0,0,3,1,0
401488038,Boston University Terriers,L. Shean,4599727,,False,10.0,1,2,0,1,1,1,0,0,0,0,0,0,0,0,0,1,3
401488038,Boston University Terriers,TEAM,TOTAL,TOTAL,False,,19,49,14,33,5,16,10,17,10,23,33,9,7,6,20,18,53
401488037,Lehigh Mountain Hawks,L. Fandre,5109220,,True,22.0,1,8,0,3,1,5,0,0,1,2,3,1,0,2,1,1,3
401488037,Lehigh Mountain Hawks,F. Hottinger,4595613,,True,36.0,10,22,8,17,2,5,2,2,4,7,11,0,0,0,1,3,24
401488037,Lehigh Mountain Hawks,E. Stemmer,4900544,,True,28.0,1,7,0,1,1,6,0,0,1,3,4,2,2,0,1,2,3
401488037,Lehigh Mountain Hawks,M. Kramer,4704762,,True,37.0,5,14,3,9,2,5,3,3,0,1,1,4,0,0,3,2,15
401488037,Lehigh Mountain Hawks,A. Harvey,4595612,,True,34.0,4,7,1,1,3,6,0,0,1,4,5,5,1,0,4,1,11
401488037,Lehigh Mountain Hawks,M. O'Brien,4900547,,False,5.0,1,1,0,0,1,1,0,0,0,0,0,2,0,0,0,0,3
401488037,Lehigh Mountain Hawks,K. Van Eps,4900545,,False,8.0,0,0,0,0,0,0,0,0,1,1,2,1,0,0,2,0,0
401488037,Lehigh Mountain Hawks,M. Albrecht,4704763,,False,7.0,0,0,0,0,0,0,0,0,2,1,3,1,0,0,0,1,0
401488037,Lehigh Mountain Hawks,F. Eggenschwiler,4704761,,False,1.0,0,0,0,0,0,0,0,0,0,0,0,0,0,0,1,0,0
401488037,Lehigh Mountain Hawks,J. Behar,4433782,,False,22.0,3,7,3,4,0,3,0,0,0,2,2,0,0,0,0,1,6
401488037,Lehigh Mountain Hawks,TEAM,TOTAL,TOTAL,False,,25,66,15,35,10,31,5,5,11,23,34,16,3,2,13,11,65
401488037,Lehigh Mountain Hawks,L. Fandre,5109220,,True,22.0,1,8,0,3,1,5,0,0,1,2,3,1,0,2,1,1,3
401488037,Lehigh Mountain Hawks,F. Hottinger,4595613,,True,36.0,10,22,8,17,2,5,2,2,4,7,11,0,0,0,1,3,24
401488037,Lehigh Mountain Hawks,E. Stemmer,4900544,,True,28.0,1,7,0,1,1,6,0,0,1,3,4,2,2,0,1,2,3
401488037,Lehigh Mountain Hawks,M. Kramer,4704762,,True,37.0,5,14,3,9,2,5,3,3,0,1,1,4,0,0,3,2,15
401488037,Lehigh Mountain Hawks,A. Harvey,4595612,,True,34.0,4,7,1,1,3,6,0,0,1,4,5,5,1,0,4,1,11
401488037,Lehigh Mountain Hawks,M. O'Brien,4900547,,False,5.0,1,1,0,0,1,1,0,0,0,0,0,2,0,0,0,0,3
401488037,Lehigh Mountain Hawks,K. Van Eps,4900545,,False,8.0,0,0,0,0,0,0,0,0,1,1,2,1,0,0,2,0,0
401488037,Lehigh Mountain Hawks,M. Albrecht,4704763,,False,7.0,0,0,0,0,0,0,0,0,2,1,3,1,0,0,0,1,0
401488037,Lehigh Mountain Hawks,F. Eggenschwiler,4704761,,False,1.0,0,0,0,0,0,0,0,0,0,0,0,0,0,0,1,0,0
401488037,Lehigh Mountain Hawks,J. Behar,4433782,,False,22.0,3,7,3,4,0,3,0,0,0,2,2,0,0,0,0,1,6
401488037,Lehigh Mountain Hawks,TEAM,TOTAL,TOTAL,False,,25,66,15,35,10,31,5,5,11,23,34,16,3,2,13,11,65
401488037,Boston University Terriers,C. Weimar,4704495,,True,33.0,9,15,9,15,0,0,6,6,2,13,15,2,0,4,2,0,24
401488037,Boston University Terriers,L. Davenport,4899718,,True,28.0,2,7,2,6,0,1,2,2,1,2,3,4,0,2,1,2,6
401488037,Boston University Terriers,A. Giannaros,4899717,,True,28.0,4,8,1,3,3,5,0,0,1,3,4,1,0,0,2,1,11
401488037,Boston University Terriers,M. Pina,4599731,,True,25.0,5,9,4,7,1,2,0,0,0,2,2,1,3,0,0,3,11
401488037,Boston University Terriers,S. Johnson,4599729,,True,29.0,5,9,3,6,2,3,0,0,0,2,2,1,2,0,3,3,12
401488037,Boston University Terriers,S. Crispe,5109197,,False,26.0,5,8,4,7,1,1,0,0,0,4,4,0,1,1,2,2,11
401488037,Boston University Terriers,A. Semenova,5109196,,False,3.0,1,1,1,1,0,0,0,0,0,0,0,0,0,0,0,0,2
401488037,Boston University Terriers,S. Beneventine,4704699,,False,20.0,0,0,0,0,0,0,1,2,0,4,4,7,2,0,0,3,1
401488037,Boston University Terriers,K. Mingo,4704698,,False,3.0,0,0,0,0,0,0,0,0,0,0,0,1,2,0,0,0,0
401488037,Boston University Terriers,L. Shean,4599727,,False,5.0,0,1,0,0,0,1,0,0,0,0,0,0,0,0,0,1,0
401488037,Boston University Terriers,TEAM,TOTAL,TOTAL,False,,31,58,24,45,7,13,9,10,5,30,35,17,10,7,10,15,78
401488037,Boston University Terriers,C. Weimar,4704495,,True,33.0,9,15,9,15,0,0,6,6,2,13,15,2,0,4,2,0,24
401488037,Boston University Terriers,L. Davenport,4899718,,True,28.0,2,7,2,6,0,1,2,2,1,2,3,4,0,2,1,2,6
401488037,Boston University Terriers,A. Giannaros,4899717,,True,28.0,4,8,1,3,3,5,0,0,1,3,4,1,0,0,2,1,11
401488037,Boston University Terriers,M. Pina,4599731,,True,25.0,5,9,4,7,1,2,0,0,0,2,2,1,3,0,0,3,11
401488037,Boston University Terriers,S. Johnson,4599729,,True,29.0,5,9,3,6,2,3,0,0,0,2,2,1,2,0,3,3,12
401488037,Boston University Terriers,S. Crispe,5109197,,False,26.0,5,8,4,7,1,1,0,0,0,4,4,0,1,1,2,2,11
401488037,Boston University Terriers,A. Semenova,5109196,,False,3.0,1,1,1,1,0,0,0,0,0,0,0,0,0,0,0,0,2
401488037,Boston University Terriers,S. Beneventine,4704699,,False,20.0,0,0,0,0,0,0,1,2,0,4,4,7,2,0,0,3,1
401488037,Boston University Terriers,K. Mingo,4704698,,False,3.0,0,0,0,0,0,0,0,0,0,0,0,1,2,0,0,0,0
401488037,Boston University Terriers,L. Shean,4599727,,False,5.0,0,1,0,0,0,1,0,0,0,0,0,0,0,0,0,1,0
401488037,Boston University Terriers,TEAM,TOTAL,TOTAL,False,,31,58,24,45,7,13,9,10,5,30,35,17,10,7,10,15,78
401488036,Bucknell Bison,I. King,4900533,,True,32.0,1,5,0,3,1,2,1,2,0,6,6,2,1,0,2,1,4
401488036,Bucknell Bison,E. Shaffer,4595535,,True,35.0,1,11,1,11,0,0,3,4,3,8,11,4,2,3,3,3,5
401488036,Bucknell Bison,E. Theodorsson,5109199,,True,32.0,4,9,3,6,1,3,0,0,0,4,4,1,0,1,2,2,9
401488036,Bucknell Bison,C. Collins,4900532,,True,35.0,7,13,6,12,1,1,5,5,0,4,4,4,0,0,2,3,20
401488036,Bucknell Bison,T. Johnson,4595533,,True,35.0,6,11,6,10,0,1,2,2,0,1,1,2,1,1,2,4,14
401488036,Bucknell Bison,G. Sullivan,5109201,,False,5.0,1,1,1,1,0,0,0,0,1,0,1,0,1,0,1,1,2
401488036,Bucknell Bison,R. Sisselman,4900531,,False,13.0,1,3,0,1,1,2,0,0,1,0,1,0,0,0,0,0,3
401488036,Bucknell Bison,J. Kulesza,4704702,,False,5.0,0,0,0,0,0,0,0,0,0,0,0,1,0,0,1,0,0
401488036,Bucknell Bison,C. Dingler,4577540,,False,8.0,0,1,0,1,0,0,0,0,1,0,1,0,0,1,0,1,0
401488036,Bucknell Bison,TEAM,TOTAL,TOTAL,False,,21,54,17,45,4,9,11,13,8,24,32,14,5,6,13,15,57
401488036,Bucknell Bison,I. King,4900533,,True,32.0,1,5,0,3,1,2,1,2,0,6,6,2,1,0,2,1,4
401488036,Bucknell Bison,E. Shaffer,4595535,,True,35.0,1,11,1,11,0,0,3,4,3,8,11,4,2,3,3,3,5
401488036,Bucknell Bison,E. Theodorsson,5109199,,True,32.0,4,9,3,6,1,3,0,0,0,4,4,1,0,1,2,2,9
401488036,Bucknell Bison,C. Collins,4900532,,True,35.0,7,13,6,12,1,1,5,5,0,4,4,4,0,0,2,3,20
401488036,Bucknell Bison,T. Johnson,4595533,,True,35.0,6,11,6,10,0,1,2,2,0,1,1,2,1,1,2,4,14
401488036,Bucknell Bison,G. Sullivan,5109201,,False,5.0,1,1,1,1,0,0,0,0,1,0,1,0,1,0,1,1,2
401488036,Bucknell Bison,R. Sisselman,4900531,,False,13.0,1,3,0,1,1,2,0,0,1,0,1,0,0,0,0,0,3
401488036,Bucknell Bison,J. Kulesza,4704702,,False,5.0,0,0,0,0,0,0,0,0,0,0,0,1,0,0,1,0,0
401488036,Bucknell Bison,C. Dingler,4577540,,False,8.0,0,1,0,1,0,0,0,0,1,0,1,0,0,1,0,1,0
401488036,Bucknell Bison,TEAM,TOTAL,TOTAL,False,,21,54,17,45,4,9,11,13,8,24,32,14,5,6,13,15,57
401488036,Boston University Terriers,C. Weimar,4704495,,True,33.0,9,12,9,12,0,0,3,4,4,7,11,1,1,1,1,2,21
401488036,Boston University Terriers,M. Durant,4599732,,True,20.0,1,5,1,5,0,0,0,0,1,7,8,4,0,3,3,3,2
401488036,Boston University Terriers,A. Giannaros,4899717,,True,32.0,2,8,0,2,2,6,0,0,0,2,2,1,2,0,4,2,6
401488036,Boston University Terriers,M. Pina,4599731,,True,32.0,2,4,2,3,0,1,0,0,0,2,2,2,3,1,1,1,4
401488036,Boston University Terriers,S. Johnson,4599729,,True,33.0,10,18,8,13,2,5,0,0,0,1,1,4,1,0,0,3,22
401488036,Boston University Terriers,S. Crispe,5109197,,False,8.0,0,2,0,2,0,0,0,0,0,1,1,0,0,0,1,0,0
401488036,Boston University Terriers,L. Davenport,4899718,,False,28.0,3,6,2,5,1,1,4,5,0,7,7,2,0,0,0,1,11
401488036,Boston University Terriers,S. Beneventine,4704699,,False,10.0,0,1,0,1,0,0,0,0,0,0,0,1,0,0,0,1,0
401488036,Boston University Terriers,L. Shean,4599727,,False,4.0,0,0,0,0,0,0,0,0,0,0,0,0,0,0,0,0,0
401488036,Boston University Terriers,TEAM,TOTAL,TOTAL,False,,27,56,22,43,5,13,7,9,5,27,32,15,7,5,10,13,66
401488036,Boston University Terriers,C. Weimar,4704495,,True,33.0,9,12,9,12,0,0,3,4,4,7,11,1,1,1,1,2,21
401488036,Boston University Terriers,M. Durant,4599732,,True,20.0,1,5,1,5,0,0,0,0,1,7,8,4,0,3,3,3,2
401488036,Boston University Terriers,A. Giannaros,4899717,,True,32.0,2,8,0,2,2,6,0,0,0,2,2,1,2,0,4,2,6
401488036,Boston University Terriers,M. Pina,4599731,,True,32.0,2,4,2,3,0,1,0,0,0,2,2,2,3,1,1,1,4
401488036,Boston University Terriers,S. Johnson,4599729,,True,33.0,10,18,8,13,2,5,0,0,0,1,1,4,1,0,0,3,22
401488036,Boston University Terriers,S. Crispe,5109197,,False,8.0,0,2,0,2,0,0,0,0,0,1,1,0,0,0,1,0,0
401488036,Boston University Terriers,L. Davenport,4899718,,False,28.0,3,6,2,5,1,1,4,5,0,7,7,2,0,0,0,1,11
401488036,Boston University Terriers,S. Beneventine,4704699,,False,10.0,0,1,0,1,0,0,0,0,0,0,0,1,0,0,0,1,0
401488036,Boston University Terriers,L. Shean,4599727,,False,4.0,0,0,0,0,0,0,0,0,0,0,0,0,0,0,0,0,0
401488036,Boston University Terriers,TEAM,TOTAL,TOTAL,False,,27,56,22,43,5,13,7,9,5,27,32,15,7,5,10,13,66
401488035,Holy Cross Crusaders,L. Berger,4900539,,True,32.0,4,6,4,6,0,0,0,0,1,6,7,1,1,1,2,5,8
401488035,Holy Cross Crusaders,J. Allen,4704714,,True,27.0,4,9,4,9,0,0,4,6,2,0,2,4,0,1,5,4,12
401488035,Holy Cross Crusaders,K. Flanagan,5109211,,True,29.0,4,5,2,3,2,2,0,1,1,1,2,1,4,1,2,2,10
401488035,Holy Cross Crusaders,B. Power-Cassidy,4704715,,True,30.0,2,6,1,3,1,3,0,0,0,1,1,4,2,0,2,3,5
401488035,Holy Cross Crusaders,A. Cross,4595975,,True,34.0,2,8,0,3,2,5,3,4,1,3,4,2,2,0,1,2,9
401488035,Holy Cross Crusaders,C. Wright,4703660,,False,12.0,0,2,0,2,0,0,0,0,2,2,4,2,0,1,1,1,0
401488035,Holy Cross Crusaders,M. Donnelly,5109213,,False,3.0,0,0,0,0,0,0,0,0,0,1,1,0,0,0,1,0,0
401488035,Holy Cross Crusaders,S. Foreman,5109212,,False,8.0,2,2,2,2,0,0,0,0,0,2,2,0,1,0,1,1,4
401488035,Holy Cross Crusaders,C. McCormack,4704716,,False,25.0,4,11,1,7,3,4,0,0,0,2,2,0,1,0,5,0,11
401488035,Holy Cross Crusaders,TEAM,TOTAL,TOTAL,False,,22,49,14,35,8,14,7,11,7,19,26,14,11,4,21,18,59
401488035,Holy Cross Crusaders,L. Berger,4900539,,True,32.0,4,6,4,6,0,0,0,0,1,6,7,1,1,1,2,5,8
401488035,Holy Cross Crusaders,J. Allen,4704714,,True,27.0,4,9,4,9,0,0,4,6,2,0,2,4,0,1,5,4,12
401488035,Holy Cross Crusaders,K. Flanagan,5109211,,True,29.0,4,5,2,3,2,2,0,1,1,1,2,1,4,1,2,2,10
401488035,Holy Cross Crusaders,B. Power-Cassidy,4704715,,True,30.0,2,6,1,3,1,3,0,0,0,1,1,4,2,0,2,3,5
401488035,Holy Cross Crusaders,A. Cross,4595975,,True,34.0,2,8,0,3,2,5,3,4,1,3,4,2,2,0,1,2,9
401488035,Holy Cross Crusaders,C. Wright,4703660,,False,12.0,0,2,0,2,0,0,0,0,2,2,4,2,0,1,1,1,0
401488035,Holy Cross Crusaders,M. Donnelly,5109213,,False,3.0,0,0,0,0,0,0,0,0,0,1,1,0,0,0,1,0,0
401488035,Holy Cross Crusaders,S. Foreman,5109212,,False,8.0,2,2,2,2,0,0,0,0,0,2,2,0,1,0,1,1,4
401488035,Holy Cross Crusaders,C. McCormack,4704716,,False,25.0,4,11,1,7,3,4,0,0,0,2,2,0,1,0,5,0,11
401488035,Holy Cross Crusaders,TEAM,TOTAL,TOTAL,False,,22,49,14,35,8,14,7,11,7,19,26,14,11,4,21,18,59
401488035,Boston University Terriers,C. Weimar,4704495,,True,38.0,4,5,4,5,0,0,3,7,2,6,8,3,2,2,7,3,11
401488035,Boston University Terriers,M. Durant,4599732,,True,25.0,3,6,3,6,0,0,2,2,2,6,8,0,1,0,2,5,8
401488035,Boston University Terriers,A. Giannaros,4899717,,True,22.0,5,9,2,4,3,5,0,0,1,1,2,2,0,0,2,1,13
401488035,Boston University Terriers,M. Pina,4599731,,True,33.0,2,5,1,3,1,2,8,8,0,1,1,1,2,0,1,1,13
401488035,Boston University Terriers,S. Johnson,4599729,,True,37.0,7,18,6,16,1,2,2,2,1,5,6,1,5,0,6,0,17
401488035,Boston University Terriers,S. Crispe,5109197,,False,14.0,0,2,0,1,0,1,0,0,0,1,1,1,0,0,1,0,0
401488035,Boston University Terriers,L. Davenport,4899718,,False,12.0,1,1,1,1,0,0,0,0,0,0,0,0,1,0,1,1,2
401488035,Boston University Terriers,S. Beneventine,4704699,,False,15.0,0,0,0,0,0,0,0,0,0,0,0,0,3,0,0,1,0
401488035,Boston University Terriers,L. Shean,4599727,,False,4.0,1,1,1,1,0,0,0,0,0,1,1,0,1,0,0,1,2
401488035,Boston University Terriers,TEAM,TOTAL,TOTAL,False,,23,47,18,37,5,10,15,19,6,21,27,8,15,2,20,13,66
401488035,Boston University Terriers,C. Weimar,4704495,,True,38.0,4,5,4,5,0,0,3,7,2,6,8,3,2,2,7,3,11
401488035,Boston University Terriers,M. Durant,4599732,,True,25.0,3,6,3,6,0,0,2,2,2,6,8,0,1,0,2,5,8
401488035,Boston University Terriers,A. Giannaros,4899717,,True,22.0,5,9,2,4,3,5,0,0,1,1,2,2,0,0,2,1,13
401488035,Boston University Terriers,M. Pina,4599731,,True,33.0,2,5,1,3,1,2,8,8,0,1,1,1,2,0,1,1,13
401488035,Boston University Terriers,S. Johnson,4599729,,True,37.0,7,18,6,16,1,2,2,2,1,5,6,1,5,0,6,0,17
401488035,Boston University Terriers,S. Crispe,5109197,,False,14.0,0,2,0,1,0,1,0,0,0,1,1,1,0,0,1,0,0
401488035,Boston University Terriers,L. Davenport,4899718,,False,12.0,1,1,1,1,0,0,0,0,0,0,0,0,1,0,1,1,2
401488035,Boston University Terriers,S. Beneventine,4704699,,False,15.0,0,0,0,0,0,0,0,0,0,0,0,0,3,0,0,1,0
401488035,Boston University Terriers,L. Shean,4599727,,False,4.0,1,1,1,1,0,0,0,0,0,1,1,0,1,0,0,1,2
401488035,Boston University Terriers,TEAM,TOTAL,TOTAL,False,,23,47,18,37,5,10,15,19,6,21,27,8,15,2,20,13,66
401488034,Lafayette Leopards,A. Matthews,4703689,,True,28.0,3,7,3,7,0,0,2,2,2,2,4,0,0,2,1,1,8
401488034,Lafayette Leopards,K. Donahue,5109215,,True,32.0,2,10,1,5,1,5,0,0,1,4,5,1,0,0,0,3,5
401488034,Lafayette Leopards,K. Favours,4900541,,True,35.0,0,6,0,3,0,3,0,0,0,3,3,1,0,1,1,1,0
401488034,Lafayette Leopards,M. Andrews,4704756,,True,34.0,10,21,10,21,0,0,1,2,2,5,7,0,2,0,1,3,21
401488034,Lafayette Leopards,H. Smith,4704553,,True,36.0,3,11,2,7,1,4,3,3,1,3,4,2,2,1,3,2,10
401488034,Lafayette Leopards,S. Ntaconayigize,5109216,,False,35.0,3,9,1,5,2,4,2,2,0,3,3,1,2,0,2,1,10
401488034,Lafayette Leopards,TEAM,TOTAL,TOTAL,False,,21,64,17,48,4,16,8,9,8,22,30,5,6,4,10,11,54
401488034,Lafayette Leopards,A. Matthews,4703689,,True,28.0,3,7,3,7,0,0,2,2,2,2,4,0,0,2,1,1,8
401488034,Lafayette Leopards,K. Donahue,5109215,,True,32.0,2,10,1,5,1,5,0,0,1,4,5,1,0,0,0,3,5
401488034,Lafayette Leopards,K. Favours,4900541,,True,35.0,0,6,0,3,0,3,0,0,0,3,3,1,0,1,1,1,0
401488034,Lafayette Leopards,M. Andrews,4704756,,True,34.0,10,21,10,21,0,0,1,2,2,5,7,0,2,0,1,3,21
401488034,Lafayette Leopards,H. Smith,4704553,,True,36.0,3,11,2,7,1,4,3,3,1,3,4,2,2,1,3,2,10
401488034,Lafayette Leopards,S. Ntaconayigize,5109216,,False,35.0,3,9,1,5,2,4,2,2,0,3,3,1,2,0,2,1,10
401488034,Lafayette Leopards,TEAM,TOTAL,TOTAL,False,,21,64,17,48,4,16,8,9,8,22,30,5,6,4,10,11,54
401488034,Boston University Terriers,M. Durant,4599732,,True,28.0,4,6,4,5,0,1,3,3,1,10,11,6,0,1,1,2,11
401488034,Boston University Terriers,M. Pina,4599731,,True,29.0,7,18,3,3,4,15,1,2,0,4,4,5,0,0,1,2,19
401488034,Boston University Terriers,S. Johnson,4599729,,True,23.0,2,7,1,5,1,2,0,0,0,2,2,4,2,0,2,2,5
401488034,Boston University Terriers,A. Larnard,4599728,,True,5.0,1,1,1,1,0,0,0,0,0,0,0,1,0,0,0,0,2
401488034,Boston University Terriers,L. Shean,4599727,,True,23.0,4,9,0,0,4,9,0,0,2,6,8,0,2,0,0,0,12
401488034,Boston University Terriers,S. Crispe,5109197,,False,15.0,2,6,2,6,0,0,0,0,3,0,3,2,0,1,1,2,4
401488034,Boston University Terriers,A. Semenova,5109196,,False,8.0,1,4,1,4,0,0,0,0,0,1,1,1,0,0,1,2,2
401488034,Boston University Terriers,C. Weimar,4704495,,False,23.0,10,12,10,12,0,0,1,1,6,4,10,0,0,1,1,1,21
401488034,Boston University Terriers,L. Davenport,4899718,,False,7.0,1,2,1,1,0,1,0,0,1,1,2,1,1,0,1,0,2
401488034,Boston University Terriers,A. Giannaros,4899717,,False,18.0,2,5,1,2,1,3,0,0,1,3,4,0,1,0,1,1,5
401488034,Boston University Terriers,S. Beneventine,4704699,,False,17.0,0,1,0,0,0,1,0,0,0,1,1,1,0,2,2,2,0
401488034,Boston University Terriers,K. Mingo,4704698,,False,4.0,0,1,0,0,0,1,0,0,0,0,0,0,0,0,1,0,0
401488034,Boston University Terriers,TEAM,TOTAL,TOTAL,False,,34,72,24,39,10,33,5,6,15,36,51,21,6,5,12,14,83
401488034,Boston University Terriers,M. Durant,4599732,,True,28.0,4,6,4,5,0,1,3,3,1,10,11,6,0,1,1,2,11
401488034,Boston University Terriers,M. Pina,4599731,,True,29.0,7,18,3,3,4,15,1,2,0,4,4,5,0,0,1,2,19
401488034,Boston University Terriers,S. Johnson,4599729,,True,23.0,2,7,1,5,1,2,0,0,0,2,2,4,2,0,2,2,5
401488034,Boston University Terriers,A. Larnard,4599728,,True,5.0,1,1,1,1,0,0,0,0,0,0,0,1,0,0,0,0,2
401488034,Boston University Terriers,L. Shean,4599727,,True,23.0,4,9,0,0,4,9,0,0,2,6,8,0,2,0,0,0,12
401488034,Boston University Terriers,S. Crispe,5109197,,False,15.0,2,6,2,6,0,0,0,0,3,0,3,2,0,1,1,2,4
401488034,Boston University Terriers,A. Semenova,5109196,,False,8.0,1,4,1,4,0,0,0,0,0,1,1,1,0,0,1,2,2
401488034,Boston University Terriers,C. Weimar,4704495,,False,23.0,10,12,10,12,0,0,1,1,6,4,10,0,0,1,1,1,21
401488034,Boston University Terriers,L. Davenport,4899718,,False,7.0,1,2,1,1,0,1,0,0,1,1,2,1,1,0,1,0,2
401488034,Boston University Terriers,A. Giannaros,4899717,,False,18.0,2,5,1,2,1,3,0,0,1,3,4,0,1,0,1,1,5
401488034,Boston University Terriers,S. Beneventine,4704699,,False,17.0,0,1,0,0,0,1,0,0,0,1,1,1,0,2,2,2,0
401488034,Boston University Terriers,K. Mingo,4704698,,False,4.0,0,1,0,0,0,1,0,0,0,0,0,0,0,0,1,0,0
401488034,Boston University Terriers,TEAM,TOTAL,TOTAL,False,,34,72,24,39,10,33,5,6,15,36,51,21,6,5,12,14,83
401488033,Boston University Terriers,C. Weimar,4704495,,True,15.0,2,4,2,4,0,0,2,2,0,4,4,0,2,2,2,2,6
401488033,Boston University Terriers,M. Durant,4599732,,True,28.0,2,4,2,4,0,0,1,2,2,7,9,4,0,1,5,3,5
401488033,Boston University Terriers,A. Giannaros,4899717,,True,27.0,4,7,3,5,1,2,3,3,0,0,0,1,0,1,3,3,12
401488033,Boston University Terriers,M. Pina,4599731,,True,30.0,2,3,2,2,0,1,2,2,0,4,4,3,3,0,3,2,6
401488033,Boston University Terriers,S. Johnson,4599729,,True,30.0,4,11,2,8,2,3,6,8,0,3,3,2,0,0,4,0,16
401488033,Boston University Terriers,S. Crispe,5109197,,False,26.0,4,6,4,6,0,0,2,2,2,1,3,1,2,1,3,4,10
401488033,Boston University Terriers,A. Semenova,5109196,,False,11.0,1,2,1,1,0,1,0,0,1,1,2,1,1,0,1,2,2
401488033,Boston University Terriers,S. Beneventine,4704699,,False,18.0,0,3,0,1,0,2,0,0,0,2,2,0,1,0,0,1,0
401488033,Boston University Terriers,L. Shean,4599727,,False,15.0,0,2,0,0,0,2,2,2,0,1,1,0,0,0,1,0,2
401488033,Boston University Terriers,TEAM,TOTAL,TOTAL,False,,19,42,16,31,3,11,18,21,6,26,32,12,9,5,23,17,59
401488033,Boston University Terriers,C. Weimar,4704495,,True,15.0,2,4,2,4,0,0,2,2,0,4,4,0,2,2,2,2,6
401488033,Boston University Terriers,M. Durant,4599732,,True,28.0,2,4,2,4,0,0,1,2,2,7,9,4,0,1,5,3,5
401488033,Boston University Terriers,A. Giannaros,4899717,,True,27.0,4,7,3,5,1,2,3,3,0,0,0,1,0,1,3,3,12
401488033,Boston University Terriers,M. Pina,4599731,,True,30.0,2,3,2,2,0,1,2,2,0,4,4,3,3,0,3,2,6
401488033,Boston University Terriers,S. Johnson,4599729,,True,30.0,4,11,2,8,2,3,6,8,0,3,3,2,0,0,4,0,16
401488033,Boston University Terriers,S. Crispe,5109197,,False,26.0,4,6,4,6,0,0,2,2,2,1,3,1,2,1,3,4,10
401488033,Boston University Terriers,A. Semenova,5109196,,False,11.0,1,2,1,1,0,1,0,0,1,1,2,1,1,0,1,2,2
401488033,Boston University Terriers,S. Beneventine,4704699,,False,18.0,0,3,0,1,0,2,0,0,0,2,2,0,1,0,0,1,0
401488033,Boston University Terriers,L. Shean,4599727,,False,15.0,0,2,0,0,0,2,2,2,0,1,1,0,0,0,1,0,2
401488033,Boston University Terriers,TEAM,TOTAL,TOTAL,False,,19,42,16,31,3,11,18,21,6,26,32,12,9,5,23,17,59
401488033,American University Eagles,E. Johns,4704688,,True,15.0,1,3,1,1,0,2,4,4,2,1,3,0,3,0,2,5,6
401488033,American University Eagles,L. Stack,4595455,,True,25.0,1,4,1,4,0,0,0,0,1,1,2,0,1,0,5,3,2
401488033,American University Eagles,K. Henning,4704686,,True,21.0,1,7,1,7,0,0,0,0,1,0,1,2,0,0,3,3,2
401488033,American University Eagles,I. Bales,4704685,,True,18.0,0,3,0,3,0,0,0,0,0,2,2,0,0,0,3,1,0
401488033,American University Eagles,S. Stetson,4595453,,True,24.0,0,5,0,4,0,1,2,2,2,0,2,1,1,0,1,0,2
401488033,American University Eagles,M. Lavin,5109188,,False,29.0,3,9,3,6,0,3,0,0,1,5,6,1,1,0,0,1,6
401488033,American University Eagles,M. Lee,4704592,,False,2.0,0,0,0,0,0,0,0,0,0,0,0,0,0,0,0,0,0
401488033,American University Eagles,L. Nogues,5109187,,False,20.0,4,8,3,4,1,4,0,2,0,1,1,2,0,0,4,3,9
401488033,American University Eagles,A. Rescifina,5109186,,False,13.0,1,2,0,0,1,2,0,0,1,2,3,0,0,0,3,3,3
401488033,American University Eagles,B. Garbee,4899710,,False,9.0,1,2,1,1,0,1,0,0,0,0,0,0,0,0,1,2,2
401488033,American University Eagles,A. LeMaster,4703737,,False,24.0,2,6,0,0,2,6,2,3,1,2,3,0,1,0,3,3,8
401488033,American University Eagles,TEAM,TOTAL,TOTAL,False,,14,49,10,30,4,19,8,11,10,16,26,6,7,0,27,24,40
401488033,American University Eagles,E. Johns,4704688,,True,15.0,1,3,1,1,0,2,4,4,2,1,3,0,3,0,2,5,6
401488033,American University Eagles,L. Stack,4595455,,True,25.0,1,4,1,4,0,0,0,0,1,1,2,0,1,0,5,3,2
401488033,American University Eagles,K. Henning,4704686,,True,21.0,1,7,1,7,0,0,0,0,1,0,1,2,0,0,3,3,2
401488033,American University Eagles,I. Bales,4704685,,True,18.0,0,3,0,3,0,0,0,0,0,2,2,0,0,0,3,1,0
401488033,American University Eagles,S. Stetson,4595453,,True,24.0,0,5,0,4,0,1,2,2,2,0,2,1,1,0,1,0,2
401488033,American University Eagles,M. Lavin,5109188,,False,29.0,3,9,3,6,0,3,0,0,1,5,6,1,1,0,0,1,6
401488033,American University Eagles,M. Lee,4704592,,False,2.0,0,0,0,0,0,0,0,0,0,0,0,0,0,0,0,0,0
401488033,American University Eagles,L. Nogues,5109187,,False,20.0,4,8,3,4,1,4,0,2,0,1,1,2,0,0,4,3,9
401488033,American University Eagles,A. Rescifina,5109186,,False,13.0,1,2,0,0,1,2,0,0,1,2,3,0,0,0,3,3,3
401488033,American University Eagles,B. Garbee,4899710,,False,9.0,1,2,1,1,0,1,0,0,0,0,0,0,0,0,1,2,2
401488033,American University Eagles,A. LeMaster,4703737,,False,24.0,2,6,0,0,2,6,2,3,1,2,3,0,1,0,3,3,8
401488033,American University Eagles,TEAM,TOTAL,TOTAL,False,,14,49,10,30,4,19,8,11,10,16,26,6,7,0,27,24,40
401488032,Loyola Maryland Greyhounds,L. Therien,4900552,,True,24.0,6,11,6,11,0,0,2,2,1,5,6,3,3,1,2,3,14
401488032,Loyola Maryland Greyhounds,K. Ratigan,5109222,,True,25.0,1,5,0,3,1,2,0,0,0,4,4,3,0,0,3,2,3
401488032,Loyola Maryland Greyhounds,B. Rozzi,4596306,,True,12.0,1,3,1,3,0,0,0,0,1,1,2,0,0,0,0,3,2
401488032,Loyola Maryland Greyhounds,T. Dixon,4400209,,True,28.0,5,17,4,13,1,4,1,1,0,2,2,1,1,0,3,2,12
401488032,Loyola Maryland Greyhounds,D. Newman,4399474,,True,21.0,5,11,5,11,0,0,3,4,1,1,2,0,0,0,1,1,13
401488032,Loyola Maryland Greyhounds,M. Espinal,5109228,,False,20.0,1,1,1,1,0,0,0,0,1,0,1,0,1,0,0,1,2
401488032,Loyola Maryland Greyhounds,C. Orza,5109227,,False,6.0,0,2,0,1,0,1,0,0,0,0,0,0,0,0,1,0,0
401488032,Loyola Maryland Greyhounds,C. Garcia,5109224,,False,20.0,0,4,0,4,0,0,0,0,2,0,2,2,1,0,1,2,0
401488032,Loyola Maryland Greyhounds,M. Van-Otoo,5109223,,False,15.0,1,3,1,2,0,1,0,0,0,2,2,1,1,0,1,1,2
401488032,Loyola Maryland Greyhounds,L. Salmeron,4900549,,False,26.0,4,10,3,6,1,4,0,0,0,1,1,1,0,0,1,1,9
401488032,Loyola Maryland Greyhounds,C. Tanedo,4704774,,False,3.0,0,0,0,0,0,0,0,0,0,0,0,0,0,0,0,0,0
401488032,Loyola Maryland Greyhounds,TEAM,TOTAL,TOTAL,False,,24,67,21,55,3,12,6,7,6,16,22,11,7,1,15,16,57
401488032,Loyola Maryland Greyhounds,L. Therien,4900552,,True,24.0,6,11,6,11,0,0,2,2,1,5,6,3,3,1,2,3,14
401488032,Loyola Maryland Greyhounds,K. Ratigan,5109222,,True,25.0,1,5,0,3,1,2,0,0,0,4,4,3,0,0,3,2,3
401488032,Loyola Maryland Greyhounds,B. Rozzi,4596306,,True,12.0,1,3,1,3,0,0,0,0,1,1,2,0,0,0,0,3,2
401488032,Loyola Maryland Greyhounds,T. Dixon,4400209,,True,28.0,5,17,4,13,1,4,1,1,0,2,2,1,1,0,3,2,12
401488032,Loyola Maryland Greyhounds,D. Newman,4399474,,True,21.0,5,11,5,11,0,0,3,4,1,1,2,0,0,0,1,1,13
401488032,Loyola Maryland Greyhounds,M. Espinal,5109228,,False,20.0,1,1,1,1,0,0,0,0,1,0,1,0,1,0,0,1,2
401488032,Loyola Maryland Greyhounds,C. Orza,5109227,,False,6.0,0,2,0,1,0,1,0,0,0,0,0,0,0,0,1,0,0
401488032,Loyola Maryland Greyhounds,C. Garcia,5109224,,False,20.0,0,4,0,4,0,0,0,0,2,0,2,2,1,0,1,2,0
401488032,Loyola Maryland Greyhounds,M. Van-Otoo,5109223,,False,15.0,1,3,1,2,0,1,0,0,0,2,2,1,1,0,1,1,2
401488032,Loyola Maryland Greyhounds,L. Salmeron,4900549,,False,26.0,4,10,3,6,1,4,0,0,0,1,1,1,0,0,1,1,9
401488032,Loyola Maryland Greyhounds,C. Tanedo,4704774,,False,3.0,0,0,0,0,0,0,0,0,0,0,0,0,0,0,0,0,0
401488032,Loyola Maryland Greyhounds,TEAM,TOTAL,TOTAL,False,,24,67,21,55,3,12,6,7,6,16,22,11,7,1,15,16,57
401488032,Boston University Terriers,C. Weimar,4704495,,True,24.0,6,8,6,8,0,0,4,4,2,7,9,3,0,0,1,3,16
401488032,Boston University Terriers,M. Durant,4599732,,True,18.0,2,3,2,3,0,0,2,2,0,2,2,3,0,1,3,3,6
401488032,Boston University Terriers,A. Giannaros,4899717,,True,23.0,7,10,3,3,4,7,0,0,0,3,3,2,0,0,2,2,18
401488032,Boston University Terriers,M. Pina,4599731,,True,23.0,6,11,2,2,4,9,3,3,0,4,4,3,3,0,0,2,19
401488032,Boston University Terriers,S. Johnson,4599729,,True,28.0,8,12,4,5,4,7,0,0,0,2,2,3,0,1,0,0,20
401488032,Boston University Terriers,S. Crispe,5109197,,False,26.0,3,6,3,5,0,1,2,2,1,3,4,4,1,0,4,1,8
401488032,Boston University Terriers,A. Semenova,5109196,,False,7.0,0,0,0,0,0,0,0,0,0,0,0,0,0,0,0,1,0
401488032,Boston University Terriers,S. Beneventine,4704699,,False,19.0,0,2,0,1,0,1,0,0,0,1,1,3,0,0,1,0,0
401488032,Boston University Terriers,K. Mingo,4704698,,False,11.0,1,2,0,0,1,2,0,0,0,3,3,0,0,1,1,2,3
401488032,Boston University Terriers,A. Larnard,4599728,,False,6.0,1,2,0,0,1,2,0,0,0,1,1,1,0,0,0,0,3
401488032,Boston University Terriers,L. Shean,4599727,,False,15.0,2,4,0,0,2,4,1,2,0,2,2,1,0,1,1,0,7
401488032,Boston University Terriers,TEAM,TOTAL,TOTAL,False,,36,60,20,27,16,33,12,13,3,28,31,23,4,4,13,14,100
401488032,Boston University Terriers,C. Weimar,4704495,,True,24.0,6,8,6,8,0,0,4,4,2,7,9,3,0,0,1,3,16
401488032,Boston University Terriers,M. Durant,4599732,,True,18.0,2,3,2,3,0,0,2,2,0,2,2,3,0,1,3,3,6
401488032,Boston University Terriers,A. Giannaros,4899717,,True,23.0,7,10,3,3,4,7,0,0,0,3,3,2,0,0,2,2,18
401488032,Boston University Terriers,M. Pina,4599731,,True,23.0,6,11,2,2,4,9,3,3,0,4,4,3,3,0,0,2,19
401488032,Boston University Terriers,S. Johnson,4599729,,True,28.0,8,12,4,5,4,7,0,0,0,2,2,3,0,1,0,0,20
401488032,Boston University Terriers,S. Crispe,5109197,,False,26.0,3,6,3,5,0,1,2,2,1,3,4,4,1,0,4,1,8
401488032,Boston University Terriers,A. Semenova,5109196,,False,7.0,0,0,0,0,0,0,0,0,0,0,0,0,0,0,0,1,0
401488032,Boston University Terriers,S. Beneventine,4704699,,False,19.0,0,2,0,1,0,1,0,0,0,1,1,3,0,0,1,0,0
401488032,Boston University Terriers,K. Mingo,4704698,,False,11.0,1,2,0,0,1,2,0,0,0,3,3,0,0,1,1,2,3
401488032,Boston University Terriers,A. Larnard,4599728,,False,6.0,1,2,0,0,1,2,0,0,0,1,1,1,0,0,0,0,3
401488032,Boston University Terriers,L. Shean,4599727,,False,15.0,2,4,0,0,2,4,1,2,0,2,2,1,0,1,1,0,7
401488032,Boston University Terriers,TEAM,TOTAL,TOTAL,False,,36,60,20,27,16,33,12,13,3,28,31,23,4,4,13,14,100
401488031,Lehigh Mountain Hawks,L. Fandre,5109220,,True,18.0,1,3,0,0,1,3,3,4,0,0,0,1,2,0,0,4,6
401488031,Lehigh Mountain Hawks,F. Hottinger,4595613,,True,34.0,5,14,5,10,0,4,4,6,2,3,5,2,3,0,3,2,14
401488031,Lehigh Mountain Hawks,M. Kramer,4704762,,True,38.0,8,13,5,5,3,8,0,0,0,3,3,4,0,0,3,0,19
401488031,Lehigh Mountain Hawks,A. Harvey,4595612,,True,27.0,1,5,0,3,1,2,0,0,1,1,2,4,0,0,4,2,3
401488031,Lehigh Mountain Hawks,J. Behar,4433782,,True,4.0,0,2,0,0,0,2,0,0,0,1,1,0,0,0,1,3,0
401488031,Lehigh Mountain Hawks,M. O'Brien,4900547,,False,24.0,4,9,2,5,2,4,0,0,0,3,3,0,0,1,2,2,10
401488031,Lehigh Mountain Hawks,M. Brown,4433751,,False,4.0,1,1,1,1,0,0,0,0,1,0,1,0,0,0,0,0,2
401488031,Lehigh Mountain Hawks,K. Hurt,5109219,,False,1.0,1,1,0,0,1,1,0,0,0,0,0,0,0,0,0,0,3
401488031,Lehigh Mountain Hawks,K. Van Eps,4900545,,False,12.0,0,0,0,0,0,0,0,0,0,1,1,1,0,0,2,0,0
401488031,Lehigh Mountain Hawks,E. Stemmer,4900544,,False,19.0,2,5,0,1,2,4,2,2,1,2,3,2,0,0,0,5,8
401488031,Lehigh Mountain Hawks,M. Albrecht,4704763,,False,19.0,2,5,2,4,0,1,0,0,0,2,2,2,0,0,0,3,4
401488031,Lehigh Mountain Hawks,TEAM,TOTAL,TOTAL,False,,25,58,15,29,10,29,9,12,7,17,24,16,5,1,17,21,69
401488031,Lehigh Mountain Hawks,L. Fandre,5109220,,True,18.0,1,3,0,0,1,3,3,4,0,0,0,1,2,0,0,4,6
401488031,Lehigh Mountain Hawks,F. Hottinger,4595613,,True,34.0,5,14,5,10,0,4,4,6,2,3,5,2,3,0,3,2,14
401488031,Lehigh Mountain Hawks,M. Kramer,4704762,,True,38.0,8,13,5,5,3,8,0,0,0,3,3,4,0,0,3,0,19
401488031,Lehigh Mountain Hawks,A. Harvey,4595612,,True,27.0,1,5,0,3,1,2,0,0,1,1,2,4,0,0,4,2,3
401488031,Lehigh Mountain Hawks,J. Behar,4433782,,True,4.0,0,2,0,0,0,2,0,0,0,1,1,0,0,0,1,3,0
401488031,Lehigh Mountain Hawks,M. O'Brien,4900547,,False,24.0,4,9,2,5,2,4,0,0,0,3,3,0,0,1,2,2,10
401488031,Lehigh Mountain Hawks,M. Brown,4433751,,False,4.0,1,1,1,1,0,0,0,0,1,0,1,0,0,0,0,0,2
401488031,Lehigh Mountain Hawks,K. Hurt,5109219,,False,1.0,1,1,0,0,1,1,0,0,0,0,0,0,0,0,0,0,3
401488031,Lehigh Mountain Hawks,K. Van Eps,4900545,,False,12.0,0,0,0,0,0,0,0,0,0,1,1,1,0,0,2,0,0
401488031,Lehigh Mountain Hawks,E. Stemmer,4900544,,False,19.0,2,5,0,1,2,4,2,2,1,2,3,2,0,0,0,5,8
401488031,Lehigh Mountain Hawks,M. Albrecht,4704763,,False,19.0,2,5,2,4,0,1,0,0,0,2,2,2,0,0,0,3,4
401488031,Lehigh Mountain Hawks,TEAM,TOTAL,TOTAL,False,,25,58,15,29,10,29,9,12,7,17,24,16,5,1,17,21,69
401488031,Boston University Terriers,C. Weimar,4704495,,True,17.0,4,9,4,9,0,0,4,4,5,4,9,0,0,1,0,1,12
401488031,Boston University Terriers,M. Durant,4599732,,True,19.0,4,6,4,6,0,0,2,2,1,1,2,1,0,0,3,5,10
401488031,Boston University Terriers,A. Giannaros,4899717,,True,28.0,4,9,4,6,0,3,0,0,1,0,1,2,2,1,4,3,8
401488031,Boston University Terriers,M. Pina,4599731,,True,28.0,3,8,3,6,0,2,2,2,1,3,4,0,1,1,0,2,8
401488031,Boston University Terriers,S. Johnson,4599729,,True,25.0,8,15,6,10,2,5,4,6,4,0,4,1,2,0,2,2,22
401488031,Boston University Terriers,S. Crispe,5109197,,False,29.0,4,7,3,5,1,2,2,2,2,6,8,3,0,0,3,1,11
401488031,Boston University Terriers,L. Davenport,4899718,,False,28.0,2,6,1,4,1,2,5,5,1,7,8,2,1,1,2,2,10
401488031,Boston University Terriers,S. Beneventine,4704699,,False,23.0,0,0,0,0,0,0,1,2,2,2,4,4,1,0,2,1,1
401488031,Boston University Terriers,L. Shean,4599727,,False,3.0,0,1,0,1,0,0,0,0,0,1,1,0,0,0,0,0,0
401488031,Boston University Terriers,TEAM,TOTAL,TOTAL,False,,29,61,25,47,4,14,20,23,17,28,45,13,7,4,17,17,82
401488031,Boston University Terriers,C. Weimar,4704495,,True,17.0,4,9,4,9,0,0,4,4,5,4,9,0,0,1,0,1,12
401488031,Boston University Terriers,M. Durant,4599732,,True,19.0,4,6,4,6,0,0,2,2,1,1,2,1,0,0,3,5,10
401488031,Boston University Terriers,A. Giannaros,4899717,,True,28.0,4,9,4,6,0,3,0,0,1,0,1,2,2,1,4,3,8
401488031,Boston University Terriers,M. Pina,4599731,,True,28.0,3,8,3,6,0,2,2,2,1,3,4,0,1,1,0,2,8
401488031,Boston University Terriers,S. Johnson,4599729,,True,25.0,8,15,6,10,2,5,4,6,4,0,4,1,2,0,2,2,22
401488031,Boston University Terriers,S. Crispe,5109197,,False,29.0,4,7,3,5,1,2,2,2,2,6,8,3,0,0,3,1,11
401488031,Boston University Terriers,L. Davenport,4899718,,False,28.0,2,6,1,4,1,2,5,5,1,7,8,2,1,1,2,2,10
401488031,Boston University Terriers,S. Beneventine,4704699,,False,23.0,0,0,0,0,0,0,1,2,2,2,4,4,1,0,2,1,1
401488031,Boston University Terriers,L. Shean,4599727,,False,3.0,0,1,0,1,0,0,0,0,0,1,1,0,0,0,0,0,0
401488031,Boston University Terriers,TEAM,TOTAL,TOTAL,False,,29,61,25,47,4,14,20,23,17,28,45,13,7,4,17,17,82
401488030,Colgate Raiders,T. McMillan,4704704,,True,21.0,5,9,5,9,0,0,0,0,3,2,5,0,0,0,2,3,10
401488030,Colgate Raiders,C. Midgette,5109204,,True,11.0,1,3,1,3,0,0,2,2,0,0,0,0,0,0,1,4,4
401488030,Colgate Raiders,M. Schiller,5109205,,True,28.0,1,6,1,6,0,0,0,0,0,1,1,5,0,0,0,1,2
401488030,Colgate Raiders,T. Golembiewski,4900535,,True,23.0,1,9,1,6,0,3,0,0,0,0,0,1,5,1,1,1,2
401488030,Colgate Raiders,A. Brodie,4595550,,True,25.0,2,6,2,4,0,2,0,0,0,1,1,3,1,0,1,1,4
401488030,Colgate Raiders,C. Okafor,5109208,,False,2.0,0,0,0,0,0,0,0,0,0,0,0,0,0,0,0,2,0
401488030,Colgate Raiders,N. Parks,5109206,,False,6.0,0,0,0,0,0,0,0,0,2,1,3,0,0,0,0,4,0
401488030,Colgate Raiders,S. Diehl,4900536,,False,17.0,1,2,1,2,0,0,0,0,0,2,2,2,0,0,2,2,2
401488030,Colgate Raiders,L. Blackmore,4704706,,False,19.0,4,7,2,5,2,2,0,0,1,5,6,1,0,0,0,1,10
401488030,Colgate Raiders,A. Ferguson,5109209,,False,1.0,0,0,0,0,0,0,0,0,0,0,0,0,0,0,0,1,0
401488030,Colgate Raiders,L. Cook,5109207,,False,12.0,1,4,0,2,1,2,0,0,1,0,1,2,2,0,1,0,3
401488030,Colgate Raiders,M. McMahon,4900534,,False,22.0,1,4,1,4,0,0,5,6,0,0,0,0,0,0,3,2,7
401488030,Colgate Raiders,J. Paul,4595552,,False,13.0,0,2,0,1,0,1,0,0,0,0,0,1,0,1,0,1,0
401488030,Colgate Raiders,TEAM,TOTAL,TOTAL,False,,17,52,14,42,3,10,7,8,10,14,24,15,8,2,14,23,44
401488030,Colgate Raiders,T. McMillan,4704704,,True,21.0,5,9,5,9,0,0,0,0,3,2,5,0,0,0,2,3,10
401488030,Colgate Raiders,C. Midgette,5109204,,True,11.0,1,3,1,3,0,0,2,2,0,0,0,0,0,0,1,4,4
401488030,Colgate Raiders,M. Schiller,5109205,,True,28.0,1,6,1,6,0,0,0,0,0,1,1,5,0,0,0,1,2
401488030,Colgate Raiders,T. Golembiewski,4900535,,True,23.0,1,9,1,6,0,3,0,0,0,0,0,1,5,1,1,1,2
401488030,Colgate Raiders,A. Brodie,4595550,,True,25.0,2,6,2,4,0,2,0,0,0,1,1,3,1,0,1,1,4
401488030,Colgate Raiders,C. Okafor,5109208,,False,2.0,0,0,0,0,0,0,0,0,0,0,0,0,0,0,0,2,0
401488030,Colgate Raiders,N. Parks,5109206,,False,6.0,0,0,0,0,0,0,0,0,2,1,3,0,0,0,0,4,0
401488030,Colgate Raiders,S. Diehl,4900536,,False,17.0,1,2,1,2,0,0,0,0,0,2,2,2,0,0,2,2,2
401488030,Colgate Raiders,L. Blackmore,4704706,,False,19.0,4,7,2,5,2,2,0,0,1,5,6,1,0,0,0,1,10
401488030,Colgate Raiders,A. Ferguson,5109209,,False,1.0,0,0,0,0,0,0,0,0,0,0,0,0,0,0,0,1,0
401488030,Colgate Raiders,L. Cook,5109207,,False,12.0,1,4,0,2,1,2,0,0,1,0,1,2,2,0,1,0,3
401488030,Colgate Raiders,M. McMahon,4900534,,False,22.0,1,4,1,4,0,0,5,6,0,0,0,0,0,0,3,2,7
401488030,Colgate Raiders,J. Paul,4595552,,False,13.0,0,2,0,1,0,1,0,0,0,0,0,1,0,1,0,1,0
401488030,Colgate Raiders,TEAM,TOTAL,TOTAL,False,,17,52,14,42,3,10,7,8,10,14,24,15,8,2,14,23,44
401488030,Boston University Terriers,C. Weimar,4704495,,True,37.0,8,11,8,11,0,0,7,12,4,7,11,2,2,2,7,2,23
401488030,Boston University Terriers,M. Durant,4599732,,True,18.0,4,5,4,5,0,0,0,0,3,4,7,2,0,1,5,4,8
401488030,Boston University Terriers,A. Giannaros,4899717,,True,26.0,1,6,0,3,1,3,0,0,0,4,4,1,0,1,1,1,3
401488030,Boston University Terriers,M. Pina,4599731,,True,25.0,3,7,2,2,1,5,0,2,1,1,2,0,1,0,0,1,7
401488030,Boston University Terriers,S. Johnson,4599729,,True,30.0,2,8,2,6,0,2,1,2,1,2,3,5,1,0,2,1,5
401488030,Boston University Terriers,S. Crispe,5109197,,False,16.0,1,1,1,1,0,0,2,4,1,2,3,2,0,0,2,2,4
401488030,Boston University Terriers,A. Semenova,5109196,,False,4.0,0,0,0,0,0,0,0,0,0,1,1,0,0,0,0,0,0
401488030,Boston University Terriers,L. Davenport,4899718,,False,13.0,2,5,2,2,0,3,2,2,0,3,3,1,0,1,2,2,6
401488030,Boston University Terriers,S. Beneventine,4704699,,False,18.0,1,3,1,3,0,0,0,0,1,1,2,2,0,0,0,1,2
401488030,Boston University Terriers,K. Mingo,4704698,,False,4.0,0,0,0,0,0,0,0,0,0,1,1,0,0,0,0,0,0
401488030,Boston University Terriers,L. Shean,4599727,,False,9.0,0,0,0,0,0,0,0,2,0,0,0,0,0,0,0,0,0
401488030,Boston University Terriers,TEAM,TOTAL,TOTAL,False,,22,46,20,33,2,13,12,24,16,26,42,15,4,5,19,14,58
401488030,Boston University Terriers,C. Weimar,4704495,,True,37.0,8,11,8,11,0,0,7,12,4,7,11,2,2,2,7,2,23
401488030,Boston University Terriers,M. Durant,4599732,,True,18.0,4,5,4,5,0,0,0,0,3,4,7,2,0,1,5,4,8
401488030,Boston University Terriers,A. Giannaros,4899717,,True,26.0,1,6,0,3,1,3,0,0,0,4,4,1,0,1,1,1,3
401488030,Boston University Terriers,M. Pina,4599731,,True,25.0,3,7,2,2,1,5,0,2,1,1,2,0,1,0,0,1,7
401488030,Boston University Terriers,S. Johnson,4599729,,True,30.0,2,8,2,6,0,2,1,2,1,2,3,5,1,0,2,1,5
401488030,Boston University Terriers,S. Crispe,5109197,,False,16.0,1,1,1,1,0,0,2,4,1,2,3,2,0,0,2,2,4
401488030,Boston University Terriers,A. Semenova,5109196,,False,4.0,0,0,0,0,0,0,0,0,0,1,1,0,0,0,0,0,0
401488030,Boston University Terriers,L. Davenport,4899718,,False,13.0,2,5,2,2,0,3,2,2,0,3,3,1,0,1,2,2,6
401488030,Boston University Terriers,S. Beneventine,4704699,,False,18.0,1,3,1,3,0,0,0,0,1,1,2,2,0,0,0,1,2
401488030,Boston University Terriers,K. Mingo,4704698,,False,4.0,0,0,0,0,0,0,0,0,0,1,1,0,0,0,0,0,0
401488030,Boston University Terriers,L. Shean,4599727,,False,9.0,0,0,0,0,0,0,0,2,0,0,0,0,0,0,0,0,0
401488030,Boston University Terriers,TEAM,TOTAL,TOTAL,False,,22,46,20,33,2,13,12,24,16,26,42,15,4,5,19,14,58
401488029,Loyola Maryland Greyhounds,L. Therien,4900552,,True,35.0,8,18,7,17,1,1,4,7,7,8,15,0,0,1,3,4,21
401488029,Loyola Maryland Greyhounds,K. Sims,4898948,,True,25.0,2,3,2,3,0,0,0,0,2,14,16,1,1,2,1,1,4
401488029,Loyola Maryland Greyhounds,C. Garcia,5109224,,True,19.0,2,2,2,2,0,0,0,0,1,0,1,1,0,0,2,3,4
401488029,Loyola Maryland Greyhounds,K. Ratigan,5109222,,True,28.0,0,2,0,0,0,2,0,0,0,0,0,2,0,0,2,2,0
401488029,Loyola Maryland Greyhounds,T. Dixon,4400209,,True,37.0,6,16,6,10,0,6,0,0,0,0,0,3,1,0,3,4,12
401488029,Loyola Maryland Greyhounds,C. Tanedo,4704774,,False,14.0,1,4,0,1,1,3,2,3,0,0,0,1,0,0,1,2,5
401488029,Loyola Maryland Greyhounds,B. Rozzi,4596306,,False,25.0,3,6,1,3,2,3,0,0,0,0,0,1,0,0,1,1,8
401488029,Loyola Maryland Greyhounds,D. Newman,4399474,,False,17.0,1,5,0,3,1,2,0,0,0,0,0,1,0,0,1,0,3
401488029,Loyola Maryland Greyhounds,TEAM,TOTAL,TOTAL,False,,23,56,18,39,5,17,6,10,13,23,36,10,2,3,16,17,57
401488029,Loyola Maryland Greyhounds,L. Therien,4900552,,True,35.0,8,18,7,17,1,1,4,7,7,8,15,0,0,1,3,4,21
401488029,Loyola Maryland Greyhounds,K. Sims,4898948,,True,25.0,2,3,2,3,0,0,0,0,2,14,16,1,1,2,1,1,4
401488029,Loyola Maryland Greyhounds,C. Garcia,5109224,,True,19.0,2,2,2,2,0,0,0,0,1,0,1,1,0,0,2,3,4
401488029,Loyola Maryland Greyhounds,K. Ratigan,5109222,,True,28.0,0,2,0,0,0,2,0,0,0,0,0,2,0,0,2,2,0
401488029,Loyola Maryland Greyhounds,T. Dixon,4400209,,True,37.0,6,16,6,10,0,6,0,0,0,0,0,3,1,0,3,4,12
401488029,Loyola Maryland Greyhounds,C. Tanedo,4704774,,False,14.0,1,4,0,1,1,3,2,3,0,0,0,1,0,0,1,2,5
401488029,Loyola Maryland Greyhounds,B. Rozzi,4596306,,False,25.0,3,6,1,3,2,3,0,0,0,0,0,1,0,0,1,1,8
401488029,Loyola Maryland Greyhounds,D. Newman,4399474,,False,17.0,1,5,0,3,1,2,0,0,0,0,0,1,0,0,1,0,3
401488029,Loyola Maryland Greyhounds,TEAM,TOTAL,TOTAL,False,,23,56,18,39,5,17,6,10,13,23,36,10,2,3,16,17,57
401488029,Boston University Terriers,C. Weimar,4704495,,True,38.0,5,12,5,12,0,0,3,4,3,4,7,2,0,3,3,3,13
401488029,Boston University Terriers,M. Durant,4599732,,True,32.0,3,7,3,7,0,0,1,2,5,8,13,2,1,3,0,5,7
401488029,Boston University Terriers,A. Giannaros,4899717,,True,23.0,3,6,0,0,3,6,4,4,1,1,2,1,0,0,5,2,13
401488029,Boston University Terriers,M. Pina,4599731,,True,29.0,1,4,0,0,1,4,0,0,0,0,0,2,0,0,1,0,3
401488029,Boston University Terriers,S. Johnson,4599729,,True,36.0,7,13,6,11,1,2,6,9,1,0,1,3,5,0,0,2,21
401488029,Boston University Terriers,S. Crispe,5109197,,False,10.0,1,6,1,5,0,1,1,2,0,3,3,0,1,0,1,1,3
401488029,Boston University Terriers,L. Davenport,4899718,,False,14.0,1,2,1,1,0,1,0,0,0,0,0,0,0,0,1,0,2
401488029,Boston University Terriers,S. Beneventine,4704699,,False,13.0,1,2,0,1,1,1,0,0,0,1,1,2,0,0,0,0,3
401488029,Boston University Terriers,L. Shean,4599727,,False,5.0,0,0,0,0,0,0,0,0,0,0,0,0,0,0,0,0,0
401488029,Boston University Terriers,TEAM,TOTAL,TOTAL,False,,22,52,16,37,6,15,15,21,11,21,32,12,7,6,11,13,65
401488029,Boston University Terriers,C. Weimar,4704495,,True,38.0,5,12,5,12,0,0,3,4,3,4,7,2,0,3,3,3,13
401488029,Boston University Terriers,M. Durant,4599732,,True,32.0,3,7,3,7,0,0,1,2,5,8,13,2,1,3,0,5,7
401488029,Boston University Terriers,A. Giannaros,4899717,,True,23.0,3,6,0,0,3,6,4,4,1,1,2,1,0,0,5,2,13
401488029,Boston University Terriers,M. Pina,4599731,,True,29.0,1,4,0,0,1,4,0,0,0,0,0,2,0,0,1,0,3
401488029,Boston University Terriers,S. Johnson,4599729,,True,36.0,7,13,6,11,1,2,6,9,1,0,1,3,5,0,0,2,21
401488029,Boston University Terriers,S. Crispe,5109197,,False,10.0,1,6,1,5,0,1,1,2,0,3,3,0,1,0,1,1,3
401488029,Boston University Terriers,L. Davenport,4899718,,False,14.0,1,2,1,1,0,1,0,0,0,0,0,0,0,0,1,0,2
401488029,Boston University Terriers,S. Beneventine,4704699,,False,13.0,1,2,0,1,1,1,0,0,0,1,1,2,0,0,0,0,3
401488029,Boston University Terriers,L. Shean,4599727,,False,5.0,0,0,0,0,0,0,0,0,0,0,0,0,0,0,0,0,0
401488029,Boston University Terriers,TEAM,TOTAL,TOTAL,False,,22,52,16,37,6,15,15,21,11,21,32,12,7,6,11,13,65
401488028,Navy Midshipmen,M. Andrews,4704780,,True,20.0,0,1,0,1,0,0,0,0,2,2,4,1,1,0,1,4,0
401488028,Navy Midshipmen,K. Samson,5109237,,True,15.0,0,4,0,4,0,0,0,0,0,5,5,0,0,0,0,5,0
401488028,Navy Midshipmen,S. Watts,4704782,,True,33.0,8,18,8,13,0,5,0,0,0,2,2,1,1,0,0,0,16
401488028,Navy Midshipmen,M. Louridas,5109236,,True,29.0,3,12,3,9,0,3,0,0,0,1,1,1,1,0,0,0,6
401488028,Navy Midshipmen,M. Schrader,4595622,,True,28.0,3,6,1,2,2,4,0,0,0,3,3,0,1,0,4,1,8
401488028,Navy Midshipmen,M. Demos,5109235,,False,19.0,1,3,1,3,0,0,0,0,2,2,4,0,0,0,2,4,2
401488028,Navy Midshipmen,G. Pissott,5109232,,False,21.0,0,1,0,1,0,0,1,2,1,1,2,0,0,0,1,1,1
401488028,Navy Midshipmen,L. Llewellyn,4595625,,False,17.0,3,8,3,8,0,0,0,0,0,0,0,0,2,0,6,3,6
401488028,Navy Midshipmen,K. Giuliani,5109230,,False,6.0,0,2,0,1,0,1,0,0,0,0,0,0,0,0,1,0,0
401488028,Navy Midshipmen,S. Schofield,4704779,,False,12.0,1,3,1,2,0,1,0,0,0,2,2,0,1,0,2,1,2
401488028,Navy Midshipmen,TEAM,TOTAL,TOTAL,False,,19,58,17,44,2,14,1,2,10,20,30,3,7,0,17,19,41
401488028,Navy Midshipmen,M. Andrews,4704780,,True,20.0,0,1,0,1,0,0,0,0,2,2,4,1,1,0,1,4,0
401488028,Navy Midshipmen,K. Samson,5109237,,True,15.0,0,4,0,4,0,0,0,0,0,5,5,0,0,0,0,5,0
401488028,Navy Midshipmen,S. Watts,4704782,,True,33.0,8,18,8,13,0,5,0,0,0,2,2,1,1,0,0,0,16
401488028,Navy Midshipmen,M. Louridas,5109236,,True,29.0,3,12,3,9,0,3,0,0,0,1,1,1,1,0,0,0,6
401488028,Navy Midshipmen,M. Schrader,4595622,,True,28.0,3,6,1,2,2,4,0,0,0,3,3,0,1,0,4,1,8
401488028,Navy Midshipmen,M. Demos,5109235,,False,19.0,1,3,1,3,0,0,0,0,2,2,4,0,0,0,2,4,2
401488028,Navy Midshipmen,G. Pissott,5109232,,False,21.0,0,1,0,1,0,0,1,2,1,1,2,0,0,0,1,1,1
401488028,Navy Midshipmen,L. Llewellyn,4595625,,False,17.0,3,8,3,8,0,0,0,0,0,0,0,0,2,0,6,3,6
401488028,Navy Midshipmen,K. Giuliani,5109230,,False,6.0,0,2,0,1,0,1,0,0,0,0,0,0,0,0,1,0,0
401488028,Navy Midshipmen,S. Schofield,4704779,,False,12.0,1,3,1,2,0,1,0,0,0,2,2,0,1,0,2,1,2
401488028,Navy Midshipmen,TEAM,TOTAL,TOTAL,False,,19,58,17,44,2,14,1,2,10,20,30,3,7,0,17,19,41
401488028,Boston University Terriers,C. Weimar,4704495,,True,26.0,7,10,7,10,0,0,3,5,3,10,13,2,1,1,0,0,17
401488028,Boston University Terriers,M. Durant,4599732,,True,23.0,5,6,5,6,0,0,0,1,2,3,5,3,2,1,2,3,10
401488028,Boston University Terriers,A. Giannaros,4899717,,True,23.0,8,9,3,4,5,5,1,1,0,0,0,3,1,0,4,1,22
401488028,Boston University Terriers,M. Pina,4599731,,True,23.0,5,10,3,5,2,5,1,2,0,1,1,4,2,0,1,2,13
401488028,Boston University Terriers,S. Johnson,4599729,,True,19.0,3,7,2,5,1,2,2,2,0,2,2,3,2,1,1,1,9
401488028,Boston University Terriers,S. Crispe,5109197,,False,19.0,0,2,0,1,0,1,2,2,2,7,9,0,1,1,1,3,2
401488028,Boston University Terriers,A. Semenova,5109196,,False,11.0,0,3,0,1,0,2,0,0,0,2,2,0,1,0,1,0,0
401488028,Boston University Terriers,L. Davenport,4899718,,False,15.0,0,6,0,3,0,3,0,0,0,1,1,1,0,1,1,0,0
401488028,Boston University Terriers,S. Beneventine,4704699,,False,16.0,2,3,2,2,0,1,0,0,1,1,2,2,2,0,1,1,4
401488028,Boston University Terriers,K. Mingo,4704698,,False,8.0,3,6,2,3,1,3,0,0,2,1,3,0,0,0,1,0,7
401488028,Boston University Terriers,L. Shean,4599727,,False,17.0,0,2,0,0,0,2,0,0,0,0,0,0,1,0,0,3,0
401488028,Boston University Terriers,TEAM,TOTAL,TOTAL,False,,33,64,24,40,9,24,9,13,14,29,43,18,13,5,13,14,84
401488028,Boston University Terriers,C. Weimar,4704495,,True,26.0,7,10,7,10,0,0,3,5,3,10,13,2,1,1,0,0,17
401488028,Boston University Terriers,M. Durant,4599732,,True,23.0,5,6,5,6,0,0,0,1,2,3,5,3,2,1,2,3,10
401488028,Boston University Terriers,A. Giannaros,4899717,,True,23.0,8,9,3,4,5,5,1,1,0,0,0,3,1,0,4,1,22
401488028,Boston University Terriers,M. Pina,4599731,,True,23.0,5,10,3,5,2,5,1,2,0,1,1,4,2,0,1,2,13
401488028,Boston University Terriers,S. Johnson,4599729,,True,19.0,3,7,2,5,1,2,2,2,0,2,2,3,2,1,1,1,9
401488028,Boston University Terriers,S. Crispe,5109197,,False,19.0,0,2,0,1,0,1,2,2,2,7,9,0,1,1,1,3,2
401488028,Boston University Terriers,A. Semenova,5109196,,False,11.0,0,3,0,1,0,2,0,0,0,2,2,0,1,0,1,0,0
401488028,Boston University Terriers,L. Davenport,4899718,,False,15.0,0,6,0,3,0,3,0,0,0,1,1,1,0,1,1,0,0
401488028,Boston University Terriers,S. Beneventine,4704699,,False,16.0,2,3,2,2,0,1,0,0,1,1,2,2,2,0,1,1,4
401488028,Boston University Terriers,K. Mingo,4704698,,False,8.0,3,6,2,3,1,3,0,0,2,1,3,0,0,0,1,0,7
401488028,Boston University Terriers,L. Shean,4599727,,False,17.0,0,2,0,0,0,2,0,0,0,0,0,0,1,0,0,3,0
401488028,Boston University Terriers,TEAM,TOTAL,TOTAL,False,,33,64,24,40,9,24,9,13,14,29,43,18,13,5,13,14,84
401488027,Colgate Raiders,T. McMillan,4704704,,True,31.0,4,7,4,7,0,0,2,4,1,1,2,0,0,0,3,2,10
401488027,Colgate Raiders,M. Schiller,5109205,,True,28.0,5,5,2,2,3,3,2,2,1,5,6,2,2,0,3,1,15
401488027,Colgate Raiders,T. Golembiewski,4900535,,True,30.0,2,9,1,5,1,4,0,0,0,2,2,3,1,0,1,1,5
401488027,Colgate Raiders,J. Paul,4595552,,True,14.0,1,5,1,1,0,4,0,0,0,2,2,1,0,0,0,1,2
401488027,Colgate Raiders,A. Brodie,4595550,,True,33.0,1,6,1,5,0,1,0,0,0,2,2,2,0,0,1,0,2
401488027,Colgate Raiders,C. Okafor,5109208,,False,3.0,0,1,0,1,0,0,0,0,0,0,0,0,0,0,0,0,0
401488027,Colgate Raiders,S. Diehl,4900536,,False,11.0,0,3,0,2,0,1,0,0,0,0,0,1,0,0,0,0,0
401488027,Colgate Raiders,A. Ferguson,5109209,,False,16.0,1,2,1,2,0,0,0,0,2,0,2,1,0,0,0,1,2
401488027,Colgate Raiders,C. Midgette,5109204,,False,7.0,1,1,1,1,0,0,0,0,3,1,4,0,0,0,0,0,2
401488027,Colgate Raiders,L. Cook,5109207,,False,2.0,0,0,0,0,0,0,0,0,0,0,0,0,0,0,0,1,0
401488027,Colgate Raiders,M. McMahon,4900534,,False,25.0,5,14,3,9,2,5,1,1,0,1,1,2,0,0,2,2,13
401488027,Colgate Raiders,TEAM,TOTAL,TOTAL,False,,20,53,14,35,6,18,5,7,9,19,28,12,3,0,10,9,51
401488027,Colgate Raiders,T. McMillan,4704704,,True,31.0,4,7,4,7,0,0,2,4,1,1,2,0,0,0,3,2,10
401488027,Colgate Raiders,M. Schiller,5109205,,True,28.0,5,5,2,2,3,3,2,2,1,5,6,2,2,0,3,1,15
401488027,Colgate Raiders,T. Golembiewski,4900535,,True,30.0,2,9,1,5,1,4,0,0,0,2,2,3,1,0,1,1,5
401488027,Colgate Raiders,J. Paul,4595552,,True,14.0,1,5,1,1,0,4,0,0,0,2,2,1,0,0,0,1,2
401488027,Colgate Raiders,A. Brodie,4595550,,True,33.0,1,6,1,5,0,1,0,0,0,2,2,2,0,0,1,0,2
401488027,Colgate Raiders,C. Okafor,5109208,,False,3.0,0,1,0,1,0,0,0,0,0,0,0,0,0,0,0,0,0
401488027,Colgate Raiders,S. Diehl,4900536,,False,11.0,0,3,0,2,0,1,0,0,0,0,0,1,0,0,0,0,0
401488027,Colgate Raiders,A. Ferguson,5109209,,False,16.0,1,2,1,2,0,0,0,0,2,0,2,1,0,0,0,1,2
401488027,Colgate Raiders,C. Midgette,5109204,,False,7.0,1,1,1,1,0,0,0,0,3,1,4,0,0,0,0,0,2
401488027,Colgate Raiders,L. Cook,5109207,,False,2.0,0,0,0,0,0,0,0,0,0,0,0,0,0,0,0,1,0
401488027,Colgate Raiders,M. McMahon,4900534,,False,25.0,5,14,3,9,2,5,1,1,0,1,1,2,0,0,2,2,13
401488027,Colgate Raiders,TEAM,TOTAL,TOTAL,False,,20,53,14,35,6,18,5,7,9,19,28,12,3,0,10,9,51
401488027,Boston University Terriers,S. Crispe,5109197,,True,28.0,3,5,3,5,0,0,1,1,2,2,4,5,0,0,1,3,7
401488027,Boston University Terriers,M. Durant,4599732,,True,38.0,8,12,8,12,0,0,2,3,1,9,10,5,2,2,3,4,18
401488027,Boston University Terriers,A. Giannaros,4899717,,True,20.0,2,4,1,2,1,2,2,2,0,1,1,1,0,0,0,2,7
401488027,Boston University Terriers,M. Pina,4599731,,True,27.0,4,7,0,1,4,6,0,0,0,2,2,0,0,0,3,0,12
401488027,Boston University Terriers,S. Johnson,4599729,,True,28.0,4,10,3,6,1,4,0,0,0,1,1,5,4,0,0,0,9
401488027,Boston University Terriers,A. Semenova,5109196,,False,3.0,0,1,0,0,0,1,0,0,0,0,0,0,0,0,0,0,0
401488027,Boston University Terriers,L. Davenport,4899718,,False,24.0,2,7,2,5,0,2,0,0,0,3,3,3,0,0,0,0,4
401488027,Boston University Terriers,S. Beneventine,4704699,,False,16.0,2,2,0,0,2,2,0,0,0,0,0,0,0,0,0,0,6
401488027,Boston University Terriers,K. Mingo,4704698,,False,5.0,1,3,0,2,1,1,0,0,1,2,3,0,1,0,0,0,3
401488027,Boston University Terriers,L. Shean,4599727,,False,11.0,2,3,0,0,2,3,0,0,1,1,2,0,0,0,0,0,6
401488027,Boston University Terriers,TEAM,TOTAL,TOTAL,False,,28,54,17,33,11,21,5,6,6,25,31,19,7,2,8,9,72
401488027,Boston University Terriers,S. Crispe,5109197,,True,28.0,3,5,3,5,0,0,1,1,2,2,4,5,0,0,1,3,7
401488027,Boston University Terriers,M. Durant,4599732,,True,38.0,8,12,8,12,0,0,2,3,1,9,10,5,2,2,3,4,18
401488027,Boston University Terriers,A. Giannaros,4899717,,True,20.0,2,4,1,2,1,2,2,2,0,1,1,1,0,0,0,2,7
401488027,Boston University Terriers,M. Pina,4599731,,True,27.0,4,7,0,1,4,6,0,0,0,2,2,0,0,0,3,0,12
401488027,Boston University Terriers,S. Johnson,4599729,,True,28.0,4,10,3,6,1,4,0,0,0,1,1,5,4,0,0,0,9
401488027,Boston University Terriers,A. Semenova,5109196,,False,3.0,0,1,0,0,0,1,0,0,0,0,0,0,0,0,0,0,0
401488027,Boston University Terriers,L. Davenport,4899718,,False,24.0,2,7,2,5,0,2,0,0,0,3,3,3,0,0,0,0,4
401488027,Boston University Terriers,S. Beneventine,4704699,,False,16.0,2,2,0,0,2,2,0,0,0,0,0,0,0,0,0,0,6
401488027,Boston University Terriers,K. Mingo,4704698,,False,5.0,1,3,0,2,1,1,0,0,1,2,3,0,1,0,0,0,3
401488027,Boston University Terriers,L. Shean,4599727,,False,11.0,2,3,0,0,2,3,0,0,1,1,2,0,0,0,0,0,6
401488027,Boston University Terriers,TEAM,TOTAL,TOTAL,False,,28,54,17,33,11,21,5,6,6,25,31,19,7,2,8,9,72
401488026,Boston University Terriers,C. Weimar,4704495,,True,34.0,5,9,5,9,0,0,0,0,2,8,10,3,1,2,0,3,10
401488026,Boston University Terriers,M. Durant,4599732,,True,25.0,2,5,2,5,0,0,2,6,0,2,2,0,1,2,6,5,6
401488026,Boston University Terriers,A. Giannaros,4899717,,True,24.0,2,6,0,3,2,3,2,2,0,2,2,2,1,0,3,1,8
401488026,Boston University Terriers,M. Pina,4599731,,True,28.0,6,10,5,8,1,2,2,2,2,1,3,4,1,0,2,1,15
401488026,Boston University Terriers,S. Johnson,4599729,,True,34.0,4,8,1,3,3,5,0,0,0,2,2,3,1,0,3,1,11
401488026,Boston University Terriers,S. Crispe,5109197,,False,16.0,2,2,2,2,0,0,1,1,2,3,5,0,0,0,1,4,5
401488026,Boston University Terriers,A. Semenova,5109196,,False,2.0,0,0,0,0,0,0,0,0,0,0,0,0,0,0,1,0,0
401488026,Boston University Terriers,L. Davenport,4899718,,False,22.0,5,9,3,5,2,4,4,6,0,6,6,1,1,0,1,0,16
401488026,Boston University Terriers,S. Beneventine,4704699,,False,10.0,1,2,1,1,0,1,0,0,1,0,1,3,1,0,2,0,2
401488026,Boston University Terriers,L. Shean,4599727,,False,5.0,0,2,0,1,0,1,0,0,0,0,0,0,0,0,0,0,0
401488026,Boston University Terriers,TEAM,TOTAL,TOTAL,False,,27,53,19,37,8,16,11,17,8,26,34,16,7,4,19,15,73
401488026,Boston University Terriers,C. Weimar,4704495,,True,34.0,5,9,5,9,0,0,0,0,2,8,10,3,1,2,0,3,10
401488026,Boston University Terriers,M. Durant,4599732,,True,25.0,2,5,2,5,0,0,2,6,0,2,2,0,1,2,6,5,6
401488026,Boston University Terriers,A. Giannaros,4899717,,True,24.0,2,6,0,3,2,3,2,2,0,2,2,2,1,0,3,1,8
401488026,Boston University Terriers,M. Pina,4599731,,True,28.0,6,10,5,8,1,2,2,2,2,1,3,4,1,0,2,1,15
401488026,Boston University Terriers,S. Johnson,4599729,,True,34.0,4,8,1,3,3,5,0,0,0,2,2,3,1,0,3,1,11
401488026,Boston University Terriers,S. Crispe,5109197,,False,16.0,2,2,2,2,0,0,1,1,2,3,5,0,0,0,1,4,5
401488026,Boston University Terriers,A. Semenova,5109196,,False,2.0,0,0,0,0,0,0,0,0,0,0,0,0,0,0,1,0,0
401488026,Boston University Terriers,L. Davenport,4899718,,False,22.0,5,9,3,5,2,4,4,6,0,6,6,1,1,0,1,0,16
401488026,Boston University Terriers,S. Beneventine,4704699,,False,10.0,1,2,1,1,0,1,0,0,1,0,1,3,1,0,2,0,2
401488026,Boston University Terriers,L. Shean,4599727,,False,5.0,0,2,0,1,0,1,0,0,0,0,0,0,0,0,0,0,0
401488026,Boston University Terriers,TEAM,TOTAL,TOTAL,False,,27,53,19,37,8,16,11,17,8,26,34,16,7,4,19,15,73
401488026,American University Eagles,E. Johns,4704688,,True,35.0,6,15,6,12,0,3,3,3,0,2,2,2,1,0,5,3,15
401488026,American University Eagles,L. Stack,4595455,,True,29.0,2,9,2,9,0,0,2,2,3,3,6,2,3,1,3,4,6
401488026,American University Eagles,K. Henning,4704686,,True,26.0,4,5,4,5,0,0,0,0,0,2,2,1,2,1,2,3,8
401488026,American University Eagles,I. Bales,4704685,,True,33.0,5,11,4,9,1,2,0,0,1,5,6,1,5,0,1,4,11
401488026,American University Eagles,S. Stetson,4595453,,True,31.0,4,8,1,3,3,5,0,0,1,1,2,1,0,0,2,4,11
401488026,American University Eagles,M. Lavin,5109188,,False,11.0,2,3,0,1,2,2,4,4,0,1,1,0,0,0,1,3,10
401488026,American University Eagles,M. Lee,4704592,,False,5.0,0,1,0,0,0,1,0,0,0,1,1,0,0,0,1,0,0
401488026,American University Eagles,L. Nogues,5109187,,False,6.0,0,0,0,0,0,0,0,0,0,0,0,1,0,0,2,1,0
401488026,American University Eagles,A. Rescifina,5109186,,False,4.0,0,0,0,0,0,0,0,0,0,0,0,0,0,0,1,1,0
401488026,American University Eagles,B. Garbee,4899710,,False,7.0,0,0,0,0,0,0,0,0,0,1,1,0,1,1,0,0,0
401488026,American University Eagles,A. LeMaster,4703737,,False,13.0,0,4,0,1,0,3,2,2,0,3,3,0,0,0,0,1,2
401488026,American University Eagles,TEAM,TOTAL,TOTAL,False,,23,56,17,40,6,16,11,11,7,20,27,8,12,3,19,24,63
401488026,American University Eagles,E. Johns,4704688,,True,35.0,6,15,6,12,0,3,3,3,0,2,2,2,1,0,5,3,15
401488026,American University Eagles,L. Stack,4595455,,True,29.0,2,9,2,9,0,0,2,2,3,3,6,2,3,1,3,4,6
401488026,American University Eagles,K. Henning,4704686,,True,26.0,4,5,4,5,0,0,0,0,0,2,2,1,2,1,2,3,8
401488026,American University Eagles,I. Bales,4704685,,True,33.0,5,11,4,9,1,2,0,0,1,5,6,1,5,0,1,4,11
401488026,American University Eagles,S. Stetson,4595453,,True,31.0,4,8,1,3,3,5,0,0,1,1,2,1,0,0,2,4,11
401488026,American University Eagles,M. Lavin,5109188,,False,11.0,2,3,0,1,2,2,4,4,0,1,1,0,0,0,1,3,10
401488026,American University Eagles,M. Lee,4704592,,False,5.0,0,1,0,0,0,1,0,0,0,1,1,0,0,0,1,0,0
401488026,American University Eagles,L. Nogues,5109187,,False,6.0,0,0,0,0,0,0,0,0,0,0,0,1,0,0,2,1,0
401488026,American University Eagles,A. Rescifina,5109186,,False,4.0,0,0,0,0,0,0,0,0,0,0,0,0,0,0,1,1,0
401488026,American University Eagles,B. Garbee,4899710,,False,7.0,0,0,0,0,0,0,0,0,0,1,1,0,1,1,0,0,0
401488026,American University Eagles,A. LeMaster,4703737,,False,13.0,0,4,0,1,0,3,2,2,0,3,3,0,0,0,0,1,2
401488026,American University Eagles,TEAM,TOTAL,TOTAL,False,,23,56,17,40,6,16,11,11,7,20,27,8,12,3,19,24,63
401488025,Lafayette Leopards,K. Drummond,4704754,,True,27.0,6,8,6,8,0,0,0,0,2,5,7,0,0,2,1,3,12
401488025,Lafayette Leopards,A. Antognoli,4900540,,True,34.0,2,6,1,3,1,3,0,0,3,6,9,5,2,0,3,1,5
401488025,Lafayette Leopards,M. Andrews,4704756,,True,24.0,3,10,3,10,0,0,2,2,0,1,1,0,1,0,3,5,8
401488025,Lafayette Leopards,H. Smith,4704553,,True,29.0,2,8,0,2,2,6,0,0,0,6,6,2,0,1,2,4,6
401488025,Lafayette Leopards,J. Booth,4433381,,True,23.0,3,8,3,7,0,1,3,5,1,3,4,4,1,0,3,1,9
401488025,Lafayette Leopards,A. Matthews,4703689,,False,13.0,0,1,0,1,0,0,0,0,0,2,2,0,0,0,1,2,0
401488025,Lafayette Leopards,S. Ntaconayigize,5109216,,False,20.0,1,4,0,0,1,4,0,0,0,2,2,0,0,0,1,0,3
401488025,Lafayette Leopards,K. Donahue,5109215,,False,7.0,1,3,1,2,0,1,0,0,1,1,2,0,0,0,0,1,2
401488025,Lafayette Leopards,K. Favours,4900541,,False,23.0,1,10,0,3,1,7,0,0,0,1,1,2,0,0,1,0,3
401488025,Lafayette Leopards,TEAM,TOTAL,TOTAL,False,,19,58,14,36,5,22,5,7,8,27,35,13,4,3,17,17,48
401488025,Lafayette Leopards,K. Drummond,4704754,,True,27.0,6,8,6,8,0,0,0,0,2,5,7,0,0,2,1,3,12
401488025,Lafayette Leopards,A. Antognoli,4900540,,True,34.0,2,6,1,3,1,3,0,0,3,6,9,5,2,0,3,1,5
401488025,Lafayette Leopards,M. Andrews,4704756,,True,24.0,3,10,3,10,0,0,2,2,0,1,1,0,1,0,3,5,8
401488025,Lafayette Leopards,H. Smith,4704553,,True,29.0,2,8,0,2,2,6,0,0,0,6,6,2,0,1,2,4,6
401488025,Lafayette Leopards,J. Booth,4433381,,True,23.0,3,8,3,7,0,1,3,5,1,3,4,4,1,0,3,1,9
401488025,Lafayette Leopards,A. Matthews,4703689,,False,13.0,0,1,0,1,0,0,0,0,0,2,2,0,0,0,1,2,0
401488025,Lafayette Leopards,S. Ntaconayigize,5109216,,False,20.0,1,4,0,0,1,4,0,0,0,2,2,0,0,0,1,0,3
401488025,Lafayette Leopards,K. Donahue,5109215,,False,7.0,1,3,1,2,0,1,0,0,1,1,2,0,0,0,0,1,2
401488025,Lafayette Leopards,K. Favours,4900541,,False,23.0,1,10,0,3,1,7,0,0,0,1,1,2,0,0,1,0,3
401488025,Lafayette Leopards,TEAM,TOTAL,TOTAL,False,,19,58,14,36,5,22,5,7,8,27,35,13,4,3,17,17,48
401488025,Boston University Terriers,C. Weimar,4704495,,True,29.0,10,19,10,19,0,0,3,3,5,7,12,1,0,0,4,1,23
401488025,Boston University Terriers,M. Durant,4599732,,True,26.0,1,4,1,4,0,0,0,0,3,10,13,8,1,4,1,2,2
401488025,Boston University Terriers,A. Giannaros,4899717,,True,25.0,4,4,1,1,3,3,0,0,0,1,1,2,0,0,2,1,11
401488025,Boston University Terriers,M. Pina,4599731,,True,15.0,4,9,2,2,2,7,0,0,0,1,1,0,1,0,1,2,10
401488025,Boston University Terriers,S. Johnson,4599729,,True,24.0,4,9,1,6,3,3,0,0,0,1,1,4,1,0,3,2,11
401488025,Boston University Terriers,S. Crispe,5109197,,False,13.0,0,3,0,2,0,1,0,0,2,3,5,1,0,0,1,0,0
401488025,Boston University Terriers,A. Semenova,5109196,,False,6.0,1,2,1,1,0,1,0,0,0,1,1,0,0,0,0,0,2
401488025,Boston University Terriers,L. Davenport,4899718,,False,21.0,1,6,1,3,0,3,0,0,2,2,4,1,0,0,0,1,2
401488025,Boston University Terriers,S. Beneventine,4704699,,False,11.0,0,1,0,0,0,1,0,0,0,2,2,1,1,0,1,0,0
401488025,Boston University Terriers,K. Mingo,4704698,,False,7.0,0,4,0,1,0,3,0,0,0,0,0,1,1,0,1,0,0
401488025,Boston University Terriers,A. Larnard,4599728,,False,5.0,1,1,1,1,0,0,0,2,0,1,1,0,0,0,1,0,2
401488025,Boston University Terriers,L. Shean,4599727,,False,17.0,1,3,0,1,1,2,0,0,0,2,2,1,0,0,0,2,3
401488025,Boston University Terriers,TEAM,TOTAL,TOTAL,False,,27,65,18,41,9,24,3,5,12,31,43,20,5,4,15,11,66
401488025,Boston University Terriers,C. Weimar,4704495,,True,29.0,10,19,10,19,0,0,3,3,5,7,12,1,0,0,4,1,23
401488025,Boston University Terriers,M. Durant,4599732,,True,26.0,1,4,1,4,0,0,0,0,3,10,13,8,1,4,1,2,2
401488025,Boston University Terriers,A. Giannaros,4899717,,True,25.0,4,4,1,1,3,3,0,0,0,1,1,2,0,0,2,1,11
401488025,Boston University Terriers,M. Pina,4599731,,True,15.0,4,9,2,2,2,7,0,0,0,1,1,0,1,0,1,2,10
401488025,Boston University Terriers,S. Johnson,4599729,,True,24.0,4,9,1,6,3,3,0,0,0,1,1,4,1,0,3,2,11
401488025,Boston University Terriers,S. Crispe,5109197,,False,13.0,0,3,0,2,0,1,0,0,2,3,5,1,0,0,1,0,0
401488025,Boston University Terriers,A. Semenova,5109196,,False,6.0,1,2,1,1,0,1,0,0,0,1,1,0,0,0,0,0,2
401488025,Boston University Terriers,L. Davenport,4899718,,False,21.0,1,6,1,3,0,3,0,0,2,2,4,1,0,0,0,1,2
401488025,Boston University Terriers,S. Beneventine,4704699,,False,11.0,0,1,0,0,0,1,0,0,0,2,2,1,1,0,1,0,0
401488025,Boston University Terriers,K. Mingo,4704698,,False,7.0,0,4,0,1,0,3,0,0,0,0,0,1,1,0,1,0,0
401488025,Boston University Terriers,A. Larnard,4599728,,False,5.0,1,1,1,1,0,0,0,2,0,1,1,0,0,0,1,0,2
401488025,Boston University Terriers,L. Shean,4599727,,False,17.0,1,3,0,1,1,2,0,0,0,2,2,1,0,0,0,2,3
401488025,Boston University Terriers,TEAM,TOTAL,TOTAL,False,,27,65,18,41,9,24,3,5,12,31,43,20,5,4,15,11,66
401488024,Bucknell Bison,I. King,4900533,,True,32.0,3,8,1,4,2,4,0,0,1,2,3,0,0,1,0,2,8
401488024,Bucknell Bison,E. Shaffer,4595535,,True,33.0,4,9,4,9,0,0,1,2,6,8,14,3,1,0,3,3,9
401488024,Bucknell Bison,E. Theodorsson,5109199,,True,24.0,3,10,2,8,1,2,3,4,0,2,2,1,0,0,0,4,10
401488024,Bucknell Bison,C. Collins,4900532,,True,33.0,5,14,5,13,0,1,0,0,0,2,2,2,1,0,3,3,10
401488024,Bucknell Bison,C. Dingler,4577540,,True,32.0,0,1,0,0,0,1,0,0,0,1,1,0,0,0,1,1,0
401488024,Bucknell Bison,G. Sullivan,5109201,,False,7.0,0,0,0,0,0,0,0,0,0,0,0,0,0,0,0,1,0
401488024,Bucknell Bison,R. Sisselman,4900531,,False,19.0,2,9,1,3,1,6,0,2,0,1,1,0,1,0,2,2,5
401488024,Bucknell Bison,B. Matthews,5109200,,False,3.0,0,1,0,1,0,0,0,0,1,0,1,0,0,0,0,0,0
401488024,Bucknell Bison,J. Kulesza,4704702,,False,5.0,0,0,0,0,0,0,0,0,0,0,0,0,0,0,0,1,0
401488024,Bucknell Bison,T. Johnson,4595533,,False,12.0,2,3,2,3,0,0,1,2,0,1,1,0,1,0,1,1,5
401488024,Bucknell Bison,TEAM,TOTAL,TOTAL,False,,19,55,15,41,4,14,5,10,8,17,25,6,4,1,10,18,47
401488024,Bucknell Bison,I. King,4900533,,True,32.0,3,8,1,4,2,4,0,0,1,2,3,0,0,1,0,2,8
401488024,Bucknell Bison,E. Shaffer,4595535,,True,33.0,4,9,4,9,0,0,1,2,6,8,14,3,1,0,3,3,9
401488024,Bucknell Bison,E. Theodorsson,5109199,,True,24.0,3,10,2,8,1,2,3,4,0,2,2,1,0,0,0,4,10
401488024,Bucknell Bison,C. Collins,4900532,,True,33.0,5,14,5,13,0,1,0,0,0,2,2,2,1,0,3,3,10
401488024,Bucknell Bison,C. Dingler,4577540,,True,32.0,0,1,0,0,0,1,0,0,0,1,1,0,0,0,1,1,0
401488024,Bucknell Bison,G. Sullivan,5109201,,False,7.0,0,0,0,0,0,0,0,0,0,0,0,0,0,0,0,1,0
401488024,Bucknell Bison,R. Sisselman,4900531,,False,19.0,2,9,1,3,1,6,0,2,0,1,1,0,1,0,2,2,5
401488024,Bucknell Bison,B. Matthews,5109200,,False,3.0,0,1,0,1,0,0,0,0,1,0,1,0,0,0,0,0,0
401488024,Bucknell Bison,J. Kulesza,4704702,,False,5.0,0,0,0,0,0,0,0,0,0,0,0,0,0,0,0,1,0
401488024,Bucknell Bison,T. Johnson,4595533,,False,12.0,2,3,2,3,0,0,1,2,0,1,1,0,1,0,1,1,5
401488024,Bucknell Bison,TEAM,TOTAL,TOTAL,False,,19,55,15,41,4,14,5,10,8,17,25,6,4,1,10,18,47
401488024,Boston University Terriers,C. Weimar,4704495,,True,26.0,6,9,6,9,0,0,6,6,4,12,16,1,0,3,2,3,18
401488024,Boston University Terriers,M. Durant,4599732,,True,30.0,3,4,3,4,0,0,2,2,2,7,9,3,2,1,1,1,8
401488024,Boston University Terriers,A. Giannaros,4899717,,True,29.0,1,7,1,6,0,1,0,0,0,1,1,5,1,0,2,1,2
401488024,Boston University Terriers,M. Pina,4599731,,True,24.0,2,5,2,4,0,1,0,0,1,3,4,0,1,0,1,0,4
401488024,Boston University Terriers,S. Johnson,4599729,,True,32.0,4,13,2,7,2,6,5,6,0,2,2,2,1,0,2,2,15
401488024,Boston University Terriers,S. Crispe,5109197,,False,18.0,3,5,2,4,1,1,2,2,1,0,1,0,0,0,2,2,9
401488024,Boston University Terriers,A. Semenova,5109196,,False,3.0,1,2,0,1,1,1,0,0,0,0,0,0,1,1,0,0,3
401488024,Boston University Terriers,L. Davenport,4899718,,False,12.0,2,3,2,3,0,0,2,2,0,2,2,1,0,0,2,0,6
401488024,Boston University Terriers,S. Beneventine,4704699,,False,11.0,0,0,0,0,0,0,0,0,1,0,1,3,0,0,2,2,0
401488024,Boston University Terriers,K. Mingo,4704698,,False,3.0,0,1,0,1,0,0,0,0,0,1,1,0,0,0,0,0,0
401488024,Boston University Terriers,A. Larnard,4599728,,False,3.0,1,1,0,0,1,1,0,0,0,0,0,0,0,0,0,0,3
401488024,Boston University Terriers,L. Shean,4599727,,False,9.0,0,0,0,0,0,0,0,0,0,2,2,1,0,0,1,0,0
401488024,Boston University Terriers,TEAM,TOTAL,TOTAL,False,,23,50,18,39,5,11,17,18,10,32,42,16,6,5,15,11,68
401488024,Boston University Terriers,C. Weimar,4704495,,True,26.0,6,9,6,9,0,0,6,6,4,12,16,1,0,3,2,3,18
401488024,Boston University Terriers,M. Durant,4599732,,True,30.0,3,4,3,4,0,0,2,2,2,7,9,3,2,1,1,1,8
401488024,Boston University Terriers,A. Giannaros,4899717,,True,29.0,1,7,1,6,0,1,0,0,0,1,1,5,1,0,2,1,2
401488024,Boston University Terriers,M. Pina,4599731,,True,24.0,2,5,2,4,0,1,0,0,1,3,4,0,1,0,1,0,4
401488024,Boston University Terriers,S. Johnson,4599729,,True,32.0,4,13,2,7,2,6,5,6,0,2,2,2,1,0,2,2,15
401488024,Boston University Terriers,S. Crispe,5109197,,False,18.0,3,5,2,4,1,1,2,2,1,0,1,0,0,0,2,2,9
401488024,Boston University Terriers,A. Semenova,5109196,,False,3.0,1,2,0,1,1,1,0,0,0,0,0,0,1,1,0,0,3
401488024,Boston University Terriers,L. Davenport,4899718,,False,12.0,2,3,2,3,0,0,2,2,0,2,2,1,0,0,2,0,6
401488024,Boston University Terriers,S. Beneventine,4704699,,False,11.0,0,0,0,0,0,0,0,0,1,0,1,3,0,0,2,2,0
401488024,Boston University Terriers,K. Mingo,4704698,,False,3.0,0,1,0,1,0,0,0,0,0,1,1,0,0,0,0,0,0
401488024,Boston University Terriers,A. Larnard,4599728,,False,3.0,1,1,0,0,1,1,0,0,0,0,0,0,0,0,0,0,3
401488024,Boston University Terriers,L. Shean,4599727,,False,9.0,0,0,0,0,0,0,0,0,0,2,2,1,0,0,1,0,0
401488024,Boston University Terriers,TEAM,TOTAL,TOTAL,False,,23,50,18,39,5,11,17,18,10,32,42,16,6,5,15,11,68
401488023,Navy Midshipmen,M. Andrews,4704780,,True,31.0,0,4,0,4,0,0,0,0,4,9,13,3,0,1,2,0,0
401488023,Navy Midshipmen,K. Samson,5109237,,True,16.0,1,6,1,6,0,0,2,2,1,2,3,0,0,1,1,4,4
401488023,Navy Midshipmen,S. Watts,4704782,,True,35.0,5,20,2,14,3,6,2,2,0,2,2,1,0,0,2,1,15
401488023,Navy Midshipmen,M. Louridas,5109236,,True,38.0,5,18,2,8,3,10,0,1,0,7,7,1,2,0,3,3,13
401488023,Navy Midshipmen,M. Schrader,4595622,,True,38.0,3,9,2,5,1,4,0,1,1,2,3,3,1,0,3,1,7
401488023,Navy Midshipmen,M. Demos,5109235,,False,13.0,0,3,0,3,0,0,0,0,3,2,5,0,1,0,0,1,0
401488023,Navy Midshipmen,G. Pissott,5109232,,False,23.0,0,4,0,4,0,0,0,2,3,0,3,2,1,0,1,3,0
401488023,Navy Midshipmen,K. Giuliani,5109230,,False,2.0,0,0,0,0,0,0,0,0,0,0,0,0,0,0,0,1,0
401488023,Navy Midshipmen,S. Schofield,4704779,,False,4.0,0,2,0,1,0,1,0,0,0,0,0,0,0,0,1,1,0
401488023,Navy Midshipmen,TEAM,TOTAL,TOTAL,False,,14,66,7,45,7,21,4,8,15,28,43,10,5,2,13,15,39
401488023,Navy Midshipmen,M. Andrews,4704780,,True,31.0,0,4,0,4,0,0,0,0,4,9,13,3,0,1,2,0,0
401488023,Navy Midshipmen,K. Samson,5109237,,True,16.0,1,6,1,6,0,0,2,2,1,2,3,0,0,1,1,4,4
401488023,Navy Midshipmen,S. Watts,4704782,,True,35.0,5,20,2,14,3,6,2,2,0,2,2,1,0,0,2,1,15
401488023,Navy Midshipmen,M. Louridas,5109236,,True,38.0,5,18,2,8,3,10,0,1,0,7,7,1,2,0,3,3,13
401488023,Navy Midshipmen,M. Schrader,4595622,,True,38.0,3,9,2,5,1,4,0,1,1,2,3,3,1,0,3,1,7
401488023,Navy Midshipmen,M. Demos,5109235,,False,13.0,0,3,0,3,0,0,0,0,3,2,5,0,1,0,0,1,0
401488023,Navy Midshipmen,G. Pissott,5109232,,False,23.0,0,4,0,4,0,0,0,2,3,0,3,2,1,0,1,3,0
401488023,Navy Midshipmen,K. Giuliani,5109230,,False,2.0,0,0,0,0,0,0,0,0,0,0,0,0,0,0,0,1,0
401488023,Navy Midshipmen,S. Schofield,4704779,,False,4.0,0,2,0,1,0,1,0,0,0,0,0,0,0,0,1,1,0
401488023,Navy Midshipmen,TEAM,TOTAL,TOTAL,False,,14,66,7,45,7,21,4,8,15,28,43,10,5,2,13,15,39
401488023,Boston University Terriers,S. Crispe,5109197,,True,24.0,2,7,1,5,1,2,0,0,3,1,4,0,0,2,2,0,5
401488023,Boston University Terriers,M. Durant,4599732,,True,17.0,0,3,0,3,0,0,3,4,4,4,8,1,0,0,0,4,3
401488023,Boston University Terriers,A. Giannaros,4899717,,True,22.0,2,4,1,2,1,2,0,0,0,4,4,5,1,0,1,1,5
401488023,Boston University Terriers,M. Pina,4599731,,True,19.0,1,7,1,5,0,2,1,2,0,2,2,1,0,0,1,1,3
401488023,Boston University Terriers,S. Johnson,4599729,,True,27.0,6,14,5,11,1,3,2,4,0,3,3,3,2,2,2,3,15
401488023,Boston University Terriers,A. Semenova,5109196,,False,7.0,0,1,0,1,0,0,0,0,0,3,3,1,0,0,0,1,0
401488023,Boston University Terriers,C. Weimar,4704495,,False,27.0,7,8,7,8,0,0,1,3,2,10,12,0,2,2,2,0,15
401488023,Boston University Terriers,L. Davenport,4899718,,False,15.0,3,5,2,3,1,2,0,0,0,3,3,1,0,2,0,1,7
401488023,Boston University Terriers,S. Beneventine,4704699,,False,21.0,0,2,0,1,0,1,0,0,1,4,5,3,0,0,1,1,0
401488023,Boston University Terriers,K. Mingo,4704698,,False,6.0,3,6,2,3,1,3,0,0,0,0,0,0,1,1,0,1,7
401488023,Boston University Terriers,A. Larnard,4599728,,False,5.0,0,0,0,0,0,0,0,0,0,1,1,0,0,0,0,0,0
401488023,Boston University Terriers,L. Shean,4599727,,False,10.0,1,4,1,3,0,1,0,1,0,1,1,0,0,0,0,2,2
401488023,Boston University Terriers,TEAM,TOTAL,TOTAL,False,,25,61,20,45,5,16,7,14,11,40,51,15,6,9,9,15,62
401488023,Boston University Terriers,S. Crispe,5109197,,True,24.0,2,7,1,5,1,2,0,0,3,1,4,0,0,2,2,0,5
401488023,Boston University Terriers,M. Durant,4599732,,True,17.0,0,3,0,3,0,0,3,4,4,4,8,1,0,0,0,4,3
401488023,Boston University Terriers,A. Giannaros,4899717,,True,22.0,2,4,1,2,1,2,0,0,0,4,4,5,1,0,1,1,5
401488023,Boston University Terriers,M. Pina,4599731,,True,19.0,1,7,1,5,0,2,1,2,0,2,2,1,0,0,1,1,3
401488023,Boston University Terriers,S. Johnson,4599729,,True,27.0,6,14,5,11,1,3,2,4,0,3,3,3,2,2,2,3,15
401488023,Boston University Terriers,A. Semenova,5109196,,False,7.0,0,1,0,1,0,0,0,0,0,3,3,1,0,0,0,1,0
401488023,Boston University Terriers,C. Weimar,4704495,,False,27.0,7,8,7,8,0,0,1,3,2,10,12,0,2,2,2,0,15
401488023,Boston University Terriers,L. Davenport,4899718,,False,15.0,3,5,2,3,1,2,0,0,0,3,3,1,0,2,0,1,7
401488023,Boston University Terriers,S. Beneventine,4704699,,False,21.0,0,2,0,1,0,1,0,0,1,4,5,3,0,0,1,1,0
401488023,Boston University Terriers,K. Mingo,4704698,,False,6.0,3,6,2,3,1,3,0,0,0,0,0,0,1,1,0,1,7
401488023,Boston University Terriers,A. Larnard,4599728,,False,5.0,0,0,0,0,0,0,0,0,0,1,1,0,0,0,0,0,0
401488023,Boston University Terriers,L. Shean,4599727,,False,10.0,1,4,1,3,0,1,0,1,0,1,1,0,0,0,0,2,2
401488023,Boston University Terriers,TEAM,TOTAL,TOTAL,False,,25,61,20,45,5,16,7,14,11,40,51,15,6,9,9,15,62
401488022,Yale Bulldogs,H. Sabol,4899334,,True,21.0,5,9,3,7,2,2,2,4,2,2,4,0,1,0,0,3,14
401488022,Yale Bulldogs,K. Capstraw,5108958,,True,29.0,3,7,1,3,2,4,4,4,0,8,8,0,0,0,1,2,12
401488022,Yale Bulldogs,N. McGill,4899339,,True,21.0,0,1,0,1,0,0,0,0,2,3,5,1,2,0,0,3,0
401488022,Yale Bulldogs,M. Egger,4899338,,True,26.0,2,7,2,5,0,2,0,1,2,3,5,2,0,2,1,1,4
401488022,Yale Bulldogs,J. Clark,4594954,,True,32.0,5,15,3,11,2,4,3,3,0,4,4,7,2,1,5,4,15
401488022,Yale Bulldogs,B. McDonald,4899337,,False,4.0,0,0,0,0,0,0,0,0,0,0,0,0,0,1,0,1,0
401488022,Yale Bulldogs,G. Thybulle,4899336,,False,15.0,2,7,2,7,0,0,0,0,2,1,3,0,0,1,3,2,4
401488022,Yale Bulldogs,E. van der Maas,4899335,,False,16.0,1,5,1,2,0,3,0,0,1,4,5,1,1,1,0,0,2
401488022,Yale Bulldogs,A. Lee,4899333,,False,11.0,2,4,2,4,0,0,1,1,1,0,1,0,0,0,1,1,5
401488022,Yale Bulldogs,K. Astrom,4594955,,False,25.0,1,5,1,3,0,2,0,0,3,2,5,2,2,0,3,1,2
401488022,Yale Bulldogs,TEAM,TOTAL,TOTAL,False,,21,60,15,43,6,17,10,13,14,29,43,13,8,6,16,18,58
401488022,Boston University Terriers,S. Crispe,5109197,,True,25.0,1,2,1,2,0,0,3,4,0,3,3,1,0,0,1,2,5
401488022,Boston University Terriers,M. Durant,4599732,,True,33.0,3,4,3,4,0,0,1,2,1,7,8,2,0,2,2,2,7
401488022,Boston University Terriers,L. Davenport,4899718,,True,22.0,0,5,0,3,0,2,0,2,1,4,5,2,0,0,2,1,0
401488022,Boston University Terriers,M. Pina,4599731,,True,25.0,3,11,2,7,1,4,0,0,1,4,5,1,2,0,2,3,7
401488022,Boston University Terriers,S. Johnson,4599729,,True,33.0,5,14,5,13,0,1,0,0,0,2,2,1,1,0,3,1,10
401488022,Boston University Terriers,A. Semenova,5109196,,False,12.0,0,1,0,1,0,0,0,0,1,2,3,0,1,0,2,1,0
401488022,Boston University Terriers,A. Giannaros,4899717,,False,19.0,3,5,1,3,2,2,4,4,0,2,2,1,0,0,3,3,12
401488022,Boston University Terriers,S. Beneventine,4704699,,False,16.0,0,0,0,0,0,0,0,0,0,2,2,0,1,0,2,0,0
401488022,Boston University Terriers,L. Shean,4599727,,False,15.0,1,7,1,4,0,3,3,4,0,0,0,0,1,0,0,2,5
401488022,Boston University Terriers,TEAM,TOTAL,TOTAL,False,,16,49,13,37,3,12,11,16,7,27,34,8,6,2,18,15,46
401488021,Merrimack Warriors,A. Staton,4704140,,True,26.0,4,13,4,13,0,0,0,0,6,7,13,1,0,4,2,2,8
401488021,Merrimack Warriors,M. Hamilton,4282089,,True,30.0,7,18,4,12,3,6,3,4,0,4,4,1,2,0,1,3,20
401488021,Merrimack Warriors,M. Manion,4900515,,True,21.0,1,2,1,2,0,0,0,0,0,1,1,0,0,0,1,1,2
401488021,Merrimack Warriors,M. Bray,4598238,,True,29.0,3,7,3,6,0,1,0,0,0,3,3,0,0,0,0,2,6
401488021,Merrimack Warriors,J. DeCesare,4597019,,True,36.0,3,11,0,2,3,9,0,0,1,2,3,6,2,0,1,4,9
401488021,Merrimack Warriors,A. Fursman,4597025,,False,29.0,5,7,3,5,2,2,0,0,1,6,7,2,0,0,3,3,12
401488021,Merrimack Warriors,L. Melaschenko,5106082,,False,22.0,3,8,3,8,0,0,2,2,2,0,2,0,0,0,3,0,8
401488021,Merrimack Warriors,D. Christian,4597020,,False,7.0,0,0,0,0,0,0,0,0,1,0,1,0,0,0,3,1,0
401488021,Merrimack Warriors,TEAM,TOTAL,TOTAL,False,,26,66,18,48,8,18,5,6,12,24,36,10,4,4,14,16,65
401488021,Boston University Terriers,S. Crispe,5109197,,True,26.0,4,5,4,4,0,1,0,0,1,5,6,1,0,1,6,5,8
401488021,Boston University Terriers,M. Durant,4599732,,True,29.0,5,7,5,7,0,0,1,1,2,10,12,5,0,1,1,4,11
401488021,Boston University Terriers,L. Davenport,4899718,,True,23.0,3,10,2,6,1,4,1,5,1,3,4,0,2,0,0,0,8
401488021,Boston University Terriers,M. Pina,4599731,,True,25.0,4,7,1,2,3,5,0,0,1,0,1,4,0,0,2,1,11
401488021,Boston University Terriers,S. Johnson,4599729,,True,26.0,3,11,1,8,2,3,2,4,0,3,3,5,1,0,1,0,10
401488021,Boston University Terriers,A. Semenova,5109196,,False,19.0,3,5,2,3,1,2,0,0,1,1,2,0,3,0,0,0,7
401488021,Boston University Terriers,S. Beneventine,4704699,,False,20.0,0,1,0,1,0,0,2,4,1,1,2,1,0,0,2,1,2
401488021,Boston University Terriers,K. Mingo,4704698,,False,11.0,2,4,1,1,1,3,0,0,0,0,0,1,1,0,0,0,5
401488021,Boston University Terriers,L. Shean,4599727,,False,21.0,3,5,0,0,3,5,2,2,0,1,1,2,0,0,2,0,11
401488021,Boston University Terriers,TEAM,TOTAL,TOTAL,False,,27,55,16,32,11,23,8,16,9,27,36,19,7,2,14,11,73
401488020,New Hampshire Wildcats,B. Morales Lopez,5107637,,True,17.0,1,5,1,5,0,0,3,3,0,3,3,0,1,0,0,1,5
401488020,New Hampshire Wildcats,A. O'Connor,5107640,,True,17.0,3,5,2,2,1,3,2,2,0,3,3,0,0,0,2,5,9
401488020,New Hampshire Wildcats,B. Williams,5107638,,True,30.0,4,10,4,8,0,2,4,4,2,2,4,1,1,0,1,3,12
401488020,New Hampshire Wildcats,A. Groman,4704607,,True,36.0,2,8,2,6,0,2,0,0,0,3,3,0,1,0,2,0,4
401488020,New Hampshire Wildcats,B. Kane,4594367,,True,35.0,2,14,2,9,0,5,2,2,2,2,4,1,2,1,1,3,6
401488020,New Hampshire Wildcats,P. Cote,4704608,,False,23.0,2,9,2,8,0,1,0,0,3,1,4,0,0,0,2,3,4
401488020,New Hampshire Wildcats,K. Andersson,5107641,,False,27.0,1,6,1,3,0,3,0,0,1,3,4,1,0,0,1,1,2
401488020,New Hampshire Wildcats,D. Eliasson,5107639,,False,15.0,0,3,0,3,0,0,0,0,0,0,0,2,0,0,0,2,0
401488020,New Hampshire Wildcats,TEAM,TOTAL,TOTAL,False,,15,60,14,44,1,16,11,11,12,19,31,5,5,1,12,18,42
401488020,Boston University Terriers,C. Weimar,4704495,,True,25.0,1,5,1,5,0,0,6,8,2,5,7,2,0,1,0,0,8
401488020,Boston University Terriers,M. Durant,4599732,,True,26.0,3,3,3,3,0,0,1,1,0,8,8,4,0,3,1,3,7
401488020,Boston University Terriers,L. Davenport,4899718,,True,20.0,1,5,1,4,0,1,3,4,0,2,2,1,1,0,1,1,5
401488020,Boston University Terriers,M. Pina,4599731,,True,26.0,5,7,2,3,3,4,0,0,0,3,3,3,1,0,3,1,13
401488020,Boston University Terriers,S. Johnson,4599729,,True,26.0,5,11,3,7,2,4,0,0,0,3,3,5,1,0,2,2,12
401488020,Boston University Terriers,S. Crispe,5109197,,False,19.0,4,6,4,6,0,0,2,2,1,3,4,0,1,1,2,1,10
401488020,Boston University Terriers,A. Semenova,5109196,,False,10.0,3,5,3,5,0,0,0,0,2,1,3,1,0,1,0,0,6
401488020,Boston University Terriers,A. Giannaros,4899717,,False,15.0,3,6,1,4,2,2,2,3,1,3,4,2,1,0,2,3,10
401488020,Boston University Terriers,S. Beneventine,4704699,,False,9.0,0,1,0,0,0,1,0,0,0,1,1,0,0,0,0,1,0
401488020,Boston University Terriers,K. Mingo,4704698,,False,10.0,1,2,1,2,0,0,1,1,0,0,0,0,0,0,1,0,3
401488020,Boston University Terriers,L. Shean,4599727,,False,14.0,2,5,2,3,0,2,0,0,0,3,3,0,1,0,0,1,4
401488020,Boston University Terriers,TEAM,TOTAL,TOTAL,False,,28,56,21,42,7,14,15,19,11,33,44,18,6,6,12,13,78
401488019,St. Francis Brooklyn Terriers,S. Bandoma,4900504,,True,25.0,4,5,4,5,0,0,1,3,2,1,3,1,0,2,1,3,9
401488019,St. Francis Brooklyn Terriers,B. Green,5106091,,True,9.0,0,3,0,2,0,1,2,2,1,0,1,0,0,0,0,3,2
401488019,St. Francis Brooklyn Terriers,T. Myers,5106088,,True,29.0,1,4,0,1,1,3,0,0,1,2,3,1,0,0,4,1,3
401488019,St. Francis Brooklyn Terriers,A. Fisher,4595797,,True,39.0,6,18,1,9,5,9,2,4,0,5,5,2,1,0,2,2,19
401488019,St. Francis Brooklyn Terriers,E. Ogier,4595792,,True,33.0,3,12,2,6,1,6,3,5,0,2,2,2,0,1,2,5,10
401488019,St. Francis Brooklyn Terriers,S. Kavanagh,4900503,,False,25.0,3,7,2,4,1,3,0,0,0,8,8,1,2,0,1,4,7
401488019,St. Francis Brooklyn Terriers,Z. Hutchinson,4705058,,False,9.0,1,1,1,1,0,0,0,0,0,2,2,0,0,0,0,0,2
401488019,St. Francis Brooklyn Terriers,A. Belloso,5106092,,False,22.0,2,4,1,2,1,2,4,4,0,2,2,3,0,0,4,2,9
401488019,St. Francis Brooklyn Terriers,K. Januszewska,5106090,,False,9.0,0,0,0,0,0,0,0,0,0,1,1,0,0,0,0,0,0
401488019,St. Francis Brooklyn Terriers,TEAM,TOTAL,TOTAL,False,,20,54,11,30,9,24,12,18,7,26,33,10,3,3,14,20,61
401488019,Boston University Terriers,C. Weimar,4704495,,True,28.0,5,8,5,8,0,0,2,6,3,10,13,1,0,1,1,2,12
401488019,Boston University Terriers,M. Durant,4599732,,True,24.0,1,8,1,8,0,0,4,5,4,9,13,4,0,1,5,5,6
401488019,Boston University Terriers,L. Davenport,4899718,,True,19.0,2,6,1,2,1,4,0,0,0,1,1,1,0,0,0,3,5
401488019,Boston University Terriers,M. Pina,4599731,,True,32.0,2,6,0,3,2,3,3,4,0,2,2,2,1,0,0,1,9
401488019,Boston University Terriers,S. Johnson,4599729,,True,34.0,7,19,5,14,2,5,4,4,2,3,5,6,5,0,0,1,20
401488019,Boston University Terriers,S. Crispe,5109197,,False,22.0,3,9,2,7,1,2,2,2,2,1,3,2,0,1,2,3,9
401488019,Boston University Terriers,A. Semenova,5109196,,False,5.0,1,1,1,1,0,0,0,0,0,1,1,1,0,0,1,0,2
401488019,Boston University Terriers,S. Beneventine,4704699,,False,16.0,1,3,0,2,1,1,0,2,0,1,1,1,0,0,1,3,3
401488019,Boston University Terriers,K. Mingo,4704698,,False,6.0,1,2,0,1,1,1,0,0,1,1,2,0,0,0,0,1,3
401488019,Boston University Terriers,L. Shean,4599727,,False,14.0,1,1,0,0,1,1,0,0,0,1,1,1,1,0,0,0,3
401488019,Boston University Terriers,TEAM,TOTAL,TOTAL,False,,24,63,15,46,9,17,15,23,15,31,46,19,7,3,10,19,72
401488018,Hartford Hawks,E. Houghton,5107585,,True,31.0,3,6,3,6,0,0,0,0,1,2,3,0,2,0,1,1,6
401488018,Hartford Hawks,L. Johnson-Kleinpeter,5107591,,True,24.0,1,4,1,2,0,2,0,0,0,2,2,0,0,0,0,1,2
401488018,Hartford Hawks,Z. Minnis,5107586,,True,16.0,4,11,4,7,0,4,0,0,0,5,5,0,0,0,1,1,8
401488018,Hartford Hawks,N. Dowding,4898959,,True,26.0,3,8,3,7,0,1,0,0,0,0,0,0,0,0,1,3,6
401488018,Hartford Hawks,I. Primo,4594352,,True,33.0,2,7,1,3,1,4,2,3,0,1,1,3,1,0,2,3,7
401488018,Hartford Hawks,T. Forbes,5107593,,False,24.0,3,11,2,8,1,3,4,6,0,5,5,3,2,0,3,4,11
401488018,Hartford Hawks,J. Barnes,5107592,,False,8.0,0,4,0,2,0,2,0,0,0,1,1,1,0,0,0,1,0
401488018,Hartford Hawks,T. Outten,5107590,,False,18.0,1,4,1,4,0,0,0,0,0,2,2,0,0,0,0,0,2
401488018,Hartford Hawks,P. Loughman,5107588,,False,14.0,1,4,0,1,1,3,0,0,1,0,1,1,1,0,0,1,3
401488018,Hartford Hawks,K. Nance,4909371,,False,6.0,0,1,0,1,0,0,0,0,0,0,0,1,0,0,0,0,0
401488018,Hartford Hawks,TEAM,TOTAL,TOTAL,False,,18,60,15,41,3,19,6,9,7,21,28,9,6,0,9,15,45
401488018,Boston University Terriers,C. Weimar,4704495,,True,25.0,7,11,7,11,0,0,1,2,1,9,10,0,1,4,1,0,15
401488018,Boston University Terriers,M. Durant,4599732,,True,26.0,1,5,1,5,0,0,1,2,6,4,10,3,2,2,2,1,3
401488018,Boston University Terriers,L. Davenport,4899718,,True,23.0,5,9,5,7,0,2,2,2,1,6,7,5,1,0,0,1,12
401488018,Boston University Terriers,M. Pina,4599731,,True,25.0,4,7,1,2,3,5,0,0,0,3,3,4,0,1,2,0,11
401488018,Boston University Terriers,S. Johnson,4599729,,True,28.0,4,10,4,8,0,2,2,2,1,2,3,7,1,0,3,0,10
401488018,Boston University Terriers,S. Crispe,5109197,,False,19.0,3,5,3,5,0,0,0,0,2,1,3,2,0,1,1,2,6
401488018,Boston University Terriers,A. Semenova,5109196,,False,10.0,1,2,0,1,1,1,0,0,0,2,2,1,0,0,0,0,3
401488018,Boston University Terriers,S. Beneventine,4704699,,False,20.0,2,6,1,2,1,4,0,0,0,2,2,2,0,0,1,1,5
401488018,Boston University Terriers,K. Mingo,4704698,,False,10.0,2,6,1,2,1,4,1,1,0,2,2,0,0,1,2,4,6
401488018,Boston University Terriers,L. Shean,4599727,,False,14.0,1,1,1,1,0,0,0,0,1,4,5,1,0,0,2,2,2
401488018,Boston University Terriers,TEAM,TOTAL,TOTAL,False,,30,62,24,44,6,18,7,9,12,36,48,25,5,9,14,11,73
401488017,UMass Lowell River Hawks,A. Dowdy,4898981,,True,19.0,0,3,0,3,0,0,0,0,1,1,2,0,1,1,2,5,0
401488017,UMass Lowell River Hawks,I. Finley,4898983,,True,36.0,3,11,2,8,1,3,3,5,1,5,6,3,5,0,1,2,10
401488017,UMass Lowell River Hawks,J. Edmonds,4704207,,True,14.0,1,4,1,4,0,0,0,0,0,0,0,1,0,0,3,0,2
401488017,UMass Lowell River Hawks,K. Banwareesingh,4594359,,True,36.0,6,15,4,9,2,6,0,1,4,5,9,1,1,1,0,3,14
401488017,UMass Lowell River Hawks,J. Sanchez,4594358,,True,33.0,1,11,1,6,0,5,6,6,1,2,3,0,2,0,4,0,8
401488017,UMass Lowell River Hawks,S. Coombs,4704206,,False,21.0,1,2,1,2,0,0,3,4,2,1,3,1,0,1,0,2,5
401488017,UMass Lowell River Hawks,E. Ner,5107651,,False,10.0,0,2,0,1,0,1,0,0,0,0,0,0,1,0,1,2,0
401488017,UMass Lowell River Hawks,T. Lima,4898982,,False,8.0,0,0,0,0,0,0,0,0,0,1,1,0,1,0,2,0,0
401488017,UMass Lowell River Hawks,M. Carrera,4605757,,False,23.0,1,7,1,3,0,4,2,2,1,2,3,1,3,0,4,1,4
401488017,UMass Lowell River Hawks,TEAM,TOTAL,TOTAL,False,,13,55,10,36,3,19,14,18,14,17,31,7,14,3,17,15,43
401488017,Boston University Terriers,C. Weimar,4704495,,True,36.0,8,11,8,11,0,0,2,3,3,10,13,2,1,2,4,2,18
401488017,Boston University Terriers,M. Durant,4599732,,True,8.0,0,3,0,3,0,0,0,0,1,2,3,0,0,0,2,0,0
401488017,Boston University Terriers,L. Davenport,4899718,,True,19.0,2,6,0,2,2,4,0,0,0,7,7,2,1,1,3,1,6
401488017,Boston University Terriers,M. Pina,4599731,,True,25.0,3,6,2,4,1,2,0,0,0,2,2,1,2,0,3,2,7
401488017,Boston University Terriers,L. Shean,4599727,,True,22.0,0,1,0,0,0,1,2,2,0,2,2,4,0,1,1,1,2
401488017,Boston University Terriers,S. Crispe,5109197,,False,27.0,3,7,3,6,0,1,3,4,1,1,2,3,1,2,2,3,9
401488017,Boston University Terriers,A. Semenova,5109196,,False,9.0,1,2,1,1,0,1,0,0,1,2,3,0,0,0,4,1,2
401488017,Boston University Terriers,S. Beneventine,4704699,,False,21.0,3,5,2,4,1,1,0,0,0,2,2,3,0,0,0,3,7
401488017,Boston University Terriers,K. Mingo,4704698,,False,16.0,1,5,1,2,0,3,0,0,1,2,3,2,1,0,2,2,2
401488017,Boston University Terriers,S. Johnson,4599729,,False,17.0,4,6,3,5,1,1,1,1,0,1,1,0,0,0,2,1,10
401488017,Boston University Terriers,TEAM,TOTAL,TOTAL,False,,25,52,20,38,5,14,8,10,11,31,42,17,6,6,24,16,63
401488016,Northeastern Huskies,A. Parker,4899586,,True,22.0,0,3,0,3,0,0,0,0,1,5,6,0,0,0,3,4,0
401488016,Northeastern Huskies,H. Idowu,4705388,,True,23.0,2,4,2,3,0,1,0,0,1,4,5,2,0,1,1,4,4
401488016,Northeastern Huskies,G. Motema,4899585,,True,28.0,6,13,6,12,0,1,4,4,2,1,3,2,2,3,5,4,16
401488016,Northeastern Huskies,D. Erdogan,4703579,,True,35.0,9,14,5,6,4,8,2,2,0,4,4,3,3,0,4,3,24
401488016,Northeastern Huskies,J. Braxton,4399212,,True,33.0,4,16,3,7,1,9,0,1,0,1,1,1,1,0,1,0,9
401488016,Northeastern Huskies,O. Kiefer,5108855,,False,26.0,3,7,2,5,1,2,0,0,3,5,8,0,1,2,0,3,7
401488016,Northeastern Huskies,I. Larsen,4705028,,False,9.0,0,2,0,2,0,0,3,4,1,1,2,2,1,0,0,2,3
401488016,Northeastern Huskies,M. Turnbull,5108857,,False,5.0,0,1,0,0,0,1,2,2,0,1,1,0,0,0,0,1,2
401488016,Northeastern Huskies,A. Webb,5108856,,False,9.0,0,2,0,2,0,0,0,0,0,3,3,0,0,0,0,1,0
401488016,Northeastern Huskies,C. Clement,4899583,,False,4.0,0,1,0,0,0,1,0,0,0,1,1,0,0,0,0,0,0
401488016,Northeastern Huskies,A. Sapenter,4710685,,False,6.0,0,0,0,0,0,0,1,2,0,1,1,0,0,0,0,0,1
401488016,Northeastern Huskies,TEAM,TOTAL,TOTAL,False,,24,63,18,40,6,23,12,15,10,29,39,10,8,6,14,22,66
401488016,Boston University Terriers,C. Weimar,4704495,,True,36.0,6,11,6,11,0,0,2,5,6,5,11,2,2,3,2,4,14
401488016,Boston University Terriers,M. Durant,4599732,,True,20.0,3,3,3,3,0,0,0,0,2,3,5,3,0,1,3,4,6
401488016,Boston University Terriers,L. Davenport,4899718,,True,11.0,1,5,1,3,0,2,0,0,1,3,4,0,1,0,1,1,2
401488016,Boston University Terriers,A. Giannaros,4899717,,True,34.0,6,18,4,12,2,6,9,13,1,5,6,3,1,0,8,2,23
401488016,Boston University Terriers,M. Pina,4599731,,True,34.0,5,9,1,3,4,6,0,2,1,1,2,1,1,0,2,1,14
401488016,Boston University Terriers,S. Crispe,5109197,,False,15.0,1,4,1,4,0,0,2,2,1,1,2,1,0,2,0,0,4
401488016,Boston University Terriers,A. Semenova,5109196,,False,10.0,1,2,1,2,0,0,0,0,0,2,2,0,0,1,0,1,2
401488016,Boston University Terriers,S. Beneventine,4704699,,False,16.0,0,4,0,1,0,3,0,0,0,4,4,1,2,0,3,1,0
401488016,Boston University Terriers,K. Mingo,4704698,,False,8.0,0,1,0,0,0,1,0,0,0,3,3,2,0,0,0,3,0
401488016,Boston University Terriers,L. Shean,4599727,,False,16.0,0,3,0,2,0,1,0,0,0,1,1,0,0,1,0,1,0
401488016,Boston University Terriers,TEAM,TOTAL,TOTAL,False,,23,60,17,41,6,19,13,22,14,30,44,13,7,8,19,18,65
401488015,Lehigh Mountain Hawks,L. Fandre,5109220,,True,30.0,4,8,1,3,3,5,0,0,0,8,8,1,0,0,0,1,11
401488015,Lehigh Mountain Hawks,F. Hottinger,4595613,,True,30.0,3,11,3,10,0,1,3,4,2,5,7,2,2,1,3,4,9
401488015,Lehigh Mountain Hawks,K. Van Eps,4900545,,True,11.0,2,6,2,3,0,3,0,0,0,0,0,1,0,0,0,1,4
401488015,Lehigh Mountain Hawks,M. Kramer,4704762,,True,33.0,7,14,5,8,2,6,0,0,2,5,7,4,4,0,2,0,16
401488015,Lehigh Mountain Hawks,A. Harvey,4595612,,True,32.0,6,9,5,7,1,2,2,2,2,4,6,1,1,0,3,0,15
401488015,Lehigh Mountain Hawks,M. O'Brien,4900547,,False,8.0,0,0,0,0,0,0,0,0,0,1,1,1,0,1,0,1,0
401488015,Lehigh Mountain Hawks,M. Brown,4433751,,False,4.0,0,0,0,0,0,0,0,0,0,0,0,0,0,0,0,0,0
401488015,Lehigh Mountain Hawks,E. Stemmer,4900544,,False,25.0,4,11,2,2,2,9,0,0,0,1,1,3,2,0,0,1,10
401488015,Lehigh Mountain Hawks,M. Albrecht,4704763,,False,14.0,1,2,1,1,0,1,0,0,1,1,2,1,1,1,2,2,2
401488015,Lehigh Mountain Hawks,F. Eggenschwiler,4704761,,False,4.0,0,0,0,0,0,0,0,0,0,0,0,1,0,0,0,0,0
401488015,Lehigh Mountain Hawks,J. Behar,4433782,,False,9.0,1,1,1,1,0,0,0,0,0,2,2,1,1,1,1,3,2
401488015,Lehigh Mountain Hawks,TEAM,TOTAL,TOTAL,False,,28,62,20,35,8,27,5,6,7,27,34,16,11,4,13,13,69
401488015,Lehigh Mountain Hawks,L. Fandre,5109220,,True,30.0,4,8,1,3,3,5,0,0,0,8,8,1,0,0,0,1,11
401488015,Lehigh Mountain Hawks,F. Hottinger,4595613,,True,30.0,3,11,3,10,0,1,3,4,2,5,7,2,2,1,3,4,9
401488015,Lehigh Mountain Hawks,K. Van Eps,4900545,,True,11.0,2,6,2,3,0,3,0,0,0,0,0,1,0,0,0,1,4
401488015,Lehigh Mountain Hawks,M. Kramer,4704762,,True,33.0,7,14,5,8,2,6,0,0,2,5,7,4,4,0,2,0,16
401488015,Lehigh Mountain Hawks,A. Harvey,4595612,,True,32.0,6,9,5,7,1,2,2,2,2,4,6,1,1,0,3,0,15
401488015,Lehigh Mountain Hawks,M. O'Brien,4900547,,False,8.0,0,0,0,0,0,0,0,0,0,1,1,1,0,1,0,1,0
401488015,Lehigh Mountain Hawks,M. Brown,4433751,,False,4.0,0,0,0,0,0,0,0,0,0,0,0,0,0,0,0,0,0
401488015,Lehigh Mountain Hawks,E. Stemmer,4900544,,False,25.0,4,11,2,2,2,9,0,0,0,1,1,3,2,0,0,1,10
401488015,Lehigh Mountain Hawks,M. Albrecht,4704763,,False,14.0,1,2,1,1,0,1,0,0,1,1,2,1,1,1,2,2,2
401488015,Lehigh Mountain Hawks,F. Eggenschwiler,4704761,,False,4.0,0,0,0,0,0,0,0,0,0,0,0,1,0,0,0,0,0
401488015,Lehigh Mountain Hawks,J. Behar,4433782,,False,9.0,1,1,1,1,0,0,0,0,0,2,2,1,1,1,1,3,2
401488015,Lehigh Mountain Hawks,TEAM,TOTAL,TOTAL,False,,28,62,20,35,8,27,5,6,7,27,34,16,11,4,13,13,69
401488015,Army Black Knights,S. Hunter,4595466,,True,26.0,2,6,2,6,0,0,2,2,4,5,9,2,3,0,5,1,6
401488015,Army Black Knights,K. Hall,4595465,,True,35.0,3,13,3,12,0,1,4,5,1,6,7,1,0,2,3,3,10
401488015,Army Black Knights,R. Ericson,5109190,,True,30.0,4,9,3,5,1,4,0,0,1,4,5,3,0,0,2,4,9
401488015,Army Black Knights,L. Lithgow,4704696,,True,21.0,1,7,1,1,0,6,0,0,1,2,3,0,1,0,2,0,2
401488015,Army Black Knights,H. Brown,4595467,,True,33.0,4,10,3,6,1,4,3,4,1,4,5,0,1,0,1,3,12
401488015,Army Black Knights,L. Madison,5109194,,False,2.0,0,1,0,1,0,0,0,0,0,0,0,0,0,0,0,0,0
401488015,Army Black Knights,C. Richman,5109191,,False,9.0,0,2,0,0,0,2,0,0,0,1,1,0,0,0,0,0,0
401488015,Army Black Knights,T. Hardy,4899714,,False,9.0,0,2,0,1,0,1,0,0,0,0,0,0,0,0,0,1,0
401488015,Army Black Knights,V. Kearney,4899713,,False,2.0,0,0,0,0,0,0,0,0,0,1,1,0,0,0,0,0,0
401488015,Army Black Knights,S. McNaughton,4704694,,False,16.0,0,2,0,1,0,1,0,0,0,0,0,1,0,0,1,0,0
401488015,Army Black Knights,J. Strippoli,4595470,,False,2.0,0,0,0,0,0,0,0,0,0,0,0,0,0,0,0,0,0
401488015,Army Black Knights,N. Rhine,4595464,,False,15.0,1,3,0,1,1,2,0,0,0,0,0,0,1,0,1,0,3
401488015,Army Black Knights,TEAM,TOTAL,TOTAL,False,,15,55,12,34,3,21,9,11,8,23,31,7,6,2,17,12,42
401488015,Army Black Knights,S. Hunter,4595466,,True,26.0,2,6,2,6,0,0,2,2,4,5,9,2,3,0,5,1,6
401488015,Army Black Knights,K. Hall,4595465,,True,35.0,3,13,3,12,0,1,4,5,1,6,7,1,0,2,3,3,10
401488015,Army Black Knights,R. Ericson,5109190,,True,30.0,4,9,3,5,1,4,0,0,1,4,5,3,0,0,2,4,9
401488015,Army Black Knights,L. Lithgow,4704696,,True,21.0,1,7,1,1,0,6,0,0,1,2,3,0,1,0,2,0,2
401488015,Army Black Knights,H. Brown,4595467,,True,33.0,4,10,3,6,1,4,3,4,1,4,5,0,1,0,1,3,12
401488015,Army Black Knights,L. Madison,5109194,,False,2.0,0,1,0,1,0,0,0,0,0,0,0,0,0,0,0,0,0
401488015,Army Black Knights,C. Richman,5109191,,False,9.0,0,2,0,0,0,2,0,0,0,1,1,0,0,0,0,0,0
401488015,Army Black Knights,T. Hardy,4899714,,False,9.0,0,2,0,1,0,1,0,0,0,0,0,0,0,0,0,1,0
401488015,Army Black Knights,V. Kearney,4899713,,False,2.0,0,0,0,0,0,0,0,0,0,1,1,0,0,0,0,0,0
401488015,Army Black Knights,S. McNaughton,4704694,,False,16.0,0,2,0,1,0,1,0,0,0,0,0,1,0,0,1,0,0
401488015,Army Black Knights,J. Strippoli,4595470,,False,2.0,0,0,0,0,0,0,0,0,0,0,0,0,0,0,0,0,0
401488015,Army Black Knights,N. Rhine,4595464,,False,15.0,1,3,0,1,1,2,0,0,0,0,0,0,1,0,1,0,3
401488015,Army Black Knights,TEAM,TOTAL,TOTAL,False,,15,55,12,34,3,21,9,11,8,23,31,7,6,2,17,12,42
401488014,Holy Cross Crusaders,L. Berger,4900539,,True,26.0,4,12,4,11,0,1,2,2,2,6,8,4,1,1,1,2,10
401488014,Holy Cross Crusaders,J. Allen,4704714,,True,13.0,2,8,2,8,0,0,0,0,1,3,4,0,0,0,2,4,4
401488014,Holy Cross Crusaders,K. Flanagan,5109211,,True,31.0,4,6,2,4,2,2,6,7,0,3,3,0,1,1,3,2,16
401488014,Holy Cross Crusaders,B. Power-Cassidy,4704715,,True,34.0,4,10,4,7,0,3,5,9,1,1,2,1,0,0,1,3,13
401488014,Holy Cross Crusaders,A. Cross,4595975,,True,34.0,0,5,0,4,0,1,0,2,0,2,2,1,1,0,1,1,0
401488014,Holy Cross Crusaders,C. Wright,4703660,,False,8.0,1,2,1,2,0,0,0,0,0,0,0,0,0,0,1,0,2
401488014,Holy Cross Crusaders,M. Donnelly,5109213,,False,1.0,0,1,0,0,0,1,0,0,0,0,0,0,0,0,0,0,0
401488014,Holy Cross Crusaders,S. Foreman,5109212,,False,17.0,1,5,0,4,1,1,0,0,0,7,7,1,0,0,1,3,3
401488014,Holy Cross Crusaders,G. Munt,4900537,,False,6.0,0,2,0,1,0,1,2,2,0,1,1,0,0,0,0,0,2
401488014,Holy Cross Crusaders,C. McCormack,4704716,,False,30.0,3,5,3,4,0,1,4,4,0,0,0,4,3,0,1,1,10
401488014,Holy Cross Crusaders,TEAM,TOTAL,TOTAL,False,,19,56,16,45,3,11,19,26,4,23,27,11,6,2,11,16,60
401488014,Holy Cross Crusaders,L. Berger,4900539,,True,26.0,4,12,4,11,0,1,2,2,2,6,8,4,1,1,1,2,10
401488014,Holy Cross Crusaders,J. Allen,4704714,,True,13.0,2,8,2,8,0,0,0,0,1,3,4,0,0,0,2,4,4
401488014,Holy Cross Crusaders,K. Flanagan,5109211,,True,31.0,4,6,2,4,2,2,6,7,0,3,3,0,1,1,3,2,16
401488014,Holy Cross Crusaders,B. Power-Cassidy,4704715,,True,34.0,4,10,4,7,0,3,5,9,1,1,2,1,0,0,1,3,13
401488014,Holy Cross Crusaders,A. Cross,4595975,,True,34.0,0,5,0,4,0,1,0,2,0,2,2,1,1,0,1,1,0
401488014,Holy Cross Crusaders,C. Wright,4703660,,False,8.0,1,2,1,2,0,0,0,0,0,0,0,0,0,0,1,0,2
401488014,Holy Cross Crusaders,M. Donnelly,5109213,,False,1.0,0,1,0,0,0,1,0,0,0,0,0,0,0,0,0,0,0
401488014,Holy Cross Crusaders,S. Foreman,5109212,,False,17.0,1,5,0,4,1,1,0,0,0,7,7,1,0,0,1,3,3
401488014,Holy Cross Crusaders,G. Munt,4900537,,False,6.0,0,2,0,1,0,1,2,2,0,1,1,0,0,0,0,0,2
401488014,Holy Cross Crusaders,C. McCormack,4704716,,False,30.0,3,5,3,4,0,1,4,4,0,0,0,4,3,0,1,1,10
401488014,Holy Cross Crusaders,TEAM,TOTAL,TOTAL,False,,19,56,16,45,3,11,19,26,4,23,27,11,6,2,11,16,60
401488014,Army Black Knights,S. Hunter,4595466,,True,33.0,1,7,1,7,0,0,1,2,1,13,14,1,2,1,4,4,3
401488014,Army Black Knights,K. Hall,4595465,,True,24.0,6,12,5,10,1,2,7,7,2,5,7,3,0,2,4,5,20
401488014,Army Black Knights,R. Ericson,5109190,,True,28.0,3,9,1,6,2,3,0,0,1,1,2,2,0,0,0,3,8
401488014,Army Black Knights,L. Lithgow,4704696,,True,35.0,1,4,0,0,1,4,0,0,0,0,0,2,1,1,0,3,3
401488014,Army Black Knights,H. Brown,4595467,,True,33.0,5,15,2,9,3,6,0,0,3,3,6,0,0,0,1,4,13
401488014,Army Black Knights,L. Madison,5109194,,False,2.0,0,0,0,0,0,0,0,0,1,0,1,0,0,0,0,0,0
401488014,Army Black Knights,T. Hardy,4899714,,False,9.0,1,3,0,2,1,1,0,0,2,2,4,0,1,0,1,2,3
401488014,Army Black Knights,V. Kearney,4899713,,False,1.0,0,1,0,0,0,1,0,0,0,1,1,0,0,0,1,0,0
401488014,Army Black Knights,S. McNaughton,4704694,,False,21.0,1,3,1,3,0,0,0,0,0,0,0,1,1,0,2,3,2
401488014,Army Black Knights,N. Rhine,4595464,,False,14.0,1,4,1,2,0,2,0,0,1,2,3,0,0,0,2,1,2
401488014,Army Black Knights,TEAM,TOTAL,TOTAL,False,,19,58,11,39,8,19,8,9,11,27,38,9,5,4,15,25,54
401488014,Army Black Knights,S. Hunter,4595466,,True,33.0,1,7,1,7,0,0,1,2,1,13,14,1,2,1,4,4,3
401488014,Army Black Knights,K. Hall,4595465,,True,24.0,6,12,5,10,1,2,7,7,2,5,7,3,0,2,4,5,20
401488014,Army Black Knights,R. Ericson,5109190,,True,28.0,3,9,1,6,2,3,0,0,1,1,2,2,0,0,0,3,8
401488014,Army Black Knights,L. Lithgow,4704696,,True,35.0,1,4,0,0,1,4,0,0,0,0,0,2,1,1,0,3,3
401488014,Army Black Knights,H. Brown,4595467,,True,33.0,5,15,2,9,3,6,0,0,3,3,6,0,0,0,1,4,13
401488014,Army Black Knights,L. Madison,5109194,,False,2.0,0,0,0,0,0,0,0,0,1,0,1,0,0,0,0,0,0
401488014,Army Black Knights,T. Hardy,4899714,,False,9.0,1,3,0,2,1,1,0,0,2,2,4,0,1,0,1,2,3
401488014,Army Black Knights,V. Kearney,4899713,,False,1.0,0,1,0,0,0,1,0,0,0,1,1,0,0,0,1,0,0
401488014,Army Black Knights,S. McNaughton,4704694,,False,21.0,1,3,1,3,0,0,0,0,0,0,0,1,1,0,2,3,2
401488014,Army Black Knights,N. Rhine,4595464,,False,14.0,1,4,1,2,0,2,0,0,1,2,3,0,0,0,2,1,2
401488014,Army Black Knights,TEAM,TOTAL,TOTAL,False,,19,58,11,39,8,19,8,9,11,27,38,9,5,4,15,25,54
401488013,Boston University Terriers,C. Weimar,4704495,,True,35.0,12,17,12,17,0,0,8,8,1,6,7,2,1,1,1,5,32
401488013,Boston University Terriers,M. Durant,4599732,,True,28.0,5,7,5,7,0,0,4,8,4,3,7,1,0,2,0,2,14
401488013,Boston University Terriers,A. Giannaros,4899717,,True,34.0,2,3,0,1,2,2,0,0,0,2,2,1,0,0,1,1,6
401488013,Boston University Terriers,M. Pina,4599731,,True,33.0,5,8,5,5,0,3,1,2,0,2,2,0,2,0,1,2,11
401488013,Boston University Terriers,S. Johnson,4599729,,True,28.0,2,8,2,4,0,4,3,4,0,1,1,5,2,0,2,2,7
401488013,Boston University Terriers,S. Crispe,5109197,,False,5.0,1,2,1,2,0,0,0,0,0,0,0,1,0,0,0,1,2
401488013,Boston University Terriers,L. Davenport,4899718,,False,16.0,0,3,0,2,0,1,0,0,1,3,4,1,0,1,0,1,0
401488013,Boston University Terriers,S. Beneventine,4704699,,False,10.0,1,1,0,0,1,1,0,0,0,0,0,3,0,0,1,0,3
401488013,Boston University Terriers,L. Shean,4599727,,False,11.0,0,2,0,1,0,1,2,2,2,0,2,1,0,0,0,0,2
401488013,Boston University Terriers,TEAM,TOTAL,TOTAL,False,,28,51,25,39,3,12,18,24,8,23,31,15,5,4,7,14,77
401488013,Boston University Terriers,C. Weimar,4704495,,True,35.0,12,17,12,17,0,0,8,8,1,6,7,2,1,1,1,5,32
401488013,Boston University Terriers,M. Durant,4599732,,True,28.0,5,7,5,7,0,0,4,8,4,3,7,1,0,2,0,2,14
401488013,Boston University Terriers,A. Giannaros,4899717,,True,34.0,2,3,0,1,2,2,0,0,0,2,2,1,0,0,1,1,6
401488013,Boston University Terriers,M. Pina,4599731,,True,33.0,5,8,5,5,0,3,1,2,0,2,2,0,2,0,1,2,11
401488013,Boston University Terriers,S. Johnson,4599729,,True,28.0,2,8,2,4,0,4,3,4,0,1,1,5,2,0,2,2,7
401488013,Boston University Terriers,S. Crispe,5109197,,False,5.0,1,2,1,2,0,0,0,0,0,0,0,1,0,0,0,1,2
401488013,Boston University Terriers,L. Davenport,4899718,,False,16.0,0,3,0,2,0,1,0,0,1,3,4,1,0,1,0,1,0
401488013,Boston University Terriers,S. Beneventine,4704699,,False,10.0,1,1,0,0,1,1,0,0,0,0,0,3,0,0,1,0,3
401488013,Boston University Terriers,L. Shean,4599727,,False,11.0,0,2,0,1,0,1,2,2,2,0,2,1,0,0,0,0,2
401488013,Boston University Terriers,TEAM,TOTAL,TOTAL,False,,28,51,25,39,3,12,18,24,8,23,31,15,5,4,7,14,77
401488013,Army Black Knights,S. Hunter,4595466,,True,26.0,2,8,2,8,0,0,2,2,2,2,4,2,0,0,1,5,6
401488013,Army Black Knights,K. Hall,4595465,,True,36.0,7,14,6,11,1,3,4,6,2,3,5,2,2,1,2,5,19
401488013,Army Black Knights,R. Ericson,5109190,,True,32.0,3,5,3,4,0,1,1,1,0,3,3,6,0,0,1,2,7
401488013,Army Black Knights,L. Lithgow,4704696,,True,35.0,6,12,1,2,5,10,0,0,0,2,2,1,0,0,2,1,17
401488013,Army Black Knights,H. Brown,4595467,,True,24.0,2,9,2,3,0,6,1,2,0,2,2,0,1,0,1,3,5
401488013,Army Black Knights,L. Madison,5109194,,False,4.0,0,0,0,0,0,0,0,0,1,0,1,1,0,0,0,0,0
401488013,Army Black Knights,T. Hardy,4899714,,False,3.0,0,1,0,0,0,1,0,0,0,0,0,0,0,0,1,0,0
401488013,Army Black Knights,S. McNaughton,4704694,,False,12.0,2,4,1,2,1,2,0,0,0,1,1,2,0,0,0,4,5
401488013,Army Black Knights,N. Rhine,4595464,,False,28.0,4,7,1,1,3,6,0,0,2,1,3,0,0,0,0,1,11
401488013,Army Black Knights,TEAM,TOTAL,TOTAL,False,,26,60,16,31,10,29,8,11,11,18,29,14,3,1,8,21,70
401488013,Army Black Knights,S. Hunter,4595466,,True,26.0,2,8,2,8,0,0,2,2,2,2,4,2,0,0,1,5,6
401488013,Army Black Knights,K. Hall,4595465,,True,36.0,7,14,6,11,1,3,4,6,2,3,5,2,2,1,2,5,19
401488013,Army Black Knights,R. Ericson,5109190,,True,32.0,3,5,3,4,0,1,1,1,0,3,3,6,0,0,1,2,7
401488013,Army Black Knights,L. Lithgow,4704696,,True,35.0,6,12,1,2,5,10,0,0,0,2,2,1,0,0,2,1,17
401488013,Army Black Knights,H. Brown,4595467,,True,24.0,2,9,2,3,0,6,1,2,0,2,2,0,1,0,1,3,5
401488013,Army Black Knights,L. Madison,5109194,,False,4.0,0,0,0,0,0,0,0,0,1,0,1,1,0,0,0,0,0
401488013,Army Black Knights,T. Hardy,4899714,,False,3.0,0,1,0,0,0,1,0,0,0,0,0,0,0,0,1,0,0
401488013,Army Black Knights,S. McNaughton,4704694,,False,12.0,2,4,1,2,1,2,0,0,0,1,1,2,0,0,0,4,5
401488013,Army Black Knights,N. Rhine,4595464,,False,28.0,4,7,1,1,3,6,0,0,2,1,3,0,0,0,0,1,11
401488013,Army Black Knights,TEAM,TOTAL,TOTAL,False,,26,60,16,31,10,29,8,11,11,18,29,14,3,1,8,21,70
401488012,Lafayette Leopards,A. Matthews,4703689,,True,22.0,0,3,0,3,0,0,1,2,0,1,1,3,0,1,0,4,1
401488012,Lafayette Leopards,S. Ntaconayigize,5109216,,True,30.0,0,2,0,0,0,2,0,0,0,2,2,0,0,0,0,0,0
401488012,Lafayette Leopards,A. Antognoli,4900540,,True,32.0,3,12,2,8,1,4,0,0,0,3,3,4,0,0,3,0,7
401488012,Lafayette Leopards,M. Andrews,4704756,,True,27.0,7,16,7,16,0,0,0,0,5,4,9,0,2,1,1,4,14
401488012,Lafayette Leopards,H. Smith,4704553,,True,32.0,5,8,4,6,1,2,1,2,1,1,2,0,1,0,2,3,12
401488012,Lafayette Leopards,K. Donahue,5109215,,False,27.0,4,10,3,7,1,3,0,0,1,4,5,1,2,3,2,2,9
401488012,Lafayette Leopards,K. Favours,4900541,,False,30.0,2,7,1,3,1,4,3,4,1,2,3,0,1,0,1,1,8
401488012,Lafayette Leopards,TEAM,TOTAL,TOTAL,False,,21,58,17,43,4,15,5,8,8,19,27,8,6,5,9,14,51
401488012,Lafayette Leopards,A. Matthews,4703689,,True,22.0,0,3,0,3,0,0,1,2,0,1,1,3,0,1,0,4,1
401488012,Lafayette Leopards,S. Ntaconayigize,5109216,,True,30.0,0,2,0,0,0,2,0,0,0,2,2,0,0,0,0,0,0
401488012,Lafayette Leopards,A. Antognoli,4900540,,True,32.0,3,12,2,8,1,4,0,0,0,3,3,4,0,0,3,0,7
401488012,Lafayette Leopards,M. Andrews,4704756,,True,27.0,7,16,7,16,0,0,0,0,5,4,9,0,2,1,1,4,14
401488012,Lafayette Leopards,H. Smith,4704553,,True,32.0,5,8,4,6,1,2,1,2,1,1,2,0,1,0,2,3,12
401488012,Lafayette Leopards,K. Donahue,5109215,,False,27.0,4,10,3,7,1,3,0,0,1,4,5,1,2,3,2,2,9
401488012,Lafayette Leopards,K. Favours,4900541,,False,30.0,2,7,1,3,1,4,3,4,1,2,3,0,1,0,1,1,8
401488012,Lafayette Leopards,TEAM,TOTAL,TOTAL,False,,21,58,17,43,4,15,5,8,8,19,27,8,6,5,9,14,51
401488012,Army Black Knights,S. Hunter,4595466,,True,31.0,5,10,5,10,0,0,7,9,9,12,21,0,0,0,3,3,17
401488012,Army Black Knights,K. Hall,4595465,,True,16.0,2,3,2,3,0,0,0,0,2,5,7,2,0,1,1,4,4
401488012,Army Black Knights,R. Ericson,5109190,,True,31.0,4,10,0,4,4,6,2,2,0,3,3,4,0,0,3,3,14
401488012,Army Black Knights,L. Lithgow,4704696,,True,32.0,4,11,2,3,2,8,0,0,1,3,4,3,1,0,1,2,10
401488012,Army Black Knights,H. Brown,4595467,,True,22.0,3,7,3,7,0,0,0,0,0,1,1,2,0,0,1,1,6
401488012,Army Black Knights,L. Madison,5109194,,False,3.0,0,0,0,0,0,0,0,0,1,2,3,0,1,0,0,0,0
401488012,Army Black Knights,A. Ainsworth,5109189,,False,2.0,0,0,0,0,0,0,0,0,0,0,0,0,0,0,0,0,0
401488012,Army Black Knights,A. Stephens-Kirkman,5109192,,False,1.0,0,0,0,0,0,0,0,0,0,0,0,0,0,0,0,0,0
401488012,Army Black Knights,J. Laguna,5109193,,False,1.0,0,1,0,1,0,0,0,0,0,0,0,0,0,0,0,0,0
401488012,Army Black Knights,C. Richman,5109191,,False,6.0,0,1,0,0,0,1,0,0,0,0,0,0,1,0,0,0,0
401488012,Army Black Knights,T. Hardy,4899714,,False,22.0,3,7,3,5,0,2,1,3,3,1,4,2,3,0,1,1,7
401488012,Army Black Knights,S. McNaughton,4704694,,False,12.0,1,3,0,1,1,2,0,0,0,0,0,0,0,0,1,2,3
401488012,Army Black Knights,J. Strippoli,4595470,,False,2.0,0,0,0,0,0,0,0,0,0,0,0,0,0,0,0,0,0
401488012,Army Black Knights,N. Rhine,4595464,,False,19.0,4,7,1,2,3,5,0,0,0,2,2,2,0,0,2,0,11
401488012,Army Black Knights,TEAM,TOTAL,TOTAL,False,,26,60,16,36,10,24,10,14,18,30,48,15,6,1,15,16,72
401488012,Army Black Knights,S. Hunter,4595466,,True,31.0,5,10,5,10,0,0,7,9,9,12,21,0,0,0,3,3,17
401488012,Army Black Knights,K. Hall,4595465,,True,16.0,2,3,2,3,0,0,0,0,2,5,7,2,0,1,1,4,4
401488012,Army Black Knights,R. Ericson,5109190,,True,31.0,4,10,0,4,4,6,2,2,0,3,3,4,0,0,3,3,14
401488012,Army Black Knights,L. Lithgow,4704696,,True,32.0,4,11,2,3,2,8,0,0,1,3,4,3,1,0,1,2,10
401488012,Army Black Knights,H. Brown,4595467,,True,22.0,3,7,3,7,0,0,0,0,0,1,1,2,0,0,1,1,6
401488012,Army Black Knights,L. Madison,5109194,,False,3.0,0,0,0,0,0,0,0,0,1,2,3,0,1,0,0,0,0
401488012,Army Black Knights,A. Ainsworth,5109189,,False,2.0,0,0,0,0,0,0,0,0,0,0,0,0,0,0,0,0,0
401488012,Army Black Knights,A. Stephens-Kirkman,5109192,,False,1.0,0,0,0,0,0,0,0,0,0,0,0,0,0,0,0,0,0
401488012,Army Black Knights,J. Laguna,5109193,,False,1.0,0,1,0,1,0,0,0,0,0,0,0,0,0,0,0,0,0
401488012,Army Black Knights,C. Richman,5109191,,False,6.0,0,1,0,0,0,1,0,0,0,0,0,0,1,0,0,0,0
401488012,Army Black Knights,T. Hardy,4899714,,False,22.0,3,7,3,5,0,2,1,3,3,1,4,2,3,0,1,1,7
401488012,Army Black Knights,S. McNaughton,4704694,,False,12.0,1,3,0,1,1,2,0,0,0,0,0,0,0,0,1,2,3
401488012,Army Black Knights,J. Strippoli,4595470,,False,2.0,0,0,0,0,0,0,0,0,0,0,0,0,0,0,0,0,0
401488012,Army Black Knights,N. Rhine,4595464,,False,19.0,4,7,1,2,3,5,0,0,0,2,2,2,0,0,2,0,11
401488012,Army Black Knights,TEAM,TOTAL,TOTAL,False,,26,60,16,36,10,24,10,14,18,30,48,15,6,1,15,16,72
401488011,Colgate Raiders,T. McMillan,4704704,,True,34.0,7,9,7,8,0,1,0,0,5,4,9,1,1,0,4,2,14
401488011,Colgate Raiders,C. Midgette,5109204,,True,30.0,1,5,1,5,0,0,0,0,0,2,2,0,0,0,2,3,2
401488011,Colgate Raiders,M. Schiller,5109205,,True,42.0,4,9,3,6,1,3,2,3,1,3,4,1,5,0,3,0,11
401488011,Colgate Raiders,M. McMahon,4900534,,True,30.0,2,14,2,12,0,2,3,4,0,3,3,0,1,0,1,0,7
401488011,Colgate Raiders,A. Brodie,4595550,,True,40.0,3,12,3,11,0,1,0,0,0,7,7,1,5,0,0,5,6
401488011,Colgate Raiders,S. Diehl,4900536,,False,4.0,1,1,1,1,0,0,0,0,0,1,1,0,0,0,1,0,2
401488011,Colgate Raiders,L. Blackmore,4704706,,False,14.0,1,3,1,2,0,1,0,0,2,1,3,2,0,0,1,0,2
401488011,Colgate Raiders,L. Cook,5109207,,False,24.0,1,6,0,3,1,3,0,2,0,1,1,1,0,1,0,1,3
401488011,Colgate Raiders,J. Paul,4595552,,False,7.0,0,1,0,1,0,0,0,0,0,0,0,0,1,0,1,0,0
401488011,Colgate Raiders,TEAM,TOTAL,TOTAL,False,,20,60,18,49,2,11,5,9,8,24,32,6,13,1,14,11,47
401488011,Colgate Raiders,T. McMillan,4704704,,True,34.0,7,9,7,8,0,1,0,0,5,4,9,1,1,0,4,2,14
401488011,Colgate Raiders,C. Midgette,5109204,,True,30.0,1,5,1,5,0,0,0,0,0,2,2,0,0,0,2,3,2
401488011,Colgate Raiders,M. Schiller,5109205,,True,42.0,4,9,3,6,1,3,2,3,1,3,4,1,5,0,3,0,11
401488011,Colgate Raiders,M. McMahon,4900534,,True,30.0,2,14,2,12,0,2,3,4,0,3,3,0,1,0,1,0,7
401488011,Colgate Raiders,A. Brodie,4595550,,True,40.0,3,12,3,11,0,1,0,0,0,7,7,1,5,0,0,5,6
401488011,Colgate Raiders,S. Diehl,4900536,,False,4.0,1,1,1,1,0,0,0,0,0,1,1,0,0,0,1,0,2
401488011,Colgate Raiders,L. Blackmore,4704706,,False,14.0,1,3,1,2,0,1,0,0,2,1,3,2,0,0,1,0,2
401488011,Colgate Raiders,L. Cook,5109207,,False,24.0,1,6,0,3,1,3,0,2,0,1,1,1,0,1,0,1,3
401488011,Colgate Raiders,J. Paul,4595552,,False,7.0,0,1,0,1,0,0,0,0,0,0,0,0,1,0,1,0,0
401488011,Colgate Raiders,TEAM,TOTAL,TOTAL,False,,20,60,18,49,2,11,5,9,8,24,32,6,13,1,14,11,47
401488011,Army Black Knights,S. Hunter,4595466,,True,40.0,8,13,8,13,0,0,2,4,4,12,16,1,3,1,6,3,18
401488011,Army Black Knights,K. Hall,4595465,,True,33.0,4,8,4,8,0,0,0,0,0,5,5,1,1,1,4,3,8
401488011,Army Black Knights,R. Ericson,5109190,,True,24.0,0,2,0,0,0,2,1,4,0,0,0,2,0,0,2,1,1
401488011,Army Black Knights,L. Lithgow,4704696,,True,42.0,2,7,0,0,2,7,0,0,0,2,2,0,1,0,1,1,6
401488011,Army Black Knights,H. Brown,4595467,,True,36.0,0,7,0,6,0,1,0,0,0,5,5,3,0,1,1,0,0
401488011,Army Black Knights,T. Hardy,4899714,,False,14.0,2,4,1,2,1,2,2,2,0,3,3,1,1,2,4,1,7
401488011,Army Black Knights,S. McNaughton,4704694,,False,32.0,4,7,2,4,2,3,0,0,0,2,2,3,2,0,2,2,10
401488011,Army Black Knights,N. Rhine,4595464,,False,4.0,0,0,0,0,0,0,0,0,0,0,0,0,0,0,0,1,0
401488011,Army Black Knights,TEAM,TOTAL,TOTAL,False,,20,48,15,33,5,15,5,10,5,30,35,11,8,5,21,12,50
401488011,Army Black Knights,S. Hunter,4595466,,True,40.0,8,13,8,13,0,0,2,4,4,12,16,1,3,1,6,3,18
401488011,Army Black Knights,K. Hall,4595465,,True,33.0,4,8,4,8,0,0,0,0,0,5,5,1,1,1,4,3,8
401488011,Army Black Knights,R. Ericson,5109190,,True,24.0,0,2,0,0,0,2,1,4,0,0,0,2,0,0,2,1,1
401488011,Army Black Knights,L. Lithgow,4704696,,True,42.0,2,7,0,0,2,7,0,0,0,2,2,0,1,0,1,1,6
401488011,Army Black Knights,H. Brown,4595467,,True,36.0,0,7,0,6,0,1,0,0,0,5,5,3,0,1,1,0,0
401488011,Army Black Knights,T. Hardy,4899714,,False,14.0,2,4,1,2,1,2,2,2,0,3,3,1,1,2,4,1,7
401488011,Army Black Knights,S. McNaughton,4704694,,False,32.0,4,7,2,4,2,3,0,0,0,2,2,3,2,0,2,2,10
401488011,Army Black Knights,N. Rhine,4595464,,False,4.0,0,0,0,0,0,0,0,0,0,0,0,0,0,0,0,1,0
401488011,Army Black Knights,TEAM,TOTAL,TOTAL,False,,20,48,15,33,5,15,5,10,5,30,35,11,8,5,21,12,50
401488010,Navy Midshipmen,M. Andrews,4704780,,True,23.0,2,4,2,4,0,0,0,0,2,0,2,3,0,1,4,5,4
401488010,Navy Midshipmen,L. Llewellyn,4595625,,True,40.0,9,17,8,13,1,4,6,8,3,7,10,4,0,0,5,2,25
401488010,Navy Midshipmen,S. Watts,4704782,,True,29.0,5,12,3,8,2,4,1,1,1,2,3,0,0,1,2,3,13
401488010,Navy Midshipmen,M. Louridas,5109236,,True,26.0,5,9,3,7,2,2,1,2,1,3,4,0,0,0,2,4,13
401488010,Navy Midshipmen,M. Schrader,4595622,,True,34.0,0,3,0,2,0,1,0,0,0,3,3,5,0,0,1,1,0
401488010,Navy Midshipmen,G. Pissott,5109232,,False,24.0,0,0,0,0,0,0,0,0,1,3,4,1,1,3,1,4,0
401488010,Navy Midshipmen,K. Samson,5109237,,False,10.0,2,2,2,2,0,0,2,3,1,1,2,0,0,0,0,0,6
401488010,Navy Midshipmen,B. Coleman,5109233,,False,9.0,0,2,0,2,0,0,0,0,0,1,1,2,1,0,0,1,0
401488010,Navy Midshipmen,S. Schofield,4704779,,False,5.0,1,1,0,0,1,1,0,0,0,0,0,1,0,0,0,0,3
401488010,Navy Midshipmen,TEAM,TOTAL,TOTAL,False,,24,50,18,38,6,12,10,14,12,24,36,16,2,5,16,20,64
401488010,Navy Midshipmen,M. Andrews,4704780,,True,23.0,2,4,2,4,0,0,0,0,2,0,2,3,0,1,4,5,4
401488010,Navy Midshipmen,L. Llewellyn,4595625,,True,40.0,9,17,8,13,1,4,6,8,3,7,10,4,0,0,5,2,25
401488010,Navy Midshipmen,S. Watts,4704782,,True,29.0,5,12,3,8,2,4,1,1,1,2,3,0,0,1,2,3,13
401488010,Navy Midshipmen,M. Louridas,5109236,,True,26.0,5,9,3,7,2,2,1,2,1,3,4,0,0,0,2,4,13
401488010,Navy Midshipmen,M. Schrader,4595622,,True,34.0,0,3,0,2,0,1,0,0,0,3,3,5,0,0,1,1,0
401488010,Navy Midshipmen,G. Pissott,5109232,,False,24.0,0,0,0,0,0,0,0,0,1,3,4,1,1,3,1,4,0
401488010,Navy Midshipmen,K. Samson,5109237,,False,10.0,2,2,2,2,0,0,2,3,1,1,2,0,0,0,0,0,6
401488010,Navy Midshipmen,B. Coleman,5109233,,False,9.0,0,2,0,2,0,0,0,0,0,1,1,2,1,0,0,1,0
401488010,Navy Midshipmen,S. Schofield,4704779,,False,5.0,1,1,0,0,1,1,0,0,0,0,0,1,0,0,0,0,3
401488010,Navy Midshipmen,TEAM,TOTAL,TOTAL,False,,24,50,18,38,6,12,10,14,12,24,36,16,2,5,16,20,64
401488010,Army Black Knights,S. Hunter,4595466,,True,27.0,1,5,1,5,0,0,6,6,1,7,8,0,2,0,2,5,8
401488010,Army Black Knights,K. Hall,4595465,,True,31.0,4,13,3,12,1,1,1,4,3,3,6,5,0,1,1,2,10
401488010,Army Black Knights,R. Ericson,5109190,,True,18.0,2,4,0,2,2,2,0,0,0,0,0,1,0,0,2,5,6
401488010,Army Black Knights,L. Lithgow,4704696,,True,30.0,3,7,1,2,2,5,0,0,0,0,0,0,1,0,0,2,8
401488010,Army Black Knights,H. Brown,4595467,,True,26.0,5,11,5,10,0,1,4,5,5,2,7,0,0,0,1,4,14
401488010,Army Black Knights,L. Madison,5109194,,False,3.0,0,0,0,0,0,0,0,0,0,0,0,0,0,0,0,0,0
401488010,Army Black Knights,C. Richman,5109191,,False,1.0,0,0,0,0,0,0,0,0,0,1,1,0,0,0,0,1,0
401488010,Army Black Knights,T. Hardy,4899714,,False,16.0,2,4,2,4,0,0,0,1,0,1,1,2,1,0,2,2,4
401488010,Army Black Knights,V. Kearney,4899713,,False,1.0,0,0,0,0,0,0,0,0,1,0,1,0,0,0,1,0,0
401488010,Army Black Knights,S. McNaughton,4704694,,False,27.0,3,9,2,7,1,2,1,2,2,1,3,5,0,0,0,0,8
401488010,Army Black Knights,N. Rhine,4595464,,False,20.0,2,5,0,0,2,5,2,2,0,1,1,0,0,0,0,2,8
401488010,Army Black Knights,TEAM,TOTAL,TOTAL,False,,22,58,14,42,8,16,14,20,16,17,33,13,4,1,10,23,66
401488010,Army Black Knights,S. Hunter,4595466,,True,27.0,1,5,1,5,0,0,6,6,1,7,8,0,2,0,2,5,8
401488010,Army Black Knights,K. Hall,4595465,,True,31.0,4,13,3,12,1,1,1,4,3,3,6,5,0,1,1,2,10
401488010,Army Black Knights,R. Ericson,5109190,,True,18.0,2,4,0,2,2,2,0,0,0,0,0,1,0,0,2,5,6
401488010,Army Black Knights,L. Lithgow,4704696,,True,30.0,3,7,1,2,2,5,0,0,0,0,0,0,1,0,0,2,8
401488010,Army Black Knights,H. Brown,4595467,,True,26.0,5,11,5,10,0,1,4,5,5,2,7,0,0,0,1,4,14
401488010,Army Black Knights,L. Madison,5109194,,False,3.0,0,0,0,0,0,0,0,0,0,0,0,0,0,0,0,0,0
401488010,Army Black Knights,C. Richman,5109191,,False,1.0,0,0,0,0,0,0,0,0,0,1,1,0,0,0,0,1,0
401488010,Army Black Knights,T. Hardy,4899714,,False,16.0,2,4,2,4,0,0,0,1,0,1,1,2,1,0,2,2,4
401488010,Army Black Knights,V. Kearney,4899713,,False,1.0,0,0,0,0,0,0,0,0,1,0,1,0,0,0,1,0,0
401488010,Army Black Knights,S. McNaughton,4704694,,False,27.0,3,9,2,7,1,2,1,2,2,1,3,5,0,0,0,0,8
401488010,Army Black Knights,N. Rhine,4595464,,False,20.0,2,5,0,0,2,5,2,2,0,1,1,0,0,0,0,2,8
401488010,Army Black Knights,TEAM,TOTAL,TOTAL,False,,22,58,14,42,8,16,14,20,16,17,33,13,4,1,10,23,66
401488009,Loyola Maryland Greyhounds,L. Therien,4900552,,True,35.0,9,15,9,15,0,0,6,7,3,8,11,1,3,1,2,5,24
401488009,Loyola Maryland Greyhounds,K. Ratigan,5109222,,True,36.0,3,7,1,4,2,3,0,0,0,3,3,5,0,0,1,5,8
401488009,Loyola Maryland Greyhounds,B. Rozzi,4596306,,True,21.0,0,2,0,1,0,1,0,0,1,1,2,2,0,0,0,1,0
401488009,Loyola Maryland Greyhounds,T. Dixon,4400209,,True,34.0,5,14,5,11,0,3,8,11,0,0,0,0,1,0,2,2,18
401488009,Loyola Maryland Greyhounds,D. Newman,4399474,,True,33.0,3,11,3,11,0,0,2,2,1,3,4,1,0,0,3,1,8
401488009,Loyola Maryland Greyhounds,M. Espinal,5109228,,False,6.0,0,1,0,1,0,0,0,0,0,1,1,0,0,0,3,1,0
401488009,Loyola Maryland Greyhounds,C. Garcia,5109224,,False,1.0,0,1,0,0,0,1,0,0,0,0,0,0,1,0,0,0,0
401488009,Loyola Maryland Greyhounds,M. Van-Otoo,5109223,,False,19.0,3,5,2,4,1,1,3,3,2,1,3,0,0,1,1,4,10
401488009,Loyola Maryland Greyhounds,L. Salmeron,4900549,,False,9.0,0,0,0,0,0,0,0,0,0,0,0,1,0,0,0,1,0
401488009,Loyola Maryland Greyhounds,C. Tanedo,4704774,,False,6.0,0,0,0,0,0,0,0,0,0,0,0,0,0,0,0,1,0
401488009,Loyola Maryland Greyhounds,TEAM,TOTAL,TOTAL,False,,23,56,20,47,3,9,19,23,10,19,29,10,5,2,12,21,68
401488009,Loyola Maryland Greyhounds,L. Therien,4900552,,True,35.0,9,15,9,15,0,0,6,7,3,8,11,1,3,1,2,5,24
401488009,Loyola Maryland Greyhounds,K. Ratigan,5109222,,True,36.0,3,7,1,4,2,3,0,0,0,3,3,5,0,0,1,5,8
401488009,Loyola Maryland Greyhounds,B. Rozzi,4596306,,True,21.0,0,2,0,1,0,1,0,0,1,1,2,2,0,0,0,1,0
401488009,Loyola Maryland Greyhounds,T. Dixon,4400209,,True,34.0,5,14,5,11,0,3,8,11,0,0,0,0,1,0,2,2,18
401488009,Loyola Maryland Greyhounds,D. Newman,4399474,,True,33.0,3,11,3,11,0,0,2,2,1,3,4,1,0,0,3,1,8
401488009,Loyola Maryland Greyhounds,M. Espinal,5109228,,False,6.0,0,1,0,1,0,0,0,0,0,1,1,0,0,0,3,1,0
401488009,Loyola Maryland Greyhounds,C. Garcia,5109224,,False,1.0,0,1,0,0,0,1,0,0,0,0,0,0,1,0,0,0,0
401488009,Loyola Maryland Greyhounds,M. Van-Otoo,5109223,,False,19.0,3,5,2,4,1,1,3,3,2,1,3,0,0,1,1,4,10
401488009,Loyola Maryland Greyhounds,L. Salmeron,4900549,,False,9.0,0,0,0,0,0,0,0,0,0,0,0,1,0,0,0,1,0
401488009,Loyola Maryland Greyhounds,C. Tanedo,4704774,,False,6.0,0,0,0,0,0,0,0,0,0,0,0,0,0,0,0,1,0
401488009,Loyola Maryland Greyhounds,TEAM,TOTAL,TOTAL,False,,23,56,20,47,3,9,19,23,10,19,29,10,5,2,12,21,68
401488009,Army Black Knights,S. Hunter,4595466,,True,33.0,12,16,12,16,0,0,8,8,5,9,14,0,0,2,2,4,32
401488009,Army Black Knights,K. Hall,4595465,,True,27.0,0,3,0,3,0,0,0,2,2,4,6,8,1,4,2,4,0
401488009,Army Black Knights,R. Ericson,5109190,,True,32.0,3,9,2,6,1,3,2,2,0,2,2,3,0,0,3,0,9
401488009,Army Black Knights,L. Lithgow,4704696,,True,24.0,4,12,1,2,3,10,0,0,1,0,1,0,0,0,3,1,11
401488009,Army Black Knights,H. Brown,4595467,,True,27.0,2,5,2,5,0,0,2,2,4,3,7,1,2,0,1,5,6
401488009,Army Black Knights,C. Richman,5109191,,False,2.0,0,1,0,0,0,1,0,0,0,1,1,0,0,0,0,0,0
401488009,Army Black Knights,T. Hardy,4899714,,False,18.0,5,7,4,5,1,2,3,4,3,1,4,1,1,0,0,0,14
401488009,Army Black Knights,S. McNaughton,4704694,,False,18.0,2,6,1,3,1,3,0,0,0,2,2,2,0,1,1,0,5
401488009,Army Black Knights,N. Rhine,4595464,,False,19.0,2,7,0,1,2,6,0,0,0,1,1,2,0,0,0,4,6
401488009,Army Black Knights,TEAM,TOTAL,TOTAL,False,,30,66,22,41,8,25,15,18,17,25,42,17,4,7,12,18,83
401488009,Army Black Knights,S. Hunter,4595466,,True,33.0,12,16,12,16,0,0,8,8,5,9,14,0,0,2,2,4,32
401488009,Army Black Knights,K. Hall,4595465,,True,27.0,0,3,0,3,0,0,0,2,2,4,6,8,1,4,2,4,0
401488009,Army Black Knights,R. Ericson,5109190,,True,32.0,3,9,2,6,1,3,2,2,0,2,2,3,0,0,3,0,9
401488009,Army Black Knights,L. Lithgow,4704696,,True,24.0,4,12,1,2,3,10,0,0,1,0,1,0,0,0,3,1,11
401488009,Army Black Knights,H. Brown,4595467,,True,27.0,2,5,2,5,0,0,2,2,4,3,7,1,2,0,1,5,6
401488009,Army Black Knights,C. Richman,5109191,,False,2.0,0,1,0,0,0,1,0,0,0,1,1,0,0,0,0,0,0
401488009,Army Black Knights,T. Hardy,4899714,,False,18.0,5,7,4,5,1,2,3,4,3,1,4,1,1,0,0,0,14
401488009,Army Black Knights,S. McNaughton,4704694,,False,18.0,2,6,1,3,1,3,0,0,0,2,2,2,0,1,1,0,5
401488009,Army Black Knights,N. Rhine,4595464,,False,19.0,2,7,0,1,2,6,0,0,0,1,1,2,0,0,0,4,6
401488009,Army Black Knights,TEAM,TOTAL,TOTAL,False,,30,66,22,41,8,25,15,18,17,25,42,17,4,7,12,18,83
401488008,Bucknell Bison,I. King,4900533,,True,36.0,5,9,3,6,2,3,7,9,1,5,6,0,1,0,2,1,19
401488008,Bucknell Bison,E. Shaffer,4595535,,True,24.0,2,9,2,9,0,0,1,2,5,10,15,1,2,0,2,3,5
401488008,Bucknell Bison,E. Theodorsson,5109199,,True,22.0,2,3,2,2,0,1,2,2,0,2,2,2,1,0,3,2,6
401488008,Bucknell Bison,T. Johnson,4595533,,True,31.0,2,7,1,4,1,3,7,7,0,3,3,0,0,0,2,2,12
401488008,Bucknell Bison,C. Dingler,4577540,,True,16.0,1,2,1,2,0,0,0,0,0,1,1,0,0,0,0,0,2
401488008,Bucknell Bison,G. Sullivan,5109201,,False,16.0,1,3,1,3,0,0,0,0,0,1,1,2,0,0,3,3,2
401488008,Bucknell Bison,R. Sisselman,4900531,,False,28.0,1,4,1,2,0,2,2,2,0,2,2,1,1,0,2,2,4
401488008,Bucknell Bison,C. Collins,4900532,,False,27.0,3,12,3,10,0,2,4,6,1,2,3,3,2,0,0,2,10
401488008,Bucknell Bison,TEAM,TOTAL,TOTAL,False,,17,49,14,38,3,11,23,28,7,26,33,9,7,0,14,15,60
401488008,Bucknell Bison,I. King,4900533,,True,36.0,5,9,3,6,2,3,7,9,1,5,6,0,1,0,2,1,19
401488008,Bucknell Bison,E. Shaffer,4595535,,True,24.0,2,9,2,9,0,0,1,2,5,10,15,1,2,0,2,3,5
401488008,Bucknell Bison,E. Theodorsson,5109199,,True,22.0,2,3,2,2,0,1,2,2,0,2,2,2,1,0,3,2,6
401488008,Bucknell Bison,T. Johnson,4595533,,True,31.0,2,7,1,4,1,3,7,7,0,3,3,0,0,0,2,2,12
401488008,Bucknell Bison,C. Dingler,4577540,,True,16.0,1,2,1,2,0,0,0,0,0,1,1,0,0,0,0,0,2
401488008,Bucknell Bison,G. Sullivan,5109201,,False,16.0,1,3,1,3,0,0,0,0,0,1,1,2,0,0,3,3,2
401488008,Bucknell Bison,R. Sisselman,4900531,,False,28.0,1,4,1,2,0,2,2,2,0,2,2,1,1,0,2,2,4
401488008,Bucknell Bison,C. Collins,4900532,,False,27.0,3,12,3,10,0,2,4,6,1,2,3,3,2,0,0,2,10
401488008,Bucknell Bison,TEAM,TOTAL,TOTAL,False,,17,49,14,38,3,11,23,28,7,26,33,9,7,0,14,15,60
401488008,Army Black Knights,S. Hunter,4595466,,True,32.0,3,5,3,5,0,0,2,4,4,11,15,0,4,1,5,4,8
401488008,Army Black Knights,K. Hall,4595465,,True,29.0,5,14,5,10,0,4,3,5,1,3,4,2,0,0,5,4,13
401488008,Army Black Knights,R. Ericson,5109190,,True,37.0,9,18,8,11,1,7,1,1,2,4,6,2,0,0,4,3,20
401488008,Army Black Knights,L. Lithgow,4704696,,True,25.0,1,4,0,1,1,3,0,0,0,0,0,0,0,0,1,5,3
401488008,Army Black Knights,H. Brown,4595467,,True,23.0,1,6,1,4,0,2,0,0,0,3,3,0,1,0,1,4,2
401488008,Army Black Knights,L. Madison,5109194,,False,2.0,0,0,0,0,0,0,0,0,0,0,0,0,0,0,0,0,0
401488008,Army Black Knights,C. Richman,5109191,,False,2.0,0,1,0,0,0,1,0,0,0,0,0,0,0,0,0,1,0
401488008,Army Black Knights,T. Hardy,4899714,,False,14.0,1,4,1,2,0,2,0,0,0,1,1,0,0,1,0,0,2
401488008,Army Black Knights,S. McNaughton,4704694,,False,20.0,0,2,0,1,0,1,0,0,1,3,4,1,1,0,0,1,0
401488008,Army Black Knights,N. Rhine,4595464,,False,16.0,1,2,1,2,0,0,0,0,0,0,0,0,1,0,1,2,2
401488008,Army Black Knights,TEAM,TOTAL,TOTAL,False,,21,56,19,36,2,20,6,10,8,25,33,5,7,2,17,24,50
401488008,Army Black Knights,S. Hunter,4595466,,True,32.0,3,5,3,5,0,0,2,4,4,11,15,0,4,1,5,4,8
401488008,Army Black Knights,K. Hall,4595465,,True,29.0,5,14,5,10,0,4,3,5,1,3,4,2,0,0,5,4,13
401488008,Army Black Knights,R. Ericson,5109190,,True,37.0,9,18,8,11,1,7,1,1,2,4,6,2,0,0,4,3,20
401488008,Army Black Knights,L. Lithgow,4704696,,True,25.0,1,4,0,1,1,3,0,0,0,0,0,0,0,0,1,5,3
401488008,Army Black Knights,H. Brown,4595467,,True,23.0,1,6,1,4,0,2,0,0,0,3,3,0,1,0,1,4,2
401488008,Army Black Knights,L. Madison,5109194,,False,2.0,0,0,0,0,0,0,0,0,0,0,0,0,0,0,0,0,0
401488008,Army Black Knights,C. Richman,5109191,,False,2.0,0,1,0,0,0,1,0,0,0,0,0,0,0,0,0,1,0
401488008,Army Black Knights,T. Hardy,4899714,,False,14.0,1,4,1,2,0,2,0,0,0,1,1,0,0,1,0,0,2
401488008,Army Black Knights,S. McNaughton,4704694,,False,20.0,0,2,0,1,0,1,0,0,1,3,4,1,1,0,0,1,0
401488008,Army Black Knights,N. Rhine,4595464,,False,16.0,1,2,1,2,0,0,0,0,0,0,0,0,1,0,1,2,2
401488008,Army Black Knights,TEAM,TOTAL,TOTAL,False,,21,56,19,36,2,20,6,10,8,25,33,5,7,2,17,24,50
401488007,Holy Cross Crusaders,L. Berger,4900539,,True,29.0,2,3,2,3,0,0,10,12,3,5,8,2,0,1,2,4,14
401488007,Holy Cross Crusaders,K. Flanagan,5109211,,True,32.0,2,4,2,3,0,1,6,8,2,4,6,2,0,0,2,3,10
401488007,Holy Cross Crusaders,C. McCormack,4704716,,True,31.0,5,19,4,10,1,9,0,0,0,1,1,3,0,0,1,1,11
401488007,Holy Cross Crusaders,B. Power-Cassidy,4704715,,True,34.0,8,15,6,9,2,6,0,0,2,5,7,1,0,0,1,2,18
401488007,Holy Cross Crusaders,A. Cross,4595975,,True,30.0,4,8,3,6,1,2,0,0,1,2,3,0,1,0,3,1,9
401488007,Holy Cross Crusaders,C. Wright,4703660,,False,11.0,0,5,0,5,0,0,0,0,3,1,4,1,0,2,0,4,0
401488007,Holy Cross Crusaders,M. Donnelly,5109213,,False,13.0,0,3,0,1,0,2,0,0,0,3,3,1,0,0,1,1,0
401488007,Holy Cross Crusaders,S. Foreman,5109212,,False,15.0,2,5,2,5,0,0,0,0,3,2,5,1,0,0,0,1,4
401488007,Holy Cross Crusaders,G. Munt,4900537,,False,5.0,0,0,0,0,0,0,0,0,0,0,0,0,0,0,0,0,0
401488007,Holy Cross Crusaders,TEAM,TOTAL,TOTAL,False,,23,62,19,42,4,20,16,20,17,25,42,11,1,3,11,17,66
401488007,Holy Cross Crusaders,L. Berger,4900539,,True,29.0,2,3,2,3,0,0,10,12,3,5,8,2,0,1,2,4,14
401488007,Holy Cross Crusaders,K. Flanagan,5109211,,True,32.0,2,4,2,3,0,1,6,8,2,4,6,2,0,0,2,3,10
401488007,Holy Cross Crusaders,C. McCormack,4704716,,True,31.0,5,19,4,10,1,9,0,0,0,1,1,3,0,0,1,1,11
401488007,Holy Cross Crusaders,B. Power-Cassidy,4704715,,True,34.0,8,15,6,9,2,6,0,0,2,5,7,1,0,0,1,2,18
401488007,Holy Cross Crusaders,A. Cross,4595975,,True,30.0,4,8,3,6,1,2,0,0,1,2,3,0,1,0,3,1,9
401488007,Holy Cross Crusaders,C. Wright,4703660,,False,11.0,0,5,0,5,0,0,0,0,3,1,4,1,0,2,0,4,0
401488007,Holy Cross Crusaders,M. Donnelly,5109213,,False,13.0,0,3,0,1,0,2,0,0,0,3,3,1,0,0,1,1,0
401488007,Holy Cross Crusaders,S. Foreman,5109212,,False,15.0,2,5,2,5,0,0,0,0,3,2,5,1,0,0,0,1,4
401488007,Holy Cross Crusaders,G. Munt,4900537,,False,5.0,0,0,0,0,0,0,0,0,0,0,0,0,0,0,0,0,0
401488007,Holy Cross Crusaders,TEAM,TOTAL,TOTAL,False,,23,62,19,42,4,20,16,20,17,25,42,11,1,3,11,17,66
401488007,Army Black Knights,S. Hunter,4595466,,True,33.0,7,11,7,11,0,0,3,7,1,12,13,0,2,3,1,5,17
401488007,Army Black Knights,K. Hall,4595465,,True,20.0,1,8,1,7,0,1,2,2,3,2,5,1,1,2,1,4,4
401488007,Army Black Knights,R. Ericson,5109190,,True,36.0,6,12,6,10,0,2,6,6,1,2,3,4,0,0,0,2,18
401488007,Army Black Knights,L. Lithgow,4704696,,True,32.0,3,5,1,1,2,4,2,2,0,1,1,0,1,0,1,2,10
401488007,Army Black Knights,H. Brown,4595467,,True,31.0,4,12,4,8,0,4,0,0,1,1,2,0,1,0,0,3,8
401488007,Army Black Knights,C. Richman,5109191,,False,2.0,0,0,0,0,0,0,0,0,0,0,0,0,0,0,0,0,0
401488007,Army Black Knights,T. Hardy,4899714,,False,10.0,2,3,0,1,2,2,0,0,0,1,1,0,1,0,2,3,6
401488007,Army Black Knights,S. McNaughton,4704694,,False,14.0,2,4,2,3,0,1,0,0,0,1,1,2,0,0,1,2,4
401488007,Army Black Knights,N. Rhine,4595464,,False,22.0,2,4,1,2,1,2,2,2,0,2,2,0,1,0,0,1,7
401488007,Army Black Knights,TEAM,TOTAL,TOTAL,False,,27,59,22,43,5,16,15,19,9,24,33,7,7,5,6,22,74
401488007,Army Black Knights,S. Hunter,4595466,,True,33.0,7,11,7,11,0,0,3,7,1,12,13,0,2,3,1,5,17
401488007,Army Black Knights,K. Hall,4595465,,True,20.0,1,8,1,7,0,1,2,2,3,2,5,1,1,2,1,4,4
401488007,Army Black Knights,R. Ericson,5109190,,True,36.0,6,12,6,10,0,2,6,6,1,2,3,4,0,0,0,2,18
401488007,Army Black Knights,L. Lithgow,4704696,,True,32.0,3,5,1,1,2,4,2,2,0,1,1,0,1,0,1,2,10
401488007,Army Black Knights,H. Brown,4595467,,True,31.0,4,12,4,8,0,4,0,0,1,1,2,0,1,0,0,3,8
401488007,Army Black Knights,C. Richman,5109191,,False,2.0,0,0,0,0,0,0,0,0,0,0,0,0,0,0,0,0,0
401488007,Army Black Knights,T. Hardy,4899714,,False,10.0,2,3,0,1,2,2,0,0,0,1,1,0,1,0,2,3,6
401488007,Army Black Knights,S. McNaughton,4704694,,False,14.0,2,4,2,3,0,1,0,0,0,1,1,2,0,0,1,2,4
401488007,Army Black Knights,N. Rhine,4595464,,False,22.0,2,4,1,2,1,2,2,2,0,2,2,0,1,0,0,1,7
401488007,Army Black Knights,TEAM,TOTAL,TOTAL,False,,27,59,22,43,5,16,15,19,9,24,33,7,7,5,6,22,74
401488006,Army Black Knights,S. Hunter,4595466,,True,36.0,5,7,5,7,0,0,8,10,4,10,14,0,2,1,3,3,18
401488006,Army Black Knights,K. Hall,4595465,,True,25.0,3,7,3,6,0,1,1,2,0,5,5,2,2,2,1,3,7
401488006,Army Black Knights,R. Ericson,5109190,,True,31.0,3,10,2,5,1,5,2,2,0,3,3,3,0,0,3,1,9
401488006,Army Black Knights,L. Lithgow,4704696,,True,38.0,4,8,2,3,2,5,0,0,0,0,0,0,2,0,1,3,10
401488006,Army Black Knights,S. McNaughton,4704694,,True,25.0,2,9,2,5,0,4,0,0,0,1,1,3,1,0,5,0,4
401488006,Army Black Knights,L. Madison,5109194,,False,1.0,0,0,0,0,0,0,0,0,0,0,0,0,0,0,0,0,0
401488006,Army Black Knights,C. Richman,5109191,,False,12.0,1,3,0,0,1,3,0,0,1,0,1,0,0,0,0,1,3
401488006,Army Black Knights,T. Hardy,4899714,,False,5.0,0,0,0,0,0,0,0,0,0,0,0,2,1,0,1,2,0
401488006,Army Black Knights,H. Brown,4595467,,False,22.0,3,6,1,3,2,3,1,3,1,1,2,1,0,0,1,0,9
401488006,Army Black Knights,N. Rhine,4595464,,False,5.0,1,3,0,1,1,2,0,0,0,0,0,0,2,0,1,0,3
401488006,Army Black Knights,TEAM,TOTAL,TOTAL,False,,22,53,15,30,7,23,12,17,6,20,26,11,10,3,16,13,63
401488006,Army Black Knights,S. Hunter,4595466,,True,36.0,5,7,5,7,0,0,8,10,4,10,14,0,2,1,3,3,18
401488006,Army Black Knights,K. Hall,4595465,,True,25.0,3,7,3,6,0,1,1,2,0,5,5,2,2,2,1,3,7
401488006,Army Black Knights,R. Ericson,5109190,,True,31.0,3,10,2,5,1,5,2,2,0,3,3,3,0,0,3,1,9
401488006,Army Black Knights,L. Lithgow,4704696,,True,38.0,4,8,2,3,2,5,0,0,0,0,0,0,2,0,1,3,10
401488006,Army Black Knights,S. McNaughton,4704694,,True,25.0,2,9,2,5,0,4,0,0,0,1,1,3,1,0,5,0,4
401488006,Army Black Knights,L. Madison,5109194,,False,1.0,0,0,0,0,0,0,0,0,0,0,0,0,0,0,0,0,0
401488006,Army Black Knights,C. Richman,5109191,,False,12.0,1,3,0,0,1,3,0,0,1,0,1,0,0,0,0,1,3
401488006,Army Black Knights,T. Hardy,4899714,,False,5.0,0,0,0,0,0,0,0,0,0,0,0,2,1,0,1,2,0
401488006,Army Black Knights,H. Brown,4595467,,False,22.0,3,6,1,3,2,3,1,3,1,1,2,1,0,0,1,0,9
401488006,Army Black Knights,N. Rhine,4595464,,False,5.0,1,3,0,1,1,2,0,0,0,0,0,0,2,0,1,0,3
401488006,Army Black Knights,TEAM,TOTAL,TOTAL,False,,22,53,15,30,7,23,12,17,6,20,26,11,10,3,16,13,63
401488006,American University Eagles,E. Johns,4704688,,True,22.0,2,7,2,5,0,2,2,2,0,1,1,2,2,0,2,1,6
401488006,American University Eagles,L. Stack,4595455,,True,27.0,4,11,4,11,0,0,1,1,0,5,5,1,1,1,3,4,9
401488006,American University Eagles,K. Henning,4704686,,True,21.0,2,4,2,4,0,0,0,0,0,1,1,2,0,0,5,1,4
401488006,American University Eagles,I. Bales,4704685,,True,31.0,7,9,5,7,2,2,0,0,2,8,10,3,3,1,4,1,16
401488006,American University Eagles,S. Stetson,4595453,,True,28.0,4,6,4,5,0,1,0,0,2,1,3,3,1,1,4,2,8
401488006,American University Eagles,M. Lavin,5109188,,False,23.0,2,7,1,4,1,3,0,0,0,7,7,1,0,0,1,3,5
401488006,American University Eagles,M. Lee,4704592,,False,1.0,0,0,0,0,0,0,0,0,0,0,0,0,0,0,0,0,0
401488006,American University Eagles,L. Nogues,5109187,,False,6.0,1,1,1,1,0,0,0,0,0,0,0,0,0,0,0,1,2
401488006,American University Eagles,A. Rescifina,5109186,,False,7.0,1,2,1,2,0,0,0,0,0,2,2,2,2,0,1,0,2
401488006,American University Eagles,B. Garbee,4899710,,False,8.0,2,3,2,3,0,0,0,0,1,0,1,0,1,0,1,1,4
401488006,American University Eagles,A. LeMaster,4703737,,False,26.0,2,7,0,2,2,5,0,0,1,1,2,2,0,0,0,1,6
401488006,American University Eagles,TEAM,TOTAL,TOTAL,False,,27,57,22,44,5,13,3,3,7,26,33,16,10,3,21,15,62
401488006,American University Eagles,E. Johns,4704688,,True,22.0,2,7,2,5,0,2,2,2,0,1,1,2,2,0,2,1,6
401488006,American University Eagles,L. Stack,4595455,,True,27.0,4,11,4,11,0,0,1,1,0,5,5,1,1,1,3,4,9
401488006,American University Eagles,K. Henning,4704686,,True,21.0,2,4,2,4,0,0,0,0,0,1,1,2,0,0,5,1,4
401488006,American University Eagles,I. Bales,4704685,,True,31.0,7,9,5,7,2,2,0,0,2,8,10,3,3,1,4,1,16
401488006,American University Eagles,S. Stetson,4595453,,True,28.0,4,6,4,5,0,1,0,0,2,1,3,3,1,1,4,2,8
401488006,American University Eagles,M. Lavin,5109188,,False,23.0,2,7,1,4,1,3,0,0,0,7,7,1,0,0,1,3,5
401488006,American University Eagles,M. Lee,4704592,,False,1.0,0,0,0,0,0,0,0,0,0,0,0,0,0,0,0,0,0
401488006,American University Eagles,L. Nogues,5109187,,False,6.0,1,1,1,1,0,0,0,0,0,0,0,0,0,0,0,1,2
401488006,American University Eagles,A. Rescifina,5109186,,False,7.0,1,2,1,2,0,0,0,0,0,2,2,2,2,0,1,0,2
401488006,American University Eagles,B. Garbee,4899710,,False,8.0,2,3,2,3,0,0,0,0,1,0,1,0,1,0,1,1,4
401488006,American University Eagles,A. LeMaster,4703737,,False,26.0,2,7,0,2,2,5,0,0,1,1,2,2,0,0,0,1,6
401488006,American University Eagles,TEAM,TOTAL,TOTAL,False,,27,57,22,44,5,13,3,3,7,26,33,16,10,3,21,15,62
401488005,Navy Midshipmen,M. Andrews,4704780,,True,34.0,2,4,2,4,0,0,1,2,3,4,7,0,5,0,4,4,5
401488005,Navy Midshipmen,K. Samson,5109237,,True,10.0,1,2,1,2,0,0,0,0,1,1,2,0,0,1,0,3,2
401488005,Navy Midshipmen,S. Watts,4704782,,True,40.0,4,11,4,10,0,1,0,1,0,2,2,0,0,0,3,4,8
401488005,Navy Midshipmen,M. Louridas,5109236,,True,36.0,6,15,4,9,2,6,6,8,0,9,9,4,1,1,4,4,20
401488005,Navy Midshipmen,M. Schrader,4595622,,True,36.0,2,9,1,5,1,4,2,2,0,1,1,3,0,0,4,2,7
401488005,Navy Midshipmen,M. Demos,5109235,,False,0.0,0,0,0,0,0,0,0,0,0,0,0,0,0,0,0,1,0
401488005,Navy Midshipmen,G. Pissott,5109232,,False,15.0,2,4,2,4,0,0,0,0,3,2,5,1,1,0,1,1,4
401488005,Navy Midshipmen,L. Llewellyn,4595625,,False,28.0,6,14,4,9,2,5,1,2,1,1,2,2,0,1,1,4,15
401488005,Navy Midshipmen,K. Giuliani,5109230,,False,1.0,0,0,0,0,0,0,0,0,0,0,0,0,0,0,0,0,0
401488005,Navy Midshipmen,TEAM,TOTAL,TOTAL,False,,23,59,18,43,5,16,10,15,8,20,28,10,7,3,18,23,61
401488005,Navy Midshipmen,M. Andrews,4704780,,True,34.0,2,4,2,4,0,0,1,2,3,4,7,0,5,0,4,4,5
401488005,Navy Midshipmen,K. Samson,5109237,,True,10.0,1,2,1,2,0,0,0,0,1,1,2,0,0,1,0,3,2
401488005,Navy Midshipmen,S. Watts,4704782,,True,40.0,4,11,4,10,0,1,0,1,0,2,2,0,0,0,3,4,8
401488005,Navy Midshipmen,M. Louridas,5109236,,True,36.0,6,15,4,9,2,6,6,8,0,9,9,4,1,1,4,4,20
401488005,Navy Midshipmen,M. Schrader,4595622,,True,36.0,2,9,1,5,1,4,2,2,0,1,1,3,0,0,4,2,7
401488005,Navy Midshipmen,M. Demos,5109235,,False,0.0,0,0,0,0,0,0,0,0,0,0,0,0,0,0,0,1,0
401488005,Navy Midshipmen,G. Pissott,5109232,,False,15.0,2,4,2,4,0,0,0,0,3,2,5,1,1,0,1,1,4
401488005,Navy Midshipmen,L. Llewellyn,4595625,,False,28.0,6,14,4,9,2,5,1,2,1,1,2,2,0,1,1,4,15
401488005,Navy Midshipmen,K. Giuliani,5109230,,False,1.0,0,0,0,0,0,0,0,0,0,0,0,0,0,0,0,0,0
401488005,Navy Midshipmen,TEAM,TOTAL,TOTAL,False,,23,59,18,43,5,16,10,15,8,20,28,10,7,3,18,23,61
401488005,Army Black Knights,S. Hunter,4595466,,True,36.0,9,16,9,16,0,0,5,8,7,10,17,0,2,0,2,2,23
401488005,Army Black Knights,K. Hall,4595465,,True,36.0,3,11,3,10,0,1,2,3,3,7,10,4,2,3,3,1,8
401488005,Army Black Knights,L. Lithgow,4704696,,True,22.0,1,3,0,0,1,3,2,2,0,0,0,1,1,0,0,4,5
401488005,Army Black Knights,S. McNaughton,4704694,,True,34.0,4,8,3,6,1,2,1,2,0,6,6,3,0,0,4,2,10
401488005,Army Black Knights,H. Brown,4595467,,True,24.0,1,1,1,1,0,0,0,0,1,1,2,0,0,0,1,5,2
401488005,Army Black Knights,L. Madison,5109194,,False,1.0,0,0,0,0,0,0,0,0,0,0,0,0,0,0,0,0,0
401488005,Army Black Knights,C. Richman,5109191,,False,2.0,0,0,0,0,0,0,0,0,0,2,2,0,0,0,1,0,0
401488005,Army Black Knights,R. Ericson,5109190,,False,30.0,8,15,7,10,1,5,7,8,0,1,1,1,0,0,3,4,24
401488005,Army Black Knights,T. Hardy,4899714,,False,6.0,1,3,1,2,0,1,1,2,0,0,0,0,0,0,1,0,3
401488005,Army Black Knights,J. Strippoli,4595470,,False,1.0,0,0,0,0,0,0,0,0,1,0,1,0,0,0,0,0,0
401488005,Army Black Knights,N. Rhine,4595464,,False,8.0,0,2,0,0,0,2,0,0,0,1,1,0,1,0,0,0,0
401488005,Army Black Knights,TEAM,TOTAL,TOTAL,False,,27,59,24,45,3,14,18,25,12,28,40,9,6,3,17,18,75
401488005,Army Black Knights,S. Hunter,4595466,,True,36.0,9,16,9,16,0,0,5,8,7,10,17,0,2,0,2,2,23
401488005,Army Black Knights,K. Hall,4595465,,True,36.0,3,11,3,10,0,1,2,3,3,7,10,4,2,3,3,1,8
401488005,Army Black Knights,L. Lithgow,4704696,,True,22.0,1,3,0,0,1,3,2,2,0,0,0,1,1,0,0,4,5
401488005,Army Black Knights,S. McNaughton,4704694,,True,34.0,4,8,3,6,1,2,1,2,0,6,6,3,0,0,4,2,10
401488005,Army Black Knights,H. Brown,4595467,,True,24.0,1,1,1,1,0,0,0,0,1,1,2,0,0,0,1,5,2
401488005,Army Black Knights,L. Madison,5109194,,False,1.0,0,0,0,0,0,0,0,0,0,0,0,0,0,0,0,0,0
401488005,Army Black Knights,C. Richman,5109191,,False,2.0,0,0,0,0,0,0,0,0,0,2,2,0,0,0,1,0,0
401488005,Army Black Knights,R. Ericson,5109190,,False,30.0,8,15,7,10,1,5,7,8,0,1,1,1,0,0,3,4,24
401488005,Army Black Knights,T. Hardy,4899714,,False,6.0,1,3,1,2,0,1,1,2,0,0,0,0,0,0,1,0,3
401488005,Army Black Knights,J. Strippoli,4595470,,False,1.0,0,0,0,0,0,0,0,0,1,0,1,0,0,0,0,0,0
401488005,Army Black Knights,N. Rhine,4595464,,False,8.0,0,2,0,0,0,2,0,0,0,1,1,0,1,0,0,0,0
401488005,Army Black Knights,TEAM,TOTAL,TOTAL,False,,27,59,24,45,3,14,18,25,12,28,40,9,6,3,17,18,75
401488004,Bucknell Bison,I. King,4900533,,True,34.0,1,5,1,2,0,3,0,0,1,2,3,0,2,0,1,2,2
401488004,Bucknell Bison,E. Shaffer,4595535,,True,30.0,7,14,7,14,0,0,1,5,5,10,15,2,1,2,4,1,15
401488004,Bucknell Bison,E. Theodorsson,5109199,,True,29.0,1,3,1,2,0,1,1,2,0,7,7,0,0,1,4,4,3
401488004,Bucknell Bison,T. Johnson,4595533,,True,40.0,4,14,4,13,0,1,3,4,0,2,2,4,0,0,4,3,11
401488004,Bucknell Bison,C. Dingler,4577540,,True,30.0,2,7,2,6,0,1,0,0,1,3,4,0,0,1,3,0,4
401488004,Bucknell Bison,G. Sullivan,5109201,,False,10.0,2,2,2,2,0,0,1,2,1,4,5,0,0,1,3,1,5
401488004,Bucknell Bison,R. Sisselman,4900531,,False,21.0,1,3,1,1,0,2,1,2,0,2,2,1,1,0,2,1,3
401488004,Bucknell Bison,J. Kulesza,4704702,,False,6.0,0,1,0,1,0,0,0,0,0,0,0,0,0,0,0,0,0
401488004,Bucknell Bison,TEAM,TOTAL,TOTAL,False,,18,49,18,41,0,8,7,15,9,33,42,7,4,5,22,12,43
401488004,Bucknell Bison,I. King,4900533,,True,34.0,1,5,1,2,0,3,0,0,1,2,3,0,2,0,1,2,2
401488004,Bucknell Bison,E. Shaffer,4595535,,True,30.0,7,14,7,14,0,0,1,5,5,10,15,2,1,2,4,1,15
401488004,Bucknell Bison,E. Theodorsson,5109199,,True,29.0,1,3,1,2,0,1,1,2,0,7,7,0,0,1,4,4,3
401488004,Bucknell Bison,T. Johnson,4595533,,True,40.0,4,14,4,13,0,1,3,4,0,2,2,4,0,0,4,3,11
401488004,Bucknell Bison,C. Dingler,4577540,,True,30.0,2,7,2,6,0,1,0,0,1,3,4,0,0,1,3,0,4
401488004,Bucknell Bison,G. Sullivan,5109201,,False,10.0,2,2,2,2,0,0,1,2,1,4,5,0,0,1,3,1,5
401488004,Bucknell Bison,R. Sisselman,4900531,,False,21.0,1,3,1,1,0,2,1,2,0,2,2,1,1,0,2,1,3
401488004,Bucknell Bison,J. Kulesza,4704702,,False,6.0,0,1,0,1,0,0,0,0,0,0,0,0,0,0,0,0,0
401488004,Bucknell Bison,TEAM,TOTAL,TOTAL,False,,18,49,18,41,0,8,7,15,9,33,42,7,4,5,22,12,43
401488004,Army Black Knights,S. Hunter,4595466,,True,32.0,4,11,4,11,0,0,2,4,2,11,13,1,4,1,0,4,10
401488004,Army Black Knights,K. Hall,4595465,,True,35.0,7,17,6,14,1,3,2,2,4,1,5,2,1,3,3,2,17
401488004,Army Black Knights,T. Hardy,4899714,,True,12.0,1,7,1,6,0,1,0,0,1,0,1,0,1,0,3,1,2
401488004,Army Black Knights,L. Lithgow,4704696,,True,30.0,1,7,0,2,1,5,2,3,0,1,1,0,2,0,0,2,5
401488004,Army Black Knights,S. McNaughton,4704694,,True,29.0,1,4,1,4,0,0,3,4,0,2,2,1,0,0,0,0,5
401488004,Army Black Knights,C. Richman,5109191,,False,11.0,1,4,0,0,1,4,0,0,1,2,3,0,0,0,0,0,3
401488004,Army Black Knights,R. Ericson,5109190,,False,28.0,2,7,2,3,0,4,1,2,0,2,2,3,1,0,3,2,5
401488004,Army Black Knights,H. Brown,4595467,,False,11.0,0,1,0,0,0,1,0,0,1,2,3,0,0,0,2,0,0
401488004,Army Black Knights,N. Rhine,4595464,,False,12.0,2,3,1,2,1,1,0,0,1,2,3,0,0,0,0,4,5
401488004,Army Black Knights,TEAM,TOTAL,TOTAL,False,,19,61,15,42,4,19,10,15,11,24,35,7,9,4,11,15,52
401488004,Army Black Knights,S. Hunter,4595466,,True,32.0,4,11,4,11,0,0,2,4,2,11,13,1,4,1,0,4,10
401488004,Army Black Knights,K. Hall,4595465,,True,35.0,7,17,6,14,1,3,2,2,4,1,5,2,1,3,3,2,17
401488004,Army Black Knights,T. Hardy,4899714,,True,12.0,1,7,1,6,0,1,0,0,1,0,1,0,1,0,3,1,2
401488004,Army Black Knights,L. Lithgow,4704696,,True,30.0,1,7,0,2,1,5,2,3,0,1,1,0,2,0,0,2,5
401488004,Army Black Knights,S. McNaughton,4704694,,True,29.0,1,4,1,4,0,0,3,4,0,2,2,1,0,0,0,0,5
401488004,Army Black Knights,C. Richman,5109191,,False,11.0,1,4,0,0,1,4,0,0,1,2,3,0,0,0,0,0,3
401488004,Army Black Knights,R. Ericson,5109190,,False,28.0,2,7,2,3,0,4,1,2,0,2,2,3,1,0,3,2,5
401488004,Army Black Knights,H. Brown,4595467,,False,11.0,0,1,0,0,0,1,0,0,1,2,3,0,0,0,2,0,0
401488004,Army Black Knights,N. Rhine,4595464,,False,12.0,2,3,1,2,1,1,0,0,1,2,3,0,0,0,0,4,5
401488004,Army Black Knights,TEAM,TOTAL,TOTAL,False,,19,61,15,42,4,19,10,15,11,24,35,7,9,4,11,15,52
401488003,Boston University Terriers,S. Crispe,5109197,,True,23.0,4,9,4,7,0,2,0,0,2,3,5,3,0,1,2,1,8
401488003,Boston University Terriers,M. Durant,4599732,,True,17.0,3,5,3,5,0,0,1,2,1,5,6,0,0,2,0,4,7
401488003,Boston University Terriers,A. Giannaros,4899717,,True,26.0,5,9,5,6,0,3,1,2,1,0,1,1,1,0,2,1,11
401488003,Boston University Terriers,M. Pina,4599731,,True,31.0,2,4,1,2,1,2,0,0,0,5,5,1,0,0,1,2,5
401488003,Boston University Terriers,S. Johnson,4599729,,True,32.0,6,11,5,9,1,2,1,2,1,5,6,3,3,1,1,1,14
401488003,Boston University Terriers,C. Weimar,4704495,,False,30.0,4,11,4,11,0,0,4,7,1,6,7,2,0,4,5,2,12
401488003,Boston University Terriers,L. Davenport,4899718,,False,22.0,5,6,4,5,1,1,0,0,1,5,6,1,0,1,0,1,11
401488003,Boston University Terriers,S. Beneventine,4704699,,False,14.0,0,0,0,0,0,0,0,0,0,2,2,2,0,0,2,0,0
401488003,Boston University Terriers,L. Shean,4599727,,False,5.0,0,0,0,0,0,0,0,0,0,0,0,0,0,0,0,0,0
401488003,Boston University Terriers,TEAM,TOTAL,TOTAL,False,,29,55,26,45,3,10,7,13,7,31,38,13,4,9,13,12,68
401488003,Boston University Terriers,S. Crispe,5109197,,True,23.0,4,9,4,7,0,2,0,0,2,3,5,3,0,1,2,1,8
401488003,Boston University Terriers,M. Durant,4599732,,True,17.0,3,5,3,5,0,0,1,2,1,5,6,0,0,2,0,4,7
401488003,Boston University Terriers,A. Giannaros,4899717,,True,26.0,5,9,5,6,0,3,1,2,1,0,1,1,1,0,2,1,11
401488003,Boston University Terriers,M. Pina,4599731,,True,31.0,2,4,1,2,1,2,0,0,0,5,5,1,0,0,1,2,5
401488003,Boston University Terriers,S. Johnson,4599729,,True,32.0,6,11,5,9,1,2,1,2,1,5,6,3,3,1,1,1,14
401488003,Boston University Terriers,C. Weimar,4704495,,False,30.0,4,11,4,11,0,0,4,7,1,6,7,2,0,4,5,2,12
401488003,Boston University Terriers,L. Davenport,4899718,,False,22.0,5,6,4,5,1,1,0,0,1,5,6,1,0,1,0,1,11
401488003,Boston University Terriers,S. Beneventine,4704699,,False,14.0,0,0,0,0,0,0,0,0,0,2,2,2,0,0,2,0,0
401488003,Boston University Terriers,L. Shean,4599727,,False,5.0,0,0,0,0,0,0,0,0,0,0,0,0,0,0,0,0,0
401488003,Boston University Terriers,TEAM,TOTAL,TOTAL,False,,29,55,26,45,3,10,7,13,7,31,38,13,4,9,13,12,68
401488003,Army Black Knights,S. Hunter,4595466,,True,24.0,4,7,4,7,0,0,4,5,1,10,11,0,0,0,0,4,12
401488003,Army Black Knights,K. Hall,4595465,,True,29.0,6,18,5,15,1,3,0,2,1,3,4,2,1,2,0,2,13
401488003,Army Black Knights,T. Hardy,4899714,,True,16.0,1,3,1,2,0,1,0,2,1,1,2,1,0,0,2,1,2
401488003,Army Black Knights,L. Lithgow,4704696,,True,33.0,2,10,0,1,2,9,0,0,2,1,3,1,1,0,1,0,6
401488003,Army Black Knights,S. McNaughton,4704694,,True,26.0,1,8,1,6,0,2,0,0,0,0,0,1,0,0,2,1,2
401488003,Army Black Knights,L. Madison,5109194,,False,4.0,0,1,0,1,0,0,0,0,1,0,1,0,0,0,0,0,0
401488003,Army Black Knights,C. Richman,5109191,,False,13.0,0,2,0,0,0,2,0,0,1,2,3,0,0,0,1,0,0
401488003,Army Black Knights,R. Ericson,5109190,,False,23.0,2,6,0,2,2,4,3,3,1,1,2,5,1,0,2,4,9
401488003,Army Black Knights,V. Kearney,4899713,,False,3.0,0,0,0,0,0,0,0,0,0,0,0,0,0,0,0,1,0
401488003,Army Black Knights,H. Brown,4595467,,False,16.0,1,4,1,2,0,2,0,0,1,1,2,1,1,0,0,0,2
401488003,Army Black Knights,N. Rhine,4595464,,False,13.0,2,5,0,0,2,5,0,0,0,0,0,0,0,0,0,0,6
401488003,Army Black Knights,TEAM,TOTAL,TOTAL,False,,19,64,12,36,7,28,7,12,9,20,29,11,4,2,8,13,52
401488003,Army Black Knights,S. Hunter,4595466,,True,24.0,4,7,4,7,0,0,4,5,1,10,11,0,0,0,0,4,12
401488003,Army Black Knights,K. Hall,4595465,,True,29.0,6,18,5,15,1,3,0,2,1,3,4,2,1,2,0,2,13
401488003,Army Black Knights,T. Hardy,4899714,,True,16.0,1,3,1,2,0,1,0,2,1,1,2,1,0,0,2,1,2
401488003,Army Black Knights,L. Lithgow,4704696,,True,33.0,2,10,0,1,2,9,0,0,2,1,3,1,1,0,1,0,6
401488003,Army Black Knights,S. McNaughton,4704694,,True,26.0,1,8,1,6,0,2,0,0,0,0,0,1,0,0,2,1,2
401488003,Army Black Knights,L. Madison,5109194,,False,4.0,0,1,0,1,0,0,0,0,1,0,1,0,0,0,0,0,0
401488003,Army Black Knights,C. Richman,5109191,,False,13.0,0,2,0,0,0,2,0,0,1,2,3,0,0,0,1,0,0
401488003,Army Black Knights,R. Ericson,5109190,,False,23.0,2,6,0,2,2,4,3,3,1,1,2,5,1,0,2,4,9
401488003,Army Black Knights,V. Kearney,4899713,,False,3.0,0,0,0,0,0,0,0,0,0,0,0,0,0,0,0,1,0
401488003,Army Black Knights,H. Brown,4595467,,False,16.0,1,4,1,2,0,2,0,0,1,1,2,1,1,0,0,0,2
401488003,Army Black Knights,N. Rhine,4595464,,False,13.0,2,5,0,0,2,5,0,0,0,0,0,0,0,0,0,0,6
401488003,Army Black Knights,TEAM,TOTAL,TOTAL,False,,19,64,12,36,7,28,7,12,9,20,29,11,4,2,8,13,52
401488002,Army Black Knights,S. Hunter,4595466,,True,22.0,6,7,6,7,0,0,2,3,7,3,10,1,1,0,3,4,14
401488002,Army Black Knights,K. Hall,4595465,,True,18.0,1,6,0,4,1,2,0,0,1,4,5,1,0,0,1,4,3
401488002,Army Black Knights,S. McShea,5109195,,True,5.0,0,0,0,0,0,0,0,2,0,1,1,0,0,0,1,0,0
401488002,Army Black Knights,T. Hardy,4899714,,True,19.0,1,10,1,8,0,2,1,2,0,2,2,1,2,0,4,0,3
401488002,Army Black Knights,S. McNaughton,4704694,,True,22.0,2,6,1,3,1,3,1,2,0,1,1,3,0,0,0,1,6
401488002,Army Black Knights,L. Madison,5109194,,False,10.0,1,2,1,2,0,0,0,0,0,3,3,1,1,0,1,1,2
401488002,Army Black Knights,A. Ainsworth,5109189,,False,2.0,0,0,0,0,0,0,0,0,1,0,1,0,0,0,1,1,0
401488002,Army Black Knights,A. Stephens-Kirkman,5109192,,False,2.0,0,0,0,0,0,0,0,0,0,0,0,0,0,0,0,0,0
401488002,Army Black Knights,J. Laguna,5109193,,False,2.0,0,0,0,0,0,0,0,0,0,0,0,0,0,0,0,0,0
401488002,Army Black Knights,C. Richman,5109191,,False,17.0,2,7,0,0,2,7,0,0,2,1,3,0,0,0,0,2,6
401488002,Army Black Knights,R. Ericson,5109190,,False,30.0,7,10,4,5,3,5,3,3,1,3,4,10,1,0,3,3,20
401488002,Army Black Knights,L. Lithgow,4704696,,False,28.0,6,12,1,1,5,11,0,0,1,2,3,0,1,0,1,0,17
401488002,Army Black Knights,J. Strippoli,4595470,,False,2.0,0,0,0,0,0,0,0,0,0,0,0,0,1,0,1,0,0
401488002,Army Black Knights,H. Brown,4595467,,False,21.0,2,6,2,4,0,2,2,2,5,2,7,0,1,0,1,2,6
401488002,Army Black Knights,TEAM,TOTAL,TOTAL,False,,28,66,16,34,12,32,9,14,19,25,44,17,8,0,20,18,77
401488002,Army Black Knights,S. Hunter,4595466,,True,22.0,6,7,6,7,0,0,2,3,7,3,10,1,1,0,3,4,14
401488002,Army Black Knights,K. Hall,4595465,,True,18.0,1,6,0,4,1,2,0,0,1,4,5,1,0,0,1,4,3
401488002,Army Black Knights,S. McShea,5109195,,True,5.0,0,0,0,0,0,0,0,2,0,1,1,0,0,0,1,0,0
401488002,Army Black Knights,T. Hardy,4899714,,True,19.0,1,10,1,8,0,2,1,2,0,2,2,1,2,0,4,0,3
401488002,Army Black Knights,S. McNaughton,4704694,,True,22.0,2,6,1,3,1,3,1,2,0,1,1,3,0,0,0,1,6
401488002,Army Black Knights,L. Madison,5109194,,False,10.0,1,2,1,2,0,0,0,0,0,3,3,1,1,0,1,1,2
401488002,Army Black Knights,A. Ainsworth,5109189,,False,2.0,0,0,0,0,0,0,0,0,1,0,1,0,0,0,1,1,0
401488002,Army Black Knights,A. Stephens-Kirkman,5109192,,False,2.0,0,0,0,0,0,0,0,0,0,0,0,0,0,0,0,0,0
401488002,Army Black Knights,J. Laguna,5109193,,False,2.0,0,0,0,0,0,0,0,0,0,0,0,0,0,0,0,0,0
401488002,Army Black Knights,C. Richman,5109191,,False,17.0,2,7,0,0,2,7,0,0,2,1,3,0,0,0,0,2,6
401488002,Army Black Knights,R. Ericson,5109190,,False,30.0,7,10,4,5,3,5,3,3,1,3,4,10,1,0,3,3,20
401488002,Army Black Knights,L. Lithgow,4704696,,False,28.0,6,12,1,1,5,11,0,0,1,2,3,0,1,0,1,0,17
401488002,Army Black Knights,J. Strippoli,4595470,,False,2.0,0,0,0,0,0,0,0,0,0,0,0,0,1,0,1,0,0
401488002,Army Black Knights,H. Brown,4595467,,False,21.0,2,6,2,4,0,2,2,2,5,2,7,0,1,0,1,2,6
401488002,Army Black Knights,TEAM,TOTAL,TOTAL,False,,28,66,16,34,12,32,9,14,19,25,44,17,8,0,20,18,77
401488002,American University Eagles,E. Johns,4704688,,True,28.0,5,14,5,12,0,2,0,0,1,1,2,0,0,0,1,4,10
401488002,American University Eagles,L. Stack,4595455,,True,35.0,5,7,5,7,0,0,2,4,1,3,4,1,2,1,5,0,12
401488002,American University Eagles,I. Bales,4704685,,True,27.0,3,7,3,6,0,1,0,0,1,6,7,6,3,0,3,3,6
401488002,American University Eagles,A. LeMaster,4703737,,True,24.0,3,8,3,5,0,3,4,5,2,2,4,1,0,0,2,1,10
401488002,American University Eagles,S. Stetson,4595453,,True,13.0,1,3,1,2,0,1,0,0,0,1,1,1,1,1,1,2,2
401488002,American University Eagles,M. Lavin,5109188,,False,13.0,1,4,1,4,0,0,1,2,1,0,1,1,0,0,2,3,3
401488002,American University Eagles,M. Lee,4704592,,False,2.0,0,0,0,0,0,0,0,0,0,0,0,0,2,0,0,0,0
401488002,American University Eagles,L. Nogues,5109187,,False,6.0,2,3,2,2,0,1,0,0,0,0,0,0,0,0,3,1,4
401488002,American University Eagles,A. Rescifina,5109186,,False,10.0,1,1,1,1,0,0,0,0,0,1,1,0,1,0,0,0,2
401488002,American University Eagles,B. Garbee,4899710,,False,12.0,0,1,0,0,0,1,0,0,0,2,2,0,0,0,0,2,0
401488002,American University Eagles,K. Henning,4704686,,False,30.0,3,6,3,6,0,0,1,2,0,4,4,3,1,0,3,1,7
401488002,American University Eagles,TEAM,TOTAL,TOTAL,False,,24,54,24,45,0,9,8,13,6,22,28,13,10,2,20,17,56
401488002,American University Eagles,E. Johns,4704688,,True,28.0,5,14,5,12,0,2,0,0,1,1,2,0,0,0,1,4,10
401488002,American University Eagles,L. Stack,4595455,,True,35.0,5,7,5,7,0,0,2,4,1,3,4,1,2,1,5,0,12
401488002,American University Eagles,I. Bales,4704685,,True,27.0,3,7,3,6,0,1,0,0,1,6,7,6,3,0,3,3,6
401488002,American University Eagles,A. LeMaster,4703737,,True,24.0,3,8,3,5,0,3,4,5,2,2,4,1,0,0,2,1,10
401488002,American University Eagles,S. Stetson,4595453,,True,13.0,1,3,1,2,0,1,0,0,0,1,1,1,1,1,1,2,2
401488002,American University Eagles,M. Lavin,5109188,,False,13.0,1,4,1,4,0,0,1,2,1,0,1,1,0,0,2,3,3
401488002,American University Eagles,M. Lee,4704592,,False,2.0,0,0,0,0,0,0,0,0,0,0,0,0,2,0,0,0,0
401488002,American University Eagles,L. Nogues,5109187,,False,6.0,2,3,2,2,0,1,0,0,0,0,0,0,0,0,3,1,4
401488002,American University Eagles,A. Rescifina,5109186,,False,10.0,1,1,1,1,0,0,0,0,0,1,1,0,1,0,0,0,2
401488002,American University Eagles,B. Garbee,4899710,,False,12.0,0,1,0,0,0,1,0,0,0,2,2,0,0,0,0,2,0
401488002,American University Eagles,K. Henning,4704686,,False,30.0,3,6,3,6,0,0,1,2,0,4,4,3,1,0,3,1,7
401488002,American University Eagles,TEAM,TOTAL,TOTAL,False,,24,54,24,45,0,9,8,13,6,22,28,13,10,2,20,17,56
401488001,Colgate Raiders,T. McMillan,4704704,,True,25.0,3,7,3,7,0,0,2,2,1,2,3,5,0,2,2,1,8
401488001,Colgate Raiders,M. Schiller,5109205,,True,31.0,3,7,2,5,1,2,2,2,2,2,4,1,1,0,2,3,9
401488001,Colgate Raiders,T. Golembiewski,4900535,,True,36.0,9,17,7,13,2,4,4,4,0,5,5,5,3,3,2,3,24
401488001,Colgate Raiders,J. Paul,4595552,,True,20.0,2,8,2,4,0,4,0,0,0,2,2,1,0,0,0,0,4
401488001,Colgate Raiders,A. Brodie,4595550,,True,32.0,0,2,0,2,0,0,0,0,0,4,4,6,1,0,0,0,0
401488001,Colgate Raiders,S. Diehl,4900536,,False,25.0,4,8,3,6,1,2,0,0,0,3,3,0,0,1,1,2,9
401488001,Colgate Raiders,A. Ferguson,5109209,,False,4.0,1,2,1,2,0,0,0,0,0,0,0,1,1,0,0,0,2
401488001,Colgate Raiders,C. Midgette,5109204,,False,6.0,1,1,1,1,0,0,0,0,3,1,4,0,1,0,1,2,2
401488001,Colgate Raiders,L. Cook,5109207,,False,8.0,0,2,0,2,0,0,0,0,0,0,0,0,0,0,0,0,0
401488001,Colgate Raiders,M. McMahon,4900534,,False,13.0,3,4,2,3,1,1,0,0,0,2,2,1,1,0,4,1,7
401488001,Colgate Raiders,TEAM,TOTAL,TOTAL,False,,26,58,21,45,5,13,8,8,8,25,33,20,8,6,13,12,65
401488001,Colgate Raiders,T. McMillan,4704704,,True,25.0,3,7,3,7,0,0,2,2,1,2,3,5,0,2,2,1,8
401488001,Colgate Raiders,M. Schiller,5109205,,True,31.0,3,7,2,5,1,2,2,2,2,2,4,1,1,0,2,3,9
401488001,Colgate Raiders,T. Golembiewski,4900535,,True,36.0,9,17,7,13,2,4,4,4,0,5,5,5,3,3,2,3,24
401488001,Colgate Raiders,J. Paul,4595552,,True,20.0,2,8,2,4,0,4,0,0,0,2,2,1,0,0,0,0,4
401488001,Colgate Raiders,A. Brodie,4595550,,True,32.0,0,2,0,2,0,0,0,0,0,4,4,6,1,0,0,0,0
401488001,Colgate Raiders,S. Diehl,4900536,,False,25.0,4,8,3,6,1,2,0,0,0,3,3,0,0,1,1,2,9
401488001,Colgate Raiders,A. Ferguson,5109209,,False,4.0,1,2,1,2,0,0,0,0,0,0,0,1,1,0,0,0,2
401488001,Colgate Raiders,C. Midgette,5109204,,False,6.0,1,1,1,1,0,0,0,0,3,1,4,0,1,0,1,2,2
401488001,Colgate Raiders,L. Cook,5109207,,False,8.0,0,2,0,2,0,0,0,0,0,0,0,0,0,0,0,0,0
401488001,Colgate Raiders,M. McMahon,4900534,,False,13.0,3,4,2,3,1,1,0,0,0,2,2,1,1,0,4,1,7
401488001,Colgate Raiders,TEAM,TOTAL,TOTAL,False,,26,58,21,45,5,13,8,8,8,25,33,20,8,6,13,12,65
401488001,Army Black Knights,K. Hall,4595465,,True,36.0,5,9,5,8,0,1,1,8,2,3,5,1,1,0,1,1,11
401488001,Army Black Knights,T. Hardy,4899714,,True,19.0,5,11,5,10,0,1,0,0,1,1,2,2,3,0,0,0,10
401488001,Army Black Knights,L. Lithgow,4704696,,True,18.0,0,3,0,2,0,1,0,0,0,1,1,0,0,0,1,0,0
401488001,Army Black Knights,S. McNaughton,4704694,,True,26.0,4,7,4,6,0,1,0,0,1,1,2,0,0,0,1,4,8
401488001,Army Black Knights,N. Rhine,4595464,,True,17.0,1,4,1,1,0,3,0,0,0,1,1,1,1,0,1,0,2
401488001,Army Black Knights,L. Madison,5109194,,False,1.0,0,0,0,0,0,0,0,0,0,0,0,0,0,0,0,0,0
401488001,Army Black Knights,S. Hunter,4595466,,False,24.0,4,10,4,10,0,0,2,4,4,8,12,3,0,1,2,3,10
401488001,Army Black Knights,J. Laguna,5109193,,False,1.0,0,0,0,0,0,0,0,0,0,0,0,0,0,0,0,0,0
401488001,Army Black Knights,C. Richman,5109191,,False,17.0,1,5,0,1,1,4,0,0,1,1,2,1,0,0,0,1,3
401488001,Army Black Knights,R. Ericson,5109190,,False,14.0,0,1,0,1,0,0,0,0,0,2,2,1,0,0,5,2,0
401488001,Army Black Knights,V. Kearney,4899713,,False,6.0,1,3,0,1,1,2,0,0,0,1,1,0,0,0,1,0,3
401488001,Army Black Knights,H. Brown,4595467,,False,21.0,2,4,2,3,0,1,1,1,0,3,3,0,1,0,3,3,5
401488001,Army Black Knights,TEAM,TOTAL,TOTAL,False,,23,57,21,43,2,14,4,13,13,24,37,9,6,1,16,14,52
401488001,Army Black Knights,K. Hall,4595465,,True,36.0,5,9,5,8,0,1,1,8,2,3,5,1,1,0,1,1,11
401488001,Army Black Knights,T. Hardy,4899714,,True,19.0,5,11,5,10,0,1,0,0,1,1,2,2,3,0,0,0,10
401488001,Army Black Knights,L. Lithgow,4704696,,True,18.0,0,3,0,2,0,1,0,0,0,1,1,0,0,0,1,0,0
401488001,Army Black Knights,S. McNaughton,4704694,,True,26.0,4,7,4,6,0,1,0,0,1,1,2,0,0,0,1,4,8
401488001,Army Black Knights,N. Rhine,4595464,,True,17.0,1,4,1,1,0,3,0,0,0,1,1,1,1,0,1,0,2
401488001,Army Black Knights,L. Madison,5109194,,False,1.0,0,0,0,0,0,0,0,0,0,0,0,0,0,0,0,0,0
401488001,Army Black Knights,S. Hunter,4595466,,False,24.0,4,10,4,10,0,0,2,4,4,8,12,3,0,1,2,3,10
401488001,Army Black Knights,J. Laguna,5109193,,False,1.0,0,0,0,0,0,0,0,0,0,0,0,0,0,0,0,0,0
401488001,Army Black Knights,C. Richman,5109191,,False,17.0,1,5,0,1,1,4,0,0,1,1,2,1,0,0,0,1,3
401488001,Army Black Knights,R. Ericson,5109190,,False,14.0,0,1,0,1,0,0,0,0,0,2,2,1,0,0,5,2,0
401488001,Army Black Knights,V. Kearney,4899713,,False,6.0,1,3,0,1,1,2,0,0,0,1,1,0,0,0,1,0,3
401488001,Army Black Knights,H. Brown,4595467,,False,21.0,2,4,2,3,0,1,1,1,0,3,3,0,1,0,3,3,5
401488001,Army Black Knights,TEAM,TOTAL,TOTAL,False,,23,57,21,43,2,14,4,13,13,24,37,9,6,1,16,14,52
401488000,Loyola Maryland Greyhounds,L. Therien,4900552,,True,36.0,7,13,7,13,0,0,1,4,2,5,7,2,0,0,7,1,15
401488000,Loyola Maryland Greyhounds,K. Sims,4898948,,True,28.0,6,8,6,8,0,0,2,3,2,3,5,3,0,1,1,1,14
401488000,Loyola Maryland Greyhounds,K. Ratigan,5109222,,True,28.0,1,1,1,1,0,0,0,0,1,1,2,1,0,0,1,2,2
401488000,Loyola Maryland Greyhounds,L. Salmeron,4900549,,True,26.0,2,6,1,4,1,2,0,0,0,3,3,0,2,0,2,2,5
401488000,Loyola Maryland Greyhounds,T. Dixon,4400209,,True,34.0,8,12,6,9,2,3,2,2,0,3,3,4,0,0,3,1,20
401488000,Loyola Maryland Greyhounds,C. Garcia,5109224,,False,2.0,0,0,0,0,0,0,0,0,0,0,0,0,0,0,0,0,0
401488000,Loyola Maryland Greyhounds,M. Van-Otoo,5109223,,False,7.0,1,1,1,1,0,0,0,0,0,0,0,1,0,0,0,2,2
401488000,Loyola Maryland Greyhounds,C. Tanedo,4704774,,False,24.0,1,2,0,0,1,2,2,2,0,1,1,2,1,0,1,1,5
401488000,Loyola Maryland Greyhounds,D. Newman,4399474,,False,17.0,2,3,2,3,0,0,0,0,1,1,2,2,0,0,1,2,4
401488000,Loyola Maryland Greyhounds,TEAM,TOTAL,TOTAL,False,,28,46,24,39,4,7,7,11,7,26,33,15,3,1,17,12,67
401488000,Loyola Maryland Greyhounds,L. Therien,4900552,,True,36.0,7,13,7,13,0,0,1,4,2,5,7,2,0,0,7,1,15
401488000,Loyola Maryland Greyhounds,K. Sims,4898948,,True,28.0,6,8,6,8,0,0,2,3,2,3,5,3,0,1,1,1,14
401488000,Loyola Maryland Greyhounds,K. Ratigan,5109222,,True,28.0,1,1,1,1,0,0,0,0,1,1,2,1,0,0,1,2,2
401488000,Loyola Maryland Greyhounds,L. Salmeron,4900549,,True,26.0,2,6,1,4,1,2,0,0,0,3,3,0,2,0,2,2,5
401488000,Loyola Maryland Greyhounds,T. Dixon,4400209,,True,34.0,8,12,6,9,2,3,2,2,0,3,3,4,0,0,3,1,20
401488000,Loyola Maryland Greyhounds,C. Garcia,5109224,,False,2.0,0,0,0,0,0,0,0,0,0,0,0,0,0,0,0,0,0
401488000,Loyola Maryland Greyhounds,M. Van-Otoo,5109223,,False,7.0,1,1,1,1,0,0,0,0,0,0,0,1,0,0,0,2,2
401488000,Loyola Maryland Greyhounds,C. Tanedo,4704774,,False,24.0,1,2,0,0,1,2,2,2,0,1,1,2,1,0,1,1,5
401488000,Loyola Maryland Greyhounds,D. Newman,4399474,,False,17.0,2,3,2,3,0,0,0,0,1,1,2,2,0,0,1,2,4
401488000,Loyola Maryland Greyhounds,TEAM,TOTAL,TOTAL,False,,28,46,24,39,4,7,7,11,7,26,33,15,3,1,17,12,67
401488000,Army Black Knights,S. Hunter,4595466,,True,23.0,5,8,5,8,0,0,3,3,2,3,5,1,1,0,1,4,13
401488000,Army Black Knights,V. Kearney,4899713,,True,9.0,0,2,0,1,0,1,0,0,0,0,0,0,0,0,0,3,0
401488000,Army Black Knights,L. Lithgow,4704696,,True,25.0,2,6,0,1,2,5,2,2,0,1,1,0,0,0,1,1,8
401488000,Army Black Knights,S. McNaughton,4704694,,True,30.0,2,10,2,7,0,3,0,0,0,0,0,2,1,0,3,0,4
401488000,Army Black Knights,H. Brown,4595467,,True,28.0,2,7,2,4,0,3,0,0,3,4,7,2,0,0,1,1,4
401488000,Army Black Knights,K. Hall,4595465,,False,29.0,4,7,3,6,1,1,0,1,0,1,1,4,1,1,0,1,9
401488000,Army Black Knights,R. Ericson,5109190,,False,17.0,0,4,0,0,0,4,0,0,0,1,1,2,0,0,3,3,0
401488000,Army Black Knights,T. Hardy,4899714,,False,12.0,1,2,1,2,0,0,0,0,0,1,1,0,1,0,2,0,2
401488000,Army Black Knights,N. Rhine,4595464,,False,27.0,3,5,1,1,2,4,0,0,1,1,2,0,0,0,1,1,8
401488000,Army Black Knights,TEAM,TOTAL,TOTAL,False,,19,51,14,30,5,21,5,6,7,14,21,11,4,1,14,14,48
401488000,Army Black Knights,S. Hunter,4595466,,True,23.0,5,8,5,8,0,0,3,3,2,3,5,1,1,0,1,4,13
401488000,Army Black Knights,V. Kearney,4899713,,True,9.0,0,2,0,1,0,1,0,0,0,0,0,0,0,0,0,3,0
401488000,Army Black Knights,L. Lithgow,4704696,,True,25.0,2,6,0,1,2,5,2,2,0,1,1,0,0,0,1,1,8
401488000,Army Black Knights,S. McNaughton,4704694,,True,30.0,2,10,2,7,0,3,0,0,0,0,0,2,1,0,3,0,4
401488000,Army Black Knights,H. Brown,4595467,,True,28.0,2,7,2,4,0,3,0,0,3,4,7,2,0,0,1,1,4
401488000,Army Black Knights,K. Hall,4595465,,False,29.0,4,7,3,6,1,1,0,1,0,1,1,4,1,1,0,1,9
401488000,Army Black Knights,R. Ericson,5109190,,False,17.0,0,4,0,0,0,4,0,0,0,1,1,2,0,0,3,3,0
401488000,Army Black Knights,T. Hardy,4899714,,False,12.0,1,2,1,2,0,0,0,0,0,1,1,0,1,0,2,0,2
401488000,Army Black Knights,N. Rhine,4595464,,False,27.0,3,5,1,1,2,4,0,0,1,1,2,0,0,0,1,1,8
401488000,Army Black Knights,TEAM,TOTAL,TOTAL,False,,19,51,14,30,5,21,5,6,7,14,21,11,4,1,14,14,48
401487999,Lafayette Leopards,K. Drummond,4704754,,True,30.0,4,6,4,6,0,0,0,0,1,3,4,0,1,0,2,3,8
401487999,Lafayette Leopards,K. Favours,4900541,,True,28.0,2,9,0,4,2,5,0,2,0,4,4,0,0,0,2,0,6
401487999,Lafayette Leopards,M. Andrews,4704756,,True,37.0,7,13,7,13,0,0,0,0,0,5,5,2,1,0,3,3,14
401487999,Lafayette Leopards,H. Smith,4704553,,True,22.0,1,3,0,2,1,1,0,0,0,2,2,3,1,0,2,3,3
401487999,Lafayette Leopards,J. Booth,4433381,,True,34.0,8,11,8,11,0,0,2,3,1,1,2,3,0,0,2,1,18
401487999,Lafayette Leopards,A. Matthews,4703689,,False,10.0,0,0,0,0,0,0,0,0,0,1,1,0,1,0,0,2,0
401487999,Lafayette Leopards,S. Ntaconayigize,5109216,,False,20.0,1,5,1,3,0,2,3,4,0,2,2,0,0,0,0,0,5
401487999,Lafayette Leopards,K. Donahue,5109215,,False,19.0,1,9,1,4,0,5,0,0,0,2,2,1,2,0,0,0,2
401487999,Lafayette Leopards,TEAM,TOTAL,TOTAL,False,,24,56,21,43,3,13,5,9,3,24,27,9,6,0,12,12,56
401487999,Lafayette Leopards,K. Drummond,4704754,,True,30.0,4,6,4,6,0,0,0,0,1,3,4,0,1,0,2,3,8
401487999,Lafayette Leopards,K. Favours,4900541,,True,28.0,2,9,0,4,2,5,0,2,0,4,4,0,0,0,2,0,6
401487999,Lafayette Leopards,M. Andrews,4704756,,True,37.0,7,13,7,13,0,0,0,0,0,5,5,2,1,0,3,3,14
401487999,Lafayette Leopards,H. Smith,4704553,,True,22.0,1,3,0,2,1,1,0,0,0,2,2,3,1,0,2,3,3
401487999,Lafayette Leopards,J. Booth,4433381,,True,34.0,8,11,8,11,0,0,2,3,1,1,2,3,0,0,2,1,18
401487999,Lafayette Leopards,A. Matthews,4703689,,False,10.0,0,0,0,0,0,0,0,0,0,1,1,0,1,0,0,2,0
401487999,Lafayette Leopards,S. Ntaconayigize,5109216,,False,20.0,1,5,1,3,0,2,3,4,0,2,2,0,0,0,0,0,5
401487999,Lafayette Leopards,K. Donahue,5109215,,False,19.0,1,9,1,4,0,5,0,0,0,2,2,1,2,0,0,0,2
401487999,Lafayette Leopards,TEAM,TOTAL,TOTAL,False,,24,56,21,43,3,13,5,9,3,24,27,9,6,0,12,12,56
401487999,Army Black Knights,S. Hunter,4595466,,True,30.0,5,6,5,6,0,0,10,13,7,10,17,1,1,0,2,4,20
401487999,Army Black Knights,V. Kearney,4899713,,True,6.0,1,1,1,1,0,0,1,2,1,0,1,0,0,0,1,2,3
401487999,Army Black Knights,L. Lithgow,4704696,,True,30.0,3,13,0,1,3,12,0,0,0,3,3,3,1,0,1,0,9
401487999,Army Black Knights,S. McNaughton,4704694,,True,31.0,3,12,1,3,2,9,0,0,2,2,4,2,0,0,3,1,8
401487999,Army Black Knights,H. Brown,4595467,,True,28.0,4,14,3,7,1,7,0,0,1,4,5,1,1,0,1,0,9
401487999,Army Black Knights,L. Madison,5109194,,False,2.0,0,0,0,0,0,0,0,0,0,1,1,0,0,0,0,0,0
401487999,Army Black Knights,K. Hall,4595465,,False,18.0,3,5,3,4,0,1,0,0,1,3,4,2,0,2,1,4,6
401487999,Army Black Knights,J. Laguna,5109193,,False,6.0,0,0,0,0,0,0,0,0,0,1,1,1,0,0,0,1,0
401487999,Army Black Knights,R. Ericson,5109190,,False,30.0,6,10,2,4,4,6,0,0,3,2,5,3,1,0,1,1,16
401487999,Army Black Knights,T. Hardy,4899714,,False,11.0,0,3,0,1,0,2,1,2,1,1,2,3,0,0,3,1,1
401487999,Army Black Knights,N. Rhine,4595464,,False,8.0,1,3,0,1,1,2,0,0,0,1,1,1,0,0,0,2,3
401487999,Army Black Knights,TEAM,TOTAL,TOTAL,False,,26,67,15,28,11,39,12,17,18,31,49,17,4,2,13,16,75
401487999,Army Black Knights,S. Hunter,4595466,,True,30.0,5,6,5,6,0,0,10,13,7,10,17,1,1,0,2,4,20
401487999,Army Black Knights,V. Kearney,4899713,,True,6.0,1,1,1,1,0,0,1,2,1,0,1,0,0,0,1,2,3
401487999,Army Black Knights,L. Lithgow,4704696,,True,30.0,3,13,0,1,3,12,0,0,0,3,3,3,1,0,1,0,9
401487999,Army Black Knights,S. McNaughton,4704694,,True,31.0,3,12,1,3,2,9,0,0,2,2,4,2,0,0,3,1,8
401487999,Army Black Knights,H. Brown,4595467,,True,28.0,4,14,3,7,1,7,0,0,1,4,5,1,1,0,1,0,9
401487999,Army Black Knights,L. Madison,5109194,,False,2.0,0,0,0,0,0,0,0,0,0,1,1,0,0,0,0,0,0
401487999,Army Black Knights,K. Hall,4595465,,False,18.0,3,5,3,4,0,1,0,0,1,3,4,2,0,2,1,4,6
401487999,Army Black Knights,J. Laguna,5109193,,False,6.0,0,0,0,0,0,0,0,0,0,1,1,1,0,0,0,1,0
401487999,Army Black Knights,R. Ericson,5109190,,False,30.0,6,10,2,4,4,6,0,0,3,2,5,3,1,0,1,1,16
401487999,Army Black Knights,T. Hardy,4899714,,False,11.0,0,3,0,1,0,2,1,2,1,1,2,3,0,0,3,1,1
401487999,Army Black Knights,N. Rhine,4595464,,False,8.0,1,3,0,1,1,2,0,0,0,1,1,1,0,0,0,2,3
401487999,Army Black Knights,TEAM,TOTAL,TOTAL,False,,26,67,15,28,11,39,12,17,18,31,49,17,4,2,13,16,75
401487998,Lehigh Mountain Hawks,L. Fandre,5109220,,True,16.0,2,2,1,1,1,1,2,3,0,2,2,0,0,0,1,3,7
401487998,Lehigh Mountain Hawks,M. O'Brien,4900547,,True,15.0,0,2,0,2,0,0,0,0,0,1,1,0,0,0,0,4,0
401487998,Lehigh Mountain Hawks,F. Hottinger,4595613,,True,29.0,9,18,9,17,0,1,4,7,4,9,13,1,3,0,6,2,22
401487998,Lehigh Mountain Hawks,M. Kramer,4704762,,True,33.0,5,14,2,7,3,7,5,5,0,3,3,3,1,1,2,1,18
401487998,Lehigh Mountain Hawks,A. Harvey,4595612,,True,35.0,3,5,3,4,0,1,2,3,1,3,4,6,3,0,4,2,8
401487998,Lehigh Mountain Hawks,M. Brown,4433751,,False,4.0,2,2,2,2,0,0,0,0,0,0,0,0,0,0,1,0,4
401487998,Lehigh Mountain Hawks,K. Hurt,5109219,,False,2.0,0,0,0,0,0,0,0,0,0,0,0,0,0,0,0,0,0
401487998,Lehigh Mountain Hawks,K. St.Paul,5109218,,False,1.0,0,0,0,0,0,0,0,0,0,0,0,0,0,0,0,0,0
401487998,Lehigh Mountain Hawks,K. Van Eps,4900545,,False,19.0,3,5,2,4,1,1,6,6,1,3,4,3,0,0,1,0,13
401487998,Lehigh Mountain Hawks,E. Stemmer,4900544,,False,13.0,1,1,0,0,1,1,0,0,0,0,0,2,1,0,2,2,3
401487998,Lehigh Mountain Hawks,M. Albrecht,4704763,,False,7.0,1,1,1,1,0,0,2,2,0,2,2,0,0,0,2,0,4
401487998,Lehigh Mountain Hawks,F. Eggenschwiler,4704761,,False,4.0,0,0,0,0,0,0,0,0,0,0,0,2,0,0,0,0,0
401487998,Lehigh Mountain Hawks,J. Behar,4433782,,False,22.0,4,6,3,4,1,2,2,2,1,3,4,0,0,1,1,2,11
401487998,Lehigh Mountain Hawks,TEAM,TOTAL,TOTAL,False,,30,56,23,42,7,14,23,28,9,29,38,17,8,2,20,16,90
401487998,Lehigh Mountain Hawks,L. Fandre,5109220,,True,16.0,2,2,1,1,1,1,2,3,0,2,2,0,0,0,1,3,7
401487998,Lehigh Mountain Hawks,M. O'Brien,4900547,,True,15.0,0,2,0,2,0,0,0,0,0,1,1,0,0,0,0,4,0
401487998,Lehigh Mountain Hawks,F. Hottinger,4595613,,True,29.0,9,18,9,17,0,1,4,7,4,9,13,1,3,0,6,2,22
401487998,Lehigh Mountain Hawks,M. Kramer,4704762,,True,33.0,5,14,2,7,3,7,5,5,0,3,3,3,1,1,2,1,18
401487998,Lehigh Mountain Hawks,A. Harvey,4595612,,True,35.0,3,5,3,4,0,1,2,3,1,3,4,6,3,0,4,2,8
401487998,Lehigh Mountain Hawks,M. Brown,4433751,,False,4.0,2,2,2,2,0,0,0,0,0,0,0,0,0,0,1,0,4
401487998,Lehigh Mountain Hawks,K. Hurt,5109219,,False,2.0,0,0,0,0,0,0,0,0,0,0,0,0,0,0,0,0,0
401487998,Lehigh Mountain Hawks,K. St.Paul,5109218,,False,1.0,0,0,0,0,0,0,0,0,0,0,0,0,0,0,0,0,0
401487998,Lehigh Mountain Hawks,K. Van Eps,4900545,,False,19.0,3,5,2,4,1,1,6,6,1,3,4,3,0,0,1,0,13
401487998,Lehigh Mountain Hawks,E. Stemmer,4900544,,False,13.0,1,1,0,0,1,1,0,0,0,0,0,2,1,0,2,2,3
401487998,Lehigh Mountain Hawks,M. Albrecht,4704763,,False,7.0,1,1,1,1,0,0,2,2,0,2,2,0,0,0,2,0,4
401487998,Lehigh Mountain Hawks,F. Eggenschwiler,4704761,,False,4.0,0,0,0,0,0,0,0,0,0,0,0,2,0,0,0,0,0
401487998,Lehigh Mountain Hawks,J. Behar,4433782,,False,22.0,4,6,3,4,1,2,2,2,1,3,4,0,0,1,1,2,11
401487998,Lehigh Mountain Hawks,TEAM,TOTAL,TOTAL,False,,30,56,23,42,7,14,23,28,9,29,38,17,8,2,20,16,90
401487998,Army Black Knights,S. Hunter,4595466,,True,19.0,2,6,2,6,0,0,1,2,3,2,5,0,0,0,1,1,5
401487998,Army Black Knights,R. Ericson,5109190,,True,26.0,3,6,3,5,0,1,0,0,0,1,1,3,0,0,4,3,6
401487998,Army Black Knights,L. Lithgow,4704696,,True,29.0,2,7,1,3,1,4,2,2,0,3,3,1,2,0,2,3,7
401487998,Army Black Knights,S. McNaughton,4704694,,True,20.0,4,9,3,6,1,3,0,0,0,0,0,4,0,0,1,3,9
401487998,Army Black Knights,N. Rhine,4595464,,True,8.0,1,4,0,1,1,3,0,0,0,0,0,0,0,0,2,1,3
401487998,Army Black Knights,L. Madison,5109194,,False,5.0,0,0,0,0,0,0,0,0,0,0,0,1,0,0,0,0,0
401487998,Army Black Knights,A. Ainsworth,5109189,,False,1.0,0,0,0,0,0,0,0,0,0,0,0,0,0,0,0,0,0
401487998,Army Black Knights,K. Hall,4595465,,False,25.0,5,10,5,9,0,1,3,5,6,7,13,0,2,4,2,5,13
401487998,Army Black Knights,J. Laguna,5109193,,False,5.0,0,1,0,1,0,0,0,0,0,1,1,0,0,0,1,2,0
401487998,Army Black Knights,C. Richman,5109191,,False,8.0,0,3,0,1,0,2,0,0,0,0,0,0,0,0,0,4,0
401487998,Army Black Knights,T. Hardy,4899714,,False,10.0,2,5,2,3,0,2,1,2,0,2,2,0,2,0,2,0,5
401487998,Army Black Knights,V. Kearney,4899713,,False,13.0,1,5,0,2,1,3,1,2,0,3,3,0,1,0,1,0,4
401487998,Army Black Knights,J. Strippoli,4595470,,False,6.0,1,1,1,1,0,0,0,0,0,0,0,0,2,0,1,1,2
401487998,Army Black Knights,H. Brown,4595467,,False,24.0,6,9,4,4,2,5,0,2,3,0,3,0,1,0,3,4,14
401487998,Army Black Knights,TEAM,TOTAL,TOTAL,False,,27,66,21,42,6,24,8,15,14,21,35,9,10,4,20,27,68
401487998,Army Black Knights,S. Hunter,4595466,,True,19.0,2,6,2,6,0,0,1,2,3,2,5,0,0,0,1,1,5
401487998,Army Black Knights,R. Ericson,5109190,,True,26.0,3,6,3,5,0,1,0,0,0,1,1,3,0,0,4,3,6
401487998,Army Black Knights,L. Lithgow,4704696,,True,29.0,2,7,1,3,1,4,2,2,0,3,3,1,2,0,2,3,7
401487998,Army Black Knights,S. McNaughton,4704694,,True,20.0,4,9,3,6,1,3,0,0,0,0,0,4,0,0,1,3,9
401487998,Army Black Knights,N. Rhine,4595464,,True,8.0,1,4,0,1,1,3,0,0,0,0,0,0,0,0,2,1,3
401487998,Army Black Knights,L. Madison,5109194,,False,5.0,0,0,0,0,0,0,0,0,0,0,0,1,0,0,0,0,0
401487998,Army Black Knights,A. Ainsworth,5109189,,False,1.0,0,0,0,0,0,0,0,0,0,0,0,0,0,0,0,0,0
401487998,Army Black Knights,K. Hall,4595465,,False,25.0,5,10,5,9,0,1,3,5,6,7,13,0,2,4,2,5,13
401487998,Army Black Knights,J. Laguna,5109193,,False,5.0,0,1,0,1,0,0,0,0,0,1,1,0,0,0,1,2,0
401487998,Army Black Knights,C. Richman,5109191,,False,8.0,0,3,0,1,0,2,0,0,0,0,0,0,0,0,0,4,0
401487998,Army Black Knights,T. Hardy,4899714,,False,10.0,2,5,2,3,0,2,1,2,0,2,2,0,2,0,2,0,5
401487998,Army Black Knights,V. Kearney,4899713,,False,13.0,1,5,0,2,1,3,1,2,0,3,3,0,1,0,1,0,4
401487998,Army Black Knights,J. Strippoli,4595470,,False,6.0,1,1,1,1,0,0,0,0,0,0,0,0,2,0,1,1,2
401487998,Army Black Knights,H. Brown,4595467,,False,24.0,6,9,4,4,2,5,0,2,3,0,3,0,1,0,3,4,14
401487998,Army Black Knights,TEAM,TOTAL,TOTAL,False,,27,66,21,42,6,24,8,15,14,21,35,9,10,4,20,27,68
401487997,Eastern Kentucky Colonels,E. Hacker,4595770,,True,28.0,2,5,1,2,1,3,3,3,0,3,3,0,2,1,2,3,8
401487997,Eastern Kentucky Colonels,A. Recanati,4705072,,True,34.0,4,8,2,6,2,2,2,2,1,0,1,5,1,0,3,2,12
401487997,Eastern Kentucky Colonels,A. Walker,4400574,,True,33.0,10,16,10,16,0,0,2,5,3,8,11,1,3,0,6,2,22
401487997,Eastern Kentucky Colonels,M. Mackins,4399243,,True,32.0,5,12,3,6,2,6,0,0,0,7,7,7,1,0,3,3,12
401487997,Eastern Kentucky Colonels,D. Rainey,4068137,,True,29.0,7,11,5,7,2,4,2,2,2,4,6,2,1,0,2,2,18
401487997,Eastern Kentucky Colonels,A. Morton,5107400,,False,1.0,0,1,0,1,0,0,0,0,1,0,1,0,0,0,0,0,0
401487997,Eastern Kentucky Colonels,B. Fox,4595283,,False,6.0,1,1,1,1,0,0,0,0,0,0,0,0,0,0,0,1,2
401487997,Eastern Kentucky Colonels,K. Lacy,4898925,,False,9.0,1,3,0,1,1,2,4,4,0,0,0,0,1,0,0,0,7
401487997,Eastern Kentucky Colonels,K. Freeman,4898922,,False,4.0,0,0,0,0,0,0,0,0,0,0,0,0,1,0,0,0,0
401487997,Eastern Kentucky Colonels,A. Collett,4704580,,False,3.0,0,2,0,0,0,2,0,0,0,0,0,0,0,0,0,1,0
401487997,Eastern Kentucky Colonels,A. Kirkwood,4595834,,False,21.0,1,2,1,2,0,0,0,0,1,3,4,0,2,4,0,2,2
401487997,Eastern Kentucky Colonels,TEAM,TOTAL,TOTAL,False,,31,61,23,42,8,19,13,16,9,27,36,15,12,5,16,16,83
401487997,Army Black Knights,S. Hunter,4595466,,True,25.0,8,10,8,10,0,0,2,5,6,4,10,2,3,0,3,2,18
401487997,Army Black Knights,R. Ericson,5109190,,True,20.0,3,9,2,4,1,5,0,0,0,3,3,1,1,0,4,2,7
401487997,Army Black Knights,L. Lithgow,4704696,,True,31.0,3,11,1,1,2,10,0,2,1,1,2,2,2,0,0,2,8
401487997,Army Black Knights,S. McNaughton,4704694,,True,29.0,4,9,1,4,3,5,0,0,0,0,0,1,0,0,3,3,11
401487997,Army Black Knights,N. Rhine,4595464,,True,25.0,1,7,1,2,0,5,0,0,0,2,2,1,1,0,0,0,2
401487997,Army Black Knights,L. Madison,5109194,,False,3.0,0,0,0,0,0,0,0,0,0,0,0,0,0,0,0,0,0
401487997,Army Black Knights,A. Ainsworth,5109189,,False,2.0,0,2,0,2,0,0,0,0,2,2,4,0,0,0,1,1,0
401487997,Army Black Knights,K. Hall,4595465,,False,22.0,1,4,1,3,0,1,1,2,3,2,5,2,0,0,5,5,3
401487997,Army Black Knights,J. Laguna,5109193,,False,9.0,1,4,1,2,0,2,2,2,2,1,3,0,0,0,0,0,4
401487997,Army Black Knights,C. Richman,5109191,,False,14.0,1,7,0,1,1,6,0,0,2,1,3,1,0,0,2,2,3
401487997,Army Black Knights,J. Strippoli,4595470,,False,12.0,1,3,0,0,1,3,0,0,1,1,2,1,2,0,2,3,3
401487997,Army Black Knights,H. Brown,4595467,,False,8.0,1,1,1,1,0,0,1,2,1,2,3,0,0,0,1,1,3
401487997,Army Black Knights,TEAM,TOTAL,TOTAL,False,,24,67,16,30,8,37,6,13,20,23,43,11,9,0,21,21,62
401487996,Hofstra Pride,Z. Swint,4704976,,True,22.0,1,6,1,6,0,0,2,4,6,0,6,1,0,1,4,2,4
401487996,Hofstra Pride,E. Von Essen,5108816,,True,30.0,3,9,1,5,2,4,0,0,0,0,0,0,3,0,0,1,8
401487996,Hofstra Pride,A. Knights,4704296,,True,23.0,0,5,0,4,0,1,4,4,0,1,1,3,1,0,1,3,4
401487996,Hofstra Pride,R. Nicholson,4399892,,True,24.0,1,5,1,4,0,1,0,0,1,2,3,1,3,0,1,2,2
401487996,Hofstra Pride,B. Thomas,4399567,,True,21.0,6,12,4,10,2,2,3,4,1,4,5,2,0,0,1,4,17
401487996,Hofstra Pride,K. Joseph-Bernard,5108815,,False,8.0,0,0,0,0,0,0,0,0,1,3,4,1,0,0,0,2,0
401487996,Hofstra Pride,A. Gooden,5108817,,False,17.0,1,5,0,0,1,5,0,0,0,1,1,1,0,0,0,0,3
401487996,Hofstra Pride,J. Fargo,4704811,,False,28.0,3,8,3,6,0,2,0,0,1,2,3,0,2,0,0,3,6
401487996,Hofstra Pride,S. Ineza,4594722,,False,23.0,4,8,2,4,2,4,2,2,0,1,1,0,0,0,2,1,12
401487996,Hofstra Pride,J. Peacock,4399031,,False,4.0,0,0,0,0,0,0,0,0,0,0,0,0,0,0,1,0,0
401487996,Hofstra Pride,TEAM,TOTAL,TOTAL,False,,19,58,12,39,7,19,11,14,11,17,28,9,9,1,11,18,56
401487996,Army Black Knights,S. Hunter,4595466,,True,28.0,2,6,2,6,0,0,6,10,6,10,16,2,0,0,4,4,10
401487996,Army Black Knights,K. Hall,4595465,,True,39.0,8,15,8,14,0,1,0,0,4,3,7,2,2,1,1,2,16
401487996,Army Black Knights,R. Ericson,5109190,,True,34.0,4,7,1,2,3,5,4,4,0,2,2,1,1,0,3,3,15
401487996,Army Black Knights,L. Lithgow,4704696,,True,31.0,0,7,0,2,0,5,2,2,2,3,5,0,0,0,2,3,2
401487996,Army Black Knights,S. McNaughton,4704694,,True,27.0,2,6,0,3,2,3,0,0,0,1,1,1,0,0,4,1,6
401487996,Army Black Knights,C. Richman,5109191,,False,21.0,0,3,0,0,0,3,0,0,0,5,5,4,0,0,2,3,0
401487996,Army Black Knights,H. Brown,4595467,,False,8.0,0,0,0,0,0,0,0,0,1,0,1,0,0,0,3,1,0
401487996,Army Black Knights,N. Rhine,4595464,,False,12.0,1,4,0,0,1,4,1,2,0,2,2,0,0,0,1,1,4
401487996,Army Black Knights,TEAM,TOTAL,TOTAL,False,,17,48,11,27,6,21,13,18,15,29,44,10,3,1,21,18,53
401487995,Sacred Heart Pioneers,C. Stroemel,4595782,,True,30.0,6,12,6,12,0,0,1,2,3,5,8,0,0,4,3,4,13
401487995,Sacred Heart Pioneers,S. Johnson,5106087,,True,31.0,1,6,1,6,0,0,0,0,1,1,2,3,0,0,5,2,2
401487995,Sacred Heart Pioneers,N. Pryor,5106084,,True,35.0,3,9,3,7,0,2,5,7,2,3,5,2,4,0,3,4,11
401487995,Sacred Heart Pioneers,S. Bonner,4595390,,True,34.0,3,10,1,5,2,5,1,1,1,2,3,1,0,0,2,2,9
401487995,Sacred Heart Pioneers,O. Tucker,4594799,,True,35.0,1,10,0,2,1,8,0,0,0,2,2,3,2,0,0,1,3
401487995,Sacred Heart Pioneers,K. Wood,4705033,,False,10.0,0,1,0,1,0,0,2,2,0,6,6,1,0,0,0,3,2
401487995,Sacred Heart Pioneers,A. Wood,5106086,,False,14.0,1,2,1,1,0,1,0,0,1,3,4,0,0,0,1,1,2
401487995,Sacred Heart Pioneers,A. Owusu-Mensah,4900506,,False,7.0,1,3,1,3,0,0,1,2,0,1,1,0,0,0,0,1,3
401487995,Sacred Heart Pioneers,W. Jackson,4399144,,False,4.0,1,2,0,1,1,1,0,0,0,1,1,0,0,0,0,1,3
401487995,Sacred Heart Pioneers,TEAM,TOTAL,TOTAL,False,,17,55,13,38,4,17,10,14,8,24,32,10,6,4,14,19,48
401487995,Army Black Knights,S. Hunter,4595466,,True,34.0,3,11,3,11,0,0,2,3,6,17,23,1,0,2,3,3,8
401487995,Army Black Knights,K. Hall,4595465,,True,34.0,4,15,4,15,0,0,2,7,3,3,6,3,2,0,3,2,10
401487995,Army Black Knights,R. Ericson,5109190,,True,31.0,2,11,2,8,0,3,0,0,2,1,3,3,1,0,2,2,4
401487995,Army Black Knights,L. Lithgow,4704696,,True,34.0,2,7,0,0,2,7,2,2,0,3,3,0,1,0,2,0,8
401487995,Army Black Knights,S. McNaughton,4704694,,True,23.0,3,7,2,6,1,1,3,4,0,0,0,1,0,0,2,3,10
401487995,Army Black Knights,L. Madison,5109194,,False,4.0,0,0,0,0,0,0,0,0,1,0,1,0,0,0,0,0,0
401487995,Army Black Knights,C. Richman,5109191,,False,29.0,3,6,0,0,3,6,0,0,1,3,4,0,1,0,3,3,9
401487995,Army Black Knights,N. Rhine,4595464,,False,11.0,0,1,0,1,0,0,1,2,0,1,1,0,0,0,0,1,1
401487995,Army Black Knights,TEAM,TOTAL,TOTAL,False,,17,58,11,41,6,17,10,18,13,28,41,8,5,2,17,14,50
401487994,William & Mary Tribe,M. Magee,4899593,,True,11.0,0,2,0,1,0,1,0,0,2,1,3,0,0,0,2,2,0
401487994,William & Mary Tribe,R. Frisby-Smith,4705066,,True,34.0,0,4,0,0,0,4,5,6,4,4,8,1,1,0,2,1,5
401487994,William & Mary Tribe,B. Bellamy,4594744,,True,31.0,2,7,2,7,0,0,1,2,2,8,10,2,3,0,3,2,5
401487994,William & Mary Tribe,R. Casey,4281390,,True,38.0,11,22,5,13,6,9,3,4,1,2,3,3,0,0,1,1,31
401487994,William & Mary Tribe,S. Wagner,4281291,,True,33.0,4,15,3,7,1,8,5,6,0,1,1,3,0,0,2,1,14
401487994,William & Mary Tribe,C. Wingertzahn,4705067,,False,25.0,3,5,3,5,0,0,4,5,1,3,4,2,1,1,1,3,10
401487994,William & Mary Tribe,A. Mikeska,5108904,,False,19.0,1,5,1,4,0,1,0,0,3,0,3,2,1,0,0,1,2
401487994,William & Mary Tribe,L. Brown,4705065,,False,9.0,1,1,1,1,0,0,0,0,0,0,0,0,0,0,0,1,2
401487994,William & Mary Tribe,TEAM,TOTAL,TOTAL,False,,22,61,15,38,7,23,18,23,13,24,37,13,6,1,12,12,69
401487994,Army Black Knights,S. Hunter,4595466,,True,31.0,6,10,6,10,0,0,4,6,6,8,14,4,0,1,2,4,16
401487994,Army Black Knights,K. Hall,4595465,,True,17.0,1,5,1,5,0,0,0,0,1,2,3,2,0,0,2,4,2
401487994,Army Black Knights,R. Ericson,5109190,,True,24.0,3,6,3,5,0,1,0,0,0,5,5,2,0,0,1,4,6
401487994,Army Black Knights,L. Lithgow,4704696,,True,36.0,8,12,2,2,6,10,0,0,1,4,5,0,1,1,4,5,22
401487994,Army Black Knights,S. McNaughton,4704694,,True,30.0,4,10,2,6,2,4,1,1,0,2,2,1,1,0,3,5,11
401487994,Army Black Knights,L. Madison,5109194,,False,10.0,1,1,1,1,0,0,0,0,1,2,3,0,1,0,0,0,2
401487994,Army Black Knights,C. Richman,5109191,,False,7.0,0,2,0,0,0,2,0,0,0,0,0,0,0,0,0,0,0
401487994,Army Black Knights,V. Kearney,4899713,,False,21.0,1,6,1,4,0,2,2,2,0,2,2,1,2,0,4,4,4
401487994,Army Black Knights,N. Rhine,4595464,,False,24.0,1,7,0,2,1,5,0,0,0,2,2,1,0,0,1,0,3
401487994,Army Black Knights,TEAM,TOTAL,TOTAL,False,,25,59,16,35,9,24,7,9,10,29,39,11,5,2,19,26,66
401487993,Yale Bulldogs,G. Thybulle,4899336,,True,16.0,2,9,2,9,0,0,2,2,1,2,3,1,0,0,1,2,6
401487993,Yale Bulldogs,N. McGill,4899339,,True,35.0,6,9,6,8,0,1,0,2,5,5,10,2,5,0,1,2,12
401487993,Yale Bulldogs,M. Egger,4899338,,True,28.0,4,8,4,7,0,1,2,2,1,4,5,0,0,0,2,2,10
401487993,Yale Bulldogs,E. van der Maas,4899335,,True,32.0,6,14,4,7,2,7,0,0,0,1,1,0,0,0,1,2,14
401487993,Yale Bulldogs,J. Clark,4594954,,True,37.0,6,10,4,6,2,4,1,3,0,4,4,5,0,1,3,2,15
401487993,Yale Bulldogs,H. Sabol,4899334,,False,0.0,0,0,0,0,0,0,0,0,0,0,0,0,0,0,0,1,0
401487993,Yale Bulldogs,K. Capstraw,5108958,,False,22.0,0,6,0,3,0,3,2,2,1,4,5,0,1,0,1,0,2
401487993,Yale Bulldogs,A. Lee,4899333,,False,4.0,0,1,0,0,0,1,0,0,0,1,1,1,0,0,0,0,0
401487993,Yale Bulldogs,K. Astrom,4594955,,False,26.0,3,7,2,5,1,2,5,7,1,3,4,1,1,0,2,4,12
401487993,Yale Bulldogs,TEAM,TOTAL,TOTAL,False,,27,64,22,45,5,19,12,18,9,24,33,10,7,1,11,15,71
401487993,Army Black Knights,S. Hunter,4595466,,True,34.0,7,11,7,11,0,0,1,2,3,10,13,0,1,0,1,3,15
401487993,Army Black Knights,K. Hall,4595465,,True,38.0,8,18,7,9,1,9,3,3,2,4,6,3,3,0,2,2,20
401487993,Army Black Knights,R. Ericson,5109190,,True,35.0,4,9,4,5,0,4,0,0,0,2,2,5,0,0,5,0,8
401487993,Army Black Knights,L. Lithgow,4704696,,True,33.0,4,9,3,4,1,5,2,4,3,1,4,1,1,0,1,3,11
401487993,Army Black Knights,H. Brown,4595467,,True,27.0,1,3,1,2,0,1,1,3,2,2,4,1,1,1,1,2,3
401487993,Army Black Knights,C. Richman,5109191,,False,12.0,1,6,0,0,1,6,0,0,0,3,3,1,1,0,1,1,3
401487993,Army Black Knights,V. Kearney,4899713,,False,1.0,0,0,0,0,0,0,0,0,0,0,0,0,0,0,0,0,0
401487993,Army Black Knights,S. McNaughton,4704694,,False,5.0,0,1,0,1,0,0,0,0,0,0,0,0,0,0,2,2,0
401487993,Army Black Knights,N. Rhine,4595464,,False,15.0,2,4,0,0,2,4,0,0,0,2,2,1,1,0,0,1,6
401487993,Army Black Knights,TEAM,TOTAL,TOTAL,False,,27,61,22,32,5,29,7,12,10,24,34,12,8,1,14,14,66
401487992,Emmanuel (MA) Lions,K. Eubanks,5111080,,True,25.0,4,7,4,7,0,0,2,2,4,3,7,0,0,0,5,3,10
401487992,Emmanuel (MA) Lions,S. Ketant,5111078,,True,25.0,1,6,1,6,0,0,0,0,3,2,5,0,1,1,4,4,2
401487992,Emmanuel (MA) Lions,Y. Chan,5111076,,True,32.0,5,16,5,12,0,4,0,0,1,3,4,9,6,0,9,4,10
401487992,Emmanuel (MA) Lions,O. Matela,5111073,,True,27.0,2,9,0,3,2,6,0,0,1,1,2,0,1,0,2,0,6
401487992,Emmanuel (MA) Lions,C. Barker,5111071,,True,17.0,3,4,2,3,1,1,0,0,0,2,2,0,0,0,2,0,7
401487992,Emmanuel (MA) Lions,A. Wild,5111083,,False,8.0,1,2,1,2,0,0,0,0,0,1,1,0,0,0,0,0,2
401487992,Emmanuel (MA) Lions,M. Reilly,5111082,,False,9.0,0,1,0,1,0,0,0,0,1,1,2,0,0,0,0,2,0
401487992,Emmanuel (MA) Lions,D. Robinson,5111077,,False,10.0,0,2,0,2,0,0,0,0,1,0,1,0,1,0,0,3,0
401487992,Emmanuel (MA) Lions,R. French,5111074,,False,7.0,1,2,1,1,0,1,0,0,0,2,2,1,0,0,0,1,2
401487992,Emmanuel (MA) Lions,T. Fischer,5111079,,False,15.0,1,4,0,1,1,3,1,2,0,0,0,2,0,0,0,0,4
401487992,Emmanuel (MA) Lions,A. Giordano,5111075,,False,21.0,2,4,1,3,1,1,5,6,2,2,4,1,0,0,3,3,10
401487992,Emmanuel (MA) Lions,T. Mobray,5111072,,False,4.0,0,1,0,1,0,0,0,0,0,2,2,0,1,0,0,1,0
401487992,Emmanuel (MA) Lions,TEAM,TOTAL,TOTAL,False,,20,58,15,42,5,16,8,10,13,19,32,13,10,1,25,21,53
401487992,Army Black Knights,S. Hunter,4595466,,True,25.0,6,9,6,9,0,0,6,10,3,10,13,2,4,1,2,3,18
401487992,Army Black Knights,L. Lithgow,4704696,,True,30.0,5,13,0,1,5,12,0,0,2,0,2,3,1,0,0,1,15
401487992,Army Black Knights,S. McNaughton,4704694,,True,19.0,1,3,1,2,0,1,2,2,0,4,4,3,0,0,3,0,4
401487992,Army Black Knights,H. Brown,4595467,,True,16.0,0,3,0,1,0,2,0,0,2,1,3,2,1,0,2,1,0
401487992,Army Black Knights,N. Rhine,4595464,,True,20.0,1,8,0,3,1,5,0,0,1,1,2,0,1,0,3,2,3
401487992,Army Black Knights,L. Madison,5109194,,False,6.0,0,1,0,1,0,0,0,0,2,0,2,0,1,0,0,0,0
401487992,Army Black Knights,A. Ainsworth,5109189,,False,2.0,0,0,0,0,0,0,0,0,0,0,0,0,0,0,0,1,0
401487992,Army Black Knights,K. Hall,4595465,,False,20.0,1,6,1,3,0,3,0,0,3,5,8,1,2,1,4,1,2
401487992,Army Black Knights,J. Laguna,5109193,,False,8.0,2,3,0,0,2,3,0,0,0,2,2,0,0,0,0,1,6
401487992,Army Black Knights,C. Richman,5109191,,False,27.0,3,11,0,0,3,11,0,0,1,0,1,4,0,0,0,2,9
401487992,Army Black Knights,R. Ericson,5109190,,False,23.0,6,9,2,2,4,7,2,2,2,0,2,4,1,0,3,1,18
401487992,Army Black Knights,M. George,4704693,,False,4.0,0,2,0,1,0,1,2,2,1,0,1,0,0,0,0,1,2
401487992,Army Black Knights,TEAM,TOTAL,TOTAL,False,,25,68,10,23,15,45,12,16,17,23,40,19,11,2,18,14,77
401487991,Delaware Blue Hens,M. Pippin,4703429,,True,19.0,1,1,1,1,0,0,2,2,1,7,8,1,2,0,6,5,4
401487991,Delaware Blue Hens,K. Sconiers,4433683,,True,16.0,2,3,2,3,0,0,2,2,0,0,0,0,0,0,4,5,6
401487991,Delaware Blue Hens,T. Cousins,4704511,,True,30.0,3,5,3,4,0,1,4,4,0,5,5,8,3,0,5,0,10
401487991,Delaware Blue Hens,J. Smalls,4400634,,True,32.0,5,13,0,2,5,11,1,2,0,2,2,1,0,0,0,1,16
401487991,Delaware Blue Hens,K. Idom,4399260,,True,26.0,6,10,2,5,4,5,0,0,1,4,5,3,3,0,4,2,16
401487991,Delaware Blue Hens,M. Ojo,4898513,,False,29.0,3,5,3,5,0,0,1,4,3,7,10,0,1,3,1,4,7
401487991,Delaware Blue Hens,N. Mays-Prince,5108758,,False,23.0,1,8,1,8,0,0,0,0,2,0,2,3,1,0,3,1,2
401487991,Delaware Blue Hens,M. Yanogacio,4899570,,False,21.0,1,3,0,0,1,3,2,2,0,3,3,0,0,0,4,2,5
401487991,Delaware Blue Hens,J. Reid,4704514,,False,4.0,0,0,0,0,0,0,0,0,0,1,1,0,0,0,0,0,0
401487991,Delaware Blue Hens,TEAM,TOTAL,TOTAL,False,,22,48,12,28,10,20,12,16,8,32,40,16,10,3,27,20,66
401487991,American University Eagles,E. Johns,4704688,,True,25.0,6,16,6,15,0,1,1,2,4,3,7,1,1,0,2,5,13
401487991,American University Eagles,L. Stack,4595455,,True,34.0,4,9,4,9,0,0,4,8,4,6,10,2,0,0,4,5,12
401487991,American University Eagles,K. Henning,4704686,,True,21.0,0,0,0,0,0,0,0,0,0,1,1,2,0,0,1,2,0
401487991,American University Eagles,I. Bales,4704685,,True,22.0,2,6,2,5,0,1,0,0,1,4,5,1,1,0,4,4,4
401487991,American University Eagles,R. DeRubbo,4703746,,True,24.0,2,12,0,6,2,6,0,0,1,3,4,0,1,0,2,2,6
401487991,American University Eagles,M. Lavin,5109188,,False,9.0,0,3,0,1,0,2,2,4,1,0,1,0,1,0,2,1,2
401487991,American University Eagles,L. Nogues,5109187,,False,12.0,2,4,1,3,1,1,0,0,0,1,1,4,0,0,2,1,5
401487991,American University Eagles,A. Rescifina,5109186,,False,13.0,0,3,0,2,0,1,1,2,0,1,1,2,1,0,0,0,1
401487991,American University Eagles,B. Garbee,4899710,,False,12.0,1,2,1,2,0,0,2,2,1,1,2,0,1,0,2,0,4
401487991,American University Eagles,A. LeMaster,4703737,,False,4.0,0,0,0,0,0,0,0,0,0,0,0,0,0,0,1,0,0
401487991,American University Eagles,S. Stetson,4595453,,False,24.0,1,8,0,3,1,5,0,0,3,0,3,1,1,0,3,2,3
401487991,American University Eagles,TEAM,TOTAL,TOTAL,False,,18,63,14,46,4,17,10,18,17,20,37,13,7,0,23,22,50
401487990,Marist Red Foxes,Z. Shazer,5109005,,True,36.0,5,18,5,17,0,1,6,8,1,3,4,2,0,0,2,0,16
401487990,Marist Red Foxes,M. Donnelly,4594789,,True,8.0,0,1,0,1,0,0,0,0,1,2,3,0,0,0,3,3,0
401487990,Marist Red Foxes,K. Fisher,4596332,,True,34.0,5,11,5,7,0,4,3,6,0,5,5,3,2,0,3,0,13
401487990,Marist Red Foxes,J. Bonilla,4595376,,True,21.0,1,2,1,1,0,1,0,0,2,2,4,2,0,0,1,3,2
401487990,Marist Red Foxes,K. Krick,4399130,,True,37.0,5,10,4,5,1,5,3,4,0,4,4,1,2,0,3,3,14
401487990,Marist Red Foxes,C. Croker,5109006,,False,6.0,0,0,0,0,0,0,0,0,2,0,2,0,0,1,0,1,0
401487990,Marist Red Foxes,M. Rife,4899851,,False,1.0,0,0,0,0,0,0,1,2,1,0,1,0,0,0,0,0,1
401487990,Marist Red Foxes,E. Fox,4704496,,False,1.0,0,0,0,0,0,0,2,2,0,3,3,0,0,0,0,0,2
401487990,Marist Red Foxes,S. Bailey,4595377,,False,18.0,2,3,2,2,0,1,0,0,1,2,3,1,1,0,0,1,4
401487990,Marist Red Foxes,M. Tompkins,5109007,,False,6.0,0,0,0,0,0,0,0,0,0,0,0,0,0,0,0,1,0
401487990,Marist Red Foxes,J. Whitman,5109004,,False,1.0,0,1,0,0,0,1,0,0,0,0,0,0,0,0,0,0,0
401487990,Marist Red Foxes,J. Piddock,5109003,,False,21.0,1,3,1,2,0,1,4,4,0,3,3,0,2,0,0,3,6
401487990,Marist Red Foxes,C. Cunningham,4899849,,False,9.0,0,1,0,1,0,0,1,2,0,4,4,1,0,0,2,1,1
401487990,Marist Red Foxes,S. Chadwick,4704960,,False,1.0,0,0,0,0,0,0,0,0,0,0,0,0,0,0,0,0,0
401487990,Marist Red Foxes,TEAM,TOTAL,TOTAL,False,,19,50,18,36,1,14,20,28,8,30,38,10,7,1,14,16,59
401487990,American University Eagles,M. Lavin,5109188,,True,15.0,0,5,0,3,0,2,1,2,6,1,7,0,0,0,1,4,1
401487990,American University Eagles,L. Stack,4595455,,True,29.0,1,9,1,8,0,1,0,2,7,4,11,0,2,0,3,4,2
401487990,American University Eagles,K. Henning,4704686,,True,32.0,3,12,3,11,0,1,2,2,0,3,3,2,1,0,1,3,8
401487990,American University Eagles,I. Bales,4704685,,True,32.0,2,8,2,6,0,2,0,0,2,6,8,2,1,0,3,5,4
401487990,American University Eagles,R. DeRubbo,4703746,,True,21.0,5,11,4,6,1,5,0,0,0,2,2,2,1,0,3,0,11
401487990,American University Eagles,M. Lee,4704592,,False,4.0,0,3,0,2,0,1,0,0,1,0,1,0,0,0,0,0,0
401487990,American University Eagles,L. Nogues,5109187,,False,22.0,1,4,0,0,1,4,0,0,0,2,2,1,1,0,4,4,3
401487990,American University Eagles,A. Rescifina,5109186,,False,10.0,1,2,1,2,0,0,1,2,0,0,0,0,0,0,0,1,3
401487990,American University Eagles,B. Garbee,4899710,,False,14.0,0,3,0,1,0,2,4,6,1,4,5,0,0,0,2,5,4
401487990,American University Eagles,A. LeMaster,4703737,,False,5.0,0,1,0,0,0,1,0,0,0,0,0,0,1,0,1,1,0
401487990,American University Eagles,S. Stetson,4595453,,False,15.0,1,1,0,0,1,1,2,2,0,2,2,0,0,1,0,0,5
401487990,American University Eagles,L. Graytok,4400159,,False,1.0,0,0,0,0,0,0,0,0,0,0,0,0,0,0,1,0,0
401487990,American University Eagles,TEAM,TOTAL,TOTAL,False,,14,59,11,39,3,20,10,16,17,26,43,7,7,1,19,27,41
401487989,Howard Bison,B. Fort-Davis,4705321,,True,22.0,2,7,2,6,0,1,3,5,2,3,5,1,1,1,5,4,7
401487989,Howard Bison,K. Marsh,4400350,,True,18.0,2,3,2,3,0,0,0,0,2,1,3,1,0,0,1,3,4
401487989,Howard Bison,D. Howell,4705316,,True,31.0,13,21,8,11,5,10,3,4,1,3,4,3,3,0,2,3,34
401487989,Howard Bison,I. Warren,4595524,,True,23.0,0,4,0,4,0,0,3,4,0,3,3,3,2,0,4,4,3
401487989,Howard Bison,A. Hudson,4399534,,True,26.0,4,10,2,5,2,5,3,5,0,2,2,0,0,0,2,0,13
401487989,Howard Bison,J. Perrin,5109718,,False,9.0,2,2,2,2,0,0,0,0,0,1,1,0,0,0,0,3,4
401487989,Howard Bison,N. Miller,5109717,,False,6.0,1,2,1,1,0,1,2,2,1,0,1,1,1,0,0,1,4
401487989,Howard Bison,M. Steel,4901382,,False,3.0,0,1,0,1,0,0,0,0,0,0,0,0,0,1,1,1,0
401487989,Howard Bison,N. Nelson,4899956,,False,6.0,1,3,1,3,0,0,0,0,1,0,1,0,0,0,0,2,2
401487989,Howard Bison,K. Creek,4705320,,False,17.0,1,2,1,2,0,0,3,4,1,3,4,1,0,0,2,3,5
401487989,Howard Bison,N. Cooper,4899955,,False,11.0,2,5,2,2,0,3,1,1,1,1,2,1,1,0,0,0,5
401487989,Howard Bison,K. Harris,4705322,,False,23.0,1,2,1,2,0,0,0,0,1,6,7,2,2,0,0,3,2
401487989,Howard Bison,A. Wilson,4705319,,False,5.0,0,0,0,0,0,0,0,0,0,1,1,0,0,0,1,0,0
401487989,Howard Bison,TEAM,TOTAL,TOTAL,False,,29,62,22,42,7,20,18,25,11,25,36,13,10,2,18,27,83
401487989,American University Eagles,E. Johns,4704688,,True,33.0,7,15,7,13,0,2,9,10,1,3,4,2,1,0,1,2,23
401487989,American University Eagles,L. Stack,4595455,,True,30.0,2,6,2,6,0,0,2,3,2,4,6,0,1,0,0,3,6
401487989,American University Eagles,K. Henning,4704686,,True,32.0,3,8,3,6,0,2,4,4,0,0,0,4,0,0,2,3,10
401487989,American University Eagles,I. Bales,4704685,,True,31.0,4,7,3,5,1,2,0,0,4,12,16,4,2,0,7,1,9
401487989,American University Eagles,R. DeRubbo,4703746,,True,21.0,4,12,2,5,2,7,0,0,0,0,0,0,1,0,4,3,10
401487989,American University Eagles,M. Lavin,5109188,,False,9.0,0,2,0,1,0,1,2,2,0,1,1,1,0,0,2,3,2
401487989,American University Eagles,M. Lee,4704592,,False,3.0,0,0,0,0,0,0,0,0,0,0,0,0,0,0,0,1,0
401487989,American University Eagles,L. Nogues,5109187,,False,5.0,0,0,0,0,0,0,0,0,0,0,0,0,0,0,3,2,0
401487989,American University Eagles,A. Rescifina,5109186,,False,2.0,0,0,0,0,0,0,0,0,0,0,0,0,0,0,0,0,0
401487989,American University Eagles,B. Garbee,4899710,,False,18.0,2,4,2,3,0,1,5,6,0,2,2,3,2,0,2,3,9
401487989,American University Eagles,A. LeMaster,4703737,,False,4.0,0,1,0,1,0,0,0,0,1,0,1,1,0,0,0,1,0
401487989,American University Eagles,S. Stetson,4595453,,False,7.0,0,3,0,0,0,3,1,2,0,0,0,0,0,0,0,1,1
401487989,American University Eagles,L. Graytok,4400159,,False,5.0,0,0,0,0,0,0,0,0,0,0,0,1,1,0,0,0,0
401487989,American University Eagles,TEAM,TOTAL,TOTAL,False,,22,58,19,40,3,18,23,27,11,24,35,16,8,0,22,23,70
401487988,Virginia Cavaliers,C. Taylor,4595150,,True,23.0,2,7,2,6,0,1,2,3,2,2,4,3,2,2,0,3,6
401487988,Virginia Cavaliers,S. Brunelle,4433631,,True,28.0,5,11,4,8,1,3,2,2,2,1,3,0,0,0,0,2,13
401487988,Virginia Cavaliers,T. Valladay,4595147,,True,28.0,9,18,9,17,0,1,1,2,2,2,4,2,3,1,3,1,19
401487988,Virginia Cavaliers,K. Lawson,4433762,,True,9.0,1,2,1,2,0,0,0,0,2,0,2,0,1,0,1,1,2
401487988,Virginia Cavaliers,M. McLean,4433737,,True,29.0,4,10,4,8,0,2,3,4,5,6,11,0,1,1,1,2,11
401487988,Virginia Cavaliers,L. Clarkson,4433043,,False,15.0,0,3,0,3,0,0,2,4,3,0,3,2,1,0,3,2,2
401487988,Virginia Cavaliers,C. Pauley,5107741,,False,8.0,1,4,0,0,1,4,0,0,0,0,0,0,0,0,0,0,3
401487988,Virginia Cavaliers,Y. Vaughn,4682910,,False,19.0,1,4,1,3,0,1,0,0,0,3,3,2,0,0,0,0,2
401487988,Virginia Cavaliers,A. Smith,4433742,,False,13.0,1,4,1,2,0,2,1,1,2,2,4,1,1,0,2,0,3
401487988,Virginia Cavaliers,C. Miller,4433120,,False,17.0,2,8,1,3,1,5,2,2,1,2,3,0,2,0,1,4,7
401487988,Virginia Cavaliers,M. Dale,4281396,,False,11.0,3,4,3,3,0,1,0,0,2,3,5,0,1,0,1,1,6
401487988,Virginia Cavaliers,TEAM,TOTAL,TOTAL,False,,29,75,26,55,3,20,13,18,23,22,45,10,12,4,12,16,74
401487988,American University Eagles,E. Johns,4704688,,True,36.0,7,17,6,13,1,4,1,2,2,7,9,0,1,0,1,3,16
401487988,American University Eagles,L. Stack,4595455,,True,31.0,0,5,0,5,0,0,1,2,2,2,4,3,2,0,5,5,1
401487988,American University Eagles,K. Henning,4704686,,True,28.0,8,11,8,10,0,1,2,2,0,1,1,3,0,0,3,3,18
401487988,American University Eagles,I. Bales,4704685,,True,26.0,3,4,2,3,1,1,0,0,0,1,1,2,0,0,3,2,7
401487988,American University Eagles,R. DeRubbo,4703746,,True,31.0,3,6,1,2,2,4,0,0,0,3,3,1,0,0,1,2,8
401487988,American University Eagles,M. Lavin,5109188,,False,8.0,1,3,1,3,0,0,3,4,0,1,1,0,1,1,3,5,5
401487988,American University Eagles,L. Nogues,5109187,,False,14.0,1,5,1,2,0,3,0,0,1,1,2,2,0,0,5,2,2
401487988,American University Eagles,A. Rescifina,5109186,,False,2.0,0,0,0,0,0,0,0,0,0,1,1,0,0,0,0,0,0
401487988,American University Eagles,B. Garbee,4899710,,False,17.0,1,1,0,0,1,1,0,0,0,1,1,0,0,0,1,1,3
401487988,American University Eagles,S. Stetson,4595453,,False,7.0,0,1,0,0,0,1,0,0,0,0,0,0,0,0,1,0,0
401487988,American University Eagles,TEAM,TOTAL,TOTAL,False,,24,53,19,38,5,15,7,10,7,23,30,11,4,1,23,23,60
401487987,George Washington Revolutionaries,M. Taiwo,4399083,,True,34.0,4,9,4,8,0,1,0,0,5,7,12,2,3,0,2,1,8
401487987,George Washington Revolutionaries,T. Webster,4705003,,True,22.0,3,8,3,6,0,2,1,3,0,2,2,0,1,0,2,1,7
401487987,George Washington Revolutionaries,E. Brown,4594778,,True,31.0,1,3,1,3,0,0,3,4,2,0,2,1,1,1,1,3,5
401487987,George Washington Revolutionaries,A. Inniss,4433498,,True,21.0,2,5,2,5,0,0,4,5,1,0,1,0,2,0,3,2,8
401487987,George Washington Revolutionaries,M. Lakstigala,4399188,,True,30.0,5,13,3,8,2,5,5,8,1,6,7,3,1,0,3,4,17
401487987,George Washington Revolutionaries,F. Blethen,4594777,,False,17.0,1,3,1,2,0,1,1,2,1,1,2,2,1,0,0,3,3
401487987,George Washington Revolutionaries,N. Robertson,5107471,,False,17.0,3,6,1,3,2,3,0,2,0,2,2,1,0,0,3,4,8
401487987,George Washington Revolutionaries,N. Lok,4898514,,False,11.0,4,8,3,5,1,3,0,0,2,3,5,1,0,0,0,1,9
401487987,George Washington Revolutionaries,J. Thornton,4282277,,False,17.0,1,6,1,3,0,3,0,0,0,3,3,0,0,0,0,1,2
401487987,George Washington Revolutionaries,TEAM,TOTAL,TOTAL,False,,24,61,19,43,5,18,14,24,13,26,39,10,9,1,14,20,67
401487987,American University Eagles,E. Johns,4704688,,True,32.0,5,12,5,10,0,2,2,4,0,6,6,2,1,0,5,4,12
401487987,American University Eagles,L. Stack,4595455,,True,33.0,4,7,4,7,0,0,5,7,0,3,3,2,1,1,3,3,13
401487987,American University Eagles,K. Henning,4704686,,True,29.0,5,7,4,5,1,2,0,0,0,4,4,1,0,0,1,1,11
401487987,American University Eagles,I. Bales,4704685,,True,29.0,0,3,0,3,0,0,0,0,0,8,8,4,0,0,5,3,0
401487987,American University Eagles,R. DeRubbo,4703746,,True,21.0,1,11,0,6,1,5,2,2,0,1,1,3,0,0,2,4,5
401487987,American University Eagles,M. Lavin,5109188,,False,16.0,3,5,0,2,3,3,0,0,2,3,5,0,0,0,1,2,9
401487987,American University Eagles,L. Nogues,5109187,,False,11.0,2,3,2,2,0,1,0,0,0,0,0,3,0,0,3,3,4
401487987,American University Eagles,B. Garbee,4899710,,False,6.0,0,0,0,0,0,0,2,2,0,0,0,1,0,0,0,0,2
401487987,American University Eagles,S. Stetson,4595453,,False,23.0,2,3,0,0,2,3,0,0,0,3,3,1,0,0,1,2,6
401487987,American University Eagles,TEAM,TOTAL,TOTAL,False,,22,51,15,35,7,16,11,15,4,28,32,17,2,1,21,22,62
401487805,South Dakota State Jackrabbits,T. Nelson,4595883,,True,29.0,6,10,5,6,1,4,3,3,1,5,6,1,0,0,1,2,16
401487805,South Dakota State Jackrabbits,P. Burckhard,4399649,,True,22.0,4,8,4,8,0,0,1,2,1,3,4,2,0,0,1,2,9
401487805,South Dakota State Jackrabbits,M. Selland,4282531,,True,28.0,6,11,5,9,1,2,5,7,2,6,8,4,2,1,2,2,18
401487805,South Dakota State Jackrabbits,E. Colbeck,5109984,,True,26.0,4,5,2,2,2,3,2,2,0,1,1,1,0,0,3,1,12
401487805,South Dakota State Jackrabbits,H. Timmer,4899819,,True,22.0,4,9,4,8,0,1,1,2,3,1,4,3,1,0,0,1,9
401487805,South Dakota State Jackrabbits,B. Meyer,5109985,,False,16.0,3,3,3,3,0,0,2,6,2,3,5,4,0,1,2,1,8
401487805,South Dakota State Jackrabbits,M. Byom,4704383,,False,2.0,1,1,1,1,0,0,0,0,0,0,0,0,0,0,0,0,2
401487805,South Dakota State Jackrabbits,M. Vlastuin,4704382,,False,5.0,0,1,0,0,0,1,0,0,1,2,3,1,0,0,0,0,0
401487805,South Dakota State Jackrabbits,K. Theisen,4595882,,False,17.0,5,9,5,9,0,0,2,2,3,5,8,0,0,1,3,3,12
401487805,South Dakota State Jackrabbits,M. Mathiowetz,5109983,,False,17.0,0,7,0,3,0,4,0,0,0,2,2,2,0,0,1,2,0
401487805,South Dakota State Jackrabbits,R. Nesheim,4595886,,False,2.0,0,0,0,0,0,0,0,0,0,0,0,0,0,0,0,0,0
401487805,South Dakota State Jackrabbits,D. Gylten,4282178,,False,14.0,2,3,1,1,1,2,0,0,0,1,1,1,1,0,0,0,5
401487805,South Dakota State Jackrabbits,TEAM,TOTAL,TOTAL,False,,35,67,30,50,5,17,16,24,13,30,43,19,4,3,13,14,91
401487805,Lehigh Mountain Hawks,M. O'Brien,4900547,,True,18.0,1,4,0,1,1,3,1,2,0,5,5,2,1,0,0,4,4
401487805,Lehigh Mountain Hawks,F. Hottinger,4595613,,True,37.0,10,17,8,13,2,4,3,4,2,5,7,0,2,0,2,2,25
401487805,Lehigh Mountain Hawks,K. Van Eps,4900545,,True,20.0,1,2,0,0,1,2,0,0,0,2,2,3,1,0,3,4,3
401487805,Lehigh Mountain Hawks,M. Kramer,4704762,,True,35.0,9,23,8,16,1,7,2,2,0,4,4,3,2,0,4,3,21
401487805,Lehigh Mountain Hawks,A. Harvey,4595612,,True,33.0,2,5,1,2,1,3,4,4,0,3,3,3,1,0,0,2,9
401487805,Lehigh Mountain Hawks,L. Fandre,5109220,,False,23.0,1,3,0,0,1,3,2,2,0,0,0,1,1,0,1,4,5
401487805,Lehigh Mountain Hawks,J. Vargas-Bines,4900546,,False,9.0,0,0,0,0,0,0,0,0,0,1,1,0,0,0,1,2,0
401487805,Lehigh Mountain Hawks,M. Brown,4433751,,False,1.0,0,0,0,0,0,0,0,0,0,0,0,0,0,0,0,0,0
401487805,Lehigh Mountain Hawks,E. Stemmer,4900544,,False,13.0,2,4,0,0,2,4,0,0,1,1,2,0,0,0,0,1,6
401487805,Lehigh Mountain Hawks,M. Albrecht,4704763,,False,7.0,0,0,0,0,0,0,0,0,0,2,2,0,0,0,1,0,0
401487805,Lehigh Mountain Hawks,F. Eggenschwiler,4704761,,False,1.0,0,0,0,0,0,0,0,0,0,0,0,0,0,0,0,0,0
401487805,Lehigh Mountain Hawks,J. Behar,4433782,,False,3.0,0,1,0,0,0,1,0,0,0,1,1,0,0,0,2,1,0
401487805,Lehigh Mountain Hawks,TEAM,TOTAL,TOTAL,False,,26,59,17,32,9,27,12,14,3,24,27,12,8,0,14,23,73
401487553,Pennsylvania Quakers,F. Toonders,4703792,,True,38.0,6,12,3,6,3,6,0,0,5,6,11,2,2,4,0,5,15
401487553,Pennsylvania Quakers,J. Obi,4705226,,True,35.0,7,15,5,11,2,4,0,0,0,4,4,5,0,0,2,3,16
401487553,Pennsylvania Quakers,S. Sawyer,5108946,,True,35.0,4,9,3,5,1,4,1,3,1,4,5,2,1,0,4,2,10
401487553,Pennsylvania Quakers,K. Padilla,4599972,,True,42.0,6,17,3,8,3,9,0,0,0,8,8,3,1,0,1,1,15
401487553,Pennsylvania Quakers,M. McGurk,4599968,,True,30.0,2,8,2,6,0,2,4,4,1,3,4,1,2,1,1,1,8
401487553,Pennsylvania Quakers,F. Parker,4599969,,False,0.0,0,0,0,0,0,0,0,0,0,0,0,0,0,0,0,0,0
401487553,Pennsylvania Quakers,S. Milliman,4599971,,False,3.0,0,0,0,0,0,0,0,0,0,1,1,0,0,0,0,0,0
401487553,Pennsylvania Quakers,Sa. Caldwell,4683048,,False,2.0,0,0,0,0,0,0,0,0,0,0,0,0,0,0,0,1,0
401487553,Pennsylvania Quakers,S. Almqvist,4899321,,False,12.0,0,2,0,1,0,1,0,0,0,2,2,0,0,1,1,1,0
401487553,Pennsylvania Quakers,M. Stanfield,4705228,,False,5.0,0,0,0,0,0,0,0,0,0,2,2,0,0,0,0,0,0
401487553,Pennsylvania Quakers,Sy. Caldwell,4433338,,False,23.0,2,6,2,5,0,1,0,2,0,0,0,2,1,0,1,0,4
401487553,Pennsylvania Quakers,TEAM,TOTAL,TOTAL,False,,27,69,18,42,9,27,5,9,9,32,41,15,7,6,11,14,68
401487553,Bucknell Bison,I. King,4900533,,True,34.0,5,10,3,4,2,6,0,0,1,6,7,0,1,1,0,3,12
401487553,Bucknell Bison,E. Shaffer,4595535,,True,37.0,5,17,5,17,0,0,5,8,4,7,11,2,1,0,3,3,15
401487553,Bucknell Bison,R. Sisselman,4900531,,True,21.0,1,6,0,0,1,6,0,0,0,1,1,1,0,0,2,1,3
401487553,Bucknell Bison,B. Matthews,5109200,,True,15.0,2,5,1,4,1,1,0,0,1,5,6,2,0,0,0,0,5
401487553,Bucknell Bison,C. Collins,4900532,,True,42.0,8,18,8,18,0,0,2,5,2,2,4,6,1,0,3,1,18
401487553,Bucknell Bison,G. Sullivan,5109201,,False,8.0,0,1,0,1,0,0,2,2,1,2,3,0,0,0,1,0,2
401487553,Bucknell Bison,K. Reinbeau,4704700,,False,28.0,0,2,0,1,0,1,0,0,0,8,8,0,0,0,1,4,0
401487553,Bucknell Bison,J. Kulesza,4704702,,False,7.0,2,3,1,1,1,2,0,1,0,0,0,0,0,0,0,0,5
401487553,Bucknell Bison,T. Johnson,4595533,,False,15.0,1,3,1,3,0,0,0,0,0,1,1,1,0,0,1,1,2
401487553,Bucknell Bison,C. Dingler,4577540,,False,18.0,0,1,0,1,0,0,0,0,0,2,2,0,0,1,0,2,0
401487553,Bucknell Bison,TEAM,TOTAL,TOTAL,False,,24,66,19,50,5,16,9,16,11,35,46,12,3,2,12,15,62
401487531,Harvard Crimson,G. Anderson,5108944,,True,25.0,0,2,0,2,0,0,0,0,1,8,9,0,0,0,4,3,0
401487531,Harvard Crimson,H. Turner,4899316,,True,40.0,12,21,11,17,1,4,3,5,3,7,10,5,2,0,1,1,28
401487531,Harvard Crimson,S. Glenn-Bello,4586315,,True,29.0,4,8,4,7,0,1,0,0,1,3,4,2,2,1,1,2,8
401487531,Harvard Crimson,L. Mullaney,4433377,,True,34.0,4,9,4,4,0,5,0,2,2,2,4,1,3,0,1,1,8
401487531,Harvard Crimson,M. Forbes,4398749,,True,28.0,4,11,4,6,0,5,0,0,0,2,2,0,0,0,4,4,8
401487531,Harvard Crimson,K. Krupa,4566914,,False,11.0,0,0,0,0,0,0,0,0,1,0,1,0,0,0,2,3,0
401487531,Harvard Crimson,E. Rodriguez,4899315,,False,33.0,10,12,9,9,1,3,0,0,2,2,4,1,3,0,2,0,21
401487531,Harvard Crimson,TEAM,TOTAL,TOTAL,False,,34,63,32,45,2,18,3,7,10,25,35,9,10,1,15,14,73
401487531,Boston University Terriers,S. Crispe,5109197,,True,32.0,2,6,2,5,0,1,2,2,3,5,8,1,1,0,3,0,6
401487531,Boston University Terriers,M. Durant,4599732,,True,39.0,6,10,6,10,0,0,4,4,3,4,7,5,0,0,4,2,16
401487531,Boston University Terriers,L. Davenport,4899718,,True,24.0,3,6,0,1,3,5,0,0,0,3,3,1,0,0,3,2,9
401487531,Boston University Terriers,M. Pina,4599731,,True,18.0,1,4,1,2,0,2,0,0,0,2,2,2,0,0,2,0,2
401487531,Boston University Terriers,S. Johnson,4599729,,True,32.0,4,13,4,12,0,1,1,1,2,4,6,4,4,0,3,2,9
401487531,Boston University Terriers,A. Semenova,5109196,,False,4.0,1,1,0,0,1,1,0,0,0,0,0,0,0,0,0,0,3
401487531,Boston University Terriers,A. Giannaros,4899717,,False,24.0,5,10,2,7,3,3,0,0,0,0,0,2,1,0,4,1,13
401487531,Boston University Terriers,S. Beneventine,4704699,,False,15.0,0,5,0,3,0,2,0,0,0,1,1,1,0,0,1,0,0
401487531,Boston University Terriers,K. Mingo,4704698,,False,2.0,0,1,0,0,0,1,0,0,0,1,1,0,0,0,0,1,0
401487531,Boston University Terriers,L. Shean,4599727,,False,10.0,0,0,0,0,0,0,0,0,0,0,0,0,0,0,2,1,0
401487531,Boston University Terriers,TEAM,TOTAL,TOTAL,False,,22,56,15,40,7,16,7,7,9,21,30,16,6,0,23,9,58
401487529,Harvard Crimson,G. Anderson,5108944,,True,31.0,4,7,4,7,0,0,0,0,2,2,4,1,3,0,3,3,8
401487529,Harvard Crimson,H. Turner,4899316,,True,33.0,9,14,5,8,4,6,0,0,1,3,4,4,4,0,3,1,22
401487529,Harvard Crimson,E. Rodriguez,4899315,,True,17.0,3,4,3,4,0,0,0,0,1,2,3,0,0,0,1,0,6
401487529,Harvard Crimson,L. Mullaney,4433377,,True,36.0,4,9,2,2,2,7,0,0,0,5,5,1,1,1,0,0,10
401487529,Harvard Crimson,M. Forbes,4398749,,True,31.0,1,8,1,5,0,3,4,4,0,5,5,2,0,1,2,2,6
401487529,Harvard Crimson,L. Lawson,4705224,,False,2.0,0,0,0,0,0,0,0,0,0,0,0,0,0,0,0,0,0
401487529,Harvard Crimson,K. Krupa,4566914,,False,13.0,1,3,1,3,0,0,0,0,0,0,0,1,0,0,2,3,2
401487529,Harvard Crimson,E. Stauffer,4899318,,False,10.0,0,2,0,1,0,1,0,0,0,0,0,1,0,0,0,0,0
401487529,Harvard Crimson,S. Glenn-Bello,4586315,,False,27.0,4,6,4,5,0,1,0,0,3,4,7,3,2,0,3,4,8
401487529,Harvard Crimson,TEAM,TOTAL,TOTAL,False,,26,53,20,35,6,18,4,4,8,23,31,13,10,2,14,13,62
401487529,Colgate Raiders,T. McMillan,4704704,,True,19.0,3,6,3,6,0,0,0,0,1,2,3,0,0,0,0,1,6
401487529,Colgate Raiders,M. Schiller,5109205,,True,28.0,1,1,1,1,0,0,0,0,0,4,4,3,1,0,2,0,2
401487529,Colgate Raiders,T. Golembiewski,4900535,,True,34.0,3,15,3,11,0,4,2,2,0,6,6,1,2,0,6,3,8
401487529,Colgate Raiders,J. Paul,4595552,,True,23.0,1,3,0,0,1,3,0,0,1,2,3,0,1,0,0,0,3
401487529,Colgate Raiders,A. Brodie,4595550,,True,31.0,1,6,0,4,1,2,1,1,0,0,0,3,0,0,0,0,4
401487529,Colgate Raiders,N. Parks,5109206,,False,15.0,2,4,2,2,0,2,1,1,1,2,3,0,1,0,2,1,5
401487529,Colgate Raiders,S. Diehl,4900536,,False,20.0,5,7,4,4,1,3,0,0,1,0,1,1,0,0,1,1,11
401487529,Colgate Raiders,C. Midgette,5109204,,False,3.0,0,1,0,1,0,0,0,0,1,0,1,0,0,0,0,0,0
401487529,Colgate Raiders,L. Cook,5109207,,False,21.0,4,7,3,4,1,3,0,0,0,0,0,2,0,1,2,1,9
401487529,Colgate Raiders,M. McMahon,4900534,,False,6.0,0,1,0,1,0,0,0,0,0,0,0,1,0,0,3,1,0
401487529,Colgate Raiders,TEAM,TOTAL,TOTAL,False,,20,51,16,34,4,17,4,4,7,19,26,11,5,1,17,8,48
401487509,Navy Midshipmen,M. Andrews,4704780,,True,18.0,0,2,0,2,0,0,0,0,3,0,3,1,1,1,1,3,0
401487509,Navy Midshipmen,K. Samson,5109237,,True,24.0,2,7,2,7,0,0,1,2,0,2,2,1,1,1,3,5,5
401487509,Navy Midshipmen,S. Watts,4704782,,True,30.0,3,13,3,5,0,8,2,2,1,2,3,1,0,0,6,1,8
401487509,Navy Midshipmen,M. Louridas,5109236,,True,35.0,8,14,4,5,4,9,1,2,1,4,5,1,0,0,4,2,21
401487509,Navy Midshipmen,M. Schrader,4595622,,True,38.0,2,3,2,3,0,0,0,0,0,4,4,3,0,0,3,0,4
401487509,Navy Midshipmen,M. Demos,5109235,,False,11.0,1,2,1,2,0,0,0,0,0,1,1,1,0,0,1,4,2
401487509,Navy Midshipmen,G. Pissott,5109232,,False,14.0,0,1,0,1,0,0,1,2,0,1,1,0,0,0,0,1,1
401487509,Navy Midshipmen,S. Lewis,4900553,,False,12.0,2,2,2,2,0,0,0,0,0,4,4,2,0,0,2,3,4
401487509,Navy Midshipmen,S. Clarke,5109231,,False,14.0,0,1,0,0,0,1,2,4,0,1,1,0,0,0,1,0,2
401487509,Navy Midshipmen,K. Giuliani,5109230,,False,2.0,0,0,0,0,0,0,0,0,0,0,0,0,0,0,0,0,0
401487509,Navy Midshipmen,S. Schofield,4704779,,False,2.0,0,0,0,0,0,0,0,0,0,0,0,1,0,0,0,0,0
401487509,Navy Midshipmen,TEAM,TOTAL,TOTAL,False,,18,45,14,27,4,18,7,12,5,26,31,11,2,2,22,19,47
401487509,Georgetown Hoyas,G. Bennett,4595143,,True,23.0,4,7,4,7,0,0,0,0,3,3,6,1,2,2,1,2,8
401487509,Georgetown Hoyas,J. Claude,4433205,,True,17.0,2,6,2,4,0,2,2,4,0,2,2,1,0,0,3,0,6
401487509,Georgetown Hoyas,K. Fauntleroy,5106189,,True,31.0,4,10,2,6,2,4,0,0,0,3,3,6,4,0,0,1,10
401487509,Georgetown Hoyas,K. Ransom,4433769,,True,32.0,6,14,4,12,2,2,1,2,3,5,8,5,4,1,0,2,15
401487509,Georgetown Hoyas,K. Moore,4398631,,True,26.0,3,7,2,3,1,4,0,0,0,0,0,5,1,0,1,2,7
401487509,Georgetown Hoyas,K. Myricks,4899014,,False,12.0,0,0,0,0,0,0,0,0,0,5,5,0,1,0,0,0,0
401487509,Georgetown Hoyas,B. Scott,4899012,,False,18.0,7,8,3,3,4,5,4,6,2,1,3,1,1,1,0,1,22
401487509,Georgetown Hoyas,M. Lee,5106190,,False,7.0,0,1,0,0,0,1,0,0,0,1,1,0,0,0,1,0,0
401487509,Georgetown Hoyas,A. Jenkins,4899013,,False,13.0,1,4,1,3,0,1,2,4,1,3,4,0,0,0,0,3,4
401487509,Georgetown Hoyas,M. McConnell,5106188,,False,5.0,0,0,0,0,0,0,0,0,0,0,0,0,0,0,0,1,0
401487509,Georgetown Hoyas,V. Rivera,5106187,,False,5.0,0,1,0,1,0,0,0,0,0,0,0,0,0,0,2,1,0
401487509,Georgetown Hoyas,Y. Ott,4433768,,False,11.0,0,1,0,1,0,0,2,2,0,1,1,0,0,0,0,1,2
401487509,Georgetown Hoyas,TEAM,TOTAL,TOTAL,False,,27,59,18,40,9,19,11,18,9,25,34,19,13,4,8,14,74
401487501,Villanova Wildcats,C. Dalce,4618079,,True,22.0,5,8,5,8,0,0,3,4,3,1,4,3,0,1,2,1,13
401487501,Villanova Wildcats,M. Siegrist,4399415,,True,26.0,10,17,8,12,2,5,2,2,1,6,7,2,2,2,3,2,24
401487501,Villanova Wildcats,L. Olsen,4433815,,True,21.0,4,7,2,3,2,4,2,2,0,6,6,3,2,0,0,2,12
401487501,Villanova Wildcats,M. Burke,4433452,,True,24.0,2,7,0,0,2,7,3,3,1,4,5,4,1,0,1,0,9
401487501,Villanova Wildcats,B. Mullin,4433296,,True,23.0,1,1,0,0,1,1,0,0,0,4,4,3,0,2,1,1,3
401487501,Villanova Wildcats,A. Welde,5106214,,False,3.0,1,1,1,1,0,0,0,0,0,0,0,0,0,0,0,2,2
401487501,Villanova Wildcats,A. Cauley,4899025,,False,16.0,3,4,3,4,0,0,0,0,1,4,5,0,0,0,3,1,6
401487501,Villanova Wildcats,K. Swider,4598582,,False,5.0,1,2,1,2,0,0,2,2,0,1,1,0,0,1,2,0,4
401487501,Villanova Wildcats,K. Orihel,4899024,,False,17.0,1,4,1,3,0,1,0,0,0,3,3,3,1,1,0,0,2
401487501,Villanova Wildcats,Z. Jones,4899023,,False,22.0,2,6,2,4,0,2,1,2,0,1,1,1,1,0,1,2,5
401487501,Villanova Wildcats,B. Runyan,4598592,,False,21.0,1,2,1,1,0,1,1,2,0,1,1,2,0,0,0,2,3
401487501,Villanova Wildcats,TEAM,TOTAL,TOTAL,False,,31,59,24,38,7,21,14,17,7,31,38,21,7,7,13,13,83
401487501,American University Eagles,E. Johns,4704688,,True,27.0,6,10,6,9,0,1,0,0,0,2,2,0,1,0,1,2,12
401487501,American University Eagles,L. Stack,4595455,,True,29.0,3,8,3,7,0,1,1,2,0,4,4,0,0,0,4,3,7
401487501,American University Eagles,K. Henning,4704686,,True,24.0,2,5,1,4,1,1,2,4,0,3,3,3,1,0,3,2,7
401487501,American University Eagles,I. Bales,4704685,,True,24.0,2,4,2,3,0,1,0,0,1,5,6,3,0,0,5,3,4
401487501,American University Eagles,R. DeRubbo,4703746,,True,21.0,0,4,0,2,0,2,2,2,0,2,2,2,0,0,0,0,2
401487501,American University Eagles,M. Lavin,5109188,,False,11.0,1,2,1,1,0,1,0,0,1,4,5,0,0,0,2,1,2
401487501,American University Eagles,M. Lee,4704592,,False,7.0,1,2,1,2,0,0,2,2,0,0,0,0,1,0,0,1,4
401487501,American University Eagles,L. Nogues,5109187,,False,10.0,0,4,0,2,0,2,0,0,1,1,2,2,0,0,1,3,0
401487501,American University Eagles,A. Rescifina,5109186,,False,8.0,0,3,0,0,0,3,4,4,0,0,0,0,0,0,1,1,4
401487501,American University Eagles,B. Garbee,4899710,,False,9.0,0,4,0,4,0,0,0,0,0,0,0,0,0,1,0,4,0
401487501,American University Eagles,A. LeMaster,4703737,,False,13.0,0,3,0,2,0,1,0,0,1,0,1,0,1,0,1,0,0
401487501,American University Eagles,S. Stetson,4595453,,False,10.0,0,1,0,1,0,0,0,0,0,1,1,1,0,0,0,0,0
401487501,American University Eagles,L. Graytok,4400159,,False,7.0,0,0,0,0,0,0,0,0,0,0,0,1,0,0,0,1,0
401487501,American University Eagles,TEAM,TOTAL,TOTAL,False,,15,50,14,37,1,13,11,14,4,22,26,12,4,1,19,21,42
401486931,Vermont Catamounts,A. Olson,4704725,,True,32.0,7,12,7,12,0,0,1,2,2,5,7,4,0,0,5,3,15
401486931,Vermont Catamounts,D. Richason,4594379,,True,32.0,4,10,0,4,4,6,0,0,0,7,7,1,1,1,0,2,12
401486931,Vermont Catamounts,C. Gilwee,4898987,,True,35.0,3,5,2,3,1,2,0,0,0,3,3,4,1,0,2,1,7
401486931,Vermont Catamounts,B. Vito,4898986,,True,18.0,2,4,2,3,0,1,0,0,3,5,8,1,4,0,2,3,4
401486931,Vermont Catamounts,E. Utterback,4594378,,True,37.0,4,15,4,15,0,0,4,5,0,6,6,7,0,0,4,3,12
401486931,Vermont Catamounts,M. Myklebust,4898988,,False,8.0,2,2,1,1,1,1,0,0,1,1,2,0,0,0,0,0,5
401486931,Vermont Catamounts,A. Dizon,4898985,,False,8.0,0,3,0,3,0,0,1,2,0,0,0,0,0,0,0,0,1
401486931,Vermont Catamounts,P. Gonzalez,5107683,,False,19.0,3,5,1,3,2,2,0,0,1,3,4,0,2,0,1,1,8
401486931,Vermont Catamounts,A. Matic,5107680,,False,2.0,0,0,0,0,0,0,0,0,0,2,2,1,1,0,0,0,0
401486931,Vermont Catamounts,C. Celaya,5107679,,False,9.0,0,2,0,1,0,1,0,0,0,1,1,1,2,0,0,0,0
401486931,Vermont Catamounts,TEAM,TOTAL,TOTAL,False,,25,58,17,45,8,13,6,9,8,34,42,19,11,1,14,13,64
401486931,Holy Cross Crusaders,L. Berger,4900539,,True,16.0,1,3,1,3,0,0,0,0,2,5,7,0,0,1,4,2,2
401486931,Holy Cross Crusaders,J. Allen,4704714,,True,26.0,6,14,6,14,0,0,1,4,2,2,4,0,1,0,3,2,13
401486931,Holy Cross Crusaders,K. Flanagan,5109211,,True,27.0,1,2,0,1,1,1,2,2,0,3,3,0,1,1,2,2,5
401486931,Holy Cross Crusaders,B. Power-Cassidy,4704715,,True,24.0,0,6,0,2,0,4,0,0,1,4,5,1,1,1,2,0,0
401486931,Holy Cross Crusaders,A. Cross,4595975,,True,28.0,1,5,0,2,1,3,2,2,1,1,2,0,2,0,1,4,5
401486931,Holy Cross Crusaders,M. Cahalan,5109210,,False,2.0,0,0,0,0,0,0,0,0,0,0,0,0,0,0,1,0,0
401486931,Holy Cross Crusaders,C. Wright,4703660,,False,6.0,0,1,0,1,0,0,0,0,0,1,1,0,0,0,0,0,0
401486931,Holy Cross Crusaders,M. Donnelly,5109213,,False,18.0,1,3,1,2,0,1,0,0,0,3,3,0,1,1,2,0,2
401486931,Holy Cross Crusaders,S. Foreman,5109212,,False,11.0,0,3,0,2,0,1,0,0,0,1,1,1,1,0,0,0,0
401486931,Holy Cross Crusaders,L. Huber,4900538,,False,2.0,0,0,0,0,0,0,0,0,0,0,0,0,0,0,0,0,0
401486931,Holy Cross Crusaders,G. Munt,4900537,,False,11.0,1,4,1,3,0,1,0,0,1,3,4,0,0,0,0,0,2
401486931,Holy Cross Crusaders,C. McCormack,4704716,,False,29.0,2,13,1,7,1,6,0,0,0,0,0,2,0,0,5,1,5
401486931,Holy Cross Crusaders,TEAM,TOTAL,TOTAL,False,,13,54,10,37,3,17,5,8,9,25,34,4,7,4,20,11,34
401486925,Vermont Catamounts,A. Olson,4704725,,True,28.0,9,12,9,12,0,0,8,10,2,4,6,1,0,1,1,1,26
401486925,Vermont Catamounts,D. Richason,4594379,,True,34.0,2,8,1,4,1,4,0,0,0,3,3,1,1,0,1,1,5
401486925,Vermont Catamounts,C. Gilwee,4898987,,True,33.0,4,9,3,4,1,5,0,0,0,3,3,1,1,1,3,2,9
401486925,Vermont Catamounts,B. Vito,4898986,,True,13.0,0,1,0,1,0,0,0,0,1,2,3,1,1,0,0,3,0
401486925,Vermont Catamounts,E. Utterback,4594378,,True,34.0,3,12,2,10,1,2,1,2,0,2,2,3,3,1,1,4,8
401486925,Vermont Catamounts,M. Myklebust,4898988,,False,2.0,0,0,0,0,0,0,0,0,0,0,0,0,0,0,0,0,0
401486925,Vermont Catamounts,A. Dizon,4898985,,False,14.0,2,6,2,6,0,0,0,0,2,4,6,1,0,0,0,1,4
401486925,Vermont Catamounts,N. Priede,5107684,,False,2.0,0,0,0,0,0,0,0,0,0,0,0,0,0,0,0,0,0
401486925,Vermont Catamounts,P. Gonzalez,5107683,,False,11.0,0,1,0,0,0,1,0,0,0,2,2,3,2,0,3,1,0
401486925,Vermont Catamounts,K. Hanson,5107682,,False,2.0,0,0,0,0,0,0,0,0,0,0,0,0,0,0,0,0,0
401486925,Vermont Catamounts,A. Matic,5107680,,False,2.0,1,1,1,1,0,0,0,0,0,0,0,0,0,0,0,0,2
401486925,Vermont Catamounts,C. Celaya,5107679,,False,25.0,1,1,1,1,0,0,4,4,1,6,7,0,2,1,0,0,6
401486925,Vermont Catamounts,TEAM,TOTAL,TOTAL,False,,22,51,19,39,3,12,13,16,8,27,35,11,10,4,9,13,60
401486925,Army Black Knights,S. Hunter,4595466,,True,24.0,2,5,2,5,0,0,0,1,5,4,9,1,0,0,2,4,4
401486925,Army Black Knights,K. Hall,4595465,,True,27.0,3,10,3,8,0,2,4,6,4,3,7,0,0,1,4,4,10
401486925,Army Black Knights,C. Richman,5109191,,True,27.0,2,8,0,0,2,8,0,0,0,3,3,2,1,0,2,0,6
401486925,Army Black Knights,R. Ericson,5109190,,True,31.0,1,8,0,5,1,3,1,2,0,2,2,3,0,1,0,1,4
401486925,Army Black Knights,L. Lithgow,4704696,,True,22.0,1,4,1,1,0,3,0,0,2,1,3,0,2,1,2,1,2
401486925,Army Black Knights,L. Madison,5109194,,False,3.0,1,1,1,1,0,0,0,0,0,0,0,0,0,0,0,0,2
401486925,Army Black Knights,A. Ainsworth,5109189,,False,4.0,0,0,0,0,0,0,0,0,1,1,2,0,0,0,0,1,0
401486925,Army Black Knights,J. Laguna,5109193,,False,3.0,0,0,0,0,0,0,0,0,0,1,1,0,0,0,0,0,0
401486925,Army Black Knights,V. Kearney,4899713,,False,12.0,2,7,1,5,1,2,0,0,0,1,1,0,0,0,2,2,5
401486925,Army Black Knights,S. McNaughton,4704694,,False,16.0,0,6,0,6,0,0,0,0,0,2,2,1,0,0,3,3,0
401486925,Army Black Knights,J. Strippoli,4595470,,False,6.0,0,3,0,1,0,2,2,2,0,0,0,0,1,0,1,0,2
401486925,Army Black Knights,H. Brown,4595467,,False,15.0,1,3,1,2,0,1,0,0,2,1,3,0,0,0,1,2,2
401486925,Army Black Knights,N. Rhine,4595464,,False,10.0,0,1,0,0,0,1,0,0,1,1,2,0,0,0,0,0,0
401486925,Army Black Knights,TEAM,TOTAL,TOTAL,False,,13,56,9,34,4,22,7,11,18,22,40,7,4,3,19,18,37
401486919,UMBC Retrievers,K. Bell,4399563,,True,30.0,9,13,9,13,0,0,0,0,5,3,8,0,3,0,3,5,18
401486919,UMBC Retrievers,L. Drake,4898978,,True,30.0,0,6,0,4,0,2,0,0,0,3,3,4,1,0,2,2,0
401486919,UMBC Retrievers,KK White,4705119,,True,29.0,6,16,5,13,1,3,1,1,3,6,9,2,0,0,6,2,14
401486919,UMBC Retrievers,R. Donahue,4703784,,True,10.0,1,4,0,1,1,3,0,0,0,0,0,0,0,0,0,0,3
401486919,UMBC Retrievers,N. Staples,4068209,,True,30.0,9,12,4,6,5,6,1,1,2,3,5,4,1,0,2,0,24
401486919,UMBC Retrievers,M. Turkstra,4704885,,False,8.0,0,1,0,1,0,0,0,0,0,0,0,0,1,1,0,1,0
401486919,UMBC Retrievers,P. Iradier,4703993,,False,3.0,0,0,0,0,0,0,0,0,0,0,0,0,0,0,0,1,0
401486919,UMBC Retrievers,C. Yanez,5107672,,False,17.0,0,1,0,0,0,1,0,0,0,0,0,3,1,0,3,1,0
401486919,UMBC Retrievers,A. McCalla,4406561,,False,26.0,3,9,2,6,1,3,2,2,0,2,2,1,2,0,1,5,9
401486919,UMBC Retrievers,S. Smith,4400234,,False,13.0,0,1,0,1,0,0,0,0,0,3,3,2,0,0,0,3,0
401486919,UMBC Retrievers,K. Dixon,4281000,,False,4.0,0,0,0,0,0,0,0,0,0,0,0,0,0,0,1,0,0
401486919,UMBC Retrievers,TEAM,TOTAL,TOTAL,False,,28,63,20,45,8,18,4,4,10,20,30,16,9,1,18,20,68
401486919,American University Eagles,E. Johns,4704688,,True,37.0,11,21,8,16,3,5,0,0,4,3,7,2,1,0,2,3,25
401486919,American University Eagles,L. Stack,4595455,,True,37.0,1,2,1,2,0,0,5,7,2,2,4,0,2,0,1,3,7
401486919,American University Eagles,K. Henning,4704686,,True,24.0,0,5,0,3,0,2,0,0,2,7,9,3,1,0,4,1,0
401486919,American University Eagles,I. Bales,4704685,,True,36.0,5,11,5,9,0,2,4,4,1,3,4,4,2,0,6,0,14
401486919,American University Eagles,R. DeRubbo,4703746,,True,32.0,5,14,2,6,3,8,5,6,0,5,5,6,3,0,1,3,18
401486919,American University Eagles,M. Lavin,5109188,,False,3.0,0,0,0,0,0,0,0,0,0,0,0,0,0,0,1,0,0
401486919,American University Eagles,M. Lee,4704592,,False,3.0,1,1,1,1,0,0,0,0,0,0,0,0,0,0,1,1,2
401486919,American University Eagles,L. Nogues,5109187,,False,2.0,0,0,0,0,0,0,0,0,0,0,0,0,0,0,1,0,0
401486919,American University Eagles,B. Garbee,4899710,,False,3.0,0,0,0,0,0,0,0,0,0,0,0,0,0,0,1,0,0
401486919,American University Eagles,A. LeMaster,4703737,,False,2.0,0,0,0,0,0,0,0,0,0,0,0,0,0,0,1,0,0
401486919,American University Eagles,S. Stetson,4595453,,False,21.0,2,3,2,2,0,1,0,0,0,0,0,2,2,0,1,3,4
401486919,American University Eagles,TEAM,TOTAL,TOTAL,False,,25,57,19,39,6,18,14,17,9,20,29,17,11,0,20,14,70
401486917,UMBC Retrievers,K. Bell,4399563,,True,26.0,1,10,1,10,0,0,0,0,3,7,10,2,1,1,1,2,2
401486917,UMBC Retrievers,L. Drake,4898978,,True,35.0,2,6,2,3,0,3,0,0,0,2,2,2,3,1,3,0,4
401486917,UMBC Retrievers,A. McCalla,4406561,,True,24.0,3,5,2,4,1,1,0,0,0,0,0,1,0,0,1,0,7
401486917,UMBC Retrievers,S. Smith,4400234,,True,15.0,2,5,2,5,0,0,1,2,1,2,3,0,0,0,1,2,5
401486917,UMBC Retrievers,K. Dixon,4281000,,True,23.0,1,4,1,4,0,0,0,1,1,0,1,5,0,0,2,1,2
401486917,UMBC Retrievers,M. Turkstra,4704885,,False,7.0,0,0,0,0,0,0,0,0,1,0,1,0,0,0,1,1,0
401486917,UMBC Retrievers,P. Iradier,4703993,,False,7.0,1,1,1,1,0,0,0,0,1,0,1,0,0,0,0,1,2
401486917,UMBC Retrievers,G. Ceseretti,5107671,,False,6.0,0,3,0,1,0,2,0,0,1,0,1,1,0,0,0,1,0
401486917,UMBC Retrievers,A. May,4898980,,False,9.0,0,0,0,0,0,0,0,0,0,1,1,0,0,0,2,0,0
401486917,UMBC Retrievers,KK White,4705119,,False,24.0,5,14,5,12,0,2,1,2,0,0,0,0,1,1,3,3,11
401486917,UMBC Retrievers,R. Donahue,4703784,,False,5.0,1,3,0,1,1,2,0,0,0,0,0,0,1,0,0,0,3
401486917,UMBC Retrievers,N. Staples,4068209,,False,19.0,1,4,1,2,0,2,0,0,0,1,1,3,1,0,1,1,2
401486917,UMBC Retrievers,TEAM,TOTAL,TOTAL,False,,17,55,15,43,2,12,2,5,8,16,24,14,7,3,15,12,38
401486917,Lafayette Leopards,K. Drummond,4704754,,True,23.0,5,6,5,6,0,0,0,1,2,5,7,1,0,0,0,1,10
401486917,Lafayette Leopards,A. Antognoli,4900540,,True,28.0,6,12,3,5,3,7,0,0,1,2,3,1,1,0,2,1,15
401486917,Lafayette Leopards,M. Andrews,4704756,,True,31.0,7,14,7,12,0,2,1,1,2,7,9,3,0,1,4,1,15
401486917,Lafayette Leopards,H. Smith,4704553,,True,27.0,1,2,1,1,0,1,0,0,1,3,4,1,0,0,4,0,2
401486917,Lafayette Leopards,J. Booth,4433381,,True,30.0,5,7,4,5,1,2,0,0,1,6,7,6,0,0,2,1,11
401486917,Lafayette Leopards,E. Shields,5109214,,False,17.0,1,3,1,3,0,0,0,0,2,3,5,0,1,1,0,1,2
401486917,Lafayette Leopards,S. Ntaconayigize,5109216,,False,11.0,1,3,0,0,1,3,0,0,0,1,1,2,0,0,1,1,3
401486917,Lafayette Leopards,K. Donahue,5109215,,False,11.0,1,2,0,0,1,2,0,0,1,0,1,2,2,0,1,2,3
401486917,Lafayette Leopards,K. Favours,4900541,,False,22.0,4,11,1,1,3,10,0,0,0,0,0,3,0,0,0,0,11
401486917,Lafayette Leopards,TEAM,TOTAL,TOTAL,False,,31,60,22,33,9,27,1,2,11,30,41,19,4,2,18,8,72
401486915,UMBC Retrievers,K. Bell,4399563,,True,30.0,2,8,2,8,0,0,1,1,2,7,9,1,1,2,5,2,5
401486915,UMBC Retrievers,L. Drake,4898978,,True,18.0,0,3,0,1,0,2,1,2,0,3,3,1,1,0,1,0,1
401486915,UMBC Retrievers,A. McCalla,4406561,,True,40.0,5,13,3,7,2,6,1,2,0,5,5,2,3,0,1,3,13
401486915,UMBC Retrievers,S. Smith,4400234,,True,29.0,1,7,1,6,0,1,0,2,0,3,3,1,0,0,0,3,2
401486915,UMBC Retrievers,K. Dixon,4281000,,True,30.0,7,11,4,8,3,3,4,6,0,0,0,1,1,0,6,3,21
401486915,UMBC Retrievers,M. Turkstra,4704885,,False,3.0,0,0,0,0,0,0,0,0,0,0,0,0,0,0,1,2,0
401486915,UMBC Retrievers,P. Iradier,4703993,,False,12.0,0,1,0,1,0,0,0,0,1,3,4,0,0,0,2,0,0
401486915,UMBC Retrievers,C. Yanez,5107672,,False,8.0,0,0,0,0,0,0,0,0,0,1,1,0,0,0,1,2,0
401486915,UMBC Retrievers,A. May,4898980,,False,6.0,0,0,0,0,0,0,0,0,0,0,0,0,0,0,0,2,0
401486915,UMBC Retrievers,N. Staples,4068209,,False,24.0,2,5,1,4,1,1,0,0,1,0,1,1,0,0,2,2,5
401486915,UMBC Retrievers,TEAM,TOTAL,TOTAL,False,,17,48,11,35,6,13,7,13,6,24,30,7,6,2,19,19,47
401486915,Loyola Maryland Greyhounds,L. Therien,4900552,,True,38.0,7,14,7,14,0,0,3,5,2,9,11,1,2,0,3,3,17
401486915,Loyola Maryland Greyhounds,K. Sims,4898948,,True,15.0,3,5,3,5,0,0,0,0,3,1,4,1,1,1,3,3,6
401486915,Loyola Maryland Greyhounds,M. Van-Otoo,5109223,,True,16.0,0,3,0,2,0,1,0,0,0,1,1,1,1,0,0,1,0
401486915,Loyola Maryland Greyhounds,B. Rozzi,4596306,,True,39.0,3,7,2,4,1,3,3,4,0,4,4,3,0,0,3,1,10
401486915,Loyola Maryland Greyhounds,T. Dixon,4400209,,True,30.0,4,10,3,7,1,3,2,2,3,7,10,2,1,0,3,2,11
401486915,Loyola Maryland Greyhounds,M. Espinal,5109228,,False,12.0,3,3,2,2,1,1,0,0,0,0,0,1,0,1,0,3,7
401486915,Loyola Maryland Greyhounds,A. Therien,4596307,,False,2.0,0,2,0,2,0,0,0,0,1,0,1,0,0,0,0,0,0
401486915,Loyola Maryland Greyhounds,E. Glezen,4596304,,False,6.0,0,0,0,0,0,0,2,2,0,0,0,0,0,0,1,4,2
401486915,Loyola Maryland Greyhounds,K. Ratigan,5109222,,False,15.0,1,4,0,0,1,4,0,0,0,2,2,0,1,0,0,1,3
401486915,Loyola Maryland Greyhounds,C. Tanedo,4704774,,False,27.0,1,5,1,3,0,2,3,5,0,1,1,1,0,0,3,0,5
401486915,Loyola Maryland Greyhounds,TEAM,TOTAL,TOTAL,False,,22,53,18,39,4,14,13,18,10,27,37,10,6,2,16,18,61
401486910,NJIT Highlanders,T. Williams,4898967,,True,29.0,5,14,5,13,0,1,3,5,4,3,7,0,0,2,3,2,13
401486910,NJIT Highlanders,A. Zuniga,5107606,,True,25.0,2,6,2,4,0,2,0,0,0,0,0,4,2,0,1,1,4
401486910,NJIT Highlanders,L. Litwinko,4704169,,True,33.0,2,7,2,7,0,0,1,1,1,5,6,1,0,0,3,1,5
401486910,NJIT Highlanders,A. Myers,4704167,,True,25.0,1,9,1,6,0,3,1,4,0,3,3,0,0,0,0,0,3
401486910,NJIT Highlanders,K. Squier,4594414,,True,29.0,4,7,4,7,0,0,0,0,1,3,4,1,0,0,1,3,8
401486910,NJIT Highlanders,L. Anderson,4704170,,False,10.0,1,2,1,2,0,0,1,1,1,1,2,1,0,0,0,0,3
401486910,NJIT Highlanders,K. Brereton,4704168,,False,3.0,0,0,0,0,0,0,0,0,0,1,1,0,0,0,0,1,0
401486910,NJIT Highlanders,L. Syrek,4704165,,False,4.0,1,1,1,1,0,0,0,0,0,1,1,0,0,0,0,0,2
401486910,NJIT Highlanders,D. Evans,4594419,,False,1.0,0,0,0,0,0,0,0,0,0,0,0,0,0,0,0,0,0
401486910,NJIT Highlanders,M. Fux,4594416,,False,7.0,2,2,2,2,0,0,0,0,0,1,1,1,0,0,1,0,4
401486910,NJIT Highlanders,A. O'Roke,5107605,,False,1.0,0,0,0,0,0,0,0,0,0,0,0,0,0,0,1,0,0
401486910,NJIT Highlanders,R. Vaughan,4898968,,False,15.0,2,4,0,1,2,3,0,0,0,1,1,1,0,0,2,4,6
401486910,NJIT Highlanders,G. Plummer,4704166,,False,5.0,0,0,0,0,0,0,0,0,0,0,0,0,0,0,0,0,0
401486910,NJIT Highlanders,K. Dalrymple,4594418,,False,13.0,1,1,0,0,1,1,0,0,0,0,0,0,0,0,1,1,3
401486910,NJIT Highlanders,TEAM,TOTAL,TOTAL,False,,21,53,18,43,3,10,6,11,8,23,31,9,2,2,13,13,51
401486910,Colgate Raiders,T. McMillan,4704704,,True,19.0,6,11,6,11,0,0,0,0,2,1,3,1,0,0,0,1,12
401486910,Colgate Raiders,M. Schiller,5109205,,True,29.0,4,6,4,4,0,2,0,0,0,6,6,2,2,1,1,0,8
401486910,Colgate Raiders,T. Golembiewski,4900535,,True,33.0,6,9,6,7,0,2,3,3,0,6,6,3,0,1,1,2,15
401486910,Colgate Raiders,J. Paul,4595552,,True,19.0,3,7,0,3,3,4,0,0,0,2,2,1,0,0,0,0,9
401486910,Colgate Raiders,A. Brodie,4595550,,True,28.0,3,8,3,5,0,3,0,0,0,3,3,3,0,0,0,0,6
401486910,Colgate Raiders,N. Parks,5109206,,False,6.0,0,2,0,2,0,0,0,0,0,0,0,0,0,0,0,2,0
401486910,Colgate Raiders,S. Diehl,4900536,,False,20.0,4,5,3,3,1,2,0,0,1,1,2,1,0,0,0,2,9
401486910,Colgate Raiders,A. Ferguson,5109209,,False,12.0,0,1,0,1,0,0,2,2,0,2,2,3,0,0,0,0,2
401486910,Colgate Raiders,C. Midgette,5109204,,False,5.0,0,2,0,2,0,0,1,2,1,0,1,0,0,0,0,1,1
401486910,Colgate Raiders,L. Cook,5109207,,False,6.0,0,2,0,0,0,2,0,0,0,1,1,0,0,0,1,0,0
401486910,Colgate Raiders,M. McMahon,4900534,,False,23.0,3,7,3,6,0,1,1,2,0,1,1,0,0,0,2,1,7
401486910,Colgate Raiders,TEAM,TOTAL,TOTAL,False,,29,60,25,44,4,16,7,9,8,24,32,14,2,2,6,9,69
401486903,NJIT Highlanders,M. Fux,4594416,,True,20.0,2,6,1,3,1,3,0,0,2,3,5,1,0,0,3,1,5
401486903,NJIT Highlanders,T. Williams,4898967,,True,27.0,3,4,2,3,1,1,0,2,0,5,5,0,0,2,1,3,7
401486903,NJIT Highlanders,L. Litwinko,4704169,,True,28.0,4,11,4,8,0,3,0,0,1,2,3,1,1,0,4,3,8
401486903,NJIT Highlanders,A. Myers,4704167,,True,37.0,9,16,6,9,3,7,2,3,1,2,3,1,1,0,5,2,23
401486903,NJIT Highlanders,K. Squier,4594414,,True,35.0,3,5,2,3,1,2,0,0,2,2,4,2,4,1,0,4,7
401486903,NJIT Highlanders,K. Brereton,4704168,,False,8.0,0,1,0,1,0,0,0,0,1,0,1,1,0,0,1,1,0
401486903,NJIT Highlanders,D. Evans,4594419,,False,2.0,0,0,0,0,0,0,0,0,0,0,0,0,0,0,0,0,0
401486903,NJIT Highlanders,A. Zuniga,5107606,,False,8.0,1,3,1,2,0,1,0,0,0,1,1,0,0,0,2,0,2
401486903,NJIT Highlanders,R. Vaughan,4898968,,False,10.0,0,1,0,0,0,1,0,0,0,0,0,2,1,0,1,2,0
401486903,NJIT Highlanders,G. Plummer,4704166,,False,14.0,0,2,0,0,0,2,0,0,1,0,1,0,0,0,1,0,0
401486903,NJIT Highlanders,K. Dalrymple,4594418,,False,11.0,2,3,0,0,2,3,0,0,0,0,0,1,0,0,1,0,6
401486903,NJIT Highlanders,TEAM,TOTAL,TOTAL,False,,24,52,16,29,8,23,2,5,8,18,26,9,7,3,19,16,58
401486903,Lafayette Leopards,K. Drummond,4704754,,True,26.0,3,6,3,6,0,0,0,0,1,2,3,0,1,1,1,3,6
401486903,Lafayette Leopards,A. Antognoli,4900540,,True,33.0,2,10,1,7,1,3,0,0,1,1,2,0,0,0,4,0,5
401486903,Lafayette Leopards,M. Andrews,4704756,,True,31.0,8,13,7,11,1,2,3,4,1,6,7,0,0,0,3,2,20
401486903,Lafayette Leopards,H. Smith,4704553,,True,34.0,3,6,3,5,0,1,6,8,2,2,4,2,2,0,1,1,12
401486903,Lafayette Leopards,J. Booth,4433381,,True,33.0,2,5,2,5,0,0,2,4,0,2,2,5,1,0,3,1,6
401486903,Lafayette Leopards,E. Shields,5109214,,False,14.0,2,2,2,2,0,0,2,2,3,2,5,0,0,0,0,0,6
401486903,Lafayette Leopards,S. Ntaconayigize,5109216,,False,15.0,1,1,0,0,1,1,2,2,0,3,3,0,1,1,0,1,5
401486903,Lafayette Leopards,K. Donahue,5109215,,False,7.0,0,2,0,1,0,1,0,0,0,0,0,0,0,0,1,1,0
401486903,Lafayette Leopards,K. Favours,4900541,,False,7.0,1,4,1,2,0,2,0,0,0,0,0,0,1,0,2,1,2
401486903,Lafayette Leopards,TEAM,TOTAL,TOTAL,False,,22,49,19,39,3,10,15,20,10,21,31,7,6,2,16,10,62
401486899,Maine Black Bears,A. Smith,4898966,,True,17.0,3,5,3,5,0,0,8,8,1,2,3,6,0,2,1,2,14
401486899,Maine Black Bears,C. Bornemann,4704599,,True,33.0,11,17,6,10,5,7,2,4,1,8,9,2,0,0,2,2,29
401486899,Maine Black Bears,P. Gallego,4898963,,True,23.0,2,4,2,3,0,1,0,0,0,6,6,3,0,0,0,3,4
401486899,Maine Black Bears,S. Hodgson,4898962,,True,24.0,0,1,0,0,0,1,0,0,0,2,2,0,0,0,2,2,0
401486899,Maine Black Bears,O. Rockwood,4704595,,True,29.0,4,7,3,3,1,4,0,0,1,0,1,1,0,0,0,0,9
401486899,Maine Black Bears,M. Nenadic,5107602,,False,3.0,0,0,0,0,0,0,2,2,1,0,1,0,0,0,1,1,2
401486899,Maine Black Bears,A. Laurence,4594356,,False,18.0,1,3,1,3,0,0,0,0,1,0,1,7,0,1,1,5,2
401486899,Maine Black Bears,A. Soler,5107603,,False,3.0,0,0,0,0,0,0,0,0,0,1,1,0,0,0,0,0,0
401486899,Maine Black Bears,S. Talon,5107601,,False,16.0,1,4,1,3,0,1,0,0,0,1,1,2,0,0,0,2,2
401486899,Maine Black Bears,J. Christopher,5107600,,False,31.0,9,13,2,3,7,10,1,2,2,5,7,4,1,0,0,0,26
401486899,Maine Black Bears,I. Shlush,4899022,,False,3.0,0,1,0,0,0,1,0,0,0,1,1,0,0,1,0,0,0
401486899,Maine Black Bears,TEAM,TOTAL,TOTAL,False,,31,55,18,30,13,25,13,16,7,30,37,25,1,4,8,17,88
401486899,Army Black Knights,S. Hunter,4595466,,True,21.0,5,12,5,12,0,0,3,6,1,4,5,0,0,0,3,2,13
401486899,Army Black Knights,K. Hall,4595465,,True,20.0,1,2,1,2,0,0,5,8,2,4,6,3,0,1,3,5,7
401486899,Army Black Knights,R. Ericson,5109190,,True,22.0,1,3,1,3,0,0,0,0,1,3,4,2,0,0,1,1,2
401486899,Army Black Knights,L. Lithgow,4704696,,True,37.0,3,8,1,2,2,6,4,5,0,1,1,0,1,0,2,0,12
401486899,Army Black Knights,S. McNaughton,4704694,,True,27.0,5,10,4,6,1,4,3,4,0,1,1,1,0,0,2,3,14
401486899,Army Black Knights,L. Madison,5109194,,False,4.0,0,2,0,2,0,0,0,0,0,0,0,0,0,0,0,0,0
401486899,Army Black Knights,A. Ainsworth,5109189,,False,2.0,0,0,0,0,0,0,2,2,0,0,0,0,0,0,0,0,2
401486899,Army Black Knights,J. Laguna,5109193,,False,4.0,0,0,0,0,0,0,0,0,0,0,0,0,0,0,0,0,0
401486899,Army Black Knights,C. Richman,5109191,,False,11.0,1,2,1,1,0,1,0,0,1,1,2,1,0,0,0,1,2
401486899,Army Black Knights,J. Strippoli,4595470,,False,2.0,0,0,0,0,0,0,0,0,0,0,0,0,1,0,1,0,0
401486899,Army Black Knights,H. Brown,4595467,,False,21.0,0,1,0,1,0,0,0,0,0,0,0,2,0,0,0,5,0
401486899,Army Black Knights,N. Rhine,4595464,,False,29.0,2,8,0,1,2,7,2,2,0,2,2,2,1,0,0,3,8
401486899,Army Black Knights,TEAM,TOTAL,TOTAL,False,,18,48,13,30,5,18,19,27,6,19,25,11,3,1,12,20,60
401486890,Navy Midshipmen,M. Andrews,4704780,,True,32.0,1,2,1,2,0,0,0,0,4,6,10,0,2,1,4,4,2
401486890,Navy Midshipmen,K. Samson,5109237,,True,29.0,3,7,3,7,0,0,0,0,1,8,9,3,0,4,3,2,6
401486890,Navy Midshipmen,S. Watts,4704782,,True,40.0,10,23,8,14,2,9,0,2,2,5,7,1,0,1,4,2,22
401486890,Navy Midshipmen,M. Louridas,5109236,,True,37.0,4,14,4,10,0,4,0,1,0,4,4,1,0,0,3,3,8
401486890,Navy Midshipmen,M. Schrader,4595622,,True,40.0,4,7,1,4,3,3,0,0,0,8,8,2,1,1,3,2,11
401486890,Navy Midshipmen,M. Demos,5109235,,False,9.0,0,0,0,0,0,0,0,0,0,0,0,0,0,1,0,0,0
401486890,Navy Midshipmen,S. Clarke,5109231,,False,13.0,0,4,0,4,0,0,2,6,1,1,2,1,0,0,1,3,2
401486890,Navy Midshipmen,K. Giuliani,5109230,,False,0.0,0,0,0,0,0,0,0,0,0,0,0,0,0,0,0,1,0
401486890,Navy Midshipmen,TEAM,TOTAL,TOTAL,False,,22,57,17,41,5,16,2,9,9,34,43,8,3,8,18,17,51
401486890,Binghamton Bearcats,G. Coleman,4898955,,True,30.0,6,14,6,13,0,1,3,3,1,2,3,1,1,0,0,3,15
401486890,Binghamton Bearcats,C. Traeger,4594347,,True,35.0,3,9,3,7,0,2,0,0,0,13,13,2,2,0,1,2,6
401486890,Binghamton Bearcats,J. Weltz,4898953,,True,31.0,1,4,1,2,0,2,2,4,1,4,5,4,3,0,1,1,4
401486890,Binghamton Bearcats,E. Wanzer,4898950,,True,23.0,3,11,2,5,1,6,0,0,0,2,2,1,0,0,1,1,7
401486890,Binghamton Bearcats,D. Bowman,4594345,,True,36.0,9,16,9,16,0,0,0,0,0,2,2,2,4,1,5,1,18
401486890,Binghamton Bearcats,E. Okubasu,5107554,,False,3.0,0,1,0,1,0,0,0,0,0,0,0,0,0,0,0,0,0
401486890,Binghamton Bearcats,K. Wilson,4899641,,False,3.0,0,1,0,1,0,0,0,0,0,0,0,0,0,0,0,1,0
401486890,Binghamton Bearcats,C. Fauria,5107553,,False,7.0,0,0,0,0,0,0,1,2,0,1,1,0,0,0,1,0,1
401486890,Binghamton Bearcats,M. Casey,5107552,,False,8.0,0,0,0,0,0,0,0,0,1,3,4,0,0,0,0,0,0
401486890,Binghamton Bearcats,A. Long,5107551,,False,5.0,0,2,0,2,0,0,0,0,0,0,0,0,0,0,1,1,0
401486890,Binghamton Bearcats,S. O'Connor,4595708,,False,18.0,1,4,1,4,0,0,1,2,2,3,5,0,0,0,0,0,3
401486890,Binghamton Bearcats,K. Bannis,4594346,,False,1.0,0,0,0,0,0,0,0,0,0,0,0,0,0,0,0,0,0
401486890,Binghamton Bearcats,TEAM,TOTAL,TOTAL,False,,23,62,22,51,1,11,7,11,7,30,37,10,10,1,10,10,54
401486882,Binghamton Bearcats,G. Coleman,4898955,,True,25.0,4,11,3,9,1,2,0,0,2,4,6,1,1,0,0,4,9
401486882,Binghamton Bearcats,C. Traeger,4594347,,True,33.0,6,11,5,9,1,2,1,2,5,10,15,1,3,0,2,0,14
401486882,Binghamton Bearcats,E. Wanzer,4898950,,True,20.0,5,10,1,3,4,7,1,2,0,0,0,1,0,0,1,3,15
401486882,Binghamton Bearcats,C. Roberts,4594349,,True,28.0,0,1,0,1,0,0,0,0,0,0,0,4,0,0,2,0,0
401486882,Binghamton Bearcats,D. Bowman,4594345,,True,38.0,7,14,6,13,1,1,2,4,0,3,3,5,4,2,3,1,17
401486882,Binghamton Bearcats,K. Wilson,4899641,,False,5.0,0,0,0,0,0,0,0,1,0,1,1,0,0,0,1,0,0
401486882,Binghamton Bearcats,E. Delicado,4704628,,False,3.0,0,1,0,1,0,0,0,0,0,1,1,0,0,0,1,0,0
401486882,Binghamton Bearcats,C. Fauria,5107553,,False,10.0,3,3,3,3,0,0,0,1,1,0,1,0,0,1,2,1,6
401486882,Binghamton Bearcats,M. Casey,5107552,,False,8.0,0,0,0,0,0,0,0,0,1,0,1,0,0,0,0,0,0
401486882,Binghamton Bearcats,A. Long,5107551,,False,1.0,0,0,0,0,0,0,0,0,0,0,0,0,0,0,0,0,0
401486882,Binghamton Bearcats,J. Weltz,4898953,,False,22.0,4,5,2,3,2,2,5,6,0,1,1,6,1,0,4,3,15
401486882,Binghamton Bearcats,S. O'Connor,4595708,,False,7.0,0,0,0,0,0,0,0,0,0,1,1,0,0,0,0,1,0
401486882,Binghamton Bearcats,TEAM,TOTAL,TOTAL,False,,29,56,20,42,9,14,9,16,10,23,33,18,9,3,17,13,76
401486882,Army Black Knights,S. Hunter,4595466,,True,36.0,9,14,9,14,0,0,4,7,4,10,14,0,3,1,4,2,22
401486882,Army Black Knights,C. Richman,5109191,,True,21.0,1,3,0,0,1,3,0,0,0,1,1,0,0,0,3,4,3
401486882,Army Black Knights,R. Ericson,5109190,,True,29.0,3,10,2,5,1,5,1,1,0,1,1,0,1,0,3,4,8
401486882,Army Black Knights,L. Lithgow,4704696,,True,31.0,3,8,3,4,0,4,1,2,0,1,1,1,1,0,3,1,7
401486882,Army Black Knights,H. Brown,4595467,,True,32.0,3,6,3,5,0,1,2,2,1,0,1,0,0,0,2,4,8
401486882,Army Black Knights,L. Madison,5109194,,False,4.0,0,0,0,0,0,0,0,0,0,0,0,0,1,0,0,0,0
401486882,Army Black Knights,S. McNaughton,4704694,,False,36.0,6,13,5,9,1,4,0,0,1,5,6,2,1,0,3,1,13
401486882,Army Black Knights,N. Rhine,4595464,,False,11.0,0,1,0,0,0,1,0,2,1,2,3,0,0,0,1,3,0
401486882,Army Black Knights,TEAM,TOTAL,TOTAL,False,,25,55,22,37,3,18,8,14,9,20,29,3,7,1,19,19,61
401486374,Temple Owls,D. Solis,4594361,,True,16.0,4,6,4,6,0,0,0,0,0,3,3,1,0,1,2,2,8
401486374,Temple Owls,T. Gary,4705049,,True,21.0,2,3,2,3,0,0,0,0,2,2,4,1,1,0,0,2,4
401486374,Temple Owls,J. Clinton,4703686,,True,36.0,7,11,7,10,0,1,3,3,0,2,2,4,2,1,4,3,17
401486374,Temple Owls,T. East,4691699,,True,24.0,3,8,3,8,0,0,0,0,1,2,3,1,2,0,0,1,6
401486374,Temple Owls,A. Nelson,4433355,,True,35.0,8,14,2,5,6,9,1,2,0,2,2,5,0,0,1,0,23
401486374,Temple Owls,I. Piper,5107578,,False,15.0,1,3,1,3,0,0,0,0,0,2,2,0,0,1,0,4,2
401486374,Temple Owls,C. Perea,4703754,,False,14.0,3,4,1,1,2,3,0,0,1,5,6,0,0,0,0,2,8
401486374,Temple Owls,B. Garner,4398742,,False,10.0,0,2,0,2,0,0,0,0,1,1,2,1,0,1,0,2,0
401486374,Temple Owls,K. Wilson,5107579,,False,3.0,0,1,0,1,0,0,0,0,0,0,0,0,1,0,0,0,0
401486374,Temple Owls,M. Waleed,4898654,,False,4.0,0,1,0,0,0,1,0,0,0,1,1,0,1,0,1,3,0
401486374,Temple Owls,J. Holmes,4281490,,False,21.0,4,6,3,5,1,1,0,0,2,5,7,2,0,1,2,3,9
401486374,Temple Owls,TEAM,TOTAL,TOTAL,False,,32,59,23,44,9,15,4,5,7,25,32,15,7,5,10,22,77
401486374,Bucknell Bison,I. King,4900533,,True,32.0,5,11,1,4,4,7,2,2,0,0,0,1,0,0,1,0,16
401486374,Bucknell Bison,E. Shaffer,4595535,,True,30.0,2,6,2,6,0,0,3,7,1,3,4,6,0,2,0,2,7
401486374,Bucknell Bison,R. Sisselman,4900531,,True,25.0,3,6,1,1,2,5,3,4,0,0,0,3,1,0,2,0,11
401486374,Bucknell Bison,B. Matthews,5109200,,True,17.0,1,4,0,1,1,3,0,0,1,3,4,0,0,0,3,0,3
401486374,Bucknell Bison,C. Collins,4900532,,True,36.0,6,11,6,9,0,2,4,5,0,3,3,4,1,0,3,3,16
401486374,Bucknell Bison,G. Sullivan,5109201,,False,10.0,1,1,1,1,0,0,0,0,0,1,1,0,0,0,0,0,2
401486374,Bucknell Bison,K. Reinbeau,4704700,,False,2.0,0,0,0,0,0,0,0,0,0,2,2,0,0,0,0,0,0
401486374,Bucknell Bison,E. Theodorsson,5109199,,False,18.0,2,6,1,4,1,2,2,2,0,5,5,0,0,0,2,0,7
401486374,Bucknell Bison,J. Kulesza,4704702,,False,4.0,0,0,0,0,0,0,0,0,0,0,0,0,0,0,0,0,0
401486374,Bucknell Bison,T. Johnson,4595533,,False,15.0,0,2,0,1,0,1,0,0,1,0,1,0,1,0,1,0,0
401486374,Bucknell Bison,C. Dingler,4577540,,False,11.0,0,0,0,0,0,0,0,0,0,0,0,1,1,0,0,1,0
401486374,Bucknell Bison,TEAM,TOTAL,TOTAL,False,,20,47,12,27,8,20,14,20,5,18,23,15,4,2,14,6,62
401486109,Boston University Terriers,S. Crispe,5109197,,True,35.0,4,8,4,7,0,1,8,8,4,3,7,2,0,0,6,4,16
401486109,Boston University Terriers,M. Durant,4599732,,True,27.0,3,6,3,6,0,0,0,0,1,9,10,5,1,2,5,5,6
401486109,Boston University Terriers,L. Davenport,4899718,,True,27.0,3,6,1,4,2,2,2,2,1,4,5,1,2,0,4,3,10
401486109,Boston University Terriers,M. Pina,4599731,,True,34.0,5,8,1,2,4,6,4,4,1,0,1,2,1,0,1,2,18
401486109,Boston University Terriers,S. Johnson,4599729,,True,37.0,6,13,6,13,0,0,1,2,0,0,0,3,2,0,4,2,13
401486109,Boston University Terriers,S. Beneventine,4704699,,False,14.0,0,2,0,1,0,1,0,0,0,0,0,3,1,0,1,0,0
401486109,Boston University Terriers,K. Mingo,4704698,,False,4.0,0,2,0,1,0,1,0,0,0,2,2,0,0,0,0,0,0
401486109,Boston University Terriers,L. Shean,4599727,,False,22.0,5,7,0,1,5,6,2,2,2,2,4,1,0,0,1,3,17
401486109,Boston University Terriers,TEAM,TOTAL,TOTAL,False,,26,52,15,35,11,17,17,18,10,23,33,17,7,2,23,19,80
401486109,Boston College Eagles,M. Gakdeng,4898548,,True,21.0,4,10,4,10,0,0,2,6,2,0,2,1,1,1,1,3,10
401486109,Boston College Eagles,J. Lacey,4702861,,True,37.0,8,15,3,5,5,10,1,1,0,3,3,1,5,1,4,2,22
401486109,Boston College Eagles,T. Mair,5106222,,True,40.0,4,8,2,5,2,3,2,2,1,5,6,9,2,0,1,4,12
401486109,Boston College Eagles,A. Daley,4898550,,True,36.0,5,10,5,8,0,2,5,8,0,3,3,1,0,1,2,3,15
401486109,Boston College Eagles,D. Waggoner,4433482,,True,40.0,13,18,13,18,0,0,1,3,7,3,10,4,4,0,2,1,27
401486109,Boston College Eagles,A. VanTimmeren,4711798,,False,20.0,2,8,2,7,0,1,0,0,4,0,4,1,0,0,2,4,4
401486109,Boston College Eagles,A. Carman,5106224,,False,3.0,0,0,0,0,0,0,0,0,0,0,0,0,0,0,1,0,0
401486109,Boston College Eagles,A. McGee,5106220,,False,3.0,0,0,0,0,0,0,0,0,0,0,0,0,0,0,0,1,0
401486109,Boston College Eagles,TEAM,TOTAL,TOTAL,False,,36,69,29,53,7,16,11,20,14,17,31,17,12,3,13,18,90
401486106,Holy Cross Crusaders,L. Berger,4900539,,True,31.0,8,12,8,12,0,0,1,2,3,3,6,1,0,0,3,4,17
401486106,Holy Cross Crusaders,J. Allen,4704714,,True,22.0,0,4,0,4,0,0,2,2,0,2,2,1,0,0,2,5,2
401486106,Holy Cross Crusaders,K. Flanagan,5109211,,True,32.0,2,8,1,5,1,3,1,2,1,4,5,1,2,1,4,0,6
401486106,Holy Cross Crusaders,B. Power-Cassidy,4704715,,True,34.0,3,13,1,5,2,8,1,2,3,6,9,1,4,2,3,4,9
401486106,Holy Cross Crusaders,A. Cross,4595975,,True,37.0,0,4,0,2,0,2,0,0,0,1,1,3,1,0,4,4,0
401486106,Holy Cross Crusaders,M. Cahalan,5109210,,False,3.0,0,1,0,1,0,0,0,0,1,0,1,0,0,0,0,0,0
401486106,Holy Cross Crusaders,C. Wright,4703660,,False,13.0,2,5,2,5,0,0,0,0,2,1,3,1,1,0,1,1,4
401486106,Holy Cross Crusaders,M. Donnelly,5109213,,False,21.0,1,5,0,1,1,4,1,2,1,3,4,1,0,0,3,1,4
401486106,Holy Cross Crusaders,L. Huber,4900538,,False,7.0,0,1,0,1,0,0,0,0,0,0,0,0,1,0,0,1,0
401486106,Holy Cross Crusaders,TEAM,TOTAL,TOTAL,False,,16,53,12,36,4,17,6,10,14,25,39,9,9,3,20,20,42
401486106,Boston College Eagles,M. Gakdeng,4898548,,True,31.0,3,10,3,10,0,0,2,4,5,4,9,0,2,1,5,2,8
401486106,Boston College Eagles,J. Lacey,4702861,,True,30.0,2,8,2,7,0,1,0,0,5,4,9,0,2,2,6,3,4
401486106,Boston College Eagles,T. Mair,5106222,,True,39.0,3,10,3,8,0,2,4,5,1,4,5,5,1,0,2,1,10
401486106,Boston College Eagles,A. Daley,4898550,,True,20.0,1,4,1,3,0,1,0,0,2,2,4,2,2,1,0,0,2
401486106,Boston College Eagles,D. Waggoner,4433482,,True,28.0,2,13,2,13,0,0,2,2,2,1,3,0,3,1,2,2,6
401486106,Boston College Eagles,A. VanTimmeren,4711798,,False,19.0,1,5,1,3,0,2,0,0,3,3,6,0,2,1,1,2,2
401486106,Boston College Eagles,T. Todd,5106223,,False,24.0,6,12,4,8,2,4,6,6,2,3,5,0,0,0,0,4,20
401486106,Boston College Eagles,K. Lezama,5106221,,False,4.0,0,2,0,2,0,0,0,0,0,0,0,1,0,0,0,0,0
401486106,Boston College Eagles,A. McGee,5106220,,False,5.0,0,0,0,0,0,0,0,0,1,0,1,0,0,0,0,1,0
401486106,Boston College Eagles,TEAM,TOTAL,TOTAL,False,,18,64,16,54,2,10,14,17,23,25,48,8,12,6,17,15,52
401486087,VCU Rams,C. Bloom,4433657,,True,22.0,5,10,5,10,0,0,2,4,4,7,11,0,0,1,1,0,12
401486087,VCU Rams,E. Motekaityte,4704163,,True,19.0,2,2,2,2,0,0,0,0,2,2,4,0,0,0,0,1,4
401486087,VCU Rams,S. Te-Biasu,4704160,,True,23.0,3,9,2,4,1,5,0,0,1,1,2,2,2,0,0,2,7
401486087,VCU Rams,G. Hutson,4613247,,True,22.0,2,5,0,1,2,4,0,0,0,0,0,6,0,0,2,2,6
401486087,VCU Rams,J. Griffith-Wallace,4282453,,True,21.0,3,9,1,4,2,5,0,0,2,2,4,3,1,0,2,1,8
401486087,VCU Rams,J. Ezeh,4433647,,False,21.0,3,6,3,6,0,0,0,0,3,7,10,0,0,0,1,1,6
401486087,VCU Rams,Sa. Robinson,4399312,,False,19.0,1,3,1,3,0,0,2,2,1,2,3,0,0,0,2,1,4
401486087,VCU Rams,M. Asare,5107544,,False,27.0,3,6,2,5,1,1,4,4,1,4,5,1,0,0,5,2,11
401486087,VCU Rams,A. Akomolafe,4898546,,False,14.0,1,1,1,1,0,0,1,2,0,0,0,1,0,0,1,5,3
401486087,VCU Rams,A. Harris,4399734,,False,12.0,2,7,2,5,0,2,0,0,1,1,2,1,0,0,0,1,4
401486087,VCU Rams,TEAM,TOTAL,TOTAL,False,,25,58,19,41,6,17,9,12,15,29,44,14,3,1,14,16,65
401486087,Lafayette Leopards,E. Shields,5109214,,True,11.0,0,0,0,0,0,0,0,2,0,3,3,0,0,0,1,2,0
401486087,Lafayette Leopards,A. Antognoli,4900540,,True,33.0,1,6,1,4,0,2,0,0,0,0,0,1,1,0,0,1,2
401486087,Lafayette Leopards,M. Andrews,4704756,,True,28.0,3,5,3,5,0,0,1,2,0,4,4,2,0,0,2,4,7
401486087,Lafayette Leopards,H. Smith,4704553,,True,19.0,0,1,0,0,0,1,4,4,0,3,3,0,1,0,0,0,4
401486087,Lafayette Leopards,J. Booth,4433381,,True,31.0,2,13,2,10,0,3,4,6,0,0,0,3,2,0,7,0,8
401486087,Lafayette Leopards,K. Drummond,4704754,,False,34.0,5,7,5,7,0,0,0,0,1,4,5,0,2,0,0,1,10
401486087,Lafayette Leopards,S. Ntaconayigize,5109216,,False,11.0,2,4,0,1,2,3,1,2,0,0,0,1,0,0,0,1,7
401486087,Lafayette Leopards,K. Donahue,5109215,,False,10.0,1,2,1,1,0,1,0,0,0,2,2,0,0,0,1,1,2
401486087,Lafayette Leopards,K. Favours,4900541,,False,23.0,1,7,1,4,0,3,0,0,0,2,2,1,3,0,1,2,2
401486087,Lafayette Leopards,TEAM,TOTAL,TOTAL,False,,15,45,13,32,2,13,10,16,2,18,20,8,9,0,13,12,42
401486061,Saint Joseph's Hawks,L. Ziegler,5107515,,True,35.0,2,9,2,8,0,1,0,0,3,9,12,2,0,1,1,2,4
401486061,Saint Joseph's Hawks,T. Brugler,4898530,,True,31.0,7,14,5,11,2,3,7,7,2,4,6,1,1,1,2,4,23
401486061,Saint Joseph's Hawks,M. Smith,4898535,,True,25.0,2,5,2,4,0,1,5,6,2,1,3,1,2,0,2,5,9
401486061,Saint Joseph's Hawks,O. Mullins,4704121,,True,33.0,4,13,2,8,2,5,1,2,0,2,2,2,1,0,0,2,11
401486061,Saint Joseph's Hawks,K. Jekot,4281901,,True,31.0,6,14,5,8,1,6,0,0,1,4,5,6,0,1,2,2,13
401486061,Saint Joseph's Hawks,P. Maurina,4704589,,False,4.0,0,2,0,1,0,1,0,0,1,0,1,0,0,0,0,1,0
401486061,Saint Joseph's Hawks,J. Walker,4594804,,False,10.0,1,1,1,1,0,0,0,2,1,2,3,0,0,1,1,1,2
401486061,Saint Joseph's Hawks,J. Nystrom,4898532,,False,18.0,0,4,0,1,0,3,3,4,1,0,1,1,0,0,0,1,3
401486061,Saint Joseph's Hawks,E. Boslet,4704122,,False,13.0,0,3,0,2,0,1,0,0,1,2,3,0,0,0,0,2,0
401486061,Saint Joseph's Hawks,TEAM,TOTAL,TOTAL,False,,22,65,17,44,5,21,16,21,14,26,40,13,4,4,8,20,65
401486061,Boston University Terriers,C. Weimar,4704495,,True,32.0,7,13,7,13,0,0,2,6,2,9,11,1,0,2,2,3,16
401486061,Boston University Terriers,M. Durant,4599732,,True,21.0,3,6,3,6,0,0,0,0,1,4,5,1,0,0,2,5,6
401486061,Boston University Terriers,L. Davenport,4899718,,True,21.0,1,4,1,3,0,1,3,3,0,2,2,1,0,0,0,1,5
401486061,Boston University Terriers,M. Pina,4599731,,True,34.0,7,11,4,6,3,5,5,7,1,1,2,1,0,0,1,0,22
401486061,Boston University Terriers,S. Johnson,4599729,,True,34.0,3,11,3,10,0,1,3,4,0,6,6,6,0,0,2,2,9
401486061,Boston University Terriers,S. Crispe,5109197,,False,18.0,0,6,0,5,0,1,2,2,4,3,7,1,0,0,2,4,2
401486061,Boston University Terriers,A. Semenova,5109196,,False,6.0,0,1,0,1,0,0,0,0,0,0,0,0,0,0,2,1,0
401486061,Boston University Terriers,S. Beneventine,4704699,,False,17.0,0,2,0,2,0,0,1,1,0,1,1,0,0,0,0,2,1
401486061,Boston University Terriers,K. Mingo,4704698,,False,3.0,0,1,0,1,0,0,0,0,0,0,0,0,0,0,0,0,0
401486061,Boston University Terriers,L. Shean,4599727,,False,14.0,0,2,0,0,0,2,0,0,0,0,0,0,0,0,1,1,0
401486061,Boston University Terriers,TEAM,TOTAL,TOTAL,False,,21,57,18,47,3,10,16,23,11,30,41,11,0,2,13,19,61
401486056,Saint Joseph's Hawks,L. Ziegler,5107515,,True,33.0,6,14,6,12,0,2,4,4,3,4,7,2,3,1,2,1,16
401486056,Saint Joseph's Hawks,T. Brugler,4898530,,True,21.0,3,8,3,5,0,3,0,0,2,2,4,2,0,0,1,4,6
401486056,Saint Joseph's Hawks,M. Smith,4898535,,True,32.0,6,10,4,8,2,2,5,5,3,1,4,2,0,0,0,3,19
401486056,Saint Joseph's Hawks,O. Mullins,4704121,,True,30.0,2,7,2,7,0,0,2,2,0,3,3,0,0,0,1,0,6
401486056,Saint Joseph's Hawks,K. Jekot,4281901,,True,33.0,3,8,3,6,0,2,0,0,0,4,4,5,0,0,1,0,6
401486056,Saint Joseph's Hawks,P. Maurina,4704589,,False,17.0,1,1,1,1,0,0,1,2,1,0,1,0,0,1,2,3,3
401486056,Saint Joseph's Hawks,J. Walker,4594804,,False,6.0,0,1,0,1,0,0,0,0,0,1,1,0,0,0,1,0,0
401486056,Saint Joseph's Hawks,E. Devenie,5107518,,False,1.0,0,0,0,0,0,0,0,0,0,0,0,0,0,0,0,0,0
401486056,Saint Joseph's Hawks,J. Nystrom,4898532,,False,26.0,4,5,2,3,2,2,0,0,0,4,4,2,1,0,0,1,10
401486056,Saint Joseph's Hawks,K. Griffin,4898531,,False,1.0,0,0,0,0,0,0,0,0,0,0,0,0,0,0,0,0,0
401486056,Saint Joseph's Hawks,TEAM,TOTAL,TOTAL,False,,25,54,21,43,4,11,12,13,9,20,29,13,4,2,9,12,66
401486056,Bucknell Bison,K. Reinbeau,4704700,,True,20.0,2,5,0,0,2,5,0,0,0,2,2,1,0,0,1,1,6
401486056,Bucknell Bison,E. Shaffer,4595535,,True,32.0,3,7,3,7,0,0,5,6,3,5,8,1,1,0,4,4,11
401486056,Bucknell Bison,C. Collins,4900532,,True,25.0,2,7,1,4,1,3,0,0,0,3,3,1,2,0,1,2,5
401486056,Bucknell Bison,J. Kulesza,4704702,,True,24.0,4,9,3,6,1,3,1,1,2,1,3,0,0,0,1,2,10
401486056,Bucknell Bison,T. Johnson,4595533,,True,33.0,5,6,5,6,0,0,0,0,1,2,3,2,0,0,4,1,10
401486056,Bucknell Bison,G. Sullivan,5109201,,False,8.0,0,2,0,2,0,0,2,2,0,1,1,0,0,0,0,1,2
401486056,Bucknell Bison,I. King,4900533,,False,16.0,1,6,0,3,1,3,0,0,0,1,1,0,0,1,2,0,3
401486056,Bucknell Bison,E. Theodorsson,5109199,,False,20.0,0,2,0,1,0,1,2,2,0,0,0,1,0,0,0,1,2
401486056,Bucknell Bison,R. Sisselman,4900531,,False,6.0,0,0,0,0,0,0,0,0,0,0,0,0,0,0,0,1,0
401486056,Bucknell Bison,B. Matthews,5109200,,False,16.0,0,2,0,2,0,0,0,0,1,1,2,0,0,0,3,3,0
401486056,Bucknell Bison,TEAM,TOTAL,TOTAL,False,,17,46,12,31,5,15,10,11,9,18,27,6,3,1,17,16,49
401486020,Lehigh Mountain Hawks,L. Fandre,5109220,,True,27.0,4,8,1,3,3,5,0,0,0,3,3,1,0,0,3,2,11
401486020,Lehigh Mountain Hawks,M. O'Brien,4900547,,True,15.0,1,3,1,2,0,1,0,0,1,3,4,1,0,0,1,2,2
401486020,Lehigh Mountain Hawks,F. Hottinger,4595613,,True,37.0,7,15,7,12,0,3,4,4,1,3,4,3,0,0,2,4,18
401486020,Lehigh Mountain Hawks,M. Kramer,4704762,,True,35.0,3,14,3,10,0,4,0,0,1,3,4,3,1,0,3,3,6
401486020,Lehigh Mountain Hawks,A. Harvey,4595612,,True,27.0,0,5,0,1,0,4,0,0,0,3,3,2,2,0,6,3,0
401486020,Lehigh Mountain Hawks,J. Vargas-Bines,4900546,,False,9.0,1,2,1,2,0,0,0,0,1,1,2,1,1,0,0,2,2
401486020,Lehigh Mountain Hawks,K. Van Eps,4900545,,False,21.0,1,5,0,1,1,4,0,0,0,2,2,2,2,0,1,2,3
401486020,Lehigh Mountain Hawks,E. Stemmer,4900544,,False,19.0,5,10,3,3,2,7,0,0,0,1,1,0,1,0,2,2,12
401486020,Lehigh Mountain Hawks,M. Albrecht,4704763,,False,4.0,0,1,0,0,0,1,0,0,0,1,1,0,0,0,1,1,0
401486020,Lehigh Mountain Hawks,F. Eggenschwiler,4704761,,False,6.0,0,0,0,0,0,0,0,0,0,1,1,0,0,0,0,1,0
401486020,Lehigh Mountain Hawks,TEAM,TOTAL,TOTAL,False,,22,63,16,34,6,29,4,4,7,22,29,13,7,0,19,22,54
401486020,La Salle Explorers,K. Spruill,4399437,,True,24.0,7,15,4,6,3,9,9,10,3,5,8,0,0,0,1,1,26
401486020,La Salle Explorers,C. Shears,5107485,,True,24.0,2,4,1,1,1,3,0,0,0,1,1,2,2,0,1,1,5
401486020,La Salle Explorers,A. Jacobs,4594785,,True,20.0,3,3,3,3,0,0,3,4,1,9,10,1,1,0,2,3,9
401486020,La Salle Explorers,M. Masciantonio,4594782,,True,24.0,0,0,0,0,0,0,0,2,0,0,0,3,4,0,2,1,0
401486020,La Salle Explorers,C. Jacobs,4594781,,True,22.0,2,11,2,6,0,5,0,0,0,2,2,1,0,0,1,2,4
401486020,La Salle Explorers,M. Jacobs,5107484,,False,16.0,0,2,0,1,0,1,4,4,2,6,8,0,2,0,2,1,4
401486020,La Salle Explorers,E. Tahata,4898521,,False,4.0,0,2,0,1,0,1,0,0,1,0,1,0,0,0,0,0,0
401486020,La Salle Explorers,G. Crawford,4398708,,False,15.0,1,4,1,3,0,1,1,2,2,4,6,0,0,1,4,0,3
401486020,La Salle Explorers,G. Falcao,5107486,,False,3.0,1,2,1,1,0,1,0,0,0,0,0,0,0,0,1,0,2
401486020,La Salle Explorers,E. Egan,5107483,,False,7.0,0,1,0,1,0,0,0,0,0,1,1,1,0,0,2,2,0
401486020,La Salle Explorers,F. Connolly,5107482,,False,13.0,2,4,2,3,0,1,0,0,0,0,0,1,0,0,2,2,4
401486020,La Salle Explorers,J. Jekot,4898520,,False,10.0,1,2,0,1,1,1,0,0,0,1,1,0,0,0,0,0,3
401486020,La Salle Explorers,J. Haynes,4433779,,False,18.0,3,7,3,6,0,1,0,0,2,0,2,1,1,0,0,0,6
401486020,La Salle Explorers,TEAM,TOTAL,TOTAL,False,,22,57,17,33,5,24,17,22,11,29,40,10,10,1,18,13,66
401486018,Lafayette Leopards,E. Shields,5109214,,True,29.0,0,6,0,3,0,3,0,0,2,3,5,2,1,1,0,1,0
401486018,Lafayette Leopards,A. Antognoli,4900540,,True,38.0,7,17,6,11,1,6,4,4,0,3,3,2,3,0,3,1,19
401486018,Lafayette Leopards,M. Andrews,4704756,,True,26.0,4,11,4,10,0,1,1,1,1,7,8,1,1,0,4,5,9
401486018,Lafayette Leopards,H. Smith,4704553,,True,34.0,1,4,1,2,0,2,0,0,3,3,6,1,1,0,3,3,2
401486018,Lafayette Leopards,J. Booth,4433381,,True,32.0,3,11,2,8,1,3,4,4,0,2,2,2,0,0,2,3,11
401486018,Lafayette Leopards,S. Ntaconayigize,5109216,,False,25.0,4,13,1,6,3,7,0,0,2,1,3,2,3,1,2,1,11
401486018,Lafayette Leopards,K. Donahue,5109215,,False,6.0,0,3,0,2,0,1,0,0,0,1,1,1,0,2,0,2,0
401486018,Lafayette Leopards,K. Favours,4900541,,False,10.0,1,5,1,4,0,1,0,0,0,2,2,0,0,0,1,0,2
401486018,Lafayette Leopards,TEAM,TOTAL,TOTAL,False,,20,70,15,46,5,24,9,9,10,30,40,11,9,4,15,16,54
401486018,La Salle Explorers,K. Spruill,4399437,,True,17.0,7,9,5,7,2,2,0,0,0,8,8,0,0,0,3,1,16
401486018,La Salle Explorers,C. Shears,5107485,,True,18.0,0,8,0,0,0,8,0,0,0,1,1,0,0,0,0,0,0
401486018,La Salle Explorers,F. Connolly,5107482,,True,16.0,0,1,0,0,0,1,0,0,0,0,0,2,0,0,1,2,0
401486018,La Salle Explorers,A. Jacobs,4594785,,True,16.0,0,2,0,0,0,2,2,2,3,4,7,4,1,1,1,2,2
401486018,La Salle Explorers,C. Jacobs,4594781,,True,17.0,1,12,0,6,1,6,0,0,1,3,4,2,0,0,1,2,3
401486018,La Salle Explorers,M. Jacobs,5107484,,False,24.0,2,9,2,7,0,2,3,3,4,7,11,4,1,1,2,2,7
401486018,La Salle Explorers,E. Tahata,4898521,,False,4.0,1,2,0,0,1,2,0,0,0,2,2,0,0,0,4,2,3
401486018,La Salle Explorers,G. Crawford,4398708,,False,21.0,6,10,6,10,0,0,4,4,1,2,3,1,0,0,1,1,16
401486018,La Salle Explorers,G. Falcao,5107486,,False,4.0,1,2,1,1,0,1,0,0,0,2,2,0,0,0,0,0,2
401486018,La Salle Explorers,E. Egan,5107483,,False,24.0,2,5,1,3,1,2,0,0,0,2,2,5,1,0,2,0,5
401486018,La Salle Explorers,J. Jekot,4898520,,False,18.0,3,8,1,2,2,6,0,0,1,4,5,1,1,0,3,1,8
401486018,La Salle Explorers,J. Haynes,4433779,,False,21.0,4,6,3,3,1,3,0,0,2,0,2,1,0,0,0,0,9
401486018,La Salle Explorers,TEAM,TOTAL,TOTAL,False,,27,74,19,39,8,35,9,9,17,40,57,20,4,2,20,13,71
401486010,George Mason Patriots,N. Kaysia,5107452,,True,21.0,5,7,5,7,0,0,1,2,6,2,8,0,1,0,1,2,11
401486010,George Mason Patriots,R. Childs,4400174,,True,16.0,0,1,0,1,0,0,1,2,1,4,5,0,0,0,1,1,1
401486010,George Mason Patriots,T. Jameson,4703748,,True,31.0,7,13,5,8,2,5,2,2,1,1,2,1,1,0,3,0,18
401486010,George Mason Patriots,S. Smith,4595781,,True,33.0,2,14,2,10,0,4,5,6,1,0,1,6,3,0,5,1,9
401486010,George Mason Patriots,J. Ephraim,4398892,,True,22.0,3,6,3,6,0,0,0,0,1,3,4,0,4,1,1,0,6
401486010,George Mason Patriots,N. Mitchell,5107450,,False,17.0,3,5,3,5,0,0,0,0,1,3,4,1,1,0,2,3,6
401486010,George Mason Patriots,A. Rodriguez,4703676,,False,1.0,0,0,0,0,0,0,0,0,0,0,0,0,0,0,0,0,0
401486010,George Mason Patriots,T. Lawhorne,4433109,,False,17.0,3,7,3,4,0,3,0,0,1,3,4,1,2,0,1,2,6
401486010,George Mason Patriots,J. Doster,4594773,,False,16.0,4,5,4,5,0,0,1,2,3,5,8,0,1,2,4,4,9
401486010,George Mason Patriots,J. Brown,5107449,,False,1.0,0,0,0,0,0,0,2,2,0,0,0,0,0,0,0,1,2
401486010,George Mason Patriots,P. Suarez,4898502,,False,24.0,1,3,1,3,0,0,1,2,0,2,2,1,2,1,3,0,3
401486010,George Mason Patriots,T. Kennedy,4595374,,False,1.0,0,0,0,0,0,0,0,0,0,0,0,0,0,0,1,0,0
401486010,George Mason Patriots,TEAM,TOTAL,TOTAL,False,,28,61,26,49,2,12,13,18,16,25,41,10,15,4,23,14,71
401486010,American University Eagles,E. Johns,4704688,,True,25.0,2,6,2,4,0,2,0,0,3,2,5,1,0,0,3,5,4
401486010,American University Eagles,L. Stack,4595455,,True,32.0,7,10,7,9,0,1,2,4,2,5,7,2,2,1,3,3,16
401486010,American University Eagles,K. Henning,4704686,,True,32.0,3,6,3,6,0,0,0,0,0,1,1,5,1,0,5,2,6
401486010,American University Eagles,I. Bales,4704685,,True,33.0,3,8,3,8,0,0,0,0,0,5,5,6,3,0,5,3,6
401486010,American University Eagles,R. DeRubbo,4703746,,True,22.0,3,8,0,0,3,8,2,4,0,1,1,1,2,0,3,4,11
401486010,American University Eagles,M. Lavin,5109188,,False,16.0,4,8,3,6,1,2,0,0,0,2,2,0,0,0,4,0,9
401486010,American University Eagles,M. Lee,4704592,,False,3.0,0,1,0,1,0,0,0,0,1,0,1,0,0,0,0,0,0
401486010,American University Eagles,L. Nogues,5109187,,False,6.0,1,3,1,2,0,1,0,0,0,0,0,1,1,0,2,0,2
401486010,American University Eagles,A. Rescifina,5109186,,False,3.0,0,0,0,0,0,0,0,0,0,1,1,0,0,0,0,0,0
401486010,American University Eagles,B. Garbee,4899710,,False,10.0,0,1,0,1,0,0,0,0,1,1,2,1,0,0,1,1,0
401486010,American University Eagles,A. LeMaster,4703737,,False,6.0,1,4,1,2,0,2,0,0,1,0,1,0,0,0,0,0,2
401486010,American University Eagles,S. Stetson,4595453,,False,12.0,1,3,0,1,1,2,0,0,0,0,0,0,1,0,0,1,3
401486010,American University Eagles,TEAM,TOTAL,TOTAL,False,,25,58,20,40,5,18,4,8,9,18,27,17,10,1,26,19,59
401486007,Loyola Maryland Greyhounds,L. Therien,4900552,,True,30.0,5,13,5,12,0,1,3,3,4,4,8,1,1,0,2,4,13
401486007,Loyola Maryland Greyhounds,K. Sims,4898948,,True,24.0,1,5,1,5,0,0,0,0,2,5,7,1,1,1,3,5,2
401486007,Loyola Maryland Greyhounds,M. Van-Otoo,5109223,,True,12.0,1,3,1,3,0,0,1,2,0,0,0,1,0,0,1,1,3
401486007,Loyola Maryland Greyhounds,B. Rozzi,4596306,,True,37.0,3,8,2,5,1,3,0,0,1,1,2,0,1,0,0,1,7
401486007,Loyola Maryland Greyhounds,T. Dixon,4400209,,True,35.0,10,17,8,13,2,4,6,6,0,1,1,0,4,0,3,3,28
401486007,Loyola Maryland Greyhounds,M. Espinal,5109228,,False,14.0,1,1,1,1,0,0,0,0,1,2,3,1,0,0,1,2,2
401486007,Loyola Maryland Greyhounds,E. Glezen,4596304,,False,11.0,0,0,0,0,0,0,0,0,0,1,1,0,0,0,3,4,0
401486007,Loyola Maryland Greyhounds,C. Garcia,5109224,,False,6.0,0,0,0,0,0,0,3,4,0,0,0,0,0,0,0,3,3
401486007,Loyola Maryland Greyhounds,K. Ratigan,5109222,,False,5.0,0,1,0,0,0,1,0,0,0,0,0,0,0,0,0,0,0
401486007,Loyola Maryland Greyhounds,C. Tanedo,4704774,,False,26.0,0,3,0,2,0,1,0,0,1,2,3,1,0,0,0,0,0
401486007,Loyola Maryland Greyhounds,TEAM,TOTAL,TOTAL,False,,21,51,18,41,3,10,13,15,11,16,27,5,7,1,14,23,58
401486007,George Mason Patriots,N. Kaysia,5107452,,True,32.0,5,8,5,8,0,0,0,4,0,6,6,0,0,2,3,1,10
401486007,George Mason Patriots,R. Childs,4400174,,True,24.0,1,3,0,1,1,2,1,2,1,3,4,2,2,2,1,4,4
401486007,George Mason Patriots,T. Jameson,4703748,,True,37.0,6,11,3,4,3,7,4,6,1,1,2,1,1,0,2,2,19
401486007,George Mason Patriots,S. Smith,4595781,,True,27.0,1,5,1,5,0,0,1,2,1,2,3,4,0,0,4,3,3
401486007,George Mason Patriots,J. Ephraim,4398892,,True,23.0,0,2,0,2,0,0,5,6,3,2,5,1,0,0,1,1,5
401486007,George Mason Patriots,N. Mitchell,5107450,,False,7.0,1,1,1,1,0,0,0,0,1,1,2,0,0,0,0,1,2
401486007,George Mason Patriots,T. Lawhorne,4433109,,False,21.0,5,8,1,2,4,6,3,4,1,1,2,1,0,0,2,0,17
401486007,George Mason Patriots,J. Doster,4594773,,False,10.0,1,2,1,2,0,0,2,6,2,4,6,0,0,3,0,4,4
401486007,George Mason Patriots,P. Suarez,4898502,,False,19.0,1,1,1,1,0,0,0,0,0,0,0,3,1,0,1,1,2
401486007,George Mason Patriots,TEAM,TOTAL,TOTAL,False,,21,41,13,26,8,15,16,30,12,20,32,12,4,7,17,17,66
401485724,Marquette Golden Eagles,L. Karlen,4703796,,True,30.0,7,11,7,10,0,1,4,4,1,4,5,3,1,0,1,1,18
401485724,Marquette Golden Eagles,C. Marotta,4399360,,True,26.0,4,10,4,9,0,1,2,4,2,6,8,2,2,2,0,3,10
401485724,Marquette Golden Eagles,R. Nkumu,4599129,,True,18.0,1,4,0,2,1,2,0,0,0,3,3,3,2,0,0,3,3
401485724,Marquette Golden Eagles,J. King,4595151,,True,31.0,0,5,0,4,0,1,1,2,0,5,5,4,2,1,1,1,1
401485724,Marquette Golden Eagles,N. Clark,4399335,,True,21.0,5,8,5,7,0,1,1,2,0,1,1,1,0,0,2,1,11
401485724,Marquette Golden Eagles,C. Smith,5106192,,False,4.0,0,0,0,0,0,0,0,0,1,0,1,2,0,0,0,1,0
401485724,Marquette Golden Eagles,J. Okosun,4703795,,False,5.0,0,0,0,0,0,0,0,0,0,1,1,0,0,0,1,1,0
401485724,Marquette Golden Eagles,K. Myles,4594770,,False,13.0,2,4,2,4,0,0,2,2,0,1,1,0,1,0,0,2,6
401485724,Marquette Golden Eagles,M. Williams,4899441,,False,8.0,3,4,3,4,0,0,0,0,0,0,0,0,1,0,1,0,6
401485724,Marquette Golden Eagles,E. La Chapell,5106194,,False,10.0,0,0,0,0,0,0,0,0,1,1,2,2,0,1,1,0,0
401485724,Marquette Golden Eagles,M. Hare,5106193,,False,25.0,6,11,1,1,5,10,1,3,0,1,1,0,0,0,1,0,18
401485724,Marquette Golden Eagles,C. Kaifes,4595148,,False,9.0,1,1,1,1,0,0,0,0,1,1,2,1,0,0,0,0,2
401485724,Marquette Golden Eagles,TEAM,TOTAL,TOTAL,False,,29,58,23,42,6,16,11,17,6,24,30,18,9,4,9,13,75
401485724,Holy Cross Crusaders,L. Berger,4900539,,True,29.0,3,8,3,8,0,0,0,2,1,5,6,1,0,0,3,3,6
401485724,Holy Cross Crusaders,J. Allen,4704714,,True,25.0,8,13,8,13,0,0,4,6,0,0,0,0,0,3,2,4,20
401485724,Holy Cross Crusaders,K. Flanagan,5109211,,True,28.0,4,6,4,6,0,0,0,0,0,2,2,3,0,0,4,0,8
401485724,Holy Cross Crusaders,B. Power-Cassidy,4704715,,True,15.0,1,5,1,5,0,0,2,2,0,1,1,1,0,0,1,4,4
401485724,Holy Cross Crusaders,A. Cross,4595975,,True,30.0,1,7,1,6,0,1,0,0,1,1,2,0,4,0,1,1,2
401485724,Holy Cross Crusaders,C. Wright,4703660,,False,7.0,0,0,0,0,0,0,0,0,0,2,2,0,0,0,0,1,0
401485724,Holy Cross Crusaders,M. Donnelly,5109213,,False,24.0,3,5,2,2,1,3,0,0,0,6,6,2,2,0,3,0,7
401485724,Holy Cross Crusaders,S. Foreman,5109212,,False,14.0,1,3,1,3,0,0,0,0,0,2,2,1,0,0,1,0,2
401485724,Holy Cross Crusaders,L. Huber,4900538,,False,19.0,1,3,1,1,0,2,0,0,1,1,2,1,0,0,0,1,2
401485724,Holy Cross Crusaders,G. Munt,4900537,,False,9.0,1,2,0,1,1,1,1,2,0,0,0,0,0,0,0,1,4
401485724,Holy Cross Crusaders,TEAM,TOTAL,TOTAL,False,,23,52,21,45,2,7,7,12,5,21,26,9,6,3,17,15,55
401485716,DePaul Blue Demons,A. Morrow,4684384,,True,22.0,10,17,9,13,1,4,3,4,4,4,8,2,6,1,4,0,24
401485716,DePaul Blue Demons,K. Holmes,4599133,,True,22.0,2,6,2,3,0,3,2,2,2,1,3,3,2,1,1,0,6
401485716,DePaul Blue Demons,D. Rogers,4433475,,True,22.0,4,14,2,7,2,7,8,9,0,3,3,1,2,0,5,2,18
401485716,DePaul Blue Demons,A. Peoples,4432842,,True,28.0,6,12,5,9,1,3,1,5,6,5,11,3,4,1,2,2,14
401485716,DePaul Blue Demons,J. Edwards,4400156,,True,22.0,0,3,0,1,0,2,0,0,0,5,5,0,1,0,1,0,0
401485716,DePaul Blue Demons,Z. Hurston,5106186,,False,12.0,3,4,2,3,1,1,2,2,1,1,2,0,0,1,0,1,9
401485716,DePaul Blue Demons,M. Wardell,5106183,,False,11.0,0,2,0,0,0,2,0,0,0,0,0,0,0,0,2,1,0
401485716,DePaul Blue Demons,J. Allen,4432936,,False,21.0,2,2,2,2,0,0,1,2,2,2,4,0,2,0,2,0,5
401485716,DePaul Blue Demons,K. Rimmer,4594817,,False,21.0,5,7,5,5,0,2,3,4,2,7,9,4,4,1,5,0,13
401485716,DePaul Blue Demons,T. Daye,5106182,,False,19.0,2,2,1,1,1,1,2,4,2,1,3,0,2,0,0,0,7
401485716,DePaul Blue Demons,TEAM,TOTAL,TOTAL,False,,34,69,28,44,6,25,22,32,21,29,50,13,23,5,22,6,96
401485716,American University Eagles,E. Johns,4704688,,True,21.0,4,9,3,6,1,3,0,0,1,1,2,1,0,0,3,2,9
401485716,American University Eagles,L. Stack,4595455,,True,29.0,2,6,2,5,0,1,0,0,1,2,3,0,2,1,4,3,4
401485716,American University Eagles,K. Henning,4704686,,True,28.0,4,10,4,8,0,2,0,0,0,3,3,0,2,0,3,2,8
401485716,American University Eagles,I. Bales,4704685,,True,26.0,1,9,1,8,0,1,0,0,2,2,4,3,1,1,8,3,2
401485716,American University Eagles,R. DeRubbo,4703746,,True,25.0,2,9,1,2,1,7,0,0,2,3,5,2,3,0,2,3,5
401485716,American University Eagles,M. Lavin,5109188,,False,23.0,6,8,5,6,1,2,2,2,2,2,4,0,1,0,4,3,15
401485716,American University Eagles,M. Lee,4704592,,False,6.0,0,0,0,0,0,0,0,0,0,0,0,0,1,1,1,1,0
401485716,American University Eagles,L. Nogues,5109187,,False,11.0,0,4,0,2,0,2,0,0,1,1,2,2,0,0,4,1,0
401485716,American University Eagles,A. Rescifina,5109186,,False,4.0,0,0,0,0,0,0,0,0,0,0,0,1,1,1,1,1,0
401485716,American University Eagles,B. Garbee,4899710,,False,10.0,1,3,1,3,0,0,0,0,1,0,1,0,1,0,1,1,2
401485716,American University Eagles,S. Stetson,4595453,,False,9.0,0,1,0,0,0,1,0,0,0,0,0,0,2,0,0,0,0
401485716,American University Eagles,L. Graytok,4400159,,False,8.0,0,2,0,1,0,1,0,0,0,0,0,1,3,0,0,0,0
401485716,American University Eagles,TEAM,TOTAL,TOTAL,False,,20,61,17,41,3,20,2,2,11,17,28,10,17,4,31,20,45
401480298,Syracuse Orange,D. Lewis,4399418,,True,26.0,3,9,3,9,0,0,3,6,0,7,7,0,0,2,4,2,9
401480298,Syracuse Orange,A. Strong,4399367,,True,27.0,3,9,3,7,0,2,1,1,0,5,5,0,0,1,0,2,7
401480298,Syracuse Orange,G. Woolley,4899639,,True,25.0,1,5,0,3,1,2,0,0,2,4,6,1,0,0,2,2,3
401480298,Syracuse Orange,D. Fair,4595236,,True,34.0,10,19,7,14,3,5,2,2,0,3,3,4,3,0,1,1,25
401480298,Syracuse Orange,T. Hyman,4433655,,True,26.0,6,10,6,10,0,0,3,3,1,1,2,2,2,0,2,1,15
401480298,Syracuse Orange,K. Wood,4898656,,False,14.0,0,3,0,3,0,0,2,2,2,4,6,0,0,2,1,0,2
401480298,Syracuse Orange,S. Wilson,4433553,,False,8.0,0,0,0,0,0,0,0,0,0,2,2,0,1,0,0,1,0
401480298,Syracuse Orange,L. McNabb,5107740,,False,1.0,0,0,0,0,0,0,0,0,0,0,0,0,0,0,0,0,0
401480298,Syracuse Orange,K. Perkins,5107739,,False,3.0,0,2,0,2,0,0,0,0,0,0,0,0,0,0,1,0,0
401480298,Syracuse Orange,C. McEvans,4705357,,False,13.0,1,2,1,2,0,0,0,0,1,0,1,1,1,0,1,1,2
401480298,Syracuse Orange,A. Rice,4595516,,False,14.0,0,1,0,1,0,0,2,2,2,3,5,0,0,0,1,1,2
401480298,Syracuse Orange,N. Wilson,4433549,,False,9.0,0,0,0,0,0,0,0,0,0,1,1,1,0,0,0,0,0
401480298,Syracuse Orange,TEAM,TOTAL,TOTAL,False,,24,60,20,51,4,9,13,16,10,30,40,9,7,5,13,11,65
401480298,Bucknell Bison,I. King,4900533,,True,33.0,4,7,2,3,2,4,0,0,2,3,5,3,1,0,2,2,10
401480298,Bucknell Bison,E. Shaffer,4595535,,True,19.0,0,5,0,5,0,0,0,0,1,3,4,2,1,0,1,1,0
401480298,Bucknell Bison,R. Sisselman,4900531,,True,29.0,2,11,2,2,0,9,0,0,0,0,0,1,2,0,2,1,4
401480298,Bucknell Bison,B. Matthews,5109200,,True,24.0,1,5,1,3,0,2,0,0,0,6,6,1,1,0,3,3,2
401480298,Bucknell Bison,C. Collins,4900532,,True,35.0,6,13,6,9,0,4,6,7,0,3,3,0,0,0,4,1,18
401480298,Bucknell Bison,G. Klag,5109202,,False,1.0,0,0,0,0,0,0,0,0,0,1,1,0,0,0,0,0,0
401480298,Bucknell Bison,G. Sullivan,5109201,,False,20.0,4,8,4,8,0,0,0,0,2,4,6,0,0,0,2,2,8
401480298,Bucknell Bison,N. Davis,4704701,,False,1.0,0,0,0,0,0,0,0,0,0,0,0,0,0,0,0,0,0
401480298,Bucknell Bison,K. Reinbeau,4704700,,False,7.0,0,2,0,1,0,1,2,2,0,0,0,0,0,0,0,0,2
401480298,Bucknell Bison,E. Theodorsson,5109199,,False,3.0,1,2,1,2,0,0,0,0,0,1,1,0,0,0,0,0,2
401480298,Bucknell Bison,J. Kulesza,4704702,,False,6.0,0,1,0,0,0,1,0,0,0,0,0,0,0,0,0,0,0
401480298,Bucknell Bison,T. Johnson,4595533,,False,10.0,0,0,0,0,0,0,2,2,0,1,1,0,0,0,1,1,2
401480298,Bucknell Bison,C. Dingler,4577540,,False,10.0,0,0,0,0,0,0,0,0,0,2,2,0,0,0,1,2,0
401480298,Bucknell Bison,TEAM,TOTAL,TOTAL,False,,18,54,16,33,2,21,10,11,6,28,34,7,5,0,16,13,48
401480294,Syracuse Orange,D. Lewis,4399418,,True,26.0,4,7,4,7,0,0,4,6,4,6,10,1,2,2,1,1,12
401480294,Syracuse Orange,A. Strong,4399367,,True,23.0,2,8,2,5,0,3,2,2,2,6,8,1,1,0,3,2,6
401480294,Syracuse Orange,A. Rice,4595516,,True,23.0,6,7,4,5,2,2,2,2,0,6,6,3,0,1,1,0,16
401480294,Syracuse Orange,D. Fair,4595236,,True,28.0,4,13,3,9,1,4,1,2,0,4,4,0,4,0,4,1,10
401480294,Syracuse Orange,T. Hyman,4433655,,True,26.0,3,8,3,6,0,2,0,0,0,6,6,7,1,2,1,1,6
401480294,Syracuse Orange,K. Wood,4898656,,False,20.0,3,4,3,4,0,0,1,2,3,2,5,0,1,1,1,1,7
401480294,Syracuse Orange,S. Wilson,4433553,,False,11.0,4,4,4,4,0,0,2,2,0,2,2,0,0,3,1,3,10
401480294,Syracuse Orange,L. McNabb,5107740,,False,10.0,0,2,0,0,0,2,0,0,0,0,0,2,0,0,1,1,0
401480294,Syracuse Orange,K. Perkins,5107739,,False,12.0,1,1,1,1,0,0,3,4,0,0,0,1,0,0,0,0,5
401480294,Syracuse Orange,A. Irvin,4703764,,False,8.0,0,3,0,1,0,2,0,0,0,0,0,0,0,0,1,0,0
401480294,Syracuse Orange,N. Wilson,4433549,,False,13.0,0,1,0,1,0,0,0,0,0,3,3,1,1,0,2,3,0
401480294,Syracuse Orange,TEAM,TOTAL,TOTAL,False,,27,58,24,43,3,15,15,20,11,38,49,16,10,9,17,13,72
401480294,Colgate Raiders,S. Diehl,4900536,,True,22.0,1,9,1,7,0,2,0,0,0,8,8,1,0,0,3,1,2
401480294,Colgate Raiders,M. Schiller,5109205,,True,35.0,0,5,0,3,0,2,0,0,2,3,5,4,0,0,2,2,0
401480294,Colgate Raiders,T. Golembiewski,4900535,,True,32.0,5,12,5,8,0,4,0,0,1,3,4,3,2,0,3,4,10
401480294,Colgate Raiders,M. McMahon,4900534,,True,20.0,0,5,0,3,0,2,1,2,0,0,0,0,0,0,2,2,1
401480294,Colgate Raiders,J. Paul,4595552,,True,30.0,6,12,0,0,6,12,0,0,0,3,3,0,1,0,2,1,18
401480294,Colgate Raiders,C. Okafor,5109208,,False,9.0,2,4,2,4,0,0,3,4,1,1,2,0,0,0,2,2,7
401480294,Colgate Raiders,N. Parks,5109206,,False,7.0,1,2,1,2,0,0,0,2,0,1,1,0,0,0,0,3,2
401480294,Colgate Raiders,A. Ferguson,5109209,,False,23.0,1,4,1,4,0,0,0,0,0,1,1,0,0,0,0,2,2
401480294,Colgate Raiders,C. Midgette,5109204,,False,11.0,1,8,1,8,0,0,1,1,1,2,3,0,1,1,0,1,3
401480294,Colgate Raiders,L. Cook,5109207,,False,11.0,1,3,1,3,0,0,1,2,1,0,1,1,1,0,0,0,3
401480294,Colgate Raiders,TEAM,TOTAL,TOTAL,False,,18,64,12,42,6,22,6,11,9,22,31,9,5,1,14,18,48
401480291,Pittsburgh Panthers,A. Brown,4594393,,True,23.0,2,4,2,4,0,0,0,0,0,2,2,0,2,0,0,0,4
401480291,Pittsburgh Panthers,L. King,4596309,,True,17.0,3,8,3,8,0,0,3,6,2,2,4,0,1,0,0,3,9
401480291,Pittsburgh Panthers,M. Washenitz,5107733,,True,25.0,1,6,1,2,0,4,0,0,1,3,4,5,1,2,4,3,2
401480291,Pittsburgh Panthers,D. Harris,4433695,,True,16.0,4,5,3,4,1,1,1,2,0,2,2,1,4,0,2,1,10
401480291,Pittsburgh Panthers,E. Hayford,4433346,,True,10.0,3,3,2,2,1,1,0,0,1,1,2,3,0,0,2,4,7
401480291,Pittsburgh Panthers,M. Johnson,4898568,,False,14.0,2,6,1,3,1,3,0,0,0,0,0,3,1,0,2,1,5
401480291,Pittsburgh Panthers,T. Exanor,4600577,,False,19.0,3,4,3,3,0,1,0,0,2,2,4,0,1,0,2,3,6
401480291,Pittsburgh Panthers,G. Hutcherson,4433757,,False,22.0,5,9,3,6,2,3,0,0,1,4,5,2,0,1,2,2,12
401480291,Pittsburgh Panthers,A. Strickland,5107734,,False,21.0,7,8,4,4,3,4,0,0,1,1,2,1,2,0,1,3,17
401480291,Pittsburgh Panthers,S. Clesca,4703736,,False,5.0,1,1,1,1,0,0,1,1,1,1,2,1,0,0,0,1,3
401480291,Pittsburgh Panthers,A. Malcolm,4683267,,False,12.0,0,2,0,0,0,2,0,0,0,4,4,1,0,0,1,2,0
401480291,Pittsburgh Panthers,D. Strother,4595149,,False,6.0,1,2,0,1,1,1,0,0,0,0,0,0,1,0,0,0,3
401480291,Pittsburgh Panthers,C. Lewis,4281247,,False,10.0,0,1,0,0,0,1,0,0,0,0,0,2,0,0,2,0,0
401480291,Pittsburgh Panthers,TEAM,TOTAL,TOTAL,False,,32,59,23,38,9,21,5,9,11,26,37,19,13,3,18,23,78
401480291,Loyola Maryland Greyhounds,L. Therien,4900552,,True,25.0,2,9,2,9,0,0,3,4,4,4,8,0,1,0,3,4,7
401480291,Loyola Maryland Greyhounds,K. Sims,4898948,,True,26.0,2,6,2,6,0,0,1,2,5,5,10,1,2,1,2,0,5
401480291,Loyola Maryland Greyhounds,K. Ratigan,5109222,,True,30.0,2,13,0,4,2,9,2,2,0,1,1,0,1,0,3,1,8
401480291,Loyola Maryland Greyhounds,B. Rozzi,4596306,,True,17.0,0,3,0,2,0,1,0,0,0,1,1,1,0,0,1,1,0
401480291,Loyola Maryland Greyhounds,T. Dixon,4400209,,True,25.0,3,17,0,7,3,10,7,8,1,1,2,1,3,0,4,2,16
401480291,Loyola Maryland Greyhounds,M. Espinal,5109228,,False,21.0,0,1,0,1,0,0,0,0,0,3,3,3,1,0,2,1,0
401480291,Loyola Maryland Greyhounds,A. Therien,4596307,,False,5.0,0,0,0,0,0,0,1,2,1,0,1,0,0,0,1,0,1
401480291,Loyola Maryland Greyhounds,C. Orza,5109227,,False,2.0,0,0,0,0,0,0,0,0,0,0,0,0,0,0,0,0,0
401480291,Loyola Maryland Greyhounds,C. Garcia,5109224,,False,18.0,0,3,0,3,0,0,1,2,3,0,3,0,1,0,1,3,1
401480291,Loyola Maryland Greyhounds,M. Van-Otoo,5109223,,False,15.0,1,2,0,1,1,1,1,2,3,1,4,1,1,0,4,1,4
401480291,Loyola Maryland Greyhounds,C. Tanedo,4704774,,False,16.0,0,2,0,0,0,2,0,0,2,1,3,1,1,0,0,2,0
401480291,Loyola Maryland Greyhounds,TEAM,TOTAL,TOTAL,False,,10,56,4,33,6,23,16,22,21,18,39,8,11,1,23,15,42
401480277,Notre Dame Fighting Irish,K. Watson,4433735,,True,24.0,4,7,4,7,0,0,2,4,5,3,8,1,1,1,2,3,10
401480277,Notre Dame Fighting Irish,M. Westbeld,4433424,,True,22.0,3,9,3,7,0,2,0,0,3,6,9,3,1,2,2,4,6
401480277,Notre Dame Fighting Irish,O. Miles,4433791,,True,28.0,7,8,6,6,1,2,4,8,0,10,10,3,2,0,6,3,19
401480277,Notre Dame Fighting Irish,S. Citron,4433524,,True,32.0,3,11,3,9,0,2,11,12,2,5,7,2,1,0,2,3,17
401480277,Notre Dame Fighting Irish,D. Mabrey,4398736,,True,35.0,4,9,1,2,3,7,4,4,0,2,2,0,0,0,0,0,15
401480277,Notre Dame Fighting Irish,N. Marshall,4433428,,False,14.0,1,2,1,2,0,0,6,11,4,2,6,0,0,1,0,1,8
401480277,Notre Dame Fighting Irish,L. Ebo,4398943,,False,12.0,1,7,1,7,0,0,1,2,2,2,4,1,0,0,1,5,3
401480277,Notre Dame Fighting Irish,S. Cernugel,4898561,,False,1.0,0,0,0,0,0,0,0,0,0,0,0,0,0,0,0,0,0
401480277,Notre Dame Fighting Irish,KK Bransford,4565508,,False,24.0,6,8,6,8,0,0,0,0,0,0,0,0,3,0,0,1,12
401480277,Notre Dame Fighting Irish,J. Brown,4398831,,False,8.0,0,1,0,1,0,0,0,0,0,0,0,0,0,0,2,0,0
401480277,Notre Dame Fighting Irish,TEAM,TOTAL,TOTAL,False,,29,62,25,49,4,13,28,41,18,34,52,10,8,4,16,20,90
401480277,American University Eagles,E. Johns,4704688,,True,20.0,5,13,4,10,1,3,4,4,0,3,3,0,0,0,1,4,15
401480277,American University Eagles,L. Stack,4595455,,True,14.0,1,6,1,5,0,1,0,0,2,0,2,1,0,0,2,4,2
401480277,American University Eagles,K. Henning,4704686,,True,23.0,3,6,3,6,0,0,2,3,0,2,2,3,0,0,2,3,8
401480277,American University Eagles,I. Bales,4704685,,True,25.0,4,6,3,4,1,2,1,1,3,2,5,2,1,0,3,1,10
401480277,American University Eagles,R. DeRubbo,4703746,,True,16.0,1,3,0,2,1,1,1,2,0,2,2,1,0,0,0,2,4
401480277,American University Eagles,M. Lavin,5109188,,False,24.0,3,8,2,5,1,3,1,2,0,2,2,0,0,0,0,3,8
401480277,American University Eagles,M. Lee,4704592,,False,17.0,4,6,4,6,0,0,0,1,0,3,3,0,0,1,0,3,8
401480277,American University Eagles,L. Nogues,5109187,,False,10.0,1,5,1,4,0,1,0,0,0,1,1,1,0,0,2,2,2
401480277,American University Eagles,A. Rescifina,5109186,,False,11.0,1,5,1,4,0,1,0,0,2,0,2,3,0,0,1,0,2
401480277,American University Eagles,A. LeMaster,4703737,,False,15.0,2,7,1,6,1,1,0,0,0,0,0,1,1,0,1,2,5
401480277,American University Eagles,S. Stetson,4595453,,False,20.0,0,2,0,1,0,1,0,0,1,1,2,2,1,0,3,2,0
401480277,American University Eagles,L. Graytok,4400159,,False,5.0,0,0,0,0,0,0,1,2,0,0,0,0,0,0,1,1,1
401480277,American University Eagles,TEAM,TOTAL,TOTAL,False,,25,67,20,53,5,14,10,15,11,19,30,14,3,1,16,27,65
401480258,Miami Hurricanes,L. Pendande,4398863,,True,10.0,2,4,2,4,0,0,2,2,0,2,2,0,0,0,3,2,6
401480258,Miami Hurricanes,D. Harden,4281329,,True,23.0,5,10,1,4,4,6,0,0,0,4,4,4,4,0,1,2,14
401480258,Miami Hurricanes,J. Williams,4898556,,True,22.0,3,8,3,8,0,0,0,0,2,2,4,2,2,0,1,1,6
401480258,Miami Hurricanes,Hal. Cavinder,4433658,,True,23.0,2,5,0,0,2,5,3,3,1,4,5,5,2,0,0,2,9
401480258,Miami Hurricanes,K. Erjavec,4400202,,True,22.0,0,2,0,0,0,2,0,0,0,2,2,4,1,0,2,1,0
401480258,Miami Hurricanes,L. Spearman,4682913,,False,15.0,4,8,4,7,0,1,2,2,3,5,8,0,0,0,3,4,10
401480258,Miami Hurricanes,L. Lattimore,4433517,,False,22.0,10,14,9,13,1,1,4,5,4,6,10,0,0,1,1,1,25
401480258,Miami Hurricanes,J. Roberts,4898555,,False,20.0,1,6,1,4,0,2,0,0,2,2,4,1,0,0,0,2,2
401480258,Miami Hurricanes,L. Dwyer,4683033,,False,16.0,2,6,2,6,0,0,0,0,1,1,2,0,1,0,1,0,4
401480258,Miami Hurricanes,K. Salgues,4594385,,False,5.0,0,2,0,0,0,2,0,0,0,0,0,2,0,0,0,0,0
401480258,Miami Hurricanes,Han. Cavinder,4433372,,False,22.0,2,5,1,3,1,2,0,0,0,1,1,5,2,0,2,1,5
401480258,Miami Hurricanes,TEAM,TOTAL,TOTAL,False,,31,70,23,49,8,21,11,12,15,29,44,23,12,1,15,16,81
401480258,Boston University Terriers,C. Weimar,4704495,,True,32.0,3,10,3,10,0,0,1,2,3,4,7,4,0,2,3,2,7
401480258,Boston University Terriers,M. Durant,4599732,,True,18.0,1,7,1,7,0,0,0,0,3,4,7,0,0,0,3,5,2
401480258,Boston University Terriers,L. Davenport,4899718,,True,16.0,0,2,0,1,0,1,0,0,0,2,2,2,0,2,1,0,0
401480258,Boston University Terriers,M. Pina,4599731,,True,28.0,1,7,1,2,0,5,3,4,0,2,2,1,1,0,3,3,5
401480258,Boston University Terriers,S. Johnson,4599729,,True,30.0,4,14,3,11,1,3,2,2,1,1,2,3,0,0,8,1,11
401480258,Boston University Terriers,S. Crispe,5109197,,False,21.0,3,7,3,6,0,1,0,0,1,5,6,1,1,0,1,1,6
401480258,Boston University Terriers,A. Semenova,5109196,,False,8.0,0,0,0,0,0,0,0,0,0,0,0,0,0,0,0,2,0
401480258,Boston University Terriers,S. Beneventine,4704699,,False,19.0,0,1,0,1,0,0,2,2,0,0,0,1,0,0,1,0,2
401480258,Boston University Terriers,K. Mingo,4704698,,False,14.0,4,7,1,3,3,4,0,0,1,1,2,0,1,1,2,0,11
401480258,Boston University Terriers,L. Shean,4599727,,False,14.0,1,1,1,1,0,0,0,0,0,2,2,0,0,0,1,1,2
401480258,Boston University Terriers,TEAM,TOTAL,TOTAL,False,,17,56,13,42,4,14,8,10,10,21,31,12,3,5,23,15,46
401480184,Texas A&M Aggies,J. Barker,4565501,,True,22.0,8,18,8,18,0,0,1,2,5,2,7,1,2,0,4,3,17
401480184,Texas A&M Aggies,A. Patty,4398939,,True,23.0,3,6,3,5,0,1,2,4,2,7,9,1,1,2,2,4,8
401480184,Texas A&M Aggies,S. Bowles,4565518,,True,23.0,2,7,0,1,2,6,0,0,0,1,1,0,1,0,1,2,6
401480184,Texas A&M Aggies,S. Jones,4433759,,True,31.0,4,10,4,8,0,2,3,3,4,7,11,1,0,1,1,0,11
401480184,Texas A&M Aggies,M. Green,4432985,,True,22.0,1,2,1,2,0,0,1,2,0,1,1,4,2,1,0,1,3
401480184,Texas A&M Aggies,J. Malone,4433526,,False,15.0,2,5,2,5,0,0,2,3,5,1,6,0,1,0,2,2,6
401480184,Texas A&M Aggies,E. Kindred,4682637,,False,15.0,1,7,1,4,0,3,0,2,1,1,2,0,0,0,1,1,2
401480184,Texas A&M Aggies,S. Roby,4433325,,False,14.0,4,10,4,10,0,0,2,4,7,2,9,1,1,0,0,2,10
401480184,Texas A&M Aggies,T. Hylton,4913560,,False,17.0,2,5,1,4,1,1,0,2,1,2,3,5,2,0,0,2,5
401480184,Texas A&M Aggies,K. Green,4704601,,False,18.0,2,7,1,3,1,4,0,0,1,0,1,2,1,0,1,2,5
401480184,Texas A&M Aggies,TEAM,TOTAL,TOTAL,False,,29,77,25,60,4,17,11,22,28,25,53,15,11,4,13,19,73
401480184,Army Black Knights,S. Hunter,4595466,,True,27.0,5,9,5,9,0,0,2,2,1,5,6,0,1,0,3,4,12
401480184,Army Black Knights,R. Ericson,5109190,,True,31.0,2,7,0,5,2,2,2,2,0,2,2,9,0,0,7,1,8
401480184,Army Black Knights,L. Lithgow,4704696,,True,30.0,1,5,1,3,0,2,0,2,1,2,3,1,0,0,1,1,2
401480184,Army Black Knights,S. McNaughton,4704694,,True,25.0,2,4,2,4,0,0,0,0,0,2,2,0,1,0,3,2,4
401480184,Army Black Knights,H. Brown,4595467,,True,22.0,0,5,0,4,0,1,2,2,2,1,3,0,0,0,2,2,2
401480184,Army Black Knights,L. Madison,5109194,,False,4.0,1,2,1,2,0,0,0,0,1,0,1,0,0,0,1,2,2
401480184,Army Black Knights,A. Ainsworth,5109189,,False,2.0,1,1,1,1,0,0,0,0,0,0,0,0,0,0,1,0,2
401480184,Army Black Knights,R. Warren,4704695,,False,4.0,0,0,0,0,0,0,0,2,0,2,2,0,0,0,0,0,0
401480184,Army Black Knights,K. Hall,4595465,,False,12.0,3,9,2,8,1,1,0,0,2,2,4,1,0,1,1,4,7
401480184,Army Black Knights,J. Laguna,5109193,,False,1.0,0,0,0,0,0,0,0,0,0,0,0,0,0,0,0,0,0
401480184,Army Black Knights,C. Richman,5109191,,False,22.0,1,4,0,1,1,3,0,0,0,3,3,1,0,0,0,4,3
401480184,Army Black Knights,V. Kearney,4899713,,False,7.0,1,1,0,0,1,1,3,4,0,0,0,0,0,0,1,3,6
401480184,Army Black Knights,M. George,4704693,,False,4.0,0,0,0,0,0,0,0,0,0,0,0,0,0,0,1,0,0
401480184,Army Black Knights,J. Strippoli,4595470,,False,3.0,0,0,0,0,0,0,1,2,0,1,1,0,0,0,1,0,1
401480184,Army Black Knights,N. Rhine,4595464,,False,6.0,0,1,0,0,0,1,0,0,0,0,0,0,0,0,1,1,0
401480184,Army Black Knights,TEAM,TOTAL,TOTAL,False,,17,48,12,37,5,11,10,16,8,24,32,12,2,1,23,24,49
