game_id,team,player,player_id,position,starter,min,fgm,fga,2pm,2pa,3pm,3pa,ftm,fta,oreb,dreb,reb,ast,stl,blk,to,pf,pts
400949246,North Carolina Tar Heels,J. Jackson,3138156,,True,37.0,6,19,6,10,0,9,4,5,3,1,4,3,1,2,1,2,16
400949246,North Carolina Tar Heels,T. Pinson,3138154,,True,30.0,2,9,2,5,0,4,2,2,1,8,9,2,1,1,1,2,6
400949246,North Carolina Tar Heels,I. Hicks,66874,,True,30.0,5,9,5,9,0,0,3,5,3,6,9,1,1,2,1,4,13
400949246,North Carolina Tar Heels,K. Meeks,66873,,True,22.0,3,5,3,5,0,0,1,4,4,6,10,0,2,2,0,4,7
400949246,North Carolina Tar Heels,J. Berry II,3138155,,True,37.0,7,19,3,6,4,13,4,8,0,3,3,6,2,1,1,3,22
400949246,North Carolina Tar Heels,T. Bradley,4065673,,False,18.0,2,8,2,8,0,0,1,2,2,5,7,1,0,0,0,2,5
400949246,North Carolina Tar Heels,L. Maye,3911620,,False,10.0,0,1,0,1,0,0,0,0,1,1,2,0,0,0,0,3,0
400949246,North Carolina Tar Heels,S. Woods,4065676,,False,3.0,0,0,0,0,0,0,0,0,0,0,0,0,0,0,0,0,0
400949246,North Carolina Tar Heels,N. Britt,66872,,False,13.0,1,3,1,2,0,1,0,0,1,1,2,2,0,0,0,2,2
400949246,North Carolina Tar Heels,TEAM,TOTAL,TOTAL,False,,26,73,22,46,4,27,15,26,15,31,46,15,7,8,4,22,71
400949246,Gonzaga Bulldogs,J. Williams,66260,,True,23.0,4,7,3,4,1,3,0,0,0,5,5,0,0,0,0,4,9
400949246,Gonzaga Bulldogs,P. Karnowski,62585,,True,29.0,1,8,1,8,0,0,7,9,2,7,9,0,0,1,4,4,9
400949246,Gonzaga Bulldogs,J. Perkins,3155941,,True,35.0,3,8,0,2,3,6,4,5,0,2,2,3,0,0,2,3,13
400949246,Gonzaga Bulldogs,N. Williams-Goss,67814,,True,39.0,5,17,4,14,1,3,4,8,2,7,9,6,0,0,2,3,15
400949246,Gonzaga Bulldogs,J. Mathews,66328,,True,32.0,2,7,0,2,2,5,0,1,0,3,3,1,1,0,1,1,6
400949246,Gonzaga Bulldogs,K. Tillie,4066651,,False,14.0,0,3,0,3,0,0,1,2,2,7,9,1,0,1,1,2,1
400949246,Gonzaga Bulldogs,Z. Collins,4066650,,False,14.0,4,6,4,6,0,0,1,1,3,4,7,0,1,3,4,5,9
400949246,Gonzaga Bulldogs,J. Jones,3947137,,False,0.0,0,0,0,0,0,0,0,0,0,0,0,0,0,0,0,0,0
400949246,Gonzaga Bulldogs,S. Melson,3155940,,False,14.0,1,3,0,1,1,2,0,0,0,0,0,0,0,0,0,0,3
400949246,Gonzaga Bulldogs,TEAM,TOTAL,TOTAL,False,,20,59,12,40,8,19,17,26,12,37,49,11,2,5,14,22,65
400949062,TCU Horned Frogs,J. Miller,3947247,,True,23.0,4,11,4,9,0,2,1,1,3,4,7,0,1,0,1,1,9
400949062,TCU Horned Frogs,V. Brodziansky,3947246,,True,24.0,8,15,8,15,0,0,2,2,3,3,6,0,0,1,0,2,18
400949062,TCU Horned Frogs,D. Bane,4066320,,True,22.0,4,7,3,5,1,2,0,0,0,2,2,1,0,1,0,3,9
400949062,TCU Horned Frogs,A. Robinson,3136624,,True,33.0,4,10,4,8,0,2,2,3,2,0,2,11,4,0,6,1,10
400949062,TCU Horned Frogs,K. Williams,3133626,,True,38.0,8,14,6,9,2,5,7,8,4,8,12,1,4,0,0,1,25
400949062,TCU Horned Frogs,A. Sottile,4066324,,False,1.0,0,1,0,1,0,0,0,0,0,0,0,0,0,0,0,0,0
400949062,TCU Horned Frogs,K. Shepherd,66151,,False,9.0,2,3,2,3,0,0,0,0,0,1,1,2,0,0,0,4,4
400949062,TCU Horned Frogs,C. Washburn,61360,,False,7.0,0,0,0,0,0,0,1,2,0,0,0,0,0,1,0,3,1
400949062,TCU Horned Frogs,J. Parrish,4066322,,False,1.0,1,1,1,1,0,0,0,0,0,0,0,1,1,0,0,0,2
400949062,TCU Horned Frogs,D. Dry,3133624,,False,1.0,1,1,0,0,1,1,0,0,0,0,0,0,0,0,0,0,3
400949062,TCU Horned Frogs,B. Parrish,66153,,False,17.0,2,2,2,2,0,0,0,0,0,6,6,0,1,0,0,0,4
400949062,TCU Horned Frogs,M. Williams,66152,,False,24.0,1,3,0,0,1,3,0,0,0,1,1,1,2,0,1,1,3
400949062,TCU Horned Frogs,TEAM,TOTAL,TOTAL,False,,35,68,30,53,5,15,13,16,16,28,44,17,13,3,12,16,88
400949062,Georgia Tech Yellow Jackets,Q. Stephens,66128,,True,34.0,2,8,1,3,1,5,0,2,1,5,6,0,2,1,2,2,5
400949062,Georgia Tech Yellow Jackets,B. Lammers,3135061,,True,32.0,1,11,1,11,0,0,6,6,2,5,7,2,0,3,1,3,8
400949062,Georgia Tech Yellow Jackets,J. Okogie,4065663,,True,34.0,4,12,3,11,1,1,3,5,3,3,6,1,1,0,2,3,12
400949062,Georgia Tech Yellow Jackets,J. Heath,67623,,True,32.0,0,1,0,1,0,0,0,0,0,3,3,4,0,0,4,2,0
400949062,Georgia Tech Yellow Jackets,C. Heyward,61609,,True,19.0,1,3,0,0,1,3,0,0,0,0,0,2,0,0,0,1,3
400949062,Georgia Tech Yellow Jackets,S. Ogbonda,3904627,,False,8.0,3,3,3,3,0,0,0,2,1,0,1,0,0,1,1,3,6
400949062,Georgia Tech Yellow Jackets,R. Rowland,67543,,False,2.0,0,0,0,0,0,0,0,0,1,0,1,1,0,0,0,0,0
400949062,Georgia Tech Yellow Jackets,K. McCormick,61453,,False,2.0,1,1,0,0,1,1,0,0,0,0,0,0,0,0,1,0,3
400949062,Georgia Tech Yellow Jackets,N. Harris,4072202,,False,1.0,0,2,0,2,0,0,0,0,1,0,1,0,0,0,0,0,0
400949062,Georgia Tech Yellow Jackets,S. Medlock,4065664,,False,1.0,0,0,0,0,0,0,0,0,0,1,1,0,0,0,0,0,0
400949062,Georgia Tech Yellow Jackets,J. Moore,4065662,,False,8.0,0,0,0,0,0,0,0,0,0,0,0,1,0,0,0,0,0
400949062,Georgia Tech Yellow Jackets,T. Jackson,3135057,,False,25.0,8,14,6,11,2,3,1,2,0,0,0,1,1,0,6,3,19
400949062,Georgia Tech Yellow Jackets,J. Price,61778,,False,2.0,0,1,0,1,0,0,0,0,0,0,0,0,0,0,0,0,0
400949062,Georgia Tech Yellow Jackets,TEAM,TOTAL,TOTAL,False,,20,56,14,43,6,13,10,17,12,18,30,12,4,5,17,17,56
400948853,Oregon Ducks,D. Brooks,3155526,,True,33.0,2,11,2,8,0,3,6,6,1,5,6,1,2,1,5,5,10
400948853,Oregon Ducks,J. Bell,66207,,True,35.0,5,7,5,7,0,0,3,5,4,12,16,1,1,4,4,2,13
400948853,Oregon Ducks,P. Pritchard,4066354,,True,23.0,2,6,1,1,1,5,0,0,2,2,4,1,0,0,1,4,5
400948853,Oregon Ducks,T. Dorsey,3915560,,True,38.0,3,11,0,4,3,7,12,12,1,3,4,0,0,0,1,4,21
400948853,Oregon Ducks,D. Ennis,56265,,True,37.0,7,19,5,10,2,9,2,2,0,6,6,3,1,1,3,2,18
400948853,Oregon Ducks,K. Bigby-Williams,3134497,,False,10.0,0,0,0,0,0,0,0,0,1,0,1,0,0,1,0,1,0
400948853,Oregon Ducks,K. Smith,4066356,,False,3.0,2,2,2,2,0,0,0,0,1,1,2,0,0,0,0,1,4
400948853,Oregon Ducks,C. Benson,3134898,,False,21.0,1,2,0,0,1,2,2,3,1,2,3,1,1,0,2,1,5
400948853,Oregon Ducks,TEAM,TOTAL,TOTAL,False,,22,58,15,32,7,26,25,28,12,31,43,7,5,7,16,20,76
400948853,North Carolina Tar Heels,J. Jackson,3138156,,True,38.0,6,13,2,4,4,9,6,6,1,1,2,2,2,1,4,1,22
400948853,North Carolina Tar Heels,T. Pinson,3138154,,True,28.0,2,8,1,6,1,2,3,4,4,4,8,5,0,1,1,3,8
400948853,North Carolina Tar Heels,I. Hicks,66874,,True,20.0,1,12,1,12,0,0,0,0,0,3,3,1,1,0,2,2,2
400948853,North Carolina Tar Heels,K. Meeks,66873,,True,30.0,11,13,11,13,0,0,3,6,8,6,14,1,3,1,0,4,25
400948853,North Carolina Tar Heels,J. Berry II,3138155,,True,35.0,2,14,0,6,2,8,5,9,1,2,3,2,1,0,2,2,11
400948853,North Carolina Tar Heels,T. Bradley,4065673,,False,10.0,1,2,1,2,0,0,0,0,2,4,6,0,0,0,2,2,2
400948853,North Carolina Tar Heels,L. Maye,3911620,,False,13.0,0,3,0,2,0,1,2,2,0,3,3,2,0,0,0,3,2
400948853,North Carolina Tar Heels,S. Woods,4065676,,False,3.0,0,0,0,0,0,0,0,0,0,1,1,0,0,0,0,1,0
400948853,North Carolina Tar Heels,N. Britt,66872,,False,22.0,2,3,1,2,1,1,0,0,0,2,2,3,0,0,0,4,5
400948853,North Carolina Tar Heels,S. White,56963,,False,1.0,0,0,0,0,0,0,0,0,0,0,0,0,0,0,0,0,0
400948853,North Carolina Tar Heels,TEAM,TOTAL,TOTAL,False,,25,68,17,47,8,21,19,27,17,26,43,16,7,3,11,22,77
400948726,North Carolina Tar Heels,J. Jackson,3138156,,True,38.0,7,17,6,12,1,5,4,7,3,2,5,4,1,0,1,1,19
400948726,North Carolina Tar Heels,T. Pinson,3138154,,True,30.0,2,4,2,3,0,1,5,6,0,4,4,3,1,1,3,2,9
400948726,North Carolina Tar Heels,I. Hicks,66874,,True,20.0,2,5,2,5,0,0,0,2,0,0,0,2,0,3,1,3,4
400948726,North Carolina Tar Heels,K. Meeks,66873,,True,32.0,2,4,2,4,0,0,3,4,5,12,17,2,1,4,2,2,7
400948726,North Carolina Tar Heels,J. Berry II,3138155,,True,33.0,4,12,4,7,0,5,3,4,0,4,4,3,2,0,4,3,11
400948726,North Carolina Tar Heels,T. Bradley,4065673,,False,8.0,3,3,3,3,0,0,0,0,0,1,1,0,1,1,1,2,6
400948726,North Carolina Tar Heels,L. Maye,3911620,,False,20.0,6,9,4,6,2,3,3,3,0,3,3,2,1,0,0,0,17
400948726,North Carolina Tar Heels,S. Woods,4065676,,False,1.0,0,0,0,0,0,0,0,0,0,0,0,1,0,0,0,2,0
400948726,North Carolina Tar Heels,N. Britt,66872,,False,13.0,0,3,0,2,0,1,0,0,0,2,2,0,0,0,2,2,0
400948726,North Carolina Tar Heels,S. White,56963,,False,5.0,1,1,1,1,0,0,0,0,1,1,2,0,0,0,1,1,2
400948726,North Carolina Tar Heels,TEAM,TOTAL,TOTAL,False,,27,58,24,43,3,15,18,26,13,31,44,17,7,9,16,18,75
400948726,Kentucky Wildcats,B. Adebayo,4066261,,True,34.0,4,10,4,10,0,0,5,6,3,4,7,2,1,1,2,2,13
400948726,Kentucky Wildcats,D. Willis,66619,,True,21.0,3,6,3,3,0,3,0,0,0,6,6,2,0,0,1,4,6
400948726,Kentucky Wildcats,M. Monk,4066262,,True,30.0,4,10,1,4,3,6,1,2,1,1,2,0,0,1,1,4,12
400948726,Kentucky Wildcats,D. Fox,4066259,,True,28.0,5,14,3,10,2,4,1,2,1,3,4,3,2,0,1,4,13
400948726,Kentucky Wildcats,I. Briscoe,3936294,,True,34.0,3,7,3,7,0,0,1,4,1,3,4,8,3,0,3,1,7
400948726,Kentucky Wildcats,W. Gabriel,4066264,,False,4.0,0,0,0,0,0,0,0,0,1,0,1,0,0,0,0,1,0
400948726,Kentucky Wildcats,I. Humphries,3926491,,False,21.0,5,8,5,8,0,0,2,2,2,3,5,1,1,0,0,1,12
400948726,Kentucky Wildcats,M. Mulder,3936298,,False,6.0,0,5,0,2,0,3,0,0,0,1,1,0,0,0,0,0,0
400948726,Kentucky Wildcats,D. Hawkins,66617,,False,22.0,3,5,1,2,2,3,2,3,1,2,3,0,0,0,1,2,10
400948726,Kentucky Wildcats,TEAM,TOTAL,TOTAL,False,,27,65,20,46,7,19,12,19,11,23,34,16,7,2,9,19,73
400948296,Georgia Tech Yellow Jackets,Q. Stephens,66128,,True,36.0,4,12,2,5,2,7,3,4,2,7,9,3,1,0,3,1,13
400948296,Georgia Tech Yellow Jackets,B. Lammers,3135061,,True,36.0,6,8,6,8,0,0,3,4,2,9,11,1,2,5,0,3,15
400948296,Georgia Tech Yellow Jackets,J. Okogie,4065663,,True,34.0,7,18,6,15,1,3,7,9,4,5,9,2,2,2,1,3,22
400948296,Georgia Tech Yellow Jackets,J. Heath,67623,,True,28.0,1,5,1,4,0,1,0,1,0,2,2,4,1,1,2,1,2
400948296,Georgia Tech Yellow Jackets,C. Heyward,61609,,True,23.0,1,1,0,0,1,1,1,2,0,3,3,2,0,0,0,0,4
400948296,Georgia Tech Yellow Jackets,S. Ogbonda,3904627,,False,4.0,0,1,0,1,0,0,0,0,0,1,1,0,0,0,0,3,0
400948296,Georgia Tech Yellow Jackets,R. Rowland,67543,,False,0.0,0,0,0,0,0,0,0,0,0,0,0,0,0,0,0,0,0
400948296,Georgia Tech Yellow Jackets,K. McCormick,61453,,False,1.0,0,0,0,0,0,0,0,0,0,0,0,0,0,0,0,0,0
400948296,Georgia Tech Yellow Jackets,N. Harris,4072202,,False,1.0,0,0,0,0,0,0,0,0,0,0,0,0,0,0,0,0,0
400948296,Georgia Tech Yellow Jackets,J. Moore,4065662,,False,14.0,3,6,3,6,0,0,2,2,1,0,1,1,0,0,1,0,8
400948296,Georgia Tech Yellow Jackets,T. Jackson,3135057,,False,22.0,4,8,3,5,1,3,3,4,0,0,0,3,0,0,0,2,12
400948296,Georgia Tech Yellow Jackets,J. Price,61778,,False,1.0,0,1,0,0,0,1,0,0,0,1,1,0,0,0,0,0,0
400948296,Georgia Tech Yellow Jackets,TEAM,TOTAL,TOTAL,False,,26,60,21,44,5,16,19,26,10,28,38,16,6,8,7,13,76
400948296,Cal State Bakersfield Roadrunners,J. Airington,66690,,True,34.0,4,9,2,6,2,3,2,2,2,2,4,3,1,0,2,5,12
400948296,Cal State Bakersfield Roadrunners,M. Smith,62572,,True,21.0,0,5,0,5,0,0,5,6,5,1,6,0,0,0,1,5,5
400948296,Cal State Bakersfield Roadrunners,M. Aly,4066812,,True,16.0,1,2,1,2,0,0,0,0,1,2,3,0,0,2,0,1,2
400948296,Cal State Bakersfield Roadrunners,D. Basile,3919459,,True,28.0,6,14,1,5,5,9,1,2,0,3,3,1,0,0,1,2,18
400948296,Cal State Bakersfield Roadrunners,B. Wrapp,66688,,True,17.0,0,2,0,1,0,1,0,0,0,2,2,2,1,1,4,1,0
400948296,Cal State Bakersfield Roadrunners,B. Barnes,3153401,,False,1.0,0,0,0,0,0,0,0,0,0,0,0,0,0,0,0,0,0
400948296,Cal State Bakersfield Roadrunners,J. Suber,3138479,,False,0.0,0,0,0,0,0,0,0,0,0,0,0,0,0,0,0,0,0
400948296,Cal State Bakersfield Roadrunners,S. Briggs,4066810,,False,26.0,4,8,4,8,0,0,2,2,1,5,6,0,0,1,2,2,10
400948296,Cal State Bakersfield Roadrunners,F. Ndoye,67113,,False,10.0,1,1,1,1,0,0,0,1,1,2,3,0,0,0,0,0,2
400948296,Cal State Bakersfield Roadrunners,J. Pride,3919463,,False,23.0,1,2,1,2,0,0,0,0,1,6,7,4,0,0,4,4,2
400948296,Cal State Bakersfield Roadrunners,D. Durham,3919461,,False,24.0,4,17,3,7,1,10,1,1,1,2,3,3,3,0,1,1,10
400948296,Cal State Bakersfield Roadrunners,TEAM,TOTAL,TOTAL,False,,21,60,13,37,8,23,11,14,13,26,39,13,5,4,15,21,61
400947324,North Carolina Tar Heels,J. Jackson,3138156,,True,34.0,9,18,7,10,2,8,4,6,3,2,5,5,0,0,1,1,24
400947324,North Carolina Tar Heels,T. Pinson,3138154,,True,25.0,1,4,1,2,0,2,3,4,2,0,2,4,1,0,3,3,5
400947324,North Carolina Tar Heels,I. Hicks,66874,,True,17.0,4,5,4,5,0,0,1,5,0,1,1,3,0,0,1,5,9
400947324,North Carolina Tar Heels,K. Meeks,66873,,True,27.0,1,3,1,3,0,0,3,4,1,10,11,0,1,1,0,3,5
400947324,North Carolina Tar Heels,J. Berry II,3138155,,True,35.0,8,13,5,6,3,7,7,9,0,1,1,2,1,0,2,2,26
400947324,North Carolina Tar Heels,A. Rohlman,4065677,,False,1.0,0,0,0,0,0,0,0,0,0,0,0,0,0,0,0,0,0
400947324,North Carolina Tar Heels,S. Rush,4065674,,False,1.0,0,0,0,0,0,0,0,0,0,0,0,0,0,0,0,0,0
400947324,North Carolina Tar Heels,T. Bradley,4065673,,False,6.0,1,2,1,2,0,0,0,1,0,1,1,0,0,0,0,2,2
400947324,North Carolina Tar Heels,L. Maye,3911620,,False,25.0,6,10,3,5,3,5,1,2,3,9,12,2,1,0,0,1,16
400947324,North Carolina Tar Heels,S. Woods,4065676,,False,4.0,0,0,0,0,0,0,0,0,0,1,1,1,1,0,1,0,0
400947324,North Carolina Tar Heels,B. Robinson,4065675,,False,1.0,0,0,0,0,0,0,0,0,0,0,0,0,0,0,0,0,0
400947324,North Carolina Tar Heels,K. Coker,3947144,,False,1.0,0,0,0,0,0,0,0,0,0,0,0,0,0,0,0,1,0
400947324,North Carolina Tar Heels,N. Britt,66872,,False,22.0,1,2,0,0,1,2,2,2,0,2,2,5,2,0,2,2,5
400947324,North Carolina Tar Heels,S. White,56963,,False,1.0,0,0,0,0,0,0,0,0,0,0,0,0,0,0,0,1,0
400947324,North Carolina Tar Heels,TEAM,TOTAL,TOTAL,False,,31,57,22,33,9,24,21,33,10,28,38,22,7,1,10,21,92
400947324,Butler Bulldogs,T. Wideman,3133594,,True,22.0,1,2,1,2,0,0,0,0,1,2,3,1,0,0,2,4,2
400947324,Butler Bulldogs,A. Chrabascz,66163,,True,35.0,7,14,5,10,2,4,5,5,2,5,7,4,0,0,1,4,21
400947324,Butler Bulldogs,K. Baldwin,4065761,,True,29.0,5,9,4,5,1,4,3,4,1,4,5,1,2,0,3,3,14
400947324,Butler Bulldogs,A. Woodson,62504,,True,28.0,3,11,1,3,2,8,0,0,0,0,0,0,2,0,1,4,8
400947324,Butler Bulldogs,K. Savage,61180,,True,24.0,2,5,1,3,1,2,3,4,0,2,2,2,0,1,0,2,8
400947324,Butler Bulldogs,N. Fowler,3908904,,False,8.0,0,1,0,0,0,1,0,0,0,0,0,0,0,0,0,3,0
400947324,Butler Bulldogs,K. Martin,3133596,,False,28.0,5,12,3,4,2,8,4,4,1,4,5,1,0,0,2,2,16
400947324,Butler Bulldogs,H. Baddley,4065762,,False,1.0,0,0,0,0,0,0,0,0,0,0,0,0,0,0,0,0,0
400947324,Butler Bulldogs,S. McDermott,3908903,,False,1.0,0,0,0,0,0,0,2,2,1,0,1,0,0,0,0,0,2
400947324,Butler Bulldogs,T. Pettus,3159057,,False,1.0,0,0,0,0,0,0,1,2,0,0,0,0,0,0,0,0,1
400947324,Butler Bulldogs,S. Bennett,66162,,False,1.0,0,0,0,0,0,0,0,0,0,0,0,0,0,0,0,0,0
400947324,Butler Bulldogs,T. Lewis,61158,,False,22.0,4,8,4,7,0,1,0,0,2,0,2,4,1,0,0,1,8
400947324,Butler Bulldogs,TEAM,TOTAL,TOTAL,False,,27,62,19,34,8,28,18,21,8,18,26,13,5,1,9,23,80
400947314,Ole Miss Rebels,J. Furmanavicius,4066280,,True,21.0,1,3,1,3,0,0,0,0,1,2,3,1,0,0,2,3,2
400947314,Ole Miss Rebels,S. Saiz,66624,,True,34.0,8,11,8,10,0,1,3,4,4,11,15,2,2,1,2,3,19
400947314,Ole Miss Rebels,B. Tyree,4066276,,True,21.0,2,8,0,3,2,5,0,0,0,0,0,1,2,0,0,1,6
400947314,Ole Miss Rebels,T. Davis,3919454,,True,34.0,7,15,6,10,1,5,0,0,1,1,2,3,3,0,2,3,15
400947314,Ole Miss Rebels,D. Burnett,66129,,True,27.0,2,15,1,6,1,9,0,0,0,0,0,2,1,0,1,2,5
400947314,Ole Miss Rebels,M. Hymon,3136220,,False,25.0,3,5,3,5,0,0,0,0,5,3,8,3,1,1,1,2,6
400947314,Ole Miss Rebels,R. Brooks,3919453,,False,14.0,0,2,0,0,0,2,0,0,0,0,0,3,0,1,2,0,0
400947314,Ole Miss Rebels,C. Neal,67735,,False,24.0,4,9,2,3,2,6,3,4,1,1,2,1,0,0,2,3,13
400947314,Ole Miss Rebels,TEAM,TOTAL,TOTAL,False,,27,68,21,40,6,28,6,8,14,22,36,16,9,3,13,17,66
400947314,Georgia Tech Yellow Jackets,Q. Stephens,66128,,True,34.0,4,7,2,2,2,5,0,0,1,6,7,2,2,0,3,2,10
400947314,Georgia Tech Yellow Jackets,B. Lammers,3135061,,True,40.0,9,11,9,11,0,0,2,2,2,2,4,4,4,8,1,1,20
400947314,Georgia Tech Yellow Jackets,J. Okogie,4065663,,True,39.0,8,17,7,13,1,4,9,10,2,5,7,2,0,0,1,3,26
400947314,Georgia Tech Yellow Jackets,J. Heath,67623,,True,30.0,1,4,1,2,0,2,3,4,0,6,6,7,2,0,3,3,5
400947314,Georgia Tech Yellow Jackets,C. Heyward,61609,,True,20.0,0,0,0,0,0,0,1,2,0,1,1,2,1,0,1,3,1
400947314,Georgia Tech Yellow Jackets,J. Moore,4065662,,False,8.0,2,3,2,3,0,0,0,0,0,1,1,0,1,0,2,0,4
400947314,Georgia Tech Yellow Jackets,T. Jackson,3135057,,False,29.0,3,10,3,6,0,4,2,2,0,3,3,4,1,0,4,1,8
400947314,Georgia Tech Yellow Jackets,TEAM,TOTAL,TOTAL,False,,27,52,24,37,3,15,17,20,6,27,33,21,11,8,15,13,74
400947225,South Carolina Gamecocks,P. Dozier,3923250,,True,26.0,5,12,5,8,0,4,1,1,1,1,2,2,1,0,3,5,11
400947225,South Carolina Gamecocks,M. Kotsar,4066224,,True,16.0,0,3,0,3,0,0,0,0,0,1,1,1,0,0,1,5,0
400947225,South Carolina Gamecocks,C. Silva,3923253,,True,30.0,6,12,6,12,0,0,5,5,5,5,10,1,0,2,2,3,17
400947225,South Carolina Gamecocks,S. Thornwell,66270,,True,36.0,6,14,3,8,3,6,9,12,2,4,6,5,1,0,3,1,24
400947225,South Carolina Gamecocks,D. Notice,66266,,True,35.0,6,8,4,4,2,4,3,3,2,2,4,2,3,0,1,1,17
400947225,South Carolina Gamecocks,S. Keita,4066223,,False,9.0,0,2,0,2,0,0,0,1,1,1,2,0,1,0,0,1,0
400947225,South Carolina Gamecocks,K. Gueye,4066222,,False,0.0,0,0,0,0,0,0,0,0,0,0,0,0,0,0,0,0,0
400947225,South Carolina Gamecocks,H. Gravett,4066221,,False,9.0,0,3,0,1,0,2,0,0,0,0,0,1,0,0,0,0,0
400947225,South Carolina Gamecocks,R. Felder,4066220,,False,21.0,2,5,0,1,2,4,9,10,0,4,4,3,1,0,0,4,15
400947225,South Carolina Gamecocks,J. McKie,66265,,False,18.0,2,4,2,2,0,2,0,0,1,3,4,1,1,0,1,2,4
400947225,South Carolina Gamecocks,TEAM,TOTAL,TOTAL,False,,27,63,20,41,7,22,27,32,15,22,37,16,8,2,11,22,88
400947225,Duke Blue Devils,J. Tatum,4065648,,True,34.0,6,12,4,8,2,4,1,2,0,3,3,1,0,0,5,5,15
400947225,Duke Blue Devils,A. Jefferson,61586,,True,36.0,4,7,4,7,0,0,6,7,5,10,15,0,0,6,3,4,14
400947225,Duke Blue Devils,F. Jackson,4065651,,True,28.0,4,9,2,4,2,5,5,5,0,1,1,2,1,0,5,3,15
400947225,Duke Blue Devils,L. Kennard,3913174,,True,28.0,1,6,0,2,1,4,8,8,0,1,1,2,2,0,1,5,11
400947225,Duke Blue Devils,M. Jones,66563,,True,32.0,2,6,0,2,2,4,0,0,0,5,5,4,2,0,1,5,6
400947225,Duke Blue Devils,J. DeLaurier,4065650,,False,0.0,0,0,0,0,0,0,0,0,0,0,0,0,0,0,0,1,0
400947225,Duke Blue Devils,H. Giles III,4065649,,False,9.0,0,0,0,0,0,0,0,0,2,1,3,0,1,1,0,1,0
400947225,Duke Blue Devils,A. Vrankovic,3913177,,False,0.0,0,0,0,0,0,0,0,0,0,0,0,0,0,0,0,0,0
400947225,Duke Blue Devils,G. Allen,3135045,,False,33.0,5,13,2,3,3,10,7,7,1,2,3,2,0,0,3,2,20
400947225,Duke Blue Devils,TEAM,TOTAL,TOTAL,False,,22,53,12,26,10,27,27,29,10,24,34,11,6,7,18,26,81
400947185,North Carolina Tar Heels,J. Jackson,3138156,,True,36.0,5,14,2,8,3,6,2,2,2,6,8,5,5,0,4,3,15
400947185,North Carolina Tar Heels,T. Pinson,3138154,,True,29.0,1,4,1,4,0,0,0,0,0,2,2,2,2,0,3,0,2
400947185,North Carolina Tar Heels,I. Hicks,66874,,True,30.0,2,7,2,7,0,0,5,6,2,5,7,4,1,1,3,2,9
400947185,North Carolina Tar Heels,K. Meeks,66873,,True,29.0,7,13,7,13,0,0,2,2,7,4,11,0,1,3,2,1,16
400947185,North Carolina Tar Heels,J. Berry II,3138155,,True,34.0,2,13,0,5,2,8,4,7,0,2,2,3,2,0,1,1,10
400947185,North Carolina Tar Heels,T. Bradley,4065673,,False,12.0,2,2,2,2,0,0,3,4,3,4,7,0,0,0,3,3,7
400947185,North Carolina Tar Heels,L. Maye,3911620,,False,10.0,3,5,3,4,0,1,1,2,2,1,3,0,0,0,0,0,7
400947185,North Carolina Tar Heels,S. Woods,4065676,,False,4.0,0,1,0,1,0,0,0,0,0,0,0,0,1,0,0,0,0
400947185,North Carolina Tar Heels,N. Britt,66872,,False,16.0,2,4,2,2,0,2,2,2,0,0,0,1,1,0,1,0,6
400947185,North Carolina Tar Heels,TEAM,TOTAL,TOTAL,False,,24,63,19,46,5,17,19,25,18,27,45,15,13,4,17,10,72
400947185,Arkansas Razorbacks,M. Kingsley,66334,,True,32.0,4,12,4,11,0,1,1,4,0,5,5,1,1,2,1,4,9
400947185,Arkansas Razorbacks,D. Thomas,66206,,True,14.0,1,1,1,1,0,0,0,0,2,0,2,0,0,1,1,3,2
400947185,Arkansas Razorbacks,J. Barford,4066241,,True,26.0,4,14,3,8,1,6,0,0,2,2,4,2,1,0,5,3,9
400947185,Arkansas Razorbacks,M. Watkins,66333,,True,29.0,2,4,2,4,0,0,0,0,0,8,8,0,2,0,0,2,4
400947185,Arkansas Razorbacks,D. Hannahs,62408,,True,19.0,3,7,1,3,2,4,0,0,1,2,3,0,0,0,6,1,8
400947185,Arkansas Razorbacks,A. Cook,4066244,,False,5.0,0,0,0,0,0,0,0,0,0,0,0,0,0,1,0,1,0
400947185,Arkansas Razorbacks,A. Bailey,4066242,,False,19.0,2,4,2,4,0,0,0,0,0,0,0,0,3,0,1,3,4
400947185,Arkansas Razorbacks,T. Thompson,3136175,,False,10.0,0,0,0,0,0,0,0,0,1,1,2,0,1,0,1,1,0
400947185,Arkansas Razorbacks,D. Macon,4066243,,False,26.0,6,8,3,3,3,5,4,4,1,0,1,3,1,0,3,1,19
400947185,Arkansas Razorbacks,A. Beard,3136174,,False,20.0,4,10,2,5,2,5,0,0,1,4,5,3,1,0,0,1,10
400947185,Arkansas Razorbacks,TEAM,TOTAL,TOTAL,False,,26,60,18,39,8,21,5,8,8,24,32,9,10,4,19,20,65
400947182,Michigan Wolverines,M. Wagner,3150844,,True,31.0,11,14,10,13,1,1,3,6,1,2,3,1,2,0,1,3,26
400947182,Michigan Wolverines,D.J. Wilson,3136491,,True,36.0,6,13,5,10,1,3,4,4,1,1,2,0,1,3,2,2,17
400947182,Michigan Wolverines,M. Abdur-Rahkman,3136492,,True,37.0,2,4,2,3,0,1,2,2,1,3,4,2,0,0,0,2,6
400947182,Michigan Wolverines,Z. Irvin,66186,,True,35.0,5,9,4,7,1,2,0,0,1,3,4,2,0,0,2,2,11
400947182,Michigan Wolverines,D. Walton Jr.,66184,,True,36.0,3,13,1,6,2,7,2,2,1,6,7,6,0,0,0,3,10
400947182,Michigan Wolverines,M. Donnal,66187,,False,9.0,1,1,0,0,1,1,0,0,0,1,1,0,0,1,0,1,3
400947182,Michigan Wolverines,Z. Simpson,4066377,,False,4.0,0,0,0,0,0,0,0,0,0,0,0,0,0,0,0,1,0
400947182,Michigan Wolverines,D. Robinson,3157465,,False,12.0,0,3,0,1,0,2,0,0,1,1,2,0,1,0,1,1,0
400947182,Michigan Wolverines,TEAM,TOTAL,TOTAL,False,,28,57,22,40,6,17,11,14,9,21,30,11,4,4,6,15,73
400947182,Louisville Cardinals,M. Mathiang,63035,,True,18.0,6,7,6,7,0,0,1,2,3,1,4,0,0,0,1,4,13
400947182,Louisville Cardinals,D. Adel,3908807,,True,38.0,6,11,4,7,2,4,2,2,0,5,5,2,1,1,2,2,16
400947182,Louisville Cardinals,J. Johnson,3147362,,True,25.0,3,4,3,4,0,0,0,0,3,3,6,0,0,0,2,1,6
400947182,Louisville Cardinals,D. Mitchell,3908809,,True,37.0,8,17,5,9,3,8,0,0,1,6,7,5,1,1,0,3,19
400947182,Louisville Cardinals,Q. Snider,3147360,,True,23.0,0,9,0,2,0,7,0,0,1,0,1,3,0,0,1,2,0
400947182,Louisville Cardinals,V.J. King,4065666,,False,5.0,0,1,0,1,0,0,0,0,0,3,3,0,0,0,0,0,0
400947182,Louisville Cardinals,R. Spalding,3908806,,False,15.0,0,1,0,1,0,0,1,2,1,0,1,0,0,0,1,1,1
400947182,Louisville Cardinals,A. Mahmoud,3147363,,False,22.0,3,5,3,5,0,0,1,2,2,2,4,1,0,3,3,3,7
400947182,Louisville Cardinals,D. Levitch,66592,,False,2.0,0,0,0,0,0,0,0,0,0,1,1,0,0,0,0,0,0
400947182,Louisville Cardinals,T. Hicks,62752,,False,15.0,2,6,2,5,0,1,3,4,0,1,1,1,2,0,1,2,7
400947182,Louisville Cardinals,TEAM,TOTAL,TOTAL,False,,28,61,23,41,5,20,8,12,15,22,37,12,4,5,11,18,69
400947046,Xavier Musketeers,T. Jones,4065846,,True,17.0,6,7,6,7,0,0,1,1,2,2,4,1,0,0,1,3,13
400947046,Xavier Musketeers,Q. Goodin,4065847,,True,34.0,2,8,1,7,1,1,1,3,0,1,1,5,1,0,2,4,6
400947046,Xavier Musketeers,J.P. Macura,3136483,,True,30.0,4,10,2,7,2,3,0,0,0,2,2,5,2,0,1,2,10
400947046,Xavier Musketeers,T. Bluiett,3136481,,True,36.0,8,14,5,9,3,5,10,14,1,5,6,3,0,0,2,3,29
400947046,Xavier Musketeers,M. Bernard,61236,,True,25.0,2,3,1,1,1,2,1,1,0,5,5,1,0,0,1,3,6
400947046,Xavier Musketeers,C. Barr,4070705,,False,1.0,0,0,0,0,0,0,0,0,0,0,0,0,0,0,0,0,0
400947046,Xavier Musketeers,K. Gates,3912339,,False,30.0,5,6,1,1,4,5,0,0,0,5,5,2,0,0,1,1,14
400947046,Xavier Musketeers,S. O'Mara,3136484,,False,21.0,2,2,2,2,0,0,7,7,0,5,5,3,1,3,1,2,11
400947046,Xavier Musketeers,T. Stainbrook,67657,,False,1.0,0,1,0,0,0,1,0,0,0,0,0,0,0,0,0,0,0
400947046,Xavier Musketeers,R. Gaston,62635,,False,2.0,1,2,1,2,0,0,0,0,0,0,0,0,0,0,0,2,2
400947046,Xavier Musketeers,C. Peterson,4070706,,False,1.0,0,0,0,0,0,0,0,0,0,0,0,0,0,0,0,0,0
400947046,Xavier Musketeers,L. Schrand,4070704,,False,1.0,0,1,0,1,0,0,0,0,0,0,0,0,0,0,0,0,0
400947046,Xavier Musketeers,A. Bergen,3947456,,False,1.0,0,0,0,0,0,0,0,0,1,0,1,0,0,0,0,0,0
400947046,Xavier Musketeers,TEAM,TOTAL,TOTAL,False,,30,54,19,37,11,17,20,26,7,29,36,20,4,3,9,20,91
400947046,Florida State Seminoles,J. Isaac,4065654,,True,33.0,4,7,4,6,0,1,0,1,1,11,12,1,1,1,0,5,8
400947046,Florida State Seminoles,M. Ojo,61596,,True,15.0,0,0,0,0,0,0,4,4,1,1,2,0,0,0,1,1,4
400947046,Florida State Seminoles,T. Mann,3907823,,True,20.0,0,2,0,0,0,2,1,2,0,0,0,1,1,0,0,2,1
400947046,Florida State Seminoles,D. Bacon,3907821,,True,34.0,9,18,9,13,0,5,2,2,2,3,5,3,1,0,2,2,20
400947046,Florida State Seminoles,X. Rathan-Mayes,66125,,True,33.0,7,15,6,10,1,5,1,3,3,4,7,3,1,0,4,4,16
400947046,Florida State Seminoles,P. Cofer,3135054,,False,9.0,0,1,0,1,0,0,0,0,2,0,2,0,0,0,1,2,0
400947046,Florida State Seminoles,J. Smith,66126,,False,7.0,1,1,1,1,0,0,0,0,1,1,2,0,0,0,0,2,2
400947046,Florida State Seminoles,B. Allen,66124,,False,2.0,0,0,0,0,0,0,0,0,0,0,0,0,0,1,0,0,0
400947046,Florida State Seminoles,C. Koumadje,3907824,,False,4.0,0,0,0,0,0,0,0,0,0,0,0,0,0,0,0,1,0
400947046,Florida State Seminoles,B. Angola-Rodas,4065658,,False,11.0,1,5,0,2,1,3,2,2,0,1,1,0,0,0,0,2,5
400947046,Florida State Seminoles,P. Savoy,4065657,,False,14.0,2,5,0,1,2,4,4,5,0,0,0,0,3,0,0,2,10
400947046,Florida State Seminoles,T. Forrest,4065656,,False,9.0,0,3,0,3,0,0,0,0,0,0,0,2,0,0,0,0,0
400947046,Florida State Seminoles,C. Walker,4065655,,False,9.0,0,3,0,2,0,1,0,0,0,0,0,0,0,1,1,1,0
400947046,Florida State Seminoles,TEAM,TOTAL,TOTAL,False,,24,60,20,39,4,21,14,19,11,22,33,10,7,3,9,24,66
400947006,West Virginia Mountaineers,E. Ahmad,3947257,,True,27.0,3,7,2,6,1,1,4,4,1,8,9,2,0,1,3,1,11
400947006,West Virginia Mountaineers,E. Macon,67656,,True,24.0,4,7,4,7,0,0,3,4,1,3,4,1,0,0,1,2,11
400947006,West Virginia Mountaineers,N. Adrian,66155,,True,30.0,1,3,1,2,0,1,1,3,2,3,5,4,1,1,3,3,3
400947006,West Virginia Mountaineers,D. Miles Jr.,3133636,,True,28.0,5,8,4,7,1,1,7,8,1,1,2,3,3,1,0,4,18
400947006,West Virginia Mountaineers,J. Carter,3133635,,True,37.0,8,15,4,10,4,5,4,5,0,3,3,2,1,0,0,3,24
400947006,West Virginia Mountaineers,S. Konate,4066333,,False,8.0,2,3,2,3,0,0,0,0,1,2,3,0,0,1,1,1,4
400947006,West Virginia Mountaineers,L. West,3913555,,False,8.0,0,3,0,1,0,2,0,0,0,0,0,0,0,0,0,1,0
400947006,West Virginia Mountaineers,B. Watkins,66156,,False,6.0,0,2,0,2,0,0,0,0,1,0,1,0,0,0,0,1,0
400947006,West Virginia Mountaineers,T. Myers,3947255,,False,2.0,0,0,0,0,0,0,0,0,0,0,0,1,0,0,1,0,0
400947006,West Virginia Mountaineers,T. Phillip,3133638,,False,30.0,4,6,2,2,2,4,2,2,0,4,4,3,1,1,3,2,12
400947006,West Virginia Mountaineers,TEAM,TOTAL,TOTAL,False,,27,54,19,40,8,14,21,26,10,24,34,16,6,5,12,18,83
400947006,Notre Dame Fighting Irish,B. Colson,3138192,,True,37.0,10,15,6,10,4,5,3,3,1,7,8,0,1,1,1,4,27
400947006,Notre Dame Fighting Irish,V.J. Beachem,66283,,True,36.0,2,14,1,5,1,9,4,4,1,1,2,2,0,1,1,3,9
400947006,Notre Dame Fighting Irish,R. Pflueger,3908335,,True,15.0,1,4,1,2,0,2,0,0,0,3,3,0,1,0,2,2,2
400947006,Notre Dame Fighting Irish,M. Farrell,3138190,,True,36.0,3,6,1,2,2,4,0,0,0,0,0,6,0,0,4,2,8
400947006,Notre Dame Fighting Irish,S. Vasturia,66285,,True,34.0,4,9,3,4,1,5,2,2,1,3,4,2,0,0,1,2,11
400947006,Notre Dame Fighting Irish,M. Geben,3138191,,False,10.0,0,0,0,0,0,0,2,2,0,1,1,0,2,1,1,1,2
400947006,Notre Dame Fighting Irish,A. Torres,66286,,False,4.0,0,1,0,1,0,0,0,0,0,0,0,0,0,0,0,2,0
400947006,Notre Dame Fighting Irish,M. Ryan,3908336,,False,11.0,2,3,0,0,2,3,2,2,0,2,2,1,1,0,0,3,8
400947006,Notre Dame Fighting Irish,T. Gibbs,4065703,,False,17.0,0,2,0,2,0,0,4,4,0,2,2,1,1,0,3,2,4
400947006,Notre Dame Fighting Irish,TEAM,TOTAL,TOTAL,False,,22,54,12,26,10,28,17,17,8,20,28,12,6,3,14,21,71
400947000,Virginia Cavaliers,M. Diakite,3947156,,True,29.0,4,8,4,8,0,0,1,1,4,2,6,0,0,1,1,4,9
400947000,Virginia Cavaliers,J. Salt,3138200,,True,26.0,4,5,4,5,0,0,0,0,2,8,10,0,1,1,1,2,8
400947000,Virginia Cavaliers,D. Thompson,66274,,True,35.0,3,7,3,5,0,2,0,0,1,1,2,3,1,0,1,2,6
400947000,Virginia Cavaliers,L. Perrantes,66139,,True,32.0,2,12,2,8,0,4,2,2,0,1,1,3,0,0,4,0,6
400947000,Virginia Cavaliers,D. Hall,66138,,True,18.0,0,3,0,2,0,1,0,0,1,0,1,1,0,0,2,5,0
400947000,Virginia Cavaliers,J. Reuter,3908374,,False,5.0,1,2,1,2,0,0,1,2,0,0,0,0,1,0,0,0,3
400947000,Virginia Cavaliers,T. Jerome,4065733,,False,17.0,0,4,0,1,0,3,0,0,0,5,5,1,0,0,1,1,0
400947000,Virginia Cavaliers,K. Guy,4065730,,False,17.0,0,4,0,2,0,2,0,0,0,1,1,0,0,0,0,0,0
400947000,Virginia Cavaliers,M. Shayok,3138201,,False,21.0,2,9,1,6,1,3,2,2,0,2,2,0,1,1,1,3,7
400947000,Virginia Cavaliers,TEAM,TOTAL,TOTAL,False,,16,54,15,39,1,15,6,7,9,23,32,8,4,3,11,17,39
400947000,Florida Gators,J. Leon,3924899,,True,25.0,4,8,1,2,3,6,3,3,1,9,10,0,0,0,0,2,14
400947000,Florida Gators,D. Robinson,3137798,,True,31.0,5,8,3,4,2,4,2,5,0,11,11,0,0,0,1,0,14
400947000,Florida Gators,K. Hayes,3924898,,True,25.0,3,3,3,3,0,0,1,2,1,1,2,0,0,0,1,0,7
400947000,Florida Gators,K. Allen,3924896,,True,26.0,2,10,2,6,0,4,0,0,0,0,0,1,1,0,0,0,4
400947000,Florida Gators,K. Hill,66247,,True,24.0,1,4,1,2,0,2,1,2,1,0,1,2,1,0,2,4,3
400947000,Florida Gators,K. Stone,3924900,,False,11.0,1,2,0,1,1,1,0,0,0,0,0,0,1,0,2,0,3
400947000,Florida Gators,S. Rimmer,66218,,False,1.0,0,0,0,0,0,0,0,0,0,1,1,0,0,0,0,1,0
400947000,Florida Gators,G. Gak,4066257,,False,10.0,3,3,3,3,0,0,0,2,2,0,2,0,0,0,1,0,6
400947000,Florida Gators,E. Hester,4066256,,False,2.0,0,0,0,0,0,0,0,0,0,0,0,0,0,0,0,0,0
400947000,Florida Gators,C. Chiozza,3137795,,False,28.0,3,8,2,6,1,2,0,0,0,4,4,5,2,0,1,2,7
400947000,Florida Gators,C. Barry,61892,,False,17.0,1,4,0,2,1,2,4,4,0,1,1,2,1,1,1,1,7
400947000,Florida Gators,TEAM,TOTAL,TOTAL,False,,23,50,15,29,8,21,11,18,7,29,36,10,6,1,10,10,65
400946995,Syracuse Orange,T. Thompson,4065721,,True,27.0,8,11,8,11,0,0,2,3,4,4,8,1,5,2,0,3,18
400946995,Syracuse Orange,T. Lydon,3934662,,True,40.0,5,14,4,8,1,6,4,6,8,6,14,1,2,2,4,3,15
400946995,Syracuse Orange,A. White III,61616,,True,40.0,4,11,1,2,3,9,7,7,0,3,3,0,1,0,2,3,18
400946995,Syracuse Orange,T. Battle,4065722,,True,37.0,7,17,4,6,3,11,0,1,1,3,4,2,1,0,1,3,17
400946995,Syracuse Orange,J. Gillon,61915,,True,24.0,1,3,1,2,0,1,1,2,1,2,3,8,1,0,2,3,3
400946995,Syracuse Orange,T. Roberson,67633,,False,13.0,1,1,1,1,0,0,0,0,0,1,1,0,1,0,2,0,2
400946995,Syracuse Orange,F. Howard,3934659,,False,19.0,3,8,2,5,1,3,0,0,0,1,1,2,0,1,2,1,7
400946995,Syracuse Orange,TEAM,TOTAL,TOTAL,False,,29,65,21,35,8,30,14,19,15,21,36,14,11,5,13,16,80
400946995,Ole Miss Rebels,J. Furmanavicius,4066280,,True,28.0,1,3,1,3,0,0,2,3,2,2,4,0,0,1,1,3,4
400946995,Ole Miss Rebels,S. Saiz,66624,,True,32.0,4,13,4,12,0,1,2,2,3,9,12,1,3,0,3,3,10
400946995,Ole Miss Rebels,B. Tyree,4066276,,True,17.0,0,6,0,1,0,5,0,0,0,0,0,4,1,0,4,1,0
400946995,Ole Miss Rebels,T. Davis,3919454,,True,33.0,11,14,5,7,6,7,2,4,3,4,7,2,2,0,3,2,30
400946995,Ole Miss Rebels,D. Burnett,66129,,True,33.0,7,11,2,2,5,9,0,0,0,3,3,9,0,0,1,1,19
400946995,Ole Miss Rebels,M. Hymon,3136220,,False,20.0,1,2,1,2,0,0,0,0,1,2,3,1,2,0,1,3,2
400946995,Ole Miss Rebels,R. Brooks,3919453,,False,12.0,1,6,0,2,1,4,2,2,2,1,3,0,0,0,0,1,5
400946995,Ole Miss Rebels,C. Neal,67735,,False,25.0,4,7,1,1,3,6,4,4,0,1,1,0,1,0,1,4,15
400946995,Ole Miss Rebels,TEAM,TOTAL,TOTAL,False,,29,62,14,30,15,32,12,15,13,25,38,17,9,1,15,18,85
400946808,Georgia Tech Yellow Jackets,Q. Stephens,66128,,True,36.0,10,17,7,10,3,7,0,0,1,7,8,4,2,0,0,0,23
400946808,Georgia Tech Yellow Jackets,B. Lammers,3135061,,True,36.0,6,9,6,9,0,0,2,7,3,7,10,2,4,0,1,2,14
400946808,Georgia Tech Yellow Jackets,J. Okogie,4065663,,True,34.0,5,9,3,6,2,3,3,4,1,7,8,5,2,2,0,1,15
400946808,Georgia Tech Yellow Jackets,J. Heath,67623,,True,28.0,1,5,1,5,0,0,0,0,0,3,3,7,3,1,3,2,2
400946808,Georgia Tech Yellow Jackets,C. Heyward,61609,,True,16.0,0,1,0,0,0,1,0,0,0,0,0,0,0,0,0,3,0
400946808,Georgia Tech Yellow Jackets,S. Ogbonda,3904627,,False,4.0,0,0,0,0,0,0,0,0,1,1,2,1,0,0,0,0,0
400946808,Georgia Tech Yellow Jackets,R. Rowland,67543,,False,1.0,0,0,0,0,0,0,0,0,0,0,0,0,0,0,0,0,0
400946808,Georgia Tech Yellow Jackets,K. McCormick,61453,,False,1.0,0,0,0,0,0,0,0,0,0,0,0,0,0,0,0,0,0
400946808,Georgia Tech Yellow Jackets,J. Moore,4065662,,False,13.0,0,2,0,2,0,0,5,6,0,1,1,1,0,0,1,1,5
400946808,Georgia Tech Yellow Jackets,T. Jackson,3135057,,False,30.0,4,13,3,9,1,4,3,4,0,3,3,3,0,0,2,0,12
400946808,Georgia Tech Yellow Jackets,J. Price,61778,,False,1.0,0,0,0,0,0,0,0,0,0,1,1,0,0,0,0,0,0
400946808,Georgia Tech Yellow Jackets,TEAM,TOTAL,TOTAL,False,,26,56,20,41,6,15,13,21,6,30,36,23,11,3,8,9,71
400946808,Belmont Bruins,A. Egekeze,3138504,,True,25.0,4,9,2,3,2,6,0,0,2,2,4,0,0,0,1,5,10
400946808,Belmont Bruins,E. Bradds,66866,,True,31.0,4,12,4,12,0,0,2,3,2,3,5,2,0,0,4,2,10
400946808,Belmont Bruins,D. Windler,3906786,,True,27.0,1,6,1,3,0,3,0,0,1,5,6,0,2,0,2,4,2
400946808,Belmont Bruins,A. Luke,66869,,True,32.0,3,9,1,3,2,6,0,0,1,4,5,8,0,0,6,1,8
400946808,Belmont Bruins,T. Barnette,61761,,True,35.0,1,9,0,1,1,8,2,2,0,3,3,4,0,0,3,1,5
400946808,Belmont Bruins,N. Smith,66871,,False,18.0,5,9,1,2,4,7,0,0,3,3,6,0,0,0,0,1,14
400946808,Belmont Bruins,J. Lester,66868,,False,1.0,0,0,0,0,0,0,0,0,0,0,0,0,0,0,0,0,0
400946808,Belmont Bruins,S. Adelsperger,3906781,,False,4.0,1,1,1,1,0,0,0,0,0,0,0,0,0,1,0,1,2
400946808,Belmont Bruins,T. Hadden,66867,,False,1.0,0,0,0,0,0,0,0,0,0,1,1,0,0,0,0,0,0
400946808,Belmont Bruins,K. McClain,3906785,,False,17.0,2,8,0,5,2,3,0,0,1,5,6,1,0,1,1,2,6
400946808,Belmont Bruins,B. Sampson,66870,,False,9.0,0,0,0,0,0,0,0,0,0,0,0,0,0,0,0,1,0
400946808,Belmont Bruins,TEAM,TOTAL,TOTAL,False,,21,63,10,30,11,33,4,5,13,27,40,15,2,2,17,18,57
400946742,UNC Greensboro Spartans,K. Galloway,4067611,,True,8.0,2,4,2,4,0,0,0,0,2,1,3,0,0,0,0,0,4
400946742,UNC Greensboro Spartans,M. Smith,3137169,,True,27.0,4,12,3,5,1,7,0,1,1,2,3,3,0,0,0,5,9
400946742,UNC Greensboro Spartans,R.J. White,61982,,True,25.0,7,12,7,10,0,2,2,3,2,1,3,3,2,0,3,5,16
400946742,UNC Greensboro Spartans,D. Baldwin,67271,,True,38.0,8,15,7,10,1,5,2,4,4,4,8,9,3,0,3,2,19
400946742,UNC Greensboro Spartans,F. Alonso,3948853,,True,27.0,1,9,0,3,1,6,0,0,0,1,1,1,0,0,3,2,3
400946742,UNC Greensboro Spartans,J. Dickey,3948855,,False,25.0,6,8,6,8,0,0,0,0,1,3,4,1,0,0,1,5,12
400946742,UNC Greensboro Spartans,J. Kuiper,67274,,False,18.0,0,1,0,0,0,1,0,0,1,1,2,2,0,0,1,1,0
400946742,UNC Greensboro Spartans,M. Massey,4067610,,False,7.0,0,0,0,0,0,0,0,0,0,0,0,0,1,0,0,2,0
400946742,UNC Greensboro Spartans,D. Troy,3948854,,False,25.0,5,10,1,2,4,8,0,0,0,2,2,3,2,0,1,2,14
400946742,UNC Greensboro Spartans,TEAM,TOTAL,TOTAL,False,,33,71,26,42,7,29,4,8,13,15,28,22,8,0,12,24,77
400946742,Syracuse Orange,T. Thompson,4065721,,True,18.0,5,6,5,6,0,0,2,4,2,6,8,0,0,0,3,3,12
400946742,Syracuse Orange,T. Lydon,3934662,,True,40.0,3,9,3,7,0,2,7,7,2,8,10,4,1,2,4,3,13
400946742,Syracuse Orange,A. White III,61616,,True,40.0,11,15,4,6,7,9,5,6,2,4,6,0,1,0,1,2,34
400946742,Syracuse Orange,T. Battle,4065722,,True,35.0,7,16,6,9,1,7,5,5,0,2,2,4,3,0,0,2,20
400946742,Syracuse Orange,J. Gillon,61915,,True,28.0,0,0,0,0,0,0,4,4,0,1,1,5,0,0,4,1,4
400946742,Syracuse Orange,T. Roberson,67633,,False,22.0,2,2,2,2,0,0,0,2,3,4,7,3,2,1,3,0,4
400946742,Syracuse Orange,F. Howard,3934659,,False,17.0,1,4,0,1,1,3,0,0,0,0,0,4,1,0,1,1,3
400946742,Syracuse Orange,TEAM,TOTAL,TOTAL,False,,29,52,20,31,9,21,23,28,9,27,36,20,8,3,17,12,90
400946473,Oakland Golden Grizzlies,I. Brock,4067448,,True,35.0,2,5,2,5,0,0,0,0,5,7,12,2,0,4,1,3,4
400946473,Oakland Golden Grizzlies,J. Hayes,66807,,True,15.0,2,4,2,4,0,0,1,2,1,7,8,0,0,1,3,0,5
400946473,Oakland Golden Grizzlies,B. Neely,4067449,,True,15.0,2,5,0,2,2,3,0,0,0,0,0,0,1,0,1,3,6
400946473,Oakland Golden Grizzlies,M. Walker,67653,,True,38.0,7,17,4,7,3,10,6,8,3,5,8,2,1,0,1,0,23
400946473,Oakland Golden Grizzlies,S. Dorsey-Walker,61208,,True,38.0,7,16,4,7,3,9,4,6,0,3,3,3,0,0,4,3,21
400946473,Oakland Golden Grizzlies,X. Hill-Mais,3913700,,False,25.0,5,8,5,8,0,0,0,0,2,4,6,0,0,0,1,3,10
400946473,Oakland Golden Grizzlies,B. Brechting,3913699,,False,2.0,0,0,0,0,0,0,0,0,0,0,0,0,0,0,0,1,0
400946473,Oakland Golden Grizzlies,J. Cumberland,3913701,,False,4.0,0,0,0,0,0,0,0,0,0,0,0,0,0,0,0,0,0
400946473,Oakland Golden Grizzlies,N. Daniels,66808,,False,23.0,1,4,0,1,1,3,0,0,0,2,2,3,0,0,3,1,3
400946473,Oakland Golden Grizzlies,S. Clark,66306,,False,5.0,1,2,1,1,0,1,0,0,0,0,0,0,0,0,1,0,2
400946473,Oakland Golden Grizzlies,TEAM,TOTAL,TOTAL,False,,27,61,18,35,9,26,11,16,14,31,45,10,2,5,16,14,74
400946473,Clemson Tigers,D. Grantham,3129674,,True,27.0,3,8,1,5,2,3,0,0,0,1,1,3,0,1,0,2,8
400946473,Clemson Tigers,J. Blossomgame,61835,,True,36.0,9,17,9,15,0,2,6,6,1,7,8,1,1,3,1,0,24
400946473,Clemson Tigers,S. Djitte,66122,,True,29.0,3,5,3,5,0,0,1,2,6,5,11,0,0,1,4,3,7
400946473,Clemson Tigers,S. Mitchell,3136699,,True,24.0,4,11,2,8,2,3,3,3,0,2,2,6,1,0,3,0,13
400946473,Clemson Tigers,A. Holmes,62043,,True,24.0,1,6,0,3,1,3,0,0,0,0,0,1,0,0,0,0,3
400946473,Clemson Tigers,E. Thomas,3947075,,False,9.0,1,2,1,2,0,0,0,0,0,2,2,1,1,2,1,4,2
400946473,Clemson Tigers,L. Robertin,3917985,,False,3.0,2,2,2,2,0,0,0,0,1,0,1,0,0,0,0,0,4
400946473,Clemson Tigers,T. Hudson,3917986,,False,3.0,0,1,0,0,0,1,0,0,0,0,0,0,0,0,0,0,0
400946473,Clemson Tigers,M. Reed,3133969,,False,25.0,2,10,1,6,1,4,0,0,1,4,5,2,3,0,1,1,5
400946473,Clemson Tigers,G. DeVoe,3129673,,False,20.0,1,5,0,1,1,4,0,0,1,0,1,2,2,0,0,2,3
400946473,Clemson Tigers,TEAM,TOTAL,TOTAL,False,,26,67,19,47,7,20,10,11,11,21,32,16,8,7,10,12,69
400946457,Indiana Hoosiers,J. Morgan,3934721,,True,29.0,3,7,3,6,0,1,8,10,1,5,6,1,0,1,0,3,14
400946457,Indiana Hoosiers,T. Bryant,3934723,,True,22.0,6,11,6,10,0,1,1,1,3,4,7,3,1,0,3,3,13
400946457,Indiana Hoosiers,R. Johnson,3147671,,True,33.0,1,8,1,3,0,5,0,0,0,2,2,2,1,0,1,2,2
400946457,Indiana Hoosiers,J. Blackmon Jr.,3147669,,True,26.0,4,8,2,3,2,5,1,2,1,3,4,1,0,0,2,1,11
400946457,Indiana Hoosiers,J. Newkirk,66288,,True,31.0,4,9,2,5,2,4,0,0,2,1,3,4,0,1,3,3,10
400946457,Indiana Hoosiers,F. McSwain Jr.,4066363,,False,19.0,2,5,2,5,0,0,0,0,1,2,3,0,0,0,0,1,4
400946457,Indiana Hoosiers,D. Davis,4066362,,False,16.0,0,6,0,6,0,0,2,2,2,2,4,2,0,0,1,3,2
400946457,Indiana Hoosiers,D. Green,4066361,,False,9.0,0,1,0,0,0,1,0,0,0,0,0,2,1,0,2,0,0
400946457,Indiana Hoosiers,C. Jones,4066359,,False,15.0,2,3,1,1,1,2,2,3,0,2,2,2,1,0,2,2,7
400946457,Indiana Hoosiers,TEAM,TOTAL,TOTAL,False,,22,58,17,39,5,19,14,18,11,24,35,17,4,2,16,18,63
400946457,Georgia Tech Yellow Jackets,Q. Stephens,66128,,True,37.0,6,9,2,2,4,7,0,0,2,7,9,3,1,0,1,3,16
400946457,Georgia Tech Yellow Jackets,B. Lammers,3135061,,True,38.0,3,8,3,8,0,0,5,8,3,8,11,3,2,5,3,3,11
400946457,Georgia Tech Yellow Jackets,J. Okogie,4065663,,True,37.0,9,15,9,13,0,2,6,9,1,6,7,4,0,0,2,3,24
400946457,Georgia Tech Yellow Jackets,J. Heath,67623,,True,38.0,0,4,0,4,0,0,0,0,0,1,1,2,0,0,1,1,0
400946457,Georgia Tech Yellow Jackets,C. Heyward,61609,,True,21.0,1,4,0,0,1,4,0,0,0,1,1,1,0,0,0,0,3
400946457,Georgia Tech Yellow Jackets,S. Ogbonda,3904627,,False,2.0,0,0,0,0,0,0,0,0,0,0,0,0,0,0,0,1,0
400946457,Georgia Tech Yellow Jackets,J. Moore,4065662,,False,2.0,1,3,1,3,0,0,0,0,1,0,1,1,0,0,0,0,2
400946457,Georgia Tech Yellow Jackets,T. Jackson,3135057,,False,25.0,7,13,5,7,2,6,3,4,0,2,2,3,3,1,2,3,19
400946457,Georgia Tech Yellow Jackets,TEAM,TOTAL,TOTAL,False,,27,56,20,37,7,19,14,21,7,25,32,17,6,6,9,14,75
400946444,Wake Forest Demon Deacons,J. Collins,3908845,,True,36.0,9,13,9,13,0,0,8,8,4,5,9,0,1,0,2,2,26
400946444,Wake Forest Demon Deacons,D. Mitoglou,3138224,,True,29.0,1,5,0,1,1,4,4,6,1,1,2,0,1,0,0,4,7
400946444,Wake Forest Demon Deacons,A. Arians,61378,,True,19.0,5,7,1,2,4,5,3,3,0,0,0,0,0,0,1,3,17
400946444,Wake Forest Demon Deacons,B. Crawford,3908844,,True,36.0,5,11,4,6,1,5,9,9,1,3,4,10,3,1,4,3,20
400946444,Wake Forest Demon Deacons,K. Woods,3132360,,True,34.0,2,8,2,3,0,5,0,0,0,1,1,3,0,0,2,5,4
400946444,Wake Forest Demon Deacons,G. McClinton,66140,,False,4.0,0,0,0,0,0,0,0,0,0,0,0,0,0,0,0,2,0
400946444,Wake Forest Demon Deacons,S. Japhet-Mathias,4065752,,False,2.0,0,0,0,0,0,0,0,0,0,0,0,0,0,0,0,2,0
400946444,Wake Forest Demon Deacons,B. Childress,4065750,,False,16.0,1,5,0,1,1,4,4,4,0,1,1,1,1,0,2,2,7
400946444,Wake Forest Demon Deacons,M. Wilbekin,3138222,,False,23.0,2,4,0,0,2,4,1,2,0,1,1,0,2,0,0,1,7
400946444,Wake Forest Demon Deacons,T. VanHorn,3078214,,False,1.0,0,0,0,0,0,0,0,0,0,1,1,0,0,0,0,1,0
400946444,Wake Forest Demon Deacons,TEAM,TOTAL,TOTAL,False,,25,53,16,26,9,27,29,32,7,14,21,14,8,1,11,25,88
400946444,Kansas State Wildcats,D. Wade,3912848,,True,23.0,3,4,3,3,0,1,2,3,0,2,2,2,0,0,2,2,8
400946444,Kansas State Wildcats,W. Iwundu,67249,,True,35.0,6,9,5,7,1,2,11,13,1,5,6,7,1,0,2,3,24
400946444,Kansas State Wildcats,D.J. Johnson,62710,,True,34.0,8,9,8,9,0,0,2,2,3,3,6,0,0,3,0,4,18
400946444,Kansas State Wildcats,K. Stokes,3912847,,True,30.0,5,9,0,1,5,8,7,8,0,2,2,3,1,0,5,3,22
400946444,Kansas State Wildcats,B. Brown Jr.,3912841,,True,38.0,6,10,6,8,0,2,2,4,0,5,5,3,0,0,0,3,14
400946444,Kansas State Wildcats,X. Sneed,4066303,,False,12.0,0,2,0,0,0,2,2,4,0,2,2,2,4,0,2,3,2
400946444,Kansas State Wildcats,I. Maurice,3912845,,False,6.0,0,0,0,0,0,0,0,0,0,1,1,0,0,0,1,3,0
400946444,Kansas State Wildcats,B. Patrick,4066302,,False,5.0,0,1,0,0,0,1,0,0,0,0,0,0,0,0,0,1,0
400946444,Kansas State Wildcats,C. Ervin II,3912843,,False,17.0,3,3,3,3,0,0,1,2,2,2,4,1,0,0,3,4,7
400946444,Kansas State Wildcats,TEAM,TOTAL,TOTAL,False,,31,47,25,31,6,16,27,36,7,22,29,18,6,3,15,26,95
400946442,Florida State Seminoles,J. Isaac,4065654,,True,34.0,5,8,4,5,1,3,6,9,0,10,10,5,2,3,2,2,17
400946442,Florida State Seminoles,M. Ojo,61596,,True,11.0,3,4,3,4,0,0,0,0,1,1,2,0,1,2,2,4,6
400946442,Florida State Seminoles,T. Mann,3907823,,True,26.0,3,5,3,5,0,0,5,7,1,4,5,0,0,0,1,4,11
400946442,Florida State Seminoles,D. Bacon,3907821,,True,34.0,11,17,11,14,0,3,3,4,0,9,9,2,2,0,3,0,25
400946442,Florida State Seminoles,X. Rathan-Mayes,66125,,True,33.0,2,7,1,3,1,4,5,10,2,3,5,5,1,0,3,1,10
400946442,Florida State Seminoles,P. Cofer,3135054,,False,7.0,1,1,1,1,0,0,0,0,0,2,2,0,0,0,1,1,2
400946442,Florida State Seminoles,J. Smith,66126,,False,6.0,0,1,0,1,0,0,0,0,0,0,0,0,0,0,0,3,0
400946442,Florida State Seminoles,C. Koumadje,3907824,,False,21.0,3,4,3,4,0,0,1,2,1,2,3,0,2,4,1,1,7
400946442,Florida State Seminoles,B. Angola-Rodas,4065658,,False,11.0,0,2,0,1,0,1,2,3,0,3,3,3,0,0,0,1,2
400946442,Florida State Seminoles,P. Savoy,4065657,,False,2.0,0,2,0,0,0,2,0,0,0,0,0,0,1,0,1,1,0
400946442,Florida State Seminoles,T. Forrest,4065656,,False,8.0,1,1,1,1,0,0,0,0,1,0,1,1,0,0,2,0,2
400946442,Florida State Seminoles,C. Walker,4065655,,False,7.0,1,2,1,2,0,0,2,4,0,0,0,0,0,0,0,1,4
400946442,Florida State Seminoles,TEAM,TOTAL,TOTAL,False,,30,54,28,41,2,13,24,39,9,37,46,16,9,9,16,19,86
400946442,Florida Gulf Coast Eagles,D. Morant,61905,,True,18.0,2,3,2,3,0,0,1,3,0,5,5,0,0,0,0,0,5
400946442,Florida Gulf Coast Eagles,M. Norelia,61345,,True,32.0,3,8,3,8,0,0,3,5,1,5,6,3,0,0,1,2,9
400946442,Florida Gulf Coast Eagles,C. Terrell,3130510,,True,29.0,3,8,1,2,2,6,1,2,0,0,0,3,1,0,2,3,9
400946442,Florida Gulf Coast Eagles,Z. Johnson,3130509,,True,33.0,5,16,2,7,3,9,4,5,2,2,4,5,2,0,2,3,17
400946442,Florida Gulf Coast Eagles,B. Goodwin,67628,,True,38.0,12,27,10,17,2,10,2,2,0,1,1,7,1,0,5,4,28
400946442,Florida Gulf Coast Eagles,K. Mickle,66936,,False,15.0,1,1,1,1,0,0,0,0,1,3,4,0,1,0,0,4,2
400946442,Florida Gulf Coast Eagles,A. Simmons,66651,,False,15.0,1,1,1,1,0,0,0,0,0,1,1,0,0,0,0,3,2
400946442,Florida Gulf Coast Eagles,R. Tucker,3908819,,False,17.0,2,5,1,3,1,2,3,3,0,0,0,0,1,1,0,1,8
400946442,Florida Gulf Coast Eagles,R. Reid,3908818,,False,3.0,0,1,0,0,0,1,0,0,0,0,0,0,0,0,0,3,0
400946442,Florida Gulf Coast Eagles,TEAM,TOTAL,TOTAL,False,,29,70,21,42,8,28,14,20,7,19,26,18,6,1,11,23,80
400946440,Princeton Tigers,S. Weisz,66880,,True,40.0,6,11,3,4,3,7,0,0,1,4,5,4,1,2,0,3,15
400946440,Princeton Tigers,P. Miller,66877,,True,11.0,2,3,2,3,0,0,0,0,2,1,3,0,0,0,0,2,4
400946440,Princeton Tigers,S. Cook,66876,,True,34.0,4,11,1,5,3,6,0,0,2,5,7,0,1,0,3,1,11
400946440,Princeton Tigers,M. Stephens,3906978,,True,36.0,3,11,3,8,0,3,4,4,0,5,5,2,0,2,3,1,10
400946440,Princeton Tigers,D. Cannady,3906977,,True,30.0,2,11,0,1,2,10,1,1,2,1,3,3,0,0,1,1,7
400946440,Princeton Tigers,W. Gladson,4066846,,False,14.0,2,4,2,2,0,2,0,0,0,2,2,1,0,0,0,1,4
400946440,Princeton Tigers,A. Brennan,3138258,,False,1.0,0,0,0,0,0,0,0,0,0,0,0,0,0,0,0,2,0
400946440,Princeton Tigers,A. Young,3138261,,False,1.0,0,0,0,0,0,0,0,0,0,0,0,0,0,0,0,0,0
400946440,Princeton Tigers,A. Bell,3138257,,False,33.0,3,6,3,3,0,3,1,1,0,7,7,3,0,0,1,3,7
400946440,Princeton Tigers,TEAM,TOTAL,TOTAL,False,,22,57,14,26,8,31,6,6,7,26,33,13,2,4,9,14,58
400946440,Notre Dame Fighting Irish,B. Colson,3138192,,True,31.0,6,13,6,12,0,1,6,10,2,5,7,2,1,2,0,2,18
400946440,Notre Dame Fighting Irish,V.J. Beachem,66283,,True,37.0,1,9,1,6,0,3,0,0,0,6,6,3,1,0,0,1,2
400946440,Notre Dame Fighting Irish,R. Pflueger,3908335,,True,28.0,2,3,2,3,0,0,0,0,0,2,2,0,0,0,1,2,4
400946440,Notre Dame Fighting Irish,M. Farrell,3138190,,True,36.0,6,9,3,4,3,5,1,3,0,4,4,4,2,0,3,2,16
400946440,Notre Dame Fighting Irish,S. Vasturia,66285,,True,37.0,3,12,2,10,1,2,3,4,3,5,8,1,0,0,0,0,10
400946440,Notre Dame Fighting Irish,M. Geben,3138191,,False,2.0,1,1,1,1,0,0,0,0,1,0,1,0,0,0,1,1,2
400946440,Notre Dame Fighting Irish,A. Torres,66286,,False,7.0,0,1,0,1,0,0,0,0,1,0,1,0,0,1,1,0,0
400946440,Notre Dame Fighting Irish,M. Ryan,3908336,,False,9.0,2,3,2,3,0,0,2,2,0,2,2,0,0,0,0,0,6
400946440,Notre Dame Fighting Irish,T. Gibbs,4065703,,False,13.0,0,1,0,1,0,0,2,2,0,2,2,0,0,0,0,1,2
400946440,Notre Dame Fighting Irish,TEAM,TOTAL,TOTAL,False,,21,52,17,41,4,11,14,21,9,27,36,10,4,3,6,9,60
400946431,Michigan State Spartans,N. Ward,4066384,,True,26.0,8,9,8,9,0,0,3,3,3,4,7,0,0,1,1,2,19
400946431,Michigan State Spartans,M. Bridges,4066383,,True,35.0,8,12,6,8,2,4,0,0,2,7,9,3,0,1,1,2,18
400946431,Michigan State Spartans,J. Langford,4066381,,True,24.0,5,10,3,6,2,4,1,2,1,1,2,1,0,0,0,2,13
400946431,Michigan State Spartans,L. Nairn Jr.,3147690,,True,18.0,0,2,0,1,0,1,0,0,0,1,1,5,0,0,2,3,0
400946431,Michigan State Spartans,A. Ellis III,67026,,True,30.0,3,9,3,4,0,5,1,1,1,6,7,1,0,0,3,1,7
400946431,Michigan State Spartans,M. Van Dyk,3157466,,False,1.0,0,0,0,0,0,0,1,2,0,0,0,0,0,1,0,0,1
400946431,Michigan State Spartans,K. Goins,3147689,,False,12.0,2,2,2,2,0,0,2,2,1,1,2,0,0,0,2,2,6
400946431,Michigan State Spartans,C. Winston,4066382,,False,22.0,2,5,1,2,1,3,2,2,0,1,1,5,1,0,0,4,7
400946431,Michigan State Spartans,G. Roy,3960228,,False,1.0,0,0,0,0,0,0,0,0,0,0,0,0,0,0,0,1,0
400946431,Michigan State Spartans,M. McQuaid,3937103,,False,25.0,2,4,1,1,1,3,2,2,1,4,5,3,0,0,3,1,7
400946431,Michigan State Spartans,C. George,3937102,,False,1.0,0,0,0,0,0,0,0,0,0,0,0,0,0,0,0,0,0
400946431,Michigan State Spartans,K. Ahrens,3937100,,False,5.0,0,0,0,0,0,0,0,0,0,0,0,0,0,0,0,0,0
400946431,Michigan State Spartans,TEAM,TOTAL,TOTAL,False,,30,53,24,33,6,20,12,14,10,26,36,18,1,3,12,18,78
400946431,Miami Hurricanes,K. Murphy,61668,,True,26.0,0,6,0,6,0,0,1,2,1,1,2,1,0,1,2,1,1
400946431,Miami Hurricanes,A. Lawrence II,3904628,,True,22.0,1,5,0,0,1,5,0,0,1,2,3,0,0,0,1,3,3
400946431,Miami Hurricanes,B. Brown,4065670,,True,34.0,3,6,2,3,1,3,4,6,0,2,2,4,3,0,1,3,11
400946431,Miami Hurricanes,J. Newton,3138145,,True,34.0,5,12,5,11,0,1,6,7,0,2,2,2,3,0,1,2,16
400946431,Miami Hurricanes,D. Reed,66130,,True,37.0,5,10,3,4,2,6,0,0,1,2,3,0,2,0,1,0,12
400946431,Miami Hurricanes,D. Hernandez,4065672,,False,9.0,4,5,4,5,0,0,0,0,0,0,0,0,0,0,1,3,8
400946431,Miami Hurricanes,C. Stowell,3138149,,False,1.0,0,0,0,0,0,0,0,0,0,0,0,0,0,0,0,0,0
400946431,Miami Hurricanes,R. Miller Jr.,4065671,,False,1.0,0,0,0,0,0,0,0,0,0,1,1,0,0,0,0,0,0
400946431,Miami Hurricanes,E. Izundu,3904629,,False,18.0,2,5,2,5,0,0,1,2,2,1,3,0,0,0,0,4,5
400946431,Miami Hurricanes,D. Vasiljevic,4065669,,False,16.0,1,3,1,2,0,1,0,0,0,2,2,1,1,0,1,1,2
400946431,Miami Hurricanes,M. Robinson,3947140,,False,2.0,0,0,0,0,0,0,0,0,0,0,0,0,0,0,0,0,0
400946431,Miami Hurricanes,TEAM,TOTAL,TOTAL,False,,21,52,17,36,4,16,12,17,9,14,23,8,9,1,10,17,58
400946428,Virginia Cavaliers,J. Salt,3138200,,True,16.0,1,1,1,1,0,0,1,2,1,1,2,0,0,1,0,3,3
400946428,Virginia Cavaliers,K. Guy,4065730,,True,25.0,2,4,1,2,1,2,0,0,0,3,3,1,0,0,1,3,5
400946428,Virginia Cavaliers,D. Thompson,66274,,True,34.0,2,6,2,5,0,1,6,12,0,4,4,1,1,4,0,1,10
400946428,Virginia Cavaliers,L. Perrantes,66139,,True,33.0,9,14,7,10,2,4,4,5,1,1,2,3,1,0,1,2,24
400946428,Virginia Cavaliers,D. Hall,66138,,True,30.0,2,7,2,5,0,2,2,2,2,5,7,3,1,0,2,4,6
400946428,Virginia Cavaliers,M. Diakite,3947156,,False,5.0,0,1,0,0,0,1,0,0,0,2,2,0,0,0,2,0,0
400946428,Virginia Cavaliers,I. Wilkins,3138203,,False,5.0,0,0,0,0,0,0,0,0,0,1,1,0,0,0,0,1,0
400946428,Virginia Cavaliers,T. Jerome,4065733,,False,22.0,2,5,1,3,1,2,0,0,0,2,2,0,0,0,1,4,5
400946428,Virginia Cavaliers,M. Shayok,3138201,,False,30.0,8,14,5,9,3,5,4,4,0,3,3,1,2,0,1,1,23
400946428,Virginia Cavaliers,TEAM,TOTAL,TOTAL,False,,26,52,19,35,7,17,17,25,6,27,33,9,5,5,8,19,76
400946428,UNC Wilmington Seahawks,D. Cacok,3946974,,True,33.0,5,6,5,6,0,0,2,2,6,9,15,1,0,1,3,3,12
400946428,UNC Wilmington Seahawks,C.J. Bryce,3946973,,True,37.0,2,11,2,9,0,2,4,7,1,2,3,1,0,0,0,2,8
400946428,UNC Wilmington Seahawks,C. Flemmings,3129963,,True,38.0,7,16,5,7,2,9,2,3,3,6,9,4,1,1,3,3,18
400946428,UNC Wilmington Seahawks,A. Mosley,62784,,True,35.0,5,5,1,1,4,4,0,0,1,4,5,1,1,0,0,3,14
400946428,UNC Wilmington Seahawks,D. Ingram,61575,,True,36.0,6,15,2,6,4,9,1,2,0,2,2,3,1,0,1,2,17
400946428,UNC Wilmington Seahawks,M. Bryan,66732,,False,3.0,0,1,0,1,0,0,0,1,2,1,3,0,0,0,0,1,0
400946428,UNC Wilmington Seahawks,C. Ogbodo,67175,,False,2.0,0,0,0,0,0,0,0,0,0,0,0,0,0,0,1,0,0
400946428,UNC Wilmington Seahawks,J. Fornes,4067294,,False,0.0,0,0,0,0,0,0,0,0,0,0,0,0,0,0,0,1,0
400946428,UNC Wilmington Seahawks,J. Talley,3129962,,False,16.0,0,7,0,5,0,2,2,2,0,2,2,5,1,0,1,5,2
400946428,UNC Wilmington Seahawks,TEAM,TOTAL,TOTAL,False,,25,61,15,35,10,26,11,17,14,26,40,15,4,2,9,20,71
400946427,Wisconsin Badgers,E. Happ,3136996,,True,27.0,5,8,5,8,0,0,0,2,3,5,8,2,1,3,2,4,10
400946427,Wisconsin Badgers,V. Brown,66201,,True,17.0,2,6,1,3,1,3,0,0,1,1,2,0,0,0,2,2,5
400946427,Wisconsin Badgers,N. Hayes,66198,,True,36.0,4,10,4,9,0,1,8,9,6,4,10,3,0,0,2,3,16
400946427,Wisconsin Badgers,B. Koenig,66200,,True,37.0,9,21,1,4,8,17,2,2,0,3,3,3,0,0,1,2,28
400946427,Wisconsin Badgers,Z. Showalter,61279,,True,27.0,2,2,0,0,2,2,0,0,0,0,0,4,2,0,0,5,6
400946427,Wisconsin Badgers,A. Illikainen,3908323,,False,1.0,0,1,0,1,0,0,0,0,0,0,0,0,0,0,0,0,0
400946427,Wisconsin Badgers,A. Moesch,66197,,False,0.0,0,0,0,0,0,0,0,0,0,0,0,0,0,0,0,0,0
400946427,Wisconsin Badgers,D. Trice,4066413,,False,24.0,2,7,0,0,2,7,0,0,0,3,3,3,0,0,0,1,6
400946427,Wisconsin Badgers,K. Iverson,3908322,,False,21.0,2,4,2,4,0,0,7,10,4,3,7,3,0,0,1,2,11
400946427,Wisconsin Badgers,J. Hill,66199,,False,10.0,0,1,0,0,0,1,2,2,0,0,0,1,1,0,0,3,2
400946427,Wisconsin Badgers,TEAM,TOTAL,TOTAL,False,,26,60,13,29,13,31,19,25,17,20,37,19,4,3,8,22,84
400946427,Virginia Tech Hokies,K. Sy,4065740,,True,10.0,1,2,1,2,0,0,0,0,0,1,1,0,0,0,0,1,2
400946427,Virginia Tech Hokies,J. Robinson,3945566,,True,37.0,1,7,1,5,0,2,9,10,0,3,3,6,0,0,3,0,11
400946427,Virginia Tech Hokies,A. Hill,3147501,,True,22.0,2,6,2,5,0,1,0,0,0,3,3,1,0,0,2,2,4
400946427,Virginia Tech Hokies,J. Bibbs,3147500,,True,37.0,2,3,0,1,2,2,2,2,0,2,2,1,1,0,1,3,8
400946427,Virginia Tech Hokies,T. Outlaw,67275,,True,40.0,6,11,2,4,4,7,0,0,1,6,7,0,0,0,0,4,16
400946427,Virginia Tech Hokies,Z. LeDay,61698,,False,29.0,8,10,8,10,0,0,7,10,2,2,4,0,0,2,2,5,23
400946427,Virginia Tech Hokies,S. Allen,61795,,False,25.0,3,10,2,5,1,5,3,4,1,1,2,6,2,0,0,3,10
400946427,Virginia Tech Hokies,TEAM,TOTAL,TOTAL,False,,23,49,16,32,7,17,21,26,6,19,25,14,3,2,10,18,74
400946425,Texas Southern Tigers,K. Scott,4070740,,True,33.0,6,14,2,6,4,8,3,4,1,4,5,3,1,0,1,3,19
400946425,Texas Southern Tigers,M. Jones,3136940,,True,25.0,3,5,3,5,0,0,0,0,1,4,5,0,1,2,2,3,6
400946425,Texas Southern Tigers,D. Jefferson,4070739,,True,34.0,6,15,5,8,1,7,0,0,0,0,0,2,1,0,4,2,13
400946425,Texas Southern Tigers,J. McCloud,4070738,,True,8.0,0,3,0,0,0,3,0,0,0,0,0,1,0,0,0,3,0
400946425,Texas Southern Tigers,Z. Lofton,66430,,True,31.0,2,11,2,8,0,3,5,6,1,3,4,2,1,0,1,1,9
400946425,Texas Southern Tigers,L. Walker,4070741,,False,19.0,2,6,2,4,0,2,2,2,2,4,6,0,1,0,1,2,6
400946425,Texas Southern Tigers,S. Bennett,3133975,,False,25.0,0,1,0,1,0,0,0,0,1,2,3,0,1,1,0,2,0
400946425,Texas Southern Tigers,E. Washington,3077465,,False,3.0,0,0,0,0,0,0,1,2,0,0,0,0,0,0,0,0,1
400946425,Texas Southern Tigers,D. Robinson,3135131,,False,18.0,2,4,1,1,1,3,2,2,0,1,1,1,0,0,2,1,7
400946425,Texas Southern Tigers,T. Bynum,67611,,False,4.0,1,1,0,0,1,1,0,0,0,0,0,0,0,0,2,0,3
400946425,Texas Southern Tigers,TEAM,TOTAL,TOTAL,False,,22,60,15,33,7,27,13,16,6,21,27,9,6,3,13,17,64
400946425,North Carolina Tar Heels,J. Jackson,3138156,,True,24.0,8,13,3,5,5,8,0,0,2,5,7,3,0,0,1,1,21
400946425,North Carolina Tar Heels,T. Pinson,3138154,,True,22.0,1,2,1,1,0,1,1,2,1,4,5,0,1,0,2,1,3
400946425,North Carolina Tar Heels,I. Hicks,66874,,True,17.0,8,12,8,12,0,0,1,3,2,4,6,0,0,1,2,2,17
400946425,North Carolina Tar Heels,K. Meeks,66873,,True,17.0,3,4,3,4,0,0,7,10,2,4,6,0,1,2,0,0,13
400946425,North Carolina Tar Heels,J. Berry II,3138155,,True,22.0,1,8,0,2,1,6,0,0,0,1,1,3,0,0,0,0,3
400946425,North Carolina Tar Heels,A. Rohlman,4065677,,False,4.0,0,1,0,1,0,0,0,0,0,1,1,0,1,0,1,0,0
400946425,North Carolina Tar Heels,S. Rush,4065674,,False,4.0,0,0,0,0,0,0,0,0,0,0,0,0,0,0,0,1,0
400946425,North Carolina Tar Heels,T. Bradley,4065673,,False,19.0,6,8,6,8,0,0,0,0,5,1,6,1,0,0,0,1,12
400946425,North Carolina Tar Heels,L. Maye,3911620,,False,19.0,4,11,4,9,0,2,2,3,4,5,9,1,0,1,2,1,10
400946425,North Carolina Tar Heels,S. Woods,4065676,,False,15.0,0,2,0,1,0,1,2,2,0,1,1,2,1,0,1,1,2
400946425,North Carolina Tar Heels,B. Robinson,4065675,,False,7.0,1,1,1,1,0,0,0,0,0,1,1,2,0,0,1,2,2
400946425,North Carolina Tar Heels,K. Coker,3947144,,False,3.0,1,1,1,1,0,0,2,2,1,0,1,0,0,0,0,1,4
400946425,North Carolina Tar Heels,N. Britt,66872,,False,18.0,3,6,1,2,2,4,2,2,0,3,3,5,0,0,0,2,10
400946425,North Carolina Tar Heels,S. White,56963,,False,9.0,2,6,2,6,0,0,2,2,2,1,3,1,2,0,0,0,6
400946425,North Carolina Tar Heels,TEAM,TOTAL,TOTAL,False,,38,75,30,53,8,22,19,26,20,34,54,18,6,4,10,13,103
400946423,Louisville Cardinals,D. Adel,3908807,,True,28.0,6,7,4,5,2,2,2,2,0,1,1,1,0,0,1,3,16
400946423,Louisville Cardinals,J. Johnson,3147362,,True,13.0,3,8,3,8,0,0,0,0,3,1,4,0,1,0,0,1,6
400946423,Louisville Cardinals,M. Mathiang,63035,,True,30.0,8,13,8,13,0,0,2,2,2,3,5,1,1,2,1,2,18
400946423,Louisville Cardinals,D. Mitchell,3908809,,True,39.0,3,15,3,9,0,6,3,3,4,6,10,5,3,1,1,3,9
400946423,Louisville Cardinals,Q. Snider,3147360,,True,37.0,6,14,3,7,3,7,1,2,0,4,4,5,1,0,2,1,16
400946423,Louisville Cardinals,V.J. King,4065666,,False,13.0,1,2,1,2,0,0,0,0,0,1,1,1,0,0,0,0,2
400946423,Louisville Cardinals,R. Spalding,3908806,,False,26.0,4,4,4,4,0,0,3,3,2,2,4,1,1,0,0,1,11
400946423,Louisville Cardinals,A. Mahmoud,3147363,,False,10.0,0,1,0,1,0,0,0,2,2,2,4,0,0,2,0,1,0
400946423,Louisville Cardinals,D. Levitch,66592,,False,1.0,0,0,0,0,0,0,0,0,0,0,0,0,0,0,0,0,0
400946423,Louisville Cardinals,T. Hicks,62752,,False,3.0,0,0,0,0,0,0,0,0,0,0,0,0,0,0,0,0,0
400946423,Louisville Cardinals,TEAM,TOTAL,TOTAL,False,,31,64,26,49,5,15,11,14,16,20,36,14,7,5,6,12,78
400946423,Jacksonville State Gamecocks,N. Giga,4073470,,True,38.0,11,13,6,8,5,5,3,4,1,8,9,1,0,0,5,2,30
400946423,Jacksonville State Gamecocks,C. Cunningham,3936311,,True,31.0,2,4,2,4,0,0,0,0,0,3,3,1,0,5,0,2,4
400946423,Jacksonville State Gamecocks,E. Durham,3936312,,True,36.0,1,2,1,2,0,0,0,0,1,1,2,2,0,0,0,1,2
400946423,Jacksonville State Gamecocks,M. Drumwright,3149048,,True,34.0,4,12,2,4,2,8,2,2,0,2,2,6,1,1,2,3,12
400946423,Jacksonville State Gamecocks,G. Tucker,62002,,True,33.0,3,10,0,4,3,6,2,2,0,0,0,0,0,0,3,3,11
400946423,Jacksonville State Gamecocks,J. Cross,4067175,,False,10.0,0,1,0,1,0,0,0,0,0,0,0,0,0,2,1,3,0
400946423,Jacksonville State Gamecocks,A. Statam,3936314,,False,1.0,0,0,0,0,0,0,0,0,0,1,1,0,0,0,0,0,0
400946423,Jacksonville State Gamecocks,A. Spears,4067176,,False,2.0,0,0,0,0,0,0,0,0,0,0,0,0,0,0,0,0,0
400946423,Jacksonville State Gamecocks,T. Edwards,4067173,,False,15.0,2,5,2,5,0,0,0,0,0,2,2,4,0,0,1,0,4
400946423,Jacksonville State Gamecocks,TEAM,TOTAL,TOTAL,False,,23,46,13,27,10,19,7,8,4,19,23,14,1,8,14,14,63
400946419,Troy Trojans,J. Davis Jr.,4067813,,True,11.0,0,2,0,0,0,2,0,0,0,1,1,0,0,0,1,3,0
400946419,Troy Trojans,J. Varnado,3906609,,True,36.0,7,12,6,7,1,5,3,3,4,6,10,4,0,1,7,0,18
400946419,Troy Trojans,D. Walker,61590,,True,27.0,2,6,2,6,0,0,2,2,2,5,7,0,0,0,1,3,6
400946419,Troy Trojans,K. Baker,4067812,,True,28.0,2,9,1,2,1,7,0,0,0,1,1,0,1,0,0,1,5
400946419,Troy Trojans,W. Person,3143755,,True,39.0,5,10,3,5,2,5,3,3,0,3,3,1,0,0,6,1,15
400946419,Troy Trojans,W. Moreman,4067816,,False,1.0,0,0,0,0,0,0,1,2,0,0,0,0,0,0,0,0,1
400946419,Troy Trojans,A. Hicks,3949221,,False,20.0,6,9,6,9,0,0,2,2,3,3,6,0,0,1,1,3,14
400946419,Troy Trojans,A. Ariri,3143749,,False,1.0,0,0,0,0,0,0,0,0,0,0,0,0,0,0,0,0,0
400946419,Troy Trojans,J. Moravek,67495,,False,1.0,0,0,0,0,0,0,1,2,0,0,0,0,0,0,0,0,1
400946419,Troy Trojans,S. Hopkins,3949220,,False,2.0,0,0,0,0,0,0,0,0,0,0,0,0,0,0,0,0,0
400946419,Troy Trojans,B.J. Miller,3906608,,False,3.0,0,0,0,0,0,0,0,0,0,0,0,0,0,0,1,0,0
400946419,Troy Trojans,D. Peace,3906607,,False,8.0,0,2,0,2,0,0,0,0,1,0,1,3,0,0,0,5,0
400946419,Troy Trojans,J. Hollimon,3143753,,False,23.0,2,9,1,5,1,4,0,0,1,2,3,2,0,0,0,3,5
400946419,Troy Trojans,TEAM,TOTAL,TOTAL,False,,24,59,19,36,5,23,12,14,13,24,37,10,1,2,17,19,65
400946419,Duke Blue Devils,J. Tatum,4065648,,True,35.0,5,13,4,10,1,3,7,10,3,9,12,1,4,4,1,4,18
400946419,Duke Blue Devils,A. Jefferson,61586,,True,29.0,3,7,3,7,0,0,2,2,3,3,6,1,2,3,2,3,8
400946419,Duke Blue Devils,F. Jackson,4065651,,True,33.0,5,10,3,4,2,6,2,4,0,1,1,3,2,0,1,2,14
400946419,Duke Blue Devils,L. Kennard,3913174,,True,29.0,3,12,1,7,2,5,0,0,3,0,3,2,0,0,1,2,8
400946419,Duke Blue Devils,M. Jones,66563,,True,32.0,5,7,2,2,3,5,1,1,0,2,2,3,3,0,1,1,14
400946419,Duke Blue Devils,J. White,4065653,,False,2.0,0,0,0,0,0,0,0,0,0,0,0,0,0,0,0,1,0
400946419,Duke Blue Devils,J. DeLaurier,4065650,,False,2.0,1,1,1,1,0,0,0,0,0,0,0,0,1,0,0,0,2
400946419,Duke Blue Devils,H. Giles III,4065649,,False,6.0,0,1,0,1,0,0,0,0,1,0,1,1,0,1,2,3,0
400946419,Duke Blue Devils,J. Robinson,3913178,,False,0.0,0,0,0,0,0,0,0,0,0,0,0,0,0,0,0,0,0
400946419,Duke Blue Devils,A. Vrankovic,3913177,,False,4.0,1,1,1,1,0,0,0,0,2,1,3,0,0,0,0,1,2
400946419,Duke Blue Devils,G. Allen,3135045,,False,28.0,6,10,1,1,5,9,4,6,1,4,5,4,1,0,0,0,21
400946419,Duke Blue Devils,TEAM,TOTAL,TOTAL,False,,29,62,16,34,13,28,16,23,14,22,36,15,13,8,8,17,87
400946221,Notre Dame Fighting Irish,B. Colson,3138192,,True,38.0,12,21,10,18,2,3,3,5,5,4,9,0,3,0,1,2,29
400946221,Notre Dame Fighting Irish,V.J. Beachem,66283,,True,35.0,6,14,5,8,1,6,2,2,2,1,3,1,2,0,1,3,15
400946221,Notre Dame Fighting Irish,R. Pflueger,3908335,,True,27.0,2,6,1,4,1,2,0,0,2,3,5,0,0,0,0,1,5
400946221,Notre Dame Fighting Irish,M. Farrell,3138190,,True,39.0,5,12,4,6,1,6,2,3,1,2,3,7,0,0,2,2,13
400946221,Notre Dame Fighting Irish,S. Vasturia,66285,,True,38.0,2,9,1,4,1,5,0,0,0,2,2,4,1,0,2,2,5
400946221,Notre Dame Fighting Irish,M. Geben,3138191,,False,4.0,0,0,0,0,0,0,0,0,1,1,2,0,0,0,0,1,0
400946221,Notre Dame Fighting Irish,A. Torres,66286,,False,2.0,0,1,0,1,0,0,0,0,1,2,3,0,0,0,0,1,0
400946221,Notre Dame Fighting Irish,M. Ryan,3908336,,False,14.0,0,4,0,1,0,3,2,2,0,0,0,0,1,0,0,1,2
400946221,Notre Dame Fighting Irish,T. Gibbs,4065703,,False,3.0,0,0,0,0,0,0,0,0,0,0,0,0,0,0,0,1,0
400946221,Notre Dame Fighting Irish,TEAM,TOTAL,TOTAL,False,,27,67,21,42,6,25,9,12,16,17,33,12,7,0,6,14,69
400946221,Notre Dame Fighting Irish,B. Colson,3138192,,True,38.0,12,21,10,18,2,3,3,5,5,4,9,0,3,0,1,2,29
400946221,Notre Dame Fighting Irish,V.J. Beachem,66283,,True,35.0,6,14,5,8,1,6,2,2,2,1,3,1,2,0,1,3,15
400946221,Notre Dame Fighting Irish,R. Pflueger,3908335,,True,27.0,2,6,1,4,1,2,0,0,2,3,5,0,0,0,0,1,5
400946221,Notre Dame Fighting Irish,M. Farrell,3138190,,True,39.0,5,12,4,6,1,6,2,3,1,2,3,7,0,0,2,2,13
400946221,Notre Dame Fighting Irish,S. Vasturia,66285,,True,38.0,2,9,1,4,1,5,0,0,0,2,2,4,1,0,2,2,5
400946221,Notre Dame Fighting Irish,M. Geben,3138191,,False,4.0,0,0,0,0,0,0,0,0,1,1,2,0,0,0,0,1,0
400946221,Notre Dame Fighting Irish,A. Torres,66286,,False,2.0,0,1,0,1,0,0,0,0,1,2,3,0,0,0,0,1,0
400946221,Notre Dame Fighting Irish,M. Ryan,3908336,,False,14.0,0,4,0,1,0,3,2,2,0,0,0,0,1,0,0,1,2
400946221,Notre Dame Fighting Irish,T. Gibbs,4065703,,False,3.0,0,0,0,0,0,0,0,0,0,0,0,0,0,0,0,1,0
400946221,Notre Dame Fighting Irish,TEAM,TOTAL,TOTAL,False,,27,67,21,42,6,25,9,12,16,17,33,12,7,0,6,14,69
400946221,Duke Blue Devils,J. Tatum,4065648,,True,39.0,7,11,7,9,0,2,5,7,1,7,8,1,1,1,2,3,19
400946221,Duke Blue Devils,A. Jefferson,61586,,True,35.0,7,8,7,8,0,0,0,1,0,5,5,1,0,3,0,3,14
400946221,Duke Blue Devils,F. Jackson,4065651,,True,26.0,4,6,3,5,1,1,0,0,0,4,4,0,0,0,2,4,9
400946221,Duke Blue Devils,L. Kennard,3913174,,True,38.0,6,13,4,8,2,5,2,3,0,3,3,3,0,0,1,1,16
400946221,Duke Blue Devils,M. Jones,66563,,True,31.0,1,2,0,0,1,2,0,0,0,4,4,2,3,0,0,1,3
400946221,Duke Blue Devils,H. Giles III,4065649,,False,10.0,2,2,2,2,0,0,0,0,2,2,4,0,0,1,1,1,4
400946221,Duke Blue Devils,G. Allen,3135045,,False,21.0,4,9,3,4,1,5,1,1,1,0,1,4,1,0,6,1,10
400946221,Duke Blue Devils,TEAM,TOTAL,TOTAL,False,,31,51,26,36,5,15,8,12,5,25,30,11,5,5,12,14,75
400946221,Duke Blue Devils,J. Tatum,4065648,,True,39.0,7,11,7,9,0,2,5,7,1,7,8,1,1,1,2,3,19
400946221,Duke Blue Devils,A. Jefferson,61586,,True,35.0,7,8,7,8,0,0,0,1,0,5,5,1,0,3,0,3,14
400946221,Duke Blue Devils,F. Jackson,4065651,,True,26.0,4,6,3,5,1,1,0,0,0,4,4,0,0,0,2,4,9
400946221,Duke Blue Devils,L. Kennard,3913174,,True,38.0,6,13,4,8,2,5,2,3,0,3,3,3,0,0,1,1,16
400946221,Duke Blue Devils,M. Jones,66563,,True,31.0,1,2,0,0,1,2,0,0,0,4,4,2,3,0,0,1,3
400946221,Duke Blue Devils,H. Giles III,4065649,,False,10.0,2,2,2,2,0,0,0,0,2,2,4,0,0,1,1,1,4
400946221,Duke Blue Devils,G. Allen,3135045,,False,21.0,4,9,3,4,1,5,1,1,1,0,1,4,1,0,6,1,10
400946221,Duke Blue Devils,TEAM,TOTAL,TOTAL,False,,31,51,26,36,5,15,8,12,5,25,30,11,5,5,12,14,75
400946183,Notre Dame Fighting Irish,B. Colson,3138192,,True,37.0,7,13,7,13,0,0,4,6,2,4,6,2,1,1,1,2,18
400946183,Notre Dame Fighting Irish,V.J. Beachem,66283,,True,33.0,2,9,1,3,1,6,1,1,0,7,7,1,2,1,1,1,6
400946183,Notre Dame Fighting Irish,R. Pflueger,3908335,,True,29.0,2,3,0,0,2,3,2,3,0,5,5,2,1,0,0,2,8
400946183,Notre Dame Fighting Irish,M. Farrell,3138190,,True,36.0,6,15,3,7,3,8,0,1,0,0,0,6,1,0,2,2,15
400946183,Notre Dame Fighting Irish,S. Vasturia,66285,,True,34.0,7,13,3,8,4,5,0,0,1,1,2,2,3,1,3,4,18
400946183,Notre Dame Fighting Irish,M. Geben,3138191,,False,4.0,0,0,0,0,0,0,0,0,0,0,0,1,0,0,0,2,0
400946183,Notre Dame Fighting Irish,A. Torres,66286,,False,5.0,0,0,0,0,0,0,1,2,0,1,1,0,0,0,1,1,1
400946183,Notre Dame Fighting Irish,M. Ryan,3908336,,False,13.0,4,5,1,1,3,4,0,0,0,0,0,1,0,0,0,0,11
400946183,Notre Dame Fighting Irish,T. Gibbs,4065703,,False,9.0,0,1,0,0,0,1,0,0,0,0,0,2,0,1,0,0,0
400946183,Notre Dame Fighting Irish,TEAM,TOTAL,TOTAL,False,,28,59,15,32,13,27,8,13,3,20,23,17,8,4,9,14,77
400946183,Notre Dame Fighting Irish,B. Colson,3138192,,True,37.0,7,13,7,13,0,0,4,6,2,4,6,2,1,1,1,2,18
400946183,Notre Dame Fighting Irish,V.J. Beachem,66283,,True,33.0,2,9,1,3,1,6,1,1,0,7,7,1,2,1,1,1,6
400946183,Notre Dame Fighting Irish,R. Pflueger,3908335,,True,29.0,2,3,0,0,2,3,2,3,0,5,5,2,1,0,0,2,8
400946183,Notre Dame Fighting Irish,M. Farrell,3138190,,True,36.0,6,15,3,7,3,8,0,1,0,0,0,6,1,0,2,2,15
400946183,Notre Dame Fighting Irish,S. Vasturia,66285,,True,34.0,7,13,3,8,4,5,0,0,1,1,2,2,3,1,3,4,18
400946183,Notre Dame Fighting Irish,M. Geben,3138191,,False,4.0,0,0,0,0,0,0,0,0,0,0,0,1,0,0,0,2,0
400946183,Notre Dame Fighting Irish,A. Torres,66286,,False,5.0,0,0,0,0,0,0,1,2,0,1,1,0,0,0,1,1,1
400946183,Notre Dame Fighting Irish,M. Ryan,3908336,,False,13.0,4,5,1,1,3,4,0,0,0,0,0,1,0,0,0,0,11
400946183,Notre Dame Fighting Irish,T. Gibbs,4065703,,False,9.0,0,1,0,0,0,1,0,0,0,0,0,2,0,1,0,0,0
400946183,Notre Dame Fighting Irish,TEAM,TOTAL,TOTAL,False,,28,59,15,32,13,27,8,13,3,20,23,17,8,4,9,14,77
400946183,Florida State Seminoles,J. Isaac,4065654,,True,35.0,2,7,2,5,0,2,1,3,1,14,15,2,1,2,4,2,5
400946183,Florida State Seminoles,P. Cofer,3135054,,True,11.0,1,2,1,2,0,0,0,0,1,1,2,1,1,0,2,0,2
400946183,Florida State Seminoles,T. Mann,3907823,,True,25.0,3,5,3,4,0,1,1,1,1,0,1,0,0,0,3,1,7
400946183,Florida State Seminoles,D. Bacon,3907821,,True,30.0,9,14,9,12,0,2,0,0,2,7,9,0,0,0,4,1,18
400946183,Florida State Seminoles,X. Rathan-Mayes,66125,,True,32.0,5,12,4,9,1,3,2,3,0,3,3,5,1,0,1,3,13
400946183,Florida State Seminoles,J. Smith,66126,,False,8.0,2,2,2,2,0,0,1,2,1,1,2,0,0,0,0,2,5
400946183,Florida State Seminoles,C. Koumadje,3907824,,False,14.0,0,3,0,3,0,0,1,2,1,1,2,0,0,0,1,3,1
400946183,Florida State Seminoles,M. Ojo,61596,,False,2.0,0,0,0,0,0,0,0,0,1,1,2,0,0,0,1,1,0
400946183,Florida State Seminoles,B. Angola-Rodas,4065658,,False,24.0,5,8,1,1,4,7,3,4,0,1,1,2,0,0,0,4,17
400946183,Florida State Seminoles,P. Savoy,4065657,,False,0.0,0,0,0,0,0,0,0,0,0,0,0,0,0,0,0,0,0
400946183,Florida State Seminoles,T. Forrest,4065656,,False,11.0,1,3,1,3,0,0,1,1,1,1,2,0,1,0,1,0,3
400946183,Florida State Seminoles,C. Walker,4065655,,False,8.0,1,1,1,1,0,0,0,0,0,0,0,0,0,0,1,0,2
400946183,Florida State Seminoles,TEAM,TOTAL,TOTAL,False,,29,57,24,42,5,15,10,16,9,32,41,10,4,2,18,17,73
400946183,Florida State Seminoles,J. Isaac,4065654,,True,35.0,2,7,2,5,0,2,1,3,1,14,15,2,1,2,4,2,5
400946183,Florida State Seminoles,P. Cofer,3135054,,True,11.0,1,2,1,2,0,0,0,0,1,1,2,1,1,0,2,0,2
400946183,Florida State Seminoles,T. Mann,3907823,,True,25.0,3,5,3,4,0,1,1,1,1,0,1,0,0,0,3,1,7
400946183,Florida State Seminoles,D. Bacon,3907821,,True,30.0,9,14,9,12,0,2,0,0,2,7,9,0,0,0,4,1,18
400946183,Florida State Seminoles,X. Rathan-Mayes,66125,,True,32.0,5,12,4,9,1,3,2,3,0,3,3,5,1,0,1,3,13
400946183,Florida State Seminoles,J. Smith,66126,,False,8.0,2,2,2,2,0,0,1,2,1,1,2,0,0,0,0,2,5
400946183,Florida State Seminoles,C. Koumadje,3907824,,False,14.0,0,3,0,3,0,0,1,2,1,1,2,0,0,0,1,3,1
400946183,Florida State Seminoles,M. Ojo,61596,,False,2.0,0,0,0,0,0,0,0,0,1,1,2,0,0,0,1,1,0
400946183,Florida State Seminoles,B. Angola-Rodas,4065658,,False,24.0,5,8,1,1,4,7,3,4,0,1,1,2,0,0,0,4,17
400946183,Florida State Seminoles,P. Savoy,4065657,,False,0.0,0,0,0,0,0,0,0,0,0,0,0,0,0,0,0,0,0
400946183,Florida State Seminoles,T. Forrest,4065656,,False,11.0,1,3,1,3,0,0,1,1,1,1,2,0,1,0,1,0,3
400946183,Florida State Seminoles,C. Walker,4065655,,False,8.0,1,1,1,1,0,0,0,0,0,0,0,0,0,0,1,0,2
400946183,Florida State Seminoles,TEAM,TOTAL,TOTAL,False,,29,57,24,42,5,15,10,16,9,32,41,10,4,2,18,17,73
400946137,North Carolina Tar Heels,J. Jackson,3138156,,True,33.0,6,22,3,11,3,11,1,2,1,3,4,4,2,0,2,4,16
400946137,North Carolina Tar Heels,I. Hicks,66874,,True,32.0,6,9,6,9,0,0,7,7,3,4,7,3,1,1,2,4,19
400946137,North Carolina Tar Heels,K. Meeks,66873,,True,27.0,9,14,9,14,0,0,1,3,6,6,12,1,0,1,0,3,19
400946137,North Carolina Tar Heels,T. Pinson,3138154,,True,34.0,2,9,2,8,0,1,0,0,4,2,6,8,1,0,3,1,4
400946137,North Carolina Tar Heels,J. Berry II,3138155,,True,24.0,3,8,3,5,0,3,4,5,1,1,2,2,0,0,1,4,10
400946137,North Carolina Tar Heels,A. Rohlman,4065677,,False,0.0,0,0,0,0,0,0,0,0,0,0,0,0,0,0,0,0,0
400946137,North Carolina Tar Heels,S. Rush,4065674,,False,0.0,0,0,0,0,0,0,0,0,0,0,0,0,0,0,0,0,0
400946137,North Carolina Tar Heels,T. Bradley,4065673,,False,11.0,2,4,2,4,0,0,0,0,2,1,3,1,0,0,0,1,4
400946137,North Carolina Tar Heels,L. Maye,3911620,,False,7.0,0,2,0,0,0,2,0,0,0,1,1,1,0,0,1,5,0
400946137,North Carolina Tar Heels,S. Woods,4065676,,False,2.0,0,0,0,0,0,0,0,0,0,0,0,0,0,0,1,0,0
400946137,North Carolina Tar Heels,B. Robinson,4065675,,False,6.0,0,1,0,0,0,1,0,0,0,0,0,0,0,0,0,2,0
400946137,North Carolina Tar Heels,K. Coker,3947144,,False,0.0,0,0,0,0,0,0,0,0,0,0,0,1,0,0,0,0,0
400946137,North Carolina Tar Heels,N. Britt,66872,,False,24.0,3,8,2,5,1,3,1,1,1,2,3,2,1,0,0,4,8
400946137,North Carolina Tar Heels,S. White,56963,,False,0.0,1,1,0,0,1,1,0,0,0,0,0,0,0,0,0,0,3
400946137,North Carolina Tar Heels,TEAM,TOTAL,TOTAL,False,,32,78,27,56,5,22,14,18,22,21,43,23,5,2,10,28,83
400946137,North Carolina Tar Heels,J. Jackson,3138156,,True,33.0,6,22,3,11,3,11,1,2,1,3,4,4,2,0,2,4,16
400946137,North Carolina Tar Heels,I. Hicks,66874,,True,32.0,6,9,6,9,0,0,7,7,3,4,7,3,1,1,2,4,19
400946137,North Carolina Tar Heels,K. Meeks,66873,,True,27.0,9,14,9,14,0,0,1,3,6,6,12,1,0,1,0,3,19
400946137,North Carolina Tar Heels,T. Pinson,3138154,,True,34.0,2,9,2,8,0,1,0,0,4,2,6,8,1,0,3,1,4
400946137,North Carolina Tar Heels,J. Berry II,3138155,,True,24.0,3,8,3,5,0,3,4,5,1,1,2,2,0,0,1,4,10
400946137,North Carolina Tar Heels,A. Rohlman,4065677,,False,0.0,0,0,0,0,0,0,0,0,0,0,0,0,0,0,0,0,0
400946137,North Carolina Tar Heels,S. Rush,4065674,,False,0.0,0,0,0,0,0,0,0,0,0,0,0,0,0,0,0,0,0
400946137,North Carolina Tar Heels,T. Bradley,4065673,,False,11.0,2,4,2,4,0,0,0,0,2,1,3,1,0,0,0,1,4
400946137,North Carolina Tar Heels,L. Maye,3911620,,False,7.0,0,2,0,0,0,2,0,0,0,1,1,1,0,0,1,5,0
400946137,North Carolina Tar Heels,S. Woods,4065676,,False,2.0,0,0,0,0,0,0,0,0,0,0,0,0,0,0,1,0,0
400946137,North Carolina Tar Heels,B. Robinson,4065675,,False,6.0,0,1,0,0,0,1,0,0,0,0,0,0,0,0,0,2,0
400946137,North Carolina Tar Heels,K. Coker,3947144,,False,0.0,0,0,0,0,0,0,0,0,0,0,0,1,0,0,0,0,0
400946137,North Carolina Tar Heels,N. Britt,66872,,False,24.0,3,8,2,5,1,3,1,1,1,2,3,2,1,0,0,4,8
400946137,North Carolina Tar Heels,S. White,56963,,False,0.0,1,1,0,0,1,1,0,0,0,0,0,0,0,0,0,0,3
400946137,North Carolina Tar Heels,TEAM,TOTAL,TOTAL,False,,32,78,27,56,5,22,14,18,22,21,43,23,5,2,10,28,83
400946137,Duke Blue Devils,J. Tatum,4065648,,True,36.0,8,15,7,11,1,4,7,7,1,6,7,2,2,0,3,4,24
400946137,Duke Blue Devils,A. Jefferson,61586,,True,28.0,2,4,2,4,0,0,4,6,1,3,4,1,0,2,0,5,8
400946137,Duke Blue Devils,F. Jackson,4065651,,True,30.0,4,11,2,6,2,5,5,6,1,4,5,1,0,0,1,0,15
400946137,Duke Blue Devils,L. Kennard,3913174,,True,39.0,4,7,2,5,2,2,10,10,0,3,3,1,3,2,4,2,20
400946137,Duke Blue Devils,M. Jones,66563,,True,21.0,0,0,0,0,0,0,2,2,0,0,0,1,1,0,1,1,2
400946137,Duke Blue Devils,H. Giles III,4065649,,False,15.0,2,3,2,3,0,0,2,2,1,6,7,0,1,4,0,3,6
400946137,Duke Blue Devils,M. Bolden,4065652,,False,1.0,0,0,0,0,0,0,0,0,0,0,0,0,0,0,0,2,0
400946137,Duke Blue Devils,G. Allen,3135045,,False,30.0,5,10,0,4,5,6,3,4,1,1,2,5,0,0,2,3,18
400946137,Duke Blue Devils,TEAM,TOTAL,TOTAL,False,,25,50,15,33,10,17,33,37,5,27,32,11,7,8,11,20,93
400946137,Duke Blue Devils,J. Tatum,4065648,,True,36.0,8,15,7,11,1,4,7,7,1,6,7,2,2,0,3,4,24
400946137,Duke Blue Devils,A. Jefferson,61586,,True,28.0,2,4,2,4,0,0,4,6,1,3,4,1,0,2,0,5,8
400946137,Duke Blue Devils,F. Jackson,4065651,,True,30.0,4,11,2,6,2,5,5,6,1,4,5,1,0,0,1,0,15
400946137,Duke Blue Devils,L. Kennard,3913174,,True,39.0,4,7,2,5,2,2,10,10,0,3,3,1,3,2,4,2,20
400946137,Duke Blue Devils,M. Jones,66563,,True,21.0,0,0,0,0,0,0,2,2,0,0,0,1,1,0,1,1,2
400946137,Duke Blue Devils,H. Giles III,4065649,,False,15.0,2,3,2,3,0,0,2,2,1,6,7,0,1,4,0,3,6
400946137,Duke Blue Devils,M. Bolden,4065652,,False,1.0,0,0,0,0,0,0,0,0,0,0,0,0,0,0,0,2,0
400946137,Duke Blue Devils,G. Allen,3135045,,False,30.0,5,10,0,4,5,6,3,4,1,1,2,5,0,0,2,3,18
400946137,Duke Blue Devils,TEAM,TOTAL,TOTAL,False,,25,50,15,33,10,17,33,37,5,27,32,11,7,8,11,20,93
400945795,Virginia Tech Hokies,K. Sy,4065740,,True,9.0,1,2,1,2,0,0,0,0,0,1,1,0,0,0,2,2,2
400945795,Virginia Tech Hokies,T. Outlaw,67275,,True,29.0,1,4,0,0,1,4,0,0,0,5,5,0,0,0,2,3,3
400945795,Virginia Tech Hokies,J. Robinson,3945566,,True,35.0,4,9,1,4,3,5,3,3,0,2,2,6,0,0,1,4,14
400945795,Virginia Tech Hokies,A. Hill,3147501,,True,28.0,1,3,1,2,0,1,1,1,0,3,3,0,0,0,1,2,3
400945795,Virginia Tech Hokies,J. Bibbs,3147500,,True,33.0,3,9,2,4,1,5,0,0,1,2,3,2,0,0,1,2,7
400945795,Virginia Tech Hokies,Z. LeDay,61698,,False,30.0,6,12,6,10,0,2,10,12,3,6,9,1,1,0,1,4,22
400945795,Virginia Tech Hokies,S. Allen,61795,,False,36.0,4,13,1,5,3,8,6,9,1,1,2,5,2,0,5,1,17
400945795,Virginia Tech Hokies,TEAM,TOTAL,TOTAL,False,,20,52,12,27,8,25,20,25,8,23,31,14,3,0,15,18,68
400945795,Virginia Tech Hokies,K. Sy,4065740,,True,9.0,1,2,1,2,0,0,0,0,0,1,1,0,0,0,2,2,2
400945795,Virginia Tech Hokies,T. Outlaw,67275,,True,29.0,1,4,0,0,1,4,0,0,0,5,5,0,0,0,2,3,3
400945795,Virginia Tech Hokies,J. Robinson,3945566,,True,35.0,4,9,1,4,3,5,3,3,0,2,2,6,0,0,1,4,14
400945795,Virginia Tech Hokies,A. Hill,3147501,,True,28.0,1,3,1,2,0,1,1,1,0,3,3,0,0,0,1,2,3
400945795,Virginia Tech Hokies,J. Bibbs,3147500,,True,33.0,3,9,2,4,1,5,0,0,1,2,3,2,0,0,1,2,7
400945795,Virginia Tech Hokies,Z. LeDay,61698,,False,30.0,6,12,6,10,0,2,10,12,3,6,9,1,1,0,1,4,22
400945795,Virginia Tech Hokies,S. Allen,61795,,False,36.0,4,13,1,5,3,8,6,9,1,1,2,5,2,0,5,1,17
400945795,Virginia Tech Hokies,TEAM,TOTAL,TOTAL,False,,20,52,12,27,8,25,20,25,8,23,31,14,3,0,15,18,68
400945795,Florida State Seminoles,J. Isaac,4065654,,True,32.0,4,13,3,9,1,4,2,2,5,7,12,1,1,2,1,2,11
400945795,Florida State Seminoles,M. Ojo,61596,,True,8.0,3,5,3,5,0,0,0,0,0,0,0,0,2,1,0,3,6
400945795,Florida State Seminoles,T. Mann,3907823,,True,30.0,5,7,4,6,1,1,0,0,6,3,9,1,1,0,2,1,11
400945795,Florida State Seminoles,D. Bacon,3907821,,True,30.0,4,17,4,12,0,5,9,10,1,6,7,0,3,0,1,3,17
400945795,Florida State Seminoles,X. Rathan-Mayes,66125,,True,28.0,4,11,3,7,1,4,0,1,1,3,4,6,1,0,3,1,9
400945795,Florida State Seminoles,P. Cofer,3135054,,False,18.0,2,3,2,3,0,0,2,2,0,3,3,0,1,0,0,2,6
400945795,Florida State Seminoles,J. Smith,66126,,False,9.0,0,0,0,0,0,0,0,0,1,1,2,0,1,1,1,2,0
400945795,Florida State Seminoles,C. Koumadje,3907824,,False,10.0,1,1,1,1,0,0,3,4,0,1,1,0,0,2,0,1,5
400945795,Florida State Seminoles,B. Angola-Rodas,4065658,,False,11.0,2,2,2,2,0,0,2,2,2,1,3,0,0,0,1,0,6
400945795,Florida State Seminoles,P. Savoy,4065657,,False,5.0,0,1,0,0,0,1,0,0,0,0,0,0,0,0,0,0,0
400945795,Florida State Seminoles,T. Forrest,4065656,,False,7.0,0,2,0,2,0,0,0,0,0,0,0,0,1,0,0,1,0
400945795,Florida State Seminoles,C. Walker,4065655,,False,12.0,1,3,1,2,0,1,1,2,0,2,2,4,1,0,1,3,3
400945795,Florida State Seminoles,TEAM,TOTAL,TOTAL,False,,26,65,23,49,3,16,19,23,18,27,45,12,12,6,10,19,74
400945795,Florida State Seminoles,J. Isaac,4065654,,True,32.0,4,13,3,9,1,4,2,2,5,7,12,1,1,2,1,2,11
400945795,Florida State Seminoles,M. Ojo,61596,,True,8.0,3,5,3,5,0,0,0,0,0,0,0,0,2,1,0,3,6
400945795,Florida State Seminoles,T. Mann,3907823,,True,30.0,5,7,4,6,1,1,0,0,6,3,9,1,1,0,2,1,11
400945795,Florida State Seminoles,D. Bacon,3907821,,True,30.0,4,17,4,12,0,5,9,10,1,6,7,0,3,0,1,3,17
400945795,Florida State Seminoles,X. Rathan-Mayes,66125,,True,28.0,4,11,3,7,1,4,0,1,1,3,4,6,1,0,3,1,9
400945795,Florida State Seminoles,P. Cofer,3135054,,False,18.0,2,3,2,3,0,0,2,2,0,3,3,0,1,0,0,2,6
400945795,Florida State Seminoles,J. Smith,66126,,False,9.0,0,0,0,0,0,0,0,0,1,1,2,0,1,1,1,2,0
400945795,Florida State Seminoles,C. Koumadje,3907824,,False,10.0,1,1,1,1,0,0,3,4,0,1,1,0,0,2,0,1,5
400945795,Florida State Seminoles,B. Angola-Rodas,4065658,,False,11.0,2,2,2,2,0,0,2,2,2,1,3,0,0,0,1,0,6
400945795,Florida State Seminoles,P. Savoy,4065657,,False,5.0,0,1,0,0,0,1,0,0,0,0,0,0,0,0,0,0,0
400945795,Florida State Seminoles,T. Forrest,4065656,,False,7.0,0,2,0,2,0,0,0,0,0,0,0,0,1,0,0,1,0
400945795,Florida State Seminoles,C. Walker,4065655,,False,12.0,1,3,1,2,0,1,1,2,0,2,2,4,1,0,1,3,3
400945795,Florida State Seminoles,TEAM,TOTAL,TOTAL,False,,26,65,23,49,3,16,19,23,18,27,45,12,12,6,10,19,74
400945794,Virginia Cavaliers,J. Salt,3138200,,True,12.0,0,1,0,1,0,0,0,2,2,2,4,0,1,0,0,3,0
400945794,Virginia Cavaliers,T. Jerome,4065733,,True,22.0,3,7,1,1,2,6,2,2,0,2,2,6,0,0,0,4,10
400945794,Virginia Cavaliers,K. Guy,4065730,,True,25.0,0,8,0,7,0,1,0,0,1,4,5,2,0,0,2,0,0
400945794,Virginia Cavaliers,L. Perrantes,66139,,True,32.0,1,9,1,6,0,3,1,2,0,1,1,2,1,0,3,2,3
400945794,Virginia Cavaliers,D. Hall,66138,,True,30.0,5,7,3,4,2,3,0,0,3,6,9,1,0,0,1,2,12
400945794,Virginia Cavaliers,M. Diakite,3947156,,False,11.0,0,3,0,3,0,0,0,0,1,1,2,0,0,0,0,4,0
400945794,Virginia Cavaliers,J. Reuter,3908374,,False,13.0,4,7,4,7,0,0,1,2,2,0,2,1,0,0,2,2,9
400945794,Virginia Cavaliers,I. Wilkins,3138203,,False,14.0,1,2,1,2,0,0,0,0,1,2,3,0,1,1,0,1,2
400945794,Virginia Cavaliers,M. Shayok,3138201,,False,13.0,4,6,4,5,0,1,2,2,0,1,1,0,0,0,0,2,10
400945794,Virginia Cavaliers,D. Thompson,66274,,False,28.0,4,7,1,2,3,5,1,2,0,0,0,0,0,0,1,1,12
400945794,Virginia Cavaliers,TEAM,TOTAL,TOTAL,False,,22,57,15,38,7,19,7,12,13,19,32,12,3,1,10,21,58
400945794,Virginia Cavaliers,J. Salt,3138200,,True,12.0,0,1,0,1,0,0,0,2,2,2,4,0,1,0,0,3,0
400945794,Virginia Cavaliers,T. Jerome,4065733,,True,22.0,3,7,1,1,2,6,2,2,0,2,2,6,0,0,0,4,10
400945794,Virginia Cavaliers,K. Guy,4065730,,True,25.0,0,8,0,7,0,1,0,0,1,4,5,2,0,0,2,0,0
400945794,Virginia Cavaliers,L. Perrantes,66139,,True,32.0,1,9,1,6,0,3,1,2,0,1,1,2,1,0,3,2,3
400945794,Virginia Cavaliers,D. Hall,66138,,True,30.0,5,7,3,4,2,3,0,0,3,6,9,1,0,0,1,2,12
400945794,Virginia Cavaliers,M. Diakite,3947156,,False,11.0,0,3,0,3,0,0,0,0,1,1,2,0,0,0,0,4,0
400945794,Virginia Cavaliers,J. Reuter,3908374,,False,13.0,4,7,4,7,0,0,1,2,2,0,2,1,0,0,2,2,9
400945794,Virginia Cavaliers,I. Wilkins,3138203,,False,14.0,1,2,1,2,0,0,0,0,1,2,3,0,1,1,0,1,2
400945794,Virginia Cavaliers,M. Shayok,3138201,,False,13.0,4,6,4,5,0,1,2,2,0,1,1,0,0,0,0,2,10
400945794,Virginia Cavaliers,D. Thompson,66274,,False,28.0,4,7,1,2,3,5,1,2,0,0,0,0,0,0,1,1,12
400945794,Virginia Cavaliers,TEAM,TOTAL,TOTAL,False,,22,57,15,38,7,19,7,12,13,19,32,12,3,1,10,21,58
400945794,Notre Dame Fighting Irish,B. Colson,3138192,,True,33.0,6,14,5,11,1,3,8,11,3,7,10,0,0,2,1,1,21
400945794,Notre Dame Fighting Irish,V.J. Beachem,66283,,True,37.0,5,9,3,4,2,5,0,0,1,6,7,0,0,0,0,1,12
400945794,Notre Dame Fighting Irish,R. Pflueger,3908335,,True,28.0,2,5,1,2,1,3,0,1,0,4,4,0,3,0,1,1,5
400945794,Notre Dame Fighting Irish,M. Farrell,3138190,,True,37.0,4,8,3,5,1,3,5,7,0,0,0,4,2,0,1,0,14
400945794,Notre Dame Fighting Irish,S. Vasturia,66285,,True,37.0,4,6,4,4,0,2,4,4,1,4,5,5,1,0,0,2,12
400945794,Notre Dame Fighting Irish,M. Geben,3138191,,False,10.0,1,1,1,1,0,0,1,2,1,2,3,0,0,1,4,2,3
400945794,Notre Dame Fighting Irish,A. Torres,66286,,False,1.0,0,0,0,0,0,0,0,0,0,0,0,0,0,0,0,0,0
400945794,Notre Dame Fighting Irish,M. Ryan,3908336,,False,2.0,0,0,0,0,0,0,0,0,0,0,0,0,0,0,0,1,0
400945794,Notre Dame Fighting Irish,T. Gibbs,4065703,,False,15.0,2,3,2,2,0,1,0,0,1,1,2,0,0,0,0,1,4
400945794,Notre Dame Fighting Irish,TEAM,TOTAL,TOTAL,False,,24,46,19,29,5,17,18,25,7,24,31,9,6,3,8,9,71
400945794,Notre Dame Fighting Irish,B. Colson,3138192,,True,33.0,6,14,5,11,1,3,8,11,3,7,10,0,0,2,1,1,21
400945794,Notre Dame Fighting Irish,V.J. Beachem,66283,,True,37.0,5,9,3,4,2,5,0,0,1,6,7,0,0,0,0,1,12
400945794,Notre Dame Fighting Irish,R. Pflueger,3908335,,True,28.0,2,5,1,2,1,3,0,1,0,4,4,0,3,0,1,1,5
400945794,Notre Dame Fighting Irish,M. Farrell,3138190,,True,37.0,4,8,3,5,1,3,5,7,0,0,0,4,2,0,1,0,14
400945794,Notre Dame Fighting Irish,S. Vasturia,66285,,True,37.0,4,6,4,4,0,2,4,4,1,4,5,5,1,0,0,2,12
400945794,Notre Dame Fighting Irish,M. Geben,3138191,,False,10.0,1,1,1,1,0,0,1,2,1,2,3,0,0,1,4,2,3
400945794,Notre Dame Fighting Irish,A. Torres,66286,,False,1.0,0,0,0,0,0,0,0,0,0,0,0,0,0,0,0,0,0
400945794,Notre Dame Fighting Irish,M. Ryan,3908336,,False,2.0,0,0,0,0,0,0,0,0,0,0,0,0,0,0,0,1,0
400945794,Notre Dame Fighting Irish,T. Gibbs,4065703,,False,15.0,2,3,2,2,0,1,0,0,1,1,2,0,0,0,0,1,4
400945794,Notre Dame Fighting Irish,TEAM,TOTAL,TOTAL,False,,24,46,19,29,5,17,18,25,7,24,31,9,6,3,8,9,71
400945793,Louisville Cardinals,M. Mathiang,63035,,True,23.0,3,4,3,4,0,0,3,4,2,2,4,2,1,3,1,2,9
400945793,Louisville Cardinals,D. Adel,3908807,,True,38.0,7,14,5,8,2,6,5,6,0,5,5,1,0,0,1,2,21
400945793,Louisville Cardinals,J. Johnson,3147362,,True,16.0,2,3,2,3,0,0,0,1,0,4,4,1,0,0,1,3,4
400945793,Louisville Cardinals,D. Mitchell,3908809,,True,32.0,3,14,2,7,1,7,1,2,0,3,3,1,0,1,1,4,8
400945793,Louisville Cardinals,Q. Snider,3147360,,True,34.0,5,13,4,7,1,6,4,6,0,3,3,5,1,0,1,4,15
400945793,Louisville Cardinals,V.J. King,4065666,,False,5.0,2,3,2,2,0,1,0,0,0,0,0,0,0,0,0,2,4
400945793,Louisville Cardinals,R. Spalding,3908806,,False,23.0,4,5,4,5,0,0,1,3,2,4,6,2,1,0,2,3,9
400945793,Louisville Cardinals,A. Mahmoud,3147363,,False,19.0,3,3,3,3,0,0,1,4,2,5,7,2,0,2,0,1,7
400945793,Louisville Cardinals,R. McMahon,3908808,,False,0.0,0,0,0,0,0,0,0,0,0,0,0,0,0,0,0,0,0
400945793,Louisville Cardinals,J. Henderson,3155491,,False,1.0,0,0,0,0,0,0,0,0,0,0,0,0,0,0,0,0,0
400945793,Louisville Cardinals,D. Levitch,66592,,False,6.0,0,1,0,0,0,1,0,0,1,2,3,1,0,0,1,2,0
400945793,Louisville Cardinals,T. Hicks,62752,,False,3.0,0,0,0,0,0,0,0,0,0,0,0,0,0,0,0,0,0
400945793,Louisville Cardinals,TEAM,TOTAL,TOTAL,False,,29,60,25,39,4,21,15,26,8,29,37,15,3,6,8,23,77
400945793,Louisville Cardinals,M. Mathiang,63035,,True,23.0,3,4,3,4,0,0,3,4,2,2,4,2,1,3,1,2,9
400945793,Louisville Cardinals,D. Adel,3908807,,True,38.0,7,14,5,8,2,6,5,6,0,5,5,1,0,0,1,2,21
400945793,Louisville Cardinals,J. Johnson,3147362,,True,16.0,2,3,2,3,0,0,0,1,0,4,4,1,0,0,1,3,4
400945793,Louisville Cardinals,D. Mitchell,3908809,,True,32.0,3,14,2,7,1,7,1,2,0,3,3,1,0,1,1,4,8
400945793,Louisville Cardinals,Q. Snider,3147360,,True,34.0,5,13,4,7,1,6,4,6,0,3,3,5,1,0,1,4,15
400945793,Louisville Cardinals,V.J. King,4065666,,False,5.0,2,3,2,2,0,1,0,0,0,0,0,0,0,0,0,2,4
400945793,Louisville Cardinals,R. Spalding,3908806,,False,23.0,4,5,4,5,0,0,1,3,2,4,6,2,1,0,2,3,9
400945793,Louisville Cardinals,A. Mahmoud,3147363,,False,19.0,3,3,3,3,0,0,1,4,2,5,7,2,0,2,0,1,7
400945793,Louisville Cardinals,R. McMahon,3908808,,False,0.0,0,0,0,0,0,0,0,0,0,0,0,0,0,0,0,0,0
400945793,Louisville Cardinals,J. Henderson,3155491,,False,1.0,0,0,0,0,0,0,0,0,0,0,0,0,0,0,0,0,0
400945793,Louisville Cardinals,D. Levitch,66592,,False,6.0,0,1,0,0,0,1,0,0,1,2,3,1,0,0,1,2,0
400945793,Louisville Cardinals,T. Hicks,62752,,False,3.0,0,0,0,0,0,0,0,0,0,0,0,0,0,0,0,0,0
400945793,Louisville Cardinals,TEAM,TOTAL,TOTAL,False,,29,60,25,39,4,21,15,26,8,29,37,15,3,6,8,23,77
400945793,Duke Blue Devils,J. Tatum,4065648,,True,39.0,9,15,8,13,1,2,6,8,0,6,6,2,3,0,3,5,25
400945793,Duke Blue Devils,A. Jefferson,61586,,True,25.0,1,3,1,3,0,0,0,0,2,4,6,0,0,1,0,3,2
400945793,Duke Blue Devils,F. Jackson,4065651,,True,28.0,2,6,1,3,1,3,3,7,0,2,2,0,0,0,0,3,8
400945793,Duke Blue Devils,L. Kennard,3913174,,True,38.0,7,16,4,8,3,8,7,9,2,8,10,3,0,1,2,2,24
400945793,Duke Blue Devils,M. Jones,66563,,True,23.0,0,3,0,1,0,2,0,0,1,0,1,1,1,0,0,1,0
400945793,Duke Blue Devils,H. Giles III,4065649,,False,15.0,2,4,2,4,0,0,0,0,1,2,3,2,2,1,0,3,4
400945793,Duke Blue Devils,M. Bolden,4065652,,False,4.0,0,0,0,0,0,0,0,0,0,0,0,0,0,0,0,1,0
400945793,Duke Blue Devils,G. Allen,3135045,,False,28.0,5,12,3,9,2,3,6,7,2,2,4,1,0,0,2,3,18
400945793,Duke Blue Devils,TEAM,TOTAL,TOTAL,False,,26,59,19,41,7,18,22,31,9,25,34,9,6,3,8,21,81
400945793,Duke Blue Devils,J. Tatum,4065648,,True,39.0,9,15,8,13,1,2,6,8,0,6,6,2,3,0,3,5,25
400945793,Duke Blue Devils,A. Jefferson,61586,,True,25.0,1,3,1,3,0,0,0,0,2,4,6,0,0,1,0,3,2
400945793,Duke Blue Devils,F. Jackson,4065651,,True,28.0,2,6,1,3,1,3,3,7,0,2,2,0,0,0,0,3,8
400945793,Duke Blue Devils,L. Kennard,3913174,,True,38.0,7,16,4,8,3,8,7,9,2,8,10,3,0,1,2,2,24
400945793,Duke Blue Devils,M. Jones,66563,,True,23.0,0,3,0,1,0,2,0,0,1,0,1,1,1,0,0,1,0
400945793,Duke Blue Devils,H. Giles III,4065649,,False,15.0,2,4,2,4,0,0,0,0,1,2,3,2,2,1,0,3,4
400945793,Duke Blue Devils,M. Bolden,4065652,,False,4.0,0,0,0,0,0,0,0,0,0,0,0,0,0,0,0,1,0
400945793,Duke Blue Devils,G. Allen,3135045,,False,28.0,5,12,3,9,2,3,6,7,2,2,4,1,0,0,2,3,18
400945793,Duke Blue Devils,TEAM,TOTAL,TOTAL,False,,26,59,19,41,7,18,22,31,9,25,34,9,6,3,8,21,81
400945792,North Carolina Tar Heels,J. Jackson,3138156,,True,33.0,5,11,3,4,2,7,0,1,0,2,2,3,2,0,3,0,12
400945792,North Carolina Tar Heels,K. Meeks,66873,,True,24.0,4,7,4,7,0,0,2,2,2,5,7,0,0,1,0,2,10
400945792,North Carolina Tar Heels,T. Pinson,3138154,,True,24.0,3,7,2,4,1,3,2,4,1,3,4,6,0,0,3,3,9
400945792,North Carolina Tar Heels,I. Hicks,66874,,True,25.0,5,7,5,7,0,0,9,9,2,4,6,2,1,0,1,1,19
400945792,North Carolina Tar Heels,J. Berry II,3138155,,True,29.0,5,8,4,5,1,3,0,0,1,3,4,5,3,0,2,2,11
400945792,North Carolina Tar Heels,T. Bradley,4065673,,False,16.0,2,4,2,4,0,0,2,2,2,2,4,1,0,0,0,2,6
400945792,North Carolina Tar Heels,L. Maye,3911620,,False,13.0,2,2,0,0,2,2,0,0,1,2,3,0,0,0,1,1,6
400945792,North Carolina Tar Heels,S. Woods,4065676,,False,8.0,0,0,0,0,0,0,0,0,0,2,2,1,0,0,1,0,0
400945792,North Carolina Tar Heels,B. Robinson,4065675,,False,6.0,0,1,0,0,0,1,0,0,0,0,0,1,0,0,0,1,0
400945792,North Carolina Tar Heels,N. Britt,66872,,False,20.0,1,4,0,3,1,1,0,0,0,1,1,2,3,0,0,0,3
400945792,North Carolina Tar Heels,S. White,56963,,False,2.0,1,2,1,2,0,0,0,0,0,0,0,0,0,0,0,0,2
400945792,North Carolina Tar Heels,TEAM,TOTAL,TOTAL,False,,28,53,21,36,7,17,15,18,9,27,36,21,9,1,11,12,78
400945792,North Carolina Tar Heels,J. Jackson,3138156,,True,33.0,5,11,3,4,2,7,0,1,0,2,2,3,2,0,3,0,12
400945792,North Carolina Tar Heels,K. Meeks,66873,,True,24.0,4,7,4,7,0,0,2,2,2,5,7,0,0,1,0,2,10
400945792,North Carolina Tar Heels,T. Pinson,3138154,,True,24.0,3,7,2,4,1,3,2,4,1,3,4,6,0,0,3,3,9
400945792,North Carolina Tar Heels,I. Hicks,66874,,True,25.0,5,7,5,7,0,0,9,9,2,4,6,2,1,0,1,1,19
400945792,North Carolina Tar Heels,J. Berry II,3138155,,True,29.0,5,8,4,5,1,3,0,0,1,3,4,5,3,0,2,2,11
400945792,North Carolina Tar Heels,T. Bradley,4065673,,False,16.0,2,4,2,4,0,0,2,2,2,2,4,1,0,0,0,2,6
400945792,North Carolina Tar Heels,L. Maye,3911620,,False,13.0,2,2,0,0,2,2,0,0,1,2,3,0,0,0,1,1,6
400945792,North Carolina Tar Heels,S. Woods,4065676,,False,8.0,0,0,0,0,0,0,0,0,0,2,2,1,0,0,1,0,0
400945792,North Carolina Tar Heels,B. Robinson,4065675,,False,6.0,0,1,0,0,0,1,0,0,0,0,0,1,0,0,0,1,0
400945792,North Carolina Tar Heels,N. Britt,66872,,False,20.0,1,4,0,3,1,1,0,0,0,1,1,2,3,0,0,0,3
400945792,North Carolina Tar Heels,S. White,56963,,False,2.0,1,2,1,2,0,0,0,0,0,0,0,0,0,0,0,0,2
400945792,North Carolina Tar Heels,TEAM,TOTAL,TOTAL,False,,28,53,21,36,7,17,15,18,9,27,36,21,9,1,11,12,78
400945792,Miami Hurricanes,K. Murphy,61668,,True,25.0,2,6,2,6,0,0,1,2,1,3,4,1,0,1,2,2,5
400945792,Miami Hurricanes,B. Brown,4065670,,True,33.0,9,13,8,10,1,3,2,2,2,5,7,1,0,0,3,2,21
400945792,Miami Hurricanes,A. Lawrence II,3904628,,True,32.0,2,6,0,1,2,5,0,0,1,2,3,1,4,1,1,3,6
400945792,Miami Hurricanes,J. Newton,3138145,,True,26.0,1,4,1,4,0,0,1,5,1,0,1,1,1,0,2,1,3
400945792,Miami Hurricanes,D. Reed,66130,,True,34.0,2,8,1,3,1,5,2,2,3,3,6,2,1,0,3,1,7
400945792,Miami Hurricanes,D. Hernandez,4065672,,False,11.0,0,1,0,1,0,0,1,2,0,1,1,0,0,2,1,2,1
400945792,Miami Hurricanes,R. Miller Jr.,4065671,,False,8.0,1,3,1,3,0,0,0,0,1,0,1,0,0,0,0,1,2
400945792,Miami Hurricanes,E. Izundu,3904629,,False,10.0,0,2,0,2,0,0,2,2,1,1,2,0,0,0,0,3,2
400945792,Miami Hurricanes,D. Vasiljevic,4065669,,False,19.0,2,9,1,2,1,7,1,1,0,1,1,1,1,0,2,2,6
400945792,Miami Hurricanes,M. Robinson,3947140,,False,2.0,0,1,0,0,0,1,0,0,0,0,0,0,0,0,0,0,0
400945792,Miami Hurricanes,TEAM,TOTAL,TOTAL,False,,19,53,14,32,5,21,10,16,11,18,29,7,7,4,15,17,53
400945792,Miami Hurricanes,K. Murphy,61668,,True,25.0,2,6,2,6,0,0,1,2,1,3,4,1,0,1,2,2,5
400945792,Miami Hurricanes,B. Brown,4065670,,True,33.0,9,13,8,10,1,3,2,2,2,5,7,1,0,0,3,2,21
400945792,Miami Hurricanes,A. Lawrence II,3904628,,True,32.0,2,6,0,1,2,5,0,0,1,2,3,1,4,1,1,3,6
400945792,Miami Hurricanes,J. Newton,3138145,,True,26.0,1,4,1,4,0,0,1,5,1,0,1,1,1,0,2,1,3
400945792,Miami Hurricanes,D. Reed,66130,,True,34.0,2,8,1,3,1,5,2,2,3,3,6,2,1,0,3,1,7
400945792,Miami Hurricanes,D. Hernandez,4065672,,False,11.0,0,1,0,1,0,0,1,2,0,1,1,0,0,2,1,2,1
400945792,Miami Hurricanes,R. Miller Jr.,4065671,,False,8.0,1,3,1,3,0,0,0,0,1,0,1,0,0,0,0,1,2
400945792,Miami Hurricanes,E. Izundu,3904629,,False,10.0,0,2,0,2,0,0,2,2,1,1,2,0,0,0,0,3,2
400945792,Miami Hurricanes,D. Vasiljevic,4065669,,False,19.0,2,9,1,2,1,7,1,1,0,1,1,1,1,0,2,2,6
400945792,Miami Hurricanes,M. Robinson,3947140,,False,2.0,0,1,0,0,0,1,0,0,0,0,0,0,0,0,0,0,0
400945792,Miami Hurricanes,TEAM,TOTAL,TOTAL,False,,19,53,14,32,5,21,10,16,11,18,29,7,7,4,15,17,53
400945791,Wake Forest Demon Deacons,J. Collins,3908845,,True,33.0,6,10,6,10,0,0,3,4,5,5,10,2,0,2,2,5,15
400945791,Wake Forest Demon Deacons,D. Mitoglou,3138224,,True,21.0,4,9,3,7,1,2,3,4,5,8,13,0,1,2,0,1,12
400945791,Wake Forest Demon Deacons,A. Arians,61378,,True,30.0,4,10,2,4,2,6,0,0,0,0,0,2,0,0,1,5,10
400945791,Wake Forest Demon Deacons,B. Crawford,3908844,,True,36.0,6,14,5,8,1,6,8,8,0,4,4,3,1,1,1,3,21
400945791,Wake Forest Demon Deacons,K. Woods,3132360,,True,29.0,4,8,3,6,1,2,0,0,0,4,4,4,0,0,2,1,9
400945791,Wake Forest Demon Deacons,G. McClinton,66140,,False,2.0,1,1,0,0,1,1,0,0,0,0,0,0,1,0,0,2,3
400945791,Wake Forest Demon Deacons,B. Childress,4065750,,False,28.0,4,7,1,3,3,4,4,5,0,1,1,1,2,0,3,4,15
400945791,Wake Forest Demon Deacons,M. Wilbekin,3138222,,False,21.0,2,6,1,3,1,3,0,0,0,1,1,1,0,0,0,2,5
400945791,Wake Forest Demon Deacons,T. VanHorn,3078214,,False,0.0,0,0,0,0,0,0,0,0,0,0,0,0,0,0,0,1,0
400945791,Wake Forest Demon Deacons,TEAM,TOTAL,TOTAL,False,,31,65,21,41,10,24,18,21,11,23,34,13,5,5,9,24,90
400945791,Wake Forest Demon Deacons,J. Collins,3908845,,True,33.0,6,10,6,10,0,0,3,4,5,5,10,2,0,2,2,5,15
400945791,Wake Forest Demon Deacons,D. Mitoglou,3138224,,True,21.0,4,9,3,7,1,2,3,4,5,8,13,0,1,2,0,1,12
400945791,Wake Forest Demon Deacons,A. Arians,61378,,True,30.0,4,10,2,4,2,6,0,0,0,0,0,2,0,0,1,5,10
400945791,Wake Forest Demon Deacons,B. Crawford,3908844,,True,36.0,6,14,5,8,1,6,8,8,0,4,4,3,1,1,1,3,21
400945791,Wake Forest Demon Deacons,K. Woods,3132360,,True,29.0,4,8,3,6,1,2,0,0,0,4,4,4,0,0,2,1,9
400945791,Wake Forest Demon Deacons,G. McClinton,66140,,False,2.0,1,1,0,0,1,1,0,0,0,0,0,0,1,0,0,2,3
400945791,Wake Forest Demon Deacons,B. Childress,4065750,,False,28.0,4,7,1,3,3,4,4,5,0,1,1,1,2,0,3,4,15
400945791,Wake Forest Demon Deacons,M. Wilbekin,3138222,,False,21.0,2,6,1,3,1,3,0,0,0,1,1,1,0,0,0,2,5
400945791,Wake Forest Demon Deacons,T. VanHorn,3078214,,False,0.0,0,0,0,0,0,0,0,0,0,0,0,0,0,0,0,1,0
400945791,Wake Forest Demon Deacons,TEAM,TOTAL,TOTAL,False,,31,65,21,41,10,24,18,21,11,23,34,13,5,5,9,24,90
400945791,Virginia Tech Hokies,K. Sy,4065740,,True,6.0,2,3,2,3,0,0,0,0,1,0,1,0,0,0,0,1,4
400945791,Virginia Tech Hokies,T. Outlaw,67275,,True,24.0,4,7,0,0,4,7,2,2,0,2,2,1,0,0,0,3,14
400945791,Virginia Tech Hokies,J. Robinson,3945566,,True,35.0,1,3,1,2,0,1,3,4,1,2,3,7,1,0,2,4,5
400945791,Virginia Tech Hokies,A. Hill,3147501,,True,36.0,5,9,4,4,1,5,1,1,1,4,5,1,0,1,0,2,12
400945791,Virginia Tech Hokies,J. Bibbs,3147500,,True,36.0,5,13,2,7,3,6,2,4,0,4,4,3,0,0,1,3,15
400945791,Virginia Tech Hokies,Z. LeDay,61698,,False,34.0,8,15,7,14,1,1,14,18,7,8,15,2,3,2,2,2,31
400945791,Virginia Tech Hokies,S. Allen,61795,,False,29.0,6,10,5,6,1,4,5,6,0,3,3,1,0,0,3,2,18
400945791,Virginia Tech Hokies,TEAM,TOTAL,TOTAL,False,,31,60,21,36,10,24,27,35,12,26,38,15,4,3,8,17,99
400945791,Virginia Tech Hokies,K. Sy,4065740,,True,6.0,2,3,2,3,0,0,0,0,1,0,1,0,0,0,0,1,4
400945791,Virginia Tech Hokies,T. Outlaw,67275,,True,24.0,4,7,0,0,4,7,2,2,0,2,2,1,0,0,0,3,14
400945791,Virginia Tech Hokies,J. Robinson,3945566,,True,35.0,1,3,1,2,0,1,3,4,1,2,3,7,1,0,2,4,5
400945791,Virginia Tech Hokies,A. Hill,3147501,,True,36.0,5,9,4,4,1,5,1,1,1,4,5,1,0,1,0,2,12
400945791,Virginia Tech Hokies,J. Bibbs,3147500,,True,36.0,5,13,2,7,3,6,2,4,0,4,4,3,0,0,1,3,15
400945791,Virginia Tech Hokies,Z. LeDay,61698,,False,34.0,8,15,7,14,1,1,14,18,7,8,15,2,3,2,2,2,31
400945791,Virginia Tech Hokies,S. Allen,61795,,False,29.0,6,10,5,6,1,4,5,6,0,3,3,1,0,0,3,2,18
400945791,Virginia Tech Hokies,TEAM,TOTAL,TOTAL,False,,31,60,21,36,10,24,27,35,12,26,38,15,4,3,8,17,99
400945790,Virginia Cavaliers,I. Wilkins,3138203,,True,23.0,3,3,3,3,0,0,2,2,3,5,8,1,0,0,0,0,8
400945790,Virginia Cavaliers,J. Salt,3138200,,True,13.0,1,1,1,1,0,0,2,2,1,1,2,0,0,0,0,4,4
400945790,Virginia Cavaliers,K. Guy,4065730,,True,32.0,7,12,3,6,4,6,2,2,0,0,0,3,0,0,2,3,20
400945790,Virginia Cavaliers,L. Perrantes,66139,,True,30.0,4,9,2,4,2,5,5,6,0,4,4,3,1,0,1,2,15
400945790,Virginia Cavaliers,D. Hall,66138,,True,31.0,1,4,1,2,0,2,3,5,1,3,4,3,1,0,2,3,5
400945790,Virginia Cavaliers,M. Diakite,3947156,,False,11.0,1,3,1,3,0,0,0,0,0,0,0,0,0,1,0,1,2
400945790,Virginia Cavaliers,J. Reuter,3908374,,False,7.0,1,3,1,3,0,0,0,0,0,1,1,0,0,0,0,3,2
400945790,Virginia Cavaliers,T. Jerome,4065733,,False,28.0,3,7,0,1,3,6,2,2,0,7,7,4,0,0,2,2,11
400945790,Virginia Cavaliers,M. Shayok,3138201,,False,9.0,1,3,1,3,0,0,0,0,0,1,1,1,0,0,0,0,2
400945790,Virginia Cavaliers,D. Thompson,66274,,False,16.0,2,4,0,1,2,3,0,0,0,0,0,1,0,0,0,1,6
400945790,Virginia Cavaliers,TEAM,TOTAL,TOTAL,False,,24,49,13,27,11,22,16,19,7,23,30,16,2,1,8,19,75
400945790,Virginia Cavaliers,I. Wilkins,3138203,,True,23.0,3,3,3,3,0,0,2,2,3,5,8,1,0,0,0,0,8
400945790,Virginia Cavaliers,J. Salt,3138200,,True,13.0,1,1,1,1,0,0,2,2,1,1,2,0,0,0,0,4,4
400945790,Virginia Cavaliers,K. Guy,4065730,,True,32.0,7,12,3,6,4,6,2,2,0,0,0,3,0,0,2,3,20
400945790,Virginia Cavaliers,L. Perrantes,66139,,True,30.0,4,9,2,4,2,5,5,6,0,4,4,3,1,0,1,2,15
400945790,Virginia Cavaliers,D. Hall,66138,,True,31.0,1,4,1,2,0,2,3,5,1,3,4,3,1,0,2,3,5
400945790,Virginia Cavaliers,M. Diakite,3947156,,False,11.0,1,3,1,3,0,0,0,0,0,0,0,0,0,1,0,1,2
400945790,Virginia Cavaliers,J. Reuter,3908374,,False,7.0,1,3,1,3,0,0,0,0,0,1,1,0,0,0,0,3,2
400945790,Virginia Cavaliers,T. Jerome,4065733,,False,28.0,3,7,0,1,3,6,2,2,0,7,7,4,0,0,2,2,11
400945790,Virginia Cavaliers,M. Shayok,3138201,,False,9.0,1,3,1,3,0,0,0,0,0,1,1,1,0,0,0,0,2
400945790,Virginia Cavaliers,D. Thompson,66274,,False,16.0,2,4,0,1,2,3,0,0,0,0,0,1,0,0,0,1,6
400945790,Virginia Cavaliers,TEAM,TOTAL,TOTAL,False,,24,49,13,27,11,22,16,19,7,23,30,16,2,1,8,19,75
400945790,Pittsburgh Panthers,M. Young,66290,,True,33.0,3,12,3,6,0,6,8,11,2,4,6,2,0,0,4,2,14
400945790,Pittsburgh Panthers,S. Jeter,61756,,True,31.0,2,5,1,1,1,4,0,2,2,5,7,1,2,2,0,2,5
400945790,Pittsburgh Panthers,J. Artis,66287,,True,37.0,6,9,2,3,4,6,2,2,0,3,3,1,0,0,0,3,18
400945790,Pittsburgh Panthers,C. Johnson,3138196,,True,34.0,6,11,2,4,4,7,4,4,0,2,2,1,0,0,2,3,20
400945790,Pittsburgh Panthers,C. Jones,61219,,True,34.0,1,4,0,1,1,3,3,4,0,3,3,2,0,1,0,2,6
400945790,Pittsburgh Panthers,R. Nix,3934653,,False,5.0,0,0,0,0,0,0,0,0,0,0,0,0,0,0,0,1,0
400945790,Pittsburgh Panthers,C. Manigault,4065714,,False,1.0,0,1,0,1,0,0,0,0,1,0,1,0,0,0,0,0,0
400945790,Pittsburgh Panthers,R. Luther,3138197,,False,13.0,0,1,0,0,0,1,0,0,0,3,3,1,0,0,2,1,0
400945790,Pittsburgh Panthers,J. Milligan,3934655,,False,8.0,0,1,0,0,0,1,0,0,0,0,0,0,0,0,2,2,0
400945790,Pittsburgh Panthers,Z. Smith,3934654,,False,0.0,0,1,0,0,0,1,0,0,0,0,0,0,0,0,0,0,0
400945790,Pittsburgh Panthers,D. Wilson,3934652,,False,4.0,0,0,0,0,0,0,0,0,0,0,0,0,0,0,0,0,0
400945790,Pittsburgh Panthers,TEAM,TOTAL,TOTAL,False,,18,45,8,16,10,29,17,23,7,20,27,8,2,3,10,16,63
400945790,Pittsburgh Panthers,M. Young,66290,,True,33.0,3,12,3,6,0,6,8,11,2,4,6,2,0,0,4,2,14
400945790,Pittsburgh Panthers,S. Jeter,61756,,True,31.0,2,5,1,1,1,4,0,2,2,5,7,1,2,2,0,2,5
400945790,Pittsburgh Panthers,J. Artis,66287,,True,37.0,6,9,2,3,4,6,2,2,0,3,3,1,0,0,0,3,18
400945790,Pittsburgh Panthers,C. Johnson,3138196,,True,34.0,6,11,2,4,4,7,4,4,0,2,2,1,0,0,2,3,20
400945790,Pittsburgh Panthers,C. Jones,61219,,True,34.0,1,4,0,1,1,3,3,4,0,3,3,2,0,1,0,2,6
400945790,Pittsburgh Panthers,R. Nix,3934653,,False,5.0,0,0,0,0,0,0,0,0,0,0,0,0,0,0,0,1,0
400945790,Pittsburgh Panthers,C. Manigault,4065714,,False,1.0,0,1,0,1,0,0,0,0,1,0,1,0,0,0,0,0,0
400945790,Pittsburgh Panthers,R. Luther,3138197,,False,13.0,0,1,0,0,0,1,0,0,0,3,3,1,0,0,2,1,0
400945790,Pittsburgh Panthers,J. Milligan,3934655,,False,8.0,0,1,0,0,0,1,0,0,0,0,0,0,0,0,2,2,0
400945790,Pittsburgh Panthers,Z. Smith,3934654,,False,0.0,0,1,0,0,0,1,0,0,0,0,0,0,0,0,0,0,0
400945790,Pittsburgh Panthers,D. Wilson,3934652,,False,4.0,0,0,0,0,0,0,0,0,0,0,0,0,0,0,0,0,0
400945790,Pittsburgh Panthers,TEAM,TOTAL,TOTAL,False,,18,45,8,16,10,29,17,23,7,20,27,8,2,3,10,16,63
400945789,Duke Blue Devils,J. Tatum,4065648,,True,39.0,7,15,6,8,1,7,5,5,1,8,9,4,0,0,2,3,20
400945789,Duke Blue Devils,A. Jefferson,61586,,True,31.0,4,7,4,7,0,0,3,4,4,6,10,1,1,2,0,4,11
400945789,Duke Blue Devils,F. Jackson,4065651,,True,35.0,7,10,5,8,2,2,4,7,0,3,3,1,1,0,3,2,20
400945789,Duke Blue Devils,L. Kennard,3913174,,True,39.0,9,20,7,12,2,8,0,0,1,4,5,2,1,0,1,2,20
400945789,Duke Blue Devils,M. Jones,66563,,True,34.0,2,4,2,2,0,2,2,2,1,1,2,1,3,0,2,2,6
400945789,Duke Blue Devils,H. Giles III,4065649,,False,5.0,1,1,1,1,0,0,0,0,0,1,1,0,0,0,0,3,2
400945789,Duke Blue Devils,M. Bolden,4065652,,False,3.0,0,0,0,0,0,0,0,0,0,0,0,0,0,0,1,0,0
400945789,Duke Blue Devils,A. Vrankovic,3913177,,False,2.0,0,0,0,0,0,0,0,0,0,1,1,0,0,0,0,0,0
400945789,Duke Blue Devils,G. Allen,3135045,,False,12.0,0,4,0,2,0,2,0,0,1,0,1,1,0,0,0,3,0
400945789,Duke Blue Devils,TEAM,TOTAL,TOTAL,False,,30,61,25,40,5,21,14,18,9,24,33,10,6,2,9,19,79
400945789,Duke Blue Devils,J. Tatum,4065648,,True,39.0,7,15,6,8,1,7,5,5,1,8,9,4,0,0,2,3,20
400945789,Duke Blue Devils,A. Jefferson,61586,,True,31.0,4,7,4,7,0,0,3,4,4,6,10,1,1,2,0,4,11
400945789,Duke Blue Devils,F. Jackson,4065651,,True,35.0,7,10,5,8,2,2,4,7,0,3,3,1,1,0,3,2,20
400945789,Duke Blue Devils,L. Kennard,3913174,,True,39.0,9,20,7,12,2,8,0,0,1,4,5,2,1,0,1,2,20
400945789,Duke Blue Devils,M. Jones,66563,,True,34.0,2,4,2,2,0,2,2,2,1,1,2,1,3,0,2,2,6
400945789,Duke Blue Devils,H. Giles III,4065649,,False,5.0,1,1,1,1,0,0,0,0,0,1,1,0,0,0,0,3,2
400945789,Duke Blue Devils,M. Bolden,4065652,,False,3.0,0,0,0,0,0,0,0,0,0,0,0,0,0,0,1,0,0
400945789,Duke Blue Devils,A. Vrankovic,3913177,,False,2.0,0,0,0,0,0,0,0,0,0,1,1,0,0,0,0,0,0
400945789,Duke Blue Devils,G. Allen,3135045,,False,12.0,0,4,0,2,0,2,0,0,1,0,1,1,0,0,0,3,0
400945789,Duke Blue Devils,TEAM,TOTAL,TOTAL,False,,30,61,25,40,5,21,14,18,9,24,33,10,6,2,9,19,79
400945789,Clemson Tigers,D. Grantham,3129674,,True,19.0,0,1,0,0,0,1,0,0,0,2,2,0,0,0,1,0,0
400945789,Clemson Tigers,J. Blossomgame,61835,,True,36.0,7,11,7,10,0,1,5,5,2,6,8,1,0,0,6,1,19
400945789,Clemson Tigers,S. Djitte,66122,,True,25.0,2,4,2,4,0,0,6,8,3,7,10,1,0,0,1,4,10
400945789,Clemson Tigers,S. Mitchell,3136699,,True,33.0,5,10,2,7,3,3,4,4,0,1,1,3,2,0,3,1,17
400945789,Clemson Tigers,A. Holmes,62043,,True,18.0,0,3,0,1,0,2,0,0,0,3,3,1,0,0,0,1,0
400945789,Clemson Tigers,E. Thomas,3947075,,False,15.0,3,9,3,9,0,0,2,2,2,2,4,0,0,1,2,5,8
400945789,Clemson Tigers,M. Reed,3133969,,False,27.0,3,12,3,7,0,5,7,7,0,1,1,2,2,0,0,4,13
400945789,Clemson Tigers,G. DeVoe,3129673,,False,27.0,2,6,1,2,1,4,0,0,0,2,2,1,1,0,0,2,5
400945789,Clemson Tigers,TEAM,TOTAL,TOTAL,False,,22,56,18,40,4,16,24,26,10,25,35,9,5,1,13,18,72
400945789,Clemson Tigers,D. Grantham,3129674,,True,19.0,0,1,0,0,0,1,0,0,0,2,2,0,0,0,1,0,0
400945789,Clemson Tigers,J. Blossomgame,61835,,True,36.0,7,11,7,10,0,1,5,5,2,6,8,1,0,0,6,1,19
400945789,Clemson Tigers,S. Djitte,66122,,True,25.0,2,4,2,4,0,0,6,8,3,7,10,1,0,0,1,4,10
400945789,Clemson Tigers,S. Mitchell,3136699,,True,33.0,5,10,2,7,3,3,4,4,0,1,1,3,2,0,3,1,17
400945789,Clemson Tigers,A. Holmes,62043,,True,18.0,0,3,0,1,0,2,0,0,0,3,3,1,0,0,0,1,0
400945789,Clemson Tigers,E. Thomas,3947075,,False,15.0,3,9,3,9,0,0,2,2,2,2,4,0,0,1,2,5,8
400945789,Clemson Tigers,M. Reed,3133969,,False,27.0,3,12,3,7,0,5,7,7,0,1,1,2,2,0,0,4,13
400945789,Clemson Tigers,G. DeVoe,3129673,,False,27.0,2,6,1,2,1,4,0,0,0,2,2,1,1,0,0,2,5
400945789,Clemson Tigers,TEAM,TOTAL,TOTAL,False,,22,56,18,40,4,16,24,26,10,25,35,9,5,1,13,18,72
400945580,Syracuse Orange,T. Thompson,4065721,,True,18.0,3,6,3,5,0,1,0,0,1,2,3,0,1,2,1,0,6
400945580,Syracuse Orange,T. Lydon,3934662,,True,40.0,2,7,1,4,1,3,0,0,2,10,12,4,0,2,1,3,5
400945580,Syracuse Orange,A. White III,61616,,True,40.0,6,12,5,6,1,6,9,10,0,5,5,1,2,0,0,3,22
400945580,Syracuse Orange,T. Battle,4065722,,True,40.0,4,9,1,3,3,6,3,3,0,1,1,3,1,0,3,3,14
400945580,Syracuse Orange,J. Gillon,61915,,True,38.0,3,9,1,4,2,5,0,0,0,0,0,2,2,0,3,3,8
400945580,Syracuse Orange,T. Roberson,67633,,False,22.0,1,1,1,1,0,0,0,0,1,2,3,0,0,0,1,1,2
400945580,Syracuse Orange,F. Howard,3934659,,False,2.0,0,0,0,0,0,0,0,0,0,0,0,0,0,0,0,0,0
400945580,Syracuse Orange,TEAM,TOTAL,TOTAL,False,,19,44,12,23,7,21,12,13,4,22,26,10,6,4,10,13,57
400945580,Syracuse Orange,T. Thompson,4065721,,True,18.0,3,6,3,5,0,1,0,0,1,2,3,0,1,2,1,0,6
400945580,Syracuse Orange,T. Lydon,3934662,,True,40.0,2,7,1,4,1,3,0,0,2,10,12,4,0,2,1,3,5
400945580,Syracuse Orange,A. White III,61616,,True,40.0,6,12,5,6,1,6,9,10,0,5,5,1,2,0,0,3,22
400945580,Syracuse Orange,T. Battle,4065722,,True,40.0,4,9,1,3,3,6,3,3,0,1,1,3,1,0,3,3,14
400945580,Syracuse Orange,J. Gillon,61915,,True,38.0,3,9,1,4,2,5,0,0,0,0,0,2,2,0,3,3,8
400945580,Syracuse Orange,T. Roberson,67633,,False,22.0,1,1,1,1,0,0,0,0,1,2,3,0,0,0,1,1,2
400945580,Syracuse Orange,F. Howard,3934659,,False,2.0,0,0,0,0,0,0,0,0,0,0,0,0,0,0,0,0,0
400945580,Syracuse Orange,TEAM,TOTAL,TOTAL,False,,19,44,12,23,7,21,12,13,4,22,26,10,6,4,10,13,57
400945580,Miami Hurricanes,K. Murphy,61668,,True,36.0,6,13,6,13,0,0,4,4,5,5,10,1,0,0,1,2,16
400945580,Miami Hurricanes,A. Lawrence II,3904628,,True,30.0,1,3,0,1,1,2,0,0,1,1,2,4,0,0,3,3,3
400945580,Miami Hurricanes,B. Brown,4065670,,True,28.0,1,6,0,1,1,5,2,2,0,5,5,1,1,0,1,2,5
400945580,Miami Hurricanes,J. Newton,3138145,,True,33.0,5,9,4,7,1,2,0,0,0,4,4,6,1,0,1,1,11
400945580,Miami Hurricanes,D. Reed,66130,,True,37.0,5,11,2,4,3,7,1,2,0,4,4,0,1,1,1,3,14
400945580,Miami Hurricanes,E. Izundu,3904629,,False,12.0,0,0,0,0,0,0,0,2,1,0,1,0,0,1,0,1,0
400945580,Miami Hurricanes,D. Vasiljevic,4065669,,False,22.0,4,9,1,2,3,7,2,2,0,1,1,1,1,0,0,3,13
400945580,Miami Hurricanes,M. Robinson,3947140,,False,2.0,0,0,0,0,0,0,0,0,0,0,0,0,0,0,0,0,0
400945580,Miami Hurricanes,TEAM,TOTAL,TOTAL,False,,22,51,13,28,9,23,9,12,9,22,31,13,4,2,8,15,62
400945580,Miami Hurricanes,K. Murphy,61668,,True,36.0,6,13,6,13,0,0,4,4,5,5,10,1,0,0,1,2,16
400945580,Miami Hurricanes,A. Lawrence II,3904628,,True,30.0,1,3,0,1,1,2,0,0,1,1,2,4,0,0,3,3,3
400945580,Miami Hurricanes,B. Brown,4065670,,True,28.0,1,6,0,1,1,5,2,2,0,5,5,1,1,0,1,2,5
400945580,Miami Hurricanes,J. Newton,3138145,,True,33.0,5,9,4,7,1,2,0,0,0,4,4,6,1,0,1,1,11
400945580,Miami Hurricanes,D. Reed,66130,,True,37.0,5,11,2,4,3,7,1,2,0,4,4,0,1,1,1,3,14
400945580,Miami Hurricanes,E. Izundu,3904629,,False,12.0,0,0,0,0,0,0,0,2,1,0,1,0,0,1,0,1,0
400945580,Miami Hurricanes,D. Vasiljevic,4065669,,False,22.0,4,9,1,2,3,7,2,2,0,1,1,1,1,0,0,3,13
400945580,Miami Hurricanes,M. Robinson,3947140,,False,2.0,0,0,0,0,0,0,0,0,0,0,0,0,0,0,0,0,0
400945580,Miami Hurricanes,TEAM,TOTAL,TOTAL,False,,22,51,13,28,9,23,9,12,9,22,31,13,4,2,8,15,62
400945579,Pittsburgh Panthers,M. Young,66290,,True,36.0,7,16,6,13,1,3,2,2,2,4,6,3,2,1,1,1,17
400945579,Pittsburgh Panthers,S. Jeter,61756,,True,34.0,6,11,5,7,1,4,1,1,5,3,8,0,0,1,2,1,14
400945579,Pittsburgh Panthers,J. Artis,66287,,True,38.0,3,12,2,4,1,8,4,5,1,8,9,4,0,2,3,3,11
400945579,Pittsburgh Panthers,C. Johnson,3138196,,True,26.0,1,4,1,2,0,2,3,5,0,5,5,4,0,0,1,4,5
400945579,Pittsburgh Panthers,C. Jones,61219,,True,36.0,3,6,1,4,2,2,3,4,0,4,4,2,0,0,4,2,11
400945579,Pittsburgh Panthers,R. Luther,3138197,,False,9.0,0,0,0,0,0,0,0,0,0,1,1,1,0,0,2,2,0
400945579,Pittsburgh Panthers,J. Milligan,3934655,,False,19.0,1,5,0,1,1,4,0,0,0,0,0,1,0,0,0,4,3
400945579,Pittsburgh Panthers,D. Wilson,3934652,,False,2.0,0,0,0,0,0,0,0,0,0,0,0,0,0,0,0,1,0
400945579,Pittsburgh Panthers,TEAM,TOTAL,TOTAL,False,,21,54,15,31,6,23,13,17,8,30,38,15,2,4,13,18,61
400945579,Pittsburgh Panthers,M. Young,66290,,True,36.0,7,16,6,13,1,3,2,2,2,4,6,3,2,1,1,1,17
400945579,Pittsburgh Panthers,S. Jeter,61756,,True,34.0,6,11,5,7,1,4,1,1,5,3,8,0,0,1,2,1,14
400945579,Pittsburgh Panthers,J. Artis,66287,,True,38.0,3,12,2,4,1,8,4,5,1,8,9,4,0,2,3,3,11
400945579,Pittsburgh Panthers,C. Johnson,3138196,,True,26.0,1,4,1,2,0,2,3,5,0,5,5,4,0,0,1,4,5
400945579,Pittsburgh Panthers,C. Jones,61219,,True,36.0,3,6,1,4,2,2,3,4,0,4,4,2,0,0,4,2,11
400945579,Pittsburgh Panthers,R. Luther,3138197,,False,9.0,0,0,0,0,0,0,0,0,0,1,1,1,0,0,2,2,0
400945579,Pittsburgh Panthers,J. Milligan,3934655,,False,19.0,1,5,0,1,1,4,0,0,0,0,0,1,0,0,0,4,3
400945579,Pittsburgh Panthers,D. Wilson,3934652,,False,2.0,0,0,0,0,0,0,0,0,0,0,0,0,0,0,0,1,0
400945579,Pittsburgh Panthers,TEAM,TOTAL,TOTAL,False,,21,54,15,31,6,23,13,17,8,30,38,15,2,4,13,18,61
400945579,Georgia Tech Yellow Jackets,Q. Stephens,66128,,True,35.0,5,15,2,5,3,10,3,5,4,6,10,0,2,0,1,3,16
400945579,Georgia Tech Yellow Jackets,B. Lammers,3135061,,True,40.0,3,9,3,9,0,0,0,0,6,9,15,2,1,1,1,2,6
400945579,Georgia Tech Yellow Jackets,J. Okogie,4065663,,True,27.0,4,11,4,10,0,1,7,9,1,4,5,2,1,1,1,4,15
400945579,Georgia Tech Yellow Jackets,T. Jackson,3135057,,True,35.0,8,21,8,16,0,5,1,3,0,3,3,1,1,0,1,3,17
400945579,Georgia Tech Yellow Jackets,J. Heath,67623,,True,40.0,2,5,1,3,1,2,0,0,0,4,4,4,2,0,3,2,5
400945579,Georgia Tech Yellow Jackets,J. Moore,4065662,,False,20.0,0,0,0,0,0,0,0,0,0,0,0,0,0,0,0,1,0
400945579,Georgia Tech Yellow Jackets,C. Heyward,61609,,False,3.0,0,1,0,1,0,0,0,0,0,1,1,0,0,0,0,1,0
400945579,Georgia Tech Yellow Jackets,TEAM,TOTAL,TOTAL,False,,22,62,18,44,4,18,11,17,12,28,40,9,7,2,7,16,59
400945579,Georgia Tech Yellow Jackets,Q. Stephens,66128,,True,35.0,5,15,2,5,3,10,3,5,4,6,10,0,2,0,1,3,16
400945579,Georgia Tech Yellow Jackets,B. Lammers,3135061,,True,40.0,3,9,3,9,0,0,0,0,6,9,15,2,1,1,1,2,6
400945579,Georgia Tech Yellow Jackets,J. Okogie,4065663,,True,27.0,4,11,4,10,0,1,7,9,1,4,5,2,1,1,1,4,15
400945579,Georgia Tech Yellow Jackets,T. Jackson,3135057,,True,35.0,8,21,8,16,0,5,1,3,0,3,3,1,1,0,1,3,17
400945579,Georgia Tech Yellow Jackets,J. Heath,67623,,True,40.0,2,5,1,3,1,2,0,0,0,4,4,4,2,0,3,2,5
400945579,Georgia Tech Yellow Jackets,J. Moore,4065662,,False,20.0,0,0,0,0,0,0,0,0,0,0,0,0,0,0,0,1,0
400945579,Georgia Tech Yellow Jackets,C. Heyward,61609,,False,3.0,0,1,0,1,0,0,0,0,0,1,1,0,0,0,0,1,0
400945579,Georgia Tech Yellow Jackets,TEAM,TOTAL,TOTAL,False,,22,62,18,44,4,18,11,17,12,28,40,9,7,2,7,16,59
400945578,Wake Forest Demon Deacons,J. Collins,3908845,,True,35.0,4,8,4,8,0,0,11,15,1,11,12,1,1,1,2,2,19
400945578,Wake Forest Demon Deacons,D. Mitoglou,3138224,,True,17.0,2,4,1,1,1,3,1,3,1,7,8,1,2,0,1,3,6
400945578,Wake Forest Demon Deacons,A. Arians,61378,,True,19.0,5,8,0,1,5,7,2,2,0,0,0,1,0,0,0,3,17
400945578,Wake Forest Demon Deacons,B. Crawford,3908844,,True,32.0,4,7,3,5,1,2,11,12,1,3,4,6,1,0,2,3,20
400945578,Wake Forest Demon Deacons,K. Woods,3132360,,True,31.0,6,11,5,6,1,5,4,5,0,2,2,3,2,0,2,2,17
400945578,Wake Forest Demon Deacons,R. Washington,4065753,,False,1.0,0,0,0,0,0,0,0,0,0,0,0,0,0,0,0,0,0
400945578,Wake Forest Demon Deacons,D. Mitchell,4065751,,False,1.0,0,0,0,0,0,0,1,2,0,1,1,0,0,0,0,0,1
400945578,Wake Forest Demon Deacons,T. Rike,3155405,,False,1.0,0,0,0,0,0,0,0,0,0,1,1,0,0,0,0,1,0
400945578,Wake Forest Demon Deacons,G. McClinton,66140,,False,6.0,2,3,2,3,0,0,0,0,2,0,2,0,0,1,1,0,4
400945578,Wake Forest Demon Deacons,S. Japhet-Mathias,4065752,,False,1.0,0,0,0,0,0,0,0,0,0,0,0,0,0,0,0,0,0
400945578,Wake Forest Demon Deacons,D. Moore,3908843,,False,3.0,0,0,0,0,0,0,0,0,0,2,2,0,0,0,0,2,0
400945578,Wake Forest Demon Deacons,B. Childress,4065750,,False,27.0,1,3,0,2,1,1,2,2,0,1,1,0,0,0,2,4,5
400945578,Wake Forest Demon Deacons,M. Wilbekin,3138222,,False,24.0,1,3,1,2,0,1,1,2,0,1,1,2,1,0,2,2,3
400945578,Wake Forest Demon Deacons,T. VanHorn,3078214,,False,2.0,0,0,0,0,0,0,0,0,0,0,0,0,0,0,0,0,0
400945578,Wake Forest Demon Deacons,TEAM,TOTAL,TOTAL,False,,25,47,16,28,9,19,33,43,7,30,37,14,7,2,13,22,92
400945578,Wake Forest Demon Deacons,J. Collins,3908845,,True,35.0,4,8,4,8,0,0,11,15,1,11,12,1,1,1,2,2,19
400945578,Wake Forest Demon Deacons,D. Mitoglou,3138224,,True,17.0,2,4,1,1,1,3,1,3,1,7,8,1,2,0,1,3,6
400945578,Wake Forest Demon Deacons,A. Arians,61378,,True,19.0,5,8,0,1,5,7,2,2,0,0,0,1,0,0,0,3,17
400945578,Wake Forest Demon Deacons,B. Crawford,3908844,,True,32.0,4,7,3,5,1,2,11,12,1,3,4,6,1,0,2,3,20
400945578,Wake Forest Demon Deacons,K. Woods,3132360,,True,31.0,6,11,5,6,1,5,4,5,0,2,2,3,2,0,2,2,17
400945578,Wake Forest Demon Deacons,R. Washington,4065753,,False,1.0,0,0,0,0,0,0,0,0,0,0,0,0,0,0,0,0,0
400945578,Wake Forest Demon Deacons,D. Mitchell,4065751,,False,1.0,0,0,0,0,0,0,1,2,0,1,1,0,0,0,0,0,1
400945578,Wake Forest Demon Deacons,T. Rike,3155405,,False,1.0,0,0,0,0,0,0,0,0,0,1,1,0,0,0,0,1,0
400945578,Wake Forest Demon Deacons,G. McClinton,66140,,False,6.0,2,3,2,3,0,0,0,0,2,0,2,0,0,1,1,0,4
400945578,Wake Forest Demon Deacons,S. Japhet-Mathias,4065752,,False,1.0,0,0,0,0,0,0,0,0,0,0,0,0,0,0,0,0,0
400945578,Wake Forest Demon Deacons,D. Moore,3908843,,False,3.0,0,0,0,0,0,0,0,0,0,2,2,0,0,0,0,2,0
400945578,Wake Forest Demon Deacons,B. Childress,4065750,,False,27.0,1,3,0,2,1,1,2,2,0,1,1,0,0,0,2,4,5
400945578,Wake Forest Demon Deacons,M. Wilbekin,3138222,,False,24.0,1,3,1,2,0,1,1,2,0,1,1,2,1,0,2,2,3
400945578,Wake Forest Demon Deacons,T. VanHorn,3078214,,False,2.0,0,0,0,0,0,0,0,0,0,0,0,0,0,0,0,0,0
400945578,Wake Forest Demon Deacons,TEAM,TOTAL,TOTAL,False,,25,47,16,28,9,19,33,43,7,30,37,14,7,2,13,22,92
400945578,Boston College Eagles,A.J. Turner,3943608,,True,29.0,1,5,1,5,0,0,1,2,1,1,2,1,1,0,0,1,3
400945578,Boston College Eagles,G. Owens,66277,,True,19.0,4,5,4,4,0,1,0,1,3,3,6,1,0,0,1,3,8
400945578,Boston College Eagles,M. Jeffers,61901,,True,13.0,2,6,2,6,0,0,0,0,2,1,3,0,0,0,0,5,4
400945578,Boston College Eagles,K. Bowman,4065635,,True,14.0,3,6,2,5,1,1,0,0,0,1,1,2,0,1,1,0,7
400945578,Boston College Eagles,J. Robinson,3943606,,True,37.0,4,15,2,7,2,8,7,8,0,2,2,5,3,0,5,3,17
400945578,Boston College Eagles,J. Reyes,3943609,,False,14.0,3,6,3,6,0,0,4,6,1,1,2,0,2,1,0,4,10
400945578,Boston College Eagles,M. Sagay,4065638,,False,2.0,1,2,1,2,0,0,0,1,0,1,1,0,0,0,0,0,2
400945578,Boston College Eagles,N. Popovic,4065637,,False,8.0,3,5,3,5,0,0,0,0,0,1,1,0,0,1,1,5,6
400945578,Boston College Eagles,A. Ghebremichael,3951741,,False,1.0,0,0,0,0,0,0,0,0,0,1,1,0,0,0,0,0,0
400945578,Boston College Eagles,C. Tava,61446,,False,26.0,2,6,1,2,1,4,2,4,2,4,6,1,1,1,0,4,7
400945578,Boston College Eagles,M. DiLuccio,4073353,,False,1.0,0,0,0,0,0,0,0,0,0,0,0,0,0,0,0,0,0
400945578,Boston College Eagles,J. Chatman,3135095,,False,36.0,4,8,2,4,2,4,4,4,1,6,7,3,1,0,2,3,14
400945578,Boston College Eagles,TEAM,TOTAL,TOTAL,False,,27,64,21,46,6,18,18,26,13,24,37,13,8,4,10,28,78
400945578,Boston College Eagles,A.J. Turner,3943608,,True,29.0,1,5,1,5,0,0,1,2,1,1,2,1,1,0,0,1,3
400945578,Boston College Eagles,G. Owens,66277,,True,19.0,4,5,4,4,0,1,0,1,3,3,6,1,0,0,1,3,8
400945578,Boston College Eagles,M. Jeffers,61901,,True,13.0,2,6,2,6,0,0,0,0,2,1,3,0,0,0,0,5,4
400945578,Boston College Eagles,K. Bowman,4065635,,True,14.0,3,6,2,5,1,1,0,0,0,1,1,2,0,1,1,0,7
400945578,Boston College Eagles,J. Robinson,3943606,,True,37.0,4,15,2,7,2,8,7,8,0,2,2,5,3,0,5,3,17
400945578,Boston College Eagles,J. Reyes,3943609,,False,14.0,3,6,3,6,0,0,4,6,1,1,2,0,2,1,0,4,10
400945578,Boston College Eagles,M. Sagay,4065638,,False,2.0,1,2,1,2,0,0,0,1,0,1,1,0,0,0,0,0,2
400945578,Boston College Eagles,N. Popovic,4065637,,False,8.0,3,5,3,5,0,0,0,0,0,1,1,0,0,1,1,5,6
400945578,Boston College Eagles,A. Ghebremichael,3951741,,False,1.0,0,0,0,0,0,0,0,0,0,1,1,0,0,0,0,0,0
400945578,Boston College Eagles,C. Tava,61446,,False,26.0,2,6,1,2,1,4,2,4,2,4,6,1,1,1,0,4,7
400945578,Boston College Eagles,M. DiLuccio,4073353,,False,1.0,0,0,0,0,0,0,0,0,0,0,0,0,0,0,0,0,0
400945578,Boston College Eagles,J. Chatman,3135095,,False,36.0,4,8,2,4,2,4,4,4,1,6,7,3,1,0,2,3,14
400945578,Boston College Eagles,TEAM,TOTAL,TOTAL,False,,27,64,21,46,6,18,18,26,13,24,37,13,8,4,10,28,78
400945577,NC State Wolfpack,T. Kapita,4065701,,True,20.0,2,2,2,2,0,0,3,4,2,2,4,0,0,0,3,3,7
400945577,NC State Wolfpack,A. Abu,3138158,,True,33.0,5,15,5,15,0,0,4,7,0,8,8,0,0,1,1,3,14
400945577,NC State Wolfpack,D. Smith Jr.,4065697,,True,36.0,3,12,3,8,0,4,1,2,2,6,8,3,2,1,4,2,7
400945577,NC State Wolfpack,M. Rowan,3947151,,True,36.0,4,8,1,2,3,6,3,4,0,2,2,0,0,0,2,3,14
400945577,NC State Wolfpack,T. Henderson,61215,,True,26.0,2,6,1,2,1,4,5,7,2,3,5,2,0,1,1,2,10
400945577,NC State Wolfpack,B. Anya,66134,,False,5.0,0,0,0,0,0,0,0,0,1,0,1,0,0,0,0,1,0
400945577,NC State Wolfpack,O. Yurtseven,66768,,False,7.0,0,1,0,1,0,0,2,2,1,1,2,0,0,1,1,3,2
400945577,NC State Wolfpack,S. Kirk,3947150,,False,4.0,0,0,0,0,0,0,0,0,0,2,2,0,0,0,0,1,0
400945577,NC State Wolfpack,T. Dorn,3132359,,False,33.0,3,6,2,3,1,3,0,0,1,2,3,2,0,0,2,2,7
400945577,NC State Wolfpack,TEAM,TOTAL,TOTAL,False,,19,50,14,33,5,17,18,26,11,27,38,7,2,4,15,20,61
400945577,NC State Wolfpack,T. Kapita,4065701,,True,20.0,2,2,2,2,0,0,3,4,2,2,4,0,0,0,3,3,7
400945577,NC State Wolfpack,A. Abu,3138158,,True,33.0,5,15,5,15,0,0,4,7,0,8,8,0,0,1,1,3,14
400945577,NC State Wolfpack,D. Smith Jr.,4065697,,True,36.0,3,12,3,8,0,4,1,2,2,6,8,3,2,1,4,2,7
400945577,NC State Wolfpack,M. Rowan,3947151,,True,36.0,4,8,1,2,3,6,3,4,0,2,2,0,0,0,2,3,14
400945577,NC State Wolfpack,T. Henderson,61215,,True,26.0,2,6,1,2,1,4,5,7,2,3,5,2,0,1,1,2,10
400945577,NC State Wolfpack,B. Anya,66134,,False,5.0,0,0,0,0,0,0,0,0,1,0,1,0,0,0,0,1,0
400945577,NC State Wolfpack,O. Yurtseven,66768,,False,7.0,0,1,0,1,0,0,2,2,1,1,2,0,0,1,1,3,2
400945577,NC State Wolfpack,S. Kirk,3947150,,False,4.0,0,0,0,0,0,0,0,0,0,2,2,0,0,0,0,1,0
400945577,NC State Wolfpack,T. Dorn,3132359,,False,33.0,3,6,2,3,1,3,0,0,1,2,3,2,0,0,2,2,7
400945577,NC State Wolfpack,TEAM,TOTAL,TOTAL,False,,19,50,14,33,5,17,18,26,11,27,38,7,2,4,15,20,61
400945577,Clemson Tigers,D. Grantham,3129674,,True,28.0,1,3,1,1,0,2,0,0,0,3,3,0,0,0,0,2,2
400945577,Clemson Tigers,J. Blossomgame,61835,,True,32.0,9,17,8,13,1,4,3,5,1,3,4,1,1,0,1,3,22
400945577,Clemson Tigers,S. Djitte,66122,,True,29.0,2,9,2,9,0,0,2,3,6,7,13,0,1,2,2,3,6
400945577,Clemson Tigers,S. Mitchell,3136699,,True,32.0,8,13,5,8,3,5,3,5,0,3,3,6,1,0,3,1,22
400945577,Clemson Tigers,A. Holmes,62043,,True,20.0,3,7,1,2,2,5,0,0,0,1,1,1,1,0,0,2,8
400945577,Clemson Tigers,E. Thomas,3947075,,False,16.0,5,10,5,10,0,0,0,0,2,2,4,0,0,1,0,4,10
400945577,Clemson Tigers,M. Reed,3133969,,False,22.0,1,6,0,4,1,2,2,2,1,2,3,3,2,0,2,2,5
400945577,Clemson Tigers,G. DeVoe,3129673,,False,21.0,0,3,0,0,0,3,0,0,0,3,3,2,0,0,0,0,0
400945577,Clemson Tigers,TEAM,TOTAL,TOTAL,False,,29,68,22,47,7,21,10,15,17,25,42,13,6,3,9,17,75
400945577,Clemson Tigers,D. Grantham,3129674,,True,28.0,1,3,1,1,0,2,0,0,0,3,3,0,0,0,0,2,2
400945577,Clemson Tigers,J. Blossomgame,61835,,True,32.0,9,17,8,13,1,4,3,5,1,3,4,1,1,0,1,3,22
400945577,Clemson Tigers,S. Djitte,66122,,True,29.0,2,9,2,9,0,0,2,3,6,7,13,0,1,2,2,3,6
400945577,Clemson Tigers,S. Mitchell,3136699,,True,32.0,8,13,5,8,3,5,3,5,0,3,3,6,1,0,3,1,22
400945577,Clemson Tigers,A. Holmes,62043,,True,20.0,3,7,1,2,2,5,0,0,0,1,1,1,1,0,0,2,8
400945577,Clemson Tigers,E. Thomas,3947075,,False,16.0,5,10,5,10,0,0,0,0,2,2,4,0,0,1,0,4,10
400945577,Clemson Tigers,M. Reed,3133969,,False,22.0,1,6,0,4,1,2,2,2,1,2,3,3,2,0,2,2,5
400945577,Clemson Tigers,G. DeVoe,3129673,,False,21.0,0,3,0,0,0,3,0,0,0,3,3,2,0,0,0,0,0
400945577,Clemson Tigers,TEAM,TOTAL,TOTAL,False,,29,68,22,47,7,21,10,15,17,25,42,13,6,3,9,17,75
400941113,Notre Dame Fighting Irish,B. Colson,3138192,,True,34.0,5,11,4,9,1,2,6,8,3,7,10,3,0,3,2,4,17
400941113,Notre Dame Fighting Irish,A. Torres,66286,,True,5.0,0,0,0,0,0,0,0,0,0,2,2,0,0,0,0,0,0
400941113,Notre Dame Fighting Irish,V.J. Beachem,66283,,True,34.0,6,12,4,5,2,7,6,6,0,1,1,0,1,1,0,4,20
400941113,Notre Dame Fighting Irish,M. Farrell,3138190,,True,37.0,7,12,3,4,4,8,0,0,0,3,3,3,0,0,3,2,18
400941113,Notre Dame Fighting Irish,S. Vasturia,66285,,True,38.0,4,11,4,7,0,4,1,2,1,1,2,4,0,1,3,4,9
400941113,Notre Dame Fighting Irish,J. Mooney,4065705,,False,1.0,0,0,0,0,0,0,0,0,0,0,0,0,0,0,0,0,0
400941113,Notre Dame Fighting Irish,E. Burns,3908337,,False,1.0,0,0,0,0,0,0,0,0,0,0,0,0,0,0,0,0,0
400941113,Notre Dame Fighting Irish,M. Geben,3138191,,False,8.0,1,2,1,2,0,0,0,0,1,1,2,2,0,0,0,4,2
400941113,Notre Dame Fighting Irish,M. Ryan,3908336,,False,1.0,0,0,0,0,0,0,0,0,0,0,0,0,0,0,0,0,0
400941113,Notre Dame Fighting Irish,T. Gibbs,4065703,,False,18.0,0,3,0,2,0,1,4,4,0,0,0,1,0,0,0,2,4
400941113,Notre Dame Fighting Irish,R. Pflueger,3908335,,False,23.0,2,5,0,1,2,4,0,0,1,1,2,1,0,1,1,1,6
400941113,Notre Dame Fighting Irish,TEAM,TOTAL,TOTAL,False,,25,56,16,30,9,26,17,20,7,18,25,14,1,6,9,21,76
400941113,Notre Dame Fighting Irish,B. Colson,3138192,,True,34.0,5,11,4,9,1,2,6,8,3,7,10,3,0,3,2,4,17
400941113,Notre Dame Fighting Irish,A. Torres,66286,,True,5.0,0,0,0,0,0,0,0,0,0,2,2,0,0,0,0,0,0
400941113,Notre Dame Fighting Irish,V.J. Beachem,66283,,True,34.0,6,12,4,5,2,7,6,6,0,1,1,0,1,1,0,4,20
400941113,Notre Dame Fighting Irish,M. Farrell,3138190,,True,37.0,7,12,3,4,4,8,0,0,0,3,3,3,0,0,3,2,18
400941113,Notre Dame Fighting Irish,S. Vasturia,66285,,True,38.0,4,11,4,7,0,4,1,2,1,1,2,4,0,1,3,4,9
400941113,Notre Dame Fighting Irish,J. Mooney,4065705,,False,1.0,0,0,0,0,0,0,0,0,0,0,0,0,0,0,0,0,0
400941113,Notre Dame Fighting Irish,E. Burns,3908337,,False,1.0,0,0,0,0,0,0,0,0,0,0,0,0,0,0,0,0,0
400941113,Notre Dame Fighting Irish,M. Geben,3138191,,False,8.0,1,2,1,2,0,0,0,0,1,1,2,2,0,0,0,4,2
400941113,Notre Dame Fighting Irish,M. Ryan,3908336,,False,1.0,0,0,0,0,0,0,0,0,0,0,0,0,0,0,0,0,0
400941113,Notre Dame Fighting Irish,T. Gibbs,4065703,,False,18.0,0,3,0,2,0,1,4,4,0,0,0,1,0,0,0,2,4
400941113,Notre Dame Fighting Irish,R. Pflueger,3908335,,False,23.0,2,5,0,1,2,4,0,0,1,1,2,1,0,1,1,1,6
400941113,Notre Dame Fighting Irish,TEAM,TOTAL,TOTAL,False,,25,56,16,30,9,26,17,20,7,18,25,14,1,6,9,21,76
400941113,North Carolina Tar Heels,J. Jackson,3138156,,True,37.0,6,15,4,8,2,7,2,4,1,3,4,3,0,0,1,2,16
400941113,North Carolina Tar Heels,I. Hicks,66874,,True,33.0,6,10,6,10,0,0,2,3,1,6,7,1,0,1,3,3,14
400941113,North Carolina Tar Heels,K. Meeks,66873,,True,16.0,4,6,4,6,0,0,3,6,3,5,8,0,1,1,2,5,11
400941113,North Carolina Tar Heels,K. Williams,3911619,,True,26.0,4,6,1,2,3,4,0,0,1,2,3,3,0,0,0,4,11
400941113,North Carolina Tar Heels,J. Berry II,3138155,,True,33.0,3,10,2,5,1,5,5,7,1,4,5,7,3,0,4,3,12
400941113,North Carolina Tar Heels,T. Bradley,4065673,,False,17.0,5,7,5,7,0,0,2,3,3,2,5,1,0,3,0,3,12
400941113,North Carolina Tar Heels,L. Maye,3911620,,False,9.0,2,3,2,3,0,0,2,3,2,1,3,1,1,0,0,1,6
400941113,North Carolina Tar Heels,S. Woods,4065676,,False,3.0,0,0,0,0,0,0,0,0,0,1,1,1,1,0,0,0,0
400941113,North Carolina Tar Heels,B. Robinson,4065675,,False,3.0,0,1,0,1,0,0,0,0,1,0,1,1,0,1,0,0,0
400941113,North Carolina Tar Heels,N. Britt,66872,,False,23.0,0,3,0,2,0,1,1,2,0,1,1,5,1,0,1,1,1
400941113,North Carolina Tar Heels,TEAM,TOTAL,TOTAL,False,,30,61,24,44,6,17,17,28,17,27,44,23,7,6,11,22,83
400941113,North Carolina Tar Heels,J. Jackson,3138156,,True,37.0,6,15,4,8,2,7,2,4,1,3,4,3,0,0,1,2,16
400941113,North Carolina Tar Heels,I. Hicks,66874,,True,33.0,6,10,6,10,0,0,2,3,1,6,7,1,0,1,3,3,14
400941113,North Carolina Tar Heels,K. Meeks,66873,,True,16.0,4,6,4,6,0,0,3,6,3,5,8,0,1,1,2,5,11
400941113,North Carolina Tar Heels,K. Williams,3911619,,True,26.0,4,6,1,2,3,4,0,0,1,2,3,3,0,0,0,4,11
400941113,North Carolina Tar Heels,J. Berry II,3138155,,True,33.0,3,10,2,5,1,5,5,7,1,4,5,7,3,0,4,3,12
400941113,North Carolina Tar Heels,T. Bradley,4065673,,False,17.0,5,7,5,7,0,0,2,3,3,2,5,1,0,3,0,3,12
400941113,North Carolina Tar Heels,L. Maye,3911620,,False,9.0,2,3,2,3,0,0,2,3,2,1,3,1,1,0,0,1,6
400941113,North Carolina Tar Heels,S. Woods,4065676,,False,3.0,0,0,0,0,0,0,0,0,0,1,1,1,1,0,0,0,0
400941113,North Carolina Tar Heels,B. Robinson,4065675,,False,3.0,0,1,0,1,0,0,0,0,1,0,1,1,0,1,0,0,0
400941113,North Carolina Tar Heels,N. Britt,66872,,False,23.0,0,3,0,2,0,1,1,2,0,1,1,5,1,0,1,1,1
400941113,North Carolina Tar Heels,TEAM,TOTAL,TOTAL,False,,30,61,24,44,6,17,17,28,17,27,44,23,7,6,11,22,83
400933455,North Carolina Tar Heels,J. Jackson,3138156,,True,23.0,7,15,1,4,6,11,1,2,1,3,4,2,0,0,0,0,21
400933455,North Carolina Tar Heels,I. Hicks,66874,,True,17.0,5,9,5,9,0,0,1,1,3,1,4,0,1,1,2,1,11
400933455,North Carolina Tar Heels,K. Meeks,66873,,True,21.0,3,7,3,7,0,0,3,4,2,3,5,1,3,0,1,0,9
400933455,North Carolina Tar Heels,K. Williams,3911619,,True,20.0,4,7,3,3,1,4,0,0,1,0,1,1,2,0,0,0,9
400933455,North Carolina Tar Heels,J. Berry II,3138155,,True,23.0,6,10,3,3,3,7,4,4,0,5,5,5,2,0,3,1,19
400933455,North Carolina Tar Heels,A. Rohlman,4065677,,False,4.0,0,0,0,0,0,0,0,0,0,2,2,0,0,0,0,0,0
400933455,North Carolina Tar Heels,S. Rush,4065674,,False,4.0,0,3,0,2,0,1,0,0,0,0,0,0,1,0,0,0,0
400933455,North Carolina Tar Heels,T. Bradley,4065673,,False,14.0,4,6,4,6,0,0,3,4,4,4,8,0,0,0,2,3,11
400933455,North Carolina Tar Heels,L. Maye,3911620,,False,19.0,4,9,3,8,1,1,0,1,4,4,8,1,1,0,1,2,9
400933455,North Carolina Tar Heels,T. Pinson,3138154,,False,13.0,0,3,0,2,0,1,0,1,1,4,5,5,4,0,0,2,0
400933455,North Carolina Tar Heels,S. Woods,4065676,,False,15.0,1,2,1,2,0,0,4,6,0,3,3,4,1,0,2,0,6
400933455,North Carolina Tar Heels,B. Robinson,4065675,,False,6.0,3,4,3,4,0,0,0,0,1,0,1,0,1,0,1,1,6
400933455,North Carolina Tar Heels,K. Coker,3947144,,False,2.0,0,0,0,0,0,0,0,0,0,0,0,0,0,0,0,0,0
400933455,North Carolina Tar Heels,N. Britt,66872,,False,15.0,2,3,1,1,1,2,0,0,0,3,3,2,1,0,0,2,5
400933455,North Carolina Tar Heels,S. White,56963,,False,4.0,0,1,0,1,0,0,1,2,0,1,1,0,0,0,0,1,1
400933455,North Carolina Tar Heels,TEAM,TOTAL,TOTAL,False,,39,79,27,52,12,27,17,25,17,33,50,21,17,1,12,13,107
400933455,North Carolina Tar Heels,J. Jackson,3138156,,True,23.0,7,15,1,4,6,11,1,2,1,3,4,2,0,0,0,0,21
400933455,North Carolina Tar Heels,I. Hicks,66874,,True,17.0,5,9,5,9,0,0,1,1,3,1,4,0,1,1,2,1,11
400933455,North Carolina Tar Heels,K. Meeks,66873,,True,21.0,3,7,3,7,0,0,3,4,2,3,5,1,3,0,1,0,9
400933455,North Carolina Tar Heels,K. Williams,3911619,,True,20.0,4,7,3,3,1,4,0,0,1,0,1,1,2,0,0,0,9
400933455,North Carolina Tar Heels,J. Berry II,3138155,,True,23.0,6,10,3,3,3,7,4,4,0,5,5,5,2,0,3,1,19
400933455,North Carolina Tar Heels,A. Rohlman,4065677,,False,4.0,0,0,0,0,0,0,0,0,0,2,2,0,0,0,0,0,0
400933455,North Carolina Tar Heels,S. Rush,4065674,,False,4.0,0,3,0,2,0,1,0,0,0,0,0,0,1,0,0,0,0
400933455,North Carolina Tar Heels,T. Bradley,4065673,,False,14.0,4,6,4,6,0,0,3,4,4,4,8,0,0,0,2,3,11
400933455,North Carolina Tar Heels,L. Maye,3911620,,False,19.0,4,9,3,8,1,1,0,1,4,4,8,1,1,0,1,2,9
400933455,North Carolina Tar Heels,T. Pinson,3138154,,False,13.0,0,3,0,2,0,1,0,1,1,4,5,5,4,0,0,2,0
400933455,North Carolina Tar Heels,S. Woods,4065676,,False,15.0,1,2,1,2,0,0,4,6,0,3,3,4,1,0,2,0,6
400933455,North Carolina Tar Heels,B. Robinson,4065675,,False,6.0,3,4,3,4,0,0,0,0,1,0,1,0,1,0,1,1,6
400933455,North Carolina Tar Heels,K. Coker,3947144,,False,2.0,0,0,0,0,0,0,0,0,0,0,0,0,0,0,0,0,0
400933455,North Carolina Tar Heels,N. Britt,66872,,False,15.0,2,3,1,1,1,2,0,0,0,3,3,2,1,0,0,2,5
400933455,North Carolina Tar Heels,S. White,56963,,False,4.0,0,1,0,1,0,0,1,2,0,1,1,0,0,0,0,1,1
400933455,North Carolina Tar Heels,TEAM,TOTAL,TOTAL,False,,39,79,27,52,12,27,17,25,17,33,50,21,17,1,12,13,107
400933455,NC State Wolfpack,A. Abu,3138158,,True,35.0,4,11,4,11,0,0,0,0,4,5,9,0,0,2,5,4,8
400933455,NC State Wolfpack,O. Yurtseven,66768,,True,26.0,1,5,1,5,0,0,0,0,2,6,8,0,0,0,1,4,2
400933455,NC State Wolfpack,D. Smith Jr.,4065697,,True,26.0,4,11,2,5,2,6,1,1,0,5,5,5,3,0,6,3,11
400933455,NC State Wolfpack,T. Dorn,3132359,,True,24.0,4,10,3,7,1,3,2,6,2,4,6,1,0,0,3,0,11
400933455,NC State Wolfpack,T. Henderson,61215,,True,30.0,2,6,2,2,0,4,0,2,0,1,1,2,1,0,3,1,4
400933455,NC State Wolfpack,T. Kapita,4065701,,False,3.0,0,2,0,2,0,0,0,0,1,0,1,0,0,0,0,0,0
400933455,NC State Wolfpack,D. Hicks,4065698,,False,3.0,0,0,0,0,0,0,0,0,0,0,0,0,0,0,0,0,0
400933455,NC State Wolfpack,B. Anya,66134,,False,13.0,2,3,2,3,0,0,0,2,1,2,3,0,0,1,2,5,4
400933455,NC State Wolfpack,M. Johnson,4065699,,False,19.0,2,6,1,2,1,4,0,0,0,1,1,0,2,0,2,1,5
400933455,NC State Wolfpack,M. Rowan,3947151,,False,19.0,4,8,1,3,3,5,0,0,0,1,1,0,1,0,2,0,11
400933455,NC State Wolfpack,S. Kirk,3947150,,False,2.0,0,1,0,0,0,1,0,0,0,0,0,0,0,0,0,0,0
400933455,NC State Wolfpack,TEAM,TOTAL,TOTAL,False,,23,63,16,40,7,23,3,11,10,26,36,8,7,3,26,18,56
400933455,NC State Wolfpack,A. Abu,3138158,,True,35.0,4,11,4,11,0,0,0,0,4,5,9,0,0,2,5,4,8
400933455,NC State Wolfpack,O. Yurtseven,66768,,True,26.0,1,5,1,5,0,0,0,0,2,6,8,0,0,0,1,4,2
400933455,NC State Wolfpack,D. Smith Jr.,4065697,,True,26.0,4,11,2,5,2,6,1,1,0,5,5,5,3,0,6,3,11
400933455,NC State Wolfpack,T. Dorn,3132359,,True,24.0,4,10,3,7,1,3,2,6,2,4,6,1,0,0,3,0,11
400933455,NC State Wolfpack,T. Henderson,61215,,True,30.0,2,6,2,2,0,4,0,2,0,1,1,2,1,0,3,1,4
400933455,NC State Wolfpack,T. Kapita,4065701,,False,3.0,0,2,0,2,0,0,0,0,1,0,1,0,0,0,0,0,0
400933455,NC State Wolfpack,D. Hicks,4065698,,False,3.0,0,0,0,0,0,0,0,0,0,0,0,0,0,0,0,0,0
400933455,NC State Wolfpack,B. Anya,66134,,False,13.0,2,3,2,3,0,0,0,2,1,2,3,0,0,1,2,5,4
400933455,NC State Wolfpack,M. Johnson,4065699,,False,19.0,2,6,1,2,1,4,0,0,0,1,1,0,2,0,2,1,5
400933455,NC State Wolfpack,M. Rowan,3947151,,False,19.0,4,8,1,3,3,5,0,0,0,1,1,0,1,0,2,0,11
400933455,NC State Wolfpack,S. Kirk,3947150,,False,2.0,0,1,0,0,0,1,0,0,0,0,0,0,0,0,0,0,0
400933455,NC State Wolfpack,TEAM,TOTAL,TOTAL,False,,23,63,16,40,7,23,3,11,10,26,36,8,7,3,26,18,56
400927028,Virginia Tech Hokies,K. Sy,4065740,,True,11.0,0,2,0,2,0,0,0,0,1,1,2,0,0,0,0,1,0
400927028,Virginia Tech Hokies,C. Clarke,3945567,,True,23.0,2,2,1,1,1,1,2,3,0,4,4,1,0,0,1,2,7
400927028,Virginia Tech Hokies,J. Robinson,3945566,,True,37.0,3,7,1,3,2,4,0,0,1,3,4,5,0,0,6,3,8
400927028,Virginia Tech Hokies,A. Hill,3147501,,True,34.0,3,8,2,5,1,3,5,6,0,1,1,1,0,0,2,4,12
400927028,Virginia Tech Hokies,J. Bibbs,3147500,,True,27.0,2,5,0,2,2,3,2,2,0,3,3,0,0,0,1,1,8
400927028,Virginia Tech Hokies,Z. LeDay,61698,,False,34.0,7,18,7,15,0,3,5,9,3,6,9,4,1,3,1,4,19
400927028,Virginia Tech Hokies,T. Outlaw,67275,,False,12.0,1,2,0,0,1,2,0,0,0,2,2,0,0,0,1,2,3
400927028,Virginia Tech Hokies,S. Allen,61795,,False,22.0,3,6,2,4,1,2,2,2,0,4,4,4,2,0,5,2,9
400927028,Virginia Tech Hokies,TEAM,TOTAL,TOTAL,False,,21,50,13,32,8,18,16,22,10,28,38,15,3,3,17,19,66
400927028,Nebraska Cornhuskers,E. Morrow,3911896,,True,26.0,5,9,5,9,0,0,3,4,6,1,7,0,0,0,4,3,13
400927028,Nebraska Cornhuskers,M. Jacobson,3911895,,True,31.0,0,6,0,4,0,2,2,2,2,4,6,0,2,2,0,3,2
400927028,Nebraska Cornhuskers,J. McVeigh,3911893,,True,23.0,2,9,1,2,1,7,0,0,0,3,3,2,0,0,0,2,5
400927028,Nebraska Cornhuskers,G. Watson Jr.,3911892,,True,36.0,1,11,1,7,0,4,0,0,1,4,5,3,5,0,1,1,2
400927028,Nebraska Cornhuskers,T. Webster,67619,,True,34.0,6,11,5,7,1,4,10,12,2,6,8,2,0,1,2,2,23
400927028,Nebraska Cornhuskers,I. Roby,4066392,,False,12.0,0,2,0,1,0,1,0,0,0,0,0,1,1,0,2,3,0
400927028,Nebraska Cornhuskers,J. Horne,4066390,,False,4.0,0,0,0,0,0,0,0,0,0,1,1,0,0,0,1,1,0
400927028,Nebraska Cornhuskers,N. Fuller,67616,,False,2.0,0,0,0,0,0,0,0,0,0,0,0,0,0,0,0,1,0
400927028,Nebraska Cornhuskers,J. Tshimanga,4066393,,False,5.0,0,2,0,2,0,0,0,0,1,2,3,0,0,1,2,2,0
400927028,Nebraska Cornhuskers,E. Taylor,3137222,,False,11.0,1,1,1,1,0,0,0,0,0,0,0,0,1,0,2,2,2
400927028,Nebraska Cornhuskers,A. Gill,66588,,False,16.0,2,6,0,3,2,3,0,0,0,2,2,0,0,0,0,0,6
400927028,Nebraska Cornhuskers,TEAM,TOTAL,TOTAL,False,,17,57,13,36,4,21,15,18,14,23,37,8,9,4,14,20,53
400927021,Richmond Spiders,M. Wood,61769,,True,18.0,1,4,1,2,0,2,0,0,1,1,2,0,0,0,2,1,2
400927021,Richmond Spiders,T.J. Cline,61416,,True,34.0,10,17,9,14,1,3,2,3,0,10,10,1,1,0,2,0,23
400927021,Richmond Spiders,J. Johnson,3908871,,True,30.0,5,6,4,4,1,2,1,1,1,5,6,2,0,0,2,3,12
400927021,Richmond Spiders,K. Fore,3133847,,True,35.0,4,9,4,9,0,0,1,3,0,2,2,1,2,1,0,2,9
400927021,Richmond Spiders,S. Jones,66407,,True,33.0,5,12,4,6,1,6,6,6,0,1,1,2,2,0,2,1,17
400927021,Richmond Spiders,G. Golden,4066836,,False,4.0,1,1,1,1,0,0,0,0,0,0,0,1,0,0,0,1,2
400927021,Richmond Spiders,K. Abakah,61999,,False,9.0,0,1,0,1,0,0,0,0,1,0,1,0,0,0,0,2,0
400927021,Richmond Spiders,D. Buckingham,4066833,,False,24.0,0,0,0,0,0,0,2,2,1,5,6,1,1,3,2,3,2
400927021,Richmond Spiders,N. Sherod,4066832,,False,13.0,0,4,0,1,0,3,0,0,0,3,3,1,1,0,0,0,0
400927021,Richmond Spiders,TEAM,TOTAL,TOTAL,False,,26,54,23,38,3,16,12,15,6,28,34,9,7,4,12,13,67
400927021,Boston College Eagles,A.J. Turner,3943608,,True,32.0,4,12,3,6,1,6,1,1,3,4,7,2,0,1,2,0,10
400927021,Boston College Eagles,M. Jeffers,61901,,True,11.0,0,1,0,1,0,0,0,2,0,2,2,0,0,0,2,3,0
400927021,Boston College Eagles,C. Tava,61446,,True,30.0,1,4,1,4,0,0,3,6,3,4,7,5,0,0,0,4,5
400927021,Boston College Eagles,K. Bowman,4065635,,True,19.0,3,6,3,4,0,2,2,2,0,2,2,1,3,0,3,2,8
400927021,Boston College Eagles,J. Robinson,3943606,,True,35.0,10,20,4,11,6,9,1,1,0,3,3,1,2,1,4,3,27
400927021,Boston College Eagles,J. Reyes,3943609,,False,18.0,1,1,1,1,0,0,0,0,0,4,4,0,1,1,1,1,2
400927021,Boston College Eagles,E. Meznieks,3943607,,False,3.0,0,1,0,1,0,0,0,0,0,0,0,0,0,0,2,0,0
400927021,Boston College Eagles,G. Owens,66277,,False,18.0,1,4,1,3,0,1,0,0,1,1,2,0,0,0,0,0,2
400927021,Boston College Eagles,T. Graves,4065636,,False,21.0,0,2,0,1,0,1,0,0,0,1,1,1,0,0,1,1,0
400927021,Boston College Eagles,J. Chatman,3135095,,False,13.0,0,5,0,2,0,3,0,0,1,3,4,0,0,0,1,1,0
400927021,Boston College Eagles,TEAM,TOTAL,TOTAL,False,,20,56,13,34,7,22,7,12,10,25,35,10,6,3,16,15,54
400927017,Virginia Cavaliers,I. Wilkins,3138203,,True,27.0,4,4,4,4,0,0,1,2,1,1,2,1,3,2,3,2,9
400927017,Virginia Cavaliers,J. Salt,3138200,,True,27.0,4,6,4,6,0,0,0,2,1,5,6,0,0,1,0,1,8
400927017,Virginia Cavaliers,D. Thompson,66274,,True,23.0,4,6,4,5,0,1,3,6,0,2,2,2,1,0,0,2,11
400927017,Virginia Cavaliers,L. Perrantes,66139,,True,34.0,4,8,1,3,3,5,0,0,0,8,8,5,1,0,1,1,11
400927017,Virginia Cavaliers,D. Hall,66138,,True,25.0,1,2,1,2,0,0,2,2,0,4,4,1,0,0,1,3,4
400927017,Virginia Cavaliers,M. Diakite,3947156,,False,17.0,4,6,2,3,2,3,0,0,0,0,0,0,0,3,0,3,10
400927017,Virginia Cavaliers,J. Reuter,3908374,,False,9.0,2,4,2,4,0,0,1,2,0,0,0,0,1,0,1,3,5
400927017,Virginia Cavaliers,T. Jerome,4065733,,False,6.0,0,0,0,0,0,0,0,0,0,1,1,2,0,0,0,2,0
400927017,Virginia Cavaliers,K. Guy,4065730,,False,14.0,2,2,2,2,0,0,0,0,0,0,0,1,1,0,0,1,4
400927017,Virginia Cavaliers,M. Shayok,3138201,,False,18.0,0,4,0,3,0,1,1,2,0,1,1,3,1,0,1,0,1
400927017,Virginia Cavaliers,TEAM,TOTAL,TOTAL,False,,25,42,20,32,5,10,8,16,3,22,25,15,8,6,7,18,63
400927017,Providence Friars,E. Holt,3147674,,True,34.0,3,7,2,5,1,2,4,4,3,3,6,1,2,1,1,3,11
400927017,Providence Friars,R. Bullock,66482,,True,37.0,3,13,1,6,2,7,8,8,0,6,6,2,0,1,2,0,16
400927017,Providence Friars,R. Fazekas,3913218,,True,16.0,0,0,0,0,0,0,0,0,0,0,0,1,1,0,0,2,0
400927017,Providence Friars,J. Lindsey,3136472,,True,35.0,6,11,2,5,4,6,2,3,2,0,2,0,0,0,1,2,18
400927017,Providence Friars,K. Cartwright,3136470,,True,35.0,3,6,2,5,1,1,0,2,0,1,1,7,0,0,4,3,7
400927017,Providence Friars,K. Young,4065814,,False,6.0,0,0,0,0,0,0,0,0,0,0,0,0,0,0,0,2,0
400927017,Providence Friars,A. Diallo,4065813,,False,21.0,0,2,0,2,0,0,0,0,0,2,2,0,0,0,0,4,0
400927017,Providence Friars,M. White,4065812,,False,6.0,0,1,0,1,0,0,0,0,0,0,0,1,0,0,2,2,0
400927017,Providence Friars,D. Edwards,3913217,,False,2.0,0,0,0,0,0,0,0,0,0,0,0,0,0,0,0,0,0
400927017,Providence Friars,I. Jackson,3133821,,False,8.0,0,0,0,0,0,0,0,0,0,1,1,0,0,0,0,1,0
400927017,Providence Friars,TEAM,TOTAL,TOTAL,False,,15,40,7,24,8,16,14,17,6,18,24,12,3,2,10,19,52
400926753,Louisville Cardinals,M. Mathiang,63035,,True,19.0,0,3,0,3,0,0,0,0,3,2,5,1,1,1,0,3,0
400926753,Louisville Cardinals,D. Adel,3908807,,True,30.0,1,9,1,7,0,2,2,2,1,4,5,1,1,0,1,4,4
400926753,Louisville Cardinals,J. Johnson,3147362,,True,29.0,5,9,5,9,0,0,0,0,5,1,6,0,0,0,1,2,10
400926753,Louisville Cardinals,D. Mitchell,3908809,,True,36.0,6,11,4,6,2,5,3,4,2,6,8,4,1,0,4,3,17
400926753,Louisville Cardinals,Q. Snider,3147360,,True,34.0,6,17,4,9,2,8,0,0,0,2,2,3,0,0,0,1,14
400926753,Louisville Cardinals,V.J. King,4065666,,False,12.0,2,5,1,4,1,1,0,0,0,2,2,0,0,0,1,0,5
400926753,Louisville Cardinals,R. Spalding,3908806,,False,16.0,3,6,3,5,0,1,0,0,2,2,4,0,0,0,0,1,6
400926753,Louisville Cardinals,A. Mahmoud,3147363,,False,14.0,1,1,1,1,0,0,0,0,0,0,0,2,1,1,0,3,2
400926753,Louisville Cardinals,M. Stockman,3147361,,False,1.0,0,1,0,1,0,0,1,2,1,0,1,0,0,0,0,1,1
400926753,Louisville Cardinals,R. McMahon,3908808,,False,1.0,0,1,0,0,0,1,2,2,0,0,0,0,0,0,0,0,2
400926753,Louisville Cardinals,J. Henderson,3155491,,False,1.0,0,0,0,0,0,0,0,0,0,0,0,0,0,0,0,0,0
400926753,Louisville Cardinals,D. Levitch,66592,,False,7.0,1,1,1,1,0,0,0,0,0,1,1,0,0,0,0,1,2
400926753,Louisville Cardinals,TEAM,TOTAL,TOTAL,False,,25,64,20,46,5,18,8,10,15,20,35,11,4,2,7,19,63
400926753,Baylor Bears,J. Lual-Acuil Jr.,3920136,,True,24.0,3,4,3,4,0,0,1,1,1,2,3,0,0,6,1,1,7
400926753,Baylor Bears,J. Motley,66298,,True,31.0,5,9,5,8,0,1,5,7,0,6,6,2,0,1,4,4,15
400926753,Baylor Bears,I. Wainright,66299,,True,30.0,0,3,0,0,0,3,0,0,1,7,8,5,0,0,1,3,0
400926753,Baylor Bears,A. Freeman,66297,,True,21.0,2,5,2,3,0,2,0,0,1,1,2,1,0,0,1,0,4
400926753,Baylor Bears,M. Lecomte,66131,,True,23.0,2,4,2,2,0,2,0,0,0,0,0,2,0,0,1,3,4
400926753,Baylor Bears,T. Maston,3149938,,False,25.0,5,10,5,10,0,0,2,2,1,4,5,1,1,0,1,1,12
400926753,Baylor Bears,K. McClure,3920139,,False,19.0,5,8,3,4,2,4,3,4,1,0,1,1,1,0,0,0,15
400926753,Baylor Bears,J. Lindsey,3920138,,False,23.0,4,4,4,4,0,0,0,0,0,2,2,5,2,0,0,0,8
400926753,Baylor Bears,W. Mitchell,3920137,,False,4.0,0,2,0,1,0,1,1,3,0,0,0,0,1,0,0,0,1
400926753,Baylor Bears,TEAM,TOTAL,TOTAL,False,,26,49,24,36,2,13,12,17,7,24,31,17,5,7,12,12,66
400926749,Wichita State Shockers,R. Kelly,3149001,,True,19.0,0,4,0,3,0,1,0,1,0,2,2,1,0,0,0,3,0
400926749,Wichita State Shockers,Z. Brown,3148998,,True,19.0,3,8,2,4,1,4,0,2,0,2,2,1,1,0,1,1,7
400926749,Wichita State Shockers,S. Morris,67751,,True,30.0,5,13,5,12,0,1,0,0,2,2,4,1,1,0,1,2,10
400926749,Wichita State Shockers,L. Shamet,3914044,,True,16.0,0,5,0,3,0,2,2,2,3,1,4,3,0,0,2,4,2
400926749,Wichita State Shockers,C. Frankamp,67434,,True,34.0,3,7,0,0,3,7,0,0,2,2,4,1,1,0,0,0,9
400926749,Wichita State Shockers,D. Willis Jr.,4066458,,False,12.0,1,4,1,4,0,0,1,2,1,3,4,1,1,0,2,4,3
400926749,Wichita State Shockers,M. McDuffie,3914047,,False,27.0,2,7,2,5,0,2,6,8,2,2,4,2,0,0,3,2,10
400926749,Wichita State Shockers,E. Hamilton,3914046,,False,2.0,0,1,0,1,0,0,0,2,0,0,0,0,0,0,0,0,0
400926749,Wichita State Shockers,R. Nurger,3149002,,False,14.0,1,1,1,1,0,0,1,1,1,4,5,0,0,0,1,1,3
400926749,Wichita State Shockers,A. Reaves,4066457,,False,14.0,2,6,1,2,1,4,0,0,0,2,2,1,0,0,1,0,5
400926749,Wichita State Shockers,D. Smith,4066454,,False,13.0,1,1,0,0,1,1,0,0,0,1,1,1,0,0,1,0,3
400926749,Wichita State Shockers,TEAM,TOTAL,TOTAL,False,,18,57,12,35,6,22,10,18,11,22,33,12,4,0,12,17,52
400926749,Louisville Cardinals,M. Mathiang,63035,,True,6.0,0,1,0,1,0,0,1,2,0,2,2,0,0,0,1,4,1
400926749,Louisville Cardinals,D. Adel,3908807,,True,21.0,3,6,0,2,3,4,2,2,0,2,2,1,0,0,1,5,11
400926749,Louisville Cardinals,J. Johnson,3147362,,True,14.0,0,1,0,1,0,0,1,2,1,5,6,0,0,0,0,3,1
400926749,Louisville Cardinals,D. Mitchell,3908809,,True,35.0,5,13,3,5,2,8,2,3,1,7,8,5,3,0,1,1,14
400926749,Louisville Cardinals,Q. Snider,3147360,,True,35.0,5,15,3,7,2,8,2,2,1,3,4,3,1,0,3,3,14
400926749,Louisville Cardinals,V.J. King,4065666,,False,20.0,2,8,2,5,0,3,6,8,2,2,4,0,0,0,3,1,10
400926749,Louisville Cardinals,R. Spalding,3908806,,False,25.0,2,5,2,5,0,0,0,0,3,6,9,1,0,2,1,3,4
400926749,Louisville Cardinals,A. Mahmoud,3147363,,False,31.0,1,1,1,1,0,0,3,4,2,3,5,1,0,6,3,2,5
400926749,Louisville Cardinals,M. Stockman,3147361,,False,3.0,0,0,0,0,0,0,0,0,0,1,1,0,0,0,0,0,0
400926749,Louisville Cardinals,R. McMahon,3908808,,False,2.0,0,1,0,0,0,1,0,0,0,1,1,0,0,0,1,0,0
400926749,Louisville Cardinals,D. Levitch,66592,,False,8.0,1,1,1,1,0,0,0,0,0,0,0,2,0,0,0,0,2
400926749,Louisville Cardinals,TEAM,TOTAL,TOTAL,False,,19,52,12,28,7,24,17,23,12,34,46,13,4,8,15,22,62
400926742,Virginia Tech Hokies,K. Sy,4065740,,True,9.0,1,2,1,2,0,0,0,0,1,2,3,0,0,0,0,3,2
400926742,Virginia Tech Hokies,C. Clarke,3945567,,True,24.0,1,6,1,5,0,1,1,2,2,7,9,3,1,0,2,2,3
400926742,Virginia Tech Hokies,J. Robinson,3945566,,True,36.0,4,10,3,7,1,3,5,6,0,1,1,5,0,0,2,1,14
400926742,Virginia Tech Hokies,A. Hill,3147501,,True,29.0,6,14,0,3,6,11,0,0,0,5,5,0,1,1,0,2,18
400926742,Virginia Tech Hokies,J. Bibbs,3147500,,True,28.0,0,4,0,2,0,2,2,2,0,1,1,2,1,0,0,1,2
400926742,Virginia Tech Hokies,Z. LeDay,61698,,False,35.0,4,11,4,9,0,2,0,0,2,3,5,0,1,1,1,3,8
400926742,Virginia Tech Hokies,T. Outlaw,67275,,False,11.0,2,3,0,0,2,3,2,2,0,1,1,0,0,0,0,1,8
400926742,Virginia Tech Hokies,S. Allen,61795,,False,28.0,4,10,2,4,2,6,0,1,0,2,2,2,0,0,2,0,10
400926742,Virginia Tech Hokies,TEAM,TOTAL,TOTAL,False,,22,60,11,32,11,28,10,13,6,24,30,12,4,2,7,13,65
400926742,Texas A&M Aggies,D.J. Hogg,3947073,,True,34.0,7,13,4,8,3,5,0,1,2,8,10,4,0,1,2,2,17
400926742,Texas A&M Aggies,T. Davis,3947078,,True,29.0,6,10,6,10,0,0,0,2,3,7,10,3,0,3,1,2,12
400926742,Texas A&M Aggies,T. Trocha-Morelos,3136625,,True,21.0,3,10,3,7,0,3,1,2,2,3,5,0,0,0,2,1,7
400926742,Texas A&M Aggies,A. Gilder,3947074,,True,37.0,6,12,5,8,1,4,1,2,1,2,3,7,1,0,3,4,14
400926742,Texas A&M Aggies,J. Hampton,62440,,True,22.0,0,5,0,2,0,3,0,0,0,4,4,1,0,0,2,2,0
400926742,Texas A&M Aggies,R. Williams III,4066211,,False,21.0,6,11,6,10,0,1,1,1,5,5,10,1,2,1,0,0,13
400926742,Texas A&M Aggies,E. Vila,4020938,,False,7.0,1,1,0,0,1,1,0,0,0,0,0,1,1,0,1,0,3
400926742,Texas A&M Aggies,T. Miller,66625,,False,10.0,1,1,1,1,0,0,0,0,0,3,3,0,0,0,0,0,2
400926742,Texas A&M Aggies,C. Smith,4066209,,False,6.0,0,0,0,0,0,0,0,0,0,1,1,0,0,0,1,1,0
400926742,Texas A&M Aggies,C. Collins,3155698,,False,13.0,0,2,0,0,0,2,0,0,0,1,1,0,0,0,1,1,0
400926742,Texas A&M Aggies,TEAM,TOTAL,TOTAL,False,,30,65,25,46,5,19,3,8,15,34,49,17,4,5,13,13,68
400926739,Illinois Fighting Illini,M. Finke,3131629,,True,21.0,0,4,0,2,0,2,2,2,4,2,6,0,0,0,0,1,2
400926739,Illinois Fighting Illini,M. Thorne Jr.,56783,,True,13.0,2,4,2,4,0,0,0,0,1,3,4,0,0,0,0,0,4
400926739,Illinois Fighting Illini,M. Hill,66179,,True,32.0,6,13,4,9,2,4,4,5,3,5,8,2,2,0,2,4,18
400926739,Illinois Fighting Illini,J. Tate,66178,,True,14.0,0,1,0,0,0,1,0,0,0,0,0,2,0,0,2,3,0
400926739,Illinois Fighting Illini,T. Abrams,56643,,True,26.0,1,7,0,3,1,4,2,2,0,1,1,1,0,0,2,2,5
400926739,Illinois Fighting Illini,L. Black,3131628,,False,24.0,4,9,4,8,0,1,7,8,4,7,11,0,0,0,1,2,15
400926739,Illinois Fighting Illini,M. Morgan,66180,,False,22.0,1,2,1,2,0,0,0,0,1,2,3,0,0,0,1,1,2
400926739,Illinois Fighting Illini,T. Lucas,4066357,,False,18.0,4,8,3,5,1,3,1,2,0,1,1,4,0,0,1,3,10
400926739,Illinois Fighting Illini,A. Jordan,3911843,,False,8.0,1,2,0,0,1,2,0,0,0,1,1,0,0,0,0,0,3
400926739,Illinois Fighting Illini,J. Coleman-Lands,3911842,,False,22.0,0,8,0,3,0,5,2,2,1,0,1,2,0,0,1,3,2
400926739,Illinois Fighting Illini,TEAM,TOTAL,TOTAL,False,,19,58,14,36,5,22,18,21,16,25,41,11,2,0,11,19,61
400926739,Florida State Seminoles,J. Isaac,4065654,,True,24.0,6,7,3,3,3,4,0,0,0,7,7,1,0,1,4,2,15
400926739,Florida State Seminoles,M. Ojo,61596,,True,22.0,1,2,1,2,0,0,0,0,3,3,6,0,0,1,0,3,2
400926739,Florida State Seminoles,T. Mann,3907823,,True,18.0,0,2,0,2,0,0,1,2,0,2,2,2,0,0,0,2,1
400926739,Florida State Seminoles,D. Bacon,3907821,,True,21.0,6,13,3,8,3,5,2,5,1,1,2,1,0,0,1,0,17
400926739,Florida State Seminoles,X. Rathan-Mayes,66125,,True,26.0,3,8,3,6,0,2,4,6,0,0,0,2,0,0,1,3,10
400926739,Florida State Seminoles,P. Cofer,3135054,,False,12.0,2,4,2,3,0,1,0,2,1,1,2,1,0,0,0,0,4
400926739,Florida State Seminoles,J. Smith,66126,,False,4.0,0,1,0,1,0,0,0,0,0,0,0,0,0,0,1,2,0
400926739,Florida State Seminoles,C. Koumadje,3907824,,False,12.0,0,1,0,1,0,0,0,0,0,1,1,0,0,4,1,2,0
400926739,Florida State Seminoles,B. Angola-Rodas,4065658,,False,10.0,1,3,0,2,1,1,0,0,0,1,1,2,0,0,0,0,3
400926739,Florida State Seminoles,T. Forrest,4065656,,False,26.0,2,5,2,5,0,0,3,3,2,3,5,2,4,1,1,1,7
400926739,Florida State Seminoles,C. Walker,4065655,,False,25.0,5,8,3,6,2,2,1,1,0,4,4,1,1,0,0,3,13
400926739,Florida State Seminoles,TEAM,TOTAL,TOTAL,False,,26,54,17,39,9,15,11,19,9,24,33,12,5,7,9,18,72
400926734,Notre Dame Fighting Irish,B. Colson,3138192,,True,38.0,4,13,3,10,1,3,4,6,4,7,11,2,1,0,0,1,13
400926734,Notre Dame Fighting Irish,M. Geben,3138191,,True,11.0,1,1,1,1,0,0,0,0,0,0,0,1,0,0,1,2,2
400926734,Notre Dame Fighting Irish,V.J. Beachem,66283,,True,35.0,3,11,2,7,1,4,4,7,1,1,2,0,1,1,1,1,11
400926734,Notre Dame Fighting Irish,M. Farrell,3138190,,True,34.0,5,11,3,7,2,4,6,6,1,2,3,6,1,0,1,2,18
400926734,Notre Dame Fighting Irish,S. Vasturia,66285,,True,35.0,6,11,3,6,3,5,3,3,1,7,8,3,3,0,2,2,18
400926734,Notre Dame Fighting Irish,A. Torres,66286,,False,8.0,2,2,2,2,0,0,1,2,0,0,0,0,0,0,0,0,5
400926734,Notre Dame Fighting Irish,M. Ryan,3908336,,False,10.0,1,2,0,0,1,2,0,0,0,0,0,0,0,0,1,0,3
400926734,Notre Dame Fighting Irish,T. Gibbs,4065703,,False,10.0,0,0,0,0,0,0,0,0,0,0,0,0,0,0,0,0,0
400926734,Notre Dame Fighting Irish,R. Pflueger,3908335,,False,19.0,0,2,0,2,0,0,0,0,1,1,2,1,0,0,0,3,0
400926734,Notre Dame Fighting Irish,TEAM,TOTAL,TOTAL,False,,22,53,14,35,8,18,18,24,9,18,27,13,6,1,6,11,70
400926734,Northwestern Wildcats,V. Law,3136746,,True,33.0,6,12,4,8,2,4,0,0,1,6,7,2,0,0,2,2,14
400926734,Northwestern Wildcats,B. McIntosh,3136749,,True,35.0,3,18,2,15,1,3,0,0,1,0,1,4,0,0,4,0,7
400926734,Northwestern Wildcats,D. Pardon,3913246,,True,35.0,3,4,3,4,0,0,0,0,2,4,6,3,2,6,0,2,6
400926734,Northwestern Wildcats,S. Lumpkin,61268,,True,17.0,1,1,1,1,0,0,0,0,1,3,4,1,0,0,1,3,2
400926734,Northwestern Wildcats,S. Lindsey,3136747,,True,28.0,6,8,3,5,3,3,3,4,2,2,4,3,0,0,1,3,18
400926734,Northwestern Wildcats,G. Skelly,3136750,,False,10.0,0,2,0,0,0,2,0,0,0,0,0,0,0,0,3,2,0
400926734,Northwestern Wildcats,N. Taphorn,66189,,False,21.0,4,6,0,1,4,5,0,0,2,3,5,1,0,0,2,1,12
400926734,Northwestern Wildcats,I. Brown,4066394,,False,12.0,0,1,0,1,0,0,4,4,0,2,2,0,0,0,1,3,4
400926734,Northwestern Wildcats,J. Ash,3913247,,False,9.0,1,2,0,0,1,2,0,0,0,3,3,1,0,0,0,1,3
400926734,Northwestern Wildcats,TEAM,TOTAL,TOTAL,False,,24,54,13,35,11,19,7,8,12,25,37,15,2,6,15,17,66
400926731,Miami Hurricanes,K. Murphy,61668,,True,36.0,1,5,1,5,0,0,0,0,2,8,10,1,0,1,2,1,2
400926731,Miami Hurricanes,B. Brown,4065670,,True,35.0,6,13,4,9,2,4,1,2,3,1,4,1,2,0,2,3,15
400926731,Miami Hurricanes,A. Lawrence II,3904628,,True,20.0,1,4,1,1,0,3,0,0,0,3,3,2,1,0,1,5,2
400926731,Miami Hurricanes,J. Newton,3138145,,True,38.0,6,15,6,14,0,1,3,3,2,1,3,1,1,0,4,0,15
400926731,Miami Hurricanes,D. Reed,66130,,True,37.0,5,14,3,9,2,5,0,2,2,3,5,2,0,0,2,2,12
400926731,Miami Hurricanes,D. Hernandez,4065672,,False,22.0,4,9,4,9,0,0,2,2,3,3,6,1,0,1,2,2,10
400926731,Miami Hurricanes,R. Miller Jr.,4065671,,False,1.0,0,0,0,0,0,0,0,0,0,0,0,0,0,0,0,0,0
400926731,Miami Hurricanes,E. Izundu,3904629,,False,2.0,0,0,0,0,0,0,0,0,0,0,0,0,0,0,0,2,0
400926731,Miami Hurricanes,D. Vasiljevic,4065669,,False,9.0,0,1,0,0,0,1,0,0,0,0,0,0,0,0,0,1,0
400926731,Miami Hurricanes,TEAM,TOTAL,TOTAL,False,,23,61,19,47,4,14,6,9,16,21,37,8,4,2,13,16,56
400926731,Florida Gators,J. Leon,3924899,,True,9.0,2,2,2,2,0,0,0,0,0,2,2,0,0,0,1,4,4
400926731,Florida Gators,D. Robinson,3137798,,True,30.0,5,9,5,7,0,2,0,0,1,4,5,1,2,3,1,0,10
400926731,Florida Gators,J. Egbunu,67622,,True,28.0,3,6,3,6,0,0,1,4,1,3,4,0,0,4,2,4,7
400926731,Florida Gators,K. Hill,66247,,True,31.0,4,7,4,7,0,0,8,10,0,2,2,3,2,0,1,1,16
400926731,Florida Gators,K. Allen,3924896,,True,24.0,4,11,3,8,1,3,0,0,0,2,2,1,1,0,0,1,9
400926731,Florida Gators,K. Stone,3924900,,False,25.0,5,8,3,6,2,2,3,4,4,4,8,0,1,1,1,1,15
400926731,Florida Gators,K. Hayes,3924898,,False,12.0,1,1,1,1,0,0,2,2,0,2,2,0,0,1,0,2,4
400926731,Florida Gators,E. Hester,4066256,,False,3.0,0,0,0,0,0,0,0,0,0,0,0,0,0,0,0,0,0
400926731,Florida Gators,C. Chiozza,3137795,,False,23.0,0,2,0,1,0,1,0,0,1,2,3,5,1,0,3,1,0
400926731,Florida Gators,C. Barry,61892,,False,15.0,0,6,0,5,0,1,0,0,1,1,2,1,2,2,0,1,0
400926731,Florida Gators,TEAM,TOTAL,TOTAL,False,,24,52,21,43,3,9,14,20,9,24,33,11,9,11,9,15,65
400926726,Miami Hurricanes,K. Murphy,61668,,True,32.0,1,5,1,5,0,0,2,2,2,10,12,0,0,0,4,3,4
400926726,Miami Hurricanes,E. Izundu,3904629,,True,9.0,0,0,0,0,0,0,0,0,1,2,3,0,0,1,1,1,0
400926726,Miami Hurricanes,A. Lawrence II,3904628,,True,24.0,1,6,1,4,0,2,4,5,0,2,2,0,1,0,2,4,6
400926726,Miami Hurricanes,J. Newton,3138145,,True,38.0,9,13,9,13,0,0,3,4,0,2,2,3,3,0,3,0,21
400926726,Miami Hurricanes,D. Reed,66130,,True,36.0,2,9,1,2,1,7,8,9,1,2,3,1,1,0,3,0,13
400926726,Miami Hurricanes,D. Hernandez,4065672,,False,24.0,2,5,2,5,0,0,1,2,2,4,6,0,0,1,1,4,5
400926726,Miami Hurricanes,B. Brown,4065670,,False,21.0,1,5,1,3,0,2,0,0,2,5,7,2,1,0,4,5,2
400926726,Miami Hurricanes,D. Vasiljevic,4065669,,False,16.0,2,7,1,2,1,5,0,0,0,0,0,0,1,0,1,1,5
400926726,Miami Hurricanes,TEAM,TOTAL,TOTAL,False,,18,50,16,34,2,16,18,22,8,29,37,6,7,2,19,18,56
400926726,Iowa State Cyclones,M. Holden,3132375,,True,20.0,1,3,1,3,0,0,4,6,4,2,6,0,1,0,0,5,6
400926726,Iowa State Cyclones,D. Burton,66167,,True,35.0,8,16,6,14,2,2,3,3,2,5,7,0,1,1,1,2,21
400926726,Iowa State Cyclones,M. Thomas,66147,,True,30.0,4,7,2,4,2,3,2,3,2,2,4,2,2,0,2,2,12
400926726,Iowa State Cyclones,M. Morris,66146,,True,22.0,2,8,2,7,0,1,2,2,0,2,2,5,0,0,2,3,6
400926726,Iowa State Cyclones,N. Mitrou-Long,61211,,True,35.0,4,13,2,4,2,9,0,0,0,5,5,3,1,0,2,1,10
400926726,Iowa State Cyclones,D. Bowie,62801,,False,17.0,3,5,3,5,0,0,0,0,0,5,5,0,1,0,1,4,6
400926726,Iowa State Cyclones,D. Jackson,4066294,,False,18.0,3,6,1,2,2,4,0,0,0,2,2,0,1,0,2,2,8
400926726,Iowa State Cyclones,N. Weiler-Babb,3136173,,False,23.0,0,3,0,3,0,0,4,4,0,2,2,0,3,0,0,2,4
400926726,Iowa State Cyclones,TEAM,TOTAL,TOTAL,False,,25,61,17,42,8,19,15,18,9,27,36,10,10,1,10,21,73
400926707,Wisconsin Badgers,E. Happ,3136996,,True,29.0,6,12,6,12,0,0,1,3,1,5,6,4,4,2,2,1,13
400926707,Wisconsin Badgers,V. Brown,66201,,True,24.0,5,6,1,1,4,5,1,2,2,1,3,0,1,0,1,4,15
400926707,Wisconsin Badgers,N. Hayes,66198,,True,34.0,3,11,2,4,1,7,1,2,0,5,5,1,1,0,2,2,8
400926707,Wisconsin Badgers,B. Koenig,66200,,True,28.0,1,13,1,8,0,5,0,0,0,0,0,1,1,1,3,0,2
400926707,Wisconsin Badgers,Z. Showalter,61279,,True,25.0,2,3,1,1,1,2,0,0,0,1,1,2,0,0,1,2,5
400926707,Wisconsin Badgers,A. Van Vliet,3919167,,False,4.0,0,1,0,0,0,1,0,0,0,1,1,0,0,1,0,0,0
400926707,Wisconsin Badgers,A. Illikainen,3908323,,False,14.0,0,0,0,0,0,0,0,0,0,0,0,1,0,0,0,0,0
400926707,Wisconsin Badgers,C. Thomas IV,3908321,,False,9.0,1,4,1,4,0,0,0,0,0,2,2,0,0,0,0,2,2
400926707,Wisconsin Badgers,A. Moesch,66197,,False,1.0,0,0,0,0,0,0,0,0,0,0,0,0,1,0,0,0,0
400926707,Wisconsin Badgers,D. Trice,4066413,,False,13.0,2,2,1,1,1,1,3,3,0,1,1,0,0,0,0,1,8
400926707,Wisconsin Badgers,K. Iverson,3908322,,False,11.0,0,2,0,2,0,0,0,0,1,5,6,0,0,1,1,0,0
400926707,Wisconsin Badgers,B. Pritzl,3908320,,False,1.0,1,1,0,0,1,1,0,0,0,0,0,0,0,0,0,0,3
400926707,Wisconsin Badgers,T.J. Schlundt,3136995,,False,1.0,0,0,0,0,0,0,0,0,0,0,0,0,0,0,0,0,0
400926707,Wisconsin Badgers,M. Ferris,3136994,,False,0.0,0,0,0,0,0,0,0,0,0,0,0,1,0,0,0,0,0
400926707,Wisconsin Badgers,J. Hill,66199,,False,6.0,0,0,0,0,0,0,0,0,0,0,0,2,0,0,0,0,0
400926707,Wisconsin Badgers,TEAM,TOTAL,TOTAL,False,,21,55,13,33,8,22,6,10,4,22,26,12,8,5,11,12,56
400926707,North Carolina Tar Heels,J. Jackson,3138156,,True,31.0,4,13,3,7,1,6,3,3,0,2,2,2,0,0,3,2,12
400926707,North Carolina Tar Heels,I. Hicks,66874,,True,30.0,6,10,6,10,0,0,2,2,1,4,5,2,0,0,2,3,14
400926707,North Carolina Tar Heels,K. Meeks,66873,,True,31.0,6,9,6,9,0,0,3,3,3,13,16,2,2,2,1,3,15
400926707,North Carolina Tar Heels,K. Williams,3911619,,True,22.0,0,1,0,0,0,1,0,0,0,3,3,0,0,0,0,1,0
400926707,North Carolina Tar Heels,J. Berry II,3138155,,True,34.0,9,12,7,9,2,3,2,2,0,3,3,3,0,0,2,2,22
400926707,North Carolina Tar Heels,A. Rohlman,4065677,,False,1.0,0,0,0,0,0,0,0,0,0,0,0,0,0,0,0,0,0
400926707,North Carolina Tar Heels,S. Rush,4065674,,False,1.0,1,1,1,1,0,0,0,0,0,0,0,0,0,0,0,0,2
400926707,North Carolina Tar Heels,T. Bradley,4065673,,False,16.0,2,5,2,5,0,0,2,2,1,2,3,0,0,0,0,0,6
400926707,North Carolina Tar Heels,S. Woods,4065676,,False,6.0,0,0,0,0,0,0,0,0,0,0,0,1,0,1,1,0,0
400926707,North Carolina Tar Heels,B. Robinson,4065675,,False,7.0,0,1,0,0,0,1,0,0,0,0,0,0,1,0,1,1,0
400926707,North Carolina Tar Heels,K. Coker,3947144,,False,1.0,0,0,0,0,0,0,0,0,0,0,0,0,0,0,0,0,0
400926707,North Carolina Tar Heels,N. Britt,66872,,False,18.0,0,5,0,4,0,1,0,0,0,2,2,0,0,0,2,1,0
400926707,North Carolina Tar Heels,S. White,56963,,False,2.0,0,0,0,0,0,0,0,0,0,0,0,0,0,0,0,0,0
400926707,North Carolina Tar Heels,TEAM,TOTAL,TOTAL,False,,28,57,25,45,3,12,12,12,7,31,38,10,3,3,12,13,71
400926705,Oklahoma State Cowboys,M. Solomon,3147618,,True,13.0,1,4,1,4,0,0,2,2,3,0,3,0,0,2,2,3,4
400926705,Oklahoma State Cowboys,L. Hammonds,66307,,True,15.0,2,9,2,7,0,2,2,2,2,2,4,0,0,1,3,5,6
400926705,Oklahoma State Cowboys,L. Waters III,4066317,,True,21.0,3,8,1,2,2,6,2,2,2,1,3,0,2,0,2,1,10
400926705,Oklahoma State Cowboys,J. Evans,3912854,,True,27.0,13,25,11,20,2,5,2,4,1,1,2,1,1,0,3,1,30
400926705,Oklahoma State Cowboys,P. Forte III,61667,,True,24.0,0,3,0,1,0,2,2,2,1,2,3,1,1,0,1,4,2
400926705,Oklahoma State Cowboys,C. McGriff,4066315,,False,26.0,0,3,0,2,0,1,2,2,2,0,2,1,0,0,2,3,2
400926705,Oklahoma State Cowboys,W. Lienhard,3951442,,False,3.0,1,2,1,2,0,0,0,0,0,1,1,0,0,0,0,1,2
400926705,Oklahoma State Cowboys,L. N'Guessan,4066316,,False,13.0,0,1,0,1,0,0,0,0,1,0,1,1,1,1,0,1,0
400926705,Oklahoma State Cowboys,T. Dziagwa,4066314,,False,6.0,1,2,0,0,1,2,2,2,1,2,3,0,0,0,0,0,5
400926705,Oklahoma State Cowboys,B. Averette,4066313,,False,11.0,2,5,2,5,0,0,1,2,0,0,0,1,1,0,1,2,5
400926705,Oklahoma State Cowboys,T. Underwood,3907342,,False,3.0,0,0,0,0,0,0,0,0,0,0,0,0,0,0,0,0,0
400926705,Oklahoma State Cowboys,T. Shine,3147617,,False,16.0,0,2,0,1,0,1,1,2,1,0,1,0,1,0,0,2,1
400926705,Oklahoma State Cowboys,J. Carroll,66308,,False,22.0,3,8,2,5,1,3,1,3,3,2,5,0,2,0,0,3,8
400926705,Oklahoma State Cowboys,TEAM,TOTAL,TOTAL,False,,26,72,20,50,6,22,17,23,19,13,32,5,9,4,14,26,75
400926705,North Carolina Tar Heels,J. Jackson,3138156,,True,28.0,7,12,6,8,1,4,7,7,4,4,8,6,1,0,0,2,22
400926705,North Carolina Tar Heels,I. Hicks,66874,,True,25.0,6,9,6,9,0,0,1,1,1,7,8,0,0,1,4,3,13
400926705,North Carolina Tar Heels,K. Meeks,66873,,True,27.0,3,9,3,9,0,0,4,7,5,3,8,1,1,1,1,5,10
400926705,North Carolina Tar Heels,K. Williams,3911619,,True,21.0,3,5,0,1,3,4,0,0,0,3,3,0,0,0,2,1,9
400926705,North Carolina Tar Heels,J. Berry II,3138155,,True,27.0,7,10,3,4,4,6,6,6,1,4,5,4,3,0,3,2,24
400926705,North Carolina Tar Heels,A. Rohlman,4065677,,False,3.0,0,0,0,0,0,0,0,0,0,0,0,0,0,0,0,0,0
400926705,North Carolina Tar Heels,S. Rush,4065674,,False,2.0,0,1,0,1,0,0,0,0,0,1,1,0,0,0,0,0,0
400926705,North Carolina Tar Heels,T. Bradley,4065673,,False,19.0,5,5,5,5,0,0,3,4,2,0,2,1,1,1,0,0,13
400926705,North Carolina Tar Heels,S. Woods,4065676,,False,7.0,0,1,0,1,0,0,0,0,0,1,1,2,1,0,1,5,0
400926705,North Carolina Tar Heels,B. Robinson,4065675,,False,9.0,0,1,0,0,0,1,2,2,1,3,4,0,0,0,1,2,2
400926705,North Carolina Tar Heels,K. Coker,3947144,,False,2.0,1,1,1,1,0,0,0,0,1,0,1,0,0,0,0,0,2
400926705,North Carolina Tar Heels,N. Britt,66872,,False,27.0,5,10,5,8,0,2,2,2,0,1,1,2,1,0,3,2,12
400926705,North Carolina Tar Heels,S. White,56963,,False,3.0,0,0,0,0,0,0,0,0,0,0,0,0,0,0,1,0,0
400926705,North Carolina Tar Heels,TEAM,TOTAL,TOTAL,False,,37,64,29,47,8,17,25,29,16,28,44,16,8,3,16,22,107
400926682,Saint Joseph's Hawks,C. Brown Jr.,4066508,,True,33.0,5,12,2,6,3,6,1,2,1,4,5,1,3,1,0,4,14
400926682,Saint Joseph's Hawks,M. Lodge,3133856,,True,12.0,2,6,2,6,0,0,0,0,6,0,6,0,0,1,1,1,4
400926682,Saint Joseph's Hawks,N. Robinson,4066509,,True,18.0,1,5,1,4,0,1,3,4,2,3,5,0,0,0,2,4,5
400926682,Saint Joseph's Hawks,L. Kimble,3911628,,True,38.0,1,15,0,8,1,7,0,0,1,3,4,2,1,0,1,0,3
400926682,Saint Joseph's Hawks,S. Newkirk,3133854,,True,38.0,10,18,9,15,1,3,2,2,4,2,6,5,0,1,3,3,23
400926682,Saint Joseph's Hawks,J. Williams,67647,,False,10.0,1,2,1,2,0,0,4,4,2,0,2,0,0,0,0,1,6
400926682,Saint Joseph's Hawks,B. Casper,67646,,False,13.0,1,5,1,3,0,2,0,0,2,3,5,0,1,0,0,3,2
400926682,Saint Joseph's Hawks,J. Baumann,61701,,False,18.0,2,3,2,3,0,0,0,0,2,2,4,1,1,1,0,1,4
400926682,Saint Joseph's Hawks,C. Clover,3911629,,False,20.0,1,7,1,4,0,3,0,0,2,3,5,0,0,0,1,0,2
400926682,Saint Joseph's Hawks,TEAM,TOTAL,TOTAL,False,,24,73,19,51,5,22,10,12,22,21,43,9,6,4,8,17,63
400926682,NC State Wolfpack,A. Abu,3138158,,True,29.0,5,8,5,7,0,1,2,2,1,9,10,1,0,2,4,4,12
400926682,NC State Wolfpack,B. Anya,66134,,True,16.0,1,1,1,1,0,0,1,3,1,1,2,1,0,2,1,3,3
400926682,NC State Wolfpack,D. Smith Jr.,4065697,,True,39.0,6,15,3,9,3,6,9,10,0,3,3,8,2,0,2,1,24
400926682,NC State Wolfpack,T. Dorn,3132359,,True,40.0,6,9,1,3,5,6,2,2,0,4,4,1,0,0,1,1,19
400926682,NC State Wolfpack,T. Henderson,61215,,True,40.0,5,10,2,5,3,5,2,2,2,1,3,1,0,2,1,1,15
400926682,NC State Wolfpack,D. Hicks,4065698,,False,4.0,0,0,0,0,0,0,0,1,0,2,2,0,0,0,1,1,0
400926682,NC State Wolfpack,M. Johnson,4065699,,False,26.0,0,5,0,3,0,2,0,0,0,1,1,4,2,0,0,4,0
400926682,NC State Wolfpack,S. Kirk,3947150,,False,6.0,0,1,0,0,0,1,0,0,0,1,1,0,0,0,1,1,0
400926682,NC State Wolfpack,TEAM,TOTAL,TOTAL,False,,23,49,12,28,11,21,16,20,6,27,33,16,4,6,14,16,73
400926563,Rhode Island Rams,K. Iverson,66594,,True,11.0,1,4,1,3,0,1,0,0,1,0,1,1,0,0,1,2,2
400926563,Rhode Island Rams,H. Martin,66404,,True,30.0,7,12,7,12,0,0,1,1,3,3,6,1,1,7,4,4,15
400926563,Rhode Island Rams,J. Terrell,3133843,,True,35.0,8,15,6,12,2,3,4,4,1,3,4,1,0,0,0,4,22
400926563,Rhode Island Rams,J. Garrett,3133842,,True,33.0,2,8,2,4,0,4,0,0,0,3,3,6,2,0,2,3,4
400926563,Rhode Island Rams,E.C. Matthews,66402,,True,34.0,3,7,3,6,0,1,3,4,0,4,4,0,0,0,1,0,9
400926563,Rhode Island Rams,C. Langevine,4066785,,False,12.0,0,2,0,2,0,0,0,0,1,1,2,0,0,0,0,2,0
400926563,Rhode Island Rams,N. Akele,3924875,,False,14.0,0,1,0,1,0,0,0,0,1,3,4,1,0,0,0,1,0
400926563,Rhode Island Rams,C. Thompson,3924873,,False,14.0,1,2,0,1,1,1,0,0,0,2,2,0,0,0,0,4,3
400926563,Rhode Island Rams,S. Robinson,66609,,False,17.0,3,8,3,7,0,1,4,7,3,3,6,0,0,0,0,1,10
400926563,Rhode Island Rams,TEAM,TOTAL,TOTAL,False,,25,59,22,48,3,11,12,16,11,24,35,10,3,7,9,21,65
400926563,Duke Blue Devils,A. Jefferson,61586,,True,36.0,8,13,8,13,0,0,1,1,4,11,15,0,0,0,3,3,17
400926563,Duke Blue Devils,F. Jackson,4065651,,True,33.0,4,11,4,7,0,4,3,4,1,0,1,1,0,0,2,4,11
400926563,Duke Blue Devils,L. Kennard,3913174,,True,40.0,8,11,4,6,4,5,4,4,2,5,7,2,0,0,1,4,24
400926563,Duke Blue Devils,G. Allen,3135045,,True,39.0,3,11,3,6,0,5,4,4,0,5,5,3,2,0,1,2,10
400926563,Duke Blue Devils,M. Jones,66563,,True,40.0,4,13,2,6,2,7,3,4,2,2,4,1,1,0,1,2,13
400926563,Duke Blue Devils,A. Vrankovic,3913177,,False,4.0,0,0,0,0,0,0,0,0,0,0,0,0,0,0,0,1,0
400926563,Duke Blue Devils,C. Jeter,3913173,,False,8.0,0,1,0,1,0,0,0,0,0,1,1,2,0,0,0,2,0
400926563,Duke Blue Devils,TEAM,TOTAL,TOTAL,False,,27,60,21,39,6,21,15,17,11,25,36,9,3,0,9,18,75
400926520,Wake Forest Demon Deacons,J. Collins,3908845,,True,14.0,4,5,4,5,0,0,7,8,0,5,5,0,0,1,1,4,15
400926520,Wake Forest Demon Deacons,D. Mitoglou,3138224,,True,17.0,3,7,2,5,1,2,1,2,0,5,5,1,0,1,1,3,8
400926520,Wake Forest Demon Deacons,A. Arians,61378,,True,31.0,4,7,1,2,3,5,0,0,2,3,5,3,0,0,0,0,11
400926520,Wake Forest Demon Deacons,B. Crawford,3908844,,True,32.0,7,12,5,7,2,5,1,1,0,2,2,6,0,0,0,4,17
400926520,Wake Forest Demon Deacons,M. Wilbekin,3138222,,True,19.0,1,4,1,2,0,2,0,0,0,2,2,2,0,0,1,1,2
400926520,Wake Forest Demon Deacons,G. McClinton,66140,,False,12.0,0,2,0,2,0,0,0,0,2,2,4,0,1,0,0,1,0
400926520,Wake Forest Demon Deacons,S. Japhet-Mathias,4065752,,False,5.0,1,2,1,2,0,0,2,2,0,1,1,0,0,0,0,4,4
400926520,Wake Forest Demon Deacons,D. Moore,3908843,,False,15.0,2,2,2,2,0,0,1,3,1,2,3,0,0,3,4,4,5
400926520,Wake Forest Demon Deacons,B. Childress,4065750,,False,21.0,1,4,1,2,0,2,2,2,1,0,1,2,0,0,1,1,4
400926520,Wake Forest Demon Deacons,K. Woods,3132360,,False,30.0,5,9,3,5,2,4,0,0,1,4,5,4,0,0,2,3,12
400926520,Wake Forest Demon Deacons,T. VanHorn,3078214,,False,4.0,0,0,0,0,0,0,0,0,0,0,0,1,0,0,0,1,0
400926520,Wake Forest Demon Deacons,TEAM,TOTAL,TOTAL,False,,28,54,20,34,8,20,14,18,7,29,36,19,1,5,10,26,78
400926520,Charleston Cougars,J. Brantley,3912292,,True,33.0,4,6,3,4,1,2,7,10,2,6,8,0,0,0,4,5,16
400926520,Charleston Cougars,N. Harris,3129936,,True,24.0,0,1,0,1,0,0,6,8,1,5,6,1,0,1,0,5,6
400926520,Charleston Cougars,C. Johnson,3129937,,True,33.0,2,7,1,3,1,4,2,4,0,2,2,1,0,0,1,2,7
400926520,Charleston Cougars,P. Hulsey,67501,,True,31.0,1,5,0,3,1,2,3,4,1,3,4,1,0,0,1,0,6
400926520,Charleston Cougars,J. Chealey,67154,,True,31.0,5,9,4,6,1,3,8,9,0,2,2,2,1,0,2,2,19
400926520,Charleston Cougars,J. McManus,4067220,,False,7.0,1,2,0,0,1,2,0,0,0,0,0,0,0,0,1,1,3
400926520,Charleston Cougars,C. Goodwin,4067218,,False,13.0,0,4,0,4,0,0,0,0,1,3,4,0,0,0,0,3,0
400926520,Charleston Cougars,G. Riller,3912295,,False,12.0,2,5,2,4,0,1,0,0,0,0,0,0,0,0,0,2,4
400926520,Charleston Cougars,M. Pointer,3912294,,False,16.0,0,6,0,2,0,4,0,0,1,1,2,1,1,0,0,0,0
400926520,Charleston Cougars,TEAM,TOTAL,TOTAL,False,,15,45,10,27,5,18,26,35,8,22,30,6,2,1,11,20,61
400926517,NC State Wolfpack,A. Abu,3138158,,True,28.0,5,12,5,12,0,0,3,4,6,2,8,0,1,0,2,4,13
400926517,NC State Wolfpack,B. Anya,66134,,True,17.0,2,3,2,3,0,0,0,2,1,4,5,2,0,2,1,5,4
400926517,NC State Wolfpack,D. Smith Jr.,4065697,,True,37.0,6,16,4,10,2,6,7,9,0,3,3,7,0,0,2,4,21
400926517,NC State Wolfpack,T. Dorn,3132359,,True,36.0,5,12,3,8,2,4,4,4,0,6,6,2,0,0,0,1,16
400926517,NC State Wolfpack,T. Henderson,61215,,True,31.0,9,14,2,3,7,11,3,5,0,1,1,1,0,0,1,4,28
400926517,NC State Wolfpack,D. Hicks,4065698,,False,10.0,0,1,0,1,0,0,1,2,1,1,2,0,0,0,0,1,1
400926517,NC State Wolfpack,M. Johnson,4065699,,False,30.0,3,9,1,3,2,6,0,0,0,0,0,4,1,1,1,0,8
400926517,NC State Wolfpack,S. Kirk,3947150,,False,11.0,1,1,0,0,1,1,0,0,0,1,1,0,0,0,2,4,3
400926517,NC State Wolfpack,TEAM,TOTAL,TOTAL,False,,31,68,17,40,14,28,18,26,8,20,28,16,2,3,9,23,94
400926517,Creighton Bluejays,C. Huff,61492,,True,26.0,4,7,0,2,4,5,8,8,1,9,10,0,0,0,1,0,20
400926517,Creighton Bluejays,J. Patton,3912332,,True,18.0,4,5,4,5,0,0,2,4,1,4,5,1,1,0,0,3,10
400926517,Creighton Bluejays,K. Thomas,3912334,,True,29.0,7,10,6,6,1,4,1,1,0,1,1,5,1,0,0,4,16
400926517,Creighton Bluejays,M. Foster,67248,,True,26.0,6,13,4,5,2,8,1,2,0,2,2,2,0,0,3,4,15
400926517,Creighton Bluejays,M. Watson Jr.,61170,,True,26.0,6,12,6,11,0,1,1,1,1,1,2,7,0,0,3,3,13
400926517,Creighton Bluejays,M. Krampelj,3912337,,False,2.0,0,0,0,0,0,0,0,0,0,0,0,0,0,0,0,0,0
400926517,Creighton Bluejays,T. Hegner,66317,,False,12.0,1,4,0,0,1,4,5,6,0,2,2,0,0,1,0,1,8
400926517,Creighton Bluejays,Z. Hanson,66318,,False,20.0,5,6,5,6,0,0,1,1,2,6,8,0,0,0,0,3,11
400926517,Creighton Bluejays,K. Paras,4065768,,False,2.0,0,0,0,0,0,0,0,0,0,0,0,0,0,0,0,0,0
400926517,Creighton Bluejays,D. Mintz,4065766,,False,1.0,0,0,0,0,0,0,0,0,0,0,0,1,0,0,1,0,0
400926517,Creighton Bluejays,R. Harrell Jr.,3155484,,False,2.0,0,1,0,1,0,0,0,0,0,1,1,0,0,1,0,2,0
400926517,Creighton Bluejays,T. Clement,66312,,False,13.0,3,3,2,2,1,1,0,0,0,1,1,5,0,0,2,0,7
400926517,Creighton Bluejays,I. Zierden,61457,,False,23.0,4,5,0,1,4,4,0,1,0,3,3,0,0,0,0,2,12
400926517,Creighton Bluejays,TEAM,TOTAL,TOTAL,False,,40,66,27,39,13,27,19,24,8,31,39,21,2,2,10,22,112
400926514,Oklahoma Sooners,K. Doolittle,4066307,,True,32.0,0,5,0,5,0,0,2,2,3,4,7,3,2,0,2,2,2
400926514,Oklahoma Sooners,K. Lattin,3133609,,True,29.0,5,10,5,10,0,0,0,0,0,4,4,1,2,2,2,4,10
400926514,Oklahoma Sooners,R. Odomes,3924878,,True,10.0,0,0,0,0,0,0,0,0,0,1,1,1,0,1,0,2,0
400926514,Oklahoma Sooners,C. James,3924876,,True,26.0,6,10,1,5,5,5,0,0,0,3,3,1,0,0,2,3,17
400926514,Oklahoma Sooners,J. Woodard,66305,,True,34.0,8,15,6,7,2,8,3,4,0,5,5,9,3,1,2,3,21
400926514,Oklahoma Sooners,M. Freeman,3960812,,False,7.0,0,2,0,1,0,1,0,0,0,4,4,1,0,1,2,1,0
400926514,Oklahoma Sooners,D. Buford,3133608,,False,2.0,0,1,0,1,0,0,0,0,0,0,0,0,0,0,0,1,0
400926514,Oklahoma Sooners,C.J. Cole,61661,,False,2.0,0,1,0,1,0,0,0,0,0,0,0,0,0,0,0,2,0
400926514,Oklahoma Sooners,J. McNeace,3133610,,False,8.0,0,0,0,0,0,0,0,0,1,2,3,0,0,2,0,3,0
400926514,Oklahoma Sooners,K. McGusty,4066310,,False,18.0,6,8,5,5,1,3,1,1,0,1,1,0,2,0,1,1,14
400926514,Oklahoma Sooners,J. Shepherd,4066308,,False,7.0,0,0,0,0,0,0,0,0,0,0,0,1,0,0,0,0,0
400926514,Oklahoma Sooners,D. Strong,4066306,,False,25.0,2,5,0,2,2,3,0,0,0,2,2,3,0,0,2,1,6
400926514,Oklahoma Sooners,TEAM,TOTAL,TOTAL,False,,27,57,17,37,10,20,6,7,5,28,33,20,9,7,13,23,70
400926514,Clemson Tigers,D. Grantham,3129674,,True,35.0,2,14,2,12,0,2,0,0,4,4,8,2,0,0,2,1,4
400926514,Clemson Tigers,J. Blossomgame,61835,,True,35.0,8,17,7,12,1,5,5,8,4,3,7,4,0,0,2,2,22
400926514,Clemson Tigers,S. Djitte,66122,,True,40.0,4,8,3,7,1,1,5,6,7,7,14,1,2,2,4,2,14
400926514,Clemson Tigers,G. DeVoe,3129673,,True,35.0,1,11,0,5,1,6,2,2,2,5,7,5,1,0,3,0,5
400926514,Clemson Tigers,A. Holmes,62043,,True,26.0,2,6,2,3,0,3,2,3,0,1,1,1,1,0,3,1,6
400926514,Clemson Tigers,S. Spencer,4065646,,False,1.0,0,0,0,0,0,0,0,0,0,0,0,0,0,0,0,1,0
400926514,Clemson Tigers,T. Hudson,3917986,,False,2.0,0,1,0,0,0,1,0,0,0,0,0,0,0,0,0,0,0
400926514,Clemson Tigers,M. Reed,3133969,,False,26.0,4,11,0,5,4,6,1,2,2,3,5,0,1,0,2,4,13
400926514,Clemson Tigers,TEAM,TOTAL,TOTAL,False,,21,68,14,44,7,24,15,21,23,24,47,13,5,2,17,11,64
400926409,Pittsburgh Panthers,M. Young,66290,,True,36.0,11,20,10,18,1,2,7,7,2,6,8,2,1,3,1,0,30
400926409,Pittsburgh Panthers,S. Jeter,61756,,True,11.0,1,2,0,0,1,2,1,2,0,1,1,0,0,0,2,4,4
400926409,Pittsburgh Panthers,J. Artis,66287,,True,34.0,7,15,5,9,2,6,5,7,1,6,7,3,2,0,0,1,21
400926409,Pittsburgh Panthers,C. Johnson,3138196,,True,22.0,0,3,0,1,0,2,0,1,3,3,6,4,0,0,2,4,0
400926409,Pittsburgh Panthers,C. Jones,61219,,True,32.0,5,7,5,6,0,1,3,3,0,4,4,4,2,0,0,4,13
400926409,Pittsburgh Panthers,R. Nix,3934653,,False,1.0,0,0,0,0,0,0,0,0,0,1,1,0,0,0,0,0,0
400926409,Pittsburgh Panthers,C. Manigault,4065714,,False,2.0,0,1,0,1,0,0,0,0,0,0,0,0,0,0,0,0,0
400926409,Pittsburgh Panthers,R. Luther,3138197,,False,29.0,4,6,4,4,0,2,0,0,0,5,5,0,0,3,2,2,8
400926409,Pittsburgh Panthers,J. Kithcart,4065713,,False,13.0,0,0,0,0,0,0,1,4,0,2,2,1,1,0,1,1,1
400926409,Pittsburgh Panthers,J. Milligan,3934655,,False,6.0,0,2,0,0,0,2,0,0,0,0,0,0,0,0,1,0,0
400926409,Pittsburgh Panthers,D. Wilson,3934652,,False,14.0,0,1,0,1,0,0,1,2,0,1,1,1,0,0,1,3,1
400926409,Pittsburgh Panthers,TEAM,TOTAL,TOTAL,False,,28,57,24,40,4,17,18,26,6,33,39,15,6,6,11,19,78
400926409,Marquette Golden Eagles,L. Fischer,66611,,True,28.0,2,5,2,5,0,0,1,3,1,8,9,2,0,1,1,4,5
400926409,Marquette Golden Eagles,H. Cheatham,3906521,,True,32.0,4,8,4,6,0,2,2,2,0,1,1,2,0,0,0,2,10
400926409,Marquette Golden Eagles,T. Carter,3906520,,True,9.0,1,2,1,1,0,1,0,0,0,0,0,3,1,0,1,4,2
400926409,Marquette Golden Eagles,J. Johnson,66169,,True,32.0,3,13,3,10,0,3,2,2,0,4,4,2,2,1,3,1,8
400926409,Marquette Golden Eagles,K. Reinhardt,61906,,True,16.0,1,8,0,5,1,3,2,2,2,2,4,0,2,0,1,0,5
400926409,Marquette Golden Eagles,S. Hauser,4065804,,False,26.0,4,8,2,2,2,6,1,1,1,1,2,0,0,1,0,3,11
400926409,Marquette Golden Eagles,M. Heldt,3906524,,False,12.0,1,1,1,1,0,0,1,1,1,2,3,1,1,1,0,3,3
400926409,Marquette Golden Eagles,M. Howard,4065805,,False,4.0,0,1,0,0,0,1,0,0,0,2,2,0,0,0,2,1,0
400926409,Marquette Golden Eagles,A. Rowsey,66633,,False,28.0,5,12,2,5,3,7,7,8,1,1,2,2,0,0,1,4,20
400926409,Marquette Golden Eagles,D. Wilson,66171,,False,13.0,5,7,4,5,1,2,0,0,0,4,4,0,0,0,2,1,11
400926409,Marquette Golden Eagles,TEAM,TOTAL,TOTAL,False,,26,65,19,40,7,25,16,19,8,27,35,12,6,4,11,23,75
400926407,Xavier Musketeers,S. O'Mara,3136484,,True,12.0,4,4,4,4,0,0,2,2,1,1,2,0,0,0,2,4,10
400926407,Xavier Musketeers,E. Sumner,3136485,,True,39.0,4,8,4,7,0,1,3,5,0,6,6,6,2,2,5,0,11
400926407,Xavier Musketeers,J.P. Macura,3136483,,True,38.0,10,18,4,7,6,11,2,2,1,3,4,5,3,1,2,3,28
400926407,Xavier Musketeers,T. Bluiett,3136481,,True,40.0,6,15,4,8,2,7,7,9,0,5,5,4,0,0,2,2,21
400926407,Xavier Musketeers,M. Bernard,61236,,True,34.0,4,6,3,4,1,2,0,1,1,6,7,0,1,0,1,4,9
400926407,Xavier Musketeers,T. Jones,4065846,,False,12.0,1,1,1,1,0,0,0,0,1,1,2,0,0,0,1,4,2
400926407,Xavier Musketeers,R. Gaston,62635,,False,15.0,1,5,1,5,0,0,0,0,3,3,6,0,0,1,2,5,2
400926407,Xavier Musketeers,Q. Goodin,4065847,,False,10.0,0,0,0,0,0,0,0,0,0,1,1,2,2,0,3,3,0
400926407,Xavier Musketeers,TEAM,TOTAL,TOTAL,False,,30,57,21,36,9,21,14,19,8,29,37,17,8,4,18,25,83
400926407,Clemson Tigers,D. Grantham,3129674,,True,35.0,7,15,4,6,3,9,4,4,1,2,3,4,4,1,2,3,21
400926407,Clemson Tigers,J. Blossomgame,61835,,True,40.0,5,12,4,8,1,4,2,5,0,3,3,2,1,0,1,3,13
400926407,Clemson Tigers,S. Djitte,66122,,True,28.0,5,8,5,8,0,0,1,4,3,4,7,2,2,0,1,5,11
400926407,Clemson Tigers,G. DeVoe,3129673,,True,38.0,5,13,2,4,3,9,3,5,2,6,8,5,2,0,2,3,16
400926407,Clemson Tigers,A. Holmes,62043,,True,36.0,3,9,1,4,2,5,4,4,0,4,4,3,0,0,2,1,12
400926407,Clemson Tigers,L. Robertin,3917985,,False,5.0,0,0,0,0,0,0,0,0,0,0,0,0,0,0,0,1,0
400926407,Clemson Tigers,M. Reed,3133969,,False,18.0,0,2,0,2,0,0,4,4,0,1,1,3,1,0,4,1,4
400926407,Clemson Tigers,TEAM,TOTAL,TOTAL,False,,25,59,16,32,9,27,18,26,9,22,31,19,10,1,12,17,77
400926406,Wake Forest Demon Deacons,J. Collins,3908845,,True,31.0,8,13,8,13,0,0,1,2,2,4,6,1,0,3,0,3,17
400926406,Wake Forest Demon Deacons,D. Mitoglou,3138224,,True,28.0,3,9,3,7,0,2,5,5,1,2,3,0,0,0,0,1,11
400926406,Wake Forest Demon Deacons,A. Arians,61378,,True,33.0,4,9,1,2,3,7,1,2,1,1,2,1,0,0,0,2,12
400926406,Wake Forest Demon Deacons,B. Crawford,3908844,,True,23.0,5,10,3,5,2,5,0,0,0,2,2,4,1,0,2,4,12
400926406,Wake Forest Demon Deacons,M. Wilbekin,3138222,,True,29.0,4,6,3,3,1,3,2,2,0,1,1,3,0,0,0,0,11
400926406,Wake Forest Demon Deacons,G. McClinton,66140,,False,0.0,0,0,0,0,0,0,0,0,0,0,0,0,0,0,0,0,0
400926406,Wake Forest Demon Deacons,D. Moore,3908843,,False,6.0,0,0,0,0,0,0,0,0,0,2,2,0,0,0,0,1,0
400926406,Wake Forest Demon Deacons,B. Childress,4065750,,False,17.0,1,3,1,2,0,1,2,2,0,1,1,2,0,0,1,2,4
400926406,Wake Forest Demon Deacons,K. Woods,3132360,,False,33.0,4,8,2,5,2,3,0,0,1,3,4,5,0,0,1,3,10
400926406,Wake Forest Demon Deacons,T. VanHorn,3078214,,False,0.0,0,0,0,0,0,0,0,0,0,0,0,0,0,0,0,0,0
400926406,Wake Forest Demon Deacons,TEAM,TOTAL,TOTAL,False,,29,58,21,37,8,21,11,13,6,18,24,16,1,3,4,16,77
400926406,Villanova Wildcats,D. Reynolds,66174,,True,27.0,0,1,0,1,0,0,2,2,3,3,6,1,1,2,0,1,2
400926406,Villanova Wildcats,K. Jenkins,66172,,True,28.0,5,8,2,2,3,6,3,3,0,6,6,3,0,0,3,3,16
400926406,Villanova Wildcats,J. Brunson,3934672,,True,37.0,5,10,4,8,1,2,0,1,0,2,2,6,0,0,1,0,11
400926406,Villanova Wildcats,M. Bridges,3147657,,True,37.0,7,11,4,4,3,7,2,2,1,6,7,4,0,2,1,2,19
400926406,Villanova Wildcats,J. Hart,66173,,True,31.0,11,14,5,6,6,8,2,2,1,3,4,2,3,0,0,4,30
400926406,Villanova Wildcats,D. Painter,4065840,,False,1.0,0,1,0,1,0,0,0,0,0,1,1,0,0,0,1,1,0
400926406,Villanova Wildcats,E. Paschall,3133817,,False,19.0,2,8,2,5,0,3,2,2,2,0,2,0,0,0,0,2,6
400926406,Villanova Wildcats,D. DiVincenzo,3934673,,False,20.0,4,6,1,1,3,5,1,2,2,2,4,1,0,0,0,1,12
400926406,Villanova Wildcats,TEAM,TOTAL,TOTAL,False,,34,59,18,28,16,31,12,14,9,25,34,17,4,4,6,14,96
400924482,Tusculum Pioneers,C. Mounce,3083685,,True,15.0,1,4,1,4,0,0,0,0,1,0,1,0,1,1,2,2,2
400924482,Tusculum Pioneers,R. Baylark,4079277,,True,25.0,4,10,3,6,1,4,1,1,0,2,2,1,1,0,2,1,10
400924482,Tusculum Pioneers,K. Patterson,3952545,,True,22.0,7,11,1,2,6,9,1,4,0,1,1,2,2,0,1,1,21
400924482,Tusculum Pioneers,Z. Davis,3083688,,True,15.0,0,3,0,2,0,1,0,0,1,0,1,0,0,1,2,2,0
400924482,Tusculum Pioneers,C. Fagan,3083679,,True,18.0,1,7,0,2,1,5,0,0,2,2,4,3,0,0,0,2,3
400924482,Tusculum Pioneers,B. Dansoh,4079280,,False,15.0,0,4,0,3,0,1,1,2,1,2,3,0,0,2,0,2,1
400924482,Tusculum Pioneers,C. Hodnett,4079274,,False,21.0,1,3,1,2,0,1,1,2,0,3,3,0,0,0,0,0,3
400924482,Tusculum Pioneers,Z. Hartle,3952546,,False,9.0,2,4,0,0,2,4,0,0,1,3,4,1,0,1,1,0,6
400924482,Tusculum Pioneers,C. Mitchell,3162445,,False,11.0,1,1,1,1,0,0,0,0,1,0,1,0,1,0,0,1,2
400924482,Tusculum Pioneers,T. Blevins,4079275,,False,16.0,2,4,2,2,0,2,2,2,0,0,0,1,0,0,2,0,6
400924482,Tusculum Pioneers,K. Dotson,4079273,,False,17.0,1,6,1,2,0,4,0,0,0,2,2,0,0,0,3,1,2
400924482,Tusculum Pioneers,D. Poore,3952547,,False,7.0,0,2,0,2,0,0,0,2,0,0,0,1,0,0,0,0,0
400924482,Tusculum Pioneers,V. Brown,3162446,,False,9.0,1,5,1,4,0,1,0,1,0,1,1,0,0,1,1,2,2
400924482,Tusculum Pioneers,TEAM,TOTAL,TOTAL,False,,21,64,11,32,10,32,6,14,12,17,29,9,5,6,14,14,58
400924482,Georgia Tech Yellow Jackets,Q. Stephens,66128,,True,18.0,3,8,2,2,1,6,0,0,1,4,5,2,1,0,2,1,7
400924482,Georgia Tech Yellow Jackets,B. Lammers,3135061,,True,22.0,5,8,5,8,0,0,3,4,1,5,6,3,1,4,0,1,13
400924482,Georgia Tech Yellow Jackets,J. Okogie,4065663,,True,22.0,5,8,3,5,2,3,3,4,5,4,9,1,1,0,2,0,15
400924482,Georgia Tech Yellow Jackets,J. Heath,67623,,True,21.0,3,5,3,4,0,1,0,0,0,3,3,5,3,0,0,1,6
400924482,Georgia Tech Yellow Jackets,C. Heyward,61609,,True,18.0,1,2,0,0,1,2,2,2,0,2,2,3,1,1,0,2,5
400924482,Georgia Tech Yellow Jackets,C. Matthews,4065665,,False,21.0,4,6,3,4,1,2,3,5,0,4,4,3,0,0,2,3,12
400924482,Georgia Tech Yellow Jackets,S. Ogbonda,3904627,,False,14.0,4,7,4,7,0,0,0,0,0,5,5,1,0,0,2,1,8
400924482,Georgia Tech Yellow Jackets,R. Rowland,67543,,False,8.0,1,2,1,2,0,0,0,0,1,0,1,1,0,0,1,1,2
400924482,Georgia Tech Yellow Jackets,K. McCormick,61453,,False,18.0,3,3,0,0,3,3,0,0,0,1,1,2,0,0,1,1,9
400924482,Georgia Tech Yellow Jackets,N. Harris,4072202,,False,3.0,1,2,1,2,0,0,0,0,0,0,0,0,0,0,1,1,2
400924482,Georgia Tech Yellow Jackets,S. Medlock,4065664,,False,4.0,1,3,1,3,0,0,0,0,0,0,0,0,0,0,0,2,2
400924482,Georgia Tech Yellow Jackets,T. Jackson,3135057,,False,19.0,3,7,2,5,1,2,3,3,0,2,2,4,1,0,2,0,10
400924482,Georgia Tech Yellow Jackets,J. Price,61778,,False,12.0,2,3,1,1,1,2,0,0,0,3,3,0,0,1,0,0,5
400924482,Georgia Tech Yellow Jackets,TEAM,TOTAL,TOTAL,False,,36,64,26,43,10,21,14,18,12,35,47,25,8,6,13,14,96
400921178,South Carolina State Bulldogs,I. Kinard,4067966,,True,17.0,1,1,1,1,0,0,0,0,1,0,1,0,0,0,3,3,2
400921178,South Carolina State Bulldogs,T. Riley,3155580,,True,33.0,7,15,7,14,0,1,0,0,1,2,3,2,0,1,3,2,14
400921178,South Carolina State Bulldogs,E. Eaves,3947061,,True,35.0,8,12,5,8,3,4,1,2,0,4,4,0,0,0,1,1,20
400921178,South Carolina State Bulldogs,E. Stephens,3155579,,True,27.0,2,4,0,0,2,4,0,0,0,3,3,1,1,0,0,1,6
400921178,South Carolina State Bulldogs,G. Mortimer,67580,,True,30.0,6,9,5,7,1,2,0,0,0,1,1,1,0,0,3,0,13
400921178,South Carolina State Bulldogs,T. Clement,4074050,,False,1.0,0,1,0,1,0,0,0,0,0,0,0,0,0,0,0,0,0
400921178,South Carolina State Bulldogs,D. Applewhite,4067967,,False,8.0,0,1,0,1,0,0,2,2,1,1,2,0,0,0,0,1,2
400921178,South Carolina State Bulldogs,D. Bottenberg,4067965,,False,5.0,0,0,0,0,0,0,0,0,0,1,1,0,0,1,0,2,0
400921178,South Carolina State Bulldogs,O. Fields,4067962,,False,6.0,0,0,0,0,0,0,0,0,0,0,0,1,0,0,0,2,0
400921178,South Carolina State Bulldogs,J. Raynor-Powell,4067964,,False,18.0,1,3,1,3,0,0,0,0,1,4,5,2,0,0,4,1,2
400921178,South Carolina State Bulldogs,J. Richardson,4067963,,False,17.0,3,8,3,5,0,3,0,0,0,1,1,4,0,1,1,1,6
400921178,South Carolina State Bulldogs,E. Jones,4067961,,False,1.0,0,0,0,0,0,0,0,0,0,0,0,0,0,0,1,0,0
400921178,South Carolina State Bulldogs,B. Williams,3167479,,False,2.0,0,0,0,0,0,0,0,0,0,0,0,0,0,0,0,0,0
400921178,South Carolina State Bulldogs,TEAM,TOTAL,TOTAL,False,,28,54,22,40,6,14,3,4,6,23,29,11,1,3,18,14,65
400921178,Clemson Tigers,D. Grantham,3129674,,True,29.0,6,14,5,9,1,5,0,0,6,1,7,2,2,1,0,0,13
400921178,Clemson Tigers,J. Blossomgame,61835,,True,31.0,10,16,8,12,2,4,7,9,4,5,9,4,1,0,0,2,29
400921178,Clemson Tigers,S. Djitte,66122,,True,26.0,4,5,4,5,0,0,0,1,6,7,13,0,0,0,0,0,8
400921178,Clemson Tigers,S. Mitchell,3136699,,True,23.0,5,9,3,5,2,4,2,2,0,0,0,5,0,0,0,0,14
400921178,Clemson Tigers,A. Holmes,62043,,True,31.0,3,13,1,3,2,10,2,2,2,0,2,0,0,0,0,1,10
400921178,Clemson Tigers,L. Robertin,3917985,,False,3.0,0,3,0,3,0,0,0,0,1,0,1,0,0,1,0,0,0
400921178,Clemson Tigers,S. Spencer,4065646,,False,7.0,2,3,2,2,0,1,0,0,0,1,1,0,1,0,0,0,4
400921178,Clemson Tigers,T. Hudson,3917986,,False,8.0,1,5,1,2,0,3,0,0,0,0,0,0,0,0,0,0,2
400921178,Clemson Tigers,L. Davis,3917984,,False,2.0,0,0,0,0,0,0,0,0,0,2,2,1,0,0,0,0,0
400921178,Clemson Tigers,R. McGillan,3155393,,False,2.0,0,0,0,0,0,0,0,0,0,0,0,0,0,0,0,0,0
400921178,Clemson Tigers,M. Reed,3133969,,False,18.0,2,6,2,5,0,1,2,2,1,1,2,1,1,0,1,1,6
400921178,Clemson Tigers,G. DeVoe,3129673,,False,20.0,3,6,2,3,1,3,0,0,1,2,3,4,3,0,1,1,7
400921178,Clemson Tigers,TEAM,TOTAL,TOTAL,False,,36,80,28,49,8,31,13,16,23,20,43,17,8,2,2,5,93
400915480,Clemson Tigers,D. Grantham,3129674,,True,31.0,2,4,2,3,0,1,4,5,2,4,6,1,1,0,1,1,8
400915480,Clemson Tigers,J. Blossomgame,61835,,True,37.0,7,13,7,10,0,3,3,4,1,6,7,3,2,0,0,2,17
400915480,Clemson Tigers,S. Djitte,66122,,True,25.0,3,3,3,3,0,0,3,4,2,3,5,0,0,1,2,1,9
400915480,Clemson Tigers,S. Mitchell,3136699,,True,30.0,5,9,5,7,0,2,4,5,0,1,1,1,0,0,2,2,14
400915480,Clemson Tigers,A. Holmes,62043,,True,30.0,6,13,1,5,5,8,0,0,4,6,10,1,3,0,2,0,17
400915480,Clemson Tigers,E. Thomas,3947075,,False,9.0,3,4,3,4,0,0,0,1,0,4,4,0,0,0,1,2,6
400915480,Clemson Tigers,L. Robertin,3917985,,False,1.0,0,0,0,0,0,0,0,0,0,0,0,0,0,0,0,0,0
400915480,Clemson Tigers,S. Spencer,4065646,,False,1.0,0,0,0,0,0,0,0,0,0,0,0,0,0,0,0,0,0
400915480,Clemson Tigers,T. Hudson,3917986,,False,1.0,0,0,0,0,0,0,0,0,0,0,0,1,0,0,0,0,0
400915480,Clemson Tigers,R. McGillan,3155393,,False,1.0,0,2,0,0,0,2,0,0,0,0,0,0,1,0,0,0,0
400915480,Clemson Tigers,M. Reed,3133969,,False,17.0,2,3,2,3,0,0,2,2,0,1,1,4,0,1,3,0,6
400915480,Clemson Tigers,G. DeVoe,3129673,,False,17.0,2,4,1,2,1,2,0,0,0,0,0,1,0,0,2,0,5
400915480,Clemson Tigers,TEAM,TOTAL,TOTAL,False,,30,55,24,37,6,18,16,21,10,26,36,12,7,2,13,8,82
400915480,Clemson Tigers,D. Grantham,3129674,,True,31.0,2,4,2,3,0,1,4,5,2,4,6,1,1,0,1,1,8
400915480,Clemson Tigers,J. Blossomgame,61835,,True,37.0,7,13,7,10,0,3,3,4,1,6,7,3,2,0,0,2,17
400915480,Clemson Tigers,S. Djitte,66122,,True,25.0,3,3,3,3,0,0,3,4,2,3,5,0,0,1,2,1,9
400915480,Clemson Tigers,S. Mitchell,3136699,,True,30.0,5,9,5,7,0,2,4,5,0,1,1,1,0,0,2,2,14
400915480,Clemson Tigers,A. Holmes,62043,,True,30.0,6,13,1,5,5,8,0,0,4,6,10,1,3,0,2,0,17
400915480,Clemson Tigers,E. Thomas,3947075,,False,9.0,3,4,3,4,0,0,0,1,0,4,4,0,0,0,1,2,6
400915480,Clemson Tigers,L. Robertin,3917985,,False,1.0,0,0,0,0,0,0,0,0,0,0,0,0,0,0,0,0,0
400915480,Clemson Tigers,S. Spencer,4065646,,False,1.0,0,0,0,0,0,0,0,0,0,0,0,0,0,0,0,0,0
400915480,Clemson Tigers,T. Hudson,3917986,,False,1.0,0,0,0,0,0,0,0,0,0,0,0,1,0,0,0,0,0
400915480,Clemson Tigers,R. McGillan,3155393,,False,1.0,0,2,0,0,0,2,0,0,0,0,0,0,1,0,0,0,0
400915480,Clemson Tigers,M. Reed,3133969,,False,17.0,2,3,2,3,0,0,2,2,0,1,1,4,0,1,3,0,6
400915480,Clemson Tigers,G. DeVoe,3129673,,False,17.0,2,4,1,2,1,2,0,0,0,0,0,1,0,0,2,0,5
400915480,Clemson Tigers,TEAM,TOTAL,TOTAL,False,,30,55,24,37,6,18,16,21,10,26,36,12,7,2,13,8,82
400915480,Boston College Eagles,A.J. Turner,3943608,,True,36.0,4,10,2,3,2,7,0,0,1,0,1,2,0,0,2,2,10
400915480,Boston College Eagles,M. Jeffers,61901,,True,18.0,2,4,2,4,0,0,1,2,0,3,3,1,0,1,1,3,5
400915480,Boston College Eagles,C. Tava,61446,,True,19.0,2,4,1,3,1,1,0,1,0,4,4,0,2,0,2,3,5
400915480,Boston College Eagles,K. Bowman,4065635,,True,28.0,4,10,2,6,2,4,0,0,1,4,5,3,1,0,3,3,10
400915480,Boston College Eagles,J. Robinson,3943606,,True,30.0,4,8,3,5,1,3,0,0,1,3,4,5,2,0,2,5,9
400915480,Boston College Eagles,J. Reyes,3943609,,False,5.0,0,1,0,1,0,0,0,0,0,0,0,0,1,0,1,0,0
400915480,Boston College Eagles,M. Sagay,4065638,,False,4.0,2,3,2,3,0,0,0,1,1,1,2,0,0,0,0,0,4
400915480,Boston College Eagles,N. Popovic,4065637,,False,16.0,4,10,4,9,0,1,0,0,2,0,2,0,0,0,0,3,8
400915480,Boston College Eagles,E. Meznieks,3943607,,False,1.0,0,0,0,0,0,0,0,0,0,0,0,0,0,0,1,0,0
400915480,Boston College Eagles,G. Owens,66277,,False,15.0,0,0,0,0,0,0,0,0,1,1,2,1,0,0,0,3,0
400915480,Boston College Eagles,J. Chatman,3135095,,False,28.0,6,10,3,3,3,7,2,2,0,2,2,0,2,1,0,2,17
400915480,Boston College Eagles,TEAM,TOTAL,TOTAL,False,,28,60,19,37,9,23,3,6,8,19,27,12,8,2,12,24,68
400915480,Boston College Eagles,A.J. Turner,3943608,,True,36.0,4,10,2,3,2,7,0,0,1,0,1,2,0,0,2,2,10
400915480,Boston College Eagles,M. Jeffers,61901,,True,18.0,2,4,2,4,0,0,1,2,0,3,3,1,0,1,1,3,5
400915480,Boston College Eagles,C. Tava,61446,,True,19.0,2,4,1,3,1,1,0,1,0,4,4,0,2,0,2,3,5
400915480,Boston College Eagles,K. Bowman,4065635,,True,28.0,4,10,2,6,2,4,0,0,1,4,5,3,1,0,3,3,10
400915480,Boston College Eagles,J. Robinson,3943606,,True,30.0,4,8,3,5,1,3,0,0,1,3,4,5,2,0,2,5,9
400915480,Boston College Eagles,J. Reyes,3943609,,False,5.0,0,1,0,1,0,0,0,0,0,0,0,0,1,0,1,0,0
400915480,Boston College Eagles,M. Sagay,4065638,,False,4.0,2,3,2,3,0,0,0,1,1,1,2,0,0,0,0,0,4
400915480,Boston College Eagles,N. Popovic,4065637,,False,16.0,4,10,4,9,0,1,0,0,2,0,2,0,0,0,0,3,8
400915480,Boston College Eagles,E. Meznieks,3943607,,False,1.0,0,0,0,0,0,0,0,0,0,0,0,0,0,0,1,0,0
400915480,Boston College Eagles,G. Owens,66277,,False,15.0,0,0,0,0,0,0,0,0,1,1,2,1,0,0,0,3,0
400915480,Boston College Eagles,J. Chatman,3135095,,False,28.0,6,10,3,3,3,7,2,2,0,2,2,0,2,1,0,2,17
400915480,Boston College Eagles,TEAM,TOTAL,TOTAL,False,,28,60,19,37,9,23,3,6,8,19,27,12,8,2,12,24,68
400915479,North Carolina Tar Heels,I. Hicks,66874,,True,22.0,7,9,7,9,0,0,7,8,3,6,9,2,0,0,1,2,21
400915479,North Carolina Tar Heels,K. Meeks,66873,,True,24.0,3,7,3,7,0,0,2,4,3,5,8,1,1,2,3,4,8
400915479,North Carolina Tar Heels,K. Coker,3947144,,True,1.0,0,0,0,0,0,0,0,0,0,0,0,0,0,0,0,1,0
400915479,North Carolina Tar Heels,N. Britt,66872,,True,16.0,0,3,0,1,0,2,0,0,0,1,1,1,0,0,1,2,0
400915479,North Carolina Tar Heels,S. White,56963,,True,1.0,0,0,0,0,0,0,0,0,0,0,0,0,0,0,0,0,0
400915479,North Carolina Tar Heels,T. Bradley,4065673,,False,15.0,4,5,4,5,0,0,0,0,1,3,4,0,0,0,0,1,8
400915479,North Carolina Tar Heels,L. Maye,3911620,,False,18.0,4,5,4,4,0,1,0,0,3,0,3,2,0,0,1,3,8
400915479,North Carolina Tar Heels,J. Jackson,3138156,,False,30.0,6,17,5,10,1,7,2,3,1,1,2,4,0,0,0,2,15
400915479,North Carolina Tar Heels,T. Pinson,3138154,,False,31.0,0,4,0,2,0,2,0,0,0,3,3,7,1,0,2,1,0
400915479,North Carolina Tar Heels,S. Woods,4065676,,False,3.0,0,2,0,2,0,0,0,0,0,1,1,0,0,0,0,1,0
400915479,North Carolina Tar Heels,B. Robinson,4065675,,False,3.0,1,1,1,1,0,0,0,0,0,1,1,1,0,0,0,2,2
400915479,North Carolina Tar Heels,J. Berry II,3138155,,False,36.0,9,14,4,9,5,5,5,6,0,2,2,1,2,0,1,3,28
400915479,North Carolina Tar Heels,TEAM,TOTAL,TOTAL,False,,34,67,28,50,6,17,16,21,12,23,35,19,4,2,9,22,90
400915479,North Carolina Tar Heels,I. Hicks,66874,,True,22.0,7,9,7,9,0,0,7,8,3,6,9,2,0,0,1,2,21
400915479,North Carolina Tar Heels,K. Meeks,66873,,True,24.0,3,7,3,7,0,0,2,4,3,5,8,1,1,2,3,4,8
400915479,North Carolina Tar Heels,K. Coker,3947144,,True,1.0,0,0,0,0,0,0,0,0,0,0,0,0,0,0,0,1,0
400915479,North Carolina Tar Heels,N. Britt,66872,,True,16.0,0,3,0,1,0,2,0,0,0,1,1,1,0,0,1,2,0
400915479,North Carolina Tar Heels,S. White,56963,,True,1.0,0,0,0,0,0,0,0,0,0,0,0,0,0,0,0,0,0
400915479,North Carolina Tar Heels,T. Bradley,4065673,,False,15.0,4,5,4,5,0,0,0,0,1,3,4,0,0,0,0,1,8
400915479,North Carolina Tar Heels,L. Maye,3911620,,False,18.0,4,5,4,4,0,1,0,0,3,0,3,2,0,0,1,3,8
400915479,North Carolina Tar Heels,J. Jackson,3138156,,False,30.0,6,17,5,10,1,7,2,3,1,1,2,4,0,0,0,2,15
400915479,North Carolina Tar Heels,T. Pinson,3138154,,False,31.0,0,4,0,2,0,2,0,0,0,3,3,7,1,0,2,1,0
400915479,North Carolina Tar Heels,S. Woods,4065676,,False,3.0,0,2,0,2,0,0,0,0,0,1,1,0,0,0,0,1,0
400915479,North Carolina Tar Heels,B. Robinson,4065675,,False,3.0,1,1,1,1,0,0,0,0,0,1,1,1,0,0,0,2,2
400915479,North Carolina Tar Heels,J. Berry II,3138155,,False,36.0,9,14,4,9,5,5,5,6,0,2,2,1,2,0,1,3,28
400915479,North Carolina Tar Heels,TEAM,TOTAL,TOTAL,False,,34,67,28,50,6,17,16,21,12,23,35,19,4,2,9,22,90
400915479,Duke Blue Devils,J. Tatum,4065648,,True,30.0,4,13,2,9,2,4,3,4,1,4,5,1,1,0,2,3,13
400915479,Duke Blue Devils,A. Jefferson,61586,,True,36.0,5,8,5,8,0,0,2,2,2,4,6,2,1,2,1,3,12
400915479,Duke Blue Devils,F. Jackson,4065651,,True,32.0,4,9,3,6,1,3,6,7,0,6,6,2,1,0,2,3,15
400915479,Duke Blue Devils,L. Kennard,3913174,,True,39.0,9,17,7,11,2,6,8,9,2,3,5,1,1,1,0,0,28
400915479,Duke Blue Devils,M. Jones,66563,,True,26.0,0,3,0,1,0,2,0,0,0,0,0,1,2,0,0,2,0
400915479,Duke Blue Devils,H. Giles III,4065649,,False,13.0,0,0,0,0,0,0,1,2,1,2,3,0,0,1,1,3,1
400915479,Duke Blue Devils,M. Bolden,4065652,,False,1.0,0,0,0,0,0,0,0,0,0,0,0,0,0,0,0,0,0
400915479,Duke Blue Devils,G. Allen,3135045,,False,23.0,2,4,0,0,2,4,8,11,0,1,1,1,2,0,1,3,14
400915479,Duke Blue Devils,TEAM,TOTAL,TOTAL,False,,24,54,17,35,7,19,28,35,8,23,31,8,8,4,8,17,83
400915479,Duke Blue Devils,J. Tatum,4065648,,True,30.0,4,13,2,9,2,4,3,4,1,4,5,1,1,0,2,3,13
400915479,Duke Blue Devils,A. Jefferson,61586,,True,36.0,5,8,5,8,0,0,2,2,2,4,6,2,1,2,1,3,12
400915479,Duke Blue Devils,F. Jackson,4065651,,True,32.0,4,9,3,6,1,3,6,7,0,6,6,2,1,0,2,3,15
400915479,Duke Blue Devils,L. Kennard,3913174,,True,39.0,9,17,7,11,2,6,8,9,2,3,5,1,1,1,0,0,28
400915479,Duke Blue Devils,M. Jones,66563,,True,26.0,0,3,0,1,0,2,0,0,0,0,0,1,2,0,0,2,0
400915479,Duke Blue Devils,H. Giles III,4065649,,False,13.0,0,0,0,0,0,0,1,2,1,2,3,0,0,1,1,3,1
400915479,Duke Blue Devils,M. Bolden,4065652,,False,1.0,0,0,0,0,0,0,0,0,0,0,0,0,0,0,0,0,0
400915479,Duke Blue Devils,G. Allen,3135045,,False,23.0,2,4,0,0,2,4,8,11,0,1,1,1,2,0,1,3,14
400915479,Duke Blue Devils,TEAM,TOTAL,TOTAL,False,,24,54,17,35,7,19,28,35,8,23,31,8,8,4,8,17,83
400915478,Wake Forest Demon Deacons,J. Collins,3908845,,True,21.0,5,6,5,6,0,0,3,4,3,6,9,1,0,1,0,4,13
400915478,Wake Forest Demon Deacons,D. Mitoglou,3138224,,True,20.0,2,5,1,3,1,2,0,0,3,4,7,0,0,1,3,2,5
400915478,Wake Forest Demon Deacons,A. Arians,61378,,True,30.0,5,10,2,3,3,7,2,2,0,2,2,0,2,0,2,1,15
400915478,Wake Forest Demon Deacons,B. Crawford,3908844,,True,32.0,5,8,2,3,3,5,13,14,0,1,1,5,1,1,0,3,26
400915478,Wake Forest Demon Deacons,K. Woods,3132360,,True,32.0,6,11,6,11,0,0,2,4,1,6,7,2,1,0,1,3,14
400915478,Wake Forest Demon Deacons,G. McClinton,66140,,False,12.0,0,1,0,1,0,0,0,0,1,0,1,0,0,0,1,3,0
400915478,Wake Forest Demon Deacons,D. Moore,3908843,,False,2.0,0,1,0,1,0,0,0,0,0,0,0,0,0,0,1,0,0
400915478,Wake Forest Demon Deacons,B. Childress,4065750,,False,28.0,3,6,3,4,0,2,5,7,0,2,2,1,0,0,0,0,11
400915478,Wake Forest Demon Deacons,M. Wilbekin,3138222,,False,23.0,1,3,0,0,1,3,2,2,0,1,1,2,1,0,2,1,5
400915478,Wake Forest Demon Deacons,T. VanHorn,3078214,,False,0.0,0,0,0,0,0,0,0,0,0,0,0,0,0,0,0,0,0
400915478,Wake Forest Demon Deacons,TEAM,TOTAL,TOTAL,False,,27,51,19,32,8,19,27,33,8,24,32,11,5,3,11,17,89
400915478,Wake Forest Demon Deacons,J. Collins,3908845,,True,21.0,5,6,5,6,0,0,3,4,3,6,9,1,0,1,0,4,13
400915478,Wake Forest Demon Deacons,D. Mitoglou,3138224,,True,20.0,2,5,1,3,1,2,0,0,3,4,7,0,0,1,3,2,5
400915478,Wake Forest Demon Deacons,A. Arians,61378,,True,30.0,5,10,2,3,3,7,2,2,0,2,2,0,2,0,2,1,15
400915478,Wake Forest Demon Deacons,B. Crawford,3908844,,True,32.0,5,8,2,3,3,5,13,14,0,1,1,5,1,1,0,3,26
400915478,Wake Forest Demon Deacons,K. Woods,3132360,,True,32.0,6,11,6,11,0,0,2,4,1,6,7,2,1,0,1,3,14
400915478,Wake Forest Demon Deacons,G. McClinton,66140,,False,12.0,0,1,0,1,0,0,0,0,1,0,1,0,0,0,1,3,0
400915478,Wake Forest Demon Deacons,D. Moore,3908843,,False,2.0,0,1,0,1,0,0,0,0,0,0,0,0,0,0,1,0,0
400915478,Wake Forest Demon Deacons,B. Childress,4065750,,False,28.0,3,6,3,4,0,2,5,7,0,2,2,1,0,0,0,0,11
400915478,Wake Forest Demon Deacons,M. Wilbekin,3138222,,False,23.0,1,3,0,0,1,3,2,2,0,1,1,2,1,0,2,1,5
400915478,Wake Forest Demon Deacons,T. VanHorn,3078214,,False,0.0,0,0,0,0,0,0,0,0,0,0,0,0,0,0,0,0,0
400915478,Wake Forest Demon Deacons,TEAM,TOTAL,TOTAL,False,,27,51,19,32,8,19,27,33,8,24,32,11,5,3,11,17,89
400915478,Virginia Tech Hokies,Z. LeDay,61698,,True,34.0,9,10,9,10,0,0,6,7,3,7,10,2,0,2,3,4,24
400915478,Virginia Tech Hokies,J. Robinson,3945566,,True,39.0,4,10,2,5,2,5,7,7,0,1,1,6,1,0,3,2,17
400915478,Virginia Tech Hokies,J. Bibbs,3147500,,True,40.0,4,8,2,3,2,5,0,0,0,1,1,1,2,0,0,5,10
400915478,Virginia Tech Hokies,T. Outlaw,67275,,True,28.0,4,7,1,1,3,6,0,0,1,2,3,1,0,1,0,4,11
400915478,Virginia Tech Hokies,S. Allen,61795,,True,32.0,9,15,8,11,1,4,1,1,0,3,3,2,2,0,3,2,20
400915478,Virginia Tech Hokies,K. Sy,4065740,,False,5.0,0,2,0,2,0,0,0,0,1,1,2,0,0,1,0,0,0
400915478,Virginia Tech Hokies,M. Galloway,3945565,,False,2.0,0,1,0,0,0,1,0,0,0,0,0,0,0,0,0,2,0
400915478,Virginia Tech Hokies,A. Hill,3147501,,False,20.0,0,5,0,0,0,5,2,2,0,4,4,1,0,0,0,3,2
400915478,Virginia Tech Hokies,TEAM,TOTAL,TOTAL,False,,30,58,22,32,8,26,16,17,5,20,25,13,5,4,9,22,84
400915478,Virginia Tech Hokies,Z. LeDay,61698,,True,34.0,9,10,9,10,0,0,6,7,3,7,10,2,0,2,3,4,24
400915478,Virginia Tech Hokies,J. Robinson,3945566,,True,39.0,4,10,2,5,2,5,7,7,0,1,1,6,1,0,3,2,17
400915478,Virginia Tech Hokies,J. Bibbs,3147500,,True,40.0,4,8,2,3,2,5,0,0,0,1,1,1,2,0,0,5,10
400915478,Virginia Tech Hokies,T. Outlaw,67275,,True,28.0,4,7,1,1,3,6,0,0,1,2,3,1,0,1,0,4,11
400915478,Virginia Tech Hokies,S. Allen,61795,,True,32.0,9,15,8,11,1,4,1,1,0,3,3,2,2,0,3,2,20
400915478,Virginia Tech Hokies,K. Sy,4065740,,False,5.0,0,2,0,2,0,0,0,0,1,1,2,0,0,1,0,0,0
400915478,Virginia Tech Hokies,M. Galloway,3945565,,False,2.0,0,1,0,0,0,1,0,0,0,0,0,0,0,0,0,2,0
400915478,Virginia Tech Hokies,A. Hill,3147501,,False,20.0,0,5,0,0,0,5,2,2,0,4,4,1,0,0,0,3,2
400915478,Virginia Tech Hokies,TEAM,TOTAL,TOTAL,False,,30,58,22,32,8,26,16,17,5,20,25,13,5,4,9,22,84
400915477,Syracuse Orange,T. Thompson,4065721,,True,15.0,2,4,1,2,1,2,0,0,0,2,2,0,0,0,1,1,5
400915477,Syracuse Orange,T. Lydon,3934662,,True,37.0,2,4,1,3,1,1,2,2,1,12,13,3,1,3,2,3,7
400915477,Syracuse Orange,A. White III,61616,,True,39.0,12,16,4,7,8,9,8,9,0,3,3,2,2,0,0,3,40
400915477,Syracuse Orange,T. Battle,4065722,,True,38.0,6,11,2,4,4,7,6,6,0,4,4,1,1,1,1,3,22
400915477,Syracuse Orange,J. Gillon,61915,,True,36.0,4,9,3,7,1,2,1,2,0,0,0,10,2,0,3,0,10
400915477,Syracuse Orange,D. Akintobi-Adeyeye,3155403,,False,1.0,1,3,1,3,0,0,0,0,3,0,3,0,0,0,1,0,2
400915477,Syracuse Orange,T. Roberson,67633,,False,24.0,2,3,2,3,0,0,0,2,1,2,3,1,1,0,1,2,4
400915477,Syracuse Orange,D. Coleman,61821,,False,3.0,0,0,0,0,0,0,0,0,0,0,0,0,0,0,0,0,0
400915477,Syracuse Orange,A. Autry,3934661,,False,1.0,0,1,0,0,0,1,0,1,0,1,1,0,1,0,0,0,0
400915477,Syracuse Orange,S. Belbey,3934660,,False,1.0,0,1,0,1,0,0,0,0,0,0,0,0,0,0,1,0,0
400915477,Syracuse Orange,F. Howard,3934659,,False,5.0,0,2,0,0,0,2,0,0,1,2,3,1,1,0,2,0,0
400915477,Syracuse Orange,TEAM,TOTAL,TOTAL,False,,29,54,14,30,15,24,17,22,6,27,33,18,9,4,13,12,90
400915477,Syracuse Orange,T. Thompson,4065721,,True,15.0,2,4,1,2,1,2,0,0,0,2,2,0,0,0,1,1,5
400915477,Syracuse Orange,T. Lydon,3934662,,True,37.0,2,4,1,3,1,1,2,2,1,12,13,3,1,3,2,3,7
400915477,Syracuse Orange,A. White III,61616,,True,39.0,12,16,4,7,8,9,8,9,0,3,3,2,2,0,0,3,40
400915477,Syracuse Orange,T. Battle,4065722,,True,38.0,6,11,2,4,4,7,6,6,0,4,4,1,1,1,1,3,22
400915477,Syracuse Orange,J. Gillon,61915,,True,36.0,4,9,3,7,1,2,1,2,0,0,0,10,2,0,3,0,10
400915477,Syracuse Orange,D. Akintobi-Adeyeye,3155403,,False,1.0,1,3,1,3,0,0,0,0,3,0,3,0,0,0,1,0,2
400915477,Syracuse Orange,T. Roberson,67633,,False,24.0,2,3,2,3,0,0,0,2,1,2,3,1,1,0,1,2,4
400915477,Syracuse Orange,D. Coleman,61821,,False,3.0,0,0,0,0,0,0,0,0,0,0,0,0,0,0,0,0,0
400915477,Syracuse Orange,A. Autry,3934661,,False,1.0,0,1,0,0,0,1,0,1,0,1,1,0,1,0,0,0,0
400915477,Syracuse Orange,S. Belbey,3934660,,False,1.0,0,1,0,1,0,0,0,0,0,0,0,0,0,0,1,0,0
400915477,Syracuse Orange,F. Howard,3934659,,False,5.0,0,2,0,0,0,2,0,0,1,2,3,1,1,0,2,0,0
400915477,Syracuse Orange,TEAM,TOTAL,TOTAL,False,,29,54,14,30,15,24,17,22,6,27,33,18,9,4,13,12,90
400915477,Georgia Tech Yellow Jackets,Q. Stephens,66128,,True,34.0,5,13,3,5,2,8,0,0,1,5,6,4,1,0,1,2,12
400915477,Georgia Tech Yellow Jackets,B. Lammers,3135061,,True,37.0,5,9,5,9,0,0,0,0,4,5,9,3,2,2,1,0,10
400915477,Georgia Tech Yellow Jackets,C. Heyward,61609,,True,9.0,0,1,0,1,0,0,0,0,2,2,4,1,2,0,2,0,0
400915477,Georgia Tech Yellow Jackets,J. Okogie,4065663,,True,34.0,6,8,6,8,0,0,4,5,1,3,4,0,2,1,3,3,16
400915477,Georgia Tech Yellow Jackets,J. Heath,67623,,True,31.0,2,5,1,3,1,2,0,0,0,2,2,2,0,0,2,3,5
400915477,Georgia Tech Yellow Jackets,S. Ogbonda,3904627,,False,4.0,0,0,0,0,0,0,0,0,0,0,0,0,0,0,0,1,0
400915477,Georgia Tech Yellow Jackets,K. McCormick,61453,,False,6.0,1,1,0,0,1,1,0,0,0,1,1,0,0,0,0,1,3
400915477,Georgia Tech Yellow Jackets,J. Moore,4065662,,False,17.0,2,4,2,4,0,0,0,0,0,0,0,2,0,0,1,1,4
400915477,Georgia Tech Yellow Jackets,T. Jackson,3135057,,False,25.0,4,14,3,7,1,7,2,6,0,0,0,3,0,0,4,4,11
400915477,Georgia Tech Yellow Jackets,J. Price,61778,,False,3.0,0,2,0,0,0,2,0,0,0,1,1,0,1,1,0,0,0
400915477,Georgia Tech Yellow Jackets,TEAM,TOTAL,TOTAL,False,,25,57,20,37,5,20,6,11,8,23,31,15,8,4,16,15,61
400915477,Georgia Tech Yellow Jackets,Q. Stephens,66128,,True,34.0,5,13,3,5,2,8,0,0,1,5,6,4,1,0,1,2,12
400915477,Georgia Tech Yellow Jackets,B. Lammers,3135061,,True,37.0,5,9,5,9,0,0,0,0,4,5,9,3,2,2,1,0,10
400915477,Georgia Tech Yellow Jackets,C. Heyward,61609,,True,9.0,0,1,0,1,0,0,0,0,2,2,4,1,2,0,2,0,0
400915477,Georgia Tech Yellow Jackets,J. Okogie,4065663,,True,34.0,6,8,6,8,0,0,4,5,1,3,4,0,2,1,3,3,16
400915477,Georgia Tech Yellow Jackets,J. Heath,67623,,True,31.0,2,5,1,3,1,2,0,0,0,2,2,2,0,0,2,3,5
400915477,Georgia Tech Yellow Jackets,S. Ogbonda,3904627,,False,4.0,0,0,0,0,0,0,0,0,0,0,0,0,0,0,0,1,0
400915477,Georgia Tech Yellow Jackets,K. McCormick,61453,,False,6.0,1,1,0,0,1,1,0,0,0,1,1,0,0,0,0,1,3
400915477,Georgia Tech Yellow Jackets,J. Moore,4065662,,False,17.0,2,4,2,4,0,0,0,0,0,0,0,2,0,0,1,1,4
400915477,Georgia Tech Yellow Jackets,T. Jackson,3135057,,False,25.0,4,14,3,7,1,7,2,6,0,0,0,3,0,0,4,4,11
400915477,Georgia Tech Yellow Jackets,J. Price,61778,,False,3.0,0,2,0,0,0,2,0,0,0,1,1,0,1,1,0,0,0
400915477,Georgia Tech Yellow Jackets,TEAM,TOTAL,TOTAL,False,,25,57,20,37,5,20,6,11,8,23,31,15,8,4,16,15,61
400915476,Miami Hurricanes,K. Murphy,61668,,True,33.0,2,5,2,5,0,0,0,1,1,8,9,0,0,0,1,1,4
400915476,Miami Hurricanes,B. Brown,4065670,,True,32.0,4,9,2,6,2,3,0,0,0,0,0,1,2,1,1,4,10
400915476,Miami Hurricanes,A. Lawrence II,3904628,,True,26.0,0,2,0,0,0,2,2,4,0,1,1,1,0,0,2,3,2
400915476,Miami Hurricanes,J. Newton,3138145,,True,25.0,1,7,1,7,0,0,3,4,0,2,2,1,1,0,2,0,5
400915476,Miami Hurricanes,D. Reed,66130,,True,39.0,6,11,2,4,4,7,6,6,0,6,6,6,0,0,3,2,22
400915476,Miami Hurricanes,D. Hernandez,4065672,,False,15.0,2,2,2,2,0,0,1,2,0,2,2,0,1,1,2,1,5
400915476,Miami Hurricanes,E. Izundu,3904629,,False,11.0,0,0,0,0,0,0,0,0,1,1,2,0,0,0,1,3,0
400915476,Miami Hurricanes,D. Vasiljevic,4065669,,False,19.0,3,7,1,2,2,5,1,2,0,3,3,0,0,0,1,0,9
400915476,Miami Hurricanes,TEAM,TOTAL,TOTAL,False,,18,43,10,26,8,17,13,19,4,23,27,9,4,2,13,14,57
400915476,Miami Hurricanes,K. Murphy,61668,,True,33.0,2,5,2,5,0,0,0,1,1,8,9,0,0,0,1,1,4
400915476,Miami Hurricanes,B. Brown,4065670,,True,32.0,4,9,2,6,2,3,0,0,0,0,0,1,2,1,1,4,10
400915476,Miami Hurricanes,A. Lawrence II,3904628,,True,26.0,0,2,0,0,0,2,2,4,0,1,1,1,0,0,2,3,2
400915476,Miami Hurricanes,J. Newton,3138145,,True,25.0,1,7,1,7,0,0,3,4,0,2,2,1,1,0,2,0,5
400915476,Miami Hurricanes,D. Reed,66130,,True,39.0,6,11,2,4,4,7,6,6,0,6,6,6,0,0,3,2,22
400915476,Miami Hurricanes,D. Hernandez,4065672,,False,15.0,2,2,2,2,0,0,1,2,0,2,2,0,1,1,2,1,5
400915476,Miami Hurricanes,E. Izundu,3904629,,False,11.0,0,0,0,0,0,0,0,0,1,1,2,0,0,0,1,3,0
400915476,Miami Hurricanes,D. Vasiljevic,4065669,,False,19.0,3,7,1,2,2,5,1,2,0,3,3,0,0,0,1,0,9
400915476,Miami Hurricanes,TEAM,TOTAL,TOTAL,False,,18,43,10,26,8,17,13,19,4,23,27,9,4,2,13,14,57
400915476,Florida State Seminoles,J. Isaac,4065654,,True,20.0,0,3,0,1,0,2,2,2,0,3,3,1,0,1,1,3,2
400915476,Florida State Seminoles,J. Smith,66126,,True,16.0,5,10,5,10,0,0,1,1,3,2,5,1,0,0,1,1,11
400915476,Florida State Seminoles,M. Ojo,61596,,True,13.0,0,2,0,2,0,0,0,0,1,3,4,0,0,1,1,2,0
400915476,Florida State Seminoles,D. Bacon,3907821,,True,33.0,8,17,6,9,2,8,5,7,0,2,2,2,1,0,1,2,23
400915476,Florida State Seminoles,X. Rathan-Mayes,66125,,True,29.0,3,7,2,3,1,4,0,2,0,2,2,4,0,1,2,1,7
400915476,Florida State Seminoles,P. Cofer,3135054,,False,5.0,0,0,0,0,0,0,0,0,0,1,1,0,0,0,1,0,0
400915476,Florida State Seminoles,C. Koumadje,3907824,,False,14.0,3,3,3,3,0,0,0,0,1,1,2,0,0,1,0,4,6
400915476,Florida State Seminoles,B. Angola-Rodas,4065658,,False,9.0,1,3,1,2,0,1,2,2,0,1,1,0,0,0,0,0,4
400915476,Florida State Seminoles,P. Savoy,4065657,,False,5.0,1,3,0,0,1,3,0,0,0,2,2,0,0,0,0,0,3
400915476,Florida State Seminoles,T. Forrest,4065656,,False,8.0,0,0,0,0,0,0,0,0,0,1,1,2,0,0,0,0,0
400915476,Florida State Seminoles,C. Walker,4065655,,False,15.0,1,4,1,3,0,1,1,1,1,1,2,1,1,0,0,1,3
400915476,Florida State Seminoles,T. Mann,3907823,,False,33.0,3,5,3,5,0,0,1,2,4,2,6,2,1,0,2,2,7
400915476,Florida State Seminoles,TEAM,TOTAL,TOTAL,False,,25,57,21,38,4,19,12,17,11,23,34,13,3,4,9,16,66
400915476,Florida State Seminoles,J. Isaac,4065654,,True,20.0,0,3,0,1,0,2,2,2,0,3,3,1,0,1,1,3,2
400915476,Florida State Seminoles,J. Smith,66126,,True,16.0,5,10,5,10,0,0,1,1,3,2,5,1,0,0,1,1,11
400915476,Florida State Seminoles,M. Ojo,61596,,True,13.0,0,2,0,2,0,0,0,0,1,3,4,0,0,1,1,2,0
400915476,Florida State Seminoles,D. Bacon,3907821,,True,33.0,8,17,6,9,2,8,5,7,0,2,2,2,1,0,1,2,23
400915476,Florida State Seminoles,X. Rathan-Mayes,66125,,True,29.0,3,7,2,3,1,4,0,2,0,2,2,4,0,1,2,1,7
400915476,Florida State Seminoles,P. Cofer,3135054,,False,5.0,0,0,0,0,0,0,0,0,0,1,1,0,0,0,1,0,0
400915476,Florida State Seminoles,C. Koumadje,3907824,,False,14.0,3,3,3,3,0,0,0,0,1,1,2,0,0,1,0,4,6
400915476,Florida State Seminoles,B. Angola-Rodas,4065658,,False,9.0,1,3,1,2,0,1,2,2,0,1,1,0,0,0,0,0,4
400915476,Florida State Seminoles,P. Savoy,4065657,,False,5.0,1,3,0,0,1,3,0,0,0,2,2,0,0,0,0,0,3
400915476,Florida State Seminoles,T. Forrest,4065656,,False,8.0,0,0,0,0,0,0,0,0,0,1,1,2,0,0,0,0,0
400915476,Florida State Seminoles,C. Walker,4065655,,False,15.0,1,4,1,3,0,1,1,1,1,1,2,1,1,0,0,1,3
400915476,Florida State Seminoles,T. Mann,3907823,,False,33.0,3,5,3,5,0,0,1,2,4,2,6,2,1,0,2,2,7
400915476,Florida State Seminoles,TEAM,TOTAL,TOTAL,False,,25,57,21,38,4,19,12,17,11,23,34,13,3,4,9,16,66
400915475,Notre Dame Fighting Irish,B. Colson,3138192,,True,37.0,6,12,4,9,2,3,6,7,1,4,5,0,1,0,1,3,20
400915475,Notre Dame Fighting Irish,V.J. Beachem,66283,,True,36.0,7,14,4,6,3,8,0,1,1,7,8,0,0,2,1,1,17
400915475,Notre Dame Fighting Irish,R. Pflueger,3908335,,True,17.0,0,3,0,1,0,2,0,0,2,3,5,0,0,0,0,1,0
400915475,Notre Dame Fighting Irish,M. Farrell,3138190,,True,36.0,4,11,2,5,2,6,1,2,0,1,1,8,3,0,3,2,11
400915475,Notre Dame Fighting Irish,S. Vasturia,66285,,True,37.0,3,10,3,6,0,4,2,2,0,2,2,4,0,0,2,3,8
400915475,Notre Dame Fighting Irish,M. Geben,3138191,,False,16.0,2,2,2,2,0,0,0,0,3,1,4,1,2,0,0,2,4
400915475,Notre Dame Fighting Irish,A. Torres,66286,,False,2.0,0,0,0,0,0,0,0,0,0,0,0,0,0,0,0,0,0
400915475,Notre Dame Fighting Irish,M. Ryan,3908336,,False,4.0,0,1,0,0,0,1,0,0,0,0,0,1,0,0,0,0,0
400915475,Notre Dame Fighting Irish,T. Gibbs,4065703,,False,15.0,2,5,2,4,0,1,0,0,1,1,2,0,0,0,1,1,4
400915475,Notre Dame Fighting Irish,TEAM,TOTAL,TOTAL,False,,24,58,17,33,7,25,9,12,8,19,27,14,6,2,8,13,64
400915475,Notre Dame Fighting Irish,B. Colson,3138192,,True,37.0,6,12,4,9,2,3,6,7,1,4,5,0,1,0,1,3,20
400915475,Notre Dame Fighting Irish,V.J. Beachem,66283,,True,36.0,7,14,4,6,3,8,0,1,1,7,8,0,0,2,1,1,17
400915475,Notre Dame Fighting Irish,R. Pflueger,3908335,,True,17.0,0,3,0,1,0,2,0,0,2,3,5,0,0,0,0,1,0
400915475,Notre Dame Fighting Irish,M. Farrell,3138190,,True,36.0,4,11,2,5,2,6,1,2,0,1,1,8,3,0,3,2,11
400915475,Notre Dame Fighting Irish,S. Vasturia,66285,,True,37.0,3,10,3,6,0,4,2,2,0,2,2,4,0,0,2,3,8
400915475,Notre Dame Fighting Irish,M. Geben,3138191,,False,16.0,2,2,2,2,0,0,0,0,3,1,4,1,2,0,0,2,4
400915475,Notre Dame Fighting Irish,A. Torres,66286,,False,2.0,0,0,0,0,0,0,0,0,0,0,0,0,0,0,0,0,0
400915475,Notre Dame Fighting Irish,M. Ryan,3908336,,False,4.0,0,1,0,0,0,1,0,0,0,0,0,1,0,0,0,0,0
400915475,Notre Dame Fighting Irish,T. Gibbs,4065703,,False,15.0,2,5,2,4,0,1,0,0,1,1,2,0,0,0,1,1,4
400915475,Notre Dame Fighting Irish,TEAM,TOTAL,TOTAL,False,,24,58,17,33,7,25,9,12,8,19,27,14,6,2,8,13,64
400915475,Louisville Cardinals,A. Mahmoud,3147363,,True,12.0,1,4,1,4,0,0,0,0,0,4,4,0,0,1,1,2,2
400915475,Louisville Cardinals,D. Adel,3908807,,True,34.0,2,8,0,2,2,6,0,0,1,5,6,4,0,0,0,2,6
400915475,Louisville Cardinals,R. Spalding,3908806,,True,25.0,1,3,1,3,0,0,2,2,2,5,7,0,0,0,5,3,4
400915475,Louisville Cardinals,D. Mitchell,3908809,,True,40.0,5,15,2,7,3,8,7,8,1,4,5,0,2,0,1,2,20
400915475,Louisville Cardinals,Q. Snider,3147360,,True,38.0,6,8,2,3,4,5,1,2,1,1,2,6,0,0,2,0,17
400915475,Louisville Cardinals,V.J. King,4065666,,False,6.0,0,0,0,0,0,0,0,0,0,0,0,0,0,0,1,0,0
400915475,Louisville Cardinals,J. Johnson,3147362,,False,15.0,1,4,1,3,0,1,2,2,4,3,7,0,0,0,2,3,4
400915475,Louisville Cardinals,M. Mathiang,63035,,False,28.0,8,17,8,17,0,0,2,2,6,5,11,1,1,1,0,2,18
400915475,Louisville Cardinals,D. Levitch,66592,,False,1.0,0,0,0,0,0,0,0,0,0,0,0,0,0,0,0,0,0
400915475,Louisville Cardinals,T. Hicks,62752,,False,1.0,0,0,0,0,0,0,0,0,0,0,0,0,0,0,1,0,0
400915475,Louisville Cardinals,TEAM,TOTAL,TOTAL,False,,24,59,15,39,9,20,14,16,16,28,44,11,3,2,13,14,71
400915475,Louisville Cardinals,A. Mahmoud,3147363,,True,12.0,1,4,1,4,0,0,0,0,0,4,4,0,0,1,1,2,2
400915475,Louisville Cardinals,D. Adel,3908807,,True,34.0,2,8,0,2,2,6,0,0,1,5,6,4,0,0,0,2,6
400915475,Louisville Cardinals,R. Spalding,3908806,,True,25.0,1,3,1,3,0,0,2,2,2,5,7,0,0,0,5,3,4
400915475,Louisville Cardinals,D. Mitchell,3908809,,True,40.0,5,15,2,7,3,8,7,8,1,4,5,0,2,0,1,2,20
400915475,Louisville Cardinals,Q. Snider,3147360,,True,38.0,6,8,2,3,4,5,1,2,1,1,2,6,0,0,2,0,17
400915475,Louisville Cardinals,V.J. King,4065666,,False,6.0,0,0,0,0,0,0,0,0,0,0,0,0,0,0,1,0,0
400915475,Louisville Cardinals,J. Johnson,3147362,,False,15.0,1,4,1,3,0,1,2,2,4,3,7,0,0,0,2,3,4
400915475,Louisville Cardinals,M. Mathiang,63035,,False,28.0,8,17,8,17,0,0,2,2,6,5,11,1,1,1,0,2,18
400915475,Louisville Cardinals,D. Levitch,66592,,False,1.0,0,0,0,0,0,0,0,0,0,0,0,0,0,0,0,0,0
400915475,Louisville Cardinals,T. Hicks,62752,,False,1.0,0,0,0,0,0,0,0,0,0,0,0,0,0,0,1,0,0
400915475,Louisville Cardinals,TEAM,TOTAL,TOTAL,False,,24,59,15,39,9,20,14,16,16,28,44,11,3,2,13,14,71
400915474,Virginia Cavaliers,J. Salt,3138200,,True,19.0,2,6,2,6,0,0,0,0,5,4,9,1,1,1,1,1,4
400915474,Virginia Cavaliers,T. Jerome,4065733,,True,21.0,5,9,2,2,3,7,0,0,0,1,1,3,2,0,0,2,13
400915474,Virginia Cavaliers,K. Guy,4065730,,True,19.0,2,6,0,1,2,5,0,0,0,2,2,2,1,0,0,2,6
400915474,Virginia Cavaliers,L. Perrantes,66139,,True,34.0,8,12,4,6,4,6,2,2,0,3,3,3,1,0,1,0,22
400915474,Virginia Cavaliers,D. Hall,66138,,True,25.0,2,9,2,8,0,1,0,0,0,4,4,1,0,0,1,0,4
400915474,Virginia Cavaliers,M. Diakite,3947156,,False,22.0,3,5,3,5,0,0,0,0,0,4,4,0,0,0,1,4,6
400915474,Virginia Cavaliers,J. Reuter,3908374,,False,3.0,0,0,0,0,0,0,0,0,0,0,0,2,0,0,0,0,0
400915474,Virginia Cavaliers,I. Wilkins,3138203,,False,16.0,1,4,1,4,0,0,0,0,1,3,4,0,1,1,2,1,2
400915474,Virginia Cavaliers,T. Gross Jr.,4065729,,False,1.0,0,0,0,0,0,0,0,0,0,0,0,0,0,0,0,0,0
400915474,Virginia Cavaliers,J. Bartley,3947155,,False,2.0,0,1,0,1,0,0,0,0,0,1,1,0,0,0,0,0,0
400915474,Virginia Cavaliers,M. Shayok,3138201,,False,14.0,1,4,1,4,0,0,0,0,0,0,0,0,1,0,0,0,2
400915474,Virginia Cavaliers,D. Thompson,66274,,False,24.0,3,6,1,3,2,3,0,0,1,1,2,1,1,0,1,1,8
400915474,Virginia Cavaliers,TEAM,TOTAL,TOTAL,False,,27,62,16,40,11,22,2,2,11,25,36,13,8,2,7,11,67
400915474,Virginia Cavaliers,J. Salt,3138200,,True,19.0,2,6,2,6,0,0,0,0,5,4,9,1,1,1,1,1,4
400915474,Virginia Cavaliers,T. Jerome,4065733,,True,21.0,5,9,2,2,3,7,0,0,0,1,1,3,2,0,0,2,13
400915474,Virginia Cavaliers,K. Guy,4065730,,True,19.0,2,6,0,1,2,5,0,0,0,2,2,2,1,0,0,2,6
400915474,Virginia Cavaliers,L. Perrantes,66139,,True,34.0,8,12,4,6,4,6,2,2,0,3,3,3,1,0,1,0,22
400915474,Virginia Cavaliers,D. Hall,66138,,True,25.0,2,9,2,8,0,1,0,0,0,4,4,1,0,0,1,0,4
400915474,Virginia Cavaliers,M. Diakite,3947156,,False,22.0,3,5,3,5,0,0,0,0,0,4,4,0,0,0,1,4,6
400915474,Virginia Cavaliers,J. Reuter,3908374,,False,3.0,0,0,0,0,0,0,0,0,0,0,0,2,0,0,0,0,0
400915474,Virginia Cavaliers,I. Wilkins,3138203,,False,16.0,1,4,1,4,0,0,0,0,1,3,4,0,1,1,2,1,2
400915474,Virginia Cavaliers,T. Gross Jr.,4065729,,False,1.0,0,0,0,0,0,0,0,0,0,0,0,0,0,0,0,0,0
400915474,Virginia Cavaliers,J. Bartley,3947155,,False,2.0,0,1,0,1,0,0,0,0,0,1,1,0,0,0,0,0,0
400915474,Virginia Cavaliers,M. Shayok,3138201,,False,14.0,1,4,1,4,0,0,0,0,0,0,0,0,1,0,0,0,2
400915474,Virginia Cavaliers,D. Thompson,66274,,False,24.0,3,6,1,3,2,3,0,0,1,1,2,1,1,0,1,1,8
400915474,Virginia Cavaliers,TEAM,TOTAL,TOTAL,False,,27,62,16,40,11,22,2,2,11,25,36,13,8,2,7,11,67
400915474,Pittsburgh Panthers,R. Luther,3138197,,True,23.0,2,5,1,3,1,2,2,2,2,1,3,0,0,2,1,2,7
400915474,Pittsburgh Panthers,S. Jeter,61756,,True,25.0,0,4,0,2,0,2,0,0,1,4,5,0,0,1,0,0,0
400915474,Pittsburgh Panthers,J. Milligan,3934655,,True,24.0,0,2,0,1,0,1,2,2,0,1,1,1,0,0,1,0,2
400915474,Pittsburgh Panthers,C. Johnson,3138196,,True,34.0,4,10,3,4,1,6,0,0,1,4,5,2,4,1,1,2,9
400915474,Pittsburgh Panthers,C. Jones,61219,,True,27.0,2,6,2,4,0,2,2,2,0,2,2,0,0,0,4,2,6
400915474,Pittsburgh Panthers,R. Nix,3934653,,False,3.0,0,0,0,0,0,0,0,0,0,0,0,0,0,0,0,1,0
400915474,Pittsburgh Panthers,C. Manigault,4065714,,False,2.0,0,0,0,0,0,0,0,0,0,0,0,0,0,0,0,0,0
400915474,Pittsburgh Panthers,M. Young,66290,,False,27.0,5,13,3,8,2,5,2,2,1,2,3,2,1,0,2,0,14
400915474,Pittsburgh Panthers,J. Artis,66287,,False,27.0,2,4,2,3,0,1,0,0,0,6,6,1,0,0,4,0,4
400915474,Pittsburgh Panthers,Z. Smith,3934654,,False,1.0,0,0,0,0,0,0,0,0,0,0,0,0,0,0,0,0,0
400915474,Pittsburgh Panthers,D. Wilson,3934652,,False,7.0,0,1,0,0,0,1,0,0,0,1,1,0,0,0,1,0,0
400915474,Pittsburgh Panthers,TEAM,TOTAL,TOTAL,False,,15,45,11,25,4,20,8,8,5,24,29,6,5,4,14,7,42
400915474,Pittsburgh Panthers,R. Luther,3138197,,True,23.0,2,5,1,3,1,2,2,2,2,1,3,0,0,2,1,2,7
400915474,Pittsburgh Panthers,S. Jeter,61756,,True,25.0,0,4,0,2,0,2,0,0,1,4,5,0,0,1,0,0,0
400915474,Pittsburgh Panthers,J. Milligan,3934655,,True,24.0,0,2,0,1,0,1,2,2,0,1,1,1,0,0,1,0,2
400915474,Pittsburgh Panthers,C. Johnson,3138196,,True,34.0,4,10,3,4,1,6,0,0,1,4,5,2,4,1,1,2,9
400915474,Pittsburgh Panthers,C. Jones,61219,,True,27.0,2,6,2,4,0,2,2,2,0,2,2,0,0,0,4,2,6
400915474,Pittsburgh Panthers,R. Nix,3934653,,False,3.0,0,0,0,0,0,0,0,0,0,0,0,0,0,0,0,1,0
400915474,Pittsburgh Panthers,C. Manigault,4065714,,False,2.0,0,0,0,0,0,0,0,0,0,0,0,0,0,0,0,0,0
400915474,Pittsburgh Panthers,M. Young,66290,,False,27.0,5,13,3,8,2,5,2,2,1,2,3,2,1,0,2,0,14
400915474,Pittsburgh Panthers,J. Artis,66287,,False,27.0,2,4,2,3,0,1,0,0,0,6,6,1,0,0,4,0,4
400915474,Pittsburgh Panthers,Z. Smith,3934654,,False,1.0,0,0,0,0,0,0,0,0,0,0,0,0,0,0,0,0,0
400915474,Pittsburgh Panthers,D. Wilson,3934652,,False,7.0,0,1,0,0,0,1,0,0,0,1,1,0,0,0,1,0,0
400915474,Pittsburgh Panthers,TEAM,TOTAL,TOTAL,False,,15,45,11,25,4,20,8,8,5,24,29,6,5,4,14,7,42
400915473,Wake Forest Demon Deacons,J. Collins,3908845,,True,29.0,7,12,7,12,0,0,11,12,5,6,11,0,1,2,1,2,25
400915473,Wake Forest Demon Deacons,G. McClinton,66140,,True,2.0,0,0,0,0,0,0,0,0,0,0,0,0,0,0,0,0,0
400915473,Wake Forest Demon Deacons,A. Arians,61378,,True,12.0,1,4,0,1,1,3,2,2,0,1,1,1,0,0,2,1,5
400915473,Wake Forest Demon Deacons,B. Crawford,3908844,,True,34.0,4,15,3,9,1,6,3,6,1,3,4,2,1,1,1,0,12
400915473,Wake Forest Demon Deacons,T. VanHorn,3078214,,True,1.0,0,0,0,0,0,0,0,0,0,0,0,0,0,0,0,0,0
400915473,Wake Forest Demon Deacons,D. Mitoglou,3138224,,False,33.0,3,6,1,1,2,5,4,6,2,5,7,1,2,0,0,2,12
400915473,Wake Forest Demon Deacons,S. Japhet-Mathias,4065752,,False,8.0,0,0,0,0,0,0,0,0,0,1,1,0,0,1,0,1,0
400915473,Wake Forest Demon Deacons,D. Moore,3908843,,False,5.0,0,0,0,0,0,0,0,0,0,0,0,0,0,0,0,4,0
400915473,Wake Forest Demon Deacons,B. Childress,4065750,,False,26.0,1,3,1,2,0,1,1,2,0,3,3,4,2,0,1,2,3
400915473,Wake Forest Demon Deacons,M. Wilbekin,3138222,,False,21.0,3,4,0,1,3,3,2,2,0,1,1,1,0,0,3,2,11
400915473,Wake Forest Demon Deacons,K. Woods,3132360,,False,29.0,7,12,4,6,3,6,3,6,2,2,4,4,0,0,1,3,20
400915473,Wake Forest Demon Deacons,TEAM,TOTAL,TOTAL,False,,26,56,16,32,10,24,26,36,11,23,34,13,6,4,9,17,88
400915473,Wake Forest Demon Deacons,J. Collins,3908845,,True,29.0,7,12,7,12,0,0,11,12,5,6,11,0,1,2,1,2,25
400915473,Wake Forest Demon Deacons,G. McClinton,66140,,True,2.0,0,0,0,0,0,0,0,0,0,0,0,0,0,0,0,0,0
400915473,Wake Forest Demon Deacons,A. Arians,61378,,True,12.0,1,4,0,1,1,3,2,2,0,1,1,1,0,0,2,1,5
400915473,Wake Forest Demon Deacons,B. Crawford,3908844,,True,34.0,4,15,3,9,1,6,3,6,1,3,4,2,1,1,1,0,12
400915473,Wake Forest Demon Deacons,T. VanHorn,3078214,,True,1.0,0,0,0,0,0,0,0,0,0,0,0,0,0,0,0,0,0
400915473,Wake Forest Demon Deacons,D. Mitoglou,3138224,,False,33.0,3,6,1,1,2,5,4,6,2,5,7,1,2,0,0,2,12
400915473,Wake Forest Demon Deacons,S. Japhet-Mathias,4065752,,False,8.0,0,0,0,0,0,0,0,0,0,1,1,0,0,1,0,1,0
400915473,Wake Forest Demon Deacons,D. Moore,3908843,,False,5.0,0,0,0,0,0,0,0,0,0,0,0,0,0,0,0,4,0
400915473,Wake Forest Demon Deacons,B. Childress,4065750,,False,26.0,1,3,1,2,0,1,1,2,0,3,3,4,2,0,1,2,3
400915473,Wake Forest Demon Deacons,M. Wilbekin,3138222,,False,21.0,3,4,0,1,3,3,2,2,0,1,1,1,0,0,3,2,11
400915473,Wake Forest Demon Deacons,K. Woods,3132360,,False,29.0,7,12,4,6,3,6,3,6,2,2,4,4,0,0,1,3,20
400915473,Wake Forest Demon Deacons,TEAM,TOTAL,TOTAL,False,,26,56,16,32,10,24,26,36,11,23,34,13,6,4,9,17,88
400915473,Louisville Cardinals,D. Adel,3908807,,True,40.0,9,16,8,13,1,3,3,3,1,4,5,3,1,0,1,4,22
400915473,Louisville Cardinals,R. Spalding,3908806,,True,21.0,4,7,4,7,0,0,1,2,3,5,8,0,0,2,1,3,9
400915473,Louisville Cardinals,A. Mahmoud,3147363,,True,10.0,0,0,0,0,0,0,0,2,0,3,3,0,0,1,1,4,0
400915473,Louisville Cardinals,D. Mitchell,3908809,,True,30.0,2,9,1,1,1,8,2,2,0,4,4,3,3,0,1,5,7
400915473,Louisville Cardinals,Q. Snider,3147360,,True,29.0,5,12,3,7,2,5,3,3,0,3,3,2,0,0,1,2,15
400915473,Louisville Cardinals,V.J. King,4065666,,False,9.0,0,0,0,0,0,0,0,0,0,0,0,0,0,0,0,1,0
400915473,Louisville Cardinals,J. Johnson,3147362,,False,14.0,4,5,3,4,1,1,4,4,0,0,0,0,0,0,2,5,13
400915473,Louisville Cardinals,M. Mathiang,63035,,False,29.0,5,10,5,10,0,0,2,2,6,4,10,2,2,1,1,1,12
400915473,Louisville Cardinals,M. Stockman,3147361,,False,1.0,0,0,0,0,0,0,0,0,0,0,0,0,0,0,0,0,0
400915473,Louisville Cardinals,R. McMahon,3908808,,False,2.0,0,1,0,0,0,1,0,0,0,0,0,0,0,0,1,0,0
400915473,Louisville Cardinals,J. Henderson,3155491,,False,1.0,0,0,0,0,0,0,0,0,0,0,0,0,0,0,0,0,0
400915473,Louisville Cardinals,D. Levitch,66592,,False,3.0,0,0,0,0,0,0,0,0,0,0,0,1,0,0,1,1,0
400915473,Louisville Cardinals,T. Hicks,62752,,False,11.0,0,1,0,1,0,0,3,4,0,1,1,1,0,0,2,0,3
400915473,Louisville Cardinals,TEAM,TOTAL,TOTAL,False,,29,61,24,43,5,18,18,22,12,25,37,12,6,4,12,27,81
400915473,Louisville Cardinals,D. Adel,3908807,,True,40.0,9,16,8,13,1,3,3,3,1,4,5,3,1,0,1,4,22
400915473,Louisville Cardinals,R. Spalding,3908806,,True,21.0,4,7,4,7,0,0,1,2,3,5,8,0,0,2,1,3,9
400915473,Louisville Cardinals,A. Mahmoud,3147363,,True,10.0,0,0,0,0,0,0,0,2,0,3,3,0,0,1,1,4,0
400915473,Louisville Cardinals,D. Mitchell,3908809,,True,30.0,2,9,1,1,1,8,2,2,0,4,4,3,3,0,1,5,7
400915473,Louisville Cardinals,Q. Snider,3147360,,True,29.0,5,12,3,7,2,5,3,3,0,3,3,2,0,0,1,2,15
400915473,Louisville Cardinals,V.J. King,4065666,,False,9.0,0,0,0,0,0,0,0,0,0,0,0,0,0,0,0,1,0
400915473,Louisville Cardinals,J. Johnson,3147362,,False,14.0,4,5,3,4,1,1,4,4,0,0,0,0,0,0,2,5,13
400915473,Louisville Cardinals,M. Mathiang,63035,,False,29.0,5,10,5,10,0,0,2,2,6,4,10,2,2,1,1,1,12
400915473,Louisville Cardinals,M. Stockman,3147361,,False,1.0,0,0,0,0,0,0,0,0,0,0,0,0,0,0,0,0,0
400915473,Louisville Cardinals,R. McMahon,3908808,,False,2.0,0,1,0,0,0,1,0,0,0,0,0,0,0,0,1,0,0
400915473,Louisville Cardinals,J. Henderson,3155491,,False,1.0,0,0,0,0,0,0,0,0,0,0,0,0,0,0,0,0,0
400915473,Louisville Cardinals,D. Levitch,66592,,False,3.0,0,0,0,0,0,0,0,0,0,0,0,1,0,0,1,1,0
400915473,Louisville Cardinals,T. Hicks,62752,,False,11.0,0,1,0,1,0,0,3,4,0,1,1,1,0,0,2,0,3
400915473,Louisville Cardinals,TEAM,TOTAL,TOTAL,False,,29,61,24,43,5,18,18,22,12,25,37,12,6,4,12,27,81
400915472,Notre Dame Fighting Irish,B. Colson,3138192,,True,28.0,7,13,7,12,0,1,4,6,5,6,11,3,1,2,1,1,18
400915472,Notre Dame Fighting Irish,V.J. Beachem,66283,,True,34.0,8,17,4,7,4,10,2,2,0,4,4,0,1,0,1,1,22
400915472,Notre Dame Fighting Irish,R. Pflueger,3908335,,True,23.0,2,3,1,1,1,2,1,4,1,3,4,1,0,0,1,2,6
400915472,Notre Dame Fighting Irish,M. Farrell,3138190,,True,28.0,5,11,3,5,2,6,2,2,0,3,3,3,2,0,1,4,14
400915472,Notre Dame Fighting Irish,S. Vasturia,66285,,True,35.0,4,10,2,4,2,6,0,0,1,4,5,3,0,0,0,0,10
400915472,Notre Dame Fighting Irish,J. Mooney,4065705,,False,1.0,0,0,0,0,0,0,0,0,0,0,0,0,0,0,0,0,0
400915472,Notre Dame Fighting Irish,E. Burns,3908337,,False,1.0,0,0,0,0,0,0,0,0,0,0,0,1,1,0,0,0,0
400915472,Notre Dame Fighting Irish,M. Gregory,3155402,,False,1.0,0,0,0,0,0,0,0,0,0,0,0,0,0,0,0,0,0
400915472,Notre Dame Fighting Irish,M. Geben,3138191,,False,10.0,3,4,3,4,0,0,0,0,3,1,4,1,1,0,1,1,6
400915472,Notre Dame Fighting Irish,P. Mazza,3125206,,False,1.0,1,2,1,2,0,0,0,0,0,1,1,0,0,1,1,0,2
400915472,Notre Dame Fighting Irish,A. Torres,66286,,False,6.0,0,0,0,0,0,0,0,0,0,1,1,1,1,0,0,1,0
400915472,Notre Dame Fighting Irish,M. Ryan,3908336,,False,11.0,0,0,0,0,0,0,0,0,0,1,1,0,0,0,0,0,0
400915472,Notre Dame Fighting Irish,T. Gibbs,4065703,,False,21.0,2,8,2,6,0,2,0,0,1,2,3,4,2,0,1,1,4
400915472,Notre Dame Fighting Irish,TEAM,TOTAL,TOTAL,False,,32,68,23,41,9,27,9,14,12,28,40,17,9,3,7,11,82
400915472,Notre Dame Fighting Irish,B. Colson,3138192,,True,28.0,7,13,7,12,0,1,4,6,5,6,11,3,1,2,1,1,18
400915472,Notre Dame Fighting Irish,V.J. Beachem,66283,,True,34.0,8,17,4,7,4,10,2,2,0,4,4,0,1,0,1,1,22
400915472,Notre Dame Fighting Irish,R. Pflueger,3908335,,True,23.0,2,3,1,1,1,2,1,4,1,3,4,1,0,0,1,2,6
400915472,Notre Dame Fighting Irish,M. Farrell,3138190,,True,28.0,5,11,3,5,2,6,2,2,0,3,3,3,2,0,1,4,14
400915472,Notre Dame Fighting Irish,S. Vasturia,66285,,True,35.0,4,10,2,4,2,6,0,0,1,4,5,3,0,0,0,0,10
400915472,Notre Dame Fighting Irish,J. Mooney,4065705,,False,1.0,0,0,0,0,0,0,0,0,0,0,0,0,0,0,0,0,0
400915472,Notre Dame Fighting Irish,E. Burns,3908337,,False,1.0,0,0,0,0,0,0,0,0,0,0,0,1,1,0,0,0,0
400915472,Notre Dame Fighting Irish,M. Gregory,3155402,,False,1.0,0,0,0,0,0,0,0,0,0,0,0,0,0,0,0,0,0
400915472,Notre Dame Fighting Irish,M. Geben,3138191,,False,10.0,3,4,3,4,0,0,0,0,3,1,4,1,1,0,1,1,6
400915472,Notre Dame Fighting Irish,P. Mazza,3125206,,False,1.0,1,2,1,2,0,0,0,0,0,1,1,0,0,1,1,0,2
400915472,Notre Dame Fighting Irish,A. Torres,66286,,False,6.0,0,0,0,0,0,0,0,0,0,1,1,1,1,0,0,1,0
400915472,Notre Dame Fighting Irish,M. Ryan,3908336,,False,11.0,0,0,0,0,0,0,0,0,0,1,1,0,0,0,0,0,0
400915472,Notre Dame Fighting Irish,T. Gibbs,4065703,,False,21.0,2,8,2,6,0,2,0,0,1,2,3,4,2,0,1,1,4
400915472,Notre Dame Fighting Irish,TEAM,TOTAL,TOTAL,False,,32,68,23,41,9,27,9,14,12,28,40,17,9,3,7,11,82
400915472,Boston College Eagles,A.J. Turner,3943608,,True,33.0,5,10,2,4,3,6,0,0,1,2,3,1,0,0,1,2,13
400915472,Boston College Eagles,M. Jeffers,61901,,True,20.0,6,10,6,10,0,0,0,1,3,9,12,0,0,0,1,1,12
400915472,Boston College Eagles,K. Bowman,4065635,,True,38.0,5,12,1,5,4,7,5,5,1,5,6,3,3,0,3,2,19
400915472,Boston College Eagles,J. Robinson,3943606,,True,37.0,3,13,2,8,1,5,2,2,1,4,5,6,0,1,5,0,9
400915472,Boston College Eagles,J. Chatman,3135095,,True,30.0,2,3,1,1,1,2,0,0,0,0,0,1,1,0,2,1,5
400915472,Boston College Eagles,J. Reyes,3943609,,False,3.0,1,1,1,1,0,0,0,0,0,0,0,0,0,1,0,0,2
400915472,Boston College Eagles,M. Sagay,4065638,,False,3.0,0,1,0,1,0,0,0,0,0,1,1,0,1,1,1,0,0
400915472,Boston College Eagles,N. Popovic,4065637,,False,16.0,3,7,3,7,0,0,0,0,0,3,3,0,0,0,1,2,6
400915472,Boston College Eagles,G. Owens,66277,,False,4.0,0,2,0,0,0,2,0,0,0,0,0,0,0,0,0,0,0
400915472,Boston College Eagles,C. Tava,61446,,False,16.0,0,1,0,1,0,0,0,0,2,3,5,3,0,0,1,1,0
400915472,Boston College Eagles,TEAM,TOTAL,TOTAL,False,,25,60,16,38,9,22,7,8,8,28,36,14,5,3,15,9,66
400915472,Boston College Eagles,A.J. Turner,3943608,,True,33.0,5,10,2,4,3,6,0,0,1,2,3,1,0,0,1,2,13
400915472,Boston College Eagles,M. Jeffers,61901,,True,20.0,6,10,6,10,0,0,0,1,3,9,12,0,0,0,1,1,12
400915472,Boston College Eagles,K. Bowman,4065635,,True,38.0,5,12,1,5,4,7,5,5,1,5,6,3,3,0,3,2,19
400915472,Boston College Eagles,J. Robinson,3943606,,True,37.0,3,13,2,8,1,5,2,2,1,4,5,6,0,1,5,0,9
400915472,Boston College Eagles,J. Chatman,3135095,,True,30.0,2,3,1,1,1,2,0,0,0,0,0,1,1,0,2,1,5
400915472,Boston College Eagles,J. Reyes,3943609,,False,3.0,1,1,1,1,0,0,0,0,0,0,0,0,0,1,0,0,2
400915472,Boston College Eagles,M. Sagay,4065638,,False,3.0,0,1,0,1,0,0,0,0,0,1,1,0,1,1,1,0,0
400915472,Boston College Eagles,N. Popovic,4065637,,False,16.0,3,7,3,7,0,0,0,0,0,3,3,0,0,0,1,2,6
400915472,Boston College Eagles,G. Owens,66277,,False,4.0,0,2,0,0,0,2,0,0,0,0,0,0,0,0,0,0,0
400915472,Boston College Eagles,C. Tava,61446,,False,16.0,0,1,0,1,0,0,0,0,2,3,5,3,0,0,1,1,0
400915472,Boston College Eagles,TEAM,TOTAL,TOTAL,False,,25,60,16,38,9,22,7,8,8,28,36,14,5,3,15,9,66
400915471,NC State Wolfpack,A. Abu,3138158,,True,35.0,8,14,8,14,0,0,2,2,0,3,3,1,1,0,0,3,18
400915471,NC State Wolfpack,M. Rowan,3947151,,True,36.0,4,10,2,5,2,5,2,2,0,4,4,1,1,0,1,1,12
400915471,NC State Wolfpack,M. Johnson,4065699,,True,9.0,0,0,0,0,0,0,0,0,0,2,2,1,0,1,0,1,0
400915471,NC State Wolfpack,D. Smith Jr.,4065697,,True,40.0,5,11,4,7,1,4,2,2,1,7,8,5,0,2,2,0,13
400915471,NC State Wolfpack,T. Henderson,61215,,True,22.0,5,9,2,3,3,6,0,0,1,3,4,0,2,2,1,4,13
400915471,NC State Wolfpack,T. Kapita,4065701,,False,18.0,3,5,3,5,0,0,0,0,2,1,3,1,0,1,2,4,6
400915471,NC State Wolfpack,O. Yurtseven,66768,,False,19.0,2,7,2,7,0,0,0,0,2,1,3,1,0,0,2,2,4
400915471,NC State Wolfpack,S. Kirk,3947150,,False,2.0,0,1,0,0,0,1,0,0,0,0,0,0,0,0,0,0,0
400915471,NC State Wolfpack,T. Dorn,3132359,,False,19.0,3,4,2,2,1,2,1,2,0,1,1,0,0,0,0,0,8
400915471,NC State Wolfpack,TEAM,TOTAL,TOTAL,False,,30,61,23,43,7,18,7,8,7,25,32,10,4,6,8,15,74
400915471,NC State Wolfpack,A. Abu,3138158,,True,35.0,8,14,8,14,0,0,2,2,0,3,3,1,1,0,0,3,18
400915471,NC State Wolfpack,M. Rowan,3947151,,True,36.0,4,10,2,5,2,5,2,2,0,4,4,1,1,0,1,1,12
400915471,NC State Wolfpack,M. Johnson,4065699,,True,9.0,0,0,0,0,0,0,0,0,0,2,2,1,0,1,0,1,0
400915471,NC State Wolfpack,D. Smith Jr.,4065697,,True,40.0,5,11,4,7,1,4,2,2,1,7,8,5,0,2,2,0,13
400915471,NC State Wolfpack,T. Henderson,61215,,True,22.0,5,9,2,3,3,6,0,0,1,3,4,0,2,2,1,4,13
400915471,NC State Wolfpack,T. Kapita,4065701,,False,18.0,3,5,3,5,0,0,0,0,2,1,3,1,0,1,2,4,6
400915471,NC State Wolfpack,O. Yurtseven,66768,,False,19.0,2,7,2,7,0,0,0,0,2,1,3,1,0,0,2,2,4
400915471,NC State Wolfpack,S. Kirk,3947150,,False,2.0,0,1,0,0,0,1,0,0,0,0,0,0,0,0,0,0,0
400915471,NC State Wolfpack,T. Dorn,3132359,,False,19.0,3,4,2,2,1,2,1,2,0,1,1,0,0,0,0,0,8
400915471,NC State Wolfpack,TEAM,TOTAL,TOTAL,False,,30,61,23,43,7,18,7,8,7,25,32,10,4,6,8,15,74
400915471,Clemson Tigers,D. Grantham,3129674,,True,17.0,0,2,0,1,0,1,0,2,0,1,1,0,0,0,1,0,0
400915471,Clemson Tigers,J. Blossomgame,61835,,True,34.0,5,15,4,13,1,2,5,6,1,7,8,2,0,1,2,1,16
400915471,Clemson Tigers,S. Djitte,66122,,True,32.0,3,3,3,3,0,0,6,7,5,4,9,2,0,2,1,1,12
400915471,Clemson Tigers,S. Mitchell,3136699,,True,22.0,7,10,5,7,2,3,0,0,1,1,2,0,0,0,0,0,16
400915471,Clemson Tigers,A. Holmes,62043,,True,29.0,3,9,2,5,1,4,0,0,0,4,4,2,0,0,2,1,7
400915471,Clemson Tigers,E. Thomas,3947075,,False,14.0,3,5,3,5,0,0,0,0,3,1,4,1,0,0,1,2,6
400915471,Clemson Tigers,T. Hudson,3917986,,False,6.0,0,1,0,0,0,1,0,0,1,1,2,0,0,0,0,1,0
400915471,Clemson Tigers,M. Reed,3133969,,False,18.0,4,8,3,6,1,2,2,2,0,3,3,1,1,0,0,3,11
400915471,Clemson Tigers,G. DeVoe,3129673,,False,28.0,4,9,2,5,2,4,0,1,0,1,1,1,1,0,0,2,10
400915471,Clemson Tigers,TEAM,TOTAL,TOTAL,False,,29,62,22,45,7,17,13,18,12,24,36,9,2,3,7,11,78
400915471,Clemson Tigers,D. Grantham,3129674,,True,17.0,0,2,0,1,0,1,0,2,0,1,1,0,0,0,1,0,0
400915471,Clemson Tigers,J. Blossomgame,61835,,True,34.0,5,15,4,13,1,2,5,6,1,7,8,2,0,1,2,1,16
400915471,Clemson Tigers,S. Djitte,66122,,True,32.0,3,3,3,3,0,0,6,7,5,4,9,2,0,2,1,1,12
400915471,Clemson Tigers,S. Mitchell,3136699,,True,22.0,7,10,5,7,2,3,0,0,1,1,2,0,0,0,0,0,16
400915471,Clemson Tigers,A. Holmes,62043,,True,29.0,3,9,2,5,1,4,0,0,0,4,4,2,0,0,2,1,7
400915471,Clemson Tigers,E. Thomas,3947075,,False,14.0,3,5,3,5,0,0,0,0,3,1,4,1,0,0,1,2,6
400915471,Clemson Tigers,T. Hudson,3917986,,False,6.0,0,1,0,0,0,1,0,0,1,1,2,0,0,0,0,1,0
400915471,Clemson Tigers,M. Reed,3133969,,False,18.0,4,8,3,6,1,2,2,2,0,3,3,1,1,0,0,3,11
400915471,Clemson Tigers,G. DeVoe,3129673,,False,28.0,4,9,2,5,2,4,0,1,0,1,1,1,1,0,0,2,10
400915471,Clemson Tigers,TEAM,TOTAL,TOTAL,False,,29,62,22,45,7,17,13,18,12,24,36,9,2,3,7,11,78
400915470,Pittsburgh Panthers,M. Young,66290,,True,29.0,6,14,5,10,1,4,3,5,1,3,4,1,1,0,2,0,16
400915470,Pittsburgh Panthers,J. Artis,66287,,True,35.0,5,13,4,8,1,5,1,3,2,3,5,4,0,0,5,2,12
400915470,Pittsburgh Panthers,S. Jeter,61756,,True,36.0,3,8,2,5,1,3,0,0,1,6,7,2,1,3,1,3,7
400915470,Pittsburgh Panthers,C. Johnson,3138196,,True,36.0,5,10,2,3,3,7,0,0,0,4,4,3,1,0,1,1,13
400915470,Pittsburgh Panthers,C. Jones,61219,,True,32.0,1,1,0,0,1,1,0,0,0,6,6,3,3,0,1,4,3
400915470,Pittsburgh Panthers,R. Nix,3934653,,False,2.0,0,1,0,1,0,0,0,0,0,0,0,0,0,0,0,0,0
400915470,Pittsburgh Panthers,C. Manigault,4065714,,False,0.0,0,0,0,0,0,0,0,0,0,0,0,0,0,0,0,0,0
400915470,Pittsburgh Panthers,R. Luther,3138197,,False,13.0,0,1,0,1,0,0,1,2,1,2,3,0,1,0,1,3,1
400915470,Pittsburgh Panthers,J. Kithcart,4065713,,False,9.0,0,1,0,1,0,0,0,0,0,0,0,0,1,0,0,1,0
400915470,Pittsburgh Panthers,J. Milligan,3934655,,False,6.0,0,3,0,0,0,3,0,0,0,0,0,0,0,0,0,0,0
400915470,Pittsburgh Panthers,D. Wilson,3934652,,False,2.0,0,1,0,1,0,0,0,0,0,0,0,0,0,0,0,0,0
400915470,Pittsburgh Panthers,TEAM,TOTAL,TOTAL,False,,20,53,13,30,7,23,5,10,6,25,31,13,8,3,13,14,52
400915470,Pittsburgh Panthers,M. Young,66290,,True,29.0,6,14,5,10,1,4,3,5,1,3,4,1,1,0,2,0,16
400915470,Pittsburgh Panthers,J. Artis,66287,,True,35.0,5,13,4,8,1,5,1,3,2,3,5,4,0,0,5,2,12
400915470,Pittsburgh Panthers,S. Jeter,61756,,True,36.0,3,8,2,5,1,3,0,0,1,6,7,2,1,3,1,3,7
400915470,Pittsburgh Panthers,C. Johnson,3138196,,True,36.0,5,10,2,3,3,7,0,0,0,4,4,3,1,0,1,1,13
400915470,Pittsburgh Panthers,C. Jones,61219,,True,32.0,1,1,0,0,1,1,0,0,0,6,6,3,3,0,1,4,3
400915470,Pittsburgh Panthers,R. Nix,3934653,,False,2.0,0,1,0,1,0,0,0,0,0,0,0,0,0,0,0,0,0
400915470,Pittsburgh Panthers,C. Manigault,4065714,,False,0.0,0,0,0,0,0,0,0,0,0,0,0,0,0,0,0,0,0
400915470,Pittsburgh Panthers,R. Luther,3138197,,False,13.0,0,1,0,1,0,0,1,2,1,2,3,0,1,0,1,3,1
400915470,Pittsburgh Panthers,J. Kithcart,4065713,,False,9.0,0,1,0,1,0,0,0,0,0,0,0,0,1,0,0,1,0
400915470,Pittsburgh Panthers,J. Milligan,3934655,,False,6.0,0,3,0,0,0,3,0,0,0,0,0,0,0,0,0,0,0
400915470,Pittsburgh Panthers,D. Wilson,3934652,,False,2.0,0,1,0,1,0,0,0,0,0,0,0,0,0,0,0,0,0
400915470,Pittsburgh Panthers,TEAM,TOTAL,TOTAL,False,,20,53,13,30,7,23,5,10,6,25,31,13,8,3,13,14,52
400915470,Georgia Tech Yellow Jackets,Q. Stephens,66128,,True,38.0,4,10,3,5,1,5,0,0,0,6,6,5,1,0,2,2,9
400915470,Georgia Tech Yellow Jackets,B. Lammers,3135061,,True,35.0,8,13,8,13,0,0,4,4,2,2,4,0,2,1,0,2,20
400915470,Georgia Tech Yellow Jackets,J. Okogie,4065663,,True,35.0,5,9,5,8,0,1,4,7,1,6,7,0,2,2,2,4,14
400915470,Georgia Tech Yellow Jackets,J. Heath,67623,,True,35.0,3,4,1,1,2,3,1,2,0,6,6,5,0,0,5,0,9
400915470,Georgia Tech Yellow Jackets,C. Heyward,61609,,True,10.0,0,2,0,0,0,2,1,2,0,2,2,0,0,0,0,0,1
400915470,Georgia Tech Yellow Jackets,S. Ogbonda,3904627,,False,5.0,1,1,1,1,0,0,0,0,0,0,0,0,0,0,0,0,2
400915470,Georgia Tech Yellow Jackets,R. Rowland,67543,,False,0.0,0,0,0,0,0,0,0,0,0,0,0,0,0,0,0,0,0
400915470,Georgia Tech Yellow Jackets,K. McCormick,61453,,False,2.0,0,0,0,0,0,0,0,0,0,0,0,0,0,0,0,0,0
400915470,Georgia Tech Yellow Jackets,J. Moore,4065662,,False,13.0,1,4,1,3,0,1,0,0,0,2,2,2,0,0,0,1,2
400915470,Georgia Tech Yellow Jackets,T. Jackson,3135057,,False,27.0,2,9,2,7,0,2,0,0,0,1,1,2,0,0,1,2,4
400915470,Georgia Tech Yellow Jackets,J. Price,61778,,False,0.0,0,0,0,0,0,0,0,0,0,0,0,0,0,0,0,0,0
400915470,Georgia Tech Yellow Jackets,TEAM,TOTAL,TOTAL,False,,24,52,21,38,3,14,10,15,5,28,33,14,5,3,11,11,61
400915470,Georgia Tech Yellow Jackets,Q. Stephens,66128,,True,38.0,4,10,3,5,1,5,0,0,0,6,6,5,1,0,2,2,9
400915470,Georgia Tech Yellow Jackets,B. Lammers,3135061,,True,35.0,8,13,8,13,0,0,4,4,2,2,4,0,2,1,0,2,20
400915470,Georgia Tech Yellow Jackets,J. Okogie,4065663,,True,35.0,5,9,5,8,0,1,4,7,1,6,7,0,2,2,2,4,14
400915470,Georgia Tech Yellow Jackets,J. Heath,67623,,True,35.0,3,4,1,1,2,3,1,2,0,6,6,5,0,0,5,0,9
400915470,Georgia Tech Yellow Jackets,C. Heyward,61609,,True,10.0,0,2,0,0,0,2,1,2,0,2,2,0,0,0,0,0,1
400915470,Georgia Tech Yellow Jackets,S. Ogbonda,3904627,,False,5.0,1,1,1,1,0,0,0,0,0,0,0,0,0,0,0,0,2
400915470,Georgia Tech Yellow Jackets,R. Rowland,67543,,False,0.0,0,0,0,0,0,0,0,0,0,0,0,0,0,0,0,0,0
400915470,Georgia Tech Yellow Jackets,K. McCormick,61453,,False,2.0,0,0,0,0,0,0,0,0,0,0,0,0,0,0,0,0,0
400915470,Georgia Tech Yellow Jackets,J. Moore,4065662,,False,13.0,1,4,1,3,0,1,0,0,0,2,2,2,0,0,0,1,2
400915470,Georgia Tech Yellow Jackets,T. Jackson,3135057,,False,27.0,2,9,2,7,0,2,0,0,0,1,1,2,0,0,1,2,4
400915470,Georgia Tech Yellow Jackets,J. Price,61778,,False,0.0,0,0,0,0,0,0,0,0,0,0,0,0,0,0,0,0,0
400915470,Georgia Tech Yellow Jackets,TEAM,TOTAL,TOTAL,False,,24,52,21,38,3,14,10,15,5,28,33,14,5,3,11,11,61
400915469,Florida State Seminoles,J. Isaac,4065654,,True,25.0,3,7,2,4,1,3,1,2,2,6,8,1,0,0,1,2,8
400915469,Florida State Seminoles,M. Ojo,61596,,True,10.0,1,5,1,5,0,0,0,0,2,2,4,0,0,1,0,1,2
400915469,Florida State Seminoles,T. Mann,3907823,,True,24.0,1,6,0,4,1,2,0,0,2,1,3,0,1,0,0,1,3
400915469,Florida State Seminoles,D. Bacon,3907821,,True,31.0,6,9,4,5,2,4,5,5,2,1,3,3,0,0,3,4,19
400915469,Florida State Seminoles,X. Rathan-Mayes,66125,,True,31.0,7,13,7,13,0,0,1,3,0,1,1,1,0,0,2,2,15
400915469,Florida State Seminoles,P. Cofer,3135054,,False,11.0,2,3,2,2,0,1,0,0,0,1,1,0,0,0,0,3,4
400915469,Florida State Seminoles,J. Smith,66126,,False,7.0,0,3,0,3,0,0,0,0,1,1,2,0,0,0,2,1,0
400915469,Florida State Seminoles,C. Koumadje,3907824,,False,6.0,0,2,0,2,0,0,0,2,0,0,0,0,0,2,0,0,0
400915469,Florida State Seminoles,B. Angola-Rodas,4065658,,False,12.0,3,6,3,5,0,1,2,2,1,0,1,0,1,0,0,1,8
400915469,Florida State Seminoles,P. Savoy,4065657,,False,9.0,1,2,0,0,1,2,0,0,0,1,1,0,1,0,0,0,3
400915469,Florida State Seminoles,T. Forrest,4065656,,False,19.0,2,5,2,5,0,0,1,1,6,3,9,2,0,0,2,2,5
400915469,Florida State Seminoles,C. Walker,4065655,,False,15.0,1,4,1,4,0,0,1,2,0,4,4,1,1,0,2,2,3
400915469,Florida State Seminoles,TEAM,TOTAL,TOTAL,False,,27,65,22,52,5,13,11,17,17,21,38,8,4,3,12,19,70
400915469,Florida State Seminoles,J. Isaac,4065654,,True,25.0,3,7,2,4,1,3,1,2,2,6,8,1,0,0,1,2,8
400915469,Florida State Seminoles,M. Ojo,61596,,True,10.0,1,5,1,5,0,0,0,0,2,2,4,0,0,1,0,1,2
400915469,Florida State Seminoles,T. Mann,3907823,,True,24.0,1,6,0,4,1,2,0,0,2,1,3,0,1,0,0,1,3
400915469,Florida State Seminoles,D. Bacon,3907821,,True,31.0,6,9,4,5,2,4,5,5,2,1,3,3,0,0,3,4,19
400915469,Florida State Seminoles,X. Rathan-Mayes,66125,,True,31.0,7,13,7,13,0,0,1,3,0,1,1,1,0,0,2,2,15
400915469,Florida State Seminoles,P. Cofer,3135054,,False,11.0,2,3,2,2,0,1,0,0,0,1,1,0,0,0,0,3,4
400915469,Florida State Seminoles,J. Smith,66126,,False,7.0,0,3,0,3,0,0,0,0,1,1,2,0,0,0,2,1,0
400915469,Florida State Seminoles,C. Koumadje,3907824,,False,6.0,0,2,0,2,0,0,0,2,0,0,0,0,0,2,0,0,0
400915469,Florida State Seminoles,B. Angola-Rodas,4065658,,False,12.0,3,6,3,5,0,1,2,2,1,0,1,0,1,0,0,1,8
400915469,Florida State Seminoles,P. Savoy,4065657,,False,9.0,1,2,0,0,1,2,0,0,0,1,1,0,1,0,0,0,3
400915469,Florida State Seminoles,T. Forrest,4065656,,False,19.0,2,5,2,5,0,0,1,1,6,3,9,2,0,0,2,2,5
400915469,Florida State Seminoles,C. Walker,4065655,,False,15.0,1,4,1,4,0,0,1,2,0,4,4,1,1,0,2,2,3
400915469,Florida State Seminoles,TEAM,TOTAL,TOTAL,False,,27,65,22,52,5,13,11,17,17,21,38,8,4,3,12,19,70
400915469,Duke Blue Devils,J. Tatum,4065648,,True,39.0,5,13,4,8,1,5,4,4,1,8,9,4,2,2,5,3,15
400915469,Duke Blue Devils,A. Jefferson,61586,,True,31.0,6,6,6,6,0,0,2,5,3,8,11,0,1,4,2,2,14
400915469,Duke Blue Devils,F. Jackson,4065651,,True,33.0,8,15,5,11,3,4,3,4,1,3,4,1,0,0,1,3,22
400915469,Duke Blue Devils,L. Kennard,3913174,,True,40.0,5,13,3,8,2,5,5,6,3,3,6,2,0,0,3,3,17
400915469,Duke Blue Devils,M. Jones,66563,,True,34.0,2,9,1,6,1,3,0,0,3,0,3,0,1,0,1,3,5
400915469,Duke Blue Devils,H. Giles III,4065649,,False,5.0,0,0,0,0,0,0,0,0,1,0,1,0,0,0,0,1,0
400915469,Duke Blue Devils,J. Robinson,3913178,,False,0.0,0,0,0,0,0,0,0,0,0,0,0,0,0,0,0,0,0
400915469,Duke Blue Devils,M. Bolden,4065652,,False,2.0,0,0,0,0,0,0,0,0,0,0,0,0,0,0,0,1,0
400915469,Duke Blue Devils,G. Allen,3135045,,False,16.0,1,3,1,2,0,1,0,0,0,2,2,0,1,0,1,0,2
400915469,Duke Blue Devils,N. Pagliuca,66630,,False,0.0,0,0,0,0,0,0,0,0,0,0,0,0,0,0,0,0,0
400915469,Duke Blue Devils,TEAM,TOTAL,TOTAL,False,,27,59,20,41,7,18,14,19,14,24,38,7,5,6,14,16,75
400915469,Duke Blue Devils,J. Tatum,4065648,,True,39.0,5,13,4,8,1,5,4,4,1,8,9,4,2,2,5,3,15
400915469,Duke Blue Devils,A. Jefferson,61586,,True,31.0,6,6,6,6,0,0,2,5,3,8,11,0,1,4,2,2,14
400915469,Duke Blue Devils,F. Jackson,4065651,,True,33.0,8,15,5,11,3,4,3,4,1,3,4,1,0,0,1,3,22
400915469,Duke Blue Devils,L. Kennard,3913174,,True,40.0,5,13,3,8,2,5,5,6,3,3,6,2,0,0,3,3,17
400915469,Duke Blue Devils,M. Jones,66563,,True,34.0,2,9,1,6,1,3,0,0,3,0,3,0,1,0,1,3,5
400915469,Duke Blue Devils,H. Giles III,4065649,,False,5.0,0,0,0,0,0,0,0,0,1,0,1,0,0,0,0,1,0
400915469,Duke Blue Devils,J. Robinson,3913178,,False,0.0,0,0,0,0,0,0,0,0,0,0,0,0,0,0,0,0,0
400915469,Duke Blue Devils,M. Bolden,4065652,,False,2.0,0,0,0,0,0,0,0,0,0,0,0,0,0,0,0,1,0
400915469,Duke Blue Devils,G. Allen,3135045,,False,16.0,1,3,1,2,0,1,0,0,0,2,2,0,1,0,1,0,2
400915469,Duke Blue Devils,N. Pagliuca,66630,,False,0.0,0,0,0,0,0,0,0,0,0,0,0,0,0,0,0,0,0
400915469,Duke Blue Devils,TEAM,TOTAL,TOTAL,False,,27,59,20,41,7,18,14,19,14,24,38,7,5,6,14,16,75
400915468,Virginia Tech Hokies,K. Sy,4065740,,True,13.0,2,2,2,2,0,0,2,2,0,3,3,0,0,0,1,1,6
400915468,Virginia Tech Hokies,J. Robinson,3945566,,True,20.0,1,4,1,3,0,1,3,6,0,1,1,4,2,0,4,4,5
400915468,Virginia Tech Hokies,A. Hill,3147501,,True,31.0,2,7,1,2,1,5,2,4,0,0,0,2,1,0,0,4,7
400915468,Virginia Tech Hokies,J. Bibbs,3147500,,True,38.0,2,4,1,1,1,3,0,0,0,5,5,0,0,0,0,0,5
400915468,Virginia Tech Hokies,T. Outlaw,67275,,True,38.0,8,11,0,1,8,10,0,0,0,4,4,2,0,0,0,2,24
400915468,Virginia Tech Hokies,Z. LeDay,61698,,False,27.0,1,4,1,4,0,0,5,8,1,6,7,0,0,0,2,1,7
400915468,Virginia Tech Hokies,S. Allen,61795,,False,33.0,3,5,3,4,0,1,6,6,0,2,2,4,0,0,4,0,12
400915468,Virginia Tech Hokies,TEAM,TOTAL,TOTAL,False,,19,37,9,17,10,20,18,26,1,23,24,12,3,0,11,12,66
400915468,Virginia Tech Hokies,K. Sy,4065740,,True,13.0,2,2,2,2,0,0,2,2,0,3,3,0,0,0,1,1,6
400915468,Virginia Tech Hokies,J. Robinson,3945566,,True,20.0,1,4,1,3,0,1,3,6,0,1,1,4,2,0,4,4,5
400915468,Virginia Tech Hokies,A. Hill,3147501,,True,31.0,2,7,1,2,1,5,2,4,0,0,0,2,1,0,0,4,7
400915468,Virginia Tech Hokies,J. Bibbs,3147500,,True,38.0,2,4,1,1,1,3,0,0,0,5,5,0,0,0,0,0,5
400915468,Virginia Tech Hokies,T. Outlaw,67275,,True,38.0,8,11,0,1,8,10,0,0,0,4,4,2,0,0,0,2,24
400915468,Virginia Tech Hokies,Z. LeDay,61698,,False,27.0,1,4,1,4,0,0,5,8,1,6,7,0,0,0,2,1,7
400915468,Virginia Tech Hokies,S. Allen,61795,,False,33.0,3,5,3,4,0,1,6,6,0,2,2,4,0,0,4,0,12
400915468,Virginia Tech Hokies,TEAM,TOTAL,TOTAL,False,,19,37,9,17,10,20,18,26,1,23,24,12,3,0,11,12,66
400915468,Miami Hurricanes,K. Murphy,61668,,True,35.0,5,7,5,7,0,0,3,4,0,2,2,3,1,1,1,3,13
400915468,Miami Hurricanes,E. Izundu,3904629,,True,16.0,0,2,0,2,0,0,0,0,0,2,2,0,0,0,0,3,0
400915468,Miami Hurricanes,A. Lawrence II,3904628,,True,28.0,6,9,3,4,3,5,3,4,0,5,5,1,1,0,0,2,18
400915468,Miami Hurricanes,B. Brown,4065670,,True,31.0,3,8,2,3,1,5,1,2,1,2,3,5,1,0,2,5,8
400915468,Miami Hurricanes,D. Reed,66130,,True,36.0,3,10,2,6,1,4,4,5,1,8,9,2,3,0,0,1,11
400915468,Miami Hurricanes,D. Hernandez,4065672,,False,9.0,0,0,0,0,0,0,0,0,0,1,1,0,0,0,2,3,0
400915468,Miami Hurricanes,D. Vasiljevic,4065669,,False,21.0,3,8,1,2,2,6,1,2,0,1,1,0,0,0,0,0,9
400915468,Miami Hurricanes,J. Newton,3138145,,False,24.0,1,5,1,4,0,1,0,0,0,0,0,4,0,0,4,3,2
400915468,Miami Hurricanes,TEAM,TOTAL,TOTAL,False,,21,49,14,28,7,21,12,17,5,21,26,15,6,1,9,20,61
400915468,Miami Hurricanes,K. Murphy,61668,,True,35.0,5,7,5,7,0,0,3,4,0,2,2,3,1,1,1,3,13
400915468,Miami Hurricanes,E. Izundu,3904629,,True,16.0,0,2,0,2,0,0,0,0,0,2,2,0,0,0,0,3,0
400915468,Miami Hurricanes,A. Lawrence II,3904628,,True,28.0,6,9,3,4,3,5,3,4,0,5,5,1,1,0,0,2,18
400915468,Miami Hurricanes,B. Brown,4065670,,True,31.0,3,8,2,3,1,5,1,2,1,2,3,5,1,0,2,5,8
400915468,Miami Hurricanes,D. Reed,66130,,True,36.0,3,10,2,6,1,4,4,5,1,8,9,2,3,0,0,1,11
400915468,Miami Hurricanes,D. Hernandez,4065672,,False,9.0,0,0,0,0,0,0,0,0,0,1,1,0,0,0,2,3,0
400915468,Miami Hurricanes,D. Vasiljevic,4065669,,False,21.0,3,8,1,2,2,6,1,2,0,1,1,0,0,0,0,0,9
400915468,Miami Hurricanes,J. Newton,3138145,,False,24.0,1,5,1,4,0,1,0,0,0,0,0,4,0,0,4,3,2
400915468,Miami Hurricanes,TEAM,TOTAL,TOTAL,False,,21,49,14,28,7,21,12,17,5,21,26,15,6,1,9,20,61
400915467,Virginia Cavaliers,J. Salt,3138200,,True,25.0,1,2,1,2,0,0,1,2,3,1,4,1,0,1,1,2,3
400915467,Virginia Cavaliers,T. Jerome,4065733,,True,13.0,1,4,0,1,1,3,0,0,0,2,2,0,0,0,2,3,3
400915467,Virginia Cavaliers,K. Guy,4065730,,True,32.0,6,11,1,4,5,7,0,2,0,6,6,4,1,0,0,1,17
400915467,Virginia Cavaliers,L. Perrantes,66139,,True,34.0,4,12,1,4,3,8,2,2,0,1,1,4,2,0,0,0,13
400915467,Virginia Cavaliers,D. Hall,66138,,True,33.0,4,14,3,10,1,4,2,2,0,1,1,5,1,1,1,0,11
400915467,Virginia Cavaliers,M. Diakite,3947156,,False,20.0,1,3,1,3,0,0,0,0,2,1,3,0,0,2,0,2,2
400915467,Virginia Cavaliers,J. Reuter,3908374,,False,6.0,0,2,0,2,0,0,0,0,1,0,1,0,1,0,0,0,0
400915467,Virginia Cavaliers,I. Wilkins,3138203,,False,22.0,2,7,2,7,0,0,0,0,4,5,9,0,0,4,0,4,4
400915467,Virginia Cavaliers,M. Shayok,3138201,,False,6.0,0,1,0,1,0,0,0,0,0,0,0,1,0,0,0,0,0
400915467,Virginia Cavaliers,D. Thompson,66274,,False,9.0,0,3,0,1,0,2,0,0,0,1,1,0,1,0,0,0,0
400915467,Virginia Cavaliers,TEAM,TOTAL,TOTAL,False,,19,59,9,35,10,24,5,8,13,22,35,15,6,8,4,12,53
400915467,Virginia Cavaliers,J. Salt,3138200,,True,25.0,1,2,1,2,0,0,1,2,3,1,4,1,0,1,1,2,3
400915467,Virginia Cavaliers,T. Jerome,4065733,,True,13.0,1,4,0,1,1,3,0,0,0,2,2,0,0,0,2,3,3
400915467,Virginia Cavaliers,K. Guy,4065730,,True,32.0,6,11,1,4,5,7,0,2,0,6,6,4,1,0,0,1,17
400915467,Virginia Cavaliers,L. Perrantes,66139,,True,34.0,4,12,1,4,3,8,2,2,0,1,1,4,2,0,0,0,13
400915467,Virginia Cavaliers,D. Hall,66138,,True,33.0,4,14,3,10,1,4,2,2,0,1,1,5,1,1,1,0,11
400915467,Virginia Cavaliers,M. Diakite,3947156,,False,20.0,1,3,1,3,0,0,0,0,2,1,3,0,0,2,0,2,2
400915467,Virginia Cavaliers,J. Reuter,3908374,,False,6.0,0,2,0,2,0,0,0,0,1,0,1,0,1,0,0,0,0
400915467,Virginia Cavaliers,I. Wilkins,3138203,,False,22.0,2,7,2,7,0,0,0,0,4,5,9,0,0,4,0,4,4
400915467,Virginia Cavaliers,M. Shayok,3138201,,False,6.0,0,1,0,1,0,0,0,0,0,0,0,1,0,0,0,0,0
400915467,Virginia Cavaliers,D. Thompson,66274,,False,9.0,0,3,0,1,0,2,0,0,0,1,1,0,1,0,0,0,0
400915467,Virginia Cavaliers,TEAM,TOTAL,TOTAL,False,,19,59,9,35,10,24,5,8,13,22,35,15,6,8,4,12,53
400915467,North Carolina Tar Heels,J. Jackson,3138156,,True,33.0,3,10,2,4,1,6,0,0,1,3,4,2,0,1,2,0,7
400915467,North Carolina Tar Heels,T. Pinson,3138154,,True,28.0,0,2,0,0,0,2,0,0,2,2,4,3,1,0,1,0,0
400915467,North Carolina Tar Heels,I. Hicks,66874,,True,19.0,1,3,1,3,0,0,0,0,0,3,3,0,0,0,3,5,2
400915467,North Carolina Tar Heels,K. Meeks,66873,,True,25.0,3,7,3,7,0,0,0,0,2,5,7,1,0,1,3,2,6
400915467,North Carolina Tar Heels,J. Berry II,3138155,,True,34.0,4,10,2,5,2,5,2,3,0,5,5,2,0,0,1,1,12
400915467,North Carolina Tar Heels,T. Bradley,4065673,,False,19.0,4,6,4,6,0,0,0,0,0,4,4,0,0,0,1,2,8
400915467,North Carolina Tar Heels,L. Maye,3911620,,False,16.0,1,3,1,2,0,1,0,0,0,2,2,3,0,1,2,0,2
400915467,North Carolina Tar Heels,S. Woods,4065676,,False,6.0,0,2,0,2,0,0,2,2,0,1,1,0,0,0,1,1,2
400915467,North Carolina Tar Heels,B. Robinson,4065675,,False,5.0,0,1,0,1,0,0,1,2,1,0,1,0,0,0,0,0,1
400915467,North Carolina Tar Heels,N. Britt,66872,,False,15.0,1,4,0,2,1,2,0,0,0,1,1,1,0,0,0,1,3
400915467,North Carolina Tar Heels,TEAM,TOTAL,TOTAL,False,,17,48,13,32,4,16,5,7,10,28,38,12,1,3,14,12,43
400915467,North Carolina Tar Heels,J. Jackson,3138156,,True,33.0,3,10,2,4,1,6,0,0,1,3,4,2,0,1,2,0,7
400915467,North Carolina Tar Heels,T. Pinson,3138154,,True,28.0,0,2,0,0,0,2,0,0,2,2,4,3,1,0,1,0,0
400915467,North Carolina Tar Heels,I. Hicks,66874,,True,19.0,1,3,1,3,0,0,0,0,0,3,3,0,0,0,3,5,2
400915467,North Carolina Tar Heels,K. Meeks,66873,,True,25.0,3,7,3,7,0,0,0,0,2,5,7,1,0,1,3,2,6
400915467,North Carolina Tar Heels,J. Berry II,3138155,,True,34.0,4,10,2,5,2,5,2,3,0,5,5,2,0,0,1,1,12
400915467,North Carolina Tar Heels,T. Bradley,4065673,,False,19.0,4,6,4,6,0,0,0,0,0,4,4,0,0,0,1,2,8
400915467,North Carolina Tar Heels,L. Maye,3911620,,False,16.0,1,3,1,2,0,1,0,0,0,2,2,3,0,1,2,0,2
400915467,North Carolina Tar Heels,S. Woods,4065676,,False,6.0,0,2,0,2,0,0,2,2,0,1,1,0,0,0,1,1,2
400915467,North Carolina Tar Heels,B. Robinson,4065675,,False,5.0,0,1,0,1,0,0,1,2,1,0,1,0,0,0,0,0,1
400915467,North Carolina Tar Heels,N. Britt,66872,,False,15.0,1,4,0,2,1,2,0,0,0,1,1,1,0,0,0,1,3
400915467,North Carolina Tar Heels,TEAM,TOTAL,TOTAL,False,,17,48,13,32,4,16,5,7,10,28,38,12,1,3,14,12,43
400915466,Notre Dame Fighting Irish,B. Colson,3138192,,True,35.0,8,14,5,11,3,3,1,1,4,7,11,1,2,2,0,3,20
400915466,Notre Dame Fighting Irish,V.J. Beachem,66283,,True,31.0,3,14,1,5,2,9,0,0,0,3,3,0,2,0,1,0,8
400915466,Notre Dame Fighting Irish,R. Pflueger,3908335,,True,35.0,1,3,0,1,1,2,3,4,0,4,4,3,1,0,0,3,6
400915466,Notre Dame Fighting Irish,M. Farrell,3138190,,True,31.0,3,8,1,3,2,5,9,10,1,0,1,2,1,0,3,3,17
400915466,Notre Dame Fighting Irish,S. Vasturia,66285,,True,36.0,3,9,2,5,1,4,0,1,0,5,5,5,1,0,2,2,7
400915466,Notre Dame Fighting Irish,A. Torres,66286,,False,5.0,0,0,0,0,0,0,1,2,0,1,1,0,0,0,1,1,1
400915466,Notre Dame Fighting Irish,M. Ryan,3908336,,False,8.0,1,5,0,1,1,4,0,0,0,0,0,0,0,0,0,0,3
400915466,Notre Dame Fighting Irish,T. Gibbs,4065703,,False,19.0,1,4,1,2,0,2,0,0,0,2,2,1,1,0,1,0,2
400915466,Notre Dame Fighting Irish,TEAM,TOTAL,TOTAL,False,,20,57,10,28,10,29,14,18,7,25,32,12,8,2,8,12,64
400915466,Notre Dame Fighting Irish,B. Colson,3138192,,True,35.0,8,14,5,11,3,3,1,1,4,7,11,1,2,2,0,3,20
400915466,Notre Dame Fighting Irish,V.J. Beachem,66283,,True,31.0,3,14,1,5,2,9,0,0,0,3,3,0,2,0,1,0,8
400915466,Notre Dame Fighting Irish,R. Pflueger,3908335,,True,35.0,1,3,0,1,1,2,3,4,0,4,4,3,1,0,0,3,6
400915466,Notre Dame Fighting Irish,M. Farrell,3138190,,True,31.0,3,8,1,3,2,5,9,10,1,0,1,2,1,0,3,3,17
400915466,Notre Dame Fighting Irish,S. Vasturia,66285,,True,36.0,3,9,2,5,1,4,0,1,0,5,5,5,1,0,2,2,7
400915466,Notre Dame Fighting Irish,A. Torres,66286,,False,5.0,0,0,0,0,0,0,1,2,0,1,1,0,0,0,1,1,1
400915466,Notre Dame Fighting Irish,M. Ryan,3908336,,False,8.0,1,5,0,1,1,4,0,0,0,0,0,0,0,0,0,0,3
400915466,Notre Dame Fighting Irish,T. Gibbs,4065703,,False,19.0,1,4,1,2,0,2,0,0,0,2,2,1,1,0,1,0,2
400915466,Notre Dame Fighting Irish,TEAM,TOTAL,TOTAL,False,,20,57,10,28,10,29,14,18,7,25,32,12,8,2,8,12,64
400915466,Georgia Tech Yellow Jackets,Q. Stephens,66128,,True,35.0,1,5,1,1,0,4,0,0,0,4,4,2,1,0,3,5,2
400915466,Georgia Tech Yellow Jackets,B. Lammers,3135061,,True,39.0,4,11,4,11,0,0,4,5,1,9,10,1,2,4,2,0,12
400915466,Georgia Tech Yellow Jackets,J. Okogie,4065663,,True,37.0,6,16,5,15,1,1,1,3,3,7,10,0,3,1,3,4,14
400915466,Georgia Tech Yellow Jackets,J. Heath,67623,,True,36.0,6,9,6,7,0,2,0,0,2,7,9,2,0,0,4,3,12
400915466,Georgia Tech Yellow Jackets,C. Heyward,61609,,True,12.0,0,0,0,0,0,0,0,0,0,2,2,1,0,0,0,1,0
400915466,Georgia Tech Yellow Jackets,K. McCormick,61453,,False,1.0,0,0,0,0,0,0,0,0,1,0,1,0,0,0,0,0,0
400915466,Georgia Tech Yellow Jackets,J. Moore,4065662,,False,12.0,0,0,0,0,0,0,0,0,0,1,1,0,1,0,0,2,0
400915466,Georgia Tech Yellow Jackets,T. Jackson,3135057,,False,28.0,9,17,7,9,2,8,0,0,1,0,1,1,0,0,2,3,20
400915466,Georgia Tech Yellow Jackets,TEAM,TOTAL,TOTAL,False,,26,58,23,43,3,15,5,8,8,31,39,7,7,5,14,18,60
400915466,Georgia Tech Yellow Jackets,Q. Stephens,66128,,True,35.0,1,5,1,1,0,4,0,0,0,4,4,2,1,0,3,5,2
400915466,Georgia Tech Yellow Jackets,B. Lammers,3135061,,True,39.0,4,11,4,11,0,0,4,5,1,9,10,1,2,4,2,0,12
400915466,Georgia Tech Yellow Jackets,J. Okogie,4065663,,True,37.0,6,16,5,15,1,1,1,3,3,7,10,0,3,1,3,4,14
400915466,Georgia Tech Yellow Jackets,J. Heath,67623,,True,36.0,6,9,6,7,0,2,0,0,2,7,9,2,0,0,4,3,12
400915466,Georgia Tech Yellow Jackets,C. Heyward,61609,,True,12.0,0,0,0,0,0,0,0,0,0,2,2,1,0,0,0,1,0
400915466,Georgia Tech Yellow Jackets,K. McCormick,61453,,False,1.0,0,0,0,0,0,0,0,0,1,0,1,0,0,0,0,0,0
400915466,Georgia Tech Yellow Jackets,J. Moore,4065662,,False,12.0,0,0,0,0,0,0,0,0,0,1,1,0,1,0,0,2,0
400915466,Georgia Tech Yellow Jackets,T. Jackson,3135057,,False,28.0,9,17,7,9,2,8,0,0,1,0,1,1,0,0,2,3,20
400915466,Georgia Tech Yellow Jackets,TEAM,TOTAL,TOTAL,False,,26,58,23,43,3,15,5,8,8,31,39,7,7,5,14,18,60
400915465,Syracuse Orange,T. Thompson,4065721,,True,21.0,3,9,3,8,0,1,5,5,6,2,8,1,0,0,4,4,11
400915465,Syracuse Orange,T. Lydon,3934662,,True,40.0,4,10,3,4,1,6,8,8,3,7,10,1,3,0,3,4,17
400915465,Syracuse Orange,T. Battle,4065722,,True,37.0,7,17,4,9,3,8,3,4,2,0,2,0,0,0,1,1,20
400915465,Syracuse Orange,J. Gillon,61915,,True,34.0,2,6,0,2,2,4,4,4,0,0,0,3,1,0,3,3,10
400915465,Syracuse Orange,A. White III,61616,,True,40.0,3,10,2,2,1,8,0,1,0,4,4,0,2,0,2,2,7
400915465,Syracuse Orange,T. Roberson,67633,,False,19.0,0,1,0,1,0,0,0,0,0,3,3,0,0,0,1,2,0
400915465,Syracuse Orange,F. Howard,3934659,,False,9.0,1,3,0,1,1,2,0,0,0,1,1,2,1,0,2,0,3
400915465,Syracuse Orange,TEAM,TOTAL,TOTAL,False,,20,56,12,27,8,29,20,22,11,17,28,7,7,0,16,16,68
400915465,Syracuse Orange,T. Thompson,4065721,,True,21.0,3,9,3,8,0,1,5,5,6,2,8,1,0,0,4,4,11
400915465,Syracuse Orange,T. Lydon,3934662,,True,40.0,4,10,3,4,1,6,8,8,3,7,10,1,3,0,3,4,17
400915465,Syracuse Orange,T. Battle,4065722,,True,37.0,7,17,4,9,3,8,3,4,2,0,2,0,0,0,1,1,20
400915465,Syracuse Orange,J. Gillon,61915,,True,34.0,2,6,0,2,2,4,4,4,0,0,0,3,1,0,3,3,10
400915465,Syracuse Orange,A. White III,61616,,True,40.0,3,10,2,2,1,8,0,1,0,4,4,0,2,0,2,2,7
400915465,Syracuse Orange,T. Roberson,67633,,False,19.0,0,1,0,1,0,0,0,0,0,3,3,0,0,0,1,2,0
400915465,Syracuse Orange,F. Howard,3934659,,False,9.0,1,3,0,1,1,2,0,0,0,1,1,2,1,0,2,0,3
400915465,Syracuse Orange,TEAM,TOTAL,TOTAL,False,,20,56,12,27,8,29,20,22,11,17,28,7,7,0,16,16,68
400915465,Louisville Cardinals,A. Mahmoud,3147363,,True,25.0,4,5,4,5,0,0,0,0,3,6,9,2,4,1,2,4,8
400915465,Louisville Cardinals,V.J. King,4065666,,True,12.0,0,2,0,1,0,1,1,2,0,2,2,1,0,0,1,0,1
400915465,Louisville Cardinals,R. Spalding,3908806,,True,28.0,8,9,8,9,0,0,2,6,4,7,11,2,2,1,3,3,18
400915465,Louisville Cardinals,D. Mitchell,3908809,,True,34.0,9,16,3,6,6,10,1,2,2,3,5,4,2,0,2,4,25
400915465,Louisville Cardinals,Q. Snider,3147360,,True,34.0,5,9,3,4,2,5,0,0,1,2,3,6,0,0,0,2,12
400915465,Louisville Cardinals,D. Adel,3908807,,False,23.0,5,9,5,8,0,1,7,9,1,2,3,2,0,0,2,2,17
400915465,Louisville Cardinals,J. Johnson,3147362,,False,13.0,1,3,0,2,1,1,2,4,1,0,1,1,0,0,0,1,5
400915465,Louisville Cardinals,M. Mathiang,63035,,False,13.0,1,3,1,3,0,0,0,0,1,2,3,0,0,1,3,2,2
400915465,Louisville Cardinals,R. McMahon,3908808,,False,8.0,0,2,0,0,0,2,0,0,0,1,1,0,0,0,1,1,0
400915465,Louisville Cardinals,D. Levitch,66592,,False,8.0,0,0,0,0,0,0,0,0,0,1,1,0,0,0,1,0,0
400915465,Louisville Cardinals,T. Hicks,62752,,False,1.0,0,0,0,0,0,0,0,0,0,0,0,0,0,0,0,0,0
400915465,Louisville Cardinals,TEAM,TOTAL,TOTAL,False,,33,58,24,38,9,20,13,23,13,26,39,18,8,3,15,19,88
400915465,Louisville Cardinals,A. Mahmoud,3147363,,True,25.0,4,5,4,5,0,0,0,0,3,6,9,2,4,1,2,4,8
400915465,Louisville Cardinals,V.J. King,4065666,,True,12.0,0,2,0,1,0,1,1,2,0,2,2,1,0,0,1,0,1
400915465,Louisville Cardinals,R. Spalding,3908806,,True,28.0,8,9,8,9,0,0,2,6,4,7,11,2,2,1,3,3,18
400915465,Louisville Cardinals,D. Mitchell,3908809,,True,34.0,9,16,3,6,6,10,1,2,2,3,5,4,2,0,2,4,25
400915465,Louisville Cardinals,Q. Snider,3147360,,True,34.0,5,9,3,4,2,5,0,0,1,2,3,6,0,0,0,2,12
400915465,Louisville Cardinals,D. Adel,3908807,,False,23.0,5,9,5,8,0,1,7,9,1,2,3,2,0,0,2,2,17
400915465,Louisville Cardinals,J. Johnson,3147362,,False,13.0,1,3,0,2,1,1,2,4,1,0,1,1,0,0,0,1,5
400915465,Louisville Cardinals,M. Mathiang,63035,,False,13.0,1,3,1,3,0,0,0,0,1,2,3,0,0,1,3,2,2
400915465,Louisville Cardinals,R. McMahon,3908808,,False,8.0,0,2,0,0,0,2,0,0,0,1,1,0,0,0,1,1,0
400915465,Louisville Cardinals,D. Levitch,66592,,False,8.0,0,0,0,0,0,0,0,0,0,1,1,0,0,0,1,0,0
400915465,Louisville Cardinals,T. Hicks,62752,,False,1.0,0,0,0,0,0,0,0,0,0,0,0,0,0,0,0,0,0
400915465,Louisville Cardinals,TEAM,TOTAL,TOTAL,False,,33,58,24,38,9,20,13,23,13,26,39,18,8,3,15,19,88
400915464,Virginia Cavaliers,J. Salt,3138200,,True,22.0,2,5,2,5,0,0,1,3,1,4,5,0,0,0,0,2,5
400915464,Virginia Cavaliers,T. Jerome,4065733,,True,23.0,2,4,1,3,1,1,0,0,0,6,6,0,4,0,1,5,5
400915464,Virginia Cavaliers,M. Shayok,3138201,,True,12.0,0,4,0,3,0,1,0,0,1,1,2,0,1,1,4,1,0
400915464,Virginia Cavaliers,L. Perrantes,66139,,True,35.0,5,10,2,5,3,5,3,3,0,3,3,10,2,0,1,1,16
400915464,Virginia Cavaliers,D. Hall,66138,,True,37.0,5,8,3,6,2,2,6,8,2,7,9,2,0,1,1,0,18
400915464,Virginia Cavaliers,M. Diakite,3947156,,False,14.0,0,1,0,1,0,0,3,4,0,1,1,0,0,0,1,3,3
400915464,Virginia Cavaliers,J. Reuter,3908374,,False,2.0,0,0,0,0,0,0,0,0,0,0,0,0,0,0,0,1,0
400915464,Virginia Cavaliers,I. Wilkins,3138203,,False,20.0,2,2,2,2,0,0,0,3,0,0,0,0,0,2,0,1,4
400915464,Virginia Cavaliers,K. Guy,4065730,,False,35.0,7,13,2,6,5,7,0,1,1,3,4,2,1,0,2,2,19
400915464,Virginia Cavaliers,TEAM,TOTAL,TOTAL,False,,23,47,12,31,11,16,13,22,7,26,33,14,8,4,11,16,70
400915464,Virginia Cavaliers,J. Salt,3138200,,True,22.0,2,5,2,5,0,0,1,3,1,4,5,0,0,0,0,2,5
400915464,Virginia Cavaliers,T. Jerome,4065733,,True,23.0,2,4,1,3,1,1,0,0,0,6,6,0,4,0,1,5,5
400915464,Virginia Cavaliers,M. Shayok,3138201,,True,12.0,0,4,0,3,0,1,0,0,1,1,2,0,1,1,4,1,0
400915464,Virginia Cavaliers,L. Perrantes,66139,,True,35.0,5,10,2,5,3,5,3,3,0,3,3,10,2,0,1,1,16
400915464,Virginia Cavaliers,D. Hall,66138,,True,37.0,5,8,3,6,2,2,6,8,2,7,9,2,0,1,1,0,18
400915464,Virginia Cavaliers,M. Diakite,3947156,,False,14.0,0,1,0,1,0,0,3,4,0,1,1,0,0,0,1,3,3
400915464,Virginia Cavaliers,J. Reuter,3908374,,False,2.0,0,0,0,0,0,0,0,0,0,0,0,0,0,0,0,1,0
400915464,Virginia Cavaliers,I. Wilkins,3138203,,False,20.0,2,2,2,2,0,0,0,3,0,0,0,0,0,2,0,1,4
400915464,Virginia Cavaliers,K. Guy,4065730,,False,35.0,7,13,2,6,5,7,0,1,1,3,4,2,1,0,2,2,19
400915464,Virginia Cavaliers,TEAM,TOTAL,TOTAL,False,,23,47,12,31,11,16,13,22,7,26,33,14,8,4,11,16,70
400915464,NC State Wolfpack,B. Anya,66134,,True,9.0,0,1,0,1,0,0,0,0,0,0,0,0,0,1,0,1,0
400915464,NC State Wolfpack,M. Johnson,4065699,,True,34.0,4,8,2,6,2,2,1,2,1,2,3,4,3,1,2,1,11
400915464,NC State Wolfpack,D. Smith Jr.,4065697,,True,35.0,4,14,2,8,2,6,3,3,3,2,5,2,2,0,5,4,13
400915464,NC State Wolfpack,M. Rowan,3947151,,True,35.0,0,5,0,0,0,5,2,2,0,5,5,0,0,0,0,3,2
400915464,NC State Wolfpack,T. Henderson,61215,,True,31.0,2,11,0,1,2,10,4,5,1,3,4,2,0,1,4,3,10
400915464,NC State Wolfpack,T. Kapita,4065701,,False,2.0,0,1,0,1,0,0,0,0,0,0,0,0,0,0,0,0,0
400915464,NC State Wolfpack,D. Hicks,4065698,,False,4.0,0,0,0,0,0,0,0,0,0,0,0,0,0,0,1,1,0
400915464,NC State Wolfpack,A. Abu,3138158,,False,28.0,5,10,5,9,0,1,2,4,4,5,9,2,0,2,2,4,12
400915464,NC State Wolfpack,C. Brickhouse,67562,,False,1.0,0,0,0,0,0,0,0,0,0,0,0,0,0,0,0,0,0
400915464,NC State Wolfpack,S. Kirk,3947150,,False,5.0,1,1,0,0,1,1,0,0,0,3,3,0,0,0,0,0,3
400915464,NC State Wolfpack,T. Dorn,3132359,,False,16.0,2,5,2,3,0,2,0,0,1,0,1,0,0,0,0,1,4
400915464,NC State Wolfpack,TEAM,TOTAL,TOTAL,False,,18,56,11,29,7,27,12,16,15,23,38,10,5,5,14,18,55
400915464,NC State Wolfpack,B. Anya,66134,,True,9.0,0,1,0,1,0,0,0,0,0,0,0,0,0,1,0,1,0
400915464,NC State Wolfpack,M. Johnson,4065699,,True,34.0,4,8,2,6,2,2,1,2,1,2,3,4,3,1,2,1,11
400915464,NC State Wolfpack,D. Smith Jr.,4065697,,True,35.0,4,14,2,8,2,6,3,3,3,2,5,2,2,0,5,4,13
400915464,NC State Wolfpack,M. Rowan,3947151,,True,35.0,0,5,0,0,0,5,2,2,0,5,5,0,0,0,0,3,2
400915464,NC State Wolfpack,T. Henderson,61215,,True,31.0,2,11,0,1,2,10,4,5,1,3,4,2,0,1,4,3,10
400915464,NC State Wolfpack,T. Kapita,4065701,,False,2.0,0,1,0,1,0,0,0,0,0,0,0,0,0,0,0,0,0
400915464,NC State Wolfpack,D. Hicks,4065698,,False,4.0,0,0,0,0,0,0,0,0,0,0,0,0,0,0,1,1,0
400915464,NC State Wolfpack,A. Abu,3138158,,False,28.0,5,10,5,9,0,1,2,4,4,5,9,2,0,2,2,4,12
400915464,NC State Wolfpack,C. Brickhouse,67562,,False,1.0,0,0,0,0,0,0,0,0,0,0,0,0,0,0,0,0,0
400915464,NC State Wolfpack,S. Kirk,3947150,,False,5.0,1,1,0,0,1,1,0,0,0,3,3,0,0,0,0,0,3
400915464,NC State Wolfpack,T. Dorn,3132359,,False,16.0,2,5,2,3,0,2,0,0,1,0,1,0,0,0,0,1,4
400915464,NC State Wolfpack,TEAM,TOTAL,TOTAL,False,,18,56,11,29,7,27,12,16,15,23,38,10,5,5,14,18,55
400915463,Miami Hurricanes,K. Murphy,61668,,True,36.0,3,6,3,6,0,0,1,2,1,5,6,1,1,1,1,0,7
400915463,Miami Hurricanes,E. Izundu,3904629,,True,18.0,1,5,1,5,0,0,1,2,3,2,5,0,1,2,0,1,3
400915463,Miami Hurricanes,B. Brown,4065670,,True,36.0,11,18,10,16,1,2,2,2,1,3,4,4,2,2,1,3,25
400915463,Miami Hurricanes,A. Lawrence II,3904628,,True,20.0,0,4,0,2,0,2,2,2,0,3,3,2,1,0,2,2,2
400915463,Miami Hurricanes,D. Reed,66130,,True,37.0,3,11,3,10,0,1,3,4,3,7,10,1,3,0,1,2,9
400915463,Miami Hurricanes,D. Hernandez,4065672,,False,9.0,1,1,1,1,0,0,0,0,1,0,1,0,0,0,0,0,2
400915463,Miami Hurricanes,D. Vasiljevic,4065669,,False,20.0,0,3,0,0,0,3,0,0,0,2,2,0,0,0,0,1,0
400915463,Miami Hurricanes,J. Newton,3138145,,False,24.0,3,10,3,10,0,0,1,2,0,5,5,0,1,0,4,1,7
400915463,Miami Hurricanes,TEAM,TOTAL,TOTAL,False,,22,58,21,50,1,8,10,14,13,29,42,8,9,5,10,10,55
400915463,Miami Hurricanes,K. Murphy,61668,,True,36.0,3,6,3,6,0,0,1,2,1,5,6,1,1,1,1,0,7
400915463,Miami Hurricanes,E. Izundu,3904629,,True,18.0,1,5,1,5,0,0,1,2,3,2,5,0,1,2,0,1,3
400915463,Miami Hurricanes,B. Brown,4065670,,True,36.0,11,18,10,16,1,2,2,2,1,3,4,4,2,2,1,3,25
400915463,Miami Hurricanes,A. Lawrence II,3904628,,True,20.0,0,4,0,2,0,2,2,2,0,3,3,2,1,0,2,2,2
400915463,Miami Hurricanes,D. Reed,66130,,True,37.0,3,11,3,10,0,1,3,4,3,7,10,1,3,0,1,2,9
400915463,Miami Hurricanes,D. Hernandez,4065672,,False,9.0,1,1,1,1,0,0,0,0,1,0,1,0,0,0,0,0,2
400915463,Miami Hurricanes,D. Vasiljevic,4065669,,False,20.0,0,3,0,0,0,3,0,0,0,2,2,0,0,0,0,1,0
400915463,Miami Hurricanes,J. Newton,3138145,,False,24.0,3,10,3,10,0,0,1,2,0,5,5,0,1,0,4,1,7
400915463,Miami Hurricanes,TEAM,TOTAL,TOTAL,False,,22,58,21,50,1,8,10,14,13,29,42,8,9,5,10,10,55
400915463,Duke Blue Devils,H. Giles III,4065649,,True,19.0,1,4,1,4,0,0,0,2,5,3,8,0,1,0,1,1,2
400915463,Duke Blue Devils,J. Tatum,4065648,,True,40.0,4,16,4,9,0,7,0,0,3,4,7,2,1,1,0,0,8
400915463,Duke Blue Devils,A. Jefferson,61586,,True,21.0,2,3,2,3,0,0,0,2,0,5,5,0,0,0,3,3,4
400915463,Duke Blue Devils,L. Kennard,3913174,,True,40.0,6,20,4,14,2,6,2,3,1,5,6,1,2,1,3,1,16
400915463,Duke Blue Devils,M. Jones,66563,,True,37.0,2,9,2,6,0,3,0,0,3,0,3,3,1,0,3,2,4
400915463,Duke Blue Devils,M. Bolden,4065652,,False,14.0,0,3,0,3,0,0,0,0,2,2,4,0,0,3,0,2,0
400915463,Duke Blue Devils,F. Jackson,4065651,,False,29.0,6,11,3,6,3,5,1,2,1,5,6,3,1,0,3,2,16
400915463,Duke Blue Devils,TEAM,TOTAL,TOTAL,False,,21,66,16,45,5,21,3,9,21,25,46,9,6,5,13,11,50
400915463,Duke Blue Devils,H. Giles III,4065649,,True,19.0,1,4,1,4,0,0,0,2,5,3,8,0,1,0,1,1,2
400915463,Duke Blue Devils,J. Tatum,4065648,,True,40.0,4,16,4,9,0,7,0,0,3,4,7,2,1,1,0,0,8
400915463,Duke Blue Devils,A. Jefferson,61586,,True,21.0,2,3,2,3,0,0,0,2,0,5,5,0,0,0,3,3,4
400915463,Duke Blue Devils,L. Kennard,3913174,,True,40.0,6,20,4,14,2,6,2,3,1,5,6,1,2,1,3,1,16
400915463,Duke Blue Devils,M. Jones,66563,,True,37.0,2,9,2,6,0,3,0,0,3,0,3,3,1,0,3,2,4
400915463,Duke Blue Devils,M. Bolden,4065652,,False,14.0,0,3,0,3,0,0,0,0,2,2,4,0,0,3,0,2,0
400915463,Duke Blue Devils,F. Jackson,4065651,,False,29.0,6,11,3,6,3,5,1,2,1,5,6,3,1,0,3,2,16
400915463,Duke Blue Devils,TEAM,TOTAL,TOTAL,False,,21,66,16,45,5,21,3,9,21,25,46,9,6,5,13,11,50
400915462,Virginia Tech Hokies,K. Sy,4065740,,True,15.0,2,5,2,5,0,0,0,0,1,2,3,1,0,0,0,0,4
400915462,Virginia Tech Hokies,J. Robinson,3945566,,True,35.0,4,8,3,6,1,2,4,4,0,0,0,11,0,1,3,2,13
400915462,Virginia Tech Hokies,A. Hill,3147501,,True,27.0,5,6,4,4,1,2,1,1,0,1,1,0,0,1,2,2,12
400915462,Virginia Tech Hokies,J. Bibbs,3147500,,True,27.0,4,6,0,0,4,6,1,1,0,4,4,2,0,0,1,2,13
400915462,Virginia Tech Hokies,T. Outlaw,67275,,True,38.0,5,6,0,1,5,5,1,2,1,6,7,1,1,0,0,1,16
400915462,Virginia Tech Hokies,Z. LeDay,61698,,False,25.0,7,9,7,9,0,0,4,5,1,6,7,0,0,0,4,3,18
400915462,Virginia Tech Hokies,M. Galloway,3945565,,False,3.0,0,0,0,0,0,0,0,0,0,0,0,0,0,0,0,1,0
400915462,Virginia Tech Hokies,S. Allen,61795,,False,30.0,4,6,3,3,1,3,6,7,0,3,3,3,3,0,8,2,15
400915462,Virginia Tech Hokies,TEAM,TOTAL,TOTAL,False,,31,46,19,28,12,18,17,20,3,24,27,18,4,2,19,13,91
400915462,Virginia Tech Hokies,K. Sy,4065740,,True,15.0,2,5,2,5,0,0,0,0,1,2,3,1,0,0,0,0,4
400915462,Virginia Tech Hokies,J. Robinson,3945566,,True,35.0,4,8,3,6,1,2,4,4,0,0,0,11,0,1,3,2,13
400915462,Virginia Tech Hokies,A. Hill,3147501,,True,27.0,5,6,4,4,1,2,1,1,0,1,1,0,0,1,2,2,12
400915462,Virginia Tech Hokies,J. Bibbs,3147500,,True,27.0,4,6,0,0,4,6,1,1,0,4,4,2,0,0,1,2,13
400915462,Virginia Tech Hokies,T. Outlaw,67275,,True,38.0,5,6,0,1,5,5,1,2,1,6,7,1,1,0,0,1,16
400915462,Virginia Tech Hokies,Z. LeDay,61698,,False,25.0,7,9,7,9,0,0,4,5,1,6,7,0,0,0,4,3,18
400915462,Virginia Tech Hokies,M. Galloway,3945565,,False,3.0,0,0,0,0,0,0,0,0,0,0,0,0,0,0,0,1,0
400915462,Virginia Tech Hokies,S. Allen,61795,,False,30.0,4,6,3,3,1,3,6,7,0,3,3,3,3,0,8,2,15
400915462,Virginia Tech Hokies,TEAM,TOTAL,TOTAL,False,,31,46,19,28,12,18,17,20,3,24,27,18,4,2,19,13,91
400915462,Boston College Eagles,G. Owens,66277,,True,19.0,3,3,3,3,0,0,0,0,0,3,3,0,0,0,0,0,6
400915462,Boston College Eagles,M. Jeffers,61901,,True,14.0,1,2,1,2,0,0,0,0,0,2,2,0,1,0,2,4,2
400915462,Boston College Eagles,C. Tava,61446,,True,22.0,1,3,1,3,0,0,0,0,1,1,2,0,0,0,0,4,2
400915462,Boston College Eagles,K. Bowman,4065635,,True,32.0,6,16,4,8,2,8,2,2,1,3,4,3,2,0,3,3,16
400915462,Boston College Eagles,J. Robinson,3943606,,True,39.0,8,17,4,9,4,8,5,5,0,1,1,5,3,0,2,0,25
400915462,Boston College Eagles,M. Sagay,4065638,,False,4.0,0,0,0,0,0,0,0,0,0,0,0,0,0,0,0,0,0
400915462,Boston College Eagles,N. Popovic,4065637,,False,8.0,4,4,4,4,0,0,0,0,0,2,2,0,0,0,2,5,8
400915462,Boston College Eagles,A.J. Turner,3943608,,False,29.0,1,2,0,0,1,2,0,0,1,0,1,2,1,0,2,2,3
400915462,Boston College Eagles,J. Chatman,3135095,,False,33.0,4,9,1,1,3,8,2,3,0,1,1,2,2,0,0,2,13
400915462,Boston College Eagles,TEAM,TOTAL,TOTAL,False,,28,56,18,30,10,26,9,10,4,14,18,12,9,0,12,20,75
400915462,Boston College Eagles,G. Owens,66277,,True,19.0,3,3,3,3,0,0,0,0,0,3,3,0,0,0,0,0,6
400915462,Boston College Eagles,M. Jeffers,61901,,True,14.0,1,2,1,2,0,0,0,0,0,2,2,0,1,0,2,4,2
400915462,Boston College Eagles,C. Tava,61446,,True,22.0,1,3,1,3,0,0,0,0,1,1,2,0,0,0,0,4,2
400915462,Boston College Eagles,K. Bowman,4065635,,True,32.0,6,16,4,8,2,8,2,2,1,3,4,3,2,0,3,3,16
400915462,Boston College Eagles,J. Robinson,3943606,,True,39.0,8,17,4,9,4,8,5,5,0,1,1,5,3,0,2,0,25
400915462,Boston College Eagles,M. Sagay,4065638,,False,4.0,0,0,0,0,0,0,0,0,0,0,0,0,0,0,0,0,0
400915462,Boston College Eagles,N. Popovic,4065637,,False,8.0,4,4,4,4,0,0,0,0,0,2,2,0,0,0,2,5,8
400915462,Boston College Eagles,A.J. Turner,3943608,,False,29.0,1,2,0,0,1,2,0,0,1,0,1,2,1,0,2,2,3
400915462,Boston College Eagles,J. Chatman,3135095,,False,33.0,4,9,1,1,3,8,2,3,0,1,1,2,2,0,0,2,13
400915462,Boston College Eagles,TEAM,TOTAL,TOTAL,False,,28,56,18,30,10,26,9,10,4,14,18,12,9,0,12,20,75
400915461,Pittsburgh Panthers,M. Young,66290,,True,35.0,4,10,2,5,2,5,7,9,1,7,8,1,0,1,3,1,17
400915461,Pittsburgh Panthers,S. Jeter,61756,,True,17.0,2,4,0,1,2,3,1,2,1,1,2,2,1,1,1,5,7
400915461,Pittsburgh Panthers,J. Artis,66287,,True,35.0,6,12,5,7,1,5,4,5,1,0,1,5,0,0,3,0,17
400915461,Pittsburgh Panthers,C. Johnson,3138196,,True,31.0,3,5,2,2,1,3,2,3,0,1,1,1,4,0,2,2,9
400915461,Pittsburgh Panthers,C. Jones,61219,,True,34.0,3,6,2,3,1,3,3,5,0,1,1,0,1,0,1,2,10
400915461,Pittsburgh Panthers,R. Nix,3934653,,False,18.0,1,4,1,4,0,0,1,2,3,5,8,0,0,1,1,3,3
400915461,Pittsburgh Panthers,C. Manigault,4065714,,False,8.0,0,3,0,2,0,1,4,4,1,0,1,0,0,0,0,1,4
400915461,Pittsburgh Panthers,J. Kithcart,4065713,,False,7.0,0,1,0,0,0,1,0,0,0,0,0,1,0,0,0,1,0
400915461,Pittsburgh Panthers,J. Milligan,3934655,,False,6.0,0,1,0,0,0,1,0,0,0,1,1,0,0,0,1,0,0
400915461,Pittsburgh Panthers,Z. Smith,3934654,,False,1.0,0,1,0,0,0,1,0,0,0,0,0,0,0,0,0,0,0
400915461,Pittsburgh Panthers,D. Wilson,3934652,,False,8.0,0,1,0,0,0,1,0,0,0,1,1,0,0,0,0,2,0
400915461,Pittsburgh Panthers,TEAM,TOTAL,TOTAL,False,,19,48,12,24,7,24,22,30,9,19,28,10,6,3,12,17,67
400915461,Pittsburgh Panthers,M. Young,66290,,True,35.0,4,10,2,5,2,5,7,9,1,7,8,1,0,1,3,1,17
400915461,Pittsburgh Panthers,S. Jeter,61756,,True,17.0,2,4,0,1,2,3,1,2,1,1,2,2,1,1,1,5,7
400915461,Pittsburgh Panthers,J. Artis,66287,,True,35.0,6,12,5,7,1,5,4,5,1,0,1,5,0,0,3,0,17
400915461,Pittsburgh Panthers,C. Johnson,3138196,,True,31.0,3,5,2,2,1,3,2,3,0,1,1,1,4,0,2,2,9
400915461,Pittsburgh Panthers,C. Jones,61219,,True,34.0,3,6,2,3,1,3,3,5,0,1,1,0,1,0,1,2,10
400915461,Pittsburgh Panthers,R. Nix,3934653,,False,18.0,1,4,1,4,0,0,1,2,3,5,8,0,0,1,1,3,3
400915461,Pittsburgh Panthers,C. Manigault,4065714,,False,8.0,0,3,0,2,0,1,4,4,1,0,1,0,0,0,0,1,4
400915461,Pittsburgh Panthers,J. Kithcart,4065713,,False,7.0,0,1,0,0,0,1,0,0,0,0,0,1,0,0,0,1,0
400915461,Pittsburgh Panthers,J. Milligan,3934655,,False,6.0,0,1,0,0,0,1,0,0,0,1,1,0,0,0,1,0,0
400915461,Pittsburgh Panthers,Z. Smith,3934654,,False,1.0,0,1,0,0,0,1,0,0,0,0,0,0,0,0,0,0,0
400915461,Pittsburgh Panthers,D. Wilson,3934652,,False,8.0,0,1,0,0,0,1,0,0,0,1,1,0,0,0,0,2,0
400915461,Pittsburgh Panthers,TEAM,TOTAL,TOTAL,False,,19,48,12,24,7,24,22,30,9,19,28,10,6,3,12,17,67
400915461,North Carolina Tar Heels,J. Jackson,3138156,,True,34.0,9,20,4,9,5,11,0,0,3,3,6,2,1,0,2,0,23
400915461,North Carolina Tar Heels,I. Hicks,66874,,True,27.0,3,7,3,7,0,0,2,3,3,3,6,6,0,1,1,4,8
400915461,North Carolina Tar Heels,K. Meeks,66873,,True,25.0,9,11,9,11,0,0,0,2,7,3,10,1,2,0,0,3,18
400915461,North Carolina Tar Heels,T. Pinson,3138154,,True,24.0,2,6,1,4,1,2,0,0,0,3,3,7,0,0,1,4,5
400915461,North Carolina Tar Heels,J. Berry II,3138155,,True,32.0,6,16,2,7,4,9,3,4,1,3,4,2,0,1,0,2,19
400915461,North Carolina Tar Heels,A. Rohlman,4065677,,False,1.0,0,0,0,0,0,0,0,0,1,0,1,0,0,0,0,0,0
400915461,North Carolina Tar Heels,S. Rush,4065674,,False,1.0,0,1,0,1,0,0,0,0,0,0,0,0,0,1,0,0,0
400915461,North Carolina Tar Heels,T. Bradley,4065673,,False,14.0,3,3,3,3,0,0,4,6,4,2,6,1,0,0,0,3,10
400915461,North Carolina Tar Heels,L. Maye,3911620,,False,12.0,1,4,1,4,0,0,0,0,4,1,5,2,0,0,1,4,2
400915461,North Carolina Tar Heels,S. Woods,4065676,,False,8.0,0,2,0,2,0,0,0,0,0,2,2,0,0,0,1,1,0
400915461,North Carolina Tar Heels,B. Robinson,4065675,,False,5.0,0,0,0,0,0,0,0,0,0,1,1,2,1,0,1,0,0
400915461,North Carolina Tar Heels,K. Coker,3947144,,False,1.0,0,0,0,0,0,0,0,0,0,0,0,0,0,0,0,0,0
400915461,North Carolina Tar Heels,N. Britt,66872,,False,15.0,0,3,0,1,0,2,0,0,0,2,2,0,1,0,0,1,0
400915461,North Carolina Tar Heels,S. White,56963,,False,1.0,0,0,0,0,0,0,0,0,0,0,0,0,0,0,0,0,0
400915461,North Carolina Tar Heels,TEAM,TOTAL,TOTAL,False,,33,73,23,49,10,24,9,15,24,24,48,23,5,3,8,22,85
400915461,North Carolina Tar Heels,J. Jackson,3138156,,True,34.0,9,20,4,9,5,11,0,0,3,3,6,2,1,0,2,0,23
400915461,North Carolina Tar Heels,I. Hicks,66874,,True,27.0,3,7,3,7,0,0,2,3,3,3,6,6,0,1,1,4,8
400915461,North Carolina Tar Heels,K. Meeks,66873,,True,25.0,9,11,9,11,0,0,0,2,7,3,10,1,2,0,0,3,18
400915461,North Carolina Tar Heels,T. Pinson,3138154,,True,24.0,2,6,1,4,1,2,0,0,0,3,3,7,0,0,1,4,5
400915461,North Carolina Tar Heels,J. Berry II,3138155,,True,32.0,6,16,2,7,4,9,3,4,1,3,4,2,0,1,0,2,19
400915461,North Carolina Tar Heels,A. Rohlman,4065677,,False,1.0,0,0,0,0,0,0,0,0,1,0,1,0,0,0,0,0,0
400915461,North Carolina Tar Heels,S. Rush,4065674,,False,1.0,0,1,0,1,0,0,0,0,0,0,0,0,0,1,0,0,0
400915461,North Carolina Tar Heels,T. Bradley,4065673,,False,14.0,3,3,3,3,0,0,4,6,4,2,6,1,0,0,0,3,10
400915461,North Carolina Tar Heels,L. Maye,3911620,,False,12.0,1,4,1,4,0,0,0,0,4,1,5,2,0,0,1,4,2
400915461,North Carolina Tar Heels,S. Woods,4065676,,False,8.0,0,2,0,2,0,0,0,0,0,2,2,0,0,0,1,1,0
400915461,North Carolina Tar Heels,B. Robinson,4065675,,False,5.0,0,0,0,0,0,0,0,0,0,1,1,2,1,0,1,0,0
400915461,North Carolina Tar Heels,K. Coker,3947144,,False,1.0,0,0,0,0,0,0,0,0,0,0,0,0,0,0,0,0,0
400915461,North Carolina Tar Heels,N. Britt,66872,,False,15.0,0,3,0,1,0,2,0,0,0,2,2,0,1,0,0,1,0
400915461,North Carolina Tar Heels,S. White,56963,,False,1.0,0,0,0,0,0,0,0,0,0,0,0,0,0,0,0,0,0
400915461,North Carolina Tar Heels,TEAM,TOTAL,TOTAL,False,,33,73,23,49,10,24,9,15,24,24,48,23,5,3,8,22,85
400915460,Florida State Seminoles,J. Isaac,4065654,,True,29.0,5,8,3,5,2,3,2,2,1,2,3,1,0,1,1,3,14
400915460,Florida State Seminoles,M. Ojo,61596,,True,10.0,2,3,2,3,0,0,4,4,3,0,3,0,0,0,0,4,8
400915460,Florida State Seminoles,D. Bacon,3907821,,True,31.0,3,14,2,8,1,6,5,5,0,3,3,1,1,0,3,2,12
400915460,Florida State Seminoles,T. Mann,3907823,,True,19.0,2,2,1,1,1,1,0,0,3,1,4,2,3,0,1,5,5
400915460,Florida State Seminoles,X. Rathan-Mayes,66125,,True,35.0,5,12,5,9,0,3,5,6,0,4,4,7,1,0,1,3,15
400915460,Florida State Seminoles,P. Cofer,3135054,,False,9.0,1,1,0,0,1,1,0,0,0,0,0,0,0,0,0,3,3
400915460,Florida State Seminoles,J. Smith,66126,,False,19.0,2,4,2,4,0,0,2,2,0,2,2,0,1,0,3,3,6
400915460,Florida State Seminoles,C. Koumadje,3907824,,False,10.0,1,1,1,1,0,0,0,0,2,1,3,0,0,1,0,1,2
400915460,Florida State Seminoles,B. Angola-Rodas,4065658,,False,9.0,1,3,1,1,0,2,0,0,1,0,1,0,0,1,0,1,2
400915460,Florida State Seminoles,P. Savoy,4065657,,False,4.0,0,0,0,0,0,0,0,0,0,0,0,0,0,0,1,1,0
400915460,Florida State Seminoles,T. Forrest,4065656,,False,22.0,2,4,2,4,0,0,5,7,1,4,5,2,1,1,0,2,9
400915460,Florida State Seminoles,C. Walker,4065655,,False,3.0,0,1,0,0,0,1,0,2,0,1,1,0,0,0,0,0,0
400915460,Florida State Seminoles,TEAM,TOTAL,TOTAL,False,,24,53,19,36,5,17,23,28,13,20,33,13,7,4,10,28,76
400915460,Florida State Seminoles,J. Isaac,4065654,,True,29.0,5,8,3,5,2,3,2,2,1,2,3,1,0,1,1,3,14
400915460,Florida State Seminoles,M. Ojo,61596,,True,10.0,2,3,2,3,0,0,4,4,3,0,3,0,0,0,0,4,8
400915460,Florida State Seminoles,D. Bacon,3907821,,True,31.0,3,14,2,8,1,6,5,5,0,3,3,1,1,0,3,2,12
400915460,Florida State Seminoles,T. Mann,3907823,,True,19.0,2,2,1,1,1,1,0,0,3,1,4,2,3,0,1,5,5
400915460,Florida State Seminoles,X. Rathan-Mayes,66125,,True,35.0,5,12,5,9,0,3,5,6,0,4,4,7,1,0,1,3,15
400915460,Florida State Seminoles,P. Cofer,3135054,,False,9.0,1,1,0,0,1,1,0,0,0,0,0,0,0,0,0,3,3
400915460,Florida State Seminoles,J. Smith,66126,,False,19.0,2,4,2,4,0,0,2,2,0,2,2,0,1,0,3,3,6
400915460,Florida State Seminoles,C. Koumadje,3907824,,False,10.0,1,1,1,1,0,0,0,0,2,1,3,0,0,1,0,1,2
400915460,Florida State Seminoles,B. Angola-Rodas,4065658,,False,9.0,1,3,1,1,0,2,0,0,1,0,1,0,0,1,0,1,2
400915460,Florida State Seminoles,P. Savoy,4065657,,False,4.0,0,0,0,0,0,0,0,0,0,0,0,0,0,0,1,1,0
400915460,Florida State Seminoles,T. Forrest,4065656,,False,22.0,2,4,2,4,0,0,5,7,1,4,5,2,1,1,0,2,9
400915460,Florida State Seminoles,C. Walker,4065655,,False,3.0,0,1,0,0,0,1,0,2,0,1,1,0,0,0,0,0,0
400915460,Florida State Seminoles,TEAM,TOTAL,TOTAL,False,,24,53,19,36,5,17,23,28,13,20,33,13,7,4,10,28,76
400915460,Clemson Tigers,E. Thomas,3947075,,True,9.0,1,1,1,1,0,0,0,0,0,1,1,0,1,0,0,4,2
400915460,Clemson Tigers,D. Grantham,3129674,,True,23.0,2,5,1,2,1,3,0,0,0,0,0,1,1,0,1,1,5
400915460,Clemson Tigers,J. Blossomgame,61835,,True,38.0,7,11,6,10,1,1,9,9,3,5,8,0,1,0,3,0,24
400915460,Clemson Tigers,S. Mitchell,3136699,,True,24.0,4,8,2,5,2,3,5,8,0,3,3,0,0,0,4,4,15
400915460,Clemson Tigers,A. Holmes,62043,,True,29.0,1,6,1,4,0,2,4,5,1,2,3,2,1,0,0,1,6
400915460,Clemson Tigers,S. Djitte,66122,,False,31.0,4,7,4,7,0,0,4,6,5,4,9,1,0,1,1,5,12
400915460,Clemson Tigers,T. Hudson,3917986,,False,3.0,0,0,0,0,0,0,0,0,0,0,0,0,0,0,0,2,0
400915460,Clemson Tigers,M. Reed,3133969,,False,24.0,3,10,3,9,0,1,4,4,0,2,2,4,1,0,1,2,10
400915460,Clemson Tigers,G. DeVoe,3129673,,False,19.0,0,1,0,0,0,1,0,0,0,1,1,0,0,0,1,2,0
400915460,Clemson Tigers,TEAM,TOTAL,TOTAL,False,,22,49,18,38,4,11,26,32,10,19,29,8,5,1,11,21,74
400915460,Clemson Tigers,E. Thomas,3947075,,True,9.0,1,1,1,1,0,0,0,0,0,1,1,0,1,0,0,4,2
400915460,Clemson Tigers,D. Grantham,3129674,,True,23.0,2,5,1,2,1,3,0,0,0,0,0,1,1,0,1,1,5
400915460,Clemson Tigers,J. Blossomgame,61835,,True,38.0,7,11,6,10,1,1,9,9,3,5,8,0,1,0,3,0,24
400915460,Clemson Tigers,S. Mitchell,3136699,,True,24.0,4,8,2,5,2,3,5,8,0,3,3,0,0,0,4,4,15
400915460,Clemson Tigers,A. Holmes,62043,,True,29.0,1,6,1,4,0,2,4,5,1,2,3,2,1,0,0,1,6
400915460,Clemson Tigers,S. Djitte,66122,,False,31.0,4,7,4,7,0,0,4,6,5,4,9,1,0,1,1,5,12
400915460,Clemson Tigers,T. Hudson,3917986,,False,3.0,0,0,0,0,0,0,0,0,0,0,0,0,0,0,0,2,0
400915460,Clemson Tigers,M. Reed,3133969,,False,24.0,3,10,3,9,0,1,4,4,0,2,2,4,1,0,1,2,10
400915460,Clemson Tigers,G. DeVoe,3129673,,False,19.0,0,1,0,0,0,1,0,0,0,1,1,0,0,0,1,2,0
400915460,Clemson Tigers,TEAM,TOTAL,TOTAL,False,,22,49,18,38,4,11,26,32,10,19,29,8,5,1,11,21,74
400915459,North Carolina Tar Heels,J. Jackson,3138156,,True,32.0,7,16,3,7,4,9,3,4,3,2,5,2,2,0,4,1,21
400915459,North Carolina Tar Heels,I. Hicks,66874,,True,14.0,0,6,0,6,0,0,0,0,3,4,7,0,2,0,1,4,0
400915459,North Carolina Tar Heels,K. Meeks,66873,,True,30.0,4,7,4,7,0,0,6,7,4,6,10,1,0,2,2,3,14
400915459,North Carolina Tar Heels,T. Pinson,3138154,,True,28.0,4,10,2,6,2,4,3,4,2,4,6,0,0,0,3,2,13
400915459,North Carolina Tar Heels,J. Berry II,3138155,,True,35.0,5,13,4,8,1,5,4,6,0,4,4,3,1,1,0,2,15
400915459,North Carolina Tar Heels,T. Bradley,4065673,,False,17.0,2,5,2,5,0,0,0,2,1,4,5,1,1,2,0,1,4
400915459,North Carolina Tar Heels,L. Maye,3911620,,False,16.0,0,2,0,2,0,0,1,2,1,1,2,1,2,0,1,2,1
400915459,North Carolina Tar Heels,S. Woods,4065676,,False,5.0,0,1,0,1,0,0,0,0,0,1,1,0,2,0,1,1,0
400915459,North Carolina Tar Heels,B. Robinson,4065675,,False,2.0,0,0,0,0,0,0,0,0,0,0,0,0,0,0,0,0,0
400915459,North Carolina Tar Heels,N. Britt,66872,,False,19.0,0,1,0,1,0,0,4,4,0,1,1,1,0,0,0,0,4
400915459,North Carolina Tar Heels,S. White,56963,,False,2.0,1,1,1,1,0,0,0,0,0,0,0,1,0,0,0,0,2
400915459,North Carolina Tar Heels,TEAM,TOTAL,TOTAL,False,,23,62,16,44,7,18,21,29,16,30,46,10,10,5,12,16,74
400915459,North Carolina Tar Heels,J. Jackson,3138156,,True,32.0,7,16,3,7,4,9,3,4,3,2,5,2,2,0,4,1,21
400915459,North Carolina Tar Heels,I. Hicks,66874,,True,14.0,0,6,0,6,0,0,0,0,3,4,7,0,2,0,1,4,0
400915459,North Carolina Tar Heels,K. Meeks,66873,,True,30.0,4,7,4,7,0,0,6,7,4,6,10,1,0,2,2,3,14
400915459,North Carolina Tar Heels,T. Pinson,3138154,,True,28.0,4,10,2,6,2,4,3,4,2,4,6,0,0,0,3,2,13
400915459,North Carolina Tar Heels,J. Berry II,3138155,,True,35.0,5,13,4,8,1,5,4,6,0,4,4,3,1,1,0,2,15
400915459,North Carolina Tar Heels,T. Bradley,4065673,,False,17.0,2,5,2,5,0,0,0,2,1,4,5,1,1,2,0,1,4
400915459,North Carolina Tar Heels,L. Maye,3911620,,False,16.0,0,2,0,2,0,0,1,2,1,1,2,1,2,0,1,2,1
400915459,North Carolina Tar Heels,S. Woods,4065676,,False,5.0,0,1,0,1,0,0,0,0,0,1,1,0,2,0,1,1,0
400915459,North Carolina Tar Heels,B. Robinson,4065675,,False,2.0,0,0,0,0,0,0,0,0,0,0,0,0,0,0,0,0,0
400915459,North Carolina Tar Heels,N. Britt,66872,,False,19.0,0,1,0,1,0,0,4,4,0,1,1,1,0,0,0,0,4
400915459,North Carolina Tar Heels,S. White,56963,,False,2.0,1,1,1,1,0,0,0,0,0,0,0,1,0,0,0,0,2
400915459,North Carolina Tar Heels,TEAM,TOTAL,TOTAL,False,,23,62,16,44,7,18,21,29,16,30,46,10,10,5,12,16,74
400915459,Louisville Cardinals,M. Mathiang,63035,,True,14.0,3,4,3,4,0,0,0,0,2,0,2,0,0,0,2,2,6
400915459,Louisville Cardinals,J. Johnson,3147362,,True,22.0,2,3,1,2,1,1,0,2,1,1,2,0,0,0,1,3,5
400915459,Louisville Cardinals,D. Adel,3908807,,True,28.0,4,13,4,10,0,3,0,1,0,6,6,3,1,1,3,4,8
400915459,Louisville Cardinals,D. Mitchell,3908809,,True,38.0,8,15,5,6,3,9,2,2,0,4,4,3,1,1,3,2,21
400915459,Louisville Cardinals,Q. Snider,3147360,,True,32.0,3,9,2,5,1,4,2,4,0,3,3,2,1,0,3,3,9
400915459,Louisville Cardinals,V.J. King,4065666,,False,12.0,1,4,1,3,0,1,0,1,0,1,1,0,1,1,0,0,2
400915459,Louisville Cardinals,R. Spalding,3908806,,False,17.0,1,4,1,4,0,0,0,2,2,2,4,0,2,0,2,3,2
400915459,Louisville Cardinals,A. Mahmoud,3147363,,False,25.0,4,5,4,5,0,0,0,1,3,2,5,1,2,4,1,2,8
400915459,Louisville Cardinals,M. Stockman,3147361,,False,1.0,0,0,0,0,0,0,0,0,0,0,0,0,0,0,0,0,0
400915459,Louisville Cardinals,R. McMahon,3908808,,False,5.0,0,2,0,0,0,2,0,0,0,1,1,0,0,0,1,2,0
400915459,Louisville Cardinals,J. Henderson,3155491,,False,2.0,0,1,0,1,0,0,0,0,0,1,1,1,0,0,0,0,0
400915459,Louisville Cardinals,T. Hicks,62752,,False,4.0,1,1,1,1,0,0,0,0,0,0,0,0,1,0,0,0,2
400915459,Louisville Cardinals,TEAM,TOTAL,TOTAL,False,,27,61,22,41,5,20,4,13,8,25,33,10,9,7,16,21,63
400915459,Louisville Cardinals,M. Mathiang,63035,,True,14.0,3,4,3,4,0,0,0,0,2,0,2,0,0,0,2,2,6
400915459,Louisville Cardinals,J. Johnson,3147362,,True,22.0,2,3,1,2,1,1,0,2,1,1,2,0,0,0,1,3,5
400915459,Louisville Cardinals,D. Adel,3908807,,True,28.0,4,13,4,10,0,3,0,1,0,6,6,3,1,1,3,4,8
400915459,Louisville Cardinals,D. Mitchell,3908809,,True,38.0,8,15,5,6,3,9,2,2,0,4,4,3,1,1,3,2,21
400915459,Louisville Cardinals,Q. Snider,3147360,,True,32.0,3,9,2,5,1,4,2,4,0,3,3,2,1,0,3,3,9
400915459,Louisville Cardinals,V.J. King,4065666,,False,12.0,1,4,1,3,0,1,0,1,0,1,1,0,1,1,0,0,2
400915459,Louisville Cardinals,R. Spalding,3908806,,False,17.0,1,4,1,4,0,0,0,2,2,2,4,0,2,0,2,3,2
400915459,Louisville Cardinals,A. Mahmoud,3147363,,False,25.0,4,5,4,5,0,0,0,1,3,2,5,1,2,4,1,2,8
400915459,Louisville Cardinals,M. Stockman,3147361,,False,1.0,0,0,0,0,0,0,0,0,0,0,0,0,0,0,0,0,0
400915459,Louisville Cardinals,R. McMahon,3908808,,False,5.0,0,2,0,0,0,2,0,0,0,1,1,0,0,0,1,2,0
400915459,Louisville Cardinals,J. Henderson,3155491,,False,2.0,0,1,0,1,0,0,0,0,0,1,1,1,0,0,0,0,0
400915459,Louisville Cardinals,T. Hicks,62752,,False,4.0,1,1,1,1,0,0,0,0,0,0,0,0,1,0,0,0,2
400915459,Louisville Cardinals,TEAM,TOTAL,TOTAL,False,,27,61,22,41,5,20,4,13,8,25,33,10,9,7,16,21,63
400915458,Wake Forest Demon Deacons,J. Collins,3908845,,True,28.0,10,16,10,16,0,0,2,5,8,5,13,0,2,1,1,4,22
400915458,Wake Forest Demon Deacons,D. Mitoglou,3138224,,True,26.0,1,5,1,4,0,1,5,6,1,6,7,1,1,0,1,4,7
400915458,Wake Forest Demon Deacons,A. Arians,61378,,True,24.0,3,8,1,2,2,6,0,0,0,2,2,2,0,1,0,2,8
400915458,Wake Forest Demon Deacons,B. Crawford,3908844,,True,36.0,3,11,3,6,0,5,4,7,0,9,9,5,5,0,3,3,10
400915458,Wake Forest Demon Deacons,K. Woods,3132360,,True,32.0,1,9,1,8,0,1,0,0,1,3,4,4,0,0,4,3,2
400915458,Wake Forest Demon Deacons,G. McClinton,66140,,False,9.0,1,1,1,1,0,0,0,0,1,2,3,1,0,0,0,1,2
400915458,Wake Forest Demon Deacons,D. Moore,3908843,,False,6.0,1,1,1,1,0,0,2,2,0,2,2,0,0,0,1,1,4
400915458,Wake Forest Demon Deacons,B. Childress,4065750,,False,27.0,2,6,1,5,1,1,3,5,0,3,3,1,1,0,1,0,8
400915458,Wake Forest Demon Deacons,M. Wilbekin,3138222,,False,12.0,0,1,0,0,0,1,0,0,0,2,2,0,0,1,1,2,0
400915458,Wake Forest Demon Deacons,TEAM,TOTAL,TOTAL,False,,22,58,19,43,3,15,16,25,13,35,48,14,9,3,12,20,63
400915458,Wake Forest Demon Deacons,J. Collins,3908845,,True,28.0,10,16,10,16,0,0,2,5,8,5,13,0,2,1,1,4,22
400915458,Wake Forest Demon Deacons,D. Mitoglou,3138224,,True,26.0,1,5,1,4,0,1,5,6,1,6,7,1,1,0,1,4,7
400915458,Wake Forest Demon Deacons,A. Arians,61378,,True,24.0,3,8,1,2,2,6,0,0,0,2,2,2,0,1,0,2,8
400915458,Wake Forest Demon Deacons,B. Crawford,3908844,,True,36.0,3,11,3,6,0,5,4,7,0,9,9,5,5,0,3,3,10
400915458,Wake Forest Demon Deacons,K. Woods,3132360,,True,32.0,1,9,1,8,0,1,0,0,1,3,4,4,0,0,4,3,2
400915458,Wake Forest Demon Deacons,G. McClinton,66140,,False,9.0,1,1,1,1,0,0,0,0,1,2,3,1,0,0,0,1,2
400915458,Wake Forest Demon Deacons,D. Moore,3908843,,False,6.0,1,1,1,1,0,0,2,2,0,2,2,0,0,0,1,1,4
400915458,Wake Forest Demon Deacons,B. Childress,4065750,,False,27.0,2,6,1,5,1,1,3,5,0,3,3,1,1,0,1,0,8
400915458,Wake Forest Demon Deacons,M. Wilbekin,3138222,,False,12.0,0,1,0,0,0,1,0,0,0,2,2,0,0,1,1,2,0
400915458,Wake Forest Demon Deacons,TEAM,TOTAL,TOTAL,False,,22,58,19,43,3,15,16,25,13,35,48,14,9,3,12,20,63
400915458,Pittsburgh Panthers,M. Young,66290,,True,28.0,7,14,5,10,2,4,8,9,0,2,2,1,0,0,0,4,24
400915458,Pittsburgh Panthers,S. Jeter,61756,,True,38.0,3,11,3,9,0,2,3,3,3,4,7,2,1,1,2,4,9
400915458,Pittsburgh Panthers,J. Artis,66287,,True,35.0,3,11,1,5,2,6,3,4,2,3,5,2,0,0,3,1,11
400915458,Pittsburgh Panthers,C. Johnson,3138196,,True,37.0,2,10,0,2,2,8,3,4,0,7,7,4,3,0,0,3,9
400915458,Pittsburgh Panthers,C. Jones,61219,,True,36.0,0,1,0,1,0,0,3,8,1,6,7,1,0,1,4,4,3
400915458,Pittsburgh Panthers,R. Nix,3934653,,False,10.0,0,1,0,1,0,0,0,0,0,4,4,0,0,0,1,3,0
400915458,Pittsburgh Panthers,J. Kithcart,4065713,,False,8.0,0,1,0,1,0,0,0,0,0,0,0,0,0,1,0,2,0
400915458,Pittsburgh Panthers,J. Milligan,3934655,,False,5.0,1,4,0,1,1,3,0,0,0,0,0,1,0,0,1,0,3
400915458,Pittsburgh Panthers,D. Wilson,3934652,,False,3.0,0,0,0,0,0,0,0,0,0,0,0,0,0,0,0,1,0
400915458,Pittsburgh Panthers,TEAM,TOTAL,TOTAL,False,,16,53,9,30,7,23,20,28,8,29,37,11,4,3,12,22,59
400915458,Pittsburgh Panthers,M. Young,66290,,True,28.0,7,14,5,10,2,4,8,9,0,2,2,1,0,0,0,4,24
400915458,Pittsburgh Panthers,S. Jeter,61756,,True,38.0,3,11,3,9,0,2,3,3,3,4,7,2,1,1,2,4,9
400915458,Pittsburgh Panthers,J. Artis,66287,,True,35.0,3,11,1,5,2,6,3,4,2,3,5,2,0,0,3,1,11
400915458,Pittsburgh Panthers,C. Johnson,3138196,,True,37.0,2,10,0,2,2,8,3,4,0,7,7,4,3,0,0,3,9
400915458,Pittsburgh Panthers,C. Jones,61219,,True,36.0,0,1,0,1,0,0,3,8,1,6,7,1,0,1,4,4,3
400915458,Pittsburgh Panthers,R. Nix,3934653,,False,10.0,0,1,0,1,0,0,0,0,0,4,4,0,0,0,1,3,0
400915458,Pittsburgh Panthers,J. Kithcart,4065713,,False,8.0,0,1,0,1,0,0,0,0,0,0,0,0,0,1,0,2,0
400915458,Pittsburgh Panthers,J. Milligan,3934655,,False,5.0,1,4,0,1,1,3,0,0,0,0,0,1,0,0,1,0,3
400915458,Pittsburgh Panthers,D. Wilson,3934652,,False,3.0,0,0,0,0,0,0,0,0,0,0,0,0,0,0,0,1,0
400915458,Pittsburgh Panthers,TEAM,TOTAL,TOTAL,False,,16,53,9,30,7,23,20,28,8,29,37,11,4,3,12,22,59
400915457,Syracuse Orange,T. Thompson,4065721,,True,22.0,4,7,4,7,0,0,3,4,0,4,4,0,0,0,3,3,11
400915457,Syracuse Orange,T. Lydon,3934662,,True,40.0,3,6,2,5,1,1,4,4,1,8,9,1,0,0,1,3,11
400915457,Syracuse Orange,A. White III,61616,,True,40.0,1,4,0,2,1,2,4,4,0,3,3,0,1,0,2,0,7
400915457,Syracuse Orange,T. Battle,4065722,,True,33.0,6,11,5,8,1,3,5,6,0,4,4,1,1,0,0,3,18
400915457,Syracuse Orange,J. Gillon,61915,,True,40.0,9,14,6,10,3,4,5,5,1,1,2,6,1,0,0,2,26
400915457,Syracuse Orange,T. Roberson,67633,,False,18.0,2,3,2,3,0,0,0,0,1,2,3,1,0,1,2,2,4
400915457,Syracuse Orange,F. Howard,3934659,,False,7.0,0,2,0,1,0,1,1,2,0,0,0,1,0,0,0,2,1
400915457,Syracuse Orange,TEAM,TOTAL,TOTAL,False,,25,47,19,36,6,11,22,25,4,24,28,10,3,1,8,15,78
400915457,Syracuse Orange,T. Thompson,4065721,,True,22.0,4,7,4,7,0,0,3,4,0,4,4,0,0,0,3,3,11
400915457,Syracuse Orange,T. Lydon,3934662,,True,40.0,3,6,2,5,1,1,4,4,1,8,9,1,0,0,1,3,11
400915457,Syracuse Orange,A. White III,61616,,True,40.0,1,4,0,2,1,2,4,4,0,3,3,0,1,0,2,0,7
400915457,Syracuse Orange,T. Battle,4065722,,True,33.0,6,11,5,8,1,3,5,6,0,4,4,1,1,0,0,3,18
400915457,Syracuse Orange,J. Gillon,61915,,True,40.0,9,14,6,10,3,4,5,5,1,1,2,6,1,0,0,2,26
400915457,Syracuse Orange,T. Roberson,67633,,False,18.0,2,3,2,3,0,0,0,0,1,2,3,1,0,1,2,2,4
400915457,Syracuse Orange,F. Howard,3934659,,False,7.0,0,2,0,1,0,1,1,2,0,0,0,1,0,0,0,2,1
400915457,Syracuse Orange,TEAM,TOTAL,TOTAL,False,,25,47,19,36,6,11,22,25,4,24,28,10,3,1,8,15,78
400915457,Duke Blue Devils,A. Jefferson,61586,,True,28.0,3,4,3,4,0,0,8,9,1,3,4,0,1,2,0,1,14
400915457,Duke Blue Devils,J. Tatum,4065648,,True,40.0,8,17,5,10,3,7,0,0,4,9,13,6,1,0,4,2,19
400915457,Duke Blue Devils,L. Kennard,3913174,,True,37.0,8,19,3,10,5,9,2,3,4,3,7,5,0,1,0,4,23
400915457,Duke Blue Devils,G. Allen,3135045,,True,29.0,2,11,1,3,1,8,3,3,0,1,1,1,1,0,2,4,8
400915457,Duke Blue Devils,M. Jones,66563,,True,40.0,1,6,0,1,1,5,0,0,3,2,5,2,2,1,1,2,3
400915457,Duke Blue Devils,H. Giles III,4065649,,False,11.0,3,3,3,3,0,0,0,0,2,2,4,0,0,0,0,1,6
400915457,Duke Blue Devils,F. Jackson,4065651,,False,15.0,0,4,0,0,0,4,2,2,1,0,1,2,1,0,1,4,2
400915457,Duke Blue Devils,TEAM,TOTAL,TOTAL,False,,25,64,15,31,10,33,15,17,16,20,36,16,6,4,8,18,75
400915457,Duke Blue Devils,A. Jefferson,61586,,True,28.0,3,4,3,4,0,0,8,9,1,3,4,0,1,2,0,1,14
400915457,Duke Blue Devils,J. Tatum,4065648,,True,40.0,8,17,5,10,3,7,0,0,4,9,13,6,1,0,4,2,19
400915457,Duke Blue Devils,L. Kennard,3913174,,True,37.0,8,19,3,10,5,9,2,3,4,3,7,5,0,1,0,4,23
400915457,Duke Blue Devils,G. Allen,3135045,,True,29.0,2,11,1,3,1,8,3,3,0,1,1,1,1,0,2,4,8
400915457,Duke Blue Devils,M. Jones,66563,,True,40.0,1,6,0,1,1,5,0,0,3,2,5,2,2,1,1,2,3
400915457,Duke Blue Devils,H. Giles III,4065649,,False,11.0,3,3,3,3,0,0,0,0,2,2,4,0,0,0,0,1,6
400915457,Duke Blue Devils,F. Jackson,4065651,,False,15.0,0,4,0,0,0,4,2,2,1,0,1,2,1,0,1,4,2
400915457,Duke Blue Devils,TEAM,TOTAL,TOTAL,False,,25,64,15,31,10,33,15,17,16,20,36,16,6,4,8,18,75
400915456,NC State Wolfpack,A. Abu,3138158,,True,17.0,3,8,3,8,0,0,0,0,3,7,10,2,0,0,3,4,6
400915456,NC State Wolfpack,M. Rowan,3947151,,True,37.0,4,13,3,5,1,8,0,0,3,2,5,3,1,0,2,4,9
400915456,NC State Wolfpack,M. Johnson,4065699,,True,37.0,1,5,0,2,1,3,2,2,2,2,4,3,0,0,1,1,5
400915456,NC State Wolfpack,D. Smith Jr.,4065697,,True,37.0,6,13,3,6,3,7,3,7,0,3,3,2,3,1,4,3,18
400915456,NC State Wolfpack,T. Henderson,61215,,True,26.0,7,11,4,6,3,5,4,5,2,3,5,0,1,0,1,3,21
400915456,NC State Wolfpack,T. Kapita,4065701,,False,20.0,4,6,4,6,0,0,0,0,2,4,6,0,0,1,1,5,8
400915456,NC State Wolfpack,O. Yurtseven,66768,,False,2.0,0,0,0,0,0,0,0,0,0,1,1,0,0,0,1,0,0
400915456,NC State Wolfpack,T. Dorn,3132359,,False,24.0,2,7,2,6,0,1,0,0,1,5,6,0,0,1,1,2,4
400915456,NC State Wolfpack,TEAM,TOTAL,TOTAL,False,,27,63,19,39,8,24,9,14,13,27,40,10,5,3,14,22,71
400915456,NC State Wolfpack,A. Abu,3138158,,True,17.0,3,8,3,8,0,0,0,0,3,7,10,2,0,0,3,4,6
400915456,NC State Wolfpack,M. Rowan,3947151,,True,37.0,4,13,3,5,1,8,0,0,3,2,5,3,1,0,2,4,9
400915456,NC State Wolfpack,M. Johnson,4065699,,True,37.0,1,5,0,2,1,3,2,2,2,2,4,3,0,0,1,1,5
400915456,NC State Wolfpack,D. Smith Jr.,4065697,,True,37.0,6,13,3,6,3,7,3,7,0,3,3,2,3,1,4,3,18
400915456,NC State Wolfpack,T. Henderson,61215,,True,26.0,7,11,4,6,3,5,4,5,2,3,5,0,1,0,1,3,21
400915456,NC State Wolfpack,T. Kapita,4065701,,False,20.0,4,6,4,6,0,0,0,0,2,4,6,0,0,1,1,5,8
400915456,NC State Wolfpack,O. Yurtseven,66768,,False,2.0,0,0,0,0,0,0,0,0,0,1,1,0,0,0,1,0,0
400915456,NC State Wolfpack,T. Dorn,3132359,,False,24.0,2,7,2,6,0,1,0,0,1,5,6,0,0,1,1,2,4
400915456,NC State Wolfpack,TEAM,TOTAL,TOTAL,False,,27,63,19,39,8,24,9,14,13,27,40,10,5,3,14,22,71
400915456,Georgia Tech Yellow Jackets,Q. Stephens,66128,,True,40.0,3,7,2,4,1,3,4,5,1,9,10,3,2,1,2,1,11
400915456,Georgia Tech Yellow Jackets,B. Lammers,3135061,,True,39.0,1,9,1,9,0,0,4,8,3,6,9,2,2,4,3,1,6
400915456,Georgia Tech Yellow Jackets,J. Okogie,4065663,,True,35.0,11,17,10,15,1,2,2,3,1,3,4,0,1,2,3,3,25
400915456,Georgia Tech Yellow Jackets,J. Heath,67623,,True,35.0,2,3,2,3,0,0,1,2,1,0,1,6,2,0,3,4,5
400915456,Georgia Tech Yellow Jackets,C. Heyward,61609,,True,9.0,1,2,1,2,0,0,1,2,0,0,0,0,1,1,0,3,3
400915456,Georgia Tech Yellow Jackets,S. Ogbonda,3904627,,False,1.0,0,0,0,0,0,0,0,0,0,0,0,0,0,0,0,0,0
400915456,Georgia Tech Yellow Jackets,J. Moore,4065662,,False,9.0,1,1,1,1,0,0,0,0,0,2,2,1,0,0,0,0,2
400915456,Georgia Tech Yellow Jackets,T. Jackson,3135057,,False,32.0,7,19,5,13,2,6,1,2,0,0,0,1,0,0,0,1,17
400915456,Georgia Tech Yellow Jackets,TEAM,TOTAL,TOTAL,False,,26,58,22,47,4,11,13,22,7,21,28,13,8,8,11,13,69
400915456,Georgia Tech Yellow Jackets,Q. Stephens,66128,,True,40.0,3,7,2,4,1,3,4,5,1,9,10,3,2,1,2,1,11
400915456,Georgia Tech Yellow Jackets,B. Lammers,3135061,,True,39.0,1,9,1,9,0,0,4,8,3,6,9,2,2,4,3,1,6
400915456,Georgia Tech Yellow Jackets,J. Okogie,4065663,,True,35.0,11,17,10,15,1,2,2,3,1,3,4,0,1,2,3,3,25
400915456,Georgia Tech Yellow Jackets,J. Heath,67623,,True,35.0,2,3,2,3,0,0,1,2,1,0,1,6,2,0,3,4,5
400915456,Georgia Tech Yellow Jackets,C. Heyward,61609,,True,9.0,1,2,1,2,0,0,1,2,0,0,0,0,1,1,0,3,3
400915456,Georgia Tech Yellow Jackets,S. Ogbonda,3904627,,False,1.0,0,0,0,0,0,0,0,0,0,0,0,0,0,0,0,0,0
400915456,Georgia Tech Yellow Jackets,J. Moore,4065662,,False,9.0,1,1,1,1,0,0,0,0,0,2,2,1,0,0,0,0,2
400915456,Georgia Tech Yellow Jackets,T. Jackson,3135057,,False,32.0,7,19,5,13,2,6,1,2,0,0,0,1,0,0,0,1,17
400915456,Georgia Tech Yellow Jackets,TEAM,TOTAL,TOTAL,False,,26,58,22,47,4,11,13,22,7,21,28,13,8,8,11,13,69
400915455,Virginia Tech Hokies,K. Sy,4065740,,True,7.0,1,3,1,3,0,0,0,0,0,1,1,0,0,1,1,1,2
400915455,Virginia Tech Hokies,J. Robinson,3945566,,True,34.0,3,7,2,4,1,3,3,3,1,3,4,8,0,1,3,1,10
400915455,Virginia Tech Hokies,A. Hill,3147501,,True,34.0,5,6,3,4,2,2,0,0,0,2,2,1,0,0,1,1,12
400915455,Virginia Tech Hokies,J. Bibbs,3147500,,True,37.0,4,10,0,3,4,7,0,0,0,2,2,5,0,0,0,1,12
400915455,Virginia Tech Hokies,T. Outlaw,67275,,True,36.0,3,7,1,2,2,5,0,0,1,1,2,1,2,0,0,3,8
400915455,Virginia Tech Hokies,Z. LeDay,61698,,False,33.0,7,15,6,13,1,2,4,5,2,6,8,0,0,3,1,3,19
400915455,Virginia Tech Hokies,S. Allen,61795,,False,19.0,3,5,1,2,2,3,0,0,0,3,3,2,0,0,3,3,8
400915455,Virginia Tech Hokies,TEAM,TOTAL,TOTAL,False,,26,53,14,31,12,22,7,8,6,20,26,17,2,5,9,13,71
400915455,Virginia Tech Hokies,K. Sy,4065740,,True,7.0,1,3,1,3,0,0,0,0,0,1,1,0,0,1,1,1,2
400915455,Virginia Tech Hokies,J. Robinson,3945566,,True,34.0,3,7,2,4,1,3,3,3,1,3,4,8,0,1,3,1,10
400915455,Virginia Tech Hokies,A. Hill,3147501,,True,34.0,5,6,3,4,2,2,0,0,0,2,2,1,0,0,1,1,12
400915455,Virginia Tech Hokies,J. Bibbs,3147500,,True,37.0,4,10,0,3,4,7,0,0,0,2,2,5,0,0,0,1,12
400915455,Virginia Tech Hokies,T. Outlaw,67275,,True,36.0,3,7,1,2,2,5,0,0,1,1,2,1,2,0,0,3,8
400915455,Virginia Tech Hokies,Z. LeDay,61698,,False,33.0,7,15,6,13,1,2,4,5,2,6,8,0,0,3,1,3,19
400915455,Virginia Tech Hokies,S. Allen,61795,,False,19.0,3,5,1,2,2,3,0,0,0,3,3,2,0,0,3,3,8
400915455,Virginia Tech Hokies,TEAM,TOTAL,TOTAL,False,,26,53,14,31,12,22,7,8,6,20,26,17,2,5,9,13,71
400915455,Clemson Tigers,E. Thomas,3947075,,True,21.0,6,10,6,10,0,0,0,0,5,4,9,0,0,0,0,3,12
400915455,Clemson Tigers,J. Blossomgame,61835,,True,36.0,4,15,3,13,1,2,4,5,4,6,10,1,1,1,1,0,13
400915455,Clemson Tigers,S. Mitchell,3136699,,True,28.0,6,10,4,7,2,3,0,0,0,2,2,4,1,0,2,2,14
400915455,Clemson Tigers,G. DeVoe,3129673,,True,28.0,0,7,0,3,0,4,0,0,1,1,2,1,2,0,0,0,0
400915455,Clemson Tigers,A. Holmes,62043,,True,15.0,3,5,2,4,1,1,1,1,1,2,3,0,1,0,1,2,8
400915455,Clemson Tigers,D. Grantham,3129674,,False,20.0,1,3,0,2,1,1,0,0,0,1,1,0,0,0,2,0,3
400915455,Clemson Tigers,S. Djitte,66122,,False,19.0,0,1,0,1,0,0,2,2,4,1,5,0,0,1,4,4,2
400915455,Clemson Tigers,M. Reed,3133969,,False,33.0,6,12,2,6,4,6,2,2,0,2,2,3,0,0,0,2,18
400915455,Clemson Tigers,TEAM,TOTAL,TOTAL,False,,26,63,17,46,9,17,9,10,15,21,36,9,5,2,10,13,70
400915455,Clemson Tigers,E. Thomas,3947075,,True,21.0,6,10,6,10,0,0,0,0,5,4,9,0,0,0,0,3,12
400915455,Clemson Tigers,J. Blossomgame,61835,,True,36.0,4,15,3,13,1,2,4,5,4,6,10,1,1,1,1,0,13
400915455,Clemson Tigers,S. Mitchell,3136699,,True,28.0,6,10,4,7,2,3,0,0,0,2,2,4,1,0,2,2,14
400915455,Clemson Tigers,G. DeVoe,3129673,,True,28.0,0,7,0,3,0,4,0,0,1,1,2,1,2,0,0,0,0
400915455,Clemson Tigers,A. Holmes,62043,,True,15.0,3,5,2,4,1,1,1,1,1,2,3,0,1,0,1,2,8
400915455,Clemson Tigers,D. Grantham,3129674,,False,20.0,1,3,0,2,1,1,0,0,0,1,1,0,0,0,2,0,3
400915455,Clemson Tigers,S. Djitte,66122,,False,19.0,0,1,0,1,0,0,2,2,4,1,5,0,0,1,4,4,2
400915455,Clemson Tigers,M. Reed,3133969,,False,33.0,6,12,2,6,4,6,2,2,0,2,2,3,0,0,0,2,18
400915455,Clemson Tigers,TEAM,TOTAL,TOTAL,False,,26,63,17,46,9,17,9,10,15,21,36,9,5,2,10,13,70
400915454,Florida State Seminoles,J. Isaac,4065654,,True,23.0,6,10,5,8,1,2,1,1,0,4,4,2,1,2,1,2,14
400915454,Florida State Seminoles,M. Ojo,61596,,True,11.0,2,3,2,3,0,0,0,0,0,0,0,1,0,0,0,2,4
400915454,Florida State Seminoles,T. Mann,3907823,,True,15.0,2,4,2,4,0,0,0,0,1,2,3,0,1,0,0,2,4
400915454,Florida State Seminoles,D. Bacon,3907821,,True,26.0,6,15,2,8,4,7,0,2,2,3,5,4,0,0,2,0,16
400915454,Florida State Seminoles,X. Rathan-Mayes,66125,,True,24.0,3,4,2,2,1,2,0,0,1,4,5,10,1,0,0,1,7
400915454,Florida State Seminoles,P. Cofer,3135054,,False,10.0,1,2,1,1,0,1,2,2,0,1,1,1,0,1,3,0,4
400915454,Florida State Seminoles,J. Smith,66126,,False,12.0,5,6,5,6,0,0,0,1,2,2,4,1,0,0,1,2,10
400915454,Florida State Seminoles,B. Allen,66124,,False,9.0,1,3,1,1,0,2,2,2,0,1,1,0,0,0,0,1,4
400915454,Florida State Seminoles,C. Koumadje,3907824,,False,16.0,2,4,2,3,0,1,0,0,0,4,4,0,0,0,0,0,4
400915454,Florida State Seminoles,B. Angola-Rodas,4065658,,False,14.0,2,3,0,1,2,2,3,3,0,0,0,4,0,0,0,0,9
400915454,Florida State Seminoles,P. Savoy,4065657,,False,13.0,4,9,1,1,3,8,4,4,0,2,2,1,3,0,0,1,15
400915454,Florida State Seminoles,T. Forrest,4065656,,False,15.0,2,3,2,3,0,0,0,0,0,4,4,1,1,0,1,1,4
400915454,Florida State Seminoles,C. Walker,4065655,,False,12.0,3,6,2,2,1,4,2,2,0,4,4,1,0,0,0,2,9
400915454,Florida State Seminoles,TEAM,TOTAL,TOTAL,False,,39,72,27,43,12,29,14,17,6,32,38,26,7,3,8,14,104
400915454,Florida State Seminoles,J. Isaac,4065654,,True,23.0,6,10,5,8,1,2,1,1,0,4,4,2,1,2,1,2,14
400915454,Florida State Seminoles,M. Ojo,61596,,True,11.0,2,3,2,3,0,0,0,0,0,0,0,1,0,0,0,2,4
400915454,Florida State Seminoles,T. Mann,3907823,,True,15.0,2,4,2,4,0,0,0,0,1,2,3,0,1,0,0,2,4
400915454,Florida State Seminoles,D. Bacon,3907821,,True,26.0,6,15,2,8,4,7,0,2,2,3,5,4,0,0,2,0,16
400915454,Florida State Seminoles,X. Rathan-Mayes,66125,,True,24.0,3,4,2,2,1,2,0,0,1,4,5,10,1,0,0,1,7
400915454,Florida State Seminoles,P. Cofer,3135054,,False,10.0,1,2,1,1,0,1,2,2,0,1,1,1,0,1,3,0,4
400915454,Florida State Seminoles,J. Smith,66126,,False,12.0,5,6,5,6,0,0,0,1,2,2,4,1,0,0,1,2,10
400915454,Florida State Seminoles,B. Allen,66124,,False,9.0,1,3,1,1,0,2,2,2,0,1,1,0,0,0,0,1,4
400915454,Florida State Seminoles,C. Koumadje,3907824,,False,16.0,2,4,2,3,0,1,0,0,0,4,4,0,0,0,0,0,4
400915454,Florida State Seminoles,B. Angola-Rodas,4065658,,False,14.0,2,3,0,1,2,2,3,3,0,0,0,4,0,0,0,0,9
400915454,Florida State Seminoles,P. Savoy,4065657,,False,13.0,4,9,1,1,3,8,4,4,0,2,2,1,3,0,0,1,15
400915454,Florida State Seminoles,T. Forrest,4065656,,False,15.0,2,3,2,3,0,0,0,0,0,4,4,1,1,0,1,1,4
400915454,Florida State Seminoles,C. Walker,4065655,,False,12.0,3,6,2,2,1,4,2,2,0,4,4,1,0,0,0,2,9
400915454,Florida State Seminoles,TEAM,TOTAL,TOTAL,False,,39,72,27,43,12,29,14,17,6,32,38,26,7,3,8,14,104
400915454,Boston College Eagles,N. Popovic,4065637,,True,14.0,2,5,2,4,0,1,0,0,2,3,5,1,1,0,2,2,4
400915454,Boston College Eagles,A.J. Turner,3943608,,True,31.0,5,9,3,4,2,5,1,2,0,1,1,2,0,0,3,2,13
400915454,Boston College Eagles,K. Bowman,4065635,,True,34.0,10,17,8,12,2,5,2,3,4,7,11,3,1,0,3,4,24
400915454,Boston College Eagles,J. Robinson,3943606,,True,34.0,6,19,2,10,4,9,5,6,0,6,6,3,1,1,4,1,21
400915454,Boston College Eagles,J. Chatman,3135095,,True,29.0,3,10,1,3,2,7,0,0,2,1,3,2,0,0,2,2,8
400915454,Boston College Eagles,J. Reyes,3943609,,False,13.0,0,2,0,2,0,0,0,2,1,3,4,1,0,1,0,2,0
400915454,Boston College Eagles,M. Sagay,4065638,,False,7.0,0,2,0,1,0,1,0,0,0,0,0,0,0,0,0,0,0
400915454,Boston College Eagles,E. Meznieks,3943607,,False,3.0,0,1,0,0,0,1,0,0,0,0,0,0,0,0,0,0,0
400915454,Boston College Eagles,G. Owens,66277,,False,12.0,0,2,0,0,0,2,2,2,0,4,4,0,0,0,1,2,2
400915454,Boston College Eagles,M. Jeffers,61901,,False,13.0,0,0,0,0,0,0,0,0,0,0,0,0,1,0,0,1,0
400915454,Boston College Eagles,C. Tava,61446,,False,10.0,0,0,0,0,0,0,0,0,2,2,4,0,0,0,0,0,0
400915454,Boston College Eagles,TEAM,TOTAL,TOTAL,False,,26,67,16,36,10,31,10,15,11,27,38,12,4,2,15,16,72
400915454,Boston College Eagles,N. Popovic,4065637,,True,14.0,2,5,2,4,0,1,0,0,2,3,5,1,1,0,2,2,4
400915454,Boston College Eagles,A.J. Turner,3943608,,True,31.0,5,9,3,4,2,5,1,2,0,1,1,2,0,0,3,2,13
400915454,Boston College Eagles,K. Bowman,4065635,,True,34.0,10,17,8,12,2,5,2,3,4,7,11,3,1,0,3,4,24
400915454,Boston College Eagles,J. Robinson,3943606,,True,34.0,6,19,2,10,4,9,5,6,0,6,6,3,1,1,4,1,21
400915454,Boston College Eagles,J. Chatman,3135095,,True,29.0,3,10,1,3,2,7,0,0,2,1,3,2,0,0,2,2,8
400915454,Boston College Eagles,J. Reyes,3943609,,False,13.0,0,2,0,2,0,0,0,2,1,3,4,1,0,1,0,2,0
400915454,Boston College Eagles,M. Sagay,4065638,,False,7.0,0,2,0,1,0,1,0,0,0,0,0,0,0,0,0,0,0
400915454,Boston College Eagles,E. Meznieks,3943607,,False,3.0,0,1,0,0,0,1,0,0,0,0,0,0,0,0,0,0,0
400915454,Boston College Eagles,G. Owens,66277,,False,12.0,0,2,0,0,0,2,2,2,0,4,4,0,0,0,1,2,2
400915454,Boston College Eagles,M. Jeffers,61901,,False,13.0,0,0,0,0,0,0,0,0,0,0,0,0,1,0,0,1,0
400915454,Boston College Eagles,C. Tava,61446,,False,10.0,0,0,0,0,0,0,0,0,2,2,4,0,0,0,0,0,0
400915454,Boston College Eagles,TEAM,TOTAL,TOTAL,False,,26,67,16,36,10,31,10,15,11,27,38,12,4,2,15,16,72
400915453,Virginia Cavaliers,I. Wilkins,3138203,,True,41.0,3,6,3,6,0,0,4,5,3,7,10,0,4,0,1,4,10
400915453,Virginia Cavaliers,J. Salt,3138200,,True,17.0,0,0,0,0,0,0,2,2,1,3,4,0,0,2,1,1,2
400915453,Virginia Cavaliers,M. Shayok,3138201,,True,27.0,4,11,4,10,0,1,0,0,2,2,4,0,0,0,1,2,8
400915453,Virginia Cavaliers,L. Perrantes,66139,,True,40.0,2,15,2,10,0,5,0,1,1,4,5,2,1,0,2,1,4
400915453,Virginia Cavaliers,D. Hall,66138,,True,39.0,4,8,1,3,3,5,4,6,0,0,0,1,2,0,2,1,15
400915453,Virginia Cavaliers,M. Diakite,3947156,,False,25.0,2,3,2,3,0,0,1,4,2,2,4,0,0,0,0,5,5
400915453,Virginia Cavaliers,J. Reuter,3908374,,False,4.0,0,0,0,0,0,0,0,0,0,0,0,0,0,0,1,1,0
400915453,Virginia Cavaliers,T. Jerome,4065733,,False,11.0,0,1,0,0,0,1,0,0,0,0,0,0,0,0,0,1,0
400915453,Virginia Cavaliers,K. Guy,4065730,,False,2.0,0,0,0,0,0,0,0,0,0,0,0,0,0,0,0,0,0
400915453,Virginia Cavaliers,D. Thompson,66274,,False,19.0,1,7,1,7,0,0,2,2,0,0,0,4,1,0,1,2,4
400915453,Virginia Cavaliers,TEAM,TOTAL,TOTAL,False,,16,51,13,39,3,12,13,20,11,20,31,7,8,2,9,18,48
400915453,Virginia Cavaliers,I. Wilkins,3138203,,True,41.0,3,6,3,6,0,0,4,5,3,7,10,0,4,0,1,4,10
400915453,Virginia Cavaliers,J. Salt,3138200,,True,17.0,0,0,0,0,0,0,2,2,1,3,4,0,0,2,1,1,2
400915453,Virginia Cavaliers,M. Shayok,3138201,,True,27.0,4,11,4,10,0,1,0,0,2,2,4,0,0,0,1,2,8
400915453,Virginia Cavaliers,L. Perrantes,66139,,True,40.0,2,15,2,10,0,5,0,1,1,4,5,2,1,0,2,1,4
400915453,Virginia Cavaliers,D. Hall,66138,,True,39.0,4,8,1,3,3,5,4,6,0,0,0,1,2,0,2,1,15
400915453,Virginia Cavaliers,M. Diakite,3947156,,False,25.0,2,3,2,3,0,0,1,4,2,2,4,0,0,0,0,5,5
400915453,Virginia Cavaliers,J. Reuter,3908374,,False,4.0,0,0,0,0,0,0,0,0,0,0,0,0,0,0,1,1,0
400915453,Virginia Cavaliers,T. Jerome,4065733,,False,11.0,0,1,0,0,0,1,0,0,0,0,0,0,0,0,0,1,0
400915453,Virginia Cavaliers,K. Guy,4065730,,False,2.0,0,0,0,0,0,0,0,0,0,0,0,0,0,0,0,0,0
400915453,Virginia Cavaliers,D. Thompson,66274,,False,19.0,1,7,1,7,0,0,2,2,0,0,0,4,1,0,1,2,4
400915453,Virginia Cavaliers,TEAM,TOTAL,TOTAL,False,,16,51,13,39,3,12,13,20,11,20,31,7,8,2,9,18,48
400915453,Miami Hurricanes,K. Murphy,61668,,True,38.0,5,8,5,8,0,0,0,0,1,10,11,0,0,1,2,4,10
400915453,Miami Hurricanes,E. Izundu,3904629,,True,20.0,3,5,3,5,0,0,0,0,2,1,3,1,0,0,1,3,6
400915453,Miami Hurricanes,A. Lawrence II,3904628,,True,40.0,0,4,0,1,0,3,4,4,0,6,6,5,1,1,2,4,4
400915453,Miami Hurricanes,B. Brown,4065670,,True,44.0,2,7,1,3,1,4,9,10,1,2,3,0,2,1,4,2,14
400915453,Miami Hurricanes,D. Reed,66130,,True,43.0,2,10,1,3,1,7,4,4,1,3,4,3,0,0,5,2,9
400915453,Miami Hurricanes,D. Hernandez,4065672,,False,11.0,0,1,0,1,0,0,1,2,1,0,1,0,0,0,1,2,1
400915453,Miami Hurricanes,D. Vasiljevic,4065669,,False,29.0,3,6,1,1,2,5,2,2,0,4,4,0,1,0,0,1,10
400915453,Miami Hurricanes,TEAM,TOTAL,TOTAL,False,,15,41,11,22,4,19,20,22,6,28,34,9,4,3,15,18,54
400915453,Miami Hurricanes,K. Murphy,61668,,True,38.0,5,8,5,8,0,0,0,0,1,10,11,0,0,1,2,4,10
400915453,Miami Hurricanes,E. Izundu,3904629,,True,20.0,3,5,3,5,0,0,0,0,2,1,3,1,0,0,1,3,6
400915453,Miami Hurricanes,A. Lawrence II,3904628,,True,40.0,0,4,0,1,0,3,4,4,0,6,6,5,1,1,2,4,4
400915453,Miami Hurricanes,B. Brown,4065670,,True,44.0,2,7,1,3,1,4,9,10,1,2,3,0,2,1,4,2,14
400915453,Miami Hurricanes,D. Reed,66130,,True,43.0,2,10,1,3,1,7,4,4,1,3,4,3,0,0,5,2,9
400915453,Miami Hurricanes,D. Hernandez,4065672,,False,11.0,0,1,0,1,0,0,1,2,1,0,1,0,0,0,1,2,1
400915453,Miami Hurricanes,D. Vasiljevic,4065669,,False,29.0,3,6,1,1,2,5,2,2,0,4,4,0,1,0,0,1,10
400915453,Miami Hurricanes,TEAM,TOTAL,TOTAL,False,,15,41,11,22,4,19,20,22,6,28,34,9,4,3,15,18,54
400915452,Syracuse Orange,T. Thompson,4065721,,True,33.0,8,21,8,21,0,0,2,3,8,4,12,1,2,3,0,4,18
400915452,Syracuse Orange,T. Lydon,3934662,,True,40.0,3,11,3,9,0,2,1,2,7,8,15,1,2,2,0,3,7
400915452,Syracuse Orange,T. Battle,4065722,,True,33.0,4,8,2,2,2,6,1,2,0,1,1,4,1,2,3,2,11
400915452,Syracuse Orange,J. Gillon,61915,,True,35.0,2,10,1,3,1,7,2,2,0,0,0,6,0,0,5,3,7
400915452,Syracuse Orange,A. White III,61616,,True,40.0,6,16,2,4,4,12,1,2,1,6,7,0,1,0,2,4,17
400915452,Syracuse Orange,T. Roberson,67633,,False,7.0,0,0,0,0,0,0,0,0,0,2,2,1,0,0,1,4,0
400915452,Syracuse Orange,F. Howard,3934659,,False,12.0,2,4,1,1,1,3,0,1,0,0,0,2,1,0,2,1,5
400915452,Syracuse Orange,TEAM,TOTAL,TOTAL,False,,25,70,17,40,8,30,7,12,19,22,41,15,7,7,13,21,65
400915452,Syracuse Orange,T. Thompson,4065721,,True,33.0,8,21,8,21,0,0,2,3,8,4,12,1,2,3,0,4,18
400915452,Syracuse Orange,T. Lydon,3934662,,True,40.0,3,11,3,9,0,2,1,2,7,8,15,1,2,2,0,3,7
400915452,Syracuse Orange,T. Battle,4065722,,True,33.0,4,8,2,2,2,6,1,2,0,1,1,4,1,2,3,2,11
400915452,Syracuse Orange,J. Gillon,61915,,True,35.0,2,10,1,3,1,7,2,2,0,0,0,6,0,0,5,3,7
400915452,Syracuse Orange,A. White III,61616,,True,40.0,6,16,2,4,4,12,1,2,1,6,7,0,1,0,2,4,17
400915452,Syracuse Orange,T. Roberson,67633,,False,7.0,0,0,0,0,0,0,0,0,0,2,2,1,0,0,1,4,0
400915452,Syracuse Orange,F. Howard,3934659,,False,12.0,2,4,1,1,1,3,0,1,0,0,0,2,1,0,2,1,5
400915452,Syracuse Orange,TEAM,TOTAL,TOTAL,False,,25,70,17,40,8,30,7,12,19,22,41,15,7,7,13,21,65
400915452,Georgia Tech Yellow Jackets,Q. Stephens,66128,,True,40.0,2,7,1,2,1,5,2,2,0,6,6,8,2,0,4,2,7
400915452,Georgia Tech Yellow Jackets,B. Lammers,3135061,,True,40.0,11,18,11,18,0,0,1,2,4,3,7,2,3,7,1,3,23
400915452,Georgia Tech Yellow Jackets,J. Okogie,4065663,,True,38.0,3,9,2,7,1,2,6,8,3,3,6,2,0,0,3,2,13
400915452,Georgia Tech Yellow Jackets,J. Heath,67623,,True,38.0,2,6,2,5,0,1,3,4,1,5,6,5,1,0,2,3,7
400915452,Georgia Tech Yellow Jackets,C. Heyward,61609,,True,13.0,0,0,0,0,0,0,1,2,1,3,4,0,0,0,0,3,1
400915452,Georgia Tech Yellow Jackets,J. Moore,4065662,,False,6.0,0,0,0,0,0,0,0,0,0,0,0,0,0,0,0,1,0
400915452,Georgia Tech Yellow Jackets,T. Jackson,3135057,,False,25.0,8,15,6,11,2,4,2,4,0,3,3,2,1,0,4,2,20
400915452,Georgia Tech Yellow Jackets,TEAM,TOTAL,TOTAL,False,,26,55,22,43,4,12,15,22,11,25,36,19,7,7,15,16,71
400915452,Georgia Tech Yellow Jackets,Q. Stephens,66128,,True,40.0,2,7,1,2,1,5,2,2,0,6,6,8,2,0,4,2,7
400915452,Georgia Tech Yellow Jackets,B. Lammers,3135061,,True,40.0,11,18,11,18,0,0,1,2,4,3,7,2,3,7,1,3,23
400915452,Georgia Tech Yellow Jackets,J. Okogie,4065663,,True,38.0,3,9,2,7,1,2,6,8,3,3,6,2,0,0,3,2,13
400915452,Georgia Tech Yellow Jackets,J. Heath,67623,,True,38.0,2,6,2,5,0,1,3,4,1,5,6,5,1,0,2,3,7
400915452,Georgia Tech Yellow Jackets,C. Heyward,61609,,True,13.0,0,0,0,0,0,0,1,2,1,3,4,0,0,0,0,3,1
400915452,Georgia Tech Yellow Jackets,J. Moore,4065662,,False,6.0,0,0,0,0,0,0,0,0,0,0,0,0,0,0,0,1,0
400915452,Georgia Tech Yellow Jackets,T. Jackson,3135057,,False,25.0,8,15,6,11,2,4,2,4,0,3,3,2,1,0,4,2,20
400915452,Georgia Tech Yellow Jackets,TEAM,TOTAL,TOTAL,False,,26,55,22,43,4,12,15,22,11,25,36,19,7,7,15,16,71
400915451,Virginia Cavaliers,I. Wilkins,3138203,,True,21.0,3,7,3,7,0,0,1,1,2,2,4,0,0,0,0,3,7
400915451,Virginia Cavaliers,J. Salt,3138200,,True,15.0,1,2,1,2,0,0,0,2,1,3,4,0,0,1,0,3,2
400915451,Virginia Cavaliers,M. Shayok,3138201,,True,30.0,6,12,5,10,1,2,0,0,0,1,1,2,0,0,0,3,13
400915451,Virginia Cavaliers,L. Perrantes,66139,,True,30.0,3,10,2,4,1,6,5,5,0,4,4,2,0,0,1,0,12
400915451,Virginia Cavaliers,D. Hall,66138,,True,29.0,0,7,0,3,0,4,0,0,0,6,6,0,0,0,2,1,0
400915451,Virginia Cavaliers,M. Diakite,3947156,,False,21.0,0,0,0,0,0,0,2,2,0,2,2,1,2,3,1,1,2
400915451,Virginia Cavaliers,J. Reuter,3908374,,False,9.0,1,1,1,1,0,0,0,0,0,0,0,1,0,0,1,1,2
400915451,Virginia Cavaliers,T. Jerome,4065733,,False,15.0,0,6,0,3,0,3,0,0,0,2,2,0,0,0,0,1,0
400915451,Virginia Cavaliers,K. Guy,4065730,,False,13.0,0,5,0,2,0,3,0,0,0,0,0,1,0,0,0,0,0
400915451,Virginia Cavaliers,D. Thompson,66274,,False,17.0,1,4,1,2,0,2,1,2,0,0,0,1,0,1,1,1,3
400915451,Virginia Cavaliers,TEAM,TOTAL,TOTAL,False,,15,54,13,34,2,20,9,12,5,21,26,8,2,5,6,14,41
400915451,Virginia Cavaliers,I. Wilkins,3138203,,True,21.0,3,7,3,7,0,0,1,1,2,2,4,0,0,0,0,3,7
400915451,Virginia Cavaliers,J. Salt,3138200,,True,15.0,1,2,1,2,0,0,0,2,1,3,4,0,0,1,0,3,2
400915451,Virginia Cavaliers,M. Shayok,3138201,,True,30.0,6,12,5,10,1,2,0,0,0,1,1,2,0,0,0,3,13
400915451,Virginia Cavaliers,L. Perrantes,66139,,True,30.0,3,10,2,4,1,6,5,5,0,4,4,2,0,0,1,0,12
400915451,Virginia Cavaliers,D. Hall,66138,,True,29.0,0,7,0,3,0,4,0,0,0,6,6,0,0,0,2,1,0
400915451,Virginia Cavaliers,M. Diakite,3947156,,False,21.0,0,0,0,0,0,0,2,2,0,2,2,1,2,3,1,1,2
400915451,Virginia Cavaliers,J. Reuter,3908374,,False,9.0,1,1,1,1,0,0,0,0,0,0,0,1,0,0,1,1,2
400915451,Virginia Cavaliers,T. Jerome,4065733,,False,15.0,0,6,0,3,0,3,0,0,0,2,2,0,0,0,0,1,0
400915451,Virginia Cavaliers,K. Guy,4065730,,False,13.0,0,5,0,2,0,3,0,0,0,0,0,1,0,0,0,0,0
400915451,Virginia Cavaliers,D. Thompson,66274,,False,17.0,1,4,1,2,0,2,1,2,0,0,0,1,0,1,1,1,3
400915451,Virginia Cavaliers,TEAM,TOTAL,TOTAL,False,,15,54,13,34,2,20,9,12,5,21,26,8,2,5,6,14,41
400915451,North Carolina Tar Heels,J. Jackson,3138156,,True,31.0,7,14,3,6,4,8,2,3,1,3,4,6,0,0,2,1,20
400915451,North Carolina Tar Heels,I. Hicks,66874,,True,25.0,5,7,5,7,0,0,0,0,0,8,8,0,0,0,0,3,10
400915451,North Carolina Tar Heels,K. Meeks,66873,,True,25.0,6,10,6,10,0,0,1,1,1,6,7,2,0,3,1,1,13
400915451,North Carolina Tar Heels,T. Pinson,3138154,,True,27.0,4,6,3,3,1,3,0,1,0,1,1,3,1,0,1,3,9
400915451,North Carolina Tar Heels,J. Berry II,3138155,,True,28.0,2,9,1,4,1,5,0,0,1,2,3,3,1,0,3,2,5
400915451,North Carolina Tar Heels,A. Rohlman,4065677,,False,1.0,0,0,0,0,0,0,0,0,0,0,0,0,0,0,0,0,0
400915451,North Carolina Tar Heels,S. Rush,4065674,,False,1.0,0,1,0,1,0,0,0,0,0,0,0,0,0,0,0,0,0
400915451,North Carolina Tar Heels,T. Bradley,4065673,,False,14.0,0,2,0,2,0,0,1,2,1,2,3,0,1,2,0,3,1
400915451,North Carolina Tar Heels,L. Maye,3911620,,False,14.0,2,4,1,3,1,1,0,0,3,4,7,0,0,0,1,0,5
400915451,North Carolina Tar Heels,S. Woods,4065676,,False,11.0,0,0,0,0,0,0,0,0,0,3,3,2,0,0,0,0,0
400915451,North Carolina Tar Heels,B. Robinson,4065675,,False,6.0,0,1,0,0,0,1,0,0,0,1,1,0,0,0,0,0,0
400915451,North Carolina Tar Heels,K. Coker,3947144,,False,1.0,0,0,0,0,0,0,0,0,0,1,1,0,0,0,0,0,0
400915451,North Carolina Tar Heels,N. Britt,66872,,False,14.0,1,4,1,3,0,1,0,0,0,2,2,1,1,0,1,0,2
400915451,North Carolina Tar Heels,S. White,56963,,False,2.0,0,0,0,0,0,0,0,0,0,0,0,0,0,0,0,0,0
400915451,North Carolina Tar Heels,TEAM,TOTAL,TOTAL,False,,27,58,20,39,7,19,4,7,10,34,44,17,4,5,9,13,65
400915451,North Carolina Tar Heels,J. Jackson,3138156,,True,31.0,7,14,3,6,4,8,2,3,1,3,4,6,0,0,2,1,20
400915451,North Carolina Tar Heels,I. Hicks,66874,,True,25.0,5,7,5,7,0,0,0,0,0,8,8,0,0,0,0,3,10
400915451,North Carolina Tar Heels,K. Meeks,66873,,True,25.0,6,10,6,10,0,0,1,1,1,6,7,2,0,3,1,1,13
400915451,North Carolina Tar Heels,T. Pinson,3138154,,True,27.0,4,6,3,3,1,3,0,1,0,1,1,3,1,0,1,3,9
400915451,North Carolina Tar Heels,J. Berry II,3138155,,True,28.0,2,9,1,4,1,5,0,0,1,2,3,3,1,0,3,2,5
400915451,North Carolina Tar Heels,A. Rohlman,4065677,,False,1.0,0,0,0,0,0,0,0,0,0,0,0,0,0,0,0,0,0
400915451,North Carolina Tar Heels,S. Rush,4065674,,False,1.0,0,1,0,1,0,0,0,0,0,0,0,0,0,0,0,0,0
400915451,North Carolina Tar Heels,T. Bradley,4065673,,False,14.0,0,2,0,2,0,0,1,2,1,2,3,0,1,2,0,3,1
400915451,North Carolina Tar Heels,L. Maye,3911620,,False,14.0,2,4,1,3,1,1,0,0,3,4,7,0,0,0,1,0,5
400915451,North Carolina Tar Heels,S. Woods,4065676,,False,11.0,0,0,0,0,0,0,0,0,0,3,3,2,0,0,0,0,0
400915451,North Carolina Tar Heels,B. Robinson,4065675,,False,6.0,0,1,0,0,0,1,0,0,0,1,1,0,0,0,0,0,0
400915451,North Carolina Tar Heels,K. Coker,3947144,,False,1.0,0,0,0,0,0,0,0,0,0,1,1,0,0,0,0,0,0
400915451,North Carolina Tar Heels,N. Britt,66872,,False,14.0,1,4,1,3,0,1,0,0,0,2,2,1,1,0,1,0,2
400915451,North Carolina Tar Heels,S. White,56963,,False,2.0,0,0,0,0,0,0,0,0,0,0,0,0,0,0,0,0,0
400915451,North Carolina Tar Heels,TEAM,TOTAL,TOTAL,False,,27,58,20,39,7,19,4,7,10,34,44,17,4,5,9,13,65
400915450,Pittsburgh Panthers,M. Young,66290,,True,34.0,2,7,2,5,0,2,7,9,1,3,4,6,1,1,2,2,11
400915450,Pittsburgh Panthers,S. Jeter,61756,,True,29.0,12,14,8,9,4,5,1,1,3,5,8,1,1,0,2,4,29
400915450,Pittsburgh Panthers,J. Artis,66287,,True,28.0,5,10,2,5,3,5,3,4,0,2,2,1,0,0,1,2,16
400915450,Pittsburgh Panthers,C. Johnson,3138196,,True,36.0,3,6,1,2,2,4,2,2,0,5,5,2,3,0,0,1,10
400915450,Pittsburgh Panthers,C. Jones,61219,,True,33.0,1,4,1,4,0,0,5,6,0,3,3,3,0,0,1,4,7
400915450,Pittsburgh Panthers,R. Nix,3934653,,False,10.0,1,1,1,1,0,0,0,0,0,2,2,1,0,0,0,2,2
400915450,Pittsburgh Panthers,C. Manigault,4065714,,False,6.0,1,3,1,2,0,1,0,0,1,2,3,0,0,0,0,1,2
400915450,Pittsburgh Panthers,J. Kithcart,4065713,,False,12.0,0,1,0,1,0,0,0,0,1,1,2,0,1,1,1,1,0
400915450,Pittsburgh Panthers,J. Milligan,3934655,,False,6.0,1,3,0,0,1,3,0,0,0,0,0,0,0,0,0,0,3
400915450,Pittsburgh Panthers,Z. Smith,3934654,,False,1.0,0,0,0,0,0,0,0,0,0,0,0,0,0,0,0,0,0
400915450,Pittsburgh Panthers,D. Wilson,3934652,,False,5.0,0,2,0,0,0,2,0,0,0,0,0,0,0,0,0,0,0
400915450,Pittsburgh Panthers,TEAM,TOTAL,TOTAL,False,,26,51,16,29,10,22,18,22,7,23,30,14,6,2,8,17,80
400915450,Pittsburgh Panthers,M. Young,66290,,True,34.0,2,7,2,5,0,2,7,9,1,3,4,6,1,1,2,2,11
400915450,Pittsburgh Panthers,S. Jeter,61756,,True,29.0,12,14,8,9,4,5,1,1,3,5,8,1,1,0,2,4,29
400915450,Pittsburgh Panthers,J. Artis,66287,,True,28.0,5,10,2,5,3,5,3,4,0,2,2,1,0,0,1,2,16
400915450,Pittsburgh Panthers,C. Johnson,3138196,,True,36.0,3,6,1,2,2,4,2,2,0,5,5,2,3,0,0,1,10
400915450,Pittsburgh Panthers,C. Jones,61219,,True,33.0,1,4,1,4,0,0,5,6,0,3,3,3,0,0,1,4,7
400915450,Pittsburgh Panthers,R. Nix,3934653,,False,10.0,1,1,1,1,0,0,0,0,0,2,2,1,0,0,0,2,2
400915450,Pittsburgh Panthers,C. Manigault,4065714,,False,6.0,1,3,1,2,0,1,0,0,1,2,3,0,0,0,0,1,2
400915450,Pittsburgh Panthers,J. Kithcart,4065713,,False,12.0,0,1,0,1,0,0,0,0,1,1,2,0,1,1,1,1,0
400915450,Pittsburgh Panthers,J. Milligan,3934655,,False,6.0,1,3,0,0,1,3,0,0,0,0,0,0,0,0,0,0,3
400915450,Pittsburgh Panthers,Z. Smith,3934654,,False,1.0,0,0,0,0,0,0,0,0,0,0,0,0,0,0,0,0,0
400915450,Pittsburgh Panthers,D. Wilson,3934652,,False,5.0,0,2,0,0,0,2,0,0,0,0,0,0,0,0,0,0,0
400915450,Pittsburgh Panthers,TEAM,TOTAL,TOTAL,False,,26,51,16,29,10,22,18,22,7,23,30,14,6,2,8,17,80
400915450,Florida State Seminoles,J. Isaac,4065654,,True,29.0,4,8,2,4,2,4,1,3,1,5,6,1,1,3,1,3,11
400915450,Florida State Seminoles,M. Ojo,61596,,True,12.0,3,4,3,4,0,0,2,4,2,0,2,0,0,0,1,1,8
400915450,Florida State Seminoles,T. Mann,3907823,,True,25.0,4,8,4,7,0,1,2,2,5,2,7,0,0,0,1,4,10
400915450,Florida State Seminoles,D. Bacon,3907821,,True,20.0,0,4,0,2,0,2,0,0,0,2,2,1,1,0,2,1,0
400915450,Florida State Seminoles,X. Rathan-Mayes,66125,,True,31.0,5,12,3,5,2,7,0,1,0,1,1,6,1,0,1,1,12
400915450,Florida State Seminoles,P. Cofer,3135054,,False,23.0,2,3,2,2,0,1,0,0,0,6,6,1,0,0,0,1,4
400915450,Florida State Seminoles,J. Smith,66126,,False,12.0,2,5,2,5,0,0,0,1,0,2,2,0,0,1,0,2,4
400915450,Florida State Seminoles,C. Koumadje,3907824,,False,2.0,1,1,1,1,0,0,0,0,0,0,0,0,0,0,0,1,2
400915450,Florida State Seminoles,B. Angola-Rodas,4065658,,False,10.0,2,4,1,3,1,1,0,0,0,1,1,0,1,1,0,1,5
400915450,Florida State Seminoles,P. Savoy,4065657,,False,4.0,1,1,1,1,0,0,2,2,0,2,2,0,0,0,0,1,4
400915450,Florida State Seminoles,T. Forrest,4065656,,False,16.0,1,3,1,3,0,0,2,2,0,0,0,2,1,0,2,1,4
400915450,Florida State Seminoles,C. Walker,4065655,,False,16.0,1,4,1,2,0,2,0,0,0,0,0,1,0,0,1,4,2
400915450,Florida State Seminoles,TEAM,TOTAL,TOTAL,False,,26,57,21,39,5,18,9,15,10,21,31,12,5,5,9,21,66
400915450,Florida State Seminoles,J. Isaac,4065654,,True,29.0,4,8,2,4,2,4,1,3,1,5,6,1,1,3,1,3,11
400915450,Florida State Seminoles,M. Ojo,61596,,True,12.0,3,4,3,4,0,0,2,4,2,0,2,0,0,0,1,1,8
400915450,Florida State Seminoles,T. Mann,3907823,,True,25.0,4,8,4,7,0,1,2,2,5,2,7,0,0,0,1,4,10
400915450,Florida State Seminoles,D. Bacon,3907821,,True,20.0,0,4,0,2,0,2,0,0,0,2,2,1,1,0,2,1,0
400915450,Florida State Seminoles,X. Rathan-Mayes,66125,,True,31.0,5,12,3,5,2,7,0,1,0,1,1,6,1,0,1,1,12
400915450,Florida State Seminoles,P. Cofer,3135054,,False,23.0,2,3,2,2,0,1,0,0,0,6,6,1,0,0,0,1,4
400915450,Florida State Seminoles,J. Smith,66126,,False,12.0,2,5,2,5,0,0,0,1,0,2,2,0,0,1,0,2,4
400915450,Florida State Seminoles,C. Koumadje,3907824,,False,2.0,1,1,1,1,0,0,0,0,0,0,0,0,0,0,0,1,2
400915450,Florida State Seminoles,B. Angola-Rodas,4065658,,False,10.0,2,4,1,3,1,1,0,0,0,1,1,0,1,1,0,1,5
400915450,Florida State Seminoles,P. Savoy,4065657,,False,4.0,1,1,1,1,0,0,2,2,0,2,2,0,0,0,0,1,4
400915450,Florida State Seminoles,T. Forrest,4065656,,False,16.0,1,3,1,3,0,0,2,2,0,0,0,2,1,0,2,1,4
400915450,Florida State Seminoles,C. Walker,4065655,,False,16.0,1,4,1,2,0,2,0,0,0,0,0,1,0,0,1,4,2
400915450,Florida State Seminoles,TEAM,TOTAL,TOTAL,False,,26,57,21,39,5,18,9,15,10,21,31,12,5,5,9,21,66
400915449,Virginia Tech Hokies,K. Sy,4065740,,True,11.0,0,1,0,1,0,0,0,0,0,1,1,0,0,0,1,2,0
400915449,Virginia Tech Hokies,T. Outlaw,67275,,True,35.0,7,8,2,2,5,6,0,0,0,7,7,1,0,1,0,2,19
400915449,Virginia Tech Hokies,J. Robinson,3945566,,True,30.0,2,5,1,2,1,3,1,2,0,2,2,4,0,0,1,5,6
400915449,Virginia Tech Hokies,A. Hill,3147501,,True,32.0,4,7,2,3,2,4,1,3,0,3,3,3,0,0,0,1,11
400915449,Virginia Tech Hokies,J. Bibbs,3147500,,True,32.0,4,7,1,2,3,5,0,0,1,1,2,2,0,0,1,0,11
400915449,Virginia Tech Hokies,Z. LeDay,61698,,False,30.0,4,8,4,8,0,0,10,11,4,5,9,3,1,0,3,2,18
400915449,Virginia Tech Hokies,M. Galloway,3945565,,False,2.0,0,0,0,0,0,0,0,0,0,0,0,0,0,0,0,0,0
400915449,Virginia Tech Hokies,S. Allen,61795,,False,28.0,8,13,2,5,6,8,3,3,0,0,0,3,0,0,3,4,25
400915449,Virginia Tech Hokies,TEAM,TOTAL,TOTAL,False,,29,49,12,23,17,26,15,19,6,19,25,16,1,1,9,16,90
400915449,Virginia Tech Hokies,K. Sy,4065740,,True,11.0,0,1,0,1,0,0,0,0,0,1,1,0,0,0,1,2,0
400915449,Virginia Tech Hokies,T. Outlaw,67275,,True,35.0,7,8,2,2,5,6,0,0,0,7,7,1,0,1,0,2,19
400915449,Virginia Tech Hokies,J. Robinson,3945566,,True,30.0,2,5,1,2,1,3,1,2,0,2,2,4,0,0,1,5,6
400915449,Virginia Tech Hokies,A. Hill,3147501,,True,32.0,4,7,2,3,2,4,1,3,0,3,3,3,0,0,0,1,11
400915449,Virginia Tech Hokies,J. Bibbs,3147500,,True,32.0,4,7,1,2,3,5,0,0,1,1,2,2,0,0,1,0,11
400915449,Virginia Tech Hokies,Z. LeDay,61698,,False,30.0,4,8,4,8,0,0,10,11,4,5,9,3,1,0,3,2,18
400915449,Virginia Tech Hokies,M. Galloway,3945565,,False,2.0,0,0,0,0,0,0,0,0,0,0,0,0,0,0,0,0,0
400915449,Virginia Tech Hokies,S. Allen,61795,,False,28.0,8,13,2,5,6,8,3,3,0,0,0,3,0,0,3,4,25
400915449,Virginia Tech Hokies,TEAM,TOTAL,TOTAL,False,,29,49,12,23,17,26,15,19,6,19,25,16,1,1,9,16,90
400915449,Louisville Cardinals,M. Mathiang,63035,,True,26.0,3,7,3,7,0,0,0,0,2,3,5,1,0,1,0,2,6
400915449,Louisville Cardinals,D. Adel,3908807,,True,36.0,4,13,3,9,1,4,0,1,1,3,4,2,1,0,0,2,9
400915449,Louisville Cardinals,J. Johnson,3147362,,True,30.0,6,9,6,9,0,0,4,5,5,3,8,2,0,0,1,2,16
400915449,Louisville Cardinals,D. Mitchell,3908809,,True,38.0,8,13,3,6,5,7,5,6,1,4,5,2,1,0,0,3,26
400915449,Louisville Cardinals,Q. Snider,3147360,,True,31.0,7,12,4,6,3,6,2,2,1,1,2,4,0,0,2,0,19
400915449,Louisville Cardinals,R. Spalding,3908806,,False,9.0,2,4,2,4,0,0,1,1,4,1,5,0,1,2,0,1,5
400915449,Louisville Cardinals,A. Mahmoud,3147363,,False,14.0,1,1,1,1,0,0,0,0,2,1,3,3,2,1,0,3,2
400915449,Louisville Cardinals,R. McMahon,3908808,,False,9.0,3,6,0,2,3,4,0,0,0,1,1,0,0,0,0,1,9
400915449,Louisville Cardinals,J. Henderson,3155491,,False,4.0,1,2,1,1,0,1,0,0,0,0,0,0,0,0,0,1,2
400915449,Louisville Cardinals,D. Levitch,66592,,False,3.0,0,1,0,1,0,0,0,0,0,0,0,1,0,0,0,1,0
400915449,Louisville Cardinals,TEAM,TOTAL,TOTAL,False,,35,68,23,46,12,22,12,15,16,17,33,15,5,4,3,16,94
400915449,Louisville Cardinals,M. Mathiang,63035,,True,26.0,3,7,3,7,0,0,0,0,2,3,5,1,0,1,0,2,6
400915449,Louisville Cardinals,D. Adel,3908807,,True,36.0,4,13,3,9,1,4,0,1,1,3,4,2,1,0,0,2,9
400915449,Louisville Cardinals,J. Johnson,3147362,,True,30.0,6,9,6,9,0,0,4,5,5,3,8,2,0,0,1,2,16
400915449,Louisville Cardinals,D. Mitchell,3908809,,True,38.0,8,13,3,6,5,7,5,6,1,4,5,2,1,0,0,3,26
400915449,Louisville Cardinals,Q. Snider,3147360,,True,31.0,7,12,4,6,3,6,2,2,1,1,2,4,0,0,2,0,19
400915449,Louisville Cardinals,R. Spalding,3908806,,False,9.0,2,4,2,4,0,0,1,1,4,1,5,0,1,2,0,1,5
400915449,Louisville Cardinals,A. Mahmoud,3147363,,False,14.0,1,1,1,1,0,0,0,0,2,1,3,3,2,1,0,3,2
400915449,Louisville Cardinals,R. McMahon,3908808,,False,9.0,3,6,0,2,3,4,0,0,0,1,1,0,0,0,0,1,9
400915449,Louisville Cardinals,J. Henderson,3155491,,False,4.0,1,2,1,1,0,1,0,0,0,0,0,0,0,0,0,1,2
400915449,Louisville Cardinals,D. Levitch,66592,,False,3.0,0,1,0,1,0,0,0,0,0,0,0,1,0,0,0,1,0
400915449,Louisville Cardinals,TEAM,TOTAL,TOTAL,False,,35,68,23,46,12,22,12,15,16,17,33,15,5,4,3,16,94
400915448,Wake Forest Demon Deacons,J. Collins,3908845,,True,33.0,13,18,13,18,0,0,5,6,5,10,15,0,1,0,2,2,31
400915448,Wake Forest Demon Deacons,D. Mitoglou,3138224,,True,24.0,3,7,3,5,0,2,2,2,1,1,2,1,0,0,0,2,8
400915448,Wake Forest Demon Deacons,A. Arians,61378,,True,17.0,1,2,0,1,1,1,2,3,1,0,1,2,0,0,1,4,5
400915448,Wake Forest Demon Deacons,B. Crawford,3908844,,True,38.0,8,19,6,13,2,6,3,4,0,1,1,6,3,0,0,2,21
400915448,Wake Forest Demon Deacons,K. Woods,3132360,,True,31.0,4,7,3,5,1,2,4,4,2,1,3,2,0,0,0,2,13
400915448,Wake Forest Demon Deacons,G. McClinton,66140,,False,6.0,0,1,0,1,0,0,0,0,2,1,3,0,0,0,1,2,0
400915448,Wake Forest Demon Deacons,D. Moore,3908843,,False,7.0,2,4,2,4,0,0,0,0,3,1,4,0,0,1,0,0,4
400915448,Wake Forest Demon Deacons,B. Childress,4065750,,False,31.0,3,10,2,6,1,4,3,4,0,2,2,3,0,0,0,3,10
400915448,Wake Forest Demon Deacons,T. VanHorn,3078214,,False,13.0,1,1,1,1,0,0,0,0,0,1,1,1,0,0,0,3,2
400915448,Wake Forest Demon Deacons,TEAM,TOTAL,TOTAL,False,,35,69,30,54,5,15,19,23,15,18,33,15,4,1,4,20,94
400915448,Wake Forest Demon Deacons,J. Collins,3908845,,True,33.0,13,18,13,18,0,0,5,6,5,10,15,0,1,0,2,2,31
400915448,Wake Forest Demon Deacons,D. Mitoglou,3138224,,True,24.0,3,7,3,5,0,2,2,2,1,1,2,1,0,0,0,2,8
400915448,Wake Forest Demon Deacons,A. Arians,61378,,True,17.0,1,2,0,1,1,1,2,3,1,0,1,2,0,0,1,4,5
400915448,Wake Forest Demon Deacons,B. Crawford,3908844,,True,38.0,8,19,6,13,2,6,3,4,0,1,1,6,3,0,0,2,21
400915448,Wake Forest Demon Deacons,K. Woods,3132360,,True,31.0,4,7,3,5,1,2,4,4,2,1,3,2,0,0,0,2,13
400915448,Wake Forest Demon Deacons,G. McClinton,66140,,False,6.0,0,1,0,1,0,0,0,0,2,1,3,0,0,0,1,2,0
400915448,Wake Forest Demon Deacons,D. Moore,3908843,,False,7.0,2,4,2,4,0,0,0,0,3,1,4,0,0,1,0,0,4
400915448,Wake Forest Demon Deacons,B. Childress,4065750,,False,31.0,3,10,2,6,1,4,3,4,0,2,2,3,0,0,0,3,10
400915448,Wake Forest Demon Deacons,T. VanHorn,3078214,,False,13.0,1,1,1,1,0,0,0,0,0,1,1,1,0,0,0,3,2
400915448,Wake Forest Demon Deacons,TEAM,TOTAL,TOTAL,False,,35,69,30,54,5,15,19,23,15,18,33,15,4,1,4,20,94
400915448,Duke Blue Devils,J. Tatum,4065648,,True,35.0,6,11,3,6,3,5,4,4,1,6,7,2,0,0,1,4,19
400915448,Duke Blue Devils,A. Jefferson,61586,,True,33.0,7,10,7,10,0,0,2,2,3,4,7,2,0,5,0,3,16
400915448,Duke Blue Devils,L. Kennard,3913174,,True,37.0,9,15,6,8,3,7,2,2,2,2,4,3,0,0,1,3,23
400915448,Duke Blue Devils,G. Allen,3135045,,True,28.0,3,8,0,2,3,6,2,3,1,3,4,6,0,0,2,2,11
400915448,Duke Blue Devils,M. Jones,66563,,True,35.0,4,7,2,3,2,4,0,1,1,1,2,2,1,0,1,2,10
400915448,Duke Blue Devils,H. Giles III,4065649,,False,4.0,1,1,1,1,0,0,0,0,0,0,0,0,0,0,1,3,2
400915448,Duke Blue Devils,M. Bolden,4065652,,False,6.0,2,2,2,2,0,0,2,2,0,1,1,1,0,0,1,2,6
400915448,Duke Blue Devils,F. Jackson,4065651,,False,22.0,4,7,2,2,2,5,2,2,1,2,3,3,0,0,0,1,12
400915448,Duke Blue Devils,TEAM,TOTAL,TOTAL,False,,36,61,23,34,13,27,14,16,9,21,30,19,1,5,7,20,99
400915448,Duke Blue Devils,J. Tatum,4065648,,True,35.0,6,11,3,6,3,5,4,4,1,6,7,2,0,0,1,4,19
400915448,Duke Blue Devils,A. Jefferson,61586,,True,33.0,7,10,7,10,0,0,2,2,3,4,7,2,0,5,0,3,16
400915448,Duke Blue Devils,L. Kennard,3913174,,True,37.0,9,15,6,8,3,7,2,2,2,2,4,3,0,0,1,3,23
400915448,Duke Blue Devils,G. Allen,3135045,,True,28.0,3,8,0,2,3,6,2,3,1,3,4,6,0,0,2,2,11
400915448,Duke Blue Devils,M. Jones,66563,,True,35.0,4,7,2,3,2,4,0,1,1,1,2,2,1,0,1,2,10
400915448,Duke Blue Devils,H. Giles III,4065649,,False,4.0,1,1,1,1,0,0,0,0,0,0,0,0,0,0,1,3,2
400915448,Duke Blue Devils,M. Bolden,4065652,,False,6.0,2,2,2,2,0,0,2,2,0,1,1,1,0,0,1,2,6
400915448,Duke Blue Devils,F. Jackson,4065651,,False,22.0,4,7,2,2,2,5,2,2,1,2,3,3,0,0,0,1,12
400915448,Duke Blue Devils,TEAM,TOTAL,TOTAL,False,,36,61,23,34,13,27,14,16,9,21,30,19,1,5,7,20,99
400915447,Notre Dame Fighting Irish,B. Colson,3138192,,True,30.0,6,10,6,10,0,0,1,1,1,6,7,1,1,0,0,2,13
400915447,Notre Dame Fighting Irish,V.J. Beachem,66283,,True,38.0,10,16,3,4,7,12,0,0,1,1,2,0,0,3,1,2,27
400915447,Notre Dame Fighting Irish,R. Pflueger,3908335,,True,20.0,1,3,1,2,0,1,0,0,0,3,3,2,1,0,3,0,2
400915447,Notre Dame Fighting Irish,M. Farrell,3138190,,True,39.0,2,8,0,1,2,7,5,7,0,0,0,8,3,0,3,2,11
400915447,Notre Dame Fighting Irish,S. Vasturia,66285,,True,35.0,3,8,2,4,1,4,4,4,1,4,5,2,4,0,1,2,11
400915447,Notre Dame Fighting Irish,A. Torres,66286,,False,10.0,2,2,2,2,0,0,0,0,1,1,2,0,0,0,0,1,4
400915447,Notre Dame Fighting Irish,M. Ryan,3908336,,False,9.0,2,4,0,0,2,4,0,0,0,2,2,1,0,0,0,1,6
400915447,Notre Dame Fighting Irish,T. Gibbs,4065703,,False,19.0,3,7,2,5,1,2,0,0,1,1,2,3,2,0,1,2,7
400915447,Notre Dame Fighting Irish,TEAM,TOTAL,TOTAL,False,,29,58,16,28,13,30,10,12,8,20,28,17,11,3,9,12,81
400915447,Notre Dame Fighting Irish,B. Colson,3138192,,True,30.0,6,10,6,10,0,0,1,1,1,6,7,1,1,0,0,2,13
400915447,Notre Dame Fighting Irish,V.J. Beachem,66283,,True,38.0,10,16,3,4,7,12,0,0,1,1,2,0,0,3,1,2,27
400915447,Notre Dame Fighting Irish,R. Pflueger,3908335,,True,20.0,1,3,1,2,0,1,0,0,0,3,3,2,1,0,3,0,2
400915447,Notre Dame Fighting Irish,M. Farrell,3138190,,True,39.0,2,8,0,1,2,7,5,7,0,0,0,8,3,0,3,2,11
400915447,Notre Dame Fighting Irish,S. Vasturia,66285,,True,35.0,3,8,2,4,1,4,4,4,1,4,5,2,4,0,1,2,11
400915447,Notre Dame Fighting Irish,A. Torres,66286,,False,10.0,2,2,2,2,0,0,0,0,1,1,2,0,0,0,0,1,4
400915447,Notre Dame Fighting Irish,M. Ryan,3908336,,False,9.0,2,4,0,0,2,4,0,0,0,2,2,1,0,0,0,1,6
400915447,Notre Dame Fighting Irish,T. Gibbs,4065703,,False,19.0,3,7,2,5,1,2,0,0,1,1,2,3,2,0,1,2,7
400915447,Notre Dame Fighting Irish,TEAM,TOTAL,TOTAL,False,,29,58,16,28,13,30,10,12,8,20,28,17,11,3,9,12,81
400915447,NC State Wolfpack,A. Abu,3138158,,True,24.0,2,7,2,7,0,0,0,0,1,5,6,1,1,0,0,4,4
400915447,NC State Wolfpack,D. Smith Jr.,4065697,,True,37.0,7,14,7,11,0,3,2,2,2,1,3,3,0,1,4,3,16
400915447,NC State Wolfpack,M. Rowan,3947151,,True,38.0,6,10,5,6,1,4,2,3,2,2,4,0,3,0,1,0,15
400915447,NC State Wolfpack,T. Dorn,3132359,,True,14.0,1,4,1,3,0,1,1,2,1,3,4,1,1,0,2,1,3
400915447,NC State Wolfpack,T. Henderson,61215,,True,27.0,2,6,0,2,2,4,3,4,1,4,5,2,1,0,1,2,9
400915447,NC State Wolfpack,T. Kapita,4065701,,False,4.0,1,1,1,1,0,0,0,0,1,1,2,0,0,1,1,0,2
400915447,NC State Wolfpack,D. Hicks,4065698,,False,9.0,1,2,1,2,0,0,1,2,2,0,2,0,0,1,1,2,3
400915447,NC State Wolfpack,O. Yurtseven,66768,,False,12.0,4,5,4,5,0,0,0,0,0,1,1,0,0,0,1,0,8
400915447,NC State Wolfpack,M. Johnson,4065699,,False,35.0,6,9,6,7,0,2,0,0,0,3,3,5,1,0,1,2,12
400915447,NC State Wolfpack,TEAM,TOTAL,TOTAL,False,,30,58,27,44,3,14,9,13,10,23,33,12,7,3,12,14,72
400915447,NC State Wolfpack,A. Abu,3138158,,True,24.0,2,7,2,7,0,0,0,0,1,5,6,1,1,0,0,4,4
400915447,NC State Wolfpack,D. Smith Jr.,4065697,,True,37.0,7,14,7,11,0,3,2,2,2,1,3,3,0,1,4,3,16
400915447,NC State Wolfpack,M. Rowan,3947151,,True,38.0,6,10,5,6,1,4,2,3,2,2,4,0,3,0,1,0,15
400915447,NC State Wolfpack,T. Dorn,3132359,,True,14.0,1,4,1,3,0,1,1,2,1,3,4,1,1,0,2,1,3
400915447,NC State Wolfpack,T. Henderson,61215,,True,27.0,2,6,0,2,2,4,3,4,1,4,5,2,1,0,1,2,9
400915447,NC State Wolfpack,T. Kapita,4065701,,False,4.0,1,1,1,1,0,0,0,0,1,1,2,0,0,1,1,0,2
400915447,NC State Wolfpack,D. Hicks,4065698,,False,9.0,1,2,1,2,0,0,1,2,2,0,2,0,0,1,1,2,3
400915447,NC State Wolfpack,O. Yurtseven,66768,,False,12.0,4,5,4,5,0,0,0,0,0,1,1,0,0,0,1,0,8
400915447,NC State Wolfpack,M. Johnson,4065699,,False,35.0,6,9,6,7,0,2,0,0,0,3,3,5,1,0,1,2,12
400915447,NC State Wolfpack,TEAM,TOTAL,TOTAL,False,,30,58,27,44,3,14,9,13,10,23,33,12,7,3,12,14,72
400915446,Miami Hurricanes,K. Murphy,61668,,True,35.0,7,9,7,9,0,0,1,1,2,7,9,2,1,1,0,3,15
400915446,Miami Hurricanes,E. Izundu,3904629,,True,25.0,5,10,5,10,0,0,2,4,1,1,2,1,1,0,1,3,12
400915446,Miami Hurricanes,B. Brown,4065670,,True,29.0,4,8,3,5,1,3,0,0,2,3,5,5,0,0,2,3,9
400915446,Miami Hurricanes,A. Lawrence II,3904628,,True,37.0,4,9,2,4,2,5,0,1,1,3,4,5,3,0,0,0,10
400915446,Miami Hurricanes,D. Reed,66130,,True,36.0,4,11,2,4,2,7,4,4,1,6,7,5,1,1,1,2,14
400915446,Miami Hurricanes,D. Hernandez,4065672,,False,17.0,2,4,2,4,0,0,2,3,1,0,1,0,0,1,1,2,6
400915446,Miami Hurricanes,D. Vasiljevic,4065669,,False,21.0,2,5,1,1,1,4,0,0,0,3,3,1,0,0,2,0,5
400915446,Miami Hurricanes,TEAM,TOTAL,TOTAL,False,,28,56,22,37,6,19,9,13,9,23,32,19,6,3,7,13,71
400915446,Miami Hurricanes,K. Murphy,61668,,True,35.0,7,9,7,9,0,0,1,1,2,7,9,2,1,1,0,3,15
400915446,Miami Hurricanes,E. Izundu,3904629,,True,25.0,5,10,5,10,0,0,2,4,1,1,2,1,1,0,1,3,12
400915446,Miami Hurricanes,B. Brown,4065670,,True,29.0,4,8,3,5,1,3,0,0,2,3,5,5,0,0,2,3,9
400915446,Miami Hurricanes,A. Lawrence II,3904628,,True,37.0,4,9,2,4,2,5,0,1,1,3,4,5,3,0,0,0,10
400915446,Miami Hurricanes,D. Reed,66130,,True,36.0,4,11,2,4,2,7,4,4,1,6,7,5,1,1,1,2,14
400915446,Miami Hurricanes,D. Hernandez,4065672,,False,17.0,2,4,2,4,0,0,2,3,1,0,1,0,0,1,1,2,6
400915446,Miami Hurricanes,D. Vasiljevic,4065669,,False,21.0,2,5,1,1,1,4,0,0,0,3,3,1,0,0,2,0,5
400915446,Miami Hurricanes,TEAM,TOTAL,TOTAL,False,,28,56,22,37,6,19,9,13,9,23,32,19,6,3,7,13,71
400915446,Clemson Tigers,E. Thomas,3947075,,True,24.0,5,8,5,8,0,0,2,5,5,6,11,1,1,0,0,2,12
400915446,Clemson Tigers,D. Grantham,3129674,,True,20.0,0,3,0,1,0,2,0,0,2,1,3,0,0,1,0,0,0
400915446,Clemson Tigers,J. Blossomgame,61835,,True,36.0,7,15,7,10,0,5,2,5,2,6,8,0,0,0,3,4,16
400915446,Clemson Tigers,S. Mitchell,3136699,,True,29.0,4,7,4,7,0,0,2,2,0,1,1,3,0,0,1,2,10
400915446,Clemson Tigers,A. Holmes,62043,,True,21.0,3,5,1,3,2,2,0,0,0,0,0,0,1,0,1,1,8
400915446,Clemson Tigers,S. Djitte,66122,,False,15.0,2,3,2,3,0,0,0,0,1,4,5,0,0,0,0,1,4
400915446,Clemson Tigers,M. Reed,3133969,,False,30.0,6,13,5,9,1,4,2,3,0,0,0,2,1,0,0,2,15
400915446,Clemson Tigers,G. DeVoe,3129673,,False,25.0,0,5,0,1,0,4,0,0,1,2,3,2,0,0,2,1,0
400915446,Clemson Tigers,TEAM,TOTAL,TOTAL,False,,27,59,24,42,3,17,8,15,13,23,36,8,3,1,7,13,65
400915446,Clemson Tigers,E. Thomas,3947075,,True,24.0,5,8,5,8,0,0,2,5,5,6,11,1,1,0,0,2,12
400915446,Clemson Tigers,D. Grantham,3129674,,True,20.0,0,3,0,1,0,2,0,0,2,1,3,0,0,1,0,0,0
400915446,Clemson Tigers,J. Blossomgame,61835,,True,36.0,7,15,7,10,0,5,2,5,2,6,8,0,0,0,3,4,16
400915446,Clemson Tigers,S. Mitchell,3136699,,True,29.0,4,7,4,7,0,0,2,2,0,1,1,3,0,0,1,2,10
400915446,Clemson Tigers,A. Holmes,62043,,True,21.0,3,5,1,3,2,2,0,0,0,0,0,0,1,0,1,1,8
400915446,Clemson Tigers,S. Djitte,66122,,False,15.0,2,3,2,3,0,0,0,0,1,4,5,0,0,0,0,1,4
400915446,Clemson Tigers,M. Reed,3133969,,False,30.0,6,13,5,9,1,4,2,3,0,0,0,2,1,0,0,2,15
400915446,Clemson Tigers,G. DeVoe,3129673,,False,25.0,0,5,0,1,0,4,0,0,1,2,3,2,0,0,2,1,0
400915446,Clemson Tigers,TEAM,TOTAL,TOTAL,False,,27,59,24,42,3,17,8,15,13,23,36,8,3,1,7,13,65
400915445,Virginia Cavaliers,I. Wilkins,3138203,,True,35.0,1,5,1,5,0,0,2,2,4,5,9,0,0,0,1,5,4
400915445,Virginia Cavaliers,J. Salt,3138200,,True,17.0,2,2,2,2,0,0,0,0,1,4,5,1,0,0,0,2,4
400915445,Virginia Cavaliers,M. Shayok,3138201,,True,33.0,3,11,2,7,1,4,0,0,1,1,2,2,1,0,1,3,7
400915445,Virginia Cavaliers,L. Perrantes,66139,,True,34.0,4,11,3,6,1,5,5,5,0,4,4,2,1,0,3,2,14
400915445,Virginia Cavaliers,D. Hall,66138,,True,23.0,4,10,4,8,0,2,0,0,1,2,3,1,0,0,2,5,8
400915445,Virginia Cavaliers,M. Diakite,3947156,,False,17.0,0,1,0,0,0,1,0,0,3,3,6,1,1,3,0,1,0
400915445,Virginia Cavaliers,J. Reuter,3908374,,False,5.0,1,1,1,1,0,0,0,0,0,0,0,0,0,0,0,0,2
400915445,Virginia Cavaliers,T. Jerome,4065733,,False,19.0,5,8,3,4,2,4,1,1,0,1,1,1,0,0,1,1,13
400915445,Virginia Cavaliers,K. Guy,4065730,,False,11.0,1,5,0,3,1,2,0,0,0,0,0,1,0,0,0,2,3
400915445,Virginia Cavaliers,D. Thompson,66274,,False,6.0,0,3,0,1,0,2,0,0,0,0,0,0,0,0,0,0,0
400915445,Virginia Cavaliers,TEAM,TOTAL,TOTAL,False,,21,57,16,37,5,20,8,8,12,20,32,9,3,3,9,21,55
400915445,Virginia Cavaliers,I. Wilkins,3138203,,True,35.0,1,5,1,5,0,0,2,2,4,5,9,0,0,0,1,5,4
400915445,Virginia Cavaliers,J. Salt,3138200,,True,17.0,2,2,2,2,0,0,0,0,1,4,5,1,0,0,0,2,4
400915445,Virginia Cavaliers,M. Shayok,3138201,,True,33.0,3,11,2,7,1,4,0,0,1,1,2,2,1,0,1,3,7
400915445,Virginia Cavaliers,L. Perrantes,66139,,True,34.0,4,11,3,6,1,5,5,5,0,4,4,2,1,0,3,2,14
400915445,Virginia Cavaliers,D. Hall,66138,,True,23.0,4,10,4,8,0,2,0,0,1,2,3,1,0,0,2,5,8
400915445,Virginia Cavaliers,M. Diakite,3947156,,False,17.0,0,1,0,0,0,1,0,0,3,3,6,1,1,3,0,1,0
400915445,Virginia Cavaliers,J. Reuter,3908374,,False,5.0,1,1,1,1,0,0,0,0,0,0,0,0,0,0,0,0,2
400915445,Virginia Cavaliers,T. Jerome,4065733,,False,19.0,5,8,3,4,2,4,1,1,0,1,1,1,0,0,1,1,13
400915445,Virginia Cavaliers,K. Guy,4065730,,False,11.0,1,5,0,3,1,2,0,0,0,0,0,1,0,0,0,2,3
400915445,Virginia Cavaliers,D. Thompson,66274,,False,6.0,0,3,0,1,0,2,0,0,0,0,0,0,0,0,0,0,0
400915445,Virginia Cavaliers,TEAM,TOTAL,TOTAL,False,,21,57,16,37,5,20,8,8,12,20,32,9,3,3,9,21,55
400915445,Duke Blue Devils,J. Tatum,4065648,,True,36.0,8,13,2,6,6,7,6,6,0,8,8,0,1,1,3,1,28
400915445,Duke Blue Devils,A. Jefferson,61586,,True,21.0,2,2,2,2,0,0,0,0,3,2,5,1,0,0,1,4,4
400915445,Duke Blue Devils,L. Kennard,3913174,,True,40.0,3,9,2,6,1,3,9,10,0,7,7,3,0,0,2,0,16
400915445,Duke Blue Devils,G. Allen,3135045,,True,33.0,2,10,1,4,1,6,0,0,0,1,1,2,0,0,1,2,5
400915445,Duke Blue Devils,M. Jones,66563,,True,36.0,2,3,1,2,1,1,0,0,1,3,4,0,1,0,1,3,5
400915445,Duke Blue Devils,H. Giles III,4065649,,False,19.0,2,2,2,2,0,0,1,2,1,2,3,1,2,0,2,1,5
400915445,Duke Blue Devils,M. Bolden,4065652,,False,2.0,0,1,0,1,0,0,0,0,0,0,0,0,0,1,0,1,0
400915445,Duke Blue Devils,F. Jackson,4065651,,False,13.0,0,2,0,0,0,2,2,2,0,0,0,1,0,0,0,0,2
400915445,Duke Blue Devils,TEAM,TOTAL,TOTAL,False,,19,42,10,23,9,19,18,20,5,23,28,8,4,2,11,12,65
400915445,Duke Blue Devils,J. Tatum,4065648,,True,36.0,8,13,2,6,6,7,6,6,0,8,8,0,1,1,3,1,28
400915445,Duke Blue Devils,A. Jefferson,61586,,True,21.0,2,2,2,2,0,0,0,0,3,2,5,1,0,0,1,4,4
400915445,Duke Blue Devils,L. Kennard,3913174,,True,40.0,3,9,2,6,1,3,9,10,0,7,7,3,0,0,2,0,16
400915445,Duke Blue Devils,G. Allen,3135045,,True,33.0,2,10,1,4,1,6,0,0,0,1,1,2,0,0,1,2,5
400915445,Duke Blue Devils,M. Jones,66563,,True,36.0,2,3,1,2,1,1,0,0,1,3,4,0,1,0,1,3,5
400915445,Duke Blue Devils,H. Giles III,4065649,,False,19.0,2,2,2,2,0,0,1,2,1,2,3,1,2,0,2,1,5
400915445,Duke Blue Devils,M. Bolden,4065652,,False,2.0,0,1,0,1,0,0,0,0,0,0,0,0,0,1,0,1,0
400915445,Duke Blue Devils,F. Jackson,4065651,,False,13.0,0,2,0,0,0,2,2,2,0,0,0,1,0,0,0,0,2
400915445,Duke Blue Devils,TEAM,TOTAL,TOTAL,False,,19,42,10,23,9,19,18,20,5,23,28,8,4,2,11,12,65
400915444,North Carolina Tar Heels,J. Jackson,3138156,,True,31.0,6,16,4,8,2,8,0,0,2,1,3,2,1,0,1,0,14
400915444,North Carolina Tar Heels,T. Pinson,3138154,,True,24.0,6,8,6,7,0,1,0,0,0,2,2,4,1,0,2,2,12
400915444,North Carolina Tar Heels,I. Hicks,66874,,True,7.0,3,4,3,4,0,0,1,1,1,0,1,0,0,0,0,4,7
400915444,North Carolina Tar Heels,K. Meeks,66873,,True,25.0,8,12,8,12,0,0,1,3,2,6,8,3,0,0,2,2,17
400915444,North Carolina Tar Heels,J. Berry II,3138155,,True,31.0,7,11,3,3,4,8,0,0,1,2,3,6,3,0,1,1,18
400915444,North Carolina Tar Heels,A. Rohlman,4065677,,False,2.0,0,0,0,0,0,0,0,0,0,0,0,0,0,0,0,0,0
400915444,North Carolina Tar Heels,S. Rush,4065674,,False,2.0,0,0,0,0,0,0,0,0,0,0,0,0,0,0,1,1,0
400915444,North Carolina Tar Heels,T. Bradley,4065673,,False,17.0,2,4,2,4,0,0,4,4,3,2,5,1,0,1,0,3,8
400915444,North Carolina Tar Heels,L. Maye,3911620,,False,23.0,6,11,5,8,1,3,0,0,4,3,7,0,0,0,0,2,13
400915444,North Carolina Tar Heels,S. Woods,4065676,,False,10.0,2,3,2,3,0,0,0,0,0,1,1,2,0,0,2,1,4
400915444,North Carolina Tar Heels,B. Robinson,4065675,,False,6.0,0,1,0,0,0,1,0,0,0,1,1,0,0,0,1,1,0
400915444,North Carolina Tar Heels,K. Coker,3947144,,False,2.0,0,0,0,0,0,0,0,0,0,0,0,0,1,0,0,0,0
400915444,North Carolina Tar Heels,N. Britt,66872,,False,17.0,2,5,2,3,0,2,0,0,0,4,4,1,0,0,1,1,4
400915444,North Carolina Tar Heels,S. White,56963,,False,3.0,0,0,0,0,0,0,0,0,1,0,1,0,0,0,0,0,0
400915444,North Carolina Tar Heels,TEAM,TOTAL,TOTAL,False,,42,75,35,52,7,23,6,8,18,23,41,19,6,1,11,18,97
400915444,North Carolina Tar Heels,J. Jackson,3138156,,True,31.0,6,16,4,8,2,8,0,0,2,1,3,2,1,0,1,0,14
400915444,North Carolina Tar Heels,T. Pinson,3138154,,True,24.0,6,8,6,7,0,1,0,0,0,2,2,4,1,0,2,2,12
400915444,North Carolina Tar Heels,I. Hicks,66874,,True,7.0,3,4,3,4,0,0,1,1,1,0,1,0,0,0,0,4,7
400915444,North Carolina Tar Heels,K. Meeks,66873,,True,25.0,8,12,8,12,0,0,1,3,2,6,8,3,0,0,2,2,17
400915444,North Carolina Tar Heels,J. Berry II,3138155,,True,31.0,7,11,3,3,4,8,0,0,1,2,3,6,3,0,1,1,18
400915444,North Carolina Tar Heels,A. Rohlman,4065677,,False,2.0,0,0,0,0,0,0,0,0,0,0,0,0,0,0,0,0,0
400915444,North Carolina Tar Heels,S. Rush,4065674,,False,2.0,0,0,0,0,0,0,0,0,0,0,0,0,0,0,1,1,0
400915444,North Carolina Tar Heels,T. Bradley,4065673,,False,17.0,2,4,2,4,0,0,4,4,3,2,5,1,0,1,0,3,8
400915444,North Carolina Tar Heels,L. Maye,3911620,,False,23.0,6,11,5,8,1,3,0,0,4,3,7,0,0,0,0,2,13
400915444,North Carolina Tar Heels,S. Woods,4065676,,False,10.0,2,3,2,3,0,0,0,0,0,1,1,2,0,0,2,1,4
400915444,North Carolina Tar Heels,B. Robinson,4065675,,False,6.0,0,1,0,0,0,1,0,0,0,1,1,0,0,0,1,1,0
400915444,North Carolina Tar Heels,K. Coker,3947144,,False,2.0,0,0,0,0,0,0,0,0,0,0,0,0,1,0,0,0,0
400915444,North Carolina Tar Heels,N. Britt,66872,,False,17.0,2,5,2,3,0,2,0,0,0,4,4,1,0,0,1,1,4
400915444,North Carolina Tar Heels,S. White,56963,,False,3.0,0,0,0,0,0,0,0,0,1,0,1,0,0,0,0,0,0
400915444,North Carolina Tar Heels,TEAM,TOTAL,TOTAL,False,,42,75,35,52,7,23,6,8,18,23,41,19,6,1,11,18,97
400915444,NC State Wolfpack,A. Abu,3138158,,True,26.0,3,5,3,5,0,0,4,4,5,2,7,1,1,1,1,3,10
400915444,NC State Wolfpack,D. Smith Jr.,4065697,,True,37.0,8,15,5,6,3,9,8,12,0,4,4,6,2,1,6,1,27
400915444,NC State Wolfpack,M. Rowan,3947151,,True,35.0,4,10,2,3,2,7,2,2,0,5,5,0,0,0,0,1,12
400915444,NC State Wolfpack,T. Dorn,3132359,,True,24.0,2,6,1,4,1,2,0,0,1,1,2,1,0,0,2,2,5
400915444,NC State Wolfpack,T. Henderson,61215,,True,28.0,2,8,2,4,0,4,3,4,1,1,2,1,3,1,3,1,7
400915444,NC State Wolfpack,T. Kapita,4065701,,False,19.0,2,3,2,3,0,0,2,2,1,0,1,0,0,1,1,1,6
400915444,NC State Wolfpack,D. Hicks,4065698,,False,1.0,0,0,0,0,0,0,0,0,0,0,0,1,0,0,0,0,0
400915444,NC State Wolfpack,B. Anya,66134,,False,10.0,0,2,0,2,0,0,0,0,0,1,1,1,1,0,1,2,0
400915444,NC State Wolfpack,O. Yurtseven,66768,,False,10.0,0,1,0,1,0,0,0,0,0,0,0,0,0,0,1,1,0
400915444,NC State Wolfpack,M. Johnson,4065699,,False,9.0,1,1,0,0,1,1,0,0,0,0,0,0,0,0,2,1,3
400915444,NC State Wolfpack,S. Kirk,3947150,,False,1.0,1,1,0,0,1,1,0,0,0,0,0,0,0,0,0,0,3
400915444,NC State Wolfpack,TEAM,TOTAL,TOTAL,False,,23,52,15,28,8,24,19,24,9,16,25,11,7,4,17,13,73
400915444,NC State Wolfpack,A. Abu,3138158,,True,26.0,3,5,3,5,0,0,4,4,5,2,7,1,1,1,1,3,10
400915444,NC State Wolfpack,D. Smith Jr.,4065697,,True,37.0,8,15,5,6,3,9,8,12,0,4,4,6,2,1,6,1,27
400915444,NC State Wolfpack,M. Rowan,3947151,,True,35.0,4,10,2,3,2,7,2,2,0,5,5,0,0,0,0,1,12
400915444,NC State Wolfpack,T. Dorn,3132359,,True,24.0,2,6,1,4,1,2,0,0,1,1,2,1,0,0,2,2,5
400915444,NC State Wolfpack,T. Henderson,61215,,True,28.0,2,8,2,4,0,4,3,4,1,1,2,1,3,1,3,1,7
400915444,NC State Wolfpack,T. Kapita,4065701,,False,19.0,2,3,2,3,0,0,2,2,1,0,1,0,0,1,1,1,6
400915444,NC State Wolfpack,D. Hicks,4065698,,False,1.0,0,0,0,0,0,0,0,0,0,0,0,1,0,0,0,0,0
400915444,NC State Wolfpack,B. Anya,66134,,False,10.0,0,2,0,2,0,0,0,0,0,1,1,1,1,0,1,2,0
400915444,NC State Wolfpack,O. Yurtseven,66768,,False,10.0,0,1,0,1,0,0,0,0,0,0,0,0,0,0,1,1,0
400915444,NC State Wolfpack,M. Johnson,4065699,,False,9.0,1,1,0,0,1,1,0,0,0,0,0,0,0,0,2,1,3
400915444,NC State Wolfpack,S. Kirk,3947150,,False,1.0,1,1,0,0,1,1,0,0,0,0,0,0,0,0,0,0,3
400915444,NC State Wolfpack,TEAM,TOTAL,TOTAL,False,,23,52,15,28,8,24,19,24,9,16,25,11,7,4,17,13,73
400915443,Miami Hurricanes,K. Murphy,61668,,True,37.0,3,4,3,4,0,0,3,4,2,6,8,0,2,0,1,1,9
400915443,Miami Hurricanes,E. Izundu,3904629,,True,13.0,1,2,1,2,0,0,0,0,0,3,3,0,0,0,0,0,2
400915443,Miami Hurricanes,B. Brown,4065670,,True,37.0,1,4,1,2,0,2,6,6,1,2,3,5,1,0,4,1,8
400915443,Miami Hurricanes,A. Lawrence II,3904628,,True,29.0,0,1,0,1,0,0,4,5,0,4,4,2,1,0,6,2,4
400915443,Miami Hurricanes,D. Reed,66130,,True,35.0,8,11,5,7,3,4,2,4,0,7,7,1,3,0,2,2,21
400915443,Miami Hurricanes,D. Hernandez,4065672,,False,21.0,4,7,4,7,0,0,5,6,1,1,2,0,1,2,1,0,13
400915443,Miami Hurricanes,D. Vasiljevic,4065669,,False,28.0,4,9,1,3,3,6,2,2,0,2,2,1,0,0,1,0,13
400915443,Miami Hurricanes,TEAM,TOTAL,TOTAL,False,,21,38,15,26,6,12,22,27,5,26,31,9,8,2,17,6,70
400915443,Miami Hurricanes,K. Murphy,61668,,True,37.0,3,4,3,4,0,0,3,4,2,6,8,0,2,0,1,1,9
400915443,Miami Hurricanes,E. Izundu,3904629,,True,13.0,1,2,1,2,0,0,0,0,0,3,3,0,0,0,0,0,2
400915443,Miami Hurricanes,B. Brown,4065670,,True,37.0,1,4,1,2,0,2,6,6,1,2,3,5,1,0,4,1,8
400915443,Miami Hurricanes,A. Lawrence II,3904628,,True,29.0,0,1,0,1,0,0,4,5,0,4,4,2,1,0,6,2,4
400915443,Miami Hurricanes,D. Reed,66130,,True,35.0,8,11,5,7,3,4,2,4,0,7,7,1,3,0,2,2,21
400915443,Miami Hurricanes,D. Hernandez,4065672,,False,21.0,4,7,4,7,0,0,5,6,1,1,2,0,1,2,1,0,13
400915443,Miami Hurricanes,D. Vasiljevic,4065669,,False,28.0,4,9,1,3,3,6,2,2,0,2,2,1,0,0,1,0,13
400915443,Miami Hurricanes,TEAM,TOTAL,TOTAL,False,,21,38,15,26,6,12,22,27,5,26,31,9,8,2,17,6,70
400915443,Georgia Tech Yellow Jackets,Q. Stephens,66128,,True,36.0,2,9,0,1,2,8,0,0,0,6,6,1,2,0,1,4,6
400915443,Georgia Tech Yellow Jackets,B. Lammers,3135061,,True,40.0,6,12,5,11,1,1,2,2,0,3,3,3,0,4,2,3,15
400915443,Georgia Tech Yellow Jackets,C. Heyward,61609,,True,20.0,0,1,0,0,0,1,0,0,1,1,2,0,0,0,0,1,0
400915443,Georgia Tech Yellow Jackets,J. Okogie,4065663,,True,32.0,7,11,3,6,4,5,0,1,0,2,2,0,2,1,4,3,18
400915443,Georgia Tech Yellow Jackets,J. Heath,67623,,True,38.0,3,8,3,5,0,3,0,0,0,1,1,9,2,0,1,0,6
400915443,Georgia Tech Yellow Jackets,K. McCormick,61453,,False,1.0,0,0,0,0,0,0,0,0,0,0,0,0,0,0,0,0,0
400915443,Georgia Tech Yellow Jackets,J. Moore,4065662,,False,9.0,3,3,2,2,1,1,0,0,0,2,2,2,1,0,2,5,7
400915443,Georgia Tech Yellow Jackets,T. Jackson,3135057,,False,24.0,4,8,3,4,1,4,0,0,0,0,0,2,1,0,2,2,9
400915443,Georgia Tech Yellow Jackets,TEAM,TOTAL,TOTAL,False,,25,52,16,29,9,23,2,3,2,15,17,17,8,5,12,18,61
400915443,Georgia Tech Yellow Jackets,Q. Stephens,66128,,True,36.0,2,9,0,1,2,8,0,0,0,6,6,1,2,0,1,4,6
400915443,Georgia Tech Yellow Jackets,B. Lammers,3135061,,True,40.0,6,12,5,11,1,1,2,2,0,3,3,3,0,4,2,3,15
400915443,Georgia Tech Yellow Jackets,C. Heyward,61609,,True,20.0,0,1,0,0,0,1,0,0,1,1,2,0,0,0,0,1,0
400915443,Georgia Tech Yellow Jackets,J. Okogie,4065663,,True,32.0,7,11,3,6,4,5,0,1,0,2,2,0,2,1,4,3,18
400915443,Georgia Tech Yellow Jackets,J. Heath,67623,,True,38.0,3,8,3,5,0,3,0,0,0,1,1,9,2,0,1,0,6
400915443,Georgia Tech Yellow Jackets,K. McCormick,61453,,False,1.0,0,0,0,0,0,0,0,0,0,0,0,0,0,0,0,0,0
400915443,Georgia Tech Yellow Jackets,J. Moore,4065662,,False,9.0,3,3,2,2,1,1,0,0,0,2,2,2,1,0,2,5,7
400915443,Georgia Tech Yellow Jackets,T. Jackson,3135057,,False,24.0,4,8,3,4,1,4,0,0,0,0,0,2,1,0,2,2,9
400915443,Georgia Tech Yellow Jackets,TEAM,TOTAL,TOTAL,False,,25,52,16,29,9,23,2,3,2,15,17,17,8,5,12,18,61
400915442,Virginia Tech Hokies,K. Sy,4065740,,True,9.0,1,2,1,2,0,0,0,0,1,1,2,1,0,0,0,0,2
400915442,Virginia Tech Hokies,T. Outlaw,67275,,True,22.0,1,3,0,0,1,3,0,0,1,1,2,0,1,0,1,3,3
400915442,Virginia Tech Hokies,J. Robinson,3945566,,True,35.0,5,11,3,8,2,3,3,5,0,3,3,8,1,0,2,1,15
400915442,Virginia Tech Hokies,A. Hill,3147501,,True,37.0,5,9,2,3,3,6,4,4,0,3,3,0,0,0,1,1,17
400915442,Virginia Tech Hokies,J. Bibbs,3147500,,True,38.0,4,14,1,5,3,9,0,0,1,2,3,2,0,0,0,2,11
400915442,Virginia Tech Hokies,Z. LeDay,61698,,False,31.0,4,11,4,11,0,0,2,2,3,8,11,1,2,3,1,1,10
400915442,Virginia Tech Hokies,M. Galloway,3945565,,False,3.0,0,0,0,0,0,0,0,0,0,0,0,1,0,0,0,1,0
400915442,Virginia Tech Hokies,S. Allen,61795,,False,25.0,2,5,1,3,1,2,3,4,2,1,3,3,0,0,3,1,8
400915442,Virginia Tech Hokies,TEAM,TOTAL,TOTAL,False,,22,55,12,32,10,23,12,15,8,21,29,16,4,3,8,10,66
400915442,Virginia Tech Hokies,K. Sy,4065740,,True,9.0,1,2,1,2,0,0,0,0,1,1,2,1,0,0,0,0,2
400915442,Virginia Tech Hokies,T. Outlaw,67275,,True,22.0,1,3,0,0,1,3,0,0,1,1,2,0,1,0,1,3,3
400915442,Virginia Tech Hokies,J. Robinson,3945566,,True,35.0,5,11,3,8,2,3,3,5,0,3,3,8,1,0,2,1,15
400915442,Virginia Tech Hokies,A. Hill,3147501,,True,37.0,5,9,2,3,3,6,4,4,0,3,3,0,0,0,1,1,17
400915442,Virginia Tech Hokies,J. Bibbs,3147500,,True,38.0,4,14,1,5,3,9,0,0,1,2,3,2,0,0,0,2,11
400915442,Virginia Tech Hokies,Z. LeDay,61698,,False,31.0,4,11,4,11,0,0,2,2,3,8,11,1,2,3,1,1,10
400915442,Virginia Tech Hokies,M. Galloway,3945565,,False,3.0,0,0,0,0,0,0,0,0,0,0,0,1,0,0,0,1,0
400915442,Virginia Tech Hokies,S. Allen,61795,,False,25.0,2,5,1,3,1,2,3,4,2,1,3,3,0,0,3,1,8
400915442,Virginia Tech Hokies,TEAM,TOTAL,TOTAL,False,,22,55,12,32,10,23,12,15,8,21,29,16,4,3,8,10,66
400915442,Pittsburgh Panthers,M. Young,66290,,True,38.0,7,18,7,17,0,1,0,0,4,6,10,1,0,0,2,2,14
400915442,Pittsburgh Panthers,S. Jeter,61756,,True,37.0,3,8,3,7,0,1,3,5,4,6,10,2,1,2,2,2,9
400915442,Pittsburgh Panthers,J. Artis,66287,,True,35.0,6,16,2,9,4,7,0,0,2,3,5,2,0,0,5,2,16
400915442,Pittsburgh Panthers,C. Johnson,3138196,,True,39.0,6,10,1,2,5,8,0,0,1,10,11,7,0,0,2,3,17
400915442,Pittsburgh Panthers,C. Jones,61219,,True,33.0,2,5,1,3,1,2,0,0,1,2,3,2,1,0,2,1,5
400915442,Pittsburgh Panthers,R. Nix,3934653,,False,4.0,1,1,1,1,0,0,0,0,1,0,1,0,0,0,0,3,2
400915442,Pittsburgh Panthers,J. Kithcart,4065713,,False,10.0,0,1,0,1,0,0,0,0,1,1,2,0,0,0,0,0,0
400915442,Pittsburgh Panthers,J. Milligan,3934655,,False,3.0,0,1,0,0,0,1,0,0,0,0,0,0,0,0,0,1,0
400915442,Pittsburgh Panthers,D. Wilson,3934652,,False,1.0,0,0,0,0,0,0,0,0,0,0,0,0,0,0,0,0,0
400915442,Pittsburgh Panthers,TEAM,TOTAL,TOTAL,False,,25,60,15,40,10,20,3,5,15,28,43,14,2,2,13,14,63
400915442,Pittsburgh Panthers,M. Young,66290,,True,38.0,7,18,7,17,0,1,0,0,4,6,10,1,0,0,2,2,14
400915442,Pittsburgh Panthers,S. Jeter,61756,,True,37.0,3,8,3,7,0,1,3,5,4,6,10,2,1,2,2,2,9
400915442,Pittsburgh Panthers,J. Artis,66287,,True,35.0,6,16,2,9,4,7,0,0,2,3,5,2,0,0,5,2,16
400915442,Pittsburgh Panthers,C. Johnson,3138196,,True,39.0,6,10,1,2,5,8,0,0,1,10,11,7,0,0,2,3,17
400915442,Pittsburgh Panthers,C. Jones,61219,,True,33.0,2,5,1,3,1,2,0,0,1,2,3,2,1,0,2,1,5
400915442,Pittsburgh Panthers,R. Nix,3934653,,False,4.0,1,1,1,1,0,0,0,0,1,0,1,0,0,0,0,3,2
400915442,Pittsburgh Panthers,J. Kithcart,4065713,,False,10.0,0,1,0,1,0,0,0,0,1,1,2,0,0,0,0,0,0
400915442,Pittsburgh Panthers,J. Milligan,3934655,,False,3.0,0,1,0,0,0,1,0,0,0,0,0,0,0,0,0,1,0
400915442,Pittsburgh Panthers,D. Wilson,3934652,,False,1.0,0,0,0,0,0,0,0,0,0,0,0,0,0,0,0,0,0
400915442,Pittsburgh Panthers,TEAM,TOTAL,TOTAL,False,,25,60,15,40,10,20,3,5,15,28,43,14,2,2,13,14,63
400915441,Wake Forest Demon Deacons,J. Collins,3908845,,True,27.0,12,14,12,14,0,0,5,5,5,5,10,2,0,2,4,4,29
400915441,Wake Forest Demon Deacons,D. Mitoglou,3138224,,True,28.0,2,5,2,4,0,1,1,2,1,5,6,1,0,1,1,3,5
400915441,Wake Forest Demon Deacons,A. Arians,61378,,True,11.0,0,3,0,1,0,2,0,0,0,1,1,2,2,0,0,4,0
400915441,Wake Forest Demon Deacons,B. Crawford,3908844,,True,35.0,9,18,6,11,3,7,4,5,0,4,4,2,1,0,7,5,25
400915441,Wake Forest Demon Deacons,K. Woods,3132360,,True,32.0,4,10,3,6,1,4,0,0,1,3,4,3,1,0,2,3,9
400915441,Wake Forest Demon Deacons,S. Japhet-Mathias,4065752,,False,2.0,0,1,0,1,0,0,0,0,0,0,0,0,0,0,0,0,0
400915441,Wake Forest Demon Deacons,D. Moore,3908843,,False,10.0,2,4,2,4,0,0,1,1,1,1,2,0,0,0,2,3,5
400915441,Wake Forest Demon Deacons,B. Childress,4065750,,False,22.0,2,5,2,3,0,2,1,1,1,3,4,3,0,0,1,2,5
400915441,Wake Forest Demon Deacons,M. Wilbekin,3138222,,False,25.0,2,5,1,4,1,1,0,0,1,1,2,2,0,0,1,2,5
400915441,Wake Forest Demon Deacons,T. VanHorn,3078214,,False,8.0,0,0,0,0,0,0,0,0,0,1,1,0,0,0,0,3,0
400915441,Wake Forest Demon Deacons,TEAM,TOTAL,TOTAL,False,,33,65,28,48,5,17,12,14,10,26,36,15,4,3,18,29,83
400915441,Wake Forest Demon Deacons,J. Collins,3908845,,True,27.0,12,14,12,14,0,0,5,5,5,5,10,2,0,2,4,4,29
400915441,Wake Forest Demon Deacons,D. Mitoglou,3138224,,True,28.0,2,5,2,4,0,1,1,2,1,5,6,1,0,1,1,3,5
400915441,Wake Forest Demon Deacons,A. Arians,61378,,True,11.0,0,3,0,1,0,2,0,0,0,1,1,2,2,0,0,4,0
400915441,Wake Forest Demon Deacons,B. Crawford,3908844,,True,35.0,9,18,6,11,3,7,4,5,0,4,4,2,1,0,7,5,25
400915441,Wake Forest Demon Deacons,K. Woods,3132360,,True,32.0,4,10,3,6,1,4,0,0,1,3,4,3,1,0,2,3,9
400915441,Wake Forest Demon Deacons,S. Japhet-Mathias,4065752,,False,2.0,0,1,0,1,0,0,0,0,0,0,0,0,0,0,0,0,0
400915441,Wake Forest Demon Deacons,D. Moore,3908843,,False,10.0,2,4,2,4,0,0,1,1,1,1,2,0,0,0,2,3,5
400915441,Wake Forest Demon Deacons,B. Childress,4065750,,False,22.0,2,5,2,3,0,2,1,1,1,3,4,3,0,0,1,2,5
400915441,Wake Forest Demon Deacons,M. Wilbekin,3138222,,False,25.0,2,5,1,4,1,1,0,0,1,1,2,2,0,0,1,2,5
400915441,Wake Forest Demon Deacons,T. VanHorn,3078214,,False,8.0,0,0,0,0,0,0,0,0,0,1,1,0,0,0,0,3,0
400915441,Wake Forest Demon Deacons,TEAM,TOTAL,TOTAL,False,,33,65,28,48,5,17,12,14,10,26,36,15,4,3,18,29,83
400915441,Clemson Tigers,E. Thomas,3947075,,True,15.0,4,5,4,5,0,0,0,0,0,2,2,0,1,2,1,5,8
400915441,Clemson Tigers,D. Grantham,3129674,,True,22.0,1,4,0,2,1,2,0,0,0,0,0,1,1,1,1,2,3
400915441,Clemson Tigers,J. Blossomgame,61835,,True,36.0,6,16,4,11,2,5,3,6,0,10,10,3,1,1,2,2,17
400915441,Clemson Tigers,S. Mitchell,3136699,,True,26.0,3,6,3,5,0,1,9,10,0,4,4,3,1,0,3,3,15
400915441,Clemson Tigers,A. Holmes,62043,,True,31.0,4,7,1,3,3,4,4,4,1,0,1,1,1,0,0,0,15
400915441,Clemson Tigers,L. Robertin,3917985,,False,13.0,2,2,2,2,0,0,0,3,0,0,0,0,0,0,1,0,4
400915441,Clemson Tigers,S. Djitte,66122,,False,12.0,2,3,2,3,0,0,2,2,1,2,3,1,0,0,0,5,6
400915441,Clemson Tigers,T. Hudson,3917986,,False,2.0,0,1,0,0,0,1,0,0,0,0,0,0,0,0,0,0,0
400915441,Clemson Tigers,M. Reed,3133969,,False,32.0,5,10,3,7,2,3,9,10,0,5,5,2,1,0,1,0,21
400915441,Clemson Tigers,G. DeVoe,3129673,,False,11.0,2,3,0,0,2,3,0,0,0,0,0,1,1,0,1,2,6
400915441,Clemson Tigers,TEAM,TOTAL,TOTAL,False,,29,57,19,38,10,19,27,35,4,24,28,12,7,4,10,19,95
400915441,Clemson Tigers,E. Thomas,3947075,,True,15.0,4,5,4,5,0,0,0,0,0,2,2,0,1,2,1,5,8
400915441,Clemson Tigers,D. Grantham,3129674,,True,22.0,1,4,0,2,1,2,0,0,0,0,0,1,1,1,1,2,3
400915441,Clemson Tigers,J. Blossomgame,61835,,True,36.0,6,16,4,11,2,5,3,6,0,10,10,3,1,1,2,2,17
400915441,Clemson Tigers,S. Mitchell,3136699,,True,26.0,3,6,3,5,0,1,9,10,0,4,4,3,1,0,3,3,15
400915441,Clemson Tigers,A. Holmes,62043,,True,31.0,4,7,1,3,3,4,4,4,1,0,1,1,1,0,0,0,15
400915441,Clemson Tigers,L. Robertin,3917985,,False,13.0,2,2,2,2,0,0,0,3,0,0,0,0,0,0,1,0,4
400915441,Clemson Tigers,S. Djitte,66122,,False,12.0,2,3,2,3,0,0,2,2,1,2,3,1,0,0,0,5,6
400915441,Clemson Tigers,T. Hudson,3917986,,False,2.0,0,1,0,0,0,1,0,0,0,0,0,0,0,0,0,0,0
400915441,Clemson Tigers,M. Reed,3133969,,False,32.0,5,10,3,7,2,3,9,10,0,5,5,2,1,0,1,0,21
400915441,Clemson Tigers,G. DeVoe,3129673,,False,11.0,2,3,0,0,2,3,0,0,0,0,0,1,1,0,1,2,6
400915441,Clemson Tigers,TEAM,TOTAL,TOTAL,False,,29,57,19,38,10,19,27,35,4,24,28,12,7,4,10,19,95
400915440,Notre Dame Fighting Irish,B. Colson,3138192,,True,33.0,9,12,9,12,0,0,2,4,1,5,6,1,0,0,3,2,20
400915440,Notre Dame Fighting Irish,V.J. Beachem,66283,,True,37.0,5,13,1,3,4,10,2,2,3,5,8,0,1,1,2,2,16
400915440,Notre Dame Fighting Irish,R. Pflueger,3908335,,True,25.0,2,3,2,3,0,0,3,3,2,3,5,3,0,0,1,3,7
400915440,Notre Dame Fighting Irish,M. Farrell,3138190,,True,37.0,6,14,1,3,5,11,2,2,0,2,2,3,3,0,1,1,19
400915440,Notre Dame Fighting Irish,S. Vasturia,66285,,True,34.0,4,13,3,6,1,7,6,6,1,5,6,7,1,0,1,3,15
400915440,Notre Dame Fighting Irish,M. Geben,3138191,,False,1.0,0,0,0,0,0,0,0,0,0,0,0,0,0,0,0,1,0
400915440,Notre Dame Fighting Irish,A. Torres,66286,,False,13.0,0,1,0,1,0,0,0,0,1,1,2,0,0,0,0,3,0
400915440,Notre Dame Fighting Irish,M. Ryan,3908336,,False,6.0,1,2,0,0,1,2,0,0,0,0,0,0,0,0,1,1,3
400915440,Notre Dame Fighting Irish,T. Gibbs,4065703,,False,14.0,0,4,0,3,0,1,4,4,0,1,1,0,3,0,0,0,4
400915440,Notre Dame Fighting Irish,TEAM,TOTAL,TOTAL,False,,27,62,16,31,11,31,19,21,9,24,33,14,8,1,9,16,84
400915440,Notre Dame Fighting Irish,B. Colson,3138192,,True,33.0,9,12,9,12,0,0,2,4,1,5,6,1,0,0,3,2,20
400915440,Notre Dame Fighting Irish,V.J. Beachem,66283,,True,37.0,5,13,1,3,4,10,2,2,3,5,8,0,1,1,2,2,16
400915440,Notre Dame Fighting Irish,R. Pflueger,3908335,,True,25.0,2,3,2,3,0,0,3,3,2,3,5,3,0,0,1,3,7
400915440,Notre Dame Fighting Irish,M. Farrell,3138190,,True,37.0,6,14,1,3,5,11,2,2,0,2,2,3,3,0,1,1,19
400915440,Notre Dame Fighting Irish,S. Vasturia,66285,,True,34.0,4,13,3,6,1,7,6,6,1,5,6,7,1,0,1,3,15
400915440,Notre Dame Fighting Irish,M. Geben,3138191,,False,1.0,0,0,0,0,0,0,0,0,0,0,0,0,0,0,0,1,0
400915440,Notre Dame Fighting Irish,A. Torres,66286,,False,13.0,0,1,0,1,0,0,0,0,1,1,2,0,0,0,0,3,0
400915440,Notre Dame Fighting Irish,M. Ryan,3908336,,False,6.0,1,2,0,0,1,2,0,0,0,0,0,0,0,0,1,1,3
400915440,Notre Dame Fighting Irish,T. Gibbs,4065703,,False,14.0,0,4,0,3,0,1,4,4,0,1,1,0,3,0,0,0,4
400915440,Notre Dame Fighting Irish,TEAM,TOTAL,TOTAL,False,,27,62,16,31,11,31,19,21,9,24,33,14,8,1,9,16,84
400915440,Boston College Eagles,A.J. Turner,3943608,,True,32.0,3,5,2,3,1,2,0,0,0,3,3,6,0,0,1,3,7
400915440,Boston College Eagles,M. Jeffers,61901,,True,23.0,4,5,4,5,0,0,4,4,1,6,7,0,1,0,1,2,12
400915440,Boston College Eagles,K. Bowman,4065635,,True,37.0,8,15,3,4,5,11,8,8,2,7,9,3,0,1,3,2,29
400915440,Boston College Eagles,J. Robinson,3943606,,True,31.0,3,12,3,11,0,1,5,8,0,5,5,6,1,0,3,4,11
400915440,Boston College Eagles,J. Chatman,3135095,,True,31.0,0,3,0,0,0,3,0,0,0,0,0,2,0,1,0,1,0
400915440,Boston College Eagles,M. Sagay,4065638,,False,10.0,1,3,0,1,1,2,0,0,0,2,2,0,0,0,2,2,3
400915440,Boston College Eagles,N. Popovic,4065637,,False,9.0,1,5,1,5,0,0,0,0,1,2,3,0,0,0,0,0,2
400915440,Boston College Eagles,G. Owens,66277,,False,9.0,2,2,1,1,1,1,0,0,0,0,0,0,2,0,1,0,5
400915440,Boston College Eagles,C. Tava,61446,,False,18.0,3,3,3,3,0,0,1,2,1,1,2,1,1,0,3,2,7
400915440,Boston College Eagles,TEAM,TOTAL,TOTAL,False,,25,53,17,33,8,20,18,22,5,27,32,18,5,2,14,16,76
400915440,Boston College Eagles,A.J. Turner,3943608,,True,32.0,3,5,2,3,1,2,0,0,0,3,3,6,0,0,1,3,7
400915440,Boston College Eagles,M. Jeffers,61901,,True,23.0,4,5,4,5,0,0,4,4,1,6,7,0,1,0,1,2,12
400915440,Boston College Eagles,K. Bowman,4065635,,True,37.0,8,15,3,4,5,11,8,8,2,7,9,3,0,1,3,2,29
400915440,Boston College Eagles,J. Robinson,3943606,,True,31.0,3,12,3,11,0,1,5,8,0,5,5,6,1,0,3,4,11
400915440,Boston College Eagles,J. Chatman,3135095,,True,31.0,0,3,0,0,0,3,0,0,0,0,0,2,0,1,0,1,0
400915440,Boston College Eagles,M. Sagay,4065638,,False,10.0,1,3,0,1,1,2,0,0,0,2,2,0,0,0,2,2,3
400915440,Boston College Eagles,N. Popovic,4065637,,False,9.0,1,5,1,5,0,0,0,0,1,2,3,0,0,0,0,0,2
400915440,Boston College Eagles,G. Owens,66277,,False,9.0,2,2,1,1,1,1,0,0,0,0,0,0,2,0,1,0,5
400915440,Boston College Eagles,C. Tava,61446,,False,18.0,3,3,3,3,0,0,1,2,1,1,2,1,1,0,3,2,7
400915440,Boston College Eagles,TEAM,TOTAL,TOTAL,False,,25,53,17,33,8,20,18,22,5,27,32,18,5,2,14,16,76
400915439,Syracuse Orange,T. Thompson,4065721,,True,18.0,5,6,5,6,0,0,1,2,1,0,1,0,1,1,1,4,11
400915439,Syracuse Orange,T. Lydon,3934662,,True,45.0,5,11,3,5,2,6,2,2,1,8,9,4,3,3,2,2,14
400915439,Syracuse Orange,A. White III,61616,,True,45.0,7,24,5,10,2,14,6,6,2,6,8,1,1,0,2,4,22
400915439,Syracuse Orange,T. Battle,4065722,,True,26.0,1,7,1,2,0,5,0,0,0,3,3,1,0,0,1,2,2
400915439,Syracuse Orange,J. Gillon,61915,,True,45.0,3,11,0,4,3,7,2,2,1,3,4,5,1,0,5,4,11
400915439,Syracuse Orange,T. Roberson,67633,,False,27.0,2,2,2,2,0,0,0,2,3,5,8,3,1,0,0,3,4
400915439,Syracuse Orange,F. Howard,3934659,,False,19.0,3,4,2,2,1,2,1,1,1,0,1,2,1,0,3,3,8
400915439,Syracuse Orange,TEAM,TOTAL,TOTAL,False,,26,65,18,31,8,34,12,15,10,28,38,16,8,4,15,22,72
400915439,Syracuse Orange,T. Thompson,4065721,,True,18.0,5,6,5,6,0,0,1,2,1,0,1,0,1,1,1,4,11
400915439,Syracuse Orange,T. Lydon,3934662,,True,45.0,5,11,3,5,2,6,2,2,1,8,9,4,3,3,2,2,14
400915439,Syracuse Orange,A. White III,61616,,True,45.0,7,24,5,10,2,14,6,6,2,6,8,1,1,0,2,4,22
400915439,Syracuse Orange,T. Battle,4065722,,True,26.0,1,7,1,2,0,5,0,0,0,3,3,1,0,0,1,2,2
400915439,Syracuse Orange,J. Gillon,61915,,True,45.0,3,11,0,4,3,7,2,2,1,3,4,5,1,0,5,4,11
400915439,Syracuse Orange,T. Roberson,67633,,False,27.0,2,2,2,2,0,0,0,2,3,5,8,3,1,0,0,3,4
400915439,Syracuse Orange,F. Howard,3934659,,False,19.0,3,4,2,2,1,2,1,1,1,0,1,2,1,0,3,3,8
400915439,Syracuse Orange,TEAM,TOTAL,TOTAL,False,,26,65,18,31,8,34,12,15,10,28,38,16,8,4,15,22,72
400915439,Louisville Cardinals,D. Adel,3908807,,True,38.0,3,9,1,4,2,5,3,6,0,7,7,2,1,0,5,1,11
400915439,Louisville Cardinals,M. Mathiang,63035,,True,21.0,2,4,2,4,0,0,1,1,1,3,4,1,1,1,2,2,5
400915439,Louisville Cardinals,J. Johnson,3147362,,True,29.0,4,7,4,7,0,0,2,6,4,3,7,0,1,0,2,3,10
400915439,Louisville Cardinals,D. Mitchell,3908809,,True,36.0,6,13,4,6,2,7,2,3,2,2,4,3,3,0,3,5,16
400915439,Louisville Cardinals,Q. Snider,3147360,,True,43.0,5,15,2,6,3,9,1,2,1,3,4,6,0,0,2,1,14
400915439,Louisville Cardinals,V.J. King,4065666,,False,7.0,0,2,0,1,0,1,0,0,1,1,2,0,0,0,0,1,0
400915439,Louisville Cardinals,R. Spalding,3908806,,False,16.0,0,2,0,2,0,0,1,2,3,2,5,0,1,0,0,1,1
400915439,Louisville Cardinals,A. Mahmoud,3147363,,False,24.0,4,6,4,6,0,0,4,6,2,6,8,1,2,3,1,2,12
400915439,Louisville Cardinals,R. McMahon,3908808,,False,5.0,2,3,1,1,1,2,2,3,1,0,1,0,0,0,0,0,7
400915439,Louisville Cardinals,D. Levitch,66592,,False,6.0,0,1,0,0,0,1,0,1,0,0,0,0,1,0,0,0,0
400915439,Louisville Cardinals,TEAM,TOTAL,TOTAL,False,,26,62,18,37,8,25,16,30,15,31,46,13,10,4,15,16,76
400915439,Louisville Cardinals,D. Adel,3908807,,True,38.0,3,9,1,4,2,5,3,6,0,7,7,2,1,0,5,1,11
400915439,Louisville Cardinals,M. Mathiang,63035,,True,21.0,2,4,2,4,0,0,1,1,1,3,4,1,1,1,2,2,5
400915439,Louisville Cardinals,J. Johnson,3147362,,True,29.0,4,7,4,7,0,0,2,6,4,3,7,0,1,0,2,3,10
400915439,Louisville Cardinals,D. Mitchell,3908809,,True,36.0,6,13,4,6,2,7,2,3,2,2,4,3,3,0,3,5,16
400915439,Louisville Cardinals,Q. Snider,3147360,,True,43.0,5,15,2,6,3,9,1,2,1,3,4,6,0,0,2,1,14
400915439,Louisville Cardinals,V.J. King,4065666,,False,7.0,0,2,0,1,0,1,0,0,1,1,2,0,0,0,0,1,0
400915439,Louisville Cardinals,R. Spalding,3908806,,False,16.0,0,2,0,2,0,0,1,2,3,2,5,0,1,0,0,1,1
400915439,Louisville Cardinals,A. Mahmoud,3147363,,False,24.0,4,6,4,6,0,0,4,6,2,6,8,1,2,3,1,2,12
400915439,Louisville Cardinals,R. McMahon,3908808,,False,5.0,2,3,1,1,1,2,2,3,1,0,1,0,0,0,0,0,7
400915439,Louisville Cardinals,D. Levitch,66592,,False,6.0,0,1,0,0,0,1,0,1,0,0,0,0,1,0,0,0,0
400915439,Louisville Cardinals,TEAM,TOTAL,TOTAL,False,,26,62,18,37,8,25,16,30,15,31,46,13,10,4,15,16,76
400915438,Virginia Tech Hokies,K. Sy,4065740,,True,17.0,4,6,4,6,0,0,2,2,1,3,4,0,0,0,2,0,10
400915438,Virginia Tech Hokies,C. Clarke,3945567,,True,25.0,1,3,1,2,0,1,3,4,0,7,7,3,0,1,3,1,5
400915438,Virginia Tech Hokies,J. Robinson,3945566,,True,39.0,2,7,1,3,1,4,2,2,0,4,4,6,0,1,3,3,7
400915438,Virginia Tech Hokies,A. Hill,3147501,,True,44.0,3,9,3,5,0,4,3,4,0,6,6,1,0,0,3,2,9
400915438,Virginia Tech Hokies,J. Bibbs,3147500,,True,46.0,6,9,2,3,4,6,0,3,0,6,6,0,0,0,1,2,16
400915438,Virginia Tech Hokies,Z. LeDay,61698,,False,24.0,3,7,3,7,0,0,5,5,3,3,6,0,0,2,2,5,11
400915438,Virginia Tech Hokies,T. Outlaw,67275,,False,14.0,1,4,1,1,0,3,0,0,1,0,1,1,0,1,0,3,2
400915438,Virginia Tech Hokies,S. Allen,61795,,False,41.0,6,14,3,6,3,8,5,6,1,3,4,2,1,0,3,4,20
400915438,Virginia Tech Hokies,TEAM,TOTAL,TOTAL,False,,26,59,18,33,8,26,20,26,7,34,41,13,1,5,17,20,80
400915438,Virginia Tech Hokies,K. Sy,4065740,,True,17.0,4,6,4,6,0,0,2,2,1,3,4,0,0,0,2,0,10
400915438,Virginia Tech Hokies,C. Clarke,3945567,,True,25.0,1,3,1,2,0,1,3,4,0,7,7,3,0,1,3,1,5
400915438,Virginia Tech Hokies,J. Robinson,3945566,,True,39.0,2,7,1,3,1,4,2,2,0,4,4,6,0,1,3,3,7
400915438,Virginia Tech Hokies,A. Hill,3147501,,True,44.0,3,9,3,5,0,4,3,4,0,6,6,1,0,0,3,2,9
400915438,Virginia Tech Hokies,J. Bibbs,3147500,,True,46.0,6,9,2,3,4,6,0,3,0,6,6,0,0,0,1,2,16
400915438,Virginia Tech Hokies,Z. LeDay,61698,,False,24.0,3,7,3,7,0,0,5,5,3,3,6,0,0,2,2,5,11
400915438,Virginia Tech Hokies,T. Outlaw,67275,,False,14.0,1,4,1,1,0,3,0,0,1,0,1,1,0,1,0,3,2
400915438,Virginia Tech Hokies,S. Allen,61795,,False,41.0,6,14,3,6,3,8,5,6,1,3,4,2,1,0,3,4,20
400915438,Virginia Tech Hokies,TEAM,TOTAL,TOTAL,False,,26,59,18,33,8,26,20,26,7,34,41,13,1,5,17,20,80
400915438,Virginia Cavaliers,I. Wilkins,3138203,,True,41.0,2,8,2,8,0,0,1,3,5,4,9,1,0,2,2,5,5
400915438,Virginia Cavaliers,J. Salt,3138200,,True,14.0,0,2,0,2,0,0,2,4,2,2,4,0,1,1,2,4,2
400915438,Virginia Cavaliers,M. Shayok,3138201,,True,21.0,5,8,5,8,0,0,1,2,1,3,4,0,1,0,1,2,11
400915438,Virginia Cavaliers,L. Perrantes,66139,,True,46.0,7,22,4,10,3,12,5,7,0,3,3,3,0,0,1,0,22
400915438,Virginia Cavaliers,D. Hall,66138,,True,37.0,3,8,2,5,1,3,3,4,0,4,4,3,0,0,1,2,10
400915438,Virginia Cavaliers,M. Diakite,3947156,,False,10.0,0,2,0,2,0,0,0,0,0,1,1,1,0,3,0,1,0
400915438,Virginia Cavaliers,J. Reuter,3908374,,False,7.0,1,1,1,1,0,0,2,3,0,3,3,0,0,0,2,2,4
400915438,Virginia Cavaliers,T. Jerome,4065733,,False,24.0,3,4,1,1,2,3,0,1,0,4,4,1,1,0,0,1,8
400915438,Virginia Cavaliers,K. Guy,4065730,,False,23.0,5,8,3,4,2,4,0,0,0,2,2,1,0,0,1,1,12
400915438,Virginia Cavaliers,D. Thompson,66274,,False,27.0,2,3,2,2,0,1,0,0,0,1,1,3,3,0,0,2,4
400915438,Virginia Cavaliers,TEAM,TOTAL,TOTAL,False,,28,66,20,43,8,23,14,24,9,29,38,13,6,6,10,20,78
400915438,Virginia Cavaliers,I. Wilkins,3138203,,True,41.0,2,8,2,8,0,0,1,3,5,4,9,1,0,2,2,5,5
400915438,Virginia Cavaliers,J. Salt,3138200,,True,14.0,0,2,0,2,0,0,2,4,2,2,4,0,1,1,2,4,2
400915438,Virginia Cavaliers,M. Shayok,3138201,,True,21.0,5,8,5,8,0,0,1,2,1,3,4,0,1,0,1,2,11
400915438,Virginia Cavaliers,L. Perrantes,66139,,True,46.0,7,22,4,10,3,12,5,7,0,3,3,3,0,0,1,0,22
400915438,Virginia Cavaliers,D. Hall,66138,,True,37.0,3,8,2,5,1,3,3,4,0,4,4,3,0,0,1,2,10
400915438,Virginia Cavaliers,M. Diakite,3947156,,False,10.0,0,2,0,2,0,0,0,0,0,1,1,1,0,3,0,1,0
400915438,Virginia Cavaliers,J. Reuter,3908374,,False,7.0,1,1,1,1,0,0,2,3,0,3,3,0,0,0,2,2,4
400915438,Virginia Cavaliers,T. Jerome,4065733,,False,24.0,3,4,1,1,2,3,0,1,0,4,4,1,1,0,0,1,8
400915438,Virginia Cavaliers,K. Guy,4065730,,False,23.0,5,8,3,4,2,4,0,0,0,2,2,1,0,0,1,1,12
400915438,Virginia Cavaliers,D. Thompson,66274,,False,27.0,2,3,2,2,0,1,0,0,0,1,1,3,3,0,0,2,4
400915438,Virginia Cavaliers,TEAM,TOTAL,TOTAL,False,,28,66,20,43,8,23,14,24,9,29,38,13,6,6,10,20,78
400915437,Miami Hurricanes,D. Hernandez,4065672,,True,14.0,2,2,2,2,0,0,0,0,0,3,3,1,1,1,1,2,4
400915437,Miami Hurricanes,K. Murphy,61668,,True,27.0,4,4,4,4,0,0,2,4,1,1,2,0,0,0,0,4,10
400915437,Miami Hurricanes,B. Brown,4065670,,True,36.0,4,10,4,9,0,1,4,6,2,5,7,4,0,0,3,3,12
400915437,Miami Hurricanes,J. Newton,3138145,,True,34.0,5,12,3,9,2,3,3,5,0,5,5,2,1,0,1,0,15
400915437,Miami Hurricanes,D. Reed,66130,,True,36.0,3,12,2,7,1,5,0,0,2,2,4,3,1,0,0,3,7
400915437,Miami Hurricanes,R. Miller Jr.,4065671,,False,1.0,0,0,0,0,0,0,0,0,0,0,0,0,0,0,0,0,0
400915437,Miami Hurricanes,E. Izundu,3904629,,False,15.0,3,4,3,4,0,0,2,2,2,3,5,0,0,2,3,4,8
400915437,Miami Hurricanes,A. Lawrence II,3904628,,False,26.0,1,5,0,1,1,4,4,4,1,2,3,3,0,1,0,1,7
400915437,Miami Hurricanes,D. Vasiljevic,4065669,,False,11.0,1,3,0,1,1,2,0,0,0,0,0,0,1,0,0,0,3
400915437,Miami Hurricanes,TEAM,TOTAL,TOTAL,False,,23,52,18,37,5,15,15,21,10,22,32,13,4,4,8,17,66
400915437,Miami Hurricanes,D. Hernandez,4065672,,True,14.0,2,2,2,2,0,0,0,0,0,3,3,1,1,1,1,2,4
400915437,Miami Hurricanes,K. Murphy,61668,,True,27.0,4,4,4,4,0,0,2,4,1,1,2,0,0,0,0,4,10
400915437,Miami Hurricanes,B. Brown,4065670,,True,36.0,4,10,4,9,0,1,4,6,2,5,7,4,0,0,3,3,12
400915437,Miami Hurricanes,J. Newton,3138145,,True,34.0,5,12,3,9,2,3,3,5,0,5,5,2,1,0,1,0,15
400915437,Miami Hurricanes,D. Reed,66130,,True,36.0,3,12,2,7,1,5,0,0,2,2,4,3,1,0,0,3,7
400915437,Miami Hurricanes,R. Miller Jr.,4065671,,False,1.0,0,0,0,0,0,0,0,0,0,0,0,0,0,0,0,0,0
400915437,Miami Hurricanes,E. Izundu,3904629,,False,15.0,3,4,3,4,0,0,2,2,2,3,5,0,0,2,3,4,8
400915437,Miami Hurricanes,A. Lawrence II,3904628,,False,26.0,1,5,0,1,1,4,4,4,1,2,3,3,0,1,0,1,7
400915437,Miami Hurricanes,D. Vasiljevic,4065669,,False,11.0,1,3,0,1,1,2,0,0,0,0,0,0,1,0,0,0,3
400915437,Miami Hurricanes,TEAM,TOTAL,TOTAL,False,,23,52,18,37,5,15,15,21,10,22,32,13,4,4,8,17,66
400915437,Louisville Cardinals,A. Mahmoud,3147363,,True,8.0,0,0,0,0,0,0,0,0,0,2,2,0,0,0,3,0,0
400915437,Louisville Cardinals,V.J. King,4065666,,True,5.0,1,1,0,0,1,1,0,0,0,0,0,0,0,0,0,2,3
400915437,Louisville Cardinals,J. Johnson,3147362,,True,27.0,3,6,3,6,0,0,4,4,4,4,8,0,2,1,1,3,10
400915437,Louisville Cardinals,D. Mitchell,3908809,,True,38.0,6,17,3,8,3,9,3,5,1,1,2,4,1,1,1,4,18
400915437,Louisville Cardinals,Q. Snider,3147360,,True,33.0,3,8,0,3,3,5,4,4,1,2,3,4,0,0,3,2,13
400915437,Louisville Cardinals,D. Adel,3908807,,False,36.0,6,14,2,4,4,10,2,3,2,3,5,3,0,1,0,0,18
400915437,Louisville Cardinals,R. Spalding,3908806,,False,13.0,0,1,0,1,0,0,0,0,0,4,4,1,0,0,1,2,0
400915437,Louisville Cardinals,M. Mathiang,63035,,False,32.0,2,5,2,5,0,0,3,4,4,4,8,1,1,1,0,2,7
400915437,Louisville Cardinals,R. McMahon,3908808,,False,4.0,0,1,0,0,0,1,0,0,0,0,0,0,0,0,0,2,0
400915437,Louisville Cardinals,D. Levitch,66592,,False,4.0,1,3,1,1,0,2,0,0,0,2,2,0,0,0,0,1,2
400915437,Louisville Cardinals,TEAM,TOTAL,TOTAL,False,,22,56,11,28,11,28,16,20,14,22,36,13,4,4,9,18,71
400915437,Louisville Cardinals,A. Mahmoud,3147363,,True,8.0,0,0,0,0,0,0,0,0,0,2,2,0,0,0,3,0,0
400915437,Louisville Cardinals,V.J. King,4065666,,True,5.0,1,1,0,0,1,1,0,0,0,0,0,0,0,0,0,2,3
400915437,Louisville Cardinals,J. Johnson,3147362,,True,27.0,3,6,3,6,0,0,4,4,4,4,8,0,2,1,1,3,10
400915437,Louisville Cardinals,D. Mitchell,3908809,,True,38.0,6,17,3,8,3,9,3,5,1,1,2,4,1,1,1,4,18
400915437,Louisville Cardinals,Q. Snider,3147360,,True,33.0,3,8,0,3,3,5,4,4,1,2,3,4,0,0,3,2,13
400915437,Louisville Cardinals,D. Adel,3908807,,False,36.0,6,14,2,4,4,10,2,3,2,3,5,3,0,1,0,0,18
400915437,Louisville Cardinals,R. Spalding,3908806,,False,13.0,0,1,0,1,0,0,0,0,0,4,4,1,0,0,1,2,0
400915437,Louisville Cardinals,M. Mathiang,63035,,False,32.0,2,5,2,5,0,0,3,4,4,4,8,1,1,1,0,2,7
400915437,Louisville Cardinals,R. McMahon,3908808,,False,4.0,0,1,0,0,0,1,0,0,0,0,0,0,0,0,0,2,0
400915437,Louisville Cardinals,D. Levitch,66592,,False,4.0,1,3,1,1,0,2,0,0,0,2,2,0,0,0,0,1,2
400915437,Louisville Cardinals,TEAM,TOTAL,TOTAL,False,,22,56,11,28,11,28,16,20,14,22,36,13,4,4,9,18,71
400915436,Georgia Tech Yellow Jackets,Q. Stephens,66128,,True,5.0,0,1,0,0,0,1,0,0,0,0,0,0,0,0,0,0,0
400915436,Georgia Tech Yellow Jackets,B. Lammers,3135061,,True,39.0,6,13,6,13,0,0,2,5,4,13,17,4,1,3,5,1,14
400915436,Georgia Tech Yellow Jackets,J. Okogie,4065663,,True,39.0,3,11,3,9,0,2,6,8,0,12,12,0,2,2,1,2,12
400915436,Georgia Tech Yellow Jackets,J. Heath,67623,,True,38.0,2,5,2,3,0,2,1,2,0,0,0,7,1,1,4,2,5
400915436,Georgia Tech Yellow Jackets,C. Heyward,61609,,True,10.0,0,1,0,0,0,1,0,0,0,1,1,0,1,0,1,1,0
400915436,Georgia Tech Yellow Jackets,C. Matthews,4065665,,False,3.0,0,1,0,1,0,0,0,0,0,1,1,0,0,0,0,0,0
400915436,Georgia Tech Yellow Jackets,S. Ogbonda,3904627,,False,1.0,0,0,0,0,0,0,0,0,0,0,0,0,0,0,0,1,0
400915436,Georgia Tech Yellow Jackets,K. McCormick,61453,,False,4.0,0,1,0,0,0,1,0,0,0,1,1,0,0,0,0,0,0
400915436,Georgia Tech Yellow Jackets,J. Moore,4065662,,False,27.0,1,5,0,3,1,2,2,3,0,8,8,6,1,1,1,3,5
400915436,Georgia Tech Yellow Jackets,T. Jackson,3135057,,False,34.0,12,21,10,16,2,5,3,3,0,1,1,1,1,0,1,3,29
400915436,Georgia Tech Yellow Jackets,TEAM,TOTAL,TOTAL,False,,24,59,21,45,3,14,14,21,4,41,45,18,7,7,14,13,65
400915436,Georgia Tech Yellow Jackets,Q. Stephens,66128,,True,5.0,0,1,0,0,0,1,0,0,0,0,0,0,0,0,0,0,0
400915436,Georgia Tech Yellow Jackets,B. Lammers,3135061,,True,39.0,6,13,6,13,0,0,2,5,4,13,17,4,1,3,5,1,14
400915436,Georgia Tech Yellow Jackets,J. Okogie,4065663,,True,39.0,3,11,3,9,0,2,6,8,0,12,12,0,2,2,1,2,12
400915436,Georgia Tech Yellow Jackets,J. Heath,67623,,True,38.0,2,5,2,3,0,2,1,2,0,0,0,7,1,1,4,2,5
400915436,Georgia Tech Yellow Jackets,C. Heyward,61609,,True,10.0,0,1,0,0,0,1,0,0,0,1,1,0,1,0,1,1,0
400915436,Georgia Tech Yellow Jackets,C. Matthews,4065665,,False,3.0,0,1,0,1,0,0,0,0,0,1,1,0,0,0,0,0,0
400915436,Georgia Tech Yellow Jackets,S. Ogbonda,3904627,,False,1.0,0,0,0,0,0,0,0,0,0,0,0,0,0,0,0,1,0
400915436,Georgia Tech Yellow Jackets,K. McCormick,61453,,False,4.0,0,1,0,0,0,1,0,0,0,1,1,0,0,0,0,0,0
400915436,Georgia Tech Yellow Jackets,J. Moore,4065662,,False,27.0,1,5,0,3,1,2,2,3,0,8,8,6,1,1,1,3,5
400915436,Georgia Tech Yellow Jackets,T. Jackson,3135057,,False,34.0,12,21,10,16,2,5,3,3,0,1,1,1,1,0,1,3,29
400915436,Georgia Tech Yellow Jackets,TEAM,TOTAL,TOTAL,False,,24,59,21,45,3,14,14,21,4,41,45,18,7,7,14,13,65
400915436,Boston College Eagles,A.J. Turner,3943608,,True,31.0,2,11,1,3,1,8,0,0,0,4,4,0,0,0,1,0,5
400915436,Boston College Eagles,M. Jeffers,61901,,True,26.0,3,9,3,9,0,0,0,2,4,4,8,1,2,1,3,3,6
400915436,Boston College Eagles,K. Bowman,4065635,,True,38.0,5,8,3,6,2,2,1,3,0,7,7,2,3,0,3,3,13
400915436,Boston College Eagles,J. Robinson,3943606,,True,28.0,7,16,6,13,1,3,2,3,1,2,3,2,3,0,1,5,17
400915436,Boston College Eagles,J. Chatman,3135095,,True,33.0,0,8,0,4,0,4,2,2,1,3,4,1,1,0,1,4,2
400915436,Boston College Eagles,M. Sagay,4065638,,False,8.0,1,4,1,4,0,0,0,0,1,2,3,0,0,0,0,0,2
400915436,Boston College Eagles,N. Popovic,4065637,,False,12.0,1,6,1,6,0,0,1,2,0,2,2,0,0,0,1,0,3
400915436,Boston College Eagles,E. Meznieks,3943607,,False,6.0,0,0,0,0,0,0,0,0,0,1,1,1,1,0,0,0,0
400915436,Boston College Eagles,C. Tava,61446,,False,18.0,3,5,3,4,0,1,0,0,0,8,8,1,0,0,3,1,6
400915436,Boston College Eagles,TEAM,TOTAL,TOTAL,False,,22,67,18,49,4,18,6,12,8,34,42,8,10,1,14,16,54
400915436,Boston College Eagles,A.J. Turner,3943608,,True,31.0,2,11,1,3,1,8,0,0,0,4,4,0,0,0,1,0,5
400915436,Boston College Eagles,M. Jeffers,61901,,True,26.0,3,9,3,9,0,0,0,2,4,4,8,1,2,1,3,3,6
400915436,Boston College Eagles,K. Bowman,4065635,,True,38.0,5,8,3,6,2,2,1,3,0,7,7,2,3,0,3,3,13
400915436,Boston College Eagles,J. Robinson,3943606,,True,28.0,7,16,6,13,1,3,2,3,1,2,3,2,3,0,1,5,17
400915436,Boston College Eagles,J. Chatman,3135095,,True,33.0,0,8,0,4,0,4,2,2,1,3,4,1,1,0,1,4,2
400915436,Boston College Eagles,M. Sagay,4065638,,False,8.0,1,4,1,4,0,0,0,0,1,2,3,0,0,0,0,0,2
400915436,Boston College Eagles,N. Popovic,4065637,,False,12.0,1,6,1,6,0,0,1,2,0,2,2,0,0,0,1,0,3
400915436,Boston College Eagles,E. Meznieks,3943607,,False,6.0,0,0,0,0,0,0,0,0,0,1,1,1,1,0,0,0,0
400915436,Boston College Eagles,C. Tava,61446,,False,18.0,3,5,3,4,0,1,0,0,0,8,8,1,0,0,3,1,6
400915436,Boston College Eagles,TEAM,TOTAL,TOTAL,False,,22,67,18,49,4,18,6,12,8,34,42,8,10,1,14,16,54
400915435,Notre Dame Fighting Irish,B. Colson,3138192,,True,35.0,12,18,11,16,1,2,8,8,2,11,13,1,2,1,1,3,33
400915435,Notre Dame Fighting Irish,V.J. Beachem,66283,,True,37.0,3,9,1,4,2,5,1,2,1,3,4,0,0,2,2,3,9
400915435,Notre Dame Fighting Irish,T. Gibbs,4065703,,True,21.0,0,4,0,2,0,2,5,6,1,3,4,2,1,0,1,4,5
400915435,Notre Dame Fighting Irish,M. Farrell,3138190,,True,37.0,5,13,2,5,3,8,2,2,0,5,5,9,1,1,3,0,15
400915435,Notre Dame Fighting Irish,S. Vasturia,66285,,True,38.0,6,10,6,6,0,4,3,3,0,7,7,2,2,0,2,2,15
400915435,Notre Dame Fighting Irish,M. Geben,3138191,,False,2.0,0,0,0,0,0,0,0,0,0,0,0,0,0,0,0,0,0
400915435,Notre Dame Fighting Irish,A. Torres,66286,,False,2.0,0,0,0,0,0,0,0,0,1,0,1,0,0,0,1,1,0
400915435,Notre Dame Fighting Irish,M. Ryan,3908336,,False,3.0,0,0,0,0,0,0,0,0,0,0,0,0,0,0,0,0,0
400915435,Notre Dame Fighting Irish,R. Pflueger,3908335,,False,25.0,3,5,2,4,1,1,0,0,0,2,2,1,0,0,2,4,7
400915435,Notre Dame Fighting Irish,TEAM,TOTAL,TOTAL,False,,29,59,22,37,7,22,19,21,7,34,41,15,6,4,13,17,84
400915435,Notre Dame Fighting Irish,B. Colson,3138192,,True,35.0,12,18,11,16,1,2,8,8,2,11,13,1,2,1,1,3,33
400915435,Notre Dame Fighting Irish,V.J. Beachem,66283,,True,37.0,3,9,1,4,2,5,1,2,1,3,4,0,0,2,2,3,9
400915435,Notre Dame Fighting Irish,T. Gibbs,4065703,,True,21.0,0,4,0,2,0,2,5,6,1,3,4,2,1,0,1,4,5
400915435,Notre Dame Fighting Irish,M. Farrell,3138190,,True,37.0,5,13,2,5,3,8,2,2,0,5,5,9,1,1,3,0,15
400915435,Notre Dame Fighting Irish,S. Vasturia,66285,,True,38.0,6,10,6,6,0,4,3,3,0,7,7,2,2,0,2,2,15
400915435,Notre Dame Fighting Irish,M. Geben,3138191,,False,2.0,0,0,0,0,0,0,0,0,0,0,0,0,0,0,0,0,0
400915435,Notre Dame Fighting Irish,A. Torres,66286,,False,2.0,0,0,0,0,0,0,0,0,1,0,1,0,0,0,1,1,0
400915435,Notre Dame Fighting Irish,M. Ryan,3908336,,False,3.0,0,0,0,0,0,0,0,0,0,0,0,0,0,0,0,0,0
400915435,Notre Dame Fighting Irish,R. Pflueger,3908335,,False,25.0,3,5,2,4,1,1,0,0,0,2,2,1,0,0,2,4,7
400915435,Notre Dame Fighting Irish,TEAM,TOTAL,TOTAL,False,,29,59,22,37,7,22,19,21,7,34,41,15,6,4,13,17,84
400915435,Florida State Seminoles,J. Isaac,4065654,,True,32.0,2,6,2,4,0,2,0,0,1,5,6,1,3,1,2,2,4
400915435,Florida State Seminoles,M. Ojo,61596,,True,9.0,1,2,1,2,0,0,0,0,0,3,3,0,0,1,1,2,2
400915435,Florida State Seminoles,T. Mann,3907823,,True,33.0,7,9,7,9,0,0,1,2,2,2,4,1,1,1,1,0,15
400915435,Florida State Seminoles,D. Bacon,3907821,,True,30.0,5,13,5,9,0,4,2,6,0,6,6,1,0,0,0,2,12
400915435,Florida State Seminoles,X. Rathan-Mayes,66125,,True,27.0,4,10,3,6,1,4,2,7,0,1,1,3,1,1,2,3,11
400915435,Florida State Seminoles,P. Cofer,3135054,,False,12.0,0,2,0,1,0,1,0,0,1,0,1,0,0,0,1,3,0
400915435,Florida State Seminoles,J. Smith,66126,,False,17.0,3,5,3,5,0,0,0,0,1,4,5,0,0,2,0,3,6
400915435,Florida State Seminoles,C. Koumadje,3907824,,False,1.0,0,0,0,0,0,0,0,0,0,0,0,0,0,0,0,1,0
400915435,Florida State Seminoles,B. Angola-Rodas,4065658,,False,3.0,1,1,1,1,0,0,0,0,0,0,0,0,0,0,1,0,2
400915435,Florida State Seminoles,P. Savoy,4065657,,False,2.0,0,0,0,0,0,0,0,0,0,0,0,0,0,0,0,0,0
400915435,Florida State Seminoles,T. Forrest,4065656,,False,19.0,5,8,5,8,0,0,2,6,2,2,4,1,2,0,0,0,12
400915435,Florida State Seminoles,C. Walker,4065655,,False,15.0,3,10,1,6,2,4,0,1,1,2,3,3,1,0,1,3,8
400915435,Florida State Seminoles,TEAM,TOTAL,TOTAL,False,,31,66,28,51,3,15,7,22,9,25,34,10,8,6,9,19,72
400915435,Florida State Seminoles,J. Isaac,4065654,,True,32.0,2,6,2,4,0,2,0,0,1,5,6,1,3,1,2,2,4
400915435,Florida State Seminoles,M. Ojo,61596,,True,9.0,1,2,1,2,0,0,0,0,0,3,3,0,0,1,1,2,2
400915435,Florida State Seminoles,T. Mann,3907823,,True,33.0,7,9,7,9,0,0,1,2,2,2,4,1,1,1,1,0,15
400915435,Florida State Seminoles,D. Bacon,3907821,,True,30.0,5,13,5,9,0,4,2,6,0,6,6,1,0,0,0,2,12
400915435,Florida State Seminoles,X. Rathan-Mayes,66125,,True,27.0,4,10,3,6,1,4,2,7,0,1,1,3,1,1,2,3,11
400915435,Florida State Seminoles,P. Cofer,3135054,,False,12.0,0,2,0,1,0,1,0,0,1,0,1,0,0,0,1,3,0
400915435,Florida State Seminoles,J. Smith,66126,,False,17.0,3,5,3,5,0,0,0,0,1,4,5,0,0,2,0,3,6
400915435,Florida State Seminoles,C. Koumadje,3907824,,False,1.0,0,0,0,0,0,0,0,0,0,0,0,0,0,0,0,1,0
400915435,Florida State Seminoles,B. Angola-Rodas,4065658,,False,3.0,1,1,1,1,0,0,0,0,0,0,0,0,0,0,1,0,2
400915435,Florida State Seminoles,P. Savoy,4065657,,False,2.0,0,0,0,0,0,0,0,0,0,0,0,0,0,0,0,0,0
400915435,Florida State Seminoles,T. Forrest,4065656,,False,19.0,5,8,5,8,0,0,2,6,2,2,4,1,2,0,0,0,12
400915435,Florida State Seminoles,C. Walker,4065655,,False,15.0,3,10,1,6,2,4,0,1,1,2,3,3,1,0,1,3,8
400915435,Florida State Seminoles,TEAM,TOTAL,TOTAL,False,,31,66,28,51,3,15,7,22,9,25,34,10,8,6,9,19,72
400915434,Duke Blue Devils,J. Tatum,4065648,,True,39.0,3,8,2,5,1,3,2,2,1,6,7,2,0,1,2,1,9
400915434,Duke Blue Devils,A. Jefferson,61586,,True,29.0,3,5,3,5,0,0,0,1,2,7,9,3,0,2,1,4,6
400915434,Duke Blue Devils,L. Kennard,3913174,,True,36.0,7,16,3,8,4,8,7,9,0,4,4,1,1,0,1,3,25
400915434,Duke Blue Devils,G. Allen,3135045,,True,32.0,2,10,0,3,2,7,2,3,0,3,3,5,0,0,3,3,8
400915434,Duke Blue Devils,M. Jones,66563,,True,38.0,2,4,0,0,2,4,0,0,1,1,2,1,1,0,0,1,6
400915434,Duke Blue Devils,H. Giles III,4065649,,False,10.0,0,1,0,1,0,0,0,0,1,4,5,0,0,2,1,1,0
400915434,Duke Blue Devils,M. Bolden,4065652,,False,2.0,1,1,1,1,0,0,0,0,0,0,0,0,0,0,0,2,2
400915434,Duke Blue Devils,F. Jackson,4065651,,False,14.0,3,5,1,1,2,4,0,0,0,2,2,1,0,0,2,1,8
400915434,Duke Blue Devils,TEAM,TOTAL,TOTAL,False,,21,50,10,24,11,26,11,15,5,29,34,13,2,5,10,16,64
400915434,Duke Blue Devils,J. Tatum,4065648,,True,39.0,3,8,2,5,1,3,2,2,1,6,7,2,0,1,2,1,9
400915434,Duke Blue Devils,A. Jefferson,61586,,True,29.0,3,5,3,5,0,0,0,1,2,7,9,3,0,2,1,4,6
400915434,Duke Blue Devils,L. Kennard,3913174,,True,36.0,7,16,3,8,4,8,7,9,0,4,4,1,1,0,1,3,25
400915434,Duke Blue Devils,G. Allen,3135045,,True,32.0,2,10,0,3,2,7,2,3,0,3,3,5,0,0,3,3,8
400915434,Duke Blue Devils,M. Jones,66563,,True,38.0,2,4,0,0,2,4,0,0,1,1,2,1,1,0,0,1,6
400915434,Duke Blue Devils,H. Giles III,4065649,,False,10.0,0,1,0,1,0,0,0,0,1,4,5,0,0,2,1,1,0
400915434,Duke Blue Devils,M. Bolden,4065652,,False,2.0,1,1,1,1,0,0,0,0,0,0,0,0,0,0,0,2,2
400915434,Duke Blue Devils,F. Jackson,4065651,,False,14.0,3,5,1,1,2,4,0,0,0,2,2,1,0,0,2,1,8
400915434,Duke Blue Devils,TEAM,TOTAL,TOTAL,False,,21,50,10,24,11,26,11,15,5,29,34,13,2,5,10,16,64
400915434,Clemson Tigers,E. Thomas,3947075,,True,30.0,5,7,5,7,0,0,5,7,2,7,9,1,0,2,0,3,15
400915434,Clemson Tigers,D. Grantham,3129674,,True,31.0,0,6,0,5,0,1,0,0,1,4,5,2,1,1,1,2,0
400915434,Clemson Tigers,J. Blossomgame,61835,,True,39.0,3,12,3,11,0,1,1,2,3,6,9,2,2,0,2,3,7
400915434,Clemson Tigers,S. Mitchell,3136699,,True,35.0,8,15,6,13,2,2,5,6,2,1,3,1,1,0,0,0,23
400915434,Clemson Tigers,A. Holmes,62043,,True,16.0,0,3,0,2,0,1,2,2,0,0,0,0,1,0,0,1,2
400915434,Clemson Tigers,S. Djitte,66122,,False,10.0,1,2,1,2,0,0,1,1,2,3,5,0,0,0,0,3,3
400915434,Clemson Tigers,M. Reed,3133969,,False,22.0,3,9,3,6,0,3,2,2,0,2,2,0,2,0,0,2,8
400915434,Clemson Tigers,G. DeVoe,3129673,,False,17.0,2,4,2,3,0,1,0,0,0,4,4,0,0,0,3,3,4
400915434,Clemson Tigers,TEAM,TOTAL,TOTAL,False,,22,58,20,49,2,9,16,20,11,27,38,6,7,3,7,17,62
400915434,Clemson Tigers,E. Thomas,3947075,,True,30.0,5,7,5,7,0,0,5,7,2,7,9,1,0,2,0,3,15
400915434,Clemson Tigers,D. Grantham,3129674,,True,31.0,0,6,0,5,0,1,0,0,1,4,5,2,1,1,1,2,0
400915434,Clemson Tigers,J. Blossomgame,61835,,True,39.0,3,12,3,11,0,1,1,2,3,6,9,2,2,0,2,3,7
400915434,Clemson Tigers,S. Mitchell,3136699,,True,35.0,8,15,6,13,2,2,5,6,2,1,3,1,1,0,0,0,23
400915434,Clemson Tigers,A. Holmes,62043,,True,16.0,0,3,0,2,0,1,2,2,0,0,0,0,1,0,0,1,2
400915434,Clemson Tigers,S. Djitte,66122,,False,10.0,1,2,1,2,0,0,1,1,2,3,5,0,0,0,0,3,3
400915434,Clemson Tigers,M. Reed,3133969,,False,22.0,3,9,3,6,0,3,2,2,0,2,2,0,2,0,0,2,8
400915434,Clemson Tigers,G. DeVoe,3129673,,False,17.0,2,4,2,3,0,1,0,0,0,4,4,0,0,0,3,3,4
400915434,Clemson Tigers,TEAM,TOTAL,TOTAL,False,,22,58,20,49,2,9,16,20,11,27,38,6,7,3,7,17,62
400915433,Syracuse Orange,T. Thompson,4065721,,True,16.0,2,2,2,2,0,0,0,2,1,1,2,0,0,1,1,3,4
400915433,Syracuse Orange,T. Lydon,3934662,,True,40.0,3,7,2,5,1,2,1,2,3,3,6,3,0,0,3,4,8
400915433,Syracuse Orange,T. Battle,4065722,,True,16.0,1,5,1,4,0,1,1,2,0,2,2,0,1,0,1,2,3
400915433,Syracuse Orange,J. Gillon,61915,,True,39.0,7,15,6,9,1,6,5,5,0,4,4,4,3,0,3,3,20
400915433,Syracuse Orange,A. White III,61616,,True,40.0,7,16,4,8,3,8,3,3,1,3,4,2,2,1,1,2,20
400915433,Syracuse Orange,T. Roberson,67633,,False,24.0,3,6,3,6,0,0,2,2,2,3,5,0,0,0,1,2,8
400915433,Syracuse Orange,F. Howard,3934659,,False,25.0,3,9,2,6,1,3,5,5,1,0,1,2,1,0,0,3,12
400915433,Syracuse Orange,TEAM,TOTAL,TOTAL,False,,26,60,20,40,6,20,17,21,9,16,25,11,7,2,10,19,75
400915433,Syracuse Orange,T. Thompson,4065721,,True,16.0,2,2,2,2,0,0,0,2,1,1,2,0,0,1,1,3,4
400915433,Syracuse Orange,T. Lydon,3934662,,True,40.0,3,7,2,5,1,2,1,2,3,3,6,3,0,0,3,4,8
400915433,Syracuse Orange,T. Battle,4065722,,True,16.0,1,5,1,4,0,1,1,2,0,2,2,0,1,0,1,2,3
400915433,Syracuse Orange,J. Gillon,61915,,True,39.0,7,15,6,9,1,6,5,5,0,4,4,4,3,0,3,3,20
400915433,Syracuse Orange,A. White III,61616,,True,40.0,7,16,4,8,3,8,3,3,1,3,4,2,2,1,1,2,20
400915433,Syracuse Orange,T. Roberson,67633,,False,24.0,3,6,3,6,0,0,2,2,2,3,5,0,0,0,1,2,8
400915433,Syracuse Orange,F. Howard,3934659,,False,25.0,3,9,2,6,1,3,5,5,1,0,1,2,1,0,0,3,12
400915433,Syracuse Orange,TEAM,TOTAL,TOTAL,False,,26,60,20,40,6,20,17,21,9,16,25,11,7,2,10,19,75
400915433,Pittsburgh Panthers,M. Young,66290,,True,39.0,7,13,7,12,0,1,7,9,3,6,9,6,0,0,3,1,21
400915433,Pittsburgh Panthers,S. Jeter,61756,,True,37.0,6,11,6,11,0,0,2,3,5,6,11,3,2,1,4,4,14
400915433,Pittsburgh Panthers,J. Artis,66287,,True,37.0,5,10,4,5,1,5,5,6,1,2,3,10,0,2,3,1,16
400915433,Pittsburgh Panthers,C. Johnson,3138196,,True,35.0,6,9,0,1,6,8,4,4,0,5,5,1,2,0,2,4,22
400915433,Pittsburgh Panthers,C. Jones,61219,,True,34.0,2,8,1,6,1,2,2,2,1,2,3,3,1,1,2,2,7
400915433,Pittsburgh Panthers,R. Nix,3934653,,False,5.0,0,1,0,1,0,0,0,0,2,0,2,0,0,1,1,3,0
400915433,Pittsburgh Panthers,J. Kithcart,4065713,,False,13.0,0,2,0,0,0,2,0,0,1,1,2,2,0,0,1,3,0
400915433,Pittsburgh Panthers,TEAM,TOTAL,TOTAL,False,,26,54,18,36,8,18,20,24,15,26,41,25,5,5,17,18,80
400915433,Pittsburgh Panthers,M. Young,66290,,True,39.0,7,13,7,12,0,1,7,9,3,6,9,6,0,0,3,1,21
400915433,Pittsburgh Panthers,S. Jeter,61756,,True,37.0,6,11,6,11,0,0,2,3,5,6,11,3,2,1,4,4,14
400915433,Pittsburgh Panthers,J. Artis,66287,,True,37.0,5,10,4,5,1,5,5,6,1,2,3,10,0,2,3,1,16
400915433,Pittsburgh Panthers,C. Johnson,3138196,,True,35.0,6,9,0,1,6,8,4,4,0,5,5,1,2,0,2,4,22
400915433,Pittsburgh Panthers,C. Jones,61219,,True,34.0,2,8,1,6,1,2,2,2,1,2,3,3,1,1,2,2,7
400915433,Pittsburgh Panthers,R. Nix,3934653,,False,5.0,0,1,0,1,0,0,0,0,2,0,2,0,0,1,1,3,0
400915433,Pittsburgh Panthers,J. Kithcart,4065713,,False,13.0,0,2,0,0,0,2,0,0,1,1,2,2,0,0,1,3,0
400915433,Pittsburgh Panthers,TEAM,TOTAL,TOTAL,False,,26,54,18,36,8,18,20,24,15,26,41,25,5,5,17,18,80
400915432,Wake Forest Demon Deacons,J. Collins,3908845,,True,26.0,9,13,9,13,0,0,5,8,2,5,7,1,0,2,1,2,23
400915432,Wake Forest Demon Deacons,D. Mitoglou,3138224,,True,25.0,2,4,2,4,0,0,1,2,1,3,4,2,0,1,0,3,5
400915432,Wake Forest Demon Deacons,A. Arians,61378,,True,25.0,4,5,2,2,2,3,0,0,1,4,5,2,0,0,1,2,10
400915432,Wake Forest Demon Deacons,B. Crawford,3908844,,True,25.0,6,8,3,3,3,5,2,3,0,3,3,3,0,0,1,2,17
400915432,Wake Forest Demon Deacons,K. Woods,3132360,,True,26.0,7,14,2,7,5,7,0,0,0,5,5,4,2,0,1,0,19
400915432,Wake Forest Demon Deacons,R. Washington,4065753,,False,2.0,0,3,0,1,0,2,0,0,0,0,0,0,0,0,0,0,0
400915432,Wake Forest Demon Deacons,D. Mitchell,4065751,,False,3.0,1,1,1,1,0,0,0,0,0,0,0,0,0,0,0,0,2
400915432,Wake Forest Demon Deacons,T. Rike,3155405,,False,1.0,0,0,0,0,0,0,0,0,0,0,0,0,0,0,0,0,0
400915432,Wake Forest Demon Deacons,S. Japhet-Mathias,4065752,,False,2.0,0,1,0,1,0,0,0,0,1,2,3,0,0,0,1,0,0
400915432,Wake Forest Demon Deacons,D. Moore,3908843,,False,14.0,1,2,1,2,0,0,1,2,0,2,2,0,0,1,0,3,3
400915432,Wake Forest Demon Deacons,B. Childress,4065750,,False,24.0,2,5,1,3,1,2,0,0,0,4,4,3,0,1,1,1,5
400915432,Wake Forest Demon Deacons,M. Wilbekin,3138222,,False,25.0,1,5,1,1,0,4,2,2,0,5,5,1,2,0,1,2,4
400915432,Wake Forest Demon Deacons,T. VanHorn,3078214,,False,2.0,0,0,0,0,0,0,0,0,0,0,0,0,0,0,0,0,0
400915432,Wake Forest Demon Deacons,TEAM,TOTAL,TOTAL,False,,33,61,22,38,11,23,11,17,5,34,39,16,4,5,8,15,88
400915432,Wake Forest Demon Deacons,J. Collins,3908845,,True,26.0,9,13,9,13,0,0,5,8,2,5,7,1,0,2,1,2,23
400915432,Wake Forest Demon Deacons,D. Mitoglou,3138224,,True,25.0,2,4,2,4,0,0,1,2,1,3,4,2,0,1,0,3,5
400915432,Wake Forest Demon Deacons,A. Arians,61378,,True,25.0,4,5,2,2,2,3,0,0,1,4,5,2,0,0,1,2,10
400915432,Wake Forest Demon Deacons,B. Crawford,3908844,,True,25.0,6,8,3,3,3,5,2,3,0,3,3,3,0,0,1,2,17
400915432,Wake Forest Demon Deacons,K. Woods,3132360,,True,26.0,7,14,2,7,5,7,0,0,0,5,5,4,2,0,1,0,19
400915432,Wake Forest Demon Deacons,R. Washington,4065753,,False,2.0,0,3,0,1,0,2,0,0,0,0,0,0,0,0,0,0,0
400915432,Wake Forest Demon Deacons,D. Mitchell,4065751,,False,3.0,1,1,1,1,0,0,0,0,0,0,0,0,0,0,0,0,2
400915432,Wake Forest Demon Deacons,T. Rike,3155405,,False,1.0,0,0,0,0,0,0,0,0,0,0,0,0,0,0,0,0,0
400915432,Wake Forest Demon Deacons,S. Japhet-Mathias,4065752,,False,2.0,0,1,0,1,0,0,0,0,1,2,3,0,0,0,1,0,0
400915432,Wake Forest Demon Deacons,D. Moore,3908843,,False,14.0,1,2,1,2,0,0,1,2,0,2,2,0,0,1,0,3,3
400915432,Wake Forest Demon Deacons,B. Childress,4065750,,False,24.0,2,5,1,3,1,2,0,0,0,4,4,3,0,1,1,1,5
400915432,Wake Forest Demon Deacons,M. Wilbekin,3138222,,False,25.0,1,5,1,1,0,4,2,2,0,5,5,1,2,0,1,2,4
400915432,Wake Forest Demon Deacons,T. VanHorn,3078214,,False,2.0,0,0,0,0,0,0,0,0,0,0,0,0,0,0,0,0,0
400915432,Wake Forest Demon Deacons,TEAM,TOTAL,TOTAL,False,,33,61,22,38,11,23,11,17,5,34,39,16,4,5,8,15,88
400915432,NC State Wolfpack,A. Abu,3138158,,True,23.0,4,9,4,9,0,0,1,4,0,3,3,1,0,0,1,2,9
400915432,NC State Wolfpack,O. Yurtseven,66768,,True,19.0,1,4,1,4,0,0,2,2,0,4,4,1,0,1,2,3,4
400915432,NC State Wolfpack,D. Smith Jr.,4065697,,True,34.0,7,13,6,11,1,2,2,2,2,1,3,3,0,0,4,2,17
400915432,NC State Wolfpack,M. Rowan,3947151,,True,35.0,2,9,1,4,1,5,2,2,0,4,4,1,1,0,1,2,7
400915432,NC State Wolfpack,T. Henderson,61215,,True,29.0,1,10,1,5,0,5,0,0,1,0,1,2,1,0,1,2,2
400915432,NC State Wolfpack,T. Kapita,4065701,,False,8.0,1,2,1,2,0,0,0,0,1,0,1,0,0,0,2,1,2
400915432,NC State Wolfpack,B. Anya,66134,,False,14.0,1,1,1,1,0,0,1,2,2,1,3,0,1,0,0,4,3
400915432,NC State Wolfpack,M. Johnson,4065699,,False,9.0,0,3,0,2,0,1,0,0,1,1,2,0,0,0,1,1,0
400915432,NC State Wolfpack,T. Dorn,3132359,,False,29.0,5,11,5,9,0,2,4,5,2,9,11,0,0,0,1,1,14
400915432,NC State Wolfpack,TEAM,TOTAL,TOTAL,False,,22,62,20,47,2,15,12,17,9,25,34,8,3,1,13,18,58
400915432,NC State Wolfpack,A. Abu,3138158,,True,23.0,4,9,4,9,0,0,1,4,0,3,3,1,0,0,1,2,9
400915432,NC State Wolfpack,O. Yurtseven,66768,,True,19.0,1,4,1,4,0,0,2,2,0,4,4,1,0,1,2,3,4
400915432,NC State Wolfpack,D. Smith Jr.,4065697,,True,34.0,7,13,6,11,1,2,2,2,2,1,3,3,0,0,4,2,17
400915432,NC State Wolfpack,M. Rowan,3947151,,True,35.0,2,9,1,4,1,5,2,2,0,4,4,1,1,0,1,2,7
400915432,NC State Wolfpack,T. Henderson,61215,,True,29.0,1,10,1,5,0,5,0,0,1,0,1,2,1,0,1,2,2
400915432,NC State Wolfpack,T. Kapita,4065701,,False,8.0,1,2,1,2,0,0,0,0,1,0,1,0,0,0,2,1,2
400915432,NC State Wolfpack,B. Anya,66134,,False,14.0,1,1,1,1,0,0,1,2,2,1,3,0,1,0,0,4,3
400915432,NC State Wolfpack,M. Johnson,4065699,,False,9.0,0,3,0,2,0,1,0,0,1,1,2,0,0,0,1,1,0
400915432,NC State Wolfpack,T. Dorn,3132359,,False,29.0,5,11,5,9,0,2,4,5,2,9,11,0,0,0,1,1,14
400915432,NC State Wolfpack,TEAM,TOTAL,TOTAL,False,,22,62,20,47,2,15,12,17,9,25,34,8,3,1,13,18,58
400915431,North Carolina Tar Heels,K. Meeks,66873,,True,27.0,4,7,4,7,0,0,1,1,1,4,5,1,0,1,0,2,9
400915431,North Carolina Tar Heels,L. Maye,3911620,,True,20.0,4,8,4,7,0,1,0,0,0,2,2,2,0,0,0,3,8
400915431,North Carolina Tar Heels,J. Jackson,3138156,,True,36.0,8,13,6,9,2,4,3,5,2,3,5,0,2,0,2,1,21
400915431,North Carolina Tar Heels,K. Williams,3911619,,True,20.0,0,1,0,1,0,0,0,0,0,2,2,0,0,0,0,0,0
400915431,North Carolina Tar Heels,J. Berry II,3138155,,True,32.0,5,13,3,6,2,7,3,5,1,2,3,2,2,0,1,2,15
400915431,North Carolina Tar Heels,T. Bradley,4065673,,False,14.0,3,3,3,3,0,0,2,4,1,2,3,0,0,0,1,1,8
400915431,North Carolina Tar Heels,T. Pinson,3138154,,False,19.0,3,9,3,9,0,0,0,1,1,6,7,3,0,1,0,2,6
400915431,North Carolina Tar Heels,S. Woods,4065676,,False,8.0,2,3,2,3,0,0,0,0,0,1,1,4,0,0,0,0,4
400915431,North Carolina Tar Heels,B. Robinson,4065675,,False,4.0,0,0,0,0,0,0,0,0,0,0,0,0,0,0,0,1,0
400915431,North Carolina Tar Heels,N. Britt,66872,,False,20.0,3,4,3,4,0,0,1,2,0,1,1,1,1,0,1,3,7
400915431,North Carolina Tar Heels,TEAM,TOTAL,TOTAL,False,,32,61,28,49,4,12,10,18,7,23,30,13,5,2,5,15,78
400915431,North Carolina Tar Heels,K. Meeks,66873,,True,27.0,4,7,4,7,0,0,1,1,1,4,5,1,0,1,0,2,9
400915431,North Carolina Tar Heels,L. Maye,3911620,,True,20.0,4,8,4,7,0,1,0,0,0,2,2,2,0,0,0,3,8
400915431,North Carolina Tar Heels,J. Jackson,3138156,,True,36.0,8,13,6,9,2,4,3,5,2,3,5,0,2,0,2,1,21
400915431,North Carolina Tar Heels,K. Williams,3911619,,True,20.0,0,1,0,1,0,0,0,0,0,2,2,0,0,0,0,0,0
400915431,North Carolina Tar Heels,J. Berry II,3138155,,True,32.0,5,13,3,6,2,7,3,5,1,2,3,2,2,0,1,2,15
400915431,North Carolina Tar Heels,T. Bradley,4065673,,False,14.0,3,3,3,3,0,0,2,4,1,2,3,0,0,0,1,1,8
400915431,North Carolina Tar Heels,T. Pinson,3138154,,False,19.0,3,9,3,9,0,0,0,1,1,6,7,3,0,1,0,2,6
400915431,North Carolina Tar Heels,S. Woods,4065676,,False,8.0,2,3,2,3,0,0,0,0,0,1,1,4,0,0,0,0,4
400915431,North Carolina Tar Heels,B. Robinson,4065675,,False,4.0,0,0,0,0,0,0,0,0,0,0,0,0,0,0,0,1,0
400915431,North Carolina Tar Heels,N. Britt,66872,,False,20.0,3,4,3,4,0,0,1,2,0,1,1,1,1,0,1,3,7
400915431,North Carolina Tar Heels,TEAM,TOTAL,TOTAL,False,,32,61,28,49,4,12,10,18,7,23,30,13,5,2,5,15,78
400915431,Duke Blue Devils,J. Tatum,4065648,,True,32.0,5,14,3,8,2,6,7,8,1,8,9,5,0,2,2,2,19
400915431,Duke Blue Devils,A. Jefferson,61586,,True,30.0,0,3,0,3,0,0,2,2,2,4,6,1,0,0,0,4,2
400915431,Duke Blue Devils,L. Kennard,3913174,,True,36.0,8,15,6,10,2,5,2,2,0,4,4,3,0,0,2,3,20
400915431,Duke Blue Devils,G. Allen,3135045,,True,30.0,9,15,2,3,7,12,0,0,0,3,3,3,1,0,3,5,25
400915431,Duke Blue Devils,M. Jones,66563,,True,35.0,1,3,0,0,1,3,0,0,3,0,3,2,2,1,2,1,3
400915431,Duke Blue Devils,H. Giles III,4065649,,False,10.0,3,3,3,3,0,0,0,0,0,2,2,0,0,1,1,1,6
400915431,Duke Blue Devils,M. Bolden,4065652,,False,7.0,0,0,0,0,0,0,0,0,0,1,1,0,0,1,0,2,0
400915431,Duke Blue Devils,F. Jackson,4065651,,False,20.0,4,4,3,3,1,1,2,4,1,2,3,1,0,1,0,1,11
400915431,Duke Blue Devils,TEAM,TOTAL,TOTAL,False,,30,57,17,30,13,27,13,16,7,24,31,15,3,6,10,19,86
400915431,Duke Blue Devils,J. Tatum,4065648,,True,32.0,5,14,3,8,2,6,7,8,1,8,9,5,0,2,2,2,19
400915431,Duke Blue Devils,A. Jefferson,61586,,True,30.0,0,3,0,3,0,0,2,2,2,4,6,1,0,0,0,4,2
400915431,Duke Blue Devils,L. Kennard,3913174,,True,36.0,8,15,6,10,2,5,2,2,0,4,4,3,0,0,2,3,20
400915431,Duke Blue Devils,G. Allen,3135045,,True,30.0,9,15,2,3,7,12,0,0,0,3,3,3,1,0,3,5,25
400915431,Duke Blue Devils,M. Jones,66563,,True,35.0,1,3,0,0,1,3,0,0,3,0,3,2,2,1,2,1,3
400915431,Duke Blue Devils,H. Giles III,4065649,,False,10.0,3,3,3,3,0,0,0,0,0,2,2,0,0,1,1,1,6
400915431,Duke Blue Devils,M. Bolden,4065652,,False,7.0,0,0,0,0,0,0,0,0,0,1,1,0,0,1,0,2,0
400915431,Duke Blue Devils,F. Jackson,4065651,,False,20.0,4,4,3,3,1,1,2,4,1,2,3,1,0,1,0,1,11
400915431,Duke Blue Devils,TEAM,TOTAL,TOTAL,False,,30,57,17,30,13,27,13,16,7,24,31,15,3,6,10,19,86
400915430,Virginia Tech Hokies,K. Sy,4065740,,True,10.0,0,0,0,0,0,0,2,2,0,4,4,0,0,1,0,1,2
400915430,Virginia Tech Hokies,C. Clarke,3945567,,True,36.0,5,9,5,9,0,0,3,4,1,4,5,4,2,0,3,2,13
400915430,Virginia Tech Hokies,J. Robinson,3945566,,True,30.0,4,8,3,6,1,2,6,7,0,3,3,2,1,0,2,1,15
400915430,Virginia Tech Hokies,A. Hill,3147501,,True,32.0,3,9,2,4,1,5,5,5,1,4,5,1,0,0,2,1,12
400915430,Virginia Tech Hokies,J. Bibbs,3147500,,True,29.0,2,4,0,0,2,4,0,0,0,1,1,0,0,0,0,4,6
400915430,Virginia Tech Hokies,Z. LeDay,61698,,False,30.0,4,6,4,6,0,0,2,4,1,9,10,2,0,0,4,2,10
400915430,Virginia Tech Hokies,T. Outlaw,67275,,False,10.0,0,1,0,0,0,1,0,0,0,0,0,0,0,0,0,2,0
400915430,Virginia Tech Hokies,S. Allen,61795,,False,23.0,4,9,4,8,0,1,2,3,0,0,0,3,2,0,3,2,10
400915430,Virginia Tech Hokies,TEAM,TOTAL,TOTAL,False,,22,46,18,33,4,13,20,25,4,28,32,12,5,1,15,15,68
400915430,Virginia Tech Hokies,K. Sy,4065740,,True,10.0,0,0,0,0,0,0,2,2,0,4,4,0,0,1,0,1,2
400915430,Virginia Tech Hokies,C. Clarke,3945567,,True,36.0,5,9,5,9,0,0,3,4,1,4,5,4,2,0,3,2,13
400915430,Virginia Tech Hokies,J. Robinson,3945566,,True,30.0,4,8,3,6,1,2,6,7,0,3,3,2,1,0,2,1,15
400915430,Virginia Tech Hokies,A. Hill,3147501,,True,32.0,3,9,2,4,1,5,5,5,1,4,5,1,0,0,2,1,12
400915430,Virginia Tech Hokies,J. Bibbs,3147500,,True,29.0,2,4,0,0,2,4,0,0,0,1,1,0,0,0,0,4,6
400915430,Virginia Tech Hokies,Z. LeDay,61698,,False,30.0,4,6,4,6,0,0,2,4,1,9,10,2,0,0,4,2,10
400915430,Virginia Tech Hokies,T. Outlaw,67275,,False,10.0,0,1,0,0,0,1,0,0,0,0,0,0,0,0,0,2,0
400915430,Virginia Tech Hokies,S. Allen,61795,,False,23.0,4,9,4,8,0,1,2,3,0,0,0,3,2,0,3,2,10
400915430,Virginia Tech Hokies,TEAM,TOTAL,TOTAL,False,,22,46,18,33,4,13,20,25,4,28,32,12,5,1,15,15,68
400915430,Miami Hurricanes,D. Hernandez,4065672,,True,14.0,1,5,1,4,0,1,1,2,3,2,5,0,0,3,0,2,3
400915430,Miami Hurricanes,K. Murphy,61668,,True,29.0,5,6,5,6,0,0,0,1,1,4,5,0,1,1,0,3,10
400915430,Miami Hurricanes,B. Brown,4065670,,True,32.0,1,12,1,7,0,5,0,0,0,5,5,4,1,0,2,3,2
400915430,Miami Hurricanes,J. Newton,3138145,,True,33.0,7,15,7,14,0,1,2,4,0,4,4,1,1,0,5,3,16
400915430,Miami Hurricanes,D. Reed,66130,,True,34.0,4,8,0,0,4,8,6,6,1,2,3,6,1,0,2,2,18
400915430,Miami Hurricanes,E. Izundu,3904629,,False,19.0,4,6,4,6,0,0,0,0,1,0,1,1,0,1,0,2,8
400915430,Miami Hurricanes,A. Lawrence II,3904628,,False,29.0,5,7,3,3,2,4,0,0,1,3,4,3,2,0,0,2,12
400915430,Miami Hurricanes,D. Vasiljevic,4065669,,False,10.0,2,5,1,3,1,2,0,0,0,1,1,0,0,0,0,0,5
400915430,Miami Hurricanes,TEAM,TOTAL,TOTAL,False,,29,64,22,43,7,21,9,13,10,22,32,15,6,5,10,17,74
400915430,Miami Hurricanes,D. Hernandez,4065672,,True,14.0,1,5,1,4,0,1,1,2,3,2,5,0,0,3,0,2,3
400915430,Miami Hurricanes,K. Murphy,61668,,True,29.0,5,6,5,6,0,0,0,1,1,4,5,0,1,1,0,3,10
400915430,Miami Hurricanes,B. Brown,4065670,,True,32.0,1,12,1,7,0,5,0,0,0,5,5,4,1,0,2,3,2
400915430,Miami Hurricanes,J. Newton,3138145,,True,33.0,7,15,7,14,0,1,2,4,0,4,4,1,1,0,5,3,16
400915430,Miami Hurricanes,D. Reed,66130,,True,34.0,4,8,0,0,4,8,6,6,1,2,3,6,1,0,2,2,18
400915430,Miami Hurricanes,E. Izundu,3904629,,False,19.0,4,6,4,6,0,0,0,0,1,0,1,1,0,1,0,2,8
400915430,Miami Hurricanes,A. Lawrence II,3904628,,False,29.0,5,7,3,3,2,4,0,0,1,3,4,3,2,0,0,2,12
400915430,Miami Hurricanes,D. Vasiljevic,4065669,,False,10.0,2,5,1,3,1,2,0,0,0,1,1,0,0,0,0,0,5
400915430,Miami Hurricanes,TEAM,TOTAL,TOTAL,False,,29,64,22,43,7,21,9,13,10,22,32,15,6,5,10,17,74
400915429,Pittsburgh Panthers,M. Young,66290,,True,38.0,11,19,9,14,2,5,6,8,2,5,7,2,1,2,1,2,30
400915429,Pittsburgh Panthers,J. Artis,66287,,True,23.0,2,6,2,4,0,2,2,2,1,3,4,4,0,0,3,3,6
400915429,Pittsburgh Panthers,S. Jeter,61756,,True,38.0,5,9,4,7,1,2,6,8,2,6,8,1,1,1,1,2,17
400915429,Pittsburgh Panthers,C. Johnson,3138196,,True,37.0,2,8,1,4,1,4,2,2,0,4,4,4,2,1,1,1,7
400915429,Pittsburgh Panthers,C. Jones,61219,,True,33.0,3,5,3,4,0,1,8,9,1,4,5,3,0,0,1,2,14
400915429,Pittsburgh Panthers,R. Nix,3934653,,False,3.0,0,0,0,0,0,0,0,0,1,0,1,0,0,0,0,1,0
400915429,Pittsburgh Panthers,C. Manigault,4065714,,False,2.0,0,0,0,0,0,0,0,0,0,1,1,0,0,0,0,2,0
400915429,Pittsburgh Panthers,J. Kithcart,4065713,,False,19.0,3,3,0,0,3,3,0,0,0,0,0,1,0,0,1,0,9
400915429,Pittsburgh Panthers,D. Wilson,3934652,,False,7.0,0,0,0,0,0,0,0,0,0,1,1,0,0,0,0,1,0
400915429,Pittsburgh Panthers,TEAM,TOTAL,TOTAL,False,,26,50,19,33,7,17,24,29,9,25,34,15,4,4,9,14,83
400915429,Pittsburgh Panthers,M. Young,66290,,True,38.0,11,19,9,14,2,5,6,8,2,5,7,2,1,2,1,2,30
400915429,Pittsburgh Panthers,J. Artis,66287,,True,23.0,2,6,2,4,0,2,2,2,1,3,4,4,0,0,3,3,6
400915429,Pittsburgh Panthers,S. Jeter,61756,,True,38.0,5,9,4,7,1,2,6,8,2,6,8,1,1,1,1,2,17
400915429,Pittsburgh Panthers,C. Johnson,3138196,,True,37.0,2,8,1,4,1,4,2,2,0,4,4,4,2,1,1,1,7
400915429,Pittsburgh Panthers,C. Jones,61219,,True,33.0,3,5,3,4,0,1,8,9,1,4,5,3,0,0,1,2,14
400915429,Pittsburgh Panthers,R. Nix,3934653,,False,3.0,0,0,0,0,0,0,0,0,1,0,1,0,0,0,0,1,0
400915429,Pittsburgh Panthers,C. Manigault,4065714,,False,2.0,0,0,0,0,0,0,0,0,0,1,1,0,0,0,0,2,0
400915429,Pittsburgh Panthers,J. Kithcart,4065713,,False,19.0,3,3,0,0,3,3,0,0,0,0,0,1,0,0,1,0,9
400915429,Pittsburgh Panthers,D. Wilson,3934652,,False,7.0,0,0,0,0,0,0,0,0,0,1,1,0,0,0,0,1,0
400915429,Pittsburgh Panthers,TEAM,TOTAL,TOTAL,False,,26,50,19,33,7,17,24,29,9,25,34,15,4,4,9,14,83
400915429,Boston College Eagles,M. Jeffers,61901,,True,20.0,7,9,7,9,0,0,0,1,1,1,2,0,0,0,1,4,14
400915429,Boston College Eagles,C. Tava,61446,,True,26.0,1,3,1,2,0,1,1,2,0,9,9,2,0,1,2,4,3
400915429,Boston College Eagles,K. Bowman,4065635,,True,33.0,5,9,1,2,4,7,1,2,0,2,2,6,0,0,1,3,15
400915429,Boston College Eagles,J. Robinson,3943606,,True,38.0,8,17,6,12,2,5,4,7,0,2,2,4,2,0,3,5,22
400915429,Boston College Eagles,J. Chatman,3135095,,True,35.0,2,5,1,2,1,3,2,2,1,1,2,2,0,0,1,0,7
400915429,Boston College Eagles,N. Popovic,4065637,,False,17.0,4,7,4,7,0,0,0,0,2,2,4,0,0,0,0,2,8
400915429,Boston College Eagles,A.J. Turner,3943608,,False,20.0,0,4,0,0,0,4,0,0,0,1,1,2,0,0,0,1,0
400915429,Boston College Eagles,E. Meznieks,3943607,,False,11.0,1,1,0,0,1,1,0,0,1,1,2,1,1,1,1,1,3
400915429,Boston College Eagles,TEAM,TOTAL,TOTAL,False,,28,55,20,34,8,21,8,14,6,19,25,17,3,2,9,20,72
400915429,Boston College Eagles,M. Jeffers,61901,,True,20.0,7,9,7,9,0,0,0,1,1,1,2,0,0,0,1,4,14
400915429,Boston College Eagles,C. Tava,61446,,True,26.0,1,3,1,2,0,1,1,2,0,9,9,2,0,1,2,4,3
400915429,Boston College Eagles,K. Bowman,4065635,,True,33.0,5,9,1,2,4,7,1,2,0,2,2,6,0,0,1,3,15
400915429,Boston College Eagles,J. Robinson,3943606,,True,38.0,8,17,6,12,2,5,4,7,0,2,2,4,2,0,3,5,22
400915429,Boston College Eagles,J. Chatman,3135095,,True,35.0,2,5,1,2,1,3,2,2,1,1,2,2,0,0,1,0,7
400915429,Boston College Eagles,N. Popovic,4065637,,False,17.0,4,7,4,7,0,0,0,0,2,2,4,0,0,0,0,2,8
400915429,Boston College Eagles,A.J. Turner,3943608,,False,20.0,0,4,0,0,0,4,0,0,0,1,1,2,0,0,0,1,0
400915429,Boston College Eagles,E. Meznieks,3943607,,False,11.0,1,1,0,0,1,1,0,0,1,1,2,1,1,1,1,1,3
400915429,Boston College Eagles,TEAM,TOTAL,TOTAL,False,,28,55,20,34,8,21,8,14,6,19,25,17,3,2,9,20,72
400915428,NC State Wolfpack,A. Abu,3138158,,True,36.0,6,11,6,11,0,0,4,7,0,6,6,0,0,0,0,4,16
400915428,NC State Wolfpack,O. Yurtseven,66768,,True,19.0,3,7,3,6,0,1,0,0,2,3,5,3,0,0,3,5,6
400915428,NC State Wolfpack,M. Rowan,3947151,,True,32.0,7,13,6,8,1,5,1,1,1,2,3,1,0,1,1,2,16
400915428,NC State Wolfpack,D. Smith Jr.,4065697,,True,35.0,4,8,4,7,0,1,0,1,1,1,2,6,0,0,3,2,8
400915428,NC State Wolfpack,T. Henderson,61215,,True,37.0,6,14,2,3,4,11,1,2,0,1,1,1,0,0,1,3,17
400915428,NC State Wolfpack,T. Kapita,4065701,,False,10.0,0,0,0,0,0,0,0,0,0,1,1,2,0,0,1,3,0
400915428,NC State Wolfpack,D. Hicks,4065698,,False,3.0,0,1,0,0,0,1,0,2,0,0,0,0,0,0,0,1,0
400915428,NC State Wolfpack,M. Johnson,4065699,,False,11.0,0,0,0,0,0,0,0,0,0,1,1,0,0,1,1,1,0
400915428,NC State Wolfpack,T. Dorn,3132359,,False,17.0,2,6,2,4,0,2,4,4,2,1,3,0,0,0,1,2,8
400915428,NC State Wolfpack,TEAM,TOTAL,TOTAL,False,,28,60,23,39,5,21,10,17,8,17,25,13,0,2,11,23,71
400915428,NC State Wolfpack,A. Abu,3138158,,True,36.0,6,11,6,11,0,0,4,7,0,6,6,0,0,0,0,4,16
400915428,NC State Wolfpack,O. Yurtseven,66768,,True,19.0,3,7,3,6,0,1,0,0,2,3,5,3,0,0,3,5,6
400915428,NC State Wolfpack,M. Rowan,3947151,,True,32.0,7,13,6,8,1,5,1,1,1,2,3,1,0,1,1,2,16
400915428,NC State Wolfpack,D. Smith Jr.,4065697,,True,35.0,4,8,4,7,0,1,0,1,1,1,2,6,0,0,3,2,8
400915428,NC State Wolfpack,T. Henderson,61215,,True,37.0,6,14,2,3,4,11,1,2,0,1,1,1,0,0,1,3,17
400915428,NC State Wolfpack,T. Kapita,4065701,,False,10.0,0,0,0,0,0,0,0,0,0,1,1,2,0,0,1,3,0
400915428,NC State Wolfpack,D. Hicks,4065698,,False,3.0,0,1,0,0,0,1,0,2,0,0,0,0,0,0,0,1,0
400915428,NC State Wolfpack,M. Johnson,4065699,,False,11.0,0,0,0,0,0,0,0,0,0,1,1,0,0,1,1,1,0
400915428,NC State Wolfpack,T. Dorn,3132359,,False,17.0,2,6,2,4,0,2,4,4,2,1,3,0,0,0,1,2,8
400915428,NC State Wolfpack,TEAM,TOTAL,TOTAL,False,,28,60,23,39,5,21,10,17,8,17,25,13,0,2,11,23,71
400915428,Florida State Seminoles,J. Isaac,4065654,,True,24.0,6,10,5,8,1,2,8,11,4,3,7,0,1,1,1,2,21
400915428,Florida State Seminoles,M. Ojo,61596,,True,21.0,4,7,4,7,0,0,3,4,4,2,6,3,2,1,0,2,11
400915428,Florida State Seminoles,T. Mann,3907823,,True,23.0,4,7,4,6,0,1,0,1,6,4,10,5,0,0,0,1,8
400915428,Florida State Seminoles,D. Bacon,3907821,,True,30.0,6,15,4,8,2,7,5,7,1,8,9,2,0,1,2,2,19
400915428,Florida State Seminoles,X. Rathan-Mayes,66125,,True,29.0,4,7,4,6,0,1,0,2,0,3,3,4,2,0,1,2,8
400915428,Florida State Seminoles,P. Cofer,3135054,,False,14.0,3,5,1,3,2,2,0,0,0,1,1,1,0,1,0,1,8
400915428,Florida State Seminoles,J. Smith,66126,,False,11.0,0,4,0,4,0,0,0,0,3,1,4,1,0,1,1,2,0
400915428,Florida State Seminoles,B. Allen,66124,,False,2.0,1,1,1,1,0,0,0,0,0,0,0,0,0,0,0,1,2
400915428,Florida State Seminoles,C. Koumadje,3907824,,False,9.0,2,2,2,2,0,0,1,2,1,1,2,0,0,1,0,1,5
400915428,Florida State Seminoles,B. Angola-Rodas,4065658,,False,7.0,1,2,1,2,0,0,2,2,1,1,2,1,0,0,0,2,4
400915428,Florida State Seminoles,P. Savoy,4065657,,False,10.0,2,4,0,0,2,4,0,0,0,0,0,0,0,0,0,0,6
400915428,Florida State Seminoles,T. Forrest,4065656,,False,9.0,1,3,1,3,0,0,1,2,0,0,0,1,0,0,1,0,3
400915428,Florida State Seminoles,C. Walker,4065655,,False,11.0,0,3,0,2,0,1,0,0,1,2,3,2,0,0,1,0,0
400915428,Florida State Seminoles,TEAM,TOTAL,TOTAL,False,,34,70,27,52,7,18,20,31,21,28,49,20,5,6,7,16,95
400915428,Florida State Seminoles,J. Isaac,4065654,,True,24.0,6,10,5,8,1,2,8,11,4,3,7,0,1,1,1,2,21
400915428,Florida State Seminoles,M. Ojo,61596,,True,21.0,4,7,4,7,0,0,3,4,4,2,6,3,2,1,0,2,11
400915428,Florida State Seminoles,T. Mann,3907823,,True,23.0,4,7,4,6,0,1,0,1,6,4,10,5,0,0,0,1,8
400915428,Florida State Seminoles,D. Bacon,3907821,,True,30.0,6,15,4,8,2,7,5,7,1,8,9,2,0,1,2,2,19
400915428,Florida State Seminoles,X. Rathan-Mayes,66125,,True,29.0,4,7,4,6,0,1,0,2,0,3,3,4,2,0,1,2,8
400915428,Florida State Seminoles,P. Cofer,3135054,,False,14.0,3,5,1,3,2,2,0,0,0,1,1,1,0,1,0,1,8
400915428,Florida State Seminoles,J. Smith,66126,,False,11.0,0,4,0,4,0,0,0,0,3,1,4,1,0,1,1,2,0
400915428,Florida State Seminoles,B. Allen,66124,,False,2.0,1,1,1,1,0,0,0,0,0,0,0,0,0,0,0,1,2
400915428,Florida State Seminoles,C. Koumadje,3907824,,False,9.0,2,2,2,2,0,0,1,2,1,1,2,0,0,1,0,1,5
400915428,Florida State Seminoles,B. Angola-Rodas,4065658,,False,7.0,1,2,1,2,0,0,2,2,1,1,2,1,0,0,0,2,4
400915428,Florida State Seminoles,P. Savoy,4065657,,False,10.0,2,4,0,0,2,4,0,0,0,0,0,0,0,0,0,0,6
400915428,Florida State Seminoles,T. Forrest,4065656,,False,9.0,1,3,1,3,0,0,1,2,0,0,0,1,0,0,1,0,3
400915428,Florida State Seminoles,C. Walker,4065655,,False,11.0,0,3,0,2,0,1,0,0,1,2,3,2,0,0,1,0,0
400915428,Florida State Seminoles,TEAM,TOTAL,TOTAL,False,,34,70,27,52,7,18,20,31,21,28,49,20,5,6,7,16,95
400915427,Wake Forest Demon Deacons,J. Collins,3908845,,True,33.0,9,19,9,19,0,0,6,8,9,5,14,1,1,1,2,2,24
400915427,Wake Forest Demon Deacons,D. Mitoglou,3138224,,True,22.0,2,6,2,6,0,0,1,2,4,3,7,0,0,1,4,2,5
400915427,Wake Forest Demon Deacons,A. Arians,61378,,True,25.0,4,8,2,2,2,6,0,0,0,2,2,2,0,0,0,4,10
400915427,Wake Forest Demon Deacons,B. Crawford,3908844,,True,34.0,6,14,3,8,3,6,4,5,0,4,4,5,2,0,1,3,19
400915427,Wake Forest Demon Deacons,K. Woods,3132360,,True,34.0,6,12,3,7,3,5,1,1,0,5,5,3,0,0,2,3,16
400915427,Wake Forest Demon Deacons,D. Moore,3908843,,False,7.0,1,2,1,2,0,0,0,0,0,2,2,0,0,1,0,2,2
400915427,Wake Forest Demon Deacons,B. Childress,4065750,,False,20.0,0,3,0,2,0,1,0,0,0,1,1,1,0,0,0,0,0
400915427,Wake Forest Demon Deacons,M. Wilbekin,3138222,,False,25.0,0,6,0,3,0,3,5,5,1,2,3,5,0,0,0,2,5
400915427,Wake Forest Demon Deacons,TEAM,TOTAL,TOTAL,False,,28,70,20,49,8,21,17,21,17,26,43,17,3,3,9,18,81
400915427,Wake Forest Demon Deacons,J. Collins,3908845,,True,33.0,9,19,9,19,0,0,6,8,9,5,14,1,1,1,2,2,24
400915427,Wake Forest Demon Deacons,D. Mitoglou,3138224,,True,22.0,2,6,2,6,0,0,1,2,4,3,7,0,0,1,4,2,5
400915427,Wake Forest Demon Deacons,A. Arians,61378,,True,25.0,4,8,2,2,2,6,0,0,0,2,2,2,0,0,0,4,10
400915427,Wake Forest Demon Deacons,B. Crawford,3908844,,True,34.0,6,14,3,8,3,6,4,5,0,4,4,5,2,0,1,3,19
400915427,Wake Forest Demon Deacons,K. Woods,3132360,,True,34.0,6,12,3,7,3,5,1,1,0,5,5,3,0,0,2,3,16
400915427,Wake Forest Demon Deacons,D. Moore,3908843,,False,7.0,1,2,1,2,0,0,0,0,0,2,2,0,0,1,0,2,2
400915427,Wake Forest Demon Deacons,B. Childress,4065750,,False,20.0,0,3,0,2,0,1,0,0,0,1,1,1,0,0,0,0,0
400915427,Wake Forest Demon Deacons,M. Wilbekin,3138222,,False,25.0,0,6,0,3,0,3,5,5,1,2,3,5,0,0,0,2,5
400915427,Wake Forest Demon Deacons,TEAM,TOTAL,TOTAL,False,,28,70,20,49,8,21,17,21,17,26,43,17,3,3,9,18,81
400915427,Notre Dame Fighting Irish,B. Colson,3138192,,True,36.0,10,16,8,14,2,2,5,7,2,14,16,2,2,5,2,3,27
400915427,Notre Dame Fighting Irish,V.J. Beachem,66283,,True,36.0,7,14,2,2,5,12,0,0,0,1,1,0,2,4,0,0,19
400915427,Notre Dame Fighting Irish,R. Pflueger,3908335,,True,26.0,1,4,1,3,0,1,0,0,0,3,3,2,2,3,1,3,2
400915427,Notre Dame Fighting Irish,M. Farrell,3138190,,True,36.0,6,11,3,6,3,5,1,2,0,2,2,6,0,0,3,2,16
400915427,Notre Dame Fighting Irish,S. Vasturia,66285,,True,35.0,4,7,1,2,3,5,6,7,1,6,7,3,0,0,1,2,17
400915427,Notre Dame Fighting Irish,M. Geben,3138191,,False,4.0,0,1,0,1,0,0,0,0,1,0,1,0,0,0,0,3,0
400915427,Notre Dame Fighting Irish,A. Torres,66286,,False,2.0,0,1,0,1,0,0,0,0,1,0,1,0,0,0,0,0,0
400915427,Notre Dame Fighting Irish,M. Ryan,3908336,,False,3.0,0,0,0,0,0,0,0,0,0,0,0,0,0,0,0,0,0
400915427,Notre Dame Fighting Irish,T. Gibbs,4065703,,False,22.0,1,5,1,3,0,2,5,5,0,0,0,4,0,0,0,3,7
400915427,Notre Dame Fighting Irish,TEAM,TOTAL,TOTAL,False,,29,59,16,32,13,27,17,21,7,28,35,17,6,12,7,16,88
400915427,Notre Dame Fighting Irish,B. Colson,3138192,,True,36.0,10,16,8,14,2,2,5,7,2,14,16,2,2,5,2,3,27
400915427,Notre Dame Fighting Irish,V.J. Beachem,66283,,True,36.0,7,14,2,2,5,12,0,0,0,1,1,0,2,4,0,0,19
400915427,Notre Dame Fighting Irish,R. Pflueger,3908335,,True,26.0,1,4,1,3,0,1,0,0,0,3,3,2,2,3,1,3,2
400915427,Notre Dame Fighting Irish,M. Farrell,3138190,,True,36.0,6,11,3,6,3,5,1,2,0,2,2,6,0,0,3,2,16
400915427,Notre Dame Fighting Irish,S. Vasturia,66285,,True,35.0,4,7,1,2,3,5,6,7,1,6,7,3,0,0,1,2,17
400915427,Notre Dame Fighting Irish,M. Geben,3138191,,False,4.0,0,1,0,1,0,0,0,0,1,0,1,0,0,0,0,3,0
400915427,Notre Dame Fighting Irish,A. Torres,66286,,False,2.0,0,1,0,1,0,0,0,0,1,0,1,0,0,0,0,0,0
400915427,Notre Dame Fighting Irish,M. Ryan,3908336,,False,3.0,0,0,0,0,0,0,0,0,0,0,0,0,0,0,0,0,0
400915427,Notre Dame Fighting Irish,T. Gibbs,4065703,,False,22.0,1,5,1,3,0,2,5,5,0,0,0,4,0,0,0,3,7
400915427,Notre Dame Fighting Irish,TEAM,TOTAL,TOTAL,False,,29,59,16,32,13,27,17,21,7,28,35,17,6,12,7,16,88
400915426,Syracuse Orange,T. Thompson,4065721,,True,17.0,6,8,6,7,0,1,2,2,3,1,4,1,0,0,1,4,14
400915426,Syracuse Orange,T. Lydon,3934662,,True,40.0,7,12,7,9,0,3,3,4,3,6,9,2,1,0,5,3,17
400915426,Syracuse Orange,T. Battle,4065722,,True,33.0,2,7,0,1,2,6,0,0,0,1,1,0,0,0,2,2,6
400915426,Syracuse Orange,J. Gillon,61915,,True,40.0,2,5,0,2,2,3,7,7,0,2,2,8,2,0,0,2,13
400915426,Syracuse Orange,A. White III,61616,,True,40.0,8,20,3,8,5,12,2,2,1,4,5,0,1,0,2,2,23
400915426,Syracuse Orange,T. Roberson,67633,,False,22.0,3,4,3,4,0,0,0,2,2,5,7,2,0,0,0,1,6
400915426,Syracuse Orange,F. Howard,3934659,,False,8.0,1,1,0,0,1,1,0,0,1,2,3,2,0,0,2,2,3
400915426,Syracuse Orange,TEAM,TOTAL,TOTAL,False,,29,57,19,31,10,26,14,17,12,21,33,15,4,0,13,16,82
400915426,Syracuse Orange,T. Thompson,4065721,,True,17.0,6,8,6,7,0,1,2,2,3,1,4,1,0,0,1,4,14
400915426,Syracuse Orange,T. Lydon,3934662,,True,40.0,7,12,7,9,0,3,3,4,3,6,9,2,1,0,5,3,17
400915426,Syracuse Orange,T. Battle,4065722,,True,33.0,2,7,0,1,2,6,0,0,0,1,1,0,0,0,2,2,6
400915426,Syracuse Orange,J. Gillon,61915,,True,40.0,2,5,0,2,2,3,7,7,0,2,2,8,2,0,0,2,13
400915426,Syracuse Orange,A. White III,61616,,True,40.0,8,20,3,8,5,12,2,2,1,4,5,0,1,0,2,2,23
400915426,Syracuse Orange,T. Roberson,67633,,False,22.0,3,4,3,4,0,0,0,2,2,5,7,2,0,0,0,1,6
400915426,Syracuse Orange,F. Howard,3934659,,False,8.0,1,1,0,0,1,1,0,0,1,2,3,2,0,0,2,2,3
400915426,Syracuse Orange,TEAM,TOTAL,TOTAL,False,,29,57,19,31,10,26,14,17,12,21,33,15,4,0,13,16,82
400915426,Clemson Tigers,E. Thomas,3947075,,True,13.0,1,4,1,4,0,0,1,2,1,1,2,0,1,1,2,2,3
400915426,Clemson Tigers,D. Grantham,3129674,,True,23.0,4,5,2,2,2,3,0,0,0,3,3,0,1,0,2,2,10
400915426,Clemson Tigers,J. Blossomgame,61835,,True,37.0,7,11,7,10,0,1,6,6,0,4,4,0,0,0,1,3,20
400915426,Clemson Tigers,S. Mitchell,3136699,,True,33.0,3,9,2,5,1,4,3,4,1,2,3,8,0,0,0,1,10
400915426,Clemson Tigers,A. Holmes,62043,,True,31.0,4,8,1,1,3,7,2,2,0,1,1,3,1,0,1,1,13
400915426,Clemson Tigers,S. Djitte,66122,,False,27.0,3,4,3,4,0,0,0,1,4,7,11,1,1,0,1,3,6
400915426,Clemson Tigers,M. Reed,3133969,,False,16.0,3,4,2,3,1,1,2,2,0,0,0,6,3,0,0,2,9
400915426,Clemson Tigers,G. DeVoe,3129673,,False,20.0,4,9,2,3,2,6,0,0,0,0,0,1,0,0,1,1,10
400915426,Clemson Tigers,TEAM,TOTAL,TOTAL,False,,29,54,20,32,9,22,14,17,6,18,24,19,7,1,8,15,81
400915426,Clemson Tigers,E. Thomas,3947075,,True,13.0,1,4,1,4,0,0,1,2,1,1,2,0,1,1,2,2,3
400915426,Clemson Tigers,D. Grantham,3129674,,True,23.0,4,5,2,2,2,3,0,0,0,3,3,0,1,0,2,2,10
400915426,Clemson Tigers,J. Blossomgame,61835,,True,37.0,7,11,7,10,0,1,6,6,0,4,4,0,0,0,1,3,20
400915426,Clemson Tigers,S. Mitchell,3136699,,True,33.0,3,9,2,5,1,4,3,4,1,2,3,8,0,0,0,1,10
400915426,Clemson Tigers,A. Holmes,62043,,True,31.0,4,8,1,1,3,7,2,2,0,1,1,3,1,0,1,1,13
400915426,Clemson Tigers,S. Djitte,66122,,False,27.0,3,4,3,4,0,0,0,1,4,7,11,1,1,0,1,3,6
400915426,Clemson Tigers,M. Reed,3133969,,False,16.0,3,4,2,3,1,1,2,2,0,0,0,6,3,0,0,2,9
400915426,Clemson Tigers,G. DeVoe,3129673,,False,20.0,4,9,2,3,2,6,0,0,0,0,0,1,0,0,1,1,10
400915426,Clemson Tigers,TEAM,TOTAL,TOTAL,False,,29,54,20,32,9,22,14,17,6,18,24,19,7,1,8,15,81
400915425,Virginia Cavaliers,I. Wilkins,3138203,,True,37.0,5,7,5,7,0,0,3,3,6,5,11,1,0,5,2,2,13
400915425,Virginia Cavaliers,J. Salt,3138200,,True,19.0,2,2,2,2,0,0,0,0,2,4,6,0,0,1,2,3,4
400915425,Virginia Cavaliers,M. Shayok,3138201,,True,18.0,3,5,3,5,0,0,0,0,0,5,5,0,1,0,2,0,6
400915425,Virginia Cavaliers,L. Perrantes,66139,,True,34.0,5,12,3,5,2,7,6,7,1,3,4,3,0,0,1,0,18
400915425,Virginia Cavaliers,D. Hall,66138,,True,29.0,3,9,2,6,1,3,2,2,0,3,3,3,0,0,2,1,9
400915425,Virginia Cavaliers,M. Diakite,3947156,,False,16.0,3,3,3,3,0,0,0,0,0,1,1,0,0,2,1,4,6
400915425,Virginia Cavaliers,J. Reuter,3908374,,False,6.0,0,0,0,0,0,0,0,0,0,0,0,0,0,0,1,0,0
400915425,Virginia Cavaliers,T. Jerome,4065733,,False,14.0,0,1,0,0,0,1,3,3,0,1,1,2,1,0,2,2,3
400915425,Virginia Cavaliers,K. Guy,4065730,,False,5.0,0,1,0,1,0,0,2,3,0,0,0,0,0,0,0,0,2
400915425,Virginia Cavaliers,T. Gross Jr.,4065729,,False,1.0,0,0,0,0,0,0,0,0,0,0,0,0,0,0,0,0,0
400915425,Virginia Cavaliers,J. Bartley,3947155,,False,1.0,0,0,0,0,0,0,0,0,0,0,0,0,0,0,0,0,0
400915425,Virginia Cavaliers,D. Thompson,66274,,False,20.0,4,7,4,6,0,1,2,2,0,4,4,4,0,0,1,2,10
400915425,Virginia Cavaliers,TEAM,TOTAL,TOTAL,False,,25,47,22,35,3,12,18,20,9,29,38,13,2,8,14,14,71
400915425,Virginia Cavaliers,I. Wilkins,3138203,,True,37.0,5,7,5,7,0,0,3,3,6,5,11,1,0,5,2,2,13
400915425,Virginia Cavaliers,J. Salt,3138200,,True,19.0,2,2,2,2,0,0,0,0,2,4,6,0,0,1,2,3,4
400915425,Virginia Cavaliers,M. Shayok,3138201,,True,18.0,3,5,3,5,0,0,0,0,0,5,5,0,1,0,2,0,6
400915425,Virginia Cavaliers,L. Perrantes,66139,,True,34.0,5,12,3,5,2,7,6,7,1,3,4,3,0,0,1,0,18
400915425,Virginia Cavaliers,D. Hall,66138,,True,29.0,3,9,2,6,1,3,2,2,0,3,3,3,0,0,2,1,9
400915425,Virginia Cavaliers,M. Diakite,3947156,,False,16.0,3,3,3,3,0,0,0,0,0,1,1,0,0,2,1,4,6
400915425,Virginia Cavaliers,J. Reuter,3908374,,False,6.0,0,0,0,0,0,0,0,0,0,0,0,0,0,0,1,0,0
400915425,Virginia Cavaliers,T. Jerome,4065733,,False,14.0,0,1,0,0,0,1,3,3,0,1,1,2,1,0,2,2,3
400915425,Virginia Cavaliers,K. Guy,4065730,,False,5.0,0,1,0,1,0,0,2,3,0,0,0,0,0,0,0,0,2
400915425,Virginia Cavaliers,T. Gross Jr.,4065729,,False,1.0,0,0,0,0,0,0,0,0,0,0,0,0,0,0,0,0,0
400915425,Virginia Cavaliers,J. Bartley,3947155,,False,1.0,0,0,0,0,0,0,0,0,0,0,0,0,0,0,0,0,0
400915425,Virginia Cavaliers,D. Thompson,66274,,False,20.0,4,7,4,6,0,1,2,2,0,4,4,4,0,0,1,2,10
400915425,Virginia Cavaliers,TEAM,TOTAL,TOTAL,False,,25,47,22,35,3,12,18,20,9,29,38,13,2,8,14,14,71
400915425,Louisville Cardinals,V.J. King,4065666,,True,37.0,8,14,5,9,3,5,5,6,0,3,3,0,1,0,2,2,24
400915425,Louisville Cardinals,A. Mahmoud,3147363,,True,35.0,1,6,1,6,0,0,0,3,0,1,1,0,1,2,0,2,2
400915425,Louisville Cardinals,J. Johnson,3147362,,True,24.0,2,4,2,4,0,0,0,0,0,0,0,1,1,0,0,2,4
400915425,Louisville Cardinals,D. Mitchell,3908809,,True,38.0,6,17,6,12,0,5,4,4,1,3,4,3,4,0,2,1,16
400915425,Louisville Cardinals,D. Levitch,66592,,True,23.0,1,2,0,0,1,2,0,0,0,2,2,2,0,0,0,4,3
400915425,Louisville Cardinals,R. Spalding,3908806,,False,19.0,1,3,1,3,0,0,1,2,2,3,5,0,0,0,0,1,3
400915425,Louisville Cardinals,M. Stockman,3147361,,False,2.0,0,0,0,0,0,0,0,0,0,0,0,0,0,0,0,1,0
400915425,Louisville Cardinals,R. McMahon,3908808,,False,19.0,1,6,0,1,1,5,0,0,1,0,1,1,2,0,1,1,3
400915425,Louisville Cardinals,J. Henderson,3155491,,False,3.0,0,2,0,1,0,1,0,0,0,0,0,0,0,0,0,1,0
400915425,Louisville Cardinals,TEAM,TOTAL,TOTAL,False,,20,54,15,36,5,18,10,15,6,13,19,7,9,2,5,15,55
400915425,Louisville Cardinals,V.J. King,4065666,,True,37.0,8,14,5,9,3,5,5,6,0,3,3,0,1,0,2,2,24
400915425,Louisville Cardinals,A. Mahmoud,3147363,,True,35.0,1,6,1,6,0,0,0,3,0,1,1,0,1,2,0,2,2
400915425,Louisville Cardinals,J. Johnson,3147362,,True,24.0,2,4,2,4,0,0,0,0,0,0,0,1,1,0,0,2,4
400915425,Louisville Cardinals,D. Mitchell,3908809,,True,38.0,6,17,6,12,0,5,4,4,1,3,4,3,4,0,2,1,16
400915425,Louisville Cardinals,D. Levitch,66592,,True,23.0,1,2,0,0,1,2,0,0,0,2,2,2,0,0,0,4,3
400915425,Louisville Cardinals,R. Spalding,3908806,,False,19.0,1,3,1,3,0,0,1,2,2,3,5,0,0,0,0,1,3
400915425,Louisville Cardinals,M. Stockman,3147361,,False,2.0,0,0,0,0,0,0,0,0,0,0,0,0,0,0,0,1,0
400915425,Louisville Cardinals,R. McMahon,3908808,,False,19.0,1,6,0,1,1,5,0,0,1,0,1,1,2,0,1,1,3
400915425,Louisville Cardinals,J. Henderson,3155491,,False,3.0,0,2,0,1,0,1,0,0,0,0,0,0,0,0,0,1,0
400915425,Louisville Cardinals,TEAM,TOTAL,TOTAL,False,,20,54,15,36,5,18,10,15,6,13,19,7,9,2,5,15,55
400915424,Florida State Seminoles,J. Isaac,4065654,,True,19.0,1,4,1,2,0,2,0,0,2,3,5,0,1,1,1,3,2
400915424,Florida State Seminoles,M. Ojo,61596,,True,10.0,2,4,2,4,0,0,2,2,1,0,1,0,0,1,0,2,6
400915424,Florida State Seminoles,T. Mann,3907823,,True,17.0,4,6,3,5,1,1,2,2,2,2,4,4,1,0,1,1,11
400915424,Florida State Seminoles,D. Bacon,3907821,,True,26.0,10,14,4,5,6,9,3,3,0,3,3,2,0,0,3,0,29
400915424,Florida State Seminoles,X. Rathan-Mayes,66125,,True,25.0,3,6,3,4,0,2,0,0,0,2,2,9,2,0,1,1,6
400915424,Florida State Seminoles,P. Cofer,3135054,,False,17.0,2,3,1,1,1,2,1,2,0,1,1,0,0,0,1,2,6
400915424,Florida State Seminoles,J. Smith,66126,,False,12.0,1,1,1,1,0,0,0,0,0,3,3,1,1,0,2,2,2
400915424,Florida State Seminoles,B. Allen,66124,,False,7.0,3,4,0,1,3,3,0,0,0,0,0,0,0,1,0,1,9
400915424,Florida State Seminoles,C. Koumadje,3907824,,False,14.0,3,3,3,3,0,0,0,0,1,0,1,0,0,2,1,3,6
400915424,Florida State Seminoles,B. Angola-Rodas,4065658,,False,14.0,4,4,1,1,3,3,1,1,0,3,3,3,0,0,1,1,12
400915424,Florida State Seminoles,P. Savoy,4065657,,False,11.0,2,6,1,1,1,5,1,1,0,2,2,0,1,0,0,0,6
400915424,Florida State Seminoles,T. Forrest,4065656,,False,13.0,3,4,3,3,0,1,0,0,0,2,2,1,3,0,1,0,6
400915424,Florida State Seminoles,C. Walker,4065655,,False,15.0,3,3,1,1,2,2,0,1,0,0,0,6,0,0,1,2,8
400915424,Florida State Seminoles,TEAM,TOTAL,TOTAL,False,,41,62,24,32,17,30,10,12,7,22,29,26,9,5,14,18,109
400915424,Florida State Seminoles,J. Isaac,4065654,,True,19.0,1,4,1,2,0,2,0,0,2,3,5,0,1,1,1,3,2
400915424,Florida State Seminoles,M. Ojo,61596,,True,10.0,2,4,2,4,0,0,2,2,1,0,1,0,0,1,0,2,6
400915424,Florida State Seminoles,T. Mann,3907823,,True,17.0,4,6,3,5,1,1,2,2,2,2,4,4,1,0,1,1,11
400915424,Florida State Seminoles,D. Bacon,3907821,,True,26.0,10,14,4,5,6,9,3,3,0,3,3,2,0,0,3,0,29
400915424,Florida State Seminoles,X. Rathan-Mayes,66125,,True,25.0,3,6,3,4,0,2,0,0,0,2,2,9,2,0,1,1,6
400915424,Florida State Seminoles,P. Cofer,3135054,,False,17.0,2,3,1,1,1,2,1,2,0,1,1,0,0,0,1,2,6
400915424,Florida State Seminoles,J. Smith,66126,,False,12.0,1,1,1,1,0,0,0,0,0,3,3,1,1,0,2,2,2
400915424,Florida State Seminoles,B. Allen,66124,,False,7.0,3,4,0,1,3,3,0,0,0,0,0,0,0,1,0,1,9
400915424,Florida State Seminoles,C. Koumadje,3907824,,False,14.0,3,3,3,3,0,0,0,0,1,0,1,0,0,2,1,3,6
400915424,Florida State Seminoles,B. Angola-Rodas,4065658,,False,14.0,4,4,1,1,3,3,1,1,0,3,3,3,0,0,1,1,12
400915424,Florida State Seminoles,P. Savoy,4065657,,False,11.0,2,6,1,1,1,5,1,1,0,2,2,0,1,0,0,0,6
400915424,Florida State Seminoles,T. Forrest,4065656,,False,13.0,3,4,3,3,0,1,0,0,0,2,2,1,3,0,1,0,6
400915424,Florida State Seminoles,C. Walker,4065655,,False,15.0,3,3,1,1,2,2,0,1,0,0,0,6,0,0,1,2,8
400915424,Florida State Seminoles,TEAM,TOTAL,TOTAL,False,,41,62,24,32,17,30,10,12,7,22,29,26,9,5,14,18,109
400915424,Clemson Tigers,E. Thomas,3947075,,True,17.0,2,2,2,2,0,0,0,1,0,1,1,0,1,1,3,3,4
400915424,Clemson Tigers,D. Grantham,3129674,,True,25.0,2,7,1,2,1,5,0,0,1,5,6,1,1,1,3,3,5
400915424,Clemson Tigers,J. Blossomgame,61835,,True,32.0,4,11,2,7,2,4,1,2,1,2,3,2,1,0,3,0,11
400915424,Clemson Tigers,S. Mitchell,3136699,,True,20.0,0,5,0,4,0,1,0,0,1,2,3,3,0,0,4,0,0
400915424,Clemson Tigers,A. Holmes,62043,,True,22.0,4,8,0,3,4,5,3,4,0,0,0,1,0,0,0,2,15
400915424,Clemson Tigers,L. Robertin,3917985,,False,5.0,0,0,0,0,0,0,0,2,1,0,1,0,0,1,0,1,0
400915424,Clemson Tigers,S. Djitte,66122,,False,18.0,3,6,3,6,0,0,4,7,8,3,11,0,0,0,4,4,10
400915424,Clemson Tigers,T. Hudson,3917986,,False,11.0,0,2,0,1,0,1,0,0,0,0,0,2,0,0,2,0,0
400915424,Clemson Tigers,R. McGillan,3155393,,False,3.0,0,0,0,0,0,0,0,0,0,0,0,1,0,0,0,0,0
400915424,Clemson Tigers,M. Reed,3133969,,False,23.0,4,7,3,5,1,2,3,3,1,0,1,1,3,0,2,1,12
400915424,Clemson Tigers,G. DeVoe,3129673,,False,24.0,2,8,2,5,0,3,0,0,1,2,3,0,0,0,1,1,4
400915424,Clemson Tigers,TEAM,TOTAL,TOTAL,False,,21,56,13,35,8,21,11,19,15,15,30,11,6,3,22,15,61
400915424,Clemson Tigers,E. Thomas,3947075,,True,17.0,2,2,2,2,0,0,0,1,0,1,1,0,1,1,3,3,4
400915424,Clemson Tigers,D. Grantham,3129674,,True,25.0,2,7,1,2,1,5,0,0,1,5,6,1,1,1,3,3,5
400915424,Clemson Tigers,J. Blossomgame,61835,,True,32.0,4,11,2,7,2,4,1,2,1,2,3,2,1,0,3,0,11
400915424,Clemson Tigers,S. Mitchell,3136699,,True,20.0,0,5,0,4,0,1,0,0,1,2,3,3,0,0,4,0,0
400915424,Clemson Tigers,A. Holmes,62043,,True,22.0,4,8,0,3,4,5,3,4,0,0,0,1,0,0,0,2,15
400915424,Clemson Tigers,L. Robertin,3917985,,False,5.0,0,0,0,0,0,0,0,2,1,0,1,0,0,1,0,1,0
400915424,Clemson Tigers,S. Djitte,66122,,False,18.0,3,6,3,6,0,0,4,7,8,3,11,0,0,0,4,4,10
400915424,Clemson Tigers,T. Hudson,3917986,,False,11.0,0,2,0,1,0,1,0,0,0,0,0,2,0,0,2,0,0
400915424,Clemson Tigers,R. McGillan,3155393,,False,3.0,0,0,0,0,0,0,0,0,0,0,0,1,0,0,0,0,0
400915424,Clemson Tigers,M. Reed,3133969,,False,23.0,4,7,3,5,1,2,3,3,1,0,1,1,3,0,2,1,12
400915424,Clemson Tigers,G. DeVoe,3129673,,False,24.0,2,8,2,5,0,3,0,0,1,2,3,0,0,0,1,1,4
400915424,Clemson Tigers,TEAM,TOTAL,TOTAL,False,,21,56,13,35,8,21,11,19,15,15,30,11,6,3,22,15,61
400915422,Wake Forest Demon Deacons,J. Collins,3908845,,True,29.0,7,12,7,12,0,0,6,8,2,9,11,1,0,5,4,3,20
400915422,Wake Forest Demon Deacons,D. Mitoglou,3138224,,True,27.0,2,5,1,3,1,2,2,2,1,5,6,0,0,0,0,1,7
400915422,Wake Forest Demon Deacons,A. Arians,61378,,True,24.0,2,6,2,3,0,3,0,0,0,1,1,1,1,0,0,2,4
400915422,Wake Forest Demon Deacons,B. Crawford,3908844,,True,30.0,3,8,3,6,0,2,4,4,1,2,3,4,2,1,4,3,10
400915422,Wake Forest Demon Deacons,K. Woods,3132360,,True,23.0,4,8,2,4,2,4,2,2,0,4,4,1,1,0,2,4,12
400915422,Wake Forest Demon Deacons,R. Washington,4065753,,False,1.0,0,0,0,0,0,0,0,0,0,1,1,0,0,0,0,1,0
400915422,Wake Forest Demon Deacons,D. Moore,3908843,,False,9.0,0,0,0,0,0,0,1,2,1,1,2,0,0,0,0,4,1
400915422,Wake Forest Demon Deacons,B. Childress,4065750,,False,23.0,4,7,3,6,1,1,0,0,0,2,2,2,1,0,2,1,9
400915422,Wake Forest Demon Deacons,M. Wilbekin,3138222,,False,32.0,4,9,0,1,4,8,4,4,1,4,5,5,2,0,1,1,16
400915422,Wake Forest Demon Deacons,T. VanHorn,3078214,,False,2.0,0,1,0,1,0,0,2,2,1,0,1,0,0,0,0,0,2
400915422,Wake Forest Demon Deacons,TEAM,TOTAL,TOTAL,False,,26,56,18,36,8,20,21,24,9,29,38,14,7,6,13,20,81
400915422,Wake Forest Demon Deacons,J. Collins,3908845,,True,29.0,7,12,7,12,0,0,6,8,2,9,11,1,0,5,4,3,20
400915422,Wake Forest Demon Deacons,D. Mitoglou,3138224,,True,27.0,2,5,1,3,1,2,2,2,1,5,6,0,0,0,0,1,7
400915422,Wake Forest Demon Deacons,A. Arians,61378,,True,24.0,2,6,2,3,0,3,0,0,0,1,1,1,1,0,0,2,4
400915422,Wake Forest Demon Deacons,B. Crawford,3908844,,True,30.0,3,8,3,6,0,2,4,4,1,2,3,4,2,1,4,3,10
400915422,Wake Forest Demon Deacons,K. Woods,3132360,,True,23.0,4,8,2,4,2,4,2,2,0,4,4,1,1,0,2,4,12
400915422,Wake Forest Demon Deacons,R. Washington,4065753,,False,1.0,0,0,0,0,0,0,0,0,0,1,1,0,0,0,0,1,0
400915422,Wake Forest Demon Deacons,D. Moore,3908843,,False,9.0,0,0,0,0,0,0,1,2,1,1,2,0,0,0,0,4,1
400915422,Wake Forest Demon Deacons,B. Childress,4065750,,False,23.0,4,7,3,6,1,1,0,0,0,2,2,2,1,0,2,1,9
400915422,Wake Forest Demon Deacons,M. Wilbekin,3138222,,False,32.0,4,9,0,1,4,8,4,4,1,4,5,5,2,0,1,1,16
400915422,Wake Forest Demon Deacons,T. VanHorn,3078214,,False,2.0,0,1,0,1,0,0,2,2,1,0,1,0,0,0,0,0,2
400915422,Wake Forest Demon Deacons,TEAM,TOTAL,TOTAL,False,,26,56,18,36,8,20,21,24,9,29,38,14,7,6,13,20,81
400915422,Georgia Tech Yellow Jackets,Q. Stephens,66128,,True,36.0,5,10,1,3,4,7,0,2,1,10,11,0,1,0,0,4,14
400915422,Georgia Tech Yellow Jackets,B. Lammers,3135061,,True,26.0,2,7,2,7,0,0,3,4,3,4,7,1,0,3,3,4,7
400915422,Georgia Tech Yellow Jackets,J. Okogie,4065663,,True,30.0,6,15,6,13,0,2,11,13,1,1,2,4,0,0,2,4,23
400915422,Georgia Tech Yellow Jackets,J. Heath,67623,,True,29.0,2,9,1,3,1,6,1,1,0,2,2,2,1,0,5,0,6
400915422,Georgia Tech Yellow Jackets,C. Heyward,61609,,True,23.0,0,2,0,1,0,1,1,2,0,0,0,2,0,0,0,4,1
400915422,Georgia Tech Yellow Jackets,C. Matthews,4065665,,False,14.0,2,3,0,1,2,2,2,2,0,1,1,0,0,0,1,0,8
400915422,Georgia Tech Yellow Jackets,S. Ogbonda,3904627,,False,14.0,1,2,1,2,0,0,3,4,1,1,2,0,1,1,0,5,5
400915422,Georgia Tech Yellow Jackets,K. McCormick,61453,,False,4.0,1,1,0,0,1,1,0,0,0,0,0,0,0,0,0,0,3
400915422,Georgia Tech Yellow Jackets,T. Jackson,3135057,,False,23.0,1,7,1,6,0,1,0,0,1,3,4,3,2,1,2,1,2
400915422,Georgia Tech Yellow Jackets,J. Price,61778,,False,1.0,0,0,0,0,0,0,0,0,0,0,0,0,0,0,0,0,0
400915422,Georgia Tech Yellow Jackets,TEAM,TOTAL,TOTAL,False,,20,56,12,36,8,20,21,28,9,23,32,12,5,5,13,22,69
400915422,Georgia Tech Yellow Jackets,Q. Stephens,66128,,True,36.0,5,10,1,3,4,7,0,2,1,10,11,0,1,0,0,4,14
400915422,Georgia Tech Yellow Jackets,B. Lammers,3135061,,True,26.0,2,7,2,7,0,0,3,4,3,4,7,1,0,3,3,4,7
400915422,Georgia Tech Yellow Jackets,J. Okogie,4065663,,True,30.0,6,15,6,13,0,2,11,13,1,1,2,4,0,0,2,4,23
400915422,Georgia Tech Yellow Jackets,J. Heath,67623,,True,29.0,2,9,1,3,1,6,1,1,0,2,2,2,1,0,5,0,6
400915422,Georgia Tech Yellow Jackets,C. Heyward,61609,,True,23.0,0,2,0,1,0,1,1,2,0,0,0,2,0,0,0,4,1
400915422,Georgia Tech Yellow Jackets,C. Matthews,4065665,,False,14.0,2,3,0,1,2,2,2,2,0,1,1,0,0,0,1,0,8
400915422,Georgia Tech Yellow Jackets,S. Ogbonda,3904627,,False,14.0,1,2,1,2,0,0,3,4,1,1,2,0,1,1,0,5,5
400915422,Georgia Tech Yellow Jackets,K. McCormick,61453,,False,4.0,1,1,0,0,1,1,0,0,0,0,0,0,0,0,0,0,3
400915422,Georgia Tech Yellow Jackets,T. Jackson,3135057,,False,23.0,1,7,1,6,0,1,0,0,1,3,4,3,2,1,2,1,2
400915422,Georgia Tech Yellow Jackets,J. Price,61778,,False,1.0,0,0,0,0,0,0,0,0,0,0,0,0,0,0,0,0,0
400915422,Georgia Tech Yellow Jackets,TEAM,TOTAL,TOTAL,False,,20,56,12,36,8,20,21,28,9,23,32,12,5,5,13,22,69
400915421,NC State Wolfpack,A. Abu,3138158,,True,37.0,4,5,4,5,0,0,2,2,2,3,5,0,1,1,1,0,10
400915421,NC State Wolfpack,O. Yurtseven,66768,,True,28.0,3,8,3,8,0,0,4,4,0,4,4,2,1,5,0,2,10
400915421,NC State Wolfpack,D. Smith Jr.,4065697,,True,39.0,10,15,5,7,5,8,6,8,1,1,2,9,3,0,5,4,31
400915421,NC State Wolfpack,M. Rowan,3947151,,True,30.0,2,7,1,4,1,3,0,0,0,3,3,3,0,0,1,4,5
400915421,NC State Wolfpack,T. Henderson,61215,,True,38.0,7,10,2,4,5,6,2,3,1,3,4,1,0,1,3,0,21
400915421,NC State Wolfpack,T. Kapita,4065701,,False,2.0,0,0,0,0,0,0,0,0,0,0,0,0,0,0,0,0,0
400915421,NC State Wolfpack,B. Anya,66134,,False,9.0,0,0,0,0,0,0,0,0,0,2,2,0,0,4,0,1,0
400915421,NC State Wolfpack,M. Johnson,4065699,,False,2.0,0,0,0,0,0,0,0,0,0,0,0,0,0,0,0,0,0
400915421,NC State Wolfpack,T. Dorn,3132359,,False,15.0,1,3,1,2,0,1,0,0,0,0,0,0,0,0,1,1,2
400915421,NC State Wolfpack,TEAM,TOTAL,TOTAL,False,,27,48,16,30,11,18,14,17,5,16,21,15,5,11,11,12,79
400915421,NC State Wolfpack,A. Abu,3138158,,True,37.0,4,5,4,5,0,0,2,2,2,3,5,0,1,1,1,0,10
400915421,NC State Wolfpack,O. Yurtseven,66768,,True,28.0,3,8,3,8,0,0,4,4,0,4,4,2,1,5,0,2,10
400915421,NC State Wolfpack,D. Smith Jr.,4065697,,True,39.0,10,15,5,7,5,8,6,8,1,1,2,9,3,0,5,4,31
400915421,NC State Wolfpack,M. Rowan,3947151,,True,30.0,2,7,1,4,1,3,0,0,0,3,3,3,0,0,1,4,5
400915421,NC State Wolfpack,T. Henderson,61215,,True,38.0,7,10,2,4,5,6,2,3,1,3,4,1,0,1,3,0,21
400915421,NC State Wolfpack,T. Kapita,4065701,,False,2.0,0,0,0,0,0,0,0,0,0,0,0,0,0,0,0,0,0
400915421,NC State Wolfpack,B. Anya,66134,,False,9.0,0,0,0,0,0,0,0,0,0,2,2,0,0,4,0,1,0
400915421,NC State Wolfpack,M. Johnson,4065699,,False,2.0,0,0,0,0,0,0,0,0,0,0,0,0,0,0,0,0,0
400915421,NC State Wolfpack,T. Dorn,3132359,,False,15.0,1,3,1,2,0,1,0,0,0,0,0,0,0,0,1,1,2
400915421,NC State Wolfpack,TEAM,TOTAL,TOTAL,False,,27,48,16,30,11,18,14,17,5,16,21,15,5,11,11,12,79
400915421,Miami Hurricanes,D. Hernandez,4065672,,True,12.0,1,2,1,2,0,0,1,2,1,1,2,0,0,0,1,1,3
400915421,Miami Hurricanes,K. Murphy,61668,,True,18.0,0,1,0,1,0,0,0,0,3,2,5,0,0,0,1,0,0
400915421,Miami Hurricanes,B. Brown,4065670,,True,32.0,3,8,2,5,1,3,0,0,1,1,2,6,1,0,1,2,7
400915421,Miami Hurricanes,J. Newton,3138145,,True,34.0,5,15,5,13,0,2,3,4,1,2,3,5,2,0,2,1,13
400915421,Miami Hurricanes,D. Reed,66130,,True,36.0,9,17,2,7,7,10,1,1,1,6,7,3,1,0,2,2,26
400915421,Miami Hurricanes,E. Izundu,3904629,,False,27.0,6,9,6,9,0,0,4,5,4,2,6,0,1,1,2,5,16
400915421,Miami Hurricanes,A. Lawrence II,3904628,,False,32.0,7,9,4,4,3,5,2,2,1,3,4,2,0,1,1,1,19
400915421,Miami Hurricanes,D. Vasiljevic,4065669,,False,9.0,0,1,0,0,0,1,0,0,0,1,1,0,0,0,0,0,0
400915421,Miami Hurricanes,TEAM,TOTAL,TOTAL,False,,31,62,20,41,11,21,11,14,17,19,36,16,5,2,11,12,84
400915421,Miami Hurricanes,D. Hernandez,4065672,,True,12.0,1,2,1,2,0,0,1,2,1,1,2,0,0,0,1,1,3
400915421,Miami Hurricanes,K. Murphy,61668,,True,18.0,0,1,0,1,0,0,0,0,3,2,5,0,0,0,1,0,0
400915421,Miami Hurricanes,B. Brown,4065670,,True,32.0,3,8,2,5,1,3,0,0,1,1,2,6,1,0,1,2,7
400915421,Miami Hurricanes,J. Newton,3138145,,True,34.0,5,15,5,13,0,2,3,4,1,2,3,5,2,0,2,1,13
400915421,Miami Hurricanes,D. Reed,66130,,True,36.0,9,17,2,7,7,10,1,1,1,6,7,3,1,0,2,2,26
400915421,Miami Hurricanes,E. Izundu,3904629,,False,27.0,6,9,6,9,0,0,4,5,4,2,6,0,1,1,2,5,16
400915421,Miami Hurricanes,A. Lawrence II,3904628,,False,32.0,7,9,4,4,3,5,2,2,1,3,4,2,0,1,1,1,19
400915421,Miami Hurricanes,D. Vasiljevic,4065669,,False,9.0,0,1,0,0,0,1,0,0,0,1,1,0,0,0,0,0,0
400915421,Miami Hurricanes,TEAM,TOTAL,TOTAL,False,,31,62,20,41,11,21,11,14,17,19,36,16,5,2,11,12,84
400915420,Louisville Cardinals,D. Adel,3908807,,True,34.0,7,10,4,6,3,4,2,2,1,1,2,0,0,2,2,0,19
400915420,Louisville Cardinals,A. Mahmoud,3147363,,True,16.0,4,6,4,6,0,0,0,0,0,3,3,0,0,3,1,1,8
400915420,Louisville Cardinals,J. Johnson,3147362,,True,22.0,3,3,3,3,0,0,3,5,1,6,7,1,0,0,1,1,9
400915420,Louisville Cardinals,D. Mitchell,3908809,,True,32.0,7,10,5,6,2,4,3,3,0,3,3,3,4,0,1,4,19
400915420,Louisville Cardinals,D. Levitch,66592,,True,22.0,1,7,0,3,1,4,0,0,0,2,2,3,0,0,1,2,3
400915420,Louisville Cardinals,V.J. King,4065666,,False,22.0,4,7,4,7,0,0,3,3,0,3,3,1,1,0,0,2,11
400915420,Louisville Cardinals,R. Spalding,3908806,,False,18.0,0,2,0,2,0,0,3,4,3,4,7,1,1,0,1,2,3
400915420,Louisville Cardinals,M. Mathiang,63035,,False,24.0,7,11,7,11,0,0,2,2,0,4,4,1,2,0,2,2,16
400915420,Louisville Cardinals,R. McMahon,3908808,,False,9.0,0,1,0,0,0,1,0,0,0,1,1,0,0,0,0,4,0
400915420,Louisville Cardinals,J. Henderson,3155491,,False,1.0,1,2,1,1,0,1,0,0,0,0,0,0,0,0,0,0,2
400915420,Louisville Cardinals,TEAM,TOTAL,TOTAL,False,,34,59,28,45,6,14,16,19,5,27,32,10,8,5,9,18,90
400915420,Louisville Cardinals,D. Adel,3908807,,True,34.0,7,10,4,6,3,4,2,2,1,1,2,0,0,2,2,0,19
400915420,Louisville Cardinals,A. Mahmoud,3147363,,True,16.0,4,6,4,6,0,0,0,0,0,3,3,0,0,3,1,1,8
400915420,Louisville Cardinals,J. Johnson,3147362,,True,22.0,3,3,3,3,0,0,3,5,1,6,7,1,0,0,1,1,9
400915420,Louisville Cardinals,D. Mitchell,3908809,,True,32.0,7,10,5,6,2,4,3,3,0,3,3,3,4,0,1,4,19
400915420,Louisville Cardinals,D. Levitch,66592,,True,22.0,1,7,0,3,1,4,0,0,0,2,2,3,0,0,1,2,3
400915420,Louisville Cardinals,V.J. King,4065666,,False,22.0,4,7,4,7,0,0,3,3,0,3,3,1,1,0,0,2,11
400915420,Louisville Cardinals,R. Spalding,3908806,,False,18.0,0,2,0,2,0,0,3,4,3,4,7,1,1,0,1,2,3
400915420,Louisville Cardinals,M. Mathiang,63035,,False,24.0,7,11,7,11,0,0,2,2,0,4,4,1,2,0,2,2,16
400915420,Louisville Cardinals,R. McMahon,3908808,,False,9.0,0,1,0,0,0,1,0,0,0,1,1,0,0,0,0,4,0
400915420,Louisville Cardinals,J. Henderson,3155491,,False,1.0,1,2,1,1,0,1,0,0,0,0,0,0,0,0,0,0,2
400915420,Louisville Cardinals,TEAM,TOTAL,TOTAL,False,,34,59,28,45,6,14,16,19,5,27,32,10,8,5,9,18,90
400915420,Boston College Eagles,M. Jeffers,61901,,True,21.0,0,1,0,1,0,0,0,0,0,2,2,0,0,0,1,1,0
400915420,Boston College Eagles,C. Tava,61446,,True,28.0,1,2,1,1,0,1,1,2,0,2,2,5,0,0,2,2,3
400915420,Boston College Eagles,K. Bowman,4065635,,True,39.0,8,15,6,12,2,3,0,1,1,4,5,2,1,0,4,1,18
400915420,Boston College Eagles,J. Robinson,3943606,,True,33.0,4,14,4,9,0,5,5,6,0,0,0,2,2,0,2,0,13
400915420,Boston College Eagles,J. Chatman,3135095,,True,27.0,3,6,1,1,2,5,2,2,1,2,3,0,0,0,0,0,10
400915420,Boston College Eagles,J. Reyes,3943609,,False,7.0,0,0,0,0,0,0,0,0,0,0,0,0,0,0,0,1,0
400915420,Boston College Eagles,M. Sagay,4065638,,False,3.0,2,2,1,1,1,1,1,2,0,1,1,0,0,0,1,0,6
400915420,Boston College Eagles,N. Popovic,4065637,,False,12.0,3,5,2,3,1,2,0,0,0,3,3,0,0,0,3,5,7
400915420,Boston College Eagles,A.J. Turner,3943608,,False,19.0,2,5,1,2,1,3,0,0,0,2,2,2,1,0,1,1,5
400915420,Boston College Eagles,E. Meznieks,3943607,,False,11.0,2,5,1,1,1,4,0,0,0,2,2,0,0,0,0,2,5
400915420,Boston College Eagles,TEAM,TOTAL,TOTAL,False,,25,55,17,31,8,24,9,13,5,21,26,11,4,0,14,13,67
400915420,Boston College Eagles,M. Jeffers,61901,,True,21.0,0,1,0,1,0,0,0,0,0,2,2,0,0,0,1,1,0
400915420,Boston College Eagles,C. Tava,61446,,True,28.0,1,2,1,1,0,1,1,2,0,2,2,5,0,0,2,2,3
400915420,Boston College Eagles,K. Bowman,4065635,,True,39.0,8,15,6,12,2,3,0,1,1,4,5,2,1,0,4,1,18
400915420,Boston College Eagles,J. Robinson,3943606,,True,33.0,4,14,4,9,0,5,5,6,0,0,0,2,2,0,2,0,13
400915420,Boston College Eagles,J. Chatman,3135095,,True,27.0,3,6,1,1,2,5,2,2,1,2,3,0,0,0,0,0,10
400915420,Boston College Eagles,J. Reyes,3943609,,False,7.0,0,0,0,0,0,0,0,0,0,0,0,0,0,0,0,1,0
400915420,Boston College Eagles,M. Sagay,4065638,,False,3.0,2,2,1,1,1,1,1,2,0,1,1,0,0,0,1,0,6
400915420,Boston College Eagles,N. Popovic,4065637,,False,12.0,3,5,2,3,1,2,0,0,0,3,3,0,0,0,3,5,7
400915420,Boston College Eagles,A.J. Turner,3943608,,False,19.0,2,5,1,2,1,3,0,0,0,2,2,2,1,0,1,1,5
400915420,Boston College Eagles,E. Meznieks,3943607,,False,11.0,2,5,1,1,1,4,0,0,0,2,2,0,0,0,0,2,5
400915420,Boston College Eagles,TEAM,TOTAL,TOTAL,False,,25,55,17,31,8,24,9,13,5,21,26,11,4,0,14,13,67
400915419,Pittsburgh Panthers,M. Young,66290,,True,38.0,10,17,10,15,0,2,4,7,1,3,4,2,1,2,0,0,24
400915419,Pittsburgh Panthers,S. Jeter,61756,,True,25.0,2,3,2,3,0,0,0,0,2,1,3,0,0,0,3,4,4
400915419,Pittsburgh Panthers,J. Artis,66287,,True,40.0,6,16,6,10,0,6,5,7,2,7,9,4,0,0,2,4,17
400915419,Pittsburgh Panthers,C. Johnson,3138196,,True,35.0,1,4,0,1,1,3,0,0,0,6,6,2,3,0,2,1,3
400915419,Pittsburgh Panthers,C. Jones,61219,,True,36.0,4,6,3,4,1,2,0,0,1,1,2,1,0,0,3,2,9
400915419,Pittsburgh Panthers,R. Nix,3934653,,False,16.0,3,4,3,4,0,0,1,2,3,2,5,0,0,0,0,2,7
400915419,Pittsburgh Panthers,J. Milligan,3934655,,False,1.0,0,0,0,0,0,0,0,0,0,0,0,0,0,0,0,0,0
400915419,Pittsburgh Panthers,D. Wilson,3934652,,False,9.0,0,1,0,0,0,1,0,0,0,0,0,0,0,0,0,2,0
400915419,Pittsburgh Panthers,TEAM,TOTAL,TOTAL,False,,26,51,24,37,2,14,10,16,9,20,29,9,4,2,13,15,64
400915419,Pittsburgh Panthers,M. Young,66290,,True,38.0,10,17,10,15,0,2,4,7,1,3,4,2,1,2,0,0,24
400915419,Pittsburgh Panthers,S. Jeter,61756,,True,25.0,2,3,2,3,0,0,0,0,2,1,3,0,0,0,3,4,4
400915419,Pittsburgh Panthers,J. Artis,66287,,True,40.0,6,16,6,10,0,6,5,7,2,7,9,4,0,0,2,4,17
400915419,Pittsburgh Panthers,C. Johnson,3138196,,True,35.0,1,4,0,1,1,3,0,0,0,6,6,2,3,0,2,1,3
400915419,Pittsburgh Panthers,C. Jones,61219,,True,36.0,4,6,3,4,1,2,0,0,1,1,2,1,0,0,3,2,9
400915419,Pittsburgh Panthers,R. Nix,3934653,,False,16.0,3,4,3,4,0,0,1,2,3,2,5,0,0,0,0,2,7
400915419,Pittsburgh Panthers,J. Milligan,3934655,,False,1.0,0,0,0,0,0,0,0,0,0,0,0,0,0,0,0,0,0
400915419,Pittsburgh Panthers,D. Wilson,3934652,,False,9.0,0,1,0,0,0,1,0,0,0,0,0,0,0,0,0,2,0
400915419,Pittsburgh Panthers,TEAM,TOTAL,TOTAL,False,,26,51,24,37,2,14,10,16,9,20,29,9,4,2,13,15,64
400915419,Duke Blue Devils,J. Tatum,4065648,,True,35.0,4,7,2,4,2,3,2,2,3,3,6,2,1,1,1,3,12
400915419,Duke Blue Devils,A. Jefferson,61586,,True,36.0,6,12,6,12,0,0,3,4,5,4,9,3,0,5,2,2,15
400915419,Duke Blue Devils,F. Jackson,4065651,,True,27.0,3,8,1,2,2,6,0,0,0,1,1,5,0,0,2,1,8
400915419,Duke Blue Devils,L. Kennard,3913174,,True,40.0,4,12,2,5,2,7,0,0,0,2,2,3,2,0,1,3,10
400915419,Duke Blue Devils,G. Allen,3135045,,True,40.0,6,13,1,2,5,11,4,4,2,4,6,6,0,0,2,4,21
400915419,Duke Blue Devils,H. Giles III,4065649,,False,7.0,2,2,2,2,0,0,1,1,0,0,0,0,0,0,0,1,5
400915419,Duke Blue Devils,M. Bolden,4065652,,False,1.0,0,0,0,0,0,0,0,0,0,0,0,0,0,0,0,0,0
400915419,Duke Blue Devils,M. Jones,66563,,False,14.0,0,1,0,0,0,1,1,3,0,1,1,0,0,0,0,1,1
400915419,Duke Blue Devils,TEAM,TOTAL,TOTAL,False,,25,55,14,27,11,28,11,14,10,16,26,19,3,6,8,15,72
400915419,Duke Blue Devils,J. Tatum,4065648,,True,35.0,4,7,2,4,2,3,2,2,3,3,6,2,1,1,1,3,12
400915419,Duke Blue Devils,A. Jefferson,61586,,True,36.0,6,12,6,12,0,0,3,4,5,4,9,3,0,5,2,2,15
400915419,Duke Blue Devils,F. Jackson,4065651,,True,27.0,3,8,1,2,2,6,0,0,0,1,1,5,0,0,2,1,8
400915419,Duke Blue Devils,L. Kennard,3913174,,True,40.0,4,12,2,5,2,7,0,0,0,2,2,3,2,0,1,3,10
400915419,Duke Blue Devils,G. Allen,3135045,,True,40.0,6,13,1,2,5,11,4,4,2,4,6,6,0,0,2,4,21
400915419,Duke Blue Devils,H. Giles III,4065649,,False,7.0,2,2,2,2,0,0,1,1,0,0,0,0,0,0,0,1,5
400915419,Duke Blue Devils,M. Bolden,4065652,,False,1.0,0,0,0,0,0,0,0,0,0,0,0,0,0,0,0,0,0
400915419,Duke Blue Devils,M. Jones,66563,,False,14.0,0,1,0,0,0,1,1,3,0,1,1,0,0,0,0,1,1
400915419,Duke Blue Devils,TEAM,TOTAL,TOTAL,False,,25,55,14,27,11,28,11,14,10,16,26,19,3,6,8,15,72
400915418,Virginia Cavaliers,I. Wilkins,3138203,,True,30.0,4,6,4,6,0,0,1,3,2,2,4,0,1,1,2,3,9
400915418,Virginia Cavaliers,J. Salt,3138200,,True,10.0,0,3,0,3,0,0,1,2,1,0,1,0,0,0,3,0,1
400915418,Virginia Cavaliers,M. Shayok,3138201,,True,24.0,1,7,1,5,0,2,0,0,0,1,1,2,0,1,0,2,2
400915418,Virginia Cavaliers,L. Perrantes,66139,,True,33.0,4,8,1,3,3,5,0,0,0,1,1,8,2,1,2,2,11
400915418,Virginia Cavaliers,D. Hall,66138,,True,23.0,2,5,0,1,2,4,0,0,0,6,6,2,1,0,0,2,6
400915418,Virginia Cavaliers,M. Diakite,3947156,,False,16.0,4,4,4,4,0,0,0,0,2,2,4,0,0,1,1,2,8
400915418,Virginia Cavaliers,J. Reuter,3908374,,False,13.0,0,1,0,1,0,0,0,0,1,0,1,3,0,0,3,1,0
400915418,Virginia Cavaliers,T. Jerome,4065733,,False,17.0,3,5,0,0,3,5,0,0,0,2,2,4,1,0,3,2,9
400915418,Virginia Cavaliers,K. Guy,4065730,,False,24.0,5,8,1,2,4,6,0,0,0,1,1,0,1,0,1,1,14
400915418,Virginia Cavaliers,D. Thompson,66274,,False,10.0,1,3,1,1,0,2,0,0,0,0,0,2,0,0,0,0,2
400915418,Virginia Cavaliers,TEAM,TOTAL,TOTAL,False,,24,50,12,26,12,24,2,5,7,17,24,21,6,4,15,15,62
400915418,Virginia Cavaliers,I. Wilkins,3138203,,True,30.0,4,6,4,6,0,0,1,3,2,2,4,0,1,1,2,3,9
400915418,Virginia Cavaliers,J. Salt,3138200,,True,10.0,0,3,0,3,0,0,1,2,1,0,1,0,0,0,3,0,1
400915418,Virginia Cavaliers,M. Shayok,3138201,,True,24.0,1,7,1,5,0,2,0,0,0,1,1,2,0,1,0,2,2
400915418,Virginia Cavaliers,L. Perrantes,66139,,True,33.0,4,8,1,3,3,5,0,0,0,1,1,8,2,1,2,2,11
400915418,Virginia Cavaliers,D. Hall,66138,,True,23.0,2,5,0,1,2,4,0,0,0,6,6,2,1,0,0,2,6
400915418,Virginia Cavaliers,M. Diakite,3947156,,False,16.0,4,4,4,4,0,0,0,0,2,2,4,0,0,1,1,2,8
400915418,Virginia Cavaliers,J. Reuter,3908374,,False,13.0,0,1,0,1,0,0,0,0,1,0,1,3,0,0,3,1,0
400915418,Virginia Cavaliers,T. Jerome,4065733,,False,17.0,3,5,0,0,3,5,0,0,0,2,2,4,1,0,3,2,9
400915418,Virginia Cavaliers,K. Guy,4065730,,False,24.0,5,8,1,2,4,6,0,0,0,1,1,0,1,0,1,1,14
400915418,Virginia Cavaliers,D. Thompson,66274,,False,10.0,1,3,1,1,0,2,0,0,0,0,0,2,0,0,0,0,2
400915418,Virginia Cavaliers,TEAM,TOTAL,TOTAL,False,,24,50,12,26,12,24,2,5,7,17,24,21,6,4,15,15,62
400915418,Syracuse Orange,T. Thompson,4065721,,True,13.0,2,3,2,3,0,0,0,0,0,0,0,0,1,0,2,1,4
400915418,Syracuse Orange,T. Lydon,3934662,,True,40.0,2,5,1,2,1,3,1,2,0,6,6,3,2,3,1,1,6
400915418,Syracuse Orange,A. White III,61616,,True,40.0,7,14,4,6,3,8,6,8,0,5,5,2,3,0,2,1,23
400915418,Syracuse Orange,T. Battle,4065722,,True,39.0,7,11,4,5,3,6,6,8,1,1,2,0,2,0,0,2,23
400915418,Syracuse Orange,J. Gillon,61915,,True,37.0,3,6,3,5,0,1,0,0,0,2,2,4,2,0,4,0,6
400915418,Syracuse Orange,T. Roberson,67633,,False,27.0,2,3,2,3,0,0,0,2,1,1,2,1,1,2,1,2,4
400915418,Syracuse Orange,F. Howard,3934659,,False,4.0,0,0,0,0,0,0,0,0,0,1,1,2,0,0,1,2,0
400915418,Syracuse Orange,TEAM,TOTAL,TOTAL,False,,23,42,16,24,7,18,13,20,4,19,23,12,11,5,12,9,66
400915418,Syracuse Orange,T. Thompson,4065721,,True,13.0,2,3,2,3,0,0,0,0,0,0,0,0,1,0,2,1,4
400915418,Syracuse Orange,T. Lydon,3934662,,True,40.0,2,5,1,2,1,3,1,2,0,6,6,3,2,3,1,1,6
400915418,Syracuse Orange,A. White III,61616,,True,40.0,7,14,4,6,3,8,6,8,0,5,5,2,3,0,2,1,23
400915418,Syracuse Orange,T. Battle,4065722,,True,39.0,7,11,4,5,3,6,6,8,1,1,2,0,2,0,0,2,23
400915418,Syracuse Orange,J. Gillon,61915,,True,37.0,3,6,3,5,0,1,0,0,0,2,2,4,2,0,4,0,6
400915418,Syracuse Orange,T. Roberson,67633,,False,27.0,2,3,2,3,0,0,0,2,1,1,2,1,1,2,1,2,4
400915418,Syracuse Orange,F. Howard,3934659,,False,4.0,0,0,0,0,0,0,0,0,0,1,1,2,0,0,1,2,0
400915418,Syracuse Orange,TEAM,TOTAL,TOTAL,False,,23,42,16,24,7,18,13,20,4,19,23,12,11,5,12,9,66
400915417,Virginia Tech Hokies,K. Sy,4065740,,True,9.0,0,0,0,0,0,0,0,0,0,1,1,0,0,0,2,1,0
400915417,Virginia Tech Hokies,T. Outlaw,67275,,True,18.0,2,5,1,1,1,4,0,0,0,1,1,0,0,1,1,3,5
400915417,Virginia Tech Hokies,J. Robinson,3945566,,True,34.0,2,4,2,3,0,1,1,2,0,2,2,2,0,1,1,3,5
400915417,Virginia Tech Hokies,J. Bibbs,3147500,,True,15.0,1,4,0,1,1,3,2,3,1,0,1,0,0,0,1,4,5
400915417,Virginia Tech Hokies,S. Allen,61795,,True,40.0,5,14,4,9,1,5,3,4,0,2,2,1,1,0,3,2,14
400915417,Virginia Tech Hokies,Z. LeDay,61698,,False,29.0,3,6,3,4,0,2,6,8,2,4,6,0,0,0,2,3,12
400915417,Virginia Tech Hokies,C. Clarke,3945567,,False,31.0,1,4,1,2,0,2,3,3,0,7,7,2,1,0,2,2,5
400915417,Virginia Tech Hokies,A. Hill,3147501,,False,24.0,1,5,1,2,0,3,0,0,0,1,1,0,0,0,2,1,2
400915417,Virginia Tech Hokies,TEAM,TOTAL,TOTAL,False,,15,42,12,22,3,20,15,20,3,19,22,5,2,2,14,19,48
400915417,Virginia Tech Hokies,K. Sy,4065740,,True,9.0,0,0,0,0,0,0,0,0,0,1,1,0,0,0,2,1,0
400915417,Virginia Tech Hokies,T. Outlaw,67275,,True,18.0,2,5,1,1,1,4,0,0,0,1,1,0,0,1,1,3,5
400915417,Virginia Tech Hokies,J. Robinson,3945566,,True,34.0,2,4,2,3,0,1,1,2,0,2,2,2,0,1,1,3,5
400915417,Virginia Tech Hokies,J. Bibbs,3147500,,True,15.0,1,4,0,1,1,3,2,3,1,0,1,0,0,0,1,4,5
400915417,Virginia Tech Hokies,S. Allen,61795,,True,40.0,5,14,4,9,1,5,3,4,0,2,2,1,1,0,3,2,14
400915417,Virginia Tech Hokies,Z. LeDay,61698,,False,29.0,3,6,3,4,0,2,6,8,2,4,6,0,0,0,2,3,12
400915417,Virginia Tech Hokies,C. Clarke,3945567,,False,31.0,1,4,1,2,0,2,3,3,0,7,7,2,1,0,2,2,5
400915417,Virginia Tech Hokies,A. Hill,3147501,,False,24.0,1,5,1,2,0,3,0,0,0,1,1,0,0,0,2,1,2
400915417,Virginia Tech Hokies,TEAM,TOTAL,TOTAL,False,,15,42,12,22,3,20,15,20,3,19,22,5,2,2,14,19,48
400915417,Virginia Cavaliers,I. Wilkins,3138203,,True,31.0,7,11,7,11,0,0,1,1,5,4,9,2,1,1,1,2,15
400915417,Virginia Cavaliers,J. Salt,3138200,,True,10.0,0,0,0,0,0,0,0,0,1,2,3,1,1,2,1,4,0
400915417,Virginia Cavaliers,M. Shayok,3138201,,True,30.0,2,5,2,4,0,1,5,7,0,4,4,1,1,0,1,1,9
400915417,Virginia Cavaliers,L. Perrantes,66139,,True,33.0,5,11,3,6,2,5,2,2,0,3,3,3,1,0,0,0,14
400915417,Virginia Cavaliers,D. Hall,66138,,True,31.0,6,14,5,11,1,3,4,7,2,7,9,4,1,0,1,2,17
400915417,Virginia Cavaliers,M. Diakite,3947156,,False,2.0,0,0,0,0,0,0,0,0,0,0,0,0,0,0,1,1,0
400915417,Virginia Cavaliers,J. Reuter,3908374,,False,13.0,1,2,1,2,0,0,2,2,3,2,5,0,0,1,1,4,4
400915417,Virginia Cavaliers,T. Jerome,4065733,,False,24.0,2,5,1,1,1,4,2,2,0,0,0,2,0,0,0,2,7
400915417,Virginia Cavaliers,K. Guy,4065730,,False,17.0,1,4,0,2,1,2,0,0,0,0,0,2,0,0,0,2,3
400915417,Virginia Cavaliers,T. Gross Jr.,4065729,,False,1.0,0,0,0,0,0,0,0,0,0,0,0,0,0,0,2,0,0
400915417,Virginia Cavaliers,J. Bartley,3947155,,False,1.0,0,0,0,0,0,0,0,0,0,1,1,0,0,0,0,0,0
400915417,Virginia Cavaliers,D. Thompson,66274,,False,7.0,1,2,1,1,0,1,0,0,0,1,1,0,0,0,1,1,2
400915417,Virginia Cavaliers,TEAM,TOTAL,TOTAL,False,,25,54,20,38,5,16,16,21,11,26,37,15,5,4,9,19,71
400915417,Virginia Cavaliers,I. Wilkins,3138203,,True,31.0,7,11,7,11,0,0,1,1,5,4,9,2,1,1,1,2,15
400915417,Virginia Cavaliers,J. Salt,3138200,,True,10.0,0,0,0,0,0,0,0,0,1,2,3,1,1,2,1,4,0
400915417,Virginia Cavaliers,M. Shayok,3138201,,True,30.0,2,5,2,4,0,1,5,7,0,4,4,1,1,0,1,1,9
400915417,Virginia Cavaliers,L. Perrantes,66139,,True,33.0,5,11,3,6,2,5,2,2,0,3,3,3,1,0,0,0,14
400915417,Virginia Cavaliers,D. Hall,66138,,True,31.0,6,14,5,11,1,3,4,7,2,7,9,4,1,0,1,2,17
400915417,Virginia Cavaliers,M. Diakite,3947156,,False,2.0,0,0,0,0,0,0,0,0,0,0,0,0,0,0,1,1,0
400915417,Virginia Cavaliers,J. Reuter,3908374,,False,13.0,1,2,1,2,0,0,2,2,3,2,5,0,0,1,1,4,4
400915417,Virginia Cavaliers,T. Jerome,4065733,,False,24.0,2,5,1,1,1,4,2,2,0,0,0,2,0,0,0,2,7
400915417,Virginia Cavaliers,K. Guy,4065730,,False,17.0,1,4,0,2,1,2,0,0,0,0,0,2,0,0,0,2,3
400915417,Virginia Cavaliers,T. Gross Jr.,4065729,,False,1.0,0,0,0,0,0,0,0,0,0,0,0,0,0,0,2,0,0
400915417,Virginia Cavaliers,J. Bartley,3947155,,False,1.0,0,0,0,0,0,0,0,0,0,1,1,0,0,0,0,0,0
400915417,Virginia Cavaliers,D. Thompson,66274,,False,7.0,1,2,1,1,0,1,0,0,0,1,1,0,0,0,1,1,2
400915417,Virginia Cavaliers,TEAM,TOTAL,TOTAL,False,,25,54,20,38,5,16,16,21,11,26,37,15,5,4,9,19,71
400915416,Miami Hurricanes,K. Murphy,61668,,True,33.0,1,4,1,4,0,0,2,3,1,4,5,1,2,0,2,2,4
400915416,Miami Hurricanes,A. Lawrence II,3904628,,True,30.0,1,4,1,1,0,3,0,0,0,2,2,1,0,0,0,2,2
400915416,Miami Hurricanes,B. Brown,4065670,,True,36.0,4,10,4,9,0,1,9,11,2,3,5,1,2,0,4,3,17
400915416,Miami Hurricanes,J. Newton,3138145,,True,32.0,4,5,4,5,0,0,4,4,0,3,3,2,1,0,5,2,12
400915416,Miami Hurricanes,D. Reed,66130,,True,31.0,5,11,4,6,1,5,1,2,2,2,4,0,0,0,2,1,12
400915416,Miami Hurricanes,D. Hernandez,4065672,,False,22.0,3,6,3,6,0,0,1,2,1,0,1,0,0,1,0,1,7
400915416,Miami Hurricanes,R. Miller Jr.,4065671,,False,3.0,0,0,0,0,0,0,0,0,0,0,0,0,0,0,0,0,0
400915416,Miami Hurricanes,E. Izundu,3904629,,False,5.0,0,0,0,0,0,0,0,0,1,0,1,0,0,0,1,0,0
400915416,Miami Hurricanes,D. Vasiljevic,4065669,,False,8.0,1,2,0,0,1,2,0,0,1,0,1,0,0,0,0,0,3
400915416,Miami Hurricanes,TEAM,TOTAL,TOTAL,False,,19,42,17,31,2,11,17,22,10,16,26,5,5,1,14,11,57
400915416,Miami Hurricanes,K. Murphy,61668,,True,33.0,1,4,1,4,0,0,2,3,1,4,5,1,2,0,2,2,4
400915416,Miami Hurricanes,A. Lawrence II,3904628,,True,30.0,1,4,1,1,0,3,0,0,0,2,2,1,0,0,0,2,2
400915416,Miami Hurricanes,B. Brown,4065670,,True,36.0,4,10,4,9,0,1,9,11,2,3,5,1,2,0,4,3,17
400915416,Miami Hurricanes,J. Newton,3138145,,True,32.0,4,5,4,5,0,0,4,4,0,3,3,2,1,0,5,2,12
400915416,Miami Hurricanes,D. Reed,66130,,True,31.0,5,11,4,6,1,5,1,2,2,2,4,0,0,0,2,1,12
400915416,Miami Hurricanes,D. Hernandez,4065672,,False,22.0,3,6,3,6,0,0,1,2,1,0,1,0,0,1,0,1,7
400915416,Miami Hurricanes,R. Miller Jr.,4065671,,False,3.0,0,0,0,0,0,0,0,0,0,0,0,0,0,0,0,0,0
400915416,Miami Hurricanes,E. Izundu,3904629,,False,5.0,0,0,0,0,0,0,0,0,1,0,1,0,0,0,1,0,0
400915416,Miami Hurricanes,D. Vasiljevic,4065669,,False,8.0,1,2,0,0,1,2,0,0,1,0,1,0,0,0,0,0,3
400915416,Miami Hurricanes,TEAM,TOTAL,TOTAL,False,,19,42,17,31,2,11,17,22,10,16,26,5,5,1,14,11,57
400915416,Florida State Seminoles,J. Isaac,4065654,,True,25.0,5,7,4,6,1,1,4,4,3,4,7,2,3,1,1,1,15
400915416,Florida State Seminoles,M. Ojo,61596,,True,18.0,1,1,1,1,0,0,3,3,1,1,2,0,3,1,2,3,5
400915416,Florida State Seminoles,T. Mann,3907823,,True,29.0,4,6,3,4,1,2,2,2,3,0,3,2,1,0,0,4,11
400915416,Florida State Seminoles,D. Bacon,3907821,,True,32.0,6,16,5,12,1,4,2,2,0,1,1,3,0,0,1,1,15
400915416,Florida State Seminoles,X. Rathan-Mayes,66125,,True,32.0,4,8,1,1,3,7,2,2,0,3,3,4,2,0,2,1,13
400915416,Florida State Seminoles,P. Cofer,3135054,,False,13.0,1,2,1,2,0,0,0,0,1,2,3,0,0,0,0,1,2
400915416,Florida State Seminoles,J. Smith,66126,,False,17.0,1,2,1,1,0,1,1,2,0,1,1,0,0,2,0,3,3
400915416,Florida State Seminoles,C. Koumadje,3907824,,False,6.0,2,2,2,2,0,0,0,0,0,2,2,0,0,0,1,2,4
400915416,Florida State Seminoles,B. Angola-Rodas,4065658,,False,5.0,0,1,0,0,0,1,0,0,0,0,0,0,0,0,0,1,0
400915416,Florida State Seminoles,P. Savoy,4065657,,False,4.0,1,1,0,0,1,1,0,0,0,0,0,0,0,0,1,0,3
400915416,Florida State Seminoles,T. Forrest,4065656,,False,11.0,1,3,1,3,0,0,0,0,1,0,1,0,1,0,0,1,2
400915416,Florida State Seminoles,C. Walker,4065655,,False,8.0,1,3,1,2,0,1,0,0,0,1,1,1,1,0,1,1,2
400915416,Florida State Seminoles,TEAM,TOTAL,TOTAL,False,,27,52,20,34,7,18,14,15,10,17,27,12,11,4,9,19,75
400915416,Florida State Seminoles,J. Isaac,4065654,,True,25.0,5,7,4,6,1,1,4,4,3,4,7,2,3,1,1,1,15
400915416,Florida State Seminoles,M. Ojo,61596,,True,18.0,1,1,1,1,0,0,3,3,1,1,2,0,3,1,2,3,5
400915416,Florida State Seminoles,T. Mann,3907823,,True,29.0,4,6,3,4,1,2,2,2,3,0,3,2,1,0,0,4,11
400915416,Florida State Seminoles,D. Bacon,3907821,,True,32.0,6,16,5,12,1,4,2,2,0,1,1,3,0,0,1,1,15
400915416,Florida State Seminoles,X. Rathan-Mayes,66125,,True,32.0,4,8,1,1,3,7,2,2,0,3,3,4,2,0,2,1,13
400915416,Florida State Seminoles,P. Cofer,3135054,,False,13.0,1,2,1,2,0,0,0,0,1,2,3,0,0,0,0,1,2
400915416,Florida State Seminoles,J. Smith,66126,,False,17.0,1,2,1,1,0,1,1,2,0,1,1,0,0,2,0,3,3
400915416,Florida State Seminoles,C. Koumadje,3907824,,False,6.0,2,2,2,2,0,0,0,0,0,2,2,0,0,0,1,2,4
400915416,Florida State Seminoles,B. Angola-Rodas,4065658,,False,5.0,0,1,0,0,0,1,0,0,0,0,0,0,0,0,0,1,0
400915416,Florida State Seminoles,P. Savoy,4065657,,False,4.0,1,1,0,0,1,1,0,0,0,0,0,0,0,0,1,0,3
400915416,Florida State Seminoles,T. Forrest,4065656,,False,11.0,1,3,1,3,0,0,0,0,1,0,1,0,1,0,0,1,2
400915416,Florida State Seminoles,C. Walker,4065655,,False,8.0,1,3,1,2,0,1,0,0,0,1,1,1,1,0,1,1,2
400915416,Florida State Seminoles,TEAM,TOTAL,TOTAL,False,,27,52,20,34,7,18,14,15,10,17,27,12,11,4,9,19,75
400915415,Syracuse Orange,T. Thompson,4065721,,True,23.0,3,6,3,6,0,0,2,3,2,2,4,2,1,2,0,4,8
400915415,Syracuse Orange,T. Lydon,3934662,,True,45.0,6,11,3,5,3,6,0,0,1,6,7,2,1,0,1,3,15
400915415,Syracuse Orange,T. Battle,4065722,,True,38.0,2,6,2,4,0,2,2,2,1,0,1,2,0,0,1,3,6
400915415,Syracuse Orange,J. Gillon,61915,,True,44.0,10,13,1,3,9,10,14,14,0,4,4,9,0,0,4,3,43
400915415,Syracuse Orange,A. White III,61616,,True,45.0,11,19,8,11,3,8,3,4,0,2,2,1,4,1,3,3,28
400915415,Syracuse Orange,T. Roberson,67633,,False,22.0,0,0,0,0,0,0,0,0,1,2,3,0,0,0,2,1,0
400915415,Syracuse Orange,F. Howard,3934659,,False,8.0,0,2,0,2,0,0,0,0,1,1,2,1,0,0,0,1,0
400915415,Syracuse Orange,TEAM,TOTAL,TOTAL,False,,32,57,17,31,15,26,21,23,6,21,27,17,6,3,11,18,100
400915415,Syracuse Orange,T. Thompson,4065721,,True,23.0,3,6,3,6,0,0,2,3,2,2,4,2,1,2,0,4,8
400915415,Syracuse Orange,T. Lydon,3934662,,True,45.0,6,11,3,5,3,6,0,0,1,6,7,2,1,0,1,3,15
400915415,Syracuse Orange,T. Battle,4065722,,True,38.0,2,6,2,4,0,2,2,2,1,0,1,2,0,0,1,3,6
400915415,Syracuse Orange,J. Gillon,61915,,True,44.0,10,13,1,3,9,10,14,14,0,4,4,9,0,0,4,3,43
400915415,Syracuse Orange,A. White III,61616,,True,45.0,11,19,8,11,3,8,3,4,0,2,2,1,4,1,3,3,28
400915415,Syracuse Orange,T. Roberson,67633,,False,22.0,0,0,0,0,0,0,0,0,1,2,3,0,0,0,2,1,0
400915415,Syracuse Orange,F. Howard,3934659,,False,8.0,0,2,0,2,0,0,0,0,1,1,2,1,0,0,0,1,0
400915415,Syracuse Orange,TEAM,TOTAL,TOTAL,False,,32,57,17,31,15,26,21,23,6,21,27,17,6,3,11,18,100
400915415,NC State Wolfpack,A. Abu,3138158,,True,41.0,8,16,8,16,0,0,3,4,4,2,6,3,1,0,2,2,19
400915415,NC State Wolfpack,O. Yurtseven,66768,,True,34.0,4,6,4,6,0,0,2,6,2,2,4,3,1,2,1,3,10
400915415,NC State Wolfpack,D. Smith Jr.,4065697,,True,43.0,4,8,2,2,2,6,3,4,1,10,11,15,1,0,2,1,13
400915415,NC State Wolfpack,M. Rowan,3947151,,True,45.0,11,23,3,5,8,18,1,1,1,1,2,1,2,1,2,1,31
400915415,NC State Wolfpack,T. Henderson,61215,,True,28.0,5,8,1,2,4,6,2,3,0,2,2,2,0,0,2,5,16
400915415,NC State Wolfpack,T. Kapita,4065701,,False,6.0,0,0,0,0,0,0,0,0,0,1,1,0,0,0,1,1,0
400915415,NC State Wolfpack,B. Anya,66134,,False,5.0,1,1,1,1,0,0,0,2,0,0,0,0,0,0,1,3,2
400915415,NC State Wolfpack,M. Johnson,4065699,,False,19.0,0,2,0,0,0,2,0,0,2,0,2,4,1,0,1,5,0
400915415,NC State Wolfpack,T. Dorn,3132359,,False,4.0,1,2,1,2,0,0,0,0,1,0,1,0,0,0,1,0,2
400915415,NC State Wolfpack,TEAM,TOTAL,TOTAL,False,,34,66,20,34,14,32,11,20,14,19,33,28,6,3,14,21,93
400915415,NC State Wolfpack,A. Abu,3138158,,True,41.0,8,16,8,16,0,0,3,4,4,2,6,3,1,0,2,2,19
400915415,NC State Wolfpack,O. Yurtseven,66768,,True,34.0,4,6,4,6,0,0,2,6,2,2,4,3,1,2,1,3,10
400915415,NC State Wolfpack,D. Smith Jr.,4065697,,True,43.0,4,8,2,2,2,6,3,4,1,10,11,15,1,0,2,1,13
400915415,NC State Wolfpack,M. Rowan,3947151,,True,45.0,11,23,3,5,8,18,1,1,1,1,2,1,2,1,2,1,31
400915415,NC State Wolfpack,T. Henderson,61215,,True,28.0,5,8,1,2,4,6,2,3,0,2,2,2,0,0,2,5,16
400915415,NC State Wolfpack,T. Kapita,4065701,,False,6.0,0,0,0,0,0,0,0,0,0,1,1,0,0,0,1,1,0
400915415,NC State Wolfpack,B. Anya,66134,,False,5.0,1,1,1,1,0,0,0,2,0,0,0,0,0,0,1,3,2
400915415,NC State Wolfpack,M. Johnson,4065699,,False,19.0,0,2,0,0,0,2,0,0,2,0,2,4,1,0,1,5,0
400915415,NC State Wolfpack,T. Dorn,3132359,,False,4.0,1,2,1,2,0,0,0,0,1,0,1,0,0,0,1,0,2
400915415,NC State Wolfpack,TEAM,TOTAL,TOTAL,False,,34,66,20,34,14,32,11,20,14,19,33,28,6,3,14,21,93
400915414,Georgia Tech Yellow Jackets,Q. Stephens,66128,,True,22.0,3,11,2,5,1,6,4,5,1,5,6,0,0,1,4,4,11
400915414,Georgia Tech Yellow Jackets,B. Lammers,3135061,,True,37.0,12,18,12,17,0,1,1,1,3,6,9,1,0,1,2,3,25
400915414,Georgia Tech Yellow Jackets,J. Okogie,4065663,,True,32.0,3,9,3,7,0,2,6,9,3,6,9,3,3,0,4,4,12
400915414,Georgia Tech Yellow Jackets,J. Heath,67623,,True,28.0,1,3,1,3,0,0,0,0,0,3,3,4,0,0,3,1,2
400915414,Georgia Tech Yellow Jackets,C. Heyward,61609,,True,23.0,0,3,0,3,0,0,0,0,1,1,2,1,1,0,1,2,0
400915414,Georgia Tech Yellow Jackets,C. Matthews,4065665,,False,3.0,0,1,0,0,0,1,0,0,0,0,0,0,0,0,0,0,0
400915414,Georgia Tech Yellow Jackets,A. Gueye,3135059,,False,9.0,0,0,0,0,0,0,0,2,0,1,1,0,0,0,1,4,0
400915414,Georgia Tech Yellow Jackets,K. McCormick,61453,,False,1.0,0,0,0,0,0,0,0,0,0,0,0,0,0,0,0,0,0
400915414,Georgia Tech Yellow Jackets,J. Moore,4065662,,False,20.0,0,0,0,0,0,0,0,0,0,2,2,2,0,0,0,2,0
400915414,Georgia Tech Yellow Jackets,T. Jackson,3135057,,False,25.0,4,8,4,7,0,1,4,4,0,1,1,2,1,0,2,5,12
400915414,Georgia Tech Yellow Jackets,TEAM,TOTAL,TOTAL,False,,23,53,22,42,1,11,15,21,8,26,34,13,5,2,17,25,62
400915414,Georgia Tech Yellow Jackets,Q. Stephens,66128,,True,22.0,3,11,2,5,1,6,4,5,1,5,6,0,0,1,4,4,11
400915414,Georgia Tech Yellow Jackets,B. Lammers,3135061,,True,37.0,12,18,12,17,0,1,1,1,3,6,9,1,0,1,2,3,25
400915414,Georgia Tech Yellow Jackets,J. Okogie,4065663,,True,32.0,3,9,3,7,0,2,6,9,3,6,9,3,3,0,4,4,12
400915414,Georgia Tech Yellow Jackets,J. Heath,67623,,True,28.0,1,3,1,3,0,0,0,0,0,3,3,4,0,0,3,1,2
400915414,Georgia Tech Yellow Jackets,C. Heyward,61609,,True,23.0,0,3,0,3,0,0,0,0,1,1,2,1,1,0,1,2,0
400915414,Georgia Tech Yellow Jackets,C. Matthews,4065665,,False,3.0,0,1,0,0,0,1,0,0,0,0,0,0,0,0,0,0,0
400915414,Georgia Tech Yellow Jackets,A. Gueye,3135059,,False,9.0,0,0,0,0,0,0,0,2,0,1,1,0,0,0,1,4,0
400915414,Georgia Tech Yellow Jackets,K. McCormick,61453,,False,1.0,0,0,0,0,0,0,0,0,0,0,0,0,0,0,0,0,0
400915414,Georgia Tech Yellow Jackets,J. Moore,4065662,,False,20.0,0,0,0,0,0,0,0,0,0,2,2,2,0,0,0,2,0
400915414,Georgia Tech Yellow Jackets,T. Jackson,3135057,,False,25.0,4,8,4,7,0,1,4,4,0,1,1,2,1,0,2,5,12
400915414,Georgia Tech Yellow Jackets,TEAM,TOTAL,TOTAL,False,,23,53,22,42,1,11,15,21,8,26,34,13,5,2,17,25,62
400915414,Clemson Tigers,E. Thomas,3947075,,True,21.0,5,10,5,9,0,1,2,5,3,7,10,1,1,1,1,5,12
400915414,Clemson Tigers,D. Grantham,3129674,,True,32.0,4,11,4,7,0,4,3,4,2,4,6,0,1,2,0,3,11
400915414,Clemson Tigers,J. Blossomgame,61835,,True,30.0,3,7,3,5,0,2,4,7,1,3,4,3,1,0,0,3,10
400915414,Clemson Tigers,S. Mitchell,3136699,,True,34.0,4,9,3,8,1,1,6,7,0,2,2,3,0,0,3,3,15
400915414,Clemson Tigers,A. Holmes,62043,,True,34.0,6,8,2,4,4,4,2,2,0,3,3,0,1,0,0,3,18
400915414,Clemson Tigers,S. Djitte,66122,,False,19.0,1,2,1,2,0,0,1,4,2,4,6,0,1,1,2,0,3
400915414,Clemson Tigers,T. Hudson,3917986,,False,6.0,0,1,0,0,0,1,0,0,0,0,0,0,0,0,0,1,0
400915414,Clemson Tigers,M. Reed,3133969,,False,12.0,1,4,1,3,0,1,3,3,2,1,3,0,2,0,1,2,5
400915414,Clemson Tigers,G. DeVoe,3129673,,False,12.0,0,2,0,0,0,2,0,0,0,0,0,0,1,1,4,0,0
400915414,Clemson Tigers,TEAM,TOTAL,TOTAL,False,,24,54,19,38,5,16,21,32,10,26,36,7,8,5,11,20,74
400915414,Clemson Tigers,E. Thomas,3947075,,True,21.0,5,10,5,9,0,1,2,5,3,7,10,1,1,1,1,5,12
400915414,Clemson Tigers,D. Grantham,3129674,,True,32.0,4,11,4,7,0,4,3,4,2,4,6,0,1,2,0,3,11
400915414,Clemson Tigers,J. Blossomgame,61835,,True,30.0,3,7,3,5,0,2,4,7,1,3,4,3,1,0,0,3,10
400915414,Clemson Tigers,S. Mitchell,3136699,,True,34.0,4,9,3,8,1,1,6,7,0,2,2,3,0,0,3,3,15
400915414,Clemson Tigers,A. Holmes,62043,,True,34.0,6,8,2,4,4,4,2,2,0,3,3,0,1,0,0,3,18
400915414,Clemson Tigers,S. Djitte,66122,,False,19.0,1,2,1,2,0,0,1,4,2,4,6,0,1,1,2,0,3
400915414,Clemson Tigers,T. Hudson,3917986,,False,6.0,0,1,0,0,0,1,0,0,0,0,0,0,0,0,0,1,0
400915414,Clemson Tigers,M. Reed,3133969,,False,12.0,1,4,1,3,0,1,3,3,2,1,3,0,2,0,1,2,5
400915414,Clemson Tigers,G. DeVoe,3129673,,False,12.0,0,2,0,0,0,2,0,0,0,0,0,0,1,1,4,0,0
400915414,Clemson Tigers,TEAM,TOTAL,TOTAL,False,,24,54,19,38,5,16,21,32,10,26,36,7,8,5,11,20,74
400915413,Wake Forest Demon Deacons,J. Collins,3908845,,True,31.0,9,14,9,14,0,0,8,10,2,14,16,0,1,3,2,1,26
400915413,Wake Forest Demon Deacons,D. Mitoglou,3138224,,True,25.0,3,6,2,3,1,3,2,2,0,2,2,1,0,0,1,2,9
400915413,Wake Forest Demon Deacons,A. Arians,61378,,True,22.0,4,10,0,3,4,7,2,2,0,1,1,0,0,0,1,2,14
400915413,Wake Forest Demon Deacons,B. Crawford,3908844,,True,32.0,5,13,2,7,3,6,2,2,1,1,2,9,0,0,1,1,15
400915413,Wake Forest Demon Deacons,K. Woods,3132360,,True,31.0,2,6,1,4,1,2,0,0,0,6,6,9,1,0,0,3,5
400915413,Wake Forest Demon Deacons,D. Moore,3908843,,False,7.0,2,4,2,4,0,0,0,1,3,0,3,0,0,1,1,1,4
400915413,Wake Forest Demon Deacons,B. Childress,4065750,,False,20.0,0,0,0,0,0,0,6,8,0,3,3,2,1,0,1,2,6
400915413,Wake Forest Demon Deacons,M. Wilbekin,3138222,,False,31.0,2,5,0,2,2,3,0,0,0,1,1,1,2,0,0,3,6
400915413,Wake Forest Demon Deacons,T. VanHorn,3078214,,False,1.0,0,0,0,0,0,0,0,0,0,0,0,0,0,0,0,0,0
400915413,Wake Forest Demon Deacons,TEAM,TOTAL,TOTAL,False,,27,58,16,37,11,21,20,25,7,29,36,22,5,4,8,15,85
400915413,Wake Forest Demon Deacons,J. Collins,3908845,,True,31.0,9,14,9,14,0,0,8,10,2,14,16,0,1,3,2,1,26
400915413,Wake Forest Demon Deacons,D. Mitoglou,3138224,,True,25.0,3,6,2,3,1,3,2,2,0,2,2,1,0,0,1,2,9
400915413,Wake Forest Demon Deacons,A. Arians,61378,,True,22.0,4,10,0,3,4,7,2,2,0,1,1,0,0,0,1,2,14
400915413,Wake Forest Demon Deacons,B. Crawford,3908844,,True,32.0,5,13,2,7,3,6,2,2,1,1,2,9,0,0,1,1,15
400915413,Wake Forest Demon Deacons,K. Woods,3132360,,True,31.0,2,6,1,4,1,2,0,0,0,6,6,9,1,0,0,3,5
400915413,Wake Forest Demon Deacons,D. Moore,3908843,,False,7.0,2,4,2,4,0,0,0,1,3,0,3,0,0,1,1,1,4
400915413,Wake Forest Demon Deacons,B. Childress,4065750,,False,20.0,0,0,0,0,0,0,6,8,0,3,3,2,1,0,1,2,6
400915413,Wake Forest Demon Deacons,M. Wilbekin,3138222,,False,31.0,2,5,0,2,2,3,0,0,0,1,1,1,2,0,0,3,6
400915413,Wake Forest Demon Deacons,T. VanHorn,3078214,,False,1.0,0,0,0,0,0,0,0,0,0,0,0,0,0,0,0,0,0
400915413,Wake Forest Demon Deacons,TEAM,TOTAL,TOTAL,False,,27,58,16,37,11,21,20,25,7,29,36,22,5,4,8,15,85
400915413,Boston College Eagles,M. Jeffers,61901,,True,24.0,2,3,2,3,0,0,0,2,3,4,7,2,1,0,3,5,4
400915413,Boston College Eagles,C. Tava,61446,,True,27.0,4,9,3,5,1,4,0,1,1,6,7,1,2,0,1,3,9
400915413,Boston College Eagles,K. Bowman,4065635,,True,37.0,6,9,2,4,4,5,2,2,2,5,7,5,0,0,2,2,18
400915413,Boston College Eagles,J. Robinson,3943606,,True,36.0,7,18,6,11,1,7,2,3,1,1,2,2,1,0,4,0,17
400915413,Boston College Eagles,J. Chatman,3135095,,True,34.0,6,10,2,4,4,6,6,6,1,2,3,1,0,0,0,3,22
400915413,Boston College Eagles,M. Sagay,4065638,,False,2.0,0,2,0,2,0,0,0,0,0,1,1,0,0,0,0,0,0
400915413,Boston College Eagles,N. Popovic,4065637,,False,12.0,3,7,2,5,1,2,0,0,0,4,4,1,0,1,1,5,7
400915413,Boston College Eagles,A.J. Turner,3943608,,False,24.0,1,4,0,0,1,4,0,0,0,4,4,5,0,1,0,2,3
400915413,Boston College Eagles,G. Owens,66277,,False,4.0,0,2,0,2,0,0,0,0,0,0,0,1,0,0,0,0,0
400915413,Boston College Eagles,TEAM,TOTAL,TOTAL,False,,29,64,17,36,12,28,10,14,9,27,36,18,4,2,11,20,80
400915413,Boston College Eagles,M. Jeffers,61901,,True,24.0,2,3,2,3,0,0,0,2,3,4,7,2,1,0,3,5,4
400915413,Boston College Eagles,C. Tava,61446,,True,27.0,4,9,3,5,1,4,0,1,1,6,7,1,2,0,1,3,9
400915413,Boston College Eagles,K. Bowman,4065635,,True,37.0,6,9,2,4,4,5,2,2,2,5,7,5,0,0,2,2,18
400915413,Boston College Eagles,J. Robinson,3943606,,True,36.0,7,18,6,11,1,7,2,3,1,1,2,2,1,0,4,0,17
400915413,Boston College Eagles,J. Chatman,3135095,,True,34.0,6,10,2,4,4,6,6,6,1,2,3,1,0,0,0,3,22
400915413,Boston College Eagles,M. Sagay,4065638,,False,2.0,0,2,0,2,0,0,0,0,0,1,1,0,0,0,0,0,0
400915413,Boston College Eagles,N. Popovic,4065637,,False,12.0,3,7,2,5,1,2,0,0,0,4,4,1,0,1,1,5,7
400915413,Boston College Eagles,A.J. Turner,3943608,,False,24.0,1,4,0,0,1,4,0,0,0,4,4,5,0,1,0,2,3
400915413,Boston College Eagles,G. Owens,66277,,False,4.0,0,2,0,2,0,0,0,0,0,0,0,1,0,0,0,0,0
400915413,Boston College Eagles,TEAM,TOTAL,TOTAL,False,,29,64,17,36,12,28,10,14,9,27,36,18,4,2,11,20,80
400915412,Pittsburgh Panthers,M. Young,66290,,True,38.0,7,11,5,7,2,4,3,3,2,8,10,2,1,0,1,3,19
400915412,Pittsburgh Panthers,S. Jeter,61756,,True,30.0,1,3,1,1,0,2,0,0,1,3,4,4,1,0,0,1,2
400915412,Pittsburgh Panthers,J. Artis,66287,,True,38.0,6,15,3,5,3,10,2,2,0,1,1,5,1,0,3,3,17
400915412,Pittsburgh Panthers,C. Johnson,3138196,,True,40.0,9,13,3,4,6,9,0,0,0,1,1,2,0,1,1,4,24
400915412,Pittsburgh Panthers,C. Jones,61219,,True,26.0,5,6,3,3,2,3,0,0,0,2,2,4,0,0,2,3,12
400915412,Pittsburgh Panthers,R. Nix,3934653,,False,12.0,1,2,1,2,0,0,0,0,2,0,2,0,0,0,0,2,2
400915412,Pittsburgh Panthers,J. Kithcart,4065713,,False,2.0,0,0,0,0,0,0,0,0,0,0,0,0,0,0,0,0,0
400915412,Pittsburgh Panthers,D. Wilson,3934652,,False,14.0,1,4,1,3,0,1,0,0,0,1,1,0,0,0,1,0,2
400915412,Pittsburgh Panthers,TEAM,TOTAL,TOTAL,False,,30,54,17,25,13,29,5,5,6,17,23,17,3,1,10,16,78
400915412,Pittsburgh Panthers,M. Young,66290,,True,38.0,7,11,5,7,2,4,3,3,2,8,10,2,1,0,1,3,19
400915412,Pittsburgh Panthers,S. Jeter,61756,,True,30.0,1,3,1,1,0,2,0,0,1,3,4,4,1,0,0,1,2
400915412,Pittsburgh Panthers,J. Artis,66287,,True,38.0,6,15,3,5,3,10,2,2,0,1,1,5,1,0,3,3,17
400915412,Pittsburgh Panthers,C. Johnson,3138196,,True,40.0,9,13,3,4,6,9,0,0,0,1,1,2,0,1,1,4,24
400915412,Pittsburgh Panthers,C. Jones,61219,,True,26.0,5,6,3,3,2,3,0,0,0,2,2,4,0,0,2,3,12
400915412,Pittsburgh Panthers,R. Nix,3934653,,False,12.0,1,2,1,2,0,0,0,0,2,0,2,0,0,0,0,2,2
400915412,Pittsburgh Panthers,J. Kithcart,4065713,,False,2.0,0,0,0,0,0,0,0,0,0,0,0,0,0,0,0,0,0
400915412,Pittsburgh Panthers,D. Wilson,3934652,,False,14.0,1,4,1,3,0,1,0,0,0,1,1,0,0,0,1,0,2
400915412,Pittsburgh Panthers,TEAM,TOTAL,TOTAL,False,,30,54,17,25,13,29,5,5,6,17,23,17,3,1,10,16,78
400915412,North Carolina Tar Heels,J. Jackson,3138156,,True,38.0,7,16,4,7,3,9,3,4,2,4,6,3,0,0,2,2,20
400915412,North Carolina Tar Heels,I. Hicks,66874,,True,33.0,6,8,6,8,0,0,6,8,2,6,8,2,1,0,1,2,18
400915412,North Carolina Tar Heels,K. Meeks,66873,,True,29.0,5,10,5,10,0,0,0,0,3,2,5,0,1,3,1,2,10
400915412,North Carolina Tar Heels,K. Williams,3911619,,True,17.0,1,3,1,1,0,2,0,0,0,1,1,2,0,0,1,1,2
400915412,North Carolina Tar Heels,J. Berry II,3138155,,True,37.0,6,12,1,3,5,9,2,3,0,1,1,3,0,0,2,1,19
400915412,North Carolina Tar Heels,T. Bradley,4065673,,False,10.0,1,2,1,2,0,0,0,1,3,1,4,0,0,0,0,0,2
400915412,North Carolina Tar Heels,L. Maye,3911620,,False,7.0,3,3,2,2,1,1,0,0,1,0,1,0,0,0,1,2,7
400915412,North Carolina Tar Heels,S. Woods,4065676,,False,2.0,0,0,0,0,0,0,0,0,0,0,0,2,0,0,0,1,0
400915412,North Carolina Tar Heels,B. Robinson,4065675,,False,4.0,0,0,0,0,0,0,0,0,0,0,0,1,0,0,0,0,0
400915412,North Carolina Tar Heels,N. Britt,66872,,False,23.0,0,4,0,1,0,3,2,3,0,1,1,4,1,0,0,2,2
400915412,North Carolina Tar Heels,TEAM,TOTAL,TOTAL,False,,29,58,20,34,9,24,13,19,15,16,31,17,3,3,8,13,80
400915412,North Carolina Tar Heels,J. Jackson,3138156,,True,38.0,7,16,4,7,3,9,3,4,2,4,6,3,0,0,2,2,20
400915412,North Carolina Tar Heels,I. Hicks,66874,,True,33.0,6,8,6,8,0,0,6,8,2,6,8,2,1,0,1,2,18
400915412,North Carolina Tar Heels,K. Meeks,66873,,True,29.0,5,10,5,10,0,0,0,0,3,2,5,0,1,3,1,2,10
400915412,North Carolina Tar Heels,K. Williams,3911619,,True,17.0,1,3,1,1,0,2,0,0,0,1,1,2,0,0,1,1,2
400915412,North Carolina Tar Heels,J. Berry II,3138155,,True,37.0,6,12,1,3,5,9,2,3,0,1,1,3,0,0,2,1,19
400915412,North Carolina Tar Heels,T. Bradley,4065673,,False,10.0,1,2,1,2,0,0,0,1,3,1,4,0,0,0,0,0,2
400915412,North Carolina Tar Heels,L. Maye,3911620,,False,7.0,3,3,2,2,1,1,0,0,1,0,1,0,0,0,1,2,7
400915412,North Carolina Tar Heels,S. Woods,4065676,,False,2.0,0,0,0,0,0,0,0,0,0,0,0,2,0,0,0,1,0
400915412,North Carolina Tar Heels,B. Robinson,4065675,,False,4.0,0,0,0,0,0,0,0,0,0,0,0,1,0,0,0,0,0
400915412,North Carolina Tar Heels,N. Britt,66872,,False,23.0,0,4,0,1,0,3,2,3,0,1,1,4,1,0,0,2,2
400915412,North Carolina Tar Heels,TEAM,TOTAL,TOTAL,False,,29,58,20,34,9,24,13,19,15,16,31,17,3,3,8,13,80
400915411,Notre Dame Fighting Irish,B. Colson,3138192,,True,34.0,8,12,8,11,0,1,1,3,2,7,9,1,0,2,0,4,17
400915411,Notre Dame Fighting Irish,M. Geben,3138191,,True,7.0,0,0,0,0,0,0,0,0,0,1,1,0,0,0,1,0,0
400915411,Notre Dame Fighting Irish,V.J. Beachem,66283,,True,35.0,7,14,5,8,2,6,4,4,2,1,3,0,2,2,1,2,20
400915411,Notre Dame Fighting Irish,M. Farrell,3138190,,True,37.0,3,9,1,4,2,5,3,4,0,2,2,4,3,0,2,2,11
400915411,Notre Dame Fighting Irish,S. Vasturia,66285,,True,36.0,1,9,1,4,0,5,5,6,0,2,2,4,0,0,1,3,7
400915411,Notre Dame Fighting Irish,J. Mooney,4065705,,False,1.0,0,1,0,1,0,0,0,0,0,0,0,0,0,0,0,0,0
400915411,Notre Dame Fighting Irish,E. Burns,3908337,,False,1.0,0,0,0,0,0,0,0,0,0,0,0,0,0,0,0,0,0
400915411,Notre Dame Fighting Irish,A. Torres,66286,,False,8.0,0,0,0,0,0,0,0,4,1,0,1,0,0,0,0,1,0
400915411,Notre Dame Fighting Irish,M. Ryan,3908336,,False,2.0,0,0,0,0,0,0,0,0,0,0,0,0,0,0,0,1,0
400915411,Notre Dame Fighting Irish,T. Gibbs,4065703,,False,19.0,3,7,1,5,2,2,4,4,2,1,3,1,1,0,2,4,12
400915411,Notre Dame Fighting Irish,R. Pflueger,3908335,,False,20.0,2,4,1,2,1,2,2,3,0,4,4,2,0,0,1,3,7
400915411,Notre Dame Fighting Irish,TEAM,TOTAL,TOTAL,False,,24,56,17,35,7,21,19,28,8,18,26,12,6,4,8,21,74
400915411,Notre Dame Fighting Irish,B. Colson,3138192,,True,34.0,8,12,8,11,0,1,1,3,2,7,9,1,0,2,0,4,17
400915411,Notre Dame Fighting Irish,M. Geben,3138191,,True,7.0,0,0,0,0,0,0,0,0,0,1,1,0,0,0,1,0,0
400915411,Notre Dame Fighting Irish,V.J. Beachem,66283,,True,35.0,7,14,5,8,2,6,4,4,2,1,3,0,2,2,1,2,20
400915411,Notre Dame Fighting Irish,M. Farrell,3138190,,True,37.0,3,9,1,4,2,5,3,4,0,2,2,4,3,0,2,2,11
400915411,Notre Dame Fighting Irish,S. Vasturia,66285,,True,36.0,1,9,1,4,0,5,5,6,0,2,2,4,0,0,1,3,7
400915411,Notre Dame Fighting Irish,J. Mooney,4065705,,False,1.0,0,1,0,1,0,0,0,0,0,0,0,0,0,0,0,0,0
400915411,Notre Dame Fighting Irish,E. Burns,3908337,,False,1.0,0,0,0,0,0,0,0,0,0,0,0,0,0,0,0,0,0
400915411,Notre Dame Fighting Irish,A. Torres,66286,,False,8.0,0,0,0,0,0,0,0,4,1,0,1,0,0,0,0,1,0
400915411,Notre Dame Fighting Irish,M. Ryan,3908336,,False,2.0,0,0,0,0,0,0,0,0,0,0,0,0,0,0,0,1,0
400915411,Notre Dame Fighting Irish,T. Gibbs,4065703,,False,19.0,3,7,1,5,2,2,4,4,2,1,3,1,1,0,2,4,12
400915411,Notre Dame Fighting Irish,R. Pflueger,3908335,,False,20.0,2,4,1,2,1,2,2,3,0,4,4,2,0,0,1,3,7
400915411,Notre Dame Fighting Irish,TEAM,TOTAL,TOTAL,False,,24,56,17,35,7,21,19,28,8,18,26,12,6,4,8,21,74
400915411,Duke Blue Devils,J. Tatum,4065648,,True,37.0,8,14,8,13,0,1,3,3,3,11,14,2,1,1,5,4,19
400915411,Duke Blue Devils,A. Jefferson,61586,,True,31.0,3,7,3,7,0,0,0,1,1,3,4,0,1,0,1,5,6
400915411,Duke Blue Devils,L. Kennard,3913174,,True,32.0,5,11,4,9,1,2,5,5,1,3,4,2,0,0,1,5,16
400915411,Duke Blue Devils,G. Allen,3135045,,True,36.0,6,13,3,6,3,7,6,6,0,5,5,3,0,1,3,3,21
400915411,Duke Blue Devils,M. Jones,66563,,True,38.0,5,6,4,4,1,2,5,5,2,3,5,3,1,0,1,3,16
400915411,Duke Blue Devils,H. Giles III,4065649,,False,9.0,1,2,1,2,0,0,2,2,2,3,5,1,0,0,1,4,4
400915411,Duke Blue Devils,A. Vrankovic,3913177,,False,2.0,0,0,0,0,0,0,0,0,0,0,0,0,0,0,1,1,0
400915411,Duke Blue Devils,F. Jackson,4065651,,False,15.0,0,1,0,1,0,0,2,2,0,0,0,0,1,1,2,2,2
400915411,Duke Blue Devils,TEAM,TOTAL,TOTAL,False,,28,54,23,42,5,12,23,24,9,29,38,11,4,3,15,27,84
400915411,Duke Blue Devils,J. Tatum,4065648,,True,37.0,8,14,8,13,0,1,3,3,3,11,14,2,1,1,5,4,19
400915411,Duke Blue Devils,A. Jefferson,61586,,True,31.0,3,7,3,7,0,0,0,1,1,3,4,0,1,0,1,5,6
400915411,Duke Blue Devils,L. Kennard,3913174,,True,32.0,5,11,4,9,1,2,5,5,1,3,4,2,0,0,1,5,16
400915411,Duke Blue Devils,G. Allen,3135045,,True,36.0,6,13,3,6,3,7,6,6,0,5,5,3,0,1,3,3,21
400915411,Duke Blue Devils,M. Jones,66563,,True,38.0,5,6,4,4,1,2,5,5,2,3,5,3,1,0,1,3,16
400915411,Duke Blue Devils,H. Giles III,4065649,,False,9.0,1,2,1,2,0,0,2,2,2,3,5,1,0,0,1,4,4
400915411,Duke Blue Devils,A. Vrankovic,3913177,,False,2.0,0,0,0,0,0,0,0,0,0,0,0,0,0,0,1,1,0
400915411,Duke Blue Devils,F. Jackson,4065651,,False,15.0,0,1,0,1,0,0,2,2,0,0,0,0,1,1,2,2,2
400915411,Duke Blue Devils,TEAM,TOTAL,TOTAL,False,,28,54,23,42,5,12,23,24,9,29,38,11,4,3,15,27,84
400915410,Virginia Tech Hokies,K. Sy,4065740,,True,10.0,0,1,0,1,0,0,1,2,0,0,0,0,0,0,1,2,1
400915410,Virginia Tech Hokies,J. Robinson,3945566,,True,32.0,3,5,2,3,1,2,0,2,0,3,3,3,3,1,2,1,7
400915410,Virginia Tech Hokies,J. Bibbs,3147500,,True,32.0,6,9,2,4,4,5,2,2,0,3,3,3,0,0,0,2,18
400915410,Virginia Tech Hokies,T. Outlaw,67275,,True,12.0,3,5,0,1,3,4,0,0,0,1,1,0,0,1,1,1,9
400915410,Virginia Tech Hokies,S. Allen,61795,,True,35.0,5,7,3,3,2,4,6,8,0,6,6,4,0,0,1,3,18
400915410,Virginia Tech Hokies,Z. LeDay,61698,,False,28.0,5,8,4,6,1,2,6,8,0,3,3,1,1,0,2,4,17
400915410,Virginia Tech Hokies,C. Clarke,3945567,,False,28.0,2,6,2,6,0,0,1,2,1,4,5,3,0,0,3,2,5
400915410,Virginia Tech Hokies,A. Hill,3147501,,False,23.0,2,3,1,2,1,1,5,6,0,3,3,1,0,0,2,1,10
400915410,Virginia Tech Hokies,TEAM,TOTAL,TOTAL,False,,26,44,14,26,12,18,21,30,1,25,26,15,4,2,12,16,85
400915410,Virginia Tech Hokies,K. Sy,4065740,,True,10.0,0,1,0,1,0,0,1,2,0,0,0,0,0,0,1,2,1
400915410,Virginia Tech Hokies,J. Robinson,3945566,,True,32.0,3,5,2,3,1,2,0,2,0,3,3,3,3,1,2,1,7
400915410,Virginia Tech Hokies,J. Bibbs,3147500,,True,32.0,6,9,2,4,4,5,2,2,0,3,3,3,0,0,0,2,18
400915410,Virginia Tech Hokies,T. Outlaw,67275,,True,12.0,3,5,0,1,3,4,0,0,0,1,1,0,0,1,1,1,9
400915410,Virginia Tech Hokies,S. Allen,61795,,True,35.0,5,7,3,3,2,4,6,8,0,6,6,4,0,0,1,3,18
400915410,Virginia Tech Hokies,Z. LeDay,61698,,False,28.0,5,8,4,6,1,2,6,8,0,3,3,1,1,0,2,4,17
400915410,Virginia Tech Hokies,C. Clarke,3945567,,False,28.0,2,6,2,6,0,0,1,2,1,4,5,3,0,0,3,2,5
400915410,Virginia Tech Hokies,A. Hill,3147501,,False,23.0,2,3,1,2,1,1,5,6,0,3,3,1,0,0,2,1,10
400915410,Virginia Tech Hokies,TEAM,TOTAL,TOTAL,False,,26,44,14,26,12,18,21,30,1,25,26,15,4,2,12,16,85
400915410,Boston College Eagles,A.J. Turner,3943608,,True,25.0,1,6,0,2,1,4,1,3,1,3,4,0,0,0,1,2,4
400915410,Boston College Eagles,M. Jeffers,61901,,True,26.0,3,3,3,3,0,0,1,1,4,5,9,1,1,0,1,4,7
400915410,Boston College Eagles,C. Tava,61446,,True,29.0,0,3,0,2,0,1,2,2,0,1,1,3,0,1,4,4,2
400915410,Boston College Eagles,K. Bowman,4065635,,True,39.0,5,18,3,9,2,9,5,9,1,9,10,4,1,0,2,0,17
400915410,Boston College Eagles,J. Robinson,3943606,,True,26.0,7,15,7,11,0,4,3,3,2,1,3,1,1,0,1,4,17
400915410,Boston College Eagles,N. Popovic,4065637,,False,12.0,1,4,1,4,0,0,0,0,0,2,2,2,0,0,0,0,2
400915410,Boston College Eagles,G. Owens,66277,,False,7.0,0,0,0,0,0,0,0,0,2,1,3,1,0,0,3,1,0
400915410,Boston College Eagles,J. Chatman,3135095,,False,36.0,10,12,1,1,9,11,1,1,0,0,0,1,0,0,0,4,30
400915410,Boston College Eagles,TEAM,TOTAL,TOTAL,False,,27,61,15,32,12,29,13,19,12,23,35,13,3,1,12,19,79
400915410,Boston College Eagles,A.J. Turner,3943608,,True,25.0,1,6,0,2,1,4,1,3,1,3,4,0,0,0,1,2,4
400915410,Boston College Eagles,M. Jeffers,61901,,True,26.0,3,3,3,3,0,0,1,1,4,5,9,1,1,0,1,4,7
400915410,Boston College Eagles,C. Tava,61446,,True,29.0,0,3,0,2,0,1,2,2,0,1,1,3,0,1,4,4,2
400915410,Boston College Eagles,K. Bowman,4065635,,True,39.0,5,18,3,9,2,9,5,9,1,9,10,4,1,0,2,0,17
400915410,Boston College Eagles,J. Robinson,3943606,,True,26.0,7,15,7,11,0,4,3,3,2,1,3,1,1,0,1,4,17
400915410,Boston College Eagles,N. Popovic,4065637,,False,12.0,1,4,1,4,0,0,0,0,0,2,2,2,0,0,0,0,2
400915410,Boston College Eagles,G. Owens,66277,,False,7.0,0,0,0,0,0,0,0,0,2,1,3,1,0,0,3,1,0
400915410,Boston College Eagles,J. Chatman,3135095,,False,36.0,10,12,1,1,9,11,1,1,0,0,0,1,0,0,0,4,30
400915410,Boston College Eagles,TEAM,TOTAL,TOTAL,False,,27,61,15,32,12,29,13,19,12,23,35,13,3,1,12,19,79
400915409,NC State Wolfpack,A. Abu,3138158,,True,31.0,6,10,6,10,0,0,1,2,3,3,6,0,1,0,2,4,13
400915409,NC State Wolfpack,O. Yurtseven,66768,,True,24.0,2,4,2,4,0,0,3,4,1,4,5,1,0,2,0,1,7
400915409,NC State Wolfpack,M. Rowan,3947151,,True,30.0,4,12,1,4,3,8,2,2,0,3,3,0,0,0,1,1,13
400915409,NC State Wolfpack,D. Smith Jr.,4065697,,True,29.0,3,12,3,10,0,2,2,4,2,3,5,6,3,0,5,3,8
400915409,NC State Wolfpack,T. Henderson,61215,,True,19.0,3,7,0,1,3,6,0,0,0,3,3,1,0,0,3,2,9
400915409,NC State Wolfpack,T. Kapita,4065701,,False,22.0,1,5,1,5,0,0,1,1,1,1,2,0,1,1,1,3,3
400915409,NC State Wolfpack,D. Hicks,4065698,,False,3.0,0,0,0,0,0,0,0,0,0,0,0,0,0,0,0,1,0
400915409,NC State Wolfpack,M. Johnson,4065699,,False,21.0,0,1,0,0,0,1,2,2,0,1,1,2,0,0,1,2,2
400915409,NC State Wolfpack,T. Dorn,3132359,,False,21.0,2,5,2,3,0,2,1,2,2,3,5,0,0,0,1,1,5
400915409,NC State Wolfpack,TEAM,TOTAL,TOTAL,False,,21,56,15,37,6,19,12,17,12,22,34,10,5,3,15,18,60
400915409,NC State Wolfpack,A. Abu,3138158,,True,31.0,6,10,6,10,0,0,1,2,3,3,6,0,1,0,2,4,13
400915409,NC State Wolfpack,O. Yurtseven,66768,,True,24.0,2,4,2,4,0,0,3,4,1,4,5,1,0,2,0,1,7
400915409,NC State Wolfpack,M. Rowan,3947151,,True,30.0,4,12,1,4,3,8,2,2,0,3,3,0,0,0,1,1,13
400915409,NC State Wolfpack,D. Smith Jr.,4065697,,True,29.0,3,12,3,10,0,2,2,4,2,3,5,6,3,0,5,3,8
400915409,NC State Wolfpack,T. Henderson,61215,,True,19.0,3,7,0,1,3,6,0,0,0,3,3,1,0,0,3,2,9
400915409,NC State Wolfpack,T. Kapita,4065701,,False,22.0,1,5,1,5,0,0,1,1,1,1,2,0,1,1,1,3,3
400915409,NC State Wolfpack,D. Hicks,4065698,,False,3.0,0,0,0,0,0,0,0,0,0,0,0,0,0,0,0,1,0
400915409,NC State Wolfpack,M. Johnson,4065699,,False,21.0,0,1,0,0,0,1,2,2,0,1,1,2,0,0,1,2,2
400915409,NC State Wolfpack,T. Dorn,3132359,,False,21.0,2,5,2,3,0,2,1,2,2,3,5,0,0,0,1,1,5
400915409,NC State Wolfpack,TEAM,TOTAL,TOTAL,False,,21,56,15,37,6,19,12,17,12,22,34,10,5,3,15,18,60
400915409,Louisville Cardinals,A. Mahmoud,3147363,,True,14.0,1,3,1,3,0,0,0,0,0,2,2,1,0,1,1,4,2
400915409,Louisville Cardinals,D. Adel,3908807,,True,30.0,4,11,2,6,2,5,0,0,0,3,3,3,0,0,2,1,10
400915409,Louisville Cardinals,J. Johnson,3147362,,True,24.0,2,4,2,4,0,0,2,3,2,1,3,0,1,0,2,1,6
400915409,Louisville Cardinals,D. Mitchell,3908809,,True,37.0,9,17,3,7,6,10,4,4,2,6,8,5,2,0,2,3,28
400915409,Louisville Cardinals,D. Levitch,66592,,True,24.0,2,5,0,0,2,5,0,0,1,0,1,3,2,0,0,3,6
400915409,Louisville Cardinals,V.J. King,4065666,,False,17.0,2,4,1,3,1,1,4,4,1,6,7,3,1,1,2,0,9
400915409,Louisville Cardinals,R. Spalding,3908806,,False,15.0,2,4,2,4,0,0,1,2,2,4,6,2,0,1,1,2,5
400915409,Louisville Cardinals,M. Mathiang,63035,,False,25.0,7,9,7,9,0,0,0,0,2,3,5,1,0,0,0,2,14
400915409,Louisville Cardinals,M. Stockman,3147361,,False,2.0,0,0,0,0,0,0,0,0,0,0,0,0,0,0,0,0,0
400915409,Louisville Cardinals,R. McMahon,3908808,,False,11.0,1,3,0,0,1,3,2,2,0,0,0,1,1,0,0,3,5
400915409,Louisville Cardinals,J. Henderson,3155491,,False,1.0,0,0,0,0,0,0,0,0,0,0,0,0,0,0,0,0,0
400915409,Louisville Cardinals,TEAM,TOTAL,TOTAL,False,,30,60,18,36,12,24,13,15,10,26,36,19,7,3,10,19,85
400915409,Louisville Cardinals,A. Mahmoud,3147363,,True,14.0,1,3,1,3,0,0,0,0,0,2,2,1,0,1,1,4,2
400915409,Louisville Cardinals,D. Adel,3908807,,True,30.0,4,11,2,6,2,5,0,0,0,3,3,3,0,0,2,1,10
400915409,Louisville Cardinals,J. Johnson,3147362,,True,24.0,2,4,2,4,0,0,2,3,2,1,3,0,1,0,2,1,6
400915409,Louisville Cardinals,D. Mitchell,3908809,,True,37.0,9,17,3,7,6,10,4,4,2,6,8,5,2,0,2,3,28
400915409,Louisville Cardinals,D. Levitch,66592,,True,24.0,2,5,0,0,2,5,0,0,1,0,1,3,2,0,0,3,6
400915409,Louisville Cardinals,V.J. King,4065666,,False,17.0,2,4,1,3,1,1,4,4,1,6,7,3,1,1,2,0,9
400915409,Louisville Cardinals,R. Spalding,3908806,,False,15.0,2,4,2,4,0,0,1,2,2,4,6,2,0,1,1,2,5
400915409,Louisville Cardinals,M. Mathiang,63035,,False,25.0,7,9,7,9,0,0,0,0,2,3,5,1,0,0,0,2,14
400915409,Louisville Cardinals,M. Stockman,3147361,,False,2.0,0,0,0,0,0,0,0,0,0,0,0,0,0,0,0,0,0
400915409,Louisville Cardinals,R. McMahon,3908808,,False,11.0,1,3,0,0,1,3,2,2,0,0,0,1,1,0,0,3,5
400915409,Louisville Cardinals,J. Henderson,3155491,,False,1.0,0,0,0,0,0,0,0,0,0,0,0,0,0,0,0,0,0
400915409,Louisville Cardinals,TEAM,TOTAL,TOTAL,False,,30,60,18,36,12,24,13,15,10,26,36,19,7,3,10,19,85
400915408,Virginia Cavaliers,I. Wilkins,3138203,,True,35.0,6,6,6,6,0,0,0,0,2,6,8,0,1,2,1,1,12
400915408,Virginia Cavaliers,J. Salt,3138200,,True,20.0,2,2,2,2,0,0,0,0,3,0,3,1,1,0,0,4,4
400915408,Virginia Cavaliers,M. Shayok,3138201,,True,36.0,6,12,5,9,1,3,1,1,0,1,1,1,1,0,2,3,14
400915408,Virginia Cavaliers,L. Perrantes,66139,,True,31.0,2,11,2,8,0,3,0,0,0,3,3,6,0,0,2,3,4
400915408,Virginia Cavaliers,D. Hall,66138,,True,31.0,2,5,1,1,1,4,2,2,1,2,3,3,1,0,2,3,7
400915408,Virginia Cavaliers,T. Jerome,4065733,,False,24.0,6,9,3,3,3,6,0,0,0,1,1,0,1,0,0,3,15
400915408,Virginia Cavaliers,K. Guy,4065730,,False,6.0,0,3,0,3,0,0,0,0,0,0,0,0,0,0,1,1,0
400915408,Virginia Cavaliers,D. Thompson,66274,,False,17.0,1,2,0,0,1,2,0,0,0,0,0,2,1,0,1,0,3
400915408,Virginia Cavaliers,TEAM,TOTAL,TOTAL,False,,25,50,19,32,6,18,3,3,6,18,24,13,6,2,9,18,59
400915408,Villanova Wildcats,D. Reynolds,66174,,True,20.0,1,3,1,3,0,0,0,0,0,1,1,0,0,0,0,0,2
400915408,Villanova Wildcats,K. Jenkins,66172,,True,35.0,2,10,0,2,2,8,2,2,0,5,5,0,1,0,2,1,8
400915408,Villanova Wildcats,J. Brunson,3934672,,True,33.0,3,4,3,4,0,0,9,10,0,1,1,4,0,0,0,1,15
400915408,Villanova Wildcats,M. Bridges,3147657,,True,37.0,6,9,3,5,3,4,0,0,1,4,5,1,2,2,2,0,15
400915408,Villanova Wildcats,J. Hart,66173,,True,37.0,2,9,0,5,2,4,6,8,1,3,4,2,0,0,2,3,12
400915408,Villanova Wildcats,E. Paschall,3133817,,False,19.0,2,4,2,4,0,0,2,2,2,3,5,0,1,0,2,3,6
400915408,Villanova Wildcats,D. DiVincenzo,3934673,,False,19.0,1,1,1,1,0,0,1,2,1,1,2,2,1,0,2,0,3
400915408,Villanova Wildcats,TEAM,TOTAL,TOTAL,False,,17,40,10,24,7,16,20,24,6,19,25,9,5,2,10,8,61
400915407,Wake Forest Demon Deacons,J. Collins,3908845,,True,22.0,7,10,7,10,0,0,6,9,5,3,8,0,0,1,2,4,20
400915407,Wake Forest Demon Deacons,D. Mitoglou,3138224,,True,20.0,2,4,2,3,0,1,0,0,1,3,4,0,0,0,0,2,4
400915407,Wake Forest Demon Deacons,A. Arians,61378,,True,22.0,2,6,0,1,2,5,1,2,3,4,7,0,1,0,0,2,7
400915407,Wake Forest Demon Deacons,B. Crawford,3908844,,True,34.0,5,15,4,11,1,4,15,15,0,6,6,4,0,0,0,2,26
400915407,Wake Forest Demon Deacons,K. Woods,3132360,,True,32.0,6,9,4,5,2,4,1,2,0,2,2,4,1,0,3,2,15
400915407,Wake Forest Demon Deacons,G. McClinton,66140,,False,3.0,0,0,0,0,0,0,0,0,0,0,0,0,0,0,0,0,0
400915407,Wake Forest Demon Deacons,S. Japhet-Mathias,4065752,,False,1.0,0,0,0,0,0,0,0,0,0,0,0,0,0,0,0,0,0
400915407,Wake Forest Demon Deacons,D. Moore,3908843,,False,11.0,1,1,1,1,0,0,2,4,0,1,1,0,0,1,2,3,4
400915407,Wake Forest Demon Deacons,B. Childress,4065750,,False,29.0,2,6,2,4,0,2,0,0,0,1,1,7,0,0,0,2,4
400915407,Wake Forest Demon Deacons,M. Wilbekin,3138222,,False,26.0,1,4,0,0,1,4,0,0,0,0,0,1,1,0,0,3,3
400915407,Wake Forest Demon Deacons,TEAM,TOTAL,TOTAL,False,,26,55,20,35,6,20,25,32,9,20,29,16,3,2,9,20,83
400915407,Wake Forest Demon Deacons,J. Collins,3908845,,True,22.0,7,10,7,10,0,0,6,9,5,3,8,0,0,1,2,4,20
400915407,Wake Forest Demon Deacons,D. Mitoglou,3138224,,True,20.0,2,4,2,3,0,1,0,0,1,3,4,0,0,0,0,2,4
400915407,Wake Forest Demon Deacons,A. Arians,61378,,True,22.0,2,6,0,1,2,5,1,2,3,4,7,0,1,0,0,2,7
400915407,Wake Forest Demon Deacons,B. Crawford,3908844,,True,34.0,5,15,4,11,1,4,15,15,0,6,6,4,0,0,0,2,26
400915407,Wake Forest Demon Deacons,K. Woods,3132360,,True,32.0,6,9,4,5,2,4,1,2,0,2,2,4,1,0,3,2,15
400915407,Wake Forest Demon Deacons,G. McClinton,66140,,False,3.0,0,0,0,0,0,0,0,0,0,0,0,0,0,0,0,0,0
400915407,Wake Forest Demon Deacons,S. Japhet-Mathias,4065752,,False,1.0,0,0,0,0,0,0,0,0,0,0,0,0,0,0,0,0,0
400915407,Wake Forest Demon Deacons,D. Moore,3908843,,False,11.0,1,1,1,1,0,0,2,4,0,1,1,0,0,1,2,3,4
400915407,Wake Forest Demon Deacons,B. Childress,4065750,,False,29.0,2,6,2,4,0,2,0,0,0,1,1,7,0,0,0,2,4
400915407,Wake Forest Demon Deacons,M. Wilbekin,3138222,,False,26.0,1,4,0,0,1,4,0,0,0,0,0,1,1,0,0,3,3
400915407,Wake Forest Demon Deacons,TEAM,TOTAL,TOTAL,False,,26,55,20,35,6,20,25,32,9,20,29,16,3,2,9,20,83
400915407,Duke Blue Devils,J. Tatum,4065648,,True,21.0,2,6,1,3,1,3,3,4,1,4,5,1,1,1,3,5,8
400915407,Duke Blue Devils,A. Jefferson,61586,,True,20.0,2,2,2,2,0,0,0,0,1,2,3,0,0,0,1,4,4
400915407,Duke Blue Devils,L. Kennard,3913174,,True,33.0,11,14,5,8,6,6,6,10,0,4,4,4,0,0,3,2,34
400915407,Duke Blue Devils,G. Allen,3135045,,True,33.0,5,13,0,2,5,11,4,4,3,3,6,3,1,0,4,4,19
400915407,Duke Blue Devils,M. Jones,66563,,True,39.0,1,10,0,2,1,8,0,0,1,2,3,6,0,0,3,3,3
400915407,Duke Blue Devils,J. White,4065653,,False,3.0,0,0,0,0,0,0,0,0,0,0,0,0,0,0,0,0,0
400915407,Duke Blue Devils,H. Giles III,4065649,,False,18.0,3,5,3,5,0,0,0,0,3,2,5,0,0,1,1,4,6
400915407,Duke Blue Devils,M. Bolden,4065652,,False,3.0,0,0,0,0,0,0,0,0,0,0,0,0,0,0,0,2,0
400915407,Duke Blue Devils,A. Vrankovic,3913177,,False,6.0,1,1,1,1,0,0,0,0,0,0,0,0,0,0,0,4,2
400915407,Duke Blue Devils,F. Jackson,4065651,,False,24.0,3,7,2,4,1,3,2,2,1,3,4,4,0,0,0,2,9
400915407,Duke Blue Devils,TEAM,TOTAL,TOTAL,False,,28,58,14,27,14,31,15,20,12,24,36,18,2,2,15,30,85
400915407,Duke Blue Devils,J. Tatum,4065648,,True,21.0,2,6,1,3,1,3,3,4,1,4,5,1,1,1,3,5,8
400915407,Duke Blue Devils,A. Jefferson,61586,,True,20.0,2,2,2,2,0,0,0,0,1,2,3,0,0,0,1,4,4
400915407,Duke Blue Devils,L. Kennard,3913174,,True,33.0,11,14,5,8,6,6,6,10,0,4,4,4,0,0,3,2,34
400915407,Duke Blue Devils,G. Allen,3135045,,True,33.0,5,13,0,2,5,11,4,4,3,3,6,3,1,0,4,4,19
400915407,Duke Blue Devils,M. Jones,66563,,True,39.0,1,10,0,2,1,8,0,0,1,2,3,6,0,0,3,3,3
400915407,Duke Blue Devils,J. White,4065653,,False,3.0,0,0,0,0,0,0,0,0,0,0,0,0,0,0,0,0,0
400915407,Duke Blue Devils,H. Giles III,4065649,,False,18.0,3,5,3,5,0,0,0,0,3,2,5,0,0,1,1,4,6
400915407,Duke Blue Devils,M. Bolden,4065652,,False,3.0,0,0,0,0,0,0,0,0,0,0,0,0,0,0,0,2,0
400915407,Duke Blue Devils,A. Vrankovic,3913177,,False,6.0,1,1,1,1,0,0,0,0,0,0,0,0,0,0,0,4,2
400915407,Duke Blue Devils,F. Jackson,4065651,,False,24.0,3,7,2,4,1,3,2,2,1,3,4,4,0,0,0,2,9
400915407,Duke Blue Devils,TEAM,TOTAL,TOTAL,False,,28,58,14,27,14,31,15,20,12,24,36,18,2,2,15,30,85
400915406,North Carolina Tar Heels,J. Jackson,3138156,,True,33.0,7,16,3,6,4,10,3,4,1,0,1,0,0,0,4,1,21
400915406,North Carolina Tar Heels,I. Hicks,66874,,True,23.0,3,6,3,6,0,0,1,2,0,6,6,1,0,2,2,3,7
400915406,North Carolina Tar Heels,K. Meeks,66873,,True,19.0,1,3,1,3,0,0,3,4,2,4,6,0,0,0,0,2,5
400915406,North Carolina Tar Heels,K. Williams,3911619,,True,24.0,1,8,1,3,0,5,0,0,1,2,3,1,0,0,1,1,2
400915406,North Carolina Tar Heels,J. Berry II,3138155,,True,30.0,0,8,0,4,0,4,2,2,0,1,1,4,1,0,2,3,2
400915406,North Carolina Tar Heels,A. Rohlman,4065677,,False,0.0,0,0,0,0,0,0,0,0,0,0,0,0,0,0,0,0,0
400915406,North Carolina Tar Heels,S. Rush,4065674,,False,0.0,0,0,0,0,0,0,0,2,0,0,0,0,0,0,0,0,0
400915406,North Carolina Tar Heels,T. Bradley,4065673,,False,16.0,3,7,3,7,0,0,0,1,3,3,6,1,1,0,1,4,6
400915406,North Carolina Tar Heels,L. Maye,3911620,,False,10.0,2,5,2,5,0,0,0,0,1,1,2,1,0,0,0,1,4
400915406,North Carolina Tar Heels,S. Woods,4065676,,False,11.0,0,1,0,1,0,0,0,0,0,3,3,1,0,1,2,3,0
400915406,North Carolina Tar Heels,B. Robinson,4065675,,False,12.0,1,2,0,0,1,2,2,2,0,1,1,0,0,0,0,2,5
400915406,North Carolina Tar Heels,K. Coker,3947144,,False,0.0,0,0,0,0,0,0,0,0,0,0,0,0,0,0,0,0,0
400915406,North Carolina Tar Heels,N. Britt,66872,,False,22.0,3,4,1,1,2,3,2,2,0,2,2,3,0,0,2,5,10
400915406,North Carolina Tar Heels,S. White,56963,,False,0.0,0,0,0,0,0,0,0,0,0,0,0,0,0,0,0,0,0
400915406,North Carolina Tar Heels,TEAM,TOTAL,TOTAL,False,,21,60,14,36,7,24,13,19,12,24,36,12,2,3,14,25,62
400915406,North Carolina Tar Heels,J. Jackson,3138156,,True,33.0,7,16,3,6,4,10,3,4,1,0,1,0,0,0,4,1,21
400915406,North Carolina Tar Heels,I. Hicks,66874,,True,23.0,3,6,3,6,0,0,1,2,0,6,6,1,0,2,2,3,7
400915406,North Carolina Tar Heels,K. Meeks,66873,,True,19.0,1,3,1,3,0,0,3,4,2,4,6,0,0,0,0,2,5
400915406,North Carolina Tar Heels,K. Williams,3911619,,True,24.0,1,8,1,3,0,5,0,0,1,2,3,1,0,0,1,1,2
400915406,North Carolina Tar Heels,J. Berry II,3138155,,True,30.0,0,8,0,4,0,4,2,2,0,1,1,4,1,0,2,3,2
400915406,North Carolina Tar Heels,A. Rohlman,4065677,,False,0.0,0,0,0,0,0,0,0,0,0,0,0,0,0,0,0,0,0
400915406,North Carolina Tar Heels,S. Rush,4065674,,False,0.0,0,0,0,0,0,0,0,2,0,0,0,0,0,0,0,0,0
400915406,North Carolina Tar Heels,T. Bradley,4065673,,False,16.0,3,7,3,7,0,0,0,1,3,3,6,1,1,0,1,4,6
400915406,North Carolina Tar Heels,L. Maye,3911620,,False,10.0,2,5,2,5,0,0,0,0,1,1,2,1,0,0,0,1,4
400915406,North Carolina Tar Heels,S. Woods,4065676,,False,11.0,0,1,0,1,0,0,0,0,0,3,3,1,0,1,2,3,0
400915406,North Carolina Tar Heels,B. Robinson,4065675,,False,12.0,1,2,0,0,1,2,2,2,0,1,1,0,0,0,0,2,5
400915406,North Carolina Tar Heels,K. Coker,3947144,,False,0.0,0,0,0,0,0,0,0,0,0,0,0,0,0,0,0,0,0
400915406,North Carolina Tar Heels,N. Britt,66872,,False,22.0,3,4,1,1,2,3,2,2,0,2,2,3,0,0,2,5,10
400915406,North Carolina Tar Heels,S. White,56963,,False,0.0,0,0,0,0,0,0,0,0,0,0,0,0,0,0,0,0,0
400915406,North Carolina Tar Heels,TEAM,TOTAL,TOTAL,False,,21,60,14,36,7,24,13,19,12,24,36,12,2,3,14,25,62
400915406,Miami Hurricanes,K. Murphy,61668,,True,29.0,2,5,2,5,0,0,0,0,4,5,9,0,0,1,1,4,4
400915406,Miami Hurricanes,B. Brown,4065670,,True,34.0,8,11,4,5,4,6,10,13,1,3,4,5,2,2,4,2,30
400915406,Miami Hurricanes,A. Lawrence II,3904628,,True,31.0,1,5,0,1,1,4,0,0,0,4,4,4,3,1,1,3,3
400915406,Miami Hurricanes,J. Newton,3138145,,True,27.0,6,14,6,12,0,2,6,6,1,6,7,3,1,0,2,4,18
400915406,Miami Hurricanes,D. Reed,66130,,True,37.0,3,12,2,8,1,4,7,9,2,5,7,2,1,0,1,3,14
400915406,Miami Hurricanes,D. Hernandez,4065672,,False,19.0,2,3,2,3,0,0,1,2,1,0,1,0,1,0,1,1,5
400915406,Miami Hurricanes,C. Stowell,3138149,,False,1.0,0,0,0,0,0,0,0,0,0,0,0,0,0,0,0,0,0
400915406,Miami Hurricanes,E. Izundu,3904629,,False,8.0,0,1,0,1,0,0,0,0,0,3,3,0,0,2,0,2,0
400915406,Miami Hurricanes,D. Vasiljevic,4065669,,False,14.0,1,5,0,1,1,4,0,0,0,1,1,0,0,0,0,0,3
400915406,Miami Hurricanes,M. Robinson,3947140,,False,0.0,0,0,0,0,0,0,0,0,0,0,0,0,0,0,0,1,0
400915406,Miami Hurricanes,TEAM,TOTAL,TOTAL,False,,23,56,16,36,7,20,24,30,11,30,41,14,8,6,10,20,77
400915406,Miami Hurricanes,K. Murphy,61668,,True,29.0,2,5,2,5,0,0,0,0,4,5,9,0,0,1,1,4,4
400915406,Miami Hurricanes,B. Brown,4065670,,True,34.0,8,11,4,5,4,6,10,13,1,3,4,5,2,2,4,2,30
400915406,Miami Hurricanes,A. Lawrence II,3904628,,True,31.0,1,5,0,1,1,4,0,0,0,4,4,4,3,1,1,3,3
400915406,Miami Hurricanes,J. Newton,3138145,,True,27.0,6,14,6,12,0,2,6,6,1,6,7,3,1,0,2,4,18
400915406,Miami Hurricanes,D. Reed,66130,,True,37.0,3,12,2,8,1,4,7,9,2,5,7,2,1,0,1,3,14
400915406,Miami Hurricanes,D. Hernandez,4065672,,False,19.0,2,3,2,3,0,0,1,2,1,0,1,0,1,0,1,1,5
400915406,Miami Hurricanes,C. Stowell,3138149,,False,1.0,0,0,0,0,0,0,0,0,0,0,0,0,0,0,0,0,0
400915406,Miami Hurricanes,E. Izundu,3904629,,False,8.0,0,1,0,1,0,0,0,0,0,3,3,0,0,2,0,2,0
400915406,Miami Hurricanes,D. Vasiljevic,4065669,,False,14.0,1,5,0,1,1,4,0,0,0,1,1,0,0,0,0,0,3
400915406,Miami Hurricanes,M. Robinson,3947140,,False,0.0,0,0,0,0,0,0,0,0,0,0,0,0,0,0,0,1,0
400915406,Miami Hurricanes,TEAM,TOTAL,TOTAL,False,,23,56,16,36,7,20,24,30,11,30,41,14,8,6,10,20,77
400915405,Syracuse Orange,T. Thompson,4065721,,True,7.0,1,4,1,3,0,1,0,0,0,1,1,0,0,0,1,4,2
400915405,Syracuse Orange,T. Lydon,3934662,,True,40.0,4,8,2,3,2,5,4,4,4,7,11,1,0,6,2,3,14
400915405,Syracuse Orange,T. Battle,4065722,,True,37.0,3,11,2,7,1,4,2,2,1,3,4,4,3,0,1,2,9
400915405,Syracuse Orange,J. Gillon,61915,,True,36.0,3,8,1,4,2,4,13,14,2,1,3,11,1,1,2,3,21
400915405,Syracuse Orange,A. White III,61616,,True,40.0,8,16,4,6,4,10,4,4,1,8,9,1,4,0,4,2,24
400915405,Syracuse Orange,T. Roberson,67633,,False,33.0,5,8,5,8,0,0,0,6,3,4,7,1,3,2,2,3,10
400915405,Syracuse Orange,F. Howard,3934659,,False,7.0,1,3,1,3,0,0,0,0,1,0,1,2,0,0,3,3,2
400915405,Syracuse Orange,TEAM,TOTAL,TOTAL,False,,25,58,16,34,9,24,23,30,16,26,42,20,11,9,16,20,82
400915405,Syracuse Orange,T. Thompson,4065721,,True,7.0,1,4,1,3,0,1,0,0,0,1,1,0,0,0,1,4,2
400915405,Syracuse Orange,T. Lydon,3934662,,True,40.0,4,8,2,3,2,5,4,4,4,7,11,1,0,6,2,3,14
400915405,Syracuse Orange,T. Battle,4065722,,True,37.0,3,11,2,7,1,4,2,2,1,3,4,4,3,0,1,2,9
400915405,Syracuse Orange,J. Gillon,61915,,True,36.0,3,8,1,4,2,4,13,14,2,1,3,11,1,1,2,3,21
400915405,Syracuse Orange,A. White III,61616,,True,40.0,8,16,4,6,4,10,4,4,1,8,9,1,4,0,4,2,24
400915405,Syracuse Orange,T. Roberson,67633,,False,33.0,5,8,5,8,0,0,0,6,3,4,7,1,3,2,2,3,10
400915405,Syracuse Orange,F. Howard,3934659,,False,7.0,1,3,1,3,0,0,0,0,1,0,1,2,0,0,3,3,2
400915405,Syracuse Orange,TEAM,TOTAL,TOTAL,False,,25,58,16,34,9,24,23,30,16,26,42,20,11,9,16,20,82
400915405,Florida State Seminoles,J. Isaac,4065654,,True,28.0,5,9,4,7,1,2,8,10,3,9,12,0,0,2,2,4,19
400915405,Florida State Seminoles,M. Ojo,61596,,True,6.0,0,1,0,1,0,0,0,0,1,1,2,0,0,0,1,0,0
400915405,Florida State Seminoles,T. Mann,3907823,,True,25.0,0,3,0,3,0,0,3,4,3,0,3,2,0,0,2,3,3
400915405,Florida State Seminoles,X. Rathan-Mayes,66125,,True,32.0,5,10,1,1,4,9,2,6,2,0,2,5,0,0,2,4,16
400915405,Florida State Seminoles,D. Bacon,3907821,,True,33.0,8,18,5,11,3,7,0,0,2,2,4,0,0,0,2,3,19
400915405,Florida State Seminoles,P. Cofer,3135054,,False,6.0,0,1,0,1,0,0,0,0,0,1,1,0,0,0,1,0,0
400915405,Florida State Seminoles,J. Smith,66126,,False,27.0,2,3,2,2,0,1,2,2,5,4,9,4,0,1,2,4,6
400915405,Florida State Seminoles,B. Allen,66124,,False,9.0,0,1,0,0,0,1,0,0,0,0,0,1,1,0,0,0,0
400915405,Florida State Seminoles,C. Koumadje,3907824,,False,7.0,1,2,1,2,0,0,0,0,0,2,2,0,2,1,1,0,2
400915405,Florida State Seminoles,B. Angola-Rodas,4065658,,False,7.0,1,3,0,1,1,2,1,2,0,0,0,0,1,0,0,1,4
400915405,Florida State Seminoles,P. Savoy,4065657,,False,2.0,0,2,0,1,0,1,0,0,0,0,0,1,0,0,1,0,0
400915405,Florida State Seminoles,T. Forrest,4065656,,False,9.0,0,4,0,4,0,0,0,0,0,0,0,0,0,0,0,0,0
400915405,Florida State Seminoles,C. Walker,4065655,,False,9.0,1,3,1,1,0,2,1,2,0,0,0,1,2,0,1,2,3
400915405,Florida State Seminoles,TEAM,TOTAL,TOTAL,False,,23,60,14,35,9,25,17,26,17,22,39,14,6,4,15,21,72
400915405,Florida State Seminoles,J. Isaac,4065654,,True,28.0,5,9,4,7,1,2,8,10,3,9,12,0,0,2,2,4,19
400915405,Florida State Seminoles,M. Ojo,61596,,True,6.0,0,1,0,1,0,0,0,0,1,1,2,0,0,0,1,0,0
400915405,Florida State Seminoles,T. Mann,3907823,,True,25.0,0,3,0,3,0,0,3,4,3,0,3,2,0,0,2,3,3
400915405,Florida State Seminoles,X. Rathan-Mayes,66125,,True,32.0,5,10,1,1,4,9,2,6,2,0,2,5,0,0,2,4,16
400915405,Florida State Seminoles,D. Bacon,3907821,,True,33.0,8,18,5,11,3,7,0,0,2,2,4,0,0,0,2,3,19
400915405,Florida State Seminoles,P. Cofer,3135054,,False,6.0,0,1,0,1,0,0,0,0,0,1,1,0,0,0,1,0,0
400915405,Florida State Seminoles,J. Smith,66126,,False,27.0,2,3,2,2,0,1,2,2,5,4,9,4,0,1,2,4,6
400915405,Florida State Seminoles,B. Allen,66124,,False,9.0,0,1,0,0,0,1,0,0,0,0,0,1,1,0,0,0,0
400915405,Florida State Seminoles,C. Koumadje,3907824,,False,7.0,1,2,1,2,0,0,0,0,0,2,2,0,2,1,1,0,2
400915405,Florida State Seminoles,B. Angola-Rodas,4065658,,False,7.0,1,3,0,1,1,2,1,2,0,0,0,0,1,0,0,1,4
400915405,Florida State Seminoles,P. Savoy,4065657,,False,2.0,0,2,0,1,0,1,0,0,0,0,0,1,0,0,1,0,0
400915405,Florida State Seminoles,T. Forrest,4065656,,False,9.0,0,4,0,4,0,0,0,0,0,0,0,0,0,0,0,0,0
400915405,Florida State Seminoles,C. Walker,4065655,,False,9.0,1,3,1,1,0,2,1,2,0,0,0,1,2,0,1,2,3
400915405,Florida State Seminoles,TEAM,TOTAL,TOTAL,False,,23,60,14,35,9,25,17,26,17,22,39,14,6,4,15,21,72
400915404,Pittsburgh Panthers,M. Young,66290,,True,34.0,3,16,2,9,1,7,7,8,3,5,8,1,1,0,1,3,14
400915404,Pittsburgh Panthers,S. Jeter,61756,,True,36.0,1,6,0,1,1,5,0,0,1,7,8,4,1,0,1,3,3
400915404,Pittsburgh Panthers,J. Artis,66287,,True,32.0,7,15,5,10,2,5,0,0,2,2,4,3,0,0,1,2,16
400915404,Pittsburgh Panthers,C. Johnson,3138196,,True,34.0,4,10,2,6,2,4,6,7,1,1,2,1,0,0,0,2,16
400915404,Pittsburgh Panthers,C. Jones,61219,,True,31.0,1,3,1,3,0,0,3,5,2,1,3,2,0,0,2,0,5
400915404,Pittsburgh Panthers,R. Nix,3934653,,False,6.0,0,1,0,1,0,0,0,0,0,3,3,0,0,0,1,3,0
400915404,Pittsburgh Panthers,C. Manigault,4065714,,False,4.0,0,1,0,0,0,1,0,0,0,0,0,0,0,0,0,0,0
400915404,Pittsburgh Panthers,J. Kithcart,4065713,,False,8.0,0,0,0,0,0,0,0,0,0,0,0,0,0,0,0,1,0
400915404,Pittsburgh Panthers,J. Milligan,3934655,,False,9.0,2,2,0,0,2,2,0,0,0,1,1,0,0,1,1,0,6
400915404,Pittsburgh Panthers,D. Wilson,3934652,,False,6.0,0,1,0,1,0,0,0,0,0,0,0,1,0,0,0,0,0
400915404,Pittsburgh Panthers,TEAM,TOTAL,TOTAL,False,,18,55,10,31,8,24,16,20,13,21,34,12,2,1,7,14,60
400915404,Pittsburgh Panthers,M. Young,66290,,True,34.0,3,16,2,9,1,7,7,8,3,5,8,1,1,0,1,3,14
400915404,Pittsburgh Panthers,S. Jeter,61756,,True,36.0,1,6,0,1,1,5,0,0,1,7,8,4,1,0,1,3,3
400915404,Pittsburgh Panthers,J. Artis,66287,,True,32.0,7,15,5,10,2,5,0,0,2,2,4,3,0,0,1,2,16
400915404,Pittsburgh Panthers,C. Johnson,3138196,,True,34.0,4,10,2,6,2,4,6,7,1,1,2,1,0,0,0,2,16
400915404,Pittsburgh Panthers,C. Jones,61219,,True,31.0,1,3,1,3,0,0,3,5,2,1,3,2,0,0,2,0,5
400915404,Pittsburgh Panthers,R. Nix,3934653,,False,6.0,0,1,0,1,0,0,0,0,0,3,3,0,0,0,1,3,0
400915404,Pittsburgh Panthers,C. Manigault,4065714,,False,4.0,0,1,0,0,0,1,0,0,0,0,0,0,0,0,0,0,0
400915404,Pittsburgh Panthers,J. Kithcart,4065713,,False,8.0,0,0,0,0,0,0,0,0,0,0,0,0,0,0,0,1,0
400915404,Pittsburgh Panthers,J. Milligan,3934655,,False,9.0,2,2,0,0,2,2,0,0,0,1,1,0,0,1,1,0,6
400915404,Pittsburgh Panthers,D. Wilson,3934652,,False,6.0,0,1,0,1,0,0,0,0,0,0,0,1,0,0,0,0,0
400915404,Pittsburgh Panthers,TEAM,TOTAL,TOTAL,False,,18,55,10,31,8,24,16,20,13,21,34,12,2,1,7,14,60
400915404,Clemson Tigers,E. Thomas,3947075,,True,30.0,2,7,2,7,0,0,0,0,2,5,7,0,0,1,3,5,4
400915404,Clemson Tigers,D. Grantham,3129674,,True,34.0,3,5,3,3,0,2,0,0,3,5,8,2,3,1,3,2,6
400915404,Clemson Tigers,J. Blossomgame,61835,,True,38.0,10,14,6,8,4,6,1,2,1,6,7,2,0,2,1,0,25
400915404,Clemson Tigers,S. Mitchell,3136699,,True,34.0,4,9,4,7,0,2,4,5,0,3,3,6,0,0,0,1,12
400915404,Clemson Tigers,A. Holmes,62043,,True,21.0,0,3,0,1,0,2,1,2,0,3,3,0,1,0,0,1,1
400915404,Clemson Tigers,L. Robertin,3917985,,False,4.0,0,0,0,0,0,0,0,0,0,1,1,0,0,0,0,2,0
400915404,Clemson Tigers,M. Reed,3133969,,False,16.0,4,8,3,6,1,2,1,2,1,2,3,2,0,0,0,3,10
400915404,Clemson Tigers,G. DeVoe,3129673,,False,23.0,4,6,3,4,1,2,0,0,1,1,2,1,0,1,2,2,9
400915404,Clemson Tigers,TEAM,TOTAL,TOTAL,False,,27,52,21,36,6,16,7,11,8,28,36,13,4,5,9,16,67
400915404,Clemson Tigers,E. Thomas,3947075,,True,30.0,2,7,2,7,0,0,0,0,2,5,7,0,0,1,3,5,4
400915404,Clemson Tigers,D. Grantham,3129674,,True,34.0,3,5,3,3,0,2,0,0,3,5,8,2,3,1,3,2,6
400915404,Clemson Tigers,J. Blossomgame,61835,,True,38.0,10,14,6,8,4,6,1,2,1,6,7,2,0,2,1,0,25
400915404,Clemson Tigers,S. Mitchell,3136699,,True,34.0,4,9,4,7,0,2,4,5,0,3,3,6,0,0,0,1,12
400915404,Clemson Tigers,A. Holmes,62043,,True,21.0,0,3,0,1,0,2,1,2,0,3,3,0,1,0,0,1,1
400915404,Clemson Tigers,L. Robertin,3917985,,False,4.0,0,0,0,0,0,0,0,0,0,1,1,0,0,0,0,2,0
400915404,Clemson Tigers,M. Reed,3133969,,False,16.0,4,8,3,6,1,2,1,2,1,2,3,2,0,0,0,3,10
400915404,Clemson Tigers,G. DeVoe,3129673,,False,23.0,4,6,3,4,1,2,0,0,1,1,2,1,0,1,2,2,9
400915404,Clemson Tigers,TEAM,TOTAL,TOTAL,False,,27,52,21,36,6,16,7,11,8,28,36,13,4,5,9,16,67
400915403,Notre Dame Fighting Irish,B. Colson,3138192,,True,30.0,6,10,6,10,0,0,1,3,3,10,13,1,1,1,2,2,13
400915403,Notre Dame Fighting Irish,M. Geben,3138191,,True,8.0,0,2,0,2,0,0,2,2,0,1,1,2,1,0,0,2,2
400915403,Notre Dame Fighting Irish,V.J. Beachem,66283,,True,37.0,10,16,7,10,3,6,0,0,0,4,4,0,0,0,0,0,23
400915403,Notre Dame Fighting Irish,M. Farrell,3138190,,True,39.0,5,14,2,9,3,5,2,2,0,0,0,4,3,0,3,2,15
400915403,Notre Dame Fighting Irish,S. Vasturia,66285,,True,39.0,1,7,0,3,1,4,2,2,1,3,4,3,3,0,3,3,5
400915403,Notre Dame Fighting Irish,A. Torres,66286,,False,21.0,1,4,1,4,0,0,0,2,3,2,5,0,0,0,0,1,2
400915403,Notre Dame Fighting Irish,M. Ryan,3908336,,False,2.0,0,1,0,1,0,0,0,0,0,0,0,0,0,0,1,0,0
400915403,Notre Dame Fighting Irish,T. Gibbs,4065703,,False,11.0,0,2,0,1,0,1,0,0,0,0,0,1,0,0,1,1,0
400915403,Notre Dame Fighting Irish,R. Pflueger,3908335,,False,13.0,0,1,0,0,0,1,0,0,0,0,0,2,0,0,1,1,0
400915403,Notre Dame Fighting Irish,TEAM,TOTAL,TOTAL,False,,23,57,16,40,7,17,7,11,9,20,29,13,8,1,11,12,60
400915403,Notre Dame Fighting Irish,B. Colson,3138192,,True,30.0,6,10,6,10,0,0,1,3,3,10,13,1,1,1,2,2,13
400915403,Notre Dame Fighting Irish,M. Geben,3138191,,True,8.0,0,2,0,2,0,0,2,2,0,1,1,2,1,0,0,2,2
400915403,Notre Dame Fighting Irish,V.J. Beachem,66283,,True,37.0,10,16,7,10,3,6,0,0,0,4,4,0,0,0,0,0,23
400915403,Notre Dame Fighting Irish,M. Farrell,3138190,,True,39.0,5,14,2,9,3,5,2,2,0,0,0,4,3,0,3,2,15
400915403,Notre Dame Fighting Irish,S. Vasturia,66285,,True,39.0,1,7,0,3,1,4,2,2,1,3,4,3,3,0,3,3,5
400915403,Notre Dame Fighting Irish,A. Torres,66286,,False,21.0,1,4,1,4,0,0,0,2,3,2,5,0,0,0,0,1,2
400915403,Notre Dame Fighting Irish,M. Ryan,3908336,,False,2.0,0,1,0,1,0,0,0,0,0,0,0,0,0,0,1,0,0
400915403,Notre Dame Fighting Irish,T. Gibbs,4065703,,False,11.0,0,2,0,1,0,1,0,0,0,0,0,1,0,0,1,1,0
400915403,Notre Dame Fighting Irish,R. Pflueger,3908335,,False,13.0,0,1,0,0,0,1,0,0,0,0,0,2,0,0,1,1,0
400915403,Notre Dame Fighting Irish,TEAM,TOTAL,TOTAL,False,,23,57,16,40,7,17,7,11,9,20,29,13,8,1,11,12,60
400915403,Georgia Tech Yellow Jackets,Q. Stephens,66128,,True,38.0,2,8,1,2,1,6,0,0,3,10,13,2,0,3,0,1,5
400915403,Georgia Tech Yellow Jackets,B. Lammers,3135061,,True,40.0,7,14,7,14,0,0,1,2,4,6,10,3,1,3,5,1,15
400915403,Georgia Tech Yellow Jackets,J. Okogie,4065663,,True,18.0,2,5,2,5,0,0,4,6,1,5,6,1,0,1,4,3,8
400915403,Georgia Tech Yellow Jackets,J. Heath,67623,,True,39.0,4,6,4,4,0,2,1,2,1,1,2,8,5,0,3,2,9
400915403,Georgia Tech Yellow Jackets,C. Heyward,61609,,True,38.0,0,2,0,0,0,2,0,0,2,1,3,1,2,0,0,0,0
400915403,Georgia Tech Yellow Jackets,J. Moore,4065662,,False,1.0,0,0,0,0,0,0,0,0,0,0,0,0,0,0,0,0,0
400915403,Georgia Tech Yellow Jackets,T. Jackson,3135057,,False,26.0,11,19,8,13,3,6,0,2,0,2,2,3,0,0,3,2,25
400915403,Georgia Tech Yellow Jackets,TEAM,TOTAL,TOTAL,False,,26,54,22,38,4,16,6,12,12,25,37,18,8,7,15,9,62
400915403,Georgia Tech Yellow Jackets,Q. Stephens,66128,,True,38.0,2,8,1,2,1,6,0,0,3,10,13,2,0,3,0,1,5
400915403,Georgia Tech Yellow Jackets,B. Lammers,3135061,,True,40.0,7,14,7,14,0,0,1,2,4,6,10,3,1,3,5,1,15
400915403,Georgia Tech Yellow Jackets,J. Okogie,4065663,,True,18.0,2,5,2,5,0,0,4,6,1,5,6,1,0,1,4,3,8
400915403,Georgia Tech Yellow Jackets,J. Heath,67623,,True,39.0,4,6,4,4,0,2,1,2,1,1,2,8,5,0,3,2,9
400915403,Georgia Tech Yellow Jackets,C. Heyward,61609,,True,38.0,0,2,0,0,0,2,0,0,2,1,3,1,2,0,0,0,0
400915403,Georgia Tech Yellow Jackets,J. Moore,4065662,,False,1.0,0,0,0,0,0,0,0,0,0,0,0,0,0,0,0,0,0
400915403,Georgia Tech Yellow Jackets,T. Jackson,3135057,,False,26.0,11,19,8,13,3,6,0,2,0,2,2,3,0,0,3,2,25
400915403,Georgia Tech Yellow Jackets,TEAM,TOTAL,TOTAL,False,,26,54,22,38,4,16,6,12,12,25,37,18,8,7,15,9,62
400915402,Virginia Tech Hokies,K. Sy,4065740,,True,17.0,1,3,1,3,0,0,0,2,0,1,1,0,0,1,0,1,2
400915402,Virginia Tech Hokies,T. Outlaw,67275,,True,20.0,1,4,0,0,1,4,0,0,0,5,5,1,1,0,1,1,3
400915402,Virginia Tech Hokies,J. Robinson,3945566,,True,32.0,6,9,4,5,2,4,3,4,0,2,2,7,0,0,2,3,17
400915402,Virginia Tech Hokies,J. Bibbs,3147500,,True,32.0,2,6,0,0,2,6,1,2,0,0,0,1,1,1,0,2,7
400915402,Virginia Tech Hokies,S. Allen,61795,,True,31.0,7,12,4,6,3,6,2,2,1,1,2,5,1,0,2,0,19
400915402,Virginia Tech Hokies,Z. LeDay,61698,,False,23.0,5,9,4,7,1,2,1,1,0,3,3,0,0,1,4,3,12
400915402,Virginia Tech Hokies,C. Clarke,3945567,,False,26.0,3,3,3,3,0,0,3,4,1,2,3,0,1,0,1,2,9
400915402,Virginia Tech Hokies,M. Galloway,3945565,,False,1.0,0,0,0,0,0,0,0,0,0,0,0,0,0,0,0,0,0
400915402,Virginia Tech Hokies,A. Hill,3147501,,False,18.0,1,5,1,2,0,3,1,3,0,1,1,0,0,0,0,1,3
400915402,Virginia Tech Hokies,TEAM,TOTAL,TOTAL,False,,26,51,17,26,9,25,11,18,4,18,22,14,4,3,10,13,72
400915402,Virginia Tech Hokies,K. Sy,4065740,,True,17.0,1,3,1,3,0,0,0,2,0,1,1,0,0,1,0,1,2
400915402,Virginia Tech Hokies,T. Outlaw,67275,,True,20.0,1,4,0,0,1,4,0,0,0,5,5,1,1,0,1,1,3
400915402,Virginia Tech Hokies,J. Robinson,3945566,,True,32.0,6,9,4,5,2,4,3,4,0,2,2,7,0,0,2,3,17
400915402,Virginia Tech Hokies,J. Bibbs,3147500,,True,32.0,2,6,0,0,2,6,1,2,0,0,0,1,1,1,0,2,7
400915402,Virginia Tech Hokies,S. Allen,61795,,True,31.0,7,12,4,6,3,6,2,2,1,1,2,5,1,0,2,0,19
400915402,Virginia Tech Hokies,Z. LeDay,61698,,False,23.0,5,9,4,7,1,2,1,1,0,3,3,0,0,1,4,3,12
400915402,Virginia Tech Hokies,C. Clarke,3945567,,False,26.0,3,3,3,3,0,0,3,4,1,2,3,0,1,0,1,2,9
400915402,Virginia Tech Hokies,M. Galloway,3945565,,False,1.0,0,0,0,0,0,0,0,0,0,0,0,0,0,0,0,0,0
400915402,Virginia Tech Hokies,A. Hill,3147501,,False,18.0,1,5,1,2,0,3,1,3,0,1,1,0,0,0,0,1,3
400915402,Virginia Tech Hokies,TEAM,TOTAL,TOTAL,False,,26,51,17,26,9,25,11,18,4,18,22,14,4,3,10,13,72
400915402,North Carolina Tar Heels,J. Jackson,3138156,,True,32.0,10,20,5,8,5,12,1,2,3,0,3,4,0,2,0,1,26
400915402,North Carolina Tar Heels,I. Hicks,66874,,True,26.0,2,4,2,4,0,0,2,3,3,3,6,2,0,0,0,4,6
400915402,North Carolina Tar Heels,K. Meeks,66873,,True,21.0,7,13,7,13,0,0,1,1,7,7,14,3,0,1,1,4,15
400915402,North Carolina Tar Heels,K. Williams,3911619,,True,27.0,1,5,0,2,1,3,0,1,1,4,5,2,0,0,3,2,3
400915402,North Carolina Tar Heels,J. Berry II,3138155,,True,30.0,5,14,0,4,5,10,0,0,1,2,3,4,1,1,0,2,15
400915402,North Carolina Tar Heels,A. Rohlman,4065677,,False,1.0,0,0,0,0,0,0,0,0,0,0,0,0,0,0,0,0,0
400915402,North Carolina Tar Heels,S. Rush,4065674,,False,1.0,0,0,0,0,0,0,0,0,0,0,0,0,0,0,1,0,0
400915402,North Carolina Tar Heels,T. Bradley,4065673,,False,19.0,3,4,3,4,0,0,1,2,1,5,6,1,0,1,0,1,7
400915402,North Carolina Tar Heels,L. Maye,3911620,,False,10.0,2,3,2,3,0,0,0,0,0,0,0,3,0,0,0,0,4
400915402,North Carolina Tar Heels,T. Pinson,3138154,,False,6.0,2,2,1,1,1,1,0,0,1,2,3,2,1,0,0,1,5
400915402,North Carolina Tar Heels,S. Woods,4065676,,False,9.0,1,3,1,2,0,1,0,0,0,0,0,3,0,0,1,0,2
400915402,North Carolina Tar Heels,B. Robinson,4065675,,False,4.0,1,2,0,0,1,2,0,0,0,0,0,0,0,0,0,0,3
400915402,North Carolina Tar Heels,K. Coker,3947144,,False,1.0,0,0,0,0,0,0,0,0,0,0,0,0,0,0,0,0,0
400915402,North Carolina Tar Heels,N. Britt,66872,,False,12.0,2,3,1,2,1,1,0,0,1,0,1,1,1,0,1,1,5
400915402,North Carolina Tar Heels,S. White,56963,,False,1.0,0,0,0,0,0,0,0,0,0,0,0,0,0,0,0,0,0
400915402,North Carolina Tar Heels,TEAM,TOTAL,TOTAL,False,,36,73,22,43,14,30,5,9,19,24,43,25,3,5,7,16,91
400915402,North Carolina Tar Heels,J. Jackson,3138156,,True,32.0,10,20,5,8,5,12,1,2,3,0,3,4,0,2,0,1,26
400915402,North Carolina Tar Heels,I. Hicks,66874,,True,26.0,2,4,2,4,0,0,2,3,3,3,6,2,0,0,0,4,6
400915402,North Carolina Tar Heels,K. Meeks,66873,,True,21.0,7,13,7,13,0,0,1,1,7,7,14,3,0,1,1,4,15
400915402,North Carolina Tar Heels,K. Williams,3911619,,True,27.0,1,5,0,2,1,3,0,1,1,4,5,2,0,0,3,2,3
400915402,North Carolina Tar Heels,J. Berry II,3138155,,True,30.0,5,14,0,4,5,10,0,0,1,2,3,4,1,1,0,2,15
400915402,North Carolina Tar Heels,A. Rohlman,4065677,,False,1.0,0,0,0,0,0,0,0,0,0,0,0,0,0,0,0,0,0
400915402,North Carolina Tar Heels,S. Rush,4065674,,False,1.0,0,0,0,0,0,0,0,0,0,0,0,0,0,0,1,0,0
400915402,North Carolina Tar Heels,T. Bradley,4065673,,False,19.0,3,4,3,4,0,0,1,2,1,5,6,1,0,1,0,1,7
400915402,North Carolina Tar Heels,L. Maye,3911620,,False,10.0,2,3,2,3,0,0,0,0,0,0,0,3,0,0,0,0,4
400915402,North Carolina Tar Heels,T. Pinson,3138154,,False,6.0,2,2,1,1,1,1,0,0,1,2,3,2,1,0,0,1,5
400915402,North Carolina Tar Heels,S. Woods,4065676,,False,9.0,1,3,1,2,0,1,0,0,0,0,0,3,0,0,1,0,2
400915402,North Carolina Tar Heels,B. Robinson,4065675,,False,4.0,1,2,0,0,1,2,0,0,0,0,0,0,0,0,0,0,3
400915402,North Carolina Tar Heels,K. Coker,3947144,,False,1.0,0,0,0,0,0,0,0,0,0,0,0,0,0,0,0,0,0
400915402,North Carolina Tar Heels,N. Britt,66872,,False,12.0,2,3,1,2,1,1,0,0,1,0,1,1,1,0,1,1,5
400915402,North Carolina Tar Heels,S. White,56963,,False,1.0,0,0,0,0,0,0,0,0,0,0,0,0,0,0,0,0,0
400915402,North Carolina Tar Heels,TEAM,TOTAL,TOTAL,False,,36,73,22,43,14,30,5,9,19,24,43,25,3,5,7,16,91
400915401,Miami Hurricanes,K. Murphy,61668,,True,33.0,2,5,2,5,0,0,4,4,1,6,7,0,1,1,2,3,8
400915401,Miami Hurricanes,A. Lawrence II,3904628,,True,30.0,2,5,0,1,2,4,1,2,1,5,6,1,0,0,3,1,7
400915401,Miami Hurricanes,B. Brown,4065670,,True,35.0,4,8,3,6,1,2,3,7,0,6,6,4,2,1,0,2,12
400915401,Miami Hurricanes,J. Newton,3138145,,True,32.0,8,13,8,12,0,1,7,7,1,4,5,2,2,0,5,1,23
400915401,Miami Hurricanes,D. Reed,66130,,True,37.0,6,10,4,5,2,5,3,3,1,2,3,4,1,3,4,4,17
400915401,Miami Hurricanes,D. Hernandez,4065672,,False,11.0,4,5,4,5,0,0,0,1,2,1,3,1,1,0,1,2,8
400915401,Miami Hurricanes,E. Izundu,3904629,,False,6.0,0,2,0,2,0,0,0,0,0,2,2,0,0,0,0,2,0
400915401,Miami Hurricanes,D. Vasiljevic,4065669,,False,16.0,1,6,0,0,1,6,0,0,0,1,1,0,0,0,0,0,3
400915401,Miami Hurricanes,TEAM,TOTAL,TOTAL,False,,27,54,21,36,6,18,18,24,7,28,35,12,7,5,15,15,78
400915401,Miami Hurricanes,K. Murphy,61668,,True,33.0,2,5,2,5,0,0,4,4,1,6,7,0,1,1,2,3,8
400915401,Miami Hurricanes,A. Lawrence II,3904628,,True,30.0,2,5,0,1,2,4,1,2,1,5,6,1,0,0,3,1,7
400915401,Miami Hurricanes,B. Brown,4065670,,True,35.0,4,8,3,6,1,2,3,7,0,6,6,4,2,1,0,2,12
400915401,Miami Hurricanes,J. Newton,3138145,,True,32.0,8,13,8,12,0,1,7,7,1,4,5,2,2,0,5,1,23
400915401,Miami Hurricanes,D. Reed,66130,,True,37.0,6,10,4,5,2,5,3,3,1,2,3,4,1,3,4,4,17
400915401,Miami Hurricanes,D. Hernandez,4065672,,False,11.0,4,5,4,5,0,0,0,1,2,1,3,1,1,0,1,2,8
400915401,Miami Hurricanes,E. Izundu,3904629,,False,6.0,0,2,0,2,0,0,0,0,0,2,2,0,0,0,0,2,0
400915401,Miami Hurricanes,D. Vasiljevic,4065669,,False,16.0,1,6,0,0,1,6,0,0,0,1,1,0,0,0,0,0,3
400915401,Miami Hurricanes,TEAM,TOTAL,TOTAL,False,,27,54,21,36,6,18,18,24,7,28,35,12,7,5,15,15,78
400915401,Boston College Eagles,A.J. Turner,3943608,,True,37.0,6,11,3,5,3,6,0,0,1,3,4,2,1,0,0,1,15
400915401,Boston College Eagles,M. Jeffers,61901,,True,25.0,4,8,4,8,0,0,1,2,4,5,9,1,1,1,1,2,9
400915401,Boston College Eagles,C. Tava,61446,,True,28.0,2,4,2,2,0,2,0,0,0,2,2,3,1,0,1,5,4
400915401,Boston College Eagles,K. Bowman,4065635,,True,39.0,3,8,1,4,2,4,2,4,0,6,6,3,1,0,3,4,10
400915401,Boston College Eagles,J. Robinson,3943606,,True,35.0,9,18,7,12,2,6,7,9,0,3,3,6,1,0,4,3,27
400915401,Boston College Eagles,N. Popovic,4065637,,False,13.0,3,6,3,6,0,0,0,0,0,2,2,0,0,0,0,2,6
400915401,Boston College Eagles,J. Chatman,3135095,,False,23.0,2,7,0,2,2,5,0,0,1,3,4,1,4,1,3,1,6
400915401,Boston College Eagles,TEAM,TOTAL,TOTAL,False,,29,62,20,39,9,23,10,15,9,24,33,16,9,2,12,18,77
400915401,Boston College Eagles,A.J. Turner,3943608,,True,37.0,6,11,3,5,3,6,0,0,1,3,4,2,1,0,0,1,15
400915401,Boston College Eagles,M. Jeffers,61901,,True,25.0,4,8,4,8,0,0,1,2,4,5,9,1,1,1,1,2,9
400915401,Boston College Eagles,C. Tava,61446,,True,28.0,2,4,2,2,0,2,0,0,0,2,2,3,1,0,1,5,4
400915401,Boston College Eagles,K. Bowman,4065635,,True,39.0,3,8,1,4,2,4,2,4,0,6,6,3,1,0,3,4,10
400915401,Boston College Eagles,J. Robinson,3943606,,True,35.0,9,18,7,12,2,6,7,9,0,3,3,6,1,0,4,3,27
400915401,Boston College Eagles,N. Popovic,4065637,,False,13.0,3,6,3,6,0,0,0,0,0,2,2,0,0,0,0,2,6
400915401,Boston College Eagles,J. Chatman,3135095,,False,23.0,2,7,0,2,2,5,0,0,1,3,4,1,4,1,3,1,6
400915401,Boston College Eagles,TEAM,TOTAL,TOTAL,False,,29,62,20,39,9,23,10,15,9,24,33,16,9,2,12,18,77
400915400,Georgia Tech Yellow Jackets,Q. Stephens,66128,,True,37.0,5,11,2,4,3,7,0,0,2,3,5,0,0,1,2,0,13
400915400,Georgia Tech Yellow Jackets,B. Lammers,3135061,,True,32.0,8,18,8,18,0,0,2,3,3,8,11,4,0,3,1,4,18
400915400,Georgia Tech Yellow Jackets,J. Okogie,4065663,,True,33.0,10,17,9,13,1,4,14,17,3,11,14,5,2,0,2,4,35
400915400,Georgia Tech Yellow Jackets,J. Heath,67623,,True,31.0,0,6,0,6,0,0,0,0,2,3,5,6,1,0,1,3,0
400915400,Georgia Tech Yellow Jackets,C. Heyward,61609,,True,22.0,1,2,0,0,1,2,2,3,1,5,6,2,1,0,0,4,5
400915400,Georgia Tech Yellow Jackets,C. Matthews,4065665,,False,1.0,0,0,0,0,0,0,0,0,0,0,0,0,0,0,0,0,0
400915400,Georgia Tech Yellow Jackets,S. Ogbonda,3904627,,False,1.0,0,0,0,0,0,0,0,0,0,0,0,0,0,0,0,0,0
400915400,Georgia Tech Yellow Jackets,A. Gueye,3135059,,False,8.0,1,2,1,2,0,0,0,0,2,1,3,0,0,2,0,1,2
400915400,Georgia Tech Yellow Jackets,R. Rowland,67543,,False,1.0,0,0,0,0,0,0,0,0,0,0,0,0,0,0,0,0,0
400915400,Georgia Tech Yellow Jackets,K. McCormick,61453,,False,1.0,0,0,0,0,0,0,0,0,0,0,0,0,0,0,0,0,0
400915400,Georgia Tech Yellow Jackets,J. Moore,4065662,,False,10.0,0,0,0,0,0,0,1,4,0,1,1,2,1,0,4,3,1
400915400,Georgia Tech Yellow Jackets,T. Jackson,3135057,,False,22.0,1,4,1,2,0,2,2,4,1,5,6,1,0,0,1,0,4
400915400,Georgia Tech Yellow Jackets,J. Price,61778,,False,1.0,0,1,0,0,0,1,0,0,0,0,0,0,0,0,0,0,0
400915400,Georgia Tech Yellow Jackets,TEAM,TOTAL,TOTAL,False,,26,61,21,45,5,16,21,31,14,39,53,20,5,6,12,19,78
400915400,Georgia Tech Yellow Jackets,Q. Stephens,66128,,True,37.0,5,11,2,4,3,7,0,0,2,3,5,0,0,1,2,0,13
400915400,Georgia Tech Yellow Jackets,B. Lammers,3135061,,True,32.0,8,18,8,18,0,0,2,3,3,8,11,4,0,3,1,4,18
400915400,Georgia Tech Yellow Jackets,J. Okogie,4065663,,True,33.0,10,17,9,13,1,4,14,17,3,11,14,5,2,0,2,4,35
400915400,Georgia Tech Yellow Jackets,J. Heath,67623,,True,31.0,0,6,0,6,0,0,0,0,2,3,5,6,1,0,1,3,0
400915400,Georgia Tech Yellow Jackets,C. Heyward,61609,,True,22.0,1,2,0,0,1,2,2,3,1,5,6,2,1,0,0,4,5
400915400,Georgia Tech Yellow Jackets,C. Matthews,4065665,,False,1.0,0,0,0,0,0,0,0,0,0,0,0,0,0,0,0,0,0
400915400,Georgia Tech Yellow Jackets,S. Ogbonda,3904627,,False,1.0,0,0,0,0,0,0,0,0,0,0,0,0,0,0,0,0,0
400915400,Georgia Tech Yellow Jackets,A. Gueye,3135059,,False,8.0,1,2,1,2,0,0,0,0,2,1,3,0,0,2,0,1,2
400915400,Georgia Tech Yellow Jackets,R. Rowland,67543,,False,1.0,0,0,0,0,0,0,0,0,0,0,0,0,0,0,0,0,0
400915400,Georgia Tech Yellow Jackets,K. McCormick,61453,,False,1.0,0,0,0,0,0,0,0,0,0,0,0,0,0,0,0,0,0
400915400,Georgia Tech Yellow Jackets,J. Moore,4065662,,False,10.0,0,0,0,0,0,0,1,4,0,1,1,2,1,0,4,3,1
400915400,Georgia Tech Yellow Jackets,T. Jackson,3135057,,False,22.0,1,4,1,2,0,2,2,4,1,5,6,1,0,0,1,0,4
400915400,Georgia Tech Yellow Jackets,J. Price,61778,,False,1.0,0,1,0,0,0,1,0,0,0,0,0,0,0,0,0,0,0
400915400,Georgia Tech Yellow Jackets,TEAM,TOTAL,TOTAL,False,,26,61,21,45,5,16,21,31,14,39,53,20,5,6,12,19,78
400915400,Florida State Seminoles,J. Isaac,4065654,,True,25.0,3,10,3,6,0,4,0,0,3,5,8,1,0,2,0,1,6
400915400,Florida State Seminoles,M. Ojo,61596,,True,7.0,1,2,1,2,0,0,3,3,1,0,1,0,0,1,0,2,5
400915400,Florida State Seminoles,T. Mann,3907823,,True,21.0,0,3,0,3,0,0,2,2,1,4,5,3,0,0,0,3,2
400915400,Florida State Seminoles,D. Bacon,3907821,,True,27.0,4,15,1,8,3,7,1,2,0,1,1,1,2,0,3,1,12
400915400,Florida State Seminoles,X. Rathan-Mayes,66125,,True,27.0,2,8,1,5,1,3,0,1,1,2,3,2,0,0,1,3,5
400915400,Florida State Seminoles,P. Cofer,3135054,,False,11.0,1,4,1,3,0,1,0,1,2,0,2,0,0,0,2,0,2
400915400,Florida State Seminoles,J. Smith,66126,,False,13.0,3,4,3,4,0,0,0,0,0,0,0,0,1,2,1,4,6
400915400,Florida State Seminoles,B. Allen,66124,,False,6.0,0,1,0,0,0,1,0,0,1,0,1,0,0,0,0,1,0
400915400,Florida State Seminoles,C. Koumadje,3907824,,False,11.0,1,2,1,2,0,0,0,0,0,1,1,0,0,0,0,3,2
400915400,Florida State Seminoles,B. Angola-Rodas,4065658,,False,7.0,1,3,1,3,0,0,1,1,0,3,3,1,0,0,1,1,3
400915400,Florida State Seminoles,P. Savoy,4065657,,False,13.0,2,8,0,1,2,7,0,2,3,1,4,0,0,0,1,1,6
400915400,Florida State Seminoles,T. Forrest,4065656,,False,19.0,2,5,2,5,0,0,3,3,1,5,6,1,4,0,0,1,7
400915400,Florida State Seminoles,C. Walker,4065655,,False,13.0,0,6,0,4,0,2,0,1,0,1,1,1,0,0,0,0,0
400915400,Florida State Seminoles,TEAM,TOTAL,TOTAL,False,,20,71,14,46,6,25,10,16,14,25,39,10,7,5,9,21,56
400915400,Florida State Seminoles,J. Isaac,4065654,,True,25.0,3,10,3,6,0,4,0,0,3,5,8,1,0,2,0,1,6
400915400,Florida State Seminoles,M. Ojo,61596,,True,7.0,1,2,1,2,0,0,3,3,1,0,1,0,0,1,0,2,5
400915400,Florida State Seminoles,T. Mann,3907823,,True,21.0,0,3,0,3,0,0,2,2,1,4,5,3,0,0,0,3,2
400915400,Florida State Seminoles,D. Bacon,3907821,,True,27.0,4,15,1,8,3,7,1,2,0,1,1,1,2,0,3,1,12
400915400,Florida State Seminoles,X. Rathan-Mayes,66125,,True,27.0,2,8,1,5,1,3,0,1,1,2,3,2,0,0,1,3,5
400915400,Florida State Seminoles,P. Cofer,3135054,,False,11.0,1,4,1,3,0,1,0,1,2,0,2,0,0,0,2,0,2
400915400,Florida State Seminoles,J. Smith,66126,,False,13.0,3,4,3,4,0,0,0,0,0,0,0,0,1,2,1,4,6
400915400,Florida State Seminoles,B. Allen,66124,,False,6.0,0,1,0,0,0,1,0,0,1,0,1,0,0,0,0,1,0
400915400,Florida State Seminoles,C. Koumadje,3907824,,False,11.0,1,2,1,2,0,0,0,0,0,1,1,0,0,0,0,3,2
400915400,Florida State Seminoles,B. Angola-Rodas,4065658,,False,7.0,1,3,1,3,0,0,1,1,0,3,3,1,0,0,1,1,3
400915400,Florida State Seminoles,P. Savoy,4065657,,False,13.0,2,8,0,1,2,7,0,2,3,1,4,0,0,0,1,1,6
400915400,Florida State Seminoles,T. Forrest,4065656,,False,19.0,2,5,2,5,0,0,3,3,1,5,6,1,4,0,0,1,7
400915400,Florida State Seminoles,C. Walker,4065655,,False,13.0,0,6,0,4,0,2,0,1,0,1,1,1,0,0,0,0,0
400915400,Florida State Seminoles,TEAM,TOTAL,TOTAL,False,,20,71,14,46,6,25,10,16,14,25,39,10,7,5,9,21,56
400915399,Wake Forest Demon Deacons,D. Mitoglou,3138224,,True,22.0,2,4,2,2,0,2,1,2,3,3,6,0,0,0,1,3,5
400915399,Wake Forest Demon Deacons,J. Collins,3908845,,True,32.0,9,14,9,14,0,0,5,6,6,6,12,0,1,1,2,4,23
400915399,Wake Forest Demon Deacons,A. Arians,61378,,True,22.0,1,5,0,0,1,5,0,0,0,0,0,2,0,0,0,1,3
400915399,Wake Forest Demon Deacons,B. Crawford,3908844,,True,33.0,4,10,2,4,2,6,3,4,0,3,3,5,0,0,4,4,13
400915399,Wake Forest Demon Deacons,K. Woods,3132360,,True,30.0,2,5,2,4,0,1,2,2,0,1,1,5,0,0,3,4,6
400915399,Wake Forest Demon Deacons,D. Moore,3908843,,False,8.0,2,4,2,4,0,0,4,6,1,2,3,0,0,0,0,2,8
400915399,Wake Forest Demon Deacons,B. Childress,4065750,,False,23.0,3,7,1,3,2,4,2,3,1,2,3,2,3,0,0,3,10
400915399,Wake Forest Demon Deacons,M. Wilbekin,3138222,,False,30.0,3,10,1,4,2,6,0,0,0,1,1,2,0,0,1,4,8
400915399,Wake Forest Demon Deacons,TEAM,TOTAL,TOTAL,False,,26,59,19,35,7,24,17,23,14,23,37,16,4,1,12,25,76
400915399,Wake Forest Demon Deacons,D. Mitoglou,3138224,,True,22.0,2,4,2,2,0,2,1,2,3,3,6,0,0,0,1,3,5
400915399,Wake Forest Demon Deacons,J. Collins,3908845,,True,32.0,9,14,9,14,0,0,5,6,6,6,12,0,1,1,2,4,23
400915399,Wake Forest Demon Deacons,A. Arians,61378,,True,22.0,1,5,0,0,1,5,0,0,0,0,0,2,0,0,0,1,3
400915399,Wake Forest Demon Deacons,B. Crawford,3908844,,True,33.0,4,10,2,4,2,6,3,4,0,3,3,5,0,0,4,4,13
400915399,Wake Forest Demon Deacons,K. Woods,3132360,,True,30.0,2,5,2,4,0,1,2,2,0,1,1,5,0,0,3,4,6
400915399,Wake Forest Demon Deacons,D. Moore,3908843,,False,8.0,2,4,2,4,0,0,4,6,1,2,3,0,0,0,0,2,8
400915399,Wake Forest Demon Deacons,B. Childress,4065750,,False,23.0,3,7,1,3,2,4,2,3,1,2,3,2,3,0,0,3,10
400915399,Wake Forest Demon Deacons,M. Wilbekin,3138222,,False,30.0,3,10,1,4,2,6,0,0,0,1,1,2,0,0,1,4,8
400915399,Wake Forest Demon Deacons,TEAM,TOTAL,TOTAL,False,,26,59,19,35,7,24,17,23,14,23,37,16,4,1,12,25,76
400915399,Syracuse Orange,T. Thompson,4065721,,True,21.0,7,10,7,10,0,0,4,7,0,3,3,0,2,2,0,2,18
400915399,Syracuse Orange,T. Lydon,3934662,,True,40.0,5,12,2,6,3,6,2,2,4,5,9,5,0,2,1,4,15
400915399,Syracuse Orange,T. Battle,4065722,,True,40.0,3,9,3,5,0,4,3,5,2,2,4,4,1,0,0,2,9
400915399,Syracuse Orange,J. Gillon,61915,,True,29.0,2,4,1,1,1,3,1,2,0,2,2,6,3,0,3,1,6
400915399,Syracuse Orange,A. White III,61616,,True,40.0,6,15,1,5,5,10,10,10,1,4,5,1,1,0,2,3,27
400915399,Syracuse Orange,T. Roberson,67633,,False,7.0,2,2,2,2,0,0,1,2,1,1,2,0,0,1,1,4,5
400915399,Syracuse Orange,D. Coleman,61821,,False,12.0,0,1,0,1,0,0,1,2,0,0,0,0,1,0,2,2,1
400915399,Syracuse Orange,F. Howard,3934659,,False,11.0,0,1,0,1,0,0,0,0,1,3,4,2,0,0,1,1,0
400915399,Syracuse Orange,TEAM,TOTAL,TOTAL,False,,25,54,16,31,9,23,22,30,10,22,32,18,8,5,10,19,81
400915399,Syracuse Orange,T. Thompson,4065721,,True,21.0,7,10,7,10,0,0,4,7,0,3,3,0,2,2,0,2,18
400915399,Syracuse Orange,T. Lydon,3934662,,True,40.0,5,12,2,6,3,6,2,2,4,5,9,5,0,2,1,4,15
400915399,Syracuse Orange,T. Battle,4065722,,True,40.0,3,9,3,5,0,4,3,5,2,2,4,4,1,0,0,2,9
400915399,Syracuse Orange,J. Gillon,61915,,True,29.0,2,4,1,1,1,3,1,2,0,2,2,6,3,0,3,1,6
400915399,Syracuse Orange,A. White III,61616,,True,40.0,6,15,1,5,5,10,10,10,1,4,5,1,1,0,2,3,27
400915399,Syracuse Orange,T. Roberson,67633,,False,7.0,2,2,2,2,0,0,1,2,1,1,2,0,0,1,1,4,5
400915399,Syracuse Orange,D. Coleman,61821,,False,12.0,0,1,0,1,0,0,1,2,0,0,0,0,1,0,2,2,1
400915399,Syracuse Orange,F. Howard,3934659,,False,11.0,0,1,0,1,0,0,0,0,1,3,4,2,0,0,1,1,0
400915399,Syracuse Orange,TEAM,TOTAL,TOTAL,False,,25,54,16,31,9,23,22,30,10,22,32,18,8,5,10,19,81
400915398,Virginia Cavaliers,I. Wilkins,3138203,,True,30.0,2,6,2,6,0,0,9,10,2,7,9,1,0,0,0,2,13
400915398,Virginia Cavaliers,J. Salt,3138200,,True,24.0,1,3,1,3,0,0,0,0,3,1,4,0,0,0,0,3,2
400915398,Virginia Cavaliers,M. Shayok,3138201,,True,27.0,5,10,5,10,0,0,0,0,2,1,3,2,3,0,4,2,10
400915398,Virginia Cavaliers,L. Perrantes,66139,,True,34.0,7,13,2,5,5,8,3,4,0,5,5,0,1,0,1,1,22
400915398,Virginia Cavaliers,D. Hall,66138,,True,32.0,5,9,4,6,1,3,0,0,1,8,9,2,0,0,0,1,11
400915398,Virginia Cavaliers,M. Diakite,3947156,,False,5.0,0,0,0,0,0,0,0,0,0,1,1,0,0,1,1,2,0
400915398,Virginia Cavaliers,J. Reuter,3908374,,False,2.0,0,0,0,0,0,0,0,0,0,0,0,0,0,0,2,1,0
400915398,Virginia Cavaliers,T. Jerome,4065733,,False,14.0,3,4,1,1,2,3,0,0,0,2,2,1,0,0,1,2,8
400915398,Virginia Cavaliers,K. Guy,4065730,,False,11.0,2,7,1,3,1,4,0,0,0,0,0,2,0,0,1,2,5
400915398,Virginia Cavaliers,D. Thompson,66274,,False,21.0,0,2,0,1,0,1,0,0,0,2,2,5,3,0,1,1,0
400915398,Virginia Cavaliers,TEAM,TOTAL,TOTAL,False,,25,54,16,35,9,19,12,14,10,28,38,13,7,1,11,17,71
400915398,Virginia Cavaliers,I. Wilkins,3138203,,True,30.0,2,6,2,6,0,0,9,10,2,7,9,1,0,0,0,2,13
400915398,Virginia Cavaliers,J. Salt,3138200,,True,24.0,1,3,1,3,0,0,0,0,3,1,4,0,0,0,0,3,2
400915398,Virginia Cavaliers,M. Shayok,3138201,,True,27.0,5,10,5,10,0,0,0,0,2,1,3,2,3,0,4,2,10
400915398,Virginia Cavaliers,L. Perrantes,66139,,True,34.0,7,13,2,5,5,8,3,4,0,5,5,0,1,0,1,1,22
400915398,Virginia Cavaliers,D. Hall,66138,,True,32.0,5,9,4,6,1,3,0,0,1,8,9,2,0,0,0,1,11
400915398,Virginia Cavaliers,M. Diakite,3947156,,False,5.0,0,0,0,0,0,0,0,0,0,1,1,0,0,1,1,2,0
400915398,Virginia Cavaliers,J. Reuter,3908374,,False,2.0,0,0,0,0,0,0,0,0,0,0,0,0,0,0,2,1,0
400915398,Virginia Cavaliers,T. Jerome,4065733,,False,14.0,3,4,1,1,2,3,0,0,0,2,2,1,0,0,1,2,8
400915398,Virginia Cavaliers,K. Guy,4065730,,False,11.0,2,7,1,3,1,4,0,0,0,0,0,2,0,0,1,2,5
400915398,Virginia Cavaliers,D. Thompson,66274,,False,21.0,0,2,0,1,0,1,0,0,0,2,2,5,3,0,1,1,0
400915398,Virginia Cavaliers,TEAM,TOTAL,TOTAL,False,,25,54,16,35,9,19,12,14,10,28,38,13,7,1,11,17,71
400915398,Notre Dame Fighting Irish,B. Colson,3138192,,True,32.0,8,11,8,9,0,2,4,7,0,3,3,0,1,3,1,3,20
400915398,Notre Dame Fighting Irish,M. Geben,3138191,,True,15.0,0,1,0,1,0,0,0,0,0,1,1,0,0,0,1,1,0
400915398,Notre Dame Fighting Irish,V.J. Beachem,66283,,True,30.0,1,10,1,5,0,5,1,1,0,2,2,0,0,3,3,0,3
400915398,Notre Dame Fighting Irish,M. Farrell,3138190,,True,35.0,3,6,2,3,1,3,1,3,1,1,2,5,1,0,2,1,8
400915398,Notre Dame Fighting Irish,S. Vasturia,66285,,True,37.0,4,10,2,5,2,5,4,4,0,5,5,4,0,0,2,0,14
400915398,Notre Dame Fighting Irish,J. Mooney,4065705,,False,2.0,0,0,0,0,0,0,0,0,0,0,0,0,0,0,1,0,0
400915398,Notre Dame Fighting Irish,E. Burns,3908337,,False,2.0,0,0,0,0,0,0,0,0,0,0,0,0,0,0,0,0,0
400915398,Notre Dame Fighting Irish,A. Torres,66286,,False,3.0,0,0,0,0,0,0,0,0,0,0,0,0,0,0,0,1,0
400915398,Notre Dame Fighting Irish,M. Ryan,3908336,,False,9.0,1,3,1,1,0,2,0,0,0,0,0,0,0,0,0,1,2
400915398,Notre Dame Fighting Irish,T. Gibbs,4065703,,False,17.0,1,2,1,2,0,0,1,2,0,0,0,0,2,0,0,1,3
400915398,Notre Dame Fighting Irish,R. Pflueger,3908335,,False,18.0,2,5,2,4,0,1,0,0,0,4,4,0,2,0,0,2,4
400915398,Notre Dame Fighting Irish,TEAM,TOTAL,TOTAL,False,,20,48,17,30,3,18,11,17,2,20,22,9,6,6,10,10,54
400915398,Notre Dame Fighting Irish,B. Colson,3138192,,True,32.0,8,11,8,9,0,2,4,7,0,3,3,0,1,3,1,3,20
400915398,Notre Dame Fighting Irish,M. Geben,3138191,,True,15.0,0,1,0,1,0,0,0,0,0,1,1,0,0,0,1,1,0
400915398,Notre Dame Fighting Irish,V.J. Beachem,66283,,True,30.0,1,10,1,5,0,5,1,1,0,2,2,0,0,3,3,0,3
400915398,Notre Dame Fighting Irish,M. Farrell,3138190,,True,35.0,3,6,2,3,1,3,1,3,1,1,2,5,1,0,2,1,8
400915398,Notre Dame Fighting Irish,S. Vasturia,66285,,True,37.0,4,10,2,5,2,5,4,4,0,5,5,4,0,0,2,0,14
400915398,Notre Dame Fighting Irish,J. Mooney,4065705,,False,2.0,0,0,0,0,0,0,0,0,0,0,0,0,0,0,1,0,0
400915398,Notre Dame Fighting Irish,E. Burns,3908337,,False,2.0,0,0,0,0,0,0,0,0,0,0,0,0,0,0,0,0,0
400915398,Notre Dame Fighting Irish,A. Torres,66286,,False,3.0,0,0,0,0,0,0,0,0,0,0,0,0,0,0,0,1,0
400915398,Notre Dame Fighting Irish,M. Ryan,3908336,,False,9.0,1,3,1,1,0,2,0,0,0,0,0,0,0,0,0,1,2
400915398,Notre Dame Fighting Irish,T. Gibbs,4065703,,False,17.0,1,2,1,2,0,0,1,2,0,0,0,0,2,0,0,1,3
400915398,Notre Dame Fighting Irish,R. Pflueger,3908335,,False,18.0,2,5,2,4,0,1,0,0,0,4,4,0,2,0,0,2,4
400915398,Notre Dame Fighting Irish,TEAM,TOTAL,TOTAL,False,,20,48,17,30,3,18,11,17,2,20,22,9,6,6,10,10,54
400915397,Pittsburgh Panthers,M. Young,66290,,True,27.0,2,9,1,5,1,4,7,8,1,1,2,1,1,0,4,2,12
400915397,Pittsburgh Panthers,J. Artis,66287,,True,28.0,3,11,2,7,1,4,2,2,1,2,3,1,0,0,1,2,9
400915397,Pittsburgh Panthers,S. Jeter,61756,,True,16.0,1,3,1,2,0,1,0,0,2,4,6,1,1,0,1,5,2
400915397,Pittsburgh Panthers,C. Johnson,3138196,,True,25.0,1,5,1,1,0,4,1,2,0,2,2,0,1,1,0,1,3
400915397,Pittsburgh Panthers,C. Jones,61219,,True,25.0,2,5,2,4,0,1,4,5,0,1,1,1,0,0,2,0,8
400915397,Pittsburgh Panthers,R. Nix,3934653,,False,9.0,0,2,0,2,0,0,4,5,2,5,7,0,0,1,1,2,4
400915397,Pittsburgh Panthers,C. Manigault,4065714,,False,10.0,0,2,0,2,0,0,0,0,0,0,0,0,0,0,0,2,0
400915397,Pittsburgh Panthers,J. Kithcart,4065713,,False,19.0,0,1,0,0,0,1,2,4,0,0,0,2,1,0,2,0,2
400915397,Pittsburgh Panthers,J. Milligan,3934655,,False,15.0,1,4,0,1,1,3,1,2,0,0,0,2,0,0,0,0,4
400915397,Pittsburgh Panthers,Z. Smith,3934654,,False,6.0,0,2,0,0,0,2,0,0,1,1,2,0,0,0,0,1,0
400915397,Pittsburgh Panthers,D. Wilson,3934652,,False,20.0,3,7,3,5,0,2,1,3,0,1,1,0,0,1,2,1,7
400915397,Pittsburgh Panthers,TEAM,TOTAL,TOTAL,False,,13,51,10,29,3,22,22,31,8,18,26,8,4,3,13,18,51
400915397,Pittsburgh Panthers,M. Young,66290,,True,27.0,2,9,1,5,1,4,7,8,1,1,2,1,1,0,4,2,12
400915397,Pittsburgh Panthers,J. Artis,66287,,True,28.0,3,11,2,7,1,4,2,2,1,2,3,1,0,0,1,2,9
400915397,Pittsburgh Panthers,S. Jeter,61756,,True,16.0,1,3,1,2,0,1,0,0,2,4,6,1,1,0,1,5,2
400915397,Pittsburgh Panthers,C. Johnson,3138196,,True,25.0,1,5,1,1,0,4,1,2,0,2,2,0,1,1,0,1,3
400915397,Pittsburgh Panthers,C. Jones,61219,,True,25.0,2,5,2,4,0,1,4,5,0,1,1,1,0,0,2,0,8
400915397,Pittsburgh Panthers,R. Nix,3934653,,False,9.0,0,2,0,2,0,0,4,5,2,5,7,0,0,1,1,2,4
400915397,Pittsburgh Panthers,C. Manigault,4065714,,False,10.0,0,2,0,2,0,0,0,0,0,0,0,0,0,0,0,2,0
400915397,Pittsburgh Panthers,J. Kithcart,4065713,,False,19.0,0,1,0,0,0,1,2,4,0,0,0,2,1,0,2,0,2
400915397,Pittsburgh Panthers,J. Milligan,3934655,,False,15.0,1,4,0,1,1,3,1,2,0,0,0,2,0,0,0,0,4
400915397,Pittsburgh Panthers,Z. Smith,3934654,,False,6.0,0,2,0,0,0,2,0,0,1,1,2,0,0,0,0,1,0
400915397,Pittsburgh Panthers,D. Wilson,3934652,,False,20.0,3,7,3,5,0,2,1,3,0,1,1,0,0,1,2,1,7
400915397,Pittsburgh Panthers,TEAM,TOTAL,TOTAL,False,,13,51,10,29,3,22,22,31,8,18,26,8,4,3,13,18,51
400915397,Louisville Cardinals,D. Adel,3908807,,True,22.0,4,5,3,4,1,1,1,1,1,5,6,3,1,0,1,1,10
400915397,Louisville Cardinals,A. Mahmoud,3147363,,True,16.0,7,7,7,7,0,0,0,1,1,2,3,0,2,2,0,3,14
400915397,Louisville Cardinals,J. Johnson,3147362,,True,21.0,2,6,2,6,0,0,3,4,3,8,11,1,0,0,1,2,7
400915397,Louisville Cardinals,D. Mitchell,3908809,,True,25.0,9,13,3,5,6,8,5,6,1,1,2,3,1,0,3,1,29
400915397,Louisville Cardinals,T. Hicks,62752,,True,20.0,4,5,4,5,0,0,2,3,0,1,1,4,0,0,0,1,10
400915397,Louisville Cardinals,V.J. King,4065666,,False,14.0,1,3,1,3,0,0,0,0,0,1,1,2,0,0,0,1,2
400915397,Louisville Cardinals,R. Spalding,3908806,,False,19.0,1,2,1,2,0,0,0,2,2,3,5,2,1,3,1,1,2
400915397,Louisville Cardinals,M. Mathiang,63035,,False,17.0,3,7,3,7,0,0,3,4,3,6,9,1,0,0,0,3,9
400915397,Louisville Cardinals,M. Stockman,3147361,,False,7.0,1,1,1,1,0,0,0,0,1,0,1,0,0,0,1,4,2
400915397,Louisville Cardinals,T. Sharpe,4065667,,False,5.0,1,4,1,2,0,2,0,0,0,1,1,0,0,0,0,1,2
400915397,Louisville Cardinals,R. McMahon,3908808,,False,15.0,5,8,0,1,5,7,0,0,0,0,0,5,1,0,1,1,15
400915397,Louisville Cardinals,J. Henderson,3155491,,False,5.0,1,4,1,2,0,2,2,2,0,1,1,0,0,0,0,0,4
400915397,Louisville Cardinals,D. Levitch,66592,,False,14.0,0,2,0,0,0,2,0,0,0,3,3,3,0,0,1,1,0
400915397,Louisville Cardinals,TEAM,TOTAL,TOTAL,False,,39,67,27,45,12,22,16,23,14,34,48,24,6,5,9,20,106
400915397,Louisville Cardinals,D. Adel,3908807,,True,22.0,4,5,3,4,1,1,1,1,1,5,6,3,1,0,1,1,10
400915397,Louisville Cardinals,A. Mahmoud,3147363,,True,16.0,7,7,7,7,0,0,0,1,1,2,3,0,2,2,0,3,14
400915397,Louisville Cardinals,J. Johnson,3147362,,True,21.0,2,6,2,6,0,0,3,4,3,8,11,1,0,0,1,2,7
400915397,Louisville Cardinals,D. Mitchell,3908809,,True,25.0,9,13,3,5,6,8,5,6,1,1,2,3,1,0,3,1,29
400915397,Louisville Cardinals,T. Hicks,62752,,True,20.0,4,5,4,5,0,0,2,3,0,1,1,4,0,0,0,1,10
400915397,Louisville Cardinals,V.J. King,4065666,,False,14.0,1,3,1,3,0,0,0,0,0,1,1,2,0,0,0,1,2
400915397,Louisville Cardinals,R. Spalding,3908806,,False,19.0,1,2,1,2,0,0,0,2,2,3,5,2,1,3,1,1,2
400915397,Louisville Cardinals,M. Mathiang,63035,,False,17.0,3,7,3,7,0,0,3,4,3,6,9,1,0,0,0,3,9
400915397,Louisville Cardinals,M. Stockman,3147361,,False,7.0,1,1,1,1,0,0,0,0,1,0,1,0,0,0,1,4,2
400915397,Louisville Cardinals,T. Sharpe,4065667,,False,5.0,1,4,1,2,0,2,0,0,0,1,1,0,0,0,0,1,2
400915397,Louisville Cardinals,R. McMahon,3908808,,False,15.0,5,8,0,1,5,7,0,0,0,0,0,5,1,0,1,1,15
400915397,Louisville Cardinals,J. Henderson,3155491,,False,5.0,1,4,1,2,0,2,2,2,0,1,1,0,0,0,0,0,4
400915397,Louisville Cardinals,D. Levitch,66592,,False,14.0,0,2,0,0,0,2,0,0,0,3,3,3,0,0,1,1,0
400915397,Louisville Cardinals,TEAM,TOTAL,TOTAL,False,,39,67,27,45,12,22,16,23,14,34,48,24,6,5,9,20,106
400915396,NC State Wolfpack,A. Abu,3138158,,True,36.0,8,12,8,12,0,0,3,4,2,7,9,2,1,0,1,2,19
400915396,NC State Wolfpack,O. Yurtseven,66768,,True,12.0,0,2,0,2,0,0,0,0,0,1,1,0,0,0,0,4,0
400915396,NC State Wolfpack,M. Rowan,3947151,,True,30.0,2,7,0,1,2,6,3,4,0,4,4,1,0,0,1,4,9
400915396,NC State Wolfpack,D. Smith Jr.,4065697,,True,33.0,10,18,6,12,4,6,8,15,0,4,4,6,2,0,3,1,32
400915396,NC State Wolfpack,T. Henderson,61215,,True,32.0,1,5,1,2,0,3,4,5,1,1,2,0,0,1,1,2,6
400915396,NC State Wolfpack,T. Kapita,4065701,,False,19.0,6,7,6,7,0,0,2,2,3,7,10,0,0,0,1,5,14
400915396,NC State Wolfpack,D. Hicks,4065698,,False,3.0,0,0,0,0,0,0,0,0,0,0,0,0,0,0,0,0,0
400915396,NC State Wolfpack,B. Anya,66134,,False,3.0,0,0,0,0,0,0,0,0,0,0,0,0,0,0,0,0,0
400915396,NC State Wolfpack,M. Johnson,4065699,,False,21.0,1,4,1,4,0,0,0,0,1,0,1,0,1,0,1,1,2
400915396,NC State Wolfpack,T. Dorn,3132359,,False,11.0,1,2,1,1,0,1,0,0,0,2,2,0,1,0,1,0,2
400915396,NC State Wolfpack,TEAM,TOTAL,TOTAL,False,,29,57,23,41,6,16,20,30,7,28,35,9,5,1,10,19,84
400915396,NC State Wolfpack,A. Abu,3138158,,True,36.0,8,12,8,12,0,0,3,4,2,7,9,2,1,0,1,2,19
400915396,NC State Wolfpack,O. Yurtseven,66768,,True,12.0,0,2,0,2,0,0,0,0,0,1,1,0,0,0,0,4,0
400915396,NC State Wolfpack,M. Rowan,3947151,,True,30.0,2,7,0,1,2,6,3,4,0,4,4,1,0,0,1,4,9
400915396,NC State Wolfpack,D. Smith Jr.,4065697,,True,33.0,10,18,6,12,4,6,8,15,0,4,4,6,2,0,3,1,32
400915396,NC State Wolfpack,T. Henderson,61215,,True,32.0,1,5,1,2,0,3,4,5,1,1,2,0,0,1,1,2,6
400915396,NC State Wolfpack,T. Kapita,4065701,,False,19.0,6,7,6,7,0,0,2,2,3,7,10,0,0,0,1,5,14
400915396,NC State Wolfpack,D. Hicks,4065698,,False,3.0,0,0,0,0,0,0,0,0,0,0,0,0,0,0,0,0,0
400915396,NC State Wolfpack,B. Anya,66134,,False,3.0,0,0,0,0,0,0,0,0,0,0,0,0,0,0,0,0,0
400915396,NC State Wolfpack,M. Johnson,4065699,,False,21.0,1,4,1,4,0,0,0,0,1,0,1,0,1,0,1,1,2
400915396,NC State Wolfpack,T. Dorn,3132359,,False,11.0,1,2,1,1,0,1,0,0,0,2,2,0,1,0,1,0,2
400915396,NC State Wolfpack,TEAM,TOTAL,TOTAL,False,,29,57,23,41,6,16,20,30,7,28,35,9,5,1,10,19,84
400915396,Duke Blue Devils,J. Tatum,4065648,,True,31.0,7,14,6,10,1,4,1,2,1,8,9,3,1,2,2,3,16
400915396,Duke Blue Devils,A. Jefferson,61586,,True,28.0,2,4,2,4,0,0,1,2,3,2,5,2,1,1,0,1,5
400915396,Duke Blue Devils,M. Bolden,4065652,,True,18.0,1,4,1,4,0,0,0,0,2,1,3,0,1,0,0,3,2
400915396,Duke Blue Devils,F. Jackson,4065651,,True,21.0,3,4,2,2,1,2,0,0,1,3,4,2,0,0,3,2,7
400915396,Duke Blue Devils,M. Jones,66563,,True,34.0,4,11,1,3,3,8,0,0,1,2,3,3,2,0,1,4,11
400915396,Duke Blue Devils,J. DeLaurier,4065650,,False,1.0,0,0,0,0,0,0,0,0,0,0,0,0,0,0,0,1,0
400915396,Duke Blue Devils,H. Giles III,4065649,,False,14.0,4,5,4,5,0,0,0,2,1,6,7,0,0,1,1,2,8
400915396,Duke Blue Devils,L. Kennard,3913174,,False,27.0,5,9,3,4,2,5,8,10,1,4,5,4,2,0,2,5,20
400915396,Duke Blue Devils,G. Allen,3135045,,False,26.0,4,13,3,4,1,9,4,5,0,1,1,2,0,0,2,1,13
400915396,Duke Blue Devils,TEAM,TOTAL,TOTAL,False,,30,64,22,36,8,28,14,21,10,28,38,16,7,4,11,22,82
400915396,Duke Blue Devils,J. Tatum,4065648,,True,31.0,7,14,6,10,1,4,1,2,1,8,9,3,1,2,2,3,16
400915396,Duke Blue Devils,A. Jefferson,61586,,True,28.0,2,4,2,4,0,0,1,2,3,2,5,2,1,1,0,1,5
400915396,Duke Blue Devils,M. Bolden,4065652,,True,18.0,1,4,1,4,0,0,0,0,2,1,3,0,1,0,0,3,2
400915396,Duke Blue Devils,F. Jackson,4065651,,True,21.0,3,4,2,2,1,2,0,0,1,3,4,2,0,0,3,2,7
400915396,Duke Blue Devils,M. Jones,66563,,True,34.0,4,11,1,3,3,8,0,0,1,2,3,3,2,0,1,4,11
400915396,Duke Blue Devils,J. DeLaurier,4065650,,False,1.0,0,0,0,0,0,0,0,0,0,0,0,0,0,0,0,1,0
400915396,Duke Blue Devils,H. Giles III,4065649,,False,14.0,4,5,4,5,0,0,0,2,1,6,7,0,0,1,1,2,8
400915396,Duke Blue Devils,L. Kennard,3913174,,False,27.0,5,9,3,4,2,5,8,10,1,4,5,4,2,0,2,5,20
400915396,Duke Blue Devils,G. Allen,3135045,,False,26.0,4,13,3,4,1,9,4,5,0,1,1,2,0,0,2,1,13
400915396,Duke Blue Devils,TEAM,TOTAL,TOTAL,False,,30,64,22,36,8,28,14,21,10,28,38,16,7,4,11,22,82
400915395,Virginia Tech Hokies,K. Sy,4065740,,True,12.0,2,2,2,2,0,0,1,1,0,3,3,0,0,0,0,3,5
400915395,Virginia Tech Hokies,T. Outlaw,67275,,True,12.0,3,3,1,1,2,2,0,0,0,4,4,0,0,0,0,1,8
400915395,Virginia Tech Hokies,J. Robinson,3945566,,True,29.0,3,7,3,4,0,3,2,3,0,2,2,3,2,0,3,1,8
400915395,Virginia Tech Hokies,J. Bibbs,3147500,,True,30.0,3,7,2,4,1,3,2,2,3,1,4,1,0,0,2,0,9
400915395,Virginia Tech Hokies,S. Allen,61795,,True,37.0,6,10,3,5,3,5,2,2,0,3,3,6,1,1,1,1,17
400915395,Virginia Tech Hokies,Z. LeDay,61698,,False,29.0,5,12,4,8,1,4,5,5,1,4,5,2,0,1,2,2,16
400915395,Virginia Tech Hokies,C. Clarke,3945567,,False,27.0,3,5,3,4,0,1,2,2,1,5,6,0,0,0,4,1,8
400915395,Virginia Tech Hokies,A. Hill,3147501,,False,24.0,4,7,3,4,1,3,2,2,0,3,3,0,1,0,0,1,11
400915395,Virginia Tech Hokies,TEAM,TOTAL,TOTAL,False,,29,53,21,32,8,21,16,17,5,27,32,12,4,2,12,10,82
400915395,Virginia Tech Hokies,K. Sy,4065740,,True,12.0,2,2,2,2,0,0,1,1,0,3,3,0,0,0,0,3,5
400915395,Virginia Tech Hokies,T. Outlaw,67275,,True,12.0,3,3,1,1,2,2,0,0,0,4,4,0,0,0,0,1,8
400915395,Virginia Tech Hokies,J. Robinson,3945566,,True,29.0,3,7,3,4,0,3,2,3,0,2,2,3,2,0,3,1,8
400915395,Virginia Tech Hokies,J. Bibbs,3147500,,True,30.0,3,7,2,4,1,3,2,2,3,1,4,1,0,0,2,0,9
400915395,Virginia Tech Hokies,S. Allen,61795,,True,37.0,6,10,3,5,3,5,2,2,0,3,3,6,1,1,1,1,17
400915395,Virginia Tech Hokies,Z. LeDay,61698,,False,29.0,5,12,4,8,1,4,5,5,1,4,5,2,0,1,2,2,16
400915395,Virginia Tech Hokies,C. Clarke,3945567,,False,27.0,3,5,3,4,0,1,2,2,1,5,6,0,0,0,4,1,8
400915395,Virginia Tech Hokies,A. Hill,3147501,,False,24.0,4,7,3,4,1,3,2,2,0,3,3,0,1,0,0,1,11
400915395,Virginia Tech Hokies,TEAM,TOTAL,TOTAL,False,,29,53,21,32,8,21,16,17,5,27,32,12,4,2,12,10,82
400915395,Clemson Tigers,D. Grantham,3129674,,True,31.0,6,10,3,5,3,5,0,0,2,3,5,1,1,1,1,1,15
400915395,Clemson Tigers,J. Blossomgame,61835,,True,36.0,8,17,5,13,3,4,1,3,2,3,5,2,1,2,1,1,20
400915395,Clemson Tigers,S. Djitte,66122,,True,19.0,1,2,1,2,0,0,0,0,3,3,6,1,1,1,0,3,2
400915395,Clemson Tigers,S. Mitchell,3136699,,True,25.0,1,5,1,3,0,2,3,5,1,1,2,10,1,0,2,3,5
400915395,Clemson Tigers,A. Holmes,62043,,True,34.0,7,12,2,3,5,9,1,1,0,2,2,3,2,0,2,2,20
400915395,Clemson Tigers,E. Thomas,3947075,,False,11.0,4,4,4,4,0,0,1,2,0,4,4,0,0,0,0,2,9
400915395,Clemson Tigers,L. Robertin,3917985,,False,1.0,0,0,0,0,0,0,0,0,0,0,0,0,0,0,0,0,0
400915395,Clemson Tigers,T. Hudson,3917986,,False,8.0,0,2,0,2,0,0,0,0,0,0,0,1,0,0,1,1,0
400915395,Clemson Tigers,M. Reed,3133969,,False,7.0,1,2,0,1,1,1,0,0,0,0,0,1,0,0,1,0,3
400915395,Clemson Tigers,G. DeVoe,3129673,,False,28.0,3,10,2,4,1,6,0,0,1,4,5,3,1,1,1,5,7
400915395,Clemson Tigers,TEAM,TOTAL,TOTAL,False,,31,64,18,37,13,27,6,11,9,20,29,22,7,5,9,18,81
400915395,Clemson Tigers,D. Grantham,3129674,,True,31.0,6,10,3,5,3,5,0,0,2,3,5,1,1,1,1,1,15
400915395,Clemson Tigers,J. Blossomgame,61835,,True,36.0,8,17,5,13,3,4,1,3,2,3,5,2,1,2,1,1,20
400915395,Clemson Tigers,S. Djitte,66122,,True,19.0,1,2,1,2,0,0,0,0,3,3,6,1,1,1,0,3,2
400915395,Clemson Tigers,S. Mitchell,3136699,,True,25.0,1,5,1,3,0,2,3,5,1,1,2,10,1,0,2,3,5
400915395,Clemson Tigers,A. Holmes,62043,,True,34.0,7,12,2,3,5,9,1,1,0,2,2,3,2,0,2,2,20
400915395,Clemson Tigers,E. Thomas,3947075,,False,11.0,4,4,4,4,0,0,1,2,0,4,4,0,0,0,0,2,9
400915395,Clemson Tigers,L. Robertin,3917985,,False,1.0,0,0,0,0,0,0,0,0,0,0,0,0,0,0,0,0,0
400915395,Clemson Tigers,T. Hudson,3917986,,False,8.0,0,2,0,2,0,0,0,0,0,0,0,1,0,0,1,1,0
400915395,Clemson Tigers,M. Reed,3133969,,False,7.0,1,2,0,1,1,1,0,0,0,0,0,1,0,0,1,0,3
400915395,Clemson Tigers,G. DeVoe,3129673,,False,28.0,3,10,2,4,1,6,0,0,1,4,5,3,1,1,1,5,7
400915395,Clemson Tigers,TEAM,TOTAL,TOTAL,False,,31,64,18,37,13,27,6,11,9,20,29,22,7,5,9,18,81
400915394,Miami Hurricanes,D. Hernandez,4065672,,True,26.0,3,5,3,5,0,0,1,3,3,0,3,0,0,0,3,3,7
400915394,Miami Hurricanes,K. Murphy,61668,,True,27.0,2,7,2,7,0,0,0,1,7,8,15,1,0,2,3,2,4
400915394,Miami Hurricanes,B. Brown,4065670,,True,38.0,6,10,4,7,2,3,1,1,0,5,5,6,2,1,1,2,15
400915394,Miami Hurricanes,J. Newton,3138145,,True,33.0,5,13,5,12,0,1,3,6,0,3,3,1,1,0,4,3,13
400915394,Miami Hurricanes,D. Reed,66130,,True,40.0,6,13,1,5,5,8,2,2,0,4,4,1,3,0,4,2,19
400915394,Miami Hurricanes,C. Stowell,3138149,,False,1.0,0,0,0,0,0,0,0,0,0,0,0,0,0,0,0,0,0
400915394,Miami Hurricanes,E. Izundu,3904629,,False,14.0,0,2,0,2,0,0,0,2,1,1,2,1,0,0,1,1,0
400915394,Miami Hurricanes,A. Lawrence II,3904628,,False,13.0,0,3,0,1,0,2,0,0,0,0,0,0,0,0,0,4,0
400915394,Miami Hurricanes,D. Vasiljevic,4065669,,False,7.0,0,2,0,0,0,2,0,0,0,1,1,0,0,0,1,1,0
400915394,Miami Hurricanes,M. Robinson,3947140,,False,1.0,0,0,0,0,0,0,0,0,0,0,0,0,0,0,0,0,0
400915394,Miami Hurricanes,TEAM,TOTAL,TOTAL,False,,22,55,15,39,7,16,7,15,12,24,36,10,6,3,18,18,58
400915394,Miami Hurricanes,D. Hernandez,4065672,,True,26.0,3,5,3,5,0,0,1,3,3,0,3,0,0,0,3,3,7
400915394,Miami Hurricanes,K. Murphy,61668,,True,27.0,2,7,2,7,0,0,0,1,7,8,15,1,0,2,3,2,4
400915394,Miami Hurricanes,B. Brown,4065670,,True,38.0,6,10,4,7,2,3,1,1,0,5,5,6,2,1,1,2,15
400915394,Miami Hurricanes,J. Newton,3138145,,True,33.0,5,13,5,12,0,1,3,6,0,3,3,1,1,0,4,3,13
400915394,Miami Hurricanes,D. Reed,66130,,True,40.0,6,13,1,5,5,8,2,2,0,4,4,1,3,0,4,2,19
400915394,Miami Hurricanes,C. Stowell,3138149,,False,1.0,0,0,0,0,0,0,0,0,0,0,0,0,0,0,0,0,0
400915394,Miami Hurricanes,E. Izundu,3904629,,False,14.0,0,2,0,2,0,0,0,2,1,1,2,1,0,0,1,1,0
400915394,Miami Hurricanes,A. Lawrence II,3904628,,False,13.0,0,3,0,1,0,2,0,0,0,0,0,0,0,0,0,4,0
400915394,Miami Hurricanes,D. Vasiljevic,4065669,,False,7.0,0,2,0,0,0,2,0,0,0,1,1,0,0,0,1,1,0
400915394,Miami Hurricanes,M. Robinson,3947140,,False,1.0,0,0,0,0,0,0,0,0,0,0,0,0,0,0,0,0,0
400915394,Miami Hurricanes,TEAM,TOTAL,TOTAL,False,,22,55,15,39,7,16,7,15,12,24,36,10,6,3,18,18,58
400915394,Duke Blue Devils,H. Giles III,4065649,,True,8.0,1,2,1,2,0,0,0,0,1,2,3,0,0,0,0,3,2
400915394,Duke Blue Devils,J. Tatum,4065648,,True,25.0,4,9,3,5,1,4,5,6,0,3,3,1,0,1,3,5,14
400915394,Duke Blue Devils,A. Jefferson,61586,,True,34.0,1,4,1,4,0,0,3,6,1,11,12,1,2,0,1,1,5
400915394,Duke Blue Devils,L. Kennard,3913174,,True,29.0,3,8,2,5,1,3,4,4,1,4,5,1,0,1,1,3,11
400915394,Duke Blue Devils,G. Allen,3135045,,True,28.0,2,9,2,6,0,3,3,4,0,2,2,2,2,0,2,1,7
400915394,Duke Blue Devils,M. Bolden,4065652,,False,23.0,4,6,4,6,0,0,0,0,3,1,4,0,0,0,1,1,8
400915394,Duke Blue Devils,F. Jackson,4065651,,False,24.0,4,7,4,6,0,1,2,3,0,1,1,4,2,0,0,3,10
400915394,Duke Blue Devils,M. Jones,66563,,False,29.0,5,7,2,2,3,5,0,0,0,2,2,0,3,0,2,2,13
400915394,Duke Blue Devils,TEAM,TOTAL,TOTAL,False,,24,52,19,36,5,16,17,23,7,27,34,9,9,2,10,19,70
400915394,Duke Blue Devils,H. Giles III,4065649,,True,8.0,1,2,1,2,0,0,0,0,1,2,3,0,0,0,0,3,2
400915394,Duke Blue Devils,J. Tatum,4065648,,True,25.0,4,9,3,5,1,4,5,6,0,3,3,1,0,1,3,5,14
400915394,Duke Blue Devils,A. Jefferson,61586,,True,34.0,1,4,1,4,0,0,3,6,1,11,12,1,2,0,1,1,5
400915394,Duke Blue Devils,L. Kennard,3913174,,True,29.0,3,8,2,5,1,3,4,4,1,4,5,1,0,1,1,3,11
400915394,Duke Blue Devils,G. Allen,3135045,,True,28.0,2,9,2,6,0,3,3,4,0,2,2,2,2,0,2,1,7
400915394,Duke Blue Devils,M. Bolden,4065652,,False,23.0,4,6,4,6,0,0,0,0,3,1,4,0,0,0,1,1,8
400915394,Duke Blue Devils,F. Jackson,4065651,,False,24.0,4,7,4,6,0,1,2,3,0,1,1,4,2,0,0,3,10
400915394,Duke Blue Devils,M. Jones,66563,,False,29.0,5,7,2,2,3,5,0,0,0,2,2,0,3,0,2,2,13
400915394,Duke Blue Devils,TEAM,TOTAL,TOTAL,False,,24,52,19,36,5,16,17,23,7,27,34,9,9,2,10,19,70
400915393,Virginia Cavaliers,I. Wilkins,3138203,,True,28.0,2,4,2,4,0,0,1,2,1,2,3,4,1,1,2,0,5
400915393,Virginia Cavaliers,J. Salt,3138200,,True,35.0,2,5,2,5,0,0,1,2,3,3,6,0,1,1,0,2,5
400915393,Virginia Cavaliers,M. Shayok,3138201,,True,23.0,6,9,4,4,2,5,5,5,0,4,4,1,0,0,1,1,19
400915393,Virginia Cavaliers,L. Perrantes,66139,,True,31.0,3,7,1,3,2,4,3,3,2,4,6,2,0,0,4,2,11
400915393,Virginia Cavaliers,D. Hall,66138,,True,33.0,3,8,2,3,1,5,3,4,0,4,4,4,1,0,2,3,10
400915393,Virginia Cavaliers,M. Diakite,3947156,,False,4.0,0,0,0,0,0,0,0,0,0,0,0,0,0,0,0,0,0
400915393,Virginia Cavaliers,J. Reuter,3908374,,False,4.0,0,0,0,0,0,0,0,0,0,1,1,0,0,0,0,1,0
400915393,Virginia Cavaliers,T. Jerome,4065733,,False,6.0,1,2,1,1,0,1,0,0,0,0,0,0,0,0,1,2,2
400915393,Virginia Cavaliers,K. Guy,4065730,,False,18.0,3,7,3,3,0,4,0,0,0,0,0,0,0,0,1,0,6
400915393,Virginia Cavaliers,T. Gross Jr.,4065729,,False,1.0,0,1,0,0,0,1,0,0,0,0,0,0,0,0,0,0,0
400915393,Virginia Cavaliers,D. Thompson,66274,,False,17.0,2,5,2,3,0,2,0,1,0,4,4,2,3,1,0,3,4
400915393,Virginia Cavaliers,TEAM,TOTAL,TOTAL,False,,22,48,17,26,5,22,13,17,7,25,32,13,6,3,11,14,62
400915393,Virginia Cavaliers,I. Wilkins,3138203,,True,28.0,2,4,2,4,0,0,1,2,1,2,3,4,1,1,2,0,5
400915393,Virginia Cavaliers,J. Salt,3138200,,True,35.0,2,5,2,5,0,0,1,2,3,3,6,0,1,1,0,2,5
400915393,Virginia Cavaliers,M. Shayok,3138201,,True,23.0,6,9,4,4,2,5,5,5,0,4,4,1,0,0,1,1,19
400915393,Virginia Cavaliers,L. Perrantes,66139,,True,31.0,3,7,1,3,2,4,3,3,2,4,6,2,0,0,4,2,11
400915393,Virginia Cavaliers,D. Hall,66138,,True,33.0,3,8,2,3,1,5,3,4,0,4,4,4,1,0,2,3,10
400915393,Virginia Cavaliers,M. Diakite,3947156,,False,4.0,0,0,0,0,0,0,0,0,0,0,0,0,0,0,0,0,0
400915393,Virginia Cavaliers,J. Reuter,3908374,,False,4.0,0,0,0,0,0,0,0,0,0,1,1,0,0,0,0,1,0
400915393,Virginia Cavaliers,T. Jerome,4065733,,False,6.0,1,2,1,1,0,1,0,0,0,0,0,0,0,0,1,2,2
400915393,Virginia Cavaliers,K. Guy,4065730,,False,18.0,3,7,3,3,0,4,0,0,0,0,0,0,0,0,1,0,6
400915393,Virginia Cavaliers,T. Gross Jr.,4065729,,False,1.0,0,1,0,0,0,1,0,0,0,0,0,0,0,0,0,0,0
400915393,Virginia Cavaliers,D. Thompson,66274,,False,17.0,2,5,2,3,0,2,0,1,0,4,4,2,3,1,0,3,4
400915393,Virginia Cavaliers,TEAM,TOTAL,TOTAL,False,,22,48,17,26,5,22,13,17,7,25,32,13,6,3,11,14,62
400915393,Georgia Tech Yellow Jackets,Q. Stephens,66128,,True,36.0,2,6,0,2,2,4,0,0,1,12,13,0,0,1,0,2,6
400915393,Georgia Tech Yellow Jackets,B. Lammers,3135061,,True,38.0,3,12,3,12,0,0,1,2,0,7,7,2,1,0,1,2,7
400915393,Georgia Tech Yellow Jackets,J. Okogie,4065663,,True,28.0,4,7,2,4,2,3,4,6,0,0,0,1,1,0,5,3,14
400915393,Georgia Tech Yellow Jackets,J. Moore,4065662,,True,28.0,5,6,5,6,0,0,0,0,0,0,0,3,3,0,0,3,10
400915393,Georgia Tech Yellow Jackets,J. Heath,67623,,True,25.0,4,5,4,5,0,0,0,0,0,0,0,2,1,0,2,4,8
400915393,Georgia Tech Yellow Jackets,S. Ogbonda,3904627,,False,2.0,0,0,0,0,0,0,1,2,0,0,0,0,0,0,1,0,1
400915393,Georgia Tech Yellow Jackets,A. Gueye,3135059,,False,1.0,0,0,0,0,0,0,0,0,0,0,0,0,0,0,0,0,0
400915393,Georgia Tech Yellow Jackets,K. McCormick,61453,,False,5.0,0,0,0,0,0,0,0,0,0,0,0,0,0,0,0,0,0
400915393,Georgia Tech Yellow Jackets,T. Jackson,3135057,,False,22.0,1,5,1,3,0,2,1,2,1,2,3,2,3,0,2,0,3
400915393,Georgia Tech Yellow Jackets,J. Price,61778,,False,1.0,0,0,0,0,0,0,0,0,0,0,0,0,0,0,0,0,0
400915393,Georgia Tech Yellow Jackets,C. Heyward,61609,,False,14.0,0,1,0,1,0,0,0,0,0,0,0,1,0,0,2,1,0
400915393,Georgia Tech Yellow Jackets,TEAM,TOTAL,TOTAL,False,,19,42,15,33,4,9,7,12,2,22,24,11,9,1,13,15,49
400915393,Georgia Tech Yellow Jackets,Q. Stephens,66128,,True,36.0,2,6,0,2,2,4,0,0,1,12,13,0,0,1,0,2,6
400915393,Georgia Tech Yellow Jackets,B. Lammers,3135061,,True,38.0,3,12,3,12,0,0,1,2,0,7,7,2,1,0,1,2,7
400915393,Georgia Tech Yellow Jackets,J. Okogie,4065663,,True,28.0,4,7,2,4,2,3,4,6,0,0,0,1,1,0,5,3,14
400915393,Georgia Tech Yellow Jackets,J. Moore,4065662,,True,28.0,5,6,5,6,0,0,0,0,0,0,0,3,3,0,0,3,10
400915393,Georgia Tech Yellow Jackets,J. Heath,67623,,True,25.0,4,5,4,5,0,0,0,0,0,0,0,2,1,0,2,4,8
400915393,Georgia Tech Yellow Jackets,S. Ogbonda,3904627,,False,2.0,0,0,0,0,0,0,1,2,0,0,0,0,0,0,1,0,1
400915393,Georgia Tech Yellow Jackets,A. Gueye,3135059,,False,1.0,0,0,0,0,0,0,0,0,0,0,0,0,0,0,0,0,0
400915393,Georgia Tech Yellow Jackets,K. McCormick,61453,,False,5.0,0,0,0,0,0,0,0,0,0,0,0,0,0,0,0,0,0
400915393,Georgia Tech Yellow Jackets,T. Jackson,3135057,,False,22.0,1,5,1,3,0,2,1,2,1,2,3,2,3,0,2,0,3
400915393,Georgia Tech Yellow Jackets,J. Price,61778,,False,1.0,0,0,0,0,0,0,0,0,0,0,0,0,0,0,0,0,0
400915393,Georgia Tech Yellow Jackets,C. Heyward,61609,,False,14.0,0,1,0,1,0,0,0,0,0,0,0,1,0,0,2,1,0
400915393,Georgia Tech Yellow Jackets,TEAM,TOTAL,TOTAL,False,,19,42,15,33,4,9,7,12,2,22,24,11,9,1,13,15,49
400915392,Wake Forest Demon Deacons,J. Collins,3908845,,True,26.0,8,11,8,11,0,0,5,6,4,5,9,0,1,1,4,5,21
400915392,Wake Forest Demon Deacons,D. Mitoglou,3138224,,True,26.0,3,10,2,7,1,3,3,3,4,4,8,2,1,0,1,2,10
400915392,Wake Forest Demon Deacons,A. Arians,61378,,True,31.0,1,6,1,3,0,3,5,5,0,4,4,0,1,0,2,2,7
400915392,Wake Forest Demon Deacons,B. Crawford,3908844,,True,33.0,4,13,3,9,1,4,5,7,1,4,5,6,0,1,1,2,14
400915392,Wake Forest Demon Deacons,K. Woods,3132360,,True,26.0,7,10,6,9,1,1,3,4,1,3,4,2,1,0,2,3,18
400915392,Wake Forest Demon Deacons,D. Moore,3908843,,False,12.0,1,1,1,1,0,0,0,0,2,1,3,0,0,0,0,3,2
400915392,Wake Forest Demon Deacons,B. Childress,4065750,,False,21.0,3,10,2,5,1,5,2,2,0,0,0,2,3,0,1,1,9
400915392,Wake Forest Demon Deacons,M. Wilbekin,3138222,,False,25.0,2,7,0,1,2,6,6,6,0,1,1,1,1,1,0,2,12
400915392,Wake Forest Demon Deacons,TEAM,TOTAL,TOTAL,False,,29,68,23,46,6,22,29,33,13,24,37,13,8,3,11,20,93
400915392,Wake Forest Demon Deacons,J. Collins,3908845,,True,26.0,8,11,8,11,0,0,5,6,4,5,9,0,1,1,4,5,21
400915392,Wake Forest Demon Deacons,D. Mitoglou,3138224,,True,26.0,3,10,2,7,1,3,3,3,4,4,8,2,1,0,1,2,10
400915392,Wake Forest Demon Deacons,A. Arians,61378,,True,31.0,1,6,1,3,0,3,5,5,0,4,4,0,1,0,2,2,7
400915392,Wake Forest Demon Deacons,B. Crawford,3908844,,True,33.0,4,13,3,9,1,4,5,7,1,4,5,6,0,1,1,2,14
400915392,Wake Forest Demon Deacons,K. Woods,3132360,,True,26.0,7,10,6,9,1,1,3,4,1,3,4,2,1,0,2,3,18
400915392,Wake Forest Demon Deacons,D. Moore,3908843,,False,12.0,1,1,1,1,0,0,0,0,2,1,3,0,0,0,0,3,2
400915392,Wake Forest Demon Deacons,B. Childress,4065750,,False,21.0,3,10,2,5,1,5,2,2,0,0,0,2,3,0,1,1,9
400915392,Wake Forest Demon Deacons,M. Wilbekin,3138222,,False,25.0,2,7,0,1,2,6,6,6,0,1,1,1,1,1,0,2,12
400915392,Wake Forest Demon Deacons,TEAM,TOTAL,TOTAL,False,,29,68,23,46,6,22,29,33,13,24,37,13,8,3,11,20,93
400915392,NC State Wolfpack,A. Abu,3138158,,True,32.0,9,14,9,14,0,0,2,3,2,5,7,1,0,1,1,5,20
400915392,NC State Wolfpack,O. Yurtseven,66768,,True,14.0,3,4,3,4,0,0,0,0,2,2,4,1,0,0,2,5,6
400915392,NC State Wolfpack,D. Smith Jr.,4065697,,True,37.0,3,9,3,6,0,3,9,11,1,6,7,13,2,1,2,4,15
400915392,NC State Wolfpack,M. Rowan,3947151,,True,37.0,5,11,2,3,3,8,0,0,1,7,8,0,1,0,1,2,13
400915392,NC State Wolfpack,T. Henderson,61215,,True,26.0,4,10,1,1,3,9,0,0,0,1,1,3,1,0,2,3,11
400915392,NC State Wolfpack,B. Anya,66134,,False,13.0,2,2,2,2,0,0,1,5,1,2,3,0,0,3,1,4,5
400915392,NC State Wolfpack,M. Johnson,4065699,,False,24.0,2,6,2,3,0,3,1,2,0,3,3,2,2,0,2,2,5
400915392,NC State Wolfpack,T. Dorn,3132359,,False,17.0,5,8,5,5,0,3,3,6,1,2,3,1,0,0,2,0,13
400915392,NC State Wolfpack,TEAM,TOTAL,TOTAL,False,,33,64,27,38,6,26,16,27,10,29,39,21,6,5,13,25,88
400915392,NC State Wolfpack,A. Abu,3138158,,True,32.0,9,14,9,14,0,0,2,3,2,5,7,1,0,1,1,5,20
400915392,NC State Wolfpack,O. Yurtseven,66768,,True,14.0,3,4,3,4,0,0,0,0,2,2,4,1,0,0,2,5,6
400915392,NC State Wolfpack,D. Smith Jr.,4065697,,True,37.0,3,9,3,6,0,3,9,11,1,6,7,13,2,1,2,4,15
400915392,NC State Wolfpack,M. Rowan,3947151,,True,37.0,5,11,2,3,3,8,0,0,1,7,8,0,1,0,1,2,13
400915392,NC State Wolfpack,T. Henderson,61215,,True,26.0,4,10,1,1,3,9,0,0,0,1,1,3,1,0,2,3,11
400915392,NC State Wolfpack,B. Anya,66134,,False,13.0,2,2,2,2,0,0,1,5,1,2,3,0,0,3,1,4,5
400915392,NC State Wolfpack,M. Johnson,4065699,,False,24.0,2,6,2,3,0,3,1,2,0,3,3,2,2,0,2,2,5
400915392,NC State Wolfpack,T. Dorn,3132359,,False,17.0,5,8,5,5,0,3,3,6,1,2,3,1,0,0,2,0,13
400915392,NC State Wolfpack,TEAM,TOTAL,TOTAL,False,,33,64,27,38,6,26,16,27,10,29,39,21,6,5,13,25,88
400915391,Louisville Cardinals,V.J. King,4065666,,True,7.0,0,4,0,3,0,1,0,0,0,0,0,0,0,0,1,0,0
400915391,Louisville Cardinals,D. Adel,3908807,,True,36.0,4,13,4,10,0,3,4,6,0,6,6,2,1,0,1,0,12
400915391,Louisville Cardinals,A. Mahmoud,3147363,,True,5.0,0,0,0,0,0,0,0,0,0,0,0,0,0,0,0,4,0
400915391,Louisville Cardinals,J. Johnson,3147362,,True,16.0,4,5,4,5,0,0,2,2,0,1,1,0,1,0,2,5,10
400915391,Louisville Cardinals,D. Mitchell,3908809,,True,20.0,2,10,2,7,0,3,2,2,1,2,3,0,0,1,2,4,6
400915391,Louisville Cardinals,R. Spalding,3908806,,False,23.0,1,4,1,4,0,0,0,2,2,4,6,0,0,1,2,2,2
400915391,Louisville Cardinals,M. Mathiang,63035,,False,33.0,5,6,5,6,0,0,3,6,7,6,13,1,1,2,1,2,13
400915391,Louisville Cardinals,M. Stockman,3147361,,False,1.0,0,0,0,0,0,0,0,0,0,0,0,0,0,0,0,2,0
400915391,Louisville Cardinals,R. McMahon,3908808,,False,4.0,0,2,0,0,0,2,0,0,0,0,0,0,0,0,0,1,0
400915391,Louisville Cardinals,D. Levitch,66592,,False,23.0,3,4,2,2,1,2,2,2,1,2,3,3,0,0,0,4,9
400915391,Louisville Cardinals,T. Hicks,62752,,False,32.0,6,17,5,15,1,2,3,4,0,3,3,1,0,0,1,2,16
400915391,Louisville Cardinals,TEAM,TOTAL,TOTAL,False,,25,65,23,52,2,13,16,24,15,28,43,7,3,4,10,26,68
400915391,Louisville Cardinals,V.J. King,4065666,,True,7.0,0,4,0,3,0,1,0,0,0,0,0,0,0,0,1,0,0
400915391,Louisville Cardinals,D. Adel,3908807,,True,36.0,4,13,4,10,0,3,4,6,0,6,6,2,1,0,1,0,12
400915391,Louisville Cardinals,A. Mahmoud,3147363,,True,5.0,0,0,0,0,0,0,0,0,0,0,0,0,0,0,0,4,0
400915391,Louisville Cardinals,J. Johnson,3147362,,True,16.0,4,5,4,5,0,0,2,2,0,1,1,0,1,0,2,5,10
400915391,Louisville Cardinals,D. Mitchell,3908809,,True,20.0,2,10,2,7,0,3,2,2,1,2,3,0,0,1,2,4,6
400915391,Louisville Cardinals,R. Spalding,3908806,,False,23.0,1,4,1,4,0,0,0,2,2,4,6,0,0,1,2,2,2
400915391,Louisville Cardinals,M. Mathiang,63035,,False,33.0,5,6,5,6,0,0,3,6,7,6,13,1,1,2,1,2,13
400915391,Louisville Cardinals,M. Stockman,3147361,,False,1.0,0,0,0,0,0,0,0,0,0,0,0,0,0,0,0,2,0
400915391,Louisville Cardinals,R. McMahon,3908808,,False,4.0,0,2,0,0,0,2,0,0,0,0,0,0,0,0,0,1,0
400915391,Louisville Cardinals,D. Levitch,66592,,False,23.0,3,4,2,2,1,2,2,2,1,2,3,3,0,0,0,4,9
400915391,Louisville Cardinals,T. Hicks,62752,,False,32.0,6,17,5,15,1,2,3,4,0,3,3,1,0,0,1,2,16
400915391,Louisville Cardinals,TEAM,TOTAL,TOTAL,False,,25,65,23,52,2,13,16,24,15,28,43,7,3,4,10,26,68
400915391,Florida State Seminoles,J. Isaac,4065654,,True,28.0,4,7,3,5,1,2,7,7,0,10,10,2,0,2,0,2,16
400915391,Florida State Seminoles,M. Ojo,61596,,True,15.0,2,5,2,5,0,0,6,7,2,4,6,1,1,1,0,1,10
400915391,Florida State Seminoles,T. Mann,3907823,,True,29.0,6,10,6,9,0,1,3,9,2,1,3,0,0,2,0,3,15
400915391,Florida State Seminoles,D. Bacon,3907821,,True,33.0,6,17,4,9,2,8,2,2,0,3,3,2,1,0,1,0,16
400915391,Florida State Seminoles,X. Rathan-Mayes,66125,,True,32.0,2,8,1,6,1,2,0,1,2,2,4,3,0,0,2,1,5
400915391,Florida State Seminoles,P. Cofer,3135054,,False,11.0,0,2,0,2,0,0,0,0,0,0,0,0,1,0,1,2,0
400915391,Florida State Seminoles,J. Smith,66126,,False,12.0,0,1,0,1,0,0,3,4,2,4,6,1,0,1,0,3,3
400915391,Florida State Seminoles,B. Allen,66124,,False,1.0,0,0,0,0,0,0,0,0,0,0,0,0,0,0,0,0,0
400915391,Florida State Seminoles,C. Koumadje,3907824,,False,12.0,1,2,1,2,0,0,2,4,2,0,2,0,0,2,0,5,4
400915391,Florida State Seminoles,P. Savoy,4065657,,False,6.0,0,2,0,0,0,2,0,0,0,0,0,0,0,0,0,0,0
400915391,Florida State Seminoles,T. Forrest,4065656,,False,11.0,0,3,0,2,0,1,2,2,0,0,0,0,0,0,1,0,2
400915391,Florida State Seminoles,C. Walker,4065655,,False,10.0,1,3,1,3,0,0,0,0,0,1,1,0,0,0,2,2,2
400915391,Florida State Seminoles,TEAM,TOTAL,TOTAL,False,,22,60,18,44,4,16,25,36,12,28,40,9,3,8,7,19,73
400915391,Florida State Seminoles,J. Isaac,4065654,,True,28.0,4,7,3,5,1,2,7,7,0,10,10,2,0,2,0,2,16
400915391,Florida State Seminoles,M. Ojo,61596,,True,15.0,2,5,2,5,0,0,6,7,2,4,6,1,1,1,0,1,10
400915391,Florida State Seminoles,T. Mann,3907823,,True,29.0,6,10,6,9,0,1,3,9,2,1,3,0,0,2,0,3,15
400915391,Florida State Seminoles,D. Bacon,3907821,,True,33.0,6,17,4,9,2,8,2,2,0,3,3,2,1,0,1,0,16
400915391,Florida State Seminoles,X. Rathan-Mayes,66125,,True,32.0,2,8,1,6,1,2,0,1,2,2,4,3,0,0,2,1,5
400915391,Florida State Seminoles,P. Cofer,3135054,,False,11.0,0,2,0,2,0,0,0,0,0,0,0,0,1,0,1,2,0
400915391,Florida State Seminoles,J. Smith,66126,,False,12.0,0,1,0,1,0,0,3,4,2,4,6,1,0,1,0,3,3
400915391,Florida State Seminoles,B. Allen,66124,,False,1.0,0,0,0,0,0,0,0,0,0,0,0,0,0,0,0,0,0
400915391,Florida State Seminoles,C. Koumadje,3907824,,False,12.0,1,2,1,2,0,0,2,4,2,0,2,0,0,2,0,5,4
400915391,Florida State Seminoles,P. Savoy,4065657,,False,6.0,0,2,0,0,0,2,0,0,0,0,0,0,0,0,0,0,0
400915391,Florida State Seminoles,T. Forrest,4065656,,False,11.0,0,3,0,2,0,1,2,2,0,0,0,0,0,0,1,0,2
400915391,Florida State Seminoles,C. Walker,4065655,,False,10.0,1,3,1,3,0,0,0,0,0,1,1,0,0,0,2,2,2
400915391,Florida State Seminoles,TEAM,TOTAL,TOTAL,False,,22,60,18,44,4,16,25,36,12,28,40,9,3,8,7,19,73
400915390,Syracuse Orange,T. Thompson,4065721,,True,9.0,0,4,0,4,0,0,0,0,0,2,2,0,0,0,2,4,0
400915390,Syracuse Orange,T. Lydon,3934662,,True,40.0,7,13,5,9,2,4,8,8,3,7,10,2,0,1,1,1,24
400915390,Syracuse Orange,T. Battle,4065722,,True,40.0,6,14,5,9,1,5,4,7,1,2,3,1,3,0,1,1,17
400915390,Syracuse Orange,J. Gillon,61915,,True,10.0,0,1,0,0,0,1,0,0,0,0,0,1,0,0,0,0,0
400915390,Syracuse Orange,A. White III,61616,,True,38.0,6,13,3,6,3,7,1,2,0,3,3,0,1,1,1,2,16
400915390,Syracuse Orange,T. Roberson,67633,,False,11.0,0,2,0,2,0,0,0,0,0,1,1,0,2,2,2,4,0
400915390,Syracuse Orange,D. Coleman,61821,,False,23.0,2,3,2,3,0,0,1,2,3,4,7,0,1,0,1,4,5
400915390,Syracuse Orange,F. Howard,3934659,,False,29.0,2,5,2,3,0,2,0,1,0,0,0,4,3,0,3,0,4
400915390,Syracuse Orange,TEAM,TOTAL,TOTAL,False,,23,55,17,36,6,19,14,20,7,21,28,8,10,4,11,16,66
400915390,Syracuse Orange,T. Thompson,4065721,,True,9.0,0,4,0,4,0,0,0,0,0,2,2,0,0,0,2,4,0
400915390,Syracuse Orange,T. Lydon,3934662,,True,40.0,7,13,5,9,2,4,8,8,3,7,10,2,0,1,1,1,24
400915390,Syracuse Orange,T. Battle,4065722,,True,40.0,6,14,5,9,1,5,4,7,1,2,3,1,3,0,1,1,17
400915390,Syracuse Orange,J. Gillon,61915,,True,10.0,0,1,0,0,0,1,0,0,0,0,0,1,0,0,0,0,0
400915390,Syracuse Orange,A. White III,61616,,True,38.0,6,13,3,6,3,7,1,2,0,3,3,0,1,1,1,2,16
400915390,Syracuse Orange,T. Roberson,67633,,False,11.0,0,2,0,2,0,0,0,0,0,1,1,0,2,2,2,4,0
400915390,Syracuse Orange,D. Coleman,61821,,False,23.0,2,3,2,3,0,0,1,2,3,4,7,0,1,0,1,4,5
400915390,Syracuse Orange,F. Howard,3934659,,False,29.0,2,5,2,3,0,2,0,1,0,0,0,4,3,0,3,0,4
400915390,Syracuse Orange,TEAM,TOTAL,TOTAL,False,,23,55,17,36,6,19,14,20,7,21,28,8,10,4,11,16,66
400915390,Notre Dame Fighting Irish,B. Colson,3138192,,True,24.0,4,8,4,8,0,0,6,6,4,10,14,3,0,0,1,3,14
400915390,Notre Dame Fighting Irish,M. Geben,3138191,,True,17.0,1,1,1,1,0,0,5,6,2,2,4,0,0,0,0,3,7
400915390,Notre Dame Fighting Irish,V.J. Beachem,66283,,True,38.0,12,22,6,12,6,10,0,0,1,6,7,1,1,2,1,2,30
400915390,Notre Dame Fighting Irish,M. Farrell,3138190,,True,37.0,6,10,3,5,3,5,0,0,0,2,2,9,2,0,3,3,15
400915390,Notre Dame Fighting Irish,S. Vasturia,66285,,True,36.0,3,9,2,3,1,6,4,4,0,3,3,4,1,0,2,3,11
400915390,Notre Dame Fighting Irish,A. Torres,66286,,False,12.0,1,2,1,2,0,0,0,0,3,2,5,0,1,0,1,2,2
400915390,Notre Dame Fighting Irish,M. Ryan,3908336,,False,4.0,0,3,0,1,0,2,0,0,0,0,0,0,0,0,0,0,0
400915390,Notre Dame Fighting Irish,T. Gibbs,4065703,,False,8.0,0,0,0,0,0,0,0,0,0,1,1,0,1,0,3,0,0
400915390,Notre Dame Fighting Irish,R. Pflueger,3908335,,False,24.0,2,4,1,1,1,3,0,0,0,2,2,3,3,0,0,2,5
400915390,Notre Dame Fighting Irish,TEAM,TOTAL,TOTAL,False,,29,59,18,33,11,26,15,16,10,29,39,20,9,2,11,18,84
400915390,Notre Dame Fighting Irish,B. Colson,3138192,,True,24.0,4,8,4,8,0,0,6,6,4,10,14,3,0,0,1,3,14
400915390,Notre Dame Fighting Irish,M. Geben,3138191,,True,17.0,1,1,1,1,0,0,5,6,2,2,4,0,0,0,0,3,7
400915390,Notre Dame Fighting Irish,V.J. Beachem,66283,,True,38.0,12,22,6,12,6,10,0,0,1,6,7,1,1,2,1,2,30
400915390,Notre Dame Fighting Irish,M. Farrell,3138190,,True,37.0,6,10,3,5,3,5,0,0,0,2,2,9,2,0,3,3,15
400915390,Notre Dame Fighting Irish,S. Vasturia,66285,,True,36.0,3,9,2,3,1,6,4,4,0,3,3,4,1,0,2,3,11
400915390,Notre Dame Fighting Irish,A. Torres,66286,,False,12.0,1,2,1,2,0,0,0,0,3,2,5,0,1,0,1,2,2
400915390,Notre Dame Fighting Irish,M. Ryan,3908336,,False,4.0,0,3,0,1,0,2,0,0,0,0,0,0,0,0,0,0,0
400915390,Notre Dame Fighting Irish,T. Gibbs,4065703,,False,8.0,0,0,0,0,0,0,0,0,0,1,1,0,1,0,3,0,0
400915390,Notre Dame Fighting Irish,R. Pflueger,3908335,,False,24.0,2,4,1,1,1,3,0,0,0,2,2,3,3,0,0,2,5
400915390,Notre Dame Fighting Irish,TEAM,TOTAL,TOTAL,False,,29,59,18,33,11,26,15,16,10,29,39,20,9,2,11,18,84
400915389,North Carolina Tar Heels,J. Jackson,3138156,,True,31.0,6,16,3,10,3,6,7,8,0,4,4,2,0,0,1,1,22
400915389,North Carolina Tar Heels,I. Hicks,66874,,True,19.0,4,5,4,5,0,0,6,7,5,0,5,4,2,1,3,2,14
400915389,North Carolina Tar Heels,K. Meeks,66873,,True,25.0,9,16,9,16,0,0,2,2,2,7,9,1,1,1,0,1,20
400915389,North Carolina Tar Heels,K. Williams,3911619,,True,19.0,1,4,1,3,0,1,2,2,0,4,4,3,0,2,1,3,4
400915389,North Carolina Tar Heels,J. Berry II,3138155,,True,35.0,3,9,1,5,2,4,1,2,0,0,0,0,1,1,2,1,9
400915389,North Carolina Tar Heels,T. Bradley,4065673,,False,11.0,2,3,2,3,0,0,1,2,1,5,6,0,0,0,2,2,5
400915389,North Carolina Tar Heels,L. Maye,3911620,,False,14.0,1,4,0,2,1,2,0,0,1,4,5,1,1,0,1,0,3
400915389,North Carolina Tar Heels,T. Pinson,3138154,,False,23.0,3,3,3,3,0,0,5,6,3,2,5,3,1,0,0,1,11
400915389,North Carolina Tar Heels,S. Woods,4065676,,False,7.0,0,2,0,1,0,1,0,0,0,0,0,2,0,0,1,0,0
400915389,North Carolina Tar Heels,B. Robinson,4065675,,False,2.0,0,0,0,0,0,0,0,0,0,1,1,0,0,0,0,0,0
400915389,North Carolina Tar Heels,N. Britt,66872,,False,14.0,1,2,1,2,0,0,0,0,0,0,0,1,1,0,1,0,2
400915389,North Carolina Tar Heels,TEAM,TOTAL,TOTAL,False,,30,64,24,50,6,14,24,29,16,27,43,17,7,5,12,11,90
400915389,North Carolina Tar Heels,J. Jackson,3138156,,True,31.0,6,16,3,10,3,6,7,8,0,4,4,2,0,0,1,1,22
400915389,North Carolina Tar Heels,I. Hicks,66874,,True,19.0,4,5,4,5,0,0,6,7,5,0,5,4,2,1,3,2,14
400915389,North Carolina Tar Heels,K. Meeks,66873,,True,25.0,9,16,9,16,0,0,2,2,2,7,9,1,1,1,0,1,20
400915389,North Carolina Tar Heels,K. Williams,3911619,,True,19.0,1,4,1,3,0,1,2,2,0,4,4,3,0,2,1,3,4
400915389,North Carolina Tar Heels,J. Berry II,3138155,,True,35.0,3,9,1,5,2,4,1,2,0,0,0,0,1,1,2,1,9
400915389,North Carolina Tar Heels,T. Bradley,4065673,,False,11.0,2,3,2,3,0,0,1,2,1,5,6,0,0,0,2,2,5
400915389,North Carolina Tar Heels,L. Maye,3911620,,False,14.0,1,4,0,2,1,2,0,0,1,4,5,1,1,0,1,0,3
400915389,North Carolina Tar Heels,T. Pinson,3138154,,False,23.0,3,3,3,3,0,0,5,6,3,2,5,3,1,0,0,1,11
400915389,North Carolina Tar Heels,S. Woods,4065676,,False,7.0,0,2,0,1,0,1,0,0,0,0,0,2,0,0,1,0,0
400915389,North Carolina Tar Heels,B. Robinson,4065675,,False,2.0,0,0,0,0,0,0,0,0,0,1,1,0,0,0,0,0,0
400915389,North Carolina Tar Heels,N. Britt,66872,,False,14.0,1,2,1,2,0,0,0,0,0,0,0,1,1,0,1,0,2
400915389,North Carolina Tar Heels,TEAM,TOTAL,TOTAL,False,,30,64,24,50,6,14,24,29,16,27,43,17,7,5,12,11,90
400915389,Boston College Eagles,A.J. Turner,3943608,,True,33.0,2,6,1,1,1,5,2,2,0,2,2,5,0,0,1,1,7
400915389,Boston College Eagles,M. Jeffers,61901,,True,27.0,3,5,3,5,0,0,0,0,3,2,5,0,1,3,1,5,6
400915389,Boston College Eagles,C. Tava,61446,,True,25.0,3,4,3,3,0,1,0,0,2,2,4,0,1,1,1,4,6
400915389,Boston College Eagles,K. Bowman,4065635,,True,37.0,13,19,6,10,7,9,0,1,0,3,3,4,1,0,8,2,33
400915389,Boston College Eagles,J. Robinson,3943606,,True,31.0,7,21,5,14,2,7,2,2,1,2,3,3,1,0,2,4,18
400915389,Boston College Eagles,N. Popovic,4065637,,False,13.0,2,4,2,4,0,0,0,0,0,3,3,0,0,1,1,0,4
400915389,Boston College Eagles,G. Owens,66277,,False,16.0,0,1,0,0,0,1,0,0,2,3,5,1,0,0,1,2,0
400915389,Boston College Eagles,J. Chatman,3135095,,False,18.0,2,8,0,4,2,4,2,2,0,4,4,2,0,0,0,1,8
400915389,Boston College Eagles,TEAM,TOTAL,TOTAL,False,,32,68,20,41,12,27,6,7,10,21,31,15,4,5,15,19,82
400915389,Boston College Eagles,A.J. Turner,3943608,,True,33.0,2,6,1,1,1,5,2,2,0,2,2,5,0,0,1,1,7
400915389,Boston College Eagles,M. Jeffers,61901,,True,27.0,3,5,3,5,0,0,0,0,3,2,5,0,1,3,1,5,6
400915389,Boston College Eagles,C. Tava,61446,,True,25.0,3,4,3,3,0,1,0,0,2,2,4,0,1,1,1,4,6
400915389,Boston College Eagles,K. Bowman,4065635,,True,37.0,13,19,6,10,7,9,0,1,0,3,3,4,1,0,8,2,33
400915389,Boston College Eagles,J. Robinson,3943606,,True,31.0,7,21,5,14,2,7,2,2,1,2,3,3,1,0,2,4,18
400915389,Boston College Eagles,N. Popovic,4065637,,False,13.0,2,4,2,4,0,0,0,0,0,3,3,0,0,1,1,0,4
400915389,Boston College Eagles,G. Owens,66277,,False,16.0,0,1,0,0,0,1,0,0,2,3,5,1,0,0,1,2,0
400915389,Boston College Eagles,J. Chatman,3135095,,False,18.0,2,8,0,4,2,4,2,2,0,4,4,2,0,0,0,1,8
400915389,Boston College Eagles,TEAM,TOTAL,TOTAL,False,,32,68,20,41,12,27,6,7,10,21,31,15,4,5,15,19,82
400915388,Louisville Cardinals,A. Mahmoud,3147363,,True,18.0,2,3,2,3,0,0,2,2,4,1,5,0,0,1,2,0,6
400915388,Louisville Cardinals,V.J. King,4065666,,True,22.0,5,8,3,5,2,3,2,2,1,1,2,1,1,0,1,1,14
400915388,Louisville Cardinals,J. Johnson,3147362,,True,27.0,4,6,4,6,0,0,4,5,3,7,10,2,2,0,0,2,12
400915388,Louisville Cardinals,D. Adel,3908807,,True,34.0,6,9,3,4,3,5,3,4,0,6,6,2,0,0,2,0,18
400915388,Louisville Cardinals,D. Mitchell,3908809,,True,31.0,8,15,6,8,2,7,0,0,0,4,4,4,3,0,2,3,18
400915388,Louisville Cardinals,R. Spalding,3908806,,False,8.0,0,1,0,1,0,0,0,0,0,3,3,1,0,1,1,4,0
400915388,Louisville Cardinals,M. Mathiang,63035,,False,22.0,6,9,6,9,0,0,0,1,5,3,8,0,0,2,2,3,12
400915388,Louisville Cardinals,T. Sharpe,4065667,,False,1.0,0,1,0,0,0,1,0,0,0,1,1,0,0,0,0,0,0
400915388,Louisville Cardinals,R. McMahon,3908808,,False,2.0,0,0,0,0,0,0,0,0,0,0,0,0,0,0,0,0,0
400915388,Louisville Cardinals,J. Henderson,3155491,,False,1.0,0,1,0,0,0,1,0,0,0,0,0,0,0,0,0,0,0
400915388,Louisville Cardinals,D. Levitch,66592,,False,17.0,1,3,0,1,1,2,0,0,1,0,1,0,0,0,1,2,3
400915388,Louisville Cardinals,T. Hicks,62752,,False,17.0,4,8,3,5,1,3,0,2,0,3,3,0,1,0,0,1,9
400915388,Louisville Cardinals,TEAM,TOTAL,TOTAL,False,,36,64,27,42,9,22,11,16,15,30,45,10,7,4,11,16,92
400915388,Louisville Cardinals,A. Mahmoud,3147363,,True,18.0,2,3,2,3,0,0,2,2,4,1,5,0,0,1,2,0,6
400915388,Louisville Cardinals,V.J. King,4065666,,True,22.0,5,8,3,5,2,3,2,2,1,1,2,1,1,0,1,1,14
400915388,Louisville Cardinals,J. Johnson,3147362,,True,27.0,4,6,4,6,0,0,4,5,3,7,10,2,2,0,0,2,12
400915388,Louisville Cardinals,D. Adel,3908807,,True,34.0,6,9,3,4,3,5,3,4,0,6,6,2,0,0,2,0,18
400915388,Louisville Cardinals,D. Mitchell,3908809,,True,31.0,8,15,6,8,2,7,0,0,0,4,4,4,3,0,2,3,18
400915388,Louisville Cardinals,R. Spalding,3908806,,False,8.0,0,1,0,1,0,0,0,0,0,3,3,1,0,1,1,4,0
400915388,Louisville Cardinals,M. Mathiang,63035,,False,22.0,6,9,6,9,0,0,0,1,5,3,8,0,0,2,2,3,12
400915388,Louisville Cardinals,T. Sharpe,4065667,,False,1.0,0,1,0,0,0,1,0,0,0,1,1,0,0,0,0,0,0
400915388,Louisville Cardinals,R. McMahon,3908808,,False,2.0,0,0,0,0,0,0,0,0,0,0,0,0,0,0,0,0,0
400915388,Louisville Cardinals,J. Henderson,3155491,,False,1.0,0,1,0,0,0,1,0,0,0,0,0,0,0,0,0,0,0
400915388,Louisville Cardinals,D. Levitch,66592,,False,17.0,1,3,0,1,1,2,0,0,1,0,1,0,0,0,1,2,3
400915388,Louisville Cardinals,T. Hicks,62752,,False,17.0,4,8,3,5,1,3,0,2,0,3,3,0,1,0,0,1,9
400915388,Louisville Cardinals,TEAM,TOTAL,TOTAL,False,,36,64,27,42,9,22,11,16,15,30,45,10,7,4,11,16,92
400915388,Clemson Tigers,D. Grantham,3129674,,True,31.0,3,10,1,3,2,7,3,4,1,3,4,3,0,1,0,2,11
400915388,Clemson Tigers,J. Blossomgame,61835,,True,27.0,4,8,2,4,2,4,0,0,2,0,2,0,0,0,1,1,10
400915388,Clemson Tigers,S. Djitte,66122,,True,25.0,2,4,2,4,0,0,1,4,3,2,5,0,3,0,1,4,5
400915388,Clemson Tigers,S. Mitchell,3136699,,True,22.0,1,3,1,2,0,1,2,4,0,1,1,3,0,0,2,3,4
400915388,Clemson Tigers,A. Holmes,62043,,True,20.0,3,7,1,2,2,5,0,0,0,1,1,0,0,0,0,0,8
400915388,Clemson Tigers,E. Thomas,3947075,,False,16.0,1,4,1,4,0,0,0,1,0,5,5,0,2,0,3,6,2
400915388,Clemson Tigers,L. Robertin,3917985,,False,2.0,0,0,0,0,0,0,0,0,0,0,0,0,0,0,0,0,0
400915388,Clemson Tigers,I. Fields,4065645,,False,1.0,0,0,0,0,0,0,0,0,0,0,0,0,0,0,0,0,0
400915388,Clemson Tigers,T. Hudson,3917986,,False,2.0,0,0,0,0,0,0,0,0,0,1,1,0,0,0,2,0,0
400915388,Clemson Tigers,M. Reed,3133969,,False,24.0,6,13,5,8,1,5,0,0,0,0,0,2,2,0,2,2,13
400915388,Clemson Tigers,G. DeVoe,3129673,,False,30.0,3,6,2,3,1,3,0,0,0,4,4,2,0,0,3,2,7
400915388,Clemson Tigers,TEAM,TOTAL,TOTAL,False,,23,55,15,30,8,25,6,13,8,17,25,10,7,1,14,20,60
400915388,Clemson Tigers,D. Grantham,3129674,,True,31.0,3,10,1,3,2,7,3,4,1,3,4,3,0,1,0,2,11
400915388,Clemson Tigers,J. Blossomgame,61835,,True,27.0,4,8,2,4,2,4,0,0,2,0,2,0,0,0,1,1,10
400915388,Clemson Tigers,S. Djitte,66122,,True,25.0,2,4,2,4,0,0,1,4,3,2,5,0,3,0,1,4,5
400915388,Clemson Tigers,S. Mitchell,3136699,,True,22.0,1,3,1,2,0,1,2,4,0,1,1,3,0,0,2,3,4
400915388,Clemson Tigers,A. Holmes,62043,,True,20.0,3,7,1,2,2,5,0,0,0,1,1,0,0,0,0,0,8
400915388,Clemson Tigers,E. Thomas,3947075,,False,16.0,1,4,1,4,0,0,0,1,0,5,5,0,2,0,3,6,2
400915388,Clemson Tigers,L. Robertin,3917985,,False,2.0,0,0,0,0,0,0,0,0,0,0,0,0,0,0,0,0,0
400915388,Clemson Tigers,I. Fields,4065645,,False,1.0,0,0,0,0,0,0,0,0,0,0,0,0,0,0,0,0,0
400915388,Clemson Tigers,T. Hudson,3917986,,False,2.0,0,0,0,0,0,0,0,0,0,1,1,0,0,0,2,0,0
400915388,Clemson Tigers,M. Reed,3133969,,False,24.0,6,13,5,8,1,5,0,0,0,0,0,2,2,0,2,2,13
400915388,Clemson Tigers,G. DeVoe,3129673,,False,30.0,3,6,2,3,1,3,0,0,0,4,4,2,0,0,3,2,7
400915388,Clemson Tigers,TEAM,TOTAL,TOTAL,False,,23,55,15,30,8,25,6,13,8,17,25,10,7,1,14,20,60
400915387,Virginia Tech Hokies,K. Sy,4065740,,True,11.0,2,3,2,3,0,0,0,0,0,1,1,0,0,0,0,1,4
400915387,Virginia Tech Hokies,J. Robinson,3945566,,True,34.0,0,7,0,3,0,4,0,1,0,8,8,3,0,0,2,1,0
400915387,Virginia Tech Hokies,A. Hill,3147501,,True,19.0,2,7,2,3,0,4,0,0,0,0,0,1,0,0,1,4,4
400915387,Virginia Tech Hokies,J. Bibbs,3147500,,True,38.0,3,8,0,0,3,8,0,0,0,3,3,4,0,0,3,3,9
400915387,Virginia Tech Hokies,T. Outlaw,67275,,True,11.0,0,3,0,1,0,2,0,0,0,4,4,0,0,1,0,0,0
400915387,Virginia Tech Hokies,Z. LeDay,61698,,False,29.0,6,10,6,9,0,1,5,7,3,2,5,1,0,1,2,2,17
400915387,Virginia Tech Hokies,C. Clarke,3945567,,False,29.0,3,8,3,8,0,0,5,6,4,7,11,2,1,0,1,2,11
400915387,Virginia Tech Hokies,S. Allen,61795,,False,29.0,6,9,3,3,3,6,2,2,0,0,0,2,0,0,3,3,17
400915387,Virginia Tech Hokies,TEAM,TOTAL,TOTAL,False,,22,55,16,30,6,25,12,16,9,25,34,13,1,2,13,16,62
400915387,Virginia Tech Hokies,K. Sy,4065740,,True,11.0,2,3,2,3,0,0,0,0,0,1,1,0,0,0,0,1,4
400915387,Virginia Tech Hokies,J. Robinson,3945566,,True,34.0,0,7,0,3,0,4,0,1,0,8,8,3,0,0,2,1,0
400915387,Virginia Tech Hokies,A. Hill,3147501,,True,19.0,2,7,2,3,0,4,0,0,0,0,0,1,0,0,1,4,4
400915387,Virginia Tech Hokies,J. Bibbs,3147500,,True,38.0,3,8,0,0,3,8,0,0,0,3,3,4,0,0,3,3,9
400915387,Virginia Tech Hokies,T. Outlaw,67275,,True,11.0,0,3,0,1,0,2,0,0,0,4,4,0,0,1,0,0,0
400915387,Virginia Tech Hokies,Z. LeDay,61698,,False,29.0,6,10,6,9,0,1,5,7,3,2,5,1,0,1,2,2,17
400915387,Virginia Tech Hokies,C. Clarke,3945567,,False,29.0,3,8,3,8,0,0,5,6,4,7,11,2,1,0,1,2,11
400915387,Virginia Tech Hokies,S. Allen,61795,,False,29.0,6,9,3,3,3,6,2,2,0,0,0,2,0,0,3,3,17
400915387,Virginia Tech Hokies,TEAM,TOTAL,TOTAL,False,,22,55,16,30,6,25,12,16,9,25,34,13,1,2,13,16,62
400915387,Georgia Tech Yellow Jackets,Q. Stephens,66128,,True,40.0,6,13,1,3,5,10,1,3,2,11,13,3,2,0,2,3,18
400915387,Georgia Tech Yellow Jackets,B. Lammers,3135061,,True,38.0,6,11,6,11,0,0,0,0,0,6,6,2,0,8,1,4,12
400915387,Georgia Tech Yellow Jackets,J. Okogie,4065663,,True,36.0,3,9,3,8,0,1,6,6,2,1,3,1,1,2,1,2,12
400915387,Georgia Tech Yellow Jackets,J. Moore,4065662,,True,17.0,0,3,0,3,0,0,0,2,0,1,1,1,0,0,0,1,0
400915387,Georgia Tech Yellow Jackets,J. Heath,67623,,True,39.0,4,7,3,5,1,2,1,2,1,2,3,6,2,0,4,2,10
400915387,Georgia Tech Yellow Jackets,A. Gueye,3135059,,False,4.0,0,0,0,0,0,0,0,0,0,0,0,0,0,0,1,1,0
400915387,Georgia Tech Yellow Jackets,T. Jackson,3135057,,False,24.0,4,8,4,7,0,1,1,2,0,2,2,3,1,0,1,2,9
400915387,Georgia Tech Yellow Jackets,C. Heyward,61609,,False,2.0,0,0,0,0,0,0,0,0,0,0,0,0,0,0,0,0,0
400915387,Georgia Tech Yellow Jackets,TEAM,TOTAL,TOTAL,False,,23,51,17,37,6,14,9,15,5,24,29,16,6,10,10,15,61
400915387,Georgia Tech Yellow Jackets,Q. Stephens,66128,,True,40.0,6,13,1,3,5,10,1,3,2,11,13,3,2,0,2,3,18
400915387,Georgia Tech Yellow Jackets,B. Lammers,3135061,,True,38.0,6,11,6,11,0,0,0,0,0,6,6,2,0,8,1,4,12
400915387,Georgia Tech Yellow Jackets,J. Okogie,4065663,,True,36.0,3,9,3,8,0,1,6,6,2,1,3,1,1,2,1,2,12
400915387,Georgia Tech Yellow Jackets,J. Moore,4065662,,True,17.0,0,3,0,3,0,0,0,2,0,1,1,1,0,0,0,1,0
400915387,Georgia Tech Yellow Jackets,J. Heath,67623,,True,39.0,4,7,3,5,1,2,1,2,1,2,3,6,2,0,4,2,10
400915387,Georgia Tech Yellow Jackets,A. Gueye,3135059,,False,4.0,0,0,0,0,0,0,0,0,0,0,0,0,0,0,1,1,0
400915387,Georgia Tech Yellow Jackets,T. Jackson,3135057,,False,24.0,4,8,4,7,0,1,1,2,0,2,2,3,1,0,1,2,9
400915387,Georgia Tech Yellow Jackets,C. Heyward,61609,,False,2.0,0,0,0,0,0,0,0,0,0,0,0,0,0,0,0,0,0
400915387,Georgia Tech Yellow Jackets,TEAM,TOTAL,TOTAL,False,,23,51,17,37,6,14,9,15,5,24,29,16,6,10,10,15,61
400915386,Wake Forest Demon Deacons,J. Collins,3908845,,True,24.0,9,11,9,11,0,0,9,9,1,6,7,0,0,1,1,3,27
400915386,Wake Forest Demon Deacons,D. Mitoglou,3138224,,True,16.0,2,5,2,2,0,3,1,1,0,4,4,1,0,0,1,5,5
400915386,Wake Forest Demon Deacons,A. Arians,61378,,True,28.0,3,6,2,3,1,3,0,0,0,1,1,1,1,0,0,2,7
400915386,Wake Forest Demon Deacons,B. Crawford,3908844,,True,33.0,3,9,2,6,1,3,7,9,0,5,5,8,1,0,2,3,14
400915386,Wake Forest Demon Deacons,K. Woods,3132360,,True,35.0,6,9,3,5,3,4,5,6,0,4,4,6,0,0,2,2,20
400915386,Wake Forest Demon Deacons,G. McClinton,66140,,False,6.0,0,0,0,0,0,0,0,0,0,0,0,0,0,0,0,0,0
400915386,Wake Forest Demon Deacons,S. Japhet-Mathias,4065752,,False,1.0,0,0,0,0,0,0,0,0,1,0,1,1,0,0,0,0,0
400915386,Wake Forest Demon Deacons,D. Moore,3908843,,False,12.0,3,5,3,5,0,0,0,2,2,1,3,0,1,1,0,5,6
400915386,Wake Forest Demon Deacons,B. Childress,4065750,,False,19.0,2,2,0,0,2,2,1,2,0,3,3,0,0,0,2,4,7
400915386,Wake Forest Demon Deacons,M. Wilbekin,3138222,,False,26.0,2,5,0,1,2,4,4,4,0,1,1,0,0,0,1,1,10
400915386,Wake Forest Demon Deacons,TEAM,TOTAL,TOTAL,False,,30,52,21,33,9,19,27,33,5,27,32,17,3,2,9,25,96
400915386,Wake Forest Demon Deacons,J. Collins,3908845,,True,24.0,9,11,9,11,0,0,9,9,1,6,7,0,0,1,1,3,27
400915386,Wake Forest Demon Deacons,D. Mitoglou,3138224,,True,16.0,2,5,2,2,0,3,1,1,0,4,4,1,0,0,1,5,5
400915386,Wake Forest Demon Deacons,A. Arians,61378,,True,28.0,3,6,2,3,1,3,0,0,0,1,1,1,1,0,0,2,7
400915386,Wake Forest Demon Deacons,B. Crawford,3908844,,True,33.0,3,9,2,6,1,3,7,9,0,5,5,8,1,0,2,3,14
400915386,Wake Forest Demon Deacons,K. Woods,3132360,,True,35.0,6,9,3,5,3,4,5,6,0,4,4,6,0,0,2,2,20
400915386,Wake Forest Demon Deacons,G. McClinton,66140,,False,6.0,0,0,0,0,0,0,0,0,0,0,0,0,0,0,0,0,0
400915386,Wake Forest Demon Deacons,S. Japhet-Mathias,4065752,,False,1.0,0,0,0,0,0,0,0,0,1,0,1,1,0,0,0,0,0
400915386,Wake Forest Demon Deacons,D. Moore,3908843,,False,12.0,3,5,3,5,0,0,0,2,2,1,3,0,1,1,0,5,6
400915386,Wake Forest Demon Deacons,B. Childress,4065750,,False,19.0,2,2,0,0,2,2,1,2,0,3,3,0,0,0,2,4,7
400915386,Wake Forest Demon Deacons,M. Wilbekin,3138222,,False,26.0,2,5,0,1,2,4,4,4,0,1,1,0,0,0,1,1,10
400915386,Wake Forest Demon Deacons,TEAM,TOTAL,TOTAL,False,,30,52,21,33,9,19,27,33,5,27,32,17,3,2,9,25,96
400915386,Miami Hurricanes,D. Hernandez,4065672,,True,25.0,3,9,3,9,0,0,3,4,2,6,8,0,0,1,0,4,9
400915386,Miami Hurricanes,K. Murphy,61668,,True,26.0,0,3,0,3,0,0,2,4,1,4,5,0,0,0,0,5,2
400915386,Miami Hurricanes,B. Brown,4065670,,True,31.0,4,7,4,6,0,1,1,1,0,3,3,1,1,0,0,4,9
400915386,Miami Hurricanes,J. Newton,3138145,,True,34.0,3,6,3,6,0,0,3,5,1,2,3,7,0,0,4,3,9
400915386,Miami Hurricanes,D. Reed,66130,,True,37.0,8,17,5,9,3,8,5,5,2,1,3,4,2,0,2,1,24
400915386,Miami Hurricanes,R. Miller Jr.,4065671,,False,1.0,0,0,0,0,0,0,1,2,0,0,0,0,0,0,0,0,1
400915386,Miami Hurricanes,E. Izundu,3904629,,False,10.0,3,4,3,4,0,0,0,0,2,3,5,0,0,0,1,5,6
400915386,Miami Hurricanes,A. Lawrence II,3904628,,False,23.0,4,8,0,0,4,8,4,4,0,0,0,2,0,0,1,3,16
400915386,Miami Hurricanes,D. Vasiljevic,4065669,,False,13.0,1,6,0,0,1,6,0,0,0,0,0,0,0,0,0,1,3
400915386,Miami Hurricanes,TEAM,TOTAL,TOTAL,False,,26,60,18,37,8,23,19,25,10,20,30,14,3,1,9,26,79
400915386,Miami Hurricanes,D. Hernandez,4065672,,True,25.0,3,9,3,9,0,0,3,4,2,6,8,0,0,1,0,4,9
400915386,Miami Hurricanes,K. Murphy,61668,,True,26.0,0,3,0,3,0,0,2,4,1,4,5,0,0,0,0,5,2
400915386,Miami Hurricanes,B. Brown,4065670,,True,31.0,4,7,4,6,0,1,1,1,0,3,3,1,1,0,0,4,9
400915386,Miami Hurricanes,J. Newton,3138145,,True,34.0,3,6,3,6,0,0,3,5,1,2,3,7,0,0,4,3,9
400915386,Miami Hurricanes,D. Reed,66130,,True,37.0,8,17,5,9,3,8,5,5,2,1,3,4,2,0,2,1,24
400915386,Miami Hurricanes,R. Miller Jr.,4065671,,False,1.0,0,0,0,0,0,0,1,2,0,0,0,0,0,0,0,0,1
400915386,Miami Hurricanes,E. Izundu,3904629,,False,10.0,3,4,3,4,0,0,0,0,2,3,5,0,0,0,1,5,6
400915386,Miami Hurricanes,A. Lawrence II,3904628,,False,23.0,4,8,0,0,4,8,4,4,0,0,0,2,0,0,1,3,16
400915386,Miami Hurricanes,D. Vasiljevic,4065669,,False,13.0,1,6,0,0,1,6,0,0,0,0,0,0,0,0,0,1,3
400915386,Miami Hurricanes,TEAM,TOTAL,TOTAL,False,,26,60,18,37,8,23,19,25,10,20,30,14,3,1,9,26,79
400915385,Virginia Cavaliers,I. Wilkins,3138203,,True,25.0,4,7,4,7,0,0,3,3,1,8,9,0,1,0,0,1,11
400915385,Virginia Cavaliers,J. Salt,3138200,,True,18.0,1,2,1,2,0,0,0,0,0,3,3,0,1,0,0,2,2
400915385,Virginia Cavaliers,M. Shayok,3138201,,True,18.0,2,5,2,5,0,0,2,2,0,0,0,1,2,1,2,1,6
400915385,Virginia Cavaliers,L. Perrantes,66139,,True,20.0,3,9,3,7,0,2,0,2,0,1,1,4,2,0,1,0,6
400915385,Virginia Cavaliers,D. Hall,66138,,True,25.0,5,6,3,4,2,2,1,1,0,2,2,6,0,1,0,2,13
400915385,Virginia Cavaliers,M. Diakite,3947156,,False,9.0,1,2,1,2,0,0,2,5,0,2,2,0,0,0,0,2,4
400915385,Virginia Cavaliers,J. Reuter,3908374,,False,15.0,2,5,2,5,0,0,0,0,1,2,3,1,1,1,1,1,4
400915385,Virginia Cavaliers,T. Jerome,4065733,,False,23.0,2,4,2,4,0,0,1,2,0,2,2,5,3,0,1,2,5
400915385,Virginia Cavaliers,K. Guy,4065730,,False,25.0,3,5,2,3,1,2,1,3,0,4,4,1,0,0,0,1,8
400915385,Virginia Cavaliers,T. Gross Jr.,4065729,,False,1.0,0,0,0,0,0,0,0,0,0,0,0,0,0,0,0,0,0
400915385,Virginia Cavaliers,J. Bartley,3947155,,False,1.0,0,0,0,0,0,0,0,0,0,0,0,0,0,0,0,0,0
400915385,Virginia Cavaliers,D. Thompson,66274,,False,20.0,4,7,2,3,2,4,2,2,0,0,0,4,2,0,0,0,12
400915385,Virginia Cavaliers,TEAM,TOTAL,TOTAL,False,,27,52,22,42,5,10,12,20,3,24,27,22,12,3,5,12,71
400915385,Virginia Cavaliers,I. Wilkins,3138203,,True,25.0,4,7,4,7,0,0,3,3,1,8,9,0,1,0,0,1,11
400915385,Virginia Cavaliers,J. Salt,3138200,,True,18.0,1,2,1,2,0,0,0,0,0,3,3,0,1,0,0,2,2
400915385,Virginia Cavaliers,M. Shayok,3138201,,True,18.0,2,5,2,5,0,0,2,2,0,0,0,1,2,1,2,1,6
400915385,Virginia Cavaliers,L. Perrantes,66139,,True,20.0,3,9,3,7,0,2,0,2,0,1,1,4,2,0,1,0,6
400915385,Virginia Cavaliers,D. Hall,66138,,True,25.0,5,6,3,4,2,2,1,1,0,2,2,6,0,1,0,2,13
400915385,Virginia Cavaliers,M. Diakite,3947156,,False,9.0,1,2,1,2,0,0,2,5,0,2,2,0,0,0,0,2,4
400915385,Virginia Cavaliers,J. Reuter,3908374,,False,15.0,2,5,2,5,0,0,0,0,1,2,3,1,1,1,1,1,4
400915385,Virginia Cavaliers,T. Jerome,4065733,,False,23.0,2,4,2,4,0,0,1,2,0,2,2,5,3,0,1,2,5
400915385,Virginia Cavaliers,K. Guy,4065730,,False,25.0,3,5,2,3,1,2,1,3,0,4,4,1,0,0,0,1,8
400915385,Virginia Cavaliers,T. Gross Jr.,4065729,,False,1.0,0,0,0,0,0,0,0,0,0,0,0,0,0,0,0,0,0
400915385,Virginia Cavaliers,J. Bartley,3947155,,False,1.0,0,0,0,0,0,0,0,0,0,0,0,0,0,0,0,0,0
400915385,Virginia Cavaliers,D. Thompson,66274,,False,20.0,4,7,2,3,2,4,2,2,0,0,0,4,2,0,0,0,12
400915385,Virginia Cavaliers,TEAM,TOTAL,TOTAL,False,,27,52,22,42,5,10,12,20,3,24,27,22,12,3,5,12,71
400915385,Boston College Eagles,A.J. Turner,3943608,,True,30.0,1,6,0,1,1,5,0,0,1,1,2,0,3,0,0,2,3
400915385,Boston College Eagles,M. Jeffers,61901,,True,17.0,0,2,0,2,0,0,1,2,1,4,5,0,0,1,0,0,1
400915385,Boston College Eagles,C. Tava,61446,,True,33.0,3,9,2,5,1,4,5,5,2,9,11,3,0,2,5,1,12
400915385,Boston College Eagles,K. Bowman,4065635,,True,33.0,3,6,2,2,1,4,0,0,1,5,6,5,1,0,4,1,7
400915385,Boston College Eagles,J. Robinson,3943606,,True,31.0,4,14,4,11,0,3,1,2,0,1,1,0,0,0,4,4,9
400915385,Boston College Eagles,J. Reyes,3943609,,False,1.0,0,1,0,1,0,0,0,0,0,0,0,0,0,0,0,0,0
400915385,Boston College Eagles,M. Sagay,4065638,,False,1.0,0,0,0,0,0,0,0,0,0,0,0,0,0,0,1,0,0
400915385,Boston College Eagles,N. Popovic,4065637,,False,19.0,3,5,3,5,0,0,0,0,3,5,8,1,0,1,1,4,6
400915385,Boston College Eagles,G. Owens,66277,,False,2.0,0,0,0,0,0,0,0,0,0,0,0,0,0,0,1,0,0
400915385,Boston College Eagles,J. Chatman,3135095,,False,33.0,6,9,4,5,2,4,2,2,0,1,1,0,0,0,0,2,16
400915385,Boston College Eagles,TEAM,TOTAL,TOTAL,False,,20,52,15,32,5,20,9,11,9,27,36,9,4,4,16,14,54
400915385,Boston College Eagles,A.J. Turner,3943608,,True,30.0,1,6,0,1,1,5,0,0,1,1,2,0,3,0,0,2,3
400915385,Boston College Eagles,M. Jeffers,61901,,True,17.0,0,2,0,2,0,0,1,2,1,4,5,0,0,1,0,0,1
400915385,Boston College Eagles,C. Tava,61446,,True,33.0,3,9,2,5,1,4,5,5,2,9,11,3,0,2,5,1,12
400915385,Boston College Eagles,K. Bowman,4065635,,True,33.0,3,6,2,2,1,4,0,0,1,5,6,5,1,0,4,1,7
400915385,Boston College Eagles,J. Robinson,3943606,,True,31.0,4,14,4,11,0,3,1,2,0,1,1,0,0,0,4,4,9
400915385,Boston College Eagles,J. Reyes,3943609,,False,1.0,0,1,0,1,0,0,0,0,0,0,0,0,0,0,0,0,0
400915385,Boston College Eagles,M. Sagay,4065638,,False,1.0,0,0,0,0,0,0,0,0,0,0,0,0,0,0,1,0,0
400915385,Boston College Eagles,N. Popovic,4065637,,False,19.0,3,5,3,5,0,0,0,0,3,5,8,1,0,1,1,4,6
400915385,Boston College Eagles,G. Owens,66277,,False,2.0,0,0,0,0,0,0,0,0,0,0,0,0,0,0,1,0,0
400915385,Boston College Eagles,J. Chatman,3135095,,False,33.0,6,9,4,5,2,4,2,2,0,1,1,0,0,0,0,2,16
400915385,Boston College Eagles,TEAM,TOTAL,TOTAL,False,,20,52,15,32,5,20,9,11,9,27,36,9,4,4,16,14,54
400915384,Notre Dame Fighting Irish,B. Colson,3138192,,True,34.0,3,8,3,8,0,0,3,5,2,6,8,2,1,0,1,3,9
400915384,Notre Dame Fighting Irish,M. Geben,3138191,,True,15.0,1,1,1,1,0,0,2,2,0,2,2,2,0,0,0,0,4
400915384,Notre Dame Fighting Irish,V.J. Beachem,66283,,True,31.0,5,11,1,6,4,5,0,0,1,3,4,2,0,0,3,2,14
400915384,Notre Dame Fighting Irish,M. Farrell,3138190,,True,37.0,6,13,3,9,3,4,2,2,0,0,0,7,1,0,6,2,17
400915384,Notre Dame Fighting Irish,S. Vasturia,66285,,True,33.0,6,15,2,9,4,6,2,2,0,3,3,1,1,1,4,2,18
400915384,Notre Dame Fighting Irish,A. Torres,66286,,False,13.0,0,0,0,0,0,0,0,0,0,3,3,0,0,1,0,4,0
400915384,Notre Dame Fighting Irish,M. Ryan,3908336,,False,2.0,1,1,0,0,1,1,0,0,0,0,0,0,0,0,0,1,3
400915384,Notre Dame Fighting Irish,T. Gibbs,4065703,,False,25.0,4,5,2,3,2,2,2,4,0,1,1,1,1,0,2,3,12
400915384,Notre Dame Fighting Irish,R. Pflueger,3908335,,False,10.0,1,4,0,1,1,3,0,0,1,1,2,3,2,0,1,3,3
400915384,Notre Dame Fighting Irish,TEAM,TOTAL,TOTAL,False,,27,58,12,37,15,21,11,15,8,21,29,18,6,2,18,21,80
400915384,Notre Dame Fighting Irish,B. Colson,3138192,,True,34.0,3,8,3,8,0,0,3,5,2,6,8,2,1,0,1,3,9
400915384,Notre Dame Fighting Irish,M. Geben,3138191,,True,15.0,1,1,1,1,0,0,2,2,0,2,2,2,0,0,0,0,4
400915384,Notre Dame Fighting Irish,V.J. Beachem,66283,,True,31.0,5,11,1,6,4,5,0,0,1,3,4,2,0,0,3,2,14
400915384,Notre Dame Fighting Irish,M. Farrell,3138190,,True,37.0,6,13,3,9,3,4,2,2,0,0,0,7,1,0,6,2,17
400915384,Notre Dame Fighting Irish,S. Vasturia,66285,,True,33.0,6,15,2,9,4,6,2,2,0,3,3,1,1,1,4,2,18
400915384,Notre Dame Fighting Irish,A. Torres,66286,,False,13.0,0,0,0,0,0,0,0,0,0,3,3,0,0,1,0,4,0
400915384,Notre Dame Fighting Irish,M. Ryan,3908336,,False,2.0,1,1,0,0,1,1,0,0,0,0,0,0,0,0,0,1,3
400915384,Notre Dame Fighting Irish,T. Gibbs,4065703,,False,25.0,4,5,2,3,2,2,2,4,0,1,1,1,1,0,2,3,12
400915384,Notre Dame Fighting Irish,R. Pflueger,3908335,,False,10.0,1,4,0,1,1,3,0,0,1,1,2,3,2,0,1,3,3
400915384,Notre Dame Fighting Irish,TEAM,TOTAL,TOTAL,False,,27,58,12,37,15,21,11,15,8,21,29,18,6,2,18,21,80
400915384,Florida State Seminoles,J. Isaac,4065654,,True,25.0,7,9,5,7,2,2,7,7,3,7,10,1,1,7,5,1,23
400915384,Florida State Seminoles,M. Ojo,61596,,True,8.0,1,2,1,2,0,0,0,0,1,0,1,0,0,1,3,2,2
400915384,Florida State Seminoles,T. Mann,3907823,,True,21.0,0,2,0,2,0,0,0,0,0,0,0,2,4,1,1,0,0
400915384,Florida State Seminoles,D. Bacon,3907821,,True,31.0,5,13,4,10,1,3,0,3,0,4,4,2,1,0,3,5,11
400915384,Florida State Seminoles,X. Rathan-Mayes,66125,,True,29.0,4,7,4,6,0,1,0,0,0,3,3,7,2,0,1,1,8
400915384,Florida State Seminoles,P. Cofer,3135054,,False,7.0,1,2,1,2,0,0,0,0,1,3,4,0,0,0,0,0,2
400915384,Florida State Seminoles,J. Smith,66126,,False,21.0,3,6,3,5,0,1,4,7,4,1,5,1,0,1,0,3,10
400915384,Florida State Seminoles,B. Allen,66124,,False,6.0,0,1,0,0,0,1,0,0,0,0,0,0,0,0,0,0,0
400915384,Florida State Seminoles,C. Koumadje,3907824,,False,7.0,1,1,1,1,0,0,0,0,0,2,2,0,0,0,1,1,2
400915384,Florida State Seminoles,B. Angola-Rodas,4065658,,False,3.0,0,1,0,0,0,1,0,0,0,0,0,0,0,0,0,0,0
400915384,Florida State Seminoles,P. Savoy,4065657,,False,14.0,3,7,0,1,3,6,3,3,0,1,1,0,0,1,0,2,12
400915384,Florida State Seminoles,T. Forrest,4065656,,False,10.0,2,4,2,4,0,0,0,0,2,0,2,1,0,0,0,2,4
400915384,Florida State Seminoles,C. Walker,4065655,,False,18.0,3,5,2,3,1,2,2,3,0,0,0,1,0,0,2,1,9
400915384,Florida State Seminoles,TEAM,TOTAL,TOTAL,False,,30,60,23,43,7,17,16,23,11,23,34,15,8,11,16,18,83
400915384,Florida State Seminoles,J. Isaac,4065654,,True,25.0,7,9,5,7,2,2,7,7,3,7,10,1,1,7,5,1,23
400915384,Florida State Seminoles,M. Ojo,61596,,True,8.0,1,2,1,2,0,0,0,0,1,0,1,0,0,1,3,2,2
400915384,Florida State Seminoles,T. Mann,3907823,,True,21.0,0,2,0,2,0,0,0,0,0,0,0,2,4,1,1,0,0
400915384,Florida State Seminoles,D. Bacon,3907821,,True,31.0,5,13,4,10,1,3,0,3,0,4,4,2,1,0,3,5,11
400915384,Florida State Seminoles,X. Rathan-Mayes,66125,,True,29.0,4,7,4,6,0,1,0,0,0,3,3,7,2,0,1,1,8
400915384,Florida State Seminoles,P. Cofer,3135054,,False,7.0,1,2,1,2,0,0,0,0,1,3,4,0,0,0,0,0,2
400915384,Florida State Seminoles,J. Smith,66126,,False,21.0,3,6,3,5,0,1,4,7,4,1,5,1,0,1,0,3,10
400915384,Florida State Seminoles,B. Allen,66124,,False,6.0,0,1,0,0,0,1,0,0,0,0,0,0,0,0,0,0,0
400915384,Florida State Seminoles,C. Koumadje,3907824,,False,7.0,1,1,1,1,0,0,0,0,0,2,2,0,0,0,1,1,2
400915384,Florida State Seminoles,B. Angola-Rodas,4065658,,False,3.0,0,1,0,0,0,1,0,0,0,0,0,0,0,0,0,0,0
400915384,Florida State Seminoles,P. Savoy,4065657,,False,14.0,3,7,0,1,3,6,3,3,0,1,1,0,0,1,0,2,12
400915384,Florida State Seminoles,T. Forrest,4065656,,False,10.0,2,4,2,4,0,0,0,0,2,0,2,1,0,0,0,2,4
400915384,Florida State Seminoles,C. Walker,4065655,,False,18.0,3,5,2,3,1,2,2,3,0,0,0,1,0,0,2,1,9
400915384,Florida State Seminoles,TEAM,TOTAL,TOTAL,False,,30,60,23,43,7,17,16,23,11,23,34,15,8,11,16,18,83
400915383,Pittsburgh Panthers,M. Young,66290,,True,37.0,9,19,5,10,4,9,3,5,1,3,4,2,1,2,1,3,25
400915383,Pittsburgh Panthers,J. Artis,66287,,True,34.0,5,15,4,9,1,6,5,6,1,2,3,5,2,0,2,1,16
400915383,Pittsburgh Panthers,S. Jeter,61756,,True,38.0,3,4,1,1,2,3,0,0,1,10,11,1,0,2,3,4,8
400915383,Pittsburgh Panthers,C. Johnson,3138196,,True,36.0,5,11,0,1,5,10,2,2,0,4,4,2,2,0,3,3,17
400915383,Pittsburgh Panthers,C. Jones,61219,,True,37.0,3,4,3,4,0,0,2,3,2,3,5,2,2,0,1,3,8
400915383,Pittsburgh Panthers,C. Manigault,4065714,,False,3.0,0,0,0,0,0,0,0,1,0,0,0,0,0,0,0,0,0
400915383,Pittsburgh Panthers,J. Kithcart,4065713,,False,11.0,0,1,0,1,0,0,0,0,0,0,0,1,0,0,1,4,0
400915383,Pittsburgh Panthers,D. Wilson,3934652,,False,4.0,0,0,0,0,0,0,0,0,0,0,0,1,0,0,0,0,0
400915383,Pittsburgh Panthers,TEAM,TOTAL,TOTAL,False,,25,54,13,26,12,28,12,17,6,24,30,14,7,4,12,18,74
400915383,Pittsburgh Panthers,M. Young,66290,,True,37.0,9,19,5,10,4,9,3,5,1,3,4,2,1,2,1,3,25
400915383,Pittsburgh Panthers,J. Artis,66287,,True,34.0,5,15,4,9,1,6,5,6,1,2,3,5,2,0,2,1,16
400915383,Pittsburgh Panthers,S. Jeter,61756,,True,38.0,3,4,1,1,2,3,0,0,1,10,11,1,0,2,3,4,8
400915383,Pittsburgh Panthers,C. Johnson,3138196,,True,36.0,5,11,0,1,5,10,2,2,0,4,4,2,2,0,3,3,17
400915383,Pittsburgh Panthers,C. Jones,61219,,True,37.0,3,4,3,4,0,0,2,3,2,3,5,2,2,0,1,3,8
400915383,Pittsburgh Panthers,C. Manigault,4065714,,False,3.0,0,0,0,0,0,0,0,1,0,0,0,0,0,0,0,0,0
400915383,Pittsburgh Panthers,J. Kithcart,4065713,,False,11.0,0,1,0,1,0,0,0,0,0,0,0,1,0,0,1,4,0
400915383,Pittsburgh Panthers,D. Wilson,3934652,,False,4.0,0,0,0,0,0,0,0,0,0,0,0,1,0,0,0,0,0
400915383,Pittsburgh Panthers,TEAM,TOTAL,TOTAL,False,,25,54,13,26,12,28,12,17,6,24,30,14,7,4,12,18,74
400915383,NC State Wolfpack,A. Abu,3138158,,True,13.0,1,3,1,3,0,0,0,0,1,2,3,0,0,0,1,4,2
400915383,NC State Wolfpack,O. Yurtseven,66768,,True,27.0,5,10,5,10,0,0,2,2,8,8,16,1,0,0,3,4,12
400915383,NC State Wolfpack,D. Smith Jr.,4065697,,True,39.0,4,13,3,6,1,7,2,2,0,3,3,6,2,0,2,2,11
400915383,NC State Wolfpack,M. Rowan,3947151,,True,31.0,7,13,1,4,6,9,1,2,1,4,5,2,0,0,4,1,21
400915383,NC State Wolfpack,T. Henderson,61215,,True,38.0,7,17,3,7,4,10,3,4,2,6,8,4,0,0,1,3,21
400915383,NC State Wolfpack,D. Hicks,4065698,,False,2.0,0,0,0,0,0,0,0,0,0,0,0,0,0,0,0,0,0
400915383,NC State Wolfpack,B. Anya,66134,,False,8.0,0,1,0,1,0,0,0,0,0,1,1,0,0,1,0,2,0
400915383,NC State Wolfpack,M. Johnson,4065699,,False,33.0,4,9,4,8,0,1,0,0,3,0,3,7,1,0,2,2,8
400915383,NC State Wolfpack,T. Dorn,3132359,,False,9.0,1,3,1,3,0,0,2,5,0,2,2,0,0,0,0,1,4
400915383,NC State Wolfpack,TEAM,TOTAL,TOTAL,False,,29,69,18,42,11,27,10,15,18,26,44,20,3,1,13,19,79
400915383,NC State Wolfpack,A. Abu,3138158,,True,13.0,1,3,1,3,0,0,0,0,1,2,3,0,0,0,1,4,2
400915383,NC State Wolfpack,O. Yurtseven,66768,,True,27.0,5,10,5,10,0,0,2,2,8,8,16,1,0,0,3,4,12
400915383,NC State Wolfpack,D. Smith Jr.,4065697,,True,39.0,4,13,3,6,1,7,2,2,0,3,3,6,2,0,2,2,11
400915383,NC State Wolfpack,M. Rowan,3947151,,True,31.0,7,13,1,4,6,9,1,2,1,4,5,2,0,0,4,1,21
400915383,NC State Wolfpack,T. Henderson,61215,,True,38.0,7,17,3,7,4,10,3,4,2,6,8,4,0,0,1,3,21
400915383,NC State Wolfpack,D. Hicks,4065698,,False,2.0,0,0,0,0,0,0,0,0,0,0,0,0,0,0,0,0,0
400915383,NC State Wolfpack,B. Anya,66134,,False,8.0,0,1,0,1,0,0,0,0,0,1,1,0,0,1,0,2,0
400915383,NC State Wolfpack,M. Johnson,4065699,,False,33.0,4,9,4,8,0,1,0,0,3,0,3,7,1,0,2,2,8
400915383,NC State Wolfpack,T. Dorn,3132359,,False,9.0,1,3,1,3,0,0,2,5,0,2,2,0,0,0,0,1,4
400915383,NC State Wolfpack,TEAM,TOTAL,TOTAL,False,,29,69,18,42,11,27,10,15,18,26,44,20,3,1,13,19,79
400915382,Syracuse Orange,T. Thompson,4065721,,True,12.0,2,5,2,5,0,0,0,0,0,2,2,2,1,0,1,2,4
400915382,Syracuse Orange,T. Lydon,3934662,,True,39.0,11,14,8,9,3,5,1,1,1,6,7,1,1,1,3,2,26
400915382,Syracuse Orange,A. White III,61616,,True,39.0,5,13,0,4,5,9,0,0,0,2,2,1,0,2,3,4,15
400915382,Syracuse Orange,T. Battle,4065722,,True,39.0,4,11,3,6,1,5,4,4,0,3,3,2,4,1,1,1,13
400915382,Syracuse Orange,J. Gillon,61915,,True,38.0,1,7,0,4,1,3,1,2,0,0,0,6,2,0,2,1,4
400915382,Syracuse Orange,D. Akintobi-Adeyeye,3155403,,False,1.0,0,0,0,0,0,0,0,0,0,0,0,0,0,0,0,1,0
400915382,Syracuse Orange,T. Roberson,67633,,False,27.0,3,7,3,7,0,0,0,0,5,3,8,2,0,0,2,2,6
400915382,Syracuse Orange,K. Feldman,3934665,,False,1.0,0,1,0,0,0,1,0,0,0,0,0,0,0,0,0,0,0
400915382,Syracuse Orange,A. Autry,3934661,,False,1.0,0,0,0,0,0,0,0,0,0,0,0,0,0,0,0,0,0
400915382,Syracuse Orange,S. Belbey,3934660,,False,1.0,0,1,0,0,0,1,0,0,0,0,0,0,0,0,0,0,0
400915382,Syracuse Orange,F. Howard,3934659,,False,1.0,0,0,0,0,0,0,0,0,0,0,0,0,0,0,1,0,0
400915382,Syracuse Orange,M. Sutton,3153164,,False,1.0,0,0,0,0,0,0,0,0,0,1,1,0,0,0,0,0,0
400915382,Syracuse Orange,TEAM,TOTAL,TOTAL,False,,26,59,16,35,10,24,6,7,6,18,24,14,8,4,13,13,68
400915382,Syracuse Orange,T. Thompson,4065721,,True,12.0,2,5,2,5,0,0,0,0,0,2,2,2,1,0,1,2,4
400915382,Syracuse Orange,T. Lydon,3934662,,True,39.0,11,14,8,9,3,5,1,1,1,6,7,1,1,1,3,2,26
400915382,Syracuse Orange,A. White III,61616,,True,39.0,5,13,0,4,5,9,0,0,0,2,2,1,0,2,3,4,15
400915382,Syracuse Orange,T. Battle,4065722,,True,39.0,4,11,3,6,1,5,4,4,0,3,3,2,4,1,1,1,13
400915382,Syracuse Orange,J. Gillon,61915,,True,38.0,1,7,0,4,1,3,1,2,0,0,0,6,2,0,2,1,4
400915382,Syracuse Orange,D. Akintobi-Adeyeye,3155403,,False,1.0,0,0,0,0,0,0,0,0,0,0,0,0,0,0,0,1,0
400915382,Syracuse Orange,T. Roberson,67633,,False,27.0,3,7,3,7,0,0,0,0,5,3,8,2,0,0,2,2,6
400915382,Syracuse Orange,K. Feldman,3934665,,False,1.0,0,1,0,0,0,1,0,0,0,0,0,0,0,0,0,0,0
400915382,Syracuse Orange,A. Autry,3934661,,False,1.0,0,0,0,0,0,0,0,0,0,0,0,0,0,0,0,0,0
400915382,Syracuse Orange,S. Belbey,3934660,,False,1.0,0,1,0,0,0,1,0,0,0,0,0,0,0,0,0,0,0
400915382,Syracuse Orange,F. Howard,3934659,,False,1.0,0,0,0,0,0,0,0,0,0,0,0,0,0,0,1,0,0
400915382,Syracuse Orange,M. Sutton,3153164,,False,1.0,0,0,0,0,0,0,0,0,0,1,1,0,0,0,0,0,0
400915382,Syracuse Orange,TEAM,TOTAL,TOTAL,False,,26,59,16,35,10,24,6,7,6,18,24,14,8,4,13,13,68
400915382,North Carolina Tar Heels,J. Jackson,3138156,,True,33.0,8,19,6,11,2,8,1,1,5,5,10,4,0,1,2,1,19
400915382,North Carolina Tar Heels,I. Hicks,66874,,True,30.0,8,13,8,13,0,0,4,4,2,6,8,1,0,1,2,0,20
400915382,North Carolina Tar Heels,K. Meeks,66873,,True,32.0,7,10,7,10,0,0,1,2,6,6,12,1,2,0,3,2,15
400915382,North Carolina Tar Heels,K. Williams,3911619,,True,27.0,2,7,0,1,2,6,0,0,0,1,1,4,2,0,0,1,6
400915382,North Carolina Tar Heels,J. Berry II,3138155,,True,31.0,4,7,2,2,2,5,0,0,0,1,1,1,1,0,2,2,10
400915382,North Carolina Tar Heels,A. Rohlman,4065677,,False,1.0,0,0,0,0,0,0,0,0,0,1,1,0,0,0,0,0,0
400915382,North Carolina Tar Heels,S. Rush,4065674,,False,1.0,0,0,0,0,0,0,0,0,0,0,0,0,0,0,0,0,0
400915382,North Carolina Tar Heels,L. Maye,3911620,,False,13.0,4,5,4,5,0,0,0,2,0,0,0,2,0,0,0,2,8
400915382,North Carolina Tar Heels,T. Pinson,3138154,,False,14.0,2,4,1,1,1,3,2,4,3,2,5,5,0,0,0,3,7
400915382,North Carolina Tar Heels,S. Woods,4065676,,False,3.0,0,2,0,1,0,1,0,2,0,3,3,1,0,0,0,1,0
400915382,North Carolina Tar Heels,B. Robinson,4065675,,False,1.0,0,0,0,0,0,0,0,0,0,0,0,0,0,0,0,1,0
400915382,North Carolina Tar Heels,K. Coker,3947144,,False,1.0,0,0,0,0,0,0,0,0,0,0,0,0,0,0,0,0,0
400915382,North Carolina Tar Heels,N. Britt,66872,,False,12.0,0,1,0,0,0,1,0,0,0,0,0,3,1,0,0,0,0
400915382,North Carolina Tar Heels,S. White,56963,,False,1.0,0,0,0,0,0,0,0,0,0,0,0,0,0,0,0,0,0
400915382,North Carolina Tar Heels,TEAM,TOTAL,TOTAL,False,,35,68,28,44,7,24,8,15,18,26,44,22,6,2,9,13,85
400915382,North Carolina Tar Heels,J. Jackson,3138156,,True,33.0,8,19,6,11,2,8,1,1,5,5,10,4,0,1,2,1,19
400915382,North Carolina Tar Heels,I. Hicks,66874,,True,30.0,8,13,8,13,0,0,4,4,2,6,8,1,0,1,2,0,20
400915382,North Carolina Tar Heels,K. Meeks,66873,,True,32.0,7,10,7,10,0,0,1,2,6,6,12,1,2,0,3,2,15
400915382,North Carolina Tar Heels,K. Williams,3911619,,True,27.0,2,7,0,1,2,6,0,0,0,1,1,4,2,0,0,1,6
400915382,North Carolina Tar Heels,J. Berry II,3138155,,True,31.0,4,7,2,2,2,5,0,0,0,1,1,1,1,0,2,2,10
400915382,North Carolina Tar Heels,A. Rohlman,4065677,,False,1.0,0,0,0,0,0,0,0,0,0,1,1,0,0,0,0,0,0
400915382,North Carolina Tar Heels,S. Rush,4065674,,False,1.0,0,0,0,0,0,0,0,0,0,0,0,0,0,0,0,0,0
400915382,North Carolina Tar Heels,L. Maye,3911620,,False,13.0,4,5,4,5,0,0,0,2,0,0,0,2,0,0,0,2,8
400915382,North Carolina Tar Heels,T. Pinson,3138154,,False,14.0,2,4,1,1,1,3,2,4,3,2,5,5,0,0,0,3,7
400915382,North Carolina Tar Heels,S. Woods,4065676,,False,3.0,0,2,0,1,0,1,0,2,0,3,3,1,0,0,0,1,0
400915382,North Carolina Tar Heels,B. Robinson,4065675,,False,1.0,0,0,0,0,0,0,0,0,0,0,0,0,0,0,0,1,0
400915382,North Carolina Tar Heels,K. Coker,3947144,,False,1.0,0,0,0,0,0,0,0,0,0,0,0,0,0,0,0,0,0
400915382,North Carolina Tar Heels,N. Britt,66872,,False,12.0,0,1,0,0,0,1,0,0,0,0,0,3,1,0,0,0,0
400915382,North Carolina Tar Heels,S. White,56963,,False,1.0,0,0,0,0,0,0,0,0,0,0,0,0,0,0,0,0,0
400915382,North Carolina Tar Heels,TEAM,TOTAL,TOTAL,False,,35,68,28,44,7,24,8,15,18,26,44,22,6,2,9,13,85
400915381,NC State Wolfpack,A. Abu,3138158,,True,29.0,3,8,3,8,0,0,1,1,1,2,3,2,0,0,0,3,7
400915381,NC State Wolfpack,O. Yurtseven,66768,,True,16.0,1,4,1,4,0,0,0,0,2,4,6,3,0,1,0,1,2
400915381,NC State Wolfpack,D. Smith Jr.,4065697,,True,38.0,10,21,6,13,4,8,7,10,2,6,8,6,2,2,2,1,31
400915381,NC State Wolfpack,M. Rowan,3947151,,True,34.0,7,16,4,9,3,7,0,0,2,4,6,0,0,0,1,1,17
400915381,NC State Wolfpack,T. Henderson,61215,,True,32.0,2,10,0,2,2,8,0,0,0,1,1,0,1,2,2,0,6
400915381,NC State Wolfpack,T. Kapita,4065701,,False,3.0,0,0,0,0,0,0,0,0,0,0,0,0,0,0,0,0,0
400915381,NC State Wolfpack,B. Anya,66134,,False,17.0,2,4,2,4,0,0,0,2,3,1,4,0,1,0,1,1,4
400915381,NC State Wolfpack,M. Johnson,4065699,,False,15.0,1,2,1,1,0,1,2,2,1,0,1,1,1,0,1,4,4
400915381,NC State Wolfpack,T. Dorn,3132359,,False,16.0,2,4,1,3,1,1,0,0,1,3,4,1,0,0,1,4,5
400915381,NC State Wolfpack,TEAM,TOTAL,TOTAL,False,,28,69,18,44,10,25,10,15,13,22,35,13,5,5,8,15,76
400915381,NC State Wolfpack,A. Abu,3138158,,True,29.0,3,8,3,8,0,0,1,1,1,2,3,2,0,0,0,3,7
400915381,NC State Wolfpack,O. Yurtseven,66768,,True,16.0,1,4,1,4,0,0,0,0,2,4,6,3,0,1,0,1,2
400915381,NC State Wolfpack,D. Smith Jr.,4065697,,True,38.0,10,21,6,13,4,8,7,10,2,6,8,6,2,2,2,1,31
400915381,NC State Wolfpack,M. Rowan,3947151,,True,34.0,7,16,4,9,3,7,0,0,2,4,6,0,0,0,1,1,17
400915381,NC State Wolfpack,T. Henderson,61215,,True,32.0,2,10,0,2,2,8,0,0,0,1,1,0,1,2,2,0,6
400915381,NC State Wolfpack,T. Kapita,4065701,,False,3.0,0,0,0,0,0,0,0,0,0,0,0,0,0,0,0,0,0
400915381,NC State Wolfpack,B. Anya,66134,,False,17.0,2,4,2,4,0,0,0,2,3,1,4,0,1,0,1,1,4
400915381,NC State Wolfpack,M. Johnson,4065699,,False,15.0,1,2,1,1,0,1,2,2,1,0,1,1,1,0,1,4,4
400915381,NC State Wolfpack,T. Dorn,3132359,,False,16.0,2,4,1,3,1,1,0,0,1,3,4,1,0,0,1,4,5
400915381,NC State Wolfpack,TEAM,TOTAL,TOTAL,False,,28,69,18,44,10,25,10,15,13,22,35,13,5,5,8,15,76
400915381,Georgia Tech Yellow Jackets,Q. Stephens,66128,,True,40.0,7,14,3,6,4,8,4,5,2,4,6,5,1,2,3,1,22
400915381,Georgia Tech Yellow Jackets,B. Lammers,3135061,,True,36.0,3,11,3,11,0,0,4,4,2,9,11,2,2,5,1,1,10
400915381,Georgia Tech Yellow Jackets,J. Okogie,4065663,,True,32.0,10,18,7,15,3,3,4,6,0,4,4,1,1,2,0,2,27
400915381,Georgia Tech Yellow Jackets,J. Moore,4065662,,True,13.0,0,1,0,1,0,0,2,2,0,0,0,3,0,0,3,2,2
400915381,Georgia Tech Yellow Jackets,J. Heath,67623,,True,39.0,4,5,2,3,2,2,0,0,2,5,7,10,0,0,4,3,10
400915381,Georgia Tech Yellow Jackets,A. Gueye,3135059,,False,4.0,0,0,0,0,0,0,0,0,1,0,1,1,0,1,0,2,0
400915381,Georgia Tech Yellow Jackets,T. Jackson,3135057,,False,30.0,6,13,5,10,1,3,0,0,1,4,5,2,0,0,0,2,13
400915381,Georgia Tech Yellow Jackets,C. Heyward,61609,,False,6.0,1,1,1,1,0,0,0,0,0,0,0,0,0,0,0,0,2
400915381,Georgia Tech Yellow Jackets,TEAM,TOTAL,TOTAL,False,,31,63,21,47,10,16,14,17,13,29,42,24,4,10,11,13,86
400915381,Georgia Tech Yellow Jackets,Q. Stephens,66128,,True,40.0,7,14,3,6,4,8,4,5,2,4,6,5,1,2,3,1,22
400915381,Georgia Tech Yellow Jackets,B. Lammers,3135061,,True,36.0,3,11,3,11,0,0,4,4,2,9,11,2,2,5,1,1,10
400915381,Georgia Tech Yellow Jackets,J. Okogie,4065663,,True,32.0,10,18,7,15,3,3,4,6,0,4,4,1,1,2,0,2,27
400915381,Georgia Tech Yellow Jackets,J. Moore,4065662,,True,13.0,0,1,0,1,0,0,2,2,0,0,0,3,0,0,3,2,2
400915381,Georgia Tech Yellow Jackets,J. Heath,67623,,True,39.0,4,5,2,3,2,2,0,0,2,5,7,10,0,0,4,3,10
400915381,Georgia Tech Yellow Jackets,A. Gueye,3135059,,False,4.0,0,0,0,0,0,0,0,0,1,0,1,1,0,1,0,2,0
400915381,Georgia Tech Yellow Jackets,T. Jackson,3135057,,False,30.0,6,13,5,10,1,3,0,0,1,4,5,2,0,0,0,2,13
400915381,Georgia Tech Yellow Jackets,C. Heyward,61609,,False,6.0,1,1,1,1,0,0,0,0,0,0,0,0,0,0,0,0,2
400915381,Georgia Tech Yellow Jackets,TEAM,TOTAL,TOTAL,False,,31,63,21,47,10,16,14,17,13,29,42,24,4,10,11,13,86
400915380,Syracuse Orange,T. Thompson,4065721,,True,21.0,5,9,5,8,0,1,0,0,0,3,3,1,1,0,1,0,10
400915380,Syracuse Orange,T. Lydon,3934662,,True,33.0,6,10,6,8,0,2,4,4,3,3,6,1,2,2,2,2,16
400915380,Syracuse Orange,A. White III,61616,,True,34.0,4,11,2,5,2,6,3,4,1,1,2,1,3,0,0,0,13
400915380,Syracuse Orange,T. Battle,4065722,,True,33.0,7,13,4,7,3,6,4,5,0,1,1,2,3,0,1,1,21
400915380,Syracuse Orange,J. Gillon,61915,,True,26.0,1,6,1,3,0,3,2,2,0,3,3,6,1,0,1,2,4
400915380,Syracuse Orange,D. Akintobi-Adeyeye,3155403,,False,2.0,0,0,0,0,0,0,0,0,0,0,0,0,0,0,0,1,0
400915380,Syracuse Orange,T. Roberson,67633,,False,27.0,2,4,2,4,0,0,2,2,2,4,6,1,0,1,0,4,6
400915380,Syracuse Orange,K. Feldman,3934665,,False,2.0,1,1,1,1,0,0,0,0,0,0,0,0,0,0,0,0,2
400915380,Syracuse Orange,A. Autry,3934661,,False,2.0,0,1,0,1,0,0,0,0,0,2,2,0,0,0,0,0,0
400915380,Syracuse Orange,S. Belbey,3934660,,False,2.0,0,0,0,0,0,0,0,0,0,0,0,0,0,0,0,0,0
400915380,Syracuse Orange,F. Howard,3934659,,False,16.0,1,2,1,1,0,1,2,2,0,2,2,3,1,0,1,0,4
400915380,Syracuse Orange,M. Sutton,3153164,,False,2.0,0,1,0,0,0,1,0,0,0,0,0,0,0,0,0,0,0
400915380,Syracuse Orange,TEAM,TOTAL,TOTAL,False,,27,58,22,38,5,20,17,19,10,19,29,15,11,3,6,10,76
400915380,Syracuse Orange,T. Thompson,4065721,,True,21.0,5,9,5,8,0,1,0,0,0,3,3,1,1,0,1,0,10
400915380,Syracuse Orange,T. Lydon,3934662,,True,33.0,6,10,6,8,0,2,4,4,3,3,6,1,2,2,2,2,16
400915380,Syracuse Orange,A. White III,61616,,True,34.0,4,11,2,5,2,6,3,4,1,1,2,1,3,0,0,0,13
400915380,Syracuse Orange,T. Battle,4065722,,True,33.0,7,13,4,7,3,6,4,5,0,1,1,2,3,0,1,1,21
400915380,Syracuse Orange,J. Gillon,61915,,True,26.0,1,6,1,3,0,3,2,2,0,3,3,6,1,0,1,2,4
400915380,Syracuse Orange,D. Akintobi-Adeyeye,3155403,,False,2.0,0,0,0,0,0,0,0,0,0,0,0,0,0,0,0,1,0
400915380,Syracuse Orange,T. Roberson,67633,,False,27.0,2,4,2,4,0,0,2,2,2,4,6,1,0,1,0,4,6
400915380,Syracuse Orange,K. Feldman,3934665,,False,2.0,1,1,1,1,0,0,0,0,0,0,0,0,0,0,0,0,2
400915380,Syracuse Orange,A. Autry,3934661,,False,2.0,0,1,0,1,0,0,0,0,0,2,2,0,0,0,0,0,0
400915380,Syracuse Orange,S. Belbey,3934660,,False,2.0,0,0,0,0,0,0,0,0,0,0,0,0,0,0,0,0,0
400915380,Syracuse Orange,F. Howard,3934659,,False,16.0,1,2,1,1,0,1,2,2,0,2,2,3,1,0,1,0,4
400915380,Syracuse Orange,M. Sutton,3153164,,False,2.0,0,1,0,0,0,1,0,0,0,0,0,0,0,0,0,0,0
400915380,Syracuse Orange,TEAM,TOTAL,TOTAL,False,,27,58,22,38,5,20,17,19,10,19,29,15,11,3,6,10,76
400915380,Boston College Eagles,A.J. Turner,3943608,,True,30.0,2,3,0,0,2,3,0,0,1,2,3,0,0,0,1,3,6
400915380,Boston College Eagles,M. Jeffers,61901,,True,13.0,2,7,2,7,0,0,1,1,3,1,4,0,0,0,3,2,5
400915380,Boston College Eagles,C. Tava,61446,,True,33.0,3,3,2,2,1,1,0,0,1,7,8,2,0,0,5,3,7
400915380,Boston College Eagles,K. Bowman,4065635,,True,28.0,1,9,0,3,1,6,0,0,1,6,7,1,0,0,6,2,3
400915380,Boston College Eagles,J. Robinson,3943606,,True,36.0,3,11,2,6,1,5,2,2,1,2,3,5,2,0,3,3,9
400915380,Boston College Eagles,J. Reyes,3943609,,False,2.0,1,1,1,1,0,0,0,1,0,0,0,0,0,0,0,0,2
400915380,Boston College Eagles,M. Sagay,4065638,,False,2.0,0,1,0,1,0,0,0,0,0,0,0,0,0,0,0,0,0
400915380,Boston College Eagles,N. Popovic,4065637,,False,27.0,5,8,4,6,1,2,2,4,5,2,7,1,0,0,1,1,13
400915380,Boston College Eagles,G. Owens,66277,,False,4.0,0,0,0,0,0,0,0,0,0,2,2,0,0,1,1,2,0
400915380,Boston College Eagles,J. Chatman,3135095,,False,25.0,2,5,0,0,2,5,2,3,0,1,1,2,0,0,0,2,8
400915380,Boston College Eagles,TEAM,TOTAL,TOTAL,False,,19,48,11,26,8,22,7,11,12,23,35,11,2,1,20,18,53
400915380,Boston College Eagles,A.J. Turner,3943608,,True,30.0,2,3,0,0,2,3,0,0,1,2,3,0,0,0,1,3,6
400915380,Boston College Eagles,M. Jeffers,61901,,True,13.0,2,7,2,7,0,0,1,1,3,1,4,0,0,0,3,2,5
400915380,Boston College Eagles,C. Tava,61446,,True,33.0,3,3,2,2,1,1,0,0,1,7,8,2,0,0,5,3,7
400915380,Boston College Eagles,K. Bowman,4065635,,True,28.0,1,9,0,3,1,6,0,0,1,6,7,1,0,0,6,2,3
400915380,Boston College Eagles,J. Robinson,3943606,,True,36.0,3,11,2,6,1,5,2,2,1,2,3,5,2,0,3,3,9
400915380,Boston College Eagles,J. Reyes,3943609,,False,2.0,1,1,1,1,0,0,0,1,0,0,0,0,0,0,0,0,2
400915380,Boston College Eagles,M. Sagay,4065638,,False,2.0,0,1,0,1,0,0,0,0,0,0,0,0,0,0,0,0,0
400915380,Boston College Eagles,N. Popovic,4065637,,False,27.0,5,8,4,6,1,2,2,4,5,2,7,1,0,0,1,1,13
400915380,Boston College Eagles,G. Owens,66277,,False,4.0,0,0,0,0,0,0,0,0,0,2,2,0,0,1,1,2,0
400915380,Boston College Eagles,J. Chatman,3135095,,False,25.0,2,5,0,0,2,5,2,3,0,1,1,2,0,0,0,2,8
400915380,Boston College Eagles,TEAM,TOTAL,TOTAL,False,,19,48,11,26,8,22,7,11,12,23,35,11,2,1,20,18,53
400915379,Virginia Tech Hokies,Z. LeDay,61698,,True,31.0,5,11,5,10,0,1,0,0,3,5,8,2,1,1,3,3,10
400915379,Virginia Tech Hokies,C. Clarke,3945567,,True,38.0,7,11,7,11,0,0,7,12,4,5,9,5,2,2,1,1,21
400915379,Virginia Tech Hokies,J. Robinson,3945566,,True,29.0,5,9,3,3,2,6,2,2,0,3,3,3,0,0,3,2,14
400915379,Virginia Tech Hokies,A. Hill,3147501,,True,28.0,1,5,1,3,0,2,0,0,0,4,4,0,0,0,1,4,2
400915379,Virginia Tech Hokies,J. Bibbs,3147500,,True,34.0,2,8,2,5,0,3,0,1,1,1,2,1,1,0,1,1,4
400915379,Virginia Tech Hokies,K. Sy,4065740,,False,9.0,2,3,2,3,0,0,0,0,0,1,1,0,0,1,1,3,4
400915379,Virginia Tech Hokies,T. Outlaw,67275,,False,2.0,0,0,0,0,0,0,0,0,0,1,1,0,0,0,1,0,0
400915379,Virginia Tech Hokies,S. Allen,61795,,False,29.0,6,10,3,4,3,6,1,3,0,1,1,1,0,0,2,4,16
400915379,Virginia Tech Hokies,TEAM,TOTAL,TOTAL,False,,28,57,23,39,5,18,10,18,9,23,32,12,4,4,13,18,71
400915379,Virginia Tech Hokies,Z. LeDay,61698,,True,31.0,5,11,5,10,0,1,0,0,3,5,8,2,1,1,3,3,10
400915379,Virginia Tech Hokies,C. Clarke,3945567,,True,38.0,7,11,7,11,0,0,7,12,4,5,9,5,2,2,1,1,21
400915379,Virginia Tech Hokies,J. Robinson,3945566,,True,29.0,5,9,3,3,2,6,2,2,0,3,3,3,0,0,3,2,14
400915379,Virginia Tech Hokies,A. Hill,3147501,,True,28.0,1,5,1,3,0,2,0,0,0,4,4,0,0,0,1,4,2
400915379,Virginia Tech Hokies,J. Bibbs,3147500,,True,34.0,2,8,2,5,0,3,0,1,1,1,2,1,1,0,1,1,4
400915379,Virginia Tech Hokies,K. Sy,4065740,,False,9.0,2,3,2,3,0,0,0,0,0,1,1,0,0,1,1,3,4
400915379,Virginia Tech Hokies,T. Outlaw,67275,,False,2.0,0,0,0,0,0,0,0,0,0,1,1,0,0,0,1,0,0
400915379,Virginia Tech Hokies,S. Allen,61795,,False,29.0,6,10,3,4,3,6,1,3,0,1,1,1,0,0,2,4,16
400915379,Virginia Tech Hokies,TEAM,TOTAL,TOTAL,False,,28,57,23,39,5,18,10,18,9,23,32,12,4,4,13,18,71
400915379,Notre Dame Fighting Irish,B. Colson,3138192,,True,31.0,4,7,4,7,0,0,6,9,3,9,12,1,1,2,3,3,14
400915379,Notre Dame Fighting Irish,M. Geben,3138191,,True,13.0,0,0,0,0,0,0,0,0,1,2,3,1,1,0,2,2,0
400915379,Notre Dame Fighting Irish,V.J. Beachem,66283,,True,34.0,2,8,2,4,0,4,0,0,0,3,3,0,0,2,0,1,4
400915379,Notre Dame Fighting Irish,M. Farrell,3138190,,True,35.0,5,11,4,7,1,4,3,5,1,0,1,5,3,0,3,2,14
400915379,Notre Dame Fighting Irish,S. Vasturia,66285,,True,36.0,8,14,5,10,3,4,1,2,1,3,4,4,1,0,2,3,20
400915379,Notre Dame Fighting Irish,A. Torres,66286,,False,9.0,2,2,2,2,0,0,0,0,0,3,3,0,0,0,0,1,4
400915379,Notre Dame Fighting Irish,M. Ryan,3908336,,False,4.0,0,0,0,0,0,0,0,0,0,1,1,0,0,0,0,0,0
400915379,Notre Dame Fighting Irish,T. Gibbs,4065703,,False,17.0,5,7,4,5,1,2,2,2,0,3,3,1,1,0,2,2,13
400915379,Notre Dame Fighting Irish,R. Pflueger,3908335,,False,21.0,2,5,0,1,2,4,1,2,0,0,0,2,1,0,1,2,7
400915379,Notre Dame Fighting Irish,TEAM,TOTAL,TOTAL,False,,28,54,21,36,7,18,13,20,7,24,31,14,8,4,13,16,76
400915379,Notre Dame Fighting Irish,B. Colson,3138192,,True,31.0,4,7,4,7,0,0,6,9,3,9,12,1,1,2,3,3,14
400915379,Notre Dame Fighting Irish,M. Geben,3138191,,True,13.0,0,0,0,0,0,0,0,0,1,2,3,1,1,0,2,2,0
400915379,Notre Dame Fighting Irish,V.J. Beachem,66283,,True,34.0,2,8,2,4,0,4,0,0,0,3,3,0,0,2,0,1,4
400915379,Notre Dame Fighting Irish,M. Farrell,3138190,,True,35.0,5,11,4,7,1,4,3,5,1,0,1,5,3,0,3,2,14
400915379,Notre Dame Fighting Irish,S. Vasturia,66285,,True,36.0,8,14,5,10,3,4,1,2,1,3,4,4,1,0,2,3,20
400915379,Notre Dame Fighting Irish,A. Torres,66286,,False,9.0,2,2,2,2,0,0,0,0,0,3,3,0,0,0,0,1,4
400915379,Notre Dame Fighting Irish,M. Ryan,3908336,,False,4.0,0,0,0,0,0,0,0,0,0,1,1,0,0,0,0,0,0
400915379,Notre Dame Fighting Irish,T. Gibbs,4065703,,False,17.0,5,7,4,5,1,2,2,2,0,3,3,1,1,0,2,2,13
400915379,Notre Dame Fighting Irish,R. Pflueger,3908335,,False,21.0,2,5,0,1,2,4,1,2,0,0,0,2,1,0,1,2,7
400915379,Notre Dame Fighting Irish,TEAM,TOTAL,TOTAL,False,,28,54,21,36,7,18,13,20,7,24,31,14,8,4,13,16,76
400915378,North Carolina Tar Heels,J. Jackson,3138156,,True,29.0,9,17,6,12,3,5,1,2,2,2,4,0,1,0,1,4,22
400915378,North Carolina Tar Heels,I. Hicks,66874,,True,22.0,5,7,5,7,0,0,12,14,4,3,7,3,0,0,3,3,22
400915378,North Carolina Tar Heels,K. Meeks,66873,,True,13.0,3,7,3,7,0,0,0,0,4,2,6,0,1,0,1,4,6
400915378,North Carolina Tar Heels,K. Williams,3911619,,True,30.0,1,7,0,3,1,4,1,4,2,4,6,1,2,0,0,1,4
400915378,North Carolina Tar Heels,J. Berry II,3138155,,True,35.0,8,19,5,13,3,6,7,8,0,2,2,1,2,0,2,3,26
400915378,North Carolina Tar Heels,A. Rohlman,4065677,,False,1.0,0,0,0,0,0,0,0,0,0,0,0,0,0,0,0,0,0
400915378,North Carolina Tar Heels,S. Rush,4065674,,False,1.0,0,0,0,0,0,0,0,0,0,0,0,0,0,0,0,0,0
400915378,North Carolina Tar Heels,L. Maye,3911620,,False,25.0,1,6,1,5,0,1,0,0,5,10,15,2,0,0,4,3,2
400915378,North Carolina Tar Heels,T. Pinson,3138154,,False,24.0,3,5,2,3,1,2,5,6,2,8,10,3,1,0,1,1,12
400915378,North Carolina Tar Heels,S. Woods,4065676,,False,3.0,0,2,0,2,0,0,0,1,0,0,0,0,0,0,0,0,0
400915378,North Carolina Tar Heels,B. Robinson,4065675,,False,4.0,0,1,0,1,0,0,0,2,0,0,0,0,0,0,0,0,0
400915378,North Carolina Tar Heels,K. Coker,3947144,,False,1.0,0,0,0,0,0,0,0,0,0,0,0,0,0,0,0,0,0
400915378,North Carolina Tar Heels,N. Britt,66872,,False,11.0,1,2,1,2,0,0,0,0,0,1,1,2,1,0,2,3,2
400915378,North Carolina Tar Heels,S. White,56963,,False,1.0,0,0,0,0,0,0,0,0,0,0,0,0,0,0,0,0,0
400915378,North Carolina Tar Heels,TEAM,TOTAL,TOTAL,False,,31,73,23,55,8,18,26,37,21,35,56,12,8,0,15,22,96
400915378,North Carolina Tar Heels,J. Jackson,3138156,,True,29.0,9,17,6,12,3,5,1,2,2,2,4,0,1,0,1,4,22
400915378,North Carolina Tar Heels,I. Hicks,66874,,True,22.0,5,7,5,7,0,0,12,14,4,3,7,3,0,0,3,3,22
400915378,North Carolina Tar Heels,K. Meeks,66873,,True,13.0,3,7,3,7,0,0,0,0,4,2,6,0,1,0,1,4,6
400915378,North Carolina Tar Heels,K. Williams,3911619,,True,30.0,1,7,0,3,1,4,1,4,2,4,6,1,2,0,0,1,4
400915378,North Carolina Tar Heels,J. Berry II,3138155,,True,35.0,8,19,5,13,3,6,7,8,0,2,2,1,2,0,2,3,26
400915378,North Carolina Tar Heels,A. Rohlman,4065677,,False,1.0,0,0,0,0,0,0,0,0,0,0,0,0,0,0,0,0,0
400915378,North Carolina Tar Heels,S. Rush,4065674,,False,1.0,0,0,0,0,0,0,0,0,0,0,0,0,0,0,0,0,0
400915378,North Carolina Tar Heels,L. Maye,3911620,,False,25.0,1,6,1,5,0,1,0,0,5,10,15,2,0,0,4,3,2
400915378,North Carolina Tar Heels,T. Pinson,3138154,,False,24.0,3,5,2,3,1,2,5,6,2,8,10,3,1,0,1,1,12
400915378,North Carolina Tar Heels,S. Woods,4065676,,False,3.0,0,2,0,2,0,0,0,1,0,0,0,0,0,0,0,0,0
400915378,North Carolina Tar Heels,B. Robinson,4065675,,False,4.0,0,1,0,1,0,0,0,2,0,0,0,0,0,0,0,0,0
400915378,North Carolina Tar Heels,K. Coker,3947144,,False,1.0,0,0,0,0,0,0,0,0,0,0,0,0,0,0,0,0,0
400915378,North Carolina Tar Heels,N. Britt,66872,,False,11.0,1,2,1,2,0,0,0,0,0,1,1,2,1,0,2,3,2
400915378,North Carolina Tar Heels,S. White,56963,,False,1.0,0,0,0,0,0,0,0,0,0,0,0,0,0,0,0,0,0
400915378,North Carolina Tar Heels,TEAM,TOTAL,TOTAL,False,,31,73,23,55,8,18,26,37,21,35,56,12,8,0,15,22,96
400915378,Florida State Seminoles,J. Isaac,4065654,,True,27.0,6,11,4,6,2,5,3,4,1,11,12,2,3,0,0,4,17
400915378,Florida State Seminoles,M. Ojo,61596,,True,14.0,2,4,2,4,0,0,0,0,0,0,0,0,0,2,0,1,4
400915378,Florida State Seminoles,T. Mann,3907823,,True,21.0,4,7,4,6,0,1,2,4,2,3,5,1,1,0,0,4,10
400915378,Florida State Seminoles,D. Bacon,3907821,,True,30.0,7,16,4,8,3,8,1,1,0,2,2,2,1,1,3,2,18
400915378,Florida State Seminoles,X. Rathan-Mayes,66125,,True,24.0,2,6,1,2,1,4,1,4,1,0,1,6,2,0,5,2,6
400915378,Florida State Seminoles,P. Cofer,3135054,,False,14.0,1,3,1,3,0,0,0,0,2,1,3,1,0,0,1,1,2
400915378,Florida State Seminoles,J. Smith,66126,,False,18.0,3,3,3,3,0,0,1,2,2,0,2,0,0,1,1,3,7
400915378,Florida State Seminoles,C. Koumadje,3907824,,False,4.0,0,0,0,0,0,0,0,0,0,3,3,0,0,0,0,2,0
400915378,Florida State Seminoles,B. Angola-Rodas,4065658,,False,14.0,0,2,0,1,0,1,0,2,0,1,1,1,0,0,2,2,0
400915378,Florida State Seminoles,P. Savoy,4065657,,False,15.0,4,6,2,2,2,4,0,2,1,2,3,0,1,0,0,0,10
400915378,Florida State Seminoles,T. Forrest,4065656,,False,5.0,0,1,0,0,0,1,3,4,0,2,2,1,0,0,2,4,3
400915378,Florida State Seminoles,C. Walker,4065655,,False,14.0,2,8,1,4,1,4,1,3,0,0,0,1,0,1,1,2,6
400915378,Florida State Seminoles,TEAM,TOTAL,TOTAL,False,,31,67,22,39,9,28,12,26,9,25,34,15,8,5,15,27,83
400915378,Florida State Seminoles,J. Isaac,4065654,,True,27.0,6,11,4,6,2,5,3,4,1,11,12,2,3,0,0,4,17
400915378,Florida State Seminoles,M. Ojo,61596,,True,14.0,2,4,2,4,0,0,0,0,0,0,0,0,0,2,0,1,4
400915378,Florida State Seminoles,T. Mann,3907823,,True,21.0,4,7,4,6,0,1,2,4,2,3,5,1,1,0,0,4,10
400915378,Florida State Seminoles,D. Bacon,3907821,,True,30.0,7,16,4,8,3,8,1,1,0,2,2,2,1,1,3,2,18
400915378,Florida State Seminoles,X. Rathan-Mayes,66125,,True,24.0,2,6,1,2,1,4,1,4,1,0,1,6,2,0,5,2,6
400915378,Florida State Seminoles,P. Cofer,3135054,,False,14.0,1,3,1,3,0,0,0,0,2,1,3,1,0,0,1,1,2
400915378,Florida State Seminoles,J. Smith,66126,,False,18.0,3,3,3,3,0,0,1,2,2,0,2,0,0,1,1,3,7
400915378,Florida State Seminoles,C. Koumadje,3907824,,False,4.0,0,0,0,0,0,0,0,0,0,3,3,0,0,0,0,2,0
400915378,Florida State Seminoles,B. Angola-Rodas,4065658,,False,14.0,0,2,0,1,0,1,0,2,0,1,1,1,0,0,2,2,0
400915378,Florida State Seminoles,P. Savoy,4065657,,False,15.0,4,6,2,2,2,4,0,2,1,2,3,0,1,0,0,0,10
400915378,Florida State Seminoles,T. Forrest,4065656,,False,5.0,0,1,0,0,0,1,3,4,0,2,2,1,0,0,2,4,3
400915378,Florida State Seminoles,C. Walker,4065655,,False,14.0,2,8,1,4,1,4,1,3,0,0,0,1,0,1,1,2,6
400915378,Florida State Seminoles,TEAM,TOTAL,TOTAL,False,,31,67,22,39,9,28,12,26,9,25,34,15,8,5,15,27,83
400915377,Pittsburgh Panthers,M. Young,66290,,True,28.0,0,10,0,7,0,3,2,2,1,3,4,3,0,1,3,1,2
400915377,Pittsburgh Panthers,S. Jeter,61756,,True,31.0,1,6,0,3,1,3,0,0,1,4,5,1,2,0,2,0,3
400915377,Pittsburgh Panthers,J. Artis,66287,,True,30.0,7,12,6,9,1,3,0,0,2,0,2,2,0,0,2,1,15
400915377,Pittsburgh Panthers,C. Johnson,3138196,,True,27.0,3,7,1,2,2,5,0,0,2,2,4,1,0,0,4,0,8
400915377,Pittsburgh Panthers,C. Jones,61219,,True,32.0,5,7,5,7,0,0,0,1,0,2,2,1,0,0,2,2,10
400915377,Pittsburgh Panthers,R. Nix,3934653,,False,5.0,0,0,0,0,0,0,0,0,1,2,3,0,0,0,0,0,0
400915377,Pittsburgh Panthers,C. Manigault,4065714,,False,12.0,1,3,1,3,0,0,0,1,1,1,2,0,0,0,0,0,2
400915377,Pittsburgh Panthers,J. Kithcart,4065713,,False,11.0,0,2,0,1,0,1,0,0,0,0,0,0,0,0,0,0,0
400915377,Pittsburgh Panthers,J. Milligan,3934655,,False,11.0,1,3,0,2,1,1,0,0,0,0,0,1,1,0,0,2,3
400915377,Pittsburgh Panthers,Z. Smith,3934654,,False,1.0,0,0,0,0,0,0,0,0,0,0,0,0,0,0,0,0,0
400915377,Pittsburgh Panthers,D. Wilson,3934652,,False,12.0,0,3,0,2,0,1,3,4,0,0,0,0,0,0,1,1,3
400915377,Pittsburgh Panthers,TEAM,TOTAL,TOTAL,False,,18,53,13,36,5,17,5,8,8,15,23,9,3,1,14,7,46
400915377,Pittsburgh Panthers,M. Young,66290,,True,28.0,0,10,0,7,0,3,2,2,1,3,4,3,0,1,3,1,2
400915377,Pittsburgh Panthers,S. Jeter,61756,,True,31.0,1,6,0,3,1,3,0,0,1,4,5,1,2,0,2,0,3
400915377,Pittsburgh Panthers,J. Artis,66287,,True,30.0,7,12,6,9,1,3,0,0,2,0,2,2,0,0,2,1,15
400915377,Pittsburgh Panthers,C. Johnson,3138196,,True,27.0,3,7,1,2,2,5,0,0,2,2,4,1,0,0,4,0,8
400915377,Pittsburgh Panthers,C. Jones,61219,,True,32.0,5,7,5,7,0,0,0,1,0,2,2,1,0,0,2,2,10
400915377,Pittsburgh Panthers,R. Nix,3934653,,False,5.0,0,0,0,0,0,0,0,0,1,2,3,0,0,0,0,0,0
400915377,Pittsburgh Panthers,C. Manigault,4065714,,False,12.0,1,3,1,3,0,0,0,1,1,1,2,0,0,0,0,0,2
400915377,Pittsburgh Panthers,J. Kithcart,4065713,,False,11.0,0,2,0,1,0,1,0,0,0,0,0,0,0,0,0,0,0
400915377,Pittsburgh Panthers,J. Milligan,3934655,,False,11.0,1,3,0,2,1,1,0,0,0,0,0,1,1,0,0,2,3
400915377,Pittsburgh Panthers,Z. Smith,3934654,,False,1.0,0,0,0,0,0,0,0,0,0,0,0,0,0,0,0,0,0
400915377,Pittsburgh Panthers,D. Wilson,3934652,,False,12.0,0,3,0,2,0,1,3,4,0,0,0,0,0,0,1,1,3
400915377,Pittsburgh Panthers,TEAM,TOTAL,TOTAL,False,,18,53,13,36,5,17,5,8,8,15,23,9,3,1,14,7,46
400915377,Miami Hurricanes,D. Hernandez,4065672,,True,21.0,2,3,2,3,0,0,0,0,1,2,3,0,1,2,1,1,4
400915377,Miami Hurricanes,K. Murphy,61668,,True,25.0,1,2,1,2,0,0,0,0,1,7,8,1,1,1,2,3,2
400915377,Miami Hurricanes,B. Brown,4065670,,True,32.0,7,13,4,8,3,5,0,0,2,4,6,3,2,1,3,3,17
400915377,Miami Hurricanes,J. Newton,3138145,,True,30.0,7,10,7,9,0,1,0,1,0,3,3,5,0,0,7,0,14
400915377,Miami Hurricanes,D. Reed,66130,,True,35.0,6,11,2,3,4,8,2,2,0,6,6,5,0,2,1,1,18
400915377,Miami Hurricanes,R. Miller Jr.,4065671,,False,2.0,0,1,0,1,0,0,0,0,0,0,0,0,0,0,0,0,0
400915377,Miami Hurricanes,E. Izundu,3904629,,False,9.0,1,3,1,3,0,0,0,0,1,1,2,0,0,0,1,2,2
400915377,Miami Hurricanes,A. Lawrence II,3904628,,False,26.0,4,5,3,4,1,1,0,0,1,4,5,2,2,0,0,4,9
400915377,Miami Hurricanes,D. Vasiljevic,4065669,,False,18.0,2,6,0,0,2,6,0,0,1,1,2,1,0,0,0,0,6
400915377,Miami Hurricanes,M. Robinson,3947140,,False,2.0,0,0,0,0,0,0,0,0,0,0,0,0,0,0,0,0,0
400915377,Miami Hurricanes,TEAM,TOTAL,TOTAL,False,,30,54,20,33,10,21,2,3,8,29,37,17,6,6,18,14,72
400915377,Miami Hurricanes,D. Hernandez,4065672,,True,21.0,2,3,2,3,0,0,0,0,1,2,3,0,1,2,1,1,4
400915377,Miami Hurricanes,K. Murphy,61668,,True,25.0,1,2,1,2,0,0,0,0,1,7,8,1,1,1,2,3,2
400915377,Miami Hurricanes,B. Brown,4065670,,True,32.0,7,13,4,8,3,5,0,0,2,4,6,3,2,1,3,3,17
400915377,Miami Hurricanes,J. Newton,3138145,,True,30.0,7,10,7,9,0,1,0,1,0,3,3,5,0,0,7,0,14
400915377,Miami Hurricanes,D. Reed,66130,,True,35.0,6,11,2,3,4,8,2,2,0,6,6,5,0,2,1,1,18
400915377,Miami Hurricanes,R. Miller Jr.,4065671,,False,2.0,0,1,0,1,0,0,0,0,0,0,0,0,0,0,0,0,0
400915377,Miami Hurricanes,E. Izundu,3904629,,False,9.0,1,3,1,3,0,0,0,0,1,1,2,0,0,0,1,2,2
400915377,Miami Hurricanes,A. Lawrence II,3904628,,False,26.0,4,5,3,4,1,1,0,0,1,4,5,2,2,0,0,4,9
400915377,Miami Hurricanes,D. Vasiljevic,4065669,,False,18.0,2,6,0,0,2,6,0,0,1,1,2,1,0,0,0,0,6
400915377,Miami Hurricanes,M. Robinson,3947140,,False,2.0,0,0,0,0,0,0,0,0,0,0,0,0,0,0,0,0,0
400915377,Miami Hurricanes,TEAM,TOTAL,TOTAL,False,,30,54,20,33,10,21,2,3,8,29,37,17,6,6,18,14,72
400915376,Louisville Cardinals,A. Mahmoud,3147363,,True,26.0,6,9,6,9,0,0,5,7,5,6,11,0,2,1,3,3,17
400915376,Louisville Cardinals,D. Adel,3908807,,True,19.0,2,7,2,5,0,2,2,3,0,1,1,4,0,0,1,4,6
400915376,Louisville Cardinals,R. Spalding,3908806,,True,24.0,3,4,3,4,0,0,5,7,0,2,2,1,1,0,2,4,11
400915376,Louisville Cardinals,D. Mitchell,3908809,,True,36.0,6,12,3,7,3,5,0,1,0,5,5,3,1,0,1,4,15
400915376,Louisville Cardinals,Q. Snider,3147360,,True,35.0,5,14,2,6,3,8,0,0,2,3,5,6,3,0,2,0,13
400915376,Louisville Cardinals,V.J. King,4065666,,False,22.0,2,5,1,1,1,4,2,2,1,2,3,0,0,0,1,1,7
400915376,Louisville Cardinals,J. Johnson,3147362,,False,16.0,0,3,0,3,0,0,0,0,2,1,3,2,0,0,1,1,0
400915376,Louisville Cardinals,M. Mathiang,63035,,False,14.0,3,3,3,3,0,0,1,2,0,1,1,0,0,0,0,2,7
400915376,Louisville Cardinals,D. Levitch,66592,,False,3.0,0,0,0,0,0,0,0,0,0,0,0,0,0,0,0,2,0
400915376,Louisville Cardinals,T. Hicks,62752,,False,5.0,1,2,1,2,0,0,0,0,0,0,0,0,0,1,0,3,2
400915376,Louisville Cardinals,TEAM,TOTAL,TOTAL,False,,28,59,21,40,7,19,15,22,11,21,32,16,7,2,11,24,78
400915376,Louisville Cardinals,A. Mahmoud,3147363,,True,26.0,6,9,6,9,0,0,5,7,5,6,11,0,2,1,3,3,17
400915376,Louisville Cardinals,D. Adel,3908807,,True,19.0,2,7,2,5,0,2,2,3,0,1,1,4,0,0,1,4,6
400915376,Louisville Cardinals,R. Spalding,3908806,,True,24.0,3,4,3,4,0,0,5,7,0,2,2,1,1,0,2,4,11
400915376,Louisville Cardinals,D. Mitchell,3908809,,True,36.0,6,12,3,7,3,5,0,1,0,5,5,3,1,0,1,4,15
400915376,Louisville Cardinals,Q. Snider,3147360,,True,35.0,5,14,2,6,3,8,0,0,2,3,5,6,3,0,2,0,13
400915376,Louisville Cardinals,V.J. King,4065666,,False,22.0,2,5,1,1,1,4,2,2,1,2,3,0,0,0,1,1,7
400915376,Louisville Cardinals,J. Johnson,3147362,,False,16.0,0,3,0,3,0,0,0,0,2,1,3,2,0,0,1,1,0
400915376,Louisville Cardinals,M. Mathiang,63035,,False,14.0,3,3,3,3,0,0,1,2,0,1,1,0,0,0,0,2,7
400915376,Louisville Cardinals,D. Levitch,66592,,False,3.0,0,0,0,0,0,0,0,0,0,0,0,0,0,0,0,2,0
400915376,Louisville Cardinals,T. Hicks,62752,,False,5.0,1,2,1,2,0,0,0,0,0,0,0,0,0,1,0,3,2
400915376,Louisville Cardinals,TEAM,TOTAL,TOTAL,False,,28,59,21,40,7,19,15,22,11,21,32,16,7,2,11,24,78
400915376,Duke Blue Devils,H. Giles III,4065649,,True,19.0,3,5,3,5,0,0,1,4,3,3,6,1,1,2,1,3,7
400915376,Duke Blue Devils,J. Tatum,4065648,,True,31.0,3,11,3,10,0,1,5,6,0,5,5,0,1,0,3,4,11
400915376,Duke Blue Devils,L. Kennard,3913174,,True,39.0,6,10,5,7,1,3,4,4,0,4,4,3,0,0,3,2,17
400915376,Duke Blue Devils,G. Allen,3135045,,True,36.0,6,11,4,8,2,3,9,12,2,7,9,3,0,0,6,3,23
400915376,Duke Blue Devils,M. Jones,66563,,True,36.0,3,5,2,3,1,2,1,1,1,2,3,1,0,1,1,3,8
400915376,Duke Blue Devils,J. DeLaurier,4065650,,False,7.0,0,0,0,0,0,0,0,0,0,0,0,0,0,1,1,2,0
400915376,Duke Blue Devils,M. Bolden,4065652,,False,5.0,0,0,0,0,0,0,0,0,0,0,0,0,0,0,0,1,0
400915376,Duke Blue Devils,C. Jeter,3913173,,False,17.0,0,0,0,0,0,0,0,1,0,2,2,0,0,1,2,2,0
400915376,Duke Blue Devils,F. Jackson,4065651,,False,10.0,1,5,0,2,1,3,0,0,0,1,1,0,0,0,1,3,3
400915376,Duke Blue Devils,TEAM,TOTAL,TOTAL,False,,22,47,17,35,5,12,20,28,7,25,32,8,2,5,18,23,69
400915376,Duke Blue Devils,H. Giles III,4065649,,True,19.0,3,5,3,5,0,0,1,4,3,3,6,1,1,2,1,3,7
400915376,Duke Blue Devils,J. Tatum,4065648,,True,31.0,3,11,3,10,0,1,5,6,0,5,5,0,1,0,3,4,11
400915376,Duke Blue Devils,L. Kennard,3913174,,True,39.0,6,10,5,7,1,3,4,4,0,4,4,3,0,0,3,2,17
400915376,Duke Blue Devils,G. Allen,3135045,,True,36.0,6,11,4,8,2,3,9,12,2,7,9,3,0,0,6,3,23
400915376,Duke Blue Devils,M. Jones,66563,,True,36.0,3,5,2,3,1,2,1,1,1,2,3,1,0,1,1,3,8
400915376,Duke Blue Devils,J. DeLaurier,4065650,,False,7.0,0,0,0,0,0,0,0,0,0,0,0,0,0,1,1,2,0
400915376,Duke Blue Devils,M. Bolden,4065652,,False,5.0,0,0,0,0,0,0,0,0,0,0,0,0,0,0,0,1,0
400915376,Duke Blue Devils,C. Jeter,3913173,,False,17.0,0,0,0,0,0,0,0,1,0,2,2,0,0,1,2,2,0
400915376,Duke Blue Devils,F. Jackson,4065651,,False,10.0,1,5,0,2,1,3,0,0,0,1,1,0,0,0,1,3,3
400915376,Duke Blue Devils,TEAM,TOTAL,TOTAL,False,,22,47,17,35,5,12,20,28,7,25,32,8,2,5,18,23,69
400915375,Virginia Cavaliers,I. Wilkins,3138203,,True,31.0,4,7,4,7,0,0,0,0,4,9,13,2,0,0,3,1,8
400915375,Virginia Cavaliers,J. Salt,3138200,,True,18.0,1,1,1,1,0,0,0,2,1,1,2,0,0,1,2,5,2
400915375,Virginia Cavaliers,M. Shayok,3138201,,True,36.0,8,14,7,11,1,3,0,0,0,7,7,2,1,0,2,1,17
400915375,Virginia Cavaliers,L. Perrantes,66139,,True,34.0,8,15,4,7,4,8,5,5,1,1,2,2,0,0,4,1,25
400915375,Virginia Cavaliers,D. Hall,66138,,True,20.0,2,3,0,1,2,2,3,4,0,0,0,0,0,0,2,4,9
400915375,Virginia Cavaliers,M. Diakite,3947156,,False,7.0,0,0,0,0,0,0,1,2,0,1,1,0,0,0,0,3,1
400915375,Virginia Cavaliers,J. Reuter,3908374,,False,3.0,0,1,0,1,0,0,0,0,0,0,0,0,0,0,1,2,0
400915375,Virginia Cavaliers,T. Jerome,4065733,,False,7.0,1,1,1,1,0,0,0,0,0,0,0,0,0,0,1,0,2
400915375,Virginia Cavaliers,K. Guy,4065730,,False,19.0,2,4,0,1,2,3,0,0,0,0,0,1,1,0,0,0,6
400915375,Virginia Cavaliers,D. Thompson,66274,,False,25.0,3,4,2,2,1,2,0,0,0,4,4,2,0,1,1,0,7
400915375,Virginia Cavaliers,TEAM,TOTAL,TOTAL,False,,29,50,19,32,10,18,9,13,7,23,30,9,2,2,16,17,77
400915375,Virginia Cavaliers,I. Wilkins,3138203,,True,31.0,4,7,4,7,0,0,0,0,4,9,13,2,0,0,3,1,8
400915375,Virginia Cavaliers,J. Salt,3138200,,True,18.0,1,1,1,1,0,0,0,2,1,1,2,0,0,1,2,5,2
400915375,Virginia Cavaliers,M. Shayok,3138201,,True,36.0,8,14,7,11,1,3,0,0,0,7,7,2,1,0,2,1,17
400915375,Virginia Cavaliers,L. Perrantes,66139,,True,34.0,8,15,4,7,4,8,5,5,1,1,2,2,0,0,4,1,25
400915375,Virginia Cavaliers,D. Hall,66138,,True,20.0,2,3,0,1,2,2,3,4,0,0,0,0,0,0,2,4,9
400915375,Virginia Cavaliers,M. Diakite,3947156,,False,7.0,0,0,0,0,0,0,1,2,0,1,1,0,0,0,0,3,1
400915375,Virginia Cavaliers,J. Reuter,3908374,,False,3.0,0,1,0,1,0,0,0,0,0,0,0,0,0,0,1,2,0
400915375,Virginia Cavaliers,T. Jerome,4065733,,False,7.0,1,1,1,1,0,0,0,0,0,0,0,0,0,0,1,0,2
400915375,Virginia Cavaliers,K. Guy,4065730,,False,19.0,2,4,0,1,2,3,0,0,0,0,0,1,1,0,0,0,6
400915375,Virginia Cavaliers,D. Thompson,66274,,False,25.0,3,4,2,2,1,2,0,0,0,4,4,2,0,1,1,0,7
400915375,Virginia Cavaliers,TEAM,TOTAL,TOTAL,False,,29,50,19,32,10,18,9,13,7,23,30,9,2,2,16,17,77
400915375,Clemson Tigers,D. Grantham,3129674,,True,25.0,1,5,0,1,1,4,0,0,0,3,3,3,0,0,1,1,3
400915375,Clemson Tigers,J. Blossomgame,61835,,True,38.0,10,14,10,13,0,1,2,3,3,3,6,2,0,1,2,1,22
400915375,Clemson Tigers,S. Djitte,66122,,True,9.0,0,0,0,0,0,0,0,0,0,2,2,0,0,0,1,0,0
400915375,Clemson Tigers,S. Mitchell,3136699,,True,25.0,3,5,2,3,1,2,0,1,0,0,0,1,1,0,3,2,7
400915375,Clemson Tigers,A. Holmes,62043,,True,32.0,4,6,2,3,2,3,5,6,0,1,1,0,2,0,0,3,15
400915375,Clemson Tigers,E. Thomas,3947075,,False,23.0,4,8,4,8,0,0,1,4,2,2,4,2,2,2,0,3,9
400915375,Clemson Tigers,T. Hudson,3917986,,False,5.0,0,2,0,2,0,0,0,0,0,1,1,0,0,0,1,0,0
400915375,Clemson Tigers,M. Reed,3133969,,False,13.0,0,3,0,2,0,1,2,2,0,0,0,0,0,0,2,1,2
400915375,Clemson Tigers,G. DeVoe,3129673,,False,30.0,6,13,3,5,3,8,0,0,3,3,6,5,4,0,1,2,15
400915375,Clemson Tigers,TEAM,TOTAL,TOTAL,False,,28,56,21,37,7,19,10,16,9,16,25,13,9,3,11,13,73
400915375,Clemson Tigers,D. Grantham,3129674,,True,25.0,1,5,0,1,1,4,0,0,0,3,3,3,0,0,1,1,3
400915375,Clemson Tigers,J. Blossomgame,61835,,True,38.0,10,14,10,13,0,1,2,3,3,3,6,2,0,1,2,1,22
400915375,Clemson Tigers,S. Djitte,66122,,True,9.0,0,0,0,0,0,0,0,0,0,2,2,0,0,0,1,0,0
400915375,Clemson Tigers,S. Mitchell,3136699,,True,25.0,3,5,2,3,1,2,0,1,0,0,0,1,1,0,3,2,7
400915375,Clemson Tigers,A. Holmes,62043,,True,32.0,4,6,2,3,2,3,5,6,0,1,1,0,2,0,0,3,15
400915375,Clemson Tigers,E. Thomas,3947075,,False,23.0,4,8,4,8,0,0,1,4,2,2,4,2,2,2,0,3,9
400915375,Clemson Tigers,T. Hudson,3917986,,False,5.0,0,2,0,2,0,0,0,0,0,1,1,0,0,0,1,0,0
400915375,Clemson Tigers,M. Reed,3133969,,False,13.0,0,3,0,2,0,1,2,2,0,0,0,0,0,0,2,1,2
400915375,Clemson Tigers,G. DeVoe,3129673,,False,30.0,6,13,3,5,3,8,0,0,3,3,6,5,4,0,1,2,15
400915375,Clemson Tigers,TEAM,TOTAL,TOTAL,False,,28,56,21,37,7,19,10,16,9,16,25,13,9,3,11,13,73
400915374,Notre Dame Fighting Irish,B. Colson,3138192,,True,29.0,2,12,1,10,1,2,3,3,2,9,11,0,2,0,1,1,8
400915374,Notre Dame Fighting Irish,M. Geben,3138191,,True,15.0,3,4,3,4,0,0,0,0,1,2,3,1,0,0,1,0,6
400915374,Notre Dame Fighting Irish,V.J. Beachem,66283,,True,36.0,4,11,3,6,1,5,4,5,2,2,4,0,1,0,0,1,13
400915374,Notre Dame Fighting Irish,M. Farrell,3138190,,True,36.0,5,14,3,8,2,6,3,4,1,3,4,6,0,1,1,3,15
400915374,Notre Dame Fighting Irish,S. Vasturia,66285,,True,35.0,5,10,5,9,0,1,0,0,1,5,6,6,2,0,1,1,10
400915374,Notre Dame Fighting Irish,A. Torres,66286,,False,8.0,4,5,4,5,0,0,0,0,2,0,2,0,1,0,0,1,8
400915374,Notre Dame Fighting Irish,M. Ryan,3908336,,False,4.0,0,2,0,0,0,2,0,0,0,0,0,0,0,0,0,0,0
400915374,Notre Dame Fighting Irish,T. Gibbs,4065703,,False,13.0,1,5,1,4,0,1,0,0,0,1,1,2,1,0,0,2,2
400915374,Notre Dame Fighting Irish,R. Pflueger,3908335,,False,24.0,1,4,0,1,1,3,2,2,0,1,1,0,2,0,1,2,5
400915374,Notre Dame Fighting Irish,TEAM,TOTAL,TOTAL,False,,25,67,20,47,5,20,12,14,14,24,38,15,9,1,6,11,67
400915374,Notre Dame Fighting Irish,B. Colson,3138192,,True,29.0,2,12,1,10,1,2,3,3,2,9,11,0,2,0,1,1,8
400915374,Notre Dame Fighting Irish,M. Geben,3138191,,True,15.0,3,4,3,4,0,0,0,0,1,2,3,1,0,0,1,0,6
400915374,Notre Dame Fighting Irish,V.J. Beachem,66283,,True,36.0,4,11,3,6,1,5,4,5,2,2,4,0,1,0,0,1,13
400915374,Notre Dame Fighting Irish,M. Farrell,3138190,,True,36.0,5,14,3,8,2,6,3,4,1,3,4,6,0,1,1,3,15
400915374,Notre Dame Fighting Irish,S. Vasturia,66285,,True,35.0,5,10,5,9,0,1,0,0,1,5,6,6,2,0,1,1,10
400915374,Notre Dame Fighting Irish,A. Torres,66286,,False,8.0,4,5,4,5,0,0,0,0,2,0,2,0,1,0,0,1,8
400915374,Notre Dame Fighting Irish,M. Ryan,3908336,,False,4.0,0,2,0,0,0,2,0,0,0,0,0,0,0,0,0,0,0
400915374,Notre Dame Fighting Irish,T. Gibbs,4065703,,False,13.0,1,5,1,4,0,1,0,0,0,1,1,2,1,0,0,2,2
400915374,Notre Dame Fighting Irish,R. Pflueger,3908335,,False,24.0,1,4,0,1,1,3,2,2,0,1,1,0,2,0,1,2,5
400915374,Notre Dame Fighting Irish,TEAM,TOTAL,TOTAL,False,,25,67,20,47,5,20,12,14,14,24,38,15,9,1,6,11,67
400915374,Miami Hurricanes,D. Hernandez,4065672,,True,10.0,1,1,1,1,0,0,0,0,0,0,0,0,0,0,0,0,2
400915374,Miami Hurricanes,K. Murphy,61668,,True,32.0,3,7,3,7,0,0,1,2,5,7,12,0,0,2,1,2,7
400915374,Miami Hurricanes,B. Brown,4065670,,True,30.0,2,6,0,3,2,3,1,3,2,7,9,1,1,3,4,1,7
400915374,Miami Hurricanes,J. Newton,3138145,,True,35.0,5,16,5,15,0,1,4,5,1,2,3,1,0,0,3,2,14
400915374,Miami Hurricanes,D. Reed,66130,,True,38.0,9,17,7,10,2,7,1,2,0,6,6,3,0,3,4,1,21
400915374,Miami Hurricanes,E. Izundu,3904629,,False,10.0,1,1,1,1,0,0,0,0,1,3,4,0,0,3,0,3,2
400915374,Miami Hurricanes,A. Lawrence II,3904628,,False,25.0,2,9,1,7,1,2,1,2,7,2,9,1,1,1,1,1,6
400915374,Miami Hurricanes,D. Vasiljevic,4065669,,False,19.0,1,6,0,1,1,5,0,0,0,0,0,1,1,0,0,2,3
400915374,Miami Hurricanes,TEAM,TOTAL,TOTAL,False,,24,63,18,45,6,18,8,14,19,28,47,7,3,12,13,12,62
400915374,Miami Hurricanes,D. Hernandez,4065672,,True,10.0,1,1,1,1,0,0,0,0,0,0,0,0,0,0,0,0,2
400915374,Miami Hurricanes,K. Murphy,61668,,True,32.0,3,7,3,7,0,0,1,2,5,7,12,0,0,2,1,2,7
400915374,Miami Hurricanes,B. Brown,4065670,,True,30.0,2,6,0,3,2,3,1,3,2,7,9,1,1,3,4,1,7
400915374,Miami Hurricanes,J. Newton,3138145,,True,35.0,5,16,5,15,0,1,4,5,1,2,3,1,0,0,3,2,14
400915374,Miami Hurricanes,D. Reed,66130,,True,38.0,9,17,7,10,2,7,1,2,0,6,6,3,0,3,4,1,21
400915374,Miami Hurricanes,E. Izundu,3904629,,False,10.0,1,1,1,1,0,0,0,0,1,3,4,0,0,3,0,3,2
400915374,Miami Hurricanes,A. Lawrence II,3904628,,False,25.0,2,9,1,7,1,2,1,2,7,2,9,1,1,1,1,1,6
400915374,Miami Hurricanes,D. Vasiljevic,4065669,,False,19.0,1,6,0,1,1,5,0,0,0,0,0,1,1,0,0,2,3
400915374,Miami Hurricanes,TEAM,TOTAL,TOTAL,False,,24,63,18,45,6,18,8,14,19,28,47,7,3,12,13,12,62
400915373,Georgia Tech Yellow Jackets,Q. Stephens,66128,,True,34.0,5,15,3,8,2,7,4,4,0,8,8,2,0,0,1,3,16
400915373,Georgia Tech Yellow Jackets,B. Lammers,3135061,,True,36.0,8,17,8,17,0,0,7,7,3,7,10,1,1,1,2,3,23
400915373,Georgia Tech Yellow Jackets,J. Okogie,4065663,,True,36.0,5,11,5,10,0,1,3,4,2,2,4,3,2,0,2,1,13
400915373,Georgia Tech Yellow Jackets,J. Moore,4065662,,True,29.0,3,7,3,7,0,0,0,0,1,3,4,3,1,1,1,2,6
400915373,Georgia Tech Yellow Jackets,J. Heath,67623,,True,28.0,2,2,2,2,0,0,1,2,1,1,2,8,1,0,2,2,5
400915373,Georgia Tech Yellow Jackets,A. Gueye,3135059,,False,10.0,1,1,1,1,0,0,0,0,0,2,2,0,0,2,2,3,2
400915373,Georgia Tech Yellow Jackets,K. McCormick,61453,,False,2.0,0,0,0,0,0,0,0,0,0,1,1,0,0,0,0,0,0
400915373,Georgia Tech Yellow Jackets,T. Jackson,3135057,,False,23.0,3,5,1,1,2,4,2,2,0,4,4,1,0,0,3,3,10
400915373,Georgia Tech Yellow Jackets,C. Heyward,61609,,False,2.0,0,0,0,0,0,0,0,0,0,0,0,1,0,0,0,1,0
400915373,Georgia Tech Yellow Jackets,TEAM,TOTAL,TOTAL,False,,27,58,23,46,4,12,17,19,10,30,40,19,5,4,13,18,75
400915373,Georgia Tech Yellow Jackets,Q. Stephens,66128,,True,34.0,5,15,3,8,2,7,4,4,0,8,8,2,0,0,1,3,16
400915373,Georgia Tech Yellow Jackets,B. Lammers,3135061,,True,36.0,8,17,8,17,0,0,7,7,3,7,10,1,1,1,2,3,23
400915373,Georgia Tech Yellow Jackets,J. Okogie,4065663,,True,36.0,5,11,5,10,0,1,3,4,2,2,4,3,2,0,2,1,13
400915373,Georgia Tech Yellow Jackets,J. Moore,4065662,,True,29.0,3,7,3,7,0,0,0,0,1,3,4,3,1,1,1,2,6
400915373,Georgia Tech Yellow Jackets,J. Heath,67623,,True,28.0,2,2,2,2,0,0,1,2,1,1,2,8,1,0,2,2,5
400915373,Georgia Tech Yellow Jackets,A. Gueye,3135059,,False,10.0,1,1,1,1,0,0,0,0,0,2,2,0,0,2,2,3,2
400915373,Georgia Tech Yellow Jackets,K. McCormick,61453,,False,2.0,0,0,0,0,0,0,0,0,0,1,1,0,0,0,0,0,0
400915373,Georgia Tech Yellow Jackets,T. Jackson,3135057,,False,23.0,3,5,1,1,2,4,2,2,0,4,4,1,0,0,3,3,10
400915373,Georgia Tech Yellow Jackets,C. Heyward,61609,,False,2.0,0,0,0,0,0,0,0,0,0,0,0,1,0,0,0,1,0
400915373,Georgia Tech Yellow Jackets,TEAM,TOTAL,TOTAL,False,,27,58,23,46,4,12,17,19,10,30,40,19,5,4,13,18,75
400915373,Clemson Tigers,D. Grantham,3129674,,True,30.0,1,7,0,2,1,5,1,2,0,4,4,3,0,1,0,4,4
400915373,Clemson Tigers,J. Blossomgame,61835,,True,34.0,8,13,8,11,0,2,4,6,3,3,6,0,1,2,2,2,20
400915373,Clemson Tigers,S. Djitte,66122,,True,25.0,2,5,2,5,0,0,0,0,2,2,4,0,3,1,2,2,4
400915373,Clemson Tigers,S. Mitchell,3136699,,True,23.0,0,7,0,5,0,2,0,0,1,3,4,5,0,0,2,2,0
400915373,Clemson Tigers,A. Holmes,62043,,True,33.0,4,11,1,4,3,7,3,4,2,2,4,1,1,0,1,1,14
400915373,Clemson Tigers,E. Thomas,3947075,,False,12.0,2,4,2,4,0,0,0,1,0,2,2,0,1,2,0,4,4
400915373,Clemson Tigers,T. Hudson,3917986,,False,4.0,0,1,0,0,0,1,0,0,0,0,0,1,0,0,0,0,0
400915373,Clemson Tigers,M. Reed,3133969,,False,19.0,2,3,1,1,1,2,4,4,0,2,2,2,1,0,0,0,9
400915373,Clemson Tigers,G. DeVoe,3129673,,False,20.0,3,9,1,4,2,5,0,0,0,2,2,0,2,0,1,3,8
400915373,Clemson Tigers,TEAM,TOTAL,TOTAL,False,,22,60,15,36,7,24,12,17,8,21,29,12,9,6,8,18,63
400915373,Clemson Tigers,D. Grantham,3129674,,True,30.0,1,7,0,2,1,5,1,2,0,4,4,3,0,1,0,4,4
400915373,Clemson Tigers,J. Blossomgame,61835,,True,34.0,8,13,8,11,0,2,4,6,3,3,6,0,1,2,2,2,20
400915373,Clemson Tigers,S. Djitte,66122,,True,25.0,2,5,2,5,0,0,0,0,2,2,4,0,3,1,2,2,4
400915373,Clemson Tigers,S. Mitchell,3136699,,True,23.0,0,7,0,5,0,2,0,0,1,3,4,5,0,0,2,2,0
400915373,Clemson Tigers,A. Holmes,62043,,True,33.0,4,11,1,4,3,7,3,4,2,2,4,1,1,0,1,1,14
400915373,Clemson Tigers,E. Thomas,3947075,,False,12.0,2,4,2,4,0,0,0,1,0,2,2,0,1,2,0,4,4
400915373,Clemson Tigers,T. Hudson,3917986,,False,4.0,0,1,0,0,0,1,0,0,0,0,0,1,0,0,0,0,0
400915373,Clemson Tigers,M. Reed,3133969,,False,19.0,2,3,1,1,1,2,4,4,0,2,2,2,1,0,0,0,9
400915373,Clemson Tigers,G. DeVoe,3129673,,False,20.0,3,9,1,4,2,5,0,0,0,2,2,0,2,0,1,3,8
400915373,Clemson Tigers,TEAM,TOTAL,TOTAL,False,,22,60,15,36,7,24,12,17,8,21,29,12,9,6,8,18,63
400915372,NC State Wolfpack,A. Abu,3138158,,True,32.0,4,10,4,10,0,0,0,0,1,10,11,1,0,1,4,4,8
400915372,NC State Wolfpack,O. Yurtseven,66768,,True,16.0,2,8,2,7,0,1,0,0,1,1,2,1,1,1,0,2,4
400915372,NC State Wolfpack,D. Smith Jr.,4065697,,True,33.0,4,9,3,5,1,4,6,10,1,2,3,3,3,0,2,1,15
400915372,NC State Wolfpack,M. Rowan,3947151,,True,26.0,3,5,1,2,2,3,0,0,0,0,0,1,1,0,3,1,8
400915372,NC State Wolfpack,T. Henderson,61215,,True,29.0,4,9,2,3,2,6,4,4,0,1,1,2,0,0,3,3,14
400915372,NC State Wolfpack,T. Kapita,4065701,,False,8.0,1,1,1,1,0,0,0,0,1,1,2,0,0,0,0,1,2
400915372,NC State Wolfpack,B. Anya,66134,,False,19.0,3,3,3,3,0,0,2,2,1,0,1,0,0,2,2,1,8
400915372,NC State Wolfpack,M. Johnson,4065699,,False,26.0,2,6,2,4,0,2,1,2,0,3,3,4,0,0,1,3,5
400915372,NC State Wolfpack,T. Dorn,3132359,,False,11.0,1,3,1,2,0,1,0,0,0,3,3,0,1,0,2,1,2
400915372,NC State Wolfpack,TEAM,TOTAL,TOTAL,False,,24,54,19,37,5,17,13,18,8,23,31,12,6,4,17,17,66
400915372,NC State Wolfpack,A. Abu,3138158,,True,32.0,4,10,4,10,0,0,0,0,1,10,11,1,0,1,4,4,8
400915372,NC State Wolfpack,O. Yurtseven,66768,,True,16.0,2,8,2,7,0,1,0,0,1,1,2,1,1,1,0,2,4
400915372,NC State Wolfpack,D. Smith Jr.,4065697,,True,33.0,4,9,3,5,1,4,6,10,1,2,3,3,3,0,2,1,15
400915372,NC State Wolfpack,M. Rowan,3947151,,True,26.0,3,5,1,2,2,3,0,0,0,0,0,1,1,0,3,1,8
400915372,NC State Wolfpack,T. Henderson,61215,,True,29.0,4,9,2,3,2,6,4,4,0,1,1,2,0,0,3,3,14
400915372,NC State Wolfpack,T. Kapita,4065701,,False,8.0,1,1,1,1,0,0,0,0,1,1,2,0,0,0,0,1,2
400915372,NC State Wolfpack,B. Anya,66134,,False,19.0,3,3,3,3,0,0,2,2,1,0,1,0,0,2,2,1,8
400915372,NC State Wolfpack,M. Johnson,4065699,,False,26.0,2,6,2,4,0,2,1,2,0,3,3,4,0,0,1,3,5
400915372,NC State Wolfpack,T. Dorn,3132359,,False,11.0,1,3,1,2,0,1,0,0,0,3,3,0,1,0,2,1,2
400915372,NC State Wolfpack,TEAM,TOTAL,TOTAL,False,,24,54,19,37,5,17,13,18,8,23,31,12,6,4,17,17,66
400915372,Boston College Eagles,A.J. Turner,3943608,,True,39.0,2,7,1,5,1,2,5,5,0,4,4,0,3,0,0,0,10
400915372,Boston College Eagles,M. Jeffers,61901,,True,17.0,0,3,0,3,0,0,2,2,0,2,2,1,0,0,3,4,2
400915372,Boston College Eagles,C. Tava,61446,,True,33.0,5,8,4,5,1,3,2,2,0,6,6,2,0,0,1,0,13
400915372,Boston College Eagles,K. Bowman,4065635,,True,33.0,6,10,3,5,3,5,4,4,1,6,7,1,3,0,2,4,19
400915372,Boston College Eagles,J. Robinson,3943606,,True,39.0,10,18,9,16,1,2,5,6,2,2,4,5,2,0,4,2,26
400915372,Boston College Eagles,J. Reyes,3943609,,False,4.0,0,0,0,0,0,0,0,0,0,0,0,0,0,0,1,1,0
400915372,Boston College Eagles,N. Popovic,4065637,,False,14.0,1,5,1,3,0,2,0,0,0,2,2,0,0,0,1,2,2
400915372,Boston College Eagles,G. Owens,66277,,False,8.0,0,0,0,0,0,0,0,0,1,1,2,2,0,0,0,0,0
400915372,Boston College Eagles,J. Chatman,3135095,,False,13.0,1,3,1,3,0,0,0,0,1,0,1,0,1,0,1,2,2
400915372,Boston College Eagles,TEAM,TOTAL,TOTAL,False,,25,54,19,40,6,14,18,19,6,24,30,11,9,0,14,15,74
400915372,Boston College Eagles,A.J. Turner,3943608,,True,39.0,2,7,1,5,1,2,5,5,0,4,4,0,3,0,0,0,10
400915372,Boston College Eagles,M. Jeffers,61901,,True,17.0,0,3,0,3,0,0,2,2,0,2,2,1,0,0,3,4,2
400915372,Boston College Eagles,C. Tava,61446,,True,33.0,5,8,4,5,1,3,2,2,0,6,6,2,0,0,1,0,13
400915372,Boston College Eagles,K. Bowman,4065635,,True,33.0,6,10,3,5,3,5,4,4,1,6,7,1,3,0,2,4,19
400915372,Boston College Eagles,J. Robinson,3943606,,True,39.0,10,18,9,16,1,2,5,6,2,2,4,5,2,0,4,2,26
400915372,Boston College Eagles,J. Reyes,3943609,,False,4.0,0,0,0,0,0,0,0,0,0,0,0,0,0,0,1,1,0
400915372,Boston College Eagles,N. Popovic,4065637,,False,14.0,1,5,1,3,0,2,0,0,0,2,2,0,0,0,1,2,2
400915372,Boston College Eagles,G. Owens,66277,,False,8.0,0,0,0,0,0,0,0,0,1,1,2,2,0,0,0,0,0
400915372,Boston College Eagles,J. Chatman,3135095,,False,13.0,1,3,1,3,0,0,0,0,1,0,1,0,1,0,1,2,2
400915372,Boston College Eagles,TEAM,TOTAL,TOTAL,False,,25,54,19,40,6,14,18,19,6,24,30,11,9,0,14,15,74
400915371,Wake Forest Demon Deacons,J. Collins,3908845,,True,20.0,3,8,3,8,0,0,0,2,2,1,3,1,1,2,2,3,6
400915371,Wake Forest Demon Deacons,D. Mitoglou,3138224,,True,31.0,3,10,2,6,1,4,6,6,3,4,7,1,0,3,2,2,13
400915371,Wake Forest Demon Deacons,A. Arians,61378,,True,22.0,3,6,1,3,2,3,0,0,0,1,1,0,1,0,0,2,8
400915371,Wake Forest Demon Deacons,B. Crawford,3908844,,True,23.0,7,10,4,6,3,4,5,8,0,3,3,4,1,0,2,5,22
400915371,Wake Forest Demon Deacons,K. Woods,3132360,,True,36.0,3,10,3,7,0,3,3,5,0,3,3,7,0,0,1,3,9
400915371,Wake Forest Demon Deacons,G. McClinton,66140,,False,3.0,0,0,0,0,0,0,0,0,0,1,1,0,0,0,0,1,0
400915371,Wake Forest Demon Deacons,S. Japhet-Mathias,4065752,,False,8.0,0,0,0,0,0,0,0,0,1,0,1,0,0,0,0,1,0
400915371,Wake Forest Demon Deacons,D. Moore,3908843,,False,12.0,1,2,1,2,0,0,0,0,4,2,6,0,0,4,2,2,2
400915371,Wake Forest Demon Deacons,B. Childress,4065750,,False,17.0,4,9,2,3,2,6,6,7,0,3,3,0,1,0,2,1,16
400915371,Wake Forest Demon Deacons,M. Wilbekin,3138222,,False,28.0,4,10,1,3,3,7,0,0,0,1,1,0,1,0,0,0,11
400915371,Wake Forest Demon Deacons,TEAM,TOTAL,TOTAL,False,,28,65,17,38,11,27,20,28,13,21,34,13,5,9,11,20,87
400915371,Wake Forest Demon Deacons,J. Collins,3908845,,True,20.0,3,8,3,8,0,0,0,2,2,1,3,1,1,2,2,3,6
400915371,Wake Forest Demon Deacons,D. Mitoglou,3138224,,True,31.0,3,10,2,6,1,4,6,6,3,4,7,1,0,3,2,2,13
400915371,Wake Forest Demon Deacons,A. Arians,61378,,True,22.0,3,6,1,3,2,3,0,0,0,1,1,0,1,0,0,2,8
400915371,Wake Forest Demon Deacons,B. Crawford,3908844,,True,23.0,7,10,4,6,3,4,5,8,0,3,3,4,1,0,2,5,22
400915371,Wake Forest Demon Deacons,K. Woods,3132360,,True,36.0,3,10,3,7,0,3,3,5,0,3,3,7,0,0,1,3,9
400915371,Wake Forest Demon Deacons,G. McClinton,66140,,False,3.0,0,0,0,0,0,0,0,0,0,1,1,0,0,0,0,1,0
400915371,Wake Forest Demon Deacons,S. Japhet-Mathias,4065752,,False,8.0,0,0,0,0,0,0,0,0,1,0,1,0,0,0,0,1,0
400915371,Wake Forest Demon Deacons,D. Moore,3908843,,False,12.0,1,2,1,2,0,0,0,0,4,2,6,0,0,4,2,2,2
400915371,Wake Forest Demon Deacons,B. Childress,4065750,,False,17.0,4,9,2,3,2,6,6,7,0,3,3,0,1,0,2,1,16
400915371,Wake Forest Demon Deacons,M. Wilbekin,3138222,,False,28.0,4,10,1,3,3,7,0,0,0,1,1,0,1,0,0,0,11
400915371,Wake Forest Demon Deacons,TEAM,TOTAL,TOTAL,False,,28,65,17,38,11,27,20,28,13,21,34,13,5,9,11,20,87
400915371,North Carolina Tar Heels,J. Jackson,3138156,,True,29.0,6,13,3,8,3,5,4,4,2,6,8,1,0,2,2,2,19
400915371,North Carolina Tar Heels,I. Hicks,66874,,True,23.0,5,6,5,6,0,0,6,6,0,5,5,0,1,1,1,4,16
400915371,North Carolina Tar Heels,K. Meeks,66873,,True,33.0,9,18,9,18,0,0,0,0,3,8,11,1,3,3,2,4,18
400915371,North Carolina Tar Heels,K. Williams,3911619,,True,25.0,3,3,1,1,2,2,4,6,0,0,0,5,2,0,2,2,12
400915371,North Carolina Tar Heels,J. Berry II,3138155,,True,33.0,7,12,5,6,2,6,2,3,1,2,3,7,1,0,1,4,18
400915371,North Carolina Tar Heels,T. Bradley,4065673,,False,6.0,2,5,2,5,0,0,0,0,4,0,4,1,1,0,1,1,4
400915371,North Carolina Tar Heels,L. Maye,3911620,,False,8.0,0,1,0,0,0,1,1,2,0,2,2,2,0,1,0,4,1
400915371,North Carolina Tar Heels,T. Pinson,3138154,,False,17.0,0,4,0,1,0,3,2,2,0,3,3,2,0,0,1,0,2
400915371,North Carolina Tar Heels,S. Woods,4065676,,False,7.0,0,0,0,0,0,0,0,0,0,0,0,1,0,0,0,0,0
400915371,North Carolina Tar Heels,B. Robinson,4065675,,False,1.0,0,0,0,0,0,0,0,0,0,0,0,0,0,0,0,0,0
400915371,North Carolina Tar Heels,N. Britt,66872,,False,18.0,1,2,0,1,1,1,0,1,0,2,2,2,0,0,0,2,3
400915371,North Carolina Tar Heels,TEAM,TOTAL,TOTAL,False,,33,64,25,46,8,18,19,24,13,28,41,22,8,7,11,23,93
400915371,North Carolina Tar Heels,J. Jackson,3138156,,True,29.0,6,13,3,8,3,5,4,4,2,6,8,1,0,2,2,2,19
400915371,North Carolina Tar Heels,I. Hicks,66874,,True,23.0,5,6,5,6,0,0,6,6,0,5,5,0,1,1,1,4,16
400915371,North Carolina Tar Heels,K. Meeks,66873,,True,33.0,9,18,9,18,0,0,0,0,3,8,11,1,3,3,2,4,18
400915371,North Carolina Tar Heels,K. Williams,3911619,,True,25.0,3,3,1,1,2,2,4,6,0,0,0,5,2,0,2,2,12
400915371,North Carolina Tar Heels,J. Berry II,3138155,,True,33.0,7,12,5,6,2,6,2,3,1,2,3,7,1,0,1,4,18
400915371,North Carolina Tar Heels,T. Bradley,4065673,,False,6.0,2,5,2,5,0,0,0,0,4,0,4,1,1,0,1,1,4
400915371,North Carolina Tar Heels,L. Maye,3911620,,False,8.0,0,1,0,0,0,1,1,2,0,2,2,2,0,1,0,4,1
400915371,North Carolina Tar Heels,T. Pinson,3138154,,False,17.0,0,4,0,1,0,3,2,2,0,3,3,2,0,0,1,0,2
400915371,North Carolina Tar Heels,S. Woods,4065676,,False,7.0,0,0,0,0,0,0,0,0,0,0,0,1,0,0,0,0,0
400915371,North Carolina Tar Heels,B. Robinson,4065675,,False,1.0,0,0,0,0,0,0,0,0,0,0,0,0,0,0,0,0,0
400915371,North Carolina Tar Heels,N. Britt,66872,,False,18.0,1,2,0,1,1,1,0,1,0,2,2,2,0,0,0,2,3
400915371,North Carolina Tar Heels,TEAM,TOTAL,TOTAL,False,,33,64,25,46,8,18,19,24,13,28,41,22,8,7,11,23,93
400915370,Pittsburgh Panthers,M. Young,66290,,True,35.0,5,14,2,6,3,8,4,11,1,10,11,3,1,2,2,2,17
400915370,Pittsburgh Panthers,S. Jeter,61756,,True,17.0,2,5,0,1,2,4,1,2,1,2,3,3,0,0,2,5,7
400915370,Pittsburgh Panthers,J. Artis,66287,,True,37.0,15,22,8,9,7,13,6,8,1,2,3,2,0,0,2,3,43
400915370,Pittsburgh Panthers,C. Johnson,3138196,,True,31.0,1,10,1,4,0,6,0,0,0,1,1,1,0,0,1,4,2
400915370,Pittsburgh Panthers,C. Jones,61219,,True,36.0,2,6,2,5,0,1,0,0,0,2,2,2,2,0,2,1,4
400915370,Pittsburgh Panthers,C. Manigault,4065714,,False,2.0,0,0,0,0,0,0,0,0,0,1,1,0,0,0,0,0,0
400915370,Pittsburgh Panthers,R. Luther,3138197,,False,27.0,1,1,1,1,0,0,4,6,3,3,6,1,0,0,4,4,6
400915370,Pittsburgh Panthers,J. Kithcart,4065713,,False,5.0,0,0,0,0,0,0,0,0,0,0,0,0,0,0,0,2,0
400915370,Pittsburgh Panthers,J. Milligan,3934655,,False,0.0,0,0,0,0,0,0,0,0,0,0,0,0,0,0,0,0,0
400915370,Pittsburgh Panthers,D. Wilson,3934652,,False,10.0,0,0,0,0,0,0,1,2,1,0,1,0,1,0,1,3,1
400915370,Pittsburgh Panthers,TEAM,TOTAL,TOTAL,False,,26,58,14,26,12,32,16,29,9,21,30,12,4,2,15,25,80
400915370,Pittsburgh Panthers,M. Young,66290,,True,35.0,5,14,2,6,3,8,4,11,1,10,11,3,1,2,2,2,17
400915370,Pittsburgh Panthers,S. Jeter,61756,,True,17.0,2,5,0,1,2,4,1,2,1,2,3,3,0,0,2,5,7
400915370,Pittsburgh Panthers,J. Artis,66287,,True,37.0,15,22,8,9,7,13,6,8,1,2,3,2,0,0,2,3,43
400915370,Pittsburgh Panthers,C. Johnson,3138196,,True,31.0,1,10,1,4,0,6,0,0,0,1,1,1,0,0,1,4,2
400915370,Pittsburgh Panthers,C. Jones,61219,,True,36.0,2,6,2,5,0,1,0,0,0,2,2,2,2,0,2,1,4
400915370,Pittsburgh Panthers,C. Manigault,4065714,,False,2.0,0,0,0,0,0,0,0,0,0,1,1,0,0,0,0,0,0
400915370,Pittsburgh Panthers,R. Luther,3138197,,False,27.0,1,1,1,1,0,0,4,6,3,3,6,1,0,0,4,4,6
400915370,Pittsburgh Panthers,J. Kithcart,4065713,,False,5.0,0,0,0,0,0,0,0,0,0,0,0,0,0,0,0,2,0
400915370,Pittsburgh Panthers,J. Milligan,3934655,,False,0.0,0,0,0,0,0,0,0,0,0,0,0,0,0,0,0,0,0
400915370,Pittsburgh Panthers,D. Wilson,3934652,,False,10.0,0,0,0,0,0,0,1,2,1,0,1,0,1,0,1,3,1
400915370,Pittsburgh Panthers,TEAM,TOTAL,TOTAL,False,,26,58,14,26,12,32,16,29,9,21,30,12,4,2,15,25,80
400915370,Louisville Cardinals,A. Mahmoud,3147363,,True,15.0,1,6,1,6,0,0,2,6,1,4,5,0,2,2,2,5,4
400915370,Louisville Cardinals,V.J. King,4065666,,True,9.0,1,3,1,3,0,0,0,0,1,1,2,0,0,0,1,0,2
400915370,Louisville Cardinals,R. Spalding,3908806,,True,29.0,4,5,4,5,0,0,3,6,4,4,8,1,0,1,3,3,11
400915370,Louisville Cardinals,D. Mitchell,3908809,,True,32.0,4,13,2,6,2,7,5,6,2,6,8,3,3,0,2,4,15
400915370,Louisville Cardinals,Q. Snider,3147360,,True,33.0,7,11,4,7,3,4,5,6,2,1,3,5,2,0,2,1,22
400915370,Louisville Cardinals,D. Adel,3908807,,False,32.0,5,8,5,6,0,2,5,7,0,6,6,1,0,0,4,1,15
400915370,Louisville Cardinals,J. Johnson,3147362,,False,15.0,2,6,2,6,0,0,0,0,1,3,4,1,1,0,0,4,4
400915370,Louisville Cardinals,M. Mathiang,63035,,False,18.0,2,4,2,4,0,0,1,1,1,2,3,0,0,3,1,4,5
400915370,Louisville Cardinals,R. McMahon,3908808,,False,1.0,0,1,0,1,0,0,0,0,0,0,0,0,0,0,0,0,0
400915370,Louisville Cardinals,J. Henderson,3155491,,False,0.0,0,0,0,0,0,0,0,0,0,0,0,0,0,0,0,0,0
400915370,Louisville Cardinals,D. Levitch,66592,,False,10.0,1,1,0,0,1,1,2,2,0,1,1,1,0,0,0,0,5
400915370,Louisville Cardinals,T. Hicks,62752,,False,6.0,1,1,1,1,0,0,0,0,0,1,1,0,0,0,3,1,2
400915370,Louisville Cardinals,TEAM,TOTAL,TOTAL,False,,28,59,22,45,6,14,23,34,14,31,45,12,8,6,18,23,85
400915370,Louisville Cardinals,A. Mahmoud,3147363,,True,15.0,1,6,1,6,0,0,2,6,1,4,5,0,2,2,2,5,4
400915370,Louisville Cardinals,V.J. King,4065666,,True,9.0,1,3,1,3,0,0,0,0,1,1,2,0,0,0,1,0,2
400915370,Louisville Cardinals,R. Spalding,3908806,,True,29.0,4,5,4,5,0,0,3,6,4,4,8,1,0,1,3,3,11
400915370,Louisville Cardinals,D. Mitchell,3908809,,True,32.0,4,13,2,6,2,7,5,6,2,6,8,3,3,0,2,4,15
400915370,Louisville Cardinals,Q. Snider,3147360,,True,33.0,7,11,4,7,3,4,5,6,2,1,3,5,2,0,2,1,22
400915370,Louisville Cardinals,D. Adel,3908807,,False,32.0,5,8,5,6,0,2,5,7,0,6,6,1,0,0,4,1,15
400915370,Louisville Cardinals,J. Johnson,3147362,,False,15.0,2,6,2,6,0,0,0,0,1,3,4,1,1,0,0,4,4
400915370,Louisville Cardinals,M. Mathiang,63035,,False,18.0,2,4,2,4,0,0,1,1,1,2,3,0,0,3,1,4,5
400915370,Louisville Cardinals,R. McMahon,3908808,,False,1.0,0,1,0,1,0,0,0,0,0,0,0,0,0,0,0,0,0
400915370,Louisville Cardinals,J. Henderson,3155491,,False,0.0,0,0,0,0,0,0,0,0,0,0,0,0,0,0,0,0,0
400915370,Louisville Cardinals,D. Levitch,66592,,False,10.0,1,1,0,0,1,1,2,2,0,1,1,1,0,0,0,0,5
400915370,Louisville Cardinals,T. Hicks,62752,,False,6.0,1,1,1,1,0,0,0,0,0,1,1,0,0,0,3,1,2
400915370,Louisville Cardinals,TEAM,TOTAL,TOTAL,False,,28,59,22,45,6,14,23,34,14,31,45,12,8,6,18,23,85
400915369,Florida State Seminoles,J. Isaac,4065654,,True,20.0,4,7,4,6,0,1,3,4,1,4,5,1,2,1,1,2,11
400915369,Florida State Seminoles,M. Ojo,61596,,True,13.0,4,5,4,5,0,0,1,1,1,0,1,0,0,0,0,3,9
400915369,Florida State Seminoles,T. Mann,3907823,,True,26.0,6,7,6,7,0,0,1,2,5,2,7,1,1,0,2,3,13
400915369,Florida State Seminoles,D. Bacon,3907821,,True,33.0,6,15,5,13,1,2,0,0,3,3,6,5,2,0,7,3,13
400915369,Florida State Seminoles,X. Rathan-Mayes,66125,,True,28.0,7,13,5,9,2,4,5,7,2,0,2,3,0,0,1,2,21
400915369,Florida State Seminoles,P. Cofer,3135054,,False,11.0,1,4,1,4,0,0,0,0,0,0,0,0,0,0,1,1,2
400915369,Florida State Seminoles,J. Smith,66126,,False,22.0,4,7,4,5,0,2,0,0,1,4,5,1,1,3,0,3,8
400915369,Florida State Seminoles,C. Koumadje,3907824,,False,5.0,0,1,0,1,0,0,0,0,0,0,0,0,0,0,0,0,0
400915369,Florida State Seminoles,B. Angola-Rodas,4065658,,False,13.0,0,2,0,1,0,1,0,0,0,3,3,2,0,0,1,0,0
400915369,Florida State Seminoles,P. Savoy,4065657,,False,9.0,2,4,0,0,2,4,0,0,0,2,2,0,0,0,0,0,6
400915369,Florida State Seminoles,T. Forrest,4065656,,False,10.0,1,1,1,1,0,0,1,2,0,0,0,1,0,0,1,1,3
400915369,Florida State Seminoles,C. Walker,4065655,,False,10.0,0,0,0,0,0,0,2,4,0,1,1,1,0,0,0,3,2
400915369,Florida State Seminoles,TEAM,TOTAL,TOTAL,False,,35,66,30,52,5,14,13,20,14,24,38,15,6,4,14,21,88
400915369,Florida State Seminoles,J. Isaac,4065654,,True,20.0,4,7,4,6,0,1,3,4,1,4,5,1,2,1,1,2,11
400915369,Florida State Seminoles,M. Ojo,61596,,True,13.0,4,5,4,5,0,0,1,1,1,0,1,0,0,0,0,3,9
400915369,Florida State Seminoles,T. Mann,3907823,,True,26.0,6,7,6,7,0,0,1,2,5,2,7,1,1,0,2,3,13
400915369,Florida State Seminoles,D. Bacon,3907821,,True,33.0,6,15,5,13,1,2,0,0,3,3,6,5,2,0,7,3,13
400915369,Florida State Seminoles,X. Rathan-Mayes,66125,,True,28.0,7,13,5,9,2,4,5,7,2,0,2,3,0,0,1,2,21
400915369,Florida State Seminoles,P. Cofer,3135054,,False,11.0,1,4,1,4,0,0,0,0,0,0,0,0,0,0,1,1,2
400915369,Florida State Seminoles,J. Smith,66126,,False,22.0,4,7,4,5,0,2,0,0,1,4,5,1,1,3,0,3,8
400915369,Florida State Seminoles,C. Koumadje,3907824,,False,5.0,0,1,0,1,0,0,0,0,0,0,0,0,0,0,0,0,0
400915369,Florida State Seminoles,B. Angola-Rodas,4065658,,False,13.0,0,2,0,1,0,1,0,0,0,3,3,2,0,0,1,0,0
400915369,Florida State Seminoles,P. Savoy,4065657,,False,9.0,2,4,0,0,2,4,0,0,0,2,2,0,0,0,0,0,6
400915369,Florida State Seminoles,T. Forrest,4065656,,False,10.0,1,1,1,1,0,0,1,2,0,0,0,1,0,0,1,1,3
400915369,Florida State Seminoles,C. Walker,4065655,,False,10.0,0,0,0,0,0,0,2,4,0,1,1,1,0,0,0,3,2
400915369,Florida State Seminoles,TEAM,TOTAL,TOTAL,False,,35,66,30,52,5,14,13,20,14,24,38,15,6,4,14,21,88
400915369,Duke Blue Devils,H. Giles III,4065649,,True,10.0,2,3,2,3,0,0,1,2,0,2,2,0,0,0,2,3,5
400915369,Duke Blue Devils,J. Tatum,4065648,,True,38.0,7,17,4,11,3,6,4,5,0,4,4,0,1,0,4,2,21
400915369,Duke Blue Devils,L. Kennard,3913174,,True,40.0,8,15,6,9,2,6,5,6,2,1,3,2,1,0,2,1,23
400915369,Duke Blue Devils,G. Allen,3135045,,True,26.0,2,6,2,3,0,3,5,7,0,3,3,5,0,0,3,3,9
400915369,Duke Blue Devils,M. Jones,66563,,True,36.0,4,8,2,3,2,5,0,0,1,2,3,2,2,0,2,4,10
400915369,Duke Blue Devils,M. Bolden,4065652,,False,4.0,0,0,0,0,0,0,0,0,0,0,0,0,0,0,1,1,0
400915369,Duke Blue Devils,C. Jeter,3913173,,False,25.0,0,2,0,2,0,0,1,2,4,2,6,0,1,2,1,3,1
400915369,Duke Blue Devils,F. Jackson,4065651,,False,21.0,0,5,0,1,0,4,3,4,3,3,6,1,0,0,1,4,3
400915369,Duke Blue Devils,TEAM,TOTAL,TOTAL,False,,23,56,16,32,7,24,19,26,10,20,30,10,5,2,16,21,72
400915369,Duke Blue Devils,H. Giles III,4065649,,True,10.0,2,3,2,3,0,0,1,2,0,2,2,0,0,0,2,3,5
400915369,Duke Blue Devils,J. Tatum,4065648,,True,38.0,7,17,4,11,3,6,4,5,0,4,4,0,1,0,4,2,21
400915369,Duke Blue Devils,L. Kennard,3913174,,True,40.0,8,15,6,9,2,6,5,6,2,1,3,2,1,0,2,1,23
400915369,Duke Blue Devils,G. Allen,3135045,,True,26.0,2,6,2,3,0,3,5,7,0,3,3,5,0,0,3,3,9
400915369,Duke Blue Devils,M. Jones,66563,,True,36.0,4,8,2,3,2,5,0,0,1,2,3,2,2,0,2,4,10
400915369,Duke Blue Devils,M. Bolden,4065652,,False,4.0,0,0,0,0,0,0,0,0,0,0,0,0,0,0,1,1,0
400915369,Duke Blue Devils,C. Jeter,3913173,,False,25.0,0,2,0,2,0,0,1,2,4,2,6,0,1,2,1,3,1
400915369,Duke Blue Devils,F. Jackson,4065651,,False,21.0,0,5,0,1,0,4,3,4,3,3,6,1,0,0,1,4,3
400915369,Duke Blue Devils,TEAM,TOTAL,TOTAL,False,,23,56,16,32,7,24,19,26,10,20,30,10,5,2,16,21,72
400915368,Virginia Tech Hokies,Z. LeDay,61698,,True,35.0,9,13,8,11,1,2,3,6,0,6,6,1,0,0,0,2,22
400915368,Virginia Tech Hokies,C. Clarke,3945567,,True,33.0,5,6,5,6,0,0,7,10,4,3,7,6,1,0,2,1,17
400915368,Virginia Tech Hokies,J. Robinson,3945566,,True,14.0,0,1,0,0,0,1,0,0,0,0,0,2,1,0,0,5,0
400915368,Virginia Tech Hokies,A. Hill,3147501,,True,35.0,4,11,1,4,3,7,2,2,1,3,4,3,0,0,1,2,13
400915368,Virginia Tech Hokies,J. Bibbs,3147500,,True,37.0,5,13,3,7,2,6,6,8,0,7,7,3,0,0,2,2,18
400915368,Virginia Tech Hokies,K. Sy,4065740,,False,6.0,0,1,0,1,0,0,0,0,1,0,1,0,0,1,0,1,0
400915368,Virginia Tech Hokies,T. Outlaw,67275,,False,9.0,1,5,1,3,0,2,0,0,1,1,2,0,0,1,0,3,2
400915368,Virginia Tech Hokies,S. Allen,61795,,False,31.0,4,7,2,5,2,2,1,1,0,2,2,5,1,1,1,1,11
400915368,Virginia Tech Hokies,TEAM,TOTAL,TOTAL,False,,28,57,20,37,8,20,19,27,7,24,31,20,3,3,6,17,83
400915368,Virginia Tech Hokies,Z. LeDay,61698,,True,35.0,9,13,8,11,1,2,3,6,0,6,6,1,0,0,0,2,22
400915368,Virginia Tech Hokies,C. Clarke,3945567,,True,33.0,5,6,5,6,0,0,7,10,4,3,7,6,1,0,2,1,17
400915368,Virginia Tech Hokies,J. Robinson,3945566,,True,14.0,0,1,0,0,0,1,0,0,0,0,0,2,1,0,0,5,0
400915368,Virginia Tech Hokies,A. Hill,3147501,,True,35.0,4,11,1,4,3,7,2,2,1,3,4,3,0,0,1,2,13
400915368,Virginia Tech Hokies,J. Bibbs,3147500,,True,37.0,5,13,3,7,2,6,6,8,0,7,7,3,0,0,2,2,18
400915368,Virginia Tech Hokies,K. Sy,4065740,,False,6.0,0,1,0,1,0,0,0,0,1,0,1,0,0,1,0,1,0
400915368,Virginia Tech Hokies,T. Outlaw,67275,,False,9.0,1,5,1,3,0,2,0,0,1,1,2,0,0,1,0,3,2
400915368,Virginia Tech Hokies,S. Allen,61795,,False,31.0,4,7,2,5,2,2,1,1,0,2,2,5,1,1,1,1,11
400915368,Virginia Tech Hokies,TEAM,TOTAL,TOTAL,False,,28,57,20,37,8,20,19,27,7,24,31,20,3,3,6,17,83
400915368,Syracuse Orange,T. Thompson,4065721,,True,32.0,7,13,7,13,0,0,4,7,3,5,8,0,0,3,2,3,18
400915368,Syracuse Orange,T. Lydon,3934662,,True,29.0,1,5,1,3,0,2,0,0,0,7,7,1,1,0,0,2,2
400915368,Syracuse Orange,T. Battle,4065722,,True,40.0,5,11,2,5,3,6,0,0,0,1,1,1,1,1,3,3,13
400915368,Syracuse Orange,J. Gillon,61915,,True,27.0,2,9,1,5,1,4,4,4,0,3,3,3,0,0,2,1,9
400915368,Syracuse Orange,A. White III,61616,,True,40.0,5,14,4,10,1,4,4,4,2,4,6,3,1,1,1,3,15
400915368,Syracuse Orange,T. Roberson,67633,,False,19.0,7,8,7,8,0,0,0,1,5,5,10,0,0,2,3,4,14
400915368,Syracuse Orange,F. Howard,3934659,,False,13.0,1,5,1,4,0,1,0,0,0,0,0,4,0,0,0,4,2
400915368,Syracuse Orange,TEAM,TOTAL,TOTAL,False,,28,65,23,48,5,17,12,16,13,25,38,12,3,7,11,20,73
400915368,Syracuse Orange,T. Thompson,4065721,,True,32.0,7,13,7,13,0,0,4,7,3,5,8,0,0,3,2,3,18
400915368,Syracuse Orange,T. Lydon,3934662,,True,29.0,1,5,1,3,0,2,0,0,0,7,7,1,1,0,0,2,2
400915368,Syracuse Orange,T. Battle,4065722,,True,40.0,5,11,2,5,3,6,0,0,0,1,1,1,1,1,3,3,13
400915368,Syracuse Orange,J. Gillon,61915,,True,27.0,2,9,1,5,1,4,4,4,0,3,3,3,0,0,2,1,9
400915368,Syracuse Orange,A. White III,61616,,True,40.0,5,14,4,10,1,4,4,4,2,4,6,3,1,1,1,3,15
400915368,Syracuse Orange,T. Roberson,67633,,False,19.0,7,8,7,8,0,0,0,1,5,5,10,0,0,2,3,4,14
400915368,Syracuse Orange,F. Howard,3934659,,False,13.0,1,5,1,4,0,1,0,0,0,0,0,4,0,0,0,4,2
400915368,Syracuse Orange,TEAM,TOTAL,TOTAL,False,,28,65,23,48,5,17,12,16,13,25,38,12,3,7,11,20,73
400915367,Wake Forest Demon Deacons,J. Collins,3908845,,True,35.0,5,11,5,11,0,0,6,10,3,3,6,1,1,2,2,2,16
400915367,Wake Forest Demon Deacons,D. Mitoglou,3138224,,True,27.0,4,8,3,5,1,3,2,2,1,3,4,0,1,1,2,2,11
400915367,Wake Forest Demon Deacons,A. Arians,61378,,True,21.0,1,2,0,0,1,2,0,0,0,2,2,2,0,0,0,1,3
400915367,Wake Forest Demon Deacons,B. Crawford,3908844,,True,34.0,7,14,6,9,1,5,0,1,0,2,2,6,1,0,2,5,15
400915367,Wake Forest Demon Deacons,K. Woods,3132360,,True,33.0,4,12,2,6,2,6,2,2,1,5,6,1,0,0,2,4,12
400915367,Wake Forest Demon Deacons,G. McClinton,66140,,False,5.0,0,0,0,0,0,0,0,0,2,0,2,0,0,0,1,4,0
400915367,Wake Forest Demon Deacons,D. Moore,3908843,,False,1.0,0,0,0,0,0,0,0,0,0,0,0,0,0,0,1,0,0
400915367,Wake Forest Demon Deacons,B. Childress,4065750,,False,22.0,1,4,1,2,0,2,0,1,0,1,1,1,1,0,1,0,2
400915367,Wake Forest Demon Deacons,M. Wilbekin,3138222,,False,22.0,1,6,0,3,1,3,0,0,0,1,1,1,1,0,0,4,3
400915367,Wake Forest Demon Deacons,TEAM,TOTAL,TOTAL,False,,23,57,17,36,6,21,10,16,13,19,32,12,5,3,12,22,62
400915367,Wake Forest Demon Deacons,J. Collins,3908845,,True,35.0,5,11,5,11,0,0,6,10,3,3,6,1,1,2,2,2,16
400915367,Wake Forest Demon Deacons,D. Mitoglou,3138224,,True,27.0,4,8,3,5,1,3,2,2,1,3,4,0,1,1,2,2,11
400915367,Wake Forest Demon Deacons,A. Arians,61378,,True,21.0,1,2,0,0,1,2,0,0,0,2,2,2,0,0,0,1,3
400915367,Wake Forest Demon Deacons,B. Crawford,3908844,,True,34.0,7,14,6,9,1,5,0,1,0,2,2,6,1,0,2,5,15
400915367,Wake Forest Demon Deacons,K. Woods,3132360,,True,33.0,4,12,2,6,2,6,2,2,1,5,6,1,0,0,2,4,12
400915367,Wake Forest Demon Deacons,G. McClinton,66140,,False,5.0,0,0,0,0,0,0,0,0,2,0,2,0,0,0,1,4,0
400915367,Wake Forest Demon Deacons,D. Moore,3908843,,False,1.0,0,0,0,0,0,0,0,0,0,0,0,0,0,0,1,0,0
400915367,Wake Forest Demon Deacons,B. Childress,4065750,,False,22.0,1,4,1,2,0,2,0,1,0,1,1,1,1,0,1,0,2
400915367,Wake Forest Demon Deacons,M. Wilbekin,3138222,,False,22.0,1,6,0,3,1,3,0,0,0,1,1,1,1,0,0,4,3
400915367,Wake Forest Demon Deacons,TEAM,TOTAL,TOTAL,False,,23,57,17,36,6,21,10,16,13,19,32,12,5,3,12,22,62
400915367,Virginia Cavaliers,I. Wilkins,3138203,,True,31.0,3,3,2,2,1,1,0,1,3,1,4,1,2,5,2,3,7
400915367,Virginia Cavaliers,J. Salt,3138200,,True,20.0,1,1,1,1,0,0,3,3,1,4,5,2,0,1,0,5,5
400915367,Virginia Cavaliers,M. Shayok,3138201,,True,25.0,6,10,5,8,1,2,4,7,0,4,4,2,0,1,0,1,17
400915367,Virginia Cavaliers,L. Perrantes,66139,,True,35.0,7,13,3,8,4,5,6,6,1,3,4,2,1,0,1,1,24
400915367,Virginia Cavaliers,D. Hall,66138,,True,31.0,5,9,4,6,1,3,2,3,2,6,8,2,0,0,1,1,13
400915367,Virginia Cavaliers,M. Diakite,3947156,,False,10.0,0,2,0,1,0,1,0,0,1,1,2,0,0,1,0,3,0
400915367,Virginia Cavaliers,J. Reuter,3908374,,False,8.0,1,3,1,3,0,0,0,0,0,1,1,0,0,0,0,2,2
400915367,Virginia Cavaliers,T. Jerome,4065733,,False,7.0,1,1,1,1,0,0,0,0,0,0,0,0,0,0,2,2,2
400915367,Virginia Cavaliers,K. Guy,4065730,,False,17.0,0,4,0,1,0,3,2,2,0,2,2,1,0,0,2,0,2
400915367,Virginia Cavaliers,D. Thompson,66274,,False,16.0,2,7,0,3,2,4,1,2,1,1,2,2,1,0,1,0,7
400915367,Virginia Cavaliers,TEAM,TOTAL,TOTAL,False,,26,53,17,34,9,19,18,24,12,25,37,12,4,8,9,18,79
400915367,Virginia Cavaliers,I. Wilkins,3138203,,True,31.0,3,3,2,2,1,1,0,1,3,1,4,1,2,5,2,3,7
400915367,Virginia Cavaliers,J. Salt,3138200,,True,20.0,1,1,1,1,0,0,3,3,1,4,5,2,0,1,0,5,5
400915367,Virginia Cavaliers,M. Shayok,3138201,,True,25.0,6,10,5,8,1,2,4,7,0,4,4,2,0,1,0,1,17
400915367,Virginia Cavaliers,L. Perrantes,66139,,True,35.0,7,13,3,8,4,5,6,6,1,3,4,2,1,0,1,1,24
400915367,Virginia Cavaliers,D. Hall,66138,,True,31.0,5,9,4,6,1,3,2,3,2,6,8,2,0,0,1,1,13
400915367,Virginia Cavaliers,M. Diakite,3947156,,False,10.0,0,2,0,1,0,1,0,0,1,1,2,0,0,1,0,3,0
400915367,Virginia Cavaliers,J. Reuter,3908374,,False,8.0,1,3,1,3,0,0,0,0,0,1,1,0,0,0,0,2,2
400915367,Virginia Cavaliers,T. Jerome,4065733,,False,7.0,1,1,1,1,0,0,0,0,0,0,0,0,0,0,2,2,2
400915367,Virginia Cavaliers,K. Guy,4065730,,False,17.0,0,4,0,1,0,3,2,2,0,2,2,1,0,0,2,0,2
400915367,Virginia Cavaliers,D. Thompson,66274,,False,16.0,2,7,0,3,2,4,1,2,1,1,2,2,1,0,1,0,7
400915367,Virginia Cavaliers,TEAM,TOTAL,TOTAL,False,,26,53,17,34,9,19,18,24,12,25,37,12,4,8,9,18,79
400915365,Notre Dame Fighting Irish,B. Colson,3138192,,True,34.0,5,10,4,7,1,3,2,2,5,7,12,3,0,1,0,2,13
400915365,Notre Dame Fighting Irish,M. Geben,3138191,,True,10.0,1,3,1,3,0,0,0,0,2,1,3,0,0,0,1,2,2
400915365,Notre Dame Fighting Irish,V.J. Beachem,66283,,True,35.0,8,14,2,4,6,10,0,0,0,1,1,1,2,0,2,1,22
400915365,Notre Dame Fighting Irish,M. Farrell,3138190,,True,33.0,5,10,1,3,4,7,1,2,0,1,1,7,2,0,4,3,15
400915365,Notre Dame Fighting Irish,S. Vasturia,66285,,True,39.0,6,15,4,9,2,6,0,0,0,3,3,2,2,0,0,1,14
400915365,Notre Dame Fighting Irish,A. Torres,66286,,False,5.0,0,0,0,0,0,0,0,0,0,0,0,0,0,1,1,2,0
400915365,Notre Dame Fighting Irish,M. Ryan,3908336,,False,3.0,1,2,0,0,1,2,0,0,0,1,1,0,0,0,0,0,3
400915365,Notre Dame Fighting Irish,T. Gibbs,4065703,,False,14.0,0,2,0,1,0,1,1,2,1,1,2,2,0,0,1,1,1
400915365,Notre Dame Fighting Irish,R. Pflueger,3908335,,False,27.0,2,4,1,1,1,3,0,0,1,3,4,3,0,0,0,1,5
400915365,Notre Dame Fighting Irish,TEAM,TOTAL,TOTAL,False,,28,60,13,28,15,32,4,6,11,18,29,18,6,2,10,13,75
400915365,Notre Dame Fighting Irish,B. Colson,3138192,,True,34.0,5,10,4,7,1,3,2,2,5,7,12,3,0,1,0,2,13
400915365,Notre Dame Fighting Irish,M. Geben,3138191,,True,10.0,1,3,1,3,0,0,0,0,2,1,3,0,0,0,1,2,2
400915365,Notre Dame Fighting Irish,V.J. Beachem,66283,,True,35.0,8,14,2,4,6,10,0,0,0,1,1,1,2,0,2,1,22
400915365,Notre Dame Fighting Irish,M. Farrell,3138190,,True,33.0,5,10,1,3,4,7,1,2,0,1,1,7,2,0,4,3,15
400915365,Notre Dame Fighting Irish,S. Vasturia,66285,,True,39.0,6,15,4,9,2,6,0,0,0,3,3,2,2,0,0,1,14
400915365,Notre Dame Fighting Irish,A. Torres,66286,,False,5.0,0,0,0,0,0,0,0,0,0,0,0,0,0,1,1,2,0
400915365,Notre Dame Fighting Irish,M. Ryan,3908336,,False,3.0,1,2,0,0,1,2,0,0,0,1,1,0,0,0,0,0,3
400915365,Notre Dame Fighting Irish,T. Gibbs,4065703,,False,14.0,0,2,0,1,0,1,1,2,1,1,2,2,0,0,1,1,1
400915365,Notre Dame Fighting Irish,R. Pflueger,3908335,,False,27.0,2,4,1,1,1,3,0,0,1,3,4,3,0,0,0,1,5
400915365,Notre Dame Fighting Irish,TEAM,TOTAL,TOTAL,False,,28,60,13,28,15,32,4,6,11,18,29,18,6,2,10,13,75
400915365,Clemson Tigers,D. Grantham,3129674,,True,26.0,3,9,1,4,2,5,0,0,2,2,4,3,2,0,0,0,8
400915365,Clemson Tigers,J. Blossomgame,61835,,True,36.0,9,17,9,16,0,1,4,4,2,6,8,1,0,0,2,0,22
400915365,Clemson Tigers,S. Djitte,66122,,True,17.0,2,3,2,3,0,0,0,0,1,2,3,0,1,0,3,3,4
400915365,Clemson Tigers,S. Mitchell,3136699,,True,31.0,4,6,4,5,0,1,0,0,1,5,6,5,0,0,2,2,8
400915365,Clemson Tigers,A. Holmes,62043,,True,22.0,1,4,0,1,1,3,0,0,0,1,1,3,0,0,2,0,3
400915365,Clemson Tigers,E. Thomas,3947075,,False,23.0,4,6,4,6,0,0,1,2,0,3,3,0,1,4,0,3,9
400915365,Clemson Tigers,M. Reed,3133969,,False,23.0,1,5,1,4,0,1,0,0,1,1,2,2,0,0,2,0,2
400915365,Clemson Tigers,G. DeVoe,3129673,,False,22.0,4,7,0,0,4,7,2,2,0,0,0,0,2,1,1,1,14
400915365,Clemson Tigers,TEAM,TOTAL,TOTAL,False,,28,57,21,39,7,18,7,8,11,22,33,14,6,5,12,9,70
400915365,Clemson Tigers,D. Grantham,3129674,,True,26.0,3,9,1,4,2,5,0,0,2,2,4,3,2,0,0,0,8
400915365,Clemson Tigers,J. Blossomgame,61835,,True,36.0,9,17,9,16,0,1,4,4,2,6,8,1,0,0,2,0,22
400915365,Clemson Tigers,S. Djitte,66122,,True,17.0,2,3,2,3,0,0,0,0,1,2,3,0,1,0,3,3,4
400915365,Clemson Tigers,S. Mitchell,3136699,,True,31.0,4,6,4,5,0,1,0,0,1,5,6,5,0,0,2,2,8
400915365,Clemson Tigers,A. Holmes,62043,,True,22.0,1,4,0,1,1,3,0,0,0,1,1,3,0,0,2,0,3
400915365,Clemson Tigers,E. Thomas,3947075,,False,23.0,4,6,4,6,0,0,1,2,0,3,3,0,1,4,0,3,9
400915365,Clemson Tigers,M. Reed,3133969,,False,23.0,1,5,1,4,0,1,0,0,1,1,2,2,0,0,2,0,2
400915365,Clemson Tigers,G. DeVoe,3129673,,False,22.0,4,7,0,0,4,7,2,2,0,0,0,0,2,1,1,1,14
400915365,Clemson Tigers,TEAM,TOTAL,TOTAL,False,,28,57,21,39,7,18,7,8,11,22,33,14,6,5,12,9,70
400915364,Louisville Cardinals,A. Mahmoud,3147363,,True,22.0,5,6,5,6,0,0,0,2,3,2,5,0,0,2,0,5,10
400915364,Louisville Cardinals,D. Adel,3908807,,True,12.0,2,7,0,4,2,3,0,0,2,1,3,0,0,1,0,0,6
400915364,Louisville Cardinals,R. Spalding,3908806,,True,26.0,3,6,3,6,0,0,0,3,4,8,12,1,2,2,0,3,6
400915364,Louisville Cardinals,D. Mitchell,3908809,,True,36.0,6,15,1,8,5,7,3,5,0,3,3,4,1,3,1,1,20
400915364,Louisville Cardinals,Q. Snider,3147360,,True,39.0,4,10,2,7,2,3,2,2,2,1,3,7,2,0,2,1,12
400915364,Louisville Cardinals,V.J. King,4065666,,False,19.0,1,7,1,5,0,2,2,4,0,1,1,1,0,0,0,0,4
400915364,Louisville Cardinals,J. Johnson,3147362,,False,8.0,0,0,0,0,0,0,0,0,0,1,1,0,0,1,2,3,0
400915364,Louisville Cardinals,M. Mathiang,63035,,False,21.0,2,8,2,8,0,0,3,4,2,4,6,0,0,3,1,3,7
400915364,Louisville Cardinals,R. McMahon,3908808,,False,2.0,0,0,0,0,0,0,0,0,0,0,0,0,0,0,1,1,0
400915364,Louisville Cardinals,J. Henderson,3155491,,False,2.0,0,0,0,0,0,0,0,0,0,1,1,0,0,0,1,0,0
400915364,Louisville Cardinals,D. Levitch,66592,,False,13.0,0,1,0,0,0,1,0,0,1,1,2,1,1,0,0,2,0
400915364,Louisville Cardinals,TEAM,TOTAL,TOTAL,False,,23,60,14,44,9,16,10,20,16,25,41,14,6,12,8,19,65
400915364,Louisville Cardinals,A. Mahmoud,3147363,,True,22.0,5,6,5,6,0,0,0,2,3,2,5,0,0,2,0,5,10
400915364,Louisville Cardinals,D. Adel,3908807,,True,12.0,2,7,0,4,2,3,0,0,2,1,3,0,0,1,0,0,6
400915364,Louisville Cardinals,R. Spalding,3908806,,True,26.0,3,6,3,6,0,0,0,3,4,8,12,1,2,2,0,3,6
400915364,Louisville Cardinals,D. Mitchell,3908809,,True,36.0,6,15,1,8,5,7,3,5,0,3,3,4,1,3,1,1,20
400915364,Louisville Cardinals,Q. Snider,3147360,,True,39.0,4,10,2,7,2,3,2,2,2,1,3,7,2,0,2,1,12
400915364,Louisville Cardinals,V.J. King,4065666,,False,19.0,1,7,1,5,0,2,2,4,0,1,1,1,0,0,0,0,4
400915364,Louisville Cardinals,J. Johnson,3147362,,False,8.0,0,0,0,0,0,0,0,0,0,1,1,0,0,1,2,3,0
400915364,Louisville Cardinals,M. Mathiang,63035,,False,21.0,2,8,2,8,0,0,3,4,2,4,6,0,0,3,1,3,7
400915364,Louisville Cardinals,R. McMahon,3908808,,False,2.0,0,0,0,0,0,0,0,0,0,0,0,0,0,0,1,1,0
400915364,Louisville Cardinals,J. Henderson,3155491,,False,2.0,0,0,0,0,0,0,0,0,0,1,1,0,0,0,1,0,0
400915364,Louisville Cardinals,D. Levitch,66592,,False,13.0,0,1,0,0,0,1,0,0,1,1,2,1,1,0,0,2,0
400915364,Louisville Cardinals,TEAM,TOTAL,TOTAL,False,,23,60,14,44,9,16,10,20,16,25,41,14,6,12,8,19,65
400915364,Georgia Tech Yellow Jackets,Q. Stephens,66128,,True,37.0,0,3,0,2,0,1,1,2,0,4,4,1,1,0,5,2,1
400915364,Georgia Tech Yellow Jackets,B. Lammers,3135061,,True,39.0,9,14,9,14,0,0,6,6,0,9,9,0,0,3,2,4,24
400915364,Georgia Tech Yellow Jackets,J. Okogie,4065663,,True,34.0,5,12,4,10,1,2,4,6,3,4,7,3,0,0,1,1,15
400915364,Georgia Tech Yellow Jackets,J. Moore,4065662,,True,19.0,1,3,1,3,0,0,1,2,0,1,1,1,0,1,1,2,3
400915364,Georgia Tech Yellow Jackets,J. Heath,67623,,True,21.0,0,4,0,3,0,1,0,0,0,0,0,2,0,0,1,4,0
400915364,Georgia Tech Yellow Jackets,A. Gueye,3135059,,False,18.0,1,4,1,4,0,0,0,0,2,2,4,1,0,2,2,1,2
400915364,Georgia Tech Yellow Jackets,T. Jackson,3135057,,False,26.0,1,10,1,6,0,4,3,4,1,1,2,1,0,1,0,4,5
400915364,Georgia Tech Yellow Jackets,C. Heyward,61609,,False,6.0,0,0,0,0,0,0,0,0,0,0,0,2,1,0,1,1,0
400915364,Georgia Tech Yellow Jackets,TEAM,TOTAL,TOTAL,False,,17,50,16,42,1,8,15,20,10,24,34,11,2,7,14,19,50
400915364,Georgia Tech Yellow Jackets,Q. Stephens,66128,,True,37.0,0,3,0,2,0,1,1,2,0,4,4,1,1,0,5,2,1
400915364,Georgia Tech Yellow Jackets,B. Lammers,3135061,,True,39.0,9,14,9,14,0,0,6,6,0,9,9,0,0,3,2,4,24
400915364,Georgia Tech Yellow Jackets,J. Okogie,4065663,,True,34.0,5,12,4,10,1,2,4,6,3,4,7,3,0,0,1,1,15
400915364,Georgia Tech Yellow Jackets,J. Moore,4065662,,True,19.0,1,3,1,3,0,0,1,2,0,1,1,1,0,1,1,2,3
400915364,Georgia Tech Yellow Jackets,J. Heath,67623,,True,21.0,0,4,0,3,0,1,0,0,0,0,0,2,0,0,1,4,0
400915364,Georgia Tech Yellow Jackets,A. Gueye,3135059,,False,18.0,1,4,1,4,0,0,0,0,2,2,4,1,0,2,2,1,2
400915364,Georgia Tech Yellow Jackets,T. Jackson,3135057,,False,26.0,1,10,1,6,0,4,3,4,1,1,2,1,0,1,0,4,5
400915364,Georgia Tech Yellow Jackets,C. Heyward,61609,,False,6.0,0,0,0,0,0,0,0,0,0,0,0,2,1,0,1,1,0
400915364,Georgia Tech Yellow Jackets,TEAM,TOTAL,TOTAL,False,,17,50,16,42,1,8,15,20,10,24,34,11,2,7,14,19,50
400915363,Virginia Tech Hokies,Z. LeDay,61698,,True,32.0,8,11,8,10,0,1,3,3,4,3,7,1,1,1,2,4,19
400915363,Virginia Tech Hokies,C. Clarke,3945567,,True,39.0,7,15,7,15,0,0,8,11,3,5,8,1,2,0,2,5,22
400915363,Virginia Tech Hokies,J. Robinson,3945566,,True,24.0,3,8,2,5,1,3,4,6,2,2,4,4,1,0,5,4,11
400915363,Virginia Tech Hokies,A. Hill,3147501,,True,37.0,5,10,2,5,3,5,3,6,1,5,6,0,0,1,3,4,16
400915363,Virginia Tech Hokies,J. Bibbs,3147500,,True,38.0,2,9,2,6,0,3,0,0,0,2,2,1,1,0,3,4,4
400915363,Virginia Tech Hokies,K. Sy,4065740,,False,8.0,1,3,1,3,0,0,0,0,2,0,2,0,0,1,0,2,2
400915363,Virginia Tech Hokies,M. Galloway,3945565,,False,1.0,0,0,0,0,0,0,0,0,0,0,0,0,1,0,0,1,0
400915363,Virginia Tech Hokies,T. Outlaw,67275,,False,21.0,2,6,2,3,0,3,0,0,0,3,3,0,1,1,1,1,4
400915363,Virginia Tech Hokies,TEAM,TOTAL,TOTAL,False,,28,62,24,47,4,15,18,26,13,21,34,7,7,4,16,25,78
400915363,Virginia Tech Hokies,Z. LeDay,61698,,True,32.0,8,11,8,10,0,1,3,3,4,3,7,1,1,1,2,4,19
400915363,Virginia Tech Hokies,C. Clarke,3945567,,True,39.0,7,15,7,15,0,0,8,11,3,5,8,1,2,0,2,5,22
400915363,Virginia Tech Hokies,J. Robinson,3945566,,True,24.0,3,8,2,5,1,3,4,6,2,2,4,4,1,0,5,4,11
400915363,Virginia Tech Hokies,A. Hill,3147501,,True,37.0,5,10,2,5,3,5,3,6,1,5,6,0,0,1,3,4,16
400915363,Virginia Tech Hokies,J. Bibbs,3147500,,True,38.0,2,9,2,6,0,3,0,0,0,2,2,1,1,0,3,4,4
400915363,Virginia Tech Hokies,K. Sy,4065740,,False,8.0,1,3,1,3,0,0,0,0,2,0,2,0,0,1,0,2,2
400915363,Virginia Tech Hokies,M. Galloway,3945565,,False,1.0,0,0,0,0,0,0,0,0,0,0,0,0,1,0,0,1,0
400915363,Virginia Tech Hokies,T. Outlaw,67275,,False,21.0,2,6,2,3,0,3,0,0,0,3,3,0,1,1,1,1,4
400915363,Virginia Tech Hokies,TEAM,TOTAL,TOTAL,False,,28,62,24,47,4,15,18,26,13,21,34,7,7,4,16,25,78
400915363,Florida State Seminoles,J. Isaac,4065654,,True,26.0,4,7,4,6,0,1,5,6,2,6,8,2,1,1,1,2,13
400915363,Florida State Seminoles,M. Ojo,61596,,True,11.0,1,2,1,2,0,0,0,0,1,0,1,0,1,0,1,1,2
400915363,Florida State Seminoles,T. Mann,3907823,,True,28.0,7,11,5,9,2,2,6,8,3,6,9,1,1,0,1,2,22
400915363,Florida State Seminoles,D. Bacon,3907821,,True,31.0,6,16,6,13,0,3,5,5,3,3,6,1,2,1,4,3,17
400915363,Florida State Seminoles,X. Rathan-Mayes,66125,,True,22.0,1,4,1,3,0,1,2,4,0,1,1,8,0,1,1,3,4
400915363,Florida State Seminoles,P. Cofer,3135054,,False,12.0,0,0,0,0,0,0,0,0,0,1,1,0,0,0,1,2,0
400915363,Florida State Seminoles,J. Smith,66126,,False,17.0,4,6,3,5,1,1,3,4,2,2,4,0,0,2,0,1,12
400915363,Florida State Seminoles,B. Allen,66124,,False,0.0,0,0,0,0,0,0,0,0,0,0,0,0,1,0,0,0,0
400915363,Florida State Seminoles,C. Koumadje,3907824,,False,3.0,1,1,1,1,0,0,0,0,0,0,0,0,2,1,1,1,2
400915363,Florida State Seminoles,B. Angola-Rodas,4065658,,False,12.0,1,1,1,1,0,0,1,2,2,2,4,3,0,0,0,1,3
400915363,Florida State Seminoles,P. Savoy,4065657,,False,7.0,4,7,1,1,3,6,0,1,0,0,0,0,0,0,0,0,11
400915363,Florida State Seminoles,T. Forrest,4065656,,False,18.0,0,4,0,4,0,0,0,0,0,1,1,2,2,0,2,2,0
400915363,Florida State Seminoles,C. Walker,4065655,,False,13.0,2,4,1,1,1,3,2,2,1,1,2,0,1,0,0,2,7
400915363,Florida State Seminoles,TEAM,TOTAL,TOTAL,False,,31,63,24,46,7,17,24,32,14,25,39,17,11,6,13,20,93
400915363,Florida State Seminoles,J. Isaac,4065654,,True,26.0,4,7,4,6,0,1,5,6,2,6,8,2,1,1,1,2,13
400915363,Florida State Seminoles,M. Ojo,61596,,True,11.0,1,2,1,2,0,0,0,0,1,0,1,0,1,0,1,1,2
400915363,Florida State Seminoles,T. Mann,3907823,,True,28.0,7,11,5,9,2,2,6,8,3,6,9,1,1,0,1,2,22
400915363,Florida State Seminoles,D. Bacon,3907821,,True,31.0,6,16,6,13,0,3,5,5,3,3,6,1,2,1,4,3,17
400915363,Florida State Seminoles,X. Rathan-Mayes,66125,,True,22.0,1,4,1,3,0,1,2,4,0,1,1,8,0,1,1,3,4
400915363,Florida State Seminoles,P. Cofer,3135054,,False,12.0,0,0,0,0,0,0,0,0,0,1,1,0,0,0,1,2,0
400915363,Florida State Seminoles,J. Smith,66126,,False,17.0,4,6,3,5,1,1,3,4,2,2,4,0,0,2,0,1,12
400915363,Florida State Seminoles,B. Allen,66124,,False,0.0,0,0,0,0,0,0,0,0,0,0,0,0,1,0,0,0,0
400915363,Florida State Seminoles,C. Koumadje,3907824,,False,3.0,1,1,1,1,0,0,0,0,0,0,0,0,2,1,1,1,2
400915363,Florida State Seminoles,B. Angola-Rodas,4065658,,False,12.0,1,1,1,1,0,0,1,2,2,2,4,3,0,0,0,1,3
400915363,Florida State Seminoles,P. Savoy,4065657,,False,7.0,4,7,1,1,3,6,0,1,0,0,0,0,0,0,0,0,11
400915363,Florida State Seminoles,T. Forrest,4065656,,False,18.0,0,4,0,4,0,0,0,0,0,1,1,2,2,0,2,2,0
400915363,Florida State Seminoles,C. Walker,4065655,,False,13.0,2,4,1,1,1,3,2,2,1,1,2,0,1,0,0,2,7
400915363,Florida State Seminoles,TEAM,TOTAL,TOTAL,False,,31,63,24,46,7,17,24,32,14,25,39,17,11,6,13,20,93
400915362,Duke Blue Devils,H. Giles III,4065649,,True,24.0,5,8,5,8,0,0,2,3,1,4,5,1,1,1,1,5,12
400915362,Duke Blue Devils,J. Tatum,4065648,,True,30.0,6,9,5,7,1,2,9,10,1,5,6,3,4,2,5,4,22
400915362,Duke Blue Devils,A. Jefferson,61586,,True,13.0,5,7,5,7,0,0,1,2,0,2,2,2,0,0,0,0,11
400915362,Duke Blue Devils,L. Kennard,3913174,,True,28.0,2,6,1,4,1,2,4,5,1,3,4,1,1,1,0,3,9
400915362,Duke Blue Devils,G. Allen,3135045,,True,37.0,5,9,3,3,2,6,0,2,0,5,5,11,3,0,5,2,12
400915362,Duke Blue Devils,M. Bolden,4065652,,False,7.0,0,1,0,1,0,0,2,2,0,0,0,0,1,0,1,4,2
400915362,Duke Blue Devils,F. Jackson,4065651,,False,25.0,4,9,2,3,2,6,5,8,1,2,3,0,1,0,1,0,15
400915362,Duke Blue Devils,M. Jones,66563,,False,36.0,4,7,2,2,2,5,0,0,0,2,2,2,2,0,3,1,10
400915362,Duke Blue Devils,TEAM,TOTAL,TOTAL,False,,31,56,23,35,8,21,23,32,4,23,27,20,13,4,16,19,93
400915362,Duke Blue Devils,H. Giles III,4065649,,True,24.0,5,8,5,8,0,0,2,3,1,4,5,1,1,1,1,5,12
400915362,Duke Blue Devils,J. Tatum,4065648,,True,30.0,6,9,5,7,1,2,9,10,1,5,6,3,4,2,5,4,22
400915362,Duke Blue Devils,A. Jefferson,61586,,True,13.0,5,7,5,7,0,0,1,2,0,2,2,2,0,0,0,0,11
400915362,Duke Blue Devils,L. Kennard,3913174,,True,28.0,2,6,1,4,1,2,4,5,1,3,4,1,1,1,0,3,9
400915362,Duke Blue Devils,G. Allen,3135045,,True,37.0,5,9,3,3,2,6,0,2,0,5,5,11,3,0,5,2,12
400915362,Duke Blue Devils,M. Bolden,4065652,,False,7.0,0,1,0,1,0,0,2,2,0,0,0,0,1,0,1,4,2
400915362,Duke Blue Devils,F. Jackson,4065651,,False,25.0,4,9,2,3,2,6,5,8,1,2,3,0,1,0,1,0,15
400915362,Duke Blue Devils,M. Jones,66563,,False,36.0,4,7,2,2,2,5,0,0,0,2,2,2,2,0,3,1,10
400915362,Duke Blue Devils,TEAM,TOTAL,TOTAL,False,,31,56,23,35,8,21,23,32,4,23,27,20,13,4,16,19,93
400915362,Boston College Eagles,A.J. Turner,3943608,,True,35.0,5,9,4,5,1,4,2,2,1,5,6,5,0,0,1,4,13
400915362,Boston College Eagles,M. Jeffers,61901,,True,29.0,3,4,3,4,0,0,2,2,4,8,12,1,0,0,2,1,8
400915362,Boston College Eagles,C. Tava,61446,,True,25.0,2,3,2,3,0,0,2,4,2,2,4,1,2,0,4,3,6
400915362,Boston College Eagles,K. Bowman,4065635,,True,36.0,8,15,8,12,0,3,3,5,0,3,3,4,3,0,5,3,19
400915362,Boston College Eagles,J. Robinson,3943606,,True,32.0,8,18,7,15,1,3,4,4,0,2,2,0,1,0,5,4,21
400915362,Boston College Eagles,N. Popovic,4065637,,False,9.0,1,5,1,5,0,0,2,2,0,4,4,0,0,0,1,2,4
400915362,Boston College Eagles,G. Owens,66277,,False,9.0,1,1,1,1,0,0,0,0,1,2,3,1,0,1,1,3,2
400915362,Boston College Eagles,J. Chatman,3135095,,False,25.0,4,7,3,3,1,4,0,0,0,0,0,0,1,0,2,3,9
400915362,Boston College Eagles,TEAM,TOTAL,TOTAL,False,,32,62,29,48,3,14,15,19,8,28,36,12,7,1,21,23,82
400915362,Boston College Eagles,A.J. Turner,3943608,,True,35.0,5,9,4,5,1,4,2,2,1,5,6,5,0,0,1,4,13
400915362,Boston College Eagles,M. Jeffers,61901,,True,29.0,3,4,3,4,0,0,2,2,4,8,12,1,0,0,2,1,8
400915362,Boston College Eagles,C. Tava,61446,,True,25.0,2,3,2,3,0,0,2,4,2,2,4,1,2,0,4,3,6
400915362,Boston College Eagles,K. Bowman,4065635,,True,36.0,8,15,8,12,0,3,3,5,0,3,3,4,3,0,5,3,19
400915362,Boston College Eagles,J. Robinson,3943606,,True,32.0,8,18,7,15,1,3,4,4,0,2,2,0,1,0,5,4,21
400915362,Boston College Eagles,N. Popovic,4065637,,False,9.0,1,5,1,5,0,0,2,2,0,4,4,0,0,0,1,2,4
400915362,Boston College Eagles,G. Owens,66277,,False,9.0,1,1,1,1,0,0,0,0,1,2,3,1,0,1,1,3,2
400915362,Boston College Eagles,J. Chatman,3135095,,False,25.0,4,7,3,3,1,4,0,0,0,0,0,0,1,0,2,3,9
400915362,Boston College Eagles,TEAM,TOTAL,TOTAL,False,,32,62,29,48,3,14,15,19,8,28,36,12,7,1,21,23,82
400915361,Syracuse Orange,T. Thompson,4065721,,True,10.0,2,3,2,3,0,0,0,0,0,0,0,0,0,0,1,3,4
400915361,Syracuse Orange,T. Lydon,3934662,,True,34.0,5,9,4,7,1,2,2,2,1,4,5,3,0,2,1,4,13
400915361,Syracuse Orange,A. White III,61616,,True,40.0,7,14,3,6,4,8,3,4,0,7,7,0,2,1,3,3,21
400915361,Syracuse Orange,T. Battle,4065722,,True,40.0,6,9,3,4,3,5,0,0,0,1,1,1,3,0,0,1,15
400915361,Syracuse Orange,J. Gillon,61915,,True,40.0,6,16,0,4,6,12,2,2,0,2,2,11,2,0,4,2,20
400915361,Syracuse Orange,T. Roberson,67633,,False,36.0,2,3,2,3,0,0,0,0,5,5,10,2,0,6,0,2,4
400915361,Syracuse Orange,TEAM,TOTAL,TOTAL,False,,28,54,14,27,14,27,7,8,7,22,29,17,7,9,10,15,77
400915361,Syracuse Orange,T. Thompson,4065721,,True,10.0,2,3,2,3,0,0,0,0,0,0,0,0,0,0,1,3,4
400915361,Syracuse Orange,T. Lydon,3934662,,True,34.0,5,9,4,7,1,2,2,2,1,4,5,3,0,2,1,4,13
400915361,Syracuse Orange,A. White III,61616,,True,40.0,7,14,3,6,4,8,3,4,0,7,7,0,2,1,3,3,21
400915361,Syracuse Orange,T. Battle,4065722,,True,40.0,6,9,3,4,3,5,0,0,0,1,1,1,3,0,0,1,15
400915361,Syracuse Orange,J. Gillon,61915,,True,40.0,6,16,0,4,6,12,2,2,0,2,2,11,2,0,4,2,20
400915361,Syracuse Orange,T. Roberson,67633,,False,36.0,2,3,2,3,0,0,0,0,5,5,10,2,0,6,0,2,4
400915361,Syracuse Orange,TEAM,TOTAL,TOTAL,False,,28,54,14,27,14,27,7,8,7,22,29,17,7,9,10,15,77
400915361,Pittsburgh Panthers,M. Young,66290,,True,33.0,6,15,5,13,1,2,4,4,4,3,7,0,1,0,0,3,17
400915361,Pittsburgh Panthers,J. Artis,66287,,True,38.0,6,14,2,5,4,9,7,9,1,4,5,1,0,1,4,2,23
400915361,Pittsburgh Panthers,S. Jeter,61756,,True,31.0,3,10,3,10,0,0,6,7,7,4,11,2,3,3,3,2,12
400915361,Pittsburgh Panthers,C. Johnson,3138196,,True,35.0,2,10,1,3,1,7,2,2,2,4,6,4,0,0,1,2,7
400915361,Pittsburgh Panthers,C. Jones,61219,,True,35.0,3,5,3,5,0,0,1,1,0,2,2,2,0,0,0,2,7
400915361,Pittsburgh Panthers,R. Luther,3138197,,False,16.0,0,1,0,1,0,0,0,0,0,1,1,2,1,0,1,1,0
400915361,Pittsburgh Panthers,J. Kithcart,4065713,,False,2.0,0,0,0,0,0,0,0,0,0,0,0,0,0,0,1,0,0
400915361,Pittsburgh Panthers,J. Milligan,3934655,,False,7.0,0,2,0,1,0,1,0,0,1,1,2,0,0,0,1,0,0
400915361,Pittsburgh Panthers,D. Wilson,3934652,,False,3.0,0,0,0,0,0,0,0,0,0,0,0,0,0,0,0,2,0
400915361,Pittsburgh Panthers,TEAM,TOTAL,TOTAL,False,,20,57,14,38,6,19,20,23,17,20,37,11,5,4,12,14,66
400915361,Pittsburgh Panthers,M. Young,66290,,True,33.0,6,15,5,13,1,2,4,4,4,3,7,0,1,0,0,3,17
400915361,Pittsburgh Panthers,J. Artis,66287,,True,38.0,6,14,2,5,4,9,7,9,1,4,5,1,0,1,4,2,23
400915361,Pittsburgh Panthers,S. Jeter,61756,,True,31.0,3,10,3,10,0,0,6,7,7,4,11,2,3,3,3,2,12
400915361,Pittsburgh Panthers,C. Johnson,3138196,,True,35.0,2,10,1,3,1,7,2,2,2,4,6,4,0,0,1,2,7
400915361,Pittsburgh Panthers,C. Jones,61219,,True,35.0,3,5,3,5,0,0,1,1,0,2,2,2,0,0,0,2,7
400915361,Pittsburgh Panthers,R. Luther,3138197,,False,16.0,0,1,0,1,0,0,0,0,0,1,1,2,1,0,1,1,0
400915361,Pittsburgh Panthers,J. Kithcart,4065713,,False,2.0,0,0,0,0,0,0,0,0,0,0,0,0,0,0,1,0,0
400915361,Pittsburgh Panthers,J. Milligan,3934655,,False,7.0,0,2,0,1,0,1,0,0,1,1,2,0,0,0,1,0,0
400915361,Pittsburgh Panthers,D. Wilson,3934652,,False,3.0,0,0,0,0,0,0,0,0,0,0,0,0,0,0,0,2,0
400915361,Pittsburgh Panthers,TEAM,TOTAL,TOTAL,False,,20,57,14,38,6,19,20,23,17,20,37,11,5,4,12,14,66
400915360,Virginia Cavaliers,I. Wilkins,3138203,,True,31.0,4,6,4,6,0,0,0,0,3,4,7,1,0,1,1,3,8
400915360,Virginia Cavaliers,J. Salt,3138200,,True,2.0,0,0,0,0,0,0,0,0,0,0,0,0,0,0,0,1,0
400915360,Virginia Cavaliers,K. Guy,4065730,,True,23.0,1,7,1,5,0,2,0,0,0,0,0,3,0,0,2,0,2
400915360,Virginia Cavaliers,L. Perrantes,66139,,True,38.0,6,9,3,4,3,5,1,1,0,2,2,3,0,0,0,3,16
400915360,Virginia Cavaliers,D. Hall,66138,,True,39.0,6,13,4,7,2,6,1,1,2,7,9,1,1,1,0,3,15
400915360,Virginia Cavaliers,M. Diakite,3947156,,False,11.0,0,2,0,1,0,1,0,0,0,0,0,2,0,1,0,4,0
400915360,Virginia Cavaliers,J. Reuter,3908374,,False,23.0,5,9,5,9,0,0,0,0,0,1,1,1,0,0,0,3,10
400915360,Virginia Cavaliers,T. Jerome,4065733,,False,2.0,0,0,0,0,0,0,0,0,0,0,0,0,0,0,0,0,0
400915360,Virginia Cavaliers,M. Shayok,3138201,,False,30.0,6,13,4,9,2,4,0,1,1,3,4,2,0,0,2,4,14
400915360,Virginia Cavaliers,D. Thompson,66274,,False,26.0,5,8,4,6,1,2,0,2,0,1,1,2,1,0,1,0,11
400915360,Virginia Cavaliers,TEAM,TOTAL,TOTAL,False,,33,67,25,47,8,20,2,5,6,18,24,15,2,3,6,21,76
400915360,Virginia Cavaliers,I. Wilkins,3138203,,True,31.0,4,6,4,6,0,0,0,0,3,4,7,1,0,1,1,3,8
400915360,Virginia Cavaliers,J. Salt,3138200,,True,2.0,0,0,0,0,0,0,0,0,0,0,0,0,0,0,0,1,0
400915360,Virginia Cavaliers,K. Guy,4065730,,True,23.0,1,7,1,5,0,2,0,0,0,0,0,3,0,0,2,0,2
400915360,Virginia Cavaliers,L. Perrantes,66139,,True,38.0,6,9,3,4,3,5,1,1,0,2,2,3,0,0,0,3,16
400915360,Virginia Cavaliers,D. Hall,66138,,True,39.0,6,13,4,7,2,6,1,1,2,7,9,1,1,1,0,3,15
400915360,Virginia Cavaliers,M. Diakite,3947156,,False,11.0,0,2,0,1,0,1,0,0,0,0,0,2,0,1,0,4,0
400915360,Virginia Cavaliers,J. Reuter,3908374,,False,23.0,5,9,5,9,0,0,0,0,0,1,1,1,0,0,0,3,10
400915360,Virginia Cavaliers,T. Jerome,4065733,,False,2.0,0,0,0,0,0,0,0,0,0,0,0,0,0,0,0,0,0
400915360,Virginia Cavaliers,M. Shayok,3138201,,False,30.0,6,13,4,9,2,4,0,1,1,3,4,2,0,0,2,4,14
400915360,Virginia Cavaliers,D. Thompson,66274,,False,26.0,5,8,4,6,1,2,0,2,0,1,1,2,1,0,1,0,11
400915360,Virginia Cavaliers,TEAM,TOTAL,TOTAL,False,,33,67,25,47,8,20,2,5,6,18,24,15,2,3,6,21,76
400915360,Pittsburgh Panthers,M. Young,66290,,True,41.0,8,18,8,15,0,3,3,7,1,5,6,5,0,0,4,3,19
400915360,Pittsburgh Panthers,S. Jeter,61756,,True,30.0,5,7,2,2,3,5,3,4,3,5,8,3,0,0,0,2,16
400915360,Pittsburgh Panthers,J. Artis,66287,,True,42.0,6,12,0,5,6,7,6,12,1,6,7,4,0,1,3,1,24
400915360,Pittsburgh Panthers,C. Johnson,3138196,,True,41.0,4,6,0,1,4,5,4,4,1,7,8,1,0,1,1,3,16
400915360,Pittsburgh Panthers,C. Jones,61219,,True,38.0,2,4,2,4,0,0,1,1,1,4,5,3,0,0,2,4,5
400915360,Pittsburgh Panthers,R. Luther,3138197,,False,20.0,4,6,4,5,0,1,0,0,2,2,4,0,0,1,3,2,8
400915360,Pittsburgh Panthers,J. Kithcart,4065713,,False,13.0,0,1,0,1,0,0,0,0,0,0,0,0,0,0,1,1,0
400915360,Pittsburgh Panthers,TEAM,TOTAL,TOTAL,False,,29,54,16,33,13,21,17,28,12,30,42,16,0,3,14,16,88
400915360,Pittsburgh Panthers,M. Young,66290,,True,41.0,8,18,8,15,0,3,3,7,1,5,6,5,0,0,4,3,19
400915360,Pittsburgh Panthers,S. Jeter,61756,,True,30.0,5,7,2,2,3,5,3,4,3,5,8,3,0,0,0,2,16
400915360,Pittsburgh Panthers,J. Artis,66287,,True,42.0,6,12,0,5,6,7,6,12,1,6,7,4,0,1,3,1,24
400915360,Pittsburgh Panthers,C. Johnson,3138196,,True,41.0,4,6,0,1,4,5,4,4,1,7,8,1,0,1,1,3,16
400915360,Pittsburgh Panthers,C. Jones,61219,,True,38.0,2,4,2,4,0,0,1,1,1,4,5,3,0,0,2,4,5
400915360,Pittsburgh Panthers,R. Luther,3138197,,False,20.0,4,6,4,5,0,1,0,0,2,2,4,0,0,1,3,2,8
400915360,Pittsburgh Panthers,J. Kithcart,4065713,,False,13.0,0,1,0,1,0,0,0,0,0,0,0,0,0,0,1,1,0
400915360,Pittsburgh Panthers,TEAM,TOTAL,TOTAL,False,,29,54,16,33,13,21,17,28,12,30,42,16,0,3,14,16,88
400915359,Notre Dame Fighting Irish,B. Colson,3138192,,True,35.0,5,14,5,14,0,0,8,10,5,9,14,0,1,3,1,1,18
400915359,Notre Dame Fighting Irish,M. Geben,3138191,,True,18.0,0,1,0,1,0,0,0,0,0,3,3,0,0,0,1,0,0
400915359,Notre Dame Fighting Irish,V.J. Beachem,66283,,True,34.0,1,3,1,3,0,0,0,0,1,2,3,1,1,1,0,2,2
400915359,Notre Dame Fighting Irish,M. Farrell,3138190,,True,38.0,6,15,4,11,2,4,8,9,0,3,3,2,1,0,4,4,22
400915359,Notre Dame Fighting Irish,S. Vasturia,66285,,True,37.0,9,15,7,11,2,4,4,4,0,6,6,1,1,1,3,2,24
400915359,Notre Dame Fighting Irish,A. Torres,66286,,False,4.0,2,2,2,2,0,0,2,2,1,0,1,0,1,2,0,2,6
400915359,Notre Dame Fighting Irish,M. Ryan,3908336,,False,3.0,0,1,0,0,0,1,0,0,0,0,0,1,0,0,0,1,0
400915359,Notre Dame Fighting Irish,T. Gibbs,4065703,,False,12.0,1,4,1,3,0,1,0,0,0,2,2,1,0,0,0,2,2
400915359,Notre Dame Fighting Irish,R. Pflueger,3908335,,False,19.0,1,2,0,0,1,2,0,0,1,1,2,0,0,0,3,3,3
400915359,Notre Dame Fighting Irish,TEAM,TOTAL,TOTAL,False,,25,57,20,45,5,12,22,25,11,27,38,6,5,7,12,17,77
400915359,Notre Dame Fighting Irish,B. Colson,3138192,,True,35.0,5,14,5,14,0,0,8,10,5,9,14,0,1,3,1,1,18
400915359,Notre Dame Fighting Irish,M. Geben,3138191,,True,18.0,0,1,0,1,0,0,0,0,0,3,3,0,0,0,1,0,0
400915359,Notre Dame Fighting Irish,V.J. Beachem,66283,,True,34.0,1,3,1,3,0,0,0,0,1,2,3,1,1,1,0,2,2
400915359,Notre Dame Fighting Irish,M. Farrell,3138190,,True,38.0,6,15,4,11,2,4,8,9,0,3,3,2,1,0,4,4,22
400915359,Notre Dame Fighting Irish,S. Vasturia,66285,,True,37.0,9,15,7,11,2,4,4,4,0,6,6,1,1,1,3,2,24
400915359,Notre Dame Fighting Irish,A. Torres,66286,,False,4.0,2,2,2,2,0,0,2,2,1,0,1,0,1,2,0,2,6
400915359,Notre Dame Fighting Irish,M. Ryan,3908336,,False,3.0,0,1,0,0,0,1,0,0,0,0,0,1,0,0,0,1,0
400915359,Notre Dame Fighting Irish,T. Gibbs,4065703,,False,12.0,1,4,1,3,0,1,0,0,0,2,2,1,0,0,0,2,2
400915359,Notre Dame Fighting Irish,R. Pflueger,3908335,,False,19.0,1,2,0,0,1,2,0,0,1,1,2,0,0,0,3,3,3
400915359,Notre Dame Fighting Irish,TEAM,TOTAL,TOTAL,False,,25,57,20,45,5,12,22,25,11,27,38,6,5,7,12,17,77
400915359,Louisville Cardinals,D. Adel,3908807,,True,28.0,4,13,3,7,1,6,1,2,2,2,4,2,0,0,2,4,10
400915359,Louisville Cardinals,R. Spalding,3908806,,True,24.0,3,6,3,6,0,0,0,1,3,7,10,0,0,1,4,4,6
400915359,Louisville Cardinals,A. Mahmoud,3147363,,True,27.0,2,4,2,4,0,0,2,2,4,0,4,2,1,6,0,4,6
400915359,Louisville Cardinals,D. Mitchell,3908809,,True,39.0,7,20,5,10,2,10,4,4,0,4,4,5,5,0,1,0,20
400915359,Louisville Cardinals,Q. Snider,3147360,,True,32.0,4,10,1,3,3,7,1,2,1,0,1,3,1,0,0,3,12
400915359,Louisville Cardinals,V.J. King,4065666,,False,9.0,1,3,1,2,0,1,0,0,0,1,1,1,0,0,2,1,2
400915359,Louisville Cardinals,J. Johnson,3147362,,False,16.0,1,2,1,2,0,0,3,4,1,3,4,0,0,0,1,4,5
400915359,Louisville Cardinals,M. Mathiang,63035,,False,13.0,2,3,2,3,0,0,0,0,2,1,3,0,1,0,1,1,4
400915359,Louisville Cardinals,R. McMahon,3908808,,False,5.0,1,3,0,0,1,3,2,3,0,1,1,0,0,0,0,0,5
400915359,Louisville Cardinals,D. Levitch,66592,,False,5.0,0,0,0,0,0,0,0,0,0,0,0,1,0,0,0,0,0
400915359,Louisville Cardinals,T. Hicks,62752,,False,2.0,0,0,0,0,0,0,0,0,0,0,0,0,0,0,0,0,0
400915359,Louisville Cardinals,TEAM,TOTAL,TOTAL,False,,25,64,18,37,7,27,13,18,14,21,35,14,8,7,11,21,70
400915359,Louisville Cardinals,D. Adel,3908807,,True,28.0,4,13,3,7,1,6,1,2,2,2,4,2,0,0,2,4,10
400915359,Louisville Cardinals,R. Spalding,3908806,,True,24.0,3,6,3,6,0,0,0,1,3,7,10,0,0,1,4,4,6
400915359,Louisville Cardinals,A. Mahmoud,3147363,,True,27.0,2,4,2,4,0,0,2,2,4,0,4,2,1,6,0,4,6
400915359,Louisville Cardinals,D. Mitchell,3908809,,True,39.0,7,20,5,10,2,10,4,4,0,4,4,5,5,0,1,0,20
400915359,Louisville Cardinals,Q. Snider,3147360,,True,32.0,4,10,1,3,3,7,1,2,1,0,1,3,1,0,0,3,12
400915359,Louisville Cardinals,V.J. King,4065666,,False,9.0,1,3,1,2,0,1,0,0,0,1,1,1,0,0,2,1,2
400915359,Louisville Cardinals,J. Johnson,3147362,,False,16.0,1,2,1,2,0,0,3,4,1,3,4,0,0,0,1,4,5
400915359,Louisville Cardinals,M. Mathiang,63035,,False,13.0,2,3,2,3,0,0,0,0,2,1,3,0,1,0,1,1,4
400915359,Louisville Cardinals,R. McMahon,3908808,,False,5.0,1,3,0,0,1,3,2,3,0,1,1,0,0,0,0,0,5
400915359,Louisville Cardinals,D. Levitch,66592,,False,5.0,0,0,0,0,0,0,0,0,0,0,0,1,0,0,0,0,0
400915359,Louisville Cardinals,T. Hicks,62752,,False,2.0,0,0,0,0,0,0,0,0,0,0,0,0,0,0,0,0,0
400915359,Louisville Cardinals,TEAM,TOTAL,TOTAL,False,,25,64,18,37,7,27,13,18,14,21,35,14,8,7,11,21,70
400915358,Virginia Tech Hokies,Z. LeDay,61698,,True,37.0,5,12,2,6,3,6,3,4,2,4,6,2,1,0,1,4,16
400915358,Virginia Tech Hokies,C. Clarke,3945567,,True,32.0,5,12,5,11,0,1,5,8,1,3,4,5,3,0,4,2,15
400915358,Virginia Tech Hokies,J. Robinson,3945566,,True,27.0,4,7,2,3,2,4,3,5,1,1,2,5,2,0,3,5,13
400915358,Virginia Tech Hokies,A. Hill,3147501,,True,33.0,5,11,1,1,4,10,3,4,0,1,1,2,0,0,2,4,17
400915358,Virginia Tech Hokies,J. Bibbs,3147500,,True,31.0,1,5,0,2,1,3,0,0,0,6,6,2,0,0,2,3,3
400915358,Virginia Tech Hokies,M. Galloway,3945565,,False,1.0,0,0,0,0,0,0,0,0,0,0,0,0,0,0,0,1,0
400915358,Virginia Tech Hokies,T. Outlaw,67275,,False,18.0,3,5,0,0,3,5,0,0,0,1,1,0,2,1,2,2,9
400915358,Virginia Tech Hokies,S. Allen,61795,,False,21.0,2,6,2,5,0,1,1,3,0,1,1,2,0,0,6,1,5
400915358,Virginia Tech Hokies,TEAM,TOTAL,TOTAL,False,,25,58,12,28,13,30,15,24,6,19,25,18,8,1,20,22,78
400915358,Virginia Tech Hokies,Z. LeDay,61698,,True,37.0,5,12,2,6,3,6,3,4,2,4,6,2,1,0,1,4,16
400915358,Virginia Tech Hokies,C. Clarke,3945567,,True,32.0,5,12,5,11,0,1,5,8,1,3,4,5,3,0,4,2,15
400915358,Virginia Tech Hokies,J. Robinson,3945566,,True,27.0,4,7,2,3,2,4,3,5,1,1,2,5,2,0,3,5,13
400915358,Virginia Tech Hokies,A. Hill,3147501,,True,33.0,5,11,1,1,4,10,3,4,0,1,1,2,0,0,2,4,17
400915358,Virginia Tech Hokies,J. Bibbs,3147500,,True,31.0,1,5,0,2,1,3,0,0,0,6,6,2,0,0,2,3,3
400915358,Virginia Tech Hokies,M. Galloway,3945565,,False,1.0,0,0,0,0,0,0,0,0,0,0,0,0,0,0,0,1,0
400915358,Virginia Tech Hokies,T. Outlaw,67275,,False,18.0,3,5,0,0,3,5,0,0,0,1,1,0,2,1,2,2,9
400915358,Virginia Tech Hokies,S. Allen,61795,,False,21.0,2,6,2,5,0,1,1,3,0,1,1,2,0,0,6,1,5
400915358,Virginia Tech Hokies,TEAM,TOTAL,TOTAL,False,,25,58,12,28,13,30,15,24,6,19,25,18,8,1,20,22,78
400915358,NC State Wolfpack,A. Abu,3138158,,True,36.0,9,9,9,9,0,0,2,3,3,8,11,1,1,3,5,3,20
400915358,NC State Wolfpack,O. Yurtseven,66768,,True,13.0,2,2,2,2,0,0,0,0,0,4,4,0,0,1,1,4,4
400915358,NC State Wolfpack,D. Smith Jr.,4065697,,True,34.0,9,16,9,15,0,1,9,15,2,9,11,11,5,0,5,2,27
400915358,NC State Wolfpack,T. Dorn,3132359,,True,18.0,2,4,1,3,1,1,0,0,0,4,4,0,1,0,2,0,5
400915358,NC State Wolfpack,T. Henderson,61215,,True,33.0,7,13,3,5,4,8,4,5,0,0,0,2,0,1,0,2,22
400915358,NC State Wolfpack,T. Kapita,4065701,,False,2.0,0,0,0,0,0,0,0,0,1,0,1,0,0,0,1,2,0
400915358,NC State Wolfpack,D. Hicks,4065698,,False,5.0,1,1,1,1,0,0,0,0,0,0,0,1,0,0,0,0,2
400915358,NC State Wolfpack,T. Thompson,3151470,,False,1.0,0,0,0,0,0,0,0,0,0,0,0,0,0,0,0,0,0
400915358,NC State Wolfpack,C. Brickhouse,67562,,False,1.0,0,0,0,0,0,0,0,0,0,0,0,0,0,0,0,0,0
400915358,NC State Wolfpack,B. Anya,66134,,False,19.0,2,2,2,2,0,0,0,0,0,3,3,1,0,1,1,4,4
400915358,NC State Wolfpack,M. Johnson,4065699,,False,9.0,2,3,2,2,0,1,0,0,0,0,0,1,1,0,0,2,4
400915358,NC State Wolfpack,M. Rowan,3947151,,False,27.0,6,13,5,7,1,6,0,0,0,3,3,4,3,0,2,1,13
400915358,NC State Wolfpack,S. Kirk,3947150,,False,1.0,1,1,1,1,0,0,1,1,0,1,1,0,0,0,0,0,3
400915358,NC State Wolfpack,C. Corchiani Jr.,3138159,,False,1.0,0,0,0,0,0,0,0,0,0,0,0,0,0,0,0,1,0
400915358,NC State Wolfpack,TEAM,TOTAL,TOTAL,False,,41,64,35,47,6,17,16,24,7,33,40,21,11,6,17,21,104
400915358,NC State Wolfpack,A. Abu,3138158,,True,36.0,9,9,9,9,0,0,2,3,3,8,11,1,1,3,5,3,20
400915358,NC State Wolfpack,O. Yurtseven,66768,,True,13.0,2,2,2,2,0,0,0,0,0,4,4,0,0,1,1,4,4
400915358,NC State Wolfpack,D. Smith Jr.,4065697,,True,34.0,9,16,9,15,0,1,9,15,2,9,11,11,5,0,5,2,27
400915358,NC State Wolfpack,T. Dorn,3132359,,True,18.0,2,4,1,3,1,1,0,0,0,4,4,0,1,0,2,0,5
400915358,NC State Wolfpack,T. Henderson,61215,,True,33.0,7,13,3,5,4,8,4,5,0,0,0,2,0,1,0,2,22
400915358,NC State Wolfpack,T. Kapita,4065701,,False,2.0,0,0,0,0,0,0,0,0,1,0,1,0,0,0,1,2,0
400915358,NC State Wolfpack,D. Hicks,4065698,,False,5.0,1,1,1,1,0,0,0,0,0,0,0,1,0,0,0,0,2
400915358,NC State Wolfpack,T. Thompson,3151470,,False,1.0,0,0,0,0,0,0,0,0,0,0,0,0,0,0,0,0,0
400915358,NC State Wolfpack,C. Brickhouse,67562,,False,1.0,0,0,0,0,0,0,0,0,0,0,0,0,0,0,0,0,0
400915358,NC State Wolfpack,B. Anya,66134,,False,19.0,2,2,2,2,0,0,0,0,0,3,3,1,0,1,1,4,4
400915358,NC State Wolfpack,M. Johnson,4065699,,False,9.0,2,3,2,2,0,1,0,0,0,0,0,1,1,0,0,2,4
400915358,NC State Wolfpack,M. Rowan,3947151,,False,27.0,6,13,5,7,1,6,0,0,0,3,3,4,3,0,2,1,13
400915358,NC State Wolfpack,S. Kirk,3947150,,False,1.0,1,1,1,1,0,0,1,1,0,1,1,0,0,0,0,0,3
400915358,NC State Wolfpack,C. Corchiani Jr.,3138159,,False,1.0,0,0,0,0,0,0,0,0,0,0,0,0,0,0,0,1,0
400915358,NC State Wolfpack,TEAM,TOTAL,TOTAL,False,,41,64,35,47,6,17,16,24,7,33,40,21,11,6,17,21,104
400915357,Syracuse Orange,T. Thompson,4065721,,True,5.0,1,1,1,1,0,0,0,0,0,0,0,0,0,0,1,2,2
400915357,Syracuse Orange,T. Lydon,3934662,,True,39.0,7,13,5,10,2,3,4,4,2,5,7,1,1,3,3,2,20
400915357,Syracuse Orange,A. White III,61616,,True,40.0,7,13,3,4,4,9,4,4,1,9,10,1,0,1,3,1,22
400915357,Syracuse Orange,T. Battle,4065722,,True,40.0,3,5,2,2,1,3,2,2,0,3,3,1,1,0,2,3,9
400915357,Syracuse Orange,J. Gillon,61915,,True,39.0,3,7,2,3,1,4,1,2,1,1,2,11,2,0,5,0,8
400915357,Syracuse Orange,T. Roberson,67633,,False,35.0,4,5,4,5,0,0,1,2,0,6,6,2,2,0,0,3,9
400915357,Syracuse Orange,D. Coleman,61821,,False,1.0,0,0,0,0,0,0,0,0,0,0,0,0,0,0,0,0,0
400915357,Syracuse Orange,F. Howard,3934659,,False,1.0,0,0,0,0,0,0,0,0,0,0,0,0,0,0,0,0,0
400915357,Syracuse Orange,TEAM,TOTAL,TOTAL,False,,25,44,17,25,8,19,12,14,5,25,30,16,6,4,15,11,70
400915357,Syracuse Orange,T. Thompson,4065721,,True,5.0,1,1,1,1,0,0,0,0,0,0,0,0,0,0,1,2,2
400915357,Syracuse Orange,T. Lydon,3934662,,True,39.0,7,13,5,10,2,3,4,4,2,5,7,1,1,3,3,2,20
400915357,Syracuse Orange,A. White III,61616,,True,40.0,7,13,3,4,4,9,4,4,1,9,10,1,0,1,3,1,22
400915357,Syracuse Orange,T. Battle,4065722,,True,40.0,3,5,2,2,1,3,2,2,0,3,3,1,1,0,2,3,9
400915357,Syracuse Orange,J. Gillon,61915,,True,39.0,3,7,2,3,1,4,1,2,1,1,2,11,2,0,5,0,8
400915357,Syracuse Orange,T. Roberson,67633,,False,35.0,4,5,4,5,0,0,1,2,0,6,6,2,2,0,0,3,9
400915357,Syracuse Orange,D. Coleman,61821,,False,1.0,0,0,0,0,0,0,0,0,0,0,0,0,0,0,0,0,0
400915357,Syracuse Orange,F. Howard,3934659,,False,1.0,0,0,0,0,0,0,0,0,0,0,0,0,0,0,0,0,0
400915357,Syracuse Orange,TEAM,TOTAL,TOTAL,False,,25,44,17,25,8,19,12,14,5,25,30,16,6,4,15,11,70
400915357,Miami Hurricanes,K. Murphy,61668,,True,35.0,4,4,4,4,0,0,0,2,2,2,4,0,0,1,2,2,8
400915357,Miami Hurricanes,D. Hernandez,4065672,,True,19.0,3,5,3,5,0,0,0,1,2,1,3,1,1,0,1,2,6
400915357,Miami Hurricanes,B. Brown,4065670,,True,33.0,3,8,1,4,2,4,1,2,4,3,7,2,1,0,2,2,9
400915357,Miami Hurricanes,J. Newton,3138145,,True,35.0,3,12,2,9,1,3,1,3,1,3,4,7,1,0,4,4,8
400915357,Miami Hurricanes,D. Reed,66130,,True,37.0,2,11,0,4,2,7,0,0,0,3,3,4,0,0,4,1,6
400915357,Miami Hurricanes,R. Miller Jr.,4065671,,False,0.0,0,0,0,0,0,0,0,0,0,0,0,0,0,0,0,0,0
400915357,Miami Hurricanes,E. Izundu,3904629,,False,7.0,0,1,0,1,0,0,0,0,1,1,2,0,0,1,0,2,0
400915357,Miami Hurricanes,A. Lawrence II,3904628,,False,6.0,0,1,0,1,0,0,0,0,0,0,0,1,0,0,1,2,0
400915357,Miami Hurricanes,D. Vasiljevic,4065669,,False,28.0,6,12,0,0,6,12,0,2,0,0,0,0,1,0,0,0,18
400915357,Miami Hurricanes,TEAM,TOTAL,TOTAL,False,,21,54,10,28,11,26,2,10,12,14,26,15,4,2,15,15,55
400915357,Miami Hurricanes,K. Murphy,61668,,True,35.0,4,4,4,4,0,0,0,2,2,2,4,0,0,1,2,2,8
400915357,Miami Hurricanes,D. Hernandez,4065672,,True,19.0,3,5,3,5,0,0,0,1,2,1,3,1,1,0,1,2,6
400915357,Miami Hurricanes,B. Brown,4065670,,True,33.0,3,8,1,4,2,4,1,2,4,3,7,2,1,0,2,2,9
400915357,Miami Hurricanes,J. Newton,3138145,,True,35.0,3,12,2,9,1,3,1,3,1,3,4,7,1,0,4,4,8
400915357,Miami Hurricanes,D. Reed,66130,,True,37.0,2,11,0,4,2,7,0,0,0,3,3,4,0,0,4,1,6
400915357,Miami Hurricanes,R. Miller Jr.,4065671,,False,0.0,0,0,0,0,0,0,0,0,0,0,0,0,0,0,0,0,0
400915357,Miami Hurricanes,E. Izundu,3904629,,False,7.0,0,1,0,1,0,0,0,0,1,1,2,0,0,1,0,2,0
400915357,Miami Hurricanes,A. Lawrence II,3904628,,False,6.0,0,1,0,1,0,0,0,0,0,0,0,1,0,0,1,2,0
400915357,Miami Hurricanes,D. Vasiljevic,4065669,,False,28.0,6,12,0,0,6,12,0,2,0,0,0,0,1,0,0,0,18
400915357,Miami Hurricanes,TEAM,TOTAL,TOTAL,False,,21,54,10,28,11,26,2,10,12,14,26,15,4,2,15,15,55
400915356,Georgia Tech Yellow Jackets,Q. Stephens,66128,,True,29.0,3,7,2,4,1,3,2,2,2,4,6,1,0,0,0,3,9
400915356,Georgia Tech Yellow Jackets,B. Lammers,3135061,,True,29.0,3,9,3,9,0,0,3,4,4,4,8,3,1,0,2,4,9
400915356,Georgia Tech Yellow Jackets,J. Okogie,4065663,,True,28.0,5,12,5,11,0,1,1,2,1,4,5,1,1,1,4,0,11
400915356,Georgia Tech Yellow Jackets,J. Moore,4065662,,True,28.0,5,12,5,11,0,1,1,2,2,1,3,2,0,0,3,2,11
400915356,Georgia Tech Yellow Jackets,T. Jackson,3135057,,True,19.0,4,9,3,4,1,5,2,6,1,2,3,1,0,0,0,1,11
400915356,Georgia Tech Yellow Jackets,C. Matthews,4065665,,False,6.0,1,4,1,3,0,1,0,0,0,0,0,0,0,0,0,0,2
400915356,Georgia Tech Yellow Jackets,S. Ogbonda,3904627,,False,11.0,1,4,1,4,0,0,2,2,2,2,4,0,0,0,1,3,4
400915356,Georgia Tech Yellow Jackets,K. McCormick,61453,,False,12.0,0,2,0,0,0,2,0,0,0,0,0,0,1,0,1,0,0
400915356,Georgia Tech Yellow Jackets,J. Heath,67623,,False,25.0,0,2,0,2,0,0,0,0,0,0,0,2,0,0,0,1,0
400915356,Georgia Tech Yellow Jackets,J. Price,61778,,False,2.0,0,1,0,0,0,1,0,0,0,0,0,0,0,0,0,0,0
400915356,Georgia Tech Yellow Jackets,C. Heyward,61609,,False,11.0,0,1,0,1,0,0,0,0,0,0,0,0,0,0,0,2,0
400915356,Georgia Tech Yellow Jackets,TEAM,TOTAL,TOTAL,False,,22,63,20,49,2,14,11,18,14,17,31,10,3,1,13,16,57
400915356,Georgia Tech Yellow Jackets,Q. Stephens,66128,,True,29.0,3,7,2,4,1,3,2,2,2,4,6,1,0,0,0,3,9
400915356,Georgia Tech Yellow Jackets,B. Lammers,3135061,,True,29.0,3,9,3,9,0,0,3,4,4,4,8,3,1,0,2,4,9
400915356,Georgia Tech Yellow Jackets,J. Okogie,4065663,,True,28.0,5,12,5,11,0,1,1,2,1,4,5,1,1,1,4,0,11
400915356,Georgia Tech Yellow Jackets,J. Moore,4065662,,True,28.0,5,12,5,11,0,1,1,2,2,1,3,2,0,0,3,2,11
400915356,Georgia Tech Yellow Jackets,T. Jackson,3135057,,True,19.0,4,9,3,4,1,5,2,6,1,2,3,1,0,0,0,1,11
400915356,Georgia Tech Yellow Jackets,C. Matthews,4065665,,False,6.0,1,4,1,3,0,1,0,0,0,0,0,0,0,0,0,0,2
400915356,Georgia Tech Yellow Jackets,S. Ogbonda,3904627,,False,11.0,1,4,1,4,0,0,2,2,2,2,4,0,0,0,1,3,4
400915356,Georgia Tech Yellow Jackets,K. McCormick,61453,,False,12.0,0,2,0,0,0,2,0,0,0,0,0,0,1,0,1,0,0
400915356,Georgia Tech Yellow Jackets,J. Heath,67623,,False,25.0,0,2,0,2,0,0,0,0,0,0,0,2,0,0,0,1,0
400915356,Georgia Tech Yellow Jackets,J. Price,61778,,False,2.0,0,1,0,0,0,1,0,0,0,0,0,0,0,0,0,0,0
400915356,Georgia Tech Yellow Jackets,C. Heyward,61609,,False,11.0,0,1,0,1,0,0,0,0,0,0,0,0,0,0,0,2,0
400915356,Georgia Tech Yellow Jackets,TEAM,TOTAL,TOTAL,False,,22,63,20,49,2,14,11,18,14,17,31,10,3,1,13,16,57
400915356,Duke Blue Devils,H. Giles III,4065649,,True,17.0,5,12,5,12,0,0,0,0,7,5,12,1,0,0,1,2,10
400915356,Duke Blue Devils,J. Tatum,4065648,,True,28.0,8,15,7,8,1,7,2,3,2,4,6,4,4,2,2,3,19
400915356,Duke Blue Devils,A. Jefferson,61586,,True,27.0,4,8,4,8,0,0,6,8,1,6,7,3,0,0,1,1,14
400915356,Duke Blue Devils,L. Kennard,3913174,,True,26.0,6,7,2,2,4,5,0,0,1,4,5,1,0,0,1,1,16
400915356,Duke Blue Devils,G. Allen,3135045,,True,27.0,3,5,1,1,2,4,7,7,1,2,3,7,1,0,1,0,15
400915356,Duke Blue Devils,J. White,4065653,,False,5.0,1,1,0,0,1,1,0,0,0,1,1,0,0,0,0,1,3
400915356,Duke Blue Devils,J. Robinson,3913178,,False,2.0,0,0,0,0,0,0,0,0,0,0,0,0,0,0,0,0,0
400915356,Duke Blue Devils,M. Bolden,4065652,,False,15.0,2,4,2,4,0,0,0,0,1,3,4,0,0,1,0,1,4
400915356,Duke Blue Devils,A. Vrankovic,3913177,,False,7.0,0,0,0,0,0,0,0,0,1,2,3,1,0,0,2,1,0
400915356,Duke Blue Devils,F. Jackson,4065651,,False,24.0,5,9,1,2,4,7,1,1,0,2,2,4,1,0,0,2,15
400915356,Duke Blue Devils,N. Pagliuca,66630,,False,3.0,0,0,0,0,0,0,0,0,0,0,0,1,0,0,0,0,0
400915356,Duke Blue Devils,M. Jones,66563,,False,19.0,5,9,1,2,4,7,0,0,3,1,4,2,0,0,2,3,14
400915356,Duke Blue Devils,TEAM,TOTAL,TOTAL,False,,39,70,23,39,16,31,16,19,17,32,49,24,6,3,10,15,110
400915356,Duke Blue Devils,H. Giles III,4065649,,True,17.0,5,12,5,12,0,0,0,0,7,5,12,1,0,0,1,2,10
400915356,Duke Blue Devils,J. Tatum,4065648,,True,28.0,8,15,7,8,1,7,2,3,2,4,6,4,4,2,2,3,19
400915356,Duke Blue Devils,A. Jefferson,61586,,True,27.0,4,8,4,8,0,0,6,8,1,6,7,3,0,0,1,1,14
400915356,Duke Blue Devils,L. Kennard,3913174,,True,26.0,6,7,2,2,4,5,0,0,1,4,5,1,0,0,1,1,16
400915356,Duke Blue Devils,G. Allen,3135045,,True,27.0,3,5,1,1,2,4,7,7,1,2,3,7,1,0,1,0,15
400915356,Duke Blue Devils,J. White,4065653,,False,5.0,1,1,0,0,1,1,0,0,0,1,1,0,0,0,0,1,3
400915356,Duke Blue Devils,J. Robinson,3913178,,False,2.0,0,0,0,0,0,0,0,0,0,0,0,0,0,0,0,0,0
400915356,Duke Blue Devils,M. Bolden,4065652,,False,15.0,2,4,2,4,0,0,0,0,1,3,4,0,0,1,0,1,4
400915356,Duke Blue Devils,A. Vrankovic,3913177,,False,7.0,0,0,0,0,0,0,0,0,1,2,3,1,0,0,2,1,0
400915356,Duke Blue Devils,F. Jackson,4065651,,False,24.0,5,9,1,2,4,7,1,1,0,2,2,4,1,0,0,2,15
400915356,Duke Blue Devils,N. Pagliuca,66630,,False,3.0,0,0,0,0,0,0,0,0,0,0,0,1,0,0,0,0,0
400915356,Duke Blue Devils,M. Jones,66563,,False,19.0,5,9,1,2,4,7,0,0,3,1,4,2,0,0,2,3,14
400915356,Duke Blue Devils,TEAM,TOTAL,TOTAL,False,,39,70,23,39,16,31,16,19,17,32,49,24,6,3,10,15,110
400915355,Wake Forest Demon Deacons,J. Collins,3908845,,True,25.0,6,11,6,11,0,0,5,7,3,4,7,2,0,2,3,4,17
400915355,Wake Forest Demon Deacons,D. Mitoglou,3138224,,True,22.0,6,8,6,8,0,0,3,4,2,5,7,2,0,0,1,2,15
400915355,Wake Forest Demon Deacons,A. Arians,61378,,True,23.0,4,5,3,3,1,2,3,4,0,5,5,3,0,0,1,3,12
400915355,Wake Forest Demon Deacons,B. Crawford,3908844,,True,33.0,3,12,1,6,2,6,3,4,0,5,5,7,0,0,1,4,11
400915355,Wake Forest Demon Deacons,K. Woods,3132360,,True,31.0,1,7,1,5,0,2,3,4,1,7,8,3,0,0,2,1,5
400915355,Wake Forest Demon Deacons,G. McClinton,66140,,False,10.0,0,0,0,0,0,0,0,0,0,1,1,0,0,0,0,2,0
400915355,Wake Forest Demon Deacons,D. Moore,3908843,,False,4.0,2,3,2,3,0,0,0,0,1,0,1,0,0,0,0,0,4
400915355,Wake Forest Demon Deacons,B. Childress,4065750,,False,20.0,3,4,1,2,2,2,0,0,0,3,3,1,1,0,4,2,8
400915355,Wake Forest Demon Deacons,M. Wilbekin,3138222,,False,32.0,2,7,1,4,1,3,2,2,0,2,2,1,1,0,0,1,7
400915355,Wake Forest Demon Deacons,TEAM,TOTAL,TOTAL,False,,27,57,21,42,6,15,19,25,8,33,41,19,2,2,12,19,79
400915355,Wake Forest Demon Deacons,J. Collins,3908845,,True,25.0,6,11,6,11,0,0,5,7,3,4,7,2,0,2,3,4,17
400915355,Wake Forest Demon Deacons,D. Mitoglou,3138224,,True,22.0,6,8,6,8,0,0,3,4,2,5,7,2,0,0,1,2,15
400915355,Wake Forest Demon Deacons,A. Arians,61378,,True,23.0,4,5,3,3,1,2,3,4,0,5,5,3,0,0,1,3,12
400915355,Wake Forest Demon Deacons,B. Crawford,3908844,,True,33.0,3,12,1,6,2,6,3,4,0,5,5,7,0,0,1,4,11
400915355,Wake Forest Demon Deacons,K. Woods,3132360,,True,31.0,1,7,1,5,0,2,3,4,1,7,8,3,0,0,2,1,5
400915355,Wake Forest Demon Deacons,G. McClinton,66140,,False,10.0,0,0,0,0,0,0,0,0,0,1,1,0,0,0,0,2,0
400915355,Wake Forest Demon Deacons,D. Moore,3908843,,False,4.0,2,3,2,3,0,0,0,0,1,0,1,0,0,0,0,0,4
400915355,Wake Forest Demon Deacons,B. Childress,4065750,,False,20.0,3,4,1,2,2,2,0,0,0,3,3,1,1,0,4,2,8
400915355,Wake Forest Demon Deacons,M. Wilbekin,3138222,,False,32.0,2,7,1,4,1,3,2,2,0,2,2,1,1,0,0,1,7
400915355,Wake Forest Demon Deacons,TEAM,TOTAL,TOTAL,False,,27,57,21,42,6,15,19,25,8,33,41,19,2,2,12,19,79
400915355,Boston College Eagles,A.J. Turner,3943608,,True,37.0,4,10,2,3,2,7,1,2,0,2,2,2,0,1,0,2,11
400915355,Boston College Eagles,M. Jeffers,61901,,True,8.0,0,0,0,0,0,0,1,2,1,0,1,1,0,0,0,5,1
400915355,Boston College Eagles,C. Tava,61446,,True,34.0,2,5,2,3,0,2,0,0,1,4,5,4,0,0,2,2,4
400915355,Boston College Eagles,K. Bowman,4065635,,True,36.0,3,15,2,7,1,8,7,8,1,5,6,4,2,1,2,3,14
400915355,Boston College Eagles,J. Robinson,3943606,,True,32.0,6,14,5,9,1,5,7,9,0,6,6,2,1,0,2,4,20
400915355,Boston College Eagles,J. Reyes,3943609,,False,5.0,1,1,1,1,0,0,0,0,0,0,0,0,0,0,0,1,2
400915355,Boston College Eagles,N. Popovic,4065637,,False,17.0,4,5,4,5,0,0,1,1,1,3,4,0,0,0,2,4,9
400915355,Boston College Eagles,G. Owens,66277,,False,5.0,0,1,0,0,0,1,0,0,0,0,0,0,0,0,0,0,0
400915355,Boston College Eagles,J. Chatman,3135095,,False,26.0,1,7,0,0,1,7,2,2,0,2,2,1,2,0,0,1,5
400915355,Boston College Eagles,TEAM,TOTAL,TOTAL,False,,21,58,16,28,5,30,19,24,5,24,29,14,5,2,8,22,66
400915355,Boston College Eagles,A.J. Turner,3943608,,True,37.0,4,10,2,3,2,7,1,2,0,2,2,2,0,1,0,2,11
400915355,Boston College Eagles,M. Jeffers,61901,,True,8.0,0,0,0,0,0,0,1,2,1,0,1,1,0,0,0,5,1
400915355,Boston College Eagles,C. Tava,61446,,True,34.0,2,5,2,3,0,2,0,0,1,4,5,4,0,0,2,2,4
400915355,Boston College Eagles,K. Bowman,4065635,,True,36.0,3,15,2,7,1,8,7,8,1,5,6,4,2,1,2,3,14
400915355,Boston College Eagles,J. Robinson,3943606,,True,32.0,6,14,5,9,1,5,7,9,0,6,6,2,1,0,2,4,20
400915355,Boston College Eagles,J. Reyes,3943609,,False,5.0,1,1,1,1,0,0,0,0,0,0,0,0,0,0,0,1,2
400915355,Boston College Eagles,N. Popovic,4065637,,False,17.0,4,5,4,5,0,0,1,1,1,3,4,0,0,0,2,4,9
400915355,Boston College Eagles,G. Owens,66277,,False,5.0,0,1,0,0,0,1,0,0,0,0,0,0,0,0,0,0,0
400915355,Boston College Eagles,J. Chatman,3135095,,False,26.0,1,7,0,0,1,7,2,2,0,2,2,1,2,0,0,1,5
400915355,Boston College Eagles,TEAM,TOTAL,TOTAL,False,,21,58,16,28,5,30,19,24,5,24,29,14,5,2,8,22,66
400915354,North Carolina Tar Heels,J. Jackson,3138156,,True,39.0,8,20,6,11,2,9,0,1,1,4,5,2,1,0,4,2,18
400915354,North Carolina Tar Heels,I. Hicks,66874,,True,24.0,3,6,3,6,0,0,2,2,4,3,7,3,0,1,2,5,8
400915354,North Carolina Tar Heels,K. Meeks,66873,,True,34.0,5,14,5,14,0,0,4,5,10,6,16,4,2,2,2,2,14
400915354,North Carolina Tar Heels,K. Williams,3911619,,True,30.0,4,8,3,5,1,3,2,2,1,3,4,0,2,0,2,1,11
400915354,North Carolina Tar Heels,J. Berry II,3138155,,True,41.0,12,19,5,9,7,10,0,0,1,4,5,3,2,0,5,3,31
400915354,North Carolina Tar Heels,T. Bradley,4065673,,False,11.0,1,3,1,3,0,0,1,2,2,0,2,0,0,1,1,3,3
400915354,North Carolina Tar Heels,L. Maye,3911620,,False,10.0,1,2,1,1,0,1,0,0,0,2,2,0,0,0,0,1,2
400915354,North Carolina Tar Heels,S. Woods,4065676,,False,4.0,0,1,0,1,0,0,0,0,0,1,1,0,0,0,1,0,0
400915354,North Carolina Tar Heels,B. Robinson,4065675,,False,6.0,1,2,1,1,0,1,0,0,0,1,1,1,2,0,0,0,2
400915354,North Carolina Tar Heels,N. Britt,66872,,False,26.0,0,3,0,3,0,0,0,0,1,3,4,4,0,0,1,2,0
400915354,North Carolina Tar Heels,TEAM,TOTAL,TOTAL,False,,35,78,25,54,10,24,9,12,23,28,51,17,9,4,18,19,89
400915354,North Carolina Tar Heels,J. Jackson,3138156,,True,39.0,8,20,6,11,2,9,0,1,1,4,5,2,1,0,4,2,18
400915354,North Carolina Tar Heels,I. Hicks,66874,,True,24.0,3,6,3,6,0,0,2,2,4,3,7,3,0,1,2,5,8
400915354,North Carolina Tar Heels,K. Meeks,66873,,True,34.0,5,14,5,14,0,0,4,5,10,6,16,4,2,2,2,2,14
400915354,North Carolina Tar Heels,K. Williams,3911619,,True,30.0,4,8,3,5,1,3,2,2,1,3,4,0,2,0,2,1,11
400915354,North Carolina Tar Heels,J. Berry II,3138155,,True,41.0,12,19,5,9,7,10,0,0,1,4,5,3,2,0,5,3,31
400915354,North Carolina Tar Heels,T. Bradley,4065673,,False,11.0,1,3,1,3,0,0,1,2,2,0,2,0,0,1,1,3,3
400915354,North Carolina Tar Heels,L. Maye,3911620,,False,10.0,1,2,1,1,0,1,0,0,0,2,2,0,0,0,0,1,2
400915354,North Carolina Tar Heels,S. Woods,4065676,,False,4.0,0,1,0,1,0,0,0,0,0,1,1,0,0,0,1,0,0
400915354,North Carolina Tar Heels,B. Robinson,4065675,,False,6.0,1,2,1,1,0,1,0,0,0,1,1,1,2,0,0,0,2
400915354,North Carolina Tar Heels,N. Britt,66872,,False,26.0,0,3,0,3,0,0,0,0,1,3,4,4,0,0,1,2,0
400915354,North Carolina Tar Heels,TEAM,TOTAL,TOTAL,False,,35,78,25,54,10,24,9,12,23,28,51,17,9,4,18,19,89
400915354,Clemson Tigers,D. Grantham,3129674,,True,23.0,1,3,0,0,1,3,0,0,0,1,1,2,1,1,1,2,3
400915354,Clemson Tigers,J. Blossomgame,61835,,True,38.0,9,14,8,9,1,5,5,8,2,5,7,1,1,2,3,1,24
400915354,Clemson Tigers,S. Djitte,66122,,True,33.0,1,7,1,7,0,0,2,2,5,3,8,2,1,4,1,2,4
400915354,Clemson Tigers,S. Mitchell,3136699,,True,30.0,5,12,2,6,3,6,0,0,0,2,2,4,3,0,2,1,13
400915354,Clemson Tigers,A. Holmes,62043,,True,36.0,8,14,4,5,4,9,0,1,0,2,2,2,3,0,0,3,20
400915354,Clemson Tigers,E. Thomas,3947075,,False,12.0,2,5,2,5,0,0,1,2,1,1,2,0,0,2,1,3,5
400915354,Clemson Tigers,T. Hudson,3917986,,False,2.0,0,0,0,0,0,0,0,0,0,0,0,0,0,0,1,0,0
400915354,Clemson Tigers,M. Reed,3133969,,False,34.0,5,9,3,6,2,3,5,6,1,3,4,1,1,0,2,3,17
400915354,Clemson Tigers,G. DeVoe,3129673,,False,17.0,0,4,0,2,0,2,0,0,1,2,3,0,0,0,1,1,0
400915354,Clemson Tigers,TEAM,TOTAL,TOTAL,False,,31,68,20,40,11,28,13,19,10,22,32,12,10,9,12,16,86
400915354,Clemson Tigers,D. Grantham,3129674,,True,23.0,1,3,0,0,1,3,0,0,0,1,1,2,1,1,1,2,3
400915354,Clemson Tigers,J. Blossomgame,61835,,True,38.0,9,14,8,9,1,5,5,8,2,5,7,1,1,2,3,1,24
400915354,Clemson Tigers,S. Djitte,66122,,True,33.0,1,7,1,7,0,0,2,2,5,3,8,2,1,4,1,2,4
400915354,Clemson Tigers,S. Mitchell,3136699,,True,30.0,5,12,2,6,3,6,0,0,0,2,2,4,3,0,2,1,13
400915354,Clemson Tigers,A. Holmes,62043,,True,36.0,8,14,4,5,4,9,0,1,0,2,2,2,3,0,0,3,20
400915354,Clemson Tigers,E. Thomas,3947075,,False,12.0,2,5,2,5,0,0,1,2,1,1,2,0,0,2,1,3,5
400915354,Clemson Tigers,T. Hudson,3917986,,False,2.0,0,0,0,0,0,0,0,0,0,0,0,0,0,0,1,0,0
400915354,Clemson Tigers,M. Reed,3133969,,False,34.0,5,9,3,6,2,3,5,6,1,3,4,1,1,0,2,3,17
400915354,Clemson Tigers,G. DeVoe,3129673,,False,17.0,0,4,0,2,0,2,0,0,1,2,3,0,0,0,1,1,0
400915354,Clemson Tigers,TEAM,TOTAL,TOTAL,False,,31,68,20,40,11,28,13,19,10,22,32,12,10,9,12,16,86
400915353,Syracuse Orange,T. Thompson,4065721,,True,28.0,5,13,5,12,0,1,4,8,1,2,3,0,2,2,1,5,14
400915353,Syracuse Orange,T. Lydon,3934662,,True,39.0,4,10,3,7,1,3,8,9,2,10,12,0,2,3,0,4,17
400915353,Syracuse Orange,T. Battle,4065722,,True,26.0,3,6,2,3,1,3,0,0,0,4,4,4,0,0,1,0,7
400915353,Syracuse Orange,F. Howard,3934659,,True,17.0,1,6,1,4,0,2,1,2,3,0,3,3,1,0,3,2,3
400915353,Syracuse Orange,A. White III,61616,,True,38.0,7,15,3,8,4,7,4,4,3,3,6,1,1,1,3,2,22
400915353,Syracuse Orange,D. Akintobi-Adeyeye,3155403,,False,1.0,0,1,0,1,0,0,0,0,0,0,0,0,0,0,0,0,0
400915353,Syracuse Orange,T. Roberson,67633,,False,22.0,4,7,4,7,0,0,3,3,8,2,10,1,1,0,1,2,11
400915353,Syracuse Orange,R. Featherston,4065723,,False,1.0,0,0,0,0,0,0,0,0,0,0,0,0,0,0,0,0,0
400915353,Syracuse Orange,A. Autry,3934661,,False,1.0,0,0,0,0,0,0,0,0,0,0,0,0,0,0,0,0,0
400915353,Syracuse Orange,S. Belbey,3934660,,False,1.0,0,0,0,0,0,0,0,0,0,0,0,0,0,0,0,0,0
400915353,Syracuse Orange,J. Gillon,61915,,False,26.0,2,10,2,6,0,4,3,4,0,0,0,3,1,0,1,2,7
400915353,Syracuse Orange,TEAM,TOTAL,TOTAL,False,,26,68,20,48,6,20,23,30,20,21,41,12,8,6,10,17,81
400915353,Syracuse Orange,T. Thompson,4065721,,True,28.0,5,13,5,12,0,1,4,8,1,2,3,0,2,2,1,5,14
400915353,Syracuse Orange,T. Lydon,3934662,,True,39.0,4,10,3,7,1,3,8,9,2,10,12,0,2,3,0,4,17
400915353,Syracuse Orange,T. Battle,4065722,,True,26.0,3,6,2,3,1,3,0,0,0,4,4,4,0,0,1,0,7
400915353,Syracuse Orange,F. Howard,3934659,,True,17.0,1,6,1,4,0,2,1,2,3,0,3,3,1,0,3,2,3
400915353,Syracuse Orange,A. White III,61616,,True,38.0,7,15,3,8,4,7,4,4,3,3,6,1,1,1,3,2,22
400915353,Syracuse Orange,D. Akintobi-Adeyeye,3155403,,False,1.0,0,1,0,1,0,0,0,0,0,0,0,0,0,0,0,0,0
400915353,Syracuse Orange,T. Roberson,67633,,False,22.0,4,7,4,7,0,0,3,3,8,2,10,1,1,0,1,2,11
400915353,Syracuse Orange,R. Featherston,4065723,,False,1.0,0,0,0,0,0,0,0,0,0,0,0,0,0,0,0,0,0
400915353,Syracuse Orange,A. Autry,3934661,,False,1.0,0,0,0,0,0,0,0,0,0,0,0,0,0,0,0,0,0
400915353,Syracuse Orange,S. Belbey,3934660,,False,1.0,0,0,0,0,0,0,0,0,0,0,0,0,0,0,0,0,0
400915353,Syracuse Orange,J. Gillon,61915,,False,26.0,2,10,2,6,0,4,3,4,0,0,0,3,1,0,1,2,7
400915353,Syracuse Orange,TEAM,TOTAL,TOTAL,False,,26,68,20,48,6,20,23,30,20,21,41,12,8,6,10,17,81
400915353,Boston College Eagles,A.J. Turner,3943608,,True,34.0,6,9,2,2,4,7,0,1,0,2,2,6,1,0,0,2,16
400915353,Boston College Eagles,M. Jeffers,61901,,True,16.0,1,5,1,5,0,0,0,0,2,3,5,0,1,1,2,1,2
400915353,Boston College Eagles,C. Tava,61446,,True,37.0,2,3,2,3,0,0,5,7,2,8,10,7,0,1,3,3,9
400915353,Boston College Eagles,K. Bowman,4065635,,True,34.0,11,17,4,9,7,8,1,2,1,4,5,9,0,0,3,4,30
400915353,Boston College Eagles,J. Robinson,3943606,,True,35.0,9,12,6,8,3,4,1,3,0,1,1,4,1,1,3,4,22
400915353,Boston College Eagles,J. Reyes,3943609,,False,1.0,0,0,0,0,0,0,0,0,0,0,0,0,0,1,0,0,0
400915353,Boston College Eagles,N. Popovic,4065637,,False,25.0,5,10,5,9,0,1,1,4,4,2,6,2,1,0,0,4,11
400915353,Boston College Eagles,A. Ghebremichael,3951741,,False,1.0,0,0,0,0,0,0,0,0,0,0,0,0,0,0,0,0,0
400915353,Boston College Eagles,E. Meznieks,3943607,,False,1.0,0,0,0,0,0,0,0,0,0,0,0,0,0,0,0,0,0
400915353,Boston College Eagles,G. Owens,66277,,False,1.0,0,1,0,0,0,1,0,0,0,0,0,0,0,0,0,0,0
400915353,Boston College Eagles,G. Gehan,3943611,,False,1.0,0,0,0,0,0,0,0,0,0,0,0,0,0,0,0,0,0
400915353,Boston College Eagles,J. Chatman,3135095,,False,14.0,2,6,0,1,2,5,0,0,0,2,2,0,0,0,1,2,6
400915353,Boston College Eagles,TEAM,TOTAL,TOTAL,False,,36,63,20,37,16,26,8,17,11,25,36,28,4,4,13,20,96
400915353,Boston College Eagles,A.J. Turner,3943608,,True,34.0,6,9,2,2,4,7,0,1,0,2,2,6,1,0,0,2,16
400915353,Boston College Eagles,M. Jeffers,61901,,True,16.0,1,5,1,5,0,0,0,0,2,3,5,0,1,1,2,1,2
400915353,Boston College Eagles,C. Tava,61446,,True,37.0,2,3,2,3,0,0,5,7,2,8,10,7,0,1,3,3,9
400915353,Boston College Eagles,K. Bowman,4065635,,True,34.0,11,17,4,9,7,8,1,2,1,4,5,9,0,0,3,4,30
400915353,Boston College Eagles,J. Robinson,3943606,,True,35.0,9,12,6,8,3,4,1,3,0,1,1,4,1,1,3,4,22
400915353,Boston College Eagles,J. Reyes,3943609,,False,1.0,0,0,0,0,0,0,0,0,0,0,0,0,0,1,0,0,0
400915353,Boston College Eagles,N. Popovic,4065637,,False,25.0,5,10,5,9,0,1,1,4,4,2,6,2,1,0,0,4,11
400915353,Boston College Eagles,A. Ghebremichael,3951741,,False,1.0,0,0,0,0,0,0,0,0,0,0,0,0,0,0,0,0,0
400915353,Boston College Eagles,E. Meznieks,3943607,,False,1.0,0,0,0,0,0,0,0,0,0,0,0,0,0,0,0,0,0
400915353,Boston College Eagles,G. Owens,66277,,False,1.0,0,1,0,0,0,1,0,0,0,0,0,0,0,0,0,0,0
400915353,Boston College Eagles,G. Gehan,3943611,,False,1.0,0,0,0,0,0,0,0,0,0,0,0,0,0,0,0,0,0
400915353,Boston College Eagles,J. Chatman,3135095,,False,14.0,2,6,0,1,2,5,0,0,0,2,2,0,0,0,1,2,6
400915353,Boston College Eagles,TEAM,TOTAL,TOTAL,False,,36,63,20,37,16,26,8,17,11,25,36,28,4,4,13,20,96
400915352,NC State Wolfpack,A. Abu,3138158,,True,31.0,4,10,4,10,0,0,3,4,6,3,9,1,0,0,2,2,11
400915352,NC State Wolfpack,O. Yurtseven,66768,,True,26.0,2,6,2,6,0,0,1,2,1,3,4,2,1,1,1,3,5
400915352,NC State Wolfpack,D. Smith Jr.,4065697,,True,35.0,7,14,4,6,3,8,4,8,1,2,3,5,2,0,5,3,21
400915352,NC State Wolfpack,T. Dorn,3132359,,True,26.0,2,6,0,3,2,3,1,2,1,2,3,2,0,0,3,0,7
400915352,NC State Wolfpack,T. Henderson,61215,,True,25.0,2,6,0,0,2,6,2,2,0,5,5,1,0,0,2,5,8
400915352,NC State Wolfpack,T. Kapita,4065701,,False,10.0,1,2,1,2,0,0,0,0,0,3,3,0,0,0,0,1,2
400915352,NC State Wolfpack,B. Anya,66134,,False,11.0,0,1,0,1,0,0,0,0,1,1,2,0,0,0,1,2,0
400915352,NC State Wolfpack,M. Johnson,4065699,,False,12.0,1,2,0,0,1,2,0,0,0,0,0,0,0,0,0,3,3
400915352,NC State Wolfpack,M. Rowan,3947151,,False,24.0,2,7,0,3,2,4,0,0,1,0,1,0,0,0,1,1,6
400915352,NC State Wolfpack,TEAM,TOTAL,TOTAL,False,,21,54,11,31,10,23,11,18,13,20,33,11,3,1,15,20,63
400915352,NC State Wolfpack,A. Abu,3138158,,True,31.0,4,10,4,10,0,0,3,4,6,3,9,1,0,0,2,2,11
400915352,NC State Wolfpack,O. Yurtseven,66768,,True,26.0,2,6,2,6,0,0,1,2,1,3,4,2,1,1,1,3,5
400915352,NC State Wolfpack,D. Smith Jr.,4065697,,True,35.0,7,14,4,6,3,8,4,8,1,2,3,5,2,0,5,3,21
400915352,NC State Wolfpack,T. Dorn,3132359,,True,26.0,2,6,0,3,2,3,1,2,1,2,3,2,0,0,3,0,7
400915352,NC State Wolfpack,T. Henderson,61215,,True,25.0,2,6,0,0,2,6,2,2,0,5,5,1,0,0,2,5,8
400915352,NC State Wolfpack,T. Kapita,4065701,,False,10.0,1,2,1,2,0,0,0,0,0,3,3,0,0,0,0,1,2
400915352,NC State Wolfpack,B. Anya,66134,,False,11.0,0,1,0,1,0,0,0,0,1,1,2,0,0,0,1,2,0
400915352,NC State Wolfpack,M. Johnson,4065699,,False,12.0,1,2,0,0,1,2,0,0,0,0,0,0,0,0,0,3,3
400915352,NC State Wolfpack,M. Rowan,3947151,,False,24.0,2,7,0,3,2,4,0,0,1,0,1,0,0,0,1,1,6
400915352,NC State Wolfpack,TEAM,TOTAL,TOTAL,False,,21,54,11,31,10,23,11,18,13,20,33,11,3,1,15,20,63
400915352,Miami Hurricanes,D. Hernandez,4065672,,True,14.0,0,3,0,2,0,1,0,0,0,0,0,1,1,0,0,1,0
400915352,Miami Hurricanes,K. Murphy,61668,,True,32.0,5,9,5,9,0,0,1,1,6,4,10,0,0,0,0,2,11
400915352,Miami Hurricanes,B. Brown,4065670,,True,26.0,7,11,6,9,1,2,2,4,3,5,8,4,3,1,2,4,17
400915352,Miami Hurricanes,J. Newton,3138145,,True,34.0,7,15,6,12,1,3,6,10,1,3,4,1,1,0,3,2,21
400915352,Miami Hurricanes,D. Reed,66130,,True,36.0,7,16,4,7,3,9,3,4,0,2,2,1,2,0,1,3,20
400915352,Miami Hurricanes,R. Miller Jr.,4065671,,False,3.0,0,0,0,0,0,0,0,0,0,0,0,0,0,1,0,0,0
400915352,Miami Hurricanes,E. Izundu,3904629,,False,19.0,1,2,1,2,0,0,1,2,4,3,7,0,0,0,1,3,3
400915352,Miami Hurricanes,A. Lawrence II,3904628,,False,28.0,3,8,3,4,0,4,0,2,2,3,5,1,2,0,1,2,6
400915352,Miami Hurricanes,D. Vasiljevic,4065669,,False,8.0,1,1,0,0,1,1,0,0,0,2,2,0,0,0,0,0,3
400915352,Miami Hurricanes,TEAM,TOTAL,TOTAL,False,,31,65,25,45,6,20,13,23,17,24,41,8,9,2,8,17,81
400915352,Miami Hurricanes,D. Hernandez,4065672,,True,14.0,0,3,0,2,0,1,0,0,0,0,0,1,1,0,0,1,0
400915352,Miami Hurricanes,K. Murphy,61668,,True,32.0,5,9,5,9,0,0,1,1,6,4,10,0,0,0,0,2,11
400915352,Miami Hurricanes,B. Brown,4065670,,True,26.0,7,11,6,9,1,2,2,4,3,5,8,4,3,1,2,4,17
400915352,Miami Hurricanes,J. Newton,3138145,,True,34.0,7,15,6,12,1,3,6,10,1,3,4,1,1,0,3,2,21
400915352,Miami Hurricanes,D. Reed,66130,,True,36.0,7,16,4,7,3,9,3,4,0,2,2,1,2,0,1,3,20
400915352,Miami Hurricanes,R. Miller Jr.,4065671,,False,3.0,0,0,0,0,0,0,0,0,0,0,0,0,0,1,0,0,0
400915352,Miami Hurricanes,E. Izundu,3904629,,False,19.0,1,2,1,2,0,0,1,2,4,3,7,0,0,0,1,3,3
400915352,Miami Hurricanes,A. Lawrence II,3904628,,False,28.0,3,8,3,4,0,4,0,2,2,3,5,1,2,0,1,2,6
400915352,Miami Hurricanes,D. Vasiljevic,4065669,,False,8.0,1,1,0,0,1,1,0,0,0,2,2,0,0,0,0,0,3
400915352,Miami Hurricanes,TEAM,TOTAL,TOTAL,False,,31,65,25,45,6,20,13,23,17,24,41,8,9,2,8,17,81
400915351,Virginia Cavaliers,I. Wilkins,3138203,,True,29.0,2,2,1,1,1,1,0,0,1,3,4,0,1,3,1,3,5
400915351,Virginia Cavaliers,J. Salt,3138200,,True,22.0,0,2,0,2,0,0,0,1,2,5,7,0,0,1,0,3,0
400915351,Virginia Cavaliers,D. Thompson,66274,,True,12.0,1,4,1,2,0,2,0,0,0,0,0,1,1,0,2,2,2
400915351,Virginia Cavaliers,L. Perrantes,66139,,True,33.0,4,9,2,6,2,3,0,0,0,1,1,4,0,0,4,1,10
400915351,Virginia Cavaliers,D. Hall,66138,,True,29.0,4,9,4,9,0,0,2,2,1,4,5,0,0,0,0,2,10
400915351,Virginia Cavaliers,M. Diakite,3947156,,False,18.0,2,3,2,2,0,1,1,2,1,2,3,0,0,1,0,2,5
400915351,Virginia Cavaliers,J. Reuter,3908374,,False,10.0,1,2,1,2,0,0,0,0,0,2,2,0,0,0,2,2,2
400915351,Virginia Cavaliers,T. Jerome,4065733,,False,9.0,0,0,0,0,0,0,0,0,0,2,2,2,0,0,1,2,0
400915351,Virginia Cavaliers,K. Guy,4065730,,False,23.0,5,12,1,5,4,7,0,0,0,3,3,0,0,0,1,1,14
400915351,Virginia Cavaliers,M. Shayok,3138201,,False,15.0,4,8,2,6,2,2,0,0,0,1,1,1,1,1,2,0,10
400915351,Virginia Cavaliers,TEAM,TOTAL,TOTAL,False,,23,51,14,35,9,16,3,5,6,28,34,8,3,6,13,18,58
400915351,Virginia Cavaliers,I. Wilkins,3138203,,True,29.0,2,2,1,1,1,1,0,0,1,3,4,0,1,3,1,3,5
400915351,Virginia Cavaliers,J. Salt,3138200,,True,22.0,0,2,0,2,0,0,0,1,2,5,7,0,0,1,0,3,0
400915351,Virginia Cavaliers,D. Thompson,66274,,True,12.0,1,4,1,2,0,2,0,0,0,0,0,1,1,0,2,2,2
400915351,Virginia Cavaliers,L. Perrantes,66139,,True,33.0,4,9,2,6,2,3,0,0,0,1,1,4,0,0,4,1,10
400915351,Virginia Cavaliers,D. Hall,66138,,True,29.0,4,9,4,9,0,0,2,2,1,4,5,0,0,0,0,2,10
400915351,Virginia Cavaliers,M. Diakite,3947156,,False,18.0,2,3,2,2,0,1,1,2,1,2,3,0,0,1,0,2,5
400915351,Virginia Cavaliers,J. Reuter,3908374,,False,10.0,1,2,1,2,0,0,0,0,0,2,2,0,0,0,2,2,2
400915351,Virginia Cavaliers,T. Jerome,4065733,,False,9.0,0,0,0,0,0,0,0,0,0,2,2,2,0,0,1,2,0
400915351,Virginia Cavaliers,K. Guy,4065730,,False,23.0,5,12,1,5,4,7,0,0,0,3,3,0,0,0,1,1,14
400915351,Virginia Cavaliers,M. Shayok,3138201,,False,15.0,4,8,2,6,2,2,0,0,0,1,1,1,1,1,2,0,10
400915351,Virginia Cavaliers,TEAM,TOTAL,TOTAL,False,,23,51,14,35,9,16,3,5,6,28,34,8,3,6,13,18,58
400915351,Florida State Seminoles,J. Isaac,4065654,,True,28.0,1,6,1,5,0,1,3,5,3,6,9,0,0,2,1,1,5
400915351,Florida State Seminoles,M. Ojo,61596,,True,17.0,0,4,0,4,0,0,0,0,2,4,6,0,0,0,2,0,0
400915351,Florida State Seminoles,T. Mann,3907823,,True,24.0,2,4,2,4,0,0,2,6,0,3,3,2,1,0,2,4,6
400915351,Florida State Seminoles,D. Bacon,3907821,,True,28.0,11,18,5,9,6,9,1,4,1,0,1,0,2,0,1,1,29
400915351,Florida State Seminoles,X. Rathan-Mayes,66125,,True,27.0,2,5,1,3,1,2,5,6,0,4,4,3,0,0,0,4,10
400915351,Florida State Seminoles,P. Cofer,3135054,,False,12.0,2,4,1,2,1,2,0,0,1,3,4,0,0,0,0,0,5
400915351,Florida State Seminoles,J. Smith,66126,,False,15.0,1,2,1,2,0,0,1,3,2,1,3,0,0,1,2,1,3
400915351,Florida State Seminoles,C. Koumadje,3907824,,False,8.0,0,0,0,0,0,0,0,0,0,0,0,0,0,0,1,2,0
400915351,Florida State Seminoles,B. Angola-Rodas,4065658,,False,10.0,0,1,0,0,0,1,0,0,0,0,0,0,0,0,0,1,0
400915351,Florida State Seminoles,T. Forrest,4065656,,False,22.0,0,3,0,3,0,0,0,0,1,1,2,2,2,0,1,1,0
400915351,Florida State Seminoles,C. Walker,4065655,,False,9.0,1,2,1,2,0,0,0,0,0,0,0,1,1,0,1,0,2
400915351,Florida State Seminoles,TEAM,TOTAL,TOTAL,False,,20,49,12,34,8,15,12,24,12,23,35,8,6,3,12,15,60
400915351,Florida State Seminoles,J. Isaac,4065654,,True,28.0,1,6,1,5,0,1,3,5,3,6,9,0,0,2,1,1,5
400915351,Florida State Seminoles,M. Ojo,61596,,True,17.0,0,4,0,4,0,0,0,0,2,4,6,0,0,0,2,0,0
400915351,Florida State Seminoles,T. Mann,3907823,,True,24.0,2,4,2,4,0,0,2,6,0,3,3,2,1,0,2,4,6
400915351,Florida State Seminoles,D. Bacon,3907821,,True,28.0,11,18,5,9,6,9,1,4,1,0,1,0,2,0,1,1,29
400915351,Florida State Seminoles,X. Rathan-Mayes,66125,,True,27.0,2,5,1,3,1,2,5,6,0,4,4,3,0,0,0,4,10
400915351,Florida State Seminoles,P. Cofer,3135054,,False,12.0,2,4,1,2,1,2,0,0,1,3,4,0,0,0,0,0,5
400915351,Florida State Seminoles,J. Smith,66126,,False,15.0,1,2,1,2,0,0,1,3,2,1,3,0,0,1,2,1,3
400915351,Florida State Seminoles,C. Koumadje,3907824,,False,8.0,0,0,0,0,0,0,0,0,0,0,0,0,0,0,1,2,0
400915351,Florida State Seminoles,B. Angola-Rodas,4065658,,False,10.0,0,1,0,0,0,1,0,0,0,0,0,0,0,0,0,1,0
400915351,Florida State Seminoles,T. Forrest,4065656,,False,22.0,0,3,0,3,0,0,0,0,1,1,2,2,2,0,1,1,0
400915351,Florida State Seminoles,C. Walker,4065655,,False,9.0,1,2,1,2,0,0,0,0,0,0,0,1,1,0,1,0,2
400915351,Florida State Seminoles,TEAM,TOTAL,TOTAL,False,,20,49,12,34,8,15,12,24,12,23,35,8,6,3,12,15,60
400915350,North Carolina Tar Heels,J. Jackson,3138156,,True,34.0,6,17,6,12,0,5,4,5,0,4,4,3,0,0,3,1,16
400915350,North Carolina Tar Heels,I. Hicks,66874,,True,23.0,4,7,4,7,0,0,1,3,3,1,4,1,0,3,4,4,9
400915350,North Carolina Tar Heels,K. Meeks,66873,,True,24.0,2,6,2,6,0,0,3,4,5,9,14,2,0,1,0,0,7
400915350,North Carolina Tar Heels,K. Williams,3911619,,True,25.0,1,7,1,1,0,6,2,2,3,1,4,2,3,1,0,3,4
400915350,North Carolina Tar Heels,J. Berry II,3138155,,True,30.0,3,13,1,4,2,9,0,0,0,2,2,1,1,0,6,4,8
400915350,North Carolina Tar Heels,T. Bradley,4065673,,False,9.0,0,2,0,2,0,0,0,0,0,2,2,0,0,0,0,1,0
400915350,North Carolina Tar Heels,L. Maye,3911620,,False,11.0,3,6,3,6,0,0,0,0,5,1,6,0,1,1,2,3,6
400915350,North Carolina Tar Heels,S. Woods,4065676,,False,3.0,0,0,0,0,0,0,0,0,0,1,1,2,0,0,1,0,0
400915350,North Carolina Tar Heels,B. Robinson,4065675,,False,9.0,0,5,0,4,0,1,0,0,2,0,2,0,0,0,2,1,0
400915350,North Carolina Tar Heels,N. Britt,66872,,False,26.0,5,8,2,4,3,4,0,0,1,2,3,2,5,0,2,4,13
400915350,North Carolina Tar Heels,S. White,56963,,False,6.0,0,1,0,0,0,1,0,0,0,1,1,0,0,0,0,1,0
400915350,North Carolina Tar Heels,TEAM,TOTAL,TOTAL,False,,24,72,19,46,5,26,10,14,19,25,44,13,10,6,20,22,63
400915350,North Carolina Tar Heels,J. Jackson,3138156,,True,34.0,6,17,6,12,0,5,4,5,0,4,4,3,0,0,3,1,16
400915350,North Carolina Tar Heels,I. Hicks,66874,,True,23.0,4,7,4,7,0,0,1,3,3,1,4,1,0,3,4,4,9
400915350,North Carolina Tar Heels,K. Meeks,66873,,True,24.0,2,6,2,6,0,0,3,4,5,9,14,2,0,1,0,0,7
400915350,North Carolina Tar Heels,K. Williams,3911619,,True,25.0,1,7,1,1,0,6,2,2,3,1,4,2,3,1,0,3,4
400915350,North Carolina Tar Heels,J. Berry II,3138155,,True,30.0,3,13,1,4,2,9,0,0,0,2,2,1,1,0,6,4,8
400915350,North Carolina Tar Heels,T. Bradley,4065673,,False,9.0,0,2,0,2,0,0,0,0,0,2,2,0,0,0,0,1,0
400915350,North Carolina Tar Heels,L. Maye,3911620,,False,11.0,3,6,3,6,0,0,0,0,5,1,6,0,1,1,2,3,6
400915350,North Carolina Tar Heels,S. Woods,4065676,,False,3.0,0,0,0,0,0,0,0,0,0,1,1,2,0,0,1,0,0
400915350,North Carolina Tar Heels,B. Robinson,4065675,,False,9.0,0,5,0,4,0,1,0,0,2,0,2,0,0,0,2,1,0
400915350,North Carolina Tar Heels,N. Britt,66872,,False,26.0,5,8,2,4,3,4,0,0,1,2,3,2,5,0,2,4,13
400915350,North Carolina Tar Heels,S. White,56963,,False,6.0,0,1,0,0,0,1,0,0,0,1,1,0,0,0,0,1,0
400915350,North Carolina Tar Heels,TEAM,TOTAL,TOTAL,False,,24,72,19,46,5,26,10,14,19,25,44,13,10,6,20,22,63
400915350,Georgia Tech Yellow Jackets,Q. Stephens,66128,,True,38.0,3,10,2,4,1,6,4,4,1,8,9,1,4,3,3,2,11
400915350,Georgia Tech Yellow Jackets,B. Lammers,3135061,,True,38.0,4,11,4,11,0,0,3,4,3,8,11,4,2,2,0,1,11
400915350,Georgia Tech Yellow Jackets,J. Okogie,4065663,,True,35.0,7,14,6,11,1,3,11,13,1,4,5,3,2,0,4,4,26
400915350,Georgia Tech Yellow Jackets,J. Moore,4065662,,True,28.0,3,7,3,7,0,0,3,4,2,4,6,4,1,0,3,3,9
400915350,Georgia Tech Yellow Jackets,T. Jackson,3135057,,True,11.0,1,3,1,3,0,0,1,2,0,1,1,2,1,0,1,4,3
400915350,Georgia Tech Yellow Jackets,A. Gueye,3135059,,False,2.0,0,0,0,0,0,0,0,0,0,0,0,0,0,0,1,1,0
400915350,Georgia Tech Yellow Jackets,K. McCormick,61453,,False,9.0,0,0,0,0,0,0,0,0,0,1,1,0,0,0,0,0,0
400915350,Georgia Tech Yellow Jackets,J. Heath,67623,,False,34.0,4,7,3,5,1,2,6,6,0,1,1,2,3,0,3,3,15
400915350,Georgia Tech Yellow Jackets,C. Heyward,61609,,False,5.0,0,1,0,1,0,0,0,0,0,0,0,0,2,0,0,0,0
400915350,Georgia Tech Yellow Jackets,TEAM,TOTAL,TOTAL,False,,22,53,19,42,3,11,28,33,8,29,37,16,15,5,16,18,75
400915350,Georgia Tech Yellow Jackets,Q. Stephens,66128,,True,38.0,3,10,2,4,1,6,4,4,1,8,9,1,4,3,3,2,11
400915350,Georgia Tech Yellow Jackets,B. Lammers,3135061,,True,38.0,4,11,4,11,0,0,3,4,3,8,11,4,2,2,0,1,11
400915350,Georgia Tech Yellow Jackets,J. Okogie,4065663,,True,35.0,7,14,6,11,1,3,11,13,1,4,5,3,2,0,4,4,26
400915350,Georgia Tech Yellow Jackets,J. Moore,4065662,,True,28.0,3,7,3,7,0,0,3,4,2,4,6,4,1,0,3,3,9
400915350,Georgia Tech Yellow Jackets,T. Jackson,3135057,,True,11.0,1,3,1,3,0,0,1,2,0,1,1,2,1,0,1,4,3
400915350,Georgia Tech Yellow Jackets,A. Gueye,3135059,,False,2.0,0,0,0,0,0,0,0,0,0,0,0,0,0,0,1,1,0
400915350,Georgia Tech Yellow Jackets,K. McCormick,61453,,False,9.0,0,0,0,0,0,0,0,0,0,1,1,0,0,0,0,0,0
400915350,Georgia Tech Yellow Jackets,J. Heath,67623,,False,34.0,4,7,3,5,1,2,6,6,0,1,1,2,3,0,3,3,15
400915350,Georgia Tech Yellow Jackets,C. Heyward,61609,,False,5.0,0,1,0,1,0,0,0,0,0,0,0,0,2,0,0,0,0
400915350,Georgia Tech Yellow Jackets,TEAM,TOTAL,TOTAL,False,,22,53,19,42,3,11,28,33,8,29,37,16,15,5,16,18,75
400915349,Pittsburgh Panthers,M. Young,66290,,True,40.0,10,24,6,15,4,9,1,1,1,6,7,7,2,0,1,1,25
400915349,Pittsburgh Panthers,S. Jeter,61756,,True,39.0,3,10,3,8,0,2,0,0,6,7,13,3,0,2,1,3,6
400915349,Pittsburgh Panthers,J. Artis,66287,,True,42.0,9,17,4,9,5,8,2,2,4,5,9,3,1,0,1,0,25
400915349,Pittsburgh Panthers,J. Kithcart,4065713,,True,22.0,0,2,0,1,0,1,0,0,0,3,3,2,0,0,0,1,0
400915349,Pittsburgh Panthers,C. Johnson,3138196,,True,41.0,4,12,2,4,2,8,4,7,2,4,6,1,0,1,2,4,14
400915349,Pittsburgh Panthers,R. Nix,3934653,,False,1.0,0,0,0,0,0,0,0,0,0,0,0,0,0,0,0,0,0
400915349,Pittsburgh Panthers,R. Luther,3138197,,False,12.0,1,4,0,2,1,2,0,0,1,1,2,0,0,0,3,3,3
400915349,Pittsburgh Panthers,J. Milligan,3934655,,False,2.0,0,0,0,0,0,0,0,0,0,0,0,0,0,0,1,0,0
400915349,Pittsburgh Panthers,C. Jones,61219,,False,26.0,0,3,0,2,0,1,4,4,0,2,2,2,2,0,0,1,4
400915349,Pittsburgh Panthers,TEAM,TOTAL,TOTAL,False,,27,72,15,41,12,31,11,14,16,29,45,18,5,3,9,13,77
400915349,Pittsburgh Panthers,M. Young,66290,,True,40.0,10,24,6,15,4,9,1,1,1,6,7,7,2,0,1,1,25
400915349,Pittsburgh Panthers,S. Jeter,61756,,True,39.0,3,10,3,8,0,2,0,0,6,7,13,3,0,2,1,3,6
400915349,Pittsburgh Panthers,J. Artis,66287,,True,42.0,9,17,4,9,5,8,2,2,4,5,9,3,1,0,1,0,25
400915349,Pittsburgh Panthers,J. Kithcart,4065713,,True,22.0,0,2,0,1,0,1,0,0,0,3,3,2,0,0,0,1,0
400915349,Pittsburgh Panthers,C. Johnson,3138196,,True,41.0,4,12,2,4,2,8,4,7,2,4,6,1,0,1,2,4,14
400915349,Pittsburgh Panthers,R. Nix,3934653,,False,1.0,0,0,0,0,0,0,0,0,0,0,0,0,0,0,0,0,0
400915349,Pittsburgh Panthers,R. Luther,3138197,,False,12.0,1,4,0,2,1,2,0,0,1,1,2,0,0,0,3,3,3
400915349,Pittsburgh Panthers,J. Milligan,3934655,,False,2.0,0,0,0,0,0,0,0,0,0,0,0,0,0,0,1,0,0
400915349,Pittsburgh Panthers,C. Jones,61219,,False,26.0,0,3,0,2,0,1,4,4,0,2,2,2,2,0,0,1,4
400915349,Pittsburgh Panthers,TEAM,TOTAL,TOTAL,False,,27,72,15,41,12,31,11,14,16,29,45,18,5,3,9,13,77
400915349,Notre Dame Fighting Irish,B. Colson,3138192,,True,40.0,10,20,10,19,0,1,1,1,6,8,14,3,1,1,2,2,21
400915349,Notre Dame Fighting Irish,M. Geben,3138191,,True,28.0,4,4,4,4,0,0,2,2,2,7,9,2,0,0,0,5,10
400915349,Notre Dame Fighting Irish,V.J. Beachem,66283,,True,35.0,3,10,3,5,0,5,0,2,0,2,2,2,1,1,0,0,6
400915349,Notre Dame Fighting Irish,M. Farrell,3138190,,True,42.0,6,14,2,7,4,7,0,1,1,4,5,3,1,0,3,0,16
400915349,Notre Dame Fighting Irish,S. Vasturia,66285,,True,36.0,4,12,1,4,3,8,4,4,1,1,2,5,2,0,3,4,15
400915349,Notre Dame Fighting Irish,A. Torres,66286,,False,1.0,0,0,0,0,0,0,0,0,0,0,0,0,0,0,0,0,0
400915349,Notre Dame Fighting Irish,M. Ryan,3908336,,False,6.0,0,1,0,0,0,1,0,0,1,1,2,0,0,0,0,0,0
400915349,Notre Dame Fighting Irish,T. Gibbs,4065703,,False,12.0,3,6,2,3,1,3,0,0,0,0,0,1,0,0,0,1,7
400915349,Notre Dame Fighting Irish,R. Pflueger,3908335,,False,25.0,1,2,0,0,1,2,0,0,0,2,2,2,1,1,1,2,3
400915349,Notre Dame Fighting Irish,TEAM,TOTAL,TOTAL,False,,31,69,22,42,9,27,7,10,12,27,39,18,6,3,9,14,78
400915349,Notre Dame Fighting Irish,B. Colson,3138192,,True,40.0,10,20,10,19,0,1,1,1,6,8,14,3,1,1,2,2,21
400915349,Notre Dame Fighting Irish,M. Geben,3138191,,True,28.0,4,4,4,4,0,0,2,2,2,7,9,2,0,0,0,5,10
400915349,Notre Dame Fighting Irish,V.J. Beachem,66283,,True,35.0,3,10,3,5,0,5,0,2,0,2,2,2,1,1,0,0,6
400915349,Notre Dame Fighting Irish,M. Farrell,3138190,,True,42.0,6,14,2,7,4,7,0,1,1,4,5,3,1,0,3,0,16
400915349,Notre Dame Fighting Irish,S. Vasturia,66285,,True,36.0,4,12,1,4,3,8,4,4,1,1,2,5,2,0,3,4,15
400915349,Notre Dame Fighting Irish,A. Torres,66286,,False,1.0,0,0,0,0,0,0,0,0,0,0,0,0,0,0,0,0,0
400915349,Notre Dame Fighting Irish,M. Ryan,3908336,,False,6.0,0,1,0,0,0,1,0,0,1,1,2,0,0,0,0,0,0
400915349,Notre Dame Fighting Irish,T. Gibbs,4065703,,False,12.0,3,6,2,3,1,3,0,0,0,0,0,1,0,0,0,1,7
400915349,Notre Dame Fighting Irish,R. Pflueger,3908335,,False,25.0,1,2,0,0,1,2,0,0,0,2,2,2,1,1,1,2,3
400915349,Notre Dame Fighting Irish,TEAM,TOTAL,TOTAL,False,,31,69,22,42,9,27,7,10,12,27,39,18,6,3,9,14,78
400915348,Wake Forest Demon Deacons,J. Collins,3908845,,True,30.0,9,13,9,13,0,0,2,2,4,3,7,0,0,2,1,2,20
400915348,Wake Forest Demon Deacons,D. Mitoglou,3138224,,True,23.0,1,3,0,1,1,2,0,0,2,3,5,0,0,1,1,2,3
400915348,Wake Forest Demon Deacons,A. Arians,61378,,True,22.0,0,3,0,0,0,3,0,0,0,3,3,2,1,0,3,1,0
400915348,Wake Forest Demon Deacons,B. Crawford,3908844,,True,34.0,5,13,1,7,4,6,2,2,0,8,8,4,2,0,5,3,16
400915348,Wake Forest Demon Deacons,K. Woods,3132360,,True,33.0,5,13,3,7,2,6,4,5,0,5,5,3,0,0,4,3,16
400915348,Wake Forest Demon Deacons,G. McClinton,66140,,False,11.0,2,2,2,2,0,0,0,0,1,0,1,0,0,0,0,3,4
400915348,Wake Forest Demon Deacons,S. Japhet-Mathias,4065752,,False,2.0,0,0,0,0,0,0,0,0,0,0,0,0,0,0,0,1,0
400915348,Wake Forest Demon Deacons,D. Moore,3908843,,False,7.0,1,1,1,1,0,0,0,0,0,1,1,0,0,0,0,1,2
400915348,Wake Forest Demon Deacons,B. Childress,4065750,,False,18.0,0,7,0,3,0,4,0,0,0,2,2,2,1,0,1,0,0
400915348,Wake Forest Demon Deacons,M. Wilbekin,3138222,,False,20.0,2,5,1,3,1,2,2,2,0,2,2,1,0,0,1,2,7
400915348,Wake Forest Demon Deacons,T. VanHorn,3078214,,False,0.0,0,0,0,0,0,0,0,0,0,0,0,0,0,0,0,0,0
400915348,Wake Forest Demon Deacons,TEAM,TOTAL,TOTAL,False,,25,60,17,37,8,23,10,11,11,27,38,12,4,3,16,18,68
400915348,Wake Forest Demon Deacons,J. Collins,3908845,,True,30.0,9,13,9,13,0,0,2,2,4,3,7,0,0,2,1,2,20
400915348,Wake Forest Demon Deacons,D. Mitoglou,3138224,,True,23.0,1,3,0,1,1,2,0,0,2,3,5,0,0,1,1,2,3
400915348,Wake Forest Demon Deacons,A. Arians,61378,,True,22.0,0,3,0,0,0,3,0,0,0,3,3,2,1,0,3,1,0
400915348,Wake Forest Demon Deacons,B. Crawford,3908844,,True,34.0,5,13,1,7,4,6,2,2,0,8,8,4,2,0,5,3,16
400915348,Wake Forest Demon Deacons,K. Woods,3132360,,True,33.0,5,13,3,7,2,6,4,5,0,5,5,3,0,0,4,3,16
400915348,Wake Forest Demon Deacons,G. McClinton,66140,,False,11.0,2,2,2,2,0,0,0,0,1,0,1,0,0,0,0,3,4
400915348,Wake Forest Demon Deacons,S. Japhet-Mathias,4065752,,False,2.0,0,0,0,0,0,0,0,0,0,0,0,0,0,0,0,1,0
400915348,Wake Forest Demon Deacons,D. Moore,3908843,,False,7.0,1,1,1,1,0,0,0,0,0,1,1,0,0,0,0,1,2
400915348,Wake Forest Demon Deacons,B. Childress,4065750,,False,18.0,0,7,0,3,0,4,0,0,0,2,2,2,1,0,1,0,0
400915348,Wake Forest Demon Deacons,M. Wilbekin,3138222,,False,20.0,2,5,1,3,1,2,2,2,0,2,2,1,0,0,1,2,7
400915348,Wake Forest Demon Deacons,T. VanHorn,3078214,,False,0.0,0,0,0,0,0,0,0,0,0,0,0,0,0,0,0,0,0
400915348,Wake Forest Demon Deacons,TEAM,TOTAL,TOTAL,False,,25,60,17,37,8,23,10,11,11,27,38,12,4,3,16,18,68
400915348,Clemson Tigers,D. Grantham,3129674,,True,25.0,4,10,3,8,1,2,2,3,4,6,10,0,0,1,1,1,11
400915348,Clemson Tigers,J. Blossomgame,61835,,True,33.0,6,12,6,10,0,2,2,4,1,2,3,1,0,1,2,1,14
400915348,Clemson Tigers,S. Djitte,66122,,True,22.0,1,1,1,1,0,0,0,0,2,3,5,2,0,1,1,3,2
400915348,Clemson Tigers,S. Mitchell,3136699,,True,28.0,1,8,1,6,0,2,1,2,0,3,3,5,1,0,3,1,3
400915348,Clemson Tigers,A. Holmes,62043,,True,22.0,3,5,0,0,3,5,0,2,0,1,1,2,1,0,2,2,9
400915348,Clemson Tigers,E. Thomas,3947075,,False,16.0,4,6,4,6,0,0,0,0,0,0,0,0,2,0,1,5,8
400915348,Clemson Tigers,T. Hudson,3917986,,False,2.0,0,0,0,0,0,0,0,0,0,0,0,0,0,0,0,0,0
400915348,Clemson Tigers,M. Reed,3133969,,False,25.0,6,11,3,5,3,6,6,7,1,3,4,3,4,0,0,2,21
400915348,Clemson Tigers,G. DeVoe,3129673,,False,27.0,2,5,1,2,1,3,0,2,0,4,4,3,3,0,1,1,5
400915348,Clemson Tigers,TEAM,TOTAL,TOTAL,False,,27,58,19,38,8,20,11,20,8,25,33,16,11,3,11,16,73
400915348,Clemson Tigers,D. Grantham,3129674,,True,25.0,4,10,3,8,1,2,2,3,4,6,10,0,0,1,1,1,11
400915348,Clemson Tigers,J. Blossomgame,61835,,True,33.0,6,12,6,10,0,2,2,4,1,2,3,1,0,1,2,1,14
400915348,Clemson Tigers,S. Djitte,66122,,True,22.0,1,1,1,1,0,0,0,0,2,3,5,2,0,1,1,3,2
400915348,Clemson Tigers,S. Mitchell,3136699,,True,28.0,1,8,1,6,0,2,1,2,0,3,3,5,1,0,3,1,3
400915348,Clemson Tigers,A. Holmes,62043,,True,22.0,3,5,0,0,3,5,0,2,0,1,1,2,1,0,2,2,9
400915348,Clemson Tigers,E. Thomas,3947075,,False,16.0,4,6,4,6,0,0,0,0,0,0,0,0,2,0,1,5,8
400915348,Clemson Tigers,T. Hudson,3917986,,False,2.0,0,0,0,0,0,0,0,0,0,0,0,0,0,0,0,0,0
400915348,Clemson Tigers,M. Reed,3133969,,False,25.0,6,11,3,5,3,6,6,7,1,3,4,3,4,0,0,2,21
400915348,Clemson Tigers,G. DeVoe,3129673,,False,27.0,2,5,1,2,1,3,0,2,0,4,4,3,3,0,1,1,5
400915348,Clemson Tigers,TEAM,TOTAL,TOTAL,False,,27,58,19,38,8,20,11,20,8,25,33,16,11,3,11,16,73
400915347,Virginia Tech Hokies,K. Sy,4065740,,True,9.0,1,4,1,4,0,0,0,0,2,4,6,0,0,1,0,3,2
400915347,Virginia Tech Hokies,C. Clarke,3945567,,True,16.0,5,5,5,5,0,0,3,6,1,5,6,2,0,0,1,3,13
400915347,Virginia Tech Hokies,J. Robinson,3945566,,True,39.0,5,11,3,8,2,3,2,2,0,5,5,7,1,0,2,2,14
400915347,Virginia Tech Hokies,A. Hill,3147501,,True,36.0,6,15,4,11,2,4,3,5,1,2,3,2,0,0,1,3,17
400915347,Virginia Tech Hokies,J. Bibbs,3147500,,True,24.0,6,9,2,4,4,5,2,2,0,1,1,1,2,1,1,2,18
400915347,Virginia Tech Hokies,Z. LeDay,61698,,False,31.0,3,5,3,5,0,0,5,9,2,5,7,0,0,2,1,1,11
400915347,Virginia Tech Hokies,T. Outlaw,67275,,False,13.0,0,1,0,0,0,1,0,0,0,2,2,1,0,0,1,2,0
400915347,Virginia Tech Hokies,S. Allen,61795,,False,32.0,6,8,6,8,0,0,2,2,0,1,1,5,0,0,2,3,14
400915347,Virginia Tech Hokies,TEAM,TOTAL,TOTAL,False,,32,58,24,45,8,13,17,26,8,25,33,18,3,4,9,19,89
400915347,Virginia Tech Hokies,K. Sy,4065740,,True,9.0,1,4,1,4,0,0,0,0,2,4,6,0,0,1,0,3,2
400915347,Virginia Tech Hokies,C. Clarke,3945567,,True,16.0,5,5,5,5,0,0,3,6,1,5,6,2,0,0,1,3,13
400915347,Virginia Tech Hokies,J. Robinson,3945566,,True,39.0,5,11,3,8,2,3,2,2,0,5,5,7,1,0,2,2,14
400915347,Virginia Tech Hokies,A. Hill,3147501,,True,36.0,6,15,4,11,2,4,3,5,1,2,3,2,0,0,1,3,17
400915347,Virginia Tech Hokies,J. Bibbs,3147500,,True,24.0,6,9,2,4,4,5,2,2,0,1,1,1,2,1,1,2,18
400915347,Virginia Tech Hokies,Z. LeDay,61698,,False,31.0,3,5,3,5,0,0,5,9,2,5,7,0,0,2,1,1,11
400915347,Virginia Tech Hokies,T. Outlaw,67275,,False,13.0,0,1,0,0,0,1,0,0,0,2,2,1,0,0,1,2,0
400915347,Virginia Tech Hokies,S. Allen,61795,,False,32.0,6,8,6,8,0,0,2,2,0,1,1,5,0,0,2,3,14
400915347,Virginia Tech Hokies,TEAM,TOTAL,TOTAL,False,,32,58,24,45,8,13,17,26,8,25,33,18,3,4,9,19,89
400915347,Duke Blue Devils,J. Tatum,4065648,,True,38.0,6,14,4,9,2,5,4,6,3,4,7,2,1,1,3,3,18
400915347,Duke Blue Devils,A. Jefferson,61586,,True,37.0,4,9,4,9,0,0,1,2,4,8,12,3,1,2,4,4,9
400915347,Duke Blue Devils,F. Jackson,4065651,,True,24.0,3,9,3,8,0,1,0,0,0,1,1,0,0,0,1,4,6
400915347,Duke Blue Devils,L. Kennard,3913174,,True,38.0,11,19,8,13,3,6,9,11,3,4,7,1,1,0,2,2,34
400915347,Duke Blue Devils,M. Jones,66563,,True,38.0,2,8,2,4,0,4,0,1,0,1,1,1,2,1,0,2,4
400915347,Duke Blue Devils,J. White,4065653,,False,3.0,0,0,0,0,0,0,0,0,1,0,1,0,0,0,0,1,0
400915347,Duke Blue Devils,H. Giles III,4065649,,False,13.0,2,6,2,6,0,0,0,0,4,4,8,1,0,0,0,3,4
400915347,Duke Blue Devils,M. Bolden,4065652,,False,3.0,0,2,0,2,0,0,0,2,3,0,3,0,0,0,0,0,0
400915347,Duke Blue Devils,C. Jeter,3913173,,False,6.0,0,0,0,0,0,0,0,0,0,1,1,0,0,1,0,1,0
400915347,Duke Blue Devils,TEAM,TOTAL,TOTAL,False,,28,67,23,51,5,16,14,22,18,23,41,8,5,5,11,20,75
400915347,Duke Blue Devils,J. Tatum,4065648,,True,38.0,6,14,4,9,2,5,4,6,3,4,7,2,1,1,3,3,18
400915347,Duke Blue Devils,A. Jefferson,61586,,True,37.0,4,9,4,9,0,0,1,2,4,8,12,3,1,2,4,4,9
400915347,Duke Blue Devils,F. Jackson,4065651,,True,24.0,3,9,3,8,0,1,0,0,0,1,1,0,0,0,1,4,6
400915347,Duke Blue Devils,L. Kennard,3913174,,True,38.0,11,19,8,13,3,6,9,11,3,4,7,1,1,0,2,2,34
400915347,Duke Blue Devils,M. Jones,66563,,True,38.0,2,8,2,4,0,4,0,1,0,1,1,1,2,1,0,2,4
400915347,Duke Blue Devils,J. White,4065653,,False,3.0,0,0,0,0,0,0,0,0,1,0,1,0,0,0,0,1,0
400915347,Duke Blue Devils,H. Giles III,4065649,,False,13.0,2,6,2,6,0,0,0,0,4,4,8,1,0,0,0,3,4
400915347,Duke Blue Devils,M. Bolden,4065652,,False,3.0,0,2,0,2,0,0,0,2,3,0,3,0,0,0,0,0,0
400915347,Duke Blue Devils,C. Jeter,3913173,,False,6.0,0,0,0,0,0,0,0,0,0,1,1,0,0,1,0,1,0
400915347,Duke Blue Devils,TEAM,TOTAL,TOTAL,False,,28,67,23,51,5,16,14,22,18,23,41,8,5,5,11,20,75
400915346,North Carolina Tar Heels,J. Jackson,3138156,,True,29.0,9,15,3,6,6,9,4,4,1,4,5,5,1,0,2,1,28
400915346,North Carolina Tar Heels,I. Hicks,66874,,True,25.0,6,12,6,12,0,0,3,4,3,6,9,1,0,0,3,3,15
400915346,North Carolina Tar Heels,K. Meeks,66873,,True,24.0,7,12,7,12,0,0,3,5,4,8,12,3,0,1,2,1,17
400915346,North Carolina Tar Heels,K. Williams,3911619,,True,23.0,3,8,2,5,1,3,0,0,4,3,7,2,0,0,3,2,7
400915346,North Carolina Tar Heels,J. Berry II,3138155,,True,23.0,0,4,0,1,0,3,6,6,0,3,3,5,0,0,0,2,6
400915346,North Carolina Tar Heels,A. Rohlman,4065677,,False,2.0,0,0,0,0,0,0,0,0,0,1,1,0,0,0,0,1,0
400915346,North Carolina Tar Heels,S. Rush,4065674,,False,2.0,0,1,0,0,0,1,2,4,0,0,0,0,1,0,0,1,2
400915346,North Carolina Tar Heels,T. Bradley,4065673,,False,14.0,3,7,3,7,0,0,4,7,5,2,7,1,1,3,2,1,10
400915346,North Carolina Tar Heels,L. Maye,3911620,,False,11.0,0,3,0,2,0,1,2,2,1,2,3,2,0,0,1,2,2
400915346,North Carolina Tar Heels,S. Woods,4065676,,False,11.0,0,2,0,1,0,1,0,4,0,2,2,1,1,0,3,1,0
400915346,North Carolina Tar Heels,B. Robinson,4065675,,False,16.0,0,1,0,1,0,0,4,5,0,1,1,1,0,0,0,3,4
400915346,North Carolina Tar Heels,K. Coker,3947144,,False,2.0,0,1,0,1,0,0,3,3,0,1,1,0,0,0,0,1,3
400915346,North Carolina Tar Heels,N. Britt,66872,,False,12.0,2,5,2,3,0,2,0,0,1,0,1,1,0,0,0,4,4
400915346,North Carolina Tar Heels,S. White,56963,,False,6.0,1,1,1,1,0,0,2,2,0,0,0,0,0,0,1,2,4
400915346,North Carolina Tar Heels,TEAM,TOTAL,TOTAL,False,,31,72,24,52,7,20,33,46,21,36,57,22,4,4,17,25,102
400915346,Monmouth Hawks,C. Brady,67377,,True,14.0,1,4,0,3,1,1,0,0,1,2,3,0,0,3,1,5,3
400915346,Monmouth Hawks,M. Seaborn,3153963,,True,32.0,6,20,3,10,3,10,4,4,1,2,3,1,1,0,3,3,19
400915346,Monmouth Hawks,J. Robinson,67373,,True,34.0,7,15,6,11,1,4,1,1,2,2,4,4,2,0,2,0,16
400915346,Monmouth Hawks,J. James,67370,,True,17.0,1,3,1,3,0,0,0,0,0,4,4,0,0,0,0,3,2
400915346,Monmouth Hawks,J. Hornbeak,61664,,True,25.0,4,13,1,4,3,9,6,8,1,3,4,0,0,1,2,5,17
400915346,Monmouth Hawks,M. Traore,3975762,,False,5.0,0,0,0,0,0,0,0,0,0,0,0,0,0,0,0,0,0
400915346,Monmouth Hawks,P. Sarr,3948710,,False,15.0,0,0,0,0,0,0,0,2,1,3,4,0,2,1,2,2,0
400915346,Monmouth Hawks,S. Ibiezugbe,4067330,,False,8.0,0,1,0,1,0,0,0,1,3,1,4,0,0,0,0,0,0
400915346,Monmouth Hawks,D. Quinn,3948714,,False,14.0,2,3,2,3,0,0,0,0,1,3,4,0,0,2,1,4,4
400915346,Monmouth Hawks,L. Pillari,3948713,,False,3.0,0,2,0,2,0,0,0,0,1,0,1,0,0,0,0,1,0
400915346,Monmouth Hawks,A. Tilghman,3153965,,False,17.0,1,4,1,3,0,1,8,8,0,1,1,0,0,0,2,2,10
400915346,Monmouth Hawks,D. Pillari,3153964,,False,3.0,0,1,0,0,0,1,0,2,0,1,1,0,0,0,1,3,0
400915346,Monmouth Hawks,C. Stewart,61513,,False,13.0,1,4,0,2,1,2,0,0,0,2,2,2,2,1,1,2,3
400915346,Monmouth Hawks,TEAM,TOTAL,TOTAL,False,,23,70,14,42,9,28,19,26,12,24,36,7,7,8,15,30,74
400915345,Saint Peter's Peacocks,Q. Welton,67511,,True,33.0,2,11,2,11,0,0,1,4,0,8,8,4,1,1,0,1,5
400915345,Saint Peter's Peacocks,T. Wyche,67512,,True,30.0,1,8,1,5,0,3,2,2,0,1,1,4,1,0,1,3,4
400915345,Saint Peter's Peacocks,N. Enechionyia,67276,,True,16.0,3,5,1,1,2,4,0,0,0,0,0,0,0,0,1,2,8
400915345,Saint Peter's Peacocks,N. Griffin,66396,,True,28.0,5,9,1,1,4,8,2,2,1,1,2,0,0,1,1,0,16
400915345,Saint Peter's Peacocks,C. Patterson,62062,,True,24.0,0,2,0,1,0,1,2,2,1,3,4,1,2,0,1,2,2
400915345,Saint Peter's Peacocks,M. Ndiaye,3922044,,False,7.0,0,1,0,1,0,0,0,0,0,0,0,0,0,0,0,1,0
400915345,Saint Peter's Peacocks,S. Idowu,3922042,,False,7.0,1,2,1,1,0,1,0,0,0,0,0,0,0,0,0,1,2
400915345,Saint Peter's Peacocks,Q. Taylor,4067357,,False,18.0,3,6,3,5,0,1,1,1,1,2,3,1,1,0,0,0,7
400915345,Saint Peter's Peacocks,A. Portley,3922045,,False,27.0,4,9,3,5,1,4,0,0,0,4,4,0,2,0,2,1,9
400915345,Saint Peter's Peacocks,C. Baker,62367,,False,10.0,1,3,1,1,0,2,0,0,1,2,3,0,1,0,1,1,2
400915345,Saint Peter's Peacocks,TEAM,TOTAL,TOTAL,False,,20,56,13,32,7,24,8,11,6,22,28,10,8,2,9,12,55
400915345,Notre Dame Fighting Irish,B. Colson,3138192,,True,32.0,5,11,5,10,0,1,0,0,1,7,8,2,2,2,2,1,10
400915345,Notre Dame Fighting Irish,M. Geben,3138191,,True,19.0,2,3,2,3,0,0,0,0,1,6,7,1,0,2,1,1,4
400915345,Notre Dame Fighting Irish,V.J. Beachem,66283,,True,34.0,6,15,4,8,2,7,4,5,1,4,5,3,1,1,1,2,18
400915345,Notre Dame Fighting Irish,M. Farrell,3138190,,True,31.0,2,5,1,2,1,3,1,2,0,4,4,3,0,0,4,3,6
400915345,Notre Dame Fighting Irish,S. Vasturia,66285,,True,36.0,4,6,2,2,2,4,1,2,0,4,4,3,0,0,1,0,11
400915345,Notre Dame Fighting Irish,J. Mooney,4065705,,False,1.0,0,0,0,0,0,0,0,0,0,0,0,0,0,0,0,1,0
400915345,Notre Dame Fighting Irish,E. Burns,3908337,,False,1.0,0,0,0,0,0,0,0,0,0,0,0,0,0,0,0,0,0
400915345,Notre Dame Fighting Irish,A. Torres,66286,,False,9.0,0,0,0,0,0,0,0,0,0,1,1,0,0,0,0,0,0
400915345,Notre Dame Fighting Irish,M. Ryan,3908336,,False,7.0,1,2,0,0,1,2,0,0,0,1,1,0,0,0,2,3,3
400915345,Notre Dame Fighting Irish,T. Gibbs,4065703,,False,12.0,1,2,1,1,0,1,3,4,0,2,2,2,1,1,1,1,5
400915345,Notre Dame Fighting Irish,R. Pflueger,3908335,,False,18.0,3,5,3,4,0,1,0,0,0,1,1,1,1,0,2,0,6
400915345,Notre Dame Fighting Irish,TEAM,TOTAL,TOTAL,False,,24,49,18,30,6,19,9,13,5,32,37,15,5,6,14,12,63
400915344,Virginia Cavaliers,I. Wilkins,3138203,,True,30.0,2,4,2,4,0,0,0,0,3,2,5,1,2,0,1,1,4
400915344,Virginia Cavaliers,J. Salt,3138200,,True,18.0,1,4,1,4,0,0,0,0,3,4,7,1,0,0,0,4,2
400915344,Virginia Cavaliers,D. Thompson,66274,,True,18.0,3,6,2,4,1,2,0,0,0,0,0,2,0,0,3,4,7
400915344,Virginia Cavaliers,L. Perrantes,66139,,True,37.0,2,10,1,6,1,4,4,6,0,4,4,7,0,0,5,1,9
400915344,Virginia Cavaliers,D. Hall,66138,,True,30.0,5,10,5,10,0,0,0,1,0,6,6,0,2,0,1,2,10
400915344,Virginia Cavaliers,M. Diakite,3947156,,False,15.0,3,3,3,3,0,0,2,2,1,3,4,0,2,0,1,2,8
400915344,Virginia Cavaliers,J. Reuter,3908374,,False,16.0,3,4,3,4,0,0,0,0,1,2,3,0,0,0,0,2,6
400915344,Virginia Cavaliers,T. Jerome,4065733,,False,6.0,0,0,0,0,0,0,0,0,0,0,0,1,0,0,1,1,0
400915344,Virginia Cavaliers,K. Guy,4065730,,False,19.0,3,5,3,4,0,1,3,3,0,1,1,0,1,0,1,0,9
400915344,Virginia Cavaliers,M. Shayok,3138201,,False,11.0,2,3,2,2,0,1,2,2,0,1,1,0,0,0,0,2,6
400915344,Virginia Cavaliers,TEAM,TOTAL,TOTAL,False,,24,49,22,41,2,8,11,14,8,23,31,12,7,0,14,19,61
400915344,Virginia Cavaliers,I. Wilkins,3138203,,True,30.0,2,4,2,4,0,0,0,0,3,2,5,1,2,0,1,1,4
400915344,Virginia Cavaliers,J. Salt,3138200,,True,18.0,1,4,1,4,0,0,0,0,3,4,7,1,0,0,0,4,2
400915344,Virginia Cavaliers,D. Thompson,66274,,True,18.0,3,6,2,4,1,2,0,0,0,0,0,2,0,0,3,4,7
400915344,Virginia Cavaliers,L. Perrantes,66139,,True,37.0,2,10,1,6,1,4,4,6,0,4,4,7,0,0,5,1,9
400915344,Virginia Cavaliers,D. Hall,66138,,True,30.0,5,10,5,10,0,0,0,1,0,6,6,0,2,0,1,2,10
400915344,Virginia Cavaliers,M. Diakite,3947156,,False,15.0,3,3,3,3,0,0,2,2,1,3,4,0,2,0,1,2,8
400915344,Virginia Cavaliers,J. Reuter,3908374,,False,16.0,3,4,3,4,0,0,0,0,1,2,3,0,0,0,0,2,6
400915344,Virginia Cavaliers,T. Jerome,4065733,,False,6.0,0,0,0,0,0,0,0,0,0,0,0,1,0,0,1,1,0
400915344,Virginia Cavaliers,K. Guy,4065730,,False,19.0,3,5,3,4,0,1,3,3,0,1,1,0,1,0,1,0,9
400915344,Virginia Cavaliers,M. Shayok,3138201,,False,11.0,2,3,2,2,0,1,2,2,0,1,1,0,0,0,0,2,6
400915344,Virginia Cavaliers,TEAM,TOTAL,TOTAL,False,,24,49,22,41,2,8,11,14,8,23,31,12,7,0,14,19,61
400915344,Louisville Cardinals,M. Mathiang,63035,,True,15.0,0,0,0,0,0,0,0,0,1,4,5,1,1,0,2,1,0
400915344,Louisville Cardinals,D. Adel,3908807,,True,27.0,3,9,3,5,0,4,2,3,0,2,2,1,1,0,1,0,8
400915344,Louisville Cardinals,J. Johnson,3147362,,True,17.0,2,4,2,4,0,0,0,0,3,0,3,0,1,0,1,2,4
400915344,Louisville Cardinals,D. Mitchell,3908809,,True,36.0,3,11,2,5,1,6,0,0,0,2,2,0,1,0,1,4,7
400915344,Louisville Cardinals,Q. Snider,3147360,,True,23.0,2,5,1,3,1,2,3,6,1,0,1,1,0,0,0,2,8
400915344,Louisville Cardinals,V.J. King,4065666,,False,13.0,2,3,2,2,0,1,2,2,1,3,4,0,0,0,1,0,6
400915344,Louisville Cardinals,R. Spalding,3908806,,False,23.0,1,2,1,2,0,0,1,2,2,4,6,1,0,0,2,1,3
400915344,Louisville Cardinals,A. Mahmoud,3147363,,False,25.0,2,5,2,5,0,0,3,5,0,3,3,2,0,2,2,1,7
400915344,Louisville Cardinals,R. McMahon,3908808,,False,2.0,0,0,0,0,0,0,2,2,0,0,0,0,0,0,1,1,2
400915344,Louisville Cardinals,T. Hicks,62752,,False,19.0,4,5,4,4,0,1,0,2,0,0,0,1,1,0,3,3,8
400915344,Louisville Cardinals,TEAM,TOTAL,TOTAL,False,,19,44,17,30,2,14,13,22,8,18,26,7,5,2,14,15,53
400915344,Louisville Cardinals,M. Mathiang,63035,,True,15.0,0,0,0,0,0,0,0,0,1,4,5,1,1,0,2,1,0
400915344,Louisville Cardinals,D. Adel,3908807,,True,27.0,3,9,3,5,0,4,2,3,0,2,2,1,1,0,1,0,8
400915344,Louisville Cardinals,J. Johnson,3147362,,True,17.0,2,4,2,4,0,0,0,0,3,0,3,0,1,0,1,2,4
400915344,Louisville Cardinals,D. Mitchell,3908809,,True,36.0,3,11,2,5,1,6,0,0,0,2,2,0,1,0,1,4,7
400915344,Louisville Cardinals,Q. Snider,3147360,,True,23.0,2,5,1,3,1,2,3,6,1,0,1,1,0,0,0,2,8
400915344,Louisville Cardinals,V.J. King,4065666,,False,13.0,2,3,2,2,0,1,2,2,1,3,4,0,0,0,1,0,6
400915344,Louisville Cardinals,R. Spalding,3908806,,False,23.0,1,2,1,2,0,0,1,2,2,4,6,1,0,0,2,1,3
400915344,Louisville Cardinals,A. Mahmoud,3147363,,False,25.0,2,5,2,5,0,0,3,5,0,3,3,2,0,2,2,1,7
400915344,Louisville Cardinals,R. McMahon,3908808,,False,2.0,0,0,0,0,0,0,2,2,0,0,0,0,0,0,1,1,2
400915344,Louisville Cardinals,T. Hicks,62752,,False,19.0,4,5,4,4,0,1,0,2,0,0,0,1,1,0,3,3,8
400915344,Louisville Cardinals,TEAM,TOTAL,TOTAL,False,,19,44,17,30,2,14,13,22,8,18,26,7,5,2,14,15,53
400915343,Wake Forest Demon Deacons,J. Collins,3908845,,True,18.0,1,3,1,3,0,0,0,0,0,3,3,0,0,0,2,4,2
400915343,Wake Forest Demon Deacons,D. Mitoglou,3138224,,True,29.0,2,6,2,5,0,1,1,2,3,4,7,3,1,1,1,0,5
400915343,Wake Forest Demon Deacons,A. Arians,61378,,True,27.0,4,5,1,1,3,4,0,0,1,0,1,0,1,0,0,2,11
400915343,Wake Forest Demon Deacons,B. Crawford,3908844,,True,31.0,5,15,3,8,2,7,4,4,0,4,4,3,4,0,7,4,16
400915343,Wake Forest Demon Deacons,K. Woods,3132360,,True,28.0,7,13,6,11,1,2,1,3,2,4,6,4,0,0,0,2,16
400915343,Wake Forest Demon Deacons,G. McClinton,66140,,False,13.0,2,3,2,3,0,0,0,0,1,0,1,0,1,0,0,1,4
400915343,Wake Forest Demon Deacons,S. Japhet-Mathias,4065752,,False,11.0,0,2,0,2,0,0,0,0,1,1,2,0,0,0,1,5,0
400915343,Wake Forest Demon Deacons,D. Moore,3908843,,False,2.0,0,1,0,1,0,0,0,0,0,1,1,0,0,1,0,0,0
400915343,Wake Forest Demon Deacons,B. Childress,4065750,,False,17.0,2,4,1,2,1,2,3,5,0,0,0,3,0,0,3,0,8
400915343,Wake Forest Demon Deacons,M. Wilbekin,3138222,,False,24.0,3,8,0,3,3,5,1,2,0,1,1,1,1,0,2,2,10
400915343,Wake Forest Demon Deacons,TEAM,TOTAL,TOTAL,False,,26,60,16,39,10,21,10,16,9,22,31,14,8,2,16,20,72
400915343,Wake Forest Demon Deacons,J. Collins,3908845,,True,18.0,1,3,1,3,0,0,0,0,0,3,3,0,0,0,2,4,2
400915343,Wake Forest Demon Deacons,D. Mitoglou,3138224,,True,29.0,2,6,2,5,0,1,1,2,3,4,7,3,1,1,1,0,5
400915343,Wake Forest Demon Deacons,A. Arians,61378,,True,27.0,4,5,1,1,3,4,0,0,1,0,1,0,1,0,0,2,11
400915343,Wake Forest Demon Deacons,B. Crawford,3908844,,True,31.0,5,15,3,8,2,7,4,4,0,4,4,3,4,0,7,4,16
400915343,Wake Forest Demon Deacons,K. Woods,3132360,,True,28.0,7,13,6,11,1,2,1,3,2,4,6,4,0,0,0,2,16
400915343,Wake Forest Demon Deacons,G. McClinton,66140,,False,13.0,2,3,2,3,0,0,0,0,1,0,1,0,1,0,0,1,4
400915343,Wake Forest Demon Deacons,S. Japhet-Mathias,4065752,,False,11.0,0,2,0,2,0,0,0,0,1,1,2,0,0,0,1,5,0
400915343,Wake Forest Demon Deacons,D. Moore,3908843,,False,2.0,0,1,0,1,0,0,0,0,0,1,1,0,0,1,0,0,0
400915343,Wake Forest Demon Deacons,B. Childress,4065750,,False,17.0,2,4,1,2,1,2,3,5,0,0,0,3,0,0,3,0,8
400915343,Wake Forest Demon Deacons,M. Wilbekin,3138222,,False,24.0,3,8,0,3,3,5,1,2,0,1,1,1,1,0,2,2,10
400915343,Wake Forest Demon Deacons,TEAM,TOTAL,TOTAL,False,,26,60,16,39,10,21,10,16,9,22,31,14,8,2,16,20,72
400915343,Florida State Seminoles,J. Isaac,4065654,,True,26.0,4,11,2,5,2,6,2,2,2,7,9,2,2,2,2,1,12
400915343,Florida State Seminoles,M. Ojo,61596,,True,10.0,0,0,0,0,0,0,2,2,2,1,3,0,0,0,0,2,2
400915343,Florida State Seminoles,T. Mann,3907823,,True,31.0,2,4,2,3,0,1,0,0,1,1,2,2,2,0,3,2,4
400915343,Florida State Seminoles,D. Bacon,3907821,,True,29.0,8,15,7,10,1,5,6,7,0,3,3,1,2,0,1,2,23
400915343,Florida State Seminoles,X. Rathan-Mayes,66125,,True,29.0,7,10,5,5,2,5,7,10,1,6,7,2,3,0,1,1,23
400915343,Florida State Seminoles,P. Cofer,3135054,,False,13.0,0,0,0,0,0,0,0,0,0,1,1,0,0,0,1,1,0
400915343,Florida State Seminoles,J. Smith,66126,,False,11.0,1,3,1,3,0,0,0,0,0,2,2,1,0,1,0,3,2
400915343,Florida State Seminoles,C. Koumadje,3907824,,False,10.0,1,1,1,1,0,0,0,2,0,1,1,1,0,1,0,1,2
400915343,Florida State Seminoles,B. Angola-Rodas,4065658,,False,10.0,1,2,0,1,1,1,1,2,0,1,1,0,0,0,1,2,4
400915343,Florida State Seminoles,P. Savoy,4065657,,False,4.0,0,1,0,0,0,1,0,0,0,0,0,0,0,0,1,0,0
400915343,Florida State Seminoles,T. Forrest,4065656,,False,14.0,0,0,0,0,0,0,3,4,0,3,3,1,2,0,2,1,3
400915343,Florida State Seminoles,C. Walker,4065655,,False,13.0,4,8,1,2,3,6,2,2,2,0,2,1,0,0,0,1,13
400915343,Florida State Seminoles,TEAM,TOTAL,TOTAL,False,,28,55,19,30,9,25,23,31,8,27,35,11,11,4,13,17,88
400915343,Florida State Seminoles,J. Isaac,4065654,,True,26.0,4,11,2,5,2,6,2,2,2,7,9,2,2,2,2,1,12
400915343,Florida State Seminoles,M. Ojo,61596,,True,10.0,0,0,0,0,0,0,2,2,2,1,3,0,0,0,0,2,2
400915343,Florida State Seminoles,T. Mann,3907823,,True,31.0,2,4,2,3,0,1,0,0,1,1,2,2,2,0,3,2,4
400915343,Florida State Seminoles,D. Bacon,3907821,,True,29.0,8,15,7,10,1,5,6,7,0,3,3,1,2,0,1,2,23
400915343,Florida State Seminoles,X. Rathan-Mayes,66125,,True,29.0,7,10,5,5,2,5,7,10,1,6,7,2,3,0,1,1,23
400915343,Florida State Seminoles,P. Cofer,3135054,,False,13.0,0,0,0,0,0,0,0,0,0,1,1,0,0,0,1,1,0
400915343,Florida State Seminoles,J. Smith,66126,,False,11.0,1,3,1,3,0,0,0,0,0,2,2,1,0,1,0,3,2
400915343,Florida State Seminoles,C. Koumadje,3907824,,False,10.0,1,1,1,1,0,0,0,2,0,1,1,1,0,1,0,1,2
400915343,Florida State Seminoles,B. Angola-Rodas,4065658,,False,10.0,1,2,0,1,1,1,1,2,0,1,1,0,0,0,1,2,4
400915343,Florida State Seminoles,P. Savoy,4065657,,False,4.0,0,1,0,0,0,1,0,0,0,0,0,0,0,0,1,0,0
400915343,Florida State Seminoles,T. Forrest,4065656,,False,14.0,0,0,0,0,0,0,3,4,0,3,3,1,2,0,2,1,3
400915343,Florida State Seminoles,C. Walker,4065655,,False,13.0,4,8,1,2,3,6,2,2,2,0,2,1,0,0,0,1,13
400915343,Florida State Seminoles,TEAM,TOTAL,TOTAL,False,,28,55,19,30,9,25,23,31,8,27,35,11,11,4,13,17,88
400915342,Virginia Tech Hokies,K. Sy,4065740,,True,10.0,0,1,0,1,0,0,0,0,1,2,3,0,0,0,2,1,0
400915342,Virginia Tech Hokies,C. Clarke,3945567,,True,33.0,9,12,9,12,0,0,4,5,1,11,12,2,2,1,2,1,22
400915342,Virginia Tech Hokies,J. Robinson,3945566,,True,27.0,4,7,0,1,4,6,0,1,1,4,5,1,1,0,7,3,12
400915342,Virginia Tech Hokies,A. Hill,3147501,,True,32.0,6,11,3,3,3,8,3,5,0,5,5,1,2,1,0,2,18
400915342,Virginia Tech Hokies,J. Bibbs,3147500,,True,21.0,1,7,1,4,0,3,0,0,0,3,3,2,0,1,0,4,2
400915342,Virginia Tech Hokies,G. Donlon,65454,,False,0.0,0,0,0,0,0,0,0,0,0,0,0,0,0,0,0,0,0
400915342,Virginia Tech Hokies,Z. LeDay,61698,,False,29.0,5,12,5,12,0,0,4,5,5,4,9,4,0,3,1,3,14
400915342,Virginia Tech Hokies,M. Galloway,3945565,,False,1.0,0,0,0,0,0,0,0,0,0,0,0,0,0,0,0,0,0
400915342,Virginia Tech Hokies,T. Outlaw,67275,,False,17.0,1,5,1,1,0,4,0,0,0,0,0,0,1,0,1,1,2
400915342,Virginia Tech Hokies,S. Allen,61795,,False,30.0,6,10,2,3,4,7,1,4,1,5,6,4,0,0,1,2,17
400915342,Virginia Tech Hokies,TEAM,TOTAL,TOTAL,False,,32,65,21,37,11,28,12,20,10,34,44,14,6,6,14,17,87
400915342,UMBC Retrievers,N. Gerrity,3904746,,True,17.0,1,4,1,4,0,0,3,4,2,3,5,0,1,1,2,1,5
400915342,UMBC Retrievers,J. Sherburne,3904749,,True,28.0,3,6,1,2,2,4,0,0,0,1,1,1,1,0,2,4,8
400915342,UMBC Retrievers,K.J. Maura,3152345,,True,32.0,2,9,2,5,0,4,1,1,0,4,4,5,2,0,2,1,5
400915342,UMBC Retrievers,J. Lyles,66648,,True,36.0,8,19,6,15,2,4,3,3,2,6,8,0,0,0,3,2,21
400915342,UMBC Retrievers,W. Darley,66489,,True,22.0,3,10,3,7,0,3,4,4,0,2,2,0,0,0,4,4,10
400915342,UMBC Retrievers,M. Curran,4066773,,False,3.0,0,0,0,0,0,0,0,0,0,1,1,0,0,0,0,1,0
400915342,UMBC Retrievers,A. Lamar,4066775,,False,25.0,4,8,2,3,2,5,0,0,2,5,7,1,1,3,0,4,10
400915342,UMBC Retrievers,D. Ervin,3904745,,False,3.0,0,0,0,0,0,0,0,0,1,0,1,0,0,0,2,1,0
400915342,UMBC Retrievers,J. Grant,3147542,,False,31.0,4,11,4,9,0,2,3,3,1,6,7,1,1,0,1,1,11
400915342,UMBC Retrievers,M. Brent,3147541,,False,3.0,0,0,0,0,0,0,0,0,0,0,0,0,0,0,0,0,0
400915342,UMBC Retrievers,B. Grace,66491,,False,0.0,0,2,0,0,0,2,0,0,0,0,0,0,0,0,0,0,0
400915342,UMBC Retrievers,TEAM,TOTAL,TOTAL,False,,25,69,19,45,6,24,14,15,11,28,39,8,6,4,16,19,70
400915341,Pittsburgh Panthers,M. Young,66290,,True,32.0,9,20,7,15,2,5,10,13,2,4,6,4,1,0,2,3,30
400915341,Pittsburgh Panthers,S. Jeter,61756,,True,31.0,8,13,7,12,1,1,4,4,5,5,10,1,1,2,2,2,21
400915341,Pittsburgh Panthers,J. Artis,66287,,True,35.0,9,14,6,6,3,8,9,15,2,6,8,3,0,1,2,2,30
400915341,Pittsburgh Panthers,J. Kithcart,4065713,,True,34.0,3,4,3,4,0,0,0,1,0,1,1,8,1,1,1,4,6
400915341,Pittsburgh Panthers,C. Johnson,3138196,,True,31.0,6,11,3,5,3,6,1,2,2,6,8,3,1,0,1,5,16
400915341,Pittsburgh Panthers,R. Nix,3934653,,False,5.0,1,3,1,3,0,0,2,2,2,3,5,0,0,0,1,3,4
400915341,Pittsburgh Panthers,R. Luther,3138197,,False,13.0,0,3,0,2,0,1,0,0,1,2,3,1,0,0,0,2,0
400915341,Pittsburgh Panthers,J. Milligan,3934655,,False,13.0,2,5,1,2,1,3,0,0,0,0,0,2,0,0,1,2,5
400915341,Pittsburgh Panthers,D. Wilson,3934652,,False,6.0,0,0,0,0,0,0,0,0,0,1,1,0,0,0,0,1,0
400915341,Pittsburgh Panthers,TEAM,TOTAL,TOTAL,False,,38,73,28,49,10,24,26,37,14,29,43,22,4,4,10,24,112
400915341,Marshall Thundering Herd,A. Penava,3923221,,True,17.0,2,3,2,2,0,1,0,0,0,4,4,1,1,0,0,5,4
400915341,Marshall Thundering Herd,R. Taylor,61327,,True,24.0,9,14,8,12,1,2,3,5,4,7,11,3,0,1,4,4,22
400915341,Marshall Thundering Herd,J. Elmore,3155937,,True,33.0,4,11,4,9,0,2,11,12,1,2,3,6,0,0,3,3,19
400915341,Marshall Thundering Herd,A. Loop,62818,,True,28.0,2,7,0,0,2,7,2,2,2,0,2,0,1,0,0,3,8
400915341,Marshall Thundering Herd,S. Browning,62336,,True,35.0,8,17,6,9,2,8,4,5,0,3,3,4,0,0,1,4,22
400915341,Marshall Thundering Herd,C. Thieneman,3923219,,False,7.0,0,2,0,0,0,2,0,0,0,2,2,1,0,0,0,2,0
400915341,Marshall Thundering Herd,M. Mijovic,3132419,,False,10.0,2,2,2,2,0,0,0,0,0,1,1,0,0,0,0,1,4
400915341,Marshall Thundering Herd,P. Bledsoe,4067003,,False,1.0,0,1,0,1,0,0,0,0,1,0,1,0,0,0,0,0,0
400915341,Marshall Thundering Herd,K. Allison,4067002,,False,7.0,1,3,1,2,0,1,0,0,1,1,2,0,0,0,1,2,2
400915341,Marshall Thundering Herd,A. Nikolic,3132420,,False,6.0,0,1,0,1,0,0,0,0,0,1,1,0,0,0,1,0,0
400915341,Marshall Thundering Herd,C.J. Burks,3132417,,False,32.0,7,10,2,3,5,7,6,6,0,4,4,4,0,0,2,3,25
400915341,Marshall Thundering Herd,TEAM,TOTAL,TOTAL,False,,35,71,25,41,10,30,26,30,10,29,39,19,2,1,12,27,106
400915340,Rider Broncs,K. Thomas,67503,,True,32.0,4,10,4,9,0,1,1,2,1,2,3,1,3,0,2,2,9
400915340,Rider Broncs,X. Lundy,67499,,True,34.0,5,12,4,9,1,3,1,1,0,5,5,1,0,1,0,1,12
400915340,Rider Broncs,N. Carey,61338,,True,28.0,4,12,4,12,0,0,2,4,4,6,10,0,2,0,1,2,10
400915340,Rider Broncs,S. Jordan,4067349,,True,30.0,5,15,4,11,1,4,3,4,0,2,2,5,0,0,2,4,14
400915340,Rider Broncs,J. Taylor,67502,,True,32.0,2,9,0,4,2,5,2,4,2,2,4,3,1,0,2,1,8
400915340,Rider Broncs,T. Marshall,4067348,,False,13.0,3,7,3,7,0,0,1,1,3,4,7,0,1,1,1,3,7
400915340,Rider Broncs,X. Malone-Key,4067346,,False,8.0,2,2,2,2,0,0,0,0,0,0,0,0,0,0,0,3,4
400915340,Rider Broncs,K. Washington-Ives,3913716,,False,13.0,0,5,0,1,0,4,0,0,0,0,0,2,0,0,2,0,0
400915340,Rider Broncs,A. Durham,3138490,,False,10.0,3,3,2,2,1,1,0,0,2,1,3,0,0,0,2,1,7
400915340,Rider Broncs,TEAM,TOTAL,TOTAL,False,,28,75,23,57,5,18,10,16,12,23,35,12,7,2,12,17,71
400915340,NC State Wolfpack,A. Abu,3138158,,True,29.0,6,8,6,7,0,1,0,0,0,12,12,2,1,1,1,0,12
400915340,NC State Wolfpack,O. Yurtseven,66768,,True,21.0,7,11,7,11,0,0,2,2,1,4,5,1,0,0,1,4,16
400915340,NC State Wolfpack,D. Smith Jr.,4065697,,True,34.0,7,15,4,9,3,6,2,2,0,4,4,16,2,0,4,3,19
400915340,NC State Wolfpack,T. Dorn,3132359,,True,24.0,5,10,4,7,1,3,2,2,1,2,3,3,2,0,4,1,13
400915340,NC State Wolfpack,T. Henderson,61215,,True,34.0,4,10,3,7,1,3,3,4,1,3,4,1,1,0,1,1,12
400915340,NC State Wolfpack,T. Kapita,4065701,,False,17.0,3,5,3,5,0,0,1,2,4,7,11,1,0,2,1,3,7
400915340,NC State Wolfpack,D. Hicks,4065698,,False,2.0,0,0,0,0,0,0,0,0,0,0,0,0,0,0,0,0,0
400915340,NC State Wolfpack,T. Thompson,3151470,,False,2.0,1,1,1,1,0,0,0,0,0,0,0,0,0,0,0,0,2
400915340,NC State Wolfpack,C. Brickhouse,67562,,False,2.0,0,0,0,0,0,0,0,0,1,0,1,0,0,0,1,0,0
400915340,NC State Wolfpack,B. Anya,66134,,False,9.0,2,2,2,2,0,0,0,0,0,0,0,0,0,4,0,2,4
400915340,NC State Wolfpack,M. Rowan,3947151,,False,21.0,5,9,4,4,1,5,1,1,2,3,5,1,1,0,0,1,12
400915340,NC State Wolfpack,S. Kirk,3947150,,False,3.0,0,0,0,0,0,0,0,1,0,1,1,0,0,0,0,0,0
400915340,NC State Wolfpack,C. Corchiani Jr.,3138159,,False,2.0,0,1,0,1,0,0,2,2,0,0,0,1,0,0,2,1,2
400915340,NC State Wolfpack,TEAM,TOTAL,TOTAL,False,,40,72,34,54,6,18,13,16,11,39,50,26,7,7,15,16,99
400915339,Miami Hurricanes,D. Hernandez,4065672,,True,17.0,2,2,2,2,0,0,0,0,0,1,1,0,0,2,1,3,4
400915339,Miami Hurricanes,K. Murphy,61668,,True,21.0,3,4,3,4,0,0,1,2,2,3,5,0,0,0,3,3,7
400915339,Miami Hurricanes,B. Brown,4065670,,True,33.0,3,7,2,4,1,3,1,2,0,6,6,5,3,1,3,3,8
400915339,Miami Hurricanes,J. Newton,3138145,,True,30.0,7,14,4,9,3,5,5,8,4,5,9,4,1,0,10,1,22
400915339,Miami Hurricanes,D. Reed,66130,,True,39.0,7,13,4,6,3,7,1,2,0,4,4,3,1,1,0,2,18
400915339,Miami Hurricanes,E. Izundu,3904629,,False,16.0,2,3,2,3,0,0,2,2,1,2,3,1,1,1,0,2,6
400915339,Miami Hurricanes,A. Lawrence II,3904628,,False,29.0,4,6,4,5,0,1,2,5,3,2,5,1,3,2,3,3,10
400915339,Miami Hurricanes,D. Vasiljevic,4065669,,False,15.0,1,4,0,0,1,4,0,0,0,1,1,1,1,0,0,1,3
400915339,Miami Hurricanes,TEAM,TOTAL,TOTAL,False,,29,53,21,33,8,20,12,21,10,24,34,15,10,7,20,18,78
400915339,Columbia Lions,L. Petrasek,66835,,True,34.0,6,10,4,6,2,4,2,2,0,5,5,1,1,0,0,2,16
400915339,Columbia Lions,J. Coby,66833,,True,24.0,5,11,5,11,0,0,3,3,1,3,4,0,2,0,2,2,13
400915339,Columbia Lions,J. Killingsworth,4066807,,True,19.0,2,5,1,3,1,2,0,0,0,1,1,2,0,0,0,1,5
400915339,Columbia Lions,M. Smith,4066806,,True,21.0,5,9,5,8,0,1,2,2,0,0,0,5,0,0,0,4,12
400915339,Columbia Lions,N. Hickman,3155734,,True,20.0,0,4,0,4,0,0,3,4,0,1,1,3,0,0,2,3,3
400915339,Columbia Lions,P. Tape,4066805,,False,9.0,3,3,3,3,0,0,0,1,0,2,2,0,0,0,2,4,6
400915339,Columbia Lions,A. Panayiotou,4066804,,False,4.0,1,1,1,1,0,0,0,0,0,0,0,0,0,0,2,2,2
400915339,Columbia Lions,C. McComber,66836,,False,9.0,0,1,0,0,0,1,0,0,0,0,0,1,2,0,1,0,0
400915339,Columbia Lions,C. Voss,66837,,False,4.0,0,1,0,1,0,0,0,0,0,1,1,1,0,0,1,0,0
400915339,Columbia Lions,Q. Adlesh,3948606,,False,15.0,1,3,0,0,1,3,0,0,0,0,0,3,1,0,2,0,3
400915339,Columbia Lions,C. Davis,3948605,,False,14.0,1,3,1,3,0,0,0,0,0,2,2,1,3,0,3,1,2
400915339,Columbia Lions,R. Hunter,3948604,,False,27.0,2,4,2,4,0,0,1,4,1,5,6,1,0,1,1,0,5
400915339,Columbia Lions,TEAM,TOTAL,TOTAL,False,,26,55,22,44,4,11,11,16,4,20,24,18,9,1,16,19,67
400915338,North Carolina A&T Aggies,A. Scales,61820,,True,36.0,1,2,1,2,0,0,1,4,3,7,10,0,2,0,2,4,3
400915338,North Carolina A&T Aggies,N. Reese,67572,,True,12.0,0,1,0,1,0,0,0,0,1,0,1,0,0,0,0,3,0
400915338,North Carolina A&T Aggies,R. Pratt,4067941,,True,22.0,1,7,1,5,0,2,0,0,0,4,4,0,2,0,1,1,2
400915338,North Carolina A&T Aggies,A. Hamilton,3158900,,True,33.0,1,6,0,2,1,4,0,0,0,2,2,2,3,0,2,0,3
400915338,North Carolina A&T Aggies,S. Hunt,66511,,True,37.0,5,16,3,8,2,8,8,8,0,3,3,2,2,0,5,2,20
400915338,North Carolina A&T Aggies,C. Carrington,4078914,,False,3.0,0,2,0,2,0,0,0,0,1,0,1,0,0,0,0,2,0
400915338,North Carolina A&T Aggies,D. McGowens,4067939,,False,27.0,5,9,5,9,0,0,4,5,1,7,8,1,2,1,2,4,14
400915338,North Carolina A&T Aggies,A. Williams,3151417,,False,10.0,1,2,1,2,0,0,1,2,0,0,0,1,0,0,0,2,3
400915338,North Carolina A&T Aggies,J. Whitaker,67575,,False,20.0,3,8,3,5,0,3,1,1,0,0,0,1,0,0,0,4,7
400915338,North Carolina A&T Aggies,TEAM,TOTAL,TOTAL,False,,17,53,14,36,3,17,15,20,11,24,35,7,11,1,12,22,52
400915338,Georgia Tech Yellow Jackets,Q. Stephens,66128,,True,30.0,2,10,2,9,0,1,5,6,2,7,9,1,0,2,2,3,9
400915338,Georgia Tech Yellow Jackets,B. Lammers,3135061,,True,31.0,5,7,5,7,0,0,2,3,1,5,6,1,1,2,1,4,12
400915338,Georgia Tech Yellow Jackets,J. Okogie,4065663,,True,26.0,1,5,1,4,0,1,3,4,0,1,1,0,0,0,3,0,5
400915338,Georgia Tech Yellow Jackets,J. Moore,4065662,,True,29.0,2,7,1,5,1,2,0,1,1,2,3,4,1,0,1,1,5
400915338,Georgia Tech Yellow Jackets,T. Jackson,3135057,,True,17.0,4,7,3,3,1,4,3,7,1,3,4,3,1,1,3,1,12
400915338,Georgia Tech Yellow Jackets,C. Matthews,4065665,,False,4.0,0,2,0,2,0,0,0,0,0,0,0,0,0,0,0,0,0
400915338,Georgia Tech Yellow Jackets,S. Ogbonda,3904627,,False,5.0,0,1,0,1,0,0,0,0,0,0,0,0,0,3,0,1,0
400915338,Georgia Tech Yellow Jackets,A. Gueye,3135059,,False,5.0,0,0,0,0,0,0,0,1,0,1,1,0,0,1,0,2,0
400915338,Georgia Tech Yellow Jackets,K. McCormick,61453,,False,17.0,4,5,0,0,4,5,0,0,0,1,1,1,1,0,0,3,12
400915338,Georgia Tech Yellow Jackets,J. Heath,67623,,False,28.0,1,3,1,1,0,2,2,2,0,1,1,5,0,0,3,1,4
400915338,Georgia Tech Yellow Jackets,C. Heyward,61609,,False,8.0,0,1,0,1,0,0,0,0,3,0,3,1,0,0,0,0,0
400915338,Georgia Tech Yellow Jackets,TEAM,TOTAL,TOTAL,False,,19,48,13,33,6,15,15,24,9,24,33,16,4,9,13,16,59
400915337,UNC Wilmington Seahawks,D. Cacok,3946974,,True,22.0,7,8,7,8,0,0,0,2,3,3,6,0,0,0,0,5,14
400915337,UNC Wilmington Seahawks,C.J. Bryce,3946973,,True,40.0,7,19,4,12,3,7,1,2,2,2,4,0,0,1,2,1,18
400915337,UNC Wilmington Seahawks,C. Flemmings,3129963,,True,26.0,3,11,3,4,0,7,1,2,1,5,6,1,0,0,4,2,7
400915337,UNC Wilmington Seahawks,A. Mosley,62784,,True,20.0,1,5,0,1,1,4,0,0,1,1,2,0,0,0,1,1,3
400915337,UNC Wilmington Seahawks,D. Ingram,61575,,True,33.0,6,13,2,4,4,9,4,4,0,1,1,6,4,0,2,3,20
400915337,UNC Wilmington Seahawks,M. Elmore,4067293,,False,3.0,0,0,0,0,0,0,0,0,0,2,2,0,0,0,0,0,0
400915337,UNC Wilmington Seahawks,M. Bryan,66732,,False,10.0,1,1,1,1,0,0,2,3,3,1,4,0,0,1,0,5,4
400915337,UNC Wilmington Seahawks,C. Ogbodo,67175,,False,7.0,0,0,0,0,0,0,0,0,0,0,0,0,0,1,0,2,0
400915337,UNC Wilmington Seahawks,J. Fornes,4067294,,False,3.0,0,0,0,0,0,0,0,0,0,0,0,0,0,0,0,0,0
400915337,UNC Wilmington Seahawks,J. Richmond,3132436,,False,21.0,1,8,1,4,0,4,0,0,1,0,1,2,2,0,0,1,2
400915337,UNC Wilmington Seahawks,J. Talley,3129962,,False,15.0,2,5,2,5,0,0,1,2,0,1,1,0,0,0,2,1,5
400915337,UNC Wilmington Seahawks,TEAM,TOTAL,TOTAL,False,,28,70,20,39,8,31,9,15,15,16,31,9,6,3,11,21,73
400915337,Clemson Tigers,D. Grantham,3129674,,True,27.0,4,7,3,4,1,3,0,0,1,5,6,2,0,0,3,1,9
400915337,Clemson Tigers,J. Blossomgame,61835,,True,32.0,7,15,7,14,0,1,6,9,2,5,7,1,2,2,2,2,20
400915337,Clemson Tigers,S. Djitte,66122,,True,21.0,5,7,5,7,0,0,1,1,4,4,8,1,1,0,0,3,11
400915337,Clemson Tigers,S. Mitchell,3136699,,True,35.0,1,3,1,2,0,1,8,8,0,2,2,6,0,0,2,2,10
400915337,Clemson Tigers,A. Holmes,62043,,True,27.0,3,6,2,4,1,2,6,7,2,4,6,2,2,0,0,1,13
400915337,Clemson Tigers,E. Thomas,3947075,,False,12.0,5,6,5,6,0,0,2,3,0,1,1,0,0,5,0,3,12
400915337,Clemson Tigers,T. Hudson,3917986,,False,2.0,0,0,0,0,0,0,0,0,0,0,0,0,0,0,0,0,0
400915337,Clemson Tigers,M. Reed,3133969,,False,29.0,3,7,3,6,0,1,0,0,0,6,6,5,1,0,3,1,6
400915337,Clemson Tigers,G. DeVoe,3129673,,False,15.0,2,3,2,3,0,0,2,2,1,3,4,1,0,0,3,3,6
400915337,Clemson Tigers,TEAM,TOTAL,TOTAL,False,,30,54,28,46,2,8,25,30,10,31,41,18,6,7,13,16,87
400915336,Syracuse Orange,T. Lydon,3934662,,True,36.0,6,12,2,6,4,6,4,5,3,7,10,3,2,1,0,2,20
400915336,Syracuse Orange,D. Coleman,61821,,True,9.0,1,2,1,2,0,0,0,0,0,1,1,0,1,0,3,1,2
400915336,Syracuse Orange,A. White III,61616,,True,32.0,3,10,3,5,0,5,6,7,2,4,6,2,1,1,1,1,12
400915336,Syracuse Orange,T. Battle,4065722,,True,32.0,5,11,1,4,4,7,2,2,0,3,3,1,3,0,1,1,16
400915336,Syracuse Orange,F. Howard,3934659,,True,21.0,1,4,1,3,0,1,0,0,1,1,2,3,2,1,1,2,2
400915336,Syracuse Orange,T. Thompson,4065721,,False,22.0,9,15,9,15,0,0,0,0,2,5,7,2,0,2,2,0,18
400915336,Syracuse Orange,D. Akintobi-Adeyeye,3155403,,False,2.0,0,0,0,0,0,0,0,0,0,0,0,0,0,0,1,0,0
400915336,Syracuse Orange,T. Roberson,67633,,False,20.0,2,4,2,4,0,0,1,2,1,6,7,2,0,2,0,1,5
400915336,Syracuse Orange,J. Radner,3934666,,False,2.0,0,1,0,0,0,1,0,0,0,0,0,1,0,0,0,0,0
400915336,Syracuse Orange,A. Autry,3934661,,False,2.0,1,2,0,0,1,2,0,0,0,0,0,0,0,0,0,0,3
400915336,Syracuse Orange,S. Belbey,3934660,,False,2.0,0,0,0,0,0,0,0,0,0,0,0,0,0,0,0,0,0
400915336,Syracuse Orange,M. Sutton,3153164,,False,1.0,0,0,0,0,0,0,0,1,1,0,1,0,0,0,1,0,0
400915336,Syracuse Orange,J. Gillon,61915,,False,19.0,1,3,1,2,0,1,0,0,1,2,3,7,1,0,0,2,2
400915336,Syracuse Orange,TEAM,TOTAL,TOTAL,False,,29,64,20,41,9,23,13,17,12,29,41,21,10,7,10,10,80
400915336,Cornell Big Red,S. Gettings,3906956,,True,29.0,1,8,1,6,0,2,0,0,2,7,9,1,1,1,2,3,2
400915336,Cornell Big Red,J. Fallas,66842,,True,25.0,1,4,0,0,1,4,0,0,0,3,3,2,0,0,1,0,3
400915336,Cornell Big Red,M. Morgan,3906955,,True,32.0,4,10,2,2,2,8,0,0,0,2,2,1,0,0,1,2,10
400915336,Cornell Big Red,T. Whiteside,3906954,,True,30.0,6,9,5,7,1,2,0,0,2,0,2,6,0,0,2,1,13
400915336,Cornell Big Red,R. Hatter,66840,,True,30.0,3,11,3,6,0,5,1,1,0,6,6,3,1,0,2,2,7
400915336,Cornell Big Red,J. Warren,4066813,,False,14.0,3,6,3,6,0,0,1,2,1,2,3,0,0,0,0,3,7
400915336,Cornell Big Red,J. Bayless,3906958,,False,2.0,0,0,0,0,0,0,0,0,0,0,0,1,0,0,0,0,0
400915336,Cornell Big Red,J. Gordon,3906959,,False,4.0,0,0,0,0,0,0,0,1,0,0,0,0,1,0,2,0,0
400915336,Cornell Big Red,J. Davis,3906957,,False,2.0,2,2,2,2,0,0,0,0,0,1,1,0,0,0,0,0,4
400915336,Cornell Big Red,K. Brown,3138247,,False,3.0,1,1,0,0,1,1,0,0,1,1,2,1,1,0,1,1,3
400915336,Cornell Big Red,W. Bathurst,3138246,,False,15.0,2,4,1,2,1,2,0,0,0,2,2,0,0,0,2,1,5
400915336,Cornell Big Red,D. Fleming,66841,,False,3.0,0,0,0,0,0,0,0,0,0,1,1,1,0,0,0,0,0
400915336,Cornell Big Red,D. Smith,66839,,False,11.0,1,2,1,2,0,0,0,0,0,0,0,0,0,0,0,3,2
400915336,Cornell Big Red,TEAM,TOTAL,TOTAL,False,,24,57,18,33,6,24,2,4,6,26,32,16,4,1,15,16,56
400915335,Providence Friars,E. Holt,3147674,,True,32.0,7,14,7,12,0,2,2,2,2,9,11,1,0,1,3,3,16
400915335,Providence Friars,R. Bullock,66482,,True,37.0,7,18,5,11,2,7,7,7,1,5,6,1,4,0,3,3,23
400915335,Providence Friars,J. Lindsey,3136472,,True,36.0,3,6,2,2,1,4,1,1,1,0,1,1,0,0,2,2,8
400915335,Providence Friars,K. Cartwright,3136470,,True,31.0,4,11,3,8,1,3,0,0,0,5,5,5,4,0,3,2,9
400915335,Providence Friars,I. Jackson,3133821,,True,18.0,2,6,2,4,0,2,0,0,1,1,2,2,1,1,0,1,4
400915335,Providence Friars,K. Young,4065814,,False,8.0,1,3,1,2,0,1,0,1,2,4,6,0,0,1,0,2,2
400915335,Providence Friars,R. Fazekas,3913218,,False,12.0,1,2,0,0,1,2,0,0,0,0,0,0,0,0,0,0,3
400915335,Providence Friars,A. Diallo,4065813,,False,12.0,0,1,0,0,0,1,0,0,0,0,0,1,1,0,1,1,0
400915335,Providence Friars,M. White,4065812,,False,14.0,1,3,1,1,0,2,0,0,0,1,1,4,2,0,2,1,2
400915335,Providence Friars,TEAM,TOTAL,TOTAL,False,,26,64,21,40,5,24,10,11,10,25,35,15,12,3,14,15,67
400915335,Boston College Eagles,A.J. Turner,3943608,,True,37.0,4,9,2,3,2,6,2,2,0,2,2,6,2,1,1,0,12
400915335,Boston College Eagles,M. Jeffers,61901,,True,28.0,6,9,6,9,0,0,1,3,4,5,9,1,1,3,0,1,13
400915335,Boston College Eagles,C. Tava,61446,,True,24.0,0,5,0,4,0,1,0,0,2,3,5,2,1,0,2,3,0
400915335,Boston College Eagles,K. Bowman,4065635,,True,31.0,7,8,5,5,2,3,0,2,1,7,8,1,2,0,4,4,16
400915335,Boston College Eagles,J. Robinson,3943606,,True,39.0,7,14,3,8,4,6,3,6,0,5,5,8,1,0,8,2,21
400915335,Boston College Eagles,N. Popovic,4065637,,False,10.0,3,4,3,4,0,0,0,0,0,0,0,0,0,0,0,3,6
400915335,Boston College Eagles,G. Owens,66277,,False,6.0,0,2,0,2,0,0,0,0,0,1,1,0,0,0,0,0,0
400915335,Boston College Eagles,J. Chatman,3135095,,False,25.0,3,6,0,1,3,5,2,2,0,4,4,1,0,0,3,0,11
400915335,Boston College Eagles,TEAM,TOTAL,TOTAL,False,,30,57,19,36,11,21,8,15,8,28,36,19,7,4,18,13,79
400915334,NC State Wolfpack,A. Abu,3138158,,True,20.0,2,4,2,4,0,0,3,3,2,3,5,2,0,0,2,3,7
400915334,NC State Wolfpack,B. Anya,66134,,True,14.0,1,2,1,2,0,0,1,2,0,2,2,0,0,0,0,2,3
400915334,NC State Wolfpack,D. Smith Jr.,4065697,,True,20.0,9,12,5,7,4,5,1,1,0,4,4,6,3,2,2,0,23
400915334,NC State Wolfpack,T. Dorn,3132359,,True,25.0,4,7,4,7,0,0,3,5,1,2,3,0,0,0,0,2,11
400915334,NC State Wolfpack,T. Henderson,61215,,True,19.0,3,5,1,1,2,4,2,2,0,2,2,0,0,1,2,2,10
400915334,NC State Wolfpack,T. Kapita,4065701,,False,17.0,0,1,0,1,0,0,2,2,2,7,9,0,0,0,2,1,2
400915334,NC State Wolfpack,D. Hicks,4065698,,False,8.0,0,1,0,1,0,0,0,0,1,3,4,0,0,0,2,2,0
400915334,NC State Wolfpack,T. Thompson,3151470,,False,2.0,1,3,1,3,0,0,0,0,1,1,2,0,0,0,0,1,2
400915334,NC State Wolfpack,C. Brickhouse,67562,,False,2.0,0,1,0,1,0,0,0,0,2,0,2,1,0,1,0,0,0
400915334,NC State Wolfpack,O. Yurtseven,66768,,False,19.0,1,4,1,4,0,0,2,2,4,3,7,3,0,0,2,4,4
400915334,NC State Wolfpack,M. Johnson,4065699,,False,18.0,1,7,1,6,0,1,0,0,0,0,0,5,0,0,1,2,2
400915334,NC State Wolfpack,M. Rowan,3947151,,False,21.0,6,11,3,4,3,7,0,0,0,4,4,0,0,0,1,0,15
400915334,NC State Wolfpack,S. Kirk,3947150,,False,13.0,2,4,2,2,0,2,2,2,1,2,3,1,1,0,2,2,6
400915334,NC State Wolfpack,C. Corchiani Jr.,3138159,,False,2.0,2,4,2,4,0,0,0,0,0,0,0,0,0,0,0,0,4
400915334,NC State Wolfpack,TEAM,TOTAL,TOTAL,False,,32,66,23,47,9,19,16,19,18,37,55,18,4,4,16,21,89
400915334,McNeese Cowboys,L. Hill,4067752,,True,27.0,4,5,4,5,0,0,2,3,4,2,6,1,0,4,1,3,10
400915334,McNeese Cowboys,S. Ugochukwu,3149943,,True,29.0,1,7,1,7,0,0,0,0,0,5,5,1,2,0,2,4,2
400915334,McNeese Cowboys,J. Greenwood,3947187,,True,22.0,1,8,1,3,0,5,1,2,0,0,0,1,0,0,1,1,3
400915334,McNeese Cowboys,L. Polter,3078927,,True,19.0,2,5,2,3,0,2,0,0,0,2,2,3,1,0,1,1,4
400915334,McNeese Cowboys,J. Burr,67327,,True,27.0,5,12,3,10,2,2,2,4,1,1,2,3,0,1,3,1,14
400915334,McNeese Cowboys,H. Thomas,4067751,,False,9.0,0,2,0,2,0,0,1,2,1,1,2,0,0,0,1,2,1
400915334,McNeese Cowboys,A. Brown,3947189,,False,7.0,0,1,0,0,0,1,1,2,0,0,0,0,0,0,0,0,1
400915334,McNeese Cowboys,R. Laku,3947185,,False,15.0,4,9,1,2,3,7,0,0,3,1,4,0,0,1,0,1,11
400915334,McNeese Cowboys,J. Ledoux,4067754,,False,7.0,0,1,0,0,0,1,0,0,0,0,0,0,0,0,1,1,0
400915334,McNeese Cowboys,K. Ledoux,4067749,,False,15.0,2,6,2,4,0,2,4,5,1,2,3,0,0,0,3,0,8
400915334,McNeese Cowboys,J. Harvey,3947184,,False,23.0,1,7,0,1,1,6,0,0,0,1,1,0,1,0,0,2,3
400915334,McNeese Cowboys,TEAM,TOTAL,TOTAL,False,,20,63,14,37,6,26,11,18,10,17,27,9,4,6,13,16,57
400915333,Miami Hurricanes,D. Hernandez,4065672,,True,18.0,1,5,1,5,0,0,0,0,0,1,1,0,0,1,0,1,2
400915333,Miami Hurricanes,K. Murphy,61668,,True,25.0,2,5,2,5,0,0,1,2,3,1,4,1,0,0,1,2,5
400915333,Miami Hurricanes,B. Brown,4065670,,True,33.0,3,9,1,7,2,2,6,6,2,10,12,2,0,0,0,1,14
400915333,Miami Hurricanes,J. Newton,3138145,,True,35.0,7,12,7,11,0,1,0,2,1,1,2,5,1,0,2,4,14
400915333,Miami Hurricanes,D. Reed,66130,,True,35.0,5,12,2,5,3,7,4,4,1,2,3,0,3,0,2,1,17
400915333,Miami Hurricanes,E. Izundu,3904629,,False,20.0,4,6,4,6,0,0,4,5,3,1,4,0,0,1,0,1,12
400915333,Miami Hurricanes,A. Lawrence II,3904628,,False,21.0,1,3,1,3,0,0,0,0,0,2,2,2,1,1,1,3,2
400915333,Miami Hurricanes,D. Vasiljevic,4065669,,False,13.0,2,5,0,1,2,4,0,0,0,3,3,0,0,0,0,1,6
400915333,Miami Hurricanes,TEAM,TOTAL,TOTAL,False,,25,57,18,43,7,14,15,19,12,22,34,10,5,3,6,14,72
400915333,George Washington Revolutionaries,A. Toro,4066875,,True,30.0,2,8,1,4,1,4,2,2,3,7,10,2,1,1,3,1,7
400915333,George Washington Revolutionaries,T. Cavanaugh,61165,,True,22.0,4,13,4,10,0,3,5,6,3,2,5,0,0,0,3,3,13
400915333,George Washington Revolutionaries,C. Smith,4066876,,True,29.0,4,9,4,8,0,1,0,0,0,3,3,0,1,2,0,4,8
400915333,George Washington Revolutionaries,J. Roland,3913553,,True,31.0,3,6,1,3,2,3,2,3,0,2,2,3,1,0,0,1,10
400915333,George Washington Revolutionaries,J. Sina,66341,,True,36.0,4,10,3,5,1,5,2,4,1,1,2,3,0,0,1,0,11
400915333,George Washington Revolutionaries,K. Marfo,4066877,,False,9.0,0,0,0,0,0,0,0,0,0,4,4,0,0,0,1,1,0
400915333,George Washington Revolutionaries,J. Bolden,4066872,,False,4.0,0,1,0,0,0,1,0,0,1,0,1,0,0,0,1,0,0
400915333,George Washington Revolutionaries,M. Hart,3133841,,False,6.0,0,0,0,0,0,0,0,0,0,0,0,0,0,0,0,1,0
400915333,George Washington Revolutionaries,Y. Watanabe,3133838,,False,33.0,6,9,3,4,3,5,0,0,3,3,6,3,2,0,2,3,15
400915333,George Washington Revolutionaries,TEAM,TOTAL,TOTAL,False,,23,56,16,34,7,22,11,15,13,22,35,11,5,3,12,14,64
400915332,Wofford Terriers,C. Jackson,3137234,,True,31.0,5,10,5,9,0,1,0,0,4,7,11,3,0,2,0,2,10
400915332,Wofford Terriers,R. Sawvell,56345,,True,34.0,2,7,2,6,0,1,0,1,1,2,3,1,1,0,2,1,4
400915332,Wofford Terriers,F. Magee,3918760,,True,32.0,4,15,2,6,2,9,2,2,0,2,2,4,0,1,1,0,12
400915332,Wofford Terriers,J. Allen,67284,,True,12.0,0,3,0,1,0,2,0,0,1,1,2,1,2,0,2,2,0
400915332,Wofford Terriers,E. Garcia,67283,,True,36.0,7,10,1,1,6,9,3,3,0,2,2,6,0,0,1,2,23
400915332,Wofford Terriers,J. Tucker,4067657,,False,2.0,0,1,0,1,0,0,0,0,0,0,0,0,0,0,0,0,0
400915332,Wofford Terriers,D. Lowery,4067653,,False,4.0,0,0,0,0,0,0,0,0,0,0,0,0,0,0,1,0,0
400915332,Wofford Terriers,M. Pegram,3918762,,False,10.0,1,1,1,1,0,0,0,0,1,2,3,1,0,0,1,2,2
400915332,Wofford Terriers,N. Hoover,4067656,,False,26.0,4,12,1,4,3,8,6,6,3,2,5,0,0,0,0,3,17
400915332,Wofford Terriers,D. Theme-Love,4067655,,False,4.0,0,1,0,0,0,1,0,0,0,2,2,1,0,0,0,2,0
400915332,Wofford Terriers,D. Brooks,3137231,,False,9.0,2,3,2,3,0,0,0,0,0,0,0,1,1,0,0,2,4
400915332,Wofford Terriers,TEAM,TOTAL,TOTAL,False,,25,63,14,32,11,31,11,12,10,22,32,18,4,3,9,16,72
400915332,Georgia Tech Yellow Jackets,Q. Stephens,66128,,True,33.0,2,6,1,4,1,2,2,3,2,10,12,3,1,1,1,2,7
400915332,Georgia Tech Yellow Jackets,B. Lammers,3135061,,True,37.0,9,12,9,12,0,0,1,2,2,5,7,6,1,2,4,2,19
400915332,Georgia Tech Yellow Jackets,J. Okogie,4065663,,True,33.0,3,3,3,3,0,0,4,4,0,3,3,2,2,1,1,1,10
400915332,Georgia Tech Yellow Jackets,J. Moore,4065662,,True,23.0,5,11,5,10,0,1,2,3,0,2,2,0,0,0,1,2,12
400915332,Georgia Tech Yellow Jackets,T. Jackson,3135057,,True,24.0,5,9,1,5,4,4,0,0,1,4,5,3,0,0,0,1,14
400915332,Georgia Tech Yellow Jackets,C. Matthews,4065665,,False,6.0,0,3,0,2,0,1,2,2,0,0,0,0,1,0,0,0,2
400915332,Georgia Tech Yellow Jackets,S. Ogbonda,3904627,,False,2.0,0,0,0,0,0,0,0,0,0,1,1,0,0,1,0,0,0
400915332,Georgia Tech Yellow Jackets,A. Gueye,3135059,,False,4.0,0,0,0,0,0,0,0,0,0,0,0,0,0,0,0,1,0
400915332,Georgia Tech Yellow Jackets,K. McCormick,61453,,False,1.0,0,0,0,0,0,0,0,0,0,0,0,0,0,0,1,0,0
400915332,Georgia Tech Yellow Jackets,J. Heath,67623,,False,28.0,3,8,3,5,0,3,6,8,1,3,4,3,0,0,2,2,12
400915332,Georgia Tech Yellow Jackets,C. Heyward,61609,,False,9.0,0,0,0,0,0,0,0,0,0,1,1,0,0,0,0,1,0
400915332,Georgia Tech Yellow Jackets,TEAM,TOTAL,TOTAL,False,,27,52,22,41,5,11,17,22,6,29,35,17,5,5,10,12,76
400915331,Syracuse Orange,T. Lydon,3934662,,True,38.0,5,13,3,7,2,6,4,6,3,7,10,2,0,0,1,2,16
400915331,Syracuse Orange,D. Coleman,61821,,True,22.0,5,11,5,10,0,1,0,2,6,4,10,0,0,2,2,3,10
400915331,Syracuse Orange,F. Howard,3934659,,True,15.0,2,9,2,7,0,2,0,0,1,1,2,2,0,0,4,4,4
400915331,Syracuse Orange,J. Gillon,61915,,True,30.0,1,7,1,4,0,3,3,6,0,2,2,4,0,0,1,1,5
400915331,Syracuse Orange,A. White III,61616,,True,37.0,1,5,1,3,0,2,0,1,3,4,7,2,0,0,4,3,2
400915331,Syracuse Orange,T. Thompson,4065721,,False,19.0,4,6,4,5,0,1,2,2,0,4,4,0,0,0,2,5,10
400915331,Syracuse Orange,D. Akintobi-Adeyeye,3155403,,False,2.0,1,1,1,1,0,0,0,1,1,0,1,0,1,0,0,0,2
400915331,Syracuse Orange,T. Roberson,67633,,False,7.0,0,3,0,3,0,0,0,0,1,0,1,0,0,0,0,1,0
400915331,Syracuse Orange,T. Battle,4065722,,False,22.0,2,8,1,2,1,6,3,4,1,0,1,3,2,0,5,4,8
400915331,Syracuse Orange,K. Feldman,3934665,,False,2.0,1,1,0,0,1,1,0,0,1,1,2,0,0,0,0,0,3
400915331,Syracuse Orange,A. Autry,3934661,,False,2.0,0,1,0,0,0,1,0,0,0,0,0,0,0,0,0,1,0
400915331,Syracuse Orange,S. Belbey,3934660,,False,2.0,0,1,0,1,0,0,0,0,0,0,0,0,0,0,0,0,0
400915331,Syracuse Orange,M. Sutton,3153164,,False,2.0,0,1,0,0,0,1,0,0,0,0,0,1,0,0,0,0,0
400915331,Syracuse Orange,TEAM,TOTAL,TOTAL,False,,22,67,18,43,4,24,12,22,21,25,46,14,3,2,19,24,60
400915331,St. John's Red Storm,K. Yakwe,3938920,,True,19.0,3,5,3,5,0,0,1,2,0,8,8,1,0,0,0,3,7
400915331,St. John's Red Storm,M. LoVett,3938917,,True,36.0,3,7,2,4,1,3,0,1,2,4,6,9,0,0,3,0,7
400915331,St. John's Red Storm,S. Ponds,4065834,,True,34.0,7,15,3,4,4,11,3,4,1,5,6,7,4,1,0,3,21
400915331,St. John's Red Storm,B. Ahmed,4065833,,True,27.0,7,11,5,7,2,4,4,6,0,5,5,3,2,0,1,2,20
400915331,St. John's Red Storm,M. Ellison,3938916,,True,31.0,5,12,2,7,3,5,3,4,4,2,6,5,0,0,0,1,16
400915331,St. John's Red Storm,R. Freudenberg,4065835,,False,19.0,3,7,1,1,2,6,1,2,0,2,2,1,0,1,0,2,9
400915331,St. John's Red Storm,D. Williams,3938922,,False,9.0,0,0,0,0,0,0,0,0,0,1,1,0,0,0,1,1,0
400915331,St. John's Red Storm,T. Owens,3149059,,False,19.0,4,5,4,5,0,0,1,2,3,2,5,1,2,4,1,3,9
400915331,St. John's Red Storm,J. Cole,4078507,,False,3.0,0,0,0,0,0,0,0,2,0,1,1,0,0,0,0,0,0
400915331,St. John's Red Storm,E. Holifield,3938919,,False,3.0,2,2,2,2,0,0,0,2,0,0,0,0,0,0,1,2,4
400915331,St. John's Red Storm,TEAM,TOTAL,TOTAL,False,,34,64,22,35,12,29,13,25,11,32,43,27,8,6,9,17,93
400915330,Pittsburgh Panthers,M. Young,66290,,True,27.0,9,15,6,11,3,4,3,3,1,10,11,6,0,1,4,2,24
400915330,Pittsburgh Panthers,S. Jeter,61756,,True,15.0,1,3,1,2,0,1,4,5,2,2,4,3,1,1,2,4,6
400915330,Pittsburgh Panthers,J. Artis,66287,,True,27.0,7,12,4,6,3,6,2,3,1,2,3,2,0,0,3,2,19
400915330,Pittsburgh Panthers,C. Johnson,3138196,,True,29.0,4,8,2,3,2,5,6,6,1,4,5,4,0,0,2,2,16
400915330,Pittsburgh Panthers,C. Jones,61219,,True,23.0,2,4,2,3,0,1,0,0,0,3,3,1,0,0,2,1,4
400915330,Pittsburgh Panthers,R. Nix,3934653,,False,6.0,1,2,1,2,0,0,1,2,0,4,4,0,0,0,0,2,3
400915330,Pittsburgh Panthers,C. Manigault,4065714,,False,3.0,0,0,0,0,0,0,1,2,0,0,0,0,0,0,0,1,1
400915330,Pittsburgh Panthers,R. Seelye,3947153,,False,2.0,0,0,0,0,0,0,0,0,0,0,0,0,0,0,0,0,0
400915330,Pittsburgh Panthers,R. Luther,3138197,,False,29.0,5,7,4,6,1,1,0,0,1,2,3,0,0,1,0,4,11
400915330,Pittsburgh Panthers,J. Kithcart,4065713,,False,21.0,1,1,1,1,0,0,3,4,0,0,0,4,1,0,1,0,5
400915330,Pittsburgh Panthers,J. Milligan,3934655,,False,8.0,1,2,0,0,1,2,0,0,0,0,0,1,0,0,0,0,3
400915330,Pittsburgh Panthers,Z. Smith,3934654,,False,3.0,0,1,0,0,0,1,0,0,0,0,0,0,0,0,0,0,0
400915330,Pittsburgh Panthers,D. Wilson,3934652,,False,7.0,1,2,1,2,0,0,0,0,0,0,0,2,0,0,0,1,2
400915330,Pittsburgh Panthers,TEAM,TOTAL,TOTAL,False,,32,57,22,36,10,21,20,25,9,29,38,23,2,3,14,19,94
400915330,Omaha Mavericks,T. Thurman,3155987,,True,32.0,8,17,7,15,1,2,1,6,4,5,9,2,0,1,0,2,18
400915330,Omaha Mavericks,Z. Pirog,3924911,,True,11.0,0,1,0,1,0,0,0,0,0,1,1,1,0,0,1,4,0
400915330,Omaha Mavericks,T. Hollins,3924910,,True,29.0,6,9,5,6,1,3,4,5,1,2,3,5,6,0,1,4,17
400915330,Omaha Mavericks,J. Gibson,3924908,,True,26.0,5,9,4,6,1,3,2,4,1,2,3,2,2,0,2,2,13
400915330,Omaha Mavericks,M. Tyus,62466,,True,20.0,3,6,1,2,2,4,2,3,0,0,0,1,1,0,3,0,10
400915330,Omaha Mavericks,M. Hahn,3130560,,False,25.0,2,5,2,4,0,1,2,2,0,3,3,1,0,1,0,3,6
400915330,Omaha Mavericks,D. Meyer,66823,,False,9.0,0,1,0,1,0,0,0,1,1,2,3,0,0,0,1,0,0
400915330,Omaha Mavericks,K. Robinson,4067683,,False,12.0,3,4,1,2,2,2,0,0,0,0,0,0,0,0,1,3,8
400915330,Omaha Mavericks,A. Allbery,3155986,,False,3.0,0,1,0,1,0,0,0,0,1,0,1,0,0,0,0,1,0
400915330,Omaha Mavericks,D. Norl,3155895,,False,33.0,0,5,0,1,0,4,3,4,0,1,1,2,1,0,0,2,3
400915330,Omaha Mavericks,TEAM,TOTAL,TOTAL,False,,27,58,20,39,7,19,14,25,8,19,27,14,10,2,10,21,75
400915329,Virginia Cavaliers,I. Wilkins,3138203,,True,26.0,1,7,1,7,0,0,3,3,1,2,3,1,0,1,1,3,5
400915329,Virginia Cavaliers,J. Salt,3138200,,True,16.0,2,2,2,2,0,0,1,2,1,4,5,0,0,0,0,4,5
400915329,Virginia Cavaliers,D. Thompson,66274,,True,25.0,1,3,1,3,0,0,0,0,0,2,2,5,0,0,1,0,2
400915329,Virginia Cavaliers,L. Perrantes,66139,,True,35.0,6,13,5,8,1,5,1,2,1,2,3,3,0,0,2,0,14
400915329,Virginia Cavaliers,D. Hall,66138,,True,30.0,3,7,2,6,1,1,0,0,1,5,6,1,0,0,0,3,7
400915329,Virginia Cavaliers,M. Diakite,3947156,,False,12.0,2,5,2,4,0,1,0,0,1,2,3,0,0,2,0,2,4
400915329,Virginia Cavaliers,J. Reuter,3908374,,False,9.0,1,3,1,3,0,0,0,0,0,0,0,1,0,0,0,0,2
400915329,Virginia Cavaliers,T. Jerome,4065733,,False,5.0,0,1,0,1,0,0,0,0,1,0,1,0,0,0,0,2,0
400915329,Virginia Cavaliers,K. Guy,4065730,,False,29.0,6,10,4,6,2,4,3,4,0,4,4,2,1,0,1,1,17
400915329,Virginia Cavaliers,M. Shayok,3138201,,False,13.0,0,6,0,4,0,2,0,0,0,2,2,1,0,0,2,2,0
400915329,Virginia Cavaliers,TEAM,TOTAL,TOTAL,False,,22,57,18,44,4,13,8,11,9,24,33,14,1,3,7,17,56
400915329,California Golden Bears,I. Rabb,3917378,,True,38.0,1,4,1,3,0,1,7,8,3,9,12,2,0,0,3,3,9
400915329,California Golden Bears,K. Okoroh,3134892,,True,25.0,3,4,3,4,0,0,1,2,2,3,5,1,1,2,0,2,7
400915329,California Golden Bears,C. Moore,4066345,,True,28.0,3,14,2,9,1,5,0,0,1,1,2,4,0,0,4,3,7
400915329,California Golden Bears,S. Singer,66331,,True,33.0,4,6,4,6,0,0,2,3,0,4,4,3,2,0,1,2,10
400915329,California Golden Bears,J. Bird,66327,,True,32.0,5,15,1,3,4,12,1,1,1,3,4,1,0,0,2,3,15
400915329,California Golden Bears,R. Moute A Bidias,66329,,False,8.0,1,2,1,1,0,1,0,0,0,1,1,0,0,1,1,0,2
400915329,California Golden Bears,S. Domingo,62708,,False,13.0,1,5,1,1,0,4,0,2,0,0,0,0,0,0,0,1,2
400915329,California Golden Bears,G. Mullins,62241,,False,23.0,0,1,0,1,0,0,0,0,0,5,5,0,0,0,1,0,0
400915329,California Golden Bears,TEAM,TOTAL,TOTAL,False,,18,51,13,28,5,23,11,16,11,28,39,11,3,3,13,14,52
400915328,Northern Iowa Panthers,B. Koch,66446,,True,13.0,4,5,4,5,0,0,2,2,0,0,0,0,0,0,1,5,10
400915328,Northern Iowa Panthers,K. Carlson,66443,,True,32.0,4,12,3,7,1,5,0,2,0,6,6,1,1,0,2,1,9
400915328,Northern Iowa Panthers,J. McCloud,4067047,,True,26.0,1,5,0,2,1,3,0,0,0,0,0,1,0,0,4,0,3
400915328,Northern Iowa Panthers,S. Haldeman,3913789,,True,18.0,1,2,0,0,1,2,0,0,0,0,0,0,0,0,1,2,3
400915328,Northern Iowa Panthers,J. Morgan,66447,,True,28.0,2,7,0,3,2,4,0,0,0,7,7,2,0,0,4,3,6
400915328,Northern Iowa Panthers,L. McDonnell,3913790,,False,3.0,0,1,0,0,0,1,0,0,0,0,0,0,0,0,1,0,0
400915328,Northern Iowa Panthers,L. Conrey,3913786,,False,1.0,0,1,0,0,0,1,0,0,0,0,0,0,0,0,0,0,0
400915328,Northern Iowa Panthers,J. Dahl,3913787,,False,10.0,2,3,2,3,0,0,1,2,1,1,2,0,0,1,0,0,5
400915328,Northern Iowa Panthers,T. Friedman,66444,,False,6.0,0,0,0,0,0,0,0,0,1,0,1,0,0,1,1,1,0
400915328,Northern Iowa Panthers,I. Brown,4067050,,False,29.0,1,8,0,2,1,6,1,2,1,2,3,0,0,0,0,1,4
400915328,Northern Iowa Panthers,H. Rhodes,4067048,,False,13.0,0,2,0,1,0,1,0,0,0,0,0,1,0,0,1,1,0
400915328,Northern Iowa Panthers,R. de Souza,4067046,,False,1.0,0,0,0,0,0,0,0,0,0,0,0,0,0,0,2,0,0
400915328,Northern Iowa Panthers,J. Ashton,3906479,,False,20.0,1,2,1,1,0,1,0,0,0,1,1,1,2,0,0,1,2
400915328,Northern Iowa Panthers,TEAM,TOTAL,TOTAL,False,,16,48,10,24,6,24,4,8,3,21,24,6,3,2,17,15,42
400915328,North Carolina Tar Heels,J. Jackson,3138156,,True,30.0,5,9,4,6,1,3,1,2,0,5,5,3,2,0,0,0,12
400915328,North Carolina Tar Heels,I. Hicks,66874,,True,22.0,5,8,5,8,0,0,1,2,1,4,5,2,0,1,0,3,11
400915328,North Carolina Tar Heels,K. Meeks,66873,,True,20.0,6,10,6,10,0,0,6,9,4,4,8,2,0,0,0,1,18
400915328,North Carolina Tar Heels,K. Williams,3911619,,True,28.0,1,3,1,1,0,2,0,1,1,1,2,5,1,0,0,2,2
400915328,North Carolina Tar Heels,J. Berry II,3138155,,True,27.0,4,9,1,2,3,7,0,0,0,4,4,3,2,0,1,2,11
400915328,North Carolina Tar Heels,A. Rohlman,4065677,,False,1.0,0,0,0,0,0,0,0,0,0,0,0,0,0,0,0,0,0
400915328,North Carolina Tar Heels,S. Rush,4065674,,False,3.0,1,2,0,1,1,1,0,0,1,0,1,0,1,0,0,0,3
400915328,North Carolina Tar Heels,T. Bradley,4065673,,False,13.0,4,7,4,7,0,0,0,0,2,3,5,0,0,1,0,0,8
400915328,North Carolina Tar Heels,L. Maye,3911620,,False,16.0,3,4,2,2,1,2,0,0,0,3,3,2,0,0,2,1,7
400915328,North Carolina Tar Heels,S. Woods,4065676,,False,6.0,2,5,2,5,0,0,0,0,1,2,3,1,2,0,0,0,4
400915328,North Carolina Tar Heels,B. Robinson,4065675,,False,16.0,2,3,2,2,0,1,2,2,1,1,2,1,0,0,1,4,6
400915328,North Carolina Tar Heels,K. Coker,3947144,,False,1.0,0,0,0,0,0,0,0,0,0,0,0,0,0,0,0,1,0
400915328,North Carolina Tar Heels,N. Britt,66872,,False,17.0,1,5,0,2,1,3,0,0,0,3,3,1,4,0,0,0,3
400915328,North Carolina Tar Heels,TEAM,TOTAL,TOTAL,False,,34,65,27,46,7,19,10,16,11,31,42,20,12,2,5,14,85
400915327,Fairfield Stags,M. Milin,3947018,,True,9.0,0,0,0,0,0,0,2,2,0,1,1,0,0,0,0,3,2
400915327,Fairfield Stags,A. Sidibe,62619,,True,23.0,5,6,5,6,0,0,2,4,2,7,9,1,0,0,1,4,12
400915327,Fairfield Stags,C. Cobb III,3947017,,True,40.0,8,15,4,8,4,7,0,0,0,3,3,4,3,2,3,1,20
400915327,Fairfield Stags,J. Segura,3138287,,True,40.0,3,7,3,6,0,1,2,3,1,3,4,6,4,0,4,2,8
400915327,Fairfield Stags,T. Nelson,3138286,,True,35.0,5,13,3,4,2,9,8,10,0,3,3,5,3,1,3,2,20
400915327,Fairfield Stags,J. Kasibabu,3947016,,False,22.0,3,4,3,4,0,0,4,6,1,7,8,2,0,2,4,4,10
400915327,Fairfield Stags,J. Johnson Jr.,3947014,,False,31.0,6,14,1,3,5,11,0,0,0,2,2,1,0,0,0,3,17
400915327,Fairfield Stags,TEAM,TOTAL,TOTAL,False,,30,59,19,31,11,28,18,25,6,27,33,19,10,5,15,19,89
400915327,Boston College Eagles,A.J. Turner,3943608,,True,31.0,2,8,1,7,1,1,0,0,1,4,5,4,1,1,0,1,5
400915327,Boston College Eagles,M. Jeffers,61901,,True,16.0,1,3,1,3,0,0,3,5,1,2,3,0,0,0,0,3,5
400915327,Boston College Eagles,C. Tava,61446,,True,23.0,2,4,2,4,0,0,2,6,4,2,6,1,1,1,4,1,6
400915327,Boston College Eagles,K. Bowman,4065635,,True,39.0,13,21,12,17,1,4,6,7,2,6,8,5,3,1,2,3,33
400915327,Boston College Eagles,J. Robinson,3943606,,True,35.0,9,16,7,12,2,4,1,6,1,4,5,1,3,0,4,4,21
400915327,Boston College Eagles,J. Reyes,3943609,,False,1.0,0,0,0,0,0,0,0,0,1,0,1,0,0,0,0,1,0
400915327,Boston College Eagles,N. Popovic,4065637,,False,19.0,2,6,2,6,0,0,2,2,2,4,6,0,1,0,2,4,6
400915327,Boston College Eagles,G. Owens,66277,,False,10.0,1,2,1,2,0,0,1,2,0,1,1,1,0,0,1,2,3
400915327,Boston College Eagles,J. Chatman,3135095,,False,26.0,2,4,2,2,0,2,0,0,0,3,3,1,2,1,3,1,4
400915327,Boston College Eagles,TEAM,TOTAL,TOTAL,False,,32,64,28,53,4,11,15,28,13,27,40,13,11,4,16,20,83
400915326,Elon Phoenix,T. Seibring,3948129,,True,34.0,3,9,3,7,0,2,1,2,1,4,5,1,1,0,3,1,7
400915326,Elon Phoenix,B. Dawkins,67241,,True,27.0,7,13,3,9,4,4,0,0,0,9,9,1,0,0,2,5,18
400915326,Elon Phoenix,S. Santa Ana,4067232,,True,29.0,3,11,2,5,1,6,4,6,2,2,4,2,0,1,1,3,11
400915326,Elon Phoenix,D. Swoope,3948126,,True,34.0,1,7,1,4,0,3,0,0,0,4,4,4,0,0,3,1,2
400915326,Elon Phoenix,D. Thompson,3129947,,True,25.0,2,4,1,3,1,1,0,0,0,6,6,1,0,2,2,2,5
400915326,Elon Phoenix,K. Kundrotas,3948125,,False,13.0,4,6,3,5,1,1,0,0,2,1,3,0,0,0,0,1,9
400915326,Elon Phoenix,C. Hairston,67243,,False,6.0,1,1,1,1,0,0,0,1,1,1,2,1,0,0,0,0,2
400915326,Elon Phoenix,S. Eberhardt,3948127,,False,24.0,2,7,2,4,0,3,0,0,1,4,5,3,1,0,2,2,4
400915326,Elon Phoenix,L. Eddy,67242,,False,8.0,1,2,0,0,1,2,0,0,0,0,0,1,0,0,3,4,3
400915326,Elon Phoenix,TEAM,TOTAL,TOTAL,False,,24,60,16,38,8,22,5,9,11,31,42,14,2,3,17,19,61
400915326,Duke Blue Devils,J. Tatum,4065648,,True,37.0,7,22,7,18,0,4,4,4,3,5,8,3,2,4,2,1,18
400915326,Duke Blue Devils,A. Jefferson,61586,,True,27.0,2,3,2,3,0,0,9,11,1,6,7,0,0,2,1,2,13
400915326,Duke Blue Devils,L. Kennard,3913174,,True,36.0,7,17,5,13,2,4,5,6,2,5,7,0,1,1,0,3,21
400915326,Duke Blue Devils,G. Allen,3135045,,True,21.0,1,8,0,2,1,6,0,0,0,3,3,2,0,0,0,3,3
400915326,Duke Blue Devils,M. Jones,66563,,True,34.0,4,6,3,3,1,3,0,0,2,4,6,1,5,1,1,2,9
400915326,Duke Blue Devils,H. Giles III,4065649,,False,6.0,0,2,0,2,0,0,1,2,1,1,2,0,0,0,0,2,1
400915326,Duke Blue Devils,M. Bolden,4065652,,False,3.0,0,0,0,0,0,0,0,0,0,0,0,0,0,0,0,0,0
400915326,Duke Blue Devils,C. Jeter,3913173,,False,7.0,0,0,0,0,0,0,0,0,1,1,2,0,1,0,0,0,0
400915326,Duke Blue Devils,F. Jackson,4065651,,False,29.0,2,5,1,2,1,3,2,2,1,1,2,1,1,0,0,1,7
400915326,Duke Blue Devils,TEAM,TOTAL,TOTAL,False,,23,63,18,43,5,20,21,25,11,26,37,7,10,8,4,14,72
400915325,Virginia Tech Hokies,K. Sy,4065740,,True,18.0,1,3,1,3,0,0,4,7,2,2,4,1,0,2,1,1,6
400915325,Virginia Tech Hokies,C. Clarke,3945567,,True,29.0,6,8,6,8,0,0,5,8,3,8,11,2,3,1,3,2,17
400915325,Virginia Tech Hokies,J. Robinson,3945566,,True,33.0,3,7,2,3,1,4,5,5,0,4,4,2,1,0,2,2,12
400915325,Virginia Tech Hokies,A. Hill,3147501,,True,32.0,5,12,3,6,2,6,8,8,0,2,2,1,0,1,0,3,20
400915325,Virginia Tech Hokies,J. Bibbs,3147500,,True,16.0,0,6,0,1,0,5,0,0,0,3,3,0,0,0,2,4,0
400915325,Virginia Tech Hokies,G. Donlon,65454,,False,1.0,0,1,0,1,0,0,0,0,0,0,0,0,0,0,0,0,0
400915325,Virginia Tech Hokies,Z. LeDay,61698,,False,25.0,5,11,5,11,0,0,4,4,4,3,7,2,0,0,1,2,14
400915325,Virginia Tech Hokies,M. Galloway,3945565,,False,5.0,1,2,0,0,1,2,0,0,0,1,1,0,0,0,0,1,3
400915325,Virginia Tech Hokies,T. Outlaw,67275,,False,14.0,1,3,0,0,1,3,0,0,1,4,5,0,0,0,0,2,3
400915325,Virginia Tech Hokies,S. Allen,61795,,False,27.0,3,7,2,4,1,3,5,5,0,5,5,2,1,0,3,0,12
400915325,Virginia Tech Hokies,TEAM,TOTAL,TOTAL,False,,25,60,19,37,6,23,31,37,10,33,43,10,5,4,12,17,87
400915325,Charleston Southern Buccaneers,A. Maxwell Jr.,3913161,,True,27.0,1,7,1,5,0,2,1,2,5,6,11,1,0,2,1,2,3
400915325,Charleston Southern Buccaneers,J. Howard,3129902,,True,22.0,1,6,1,6,0,0,0,0,1,0,1,1,0,1,1,4,2
400915325,Charleston Southern Buccaneers,C. Keeling,4067301,,True,32.0,8,17,8,14,0,3,8,9,2,8,10,0,0,0,2,0,24
400915325,Charleston Southern Buccaneers,C. Mitchell,4067298,,True,23.0,4,12,4,8,0,4,1,6,1,3,4,1,1,0,1,2,9
400915325,Charleston Southern Buccaneers,A. Potter,3913163,,True,30.0,0,5,0,3,0,2,0,2,0,2,2,3,0,0,3,3,0
400915325,Charleston Southern Buccaneers,J. Martin,4067299,,False,8.0,2,2,1,1,1,1,0,0,0,1,1,0,0,0,3,4,5
400915325,Charleston Southern Buccaneers,U. Mmonu,66918,,False,12.0,0,0,0,0,0,0,0,0,2,3,5,0,0,1,0,2,0
400915325,Charleston Southern Buccaneers,J. Jones,4067302,,False,10.0,1,4,1,4,0,0,0,0,1,0,1,0,1,1,2,4,2
400915325,Charleston Southern Buccaneers,J. Thomas,4067304,,False,9.0,3,3,0,0,3,3,0,0,0,0,0,0,0,0,1,1,9
400915325,Charleston Southern Buccaneers,P. Wallace,66136,,False,14.0,1,6,1,3,0,3,0,0,0,0,0,0,0,0,1,4,2
400915325,Charleston Southern Buccaneers,R. Robinson,62226,,False,13.0,1,4,0,0,1,4,0,0,0,3,3,1,0,0,2,2,3
400915325,Charleston Southern Buccaneers,TEAM,TOTAL,TOTAL,False,,22,66,17,44,5,22,10,19,14,26,40,7,2,5,17,28,59
400915324,Tennessee State Tigers,K. Hamilton,4067261,,True,24.0,2,6,2,5,0,1,0,0,2,6,8,1,0,0,3,2,4
400915324,Tennessee State Tigers,W. Martin,66964,,True,34.0,3,6,3,5,0,1,3,6,0,5,5,2,0,0,3,3,9
400915324,Tennessee State Tigers,D. Reddick,3138575,,True,31.0,6,10,5,5,1,5,1,1,0,4,4,0,0,0,2,3,14
400915324,Tennessee State Tigers,J. Reed,61859,,True,22.0,3,5,2,3,1,2,2,4,1,1,2,0,0,0,1,4,9
400915324,Tennessee State Tigers,T. McCall,61417,,True,35.0,7,16,7,14,0,2,0,0,0,3,3,3,3,0,1,2,14
400915324,Tennessee State Tigers,S. Oyediran,3923239,,False,1.0,0,0,0,0,0,0,1,2,1,0,1,0,0,0,0,0,1
400915324,Tennessee State Tigers,C. Mekowulu,3138574,,False,15.0,1,2,1,2,0,0,0,0,0,4,4,0,0,1,0,5,2
400915324,Tennessee State Tigers,X. Williams,68525,,False,3.0,0,1,0,1,0,0,0,0,0,0,0,0,1,0,0,2,0
400915324,Tennessee State Tigers,K. Spencer,4067264,,False,1.0,0,0,0,0,0,0,0,0,0,0,0,0,0,0,0,0,0
400915324,Tennessee State Tigers,A. Everett,4067263,,False,8.0,0,0,0,0,0,0,0,0,0,0,0,0,0,0,1,2,0
400915324,Tennessee State Tigers,D. Spencer,4067260,,False,13.0,0,2,0,0,0,2,0,0,0,1,1,0,0,0,1,1,0
400915324,Tennessee State Tigers,J. Duke,3948864,,False,1.0,0,0,0,0,0,0,0,0,0,0,0,0,0,0,0,0,0
400915324,Tennessee State Tigers,T. Davis,3923238,,False,1.0,0,0,0,0,0,0,0,0,0,0,0,0,0,0,0,0,0
400915324,Tennessee State Tigers,A. Chaney,3923237,,False,11.0,0,3,0,0,0,3,2,2,0,1,1,1,0,0,1,1,2
400915324,Tennessee State Tigers,TEAM,TOTAL,TOTAL,False,,22,51,20,35,2,16,9,15,4,25,29,7,4,1,13,25,55
400915324,Duke Blue Devils,J. Tatum,4065648,,True,29.0,4,11,2,5,2,6,4,5,3,6,9,3,2,2,4,4,14
400915324,Duke Blue Devils,A. Jefferson,61586,,True,33.0,2,7,2,7,0,0,1,8,7,11,18,2,1,1,2,2,5
400915324,Duke Blue Devils,L. Kennard,3913174,,True,39.0,7,10,4,5,3,5,7,8,0,3,3,1,0,0,4,2,24
400915324,Duke Blue Devils,G. Allen,3135045,,True,35.0,2,7,1,1,1,6,7,11,2,3,5,2,0,0,0,3,12
400915324,Duke Blue Devils,M. Jones,66563,,True,31.0,2,8,1,4,1,4,0,0,1,1,2,3,3,0,0,2,5
400915324,Duke Blue Devils,H. Giles III,4065649,,False,4.0,0,1,0,1,0,0,0,0,0,0,0,0,0,0,0,0,0
400915324,Duke Blue Devils,M. Bolden,4065652,,False,6.0,0,1,0,1,0,0,0,0,0,0,0,1,0,0,0,1,0
400915324,Duke Blue Devils,C. Jeter,3913173,,False,10.0,0,0,0,0,0,0,0,0,0,2,2,0,1,0,1,1,0
400915324,Duke Blue Devils,F. Jackson,4065651,,False,13.0,2,6,1,3,1,3,0,0,0,1,1,0,0,0,1,4,5
400915324,Duke Blue Devils,TEAM,TOTAL,TOTAL,False,,19,51,11,27,8,24,19,32,14,27,41,12,7,3,12,19,65
400915323,Notre Dame Fighting Irish,B. Colson,3138192,,True,25.0,5,9,5,8,0,1,3,4,0,7,7,3,2,1,3,2,13
400915323,Notre Dame Fighting Irish,M. Geben,3138191,,True,13.0,4,6,4,6,0,0,0,0,3,1,4,1,1,0,0,0,8
400915323,Notre Dame Fighting Irish,V.J. Beachem,66283,,True,34.0,7,13,1,3,6,10,0,0,0,2,2,2,3,1,4,3,20
400915323,Notre Dame Fighting Irish,M. Farrell,3138190,,True,37.0,5,11,2,4,3,7,0,0,0,3,3,7,2,0,4,1,13
400915323,Notre Dame Fighting Irish,S. Vasturia,66285,,True,35.0,2,5,0,1,2,4,1,2,1,5,6,4,1,0,1,2,7
400915323,Notre Dame Fighting Irish,J. Mooney,4065705,,False,2.0,0,0,0,0,0,0,0,0,0,0,0,0,0,1,0,0,0
400915323,Notre Dame Fighting Irish,E. Burns,3908337,,False,2.0,0,0,0,0,0,0,0,0,0,1,1,0,0,0,0,0,0
400915323,Notre Dame Fighting Irish,A. Torres,66286,,False,8.0,1,1,1,1,0,0,1,2,0,1,1,0,2,2,0,1,3
400915323,Notre Dame Fighting Irish,M. Ryan,3908336,,False,11.0,3,5,0,0,3,5,0,0,0,0,0,2,0,0,0,2,9
400915323,Notre Dame Fighting Irish,T. Gibbs,4065703,,False,17.0,1,3,1,1,0,2,2,2,1,1,2,2,0,0,2,2,4
400915323,Notre Dame Fighting Irish,R. Pflueger,3908335,,False,16.0,0,3,0,1,0,2,0,0,2,2,4,2,1,2,0,1,0
400915323,Notre Dame Fighting Irish,TEAM,TOTAL,TOTAL,False,,28,56,14,25,14,31,7,10,7,24,31,23,12,7,14,14,77
400915323,Colgate Raiders,W. Rayman,4067106,,True,28.0,7,11,5,7,2,4,2,4,1,1,2,0,0,0,2,3,18
400915323,Colgate Raiders,M. Regisford,3921437,,True,27.0,3,5,3,5,0,0,5,5,1,5,6,1,1,2,3,2,11
400915323,Colgate Raiders,T. Rivard,67172,,True,18.0,2,5,1,2,1,3,0,0,0,2,2,0,1,0,4,0,5
400915323,Colgate Raiders,S. O'Brien,3130556,,True,31.0,1,8,1,6,0,2,0,0,1,3,4,6,0,0,3,2,2
400915323,Colgate Raiders,N. Harries,67191,,True,26.0,6,10,4,6,2,4,3,3,0,1,1,0,1,0,1,3,17
400915323,Colgate Raiders,D. Krmpotich,3921439,,False,2.0,0,0,0,0,0,0,0,0,0,0,0,0,0,0,0,0,0
400915323,Colgate Raiders,J. Swopshire,66418,,False,15.0,0,3,0,2,0,1,2,2,3,2,5,1,0,0,2,3,2
400915323,Colgate Raiders,D. Batt,3921438,,False,11.0,0,2,0,2,0,0,0,0,0,1,1,0,0,0,1,2,0
400915323,Colgate Raiders,F. Amiel,3921440,,False,18.0,0,3,0,0,0,3,0,0,0,2,2,0,2,0,0,0,0
400915323,Colgate Raiders,J. Robertson,3130557,,False,18.0,1,3,0,1,1,2,4,4,0,1,1,0,1,1,2,1,7
400915323,Colgate Raiders,A. Bargmann,67194,,False,6.0,0,0,0,0,0,0,0,0,0,1,1,1,0,0,0,0,0
400915323,Colgate Raiders,TEAM,TOTAL,TOTAL,False,,20,50,14,31,6,19,16,18,7,21,28,9,6,3,18,16,62
400915322,Syracuse Orange,T. Lydon,3934662,,True,16.0,4,7,2,5,2,2,2,2,1,5,6,4,1,1,2,1,12
400915322,Syracuse Orange,D. Coleman,61821,,True,16.0,5,8,5,8,0,0,2,3,1,3,4,0,0,2,2,3,12
400915322,Syracuse Orange,A. White III,61616,,True,30.0,5,10,1,2,4,8,0,0,1,2,3,0,3,0,1,0,14
400915322,Syracuse Orange,F. Howard,3934659,,True,29.0,3,5,2,3,1,2,3,4,2,2,4,11,2,1,4,4,10
400915322,Syracuse Orange,J. Gillon,61915,,True,31.0,4,9,1,2,3,7,3,3,1,2,3,9,5,0,1,0,14
400915322,Syracuse Orange,T. Thompson,4065721,,False,20.0,5,6,4,5,1,1,0,2,0,7,7,5,2,3,2,3,11
400915322,Syracuse Orange,D. Akintobi-Adeyeye,3155403,,False,2.0,2,2,2,2,0,0,0,0,0,0,0,0,0,0,0,0,4
400915322,Syracuse Orange,T. Roberson,67633,,False,25.0,4,6,4,6,0,0,2,7,3,5,8,2,0,1,3,2,10
400915322,Syracuse Orange,T. Battle,4065722,,False,23.0,5,9,1,2,4,7,4,4,0,2,2,1,1,0,1,1,18
400915322,Syracuse Orange,K. Feldman,3934665,,False,2.0,0,1,0,0,0,1,0,0,0,0,0,1,0,0,0,0,0
400915322,Syracuse Orange,A. Autry,3934661,,False,2.0,0,0,0,0,0,0,0,0,0,0,0,0,1,0,0,0,0
400915322,Syracuse Orange,S. Belbey,3934660,,False,2.0,0,0,0,0,0,0,0,0,0,0,0,1,0,0,1,0,0
400915322,Syracuse Orange,M. Sutton,3153164,,False,2.0,0,0,0,0,0,0,0,0,0,1,1,0,0,0,0,0,0
400915322,Syracuse Orange,TEAM,TOTAL,TOTAL,False,,37,63,22,35,15,28,16,25,11,34,45,34,15,8,17,14,105
400915322,Eastern Michigan Eagles,B. Steele,4067383,,True,18.0,2,4,2,4,0,0,0,0,1,0,1,0,1,0,0,1,4
400915322,Eastern Michigan Eagles,J. Thompson IV,3913762,,True,20.0,0,5,0,5,0,0,4,4,2,4,6,2,1,0,5,1,4
400915322,Eastern Michigan Eagles,T. Bond,3148983,,True,30.0,3,7,1,3,2,4,0,1,1,1,2,3,2,1,1,3,8
400915322,Eastern Michigan Eagles,W. Mangum IV,3913764,,True,36.0,4,20,2,7,2,13,0,0,1,4,5,3,2,0,4,2,10
400915322,Eastern Michigan Eagles,R. Lee,62353,,True,13.0,1,6,1,3,0,3,0,0,0,1,1,1,2,0,5,2,2
400915322,Eastern Michigan Eagles,B. Brown,3948765,,False,7.0,0,0,0,0,0,0,0,0,0,0,0,0,0,0,0,1,0
400915322,Eastern Michigan Eagles,L. Wofford-Humphrey,3913767,,False,1.0,0,0,0,0,0,0,0,0,0,0,0,0,0,0,1,0,0
400915322,Eastern Michigan Eagles,Q. Jones,3913766,,False,13.0,5,7,5,7,0,0,2,5,0,0,0,0,0,0,1,5,12
400915322,Eastern Michigan Eagles,J. Nobles,3148984,,False,37.0,5,11,4,6,1,5,0,2,3,7,10,2,1,0,3,3,11
400915322,Eastern Michigan Eagles,N. Madray,66488,,False,15.0,3,5,3,5,0,0,0,0,1,0,1,0,0,0,0,2,6
400915322,Eastern Michigan Eagles,J. Brown,4067381,,False,10.0,0,1,0,0,0,1,0,0,0,1,1,0,0,0,0,0,0
400915322,Eastern Michigan Eagles,TEAM,TOTAL,TOTAL,False,,23,66,18,40,5,26,6,12,13,20,33,11,9,1,20,20,57
400915321,Samford Bulldogs,W. Walker,3906811,,True,34.0,2,4,2,4,0,0,0,0,2,6,8,1,0,1,1,2,4
400915321,Samford Bulldogs,A. Thompson,66242,,True,27.0,5,11,2,2,3,9,0,0,0,6,6,0,0,0,1,2,13
400915321,Samford Bulldogs,D. Denzel-Dyson,4067630,,True,32.0,5,11,5,9,0,2,4,4,1,3,4,0,0,0,5,3,14
400915321,Samford Bulldogs,T. Chambers,4067627,,True,21.0,3,5,0,0,3,5,0,0,0,1,1,0,0,0,1,1,9
400915321,Samford Bulldogs,C. Cunningham,3137221,,True,34.0,7,15,5,9,2,6,0,0,0,1,1,3,0,0,3,0,16
400915321,Samford Bulldogs,A. Peters,3137225,,False,6.0,0,0,0,0,0,0,0,0,0,0,0,0,0,0,1,4,0
400915321,Samford Bulldogs,T. Brutus,61628,,False,13.0,0,1,0,1,0,0,2,2,1,4,5,1,0,0,1,2,2
400915321,Samford Bulldogs,J. Hopkins,4067629,,False,8.0,0,1,0,1,0,0,0,0,0,0,0,0,0,0,0,1,0
400915321,Samford Bulldogs,J. Sharkey,4067626,,False,25.0,2,8,1,5,1,3,5,6,1,2,3,7,3,0,1,4,10
400915321,Samford Bulldogs,TEAM,TOTAL,TOTAL,False,,24,56,15,31,9,25,11,12,5,25,30,12,3,1,14,19,68
400915321,Florida State Seminoles,J. Isaac,4065654,,True,22.0,2,6,2,3,0,3,1,2,2,2,4,0,0,1,2,3,5
400915321,Florida State Seminoles,M. Ojo,61596,,True,14.0,1,2,1,2,0,0,0,0,3,0,3,0,0,1,1,2,2
400915321,Florida State Seminoles,T. Mann,3907823,,True,25.0,7,8,7,8,0,0,5,6,1,4,5,1,1,0,0,1,19
400915321,Florida State Seminoles,D. Bacon,3907821,,True,29.0,4,15,3,10,1,5,5,6,0,6,6,2,1,0,2,0,14
400915321,Florida State Seminoles,X. Rathan-Mayes,66125,,True,31.0,6,10,3,4,3,6,0,0,0,4,4,5,0,0,2,1,15
400915321,Florida State Seminoles,P. Cofer,3135054,,False,22.0,0,2,0,2,0,0,1,2,3,2,5,0,1,0,0,1,1
400915321,Florida State Seminoles,J. Smith,66126,,False,6.0,0,3,0,3,0,0,0,0,0,1,1,0,0,0,1,2,0
400915321,Florida State Seminoles,B. Allen,66124,,False,5.0,1,2,0,0,1,2,0,0,0,0,0,0,0,0,0,2,3
400915321,Florida State Seminoles,C. Koumadje,3907824,,False,10.0,0,2,0,2,0,0,1,2,1,2,3,0,0,1,0,0,1
400915321,Florida State Seminoles,B. Angola-Rodas,4065658,,False,10.0,3,5,2,4,1,1,0,0,0,0,0,1,0,0,0,1,7
400915321,Florida State Seminoles,P. Savoy,4065657,,False,7.0,0,5,0,1,0,4,1,2,0,0,0,1,0,0,1,0,1
400915321,Florida State Seminoles,T. Forrest,4065656,,False,19.0,3,4,3,3,0,1,2,2,0,4,4,1,1,0,3,2,8
400915321,Florida State Seminoles,TEAM,TOTAL,TOTAL,False,,27,64,21,42,6,22,16,22,14,27,41,11,4,3,12,15,76
400915320,Sacred Heart Pioneers,J. Lopez,4067937,,True,28.0,6,11,6,11,0,0,4,8,4,5,9,1,3,1,2,4,16
400915320,Sacred Heart Pioneers,D. Barnett,66958,,True,19.0,3,3,3,3,0,0,0,2,2,6,8,1,0,0,1,5,6
400915320,Sacred Heart Pioneers,Q. McKnight,3947674,,True,39.0,10,18,9,14,1,4,15,18,0,5,5,3,2,0,4,4,36
400915320,Sacred Heart Pioneers,C. Tucker Jr.,4067935,,True,22.0,0,2,0,0,0,2,1,2,0,2,2,4,1,0,6,4,1
400915320,Sacred Heart Pioneers,S. Hoehn,3947677,,True,31.0,2,10,2,5,0,5,0,0,0,1,1,4,1,0,3,4,4
400915320,Sacred Heart Pioneers,M. Buovac,61650,,False,12.0,0,4,0,1,0,3,0,0,0,1,1,0,0,0,5,4,0
400915320,Sacred Heart Pioneers,C. Walton,61522,,False,9.0,1,1,1,1,0,0,0,0,0,3,3,1,0,1,0,4,2
400915320,Sacred Heart Pioneers,Z. Radz,4067934,,False,0.0,0,0,0,0,0,0,0,0,0,0,0,0,0,0,0,0,0
400915320,Sacred Heart Pioneers,S. Montague,4067936,,False,12.0,2,3,2,3,0,0,3,3,0,5,5,1,0,0,0,3,7
400915320,Sacred Heart Pioneers,C. Robinson,3153184,,False,28.0,1,7,0,2,1,5,0,0,2,4,6,2,0,0,0,2,3
400915320,Sacred Heart Pioneers,TEAM,TOTAL,TOTAL,False,,25,59,23,40,2,19,23,33,9,36,45,17,7,2,21,34,75
400915320,Boston College Eagles,M. Jeffers,61901,,True,18.0,2,5,2,5,0,0,1,2,1,4,5,1,0,0,2,2,5
400915320,Boston College Eagles,A.J. Turner,3943608,,True,32.0,3,7,1,3,2,4,2,2,1,3,4,3,0,0,1,4,10
400915320,Boston College Eagles,C. Tava,61446,,True,29.0,2,6,2,5,0,1,2,3,1,5,6,4,2,1,4,5,6
400915320,Boston College Eagles,K. Bowman,4065635,,True,28.0,2,6,2,4,0,2,8,13,0,5,5,3,1,0,4,4,12
400915320,Boston College Eagles,J. Robinson,3943606,,True,36.0,11,20,10,17,1,3,9,11,2,1,3,2,5,2,1,3,32
400915320,Boston College Eagles,J. Reyes,3943609,,False,4.0,0,2,0,2,0,0,0,0,0,1,1,0,0,1,0,1,0
400915320,Boston College Eagles,N. Popovic,4065637,,False,16.0,2,5,2,3,0,2,3,8,1,4,5,2,0,1,1,4,7
400915320,Boston College Eagles,G. Owens,66277,,False,11.0,1,2,1,1,0,1,0,1,2,3,5,1,0,0,0,1,2
400915320,Boston College Eagles,T. Graves,4065636,,False,7.0,0,3,0,2,0,1,0,0,0,0,0,0,0,0,2,1,0
400915320,Boston College Eagles,J. Chatman,3135095,,False,19.0,3,5,1,2,2,3,0,1,0,2,2,0,0,0,0,1,8
400915320,Boston College Eagles,TEAM,TOTAL,TOTAL,False,,26,61,21,44,5,17,25,41,8,31,39,16,8,5,15,26,82
400915319,NC State Wolfpack,A. Abu,3138158,,True,22.0,6,9,6,9,0,0,2,3,1,8,9,2,0,0,4,1,14
400915319,NC State Wolfpack,B. Anya,66134,,True,11.0,1,2,1,2,0,0,0,0,0,2,2,2,0,0,0,0,2
400915319,NC State Wolfpack,D. Smith Jr.,4065697,,True,31.0,6,10,1,3,5,7,0,0,0,5,5,9,2,1,4,2,17
400915319,NC State Wolfpack,T. Dorn,3132359,,True,24.0,3,6,3,4,0,2,6,6,1,3,4,3,0,0,2,1,12
400915319,NC State Wolfpack,T. Henderson,61215,,True,32.0,7,13,1,3,6,10,5,6,1,6,7,3,0,0,1,3,25
400915319,NC State Wolfpack,T. Kapita,4065701,,False,14.0,1,3,1,3,0,0,4,4,1,3,4,0,0,0,1,1,6
400915319,NC State Wolfpack,D. Hicks,4065698,,False,3.0,0,0,0,0,0,0,0,0,0,0,0,1,0,1,1,0,0
400915319,NC State Wolfpack,T. Thompson,3151470,,False,1.0,0,0,0,0,0,0,0,0,0,0,0,0,0,0,0,1,0
400915319,NC State Wolfpack,C. Brickhouse,67562,,False,2.0,0,0,0,0,0,0,0,0,0,0,0,0,0,0,0,0,0
400915319,NC State Wolfpack,O. Yurtseven,66768,,False,28.0,6,11,6,11,0,0,0,2,1,5,6,3,0,1,1,3,12
400915319,NC State Wolfpack,M. Johnson,4065699,,False,12.0,1,1,1,1,0,0,1,2,1,1,2,1,1,0,1,1,3
400915319,NC State Wolfpack,M. Rowan,3947151,,False,16.0,2,6,0,1,2,5,0,0,1,1,2,1,1,1,0,3,6
400915319,NC State Wolfpack,S. Kirk,3947150,,False,3.0,1,2,1,1,0,1,0,0,0,0,0,0,0,0,0,0,2
400915319,NC State Wolfpack,C. Corchiani Jr.,3138159,,False,1.0,0,1,0,1,0,0,0,0,0,0,0,0,0,0,0,0,0
400915319,NC State Wolfpack,TEAM,TOTAL,TOTAL,False,,34,64,21,39,13,25,18,23,9,36,45,25,4,4,15,16,99
400915319,Fairfield Stags,M. Milin,3947018,,True,24.0,3,8,3,4,0,4,0,0,0,3,3,2,2,0,2,2,6
400915319,Fairfield Stags,A. Sidibe,62619,,True,18.0,2,3,2,3,0,0,0,0,1,4,5,0,2,0,0,5,4
400915319,Fairfield Stags,C. Cobb III,3947017,,True,34.0,4,14,2,6,2,8,4,4,1,1,2,4,3,0,3,3,14
400915319,Fairfield Stags,J. Segura,3138287,,True,11.0,0,0,0,0,0,0,0,0,0,1,1,2,0,0,3,2,0
400915319,Fairfield Stags,T. Nelson,3138286,,True,39.0,8,19,3,6,5,13,2,2,1,1,2,3,1,0,0,2,23
400915319,Fairfield Stags,D. Celen,4067291,,False,16.0,1,3,1,1,0,2,0,0,1,3,4,1,1,0,0,2,2
400915319,Fairfield Stags,J. Kasibabu,3947016,,False,24.0,3,5,2,3,1,2,0,0,1,5,6,0,0,0,1,3,7
400915319,Fairfield Stags,O. Cadieux,4067290,,False,3.0,0,2,0,1,0,1,2,2,0,1,1,0,0,0,0,0,2
400915319,Fairfield Stags,T. Nolan,3947015,,False,1.0,0,0,0,0,0,0,0,0,0,0,0,1,0,0,0,0,0
400915319,Fairfield Stags,J. Johnson Jr.,3947014,,False,28.0,3,13,1,2,2,11,9,9,0,3,3,2,0,0,2,1,17
400915319,Fairfield Stags,J. Harper,3138283,,False,1.0,0,0,0,0,0,0,0,0,0,0,0,0,0,0,0,0,0
400915319,Fairfield Stags,A. Leone,3091075,,False,1.0,1,1,0,0,1,1,0,0,0,0,0,1,0,0,0,0,3
400915319,Fairfield Stags,TEAM,TOTAL,TOTAL,False,,25,68,14,26,11,42,17,17,7,23,30,16,9,0,11,20,78
400915318,Georgia Tech Yellow Jackets,Q. Stephens,66128,,True,24.0,5,10,5,8,0,2,1,4,2,6,8,3,3,1,1,1,11
400915318,Georgia Tech Yellow Jackets,B. Lammers,3135061,,True,20.0,5,7,5,7,0,0,2,2,6,7,13,1,1,1,3,1,12
400915318,Georgia Tech Yellow Jackets,J. Okogie,4065663,,True,20.0,3,9,3,8,0,1,8,8,0,0,0,2,3,1,2,1,14
400915318,Georgia Tech Yellow Jackets,J. Moore,4065662,,True,28.0,1,5,1,5,0,0,3,4,2,2,4,7,1,0,2,3,5
400915318,Georgia Tech Yellow Jackets,C. Heyward,61609,,True,20.0,1,4,1,3,0,1,2,2,1,2,3,0,0,0,1,0,4
400915318,Georgia Tech Yellow Jackets,S. Ogbonda,3904627,,False,9.0,2,4,2,4,0,0,1,2,2,2,4,2,0,0,0,2,5
400915318,Georgia Tech Yellow Jackets,A. Gueye,3135059,,False,18.0,2,3,2,3,0,0,1,2,2,4,6,2,0,2,2,2,5
400915318,Georgia Tech Yellow Jackets,R. Rowland,67543,,False,4.0,0,1,0,1,0,0,0,0,1,1,2,0,0,0,2,0,0
400915318,Georgia Tech Yellow Jackets,K. McCormick,61453,,False,10.0,1,1,0,0,1,1,0,0,0,0,0,0,0,0,1,1,3
400915318,Georgia Tech Yellow Jackets,N. Harris,4072202,,False,2.0,0,0,0,0,0,0,0,0,0,0,0,0,0,0,0,1,0
400915318,Georgia Tech Yellow Jackets,S. Medlock,4065664,,False,1.0,0,0,0,0,0,0,0,0,0,0,0,0,0,0,0,1,0
400915318,Georgia Tech Yellow Jackets,T. Jackson,3135057,,False,20.0,6,13,5,8,1,5,1,1,1,2,3,0,2,1,0,0,14
400915318,Georgia Tech Yellow Jackets,J. Heath,67623,,False,19.0,0,3,0,3,0,0,1,2,0,1,1,1,0,0,0,1,1
400915318,Georgia Tech Yellow Jackets,J. Price,61778,,False,5.0,0,2,0,1,0,1,0,0,0,0,0,0,0,0,0,0,0
400915318,Georgia Tech Yellow Jackets,TEAM,TOTAL,TOTAL,False,,26,62,24,51,2,11,20,27,18,28,46,18,10,6,14,14,74
400915318,Alcorn State Braves,D. Brewer,4067682,,True,9.0,0,2,0,2,0,0,0,0,0,0,0,1,1,1,1,2,0
400915318,Alcorn State Braves,Y. Reed,4067681,,True,14.0,0,2,0,1,0,1,0,0,0,1,1,0,0,0,0,4,0
400915318,Alcorn State Braves,T. Carter,4067678,,True,6.0,0,1,0,1,0,0,0,0,0,0,0,0,0,0,1,2,0
400915318,Alcorn State Braves,A.J. Mosby,4067677,,True,32.0,5,8,1,3,4,5,2,2,1,2,3,3,0,1,5,1,16
400915318,Alcorn State Braves,A. Patterson,3132546,,True,20.0,0,5,0,2,0,3,1,2,0,2,2,1,1,0,4,2,1
400915318,Alcorn State Braves,T. Smith,3947702,,False,10.0,0,0,0,0,0,0,0,0,0,1,1,0,0,1,0,1,0
400915318,Alcorn State Braves,R. Johnson,3155568,,False,25.0,6,10,6,8,0,2,3,5,3,2,5,0,1,0,1,1,15
400915318,Alcorn State Braves,M. Vance,68116,,False,24.0,1,8,0,6,1,2,0,0,3,3,6,1,0,2,3,2,3
400915318,Alcorn State Braves,M. Howard,4067679,,False,16.0,2,5,1,2,1,3,0,0,0,2,2,1,1,0,2,1,5
400915318,Alcorn State Braves,R. Katumbusi,3947701,,False,8.0,0,2,0,2,0,0,2,2,0,3,3,0,0,0,0,0,2
400915318,Alcorn State Braves,J. Henderson,3155564,,False,4.0,0,0,0,0,0,0,3,4,1,0,1,0,1,0,2,1,3
400915318,Alcorn State Braves,D. Dulin,3133271,,False,32.0,2,8,1,5,1,3,0,0,0,0,0,0,1,0,1,2,5
400915318,Alcorn State Braves,TEAM,TOTAL,TOTAL,False,,16,51,9,32,7,19,11,15,10,21,31,7,6,5,21,19,50
400915317,Louisville Cardinals,M. Mathiang,63035,,True,20.0,0,3,0,3,0,0,0,0,5,8,13,4,0,2,1,3,0
400915317,Louisville Cardinals,D. Adel,3908807,,True,26.0,2,8,2,5,0,3,3,3,0,3,3,3,1,1,2,1,7
400915317,Louisville Cardinals,J. Johnson,3147362,,True,17.0,2,3,2,3,0,0,6,6,3,4,7,0,0,1,1,4,10
400915317,Louisville Cardinals,D. Mitchell,3908809,,True,19.0,4,9,2,2,2,7,5,5,1,6,7,0,1,0,2,3,15
400915317,Louisville Cardinals,Q. Snider,3147360,,True,25.0,5,7,2,2,3,5,0,0,0,1,1,6,0,0,1,0,13
400915317,Louisville Cardinals,V.J. King,4065666,,False,13.0,3,7,3,6,0,1,3,4,1,1,2,0,0,0,0,1,9
400915317,Louisville Cardinals,R. Spalding,3908806,,False,23.0,4,7,4,7,0,0,0,2,0,5,5,1,2,4,1,0,8
400915317,Louisville Cardinals,A. Mahmoud,3147363,,False,16.0,3,5,3,5,0,0,0,1,3,1,4,0,2,5,1,1,6
400915317,Louisville Cardinals,M. Stockman,3147361,,False,4.0,0,0,0,0,0,0,0,0,1,2,3,0,0,0,0,0,0
400915317,Louisville Cardinals,T. Sharpe,4065667,,False,1.0,0,0,0,0,0,0,0,0,0,0,0,1,0,0,1,0,0
400915317,Louisville Cardinals,R. McMahon,3908808,,False,9.0,1,2,0,0,1,2,0,0,0,1,1,0,0,1,1,1,3
400915317,Louisville Cardinals,J. Henderson,3155491,,False,1.0,0,0,0,0,0,0,0,0,0,0,0,1,1,0,0,0,0
400915317,Louisville Cardinals,D. Levitch,66592,,False,9.0,2,3,0,0,2,3,0,0,0,0,0,2,0,0,1,1,6
400915317,Louisville Cardinals,T. Hicks,62752,,False,17.0,4,8,2,5,2,3,0,0,0,1,1,1,0,0,4,1,10
400915317,Louisville Cardinals,TEAM,TOTAL,TOTAL,False,,30,62,20,38,10,24,17,21,14,33,47,19,7,14,16,16,87
400915317,Eastern Kentucky Colonels,Z. Charles,4067166,,True,13.0,2,5,2,5,0,0,0,1,3,1,4,0,2,0,0,4,4
400915317,Eastern Kentucky Colonels,N. Mayo,3906491,,True,32.0,5,12,3,9,2,3,3,6,0,5,5,4,1,0,1,2,15
400915317,Eastern Kentucky Colonels,A. Gist,4067164,,True,31.0,5,15,3,9,2,6,0,2,0,1,1,3,2,0,4,3,12
400915317,Eastern Kentucky Colonels,I. McGlone,66891,,True,25.0,1,3,0,1,1,2,2,2,0,1,1,3,1,0,1,1,5
400915317,Eastern Kentucky Colonels,D. Avare,66590,,True,34.0,1,5,0,1,1,4,0,0,0,2,2,0,1,0,0,1,3
400915317,Eastern Kentucky Colonels,L. Anderson,4067167,,False,6.0,1,4,1,3,0,1,0,0,1,1,2,1,0,0,1,1,2
400915317,Eastern Kentucky Colonels,D. Dishman,4067165,,False,18.0,1,7,1,7,0,0,0,0,2,6,8,0,0,1,1,1,2
400915317,Eastern Kentucky Colonels,M. Adams,4067163,,False,22.0,4,5,4,4,0,1,2,2,1,2,3,0,0,2,0,2,10
400915317,Eastern Kentucky Colonels,P. Chitty,4067169,,False,17.0,1,3,1,2,0,1,0,0,0,1,1,1,1,0,7,2,2
400915317,Eastern Kentucky Colonels,K. Humphrey,3948862,,False,1.0,0,0,0,0,0,0,0,0,0,0,0,0,0,0,1,0,0
400915317,Eastern Kentucky Colonels,D. Parke,3155896,,False,1.0,0,0,0,0,0,0,1,2,0,0,0,0,0,0,0,0,1
400915317,Eastern Kentucky Colonels,TEAM,TOTAL,TOTAL,False,,21,59,15,41,6,18,8,15,10,21,31,12,8,3,17,17,56
400915316,Syracuse Orange,T. Lydon,3934662,,True,36.0,12,13,9,10,3,3,2,5,4,5,9,2,1,1,0,3,29
400915316,Syracuse Orange,D. Coleman,61821,,True,14.0,1,3,1,3,0,0,0,0,1,1,2,0,0,0,2,3,2
400915316,Syracuse Orange,A. White III,61616,,True,40.0,3,11,1,3,2,8,4,7,2,2,4,1,2,0,0,3,12
400915316,Syracuse Orange,F. Howard,3934659,,True,28.0,2,6,2,4,0,2,0,0,1,0,1,4,3,0,6,3,4
400915316,Syracuse Orange,J. Gillon,61915,,True,37.0,4,14,2,10,2,4,3,4,1,2,3,2,3,0,1,4,13
400915316,Syracuse Orange,T. Thompson,4065721,,False,27.0,2,8,2,6,0,2,5,7,1,3,4,1,1,2,3,4,9
400915316,Syracuse Orange,T. Roberson,67633,,False,6.0,0,0,0,0,0,0,0,2,0,1,1,0,0,0,0,0,0
400915316,Syracuse Orange,T. Battle,4065722,,False,12.0,1,2,1,1,0,1,0,0,0,2,2,0,0,0,1,3,2
400915316,Syracuse Orange,TEAM,TOTAL,TOTAL,False,,25,57,18,37,7,20,14,25,12,18,30,10,10,3,13,23,71
400915316,Georgetown Hoyas,A. Agau,66591,,True,8.0,2,2,2,2,0,0,2,2,0,1,1,0,0,0,1,2,6
400915316,Georgetown Hoyas,J. Govan,3934669,,True,23.0,4,10,4,10,0,0,4,5,2,8,10,1,0,1,1,3,12
400915316,Georgetown Hoyas,R. Pryor,3133971,,True,34.0,6,11,3,5,3,6,5,5,2,4,6,3,1,1,4,1,20
400915316,Georgetown Hoyas,J. Mosely,4065792,,True,6.0,1,1,1,1,0,0,0,0,0,0,0,0,0,0,0,1,2
400915316,Georgetown Hoyas,L.J. Peak,3149030,,True,38.0,7,12,5,9,2,3,7,9,4,7,11,4,0,1,5,4,23
400915316,Georgetown Hoyas,M. Derrickson,3934670,,False,20.0,1,6,1,5,0,1,2,2,2,1,3,2,0,2,2,3,4
400915316,Georgetown Hoyas,T. Mourning,3149034,,False,3.0,0,1,0,1,0,0,0,0,0,1,1,0,0,0,0,1,0
400915316,Georgetown Hoyas,R. Cameron II,67025,,False,12.0,1,2,1,1,0,1,0,0,0,1,1,1,0,0,3,0,2
400915316,Georgetown Hoyas,B. Hayes,61852,,False,15.0,2,3,2,3,0,0,0,0,1,3,4,0,0,0,1,4,4
400915316,Georgetown Hoyas,J. Mulmore,4065791,,False,23.0,1,2,0,1,1,1,2,2,0,0,0,3,2,0,0,1,5
400915316,Georgetown Hoyas,K. Johnson,3934671,,False,3.0,0,0,0,0,0,0,0,0,0,0,0,0,0,0,0,0,0
400915316,Georgetown Hoyas,T. Campbell,3149031,,False,15.0,0,3,0,1,0,2,0,0,0,2,2,2,3,0,1,0,0
400915316,Georgetown Hoyas,TEAM,TOTAL,TOTAL,False,,25,53,19,39,6,14,22,25,12,29,41,16,6,5,19,20,78
400915315,Xavier Musketeers,R. Gaston,62635,,True,28.0,6,9,6,9,0,0,2,3,0,4,4,1,0,2,0,0,14
400915315,Xavier Musketeers,E. Sumner,3136485,,True,38.0,6,8,6,6,0,2,5,6,0,4,4,2,1,1,6,2,17
400915315,Xavier Musketeers,J.P. Macura,3136483,,True,33.0,5,9,4,5,1,4,0,0,0,5,5,2,3,1,2,2,11
400915315,Xavier Musketeers,T. Bluiett,3136481,,True,34.0,6,14,3,7,3,7,5,8,1,6,7,1,0,1,3,3,20
400915315,Xavier Musketeers,M. Bernard,61236,,True,24.0,1,3,0,1,1,2,0,0,2,3,5,3,1,0,0,3,3
400915315,Xavier Musketeers,T. Jones,4065846,,False,11.0,1,3,1,3,0,0,0,0,0,3,3,0,0,0,0,2,2
400915315,Xavier Musketeers,K. Gates,3912339,,False,16.0,1,3,1,1,0,2,0,1,2,2,4,1,2,0,0,3,2
400915315,Xavier Musketeers,S. O'Mara,3136484,,False,4.0,0,2,0,2,0,0,0,0,0,1,1,0,0,0,2,1,0
400915315,Xavier Musketeers,Q. Goodin,4065847,,False,12.0,0,0,0,0,0,0,0,0,0,1,1,2,1,0,2,1,0
400915315,Xavier Musketeers,TEAM,TOTAL,TOTAL,False,,26,51,21,34,5,17,12,18,6,31,37,12,8,5,15,17,69
400915315,Wake Forest Demon Deacons,J. Collins,3908845,,True,26.0,6,19,6,18,0,1,0,0,4,8,12,0,1,2,1,3,12
400915315,Wake Forest Demon Deacons,D. Mitoglou,3138224,,True,28.0,1,7,1,4,0,3,2,3,1,3,4,2,0,0,1,0,4
400915315,Wake Forest Demon Deacons,A. Arians,61378,,True,26.0,2,6,1,1,1,5,0,0,0,0,0,3,0,0,0,1,5
400915315,Wake Forest Demon Deacons,B. Crawford,3908844,,True,32.0,6,14,3,6,3,8,5,5,2,1,3,6,3,1,4,1,20
400915315,Wake Forest Demon Deacons,K. Woods,3132360,,True,37.0,4,11,3,6,1,5,0,0,2,2,4,3,1,0,1,4,9
400915315,Wake Forest Demon Deacons,G. McClinton,66140,,False,1.0,0,0,0,0,0,0,0,0,0,0,0,0,0,0,0,0,0
400915315,Wake Forest Demon Deacons,S. Japhet-Mathias,4065752,,False,8.0,3,3,3,3,0,0,0,0,3,1,4,0,0,1,2,2,6
400915315,Wake Forest Demon Deacons,D. Moore,3908843,,False,6.0,1,2,1,2,0,0,0,0,0,2,2,0,1,0,0,3,2
400915315,Wake Forest Demon Deacons,B. Childress,4065750,,False,22.0,2,4,2,3,0,1,3,4,0,4,4,1,1,0,1,3,7
400915315,Wake Forest Demon Deacons,M. Wilbekin,3138222,,False,14.0,0,3,0,1,0,2,0,0,0,0,0,0,3,0,0,2,0
400915315,Wake Forest Demon Deacons,T. VanHorn,3078214,,False,0.0,0,0,0,0,0,0,0,0,0,0,0,0,0,0,0,1,0
400915315,Wake Forest Demon Deacons,TEAM,TOTAL,TOTAL,False,,25,69,20,44,5,25,10,12,15,23,38,15,10,4,10,20,65
400915314,Virginia Tech Hokies,K. Sy,4065740,,True,15.0,6,6,5,5,1,1,1,2,1,3,4,0,2,2,1,2,14
400915314,Virginia Tech Hokies,C. Clarke,3945567,,True,29.0,6,9,6,9,0,0,1,3,1,11,12,10,2,0,2,0,13
400915314,Virginia Tech Hokies,J. Robinson,3945566,,True,24.0,4,7,4,6,0,1,6,9,2,3,5,6,1,0,3,3,14
400915314,Virginia Tech Hokies,A. Hill,3147501,,True,33.0,8,12,4,6,4,6,2,2,0,8,8,4,0,0,2,1,22
400915314,Virginia Tech Hokies,J. Bibbs,3147500,,True,27.0,6,8,4,6,2,2,0,0,1,2,3,3,0,0,1,2,14
400915314,Virginia Tech Hokies,Z. LeDay,61698,,False,25.0,4,11,4,11,0,0,8,9,5,4,9,1,0,2,3,2,16
400915314,Virginia Tech Hokies,M. Galloway,3945565,,False,5.0,0,0,0,0,0,0,0,0,0,0,0,0,0,0,0,0,0
400915314,Virginia Tech Hokies,T. Outlaw,67275,,False,15.0,5,7,1,1,4,6,0,0,0,7,7,0,0,1,0,1,14
400915314,Virginia Tech Hokies,S. Allen,61795,,False,27.0,3,9,3,7,0,2,0,1,0,1,1,6,0,0,4,1,6
400915314,Virginia Tech Hokies,TEAM,TOTAL,TOTAL,False,,42,69,31,51,11,18,18,26,11,41,52,30,5,5,17,12,113
400915314,The Citadel Bulldogs,Z. Najdawi,3913211,,True,16.0,1,7,1,7,0,0,0,0,1,3,4,0,1,0,2,5,2
400915314,The Citadel Bulldogs,B. White,67233,,True,14.0,1,4,1,3,0,1,0,0,1,0,1,1,0,0,1,0,2
400915314,The Citadel Bulldogs,F. Johnson,4067282,,True,23.0,3,5,1,2,2,3,1,2,0,1,1,4,3,0,3,4,9
400915314,The Citadel Bulldogs,Q. Williams,3913203,,True,23.0,1,5,0,1,1,4,0,0,0,5,5,1,2,0,2,2,3
400915314,The Citadel Bulldogs,W. Sledge,67231,,True,34.0,5,12,3,5,2,7,0,0,0,3,3,2,2,0,1,2,12
400915314,The Citadel Bulldogs,E. Balogun,4067283,,False,6.0,1,2,0,1,1,1,0,0,0,2,2,0,1,1,0,2,3
400915314,The Citadel Bulldogs,B. Duncan,3913207,,False,2.0,0,0,0,0,0,0,0,0,0,0,0,0,0,0,0,0,0
400915314,The Citadel Bulldogs,T. Koopman,67232,,False,10.0,0,1,0,1,0,0,0,0,0,1,1,0,0,0,0,3,0
400915314,The Citadel Bulldogs,K. Harris,4067287,,False,24.0,6,12,6,9,0,3,3,6,2,1,3,1,1,2,2,1,15
400915314,The Citadel Bulldogs,L. Allende,4067284,,False,11.0,1,6,1,3,0,3,0,0,2,1,3,0,0,1,3,0,2
400915314,The Citadel Bulldogs,P. Parks,4067281,,False,24.0,8,16,5,7,3,9,1,2,0,2,2,1,2,0,3,2,20
400915314,The Citadel Bulldogs,M. Frierson,3913204,,False,13.0,1,6,0,0,1,6,0,0,0,0,0,1,0,0,1,1,3
400915314,The Citadel Bulldogs,TEAM,TOTAL,TOTAL,False,,28,76,18,39,10,37,5,10,9,19,28,11,12,4,18,22,71
400915313,Virginia Cavaliers,I. Wilkins,3138203,,True,21.0,3,4,3,4,0,0,1,2,1,5,6,6,1,1,2,1,7
400915313,Virginia Cavaliers,J. Salt,3138200,,True,17.0,5,6,5,6,0,0,0,0,1,1,2,0,1,0,1,1,10
400915313,Virginia Cavaliers,D. Thompson,66274,,True,25.0,2,6,2,3,0,3,0,0,0,3,3,2,0,0,1,1,4
400915313,Virginia Cavaliers,L. Perrantes,66139,,True,25.0,1,3,1,2,0,1,2,2,0,2,2,4,0,0,0,0,4
400915313,Virginia Cavaliers,D. Hall,66138,,True,18.0,4,7,3,5,1,2,4,4,1,4,5,0,0,0,0,2,13
400915313,Virginia Cavaliers,M. Diakite,3947156,,False,15.0,3,4,3,4,0,0,0,0,1,3,4,0,2,2,1,5,6
400915313,Virginia Cavaliers,J. Reuter,3908374,,False,18.0,5,6,5,6,0,0,0,0,3,2,5,1,0,0,0,1,10
400915313,Virginia Cavaliers,J. Jones,67567,,False,3.0,0,0,0,0,0,0,0,0,0,0,0,0,0,0,1,1,0
400915313,Virginia Cavaliers,T. Jerome,4065733,,False,16.0,2,2,1,1,1,1,0,0,0,4,4,6,1,2,3,1,5
400915313,Virginia Cavaliers,K. Guy,4065730,,False,20.0,4,7,1,2,3,5,2,2,0,3,3,0,0,0,0,3,13
400915313,Virginia Cavaliers,T. Gross Jr.,4065729,,False,3.0,0,0,0,0,0,0,0,0,0,0,0,0,0,0,0,2,0
400915313,Virginia Cavaliers,J. Bartley,3947155,,False,3.0,1,1,1,1,0,0,0,2,0,0,0,0,0,0,0,0,2
400915313,Virginia Cavaliers,M. Shayok,3138201,,False,16.0,1,6,0,4,1,2,2,2,0,3,3,2,2,2,2,1,5
400915313,Virginia Cavaliers,TEAM,TOTAL,TOTAL,False,,31,52,25,38,6,14,11,14,7,32,39,21,7,7,11,19,79
400915313,Robert Morris Colonials,R. Mantovani,4067927,,True,18.0,0,1,0,1,0,0,1,2,1,5,6,1,0,0,0,1,1
400915313,Robert Morris Colonials,A. Tate,66956,,True,23.0,1,3,1,3,0,0,0,0,0,1,1,0,0,0,3,2,2
400915313,Robert Morris Colonials,M. McConnell,3938915,,True,20.0,1,7,1,3,0,4,0,0,0,3,3,1,0,0,0,1,2
400915313,Robert Morris Colonials,I. Still,3938908,,True,29.0,5,10,3,6,2,4,4,8,0,2,2,0,1,0,1,1,16
400915313,Robert Morris Colonials,K. Stewart,66953,,True,28.0,1,8,0,6,1,2,1,2,0,0,0,5,5,0,2,2,4
400915313,Robert Morris Colonials,S. Rouse,3951250,,False,2.0,0,0,0,0,0,0,0,0,0,0,0,0,0,0,0,1,0
400915313,Robert Morris Colonials,B. Giles,3938914,,False,15.0,0,3,0,3,0,0,0,0,2,1,3,0,0,1,0,0,0
400915313,Robert Morris Colonials,C. Stephens,3162359,,False,3.0,0,0,0,0,0,0,0,0,0,0,0,0,0,0,1,0,0
400915313,Robert Morris Colonials,B. Burke,4067925,,False,22.0,0,2,0,2,0,0,3,6,1,3,4,0,0,0,1,0,3
400915313,Robert Morris Colonials,L. Wright Jr.,4067928,,False,5.0,0,1,0,0,0,1,0,0,0,0,0,0,0,0,0,1,0
400915313,Robert Morris Colonials,D. Burke Jr.,4067926,,False,17.0,3,6,2,4,1,2,0,0,1,0,1,0,1,0,2,5,7
400915313,Robert Morris Colonials,C. Allen,4067924,,False,18.0,0,5,0,3,0,2,4,5,0,0,0,0,0,0,3,2,4
400915313,Robert Morris Colonials,TEAM,TOTAL,TOTAL,False,,11,46,7,31,4,15,13,23,6,15,21,7,7,1,13,16,39
400915312,Rice Owls,C. Douglas Jr.,4067052,,True,14.0,1,1,1,1,0,0,0,1,2,2,4,1,1,1,1,4,2
400915312,Rice Owls,E. Koulechov,66324,,True,32.0,6,13,5,9,1,4,0,0,0,4,4,4,0,0,2,3,13
400915312,Rice Owls,M. Evans,3920203,,True,36.0,5,12,4,7,1,5,8,14,0,1,1,4,2,0,2,2,19
400915312,Rice Owls,C. Cashaw,3920202,,True,26.0,2,8,1,3,1,5,0,0,0,0,0,2,1,0,1,0,5
400915312,Rice Owls,M. Jackson,66759,,True,32.0,8,14,5,6,3,8,1,1,2,3,5,3,2,0,0,0,20
400915312,Rice Owls,A. Meyer,4067054,,False,3.0,0,1,0,1,0,0,0,0,0,0,0,0,0,0,0,0,0
400915312,Rice Owls,R. Martin,4067053,,False,11.0,1,3,0,1,1,2,0,1,2,0,2,0,0,0,0,2,3
400915312,Rice Owls,M. Letcher-Ellis,3920204,,False,17.0,2,2,1,1,1,1,2,2,1,2,3,0,1,1,1,4,7
400915312,Rice Owls,A. Drone,66757,,False,3.0,0,0,0,0,0,0,0,0,0,1,1,0,0,0,0,0,0
400915312,Rice Owls,A. Adams,4067051,,False,4.0,0,1,0,0,0,1,0,0,0,0,0,0,0,0,0,1,0
400915312,Rice Owls,C. Lott,3920205,,False,22.0,1,2,1,2,0,0,2,4,2,0,2,1,1,0,0,2,4
400915312,Rice Owls,TEAM,TOTAL,TOTAL,False,,26,57,18,31,8,26,13,23,9,13,22,15,8,2,7,18,73
400915312,Pittsburgh Panthers,M. Young,66290,,True,25.0,4,8,4,7,0,1,4,4,1,3,4,4,1,1,5,3,12
400915312,Pittsburgh Panthers,S. Jeter,61756,,True,23.0,1,2,1,1,0,1,0,0,2,3,5,1,1,2,0,2,2
400915312,Pittsburgh Panthers,J. Artis,66287,,True,39.0,10,14,6,7,4,7,7,9,0,5,5,3,1,0,2,3,31
400915312,Pittsburgh Panthers,C. Johnson,3138196,,True,38.0,4,8,2,3,2,5,0,0,0,5,5,3,0,0,1,3,10
400915312,Pittsburgh Panthers,C. Jones,61219,,True,24.0,0,0,0,0,0,0,3,4,0,3,3,1,0,1,5,4,3
400915312,Pittsburgh Panthers,R. Luther,3138197,,False,31.0,8,8,6,6,2,2,2,2,1,6,7,4,0,0,3,4,20
400915312,Pittsburgh Panthers,J. Kithcart,4065713,,False,12.0,1,2,1,2,0,0,0,0,0,2,2,1,0,0,2,2,2
400915312,Pittsburgh Panthers,J. Milligan,3934655,,False,7.0,1,2,0,0,1,2,0,0,0,0,0,1,0,0,0,0,3
400915312,Pittsburgh Panthers,D. Wilson,3934652,,False,1.0,0,1,0,1,0,0,0,0,0,0,0,0,0,0,0,0,0
400915312,Pittsburgh Panthers,TEAM,TOTAL,TOTAL,False,,29,45,20,27,9,18,16,19,4,28,32,18,3,4,18,21,83
400915311,Manhattan Jaspers,Z. Peart,4067311,,True,15.0,0,1,0,1,0,0,0,2,0,0,0,0,0,0,0,4,0
400915311,Manhattan Jaspers,Z. Waterman,3138469,,True,25.0,5,8,3,4,2,4,0,1,3,1,4,0,0,0,2,3,12
400915311,Manhattan Jaspers,T. Capuano,3948706,,True,36.0,3,9,2,3,1,6,2,2,0,0,0,0,3,0,2,2,9
400915311,Manhattan Jaspers,S. Usilo,3138468,,True,9.0,0,3,0,3,0,0,0,0,1,0,1,0,1,0,0,4,0
400915311,Manhattan Jaspers,Z. Turner,67032,,True,30.0,4,10,2,6,2,4,8,8,0,2,2,5,0,0,4,3,18
400915311,Manhattan Jaspers,O. Ehrnvall,4067313,,False,8.0,0,0,0,0,0,0,0,0,0,0,0,0,0,0,0,2,0
400915311,Manhattan Jaspers,C. Crawford,3138470,,False,8.0,1,2,0,1,1,1,0,0,0,0,0,0,0,0,1,4,3
400915311,Manhattan Jaspers,A. Ismail,4067312,,False,25.0,1,1,1,1,0,0,0,2,3,6,9,0,0,0,1,4,2
400915311,Manhattan Jaspers,A. Walker Jr.,4067310,,False,23.0,4,10,3,6,1,4,5,8,2,1,3,4,2,0,3,3,14
400915311,Manhattan Jaspers,N. Council,4067309,,False,17.0,3,8,1,3,2,5,1,1,0,2,2,1,1,0,1,1,9
400915311,Manhattan Jaspers,T. Wilson,67359,,False,4.0,0,0,0,0,0,0,0,0,0,0,0,0,0,0,2,1,0
400915311,Manhattan Jaspers,TEAM,TOTAL,TOTAL,False,,21,52,12,28,9,24,16,24,10,13,23,10,7,0,18,31,67
400915311,Florida State Seminoles,J. Isaac,4065654,,True,26.0,2,3,2,2,0,1,5,5,2,7,9,0,4,2,4,4,9
400915311,Florida State Seminoles,M. Ojo,61596,,True,9.0,3,3,3,3,0,0,1,2,1,0,1,0,0,1,1,2,7
400915311,Florida State Seminoles,D. Bacon,3907821,,True,26.0,4,11,4,11,0,0,8,11,4,0,4,1,1,0,3,3,16
400915311,Florida State Seminoles,T. Mann,3907823,,True,26.0,4,5,4,5,0,0,1,2,1,4,5,3,1,0,2,2,9
400915311,Florida State Seminoles,X. Rathan-Mayes,66125,,True,31.0,3,6,2,4,1,2,3,6,0,4,4,5,0,0,3,3,10
400915311,Florida State Seminoles,P. Cofer,3135054,,False,16.0,2,3,2,3,0,0,5,6,1,0,1,0,0,0,0,1,9
400915311,Florida State Seminoles,J. Smith,66126,,False,10.0,0,1,0,1,0,0,0,0,0,2,2,0,1,2,1,1,0
400915311,Florida State Seminoles,C. Koumadje,3907824,,False,8.0,1,2,1,2,0,0,0,0,0,3,3,0,0,0,1,2,2
400915311,Florida State Seminoles,B. Angola-Rodas,4065658,,False,13.0,3,5,3,5,0,0,0,0,1,1,2,2,1,0,1,2,6
400915311,Florida State Seminoles,P. Savoy,4065657,,False,13.0,1,4,0,1,1,3,2,4,0,1,1,0,0,0,0,3,5
400915311,Florida State Seminoles,T. Forrest,4065656,,False,22.0,4,5,4,5,0,0,2,4,1,2,3,3,3,1,0,2,10
400915311,Florida State Seminoles,TEAM,TOTAL,TOTAL,False,,27,48,25,42,2,6,27,40,12,25,37,14,11,6,16,25,83
400915310,Miami Hurricanes,D. Hernandez,4065672,,True,24.0,4,10,4,10,0,0,1,2,4,6,10,0,1,1,0,2,9
400915310,Miami Hurricanes,K. Murphy,61668,,True,23.0,3,6,3,6,0,0,1,5,3,7,10,1,0,0,1,3,7
400915310,Miami Hurricanes,B. Brown,4065670,,True,38.0,4,11,4,8,0,3,6,8,2,6,8,6,2,0,2,2,14
400915310,Miami Hurricanes,J. Newton,3138145,,True,23.0,3,9,3,8,0,1,2,2,0,6,6,6,1,0,1,2,8
400915310,Miami Hurricanes,D. Reed,66130,,True,34.0,6,10,1,1,5,9,4,4,0,0,0,0,1,2,2,0,21
400915310,Miami Hurricanes,R. Miller Jr.,4065671,,False,3.0,0,0,0,0,0,0,0,0,0,0,0,0,0,0,0,0,0
400915310,Miami Hurricanes,E. Izundu,3904629,,False,6.0,0,0,0,0,0,0,2,2,1,1,2,0,1,0,3,4,2
400915310,Miami Hurricanes,A. Lawrence II,3904628,,False,23.0,4,5,1,2,3,3,2,4,3,3,6,0,1,0,1,3,13
400915310,Miami Hurricanes,D. Vasiljevic,4065669,,False,26.0,1,4,1,1,0,3,0,0,1,1,2,0,0,0,1,2,2
400915310,Miami Hurricanes,TEAM,TOTAL,TOTAL,False,,25,55,17,36,8,19,18,27,16,32,48,13,7,3,12,18,76
400915310,Florida Atlantic Owls,J. Ingram,4066981,,True,16.0,2,6,2,5,0,1,0,1,0,0,0,0,1,0,0,4,4
400915310,Florida Atlantic Owls,J. Cylla,3946975,,True,24.0,0,4,0,3,0,1,3,4,0,3,3,0,0,0,2,1,3
400915310,Florida Atlantic Owls,R. Delph,66245,,True,28.0,4,9,4,9,0,0,1,1,1,6,7,0,0,1,0,2,9
400915310,Florida Atlantic Owls,N. Rutherford,3946977,,True,26.0,0,4,0,3,0,1,3,4,1,2,3,4,0,2,2,1,3
400915310,Florida Atlantic Owls,F. Booker,66300,,True,19.0,2,7,1,3,1,4,2,2,0,1,1,0,0,0,0,3,7
400915310,Florida Atlantic Owls,W. Pfister,4066979,,False,18.0,1,2,1,2,0,0,0,0,2,0,2,0,1,0,0,4,2
400915310,Florida Atlantic Owls,J. Hill,3946978,,False,3.0,0,0,0,0,0,0,0,0,0,0,0,0,0,0,0,0,0
400915310,Florida Atlantic Owls,M. Neely,61259,,False,21.0,5,7,5,6,0,1,2,2,2,4,6,1,1,0,2,2,12
400915310,Florida Atlantic Owls,G. Troutman,3155583,,False,13.0,2,7,1,3,1,4,0,0,0,1,1,1,0,0,0,1,5
400915310,Florida Atlantic Owls,J. Massey,3151395,,False,12.0,0,2,0,1,0,1,0,0,0,1,1,1,1,0,1,0,0
400915310,Florida Atlantic Owls,A. Filer,61836,,False,23.0,3,9,2,5,1,4,4,4,0,0,0,0,0,0,2,1,11
400915310,Florida Atlantic Owls,TEAM,TOTAL,TOTAL,False,,19,57,16,40,3,17,15,18,9,20,29,7,4,3,9,19,56
400915309,NC State Wolfpack,A. Abu,3138158,,True,18.0,5,10,5,10,0,0,1,1,0,3,3,2,0,1,0,4,11
400915309,NC State Wolfpack,B. Anya,66134,,True,16.0,0,1,0,1,0,0,0,0,0,6,6,1,0,1,1,1,0
400915309,NC State Wolfpack,D. Smith Jr.,4065697,,True,27.0,5,8,4,6,1,2,11,12,0,2,2,6,3,0,4,1,22
400915309,NC State Wolfpack,T. Dorn,3132359,,True,25.0,2,5,1,4,1,1,2,4,1,9,10,1,0,1,1,2,7
400915309,NC State Wolfpack,T. Henderson,61215,,True,24.0,2,6,1,4,1,2,6,7,0,3,3,2,0,2,1,0,11
400915309,NC State Wolfpack,T. Kapita,4065701,,False,16.0,3,5,3,5,0,0,4,6,0,5,5,1,0,0,0,2,10
400915309,NC State Wolfpack,D. Hicks,4065698,,False,5.0,0,0,0,0,0,0,2,2,0,1,1,1,0,0,0,1,2
400915309,NC State Wolfpack,T. Thompson,3151470,,False,1.0,1,1,1,1,0,0,0,0,0,0,0,0,0,0,0,0,2
400915309,NC State Wolfpack,C. Brickhouse,67562,,False,1.0,0,0,0,0,0,0,0,0,0,2,2,0,0,0,1,0,0
400915309,NC State Wolfpack,O. Yurtseven,66768,,False,24.0,4,6,3,5,1,1,3,4,0,4,4,0,0,0,4,4,12
400915309,NC State Wolfpack,M. Johnson,4065699,,False,13.0,1,3,1,2,0,1,0,0,0,0,0,3,0,0,0,1,2
400915309,NC State Wolfpack,M. Rowan,3947151,,False,23.0,4,8,3,6,1,2,4,4,2,0,2,1,0,0,1,3,13
400915309,NC State Wolfpack,S. Kirk,3947150,,False,6.0,2,3,2,2,0,1,1,1,0,1,1,0,0,0,0,1,5
400915309,NC State Wolfpack,C. Corchiani Jr.,3138159,,False,1.0,0,0,0,0,0,0,0,0,0,0,0,1,0,0,0,0,0
400915309,NC State Wolfpack,TEAM,TOTAL,TOTAL,False,,29,56,24,46,5,10,34,41,4,41,45,19,3,5,13,20,97
400915309,App State Mountaineers,T. Johnson,3949203,,True,12.0,3,7,3,4,0,3,0,0,1,5,6,0,0,0,1,3,6
400915309,App State Mountaineers,G. Kinney,3141196,,True,21.0,3,9,3,9,0,0,1,2,0,3,3,1,0,1,1,2,7
400915309,App State Mountaineers,K. Robinson,4067771,,True,11.0,1,6,1,4,0,2,3,4,0,1,1,0,0,0,1,3,5
400915309,App State Mountaineers,R. Shabazz,3949207,,True,29.0,6,19,5,10,1,9,1,2,0,1,1,1,0,0,2,1,14
400915309,App State Mountaineers,E. Logan,3949205,,True,14.0,1,7,1,5,0,2,0,0,0,1,1,4,2,0,2,3,2
400915309,App State Mountaineers,I. Johnson,4067770,,False,19.0,3,5,3,4,0,1,3,4,4,2,6,0,0,0,1,4,9
400915309,App State Mountaineers,Z. Cottrell,4067768,,False,7.0,0,3,0,1,0,2,0,0,0,0,0,0,1,0,0,0,0
400915309,App State Mountaineers,C. Hinton,66640,,False,12.0,1,2,0,0,1,2,0,0,0,3,3,1,0,0,0,2,3
400915309,App State Mountaineers,J. Wilson,3949209,,False,18.0,1,3,1,3,0,0,1,3,2,1,3,0,0,0,1,4,3
400915309,App State Mountaineers,P. Good,4067769,,False,22.0,0,7,0,2,0,5,0,0,0,2,2,3,1,0,1,1,0
400915309,App State Mountaineers,M. O'Boyle,3949206,,False,12.0,2,3,1,2,1,1,0,0,1,3,4,0,0,0,0,2,5
400915309,App State Mountaineers,J. Babic,3141192,,False,23.0,3,5,2,3,1,2,3,4,1,1,2,1,2,0,1,1,10
400915309,App State Mountaineers,TEAM,TOTAL,TOTAL,False,,24,76,20,47,4,29,12,19,14,27,41,11,6,1,11,26,64
400915307,UNLV Rebels,D. Morgan,3137731,,True,25.0,2,7,2,7,0,0,1,1,2,3,5,0,1,0,3,3,5
400915307,UNLV Rebels,T. Green,3936098,,True,25.0,2,8,2,5,0,3,1,2,0,2,2,1,0,0,0,2,5
400915307,UNLV Rebels,K. Clyburn,4066779,,True,23.0,1,4,1,3,0,1,0,0,0,1,1,0,0,0,4,2,2
400915307,UNLV Rebels,J. Poyser,3936100,,True,31.0,5,14,1,6,4,8,2,3,0,1,1,3,1,0,5,1,16
400915307,UNLV Rebels,U. Ofoegbu,61848,,True,21.0,3,8,3,8,0,0,1,2,1,3,4,0,2,0,2,2,7
400915307,UNLV Rebels,D. Sljivancanin,4066784,,False,0.0,0,0,0,0,0,0,0,0,0,0,0,0,0,0,0,0,0
400915307,UNLV Rebels,C. Dembele,4066781,,False,9.0,0,1,0,1,0,0,0,2,2,1,3,0,1,1,3,1,0
400915307,UNLV Rebels,T. Baxter Jr.,4066777,,False,18.0,0,2,0,1,0,1,1,2,1,1,2,0,2,0,0,2,1
400915307,UNLV Rebels,C. Jones,61813,,False,17.0,0,4,0,4,0,0,0,0,2,3,5,2,0,0,1,1,0
400915307,UNLV Rebels,B. Coupet Jr.,4066780,,False,4.0,0,1,0,0,0,1,0,0,0,2,2,0,0,0,0,0,0
400915307,UNLV Rebels,J. Mooring,4066782,,False,15.0,2,3,1,1,1,2,0,0,0,0,0,0,0,0,3,0,5
400915307,UNLV Rebels,L. Bush,4066778,,False,12.0,1,2,0,0,1,2,1,2,0,0,0,0,0,0,0,2,4
400915307,UNLV Rebels,J. Ballou,4066776,,False,0.0,0,0,0,0,0,0,0,0,0,0,0,0,0,0,0,0,0
400915307,UNLV Rebels,TEAM,TOTAL,TOTAL,False,,16,54,10,36,6,18,7,14,10,19,29,6,7,1,21,16,45
400915307,Duke Blue Devils,A. Jefferson,61586,,True,30.0,4,6,4,6,0,0,2,4,2,10,12,5,1,0,2,0,10
400915307,Duke Blue Devils,C. Jeter,3913173,,True,15.0,1,2,1,2,0,0,0,1,0,3,3,0,0,2,0,2,2
400915307,Duke Blue Devils,L. Kennard,3913174,,True,34.0,6,12,4,7,2,5,2,2,1,4,5,4,3,0,0,0,16
400915307,Duke Blue Devils,G. Allen,3135045,,True,29.0,12,16,6,7,6,9,4,5,2,2,4,1,0,0,2,2,34
400915307,Duke Blue Devils,M. Jones,66563,,True,23.0,1,5,1,1,0,4,0,0,1,2,3,3,2,0,0,4,2
400915307,Duke Blue Devils,J. White,4065653,,False,4.0,0,0,0,0,0,0,0,0,0,1,1,0,1,0,1,0,0
400915307,Duke Blue Devils,J. DeLaurier,4065650,,False,8.0,1,1,1,1,0,0,0,0,0,2,2,0,0,0,0,2,2
400915307,Duke Blue Devils,J. Tatum,4065648,,False,24.0,5,11,4,8,1,3,2,2,0,5,5,3,2,2,1,2,13
400915307,Duke Blue Devils,M. Bolden,4065652,,False,13.0,3,5,3,5,0,0,0,0,0,1,1,0,0,0,3,2,6
400915307,Duke Blue Devils,F. Jackson,4065651,,False,20.0,4,5,3,4,1,1,0,0,1,0,1,2,1,0,2,0,9
400915307,Duke Blue Devils,TEAM,TOTAL,TOTAL,False,,37,63,27,41,10,22,10,14,9,31,40,18,10,4,11,14,94
400915306,Texas Southern Tigers,D. Griffin,3955137,,True,39.0,7,11,7,11,0,0,1,6,15,11,26,1,1,1,3,4,15
400915306,Texas Southern Tigers,M. Jones,3136940,,True,21.0,1,4,1,3,0,1,1,2,4,2,6,0,0,1,1,5,3
400915306,Texas Southern Tigers,D. Jefferson,4070739,,True,40.0,10,30,7,20,3,10,4,6,2,1,3,4,0,0,11,2,27
400915306,Texas Southern Tigers,D. Robinson,3135131,,True,35.0,6,14,2,7,4,7,0,0,0,3,3,3,1,0,1,3,16
400915306,Texas Southern Tigers,Z. Lofton,66430,,True,25.0,1,7,1,3,0,4,0,1,2,1,3,1,1,0,1,3,2
400915306,Texas Southern Tigers,J. Rutherford,4070743,,False,8.0,0,1,0,1,0,0,0,0,1,0,1,1,0,0,0,0,0
400915306,Texas Southern Tigers,L. Walker,4070741,,False,3.0,0,0,0,0,0,0,0,0,0,1,1,0,0,0,0,3,0
400915306,Texas Southern Tigers,K. Scott,4070740,,False,17.0,1,6,0,3,1,3,0,0,3,0,3,2,0,0,2,3,3
400915306,Texas Southern Tigers,J. McCloud,4070738,,False,12.0,0,1,0,0,0,1,5,5,0,0,0,0,1,0,0,1,5
400915306,Texas Southern Tigers,TEAM,TOTAL,TOTAL,False,,26,74,18,48,8,26,11,20,30,19,49,12,4,2,19,24,71
400915306,Louisville Cardinals,M. Mathiang,63035,,True,22.0,3,4,3,4,0,0,4,5,4,4,8,1,0,1,1,2,10
400915306,Louisville Cardinals,D. Adel,3908807,,True,33.0,4,10,2,5,2,5,1,2,2,4,6,1,0,3,2,1,11
400915306,Louisville Cardinals,J. Johnson,3147362,,True,23.0,5,8,5,8,0,0,1,2,6,2,8,0,1,2,2,2,11
400915306,Louisville Cardinals,D. Mitchell,3908809,,True,27.0,4,14,2,5,2,9,2,2,3,2,5,3,4,0,0,2,12
400915306,Louisville Cardinals,Q. Snider,3147360,,True,25.0,5,13,3,8,2,5,3,4,1,5,6,4,0,0,1,0,15
400915306,Louisville Cardinals,V.J. King,4065666,,False,18.0,5,8,4,7,1,1,2,2,3,0,3,1,1,0,0,1,13
400915306,Louisville Cardinals,R. Spalding,3908806,,False,6.0,0,0,0,0,0,0,2,2,0,0,0,0,0,0,1,5,2
400915306,Louisville Cardinals,M. Stockman,3147361,,False,9.0,2,5,2,5,0,0,3,4,4,1,5,1,1,0,1,2,7
400915306,Louisville Cardinals,T. Sharpe,4065667,,False,1.0,0,1,0,0,0,1,0,0,1,0,1,0,0,0,0,0,0
400915306,Louisville Cardinals,R. McMahon,3908808,,False,10.0,2,6,0,1,2,5,2,2,0,1,1,0,0,0,0,2,8
400915306,Louisville Cardinals,J. Henderson,3155491,,False,3.0,1,1,1,1,0,0,0,0,0,0,0,0,1,0,0,0,2
400915306,Louisville Cardinals,D. Levitch,66592,,False,13.0,1,3,0,1,1,2,1,3,2,1,3,1,1,0,0,0,4
400915306,Louisville Cardinals,T. Hicks,62752,,False,10.0,2,5,1,2,1,3,2,2,1,3,4,2,1,0,1,0,7
400915306,Louisville Cardinals,TEAM,TOTAL,TOTAL,False,,34,78,23,47,11,31,23,30,28,23,51,14,10,6,9,17,102
400915305,Villanova Wildcats,D. Reynolds,66174,,True,25.0,2,3,2,3,0,0,2,3,2,1,3,0,1,2,0,1,6
400915305,Villanova Wildcats,K. Jenkins,66172,,True,36.0,2,9,1,4,1,5,2,3,0,3,3,2,0,1,3,2,7
400915305,Villanova Wildcats,J. Brunson,3934672,,True,25.0,3,8,3,6,0,2,2,2,2,1,3,3,0,0,2,2,8
400915305,Villanova Wildcats,M. Bridges,3147657,,True,38.0,4,8,4,7,0,1,0,0,4,2,6,1,2,0,0,0,8
400915305,Villanova Wildcats,J. Hart,66173,,True,37.0,10,14,7,10,3,4,14,14,1,10,11,4,2,0,1,2,37
400915305,Villanova Wildcats,E. Paschall,3133817,,False,20.0,4,4,4,4,0,0,0,0,0,3,3,0,0,1,1,2,8
400915305,Villanova Wildcats,D. DiVincenzo,3934673,,False,19.0,0,4,0,0,0,4,0,0,1,3,4,0,0,0,2,1,0
400915305,Villanova Wildcats,TEAM,TOTAL,TOTAL,False,,25,50,21,34,4,16,20,22,10,23,33,10,5,4,10,10,74
400915305,Notre Dame Fighting Irish,M. Geben,3138191,,True,16.0,2,3,2,3,0,0,1,1,2,1,3,1,1,0,1,3,5
400915305,Notre Dame Fighting Irish,B. Colson,3138192,,True,35.0,5,12,5,9,0,3,1,1,2,6,8,3,2,0,2,2,11
400915305,Notre Dame Fighting Irish,V.J. Beachem,66283,,True,37.0,2,11,2,6,0,5,0,0,0,5,5,1,0,1,1,1,4
400915305,Notre Dame Fighting Irish,M. Farrell,3138190,,True,36.0,8,13,6,8,2,5,0,0,0,2,2,6,2,0,2,4,18
400915305,Notre Dame Fighting Irish,S. Vasturia,66285,,True,37.0,7,15,5,9,2,6,2,2,0,0,0,3,2,0,2,2,18
400915305,Notre Dame Fighting Irish,A. Torres,66286,,False,2.0,0,0,0,0,0,0,0,0,0,0,0,0,0,0,0,0,0
400915305,Notre Dame Fighting Irish,M. Ryan,3908336,,False,8.0,0,0,0,0,0,0,0,0,1,0,1,0,0,0,1,2,0
400915305,Notre Dame Fighting Irish,T. Gibbs,4065703,,False,10.0,1,2,0,0,1,2,2,2,0,0,0,1,0,0,0,1,5
400915305,Notre Dame Fighting Irish,R. Pflueger,3908335,,False,19.0,2,2,1,1,1,1,0,0,1,2,3,1,0,0,0,2,5
400915305,Notre Dame Fighting Irish,TEAM,TOTAL,TOTAL,False,,27,58,21,36,6,22,6,6,8,17,25,16,7,1,9,17,66
400915304,Syracuse Orange,T. Lydon,3934662,,True,26.0,4,9,4,6,0,3,2,3,0,6,6,2,2,1,0,2,10
400915304,Syracuse Orange,D. Coleman,61821,,True,9.0,0,2,0,2,0,0,2,2,1,3,4,0,0,1,1,0,2
400915304,Syracuse Orange,A. White III,61616,,True,31.0,5,11,0,2,5,9,4,4,0,2,2,2,4,0,1,3,19
400915304,Syracuse Orange,T. Battle,4065722,,True,28.0,2,8,0,1,2,7,1,2,0,1,1,3,2,0,1,0,7
400915304,Syracuse Orange,F. Howard,3934659,,True,26.0,0,5,0,3,0,2,6,8,0,2,2,11,3,0,2,2,6
400915304,Syracuse Orange,T. Thompson,4065721,,False,19.0,10,13,9,11,1,2,1,2,4,3,7,0,0,2,1,0,22
400915304,Syracuse Orange,D. Akintobi-Adeyeye,3155403,,False,1.0,0,0,0,0,0,0,0,0,0,1,1,0,0,0,0,0,0
400915304,Syracuse Orange,T. Roberson,67633,,False,18.0,2,2,2,2,0,0,0,1,0,3,3,1,0,1,2,1,4
400915304,Syracuse Orange,P. Chukwu,3136471,,False,10.0,2,2,2,2,0,0,0,2,1,2,3,0,0,3,1,2,4
400915304,Syracuse Orange,K. Feldman,3934665,,False,1.0,0,1,0,0,0,1,0,0,0,0,0,1,0,0,0,0,0
400915304,Syracuse Orange,A. Autry,3934661,,False,1.0,0,1,0,0,0,1,0,0,0,0,0,0,0,0,0,0,0
400915304,Syracuse Orange,S. Belbey,3934660,,False,1.0,1,1,1,1,0,0,0,0,0,0,0,0,0,0,0,0,2
400915304,Syracuse Orange,M. Sutton,3153164,,False,1.0,0,0,0,0,0,0,0,0,0,0,0,0,0,0,0,0,0
400915304,Syracuse Orange,J. Gillon,61915,,False,28.0,7,9,1,2,6,7,3,4,1,4,5,4,2,0,0,0,23
400915304,Syracuse Orange,TEAM,TOTAL,TOTAL,False,,33,64,19,32,14,32,19,28,9,29,38,24,13,8,9,10,99
400915304,Boston University Terriers,J. Alston,61167,,True,19.0,4,7,4,7,0,0,0,0,5,0,5,0,0,0,2,4,8
400915304,Boston University Terriers,T. Scanlon,4067099,,True,19.0,2,8,1,3,1,5,0,0,2,1,3,2,0,0,2,2,5
400915304,Boston University Terriers,E. Fanning,61534,,True,26.0,3,9,2,6,1,3,5,6,2,7,9,2,2,0,3,2,12
400915304,Boston University Terriers,K. Foreman,3936305,,True,19.0,0,2,0,1,0,1,0,0,0,1,1,6,0,0,3,2,0
400915304,Boston University Terriers,C. Hankerson,67094,,True,34.0,10,20,0,0,10,20,4,6,0,4,4,0,0,0,0,4,34
400915304,Boston University Terriers,N. Havener,3130551,,False,21.0,0,2,0,2,0,0,1,2,1,0,1,3,0,0,1,1,1
400915304,Boston University Terriers,D. Haines,67093,,False,21.0,2,4,2,4,0,0,1,2,3,2,5,0,0,0,1,2,5
400915304,Boston University Terriers,D. Barnes,4067100,,False,13.0,0,5,0,2,0,3,0,0,0,3,3,1,2,0,2,1,0
400915304,Boston University Terriers,W. Goff,3155899,,False,3.0,1,1,0,0,1,1,0,0,1,0,1,0,0,0,0,0,3
400915304,Boston University Terriers,C. Mosely,3130550,,False,19.0,3,9,0,1,3,8,0,0,0,3,3,4,0,0,3,2,9
400915304,Boston University Terriers,E. Johnson,3130549,,False,6.0,0,2,0,2,0,0,0,0,0,2,2,2,0,0,0,1,0
400915304,Boston University Terriers,TEAM,TOTAL,TOTAL,False,,25,69,9,28,16,41,11,16,17,25,42,20,4,0,18,21,77
400915303,Tennessee State Tigers,K. Hamilton,4067261,,True,23.0,4,7,3,4,1,3,0,0,0,4,4,0,0,1,2,3,9
400915303,Tennessee State Tigers,W. Martin,66964,,True,29.0,7,15,7,15,0,0,2,2,6,3,9,0,1,2,2,5,16
400915303,Tennessee State Tigers,D. Reddick,3138575,,True,40.0,3,8,1,2,2,6,0,0,0,4,4,0,0,1,4,2,8
400915303,Tennessee State Tigers,J. Reed,61859,,True,37.0,1,9,1,8,0,1,0,3,6,4,10,2,0,1,2,3,2
400915303,Tennessee State Tigers,T. McCall,61417,,True,36.0,3,14,3,11,0,3,4,6,4,2,6,4,4,0,3,4,10
400915303,Tennessee State Tigers,C. Mekowulu,3138574,,False,30.0,1,6,1,6,0,0,3,4,3,6,9,2,1,0,4,2,5
400915303,Tennessee State Tigers,A. Everett,4067263,,False,4.0,0,0,0,0,0,0,0,0,0,2,2,0,0,0,0,0,0
400915303,Tennessee State Tigers,D. Spencer,4067260,,False,22.0,2,5,1,1,1,4,0,0,1,0,1,1,0,0,0,3,5
400915303,Tennessee State Tigers,A. Chaney,3923237,,False,4.0,0,1,0,1,0,0,0,0,0,0,0,0,0,0,1,1,0
400915303,Tennessee State Tigers,TEAM,TOTAL,TOTAL,False,,21,65,17,48,4,17,9,15,22,26,48,9,6,5,18,23,55
400915303,NC State Wolfpack,T. Kapita,4065701,,True,11.0,0,2,0,2,0,0,0,0,0,2,2,1,0,0,3,2,0
400915303,NC State Wolfpack,A. Abu,3138158,,True,20.0,1,3,1,3,0,0,1,2,2,1,3,0,0,1,2,4,3
400915303,NC State Wolfpack,D. Smith Jr.,4065697,,True,42.0,7,19,6,15,1,4,4,9,1,3,4,6,4,1,3,2,19
400915303,NC State Wolfpack,T. Dorn,3132359,,True,40.0,4,12,4,9,0,3,0,0,1,7,8,1,1,0,1,2,8
400915303,NC State Wolfpack,T. Henderson,61215,,True,40.0,5,10,2,5,3,5,8,9,3,2,5,0,1,0,1,3,21
400915303,NC State Wolfpack,B. Anya,66134,,False,38.0,3,6,3,6,0,0,6,11,4,10,14,1,0,7,2,2,12
400915303,NC State Wolfpack,M. Johnson,4065699,,False,22.0,0,3,0,1,0,2,2,2,1,0,1,0,0,0,2,1,2
400915303,NC State Wolfpack,M. Rowan,3947151,,False,12.0,0,2,0,1,0,1,2,3,0,2,2,0,0,1,0,1,2
400915303,NC State Wolfpack,TEAM,TOTAL,TOTAL,False,,20,57,16,42,4,15,23,36,18,27,45,9,6,10,14,17,67
400915302,Mercer Bears,S. Jelks,3137162,,True,29.0,1,5,1,3,0,2,2,2,1,3,4,0,0,1,0,3,4
400915302,Mercer Bears,D. Ringer,66267,,True,21.0,2,6,2,6,0,0,0,0,2,3,5,0,0,1,2,2,4
400915302,Mercer Bears,J. Strawberry,3137168,,True,24.0,1,5,0,3,1,2,0,0,1,1,2,3,0,0,5,1,3
400915302,Mercer Bears,D. Rivers,3137167,,True,29.0,2,8,1,3,1,5,0,0,0,2,2,1,0,0,3,1,5
400915302,Mercer Bears,R. Holland,67750,,True,27.0,4,9,0,1,4,8,0,0,1,0,1,1,1,0,2,4,12
400915302,Mercer Bears,C. Kilby,3924905,,False,11.0,1,6,1,4,0,2,0,0,2,1,3,0,0,0,0,1,2
400915302,Mercer Bears,J. N'Ganga,3137706,,False,10.0,1,2,1,2,0,0,0,1,0,0,0,0,0,1,2,1,2
400915302,Mercer Bears,A. Fishler,3137161,,False,10.0,0,0,0,0,0,0,2,2,0,2,2,0,0,2,1,1,2
400915302,Mercer Bears,R. Lewis,4067721,,False,14.0,2,9,0,2,2,7,0,0,0,5,5,0,1,0,0,5,6
400915302,Mercer Bears,R. Cummings,4067720,,False,3.0,0,2,0,0,0,2,0,0,0,1,1,0,0,0,2,1,0
400915302,Mercer Bears,D. Roy,4067719,,False,11.0,2,3,2,2,0,1,1,2,2,0,2,0,0,0,1,0,5
400915302,Mercer Bears,J. Stowe,3924907,,False,3.0,0,0,0,0,0,0,0,0,0,0,0,0,0,0,0,0,0
400915302,Mercer Bears,R. Johnson,3149901,,False,8.0,1,1,1,1,0,0,0,0,1,1,2,0,0,0,0,5,2
400915302,Mercer Bears,TEAM,TOTAL,TOTAL,False,,17,56,9,27,8,29,5,7,15,20,35,5,2,5,18,25,47
400915302,Clemson Tigers,D. Grantham,3129674,,True,30.0,6,10,2,4,4,6,3,3,2,4,6,2,1,1,0,0,19
400915302,Clemson Tigers,J. Blossomgame,61835,,True,26.0,6,11,6,7,0,4,4,7,1,1,2,0,0,1,2,2,16
400915302,Clemson Tigers,S. Djitte,66122,,True,19.0,1,3,1,3,0,0,4,5,5,2,7,1,1,1,0,4,6
400915302,Clemson Tigers,S. Mitchell,3136699,,True,24.0,3,6,1,3,2,3,5,6,2,5,7,5,0,0,2,3,13
400915302,Clemson Tigers,A. Holmes,62043,,True,24.0,2,7,0,1,2,6,4,4,1,1,2,2,3,0,1,0,10
400915302,Clemson Tigers,L. Robertin,3917985,,False,16.0,0,0,0,0,0,0,1,2,2,4,6,0,1,4,0,2,1
400915302,Clemson Tigers,S. Spencer,4065646,,False,5.0,1,4,1,4,0,0,0,0,0,0,0,0,0,0,0,0,2
400915302,Clemson Tigers,I. Fields,4065645,,False,2.0,0,0,0,0,0,0,0,0,0,0,0,0,0,0,0,0,0
400915302,Clemson Tigers,T. Hudson,3917986,,False,7.0,1,1,0,0,1,1,0,0,0,0,0,0,0,0,0,1,3
400915302,Clemson Tigers,L. Davis,3917984,,False,2.0,0,0,0,0,0,0,0,2,0,2,2,0,1,0,0,0,0
400915302,Clemson Tigers,R. McGillan,3155393,,False,3.0,0,1,0,0,0,1,0,0,0,0,0,0,0,0,0,0,0
400915302,Clemson Tigers,M. Reed,3133969,,False,20.0,3,8,2,6,1,2,0,0,1,4,5,2,2,0,2,2,7
400915302,Clemson Tigers,G. DeVoe,3129673,,False,22.0,4,9,1,4,3,5,2,2,1,3,4,3,2,1,0,1,13
400915302,Clemson Tigers,TEAM,TOTAL,TOTAL,False,,27,60,14,32,13,28,23,31,18,26,44,15,11,8,7,15,90
400915301,Wake Forest Demon Deacons,J. Collins,3908845,,True,33.0,5,6,5,6,0,0,7,10,4,8,12,1,1,1,4,3,17
400915301,Wake Forest Demon Deacons,D. Mitoglou,3138224,,True,19.0,3,6,2,5,1,1,4,5,2,2,4,3,0,0,0,5,11
400915301,Wake Forest Demon Deacons,A. Arians,61378,,True,22.0,3,6,2,3,1,3,0,0,1,0,1,1,0,0,1,1,7
400915301,Wake Forest Demon Deacons,B. Crawford,3908844,,True,35.0,7,14,6,9,1,5,2,2,0,4,4,3,3,1,1,2,17
400915301,Wake Forest Demon Deacons,M. Wilbekin,3138222,,True,25.0,1,4,0,3,1,1,2,4,0,0,0,3,2,0,0,3,5
400915301,Wake Forest Demon Deacons,G. McClinton,66140,,False,6.0,1,2,1,2,0,0,0,0,0,0,0,0,0,0,1,2,2
400915301,Wake Forest Demon Deacons,S. Japhet-Mathias,4065752,,False,2.0,0,0,0,0,0,0,0,0,0,0,0,0,0,1,1,2,0
400915301,Wake Forest Demon Deacons,D. Moore,3908843,,False,7.0,0,1,0,1,0,0,0,0,0,2,2,0,0,0,1,2,0
400915301,Wake Forest Demon Deacons,B. Childress,4065750,,False,21.0,1,3,0,0,1,3,0,0,1,1,2,1,2,0,1,2,3
400915301,Wake Forest Demon Deacons,K. Woods,3132360,,False,30.0,5,10,2,5,3,5,3,4,1,3,4,1,3,0,4,2,16
400915301,Wake Forest Demon Deacons,TEAM,TOTAL,TOTAL,False,,26,52,18,34,8,18,18,25,10,21,31,13,11,3,15,24,78
400915301,UNC Greensboro Spartans,M. Smith,3137169,,True,23.0,2,8,1,4,1,4,2,2,2,4,6,0,3,1,0,3,7
400915301,UNC Greensboro Spartans,J. Kuiper,67274,,True,32.0,2,4,1,1,1,3,0,0,1,2,3,0,0,0,1,2,5
400915301,UNC Greensboro Spartans,R.J. White,61982,,True,27.0,8,13,8,13,0,0,6,12,4,1,5,0,1,1,2,4,22
400915301,UNC Greensboro Spartans,F. Alonso,3948853,,True,30.0,2,8,0,1,2,7,3,3,1,1,2,2,0,0,6,4,9
400915301,UNC Greensboro Spartans,D. Baldwin,67271,,True,32.0,6,12,4,8,2,4,4,4,0,0,0,1,3,0,3,3,18
400915301,UNC Greensboro Spartans,J. Dickey,3948855,,False,18.0,1,2,1,2,0,0,2,2,2,3,5,0,0,1,0,2,4
400915301,UNC Greensboro Spartans,M. Massey,4067610,,False,13.0,1,3,0,2,1,1,0,0,0,1,1,3,0,0,2,1,3
400915301,UNC Greensboro Spartans,D. Troy,3948854,,False,25.0,3,6,2,3,1,3,0,0,2,4,6,3,0,0,1,1,7
400915301,UNC Greensboro Spartans,TEAM,TOTAL,TOTAL,False,,25,56,17,34,8,22,17,23,13,18,31,9,7,3,15,20,75
400915300,Hartford Hawks,J. Carroll,3130746,,True,11.0,1,2,1,2,0,0,0,0,0,2,2,1,0,0,4,5,2
400915300,Hartford Hawks,H. Attia,4066694,,True,14.0,0,0,0,0,0,0,0,0,1,3,4,0,1,4,3,4,0
400915300,Hartford Hawks,J.R. Lynch,3917979,,True,34.0,4,10,2,4,2,6,0,0,0,2,2,4,0,0,2,1,10
400915300,Hartford Hawks,J. Dunne,3917978,,True,35.0,7,15,2,5,5,10,6,6,1,6,7,3,2,0,2,2,25
400915300,Hartford Hawks,J. Ross,62354,,True,34.0,4,11,2,6,2,5,6,6,0,6,6,2,1,0,0,0,16
400915300,Hartford Hawks,G. Blagojevic,3917980,,False,14.0,1,3,1,2,0,1,0,0,0,0,0,1,0,0,0,0,2
400915300,Hartford Hawks,T. Wilkerson,3917977,,False,19.0,1,1,1,1,0,0,2,2,0,3,3,0,0,1,2,3,4
400915300,Hartford Hawks,J. Hobbs,3130747,,False,26.0,2,4,0,0,2,4,0,0,0,5,5,4,2,0,0,2,6
400915300,Hartford Hawks,A. Ramirez,4066692,,False,13.0,0,5,0,3,0,2,0,0,0,2,2,0,1,0,1,0,0
400915300,Hartford Hawks,TEAM,TOTAL,TOTAL,False,,20,51,9,23,11,28,14,14,6,31,37,15,7,5,18,17,65
400915300,Boston College Eagles,A.J. Turner,3943608,,True,38.0,5,9,3,4,2,5,1,2,0,3,3,7,2,0,1,2,13
400915300,Boston College Eagles,M. Jeffers,61901,,True,22.0,3,5,3,5,0,0,2,3,4,4,8,1,0,0,3,2,8
400915300,Boston College Eagles,C. Tava,61446,,True,28.0,3,7,3,7,0,0,6,7,3,3,6,3,2,0,0,2,12
400915300,Boston College Eagles,T. Graves,4065636,,True,24.0,2,8,1,2,1,6,1,2,0,1,1,1,0,1,1,2,6
400915300,Boston College Eagles,J. Robinson,3943606,,True,32.0,2,13,2,8,0,5,0,0,2,5,7,2,0,3,5,4,4
400915300,Boston College Eagles,J. Reyes,3943609,,False,5.0,0,1,0,1,0,0,0,0,0,2,2,0,0,1,0,1,0
400915300,Boston College Eagles,N. Popovic,4065637,,False,8.0,1,3,1,3,0,0,3,4,1,1,2,0,0,1,0,0,5
400915300,Boston College Eagles,G. Owens,66277,,False,12.0,2,5,2,5,0,0,0,0,1,3,4,3,0,0,0,0,4
400915300,Boston College Eagles,K. Bowman,4065635,,False,9.0,1,2,0,1,1,1,0,0,0,3,3,0,0,0,1,2,3
400915300,Boston College Eagles,J. Chatman,3135095,,False,22.0,2,8,0,4,2,4,2,2,1,0,1,0,0,0,2,0,8
400915300,Boston College Eagles,TEAM,TOTAL,TOTAL,False,,21,61,15,40,6,21,15,20,13,25,38,17,4,6,13,15,63
400915299,Nicholls Colonels,J. Frye,63058,,True,36.0,5,15,4,11,1,4,9,11,3,2,5,2,0,1,4,1,20
400915299,Nicholls Colonels,L. Thomas,67348,,True,13.0,1,3,1,3,0,0,0,0,2,2,4,1,1,2,0,2,2
400915299,Nicholls Colonels,J. Powell,4067758,,True,37.0,5,14,3,8,2,6,2,3,0,5,5,5,0,0,7,2,14
400915299,Nicholls Colonels,J. Bell,3948870,,True,31.0,5,12,5,8,0,4,2,2,3,4,7,1,1,0,2,1,12
400915299,Nicholls Colonels,T. O'Neal,3948868,,True,25.0,1,5,1,3,0,2,2,3,0,1,1,1,0,0,4,1,4
400915299,Nicholls Colonels,A. Ward,3151441,,False,20.0,3,6,3,6,0,0,2,3,3,0,3,0,0,2,1,1,8
400915299,Nicholls Colonels,L. Kamber,67456,,False,10.0,0,1,0,0,0,1,0,0,0,0,0,1,1,0,0,3,0
400915299,Nicholls Colonels,Z. Young,3151440,,False,2.0,0,0,0,0,0,0,0,0,0,0,0,0,0,0,0,0,0
400915299,Nicholls Colonels,S. Repichowski,66776,,False,26.0,1,6,0,0,1,6,0,0,0,1,1,0,1,0,2,1,3
400915299,Nicholls Colonels,TEAM,TOTAL,TOTAL,False,,21,62,17,39,4,23,17,22,14,16,30,11,4,5,20,12,63
400915299,Florida State Seminoles,J. Smith,66126,,True,7.0,1,2,1,2,0,0,0,0,0,0,0,0,0,0,0,2,2
400915299,Florida State Seminoles,M. Ojo,61596,,True,16.0,5,5,5,5,0,0,0,0,1,1,2,0,0,3,2,3,10
400915299,Florida State Seminoles,T. Mann,3907823,,True,18.0,1,3,1,2,0,1,2,2,0,1,1,0,1,0,2,0,4
400915299,Florida State Seminoles,D. Bacon,3907821,,True,23.0,6,10,5,8,1,2,3,3,0,5,5,4,1,0,0,3,16
400915299,Florida State Seminoles,X. Rathan-Mayes,66125,,True,22.0,6,9,3,5,3,4,1,2,2,5,7,7,3,0,2,1,16
400915299,Florida State Seminoles,B. Allen,66124,,False,17.0,4,7,1,2,3,5,0,0,0,2,2,3,0,0,0,2,11
400915299,Florida State Seminoles,C. Koumadje,3907824,,False,20.0,4,6,4,6,0,0,1,1,2,3,5,0,0,3,1,4,9
400915299,Florida State Seminoles,B. Angola-Rodas,4065658,,False,19.0,4,6,2,3,2,3,4,4,0,2,2,5,1,1,0,1,14
400915299,Florida State Seminoles,P. Savoy,4065657,,False,23.0,6,14,0,0,6,14,0,0,0,2,2,3,0,0,0,0,18
400915299,Florida State Seminoles,T. Forrest,4065656,,False,18.0,6,7,5,6,1,1,0,0,2,4,6,6,2,0,2,1,13
400915299,Florida State Seminoles,C. Walker,4065655,,False,17.0,2,3,1,1,1,2,0,0,1,1,2,4,2,0,2,4,5
400915299,Florida State Seminoles,TEAM,TOTAL,TOTAL,False,,45,72,28,40,17,32,11,12,10,30,40,32,10,7,11,21,118
400915298,North Carolina Tar Heels,J. Jackson,3138156,,True,31.0,9,19,2,6,7,13,2,2,0,8,8,1,0,0,3,3,27
400915298,North Carolina Tar Heels,I. Hicks,66874,,True,17.0,4,7,4,7,0,0,5,6,2,1,3,0,0,0,0,4,13
400915298,North Carolina Tar Heels,K. Meeks,66873,,True,28.0,2,7,2,7,0,0,5,6,3,4,7,2,1,1,3,1,9
400915298,North Carolina Tar Heels,K. Williams,3911619,,True,25.0,2,4,1,1,1,3,1,2,1,1,2,3,1,1,3,4,6
400915298,North Carolina Tar Heels,N. Britt,66872,,True,31.0,0,8,0,5,0,3,2,4,1,2,3,6,0,0,3,2,2
400915298,North Carolina Tar Heels,T. Bradley,4065673,,False,12.0,0,3,0,3,0,0,3,4,2,2,4,1,1,1,0,0,3
400915298,North Carolina Tar Heels,L. Maye,3911620,,False,16.0,4,7,3,5,1,2,1,2,2,4,6,1,3,0,2,4,10
400915298,North Carolina Tar Heels,S. Woods,4065676,,False,11.0,1,3,1,2,0,1,2,2,2,1,3,2,2,0,1,0,4
400915298,North Carolina Tar Heels,B. Robinson,4065675,,False,14.0,1,1,0,0,1,1,0,0,0,2,2,1,2,0,0,1,3
400915298,North Carolina Tar Heels,S. White,56963,,False,15.0,0,2,0,1,0,1,6,6,0,0,0,1,0,0,0,0,6
400915298,North Carolina Tar Heels,TEAM,TOTAL,TOTAL,False,,23,61,13,37,10,24,27,34,14,29,43,18,10,3,15,19,83
400915298,Davidson Wildcats,P. Aldridge,3133797,,True,24.0,8,15,7,9,1,6,5,5,0,2,2,1,0,0,3,3,22
400915298,Davidson Wildcats,W. Magarity,67537,,True,26.0,3,6,3,4,0,2,2,2,1,4,5,1,0,3,3,3,8
400915298,Davidson Wildcats,J. Gudmundsson,4070687,,True,30.0,3,7,1,3,2,4,2,2,2,4,6,3,3,0,3,4,10
400915298,Davidson Wildcats,R. Reigel,3133798,,True,35.0,0,2,0,0,0,2,2,2,1,4,5,0,0,0,3,3,2
400915298,Davidson Wildcats,J. Gibbs,67236,,True,38.0,9,20,4,10,5,10,7,10,2,3,5,3,1,0,3,3,30
400915298,Davidson Wildcats,D. Kovacevic,3904644,,False,18.0,1,4,1,1,0,3,0,0,0,2,2,1,0,0,2,2,2
400915298,Davidson Wildcats,O. Michelsen,3133796,,False,1.0,0,0,0,0,0,0,0,0,0,0,0,0,0,0,0,0,0
400915298,Davidson Wildcats,N. Ekwu,3133794,,False,6.0,0,1,0,1,0,0,0,0,1,0,1,1,0,0,0,4,0
400915298,Davidson Wildcats,A. McAuliffe,67238,,False,5.0,0,1,0,1,0,0,0,0,0,0,0,0,0,0,0,1,0
400915298,Davidson Wildcats,K. Pritchett,3904645,,False,7.0,0,1,0,0,0,1,0,0,0,0,0,0,0,0,0,1,0
400915298,Davidson Wildcats,J. Watkins,3133795,,False,10.0,0,2,0,1,0,1,0,0,0,1,1,0,0,0,0,1,0
400915298,Davidson Wildcats,TEAM,TOTAL,TOTAL,False,,24,59,16,30,8,29,18,21,8,25,33,10,4,3,17,25,74
400915297,VCU Rams,J. Tillman,3138206,,True,39.0,10,16,10,15,0,1,6,7,4,5,9,2,1,0,3,4,26
400915297,VCU Rams,M. Alie-Cox,62608,,True,30.0,2,7,2,7,0,0,2,2,2,4,6,0,1,3,1,4,6
400915297,VCU Rams,J. Williams,3138207,,True,20.0,0,3,0,3,0,0,0,0,0,3,3,4,0,0,2,1,0
400915297,VCU Rams,J. Lewis,66649,,True,36.0,5,11,2,6,3,5,3,4,0,4,4,7,2,0,7,3,16
400915297,VCU Rams,J. Burgess,62609,,True,31.0,3,8,2,3,1,5,0,0,1,2,3,1,2,1,1,2,7
400915297,VCU Rams,A. Hamdy-Mohamed,66115,,False,15.0,0,1,0,1,0,0,0,2,0,3,3,1,1,2,1,3,0
400915297,VCU Rams,M. Fraser,4066502,,False,1.0,0,0,0,0,0,0,0,0,0,0,0,0,0,0,0,0,0
400915297,VCU Rams,M. Crowfield,4066501,,False,3.0,0,1,0,0,0,1,0,0,0,0,0,0,0,0,0,1,0
400915297,VCU Rams,D. Jenkins,4066500,,False,13.0,2,2,0,0,2,2,2,2,0,0,0,1,1,0,1,1,8
400915297,VCU Rams,S. Doughty,3913188,,False,12.0,0,2,0,2,0,0,0,0,0,3,3,1,0,0,4,1,0
400915297,VCU Rams,D. Brooks,66650,,False,25.0,3,9,1,3,2,6,2,4,0,1,1,2,4,0,1,2,10
400915297,VCU Rams,TEAM,TOTAL,TOTAL,False,,25,60,17,40,8,20,15,21,11,25,36,19,12,6,21,22,73
400915297,Georgia Tech Yellow Jackets,Q. Stephens,66128,,True,42.0,4,7,4,6,0,1,4,6,3,5,8,3,1,2,2,4,12
400915297,Georgia Tech Yellow Jackets,B. Lammers,3135061,,True,42.0,7,13,7,13,0,0,2,5,4,4,8,2,2,4,1,3,16
400915297,Georgia Tech Yellow Jackets,J. Okogie,4065663,,True,13.0,1,4,0,2,1,2,0,0,0,2,2,1,0,0,1,2,3
400915297,Georgia Tech Yellow Jackets,J. Moore,4065662,,True,18.0,2,4,2,4,0,0,0,2,0,2,2,1,0,0,6,1,4
400915297,Georgia Tech Yellow Jackets,C. Heyward,61609,,True,32.0,2,3,1,1,1,2,0,1,0,4,4,2,1,0,1,1,5
400915297,Georgia Tech Yellow Jackets,C. Matthews,4065665,,False,11.0,0,4,0,4,0,0,3,4,2,0,2,0,0,0,0,1,3
400915297,Georgia Tech Yellow Jackets,A. Gueye,3135059,,False,5.0,0,0,0,0,0,0,0,0,0,0,0,0,2,0,2,2,0
400915297,Georgia Tech Yellow Jackets,T. Jackson,3135057,,False,30.0,9,18,7,13,2,5,4,6,1,3,4,0,1,0,0,3,24
400915297,Georgia Tech Yellow Jackets,J. Heath,67623,,False,32.0,4,8,4,8,0,0,1,2,0,3,3,2,3,0,5,2,9
400915297,Georgia Tech Yellow Jackets,TEAM,TOTAL,TOTAL,False,,29,61,25,51,4,10,14,26,13,25,38,11,10,6,20,19,76
400915296,Harvard Crimson,S. Towns,4066829,,True,30.0,7,11,4,7,3,4,1,2,0,4,4,2,1,0,7,3,18
400915296,Harvard Crimson,Z. Edosomwan,66848,,True,16.0,2,4,2,4,0,0,2,2,0,6,6,0,0,1,2,2,6
400915296,Harvard Crimson,J. Bassey,4066827,,True,30.0,1,4,1,2,0,2,1,2,0,3,3,3,2,0,0,2,3
400915296,Harvard Crimson,C. Johnson,3920225,,True,24.0,1,4,1,3,0,1,0,0,0,2,2,0,1,0,1,1,2
400915296,Harvard Crimson,S. Chambers,61399,,True,32.0,1,8,1,7,0,1,2,2,0,4,4,11,2,0,0,0,4
400915296,Harvard Crimson,H. Welsh,4066831,,False,4.0,0,0,0,0,0,0,0,0,0,1,1,0,0,0,0,0,0
400915296,Harvard Crimson,C. Lewis,4066825,,False,24.0,9,12,9,12,0,0,4,4,4,1,5,0,1,0,1,0,22
400915296,Harvard Crimson,C. Juzang,4066828,,False,8.0,0,1,0,0,0,1,0,0,0,1,1,2,0,0,0,0,0
400915296,Harvard Crimson,B. Aiken,4066826,,False,28.0,4,8,2,4,2,4,6,6,0,2,2,3,0,0,1,2,16
400915296,Harvard Crimson,C. Miller,57273,,False,4.0,1,2,0,1,1,1,0,0,0,0,0,0,0,0,0,0,3
400915296,Harvard Crimson,TEAM,TOTAL,TOTAL,False,,26,54,20,40,6,14,16,18,6,25,31,21,7,1,14,10,74
400915296,Boston College Eagles,A.J. Turner,3943608,,True,32.0,5,11,2,5,3,6,0,0,1,7,8,3,2,0,4,1,13
400915296,Boston College Eagles,M. Jeffers,61901,,True,32.0,2,4,2,4,0,0,0,0,2,4,6,0,0,3,1,0,4
400915296,Boston College Eagles,C. Tava,61446,,True,13.0,3,5,3,5,0,0,1,2,3,1,4,1,0,0,1,2,7
400915296,Boston College Eagles,K. Bowman,4065635,,True,11.0,0,1,0,1,0,0,0,0,0,0,0,1,0,0,3,1,0
400915296,Boston College Eagles,J. Robinson,3943606,,True,40.0,10,23,7,15,3,8,2,4,0,2,2,6,0,0,2,3,25
400915296,Boston College Eagles,J. Reyes,3943609,,False,4.0,0,0,0,0,0,0,0,0,0,1,1,0,0,0,0,0,0
400915296,Boston College Eagles,G. Owens,66277,,False,16.0,3,7,1,4,2,3,0,0,3,5,8,2,1,0,1,2,8
400915296,Boston College Eagles,T. Graves,4065636,,False,30.0,1,5,0,1,1,4,0,0,0,1,1,3,0,1,2,4,3
400915296,Boston College Eagles,J. Chatman,3135095,,False,23.0,2,5,0,0,2,5,0,0,1,0,1,2,0,0,2,4,6
400915296,Boston College Eagles,TEAM,TOTAL,TOTAL,False,,26,61,15,35,11,26,3,6,11,23,34,18,3,4,16,17,66
400915295,Southern Illinois Salukis,T. Bol,4067067,,True,20.0,3,7,3,7,0,0,0,1,1,0,1,0,1,0,0,3,6
400915295,Southern Illinois Salukis,S. O'Brien,66452,,True,34.0,6,10,4,5,2,5,1,2,1,10,11,2,0,1,2,5,15
400915295,Southern Illinois Salukis,A. Fletcher,3148993,,True,33.0,3,13,2,5,1,8,1,1,2,6,8,1,5,1,1,2,8
400915295,Southern Illinois Salukis,M. Rodriguez,3907574,,True,35.0,5,9,4,7,1,2,4,5,0,2,2,4,0,0,3,2,15
400915295,Southern Illinois Salukis,L. Vincent,66959,,True,26.0,1,7,0,1,1,6,0,0,0,0,0,1,0,0,6,1,3
400915295,Southern Illinois Salukis,B. Cherestal,4067064,,False,0.0,0,0,0,0,0,0,0,0,0,0,0,0,0,0,0,0,0
400915295,Southern Illinois Salukis,R. Stradnieks,3907575,,False,16.0,1,4,1,3,0,1,0,0,0,2,2,0,0,0,1,2,2
400915295,Southern Illinois Salukis,A. Weiher,3148997,,False,10.0,0,2,0,0,0,2,0,0,1,1,2,0,0,0,1,0,0
400915295,Southern Illinois Salukis,J. Wiley,3143730,,False,1.0,0,0,0,0,0,0,0,0,0,0,0,0,0,0,0,1,0
400915295,Southern Illinois Salukis,A. Cook,4067063,,False,12.0,0,1,0,1,0,0,2,2,0,4,4,0,0,0,0,2,2
400915295,Southern Illinois Salukis,S. Lloyd Jr.,3948779,,False,13.0,0,1,0,1,0,0,0,0,0,0,0,0,1,1,2,2,0
400915295,Southern Illinois Salukis,TEAM,TOTAL,TOTAL,False,,19,54,14,30,5,24,8,11,5,26,31,8,7,3,17,20,51
400915295,Louisville Cardinals,M. Mathiang,63035,,True,22.0,6,9,6,9,0,0,3,4,2,4,6,0,0,1,1,1,15
400915295,Louisville Cardinals,D. Adel,3908807,,True,26.0,6,12,6,10,0,2,0,1,2,10,12,2,0,0,1,2,12
400915295,Louisville Cardinals,J. Johnson,3147362,,True,25.0,3,4,3,4,0,0,3,7,5,5,10,0,1,6,3,2,9
400915295,Louisville Cardinals,D. Mitchell,3908809,,True,26.0,2,8,1,3,1,5,2,4,0,3,3,3,2,1,1,0,7
400915295,Louisville Cardinals,Q. Snider,3147360,,True,23.0,2,8,0,4,2,4,3,4,0,1,1,4,0,0,0,0,9
400915295,Louisville Cardinals,V.J. King,4065666,,False,14.0,1,2,0,1,1,1,0,0,0,3,3,0,0,0,0,1,3
400915295,Louisville Cardinals,R. Spalding,3908806,,False,17.0,3,3,3,3,0,0,2,2,1,3,4,0,2,0,1,1,8
400915295,Louisville Cardinals,M. Stockman,3147361,,False,16.0,3,4,3,4,0,0,1,2,2,0,2,1,1,1,3,2,7
400915295,Louisville Cardinals,T. Sharpe,4065667,,False,1.0,0,1,0,0,0,1,0,0,0,0,0,0,0,0,0,0,0
400915295,Louisville Cardinals,R. McMahon,3908808,,False,10.0,0,3,0,0,0,3,0,0,0,0,0,1,0,0,0,1,0
400915295,Louisville Cardinals,D. Levitch,66592,,False,6.0,1,2,1,2,0,0,0,0,0,0,0,0,0,0,0,3,2
400915295,Louisville Cardinals,T. Hicks,62752,,False,14.0,0,3,0,2,0,1,2,2,0,0,0,2,2,0,2,1,2
400915295,Louisville Cardinals,TEAM,TOTAL,TOTAL,False,,27,59,23,42,4,17,16,26,13,30,43,13,8,9,12,14,74
400915294,Virginia Tech Hokies,K. Sy,4065740,,True,14.0,3,5,3,5,0,0,1,2,1,3,4,2,0,2,2,1,7
400915294,Virginia Tech Hokies,C. Clarke,3945567,,True,20.0,2,4,2,4,0,0,1,1,1,7,8,3,2,0,2,3,5
400915294,Virginia Tech Hokies,J. Robinson,3945566,,True,33.0,4,13,2,5,2,8,2,3,2,1,3,2,0,0,2,0,12
400915294,Virginia Tech Hokies,A. Hill,3147501,,True,30.0,1,6,0,1,1,5,1,2,0,4,4,2,0,0,3,2,4
400915294,Virginia Tech Hokies,J. Bibbs,3147500,,True,34.0,4,9,2,4,2,5,0,0,2,2,4,1,1,0,0,0,10
400915294,Virginia Tech Hokies,Z. LeDay,61698,,False,26.0,7,10,7,9,0,1,9,9,3,3,6,1,1,0,0,2,23
400915294,Virginia Tech Hokies,T. Outlaw,67275,,False,12.0,1,3,0,0,1,3,0,0,1,0,1,0,0,0,0,2,3
400915294,Virginia Tech Hokies,S. Allen,61795,,False,31.0,4,7,2,3,2,4,1,2,1,2,3,8,1,1,1,1,11
400915294,Virginia Tech Hokies,TEAM,TOTAL,TOTAL,False,,26,57,18,31,8,26,15,19,11,23,34,19,5,3,10,11,75
400915294,Maryland Eastern Shore Hawks,I. Taylor,3947054,,True,12.0,3,5,3,5,0,0,0,1,1,3,4,1,0,1,1,2,6
400915294,Maryland Eastern Shore Hawks,B. Copeland,66560,,True,29.0,3,8,3,8,0,0,3,4,0,4,4,3,0,0,5,4,9
400915294,Maryland Eastern Shore Hawks,L. McIntosh,4067903,,True,24.0,2,5,2,5,0,0,0,0,0,3,3,6,0,0,5,4,4
400915294,Maryland Eastern Shore Hawks,D. Caldwell,3947053,,True,23.0,3,4,2,2,1,2,0,0,0,1,1,1,0,0,0,4,7
400915294,Maryland Eastern Shore Hawks,R. Andino,3153381,,True,39.0,8,14,1,1,7,13,0,0,0,3,3,2,0,0,1,0,23
400915294,Maryland Eastern Shore Hawks,T. Jones,4067908,,False,4.0,0,0,0,0,0,0,0,0,0,0,0,0,0,0,0,0,0
400915294,Maryland Eastern Shore Hawks,D. Dorsett,4067905,,False,5.0,0,2,0,2,0,0,0,0,1,1,2,0,0,0,0,0,0
400915294,Maryland Eastern Shore Hawks,M. Chambers,4067909,,False,12.0,1,2,1,1,0,1,0,0,0,0,0,1,0,0,1,0,2
400915294,Maryland Eastern Shore Hawks,T. Rivera,3947049,,False,16.0,0,6,0,3,0,3,0,0,0,1,1,3,0,0,1,1,0
400915294,Maryland Eastern Shore Hawks,M. Seylan,3947048,,False,7.0,1,2,1,2,0,0,0,0,0,2,2,0,0,0,1,0,2
400915294,Maryland Eastern Shore Hawks,D. Peck,61997,,False,29.0,3,3,3,3,0,0,0,0,1,3,4,0,4,2,0,3,6
400915294,Maryland Eastern Shore Hawks,TEAM,TOTAL,TOTAL,False,,24,51,16,32,8,19,3,5,4,21,25,17,4,3,15,18,59
400915293,Pittsburgh Panthers,M. Young,66290,,True,23.0,6,10,5,8,1,2,4,6,0,7,7,1,0,0,0,3,17
400915293,Pittsburgh Panthers,S. Jeter,61756,,True,33.0,5,7,4,4,1,3,0,0,0,4,4,3,0,1,1,2,11
400915293,Pittsburgh Panthers,J. Artis,66287,,True,34.0,7,14,6,11,1,3,1,3,1,4,5,3,1,0,5,1,16
400915293,Pittsburgh Panthers,C. Johnson,3138196,,True,36.0,6,10,3,4,3,6,2,2,0,4,4,5,1,0,0,3,17
400915293,Pittsburgh Panthers,C. Jones,61219,,True,32.0,4,7,4,5,0,2,4,6,1,0,1,4,1,0,3,4,12
400915293,Pittsburgh Panthers,C. Manigault,4065714,,False,6.0,0,1,0,1,0,0,0,0,0,1,1,1,0,0,0,2,0
400915293,Pittsburgh Panthers,R. Luther,3138197,,False,19.0,2,4,1,3,1,1,6,8,3,4,7,0,1,1,1,1,11
400915293,Pittsburgh Panthers,J. Kithcart,4065713,,False,12.0,0,1,0,0,0,1,0,0,0,1,1,2,0,0,0,2,0
400915293,Pittsburgh Panthers,J. Milligan,3934655,,False,4.0,0,1,0,1,0,0,0,0,0,0,0,1,0,0,0,0,0
400915293,Pittsburgh Panthers,D. Wilson,3934652,,False,1.0,0,0,0,0,0,0,0,0,0,0,0,0,0,0,0,0,0
400915293,Pittsburgh Panthers,TEAM,TOTAL,TOTAL,False,,30,55,23,37,7,18,17,25,5,27,32,20,4,2,10,18,84
400915293,Buffalo Bulls,N. Perkins,3907031,,True,34.0,11,18,11,15,0,3,1,2,3,5,8,0,0,1,2,2,23
400915293,Buffalo Bulls,I. Smart,3136934,,True,8.0,2,3,2,3,0,0,0,0,1,0,1,0,0,0,0,2,4
400915293,Buffalo Bulls,W. Conner,68094,,True,35.0,2,8,1,3,1,5,1,2,0,0,0,1,0,0,1,1,6
400915293,Buffalo Bulls,B. Hamilton,62746,,True,29.0,7,15,6,10,1,5,3,3,0,4,4,3,0,0,1,4,18
400915293,Buffalo Bulls,D. Jordan,4067370,,True,29.0,1,4,1,3,0,1,4,8,0,2,2,6,1,0,2,4,6
400915293,Buffalo Bulls,Q. McKinzie,4067373,,False,20.0,2,3,2,2,0,1,2,2,2,4,6,0,0,1,0,3,6
400915293,Buffalo Bulls,R. Johnson,3136933,,False,6.0,0,0,0,0,0,0,0,0,0,3,3,0,0,1,0,3,0
400915293,Buffalo Bulls,D. Kadiri,66493,,False,1.0,0,1,0,1,0,0,0,0,0,0,0,0,0,0,0,0,0
400915293,Buffalo Bulls,D. Caruthers,4067372,,False,13.0,1,1,1,1,0,0,0,0,0,0,0,3,1,0,1,1,2
400915293,Buffalo Bulls,C. Massinburg,3907030,,False,25.0,4,8,1,3,3,5,3,4,0,3,3,5,1,0,1,2,14
400915293,Buffalo Bulls,TEAM,TOTAL,TOTAL,False,,30,61,25,41,5,20,14,21,7,23,30,18,3,3,8,22,79
400915292,Purdue Fort Wayne Mastodons,B. Calhoun,62418,,True,19.0,1,2,1,2,0,0,0,0,1,7,8,1,0,1,2,1,2
400915292,Purdue Fort Wayne Mastodons,K. Harrell,3906796,,True,23.0,1,4,0,0,1,4,0,0,0,2,2,1,1,0,3,1,3
400915292,Purdue Fort Wayne Mastodons,J. Konchar,3134932,,True,40.0,7,9,6,8,1,1,3,3,2,7,9,1,3,2,3,3,18
400915292,Purdue Fort Wayne Mastodons,M. Evans,67418,,True,37.0,9,18,5,8,4,10,3,3,0,5,5,3,0,0,3,3,25
400915292,Purdue Fort Wayne Mastodons,B. Scott,66194,,True,21.0,0,10,0,6,0,4,2,2,1,4,5,2,0,0,1,2,2
400915292,Purdue Fort Wayne Mastodons,R. Talla,67022,,False,5.0,0,1,0,0,0,1,0,0,0,0,0,0,0,0,0,0,0
400915292,Purdue Fort Wayne Mastodons,X. Taylor,66419,,False,21.0,5,8,5,8,0,0,0,0,0,1,1,0,0,1,2,5,10
400915292,Purdue Fort Wayne Mastodons,J. King,4067660,,False,13.0,1,4,0,3,1,1,0,0,0,2,2,2,0,0,1,2,3
400915292,Purdue Fort Wayne Mastodons,C. Ruise Jr.,3906795,,False,13.0,3,3,3,3,0,0,0,0,0,4,4,1,1,0,0,3,6
400915292,Purdue Fort Wayne Mastodons,D. Stewart,67587,,False,8.0,1,2,0,0,1,2,0,0,0,1,1,0,0,0,0,0,3
400915292,Purdue Fort Wayne Mastodons,TEAM,TOTAL,TOTAL,False,,28,61,20,38,8,23,8,8,5,33,38,11,5,4,15,20,72
400915292,Notre Dame Fighting Irish,B. Colson,3138192,,True,32.0,6,11,3,6,3,5,2,2,2,12,14,5,1,0,0,0,17
400915292,Notre Dame Fighting Irish,M. Geben,3138191,,True,17.0,1,2,1,2,0,0,1,2,1,1,2,1,1,1,0,2,3
400915292,Notre Dame Fighting Irish,V.J. Beachem,66283,,True,33.0,4,14,2,3,2,11,4,5,1,7,8,0,1,2,2,0,14
400915292,Notre Dame Fighting Irish,M. Farrell,3138190,,True,34.0,4,10,4,6,0,4,4,4,0,2,2,6,1,0,3,0,12
400915292,Notre Dame Fighting Irish,S. Vasturia,66285,,True,29.0,6,11,5,7,1,4,8,8,0,4,4,2,1,0,0,2,21
400915292,Notre Dame Fighting Irish,J. Mooney,4065705,,False,3.0,1,1,1,1,0,0,0,0,2,0,2,0,0,0,0,1,2
400915292,Notre Dame Fighting Irish,A. Torres,66286,,False,1.0,0,1,0,1,0,0,0,0,0,0,0,0,0,0,0,1,0
400915292,Notre Dame Fighting Irish,M. Ryan,3908336,,False,10.0,1,4,0,1,1,3,0,0,1,0,1,0,0,0,1,2,3
400915292,Notre Dame Fighting Irish,T. Gibbs,4065703,,False,15.0,2,5,1,2,1,3,1,2,0,1,1,4,0,0,0,1,6
400915292,Notre Dame Fighting Irish,R. Pflueger,3908335,,False,26.0,3,8,0,3,3,5,0,0,1,0,1,2,1,0,0,0,9
400915292,Notre Dame Fighting Irish,TEAM,TOTAL,TOTAL,False,,28,67,17,32,11,35,20,23,9,28,37,20,6,3,6,9,87
400915291,Wake Forest Demon Deacons,J. Collins,3908845,,True,21.0,7,11,7,11,0,0,8,10,6,9,15,1,1,3,2,3,22
400915291,Wake Forest Demon Deacons,D. Mitoglou,3138224,,True,17.0,2,5,2,4,0,1,7,7,2,3,5,1,0,2,3,1,11
400915291,Wake Forest Demon Deacons,A. Arians,61378,,True,21.0,2,4,0,0,2,4,0,0,0,1,1,0,2,0,0,4,6
400915291,Wake Forest Demon Deacons,B. Crawford,3908844,,True,27.0,6,9,4,6,2,3,1,1,0,2,2,3,1,0,1,2,15
400915291,Wake Forest Demon Deacons,M. Wilbekin,3138222,,True,26.0,1,4,0,1,1,3,2,2,0,0,0,5,3,0,1,2,5
400915291,Wake Forest Demon Deacons,R. Washington,4065753,,False,5.0,0,0,0,0,0,0,0,0,0,1,1,2,0,0,0,1,0
400915291,Wake Forest Demon Deacons,D. Mitchell,4065751,,False,1.0,0,0,0,0,0,0,0,0,0,0,0,0,0,0,1,0,0
400915291,Wake Forest Demon Deacons,T. Rike,3155405,,False,2.0,0,0,0,0,0,0,0,0,0,1,1,0,0,0,0,0,0
400915291,Wake Forest Demon Deacons,G. McClinton,66140,,False,6.0,1,1,1,1,0,0,1,2,0,1,1,0,0,0,0,0,3
400915291,Wake Forest Demon Deacons,S. Japhet-Mathias,4065752,,False,3.0,1,1,1,1,0,0,0,0,0,0,0,0,0,0,1,0,2
400915291,Wake Forest Demon Deacons,D. Moore,3908843,,False,15.0,2,2,2,2,0,0,2,3,0,4,4,0,0,0,0,3,6
400915291,Wake Forest Demon Deacons,A. Spivey,4074937,,False,1.0,0,0,0,0,0,0,1,2,0,0,0,0,0,0,0,0,1
400915291,Wake Forest Demon Deacons,B. Childress,4065750,,False,19.0,2,6,1,4,1,2,3,5,0,4,4,2,1,0,3,3,8
400915291,Wake Forest Demon Deacons,B. Anderson,3908847,,False,1.0,0,0,0,0,0,0,0,1,0,0,0,0,0,0,0,0,0
400915291,Wake Forest Demon Deacons,A. Bilas,3908846,,False,1.0,0,0,0,0,0,0,0,0,0,0,0,0,0,0,0,1,0
400915291,Wake Forest Demon Deacons,K. Woods,3132360,,False,29.0,5,9,5,8,0,1,2,2,0,2,2,2,1,0,1,3,12
400915291,Wake Forest Demon Deacons,T. VanHorn,3078214,,False,6.0,0,1,0,1,0,0,0,0,0,0,0,0,0,0,1,0,0
400915291,Wake Forest Demon Deacons,TEAM,TOTAL,TOTAL,False,,29,53,23,39,6,14,27,34,9,28,37,16,9,5,14,23,91
400915291,Charlotte 49ers,A. Vanhook,3906685,,True,19.0,5,9,5,9,0,0,3,3,2,3,5,3,2,0,4,3,13
400915291,Charlotte 49ers,R. Aube,67679,,True,12.0,1,1,1,1,0,0,0,0,2,0,2,0,0,0,1,3,2
400915291,Charlotte 49ers,J. Davis,3906683,,True,34.0,5,11,4,8,1,3,5,6,1,4,5,4,3,0,5,0,16
400915291,Charlotte 49ers,A. White,3906682,,True,21.0,1,9,1,2,0,7,2,2,1,1,2,0,0,0,0,3,4
400915291,Charlotte 49ers,B. Ogbueze,61589,,True,30.0,7,11,1,1,6,10,0,1,0,1,1,1,0,0,1,2,20
400915291,Charlotte 49ers,N. Garvin,4066966,,False,13.0,1,2,1,2,0,0,2,5,0,3,3,0,0,1,0,4,4
400915291,Charlotte 49ers,J. Washington,3953180,,False,9.0,0,0,0,0,0,0,0,0,1,0,1,0,0,0,2,5,0
400915291,Charlotte 49ers,L. Bergang,3948141,,False,4.0,0,0,0,0,0,0,0,0,0,0,0,0,0,0,0,2,0
400915291,Charlotte 49ers,B. Griciunas,66244,,False,15.0,2,5,2,5,0,0,1,2,1,3,4,0,0,1,0,3,5
400915291,Charlotte 49ers,Q. Jackson Jr.,4066968,,False,21.0,4,7,4,5,0,2,0,1,0,1,1,3,1,0,2,3,8
400915291,Charlotte 49ers,H. Price,66154,,False,22.0,1,5,1,2,0,3,0,0,1,0,1,0,0,0,1,2,2
400915291,Charlotte 49ers,TEAM,TOTAL,TOTAL,False,,27,60,20,35,7,25,13,20,11,17,28,11,6,2,16,30,74
400915290,Virginia Cavaliers,I. Wilkins,3138203,,True,20.0,1,1,1,1,0,0,0,0,1,4,5,3,3,1,1,3,2
400915290,Virginia Cavaliers,J. Salt,3138200,,True,23.0,3,4,3,4,0,0,2,3,0,1,1,0,0,1,1,3,8
400915290,Virginia Cavaliers,D. Thompson,66274,,True,24.0,1,3,1,1,0,2,0,0,0,1,1,6,1,1,2,0,2
400915290,Virginia Cavaliers,L. Perrantes,66139,,True,29.0,4,6,2,2,2,4,2,2,0,2,2,5,0,0,0,1,12
400915290,Virginia Cavaliers,D. Hall,66138,,True,20.0,1,7,0,4,1,3,2,2,0,4,4,1,0,0,0,0,5
400915290,Virginia Cavaliers,M. Diakite,3947156,,False,19.0,5,7,4,5,1,2,1,3,0,2,2,0,0,2,0,2,12
400915290,Virginia Cavaliers,J. Reuter,3908374,,False,17.0,5,5,5,5,0,0,0,0,3,2,5,1,1,0,0,4,10
400915290,Virginia Cavaliers,J. Jones,67567,,False,1.0,0,0,0,0,0,0,0,0,0,1,1,0,0,0,0,0,0
400915290,Virginia Cavaliers,T. Jerome,4065733,,False,6.0,0,0,0,0,0,0,0,0,0,0,0,1,0,0,1,1,0
400915290,Virginia Cavaliers,K. Guy,4065730,,False,21.0,5,9,2,4,3,5,0,0,2,0,2,4,1,0,0,0,13
400915290,Virginia Cavaliers,T. Gross Jr.,4065729,,False,1.0,0,1,0,1,0,0,0,0,0,0,0,0,0,0,0,0,0
400915290,Virginia Cavaliers,J. Bartley,3947155,,False,1.0,0,0,0,0,0,0,0,0,0,0,0,0,0,0,0,0,0
400915290,Virginia Cavaliers,M. Shayok,3138201,,False,18.0,5,10,3,5,2,5,0,0,0,4,4,1,0,0,1,0,12
400915290,Virginia Cavaliers,TEAM,TOTAL,TOTAL,False,,30,53,21,32,9,21,7,10,8,22,30,22,6,5,6,14,76
400915290,East Carolina Pirates,C. Williams,3923215,,True,16.0,1,4,1,3,0,1,0,0,2,3,5,0,0,0,0,1,2
400915290,East Carolina Pirates,A. Washington,61163,,True,17.0,0,2,0,2,0,0,0,0,1,3,4,1,0,1,5,1,0
400915290,East Carolina Pirates,K. Barkley,3923216,,True,32.0,2,6,1,4,1,2,2,3,3,1,4,2,1,1,1,1,7
400915290,East Carolina Pirates,B.J. Tyson,3147355,,True,24.0,4,10,2,6,2,4,0,0,1,0,1,4,1,0,1,0,10
400915290,East Carolina Pirates,C. White,66733,,True,39.0,2,12,0,4,2,8,0,0,1,1,2,2,1,0,2,3,6
400915290,East Carolina Pirates,J. Craig,4066448,,False,14.0,0,0,0,0,0,0,0,0,0,2,2,0,0,0,0,0,0
400915290,East Carolina Pirates,M. Nzege,63387,,False,20.0,2,4,1,2,1,2,1,2,1,0,1,1,0,0,0,2,6
400915290,East Carolina Pirates,D. Riak,3923213,,False,11.0,2,2,2,2,0,0,1,2,1,2,3,0,0,0,1,3,5
400915290,East Carolina Pirates,R. Wilkins,4066447,,False,6.0,0,0,0,0,0,0,0,0,0,0,0,0,0,0,0,0,0
400915290,East Carolina Pirates,J. Sheppard,4066445,,False,21.0,5,9,1,3,4,6,3,4,0,3,3,2,0,0,3,1,17
400915290,East Carolina Pirates,TEAM,TOTAL,TOTAL,False,,18,49,8,26,10,23,7,11,11,17,28,12,3,2,13,12,53
400915289,South Carolina State Bulldogs,T. Clement,4074050,,False,1.0,0,0,0,0,0,0,0,0,0,0,0,0,0,0,0,0,0
400915289,South Carolina State Bulldogs,D. Applewhite,4067967,,False,12.0,0,1,0,1,0,0,0,0,0,1,1,0,0,1,0,1,0
400915289,South Carolina State Bulldogs,I. Kinard,4067966,,False,12.0,1,6,1,5,0,1,0,0,2,2,4,0,1,0,0,4,2
400915289,South Carolina State Bulldogs,D. Bottenberg,4067965,,False,9.0,0,0,0,0,0,0,0,0,0,1,1,0,1,0,0,1,0
400915289,South Carolina State Bulldogs,O. Fields,4067962,,False,15.0,0,4,0,4,0,0,0,0,1,2,3,1,0,0,1,2,0
400915289,South Carolina State Bulldogs,T. Riley,3155580,,False,28.0,6,12,6,12,0,0,0,0,3,4,7,0,0,0,0,3,12
400915289,South Carolina State Bulldogs,J. Raynor-Powell,4067964,,False,22.0,1,3,0,2,1,1,1,2,0,1,1,1,0,0,2,0,4
400915289,South Carolina State Bulldogs,J. Richardson,4067963,,False,18.0,0,8,0,7,0,1,1,2,1,1,2,1,0,0,1,2,1
400915289,South Carolina State Bulldogs,E. Jones,4067961,,False,1.0,0,0,0,0,0,0,0,0,0,0,0,0,0,0,0,0,0
400915289,South Carolina State Bulldogs,E. Eaves,3947061,,False,27.0,6,12,4,7,2,5,0,0,1,2,3,1,1,1,3,0,14
400915289,South Carolina State Bulldogs,E. Stephens,3155579,,False,28.0,2,9,1,4,1,5,0,0,0,1,1,1,0,0,0,0,5
400915289,South Carolina State Bulldogs,G. Mortimer,67580,,False,27.0,2,7,2,6,0,1,4,4,0,2,2,1,2,0,1,1,8
400915289,South Carolina State Bulldogs,TEAM,TOTAL,TOTAL,False,,18,62,14,48,4,14,6,8,13,18,31,6,5,2,10,14,46
400915289,Miami Hurricanes,D. Hernandez,4065672,,False,18.0,2,2,2,2,0,0,1,2,0,3,3,0,1,2,2,3,5
400915289,Miami Hurricanes,C. Stowell,3138149,,False,3.0,0,0,0,0,0,0,0,0,0,2,2,0,0,0,0,0,0
400915289,Miami Hurricanes,K. Murphy,61668,,False,20.0,4,4,4,4,0,0,0,2,3,3,6,0,0,0,1,0,8
400915289,Miami Hurricanes,R. Miller Jr.,4065671,,False,7.0,0,0,0,0,0,0,0,0,0,2,2,0,0,0,1,0,0
400915289,Miami Hurricanes,E. Izundu,3904629,,False,17.0,4,7,4,7,0,0,1,2,2,1,3,0,0,3,1,0,9
400915289,Miami Hurricanes,A. Lawrence II,3904628,,False,23.0,1,4,0,1,1,3,2,2,1,6,7,1,0,1,0,2,5
400915289,Miami Hurricanes,B. Brown,4065670,,False,30.0,5,11,5,8,0,3,1,2,3,8,11,10,2,0,2,3,11
400915289,Miami Hurricanes,D. Vasiljevic,4065669,,False,25.0,5,13,0,2,5,11,2,2,1,1,2,2,0,0,0,2,17
400915289,Miami Hurricanes,M. Robinson,3947140,,False,3.0,0,2,0,1,0,1,1,2,1,0,1,0,0,0,1,1,1
400915289,Miami Hurricanes,J. Newton,3138145,,False,24.0,4,7,3,5,1,2,2,2,0,1,1,5,0,0,1,1,11
400915289,Miami Hurricanes,D. Reed,66130,,False,30.0,6,8,3,3,3,5,0,0,1,5,6,6,3,1,3,0,15
400915289,Miami Hurricanes,TEAM,TOTAL,TOTAL,False,,31,58,21,33,10,25,10,16,13,32,45,24,6,7,12,12,82
400915288,Southern Miss Golden Eagles,R. Watts,3946991,,True,23.0,2,8,2,6,0,2,2,2,0,2,2,2,0,0,2,3,6
400915288,Southern Miss Golden Eagles,E. Davis III,3152336,,True,34.0,7,15,5,8,2,7,1,2,2,3,5,1,0,0,1,3,17
400915288,Southern Miss Golden Eagles,K. Holland,3152337,,True,18.0,1,5,1,4,0,1,0,1,3,0,3,1,0,0,1,3,2
400915288,Southern Miss Golden Eagles,Q. Campbell,65090,,True,26.0,0,10,0,5,0,5,3,4,3,5,8,0,0,0,4,1,3
400915288,Southern Miss Golden Eagles,M. Ramey,61435,,True,20.0,1,6,1,1,0,5,0,0,0,0,0,0,0,0,1,3,2
400915288,Southern Miss Golden Eagles,C. Weatherspoon,4067061,,False,14.0,0,0,0,0,0,0,0,0,2,2,4,0,0,0,3,0,0
400915288,Southern Miss Golden Eagles,B. Abdur-Rahim,4067059,,False,11.0,0,2,0,2,0,0,0,0,1,0,1,2,1,0,2,1,0
400915288,Southern Miss Golden Eagles,D. Richardson,4067057,,False,14.0,1,2,0,1,1,1,0,0,0,1,1,2,1,0,1,0,3
400915288,Southern Miss Golden Eagles,R. Thomas III,3946993,,False,9.0,2,3,1,1,1,2,0,0,0,0,0,0,0,0,1,1,5
400915288,Southern Miss Golden Eagles,C. Edwards,3946992,,False,31.0,5,12,4,7,1,5,0,0,1,1,2,4,0,0,4,0,11
400915288,Southern Miss Golden Eagles,TEAM,TOTAL,TOTAL,False,,19,63,14,35,5,28,6,9,14,17,31,12,2,0,20,15,49
400915288,Florida State Seminoles,J. Smith,66126,,True,20.0,5,6,3,3,2,3,2,2,0,1,1,1,2,2,3,1,14
400915288,Florida State Seminoles,M. Ojo,61596,,True,17.0,1,1,1,1,0,0,0,0,1,5,6,0,0,2,0,4,2
400915288,Florida State Seminoles,T. Mann,3907823,,True,19.0,3,3,3,3,0,0,1,2,2,1,3,2,3,0,1,1,7
400915288,Florida State Seminoles,D. Bacon,3907821,,True,24.0,5,12,4,7,1,5,2,2,1,4,5,2,1,0,1,1,13
400915288,Florida State Seminoles,X. Rathan-Mayes,66125,,True,19.0,2,4,2,2,0,2,1,1,0,2,2,7,3,0,4,2,5
400915288,Florida State Seminoles,B. Allen,66124,,False,10.0,4,5,2,2,2,3,0,0,0,0,0,0,0,0,1,0,10
400915288,Florida State Seminoles,C. Koumadje,3907824,,False,14.0,1,1,1,1,0,0,0,0,0,2,2,2,0,3,1,0,2
400915288,Florida State Seminoles,B. Angola-Rodas,4065658,,False,23.0,2,6,1,2,1,4,0,0,0,3,3,3,2,1,2,2,5
400915288,Florida State Seminoles,P. Savoy,4065657,,False,14.0,8,11,1,1,7,10,4,4,0,0,0,0,0,0,0,0,27
400915288,Florida State Seminoles,T. Forrest,4065656,,False,21.0,1,5,1,4,0,1,2,2,2,7,9,1,2,0,0,1,4
400915288,Florida State Seminoles,C. Walker,4065655,,False,19.0,4,6,3,5,1,1,0,0,0,3,3,5,1,0,1,2,9
400915288,Florida State Seminoles,TEAM,TOTAL,TOTAL,False,,36,60,22,31,14,29,12,13,7,29,36,23,14,8,14,14,98
400915287,UConn Huskies,A. Brimah,66679,,True,21.0,1,3,1,3,0,0,0,2,1,3,4,0,1,4,0,4,2
400915287,UConn Huskies,S. Enoch,3934623,,True,11.0,0,5,0,5,0,0,0,2,2,0,2,1,0,0,1,3,0
400915287,UConn Huskies,C. Vital,4066443,,True,28.0,0,6,0,2,0,4,2,2,1,1,2,0,2,0,2,1,2
400915287,UConn Huskies,J. Adams,3934622,,True,40.0,4,11,2,6,2,5,6,9,1,6,7,7,2,0,3,1,16
400915287,UConn Huskies,R. Purvis,61157,,True,38.0,6,15,1,3,5,12,4,4,0,7,7,3,1,0,4,1,21
400915287,UConn Huskies,V. Jackson,4066442,,False,18.0,0,5,0,1,0,4,0,0,0,1,1,0,0,0,1,2,0
400915287,UConn Huskies,J. Durham,4066440,,False,15.0,2,2,2,2,0,0,0,0,1,1,2,0,0,1,1,2,4
400915287,UConn Huskies,K. Facey,66680,,False,29.0,3,4,3,4,0,0,1,4,4,9,13,2,1,0,1,3,7
400915287,UConn Huskies,TEAM,TOTAL,TOTAL,False,,16,51,9,26,7,25,13,23,10,32,42,13,7,5,13,17,52
400915287,Syracuse Orange,T. Lydon,3934662,,True,40.0,1,7,0,3,1,4,4,4,1,8,9,0,1,1,1,3,7
400915287,Syracuse Orange,D. Coleman,61821,,True,28.0,4,6,4,6,0,0,2,5,6,10,16,1,0,2,5,3,10
400915287,Syracuse Orange,A. White III,61616,,True,37.0,4,15,1,4,3,11,3,4,0,2,2,1,2,0,0,2,14
400915287,Syracuse Orange,T. Battle,4065722,,True,35.0,2,6,0,1,2,5,1,2,0,1,1,2,0,0,3,4,7
400915287,Syracuse Orange,F. Howard,3934659,,True,27.0,0,9,0,6,0,3,3,4,1,2,3,3,1,0,2,4,3
400915287,Syracuse Orange,T. Thompson,4065721,,False,4.0,1,2,1,2,0,0,1,2,0,0,0,0,0,0,0,0,3
400915287,Syracuse Orange,T. Roberson,67633,,False,13.0,2,5,2,5,0,0,2,3,0,2,2,0,0,0,0,1,6
400915287,Syracuse Orange,J. Gillon,61915,,False,16.0,0,4,0,1,0,3,0,0,0,1,1,2,2,0,0,1,0
400915287,Syracuse Orange,TEAM,TOTAL,TOTAL,False,,14,54,8,28,6,26,16,24,13,29,42,9,6,3,12,18,50
400915286,George Washington Revolutionaries,A. Toro,4066875,,True,18.0,0,6,0,4,0,2,0,0,4,2,6,0,0,0,0,3,0
400915286,George Washington Revolutionaries,T. Cavanaugh,61165,,True,27.0,2,9,1,6,1,3,3,4,1,5,6,2,2,0,2,3,8
400915286,George Washington Revolutionaries,C. Smith,4066876,,True,21.0,0,3,0,1,0,2,2,3,2,7,9,0,1,1,3,2,2
400915286,George Washington Revolutionaries,M. Hart,3133841,,True,20.0,1,6,1,4,0,2,0,0,1,1,2,0,0,0,2,1,2
400915286,George Washington Revolutionaries,J. Sina,66341,,True,27.0,2,9,0,5,2,4,3,4,2,3,5,2,0,0,2,0,9
400915286,George Washington Revolutionaries,K. Marfo,4066877,,False,26.0,6,10,6,10,0,0,6,11,7,2,9,0,2,0,2,2,18
400915286,George Washington Revolutionaries,C. Goss,3913552,,False,19.0,0,1,0,1,0,0,0,0,0,2,2,0,1,1,0,0,0
400915286,George Washington Revolutionaries,A. Mitola,4066874,,False,6.0,0,3,0,2,0,1,0,0,0,1,1,0,0,0,1,1,0
400915286,George Washington Revolutionaries,J. Williams,4066873,,False,10.0,0,2,0,1,0,1,2,2,1,2,3,0,0,1,1,1,2
400915286,George Washington Revolutionaries,J. Bolden,4066872,,False,13.0,1,7,1,3,0,4,0,0,1,1,2,2,1,1,2,0,2
400915286,George Washington Revolutionaries,J. Roland,3913553,,False,13.0,2,6,1,2,1,4,0,0,1,0,1,0,0,0,2,1,5
400915286,George Washington Revolutionaries,TEAM,TOTAL,TOTAL,False,,14,62,10,39,4,23,16,24,23,29,52,6,7,4,18,14,48
400915286,Florida State Seminoles,P. Cofer,3135054,,True,14.0,1,5,1,5,0,0,0,0,0,4,4,0,0,0,0,0,2
400915286,Florida State Seminoles,M. Ojo,61596,,True,12.0,1,2,1,2,0,0,1,2,2,2,4,0,0,2,0,3,3
400915286,Florida State Seminoles,T. Mann,3907823,,True,31.0,3,8,3,7,0,1,0,0,1,3,4,3,2,0,3,2,6
400915286,Florida State Seminoles,D. Bacon,3907821,,True,22.0,4,11,4,7,0,4,2,3,2,4,6,0,0,0,1,0,10
400915286,Florida State Seminoles,X. Rathan-Mayes,66125,,True,22.0,4,8,1,3,3,5,0,0,0,6,6,5,2,0,2,1,11
400915286,Florida State Seminoles,J. Smith,66126,,False,14.0,1,5,1,5,0,0,0,1,1,3,4,2,0,1,0,5,2
400915286,Florida State Seminoles,B. Allen,66124,,False,8.0,1,4,0,1,1,3,0,0,0,2,2,0,0,0,2,1,3
400915286,Florida State Seminoles,C. Koumadje,3907824,,False,12.0,4,6,4,6,0,0,0,0,1,3,4,0,0,3,0,2,8
400915286,Florida State Seminoles,B. Angola-Rodas,4065658,,False,17.0,1,2,0,0,1,2,0,0,1,1,2,0,1,0,0,2,3
400915286,Florida State Seminoles,P. Savoy,4065657,,False,12.0,2,5,0,1,2,4,0,0,0,1,1,1,0,0,2,2,6
400915286,Florida State Seminoles,T. Forrest,4065656,,False,18.0,1,3,1,3,0,0,0,0,2,0,2,5,2,0,0,1,2
400915286,Florida State Seminoles,C. Walker,4065655,,False,18.0,4,7,3,4,1,3,2,2,1,0,1,1,3,0,2,1,11
400915286,Florida State Seminoles,TEAM,TOTAL,TOTAL,False,,27,66,19,44,8,22,5,8,12,30,42,17,10,6,12,20,67
400915285,Notre Dame Fighting Irish,B. Colson,3138192,,True,26.0,4,8,4,7,0,1,2,2,4,7,11,2,1,2,1,1,10
400915285,Notre Dame Fighting Irish,M. Geben,3138191,,True,14.0,2,3,2,3,0,0,1,1,2,2,4,2,1,0,0,5,5
400915285,Notre Dame Fighting Irish,V.J. Beachem,66283,,True,27.0,7,14,5,8,2,6,3,3,1,1,2,1,0,0,1,0,19
400915285,Notre Dame Fighting Irish,M. Farrell,3138190,,True,22.0,5,7,1,2,4,5,1,1,0,2,2,4,1,0,1,2,15
400915285,Notre Dame Fighting Irish,S. Vasturia,66285,,True,25.0,4,7,1,2,3,5,2,2,1,0,1,4,1,0,2,0,13
400915285,Notre Dame Fighting Irish,J. Mooney,4065705,,False,5.0,0,0,0,0,0,0,2,2,1,1,2,0,0,0,0,0,2
400915285,Notre Dame Fighting Irish,E. Burns,3908337,,False,8.0,0,1,0,0,0,1,2,2,2,1,3,0,1,0,0,0,2
400915285,Notre Dame Fighting Irish,M. Gregory,3155402,,False,1.0,0,1,0,0,0,1,0,0,0,0,0,0,0,0,0,0,0
400915285,Notre Dame Fighting Irish,P. Mazza,3125206,,False,1.0,0,0,0,0,0,0,0,0,0,0,0,0,0,0,0,0,0
400915285,Notre Dame Fighting Irish,A. Torres,66286,,False,15.0,1,3,1,3,0,0,0,0,0,2,2,3,0,0,1,1,2
400915285,Notre Dame Fighting Irish,M. Ryan,3908336,,False,18.0,6,8,1,1,5,7,0,0,0,5,5,1,1,0,1,1,17
400915285,Notre Dame Fighting Irish,T. Gibbs,4065703,,False,20.0,4,7,0,1,4,6,0,0,1,3,4,7,1,0,1,2,12
400915285,Notre Dame Fighting Irish,R. Pflueger,3908335,,False,18.0,4,7,3,4,1,3,1,1,0,5,5,5,1,3,0,0,10
400915285,Notre Dame Fighting Irish,TEAM,TOTAL,TOTAL,False,,37,66,18,31,19,35,14,14,12,32,44,29,8,5,8,12,107
400915285,North Carolina A&T Aggies,D. McGowens,4067939,,True,19.0,2,6,2,6,0,0,1,2,3,2,5,0,0,0,3,3,5
400915285,North Carolina A&T Aggies,A. Scales,61820,,True,35.0,4,6,4,6,0,0,3,4,4,5,9,0,0,1,1,4,11
400915285,North Carolina A&T Aggies,R. Pratt,4067941,,True,25.0,0,8,0,4,0,4,0,0,0,2,2,3,1,0,1,1,0
400915285,North Carolina A&T Aggies,E. Gonzalez,67168,,True,39.0,7,14,5,9,2,5,2,2,4,1,5,2,0,0,3,2,18
400915285,North Carolina A&T Aggies,S. Hunt,66511,,True,38.0,5,17,0,3,5,14,2,2,0,1,1,1,2,0,2,1,17
400915285,North Carolina A&T Aggies,M. Owona,66941,,False,5.0,1,1,1,1,0,0,0,0,0,0,0,0,1,0,0,0,2
400915285,North Carolina A&T Aggies,J. Mullins,4067940,,False,3.0,0,1,0,1,0,0,0,0,0,0,0,1,0,0,0,0,0
400915285,North Carolina A&T Aggies,M. Jones,3951322,,False,14.0,0,6,0,1,0,5,0,0,1,2,3,0,1,0,1,2,0
400915285,North Carolina A&T Aggies,A. Hamilton,3158900,,False,19.0,0,4,0,0,0,4,0,0,0,2,2,0,1,0,0,0,0
400915285,North Carolina A&T Aggies,A. Williams,3151417,,False,3.0,0,0,0,0,0,0,0,0,0,0,0,0,0,0,2,1,0
400915285,North Carolina A&T Aggies,TEAM,TOTAL,TOTAL,False,,19,63,12,31,7,32,8,10,14,17,31,7,6,1,13,14,53
400915284,Radford Highlanders,E. Polite Jr.,3913244,,True,22.0,0,5,0,5,0,0,1,2,0,5,5,1,2,0,2,4,1
400915284,Radford Highlanders,R. Phillips,4067739,,True,16.0,2,4,2,4,0,0,0,0,3,2,5,0,0,0,2,4,4
400915284,Radford Highlanders,D. Hicks,4067737,,True,25.0,1,7,1,5,0,2,0,0,0,3,3,2,2,0,2,1,2
400915284,Radford Highlanders,C. Bradford,4067736,,True,31.0,5,13,4,8,1,5,2,2,0,3,3,2,1,0,6,2,13
400915284,Radford Highlanders,J. Cousin,3078875,,True,27.0,4,9,1,2,3,7,3,3,0,1,1,2,1,0,2,2,14
400915284,Radford Highlanders,S. Christy,3143999,,False,10.0,1,3,1,2,0,1,0,0,0,2,2,0,0,0,0,1,2
400915284,Radford Highlanders,D. Bolstad,3913241,,False,15.0,0,1,0,1,0,0,0,0,0,0,0,0,1,1,1,4,0
400915284,Radford Highlanders,D. Holland,4067738,,False,17.0,3,5,3,5,0,0,0,3,4,2,6,1,0,1,1,3,6
400915284,Radford Highlanders,C. Lutete,3913243,,False,18.0,0,4,0,1,0,3,0,0,0,3,3,0,1,0,2,2,0
400915284,Radford Highlanders,B. Rodriguez,3954877,,False,1.0,0,1,0,1,0,0,0,0,0,0,0,0,0,0,0,0,0
400915284,Radford Highlanders,C. Tanner,3913245,,False,18.0,3,10,1,3,2,7,0,0,0,0,0,1,0,0,0,0,8
400915284,Radford Highlanders,TEAM,TOTAL,TOTAL,False,,19,62,13,37,6,25,6,10,8,21,29,9,8,2,19,23,50
400915284,North Carolina Tar Heels,J. Jackson,3138156,,True,27.0,4,8,4,5,0,3,0,0,0,4,4,6,1,0,3,2,8
400915284,North Carolina Tar Heels,I. Hicks,66874,,True,22.0,4,6,4,6,0,0,4,5,2,1,3,0,1,1,0,1,12
400915284,North Carolina Tar Heels,K. Meeks,66873,,True,20.0,6,9,6,9,0,0,1,5,1,8,9,1,2,1,0,1,13
400915284,North Carolina Tar Heels,K. Williams,3911619,,True,25.0,7,10,2,4,5,6,0,0,3,2,5,1,1,0,0,1,19
400915284,North Carolina Tar Heels,J. Berry II,3138155,,True,13.0,1,3,0,0,1,3,2,2,0,0,0,4,1,0,3,0,5
400915284,North Carolina Tar Heels,A. Rohlman,4065677,,False,2.0,0,0,0,0,0,0,0,0,0,1,1,0,0,0,0,0,0
400915284,North Carolina Tar Heels,S. Rush,4065674,,False,2.0,0,1,0,1,0,0,2,2,0,0,0,0,0,0,0,0,2
400915284,North Carolina Tar Heels,T. Bradley,4065673,,False,20.0,3,8,3,8,0,0,4,8,4,7,11,3,1,2,0,1,10
400915284,North Carolina Tar Heels,L. Maye,3911620,,False,14.0,2,3,2,3,0,0,0,1,3,3,6,0,0,0,1,2,4
400915284,North Carolina Tar Heels,S. Woods,4065676,,False,22.0,3,6,3,5,0,1,3,4,0,3,3,1,2,0,5,1,9
400915284,North Carolina Tar Heels,B. Robinson,4065675,,False,13.0,0,5,0,2,0,3,2,2,1,3,4,2,1,0,1,1,2
400915284,North Carolina Tar Heels,K. Coker,3947144,,False,2.0,0,0,0,0,0,0,0,0,0,0,0,0,0,0,0,0,0
400915284,North Carolina Tar Heels,N. Britt,66872,,False,14.0,3,5,1,2,2,3,0,0,0,3,3,3,1,0,0,1,8
400915284,North Carolina Tar Heels,S. White,56963,,False,4.0,1,1,0,0,1,1,0,0,0,1,1,0,0,0,0,0,3
400915284,North Carolina Tar Heels,TEAM,TOTAL,TOTAL,False,,34,65,25,45,9,20,18,29,15,37,52,21,11,4,13,11,95
400915283,Coppin State Eagles,B. Simpson,3152110,,True,18.0,0,2,0,2,0,0,0,0,3,2,5,1,1,1,0,5,0
400915283,Coppin State Eagles,D. Clayton,4067878,,True,32.0,2,6,1,3,1,3,1,2,0,0,0,1,1,0,4,1,6
400915283,Coppin State Eagles,T. Thomas,4067877,,True,29.0,3,13,3,7,0,6,0,0,1,3,4,1,0,0,0,0,6
400915283,Coppin State Eagles,K. Shivers,3947037,,True,23.0,2,6,0,3,2,3,0,0,0,2,2,2,1,0,1,2,6
400915283,Coppin State Eagles,J. Treadwell,3947032,,True,16.0,0,8,0,6,0,2,0,0,2,4,6,1,1,0,4,1,0
400915283,Coppin State Eagles,M. Murinda,3947039,,False,3.0,0,1,0,0,0,1,0,0,0,0,0,0,0,0,0,0,0
400915283,Coppin State Eagles,I. Hicks,3947038,,False,22.0,3,3,3,3,0,0,0,0,3,4,7,0,0,0,1,4,6
400915283,Coppin State Eagles,T. Harris Jr.,3947034,,False,26.0,5,11,3,8,2,3,2,2,1,5,6,0,1,0,3,2,14
400915283,Coppin State Eagles,J. Gripper,4067879,,False,8.0,0,1,0,1,0,0,0,0,0,0,0,1,0,0,3,1,0
400915283,Coppin State Eagles,J. Davenport,4067876,,False,13.0,1,2,1,2,0,0,0,0,1,1,2,0,0,0,1,3,2
400915283,Coppin State Eagles,R. Hinson,4067875,,False,2.0,0,0,0,0,0,0,0,0,0,0,0,1,0,0,0,0,0
400915283,Coppin State Eagles,L. Brownlee,3947036,,False,8.0,1,2,0,0,1,2,0,0,0,1,1,0,0,0,2,1,3
400915283,Coppin State Eagles,TEAM,TOTAL,TOTAL,False,,17,55,11,35,6,20,3,4,13,23,36,8,5,1,22,20,43
400915283,Clemson Tigers,D. Grantham,3129674,,True,26.0,3,6,1,2,2,4,0,0,1,3,4,2,0,0,2,2,8
400915283,Clemson Tigers,J. Blossomgame,61835,,True,21.0,7,13,7,10,0,3,1,2,5,6,11,2,0,2,2,0,15
400915283,Clemson Tigers,S. Djitte,66122,,True,25.0,2,4,2,4,0,0,2,4,4,9,13,0,1,1,1,2,6
400915283,Clemson Tigers,S. Mitchell,3136699,,True,22.0,6,8,6,7,0,1,0,1,0,0,0,2,2,0,0,0,12
400915283,Clemson Tigers,A. Holmes,62043,,True,16.0,4,6,1,1,3,5,2,2,0,3,3,1,1,1,1,1,13
400915283,Clemson Tigers,L. Robertin,3917985,,False,14.0,0,1,0,1,0,0,0,4,0,0,0,0,0,4,0,1,0
400915283,Clemson Tigers,I. Fields,4065645,,False,3.0,1,2,1,1,0,1,0,0,0,0,0,0,0,0,0,0,2
400915283,Clemson Tigers,T. Hudson,3917986,,False,19.0,2,3,1,1,1,2,0,0,0,0,0,1,2,0,0,2,5
400915283,Clemson Tigers,L. Davis,3917984,,False,3.0,1,1,1,1,0,0,0,0,0,0,0,1,1,0,0,0,2
400915283,Clemson Tigers,R. McGillan,3155393,,False,5.0,1,2,1,1,0,1,0,0,0,0,0,0,0,0,1,1,2
400915283,Clemson Tigers,M. Reed,3133969,,False,22.0,2,8,1,4,1,4,6,8,1,1,2,1,4,0,0,0,11
400915283,Clemson Tigers,G. DeVoe,3129673,,False,24.0,4,7,3,3,1,4,0,0,1,3,4,1,1,1,1,2,9
400915283,Clemson Tigers,TEAM,TOTAL,TOTAL,False,,33,61,25,36,8,25,11,21,12,25,37,11,12,9,8,11,85
400915282,Louisville Cardinals,M. Mathiang,63035,,True,20.0,1,4,1,4,0,0,1,2,4,4,8,1,1,2,1,4,3
400915282,Louisville Cardinals,D. Adel,3908807,,True,29.0,7,16,6,11,1,5,0,0,2,1,3,0,1,0,1,3,15
400915282,Louisville Cardinals,J. Johnson,3147362,,True,16.0,2,5,2,5,0,0,1,2,1,3,4,1,0,0,3,2,5
400915282,Louisville Cardinals,D. Mitchell,3908809,,True,26.0,4,9,3,6,1,3,0,0,1,3,4,1,1,1,1,0,9
400915282,Louisville Cardinals,Q. Snider,3147360,,True,25.0,3,9,2,6,1,3,2,2,2,1,3,4,0,0,0,4,9
400915282,Louisville Cardinals,V.J. King,4065666,,False,24.0,4,6,2,4,2,2,4,4,1,2,3,3,0,0,2,0,14
400915282,Louisville Cardinals,R. Spalding,3908806,,False,27.0,5,7,5,7,0,0,4,4,0,3,3,3,0,1,1,4,14
400915282,Louisville Cardinals,M. Stockman,3147361,,False,15.0,3,3,3,3,0,0,4,5,1,2,3,0,0,0,1,1,10
400915282,Louisville Cardinals,R. McMahon,3908808,,False,4.0,0,1,0,0,0,1,0,0,0,0,0,0,0,0,0,1,0
400915282,Louisville Cardinals,D. Levitch,66592,,False,14.0,0,1,0,0,0,1,0,0,0,2,2,2,2,0,0,0,0
400915282,Louisville Cardinals,TEAM,TOTAL,TOTAL,False,,29,61,24,46,5,15,16,19,14,22,36,15,5,4,10,19,79
400915282,Grand Canyon Lopes,K. Vernon,66377,,True,30.0,3,8,3,8,0,0,2,2,1,2,3,1,0,0,1,4,8
400915282,Grand Canyon Lopes,D. Clark,61573,,True,26.0,3,6,3,6,0,0,2,2,1,6,7,0,0,0,0,4,8
400915282,Grand Canyon Lopes,O. Frayer,4067332,,True,31.0,1,5,0,1,1,4,1,2,0,2,2,0,1,2,0,3,4
400915282,Grand Canyon Lopes,G. Martin,3130581,,True,28.0,1,1,0,0,1,1,0,0,0,1,1,1,0,1,1,3,3
400915282,Grand Canyon Lopes,D. Russell,62748,,True,40.0,14,27,11,21,3,6,11,16,1,2,3,2,1,0,4,4,42
400915282,Grand Canyon Lopes,K. Smith,3130579,,False,15.0,0,0,0,0,0,0,0,0,0,1,1,0,0,0,2,2,0
400915282,Grand Canyon Lopes,S. Carr,4067333,,False,17.0,0,1,0,1,0,0,0,0,0,2,2,3,0,0,3,0,0
400915282,Grand Canyon Lopes,F. Aidoo,4067331,,False,13.0,1,1,0,0,1,1,2,2,1,1,2,0,0,0,2,0,5
400915282,Grand Canyon Lopes,TEAM,TOTAL,TOTAL,False,,23,49,17,37,6,12,18,24,6,19,25,7,2,3,13,20,70
400915281,Maine Black Bears,A. Fleming,4066695,,True,31.0,2,12,2,12,0,0,0,0,4,2,6,0,2,0,0,4,4
400915281,Maine Black Bears,I. Stojiljkovic,3941316,,True,11.0,1,3,0,1,1,2,0,0,0,2,2,0,2,0,0,3,3
400915281,Maine Black Bears,I. Er,4066698,,True,27.0,8,13,4,6,4,7,0,0,2,3,5,0,0,0,1,2,20
400915281,Maine Black Bears,R. Bernstein,3941311,,True,23.0,0,3,0,0,0,3,0,0,0,1,1,5,1,0,0,1,0
400915281,Maine Black Bears,W. Myers,67482,,True,26.0,5,11,2,6,3,5,2,2,0,1,1,3,0,0,1,2,15
400915281,Maine Black Bears,V. Eze,3941313,,False,19.0,2,6,2,6,0,0,1,2,2,0,2,0,0,0,1,3,5
400915281,Maine Black Bears,M. Pirovic,66981,,False,11.0,0,2,0,0,0,2,0,0,0,0,0,0,0,0,0,1,0
400915281,Maine Black Bears,J. McKennon,4066699,,False,13.0,1,4,1,4,0,0,1,2,0,0,0,1,0,0,1,3,3
400915281,Maine Black Bears,D. Evans,4066697,,False,9.0,0,0,0,0,0,0,0,0,1,0,1,0,0,0,1,0,0
400915281,Maine Black Bears,A. Howard,4066696,,False,9.0,0,3,0,1,0,2,0,0,1,0,1,1,0,0,1,0,0
400915281,Maine Black Bears,D. Ashley,3941310,,False,15.0,1,9,1,2,0,7,0,0,0,0,0,1,0,0,0,2,2
400915281,Maine Black Bears,C.J. Ward,3155383,,False,2.0,0,2,0,1,0,1,0,0,0,0,0,1,0,0,0,0,0
400915281,Maine Black Bears,G. Melmed,3155382,,False,4.0,1,1,0,0,1,1,0,0,0,0,0,0,0,0,0,0,3
400915281,Maine Black Bears,TEAM,TOTAL,TOTAL,False,,21,69,12,39,9,30,4,6,12,10,22,12,5,0,6,21,55
400915281,Duke Blue Devils,J. Tatum,4065648,,True,20.0,2,8,1,6,1,2,5,6,1,7,8,0,0,1,1,0,10
400915281,Duke Blue Devils,A. Jefferson,61586,,True,34.0,8,11,8,11,0,0,4,4,3,6,9,4,2,2,2,2,20
400915281,Duke Blue Devils,C. Jeter,3913173,,True,24.0,2,3,2,3,0,0,0,1,1,0,1,1,0,1,5,2,4
400915281,Duke Blue Devils,L. Kennard,3913174,,True,34.0,11,16,7,7,4,9,9,9,0,8,8,2,2,1,0,1,35
400915281,Duke Blue Devils,M. Jones,66563,,True,34.0,1,4,0,2,1,2,0,0,0,3,3,4,0,0,0,1,3
400915281,Duke Blue Devils,J. White,4065653,,False,10.0,1,2,1,1,0,1,2,2,0,4,4,0,0,1,0,0,4
400915281,Duke Blue Devils,J. DeLaurier,4065650,,False,17.0,1,1,1,1,0,0,1,2,3,2,5,0,2,0,1,1,3
400915281,Duke Blue Devils,M. Bolden,4065652,,False,12.0,3,5,3,5,0,0,1,2,3,2,5,0,0,1,3,1,7
400915281,Duke Blue Devils,A. Vrankovic,3913177,,False,13.0,4,5,4,5,0,0,0,0,1,2,3,2,0,1,0,1,8
400915281,Duke Blue Devils,N. Pagliuca,66630,,False,2.0,0,0,0,0,0,0,0,0,0,0,0,1,0,0,0,0,0
400915281,Duke Blue Devils,TEAM,TOTAL,TOTAL,False,,33,55,27,41,6,14,22,26,13,36,49,14,6,8,12,9,94
400915280,West Virginia Mountaineers,E. Ahmad,3947257,,True,34.0,2,7,1,5,1,2,4,4,3,4,7,0,1,0,3,3,9
400915280,West Virginia Mountaineers,E. Macon,67656,,True,15.0,1,2,1,2,0,0,0,0,1,0,1,0,0,0,0,1,2
400915280,West Virginia Mountaineers,N. Adrian,66155,,True,33.0,3,7,3,3,0,4,4,4,2,3,5,4,2,0,0,1,10
400915280,West Virginia Mountaineers,D. Miles Jr.,3133636,,True,11.0,3,3,2,2,1,1,0,0,0,1,1,0,0,0,1,2,7
400915280,West Virginia Mountaineers,J. Carter,3133635,,True,35.0,3,9,3,5,0,4,5,5,0,2,2,5,3,1,2,3,11
400915280,West Virginia Mountaineers,S. Konate,4066333,,False,1.0,0,0,0,0,0,0,0,0,0,1,1,0,0,0,0,1,0
400915280,West Virginia Mountaineers,L. West,3913555,,False,9.0,3,4,1,1,2,3,0,0,0,2,2,0,0,0,0,0,8
400915280,West Virginia Mountaineers,B. Watkins,66156,,False,19.0,3,4,3,4,0,0,0,0,0,3,3,0,2,0,0,2,6
400915280,West Virginia Mountaineers,T. Myers,3947255,,False,20.0,2,8,2,8,0,0,2,2,0,0,0,2,1,0,2,0,6
400915280,West Virginia Mountaineers,T. Phillip,3133638,,False,23.0,3,7,3,6,0,1,1,4,1,1,2,2,1,0,0,3,7
400915280,West Virginia Mountaineers,TEAM,TOTAL,TOTAL,False,,23,51,19,36,4,15,16,19,8,20,28,13,10,1,8,16,66
400915280,Virginia Cavaliers,I. Wilkins,3138203,,True,26.0,3,5,2,4,1,1,0,2,2,6,8,1,0,1,2,0,7
400915280,Virginia Cavaliers,J. Salt,3138200,,True,19.0,2,2,2,2,0,0,2,3,1,2,3,1,0,1,0,2,6
400915280,Virginia Cavaliers,D. Thompson,66274,,True,32.0,5,10,2,4,3,6,1,2,0,1,1,1,2,0,3,2,14
400915280,Virginia Cavaliers,L. Perrantes,66139,,True,37.0,2,10,1,3,1,7,1,1,1,3,4,7,0,1,3,2,6
400915280,Virginia Cavaliers,D. Hall,66138,,True,21.0,2,3,2,3,0,0,0,0,0,1,1,2,0,0,2,5,4
400915280,Virginia Cavaliers,M. Diakite,3947156,,False,17.0,1,2,1,2,0,0,0,1,1,2,3,1,1,0,0,1,2
400915280,Virginia Cavaliers,J. Reuter,3908374,,False,11.0,0,1,0,1,0,0,0,0,0,0,0,0,0,0,1,1,0
400915280,Virginia Cavaliers,T. Jerome,4065733,,False,10.0,1,3,1,1,0,2,0,0,0,0,0,0,0,0,0,1,2
400915280,Virginia Cavaliers,K. Guy,4065730,,False,9.0,3,4,2,2,1,2,0,0,0,2,2,0,0,0,1,2,7
400915280,Virginia Cavaliers,M. Shayok,3138201,,False,18.0,3,8,3,7,0,1,3,4,2,2,4,0,1,0,2,1,9
400915280,Virginia Cavaliers,TEAM,TOTAL,TOTAL,False,,22,48,16,29,6,19,7,13,7,21,28,13,4,3,14,17,57
400915279,Dartmouth Big Green,E. Boudreaux,3906964,,True,30.0,8,14,5,9,3,5,4,5,2,4,6,0,2,0,3,1,23
400915279,Dartmouth Big Green,I. Ngwudo,66847,,True,14.0,0,2,0,2,0,0,2,2,0,0,0,0,0,3,1,2,2
400915279,Dartmouth Big Green,G. Smith,3906965,,True,23.0,2,3,1,1,1,2,4,5,0,3,3,1,1,0,3,1,9
400915279,Dartmouth Big Green,M. Wright,3138252,,True,31.0,5,10,3,6,2,4,0,0,3,3,6,2,0,0,3,1,12
400915279,Dartmouth Big Green,M. Fleming,66844,,True,29.0,0,5,0,0,0,5,0,0,0,1,1,6,0,0,1,2,0
400915279,Dartmouth Big Green,I. Carter,4066820,,False,10.0,0,2,0,1,0,1,1,2,0,1,1,0,0,0,2,1,1
400915279,Dartmouth Big Green,W. Emery,4066819,,False,3.0,0,0,0,0,0,0,3,4,1,0,1,0,0,0,0,0,3
400915279,Dartmouth Big Green,W. Dickinson,66843,,False,13.0,2,4,2,4,0,0,0,0,1,2,3,0,0,1,1,3,4
400915279,Dartmouth Big Green,B. Barry,4066823,,False,8.0,1,3,1,2,0,1,0,0,1,0,1,0,0,0,0,0,2
400915279,Dartmouth Big Green,J. Foye,4066822,,False,2.0,0,1,0,0,0,1,0,0,0,0,0,0,0,0,0,0,0
400915279,Dartmouth Big Green,I. Sistare,4066821,,False,12.0,0,4,0,2,0,2,0,0,2,4,6,2,2,0,1,3,0
400915279,Dartmouth Big Green,C. Smith,3138250,,False,7.0,0,1,0,0,0,1,0,0,0,0,0,0,0,0,2,2,0
400915279,Dartmouth Big Green,T. Johnson,3138249,,False,18.0,4,5,2,3,2,2,4,4,0,3,3,0,1,0,1,1,14
400915279,Dartmouth Big Green,TEAM,TOTAL,TOTAL,False,,22,54,14,30,8,24,18,22,11,22,33,11,6,4,20,17,70
400915279,Boston College Eagles,A.J. Turner,3943608,,True,29.0,2,6,1,4,1,2,2,2,0,3,3,6,0,0,1,0,7
400915279,Boston College Eagles,M. Jeffers,61901,,True,17.0,4,5,4,5,0,0,0,0,0,1,1,0,0,0,1,3,8
400915279,Boston College Eagles,C. Tava,61446,,True,27.0,2,4,2,3,0,1,2,2,0,4,4,3,0,1,1,3,6
400915279,Boston College Eagles,K. Bowman,4065635,,True,20.0,3,4,3,4,0,0,0,0,1,3,4,3,0,0,2,1,6
400915279,Boston College Eagles,J. Robinson,3943606,,True,26.0,10,16,6,9,4,7,3,3,1,2,3,4,3,0,3,3,27
400915279,Boston College Eagles,J. Reyes,3943609,,False,16.0,2,2,2,2,0,0,0,0,1,3,4,2,0,2,0,1,4
400915279,Boston College Eagles,M. Sagay,4065638,,False,15.0,2,6,1,4,1,2,0,2,0,1,1,0,1,0,2,2,5
400915279,Boston College Eagles,E. Meznieks,3943607,,False,3.0,0,2,0,0,0,2,0,0,0,0,0,0,0,0,1,2,0
400915279,Boston College Eagles,G. Owens,66277,,False,1.0,0,0,0,0,0,0,0,0,0,0,0,0,0,0,0,0,0
400915279,Boston College Eagles,T. Graves,4065636,,False,22.0,5,7,2,4,3,3,0,0,0,2,2,4,0,0,1,2,13
400915279,Boston College Eagles,G. Gehan,3943611,,False,2.0,0,2,0,1,0,1,0,0,0,0,0,0,0,0,0,0,0
400915279,Boston College Eagles,J. Chatman,3135095,,False,22.0,4,7,2,4,2,3,2,2,0,2,2,1,1,0,0,2,12
400915279,Boston College Eagles,TEAM,TOTAL,TOTAL,False,,34,61,23,40,11,21,9,11,5,22,27,23,5,3,13,19,88
400915278,Wake Forest Demon Deacons,J. Collins,3908845,,True,19.0,8,12,8,12,0,0,0,3,6,7,13,0,0,0,1,3,16
400915278,Wake Forest Demon Deacons,D. Mitoglou,3138224,,True,25.0,3,5,3,3,0,2,5,6,1,7,8,0,2,0,5,3,11
400915278,Wake Forest Demon Deacons,A. Arians,61378,,True,26.0,4,10,1,1,3,9,4,4,0,2,2,1,0,1,2,2,15
400915278,Wake Forest Demon Deacons,B. Crawford,3908844,,True,33.0,2,6,2,3,0,3,4,7,0,7,7,10,3,0,1,2,8
400915278,Wake Forest Demon Deacons,M. Wilbekin,3138222,,True,27.0,2,6,1,2,1,4,2,2,0,0,0,0,0,0,1,1,7
400915278,Wake Forest Demon Deacons,G. McClinton,66140,,False,14.0,2,2,2,2,0,0,0,1,3,1,4,0,1,0,1,3,4
400915278,Wake Forest Demon Deacons,D. Moore,3908843,,False,6.0,1,4,1,4,0,0,0,0,2,3,5,0,0,0,1,0,2
400915278,Wake Forest Demon Deacons,B. Childress,4065750,,False,21.0,0,5,0,2,0,3,1,2,0,1,1,2,0,0,1,1,1
400915278,Wake Forest Demon Deacons,K. Woods,3132360,,False,29.0,3,8,3,5,0,3,5,7,1,4,5,1,0,0,2,2,11
400915278,Wake Forest Demon Deacons,T. VanHorn,3078214,,False,0.0,0,0,0,0,0,0,0,0,0,0,0,0,0,0,0,0,0
400915278,Wake Forest Demon Deacons,TEAM,TOTAL,TOTAL,False,,25,58,21,34,4,24,21,32,13,32,45,14,6,1,15,17,75
400915278,Richmond Spiders,M. Wood,61769,,True,16.0,2,5,1,2,1,3,1,2,1,2,3,0,0,0,2,4,6
400915278,Richmond Spiders,T.J. Cline,61416,,True,37.0,8,14,6,6,2,8,2,2,1,5,6,8,2,0,5,3,20
400915278,Richmond Spiders,J. Johnson,3908871,,True,30.0,0,3,0,3,0,0,0,0,2,5,7,1,2,0,0,3,0
400915278,Richmond Spiders,K. Fore,3133847,,True,22.0,1,3,1,2,0,1,2,6,0,2,2,0,1,0,1,4,4
400915278,Richmond Spiders,S. Jones,66407,,True,39.0,7,17,3,7,4,10,0,2,0,4,4,2,3,0,2,3,18
400915278,Richmond Spiders,G. Golden,4066836,,False,7.0,2,3,1,2,1,1,1,2,0,1,1,0,0,0,0,0,6
400915278,Richmond Spiders,K. Abakah,61999,,False,6.0,0,1,0,1,0,0,0,0,1,1,2,1,0,0,0,0,0
400915278,Richmond Spiders,D. Buckingham,4066833,,False,22.0,0,5,0,1,0,4,0,0,0,2,2,3,2,1,1,5,0
400915278,Richmond Spiders,N. Sherod,4066832,,False,21.0,5,9,2,3,3,6,0,0,0,4,4,0,0,0,0,3,13
400915278,Richmond Spiders,TEAM,TOTAL,TOTAL,False,,25,60,14,27,11,33,6,14,5,26,31,15,10,1,11,25,67
400915277,Syracuse Orange,T. Lydon,3934662,,True,37.0,2,9,1,5,1,4,1,2,3,6,9,3,0,0,4,1,6
400915277,Syracuse Orange,D. Coleman,61821,,True,29.0,6,10,6,10,0,0,3,5,1,5,6,0,1,1,0,3,15
400915277,Syracuse Orange,T. Battle,4065722,,True,36.0,6,7,2,2,4,5,3,4,0,2,2,1,1,0,1,2,19
400915277,Syracuse Orange,F. Howard,3934659,,True,30.0,2,3,1,2,1,1,5,9,1,4,5,13,4,0,2,1,10
400915277,Syracuse Orange,A. White III,61616,,True,38.0,9,15,2,2,7,13,1,2,1,3,4,2,2,0,2,1,26
400915277,Syracuse Orange,T. Thompson,4065721,,False,8.0,0,2,0,1,0,1,0,0,0,1,1,0,0,1,1,2,0
400915277,Syracuse Orange,T. Roberson,67633,,False,11.0,0,6,0,6,0,0,1,2,3,1,4,0,1,1,0,2,1
400915277,Syracuse Orange,J. Gillon,61915,,False,11.0,0,0,0,0,0,0,0,0,0,0,0,1,1,0,2,1,0
400915277,Syracuse Orange,TEAM,TOTAL,TOTAL,False,,25,52,12,28,13,24,14,24,9,24,33,20,10,3,12,13,77
400915277,North Florida Ospreys,W. Aminu,4067207,,True,33.0,5,10,5,10,0,0,0,4,7,3,10,1,0,0,3,3,10
400915277,North Florida Ospreys,R. Banks,66524,,True,32.0,2,4,2,4,0,0,3,4,2,8,10,1,0,0,3,4,7
400915277,North Florida Ospreys,D. Moore,66523,,True,39.0,10,19,4,6,6,13,4,5,2,5,7,5,2,0,1,3,30
400915277,North Florida Ospreys,G. Sams,4067210,,True,16.0,1,4,1,1,0,3,0,0,0,1,1,1,0,0,3,0,2
400915277,North Florida Ospreys,A. Bodager,61202,,True,28.0,3,14,1,1,2,13,0,0,1,1,2,2,3,0,1,2,8
400915277,North Florida Ospreys,K. Odum,3130522,,False,15.0,1,2,1,2,0,0,0,0,0,0,0,0,0,0,0,2,2
400915277,North Florida Ospreys,B. Haid,4067208,,False,12.0,0,5,0,0,0,5,0,0,0,0,0,1,0,0,0,1,0
400915277,North Florida Ospreys,N. Malonga,3130524,,False,24.0,3,5,0,0,3,5,3,3,2,3,5,1,0,0,1,3,12
400915277,North Florida Ospreys,O. Blount,3130523,,False,1.0,0,0,0,0,0,0,0,0,0,0,0,0,0,0,1,0,0
400915277,North Florida Ospreys,TEAM,TOTAL,TOTAL,False,,25,63,14,24,11,39,10,16,17,24,41,12,5,0,14,18,71
400915276,NC State Wolfpack,T. Kapita,4065701,,True,17.0,3,3,3,3,0,0,0,0,1,4,5,1,0,0,0,5,6
400915276,NC State Wolfpack,A. Abu,3138158,,True,26.0,2,7,2,7,0,0,1,2,2,4,6,2,0,1,3,4,5
400915276,NC State Wolfpack,D. Smith Jr.,4065697,,True,37.0,4,12,3,7,1,5,6,10,0,2,2,3,1,1,3,1,15
400915276,NC State Wolfpack,T. Dorn,3132359,,True,37.0,6,14,5,11,1,3,9,11,2,9,11,1,0,2,1,2,22
400915276,NC State Wolfpack,T. Henderson,61215,,True,36.0,8,14,4,4,4,10,3,4,1,2,3,2,2,0,1,5,23
400915276,NC State Wolfpack,D. Hicks,4065698,,False,18.0,0,1,0,1,0,0,0,3,1,3,4,1,0,0,0,2,0
400915276,NC State Wolfpack,B. Anya,66134,,False,4.0,0,2,0,2,0,0,1,2,1,2,3,0,0,0,0,1,1
400915276,NC State Wolfpack,M. Johnson,4065699,,False,25.0,1,4,0,2,1,2,2,4,1,3,4,5,1,1,2,1,5
400915276,NC State Wolfpack,TEAM,TOTAL,TOTAL,False,,24,57,17,37,7,20,22,36,11,32,43,15,4,5,10,22,77
400915276,Boston University Terriers,N. Havener,3130551,,True,13.0,1,1,1,1,0,0,0,3,2,2,4,0,0,0,0,5,2
400915276,Boston University Terriers,J. Alston,61167,,True,23.0,5,8,5,8,0,0,2,3,0,5,5,0,1,0,2,3,12
400915276,Boston University Terriers,K. Foreman,3936305,,True,33.0,1,4,1,3,0,1,0,0,1,2,3,9,2,0,3,0,2
400915276,Boston University Terriers,C. Hankerson,67094,,True,25.0,3,10,1,2,2,8,1,3,1,2,3,0,2,0,0,2,9
400915276,Boston University Terriers,E. Fanning,61534,,True,22.0,5,7,5,6,0,1,6,6,0,3,3,0,0,0,2,3,16
400915276,Boston University Terriers,T. Scanlon,4067099,,False,27.0,6,13,3,5,3,8,0,0,1,8,9,1,0,0,0,0,15
400915276,Boston University Terriers,D. Barnes,4067100,,False,15.0,2,5,2,3,0,2,1,2,1,1,2,1,2,0,0,5,5
400915276,Boston University Terriers,B. Mbargorba,61847,,False,16.0,0,0,0,0,0,0,0,2,2,3,5,0,0,1,1,3,0
400915276,Boston University Terriers,C. Mosely,3130550,,False,19.0,4,10,2,4,2,6,2,4,0,1,1,2,1,0,3,3,12
400915276,Boston University Terriers,E. Johnson,3130549,,False,7.0,0,2,0,0,0,2,0,0,0,1,1,1,0,0,0,1,0
400915276,Boston University Terriers,TEAM,TOTAL,TOTAL,False,,27,60,20,32,7,28,12,23,10,30,40,14,8,1,11,25,73
400915275,Wofford Terriers,R. Sawvell,56345,,True,30.0,2,7,2,5,0,2,1,2,5,0,5,1,1,0,2,3,5
400915275,Wofford Terriers,M. Pegram,3918762,,True,15.0,1,1,1,1,0,0,1,2,2,1,3,1,1,0,0,4,3
400915275,Wofford Terriers,F. Magee,3918760,,True,31.0,4,11,3,4,1,7,2,2,0,3,3,1,1,0,2,1,11
400915275,Wofford Terriers,J. Allen,67284,,True,16.0,2,5,1,2,1,3,1,2,0,1,1,0,0,0,2,1,6
400915275,Wofford Terriers,E. Garcia,67283,,True,28.0,2,9,1,4,1,5,0,0,0,2,2,3,0,1,1,0,5
400915275,Wofford Terriers,J. Tucker,4067657,,False,10.0,0,1,0,1,0,0,0,0,1,0,1,1,0,0,0,0,0
400915275,Wofford Terriers,D. Lowery,4067653,,False,10.0,1,3,1,3,0,0,0,0,1,2,3,1,0,1,0,1,2
400915275,Wofford Terriers,C. Jackson,3137234,,False,15.0,6,11,6,11,0,0,4,5,0,0,0,0,4,1,1,3,16
400915275,Wofford Terriers,K. Tucker,4067658,,False,3.0,0,0,0,0,0,0,0,0,0,1,1,0,0,0,0,0,0
400915275,Wofford Terriers,N. Hoover,4067656,,False,21.0,2,6,1,1,1,5,0,0,0,3,3,1,0,0,3,0,5
400915275,Wofford Terriers,D. Theme-Love,4067655,,False,12.0,1,2,0,1,1,1,0,0,0,1,1,1,1,0,0,3,3
400915275,Wofford Terriers,D. Brooks,3137231,,False,9.0,0,2,0,2,0,0,1,2,0,1,1,0,0,0,1,1,1
400915275,Wofford Terriers,TEAM,TOTAL,TOTAL,False,,21,58,16,35,5,23,10,15,13,16,29,10,8,3,13,17,57
400915275,Miami Hurricanes,D. Hernandez,4065672,,True,13.0,1,3,1,3,0,0,0,0,0,1,1,0,0,0,3,3,2
400915275,Miami Hurricanes,K. Murphy,61668,,True,28.0,5,10,5,10,0,0,4,4,3,7,10,0,0,1,1,2,14
400915275,Miami Hurricanes,B. Brown,4065670,,True,37.0,3,4,1,1,2,3,4,4,2,3,5,1,3,0,2,1,12
400915275,Miami Hurricanes,J. Newton,3138145,,True,37.0,5,8,4,6,1,2,4,5,1,1,2,9,0,0,4,1,15
400915275,Miami Hurricanes,D. Reed,66130,,True,33.0,4,10,3,6,1,4,4,4,1,4,5,4,3,0,1,0,13
400915275,Miami Hurricanes,E. Izundu,3904629,,False,15.0,3,5,3,5,0,0,3,4,3,2,5,0,1,1,3,3,9
400915275,Miami Hurricanes,A. Lawrence II,3904628,,False,17.0,1,2,0,0,1,2,0,0,0,5,5,1,0,0,2,1,3
400915275,Miami Hurricanes,D. Vasiljevic,4065669,,False,20.0,2,6,0,2,2,4,0,0,0,2,2,0,0,0,0,1,6
400915275,Miami Hurricanes,TEAM,TOTAL,TOTAL,False,,24,48,17,33,7,15,19,21,10,28,38,15,7,2,16,12,74
400915274,Pittsburgh Panthers,M. Young,66290,,True,37.0,8,21,7,17,1,4,2,3,0,6,6,3,1,1,2,2,19
400915274,Pittsburgh Panthers,S. Jeter,61756,,True,31.0,1,6,0,2,1,4,2,2,2,8,10,0,0,1,3,2,5
400915274,Pittsburgh Panthers,D. Wilson,3934652,,True,9.0,1,3,1,1,0,2,0,0,0,0,0,2,0,0,1,0,2
400915274,Pittsburgh Panthers,C. Johnson,3138196,,True,38.0,5,16,4,9,1,7,3,4,3,5,8,0,1,1,1,3,14
400915274,Pittsburgh Panthers,C. Jones,61219,,True,38.0,4,6,4,5,0,1,3,4,1,2,3,3,0,2,2,3,11
400915274,Pittsburgh Panthers,C. Manigault,4065714,,False,3.0,0,1,0,1,0,0,0,0,0,1,1,0,0,0,0,0,0
400915274,Pittsburgh Panthers,R. Luther,3138197,,False,22.0,1,4,1,3,0,1,2,4,2,6,8,0,0,2,2,5,4
400915274,Pittsburgh Panthers,J. Kithcart,4065713,,False,15.0,0,1,0,0,0,1,0,0,0,0,0,0,1,0,1,2,0
400915274,Pittsburgh Panthers,J. Milligan,3934655,,False,7.0,0,2,0,0,0,2,0,0,0,0,0,1,0,0,0,0,0
400915274,Pittsburgh Panthers,TEAM,TOTAL,TOTAL,False,,20,60,17,38,3,22,12,17,10,33,43,9,3,7,12,17,55
400915274,Duquesne Dukes,I. Mike,4066494,,True,31.0,0,7,0,3,0,4,0,3,1,7,8,3,1,0,2,2,0
400915274,Duquesne Dukes,N. Sanders,3908862,,True,25.0,2,3,2,3,0,0,0,0,2,2,4,1,0,0,0,5,4
400915274,Duquesne Dukes,M. Lewis II,4066491,,True,36.0,5,14,3,7,2,7,3,3,0,2,2,1,0,0,0,1,15
400915274,Duquesne Dukes,T. Smith,3136501,,True,31.0,5,11,4,7,1,4,1,3,2,1,3,3,3,0,2,1,12
400915274,Duquesne Dukes,E. Blackman,67480,,True,37.0,7,12,3,5,4,7,3,3,0,6,6,2,0,1,1,1,21
400915274,Duquesne Dukes,E. James,3133808,,False,10.0,2,4,2,3,0,1,1,2,0,3,3,0,1,0,0,1,5
400915274,Duquesne Dukes,D. Lewis,66387,,False,13.0,1,3,1,3,0,0,0,0,1,6,7,1,0,2,1,5,2
400915274,Duquesne Dukes,S. Littleson,4066492,,False,2.0,0,0,0,0,0,0,0,0,0,0,0,0,0,0,0,0,0
400915274,Duquesne Dukes,R. Castro-Caneddy,66160,,False,15.0,2,6,1,3,1,3,0,0,0,1,1,2,0,0,1,0,5
400915274,Duquesne Dukes,TEAM,TOTAL,TOTAL,False,,24,60,16,34,8,26,8,14,7,32,39,13,5,3,8,16,64
400915273,Duke Blue Devils,A. Jefferson,61586,,True,25.0,6,11,6,11,0,0,3,3,2,4,6,5,2,1,1,0,15
400915273,Duke Blue Devils,F. Jackson,4065651,,True,32.0,6,14,5,10,1,4,2,3,0,1,1,2,0,0,1,2,15
400915273,Duke Blue Devils,L. Kennard,3913174,,True,30.0,4,15,3,7,1,8,9,10,2,7,9,3,0,1,0,0,18
400915273,Duke Blue Devils,G. Allen,3135045,,True,18.0,6,9,2,3,4,6,5,5,1,3,4,2,0,0,0,4,21
400915273,Duke Blue Devils,M. Jones,66563,,True,26.0,4,6,2,2,2,4,0,0,1,3,4,1,4,0,2,2,10
400915273,Duke Blue Devils,J. White,4065653,,False,15.0,1,2,1,2,0,0,0,0,0,2,2,1,0,0,2,1,2
400915273,Duke Blue Devils,J. DeLaurier,4065650,,False,15.0,1,3,1,2,0,1,0,0,2,3,5,0,0,2,2,3,2
400915273,Duke Blue Devils,J. Robinson,3913178,,False,1.0,0,0,0,0,0,0,0,0,0,0,0,0,0,0,0,0,0
400915273,Duke Blue Devils,A. Vrankovic,3913177,,False,19.0,3,3,3,3,0,0,2,4,2,3,5,0,0,1,1,1,8
400915273,Duke Blue Devils,C. Jeter,3913173,,False,19.0,1,3,1,3,0,0,0,0,2,2,4,0,1,0,1,3,2
400915273,Duke Blue Devils,TEAM,TOTAL,TOTAL,False,,32,66,24,43,8,23,21,25,17,28,45,14,7,5,10,16,93
400915273,App State Mountaineers,T. Johnson,3949203,,True,18.0,3,7,2,5,1,2,1,2,2,2,4,0,1,0,0,3,8
400915273,App State Mountaineers,G. Kinney,3141196,,True,21.0,5,8,5,8,0,0,1,1,0,1,1,1,0,0,6,3,11
400915273,App State Mountaineers,K. Robinson,4067771,,True,15.0,3,4,0,1,3,3,3,4,2,3,5,0,0,0,2,2,12
400915273,App State Mountaineers,R. Shabazz,3949207,,True,23.0,1,6,0,3,1,3,5,6,0,0,0,0,0,0,2,0,8
400915273,App State Mountaineers,E. Logan,3949205,,True,19.0,0,4,0,4,0,0,0,0,0,1,1,0,0,0,3,1,0
400915273,App State Mountaineers,I. Johnson,4067770,,False,22.0,2,4,0,2,2,2,2,2,1,4,5,2,0,0,0,1,8
400915273,App State Mountaineers,Z. Cottrell,4067768,,False,4.0,0,1,0,0,0,1,0,0,0,0,0,0,0,0,1,0,0
400915273,App State Mountaineers,B. Holley,3949202,,False,5.0,0,1,0,0,0,1,0,0,1,0,1,2,0,0,0,3,0
400915273,App State Mountaineers,C. Hinton,66640,,False,6.0,0,0,0,0,0,0,0,0,0,0,0,0,1,0,1,0,0
400915273,App State Mountaineers,J. Wilson,3949209,,False,7.0,2,5,2,5,0,0,0,0,1,2,3,0,0,0,0,2,4
400915273,App State Mountaineers,P. Good,4067769,,False,24.0,2,5,0,1,2,4,0,0,0,2,2,1,0,0,1,1,6
400915273,App State Mountaineers,M. O'Boyle,3949206,,False,12.0,0,5,0,1,0,4,0,1,1,1,2,1,0,0,0,1,0
400915273,App State Mountaineers,K. Kerley,3949204,,False,1.0,0,1,0,0,0,1,0,0,0,0,0,0,0,0,0,0,0
400915273,App State Mountaineers,T. Ford,3949201,,False,1.0,0,0,0,0,0,0,0,0,0,0,0,0,0,0,0,0,0
400915273,App State Mountaineers,J. Babic,3141192,,False,22.0,0,3,0,0,0,3,1,2,1,1,2,5,0,0,1,4,1
400915273,App State Mountaineers,TEAM,TOTAL,TOTAL,False,,18,54,9,30,9,24,13,18,12,18,30,12,2,0,18,21,58
400915272,Notre Dame Fighting Irish,B. Colson,3138192,,True,28.0,3,8,2,6,1,2,3,4,4,7,11,5,1,1,2,3,10
400915272,Notre Dame Fighting Irish,M. Geben,3138191,,True,14.0,1,1,1,1,0,0,1,2,1,2,3,0,0,1,1,3,3
400915272,Notre Dame Fighting Irish,V.J. Beachem,66283,,True,31.0,6,12,3,5,3,7,0,0,0,4,4,2,0,0,1,0,15
400915272,Notre Dame Fighting Irish,M. Farrell,3138190,,True,27.0,2,8,2,4,0,4,2,2,0,0,0,7,0,2,2,2,6
400915272,Notre Dame Fighting Irish,S. Vasturia,66285,,True,29.0,8,13,5,8,3,5,0,0,2,1,3,3,3,0,1,1,19
400915272,Notre Dame Fighting Irish,J. Mooney,4065705,,False,9.0,1,1,0,0,1,1,0,0,0,4,4,0,0,0,0,1,3
400915272,Notre Dame Fighting Irish,E. Burns,3908337,,False,5.0,1,1,1,1,0,0,0,0,2,1,3,0,0,0,1,1,2
400915272,Notre Dame Fighting Irish,M. Gregory,3155402,,False,1.0,0,2,0,0,0,2,0,0,0,0,0,0,0,0,0,0,0
400915272,Notre Dame Fighting Irish,P. Mazza,3125206,,False,1.0,0,0,0,0,0,0,0,0,0,0,0,0,0,0,0,0,0
400915272,Notre Dame Fighting Irish,A. Torres,66286,,False,12.0,1,1,1,1,0,0,0,0,2,2,4,1,1,1,0,3,2
400915272,Notre Dame Fighting Irish,M. Ryan,3908336,,False,23.0,8,15,1,1,7,14,0,1,0,3,3,3,0,0,1,1,23
400915272,Notre Dame Fighting Irish,T. Gibbs,4065703,,False,20.0,3,4,1,2,2,2,0,0,0,4,4,5,1,0,2,2,8
400915272,Notre Dame Fighting Irish,TEAM,TOTAL,TOTAL,False,,34,66,17,29,17,37,6,9,14,29,43,26,6,5,11,17,91
400915272,Chicago State Cougars,P. Szpir,4066816,,True,26.0,1,1,1,1,0,0,0,2,1,4,5,0,1,0,0,3,2
400915272,Chicago State Cougars,G. Burns,4066814,,True,24.0,1,4,0,2,1,2,2,4,0,0,0,4,1,0,2,1,5
400915272,Chicago State Cougars,F. Sims Jr.,3948138,,True,27.0,4,12,3,8,1,4,2,3,0,2,2,1,0,0,1,0,11
400915272,Chicago State Cougars,T. Palmer,3151568,,True,32.0,5,11,2,5,3,6,2,4,2,7,9,2,2,0,4,4,15
400915272,Chicago State Cougars,C. Owens V,67187,,True,24.0,3,9,3,8,0,1,0,0,1,1,2,1,0,0,1,0,6
400915272,Chicago State Cougars,D. Simmons,4066815,,False,13.0,2,4,2,3,0,1,0,0,1,1,2,0,0,0,0,1,4
400915272,Chicago State Cougars,G. Hunt,3948140,,False,1.0,1,1,0,0,1,1,0,0,0,1,1,0,0,0,0,1,3
400915272,Chicago State Cougars,A. Eaves,3948137,,False,12.0,1,7,1,4,0,3,0,0,1,0,1,0,0,0,0,0,2
400915272,Chicago State Cougars,D. Dixon,3918429,,False,16.0,2,2,1,1,1,1,0,0,1,3,4,0,0,0,2,2,5
400915272,Chicago State Cougars,A. Dubovitskiy,67492,,False,3.0,0,1,0,0,0,1,0,0,0,0,0,0,0,0,0,0,0
400915272,Chicago State Cougars,J. Batson,66693,,False,11.0,1,4,0,2,1,2,1,3,1,1,2,1,0,0,2,0,4
400915272,Chicago State Cougars,B. Greene Jr.,61565,,False,12.0,1,1,0,0,1,1,0,0,0,0,0,1,1,0,1,0,3
400915272,Chicago State Cougars,TEAM,TOTAL,TOTAL,False,,22,57,13,31,9,26,7,16,10,20,30,10,5,0,15,12,60
400915271,NC State Wolfpack,A. Abu,3138158,,True,27.0,2,6,2,6,0,0,2,2,2,4,6,0,0,1,2,3,6
400915271,NC State Wolfpack,B. Anya,66134,,True,7.0,0,2,0,2,0,0,0,0,0,1,1,0,0,0,0,0,0
400915271,NC State Wolfpack,D. Smith Jr.,4065697,,True,40.0,13,22,12,19,1,3,3,4,1,5,6,7,3,0,2,0,30
400915271,NC State Wolfpack,T. Dorn,3132359,,True,37.0,7,10,5,7,2,3,4,4,2,3,5,0,1,0,1,1,20
400915271,NC State Wolfpack,T. Henderson,61215,,True,36.0,8,15,6,9,2,6,1,3,0,4,4,2,1,1,1,3,19
400915271,NC State Wolfpack,T. Kapita,4065701,,False,8.0,0,1,0,1,0,0,0,0,0,1,1,1,0,0,0,3,0
400915271,NC State Wolfpack,D. Hicks,4065698,,False,10.0,0,0,0,0,0,0,0,0,0,2,2,0,0,1,0,0,0
400915271,NC State Wolfpack,M. Johnson,4065699,,False,35.0,2,7,2,4,0,3,0,1,0,4,4,2,3,2,1,3,4
400915271,NC State Wolfpack,TEAM,TOTAL,TOTAL,False,,32,63,27,48,5,15,10,14,5,25,30,12,8,5,7,13,79
400915271,Loyola Chicago Ramblers,M. Kirby,66294,,True,9.0,1,1,1,1,0,0,0,0,0,1,1,1,0,0,0,2,2
400915271,Loyola Chicago Ramblers,B. Richardson,3138279,,True,37.0,5,11,1,5,4,6,0,0,0,8,8,4,0,0,3,5,14
400915271,Loyola Chicago Ramblers,D. Ingram,3138274,,True,33.0,3,8,2,5,1,3,2,2,2,4,6,1,2,0,1,0,9
400915271,Loyola Chicago Ramblers,C. Custer,3133597,,True,32.0,4,8,2,5,2,3,1,2,0,3,3,1,1,0,2,4,11
400915271,Loyola Chicago Ramblers,M. Doyle,61619,,True,28.0,6,12,6,11,0,1,2,3,0,3,3,2,0,0,5,4,14
400915271,Loyola Chicago Ramblers,V. Granic,4067025,,False,6.0,1,2,1,2,0,0,0,0,1,0,1,1,0,0,1,0,2
400915271,Loyola Chicago Ramblers,A. Jackson,4067024,,False,30.0,8,11,6,9,2,2,2,4,1,5,6,3,0,0,2,0,20
400915271,Loyola Chicago Ramblers,C. Satterwhite,4067023,,False,11.0,2,2,1,1,1,1,0,0,0,1,1,1,0,0,0,1,5
400915271,Loyola Chicago Ramblers,B. Skokna,4067020,,False,14.0,0,4,0,3,0,1,0,0,0,1,1,0,0,0,0,0,0
400915271,Loyola Chicago Ramblers,TEAM,TOTAL,TOTAL,False,,30,59,20,42,10,17,7,11,5,30,35,14,3,0,14,16,77
400915270,Tulane Green Wave,R. Smith,66769,,True,30.0,3,7,3,7,0,0,0,0,2,4,6,1,1,1,0,4,6
400915270,Tulane Green Wave,O. Yurtseven,66768,,True,30.0,6,13,4,8,2,5,6,6,2,1,3,3,1,0,3,5,20
400915270,Tulane Green Wave,C. Slater,4066475,,True,15.0,2,6,2,4,0,2,1,2,0,2,2,0,0,0,0,1,5
400915270,Tulane Green Wave,M. Frazier Jr.,3913546,,True,11.0,1,3,0,1,1,2,0,0,1,1,2,0,0,1,2,2,3
400915270,Tulane Green Wave,M. Morgan,61624,,True,35.0,4,7,2,3,2,4,3,4,3,2,5,1,1,1,3,5,13
400915270,Tulane Green Wave,D. Jones,4066476,,False,2.0,0,0,0,0,0,0,0,0,0,0,0,0,0,0,0,0,0
400915270,Tulane Green Wave,B. Paul,3913551,,False,11.0,1,4,1,4,0,0,0,0,2,3,5,3,0,2,1,1,2
400915270,Tulane Green Wave,S. Reyes,3148929,,False,4.0,1,2,1,2,0,0,0,0,0,0,0,0,1,1,0,3,2
400915270,Tulane Green Wave,K. Harris,3913547,,False,29.0,4,11,2,4,2,7,1,2,0,0,0,0,2,0,2,2,11
400915270,Tulane Green Wave,R. Ona Embo,4066474,,False,6.0,0,1,0,0,0,1,0,0,0,1,1,2,0,0,0,0,0
400915270,Tulane Green Wave,V. Julien,3913548,,False,25.0,2,4,1,3,1,1,1,3,0,2,2,2,1,0,1,3,6
400915270,Tulane Green Wave,R. Conroy,3155389,,False,2.0,0,0,0,0,0,0,0,0,0,0,0,0,0,0,0,0,0
400915270,Tulane Green Wave,TEAM,TOTAL,TOTAL,False,,24,58,16,36,8,22,12,17,10,17,27,12,7,6,14,26,68
400915270,Georgia Tech Yellow Jackets,Q. Stephens,66128,,True,37.0,4,8,2,5,2,3,4,7,4,8,12,2,1,1,2,2,14
400915270,Georgia Tech Yellow Jackets,B. Lammers,3135061,,True,33.0,8,11,8,11,0,0,3,5,5,7,12,2,0,4,1,1,19
400915270,Georgia Tech Yellow Jackets,J. Okogie,4065663,,True,34.0,12,20,11,17,1,3,13,18,2,3,5,3,1,0,2,3,38
400915270,Georgia Tech Yellow Jackets,J. Moore,4065662,,True,29.0,2,5,2,5,0,0,1,2,2,2,4,5,0,0,3,4,5
400915270,Georgia Tech Yellow Jackets,C. Heyward,61609,,True,21.0,0,3,0,1,0,2,0,0,1,0,1,1,0,0,0,3,0
400915270,Georgia Tech Yellow Jackets,C. Matthews,4065665,,False,0.0,0,0,0,0,0,0,0,0,0,1,1,0,0,0,0,0,0
400915270,Georgia Tech Yellow Jackets,S. Ogbonda,3904627,,False,3.0,0,0,0,0,0,0,0,0,0,0,0,0,0,0,0,1,0
400915270,Georgia Tech Yellow Jackets,A. Gueye,3135059,,False,8.0,0,1,0,1,0,0,0,0,1,2,3,0,0,0,1,1,0
400915270,Georgia Tech Yellow Jackets,T. Jackson,3135057,,False,12.0,1,5,1,4,0,1,1,2,0,0,0,0,2,0,2,2,3
400915270,Georgia Tech Yellow Jackets,J. Heath,67623,,False,23.0,1,5,0,3,1,2,0,0,0,1,1,5,1,0,3,3,3
400915270,Georgia Tech Yellow Jackets,TEAM,TOTAL,TOTAL,False,,28,58,24,47,4,11,22,34,16,24,40,18,5,5,15,20,82
400915269,Kansas State Wildcats,D. Wade,3912848,,True,32.0,5,8,4,6,1,2,0,0,1,7,8,2,1,2,2,4,11
400915269,Kansas State Wildcats,D.J. Johnson,62710,,True,19.0,3,5,3,5,0,0,1,3,2,2,4,1,1,4,2,4,7
400915269,Kansas State Wildcats,W. Iwundu,67249,,True,19.0,3,8,3,6,0,2,2,4,1,4,5,3,0,0,3,3,8
400915269,Kansas State Wildcats,K. Stokes,3912847,,True,37.0,3,9,1,3,2,6,0,2,1,2,3,6,4,0,1,2,8
400915269,Kansas State Wildcats,B. Brown Jr.,3912841,,True,37.0,2,8,1,4,1,4,6,8,0,0,0,3,4,1,1,2,11
400915269,Kansas State Wildcats,X. Sneed,4066303,,False,29.0,5,9,3,3,2,6,4,4,0,8,8,1,3,0,2,2,16
400915269,Kansas State Wildcats,D. Williams,3912849,,False,1.0,0,0,0,0,0,0,0,0,0,0,0,0,0,0,0,0,0
400915269,Kansas State Wildcats,P. McAtee,3912846,,False,1.0,0,0,0,0,0,0,0,0,0,0,0,0,0,0,0,0,0
400915269,Kansas State Wildcats,I. Maurice,3912845,,False,13.0,3,6,3,5,0,1,0,0,1,0,1,0,0,0,1,3,6
400915269,Kansas State Wildcats,A. Budke,3912842,,False,0.0,0,0,0,0,0,0,0,0,0,0,0,0,0,0,0,0,0
400915269,Kansas State Wildcats,B. Patrick,4066302,,False,3.0,0,1,0,0,0,1,2,2,0,2,2,0,0,0,0,1,2
400915269,Kansas State Wildcats,Z. Winter,3912850,,False,0.0,0,0,0,0,0,0,0,0,0,0,0,0,0,0,0,0,0
400915269,Kansas State Wildcats,C. Ervin II,3912843,,False,9.0,1,1,0,0,1,1,0,1,0,1,1,0,0,0,0,2,3
400915269,Kansas State Wildcats,TEAM,TOTAL,TOTAL,False,,25,55,18,32,7,23,15,24,9,31,40,16,13,7,13,23,72
400915269,Boston College Eagles,A.J. Turner,3943608,,True,29.0,1,4,0,2,1,2,0,0,2,4,6,3,1,0,0,0,3
400915269,Boston College Eagles,M. Jeffers,61901,,True,22.0,1,4,1,4,0,0,1,2,2,5,7,1,0,1,2,4,3
400915269,Boston College Eagles,C. Tava,61446,,True,29.0,3,5,3,4,0,1,5,6,2,1,3,2,1,0,4,3,11
400915269,Boston College Eagles,K. Bowman,4065635,,True,27.0,4,13,3,9,1,4,4,5,1,4,5,1,0,0,4,1,13
400915269,Boston College Eagles,J. Robinson,3943606,,True,33.0,3,12,1,7,2,5,3,5,0,3,3,0,3,0,2,1,11
400915269,Boston College Eagles,J. Reyes,3943609,,False,10.0,2,2,2,2,0,0,0,1,0,2,2,0,0,1,2,3,4
400915269,Boston College Eagles,M. Sagay,4065638,,False,1.0,0,0,0,0,0,0,0,0,0,0,0,0,0,0,0,0,0
400915269,Boston College Eagles,N. Popovic,4065637,,False,8.0,0,2,0,1,0,1,0,0,1,0,1,0,0,0,2,2,0
400915269,Boston College Eagles,G. Owens,66277,,False,13.0,1,2,0,1,1,1,0,0,1,2,3,2,0,0,1,3,3
400915269,Boston College Eagles,T. Graves,4065636,,False,13.0,1,4,1,3,0,1,1,1,0,1,1,0,0,0,4,1,3
400915269,Boston College Eagles,J. Chatman,3135095,,False,15.0,1,3,0,1,1,2,0,0,0,0,0,2,0,0,0,4,3
400915269,Boston College Eagles,TEAM,TOTAL,TOTAL,False,,17,51,11,34,6,17,14,20,9,27,36,11,5,2,21,22,54
400915268,Pittsburgh Panthers,M. Young,66290,,True,34.0,8,14,7,13,1,1,3,4,2,4,6,4,0,1,4,0,20
400915268,Pittsburgh Panthers,S. Jeter,61756,,True,21.0,0,5,0,5,0,0,0,0,3,5,8,2,0,0,1,3,0
400915268,Pittsburgh Panthers,J. Artis,66287,,True,31.0,5,13,3,8,2,5,5,7,2,1,3,5,0,0,2,1,17
400915268,Pittsburgh Panthers,C. Johnson,3138196,,True,34.0,5,8,1,1,4,7,2,2,1,5,6,4,1,0,0,1,16
400915268,Pittsburgh Panthers,C. Jones,61219,,True,27.0,1,3,1,2,0,1,2,4,1,1,2,1,0,0,1,1,4
400915268,Pittsburgh Panthers,R. Nix,3934653,,False,1.0,0,0,0,0,0,0,0,0,0,0,0,0,0,0,1,1,0
400915268,Pittsburgh Panthers,C. Manigault,4065714,,False,3.0,1,1,1,1,0,0,0,0,1,1,2,1,0,0,0,0,2
400915268,Pittsburgh Panthers,R. Luther,3138197,,False,21.0,2,2,1,1,1,1,3,4,1,3,4,1,0,0,1,4,8
400915268,Pittsburgh Panthers,J. Kithcart,4065713,,False,11.0,0,0,0,0,0,0,0,0,0,1,1,0,0,0,0,2,0
400915268,Pittsburgh Panthers,J. Milligan,3934655,,False,12.0,3,5,0,1,3,4,0,0,0,0,0,0,0,0,0,2,9
400915268,Pittsburgh Panthers,D. Wilson,3934652,,False,5.0,0,0,0,0,0,0,0,0,0,0,0,1,0,0,1,0,0
400915268,Pittsburgh Panthers,TEAM,TOTAL,TOTAL,False,,25,51,14,32,11,19,15,21,12,24,36,19,1,1,11,15,76
400915268,Morehead State Eagles,T. Williams,3914076,,True,10.0,0,1,0,1,0,0,0,0,2,1,3,0,0,0,1,2,0
400915268,Morehead State Eagles,D. Marrero,61777,,True,40.0,8,13,8,13,0,0,2,4,6,7,13,2,1,0,1,2,18
400915268,Morehead State Eagles,X. Moon,3914075,,True,40.0,5,17,4,8,1,9,4,4,0,0,0,4,1,0,1,1,15
400915268,Morehead State Eagles,M. Maitland,3914072,,True,37.0,5,11,1,2,4,9,2,2,2,2,4,2,1,0,3,3,16
400915268,Morehead State Eagles,M. Dicent,3138509,,True,29.0,2,8,0,2,2,6,0,0,0,0,0,2,2,0,1,4,6
400915268,Morehead State Eagles,S. Diakite,4067185,,False,3.0,1,2,1,2,0,0,0,0,0,0,0,0,0,0,0,0,2
400915268,Morehead State Eagles,L. Harris,3914073,,False,15.0,1,7,1,5,0,2,0,0,3,3,6,1,0,0,0,1,2
400915268,Morehead State Eagles,T. Bitting,66559,,False,11.0,1,2,1,2,0,0,1,2,0,1,1,0,0,0,1,3,3
400915268,Morehead State Eagles,R. Beamon,62569,,False,10.0,0,0,0,0,0,0,1,2,1,1,2,0,0,0,0,2,1
400915268,Morehead State Eagles,J. Walker,4067181,,False,5.0,0,0,0,0,0,0,0,0,0,0,0,0,0,0,0,1,0
400915268,Morehead State Eagles,TEAM,TOTAL,TOTAL,False,,23,61,16,35,7,26,10,14,15,16,31,11,5,0,8,19,63
400915267,High Point Panthers,R. Madison,3913172,,True,16.0,1,2,1,2,0,0,2,2,1,1,2,0,0,0,0,5,4
400915267,High Point Panthers,M. Bowman Jr.,57310,,True,28.0,3,5,2,4,1,1,2,2,1,5,6,0,0,1,1,2,9
400915267,High Point Panthers,J. Wright,4067464,,True,33.0,5,12,2,7,3,5,0,0,0,3,3,3,1,0,3,4,13
400915267,High Point Panthers,A. Fox,3913171,,True,36.0,6,16,4,11,2,5,8,10,0,4,4,1,1,1,4,3,22
400915267,High Point Panthers,A. Lindauer,66572,,True,31.0,7,13,5,6,2,7,0,0,0,3,3,2,0,0,4,3,16
400915267,High Point Panthers,C. Thomas Jr.,4067467,,False,5.0,1,1,1,1,0,0,0,0,1,1,2,0,0,0,1,0,2
400915267,High Point Panthers,L. Vargo,4067466,,False,7.0,0,1,0,0,0,1,0,0,0,0,0,0,0,0,0,2,0
400915267,High Point Panthers,T. Thompson,66570,,False,24.0,3,6,3,5,0,1,0,0,3,2,5,0,1,0,0,2,6
400915267,High Point Panthers,J. Williams,4067465,,False,7.0,0,1,0,1,0,0,2,2,0,0,0,0,0,0,0,0,2
400915267,High Point Panthers,A. White,3129914,,False,13.0,0,0,0,0,0,0,0,0,0,1,1,3,0,0,0,1,0
400915267,High Point Panthers,TEAM,TOTAL,TOTAL,False,,26,57,18,37,8,20,14,16,9,21,30,9,3,2,13,22,74
400915267,Clemson Tigers,D. Grantham,3129674,,True,33.0,5,9,3,4,2,5,1,1,1,4,5,4,0,0,0,0,13
400915267,Clemson Tigers,J. Blossomgame,61835,,True,38.0,10,15,10,13,0,2,7,7,0,3,3,1,4,3,0,1,27
400915267,Clemson Tigers,S. Djitte,66122,,True,31.0,2,4,2,4,0,0,4,4,7,8,15,1,0,1,4,3,8
400915267,Clemson Tigers,G. DeVoe,3129673,,True,29.0,3,9,0,1,3,8,2,2,0,2,2,5,1,0,4,1,11
400915267,Clemson Tigers,A. Holmes,62043,,True,31.0,3,10,1,1,2,9,5,6,0,2,2,3,0,0,1,1,13
400915267,Clemson Tigers,L. Robertin,3917985,,False,6.0,0,0,0,0,0,0,0,0,0,0,0,0,0,2,1,3,0
400915267,Clemson Tigers,S. Spencer,4065646,,False,2.0,0,0,0,0,0,0,0,0,0,0,0,0,0,0,0,0,0
400915267,Clemson Tigers,S. Mitchell,3136699,,False,11.0,0,2,0,1,0,1,0,0,0,1,1,2,1,0,0,2,0
400915267,Clemson Tigers,M. Reed,3133969,,False,19.0,3,5,1,2,2,3,3,4,0,1,1,3,1,0,2,3,11
400915267,Clemson Tigers,TEAM,TOTAL,TOTAL,False,,26,54,17,26,9,28,22,24,9,23,32,19,7,6,12,14,83
400915266,Virginia Tech Hokies,K. Sy,4065740,,True,16.0,2,4,2,4,0,0,0,0,4,6,10,0,0,0,1,2,4
400915266,Virginia Tech Hokies,C. Clarke,3945567,,True,27.0,4,8,4,6,0,2,0,0,3,6,9,4,1,1,0,2,8
400915266,Virginia Tech Hokies,J. Robinson,3945566,,True,40.0,5,11,2,8,3,3,9,10,1,3,4,8,0,1,0,0,22
400915266,Virginia Tech Hokies,A. Hill,3147501,,True,31.0,6,11,3,4,3,7,3,3,0,2,2,3,0,0,0,3,18
400915266,Virginia Tech Hokies,J. Bibbs,3147500,,True,25.0,5,10,2,4,3,6,0,0,0,1,1,2,1,0,1,3,13
400915266,Virginia Tech Hokies,Z. LeDay,61698,,False,31.0,6,10,5,8,1,2,3,3,0,3,3,2,3,1,4,3,16
400915266,Virginia Tech Hokies,J. Hamilton,3945563,,False,2.0,0,0,0,0,0,0,2,2,1,0,1,0,0,0,0,1,2
400915266,Virginia Tech Hokies,M. Galloway,3945565,,False,4.0,0,1,0,0,0,1,0,0,0,0,0,0,0,0,0,0,0
400915266,Virginia Tech Hokies,T. Outlaw,67275,,False,11.0,0,3,0,1,0,2,2,2,0,3,3,1,0,0,0,3,2
400915266,Virginia Tech Hokies,S. Allen,61795,,False,13.0,3,4,2,3,1,1,0,0,0,0,0,0,1,0,2,4,7
400915266,Virginia Tech Hokies,TEAM,TOTAL,TOTAL,False,,31,62,20,38,11,24,19,20,10,25,35,20,6,3,8,21,92
400915266,New Mexico Lobos,T. Williams,62037,,True,37.0,8,13,8,12,0,1,3,4,6,5,11,1,0,2,1,1,19
400915266,New Mexico Lobos,O. Aget,67734,,True,14.0,2,5,2,5,0,0,1,1,0,3,3,0,0,1,0,0,5
400915266,New Mexico Lobos,J. Hunter,3906576,,True,24.0,4,7,2,3,2,4,0,0,1,1,2,4,1,0,2,2,10
400915266,New Mexico Lobos,S. Logwood,3155771,,True,24.0,2,6,2,6,0,0,0,1,1,2,3,2,0,0,1,2,4
400915266,New Mexico Lobos,E. Brown,66158,,True,25.0,5,13,3,6,2,7,4,6,1,3,4,0,0,0,2,3,16
400915266,New Mexico Lobos,J. Furstinger,3137709,,False,2.0,0,0,0,0,0,0,0,0,0,0,0,0,0,0,0,1,0
400915266,New Mexico Lobos,C. MacDougall,3134889,,False,15.0,2,5,2,5,0,0,1,2,0,2,2,0,0,0,1,3,5
400915266,New Mexico Lobos,D. Jefferson,4066720,,False,10.0,1,2,1,1,0,1,2,2,0,0,0,1,0,0,1,2,4
400915266,New Mexico Lobos,A. Uguak,4066717,,False,11.0,0,1,0,1,0,0,2,2,0,0,0,0,0,0,0,1,2
400915266,New Mexico Lobos,D. Kuiper,3906577,,False,11.0,0,2,0,1,0,1,0,0,0,1,1,0,0,1,1,1,0
400915266,New Mexico Lobos,J. Harris,4066718,,False,16.0,2,3,2,3,0,0,1,1,0,0,0,3,0,0,1,1,5
400915266,New Mexico Lobos,X. Adams,3137708,,False,11.0,0,1,0,1,0,0,2,2,0,1,1,0,1,0,1,5,2
400915266,New Mexico Lobos,TEAM,TOTAL,TOTAL,False,,26,58,22,44,4,14,16,21,11,20,31,11,2,4,11,22,72
400915265,Stanford Cardinal,R. Travis,3134914,,True,33.0,5,9,5,9,0,0,1,2,3,7,10,0,0,0,2,2,11
400915265,Stanford Cardinal,M. Humphrey,3134912,,True,27.0,2,10,2,8,0,2,1,2,2,5,7,0,0,0,2,3,5
400915265,Stanford Cardinal,D. Pickens,3134913,,True,36.0,6,11,4,6,2,5,1,1,0,3,3,2,1,0,4,3,15
400915265,Stanford Cardinal,M. Allen,66217,,True,17.0,1,4,1,3,0,1,0,0,2,2,4,0,0,0,1,1,2
400915265,Stanford Cardinal,C. Sanders,61703,,True,13.0,1,1,1,1,0,0,2,2,0,2,2,2,0,1,1,3,4
400915265,Stanford Cardinal,C. Walker,3922053,,False,3.0,0,0,0,0,0,0,2,2,0,1,1,0,0,0,0,0,2
400915265,Stanford Cardinal,J. Sharma,3922052,,False,5.0,1,4,1,2,0,2,0,0,0,1,1,0,1,1,1,4,2
400915265,Stanford Cardinal,G. Verhoeven,61704,,False,12.0,3,4,2,3,1,1,0,0,1,0,1,0,0,0,1,2,7
400915265,Stanford Cardinal,M. Sheffield II,3922051,,False,27.0,1,4,1,4,0,0,1,2,0,2,2,3,2,0,3,3,3
400915265,Stanford Cardinal,R. Cartwright,3134911,,False,27.0,1,4,1,3,0,1,0,0,0,1,1,3,1,0,3,4,2
400915265,Stanford Cardinal,TEAM,TOTAL,TOTAL,False,,21,51,18,39,3,12,8,11,9,25,34,10,5,2,18,25,53
400915265,Miami Hurricanes,K. Murphy,61668,,True,32.0,3,5,3,5,0,0,0,1,2,5,7,1,0,2,3,3,6
400915265,Miami Hurricanes,E. Izundu,3904629,,True,11.0,0,2,0,2,0,0,0,0,2,1,3,0,0,1,1,2,0
400915265,Miami Hurricanes,A. Lawrence II,3904628,,True,24.0,6,9,3,3,3,6,3,3,0,3,3,1,4,0,2,3,18
400915265,Miami Hurricanes,J. Newton,3138145,,True,37.0,7,14,7,14,0,0,6,10,0,2,2,2,1,0,1,2,20
400915265,Miami Hurricanes,D. Reed,66130,,True,33.0,2,9,1,6,1,3,2,2,0,3,3,0,1,0,3,2,7
400915265,Miami Hurricanes,D. Hernandez,4065672,,False,19.0,1,1,1,1,0,0,1,2,1,2,3,0,1,0,0,2,3
400915265,Miami Hurricanes,B. Brown,4065670,,False,22.0,3,8,3,6,0,2,4,6,2,4,6,2,1,0,0,3,10
400915265,Miami Hurricanes,D. Vasiljevic,4065669,,False,22.0,1,2,0,0,1,2,0,0,0,1,1,1,0,1,1,1,3
400915265,Miami Hurricanes,TEAM,TOTAL,TOTAL,False,,23,50,18,37,5,13,16,24,7,23,30,7,8,4,11,18,67
400915264,Temple Owls,O. Enechionyia,3147357,,True,40.0,7,13,5,10,2,3,0,0,4,4,8,1,0,6,1,0,16
400915264,Temple Owls,M. Williams,66338,,True,12.0,2,3,1,1,1,2,0,0,0,2,2,1,0,1,1,4,5
400915264,Temple Owls,A. Moore II,4066469,,True,28.0,3,5,1,2,2,3,0,0,2,1,3,1,2,0,1,2,8
400915264,Temple Owls,S. Alston Jr.,3934628,,True,38.0,7,15,3,7,4,8,4,4,0,2,2,4,3,0,0,3,22
400915264,Temple Owls,D. Dingle,62779,,True,26.0,2,6,2,6,0,0,1,2,1,5,6,1,0,0,3,4,5
400915264,Temple Owls,E. Aflakpui,3934630,,False,18.0,2,4,2,4,0,0,3,5,4,1,5,0,0,1,2,4,7
400915264,Temple Owls,Q. Rose,4066471,,False,32.0,6,16,4,11,2,5,12,15,3,3,6,4,0,0,4,1,26
400915264,Temple Owls,M. Robbins,3158747,,False,6.0,0,0,0,0,0,0,0,1,0,0,0,0,0,1,0,0,0
400915264,Temple Owls,TEAM,TOTAL,TOTAL,False,,29,62,18,41,11,21,20,27,17,19,36,12,5,9,12,18,89
400915264,Florida State Seminoles,J. Isaac,4065654,,True,27.0,7,12,5,7,2,5,3,4,1,6,7,3,1,2,0,0,19
400915264,Florida State Seminoles,M. Ojo,61596,,True,10.0,2,2,2,2,0,0,2,2,2,2,4,1,0,1,1,1,6
400915264,Florida State Seminoles,T. Mann,3907823,,True,30.0,4,8,4,8,0,0,2,2,1,4,5,3,1,1,0,5,10
400915264,Florida State Seminoles,D. Bacon,3907821,,True,27.0,9,12,6,8,3,4,1,3,0,2,2,1,2,0,2,3,22
400915264,Florida State Seminoles,X. Rathan-Mayes,66125,,True,29.0,4,10,3,5,1,5,2,3,1,0,1,6,0,0,1,3,11
400915264,Florida State Seminoles,P. Cofer,3135054,,False,22.0,2,6,1,5,1,1,0,0,1,1,2,0,0,0,2,1,5
400915264,Florida State Seminoles,J. Smith,66126,,False,16.0,0,1,0,1,0,0,0,0,0,1,1,1,0,0,2,2,0
400915264,Florida State Seminoles,C. Koumadje,3907824,,False,7.0,1,1,1,1,0,0,0,0,0,0,0,0,0,0,0,1,2
400915264,Florida State Seminoles,B. Angola-Rodas,4065658,,False,8.0,0,1,0,0,0,1,0,0,0,0,0,1,0,0,1,2,0
400915264,Florida State Seminoles,T. Forrest,4065656,,False,18.0,1,2,1,2,0,0,2,4,0,1,1,0,0,1,4,2,4
400915264,Florida State Seminoles,C. Walker,4065655,,False,6.0,3,5,2,3,1,2,0,0,1,1,2,1,1,0,0,2,7
400915264,Florida State Seminoles,TEAM,TOTAL,TOTAL,False,,33,60,25,42,8,18,12,18,11,19,30,17,5,5,13,22,86
400915263,Old Dominion Monarchs,Z. Talley Jr.,3147476,,True,10.0,3,6,3,6,0,0,3,5,0,0,0,1,0,0,2,5,9
400915263,Old Dominion Monarchs,D. Taylor,66753,,True,41.0,2,3,2,3,0,0,0,3,6,6,12,3,0,2,3,3,4
400915263,Old Dominion Monarchs,B. Stith,66735,,True,34.0,9,12,9,11,0,1,4,9,3,9,12,0,2,2,4,4,22
400915263,Old Dominion Monarchs,A. Caver,3948144,,True,39.0,3,13,2,8,1,5,2,7,0,1,1,3,0,0,3,4,9
400915263,Old Dominion Monarchs,J. Baker,66750,,True,42.0,1,5,0,1,1,4,0,0,0,3,3,4,0,0,1,2,3
400915263,Old Dominion Monarchs,A. Carver,3913676,,False,1.0,0,0,0,0,0,0,0,0,0,0,0,0,0,0,0,0,0
400915263,Old Dominion Monarchs,S. Vassor,3155709,,False,1.0,0,0,0,0,0,0,0,0,0,0,0,0,0,0,0,0,0
400915263,Old Dominion Monarchs,T. Porter,3133824,,False,14.0,0,2,0,2,0,0,0,2,1,5,6,0,0,1,1,2,0
400915263,Old Dominion Monarchs,R. Haynes,4067032,,False,9.0,1,6,0,4,1,2,2,2,0,3,3,0,2,0,1,3,5
400915263,Old Dominion Monarchs,T. Fields Jr.,4067030,,False,6.0,1,3,1,2,0,1,0,0,0,1,1,0,1,0,1,2,2
400915263,Old Dominion Monarchs,B.J. Stith,3138202,,False,28.0,2,8,2,5,0,3,4,4,1,5,6,1,0,1,4,3,8
400915263,Old Dominion Monarchs,TEAM,TOTAL,TOTAL,False,,22,58,19,42,3,16,15,32,13,38,51,12,5,6,22,28,62
400915263,Louisville Cardinals,M. Mathiang,63035,,True,25.0,3,6,3,6,0,0,6,9,1,4,5,0,0,0,5,5,12
400915263,Louisville Cardinals,D. Adel,3908807,,True,40.0,2,13,1,10,1,3,0,1,0,2,2,3,2,0,1,2,5
400915263,Louisville Cardinals,J. Johnson,3147362,,True,28.0,2,4,2,3,0,1,2,5,4,8,12,2,0,0,2,3,6
400915263,Louisville Cardinals,D. Mitchell,3908809,,True,40.0,4,16,1,10,3,6,4,5,3,4,7,2,7,0,2,3,15
400915263,Louisville Cardinals,Q. Snider,3147360,,True,39.0,4,13,1,7,3,6,7,11,0,1,1,4,0,0,2,3,18
400915263,Louisville Cardinals,V.J. King,4065666,,False,8.0,0,1,0,1,0,0,2,2,2,0,2,1,0,0,0,1,2
400915263,Louisville Cardinals,R. Spalding,3908806,,False,15.0,2,3,2,2,0,1,1,2,2,3,5,0,0,2,0,5,5
400915263,Louisville Cardinals,A. Mahmoud,3147363,,False,16.0,1,3,1,3,0,0,0,0,0,2,2,0,0,1,2,4,2
400915263,Louisville Cardinals,M. Stockman,3147361,,False,3.0,0,0,0,0,0,0,0,0,0,1,1,0,0,0,0,1,0
400915263,Louisville Cardinals,R. McMahon,3908808,,False,2.0,0,0,0,0,0,0,0,0,0,0,0,0,0,0,0,0,0
400915263,Louisville Cardinals,D. Levitch,66592,,False,7.0,1,2,0,0,1,2,0,0,1,3,4,0,1,0,0,0,3
400915263,Louisville Cardinals,T. Hicks,62752,,False,2.0,0,3,0,2,0,1,0,0,0,0,0,0,0,0,0,0,0
400915263,Louisville Cardinals,TEAM,TOTAL,TOTAL,False,,19,64,11,44,8,20,22,35,16,33,49,12,10,3,14,27,68
400915262,William & Mary Tribe,P. Rowley,3129966,,True,26.0,3,5,0,1,3,4,0,0,0,0,0,2,1,1,1,4,9
400915262,William & Mary Tribe,J. Whitman,67189,,True,16.0,4,4,4,4,0,0,5,6,1,3,4,1,0,0,2,4,13
400915262,William & Mary Tribe,O. Prewitt,67186,,True,33.0,5,11,5,8,0,3,1,2,0,5,5,3,0,0,1,2,11
400915262,William & Mary Tribe,D. Dixon,67184,,True,25.0,4,14,2,7,2,7,3,3,0,3,3,1,2,0,3,3,13
400915262,William & Mary Tribe,D. Cohn,66345,,True,27.0,0,2,0,1,0,1,2,2,0,2,2,7,1,0,3,2,2
400915262,William & Mary Tribe,N. Knight,4067325,,False,21.0,4,8,4,7,0,1,3,4,1,4,5,2,0,0,2,1,11
400915262,William & Mary Tribe,J. Pierce,4067326,,False,10.0,1,3,1,2,0,1,0,0,1,2,3,0,0,0,0,0,2
400915262,William & Mary Tribe,G. Malinowski,3129965,,False,13.0,0,3,0,2,0,1,0,0,0,1,1,1,0,1,2,2,0
400915262,William & Mary Tribe,O. Tot,3129967,,False,11.0,0,0,0,0,0,0,0,0,0,0,0,0,0,1,0,1,0
400915262,William & Mary Tribe,C. Burchfield,3129964,,False,16.0,2,3,0,0,2,3,0,0,0,0,0,0,0,0,0,3,6
400915262,William & Mary Tribe,M. Schlotman,67188,,False,2.0,0,0,0,0,0,0,0,0,0,0,0,0,0,0,0,0,0
400915262,William & Mary Tribe,TEAM,TOTAL,TOTAL,False,,23,53,16,32,7,21,14,17,4,21,25,17,4,3,14,22,67
400915262,Duke Blue Devils,A. Jefferson,61586,,True,24.0,5,5,5,5,0,0,5,7,1,9,10,1,0,1,2,3,15
400915262,Duke Blue Devils,F. Jackson,4065651,,True,33.0,6,12,3,5,3,7,4,4,0,4,4,2,1,0,0,2,19
400915262,Duke Blue Devils,L. Kennard,3913174,,True,35.0,5,13,4,8,1,5,0,0,4,4,8,6,2,0,2,3,11
400915262,Duke Blue Devils,G. Allen,3135045,,True,29.0,4,11,1,3,3,8,6,6,1,4,5,6,0,0,2,0,17
400915262,Duke Blue Devils,M. Jones,66563,,True,38.0,3,9,1,5,2,4,2,2,1,1,2,2,0,0,0,2,10
400915262,Duke Blue Devils,J. White,4065653,,False,3.0,2,3,2,3,0,0,0,0,1,0,1,0,0,1,0,0,4
400915262,Duke Blue Devils,J. DeLaurier,4065650,,False,9.0,1,1,1,1,0,0,0,0,1,1,2,0,1,0,3,3,2
400915262,Duke Blue Devils,J. Robinson,3913178,,False,2.0,0,0,0,0,0,0,0,0,0,0,0,0,0,0,0,0,0
400915262,Duke Blue Devils,A. Vrankovic,3913177,,False,13.0,2,2,2,2,0,0,0,1,1,3,4,0,0,2,0,0,4
400915262,Duke Blue Devils,C. Jeter,3913173,,False,13.0,2,3,2,3,0,0,2,2,1,2,3,1,0,1,1,3,6
400915262,Duke Blue Devils,N. Pagliuca,66630,,False,1.0,0,1,0,0,0,1,0,0,0,0,0,0,0,0,0,0,0
400915262,Duke Blue Devils,TEAM,TOTAL,TOTAL,False,,30,60,21,35,9,25,19,22,11,28,39,18,4,5,10,16,88
400915261,Wake Forest Demon Deacons,J. Collins,3908845,,True,26.0,8,11,8,11,0,0,4,5,1,12,13,0,1,2,1,0,20
400915261,Wake Forest Demon Deacons,D. Mitoglou,3138224,,True,27.0,0,6,0,3,0,3,3,4,0,12,12,2,1,3,5,3,3
400915261,Wake Forest Demon Deacons,A. Arians,61378,,True,19.0,3,5,1,1,2,4,0,0,1,0,1,0,0,0,1,0,8
400915261,Wake Forest Demon Deacons,B. Crawford,3908844,,True,30.0,3,9,2,6,1,3,5,7,0,2,2,5,0,0,1,0,12
400915261,Wake Forest Demon Deacons,M. Wilbekin,3138222,,True,27.0,3,6,0,0,3,6,5,5,0,1,1,3,0,0,0,2,14
400915261,Wake Forest Demon Deacons,R. Washington,4065753,,False,2.0,0,1,0,0,0,1,0,0,0,0,0,1,0,0,0,1,0
400915261,Wake Forest Demon Deacons,G. McClinton,66140,,False,8.0,1,1,1,1,0,0,0,0,0,1,1,0,0,0,0,1,2
400915261,Wake Forest Demon Deacons,D. Moore,3908843,,False,12.0,2,5,2,5,0,0,0,0,0,2,2,1,0,1,0,1,4
400915261,Wake Forest Demon Deacons,B. Childress,4065750,,False,20.0,4,8,1,2,3,6,4,4,0,3,3,4,1,0,4,3,15
400915261,Wake Forest Demon Deacons,K. Woods,3132360,,False,26.0,3,5,1,2,2,3,0,0,1,4,5,3,0,0,2,4,8
400915261,Wake Forest Demon Deacons,T. VanHorn,3078214,,False,3.0,0,0,0,0,0,0,0,0,0,0,0,2,0,0,0,0,0
400915261,Wake Forest Demon Deacons,TEAM,TOTAL,TOTAL,False,,27,57,16,31,11,26,21,25,3,38,41,21,3,6,14,15,86
400915261,Coastal Carolina Chanticleers,D. Beck,4067319,,True,23.0,5,16,3,9,2,7,1,2,2,4,6,1,2,0,4,2,13
400915261,Coastal Carolina Chanticleers,A. Bamba,4067318,,True,27.0,2,5,2,5,0,0,0,2,2,5,7,0,0,1,0,5,4
400915261,Coastal Carolina Chanticleers,C. Ray-St Cyr,66566,,True,35.0,4,9,2,5,2,4,2,3,4,9,13,6,4,0,1,2,12
400915261,Coastal Carolina Chanticleers,E. Wilson,66565,,True,35.0,7,21,3,9,4,12,2,2,0,7,7,3,0,0,3,2,20
400915261,Coastal Carolina Chanticleers,J. Shaw,66268,,True,36.0,3,11,1,7,2,4,2,2,1,1,2,8,3,0,1,2,10
400915261,Coastal Carolina Chanticleers,J. Williams-Powell,4067316,,False,24.0,4,8,3,7,1,1,1,3,0,3,3,0,0,0,1,4,10
400915261,Coastal Carolina Chanticleers,J. Coleman,3913168,,False,4.0,1,1,1,1,0,0,0,0,0,0,0,0,0,0,0,2,2
400915261,Coastal Carolina Chanticleers,A. Labinowicz,4067315,,False,12.0,1,1,0,0,1,1,0,0,0,0,0,0,1,0,1,1,3
400915261,Coastal Carolina Chanticleers,J. Robertson,4067314,,False,4.0,0,1,0,1,0,0,0,0,0,0,0,0,0,0,1,2,0
400915261,Coastal Carolina Chanticleers,TEAM,TOTAL,TOTAL,False,,27,73,15,44,12,29,8,14,12,29,41,18,10,1,12,22,74
400915260,Towson Tigers,A. Thomas,3912285,,True,23.0,1,1,1,1,0,0,2,3,1,3,4,1,0,1,0,3,4
400915260,Towson Tigers,A. Adala Moto,61166,,True,32.0,7,16,6,13,1,3,5,8,0,5,5,2,3,0,1,4,20
400915260,Towson Tigers,E. Keith II,3147466,,True,31.0,1,3,0,0,1,3,0,0,0,3,3,5,0,1,0,2,3
400915260,Towson Tigers,M. Morsell,3147465,,True,35.0,7,15,4,8,3,7,5,6,1,0,1,2,1,0,4,3,22
400915260,Towson Tigers,D. Morman,66974,,True,24.0,1,5,1,4,0,1,1,2,1,2,3,2,0,0,2,4,3
400915260,Towson Tigers,J. Gorham,4067322,,False,6.0,0,1,0,1,0,0,0,0,2,1,3,0,0,0,1,1,0
400915260,Towson Tigers,D. Tunstall,3912284,,False,2.0,0,0,0,0,0,0,0,0,0,0,0,0,0,0,0,0,0
400915260,Towson Tigers,J. Davis,67181,,False,17.0,4,7,4,6,0,1,1,2,2,3,5,0,1,0,0,3,9
400915260,Towson Tigers,B. Starr,4067323,,False,12.0,0,1,0,0,0,1,1,2,0,0,0,0,1,0,0,1,1
400915260,Towson Tigers,Z. Martin,4067320,,False,6.0,0,0,0,0,0,0,2,2,0,0,0,1,0,0,0,2,2
400915260,Towson Tigers,J. McNeil,3147464,,False,12.0,2,3,0,0,2,3,0,0,0,0,0,1,1,0,2,3,6
400915260,Towson Tigers,TEAM,TOTAL,TOTAL,False,,23,52,16,33,7,19,17,25,8,18,26,14,7,2,10,26,70
400915260,Boston College Eagles,A.J. Turner,3943608,,True,23.0,0,2,0,1,0,1,0,0,0,1,1,3,0,0,0,2,0
400915260,Boston College Eagles,M. Jeffers,61901,,True,27.0,1,4,1,4,0,0,2,2,1,5,6,0,0,1,4,4,4
400915260,Boston College Eagles,C. Tava,61446,,True,32.0,4,6,4,6,0,0,5,5,2,6,8,3,2,0,1,1,13
400915260,Boston College Eagles,K. Bowman,4065635,,True,18.0,2,6,1,3,1,3,9,11,1,3,4,3,1,0,1,4,14
400915260,Boston College Eagles,J. Robinson,3943606,,True,36.0,8,16,7,11,1,5,7,8,1,4,5,4,1,1,1,2,24
400915260,Boston College Eagles,J. Reyes,3943609,,False,3.0,0,0,0,0,0,0,0,0,0,0,0,0,0,0,0,1,0
400915260,Boston College Eagles,N. Popovic,4065637,,False,14.0,3,3,2,2,1,1,0,0,1,1,2,0,0,0,1,4,7
400915260,Boston College Eagles,G. Owens,66277,,False,10.0,0,1,0,0,0,1,2,2,1,2,3,1,0,0,1,2,2
400915260,Boston College Eagles,T. Graves,4065636,,False,13.0,2,4,0,0,2,4,0,0,0,1,1,2,0,0,1,2,6
400915260,Boston College Eagles,G. Gehan,3943611,,False,0.0,0,0,0,0,0,0,0,0,0,0,0,0,0,0,0,0,0
400915260,Boston College Eagles,J. Chatman,3135095,,False,24.0,3,8,1,3,2,5,2,2,0,1,1,2,0,1,3,0,10
400915260,Boston College Eagles,TEAM,TOTAL,TOTAL,False,,23,50,16,30,7,20,27,30,10,26,36,18,4,3,13,22,80
400915259,Virginia Cavaliers,I. Wilkins,3138203,,True,17.0,2,3,2,2,0,1,0,0,1,1,2,0,3,2,0,0,4
400915259,Virginia Cavaliers,J. Salt,3138200,,True,16.0,1,2,1,2,0,0,0,2,0,3,3,1,1,0,1,2,2
400915259,Virginia Cavaliers,D. Thompson,66274,,True,16.0,4,7,2,3,2,4,2,2,1,3,4,1,0,0,0,0,12
400915259,Virginia Cavaliers,L. Perrantes,66139,,True,17.0,2,3,1,1,1,2,1,2,1,3,4,4,1,0,2,1,6
400915259,Virginia Cavaliers,D. Hall,66138,,True,16.0,2,5,1,2,1,3,0,0,0,2,2,3,0,0,0,0,5
400915259,Virginia Cavaliers,M. Diakite,3947156,,False,16.0,4,4,4,4,0,0,0,0,2,2,4,0,0,3,0,2,8
400915259,Virginia Cavaliers,J. Reuter,3908374,,False,19.0,1,1,1,1,0,0,2,2,1,7,8,4,1,0,1,1,4
400915259,Virginia Cavaliers,J. Jones,67567,,False,10.0,1,3,0,1,1,2,0,0,0,1,1,0,0,0,0,2,3
400915259,Virginia Cavaliers,T. Jerome,4065733,,False,23.0,2,5,0,0,2,5,0,0,0,1,1,5,1,0,2,1,6
400915259,Virginia Cavaliers,K. Guy,4065730,,False,13.0,6,7,1,1,5,6,3,3,0,2,2,3,1,0,0,2,20
400915259,Virginia Cavaliers,T. Gross Jr.,4065729,,False,11.0,1,8,0,2,1,6,0,1,2,2,4,1,1,0,2,1,3
400915259,Virginia Cavaliers,J. Bartley,3947155,,False,12.0,2,5,1,1,1,4,0,0,0,3,3,1,0,1,3,3,5
400915259,Virginia Cavaliers,M. Shayok,3138201,,False,14.0,5,7,5,6,0,1,2,2,0,2,2,0,2,0,0,0,12
400915259,Virginia Cavaliers,TEAM,TOTAL,TOTAL,False,,33,60,19,26,14,34,10,14,10,34,44,23,11,6,11,15,90
400915259,Grambling Tigers,A. Ugba,4072628,,True,25.0,1,3,1,2,0,1,0,2,4,1,5,1,1,0,2,1,2
400915259,Grambling Tigers,D. Hearns,3947708,,True,24.0,2,7,2,6,0,1,0,0,1,3,4,0,1,0,3,1,4
400915259,Grambling Tigers,E. Mitchell,3947703,,True,19.0,0,6,0,5,0,1,1,2,0,1,1,0,0,0,1,3,1
400915259,Grambling Tigers,R. Brown,68127,,True,28.0,2,8,2,5,0,3,0,0,1,3,4,0,0,0,5,1,4
400915259,Grambling Tigers,C. Cormier,68118,,True,25.0,1,4,0,3,1,1,0,0,0,3,3,0,0,0,2,1,3
400915259,Grambling Tigers,D. Jones,3137770,,False,2.0,0,1,0,1,0,0,0,0,1,0,1,0,1,0,2,1,0
400915259,Grambling Tigers,N. Cummings,4072619,,False,14.0,0,0,0,0,0,0,0,0,0,0,0,0,0,0,0,1,0
400915259,Grambling Tigers,D. Wilks,4072629,,False,12.0,1,4,0,1,1,3,3,4,0,2,2,1,2,0,1,1,6
400915259,Grambling Tigers,M. Thompson,4072627,,False,14.0,3,5,2,2,1,3,1,2,0,1,1,1,0,0,1,1,8
400915259,Grambling Tigers,I. Smith Jr.,4072626,,False,7.0,0,3,0,1,0,2,0,0,0,0,0,0,1,0,2,2,0
400915259,Grambling Tigers,C. Simmons,4072625,,False,5.0,0,1,0,1,0,0,0,0,0,1,1,0,0,0,1,0,0
400915259,Grambling Tigers,X. Larry,4072623,,False,7.0,0,0,0,0,0,0,0,0,0,1,1,0,0,1,1,1,0
400915259,Grambling Tigers,A. Gaston,4072622,,False,9.0,0,4,0,4,0,0,1,2,0,3,3,0,1,0,0,1,1
400915259,Grambling Tigers,C. Lowe,3158666,,False,9.0,2,6,1,4,1,2,0,0,1,1,2,0,0,0,0,0,5
400915259,Grambling Tigers,TEAM,TOTAL,TOTAL,False,,12,52,8,35,4,17,6,12,10,20,30,3,7,1,21,15,34
400915258,Syracuse Orange,T. Lydon,3934662,,True,25.0,4,6,0,1,4,5,2,4,3,7,10,1,1,0,0,0,14
400915258,Syracuse Orange,T. Roberson,67633,,True,19.0,4,9,4,9,0,0,5,5,5,7,12,2,0,1,1,1,13
400915258,Syracuse Orange,D. Coleman,61821,,True,12.0,3,4,3,4,0,0,1,2,1,3,4,0,0,0,2,2,7
400915258,Syracuse Orange,F. Howard,3934659,,True,22.0,4,7,2,3,2,4,0,1,0,4,4,11,1,0,1,1,10
400915258,Syracuse Orange,A. White III,61616,,True,21.0,5,10,2,3,3,7,2,4,0,3,3,2,0,1,1,2,15
400915258,Syracuse Orange,T. Thompson,4065721,,False,24.0,5,7,5,7,0,0,2,2,0,4,4,1,0,4,1,2,12
400915258,Syracuse Orange,D. Akintobi-Adeyeye,3155403,,False,3.0,1,2,1,2,0,0,0,0,0,0,0,0,0,0,0,3,2
400915258,Syracuse Orange,P. Chukwu,3136471,,False,25.0,2,3,2,3,0,0,0,1,5,2,7,1,0,4,3,4,4
400915258,Syracuse Orange,R. Featherston,4065723,,False,2.0,1,1,0,0,1,1,0,0,0,0,0,0,0,0,0,0,3
400915258,Syracuse Orange,T. Battle,4065722,,False,16.0,2,4,1,2,1,2,0,0,0,1,1,1,0,1,0,1,5
400915258,Syracuse Orange,J. Radner,3934666,,False,2.0,0,2,0,1,0,1,0,0,0,1,1,1,0,0,0,0,0
400915258,Syracuse Orange,K. Feldman,3934665,,False,2.0,0,0,0,0,0,0,0,0,0,0,0,0,0,0,0,0,0
400915258,Syracuse Orange,E. Dourdas,3934664,,False,1.0,0,0,0,0,0,0,0,0,0,0,0,0,0,0,0,0,0
400915258,Syracuse Orange,A. Autry,3934661,,False,1.0,1,1,1,1,0,0,0,0,0,0,0,0,0,0,0,0,2
400915258,Syracuse Orange,S. Belbey,3934660,,False,2.0,0,0,0,0,0,0,0,0,0,0,0,0,0,0,0,0,0
400915258,Syracuse Orange,M. Sutton,3153164,,False,3.0,0,0,0,0,0,0,0,0,0,1,1,1,0,0,0,0,0
400915258,Syracuse Orange,J. Gillon,61915,,False,20.0,5,12,3,8,2,4,2,2,0,1,1,4,3,0,1,0,14
400915258,Syracuse Orange,TEAM,TOTAL,TOTAL,False,,37,68,24,44,13,24,14,21,15,39,54,25,5,11,10,16,101
400915258,South Carolina State Bulldogs,I. Kinard,4067966,,True,21.0,0,2,0,2,0,0,2,4,2,2,4,0,0,1,0,2,2
400915258,South Carolina State Bulldogs,T. Riley,3155580,,True,13.0,1,5,1,4,0,1,1,2,0,1,1,0,0,0,0,5,3
400915258,South Carolina State Bulldogs,E. Eaves,3947061,,True,25.0,2,12,2,8,0,4,4,4,0,3,3,3,0,0,0,1,8
400915258,South Carolina State Bulldogs,E. Stephens,3155579,,True,24.0,1,9,0,2,1,7,2,2,1,2,3,2,2,0,0,1,5
400915258,South Carolina State Bulldogs,G. Mortimer,67580,,True,22.0,3,7,2,4,1,3,0,2,0,2,2,2,2,0,1,1,7
400915258,South Carolina State Bulldogs,D. Applewhite,4067967,,False,10.0,0,2,0,2,0,0,0,0,0,0,0,0,0,0,0,0,0
400915258,South Carolina State Bulldogs,D. Bottenberg,4067965,,False,3.0,1,1,1,1,0,0,0,0,0,1,1,0,0,1,0,0,2
400915258,South Carolina State Bulldogs,O. Fields,4067962,,False,25.0,5,10,5,10,0,0,1,2,5,1,6,0,0,0,3,3,11
400915258,South Carolina State Bulldogs,J. Raynor-Powell,4067964,,False,26.0,3,9,1,5,2,4,0,0,0,1,1,0,2,0,2,3,8
400915258,South Carolina State Bulldogs,J. Richardson,4067963,,False,23.0,3,12,2,5,1,7,2,2,3,0,3,3,2,1,2,2,9
400915258,South Carolina State Bulldogs,E. Jones,4067961,,False,3.0,0,0,0,0,0,0,4,4,0,2,2,1,0,0,0,0,4
400915258,South Carolina State Bulldogs,B. Williams,3167479,,False,5.0,0,1,0,0,0,1,0,0,0,0,0,1,0,0,0,0,0
400915258,South Carolina State Bulldogs,TEAM,TOTAL,TOTAL,False,,19,70,14,43,5,27,16,22,14,18,32,12,8,3,10,18,59
400915257,Yale Bulldogs,B. Reynolds,3906996,,True,31.0,5,10,1,4,4,6,0,0,4,2,6,2,0,0,0,2,14
400915257,Yale Bulldogs,S. Downey,66858,,True,37.0,8,15,8,15,0,0,1,2,2,2,4,0,1,0,1,3,17
400915257,Yale Bulldogs,M. Oni,4066851,,True,27.0,4,12,1,3,3,9,2,2,0,11,11,1,0,2,3,2,13
400915257,Yale Bulldogs,T. Phills,3906995,,True,20.0,1,6,1,4,0,2,0,0,0,5,5,2,0,0,1,3,2
400915257,Yale Bulldogs,A. Dallier,66857,,True,31.0,2,6,0,2,2,4,0,0,1,2,3,5,0,2,1,5,6
400915257,Yale Bulldogs,A. Williams,4066849,,False,11.0,0,2,0,1,0,1,0,0,0,0,0,3,0,0,0,3,0
400915257,Yale Bulldogs,E. Anderson,3138262,,False,16.0,1,3,1,3,0,0,0,0,0,2,2,0,0,0,0,0,2
400915257,Yale Bulldogs,A. Copeland,3906992,,False,27.0,6,13,4,8,2,5,2,2,0,2,2,3,1,0,1,1,16
400915257,Yale Bulldogs,TEAM,TOTAL,TOTAL,False,,27,67,16,40,11,27,5,6,10,26,36,16,2,4,8,19,70
400915257,Pittsburgh Panthers,M. Young,66290,,True,35.0,9,15,9,14,0,1,6,6,4,6,10,3,0,4,1,1,24
400915257,Pittsburgh Panthers,S. Jeter,61756,,True,27.0,2,5,2,3,0,2,0,2,1,6,7,0,1,0,1,1,4
400915257,Pittsburgh Panthers,J. Artis,66287,,True,30.0,7,15,7,12,0,3,6,7,1,5,6,4,2,0,0,3,20
400915257,Pittsburgh Panthers,C. Johnson,3138196,,True,27.0,4,7,0,2,4,5,3,4,0,4,4,1,0,0,1,3,15
400915257,Pittsburgh Panthers,C. Jones,61219,,True,37.0,2,8,2,7,0,1,1,2,0,4,4,2,0,2,0,1,5
400915257,Pittsburgh Panthers,R. Luther,3138197,,False,17.0,1,4,1,3,0,1,2,2,0,2,2,1,0,2,1,0,4
400915257,Pittsburgh Panthers,J. Kithcart,4065713,,False,15.0,0,2,0,1,0,1,0,0,0,0,0,2,0,0,0,0,0
400915257,Pittsburgh Panthers,J. Milligan,3934655,,False,9.0,1,2,0,1,1,1,0,0,0,1,1,0,0,0,0,0,3
400915257,Pittsburgh Panthers,D. Wilson,3934652,,False,3.0,0,0,0,0,0,0,0,0,0,0,0,0,0,0,0,0,0
400915257,Pittsburgh Panthers,TEAM,TOTAL,TOTAL,False,,26,58,21,43,5,15,18,23,7,30,37,13,3,8,5,9,75
400915256,Sam Houston Bearkats,A. Majauskas,67384,,True,21.0,3,8,3,7,0,1,0,0,3,4,7,1,0,1,1,4,6
400915256,Sam Houston Bearkats,T. Butler,3922239,,True,24.0,5,7,5,6,0,1,0,0,1,5,6,3,1,1,0,3,10
400915256,Sam Houston Bearkats,J. Dewey III,4067744,,True,27.0,6,10,6,10,0,0,3,6,1,1,2,6,1,0,4,4,15
400915256,Sam Houston Bearkats,D. Henderson,62489,,True,30.0,4,12,1,3,3,9,1,3,1,4,5,0,1,0,1,1,12
400915256,Sam Houston Bearkats,P. Baxter,62485,,True,18.0,2,4,1,1,1,3,0,0,1,1,2,2,0,0,1,5,5
400915256,Sam Houston Bearkats,C. Galbreath Jr.,4067745,,False,10.0,1,6,1,6,0,0,0,0,1,2,3,0,0,0,3,3,2
400915256,Sam Houston Bearkats,P. Jones Jr.,62770,,False,8.0,0,1,0,1,0,0,1,2,2,1,3,0,0,0,2,2,1
400915256,Sam Houston Bearkats,A. Almanza,3130721,,False,13.0,2,2,1,1,1,1,1,2,1,1,2,0,1,0,0,2,6
400915256,Sam Houston Bearkats,J. Spivey,3922244,,False,17.0,1,3,0,1,1,2,2,2,0,1,1,1,0,0,2,3,5
400915256,Sam Houston Bearkats,J. Williams,3155926,,False,16.0,3,6,3,5,0,1,2,3,1,1,2,1,0,0,1,1,8
400915256,Sam Houston Bearkats,C. Delaney,3134929,,False,15.0,1,5,0,1,1,4,0,0,0,1,1,1,1,0,0,2,3
400915256,Sam Houston Bearkats,J. Delaney,3130722,,False,1.0,0,1,0,0,0,1,0,0,0,0,0,0,0,0,0,1,0
400915256,Sam Houston Bearkats,TEAM,TOTAL,TOTAL,False,,28,65,21,42,7,23,10,18,13,22,35,15,5,2,16,31,73
400915256,Georgia Tech Yellow Jackets,Q. Stephens,66128,,True,34.0,3,11,1,6,2,5,2,4,1,9,10,2,4,0,4,2,10
400915256,Georgia Tech Yellow Jackets,B. Lammers,3135061,,True,37.0,6,8,6,8,0,0,7,9,2,6,8,2,0,6,1,2,19
400915256,Georgia Tech Yellow Jackets,J. Okogie,4065663,,True,26.0,5,10,4,8,1,2,5,7,0,3,3,1,0,1,1,4,16
400915256,Georgia Tech Yellow Jackets,J. Moore,4065662,,True,38.0,4,8,4,8,0,0,1,4,1,1,2,6,2,0,5,3,9
400915256,Georgia Tech Yellow Jackets,C. Heyward,61609,,True,34.0,3,8,2,6,1,2,3,4,1,4,5,3,1,0,1,4,10
400915256,Georgia Tech Yellow Jackets,S. Ogbonda,3904627,,False,3.0,0,0,0,0,0,0,0,0,0,0,0,0,1,0,0,0,0
400915256,Georgia Tech Yellow Jackets,A. Gueye,3135059,,False,6.0,1,1,1,1,0,0,0,0,1,1,2,0,0,0,0,1,2
400915256,Georgia Tech Yellow Jackets,T. Jackson,3135057,,False,19.0,5,5,3,3,2,2,3,8,0,0,0,2,0,1,1,2,15
400915256,Georgia Tech Yellow Jackets,J. Price,61778,,False,3.0,0,0,0,0,0,0,0,0,0,1,1,0,0,0,0,0,0
400915256,Georgia Tech Yellow Jackets,TEAM,TOTAL,TOTAL,False,,27,51,21,40,6,11,21,36,6,25,31,16,8,8,16,18,81
400915255,North Carolina Tar Heels,J. Jackson,3138156,,True,25.0,5,10,3,6,2,4,0,0,0,3,3,2,0,0,2,1,12
400915255,North Carolina Tar Heels,I. Hicks,66874,,True,27.0,8,13,8,13,0,0,6,8,1,5,6,0,0,0,1,0,22
400915255,North Carolina Tar Heels,K. Meeks,66873,,True,20.0,7,7,7,7,0,0,6,8,4,6,10,1,1,1,2,2,20
400915255,North Carolina Tar Heels,K. Williams,3911619,,True,27.0,3,6,2,3,1,3,0,0,3,1,4,2,3,1,3,2,7
400915255,North Carolina Tar Heels,J. Berry II,3138155,,True,23.0,3,8,1,3,2,5,0,0,1,3,4,4,4,0,1,1,8
400915255,North Carolina Tar Heels,A. Rohlman,4065677,,False,2.0,0,0,0,0,0,0,0,0,0,3,3,0,0,0,0,0,0
400915255,North Carolina Tar Heels,S. Rush,4065674,,False,2.0,0,0,0,0,0,0,1,2,0,0,0,0,0,0,0,0,1
400915255,North Carolina Tar Heels,T. Bradley,4065673,,False,18.0,5,6,5,6,0,0,4,6,5,3,8,0,0,0,1,2,14
400915255,North Carolina Tar Heels,S. Woods,4065676,,False,17.0,0,3,0,1,0,2,2,4,1,3,4,1,0,0,1,0,2
400915255,North Carolina Tar Heels,B. Robinson,4065675,,False,14.0,2,3,1,1,1,2,0,0,0,3,3,4,0,2,1,1,5
400915255,North Carolina Tar Heels,K. Coker,3947144,,False,1.0,0,0,0,0,0,0,0,0,0,0,0,0,0,0,0,0,0
400915255,North Carolina Tar Heels,N. Britt,66872,,False,16.0,3,7,2,3,1,4,1,2,0,2,2,3,3,0,1,4,8
400915255,North Carolina Tar Heels,S. White,56963,,False,8.0,1,1,1,1,0,0,3,4,0,0,0,1,1,0,0,2,5
400915255,North Carolina Tar Heels,TEAM,TOTAL,TOTAL,False,,37,64,30,44,7,20,23,34,17,35,52,18,12,4,13,15,104
400915255,Chaminade Silverswords,A. Pope,4075481,,True,31.0,3,8,2,6,1,2,5,6,1,4,5,2,2,0,1,3,12
400915255,Chaminade Silverswords,R. Goodwin,3954039,,True,29.0,7,13,4,9,3,4,1,2,1,2,3,1,1,0,2,3,18
400915255,Chaminade Silverswords,K. Shastri,3082052,,True,28.0,5,9,2,2,3,7,0,0,1,2,3,1,1,1,1,3,13
400915255,Chaminade Silverswords,K. Kuany,3082048,,True,27.0,4,11,2,3,2,8,0,0,0,4,4,0,0,0,2,2,10
400915255,Chaminade Silverswords,S. Daly,66697,,True,27.0,0,3,0,2,0,1,2,3,0,2,2,2,2,0,6,2,2
400915255,Chaminade Silverswords,M. Southard,3954040,,False,5.0,0,1,0,1,0,0,0,0,0,0,0,0,0,0,0,0,0
400915255,Chaminade Silverswords,M. Sakazaki,3082047,,False,1.0,0,1,0,0,0,1,0,0,0,0,0,0,0,0,0,0,0
400915255,Chaminade Silverswords,N. Pollard,3132468,,False,10.0,1,4,1,4,0,0,0,1,0,0,0,0,0,0,2,3,2
400915255,Chaminade Silverswords,M. Swain,3954041,,False,1.0,0,1,0,1,0,0,0,0,0,0,0,0,0,0,0,1,0
400915255,Chaminade Silverswords,K. Gilmore,3954038,,False,2.0,0,1,0,0,0,1,0,0,0,0,0,0,0,0,0,1,0
400915255,Chaminade Silverswords,T. Cartaino,3954037,,False,15.0,0,1,0,1,0,0,1,2,0,1,1,0,0,0,2,3,1
400915255,Chaminade Silverswords,K. Pu'ulei-Auld,3082053,,False,4.0,0,1,0,1,0,0,0,0,0,0,0,1,0,0,0,0,0
400915255,Chaminade Silverswords,D. Walker,66368,,False,20.0,1,4,0,0,1,4,0,0,0,1,1,0,0,0,1,3,3
400915255,Chaminade Silverswords,TEAM,TOTAL,TOTAL,False,,21,58,11,30,10,28,9,14,6,17,23,7,6,1,17,24,61
400915254,Notre Dame Fighting Irish,B. Colson,3138192,,True,27.0,6,13,5,12,1,1,9,9,4,8,12,0,2,1,2,4,22
400915254,Notre Dame Fighting Irish,M. Geben,3138191,,True,21.0,2,5,2,5,0,0,2,2,4,4,8,0,0,0,1,4,6
400915254,Notre Dame Fighting Irish,V.J. Beachem,66283,,True,37.0,5,15,3,8,2,7,5,5,1,6,7,1,1,1,1,2,17
400915254,Notre Dame Fighting Irish,M. Farrell,3138190,,True,32.0,7,13,5,9,2,4,4,4,0,1,1,6,3,0,0,3,20
400915254,Notre Dame Fighting Irish,S. Vasturia,66285,,True,33.0,6,14,6,11,0,3,5,5,0,0,0,3,1,0,1,1,17
400915254,Notre Dame Fighting Irish,A. Torres,66286,,False,18.0,0,3,0,3,0,0,0,2,2,4,6,0,0,0,1,4,0
400915254,Notre Dame Fighting Irish,M. Ryan,3908336,,False,6.0,1,1,0,0,1,1,0,0,0,0,0,0,0,0,0,2,3
400915254,Notre Dame Fighting Irish,T. Gibbs,4065703,,False,9.0,1,2,1,1,0,1,0,0,1,0,1,1,0,0,0,1,2
400915254,Notre Dame Fighting Irish,R. Pflueger,3908335,,False,17.0,0,0,0,0,0,0,2,2,1,2,3,0,0,0,0,2,2
400915254,Notre Dame Fighting Irish,TEAM,TOTAL,TOTAL,False,,28,66,22,49,6,17,27,29,14,27,41,11,7,2,8,23,89
400915254,Colorado Buffaloes,W. Gordon,61895,,True,19.0,2,4,2,4,0,0,0,0,1,3,4,0,1,1,0,4,4
400915254,Colorado Buffaloes,D. White,67845,,True,37.0,6,14,5,9,1,5,7,7,2,3,5,9,0,2,5,2,20
400915254,Colorado Buffaloes,G. King,66205,,True,28.0,7,16,4,10,3,6,0,0,4,9,13,1,0,0,4,3,17
400915254,Colorado Buffaloes,X. Johnson,61897,,True,30.0,8,15,6,11,2,4,5,6,4,3,7,2,0,0,0,3,23
400915254,Colorado Buffaloes,J. Fortune,61805,,True,27.0,1,4,1,1,0,3,2,2,0,1,1,1,0,0,1,1,4
400915254,Colorado Buffaloes,L. Siewert,4066352,,False,8.0,2,4,2,2,0,2,0,0,0,0,0,0,0,0,0,1,4
400915254,Colorado Buffaloes,T. Miller-Stewart,3134895,,False,14.0,1,4,1,4,0,0,0,0,1,2,3,0,0,0,0,0,2
400915254,Colorado Buffaloes,B. Peters,4066351,,False,18.0,2,4,1,2,1,2,2,2,1,1,2,1,0,0,0,3,7
400915254,Colorado Buffaloes,D. Brown,4066349,,False,7.0,0,1,0,1,0,0,2,2,0,1,1,0,0,0,0,2,2
400915254,Colorado Buffaloes,T. Akyazili,3907517,,False,12.0,0,3,0,3,0,0,0,0,0,2,2,1,0,0,0,1,0
400915254,Colorado Buffaloes,TEAM,TOTAL,TOTAL,False,,29,69,22,47,7,22,18,19,13,25,38,15,1,3,10,20,83
400915253,Stony Brook Seawolves,T. Sturdivant,3130761,,True,27.0,9,15,9,15,0,0,8,11,5,2,7,0,0,1,0,3,26
400915253,Stony Brook Seawolves,A. Yeboah,3913169,,True,25.0,3,12,0,5,3,7,1,4,2,3,5,0,0,0,0,3,10
400915253,Stony Brook Seawolves,J. Saintel,4066767,,True,20.0,1,7,1,6,0,1,0,0,2,5,7,1,0,0,2,1,2
400915253,Stony Brook Seawolves,U. Iroegbu,4066765,,True,17.0,2,5,0,1,2,4,0,0,0,0,0,2,0,0,0,5,6
400915253,Stony Brook Seawolves,L. Woodhouse,61244,,True,30.0,4,8,4,7,0,1,1,1,0,3,3,7,1,0,3,5,9
400915253,Stony Brook Seawolves,J. Petras,3155385,,False,13.0,2,4,2,4,0,0,2,3,1,1,2,1,0,0,0,1,6
400915253,Stony Brook Seawolves,M. Almonacy,4066766,,False,15.0,2,4,2,2,0,2,0,1,0,0,0,2,1,0,0,2,4
400915253,Stony Brook Seawolves,B. Sekunda,3130762,,False,16.0,1,6,0,1,1,5,0,0,2,3,5,2,0,0,0,0,3
400915253,Stony Brook Seawolves,R. Nyama,66497,,False,21.0,3,10,3,6,0,4,1,1,0,2,2,2,1,0,1,0,7
400915253,Stony Brook Seawolves,K. Mitchell,65986,,False,16.0,0,2,0,0,0,2,2,2,0,2,2,1,3,0,0,4,2
400915253,Stony Brook Seawolves,TEAM,TOTAL,TOTAL,False,,27,73,21,47,6,26,15,23,15,22,37,18,6,1,7,24,75
400915253,Boston College Eagles,A.J. Turner,3943608,,True,30.0,4,6,2,3,2,3,2,2,0,4,4,4,0,1,2,1,12
400915253,Boston College Eagles,M. Jeffers,61901,,True,18.0,4,8,4,8,0,0,2,5,3,5,8,1,0,0,2,4,10
400915253,Boston College Eagles,C. Tava,61446,,True,26.0,1,2,1,2,0,0,5,8,1,7,8,1,1,0,2,2,7
400915253,Boston College Eagles,T. Graves,4065636,,True,20.0,1,2,1,2,0,0,0,0,0,1,1,2,0,0,3,1,2
400915253,Boston College Eagles,J. Robinson,3943606,,True,34.0,8,17,8,14,0,3,6,9,0,8,8,5,2,1,2,1,22
400915253,Boston College Eagles,J. Reyes,3943609,,False,8.0,1,3,1,3,0,0,0,0,0,1,1,1,0,0,0,2,2
400915253,Boston College Eagles,M. Sagay,4065638,,False,4.0,1,2,0,1,1,1,3,4,1,1,2,0,0,0,0,2,6
400915253,Boston College Eagles,N. Popovic,4065637,,False,13.0,6,7,5,6,1,1,0,0,2,3,5,0,0,2,1,4,13
400915253,Boston College Eagles,G. Owens,66277,,False,18.0,0,1,0,1,0,0,1,4,0,1,1,0,0,1,0,0,1
400915253,Boston College Eagles,K. Bowman,4065635,,False,9.0,0,0,0,0,0,0,0,0,0,1,1,1,0,0,0,3,0
400915253,Boston College Eagles,J. Chatman,3135095,,False,20.0,1,2,0,1,1,1,4,4,0,4,4,0,0,0,3,0,7
400915253,Boston College Eagles,TEAM,TOTAL,TOTAL,False,,27,50,22,41,5,9,23,36,8,37,45,15,3,5,15,20,82
400915252,Yale Bulldogs,B. Reynolds,3906996,,True,33.0,4,11,2,5,2,6,0,0,2,5,7,1,2,0,4,2,10
400915252,Yale Bulldogs,S. Downey,66858,,True,32.0,2,10,2,9,0,1,0,0,0,0,0,0,0,1,1,2,4
400915252,Yale Bulldogs,M. Oni,4066851,,True,25.0,1,8,0,4,1,4,0,0,0,7,7,2,0,0,2,2,3
400915252,Yale Bulldogs,T. Phills,3906995,,True,26.0,2,3,2,3,0,0,2,2,1,1,2,2,0,1,0,1,6
400915252,Yale Bulldogs,A. Dallier,66857,,True,33.0,2,3,2,3,0,0,0,0,1,3,4,2,1,0,4,2,4
400915252,Yale Bulldogs,A. Williams,4066849,,False,10.0,0,2,0,2,0,0,0,0,0,1,1,0,0,0,0,0,0
400915252,Yale Bulldogs,E. Anderson,3138262,,False,13.0,0,2,0,1,0,1,0,2,1,1,2,0,1,0,1,1,0
400915252,Yale Bulldogs,E. Monroe,4066848,,False,4.0,1,1,0,0,1,1,0,0,0,0,0,0,1,0,1,1,3
400915252,Yale Bulldogs,A. Copeland,3906992,,False,24.0,4,8,4,6,0,2,0,0,1,1,2,0,0,0,0,2,8
400915252,Yale Bulldogs,TEAM,TOTAL,TOTAL,False,,16,48,12,33,4,15,2,4,8,20,28,7,5,2,14,13,38
400915252,Virginia Cavaliers,I. Wilkins,3138203,,True,27.0,2,5,2,5,0,0,1,1,5,4,9,3,2,1,0,1,5
400915252,Virginia Cavaliers,J. Salt,3138200,,True,20.0,2,6,2,6,0,0,0,0,3,2,5,0,0,1,1,3,4
400915252,Virginia Cavaliers,D. Thompson,66274,,True,23.0,5,8,4,4,1,4,0,0,0,0,0,3,1,0,4,1,11
400915252,Virginia Cavaliers,L. Perrantes,66139,,True,30.0,3,9,1,2,2,7,0,0,0,1,1,7,1,0,0,0,8
400915252,Virginia Cavaliers,D. Hall,66138,,True,22.0,0,5,0,3,0,2,0,0,0,1,1,2,1,0,1,0,0
400915252,Virginia Cavaliers,M. Diakite,3947156,,False,18.0,2,4,2,4,0,0,1,2,2,5,7,0,0,4,0,2,5
400915252,Virginia Cavaliers,J. Reuter,3908374,,False,15.0,1,3,1,3,0,0,0,0,1,3,4,0,0,0,0,0,2
400915252,Virginia Cavaliers,T. Jerome,4065733,,False,5.0,0,1,0,0,0,1,0,0,0,0,0,0,0,0,0,0,0
400915252,Virginia Cavaliers,K. Guy,4065730,,False,16.0,3,4,1,1,2,3,4,4,0,3,3,0,0,0,0,1,12
400915252,Virginia Cavaliers,T. Gross Jr.,4065729,,False,2.0,0,1,0,1,0,0,0,0,0,0,0,0,1,0,0,0,0
400915252,Virginia Cavaliers,J. Bartley,3947155,,False,2.0,0,0,0,0,0,0,0,0,0,0,0,0,0,0,1,2,0
400915252,Virginia Cavaliers,M. Shayok,3138201,,False,20.0,6,14,5,11,1,3,2,2,1,3,4,2,0,1,0,0,15
400915252,Virginia Cavaliers,TEAM,TOTAL,TOTAL,False,,24,60,18,40,6,20,8,9,16,25,41,17,6,7,7,10,62
400915251,Florida State Seminoles,J. Isaac,4065654,,True,25.0,7,12,7,10,0,2,0,0,4,6,10,2,1,1,1,2,14
400915251,Florida State Seminoles,M. Ojo,61596,,True,14.0,2,4,2,4,0,0,0,1,2,5,7,0,0,1,0,1,4
400915251,Florida State Seminoles,T. Mann,3907823,,True,30.0,3,6,3,5,0,1,5,5,0,4,4,2,0,0,1,1,11
400915251,Florida State Seminoles,D. Bacon,3907821,,True,28.0,9,15,9,12,0,3,4,4,1,0,1,1,2,0,2,0,22
400915251,Florida State Seminoles,X. Rathan-Mayes,66125,,True,23.0,3,8,2,4,1,4,3,6,0,2,2,4,2,0,2,2,10
400915251,Florida State Seminoles,J. Smith,66126,,False,12.0,3,4,3,4,0,0,2,2,1,2,3,1,0,3,0,2,8
400915251,Florida State Seminoles,B. Allen,66124,,False,5.0,0,3,0,1,0,2,0,0,0,0,0,0,0,0,0,1,0
400915251,Florida State Seminoles,C. Koumadje,3907824,,False,13.0,3,4,3,4,0,0,0,0,2,3,5,0,0,1,1,1,6
400915251,Florida State Seminoles,B. Angola-Rodas,4065658,,False,18.0,2,4,2,3,0,1,0,0,0,3,3,2,1,0,1,1,4
400915251,Florida State Seminoles,T. Forrest,4065656,,False,20.0,6,7,6,7,0,0,0,2,1,2,3,5,4,0,0,1,12
400915251,Florida State Seminoles,C. Walker,4065655,,False,12.0,2,3,2,2,0,1,5,6,0,1,1,1,1,0,0,2,9
400915251,Florida State Seminoles,TEAM,TOTAL,TOTAL,False,,40,70,39,56,1,14,19,26,12,29,41,18,11,6,8,14,100
400915251,Detroit Mercy Titans,J. Hogan,3133891,,True,20.0,5,8,5,8,0,0,2,4,1,0,1,0,0,0,1,3,12
400915251,Detroit Mercy Titans,C. Jenkins,61896,,True,31.0,7,15,5,10,2,5,2,3,2,4,6,2,0,0,3,4,18
400915251,Detroit Mercy Titans,C. Allen,4067418,,True,30.0,3,14,3,12,0,2,0,0,1,4,5,1,0,0,1,1,6
400915251,Detroit Mercy Titans,J. McFolley,3936019,,True,23.0,2,7,0,1,2,6,1,4,0,1,1,4,1,0,6,2,7
400915251,Detroit Mercy Titans,J. Williams,66795,,True,18.0,1,4,1,4,0,0,0,0,1,2,3,2,0,0,1,4,2
400915251,Detroit Mercy Titans,C. Long,4067421,,False,9.0,0,2,0,1,0,1,2,2,0,2,2,0,1,0,1,0,2
400915251,Detroit Mercy Titans,M. Eichler,4067420,,False,7.0,2,2,1,1,1,1,0,0,0,0,0,0,0,0,0,0,5
400915251,Detroit Mercy Titans,G. Blackshear Jr.,3936020,,False,14.0,0,0,0,0,0,0,0,0,1,0,1,1,1,2,0,2,0
400915251,Detroit Mercy Titans,A. Foster-Smith,3133890,,False,15.0,3,4,3,4,0,0,0,0,4,3,7,0,0,0,1,2,6
400915251,Detroit Mercy Titans,E. Carter III,4067424,,False,12.0,2,5,0,1,2,4,0,0,1,1,2,1,1,0,2,2,6
400915251,Detroit Mercy Titans,D. Black,4067419,,False,18.0,2,5,2,4,0,1,0,0,0,0,0,3,0,0,0,2,4
400915251,Detroit Mercy Titans,P. Robinson Jr.,3948162,,False,3.0,1,2,0,0,1,2,0,0,0,1,1,0,0,0,0,0,3
400915251,Detroit Mercy Titans,TEAM,TOTAL,TOTAL,False,,28,68,20,46,8,22,7,13,12,19,31,14,4,2,16,22,71
400915250,Virginia Tech Hokies,K. Sy,4065740,,True,13.0,3,5,3,5,0,0,0,0,0,2,2,0,0,1,1,2,6
400915250,Virginia Tech Hokies,C. Clarke,3945567,,True,36.0,6,9,6,7,0,2,1,2,1,6,7,5,1,1,3,3,13
400915250,Virginia Tech Hokies,J. Robinson,3945566,,True,26.0,1,5,0,2,1,3,3,5,1,4,5,6,1,0,3,4,6
400915250,Virginia Tech Hokies,A. Hill,3147501,,True,19.0,2,6,1,2,1,4,1,3,0,0,0,0,0,0,0,4,6
400915250,Virginia Tech Hokies,J. Bibbs,3147500,,True,37.0,5,7,2,2,3,5,0,0,0,2,2,1,0,0,3,2,13
400915250,Virginia Tech Hokies,Z. LeDay,61698,,False,31.0,7,11,7,11,0,0,9,14,3,9,12,2,0,1,0,1,23
400915250,Virginia Tech Hokies,M. Galloway,3945565,,False,1.0,0,0,0,0,0,0,0,0,0,0,0,0,0,0,0,0,0
400915250,Virginia Tech Hokies,T. Outlaw,67275,,False,8.0,2,3,0,0,2,3,0,0,0,2,2,0,0,1,0,0,6
400915250,Virginia Tech Hokies,S. Allen,61795,,False,29.0,7,9,7,9,0,0,1,5,0,1,1,5,0,0,2,3,15
400915250,Virginia Tech Hokies,TEAM,TOTAL,TOTAL,False,,33,55,26,38,7,17,15,29,8,26,34,19,2,4,12,19,88
400915250,VMI Keydets,F. Iruafemi,3155938,,True,19.0,3,4,3,4,0,0,0,0,1,1,2,2,2,1,1,4,6
400915250,VMI Keydets,T. Chapman,66637,,True,37.0,5,12,5,10,0,2,0,0,2,4,6,0,1,1,4,4,10
400915250,VMI Keydets,A. Rich,3948858,,True,25.0,3,5,1,1,2,4,2,2,0,1,1,4,1,0,1,2,10
400915250,VMI Keydets,J. Eleby,66641,,True,34.0,3,7,2,2,1,5,0,1,0,3,3,4,0,0,1,2,7
400915250,VMI Keydets,Q. Peterson,66639,,True,38.0,9,20,6,13,3,7,8,10,2,6,8,6,0,0,1,1,29
400915250,VMI Keydets,W. Miller,4067635,,False,7.0,0,2,0,2,0,0,0,1,1,1,2,0,0,0,2,4,0
400915250,VMI Keydets,A. Branch,3155936,,False,7.0,0,1,0,1,0,0,0,0,1,0,1,0,0,0,0,2,0
400915250,VMI Keydets,T. Creammer,4067636,,False,2.0,0,0,0,0,0,0,0,0,0,0,0,0,0,0,1,2,0
400915250,VMI Keydets,C. Enechionyia,4067633,,False,1.0,0,0,0,0,0,0,0,0,0,0,0,0,0,0,0,0,0
400915250,VMI Keydets,G. Gilkeson,4067632,,False,12.0,2,4,0,1,2,3,1,1,0,1,1,1,0,0,0,0,7
400915250,VMI Keydets,K. Smith,4067631,,False,14.0,1,3,0,1,1,2,0,0,0,0,0,0,0,1,1,3,3
400915250,VMI Keydets,A. Vereen,3948857,,False,4.0,0,1,0,0,0,1,0,0,0,0,0,0,0,0,0,1,0
400915250,VMI Keydets,TEAM,TOTAL,TOTAL,False,,26,59,17,35,9,24,11,15,9,19,28,17,4,3,12,25,72
400915249,Pennsylvania Quakers,A. Brodeur,4066838,,True,34.0,5,11,5,11,0,0,6,8,5,3,8,3,1,2,5,2,16
400915249,Pennsylvania Quakers,C. Wood,4066843,,True,21.0,4,5,1,1,3,4,0,0,0,3,3,1,0,0,6,4,11
400915249,Pennsylvania Quakers,J. Donahue,3906968,,True,24.0,0,9,0,2,0,7,0,0,0,0,0,0,1,0,2,1,0
400915249,Pennsylvania Quakers,M. MacDonald,66938,,True,31.0,1,4,0,2,1,2,1,2,0,5,5,4,0,0,1,1,4
400915249,Pennsylvania Quakers,M. Howard,66854,,True,26.0,3,7,2,5,1,2,0,0,4,0,4,0,2,0,0,2,7
400915249,Pennsylvania Quakers,M. Rothschild,3906966,,False,16.0,0,2,0,2,0,0,2,2,0,2,2,1,1,1,3,1,2
400915249,Pennsylvania Quakers,S. Jones,3155744,,False,11.0,3,5,1,1,2,4,0,0,0,1,1,0,0,0,1,1,8
400915249,Pennsylvania Quakers,J. Silpe,3906967,,False,2.0,0,0,0,0,0,0,0,0,0,0,0,0,0,0,0,0,0
400915249,Pennsylvania Quakers,D. Foreman,3155741,,False,23.0,3,6,2,4,1,2,0,1,1,4,5,3,1,1,2,2,7
400915249,Pennsylvania Quakers,D. Goodman,4066839,,False,3.0,1,3,1,2,0,1,0,0,0,0,0,0,1,0,0,0,2
400915249,Pennsylvania Quakers,T. Hamilton,3906969,,False,9.0,2,4,1,3,1,1,0,0,0,1,1,0,2,0,0,0,5
400915249,Pennsylvania Quakers,TEAM,TOTAL,TOTAL,False,,22,56,13,33,9,23,9,13,12,22,34,12,9,4,21,14,62
400915249,Miami Hurricanes,K. Murphy,61668,,True,26.0,3,7,3,6,0,1,0,0,4,4,8,2,1,0,1,4,6
400915249,Miami Hurricanes,A. Lawrence II,3904628,,True,33.0,0,3,0,2,0,1,0,0,0,3,3,2,4,1,3,3,0
400915249,Miami Hurricanes,B. Brown,4065670,,True,27.0,6,10,5,7,1,3,2,2,2,3,5,1,3,3,1,2,15
400915249,Miami Hurricanes,J. Newton,3138145,,True,34.0,6,16,5,13,1,3,5,6,0,4,4,3,3,0,5,0,18
400915249,Miami Hurricanes,D. Reed,66130,,True,34.0,3,12,2,5,1,7,4,4,0,7,7,1,0,1,2,1,11
400915249,Miami Hurricanes,D. Hernandez,4065672,,False,24.0,5,6,5,6,0,0,1,1,5,0,5,0,0,0,2,2,11
400915249,Miami Hurricanes,R. Miller Jr.,4065671,,False,4.0,1,1,1,1,0,0,0,0,0,0,0,0,0,0,0,1,2
400915249,Miami Hurricanes,D. Vasiljevic,4065669,,False,18.0,4,7,1,2,3,5,0,0,0,0,0,1,0,0,2,1,11
400915249,Miami Hurricanes,TEAM,TOTAL,TOTAL,False,,28,62,22,42,6,20,12,13,12,25,37,10,11,5,16,14,74
400915248,NC State Wolfpack,A. Abu,3138158,,True,37.0,8,10,8,9,0,1,9,10,2,6,8,1,1,0,4,2,25
400915248,NC State Wolfpack,B. Anya,66134,,True,29.0,2,4,2,4,0,0,2,2,1,4,5,1,0,2,0,1,6
400915248,NC State Wolfpack,D. Smith Jr.,4065697,,True,30.0,6,12,4,7,2,5,7,7,1,3,4,3,3,0,5,2,21
400915248,NC State Wolfpack,T. Dorn,3132359,,True,39.0,8,12,8,11,0,1,0,0,0,5,5,1,1,0,0,2,16
400915248,NC State Wolfpack,T. Henderson,61215,,True,31.0,2,8,1,2,1,6,3,4,0,0,0,1,1,1,3,2,8
400915248,NC State Wolfpack,D. Hicks,4065698,,False,7.0,0,0,0,0,0,0,0,2,1,0,1,0,0,0,0,0,0
400915248,NC State Wolfpack,M. Johnson,4065699,,False,27.0,4,5,3,4,1,1,0,2,0,2,2,6,4,1,0,1,9
400915248,NC State Wolfpack,TEAM,TOTAL,TOTAL,False,,30,51,26,37,4,14,21,27,5,21,26,13,10,4,13,11,85
400915248,Montana Grizzlies,F. Krslovic,3153168,,True,32.0,4,7,4,7,0,0,0,0,2,5,7,2,0,0,4,5,8
400915248,Montana Grizzlies,J. Lopez,66536,,True,18.0,3,7,2,4,1,3,0,0,1,2,3,1,0,0,0,3,7
400915248,Montana Grizzlies,W. Wright,3917346,,True,34.0,8,17,8,13,0,4,6,6,1,3,4,2,0,0,4,1,22
400915248,Montana Grizzlies,B. Moorehead,3917342,,True,18.0,0,3,0,1,0,2,0,0,0,2,2,0,0,0,0,0,0
400915248,Montana Grizzlies,A. Rorie,3134900,,True,36.0,5,11,1,3,4,8,1,1,0,2,2,3,0,0,4,3,15
400915248,Montana Grizzlies,J. Samuelson,3917344,,False,22.0,3,5,3,5,0,0,2,4,2,0,2,1,0,0,2,3,8
400915248,Montana Grizzlies,G. DeJong,3153170,,False,2.0,0,0,0,0,0,0,0,0,0,0,0,0,0,0,1,0,0
400915248,Montana Grizzlies,S. Pridgett,4066574,,False,24.0,5,5,5,5,0,0,2,2,0,1,1,1,0,0,2,3,12
400915248,Montana Grizzlies,M. Dunn,66539,,False,6.0,0,0,0,0,0,0,0,0,0,1,1,1,0,0,1,0,0
400915248,Montana Grizzlies,B. Gfeller,66538,,False,8.0,0,1,0,0,0,1,0,0,0,1,1,0,0,0,0,2,0
400915248,Montana Grizzlies,TEAM,TOTAL,TOTAL,False,,28,56,23,38,5,18,11,13,7,17,24,11,0,0,18,20,72
400915247,Syracuse Orange,T. Lydon,3934662,,True,32.0,2,9,2,7,0,2,2,2,2,5,7,3,2,4,2,2,6
400915247,Syracuse Orange,T. Roberson,67633,,True,25.0,2,4,2,4,0,0,2,2,1,3,4,0,0,2,1,3,6
400915247,Syracuse Orange,D. Coleman,61821,,True,15.0,2,7,2,7,0,0,3,4,4,4,8,0,0,0,1,3,7
400915247,Syracuse Orange,F. Howard,3934659,,True,23.0,3,6,2,3,1,3,1,2,1,2,3,6,1,1,2,3,8
400915247,Syracuse Orange,A. White III,61616,,True,36.0,6,15,3,6,3,9,3,4,1,5,6,4,2,0,3,1,18
400915247,Syracuse Orange,T. Thompson,4065721,,False,13.0,5,6,5,6,0,0,2,3,1,1,2,0,2,0,1,0,12
400915247,Syracuse Orange,D. Akintobi-Adeyeye,3155403,,False,1.0,0,1,0,1,0,0,0,0,0,0,0,0,0,1,1,0,0
400915247,Syracuse Orange,P. Chukwu,3136471,,False,10.0,0,0,0,0,0,0,0,0,1,3,4,0,1,2,2,1,0
400915247,Syracuse Orange,T. Battle,4065722,,False,20.0,3,4,0,0,3,4,0,1,0,3,3,1,2,0,0,2,9
400915247,Syracuse Orange,J. Radner,3934666,,False,1.0,0,0,0,0,0,0,0,0,0,1,1,0,0,0,0,0,0
400915247,Syracuse Orange,K. Feldman,3934665,,False,1.0,0,0,0,0,0,0,0,0,0,0,0,0,0,0,0,0,0
400915247,Syracuse Orange,A. Autry,3934661,,False,1.0,0,0,0,0,0,0,0,0,0,0,0,0,0,0,0,0,0
400915247,Syracuse Orange,S. Belbey,3934660,,False,1.0,0,0,0,0,0,0,0,0,0,0,0,0,0,0,0,0,0
400915247,Syracuse Orange,J. Gillon,61915,,False,21.0,2,7,1,2,1,5,0,0,2,0,2,1,0,0,2,1,5
400915247,Syracuse Orange,TEAM,TOTAL,TOTAL,False,,25,59,17,36,8,23,13,18,14,32,46,15,10,10,16,16,71
400915247,Monmouth Hawks,C. Brady,67377,,True,24.0,2,6,2,5,0,1,0,0,1,2,3,2,1,1,1,3,4
400915247,Monmouth Hawks,J. Robinson,67373,,True,38.0,4,16,3,6,1,10,2,2,0,1,1,4,0,0,4,1,11
400915247,Monmouth Hawks,J. James,67370,,True,28.0,1,4,1,2,0,2,2,2,2,4,6,3,0,0,2,3,4
400915247,Monmouth Hawks,J. Hornbeak,61664,,True,20.0,1,5,1,3,0,2,2,3,1,3,4,0,1,0,2,4,4
400915247,Monmouth Hawks,C. Stewart,61513,,True,25.0,3,8,1,2,2,6,0,0,0,1,1,0,0,1,0,1,8
400915247,Monmouth Hawks,M. Traore,3975762,,False,8.0,2,3,2,3,0,0,0,0,2,1,3,0,0,0,0,0,4
400915247,Monmouth Hawks,P. Sarr,3948710,,False,1.0,1,1,1,1,0,0,0,0,0,0,0,0,0,0,0,0,2
400915247,Monmouth Hawks,S. Ibiezugbe,4067330,,False,8.0,2,3,2,3,0,0,0,0,1,3,4,0,0,0,1,1,4
400915247,Monmouth Hawks,D. Quinn,3948714,,False,7.0,0,1,0,1,0,0,0,0,1,1,2,0,0,0,1,3,0
400915247,Monmouth Hawks,L. Pillari,3948713,,False,5.0,0,1,0,0,0,1,0,0,0,0,0,1,0,0,1,1,0
400915247,Monmouth Hawks,A. Tilghman,3153965,,False,9.0,0,0,0,0,0,0,0,0,1,1,2,0,0,0,0,1,0
400915247,Monmouth Hawks,D. Pillari,3153964,,False,1.0,1,3,1,1,0,2,0,0,1,1,2,0,1,0,0,0,2
400915247,Monmouth Hawks,M. Seaborn,3153963,,False,26.0,3,13,2,8,1,5,0,2,0,1,1,2,3,1,2,2,7
400915247,Monmouth Hawks,TEAM,TOTAL,TOTAL,False,,20,64,16,35,4,29,6,9,14,22,36,12,6,3,15,20,50
400915246,Notre Dame Fighting Irish,B. Colson,3138192,,True,27.0,8,12,7,11,1,1,2,2,3,4,7,3,0,4,1,1,19
400915246,Notre Dame Fighting Irish,M. Geben,3138191,,True,15.0,2,3,2,3,0,0,0,0,3,7,10,2,0,1,1,4,4
400915246,Notre Dame Fighting Irish,V.J. Beachem,66283,,True,29.0,8,15,5,8,3,7,2,3,1,3,4,1,4,1,1,0,21
400915246,Notre Dame Fighting Irish,M. Farrell,3138190,,True,23.0,3,8,2,4,1,4,1,1,0,0,0,3,1,0,1,2,8
400915246,Notre Dame Fighting Irish,S. Vasturia,66285,,True,27.0,4,9,3,6,1,3,0,0,2,0,2,4,3,0,1,1,9
400915246,Notre Dame Fighting Irish,J. Mooney,4065705,,False,7.0,3,4,2,2,1,2,0,0,2,2,4,0,1,0,0,0,7
400915246,Notre Dame Fighting Irish,E. Burns,3908337,,False,7.0,0,1,0,1,0,0,0,0,0,0,0,0,0,1,1,2,0
400915246,Notre Dame Fighting Irish,A. Torres,66286,,False,12.0,1,1,1,1,0,0,0,0,2,0,2,2,0,0,0,0,2
400915246,Notre Dame Fighting Irish,M. Ryan,3908336,,False,15.0,2,7,0,2,2,5,0,0,0,4,4,1,0,1,2,2,6
400915246,Notre Dame Fighting Irish,T. Gibbs,4065703,,False,17.0,0,4,0,3,0,1,0,0,0,3,3,5,2,0,1,0,0
400915246,Notre Dame Fighting Irish,R. Pflueger,3908335,,False,21.0,3,6,2,4,1,2,0,2,0,3,3,2,2,0,0,1,7
400915246,Notre Dame Fighting Irish,TEAM,TOTAL,TOTAL,False,,34,70,24,45,10,25,5,8,17,29,46,23,13,8,9,13,83
400915246,Loyola Maryland Greyhounds,K. Scott,4067129,,True,18.0,0,2,0,2,0,0,4,6,2,1,3,1,0,1,1,1,4
400915246,Loyola Maryland Greyhounds,J. Jones,62721,,True,21.0,4,11,4,11,0,0,0,0,0,3,3,1,0,3,2,0,8
400915246,Loyola Maryland Greyhounds,A. Kostecka,4067130,,True,26.0,3,4,2,3,1,1,1,1,2,3,5,0,1,2,4,0,8
400915246,Loyola Maryland Greyhounds,J. Fives,3908518,,True,23.0,2,4,0,1,2,3,2,2,2,1,3,0,1,0,1,2,8
400915246,Loyola Maryland Greyhounds,A. Walker,3130568,,True,25.0,3,12,1,7,2,5,0,0,0,0,0,6,0,0,3,2,8
400915246,Loyola Maryland Greyhounds,C. Gregory,3130571,,False,15.0,0,3,0,2,0,1,0,0,1,3,4,0,2,1,0,0,0
400915246,Loyola Maryland Greyhounds,N. Gorski,67213,,False,5.0,0,1,0,0,0,1,0,0,0,0,0,0,0,0,1,0,0
400915246,Loyola Maryland Greyhounds,I. Langendoerfer,4067133,,False,10.0,0,3,0,1,0,2,0,0,0,0,0,0,0,0,3,0,0
400915246,Loyola Maryland Greyhounds,S. Norton,3948846,,False,4.0,0,1,0,1,0,0,0,0,0,0,0,0,1,0,0,0,0
400915246,Loyola Maryland Greyhounds,C. Barnard,3130572,,False,17.0,1,4,1,4,0,0,0,0,2,2,4,0,0,0,0,1,2
400915246,Loyola Maryland Greyhounds,C. Champion,4067132,,False,9.0,0,1,0,0,0,1,0,0,0,0,0,1,0,0,1,1,0
400915246,Loyola Maryland Greyhounds,A. Harriott,4067131,,False,13.0,1,2,1,1,0,1,2,3,0,2,2,0,0,0,0,0,4
400915246,Loyola Maryland Greyhounds,N. Provo,3908517,,False,10.0,2,5,0,2,2,3,0,0,1,3,4,1,0,0,1,0,6
400915246,Loyola Maryland Greyhounds,M. Staubi,3130570,,False,4.0,0,1,0,1,0,0,0,0,0,0,0,0,0,0,1,0,0
400915246,Loyola Maryland Greyhounds,TEAM,TOTAL,TOTAL,False,,16,54,9,36,7,18,9,12,11,20,31,10,5,7,18,7,48
400915245,North Carolina Tar Heels,J. Jackson,3138156,,True,34.0,4,10,3,5,1,5,2,2,1,2,3,1,1,0,2,3,11
400915245,North Carolina Tar Heels,I. Hicks,66874,,True,28.0,7,8,7,8,0,0,2,3,2,3,5,2,0,0,1,4,16
400915245,North Carolina Tar Heels,K. Meeks,66873,,True,20.0,6,12,6,12,0,0,1,2,4,3,7,0,1,0,3,2,13
400915245,North Carolina Tar Heels,J. Berry II,3138155,,True,29.0,1,9,1,4,0,5,0,0,1,1,2,6,1,0,4,2,2
400915245,North Carolina Tar Heels,N. Britt,66872,,True,24.0,5,9,2,4,3,5,0,0,0,3,3,3,2,0,1,2,13
400915245,North Carolina Tar Heels,T. Bradley,4065673,,False,20.0,4,8,4,8,0,0,2,4,8,5,13,2,0,1,1,2,10
400915245,North Carolina Tar Heels,S. Woods,4065676,,False,11.0,1,2,0,1,1,1,4,4,0,4,4,0,0,0,1,1,7
400915245,North Carolina Tar Heels,B. Robinson,4065675,,False,14.0,2,5,1,3,1,2,0,0,1,2,3,3,0,0,1,2,5
400915245,North Carolina Tar Heels,K. Williams,3911619,,False,20.0,2,4,0,1,2,3,0,0,0,3,3,2,0,0,2,2,6
400915245,North Carolina Tar Heels,TEAM,TOTAL,TOTAL,False,,32,67,24,46,8,21,11,15,19,27,46,19,5,1,16,20,83
400915245,Hawai'i Rainbow Warriors,G. Johnson,4066917,,True,23.0,3,5,3,5,0,0,1,2,1,2,3,1,1,0,0,3,7
400915245,Hawai'i Rainbow Warriors,J. Purchase,3136178,,True,27.0,4,7,2,2,2,5,4,4,1,1,2,1,1,1,1,2,14
400915245,Hawai'i Rainbow Warriors,L. Green,4066910,,True,22.0,0,6,0,3,0,3,0,0,0,1,1,0,0,0,0,0,0
400915245,Hawai'i Rainbow Warriors,S. Drammeh,3948041,,True,35.0,5,15,4,12,1,3,2,2,1,2,3,2,3,0,4,4,13
400915245,Hawai'i Rainbow Warriors,N. Allen,66223,,True,38.0,10,17,8,11,2,6,0,1,0,3,3,3,2,0,2,1,22
400915245,Hawai'i Rainbow Warriors,Z. Raimo,4066914,,False,13.0,0,1,0,0,0,1,0,0,0,2,2,2,0,0,0,3,0
400915245,Hawai'i Rainbow Warriors,I. Flaisher,4066915,,False,17.0,2,4,2,4,0,0,2,2,1,3,4,1,0,1,3,2,6
400915245,Hawai'i Rainbow Warriors,Z. Buscher,3148931,,False,2.0,0,1,0,0,0,1,0,0,0,0,0,0,0,0,0,0,0
400915245,Hawai'i Rainbow Warriors,B. Stepteau,3148930,,False,23.0,2,4,0,1,2,3,0,0,0,0,0,2,0,0,3,0,6
400915245,Hawai'i Rainbow Warriors,TEAM,TOTAL,TOTAL,False,,26,60,19,38,7,22,9,11,7,16,23,12,7,2,14,15,68
400915244,Ohio Bobcats,A. Campbell,67066,,True,31.0,10,17,7,10,3,7,2,4,1,11,12,0,0,3,1,4,25
400915244,Ohio Bobcats,K. Kaminski,62614,,True,27.0,5,10,0,2,5,8,0,0,2,2,4,0,1,0,0,4,15
400915244,Ohio Bobcats,G. Block,3907082,,True,36.0,2,4,2,3,0,1,2,3,2,4,6,2,1,0,1,1,6
400915244,Ohio Bobcats,J. Dartis,3907084,,True,37.0,2,6,2,4,0,2,0,0,1,4,5,2,0,1,2,2,4
400915244,Ohio Bobcats,J. Simmons,66114,,True,38.0,6,15,4,12,2,3,3,5,0,1,1,9,1,0,6,2,17
400915244,Ohio Bobcats,J. Carter,4067398,,False,9.0,0,2,0,2,0,0,0,0,1,1,2,0,0,0,0,2,0
400915244,Ohio Bobcats,D. Taylor,3907085,,False,9.0,0,3,0,3,0,0,0,4,1,3,4,0,0,1,0,1,0
400915244,Ohio Bobcats,R. Culver,4067400,,False,5.0,0,0,0,0,0,0,0,0,0,0,0,0,0,0,2,1,0
400915244,Ohio Bobcats,M. Laster,3137002,,False,8.0,0,4,0,3,0,1,0,0,0,1,1,0,0,0,0,0,0
400915244,Ohio Bobcats,TEAM,TOTAL,TOTAL,False,,25,61,15,39,10,22,7,16,9,29,38,13,3,5,12,17,67
400915244,Georgia Tech Yellow Jackets,A. Gueye,3135059,,True,25.0,1,3,1,3,0,0,0,0,3,6,9,0,1,0,1,3,2
400915244,Georgia Tech Yellow Jackets,Q. Stephens,66128,,True,28.0,1,9,1,5,0,4,4,4,1,3,4,3,0,1,0,2,6
400915244,Georgia Tech Yellow Jackets,B. Lammers,3135061,,True,38.0,9,19,9,19,0,0,4,4,6,5,11,0,0,4,3,2,22
400915244,Georgia Tech Yellow Jackets,J. Okogie,4065663,,True,30.0,2,13,2,10,0,3,1,1,5,6,11,0,1,3,3,3,5
400915244,Georgia Tech Yellow Jackets,J. Moore,4065662,,True,28.0,2,6,2,6,0,0,3,8,0,2,2,8,0,0,0,3,7
400915244,Georgia Tech Yellow Jackets,S. Ogbonda,3904627,,False,2.0,0,1,0,1,0,0,0,0,0,0,0,0,0,0,1,1,0
400915244,Georgia Tech Yellow Jackets,T. Jackson,3135057,,False,27.0,6,13,3,9,3,4,2,2,1,3,4,0,0,0,2,1,17
400915244,Georgia Tech Yellow Jackets,C. Heyward,61609,,False,22.0,1,2,1,2,0,0,0,0,0,4,4,1,0,0,0,2,2
400915244,Georgia Tech Yellow Jackets,TEAM,TOTAL,TOTAL,False,,22,66,19,55,3,11,14,19,17,30,47,12,2,8,11,17,61
400915243,Winthrop Eagles,J. Davenport,66645,,True,28.0,1,5,0,4,1,1,4,4,1,3,4,4,1,0,2,0,7
400915243,Winthrop Eagles,D. Okeke,66642,,True,20.0,4,5,4,5,0,0,1,1,1,4,5,0,0,0,2,4,9
400915243,Winthrop Eagles,B. Broman,3906640,,True,33.0,5,10,3,5,2,5,4,5,1,0,1,5,0,0,1,4,16
400915243,Winthrop Eagles,X. Cooks,3129932,,True,38.0,9,16,8,13,1,3,4,8,0,5,5,2,0,1,6,2,23
400915243,Winthrop Eagles,A. Broman,67441,,True,27.0,2,10,2,4,0,6,4,4,2,7,9,4,0,1,0,2,8
400915243,Winthrop Eagles,J. Ferguson,4067741,,False,11.0,3,5,3,4,0,1,3,5,2,0,2,0,0,0,1,2,9
400915243,Winthrop Eagles,R. Perkins,3155530,,False,23.0,3,8,0,1,3,7,2,4,1,3,4,2,0,0,0,5,11
400915243,Winthrop Eagles,T. Prescott,64666,,False,9.0,0,4,0,4,0,0,0,0,1,0,1,0,0,0,0,4,0
400915243,Winthrop Eagles,P. Fisher,4067740,,False,7.0,1,1,1,1,0,0,0,0,0,0,0,0,0,0,1,0,2
400915243,Winthrop Eagles,A. Pickett,3906641,,False,4.0,0,0,0,0,0,0,1,2,0,0,0,0,0,0,0,2,1
400915243,Winthrop Eagles,TEAM,TOTAL,TOTAL,False,,28,64,21,41,7,23,23,33,11,24,35,17,1,2,13,25,86
400915243,Florida State Seminoles,J. Isaac,4065654,,True,25.0,5,11,2,5,3,6,1,2,1,4,5,0,0,1,2,3,14
400915243,Florida State Seminoles,M. Ojo,61596,,True,13.0,2,4,2,4,0,0,9,12,4,6,10,0,0,1,1,4,13
400915243,Florida State Seminoles,T. Mann,3907823,,True,26.0,4,6,4,6,0,0,0,0,2,5,7,1,1,0,0,4,8
400915243,Florida State Seminoles,D. Bacon,3907821,,True,29.0,5,14,2,7,3,7,2,2,0,2,2,3,0,0,1,1,15
400915243,Florida State Seminoles,X. Rathan-Mayes,66125,,True,26.0,2,8,1,3,1,5,2,2,2,1,3,9,1,0,1,1,7
400915243,Florida State Seminoles,P. Cofer,3135054,,False,4.0,1,1,1,1,0,0,0,0,0,1,1,0,0,0,0,0,2
400915243,Florida State Seminoles,J. Smith,66126,,False,10.0,1,2,1,2,0,0,0,0,0,5,5,0,0,0,0,3,2
400915243,Florida State Seminoles,C. Koumadje,3907824,,False,17.0,7,8,7,8,0,0,0,0,2,1,3,0,0,1,1,3,14
400915243,Florida State Seminoles,B. Angola-Rodas,4065658,,False,21.0,5,11,4,10,1,1,0,0,1,0,1,1,2,0,1,1,11
400915243,Florida State Seminoles,T. Forrest,4065656,,False,16.0,2,4,2,4,0,0,5,6,0,3,3,2,2,0,0,2,9
400915243,Florida State Seminoles,C. Walker,4065655,,False,13.0,1,3,1,2,0,1,3,5,1,1,2,2,1,0,0,4,5
400915243,Florida State Seminoles,TEAM,TOTAL,TOTAL,False,,35,72,27,52,8,20,22,29,13,30,43,18,7,3,7,26,100
400915242,SMU Mustangs,S. Ojeleye,66915,,True,37.0,9,17,7,12,2,5,4,6,2,3,5,1,0,2,1,3,24
400915242,SMU Mustangs,B. Moore,66118,,True,29.0,4,7,4,7,0,0,4,4,1,2,3,2,0,1,1,4,12
400915242,SMU Mustangs,S. Milton,3915195,,True,28.0,5,10,3,5,2,5,2,2,0,2,2,5,2,0,0,2,14
400915242,SMU Mustangs,J. Foster,3915194,,True,20.0,3,5,3,4,0,1,0,0,4,1,5,1,0,2,1,4,6
400915242,SMU Mustangs,S. Brown,66116,,True,36.0,4,9,3,5,1,4,0,0,2,4,6,3,1,0,1,3,9
400915242,SMU Mustangs,H. Froling,4066463,,False,12.0,2,4,2,4,0,0,0,0,2,1,3,0,0,0,1,0,4
400915242,SMU Mustangs,D. McDowell,4066462,,False,11.0,2,2,1,1,1,1,0,1,0,1,1,0,0,0,0,1,5
400915242,SMU Mustangs,B. Emelogu II,66293,,False,27.0,1,9,1,7,0,2,0,0,2,5,7,0,2,0,2,2,2
400915242,SMU Mustangs,TEAM,TOTAL,TOTAL,False,,30,63,24,45,6,18,10,13,14,23,37,12,5,5,7,19,76
400915242,Pittsburgh Panthers,M. Young,66290,,True,37.0,6,12,6,10,0,2,10,12,0,8,8,3,0,0,4,2,22
400915242,Pittsburgh Panthers,J. Artis,66287,,True,39.0,7,13,5,8,2,5,4,7,2,2,4,2,0,0,4,2,20
400915242,Pittsburgh Panthers,S. Jeter,61756,,True,29.0,2,8,2,7,0,1,1,2,2,6,8,1,0,0,1,4,5
400915242,Pittsburgh Panthers,C. Johnson,3138196,,True,38.0,3,7,0,2,3,5,0,0,0,1,1,1,0,2,1,2,9
400915242,Pittsburgh Panthers,C. Jones,61219,,True,25.0,0,5,0,2,0,3,0,0,0,0,0,2,0,0,0,1,0
400915242,Pittsburgh Panthers,R. Luther,3138197,,False,13.0,3,3,2,2,1,1,0,0,1,1,2,0,0,1,1,5,7
400915242,Pittsburgh Panthers,J. Kithcart,4065713,,False,12.0,2,3,2,2,0,1,0,1,0,0,0,1,1,0,2,3,4
400915242,Pittsburgh Panthers,J. Milligan,3934655,,False,7.0,0,1,0,0,0,1,0,0,1,0,1,0,0,0,0,1,0
400915242,Pittsburgh Panthers,D. Wilson,3934652,,False,0.0,0,0,0,0,0,0,0,0,0,0,0,0,0,0,0,0,0
400915242,Pittsburgh Panthers,TEAM,TOTAL,TOTAL,False,,23,52,17,33,6,19,15,22,9,21,30,10,1,3,13,20,67
400915241,Louisville Cardinals,M. Mathiang,63035,,True,17.0,3,7,3,7,0,0,5,5,5,2,7,0,2,0,2,3,11
400915241,Louisville Cardinals,D. Adel,3908807,,True,24.0,5,9,4,7,1,2,0,0,0,3,3,3,0,1,0,1,11
400915241,Louisville Cardinals,J. Johnson,3147362,,True,18.0,7,11,7,10,0,1,0,2,4,7,11,0,0,1,1,2,14
400915241,Louisville Cardinals,D. Mitchell,3908809,,True,27.0,3,10,1,5,2,5,0,0,2,4,6,1,2,1,2,0,8
400915241,Louisville Cardinals,Q. Snider,3147360,,True,27.0,1,10,1,6,0,4,2,3,1,1,2,5,0,0,1,0,4
400915241,Louisville Cardinals,V.J. King,4065666,,False,13.0,3,8,3,6,0,2,2,2,0,3,3,0,0,0,0,0,8
400915241,Louisville Cardinals,R. Spalding,3908806,,False,21.0,4,6,4,6,0,0,2,4,5,1,6,3,2,2,1,2,10
400915241,Louisville Cardinals,A. Mahmoud,3147363,,False,20.0,4,7,4,7,0,0,0,0,3,5,8,1,0,2,1,2,8
400915241,Louisville Cardinals,M. Stockman,3147361,,False,3.0,0,0,0,0,0,0,0,0,0,1,1,1,0,1,1,0,0
400915241,Louisville Cardinals,T. Sharpe,4065667,,False,1.0,0,1,0,0,0,1,0,0,0,0,0,0,0,0,0,0,0
400915241,Louisville Cardinals,R. McMahon,3908808,,False,15.0,2,2,0,0,2,2,0,0,0,3,3,5,1,1,1,3,6
400915241,Louisville Cardinals,J. Henderson,3155491,,False,5.0,0,2,0,1,0,1,2,2,0,0,0,1,1,0,0,1,2
400915241,Louisville Cardinals,D. Levitch,66592,,False,9.0,2,3,0,1,2,2,0,0,1,0,1,0,1,0,0,0,6
400915241,Louisville Cardinals,TEAM,TOTAL,TOTAL,False,,34,76,27,56,7,20,13,18,21,30,51,20,9,9,10,14,88
400915241,Long Beach State Beach,J. Jackson,4066921,,True,8.0,1,1,1,1,0,0,0,0,2,0,2,0,0,0,1,1,2
400915241,Long Beach State Beach,G. Levin,68087,,True,32.0,5,13,5,11,0,2,2,4,4,8,12,0,2,0,4,1,12
400915241,Long Beach State Beach,T. Yussuf,3137252,,True,12.0,0,3,0,3,0,0,0,0,2,1,3,1,0,0,1,2,0
400915241,Long Beach State Beach,J. Bibbins,3137254,,True,31.0,4,12,3,8,1,4,0,0,1,2,3,3,1,0,5,2,9
400915241,Long Beach State Beach,E. Payne,68089,,True,26.0,3,10,0,5,3,5,6,7,0,2,2,0,1,0,1,4,15
400915241,Long Beach State Beach,L. Williams,3946950,,False,10.0,1,2,1,2,0,0,4,4,1,2,3,1,1,2,0,2,6
400915241,Long Beach State Beach,M. Riggins,3946948,,False,6.0,0,1,0,1,0,0,0,0,0,0,0,0,0,0,1,1,0
400915241,Long Beach State Beach,R. Prince,66229,,False,19.0,0,5,0,5,0,0,2,2,2,3,5,1,0,0,2,3,2
400915241,Long Beach State Beach,B. Ogalue,3960034,,False,7.0,0,0,0,0,0,0,0,0,0,0,0,0,0,0,0,0,0
400915241,Long Beach State Beach,J. Griffin,4066920,,False,15.0,1,4,0,2,1,2,0,0,0,4,4,0,0,0,0,0,3
400915241,Long Beach State Beach,L. Jackson,4066919,,False,16.0,1,6,1,4,0,2,0,0,0,0,0,0,1,0,4,2,2
400915241,Long Beach State Beach,N. Blackwell,3946947,,False,17.0,2,4,1,1,1,3,0,0,0,1,1,0,2,1,0,2,5
400915241,Long Beach State Beach,A. Moye,66672,,False,1.0,0,0,0,0,0,0,0,0,0,0,0,0,0,0,0,0,0
400915241,Long Beach State Beach,TEAM,TOTAL,TOTAL,False,,18,61,12,43,6,18,14,17,14,23,37,6,8,3,19,20,56
400915240,Wake Forest Demon Deacons,J. Collins,3908845,,True,23.0,9,10,9,10,0,0,6,9,2,4,6,0,2,1,2,4,24
400915240,Wake Forest Demon Deacons,D. Mitoglou,3138224,,True,27.0,5,12,1,6,4,6,4,4,3,4,7,2,2,0,1,1,18
400915240,Wake Forest Demon Deacons,A. Arians,61378,,True,19.0,3,4,1,1,2,3,0,0,1,0,1,2,0,0,0,1,8
400915240,Wake Forest Demon Deacons,B. Crawford,3908844,,True,27.0,7,12,5,8,2,4,4,6,0,2,2,7,2,0,1,4,20
400915240,Wake Forest Demon Deacons,M. Wilbekin,3138222,,True,29.0,3,8,1,4,2,4,0,0,0,1,1,3,1,0,1,2,8
400915240,Wake Forest Demon Deacons,R. Washington,4065753,,False,2.0,0,0,0,0,0,0,0,0,0,0,0,0,0,0,1,0,0
400915240,Wake Forest Demon Deacons,D. Mitchell,4065751,,False,2.0,0,0,0,0,0,0,0,0,0,0,0,0,0,0,1,0,0
400915240,Wake Forest Demon Deacons,T. Rike,3155405,,False,1.0,0,0,0,0,0,0,0,0,0,1,1,0,0,0,0,0,0
400915240,Wake Forest Demon Deacons,G. McClinton,66140,,False,7.0,0,1,0,1,0,0,0,0,1,1,2,0,0,0,0,0,0
400915240,Wake Forest Demon Deacons,S. Japhet-Mathias,4065752,,False,3.0,0,0,0,0,0,0,0,0,0,0,0,0,0,0,0,0,0
400915240,Wake Forest Demon Deacons,D. Moore,3908843,,False,11.0,1,2,1,2,0,0,0,0,1,1,2,0,0,2,2,4,2
400915240,Wake Forest Demon Deacons,B. Childress,4065750,,False,19.0,1,3,0,1,1,2,4,4,0,2,2,3,0,0,4,3,7
400915240,Wake Forest Demon Deacons,A. Bilas,3908846,,False,0.0,0,0,0,0,0,0,0,0,0,0,0,0,0,0,0,0,0
400915240,Wake Forest Demon Deacons,K. Woods,3132360,,False,25.0,6,7,4,5,2,2,2,2,1,2,3,5,1,0,2,2,16
400915240,Wake Forest Demon Deacons,T. VanHorn,3078214,,False,5.0,0,0,0,0,0,0,0,0,0,1,1,0,0,0,1,0,0
400915240,Wake Forest Demon Deacons,TEAM,TOTAL,TOTAL,False,,35,59,22,38,13,21,20,25,11,22,33,22,8,3,16,21,103
400915240,UTEP Miners,T. Winn III,3132540,,True,15.0,2,8,2,8,0,0,0,0,0,4,4,1,0,0,2,5,4
400915240,UTEP Miners,J. Flaggert,66784,,True,16.0,0,0,0,0,0,0,2,2,1,0,1,0,0,0,0,4,2
400915240,UTEP Miners,M. Willms,61362,,True,20.0,6,8,6,8,0,0,1,3,1,1,2,0,0,5,3,4,13
400915240,UTEP Miners,O. Harris,3132536,,True,32.0,5,12,5,8,0,4,6,6,0,2,2,2,3,0,3,2,16
400915240,UTEP Miners,D. Artis,61671,,True,35.0,8,12,5,7,3,5,5,8,0,4,4,6,0,0,6,1,24
400915240,UTEP Miners,J. Martinez,4073829,,False,0.0,0,0,0,0,0,0,0,0,0,0,0,0,0,0,0,0,0
400915240,UTEP Miners,I. Venegas,3924888,,False,2.0,0,2,0,2,0,0,0,0,0,0,0,0,0,0,0,0,0
400915240,UTEP Miners,P. Thomas,3924887,,False,26.0,4,4,4,4,0,0,0,0,2,3,5,5,0,0,0,1,8
400915240,UTEP Miners,K. Jones,4067073,,False,13.0,2,3,2,3,0,0,0,0,1,0,1,2,0,2,1,5,4
400915240,UTEP Miners,H. Urbanus,4067076,,False,2.0,0,1,0,0,0,1,0,0,0,0,0,0,0,0,0,0,0
400915240,UTEP Miners,D. Barrett,4067071,,False,24.0,3,5,1,1,2,4,0,0,0,0,0,2,0,0,1,1,8
400915240,UTEP Miners,C. Barnes,4067070,,False,5.0,1,2,1,2,0,0,0,0,1,0,1,0,0,0,1,0,2
400915240,UTEP Miners,T. Touchet,3132539,,False,10.0,0,1,0,1,0,0,0,0,0,0,0,0,2,0,1,0,0
400915240,UTEP Miners,TEAM,TOTAL,TOTAL,False,,31,58,26,44,5,14,14,19,8,16,24,18,5,7,18,23,81
400915239,Davidson Wildcats,P. Aldridge,3133797,,True,34.0,7,16,5,8,2,8,6,8,2,6,8,1,0,0,2,2,22
400915239,Davidson Wildcats,W. Magarity,67537,,True,17.0,2,5,2,3,0,2,2,2,3,1,4,1,0,0,1,4,6
400915239,Davidson Wildcats,J. Gudmundsson,4070687,,True,34.0,4,8,2,2,2,6,1,1,4,3,7,1,1,0,1,0,11
400915239,Davidson Wildcats,R. Reigel,3133798,,True,19.0,2,6,2,2,0,4,2,2,2,1,3,5,0,0,2,4,6
400915239,Davidson Wildcats,J. Gibbs,67236,,True,28.0,7,18,5,12,2,6,2,2,1,2,3,4,1,0,4,5,18
400915239,Davidson Wildcats,D. Kovacevic,3904644,,False,16.0,1,4,0,1,1,3,0,0,2,3,5,1,1,0,0,1,3
400915239,Davidson Wildcats,O. Michelsen,3133796,,False,7.0,0,3,0,0,0,3,0,0,0,0,0,1,0,0,0,0,0
400915239,Davidson Wildcats,N. Ekwu,3133794,,False,8.0,0,0,0,0,0,0,0,0,1,0,1,0,0,2,2,5,0
400915239,Davidson Wildcats,A. McAuliffe,67238,,False,6.0,0,0,0,0,0,0,0,1,2,1,3,1,0,0,1,2,0
400915239,Davidson Wildcats,K. Pritchett,3904645,,False,1.0,0,0,0,0,0,0,0,0,0,0,0,0,0,0,2,0,0
400915239,Davidson Wildcats,J. Watkins,3133795,,False,30.0,4,8,0,0,4,8,0,0,1,2,3,4,0,0,1,2,12
400915239,Davidson Wildcats,TEAM,TOTAL,TOTAL,False,,27,68,16,28,11,40,13,16,20,22,42,19,3,2,16,25,78
400915239,Clemson Tigers,D. Grantham,3129674,,True,36.0,5,8,3,3,2,5,0,0,1,7,8,4,2,1,3,1,12
400915239,Clemson Tigers,J. Blossomgame,61835,,True,34.0,6,16,5,12,1,4,4,5,2,4,6,2,1,1,0,3,17
400915239,Clemson Tigers,S. Djitte,66122,,True,23.0,2,3,2,3,0,0,8,12,3,3,6,1,1,2,2,4,12
400915239,Clemson Tigers,G. DeVoe,3129673,,True,34.0,6,8,4,4,2,4,2,2,0,1,1,4,3,0,1,1,16
400915239,Clemson Tigers,A. Holmes,62043,,True,37.0,6,12,2,5,4,7,6,7,1,5,6,3,2,0,1,3,22
400915239,Clemson Tigers,L. Robertin,3917985,,False,6.0,2,2,2,2,0,0,1,1,1,0,1,0,0,0,1,2,5
400915239,Clemson Tigers,S. Spencer,4065646,,False,12.0,1,4,1,3,0,1,0,0,0,2,2,0,0,0,0,1,2
400915239,Clemson Tigers,L. Davis,3917984,,False,1.0,0,0,0,0,0,0,0,0,0,0,0,0,0,0,0,0,0
400915239,Clemson Tigers,R. McGillan,3155393,,False,1.0,0,0,0,0,0,0,0,0,0,0,0,0,0,0,0,0,0
400915239,Clemson Tigers,M. Reed,3133969,,False,16.0,2,5,2,4,0,1,5,5,0,0,0,2,0,0,0,4,9
400915239,Clemson Tigers,TEAM,TOTAL,TOTAL,False,,30,58,21,36,9,22,26,32,9,23,32,16,9,4,8,19,95
400915238,North Florida Ospreys,C. Davenport,66525,,True,23.0,0,6,0,4,0,2,0,0,0,2,2,1,0,0,4,4,0
400915238,North Florida Ospreys,R. Banks,66524,,True,27.0,4,7,4,7,0,0,1,2,2,1,3,0,0,2,0,4,9
400915238,North Florida Ospreys,N. Malonga,3130524,,True,10.0,0,2,0,2,0,0,0,0,0,0,0,0,0,0,0,2,0
400915238,North Florida Ospreys,D. Moore,66523,,True,32.0,5,12,3,6,2,6,0,0,0,1,1,1,0,0,3,0,12
400915238,North Florida Ospreys,A. Bodager,61202,,True,28.0,0,6,0,0,0,6,0,0,2,2,4,0,0,0,2,2,0
400915238,North Florida Ospreys,A. Horne,4067209,,False,16.0,2,4,1,1,1,3,0,0,1,0,1,3,1,0,0,2,5
400915238,North Florida Ospreys,W. Aminu,4067207,,False,17.0,4,9,3,8,1,1,2,4,3,3,6,0,0,2,1,1,11
400915238,North Florida Ospreys,K. Odum,3130522,,False,12.0,0,2,0,2,0,0,1,2,0,2,2,1,0,0,0,0,1
400915238,North Florida Ospreys,G. Sams,4067210,,False,21.0,4,9,3,6,1,3,1,1,0,2,2,1,1,0,3,1,10
400915238,North Florida Ospreys,C. Fisher,3908848,,False,9.0,0,1,0,1,0,0,2,4,1,2,3,2,0,0,1,0,2
400915238,North Florida Ospreys,O. Blount,3130523,,False,5.0,2,3,0,0,2,3,0,0,0,0,0,0,0,1,0,1,6
400915238,North Florida Ospreys,TEAM,TOTAL,TOTAL,False,,21,61,14,37,7,24,7,13,13,18,31,9,2,5,14,17,56
400915238,Miami Hurricanes,K. Murphy,61668,,True,27.0,3,6,3,6,0,0,2,2,3,6,9,1,0,0,3,2,8
400915238,Miami Hurricanes,E. Izundu,3904629,,True,4.0,2,2,2,2,0,0,0,0,3,1,4,0,0,0,0,1,4
400915238,Miami Hurricanes,A. Lawrence II,3904628,,True,31.0,4,8,3,5,1,3,1,2,1,4,5,2,1,1,4,1,10
400915238,Miami Hurricanes,J. Newton,3138145,,True,27.0,7,10,7,9,0,1,2,2,0,3,3,7,3,0,0,3,16
400915238,Miami Hurricanes,D. Reed,66130,,True,29.0,6,11,3,5,3,6,2,3,0,3,3,2,2,0,3,2,17
400915238,Miami Hurricanes,D. Hernandez,4065672,,False,19.0,6,9,6,9,0,0,3,3,3,5,8,0,0,1,0,4,15
400915238,Miami Hurricanes,C. Stowell,3138149,,False,3.0,0,1,0,0,0,1,0,0,0,0,0,0,0,0,0,0,0
400915238,Miami Hurricanes,R. Miller Jr.,4065671,,False,11.0,2,2,2,2,0,0,0,0,1,2,3,0,0,0,0,2,4
400915238,Miami Hurricanes,B. Brown,4065670,,False,25.0,3,7,3,6,0,1,1,2,2,4,6,2,2,0,0,1,7
400915238,Miami Hurricanes,D. Vasiljevic,4065669,,False,21.0,4,10,1,4,3,6,2,2,0,1,1,0,1,0,0,3,13
400915238,Miami Hurricanes,M. Robinson,3947140,,False,3.0,0,2,0,0,0,2,0,0,0,0,0,0,0,0,0,0,0
400915238,Miami Hurricanes,TEAM,TOTAL,TOTAL,False,,37,68,30,48,7,20,13,16,15,31,46,14,9,2,10,19,94
400915237,Seattle U Redhawks,W. Powell,66716,,True,20.0,2,8,2,8,0,0,5,5,2,2,4,0,1,1,4,2,9
400915237,Seattle U Redhawks,E. Chibuogwu,61691,,True,17.0,1,3,0,0,1,3,0,0,1,2,3,0,0,0,2,3,3
400915237,Seattle U Redhawks,A. Menzies,3156148,,True,19.0,2,6,2,6,0,0,0,0,0,2,2,0,0,0,0,0,4
400915237,Seattle U Redhawks,M. Means,4067559,,True,21.0,2,5,0,2,2,3,1,2,0,3,3,0,0,0,2,2,7
400915237,Seattle U Redhawks,B. Westendorf,3947713,,True,22.0,0,8,0,1,0,7,0,0,0,1,1,4,0,1,1,0,0
400915237,Seattle U Redhawks,S. Ulaneo,4067560,,False,26.0,3,7,2,4,1,3,0,2,1,4,5,1,1,0,3,4,7
400915237,Seattle U Redhawks,M. Da Campo,4067561,,False,17.0,0,0,0,0,0,0,0,0,1,0,1,3,0,0,2,0,0
400915237,Seattle U Redhawks,Z. Moore,3947717,,False,23.0,1,6,0,0,1,6,2,2,0,1,1,0,0,0,2,4,5
400915237,Seattle U Redhawks,M. Kavas,3947715,,False,20.0,4,9,1,3,3,6,0,0,1,3,4,1,0,0,2,0,11
400915237,Seattle U Redhawks,J. Shaughnessy,3156147,,False,15.0,1,3,0,1,1,2,0,0,1,1,2,1,0,0,2,0,3
400915237,Seattle U Redhawks,TEAM,TOTAL,TOTAL,False,,16,55,7,25,9,30,8,11,13,20,33,10,2,2,21,15,49
400915237,Notre Dame Fighting Irish,B. Colson,3138192,,True,23.0,6,12,6,12,0,0,4,5,4,4,8,0,2,0,1,1,16
400915237,Notre Dame Fighting Irish,M. Geben,3138191,,True,19.0,1,1,1,1,0,0,0,0,1,3,4,0,1,2,0,1,2
400915237,Notre Dame Fighting Irish,V.J. Beachem,66283,,True,23.0,5,10,2,4,3,6,3,4,0,4,4,3,0,0,1,2,16
400915237,Notre Dame Fighting Irish,M. Farrell,3138190,,True,23.0,4,9,1,2,3,7,2,2,1,3,4,4,2,0,2,1,13
400915237,Notre Dame Fighting Irish,S. Vasturia,66285,,True,24.0,4,6,1,2,3,4,2,2,0,2,2,4,0,0,2,2,13
400915237,Notre Dame Fighting Irish,J. Mooney,4065705,,False,10.0,0,1,0,0,0,1,0,0,1,4,5,1,0,0,0,2,0
400915237,Notre Dame Fighting Irish,E. Burns,3908337,,False,10.0,0,1,0,1,0,0,0,0,0,1,1,0,0,0,0,0,0
400915237,Notre Dame Fighting Irish,M. Gregory,3155402,,False,1.0,0,1,0,0,0,1,0,0,0,0,0,0,0,0,0,0,0
400915237,Notre Dame Fighting Irish,P. Mazza,3125206,,False,1.0,0,0,0,0,0,0,0,0,0,0,0,0,0,0,0,0,0
400915237,Notre Dame Fighting Irish,A. Torres,66286,,False,10.0,0,0,0,0,0,0,0,0,0,2,2,0,1,0,1,2,0
400915237,Notre Dame Fighting Irish,M. Ryan,3908336,,False,17.0,3,9,0,1,3,8,0,0,3,1,4,2,1,0,1,2,9
400915237,Notre Dame Fighting Irish,T. Gibbs,4065703,,False,20.0,4,8,3,4,1,4,2,3,0,1,1,5,3,0,0,2,11
400915237,Notre Dame Fighting Irish,R. Pflueger,3908335,,False,19.0,5,7,3,4,2,3,0,0,0,1,1,4,2,1,0,0,12
400915237,Notre Dame Fighting Irish,TEAM,TOTAL,TOTAL,False,,32,65,17,31,15,34,13,16,13,27,40,23,12,3,8,15,92
400915236,Kansas Jayhawks,L. Lucas,61621,,True,14.0,1,4,1,4,0,0,0,0,1,0,1,1,0,0,1,4,2
400915236,Kansas Jayhawks,C. Bragg Jr.,3919336,,True,16.0,3,5,3,5,0,0,3,4,1,4,5,1,1,1,2,4,9
400915236,Kansas Jayhawks,J. Jackson,4066297,,True,18.0,7,9,6,7,1,2,0,4,1,1,2,1,1,0,0,5,15
400915236,Kansas Jayhawks,D. Graham,3133601,,True,40.0,6,12,5,6,1,6,0,0,2,1,3,2,0,1,3,2,13
400915236,Kansas Jayhawks,F. Mason III,67430,,True,35.0,8,13,8,12,0,1,5,7,1,2,3,5,2,0,2,4,21
400915236,Kansas Jayhawks,M. Lightfoot,4066300,,False,3.0,0,2,0,1,0,1,0,2,0,1,1,0,0,1,0,0,0
400915236,Kansas Jayhawks,U. Azubuike,4066299,,False,15.0,3,6,3,6,0,0,0,0,4,8,12,1,1,1,3,4,6
400915236,Kansas Jayhawks,L. Vick,3919334,,False,31.0,4,9,4,5,0,4,1,2,1,4,5,0,0,0,2,2,9
400915236,Kansas Jayhawks,S. Mykhailiuk,3133602,,False,28.0,1,5,1,2,0,3,0,0,1,1,2,2,1,0,1,1,2
400915236,Kansas Jayhawks,TEAM,TOTAL,TOTAL,False,,33,65,31,48,2,17,9,19,14,24,38,13,6,4,14,26,77
400915236,Duke Blue Devils,A. Jefferson,61586,,True,30.0,4,6,4,6,0,0,4,7,0,4,4,2,1,1,7,5,12
400915236,Duke Blue Devils,C. Jeter,3913173,,True,26.0,1,4,1,4,0,0,5,10,2,2,4,0,0,3,3,4,7
400915236,Duke Blue Devils,L. Kennard,3913174,,True,35.0,7,10,5,6,2,4,6,6,0,5,5,5,0,1,3,3,22
400915236,Duke Blue Devils,G. Allen,3135045,,True,38.0,4,15,3,8,1,7,3,4,0,3,3,3,1,0,1,2,12
400915236,Duke Blue Devils,M. Jones,66563,,True,40.0,4,7,1,2,3,5,0,0,0,3,3,2,1,0,0,4,11
400915236,Duke Blue Devils,J. DeLaurier,4065650,,False,1.0,0,0,0,0,0,0,0,0,0,0,0,0,0,0,0,0,0
400915236,Duke Blue Devils,F. Jackson,4065651,,False,30.0,3,5,1,2,2,3,3,3,1,2,3,0,0,0,2,4,11
400915236,Duke Blue Devils,TEAM,TOTAL,TOTAL,False,,23,47,15,28,8,19,21,30,6,23,29,12,3,5,16,22,75
400915235,Maryland Eastern Shore Hawks,I. Taylor,3947054,,True,11.0,2,4,2,4,0,0,0,0,2,0,2,0,0,0,1,1,4
400915235,Maryland Eastern Shore Hawks,B. Copeland,66560,,True,24.0,6,13,6,12,0,1,2,4,0,5,5,0,0,2,5,3,14
400915235,Maryland Eastern Shore Hawks,T. Rivera,3947049,,True,21.0,3,9,1,5,2,4,0,0,1,2,3,3,1,0,0,2,8
400915235,Maryland Eastern Shore Hawks,R. Andino,3153381,,True,34.0,3,11,1,2,2,9,0,0,0,0,0,1,0,0,1,0,8
400915235,Maryland Eastern Shore Hawks,D. Peck,61997,,True,29.0,2,4,2,4,0,0,1,2,3,5,8,1,5,1,1,3,5
400915235,Maryland Eastern Shore Hawks,T. Jones,4067908,,False,17.0,1,5,1,2,0,3,0,0,1,0,1,0,0,0,1,0,2
400915235,Maryland Eastern Shore Hawks,D. Dorsett,4067905,,False,5.0,1,3,1,2,0,1,0,0,0,1,1,0,0,0,1,1,2
400915235,Maryland Eastern Shore Hawks,M. Chambers,4067909,,False,10.0,0,0,0,0,0,0,0,0,0,0,0,1,0,0,2,0,0
400915235,Maryland Eastern Shore Hawks,C. Gaynor,4067904,,False,0.0,0,0,0,0,0,0,0,0,0,0,0,0,0,0,0,0,0
400915235,Maryland Eastern Shore Hawks,L. McIntosh,4067903,,False,25.0,3,6,2,5,1,1,4,6,0,1,1,5,0,0,0,0,11
400915235,Maryland Eastern Shore Hawks,D. Caldwell,3947053,,False,23.0,1,6,1,3,0,3,1,2,3,7,10,0,1,1,2,2,3
400915235,Maryland Eastern Shore Hawks,M. Seylan,3947048,,False,1.0,0,0,0,0,0,0,0,0,0,0,0,0,0,0,0,0,0
400915235,Maryland Eastern Shore Hawks,TEAM,TOTAL,TOTAL,False,,22,61,17,39,5,22,8,14,11,22,33,11,7,4,14,12,57
400915235,Boston College Eagles,A.J. Turner,3943608,,True,29.0,5,7,3,3,2,4,1,2,1,1,2,4,0,0,2,2,13
400915235,Boston College Eagles,M. Jeffers,61901,,True,18.0,2,5,2,5,0,0,1,2,4,9,13,1,1,0,0,4,5
400915235,Boston College Eagles,C. Tava,61446,,True,27.0,2,4,2,4,0,0,1,3,5,5,10,2,1,0,4,1,5
400915235,Boston College Eagles,T. Graves,4065636,,True,18.0,1,5,0,0,1,5,0,0,0,0,0,2,0,0,1,0,3
400915235,Boston College Eagles,J. Robinson,3943606,,True,32.0,6,16,4,10,2,6,2,4,1,6,7,4,3,1,1,0,16
400915235,Boston College Eagles,J. Reyes,3943609,,False,9.0,3,4,3,4,0,0,0,0,1,1,2,0,0,1,2,1,6
400915235,Boston College Eagles,M. Sagay,4065638,,False,1.0,1,1,1,1,0,0,0,0,0,0,0,0,0,0,0,0,2
400915235,Boston College Eagles,N. Popovic,4065637,,False,14.0,2,7,2,7,0,0,0,0,2,2,4,0,0,0,2,0,4
400915235,Boston College Eagles,G. Owens,66277,,False,12.0,1,2,1,1,0,1,0,0,1,2,3,3,0,1,0,3,2
400915235,Boston College Eagles,K. Bowman,4065635,,False,24.0,5,9,4,5,1,4,0,0,0,1,1,4,1,0,4,2,11
400915235,Boston College Eagles,J. Chatman,3135095,,False,16.0,2,6,1,3,1,3,1,2,0,2,2,2,0,0,0,1,6
400915235,Boston College Eagles,TEAM,TOTAL,TOTAL,False,,30,66,23,43,7,23,6,13,17,32,49,22,6,3,16,14,73
400915234,Virginia Tech Hokies,K. Sy,4065740,,True,17.0,6,9,6,9,0,0,2,4,4,2,6,1,0,1,1,3,14
400915234,Virginia Tech Hokies,C. Clarke,3945567,,True,26.0,3,4,3,4,0,0,3,5,1,4,5,6,1,0,2,2,9
400915234,Virginia Tech Hokies,J. Robinson,3945566,,True,21.0,2,6,2,2,0,4,1,1,1,3,4,4,1,0,2,4,5
400915234,Virginia Tech Hokies,A. Hill,3147501,,True,34.0,7,12,1,1,6,11,0,2,0,3,3,4,2,0,0,1,20
400915234,Virginia Tech Hokies,J. Bibbs,3147500,,True,20.0,2,6,1,2,1,4,2,2,0,3,3,3,0,0,0,3,7
400915234,Virginia Tech Hokies,Z. LeDay,61698,,False,22.0,5,8,5,7,0,1,2,3,0,5,5,1,1,0,0,3,12
400915234,Virginia Tech Hokies,J. Hamilton,3945563,,False,16.0,4,4,4,4,0,0,1,4,2,1,3,0,2,1,0,2,9
400915234,Virginia Tech Hokies,M. Galloway,3945565,,False,5.0,0,3,0,0,0,3,0,0,0,0,0,0,0,0,0,1,0
400915234,Virginia Tech Hokies,T. Outlaw,67275,,False,10.0,2,4,0,1,2,3,0,0,0,2,2,0,0,0,1,2,6
400915234,Virginia Tech Hokies,S. Allen,61795,,False,29.0,6,10,3,6,3,4,2,2,0,5,5,5,1,1,3,1,17
400915234,Virginia Tech Hokies,TEAM,TOTAL,TOTAL,False,,37,66,25,36,12,30,13,23,9,28,37,24,8,3,9,22,99
400915234,High Point Panthers,M. Bowman Jr.,57310,,True,31.0,5,10,4,9,1,1,6,7,2,8,10,0,1,0,1,1,17
400915234,High Point Panthers,R. Madison,3913172,,True,18.0,0,0,0,0,0,0,0,0,1,4,5,1,0,0,2,4,0
400915234,High Point Panthers,J. Wright,4067464,,True,28.0,4,10,2,4,2,6,2,2,0,3,3,4,2,0,3,3,12
400915234,High Point Panthers,A. Fox,3913171,,True,31.0,9,16,5,10,4,6,1,2,0,2,2,1,0,0,3,0,23
400915234,High Point Panthers,A. Lindauer,66572,,True,21.0,0,4,0,1,0,3,4,4,0,0,0,3,0,0,2,1,4
400915234,High Point Panthers,C. Thomas Jr.,4067467,,False,8.0,0,0,0,0,0,0,2,4,0,2,2,0,0,0,0,0,2
400915234,High Point Panthers,L. Vargo,4067466,,False,12.0,0,2,0,0,0,2,0,2,0,4,4,0,0,1,0,2,0
400915234,High Point Panthers,J. Whitehead,3947731,,False,2.0,0,0,0,0,0,0,0,0,0,0,0,0,0,0,1,0,0
400915234,High Point Panthers,T. Thompson,66570,,False,14.0,2,3,1,2,1,1,2,2,0,2,2,1,0,0,0,5,7
400915234,High Point Panthers,J. Williams,4067465,,False,18.0,2,5,2,3,0,2,1,3,0,0,0,0,1,0,2,1,5
400915234,High Point Panthers,A. White,3129914,,False,17.0,1,2,0,0,1,2,0,0,0,2,2,0,0,0,0,3,3
400915234,High Point Panthers,TEAM,TOTAL,TOTAL,False,,23,52,14,29,9,23,18,26,3,28,31,10,4,1,14,20,73
400915233,Virginia Cavaliers,I. Wilkins,3138203,,True,18.0,2,3,2,2,0,1,0,0,1,2,3,1,2,1,2,1,4
400915233,Virginia Cavaliers,J. Salt,3138200,,True,16.0,3,3,3,3,0,0,0,0,0,2,2,0,0,0,1,0,6
400915233,Virginia Cavaliers,D. Thompson,66274,,True,19.0,2,4,2,4,0,0,0,0,0,6,6,3,0,1,3,0,4
400915233,Virginia Cavaliers,L. Perrantes,66139,,True,25.0,4,9,4,4,0,5,0,2,1,2,3,3,2,0,1,1,8
400915233,Virginia Cavaliers,D. Hall,66138,,True,21.0,2,4,2,3,0,1,0,0,1,3,4,3,0,0,2,0,4
400915233,Virginia Cavaliers,M. Diakite,3947156,,False,14.0,3,3,3,3,0,0,2,3,0,4,4,0,0,1,0,4,8
400915233,Virginia Cavaliers,J. Reuter,3908374,,False,16.0,3,5,3,5,0,0,3,4,2,2,4,1,0,0,0,1,9
400915233,Virginia Cavaliers,J. Jones,67567,,False,2.0,0,0,0,0,0,0,0,0,0,0,0,0,0,0,0,0,0
400915233,Virginia Cavaliers,A. Nichols,66597,,False,16.0,4,7,4,6,0,1,3,3,0,3,3,0,0,0,0,3,11
400915233,Virginia Cavaliers,T. Jerome,4065733,,False,10.0,1,3,1,1,0,2,1,2,0,3,3,2,0,0,0,3,3
400915233,Virginia Cavaliers,K. Guy,4065730,,False,21.0,2,4,2,4,0,0,1,2,0,2,2,2,0,1,0,1,5
400915233,Virginia Cavaliers,T. Gross Jr.,4065729,,False,2.0,0,0,0,0,0,0,0,0,1,0,1,1,0,0,0,0,0
400915233,Virginia Cavaliers,J. Bartley,3947155,,False,2.0,1,1,1,1,0,0,0,0,0,0,0,0,0,0,1,0,2
400915233,Virginia Cavaliers,M. Shayok,3138201,,False,18.0,4,6,4,6,0,0,0,0,0,2,2,2,0,1,0,1,8
400915233,Virginia Cavaliers,TEAM,TOTAL,TOTAL,False,,31,52,31,42,0,10,10,16,7,36,43,18,4,5,10,15,72
400915233,St. Francis Brooklyn Terriers,J. Nurse,3948801,,True,12.0,1,1,1,1,0,0,1,2,0,0,0,0,0,0,1,3,3
400915233,St. Francis Brooklyn Terriers,K. Williams,3155881,,True,17.0,0,4,0,2,0,2,0,0,0,0,0,0,0,0,0,0,0
400915233,St. Francis Brooklyn Terriers,G. Olafsson,3133978,,True,25.0,3,6,2,4,1,2,0,0,0,4,4,1,1,0,1,1,7
400915233,St. Francis Brooklyn Terriers,G. Sanabria,3133979,,True,32.0,4,11,2,4,2,7,0,0,0,0,0,1,1,0,0,2,10
400915233,St. Francis Brooklyn Terriers,Y. Hopkinson,66961,,True,26.0,1,10,0,3,1,7,2,3,0,5,5,1,2,0,5,1,5
400915233,St. Francis Brooklyn Terriers,D.J. Porter,4067954,,False,12.0,1,5,0,2,1,3,0,0,0,2,2,0,0,0,2,2,3
400915233,St. Francis Brooklyn Terriers,J. Bodrick,4067952,,False,14.0,0,1,0,1,0,0,0,0,0,1,1,0,0,0,0,4,0
400915233,St. Francis Brooklyn Terriers,R. Montgomery,4067951,,False,28.0,1,4,1,4,0,0,0,0,0,3,3,0,0,1,1,2,2
400915233,St. Francis Brooklyn Terriers,J. Lasic,3948802,,False,2.0,0,0,0,0,0,0,0,0,0,0,0,1,0,0,0,0,0
400915233,St. Francis Brooklyn Terriers,R. Dunn,4067955,,False,24.0,0,5,0,1,0,4,2,2,0,1,1,0,0,0,2,1,2
400915233,St. Francis Brooklyn Terriers,G. Ford,4067950,,False,8.0,0,1,0,0,0,1,0,0,0,0,0,0,0,0,1,1,0
400915233,St. Francis Brooklyn Terriers,TEAM,TOTAL,TOTAL,False,,11,48,6,22,5,26,5,7,3,17,20,4,4,1,13,17,32
400915232,Syracuse Orange,T. Lydon,3934662,,True,24.0,6,7,4,4,2,3,3,4,3,3,6,1,0,0,2,2,17
400915232,Syracuse Orange,T. Roberson,67633,,True,26.0,5,7,5,7,0,0,2,2,1,5,6,1,1,0,0,2,12
400915232,Syracuse Orange,D. Coleman,61821,,True,12.0,0,1,0,1,0,0,1,2,2,4,6,0,0,0,1,1,1
400915232,Syracuse Orange,F. Howard,3934659,,True,20.0,3,5,2,3,1,2,0,0,0,1,1,3,1,1,1,1,7
400915232,Syracuse Orange,A. White III,61616,,True,25.0,5,12,0,2,5,10,4,4,0,3,3,3,1,0,0,0,19
400915232,Syracuse Orange,T. Thompson,4065721,,False,18.0,5,7,5,7,0,0,0,0,2,0,2,0,0,0,0,1,10
400915232,Syracuse Orange,D. Akintobi-Adeyeye,3155403,,False,2.0,0,1,0,1,0,0,0,0,0,1,1,0,0,1,0,0,0
400915232,Syracuse Orange,P. Chukwu,3136471,,False,22.0,0,0,0,0,0,0,0,0,0,5,5,1,1,3,2,3,0
400915232,Syracuse Orange,R. Featherston,4065723,,False,1.0,0,0,0,0,0,0,0,0,0,0,0,0,0,0,0,0,0
400915232,Syracuse Orange,T. Battle,4065722,,False,24.0,3,7,0,2,3,5,0,0,1,1,2,4,3,1,0,0,9
400915232,Syracuse Orange,J. Radner,3934666,,False,1.0,0,0,0,0,0,0,0,0,0,0,0,0,0,0,1,0,0
400915232,Syracuse Orange,K. Feldman,3934665,,False,2.0,0,1,0,0,0,1,0,0,0,0,0,0,0,0,0,0,0
400915232,Syracuse Orange,E. Dourdas,3934664,,False,1.0,0,0,0,0,0,0,0,0,0,0,0,0,0,0,1,0,0
400915232,Syracuse Orange,A. Autry,3934661,,False,2.0,0,1,0,0,0,1,0,0,0,0,0,0,0,0,0,0,0
400915232,Syracuse Orange,S. Belbey,3934660,,False,2.0,0,0,0,0,0,0,0,0,0,0,0,0,0,0,0,0,0
400915232,Syracuse Orange,J. Gillon,61915,,False,18.0,6,8,4,5,2,3,1,1,1,0,1,9,2,0,1,1,15
400915232,Syracuse Orange,TEAM,TOTAL,TOTAL,False,,33,57,20,32,13,25,11,13,15,24,39,22,9,6,9,11,90
400915232,Holy Cross Crusaders,J. Floyd,3907455,,True,19.0,2,2,2,2,0,0,1,2,1,0,1,2,0,1,2,5,5
400915232,Holy Cross Crusaders,M. Alexander,67198,,True,37.0,3,11,1,3,2,8,0,0,3,4,7,1,1,0,4,2,8
400915232,Holy Cross Crusaders,R. Champion,67199,,True,34.0,3,15,1,6,2,9,0,3,1,3,4,2,1,0,2,2,8
400915232,Holy Cross Crusaders,P. Benzan,3907453,,True,22.0,2,5,1,3,1,2,0,0,1,0,1,0,1,0,1,1,5
400915232,Holy Cross Crusaders,A. Thompson,67197,,True,30.0,4,10,0,1,4,9,0,0,1,1,2,1,0,0,0,4,12
400915232,Holy Cross Crusaders,K. Charles,3907454,,False,19.0,1,1,1,1,0,0,1,1,1,1,2,3,1,0,3,2,3
400915232,Holy Cross Crusaders,J. Stevens,4067112,,False,1.0,0,0,0,0,0,0,0,0,0,0,0,0,0,0,0,0,0
400915232,Holy Cross Crusaders,M. Husek,67201,,False,13.0,0,3,0,2,0,1,1,2,1,0,1,0,0,0,0,0,1
400915232,Holy Cross Crusaders,T. Cohen,4067111,,False,2.0,0,1,0,1,0,0,0,0,0,1,1,0,0,0,0,0,0
400915232,Holy Cross Crusaders,C. Le Sann,4067110,,False,8.0,2,3,2,2,0,1,0,0,1,0,1,0,0,0,0,0,4
400915232,Holy Cross Crusaders,T. Kennedy,3948833,,False,1.0,0,1,0,1,0,0,0,0,2,0,2,0,1,0,0,0,0
400915232,Holy Cross Crusaders,P. Rielly,3948832,,False,1.0,0,1,0,1,0,0,0,0,1,0,1,0,0,0,0,0,0
400915232,Holy Cross Crusaders,M. Zignorski,3907457,,False,13.0,0,2,0,0,0,2,0,0,0,0,0,1,1,0,0,0,0
400915232,Holy Cross Crusaders,TEAM,TOTAL,TOTAL,False,,17,55,8,23,9,32,3,8,16,11,27,10,6,1,13,16,46
400915231,North Carolina Tar Heels,J. Jackson,3138156,,True,29.0,6,13,6,9,0,4,2,3,3,7,10,2,1,0,1,2,14
400915231,North Carolina Tar Heels,I. Hicks,66874,,True,25.0,4,8,4,8,0,0,0,0,2,1,3,2,1,0,2,2,8
400915231,North Carolina Tar Heels,K. Meeks,66873,,True,22.0,7,14,7,14,0,0,1,4,4,3,7,0,0,0,0,2,15
400915231,North Carolina Tar Heels,J. Berry II,3138155,,True,21.0,7,10,5,6,2,4,7,7,1,5,6,4,1,0,2,3,23
400915231,North Carolina Tar Heels,N. Britt,66872,,True,20.0,2,3,1,1,1,2,2,3,0,1,1,2,1,0,0,1,7
400915231,North Carolina Tar Heels,A. Rohlman,4065677,,False,3.0,0,0,0,0,0,0,0,0,0,2,2,0,0,0,0,0,0
400915231,North Carolina Tar Heels,S. Rush,4065674,,False,2.0,1,1,1,1,0,0,1,2,0,0,0,0,0,0,0,0,3
400915231,North Carolina Tar Heels,T. Bradley,4065673,,False,18.0,3,3,3,3,0,0,4,7,2,3,5,1,0,0,2,4,10
400915231,North Carolina Tar Heels,S. Woods,4065676,,False,17.0,0,1,0,1,0,0,0,0,0,2,2,6,1,0,3,2,0
400915231,North Carolina Tar Heels,B. Robinson,4065675,,False,21.0,1,3,0,0,1,3,4,5,0,3,3,2,0,0,2,0,7
400915231,North Carolina Tar Heels,K. Coker,3947144,,False,2.0,0,1,0,1,0,0,0,0,0,0,0,0,0,0,1,1,0
400915231,North Carolina Tar Heels,K. Williams,3911619,,False,17.0,1,3,0,1,1,2,1,2,2,3,5,1,0,0,0,1,4
400915231,North Carolina Tar Heels,S. White,56963,,False,3.0,0,0,0,0,0,0,2,2,0,0,0,0,0,0,0,0,2
400915231,North Carolina Tar Heels,TEAM,TOTAL,TOTAL,False,,32,60,27,45,5,15,24,35,14,31,45,20,5,0,13,18,93
400915231,Long Beach State Beach,J. Jackson,4066921,,True,14.0,0,1,0,1,0,0,2,2,0,1,1,0,2,0,3,2,2
400915231,Long Beach State Beach,M. Riggins,3946948,,True,14.0,2,4,2,4,0,0,0,3,2,0,2,0,0,0,1,4,4
400915231,Long Beach State Beach,G. Levin,68087,,True,29.0,8,16,7,11,1,5,0,3,2,8,10,0,0,0,0,2,17
400915231,Long Beach State Beach,J. Bibbins,3137254,,True,27.0,0,5,0,2,0,3,2,2,1,2,3,4,1,0,2,1,2
400915231,Long Beach State Beach,E. Payne,68089,,True,17.0,3,10,2,4,1,6,2,2,0,1,1,1,0,0,1,1,9
400915231,Long Beach State Beach,L. Williams,3946950,,False,7.0,1,5,1,5,0,0,0,0,1,2,3,0,0,1,0,3,2
400915231,Long Beach State Beach,R. Prince,66229,,False,24.0,2,4,2,4,0,0,3,3,3,2,5,2,0,0,1,4,7
400915231,Long Beach State Beach,T. Yussuf,3137252,,False,6.0,1,1,1,1,0,0,2,2,1,1,2,0,0,0,1,5,4
400915231,Long Beach State Beach,J. Griffin,4066920,,False,17.0,4,6,1,1,3,5,0,0,1,1,2,1,0,0,1,0,11
400915231,Long Beach State Beach,L. Jackson,4066919,,False,13.0,1,3,0,1,1,2,0,0,0,0,0,2,0,0,2,2,3
400915231,Long Beach State Beach,N. Blackwell,3946947,,False,24.0,1,8,1,4,0,4,2,2,1,2,3,2,2,0,1,4,4
400915231,Long Beach State Beach,A. Moye,66672,,False,8.0,1,3,1,2,0,1,0,0,0,1,1,1,1,0,0,0,2
400915231,Long Beach State Beach,TEAM,TOTAL,TOTAL,False,,24,66,18,40,6,26,13,19,12,21,33,13,6,1,14,28,67
400915230,Iona Gaels,J. Washington,3948701,,True,16.0,5,9,5,9,0,0,6,7,1,1,2,0,1,0,0,5,16
400915230,Iona Gaels,R. McGill,3948698,,True,30.0,2,5,1,3,1,2,3,4,2,2,4,2,1,0,2,3,8
400915230,Iona Gaels,D. Much,67042,,True,26.0,2,12,1,4,1,8,0,0,0,2,2,2,0,1,2,0,5
400915230,Iona Gaels,J. Severe,66390,,True,28.0,5,6,4,5,1,1,1,1,0,5,5,3,3,0,3,3,12
400915230,Iona Gaels,S. Cassell Jr.,61797,,True,36.0,8,21,3,7,5,14,7,8,1,1,2,3,1,0,2,1,28
400915230,Iona Gaels,T. Williams,3137772,,False,19.0,1,1,1,1,0,0,2,2,3,4,7,0,1,1,0,5,4
400915230,Iona Gaels,J. Svandrlik,4067297,,False,14.0,1,3,1,1,0,2,0,0,2,2,4,1,1,0,2,3,2
400915230,Iona Gaels,D. Turner,4067296,,False,11.0,0,2,0,1,0,1,0,2,1,0,1,0,1,0,0,2,0
400915230,Iona Gaels,E.J. Crawford,4067295,,False,10.0,1,3,0,1,1,2,0,0,0,0,0,0,0,1,0,5,3
400915230,Iona Gaels,S. Casimir,3155750,,False,10.0,0,5,0,4,0,1,0,0,0,0,0,1,1,0,2,0,0
400915230,Iona Gaels,TEAM,TOTAL,TOTAL,False,,25,67,16,36,9,31,19,24,12,19,31,12,10,3,14,27,78
400915230,Florida State Seminoles,J. Isaac,4065654,,True,23.0,6,8,4,5,2,3,6,7,2,4,6,0,2,1,1,1,20
400915230,Florida State Seminoles,M. Ojo,61596,,True,5.0,1,1,1,1,0,0,1,2,1,1,2,0,0,0,2,1,3
400915230,Florida State Seminoles,T. Mann,3907823,,True,23.0,5,5,5,5,0,0,2,2,1,5,6,3,0,1,4,5,12
400915230,Florida State Seminoles,D. Bacon,3907821,,True,26.0,3,7,2,3,1,4,3,3,1,2,3,2,2,0,2,0,10
400915230,Florida State Seminoles,X. Rathan-Mayes,66125,,True,21.0,2,6,1,2,1,4,4,8,0,4,4,2,0,1,2,2,9
400915230,Florida State Seminoles,P. Cofer,3135054,,False,20.0,6,8,6,8,0,0,1,3,4,2,6,0,0,0,2,1,13
400915230,Florida State Seminoles,J. Smith,66126,,False,23.0,3,5,3,4,0,1,6,6,0,7,7,0,0,0,0,3,12
400915230,Florida State Seminoles,C. Koumadje,3907824,,False,7.0,1,2,1,2,0,0,0,0,0,0,0,0,0,0,1,2,2
400915230,Florida State Seminoles,B. Angola-Rodas,4065658,,False,16.0,1,5,1,3,0,2,0,0,0,5,5,1,1,0,2,2,2
400915230,Florida State Seminoles,T. Forrest,4065656,,False,21.0,5,8,5,7,0,1,0,4,2,1,3,2,2,1,3,3,10
400915230,Florida State Seminoles,C. Walker,4065655,,False,15.0,1,4,1,2,0,2,4,5,1,0,1,0,0,0,0,1,6
400915230,Florida State Seminoles,TEAM,TOTAL,TOTAL,False,,34,59,30,42,4,17,27,40,13,32,45,10,7,4,20,21,99
400915229,William & Mary Tribe,P. Rowley,3129966,,True,18.0,1,4,0,0,1,4,0,0,0,3,3,0,0,0,2,1,3
400915229,William & Mary Tribe,J. Whitman,67189,,True,19.0,1,4,1,4,0,0,1,2,2,4,6,0,0,1,0,4,3
400915229,William & Mary Tribe,O. Prewitt,67186,,True,32.0,4,13,2,6,2,7,4,5,0,2,2,1,0,0,5,0,14
400915229,William & Mary Tribe,D. Dixon,67184,,True,25.0,1,6,0,1,1,5,4,4,0,6,6,1,0,0,1,4,7
400915229,William & Mary Tribe,D. Cohn,66345,,True,26.0,2,6,1,3,1,3,3,4,0,4,4,4,0,1,2,2,8
400915229,William & Mary Tribe,N. Knight,4067325,,False,20.0,6,12,6,11,0,1,2,9,2,5,7,1,1,0,2,4,14
400915229,William & Mary Tribe,J. Pierce,4067326,,False,20.0,1,5,1,2,0,3,0,1,1,1,2,2,0,0,1,1,2
400915229,William & Mary Tribe,G. Malinowski,3129965,,False,9.0,1,3,1,2,0,1,0,0,1,1,2,0,0,0,2,3,2
400915229,William & Mary Tribe,O. Tot,3129967,,False,10.0,0,1,0,0,0,1,0,0,0,0,0,1,0,1,0,1,0
400915229,William & Mary Tribe,C. Burchfield,3129964,,False,16.0,2,7,1,3,1,4,0,0,1,1,2,1,1,0,0,1,5
400915229,William & Mary Tribe,M. Schlotman,67188,,False,5.0,0,0,0,0,0,0,0,2,1,0,1,0,0,0,1,0,0
400915229,William & Mary Tribe,TEAM,TOTAL,TOTAL,False,,19,61,13,32,6,29,14,27,14,28,42,11,2,3,16,21,58
400915229,Louisville Cardinals,M. Mathiang,63035,,True,23.0,1,2,1,2,0,0,1,6,2,8,10,2,0,5,0,1,3
400915229,Louisville Cardinals,D. Adel,3908807,,True,27.0,4,9,3,4,1,5,7,7,1,4,5,5,4,0,0,1,16
400915229,Louisville Cardinals,J. Johnson,3147362,,True,25.0,5,8,5,8,0,0,3,4,5,4,9,0,1,0,1,3,13
400915229,Louisville Cardinals,D. Mitchell,3908809,,True,29.0,4,10,3,5,1,5,0,0,1,4,5,3,1,4,2,3,9
400915229,Louisville Cardinals,Q. Snider,3147360,,True,26.0,4,11,0,2,4,9,1,2,0,3,3,4,0,0,2,1,13
400915229,Louisville Cardinals,V.J. King,4065666,,False,17.0,7,11,4,8,3,3,0,0,2,3,5,0,1,0,1,2,17
400915229,Louisville Cardinals,R. Spalding,3908806,,False,16.0,5,6,5,6,0,0,0,1,1,3,4,0,1,1,1,4,10
400915229,Louisville Cardinals,A. Mahmoud,3147363,,False,14.0,1,2,1,2,0,0,0,0,2,1,3,1,2,1,1,4,2
400915229,Louisville Cardinals,M. Stockman,3147361,,False,1.0,0,0,0,0,0,0,0,0,0,1,1,0,0,0,0,0,0
400915229,Louisville Cardinals,R. McMahon,3908808,,False,5.0,0,1,0,0,0,1,0,0,0,0,0,3,0,0,0,0,0
400915229,Louisville Cardinals,J. Henderson,3155491,,False,1.0,1,1,0,0,1,1,0,0,0,0,0,0,0,0,0,3,3
400915229,Louisville Cardinals,D. Levitch,66592,,False,4.0,0,2,0,1,0,1,1,3,1,0,1,0,0,0,0,0,1
400915229,Louisville Cardinals,T. Hicks,62752,,False,12.0,1,9,1,6,0,3,2,2,1,1,2,3,0,0,1,1,4
400915229,Louisville Cardinals,TEAM,TOTAL,TOTAL,False,,33,72,23,44,10,28,15,25,17,32,49,21,10,11,9,23,91
400915228,Pittsburgh Panthers,R. Luther,3138197,,True,20.0,3,5,3,4,0,1,2,3,1,5,6,3,1,0,3,0,8
400915228,Pittsburgh Panthers,S. Jeter,61756,,True,27.0,4,9,2,6,2,3,4,6,5,8,13,4,3,1,1,2,14
400915228,Pittsburgh Panthers,J. Artis,66287,,True,21.0,5,8,4,5,1,3,0,0,1,2,3,6,1,0,4,2,11
400915228,Pittsburgh Panthers,C. Johnson,3138196,,True,25.0,7,8,3,4,4,4,0,0,1,3,4,4,1,1,1,1,18
400915228,Pittsburgh Panthers,C. Jones,61219,,True,23.0,3,6,1,3,2,3,0,2,2,2,4,5,0,1,2,2,8
400915228,Pittsburgh Panthers,R. Nix,3934653,,False,4.0,0,1,0,1,0,0,0,0,1,3,4,0,0,1,0,1,0
400915228,Pittsburgh Panthers,C. Manigault,4065714,,False,11.0,1,2,1,2,0,0,0,0,0,2,2,0,0,1,0,3,2
400915228,Pittsburgh Panthers,R. Seelye,3947153,,False,2.0,1,1,1,1,0,0,0,0,0,0,0,0,0,0,0,0,2
400915228,Pittsburgh Panthers,M. Young,66290,,False,15.0,6,10,4,7,2,3,4,4,3,4,7,1,0,0,0,3,18
400915228,Pittsburgh Panthers,J. Kithcart,4065713,,False,17.0,1,6,1,4,0,2,1,5,0,1,1,3,0,0,2,2,3
400915228,Pittsburgh Panthers,J. Milligan,3934655,,False,17.0,2,6,0,0,2,6,4,4,0,1,1,2,0,0,2,1,10
400915228,Pittsburgh Panthers,Z. Smith,3934654,,False,2.0,0,0,0,0,0,0,0,0,0,0,0,0,0,0,1,0,0
400915228,Pittsburgh Panthers,D. Wilson,3934652,,False,16.0,2,3,2,2,0,1,1,1,0,4,4,1,0,0,2,2,5
400915228,Pittsburgh Panthers,TEAM,TOTAL,TOTAL,False,,35,65,22,39,13,26,16,25,14,36,50,29,6,5,19,19,99
400915228,Gardner-Webb Runnin' Bulldogs,L. Niangane,3129913,,True,11.0,0,2,0,2,0,0,0,0,1,1,2,0,0,0,0,1,0
400915228,Gardner-Webb Runnin' Bulldogs,T. Nelson,66568,,True,29.0,4,8,4,8,0,0,2,2,2,0,2,1,0,1,1,4,10
400915228,Gardner-Webb Runnin' Bulldogs,L. O'Reilly,4067337,,True,32.0,6,11,5,7,1,4,1,1,1,4,5,0,2,0,2,2,14
400915228,Gardner-Webb Runnin' Bulldogs,J. Robateau,3922036,,True,19.0,1,4,0,2,1,2,0,0,0,5,5,3,2,0,1,2,3
400915228,Gardner-Webb Runnin' Bulldogs,L. Rideau,3922039,,True,34.0,6,18,6,16,0,2,11,13,2,6,8,6,4,0,4,2,23
400915228,Gardner-Webb Runnin' Bulldogs,E. Jamison Jr.,3922038,,False,11.0,0,1,0,0,0,1,0,1,0,0,0,1,0,0,0,3,0
400915228,Gardner-Webb Runnin' Bulldogs,P. Zeck,4067339,,False,15.0,1,1,1,1,0,0,0,0,1,2,3,0,0,0,0,4,2
400915228,Gardner-Webb Runnin' Bulldogs,D. Laster,3922040,,False,18.0,4,8,4,7,0,1,0,0,1,0,1,1,0,0,0,0,8
400915228,Gardner-Webb Runnin' Bulldogs,C. Turner,4067336,,False,6.0,0,3,0,2,0,1,0,0,0,0,0,1,0,0,1,3,0
400915228,Gardner-Webb Runnin' Bulldogs,J. Jenkins,3922037,,False,2.0,0,1,0,0,0,1,0,0,0,0,0,0,0,0,0,0,0
400915228,Gardner-Webb Runnin' Bulldogs,D. Efianayi,3129910,,False,23.0,9,16,7,13,2,3,0,1,1,1,2,0,0,0,0,1,20
400915228,Gardner-Webb Runnin' Bulldogs,TEAM,TOTAL,TOTAL,False,,31,73,27,58,4,15,14,18,9,21,30,13,8,1,9,22,80
400915227,Southern Jaguars,P. Smith,3918774,,True,26.0,1,8,1,6,0,2,0,0,1,1,2,0,0,0,1,5,2
400915227,Southern Jaguars,J. Sam,3154920,,True,37.0,1,8,1,8,0,0,3,3,2,4,6,0,0,1,0,3,5
400915227,Southern Jaguars,S. Prudhomme,3154924,,True,33.0,6,14,4,9,2,5,1,2,2,0,2,1,1,1,0,4,15
400915227,Southern Jaguars,J. Weatherspoon,3143733,,True,21.0,3,13,3,13,0,0,1,3,4,7,11,1,2,0,1,3,7
400915227,Southern Jaguars,T. Banks,67607,,True,34.0,7,9,4,6,3,3,2,2,0,1,1,4,1,0,2,4,19
400915227,Southern Jaguars,B. Bolden,61851,,False,4.0,0,1,0,1,0,0,0,2,1,0,1,0,0,1,0,2,0
400915227,Southern Jaguars,J. Robinson,4067981,,False,16.0,2,8,1,2,1,6,0,0,0,1,1,3,1,0,2,1,5
400915227,Southern Jaguars,B. Ganaway,3918772,,False,6.0,1,2,1,1,0,1,0,0,0,0,0,0,0,0,1,2,2
400915227,Southern Jaguars,C. Thomas,3154923,,False,19.0,3,8,2,5,1,3,0,0,2,7,9,0,0,0,2,2,7
400915227,Southern Jaguars,L. Collins,3154922,,False,4.0,0,1,0,1,0,0,0,0,0,0,0,0,0,0,0,0,0
400915227,Southern Jaguars,TEAM,TOTAL,TOTAL,False,,24,72,17,52,7,20,7,12,17,23,40,9,5,3,10,26,62
400915227,Georgia Tech Yellow Jackets,A. Gueye,3135059,,True,26.0,1,4,1,2,0,2,0,1,1,4,5,1,0,1,1,2,2
400915227,Georgia Tech Yellow Jackets,Q. Stephens,66128,,True,33.0,3,8,2,3,1,5,5,6,2,5,7,4,0,3,2,2,12
400915227,Georgia Tech Yellow Jackets,B. Lammers,3135061,,True,33.0,6,9,6,9,0,0,1,2,5,10,15,1,1,9,2,3,13
400915227,Georgia Tech Yellow Jackets,J. Okogie,4065663,,True,34.0,6,15,6,14,0,1,6,10,1,3,4,4,2,1,0,1,18
400915227,Georgia Tech Yellow Jackets,J. Moore,4065662,,True,10.0,1,3,1,2,0,1,0,0,1,0,1,2,0,0,2,4,2
400915227,Georgia Tech Yellow Jackets,C. Matthews,4065665,,False,4.0,0,1,0,1,0,0,1,2,0,0,0,0,0,1,0,1,1
400915227,Georgia Tech Yellow Jackets,S. Ogbonda,3904627,,False,7.0,1,2,1,2,0,0,0,0,0,1,1,0,0,0,1,1,2
400915227,Georgia Tech Yellow Jackets,R. Rowland,67543,,False,0.0,0,0,0,0,0,0,0,0,0,0,0,0,0,0,0,0,0
400915227,Georgia Tech Yellow Jackets,K. McCormick,61453,,False,1.0,0,0,0,0,0,0,0,0,0,0,0,0,0,0,0,0,0
400915227,Georgia Tech Yellow Jackets,T. Jackson,3135057,,False,21.0,8,11,7,10,1,1,3,8,1,4,5,1,0,1,1,1,20
400915227,Georgia Tech Yellow Jackets,J. Price,61778,,False,1.0,0,1,0,0,0,1,0,0,0,0,0,0,0,0,0,0,0
400915227,Georgia Tech Yellow Jackets,C. Heyward,61609,,False,30.0,2,3,0,1,2,2,1,2,0,2,2,1,1,0,3,3,7
400915227,Georgia Tech Yellow Jackets,TEAM,TOTAL,TOTAL,False,,28,57,24,44,4,13,17,31,12,31,43,14,4,16,12,17,77
400915226,North Carolina Tar Heels,J. Jackson,3138156,,True,28.0,4,13,2,8,2,5,0,0,1,1,2,5,2,0,0,1,10
400915226,North Carolina Tar Heels,I. Hicks,66874,,True,27.0,5,10,5,10,0,0,3,4,1,4,5,2,1,1,4,3,13
400915226,North Carolina Tar Heels,K. Meeks,66873,,True,22.0,6,12,6,12,0,0,2,2,5,7,12,0,2,3,2,0,14
400915226,North Carolina Tar Heels,J. Berry II,3138155,,True,28.0,5,8,3,4,2,4,6,6,0,4,4,5,1,0,1,2,18
400915226,North Carolina Tar Heels,N. Britt,66872,,True,22.0,1,1,0,0,1,1,0,0,1,1,2,3,1,0,3,1,3
400915226,North Carolina Tar Heels,A. Rohlman,4065677,,False,2.0,0,0,0,0,0,0,0,0,0,1,1,1,0,0,0,0,0
400915226,North Carolina Tar Heels,S. Rush,4065674,,False,2.0,1,2,1,2,0,0,0,0,0,2,2,0,0,0,0,1,2
400915226,North Carolina Tar Heels,T. Bradley,4065673,,False,15.0,4,7,4,7,0,0,4,8,7,1,8,1,1,0,1,1,12
400915226,North Carolina Tar Heels,L. Maye,3911620,,False,8.0,1,1,1,1,0,0,1,2,1,1,2,2,1,0,2,1,3
400915226,North Carolina Tar Heels,S. Woods,4065676,,False,12.0,1,3,0,2,1,1,3,6,0,0,0,1,1,0,1,1,6
400915226,North Carolina Tar Heels,B. Robinson,4065675,,False,11.0,2,6,2,4,0,2,1,2,1,2,3,1,1,0,0,0,5
400915226,North Carolina Tar Heels,K. Coker,3947144,,False,2.0,0,0,0,0,0,0,0,0,0,0,0,0,0,0,0,0,0
400915226,North Carolina Tar Heels,K. Williams,3911619,,False,18.0,4,7,3,5,1,2,2,2,4,2,6,5,3,0,1,1,11
400915226,North Carolina Tar Heels,S. White,56963,,False,3.0,0,0,0,0,0,0,0,0,0,0,0,0,0,0,0,1,0
400915226,North Carolina Tar Heels,TEAM,TOTAL,TOTAL,False,,34,70,27,55,7,15,22,32,22,29,51,26,14,4,15,13,97
400915226,Chattanooga Mocs,T. McLean,67227,,True,32.0,0,5,0,2,0,3,0,0,2,2,4,0,1,0,5,1,0
400915226,Chattanooga Mocs,J. Tuoyo,62610,,True,31.0,3,9,3,9,0,0,2,2,3,6,9,1,1,3,1,1,8
400915226,Chattanooga Mocs,G. Pryor,67228,,True,27.0,7,12,4,6,3,6,0,0,1,0,1,3,3,0,5,4,17
400915226,Chattanooga Mocs,J. Burroughs-Cook,67155,,True,15.0,1,7,1,6,0,1,0,0,2,1,3,2,0,0,5,4,2
400915226,Chattanooga Mocs,C. Jones,62223,,True,22.0,4,6,3,4,1,2,1,1,1,1,2,0,0,0,3,3,10
400915226,Chattanooga Mocs,T. Massenburg,4067254,,False,3.0,0,0,0,0,0,0,1,2,0,1,1,0,0,1,0,0,1
400915226,Chattanooga Mocs,M. London,3136482,,False,13.0,2,5,1,2,1,3,0,0,0,1,1,1,1,0,2,3,5
400915226,Chattanooga Mocs,M. Foreman,4067252,,False,3.0,0,1,0,0,0,1,0,0,0,0,0,0,0,0,0,0,0
400915226,Chattanooga Mocs,N. Dixon,4067251,,False,12.0,1,2,1,1,0,1,1,2,2,0,2,1,0,0,0,4,3
400915226,Chattanooga Mocs,R. Chatman,4067250,,False,16.0,2,8,2,6,0,2,0,0,1,2,3,3,0,0,5,2,4
400915226,Chattanooga Mocs,P. Woods,3907297,,False,26.0,2,8,0,0,2,8,1,2,0,1,1,0,1,0,0,3,7
400915226,Chattanooga Mocs,TEAM,TOTAL,TOTAL,False,,22,63,15,36,7,27,6,9,15,17,32,11,7,4,26,25,57
400915225,Wake Forest Demon Deacons,J. Collins,3908845,,True,24.0,4,10,4,10,0,0,11,14,5,4,9,0,2,1,1,3,19
400915225,Wake Forest Demon Deacons,D. Mitoglou,3138224,,True,21.0,3,8,1,3,2,5,3,3,3,4,7,0,0,2,3,4,11
400915225,Wake Forest Demon Deacons,A. Arians,61378,,True,22.0,3,7,0,1,3,6,1,1,1,3,4,0,1,0,2,2,10
400915225,Wake Forest Demon Deacons,B. Crawford,3908844,,True,31.0,3,9,3,6,0,3,2,2,0,3,3,8,1,0,0,3,8
400915225,Wake Forest Demon Deacons,M. Wilbekin,3138222,,True,28.0,5,7,2,3,3,4,0,0,1,3,4,1,0,0,0,1,13
400915225,Wake Forest Demon Deacons,R. Washington,4065753,,False,3.0,0,1,0,0,0,1,0,0,0,0,0,0,0,0,0,0,0
400915225,Wake Forest Demon Deacons,G. McClinton,66140,,False,13.0,1,3,1,3,0,0,0,2,3,0,3,0,0,0,1,1,2
400915225,Wake Forest Demon Deacons,D. Moore,3908843,,False,12.0,0,0,0,0,0,0,2,2,0,2,2,0,0,3,2,1,2
400915225,Wake Forest Demon Deacons,B. Childress,4065750,,False,18.0,2,4,2,3,0,1,3,3,0,2,2,5,0,0,0,0,7
400915225,Wake Forest Demon Deacons,K. Woods,3132360,,False,27.0,8,9,3,3,5,6,1,2,1,3,4,2,0,0,0,1,22
400915225,Wake Forest Demon Deacons,T. VanHorn,3078214,,False,1.0,0,0,0,0,0,0,0,0,0,0,0,0,0,0,0,0,0
400915225,Wake Forest Demon Deacons,TEAM,TOTAL,TOTAL,False,,29,58,16,32,13,26,23,29,15,25,40,16,4,6,9,16,94
400915225,Bucknell Bison,Z. Thomas,3149021,,True,30.0,6,12,3,7,3,5,1,1,1,2,3,1,0,0,3,4,16
400915225,Bucknell Bison,N. Foulland,3149020,,True,23.0,5,9,5,9,0,0,0,1,1,7,8,0,1,2,2,3,10
400915225,Bucknell Bison,N. Jones,3914280,,True,29.0,3,6,2,3,1,3,1,1,1,0,1,2,0,0,2,0,8
400915225,Bucknell Bison,K. Mackenzie,3914278,,True,30.0,6,12,4,8,2,4,1,2,2,0,2,1,4,0,1,2,15
400915225,Bucknell Bison,S. Brown,3149018,,True,31.0,2,5,2,3,0,2,1,2,0,3,3,5,0,0,2,0,5
400915225,Bucknell Bison,N. Sestina,3914279,,False,12.0,5,8,4,7,1,1,1,1,3,1,4,0,0,0,0,4,12
400915225,Bucknell Bison,B. Moore,4067103,,False,8.0,1,3,0,0,1,3,0,0,1,0,1,0,0,0,0,5,3
400915225,Bucknell Bison,D.J. MacLeay,67096,,False,9.0,1,3,1,1,0,2,0,1,2,3,5,0,0,0,0,4,2
400915225,Bucknell Bison,B. Robertson,4067104,,False,4.0,0,1,0,1,0,0,0,0,2,0,2,0,0,0,0,0,0
400915225,Bucknell Bison,A. Toomer,4067102,,False,4.0,0,1,0,1,0,0,0,0,0,0,0,1,0,0,0,0,0
400915225,Bucknell Bison,M. O'Reilly,3914281,,False,9.0,0,3,0,0,0,3,0,0,0,0,0,1,0,0,0,1,0
400915225,Bucknell Bison,J. Azzinaro,67097,,False,12.0,1,4,0,2,1,2,0,0,0,0,0,1,0,0,0,1,3
400915225,Bucknell Bison,TEAM,TOTAL,TOTAL,False,,30,67,21,42,9,25,5,9,15,17,32,12,5,2,10,24,74
400915224,St. Francis Brooklyn Terriers,J. Nurse,3948801,,True,5.0,1,1,1,1,0,0,0,1,1,0,1,0,0,0,1,3,2
400915224,St. Francis Brooklyn Terriers,K. Williams,3155881,,True,15.0,1,4,1,2,0,2,0,1,1,1,2,0,1,0,1,1,2
400915224,St. Francis Brooklyn Terriers,G. Sanabria,3133979,,True,32.0,4,13,2,8,2,5,4,5,0,2,2,3,1,0,0,4,14
400915224,St. Francis Brooklyn Terriers,G. Olafsson,3133978,,True,25.0,3,6,2,3,1,3,1,2,4,5,9,2,2,0,2,2,8
400915224,St. Francis Brooklyn Terriers,Y. Hopkinson,66961,,True,35.0,4,11,1,2,3,9,2,2,1,1,2,3,0,0,4,3,13
400915224,St. Francis Brooklyn Terriers,D.J. Porter,4067954,,False,14.0,1,3,1,2,0,1,2,2,1,2,3,0,0,0,1,2,4
400915224,St. Francis Brooklyn Terriers,J. Bodrick,4067952,,False,12.0,1,4,1,4,0,0,0,0,1,1,2,0,0,0,1,3,2
400915224,St. Francis Brooklyn Terriers,R. Montgomery,4067951,,False,20.0,2,5,2,5,0,0,0,0,1,1,2,0,1,0,1,3,4
400915224,St. Francis Brooklyn Terriers,J. Lasic,3948802,,False,3.0,0,0,0,0,0,0,0,0,0,0,0,0,0,0,0,1,0
400915224,St. Francis Brooklyn Terriers,S. Harris,4072617,,False,1.0,0,0,0,0,0,0,0,0,0,0,0,0,0,0,0,0,0
400915224,St. Francis Brooklyn Terriers,R. Dunn,4067955,,False,23.0,4,11,2,7,2,4,2,4,2,0,2,0,2,0,1,3,12
400915224,St. Francis Brooklyn Terriers,G. Ford,4067950,,False,15.0,0,4,0,2,0,2,0,0,0,1,1,1,0,0,1,0,0
400915224,St. Francis Brooklyn Terriers,TEAM,TOTAL,TOTAL,False,,21,62,13,36,8,26,11,17,16,14,30,9,7,0,13,25,61
400915224,NC State Wolfpack,A. Abu,3138158,,True,18.0,3,6,3,6,0,0,6,9,5,2,7,0,1,1,2,3,12
400915224,NC State Wolfpack,B. Anya,66134,,True,15.0,2,4,2,4,0,0,3,4,1,2,3,0,0,1,0,1,7
400915224,NC State Wolfpack,D. Smith Jr.,4065697,,True,26.0,3,9,3,7,0,2,6,7,1,2,3,3,1,0,1,4,12
400915224,NC State Wolfpack,T. Dorn,3132359,,True,31.0,9,11,8,8,1,3,2,4,1,6,7,1,3,0,3,2,21
400915224,NC State Wolfpack,T. Henderson,61215,,True,35.0,4,10,4,8,0,2,3,4,0,5,5,3,2,0,1,3,11
400915224,NC State Wolfpack,T. Kapita,4065701,,False,24.0,7,8,7,8,0,0,3,4,3,5,8,1,1,0,1,0,17
400915224,NC State Wolfpack,D. Hicks,4065698,,False,23.0,0,1,0,1,0,0,0,2,1,3,4,2,0,0,1,2,0
400915224,NC State Wolfpack,M. Johnson,4065699,,False,21.0,3,4,3,4,0,0,0,2,0,3,3,3,0,1,1,3,6
400915224,NC State Wolfpack,S. Kirk,3947150,,False,7.0,0,0,0,0,0,0,0,0,0,0,0,1,0,1,0,0,0
400915224,NC State Wolfpack,TEAM,TOTAL,TOTAL,False,,31,53,30,46,1,7,23,36,14,30,44,14,8,4,11,18,86
400915223,Notre Dame Fighting Irish,B. Colson,3138192,,True,28.0,8,11,7,8,1,3,6,6,2,7,9,1,1,2,1,2,23
400915223,Notre Dame Fighting Irish,M. Geben,3138191,,True,12.0,2,4,2,4,0,0,0,0,2,5,7,0,0,1,0,0,4
400915223,Notre Dame Fighting Irish,V.J. Beachem,66283,,True,33.0,7,12,6,10,1,2,7,7,0,5,5,0,1,3,1,0,22
400915223,Notre Dame Fighting Irish,M. Farrell,3138190,,True,28.0,2,8,2,6,0,2,0,0,0,1,1,6,3,0,1,2,4
400915223,Notre Dame Fighting Irish,S. Vasturia,66285,,True,31.0,6,14,5,9,1,5,3,4,1,1,2,2,0,0,0,4,16
400915223,Notre Dame Fighting Irish,J. Mooney,4065705,,False,4.0,0,0,0,0,0,0,0,0,0,2,2,1,0,0,0,0,0
400915223,Notre Dame Fighting Irish,E. Burns,3908337,,False,6.0,0,0,0,0,0,0,5,6,1,1,2,0,0,0,0,2,5
400915223,Notre Dame Fighting Irish,M. Gregory,3155402,,False,2.0,0,0,0,0,0,0,0,0,0,0,0,0,0,0,0,0,0
400915223,Notre Dame Fighting Irish,A. Torres,66286,,False,8.0,1,1,1,1,0,0,0,0,0,0,0,0,0,0,0,3,2
400915223,Notre Dame Fighting Irish,M. Ryan,3908336,,False,13.0,1,3,1,1,0,2,0,0,0,2,2,0,1,0,0,0,2
400915223,Notre Dame Fighting Irish,T. Gibbs,4065703,,False,18.0,1,4,1,4,0,0,3,4,0,0,0,2,1,0,0,1,5
400915223,Notre Dame Fighting Irish,R. Pflueger,3908335,,False,17.0,2,4,2,2,0,2,2,2,1,2,3,3,2,0,0,2,6
400915223,Notre Dame Fighting Irish,TEAM,TOTAL,TOTAL,False,,30,61,27,45,3,16,26,29,7,27,34,15,9,6,3,16,89
400915223,Bryant Bulldogs,M. Pettway,3947122,,True,27.0,2,5,2,5,0,0,0,0,2,4,6,2,0,0,2,2,4
400915223,Bryant Bulldogs,D. Garvin,66931,,True,25.0,2,6,2,6,0,0,0,0,3,9,12,0,0,2,0,4,4
400915223,Bryant Bulldogs,I. Ndugba,4067522,,True,30.0,4,10,4,7,0,3,0,0,0,3,3,5,0,0,3,2,8
400915223,Bryant Bulldogs,N. Zouzoua,3947120,,True,31.0,7,14,5,8,2,6,3,4,1,1,2,0,1,0,1,4,19
400915223,Bryant Bulldogs,H. Ware,3133956,,True,23.0,0,6,0,3,0,3,0,0,1,0,1,2,1,0,0,3,0
400915223,Bryant Bulldogs,S. Townes,4067527,,False,20.0,5,9,5,8,0,1,6,11,2,2,4,1,0,0,2,1,16
400915223,Bryant Bulldogs,G. Riley,3133958,,False,4.0,0,1,0,0,0,1,0,0,0,0,0,1,0,0,0,0,0
400915223,Bryant Bulldogs,T. Johnson,4067525,,False,3.0,0,2,0,0,0,2,0,0,0,1,1,0,0,0,0,0,0
400915223,Bryant Bulldogs,A. Grant,4067524,,False,26.0,4,6,1,1,3,5,2,2,0,3,3,4,0,0,3,5,13
400915223,Bryant Bulldogs,T. McHugh,3947121,,False,5.0,0,0,0,0,0,0,0,0,0,0,0,0,0,0,2,1,0
400915223,Bryant Bulldogs,J. Brickman,66929,,False,1.0,0,0,0,0,0,0,0,0,0,0,0,0,0,0,0,0,0
400915223,Bryant Bulldogs,T. Toe,66928,,False,2.0,0,0,0,0,0,0,0,0,0,0,0,0,0,0,0,0,0
400915223,Bryant Bulldogs,B. Kostur,66927,,False,3.0,0,0,0,0,0,0,0,0,0,2,2,0,0,0,0,2,0
400915223,Bryant Bulldogs,TEAM,TOTAL,TOTAL,False,,24,59,19,38,5,21,11,17,11,26,37,15,2,2,13,24,64
400915222,Grand Canyon Lopes,O. Frayer,4067332,,True,35.0,4,12,4,7,0,5,0,0,0,5,5,0,1,2,2,4,8
400915222,Grand Canyon Lopes,D. Clark,61573,,True,10.0,2,6,2,6,0,0,1,3,2,1,3,0,2,0,2,2,5
400915222,Grand Canyon Lopes,S. Carr,4067333,,True,38.0,8,17,8,16,0,1,2,3,2,1,3,8,0,0,8,3,18
400915222,Grand Canyon Lopes,G. Martin,3130581,,True,31.0,3,6,1,2,2,4,2,4,0,5,5,1,2,0,6,4,10
400915222,Grand Canyon Lopes,J. Braun,66700,,True,33.0,2,6,1,4,1,2,0,0,2,3,5,0,0,0,1,5,5
400915222,Grand Canyon Lopes,K. Smith,3130579,,False,15.0,2,3,2,3,0,0,0,0,1,0,1,0,0,0,0,3,4
400915222,Grand Canyon Lopes,K. Vernon,66377,,False,22.0,5,12,5,12,0,0,1,2,1,3,4,1,2,0,1,5,11
400915222,Grand Canyon Lopes,F. Aidoo,4067331,,False,16.0,0,0,0,0,0,0,0,0,0,1,1,1,0,0,1,0,0
400915222,Grand Canyon Lopes,TEAM,TOTAL,TOTAL,False,,26,62,23,50,3,12,6,12,10,21,31,11,7,2,21,26,61
400915222,Duke Blue Devils,A. Jefferson,61586,,True,28.0,6,7,6,7,0,0,3,6,2,5,7,1,3,5,2,2,15
400915222,Duke Blue Devils,C. Jeter,3913173,,True,22.0,0,2,0,2,0,0,3,4,1,1,2,0,3,3,2,4,3
400915222,Duke Blue Devils,L. Kennard,3913174,,True,36.0,5,7,3,4,2,3,2,4,0,5,5,6,2,0,4,2,14
400915222,Duke Blue Devils,G. Allen,3135045,,True,37.0,8,17,4,5,4,12,5,7,0,10,10,4,3,0,3,3,25
400915222,Duke Blue Devils,M. Jones,66563,,True,37.0,4,14,3,6,1,8,2,2,2,4,6,5,3,0,1,1,11
400915222,Duke Blue Devils,J. White,4065653,,False,4.0,1,1,1,1,0,0,1,2,0,1,1,0,0,0,0,0,3
400915222,Duke Blue Devils,J. DeLaurier,4065650,,False,6.0,1,1,1,1,0,0,0,0,1,0,1,1,0,0,0,2,2
400915222,Duke Blue Devils,A. Vrankovic,3913177,,False,5.0,0,1,0,1,0,0,2,2,1,1,2,1,0,0,0,1,2
400915222,Duke Blue Devils,F. Jackson,4065651,,False,25.0,7,10,3,4,4,6,3,4,2,2,4,2,0,0,3,4,21
400915222,Duke Blue Devils,TEAM,TOTAL,TOTAL,False,,32,60,21,31,11,29,21,31,10,29,39,20,14,8,15,19,96
400915221,Florida State Seminoles,J. Isaac,4065654,,True,23.0,4,8,2,4,2,4,0,1,1,2,3,1,3,0,0,1,10
400915221,Florida State Seminoles,M. Ojo,61596,,True,10.0,1,2,1,2,0,0,2,2,0,3,3,0,0,1,2,0,4
400915221,Florida State Seminoles,T. Mann,3907823,,True,26.0,4,7,4,5,0,2,0,0,1,5,6,3,1,0,1,3,8
400915221,Florida State Seminoles,D. Bacon,3907821,,True,27.0,7,14,3,8,4,6,5,6,3,6,9,2,2,1,0,2,23
400915221,Florida State Seminoles,X. Rathan-Mayes,66125,,True,29.0,5,11,4,7,1,4,1,1,1,4,5,7,1,0,3,2,12
400915221,Florida State Seminoles,P. Cofer,3135054,,False,14.0,2,4,2,4,0,0,0,0,0,1,1,1,0,0,1,2,4
400915221,Florida State Seminoles,J. Smith,66126,,False,10.0,1,2,1,2,0,0,0,0,0,1,1,0,0,2,0,3,2
400915221,Florida State Seminoles,C. Koumadje,3907824,,False,13.0,4,8,4,8,0,0,1,1,2,1,3,0,0,3,1,2,9
400915221,Florida State Seminoles,B. Angola-Rodas,4065658,,False,15.0,1,4,1,1,0,3,3,4,0,1,1,1,1,0,0,2,5
400915221,Florida State Seminoles,T. Forrest,4065656,,False,19.0,3,4,3,4,0,0,1,2,2,4,6,1,0,0,1,0,7
400915221,Florida State Seminoles,C. Walker,4065655,,False,14.0,1,3,1,1,0,2,2,2,1,1,2,1,1,0,1,1,4
400915221,Florida State Seminoles,TEAM,TOTAL,TOTAL,False,,33,67,26,46,7,21,15,19,11,31,42,17,9,7,10,18,88
400915221,Charleston Southern Buccaneers,J. Howard,3129902,,True,34.0,2,3,2,3,0,0,1,2,2,4,6,2,0,2,0,2,5
400915221,Charleston Southern Buccaneers,U. Mmonu,66918,,True,19.0,0,5,0,4,0,1,0,0,0,2,2,0,0,3,2,3,0
400915221,Charleston Southern Buccaneers,C. Keeling,4067301,,True,28.0,7,12,7,11,0,1,2,6,2,2,4,1,0,0,2,0,16
400915221,Charleston Southern Buccaneers,C. Mitchell,4067298,,True,24.0,4,10,2,6,2,4,4,4,0,2,2,4,1,0,4,3,14
400915221,Charleston Southern Buccaneers,A. Potter,3913163,,True,26.0,1,8,1,5,0,3,3,4,0,2,2,2,0,0,2,1,5
400915221,Charleston Southern Buccaneers,J. Martin,4067299,,False,21.0,4,8,0,0,4,8,0,0,1,4,5,0,2,0,2,4,12
400915221,Charleston Southern Buccaneers,A. Maxwell Jr.,3913161,,False,4.0,0,1,0,1,0,0,2,2,1,2,3,0,0,1,0,1,2
400915221,Charleston Southern Buccaneers,J. Jones,4067302,,False,1.0,1,1,1,1,0,0,0,0,0,0,0,0,0,0,0,0,2
400915221,Charleston Southern Buccaneers,J. Thomas,4067304,,False,12.0,1,2,0,0,1,2,0,1,1,0,1,0,0,0,1,3,3
400915221,Charleston Southern Buccaneers,P. Wallace,66136,,False,13.0,3,6,3,3,0,3,0,0,0,2,2,0,0,0,2,1,6
400915221,Charleston Southern Buccaneers,R. Robinson,62226,,False,18.0,1,4,1,1,0,3,0,0,0,1,1,2,0,0,0,1,2
400915221,Charleston Southern Buccaneers,TEAM,TOTAL,TOTAL,False,,24,60,17,35,7,25,12,19,8,22,30,11,3,6,15,19,67
400915220,Virginia Tech Hokies,K. Sy,4065740,,True,15.0,3,4,3,4,0,0,0,0,0,4,4,0,0,3,0,0,6
400915220,Virginia Tech Hokies,C. Clarke,3945567,,True,24.0,4,5,3,4,1,1,3,4,0,9,9,2,1,0,2,3,12
400915220,Virginia Tech Hokies,J. Robinson,3945566,,True,27.0,4,8,3,4,1,4,4,6,1,5,6,4,1,0,2,2,13
400915220,Virginia Tech Hokies,A. Hill,3147501,,True,30.0,5,11,2,5,3,6,1,1,0,3,3,1,0,0,1,1,14
400915220,Virginia Tech Hokies,J. Bibbs,3147500,,True,31.0,2,11,0,6,2,5,0,0,1,1,2,3,0,0,1,1,6
400915220,Virginia Tech Hokies,Z. LeDay,61698,,False,26.0,8,13,8,12,0,1,4,4,5,7,12,2,0,0,2,0,20
400915220,Virginia Tech Hokies,J. Hamilton,3945563,,False,3.0,0,0,0,0,0,0,0,0,0,0,0,0,0,0,0,0,0
400915220,Virginia Tech Hokies,M. Galloway,3945565,,False,5.0,0,2,0,0,0,2,0,0,0,0,0,0,0,0,0,0,0
400915220,Virginia Tech Hokies,T. Outlaw,67275,,False,15.0,0,5,0,3,0,2,1,2,1,2,3,0,0,0,1,3,1
400915220,Virginia Tech Hokies,S. Allen,61795,,False,24.0,4,7,4,5,0,2,0,0,0,1,1,2,1,0,1,1,8
400915220,Virginia Tech Hokies,TEAM,TOTAL,TOTAL,False,,30,66,23,43,7,23,13,17,8,36,44,14,3,3,10,11,80
400915220,Maine Black Bears,V. Eze,3941313,,True,10.0,1,2,1,2,0,0,0,0,0,3,3,0,0,0,1,5,2
400915220,Maine Black Bears,I. Er,4066698,,True,20.0,2,10,0,4,2,6,2,3,0,3,3,0,0,0,2,5,8
400915220,Maine Black Bears,A. Howard,4066696,,True,24.0,3,8,1,4,2,4,0,0,0,3,3,0,0,0,1,0,8
400915220,Maine Black Bears,A. Calixte,3147346,,True,31.0,2,10,2,4,0,6,3,3,0,1,1,2,0,0,0,0,7
400915220,Maine Black Bears,W. Myers,67482,,True,32.0,6,13,4,10,2,3,4,6,1,7,8,2,0,0,1,2,18
400915220,Maine Black Bears,A. Fleming,4066695,,False,26.0,3,7,3,6,0,1,0,0,0,3,3,1,0,1,3,2,6
400915220,Maine Black Bears,M. Pirovic,66981,,False,21.0,1,4,1,1,0,3,1,2,0,4,4,0,0,0,2,2,3
400915220,Maine Black Bears,J. McKennon,4066699,,False,8.0,3,6,2,3,1,3,0,0,0,1,1,1,1,0,1,0,7
400915220,Maine Black Bears,D. Evans,4066697,,False,14.0,0,3,0,1,0,2,0,0,1,3,4,3,0,0,0,0,0
400915220,Maine Black Bears,R. Bernstein,3941311,,False,11.0,1,2,1,2,0,0,0,0,1,1,2,2,1,0,0,1,2
400915220,Maine Black Bears,D. Ashley,3941310,,False,3.0,2,2,0,0,2,2,0,0,0,0,0,0,0,0,0,0,6
400915220,Maine Black Bears,TEAM,TOTAL,TOTAL,False,,24,67,15,37,9,30,10,14,7,29,36,11,2,1,11,17,67
400915219,Tulane Green Wave,R. Smith,66769,,True,22.0,1,6,1,6,0,0,1,2,4,4,8,0,0,1,1,4,3
400915219,Tulane Green Wave,O. Yurtseven,66768,,True,35.0,7,15,2,9,5,6,2,2,1,3,4,2,1,1,0,1,21
400915219,Tulane Green Wave,C. Slater,4066475,,True,24.0,4,10,2,3,2,7,4,5,1,0,1,2,0,0,3,3,14
400915219,Tulane Green Wave,M. Frazier Jr.,3913546,,True,25.0,3,10,2,6,1,4,1,3,0,1,1,3,3,0,2,2,8
400915219,Tulane Green Wave,M. Morgan,61624,,True,29.0,3,11,3,8,0,3,0,0,4,3,7,0,0,1,3,2,6
400915219,Tulane Green Wave,D. Jones,4066476,,False,1.0,0,0,0,0,0,0,0,0,0,0,0,0,0,0,0,0,0
400915219,Tulane Green Wave,B. Paul,3913551,,False,13.0,1,1,1,1,0,0,0,1,0,1,1,0,0,1,0,4,2
400915219,Tulane Green Wave,S. Reyes,3148929,,False,10.0,0,1,0,1,0,0,0,0,1,1,2,0,1,0,0,1,0
400915219,Tulane Green Wave,K. Harris,3913547,,False,18.0,5,12,2,6,3,6,2,2,1,0,1,1,0,0,0,0,15
400915219,Tulane Green Wave,R. Ona Embo,4066474,,False,10.0,0,3,0,2,0,1,3,4,0,5,5,1,0,0,2,2,3
400915219,Tulane Green Wave,V. Julien,3913548,,False,13.0,1,3,0,0,1,3,0,0,1,2,3,3,0,0,0,2,3
400915219,Tulane Green Wave,TEAM,TOTAL,TOTAL,False,,25,72,13,42,12,30,13,19,17,21,38,12,5,4,12,21,75
400915219,North Carolina Tar Heels,J. Jackson,3138156,,True,29.0,9,12,5,7,4,5,5,6,0,1,1,4,0,0,2,2,27
400915219,North Carolina Tar Heels,I. Hicks,66874,,True,25.0,7,7,7,7,0,0,2,2,1,5,6,1,0,0,2,3,16
400915219,North Carolina Tar Heels,K. Meeks,66873,,True,22.0,4,13,4,13,0,0,1,4,7,8,15,1,2,0,1,2,9
400915219,North Carolina Tar Heels,K. Williams,3911619,,True,21.0,1,5,1,2,0,3,0,0,2,3,5,4,1,0,1,0,2
400915219,North Carolina Tar Heels,J. Berry II,3138155,,True,30.0,6,12,2,5,4,7,7,9,0,6,6,4,2,0,1,3,23
400915219,North Carolina Tar Heels,A. Rohlman,4065677,,False,1.0,0,0,0,0,0,0,0,0,0,0,0,0,0,0,0,0,0
400915219,North Carolina Tar Heels,S. Rush,4065674,,False,1.0,0,0,0,0,0,0,0,0,0,0,0,0,0,0,0,0,0
400915219,North Carolina Tar Heels,T. Bradley,4065673,,False,17.0,5,7,5,7,0,0,0,0,2,3,5,0,0,0,2,4,10
400915219,North Carolina Tar Heels,L. Maye,3911620,,False,14.0,1,4,1,4,0,0,0,0,2,2,4,1,1,2,2,2,2
400915219,North Carolina Tar Heels,S. Woods,4065676,,False,10.0,0,1,0,1,0,0,2,2,1,2,3,2,1,0,2,2,2
400915219,North Carolina Tar Heels,B. Robinson,4065675,,False,10.0,1,3,0,1,1,2,0,0,0,1,1,1,0,0,0,0,3
400915219,North Carolina Tar Heels,K. Coker,3947144,,False,1.0,0,0,0,0,0,0,0,0,0,0,0,0,0,0,0,0,0
400915219,North Carolina Tar Heels,N. Britt,66872,,False,18.0,0,5,0,2,0,3,1,2,0,1,1,5,0,0,0,2,1
400915219,North Carolina Tar Heels,S. White,56963,,False,1.0,0,0,0,0,0,0,0,0,1,0,1,0,0,0,0,0,0
400915219,North Carolina Tar Heels,TEAM,TOTAL,TOTAL,False,,34,69,25,49,9,20,18,25,18,34,52,23,7,2,13,20,95
400915218,Wake Forest Demon Deacons,J. Collins,3908845,,True,23.0,7,11,7,11,0,0,4,7,4,8,12,0,1,3,4,1,18
400915218,Wake Forest Demon Deacons,D. Mitoglou,3138224,,True,26.0,4,7,4,5,0,2,1,3,2,4,6,0,2,2,3,1,9
400915218,Wake Forest Demon Deacons,A. Arians,61378,,True,20.0,3,6,2,2,1,4,0,0,1,1,2,0,1,1,0,1,7
400915218,Wake Forest Demon Deacons,B. Crawford,3908844,,True,27.0,5,9,4,6,1,3,3,4,0,4,4,8,2,1,4,1,14
400915218,Wake Forest Demon Deacons,M. Wilbekin,3138222,,True,28.0,1,6,0,1,1,5,2,2,1,2,3,1,0,0,1,2,5
400915218,Wake Forest Demon Deacons,R. Washington,4065753,,False,1.0,1,1,1,1,0,0,0,0,0,0,0,0,0,0,0,0,2
400915218,Wake Forest Demon Deacons,G. McClinton,66140,,False,8.0,0,1,0,1,0,0,0,0,1,1,2,0,0,0,1,1,0
400915218,Wake Forest Demon Deacons,S. Japhet-Mathias,4065752,,False,1.0,0,0,0,0,0,0,0,0,0,0,0,0,0,0,0,0,0
400915218,Wake Forest Demon Deacons,D. Moore,3908843,,False,13.0,3,3,3,3,0,0,0,0,1,2,3,0,0,3,2,4,6
400915218,Wake Forest Demon Deacons,B. Childress,4065750,,False,23.0,2,9,1,8,1,1,0,0,1,2,3,5,2,0,0,1,5
400915218,Wake Forest Demon Deacons,K. Woods,3132360,,False,26.0,6,11,5,8,1,3,1,1,0,4,4,3,1,0,1,3,14
400915218,Wake Forest Demon Deacons,T. VanHorn,3078214,,False,4.0,0,1,0,1,0,0,0,0,0,0,0,1,0,0,0,0,0
400915218,Wake Forest Demon Deacons,TEAM,TOTAL,TOTAL,False,,32,65,27,47,5,18,11,17,14,29,43,18,9,10,16,15,80
400915218,Radford Highlanders,E. Polite Jr.,3913244,,True,29.0,5,12,4,9,1,3,0,2,3,5,8,3,1,0,2,2,11
400915218,Radford Highlanders,S. Christy,3143999,,True,27.0,0,6,0,3,0,3,0,0,1,2,3,3,1,1,1,3,0
400915218,Radford Highlanders,R. Phillips,4067739,,True,21.0,1,5,1,5,0,0,1,4,1,3,4,0,0,2,2,3,3
400915218,Radford Highlanders,D. Cooper,3913242,,True,25.0,3,5,2,3,1,2,0,0,0,5,5,2,0,0,5,2,7
400915218,Radford Highlanders,J. Cousin,3078875,,True,21.0,1,5,0,2,1,3,0,0,1,0,1,1,0,0,0,1,3
400915218,Radford Highlanders,D. Holland,4067738,,False,15.0,4,4,4,4,0,0,0,0,2,4,6,0,2,0,1,5,8
400915218,Radford Highlanders,C. Lutete,3913243,,False,15.0,4,10,3,7,1,3,0,0,3,1,4,1,0,0,0,0,9
400915218,Radford Highlanders,D. Hicks,4067737,,False,16.0,1,3,0,1,1,2,0,0,3,2,5,1,0,0,3,1,3
400915218,Radford Highlanders,C. Bradford,4067736,,False,15.0,3,10,3,7,0,3,0,0,0,1,1,1,1,0,3,1,6
400915218,Radford Highlanders,C. Tanner,3913245,,False,16.0,2,7,1,2,1,5,4,4,0,0,0,0,1,0,1,1,9
400915218,Radford Highlanders,TEAM,TOTAL,TOTAL,False,,24,67,18,43,6,24,5,10,16,23,39,12,6,3,18,19,59
400915217,Virginia Cavaliers,I. Wilkins,3138203,,True,29.0,4,7,3,6,1,1,1,1,3,6,9,2,0,0,0,1,10
400915217,Virginia Cavaliers,J. Salt,3138200,,True,27.0,2,4,2,4,0,0,3,4,3,1,4,3,0,1,1,2,7
400915217,Virginia Cavaliers,D. Thompson,66274,,True,23.0,4,6,1,2,3,4,1,2,0,1,1,1,1,0,1,2,12
400915217,Virginia Cavaliers,L. Perrantes,66139,,True,26.0,4,8,2,4,2,4,0,0,0,3,3,3,0,0,1,1,10
400915217,Virginia Cavaliers,D. Hall,66138,,True,23.0,1,5,0,2,1,3,2,2,0,4,4,0,2,0,0,2,5
400915217,Virginia Cavaliers,J. Reuter,3908374,,False,18.0,3,5,3,5,0,0,2,2,4,2,6,1,0,0,5,2,8
400915217,Virginia Cavaliers,J. Jones,67567,,False,2.0,0,0,0,0,0,0,0,0,1,0,1,0,0,0,1,0,0
400915217,Virginia Cavaliers,T. Jerome,4065733,,False,9.0,0,0,0,0,0,0,2,2,0,3,3,0,0,0,2,2,2
400915217,Virginia Cavaliers,K. Guy,4065730,,False,19.0,3,5,2,4,1,1,0,0,0,1,1,3,2,0,0,3,7
400915217,Virginia Cavaliers,T. Gross Jr.,4065729,,False,2.0,0,1,0,0,0,1,0,0,0,0,0,0,0,0,0,1,0
400915217,Virginia Cavaliers,J. Bartley,3947155,,False,2.0,0,1,0,0,0,1,0,0,0,2,2,0,0,0,0,0,0
400915217,Virginia Cavaliers,M. Shayok,3138201,,False,20.0,5,8,5,7,0,1,5,5,0,1,1,0,3,0,0,1,15
400915217,Virginia Cavaliers,TEAM,TOTAL,TOTAL,False,,26,50,18,34,8,16,16,18,11,24,35,13,8,1,11,17,76
400915217,UNC Greensboro Spartans,M. Smith,3137169,,True,30.0,4,8,2,2,2,6,0,0,1,3,4,1,0,0,2,3,10
400915217,UNC Greensboro Spartans,J. Kuiper,67274,,True,26.0,3,8,2,3,1,5,0,1,2,1,3,0,1,0,1,1,7
400915217,UNC Greensboro Spartans,R.J. White,61982,,True,27.0,3,5,2,3,1,2,0,0,1,3,4,0,1,1,2,3,7
400915217,UNC Greensboro Spartans,F. Alonso,3948853,,True,32.0,3,10,1,6,2,4,6,6,0,0,0,0,2,0,3,2,14
400915217,UNC Greensboro Spartans,D. Baldwin,67271,,True,30.0,2,9,1,8,1,1,2,2,2,3,5,4,2,0,2,3,7
400915217,UNC Greensboro Spartans,K. Galloway,4067611,,False,11.0,0,0,0,0,0,0,0,0,0,2,2,1,0,0,0,1,0
400915217,UNC Greensboro Spartans,J. Mofford,3948851,,False,2.0,0,0,0,0,0,0,0,0,0,0,0,0,0,0,0,0,0
400915217,UNC Greensboro Spartans,G. Collins,3137171,,False,2.0,0,0,0,0,0,0,0,0,0,0,0,0,0,0,0,0,0
400915217,UNC Greensboro Spartans,L. Burgess,3137172,,False,11.0,0,0,0,0,0,0,0,0,1,1,2,0,0,0,0,0,0
400915217,UNC Greensboro Spartans,M. Massey,4067610,,False,23.0,2,6,2,3,0,3,2,4,0,1,1,1,0,0,0,2,6
400915217,UNC Greensboro Spartans,T. Muhammad,3948852,,False,6.0,0,0,0,0,0,0,0,0,0,0,0,0,0,0,1,0,0
400915217,UNC Greensboro Spartans,TEAM,TOTAL,TOTAL,False,,17,46,10,25,7,21,10,13,7,14,21,7,6,1,13,15,51
400915216,Nicholls Colonels,J. Frye,63058,,True,34.0,4,11,4,9,0,2,3,4,1,7,8,0,2,0,1,1,11
400915216,Nicholls Colonels,L. Thomas,67348,,True,31.0,6,7,6,7,0,0,2,3,1,3,4,2,0,3,1,4,14
400915216,Nicholls Colonels,J. Powell,4067758,,True,19.0,2,2,0,0,2,2,0,3,0,0,0,3,0,0,1,2,6
400915216,Nicholls Colonels,J. Bell,3948870,,True,37.0,4,9,4,7,0,2,0,3,2,4,6,4,0,0,1,3,8
400915216,Nicholls Colonels,T. O'Neal,3948868,,True,25.0,2,7,2,5,0,2,0,0,1,0,1,2,1,0,1,1,4
400915216,Nicholls Colonels,A. Ward,3151441,,False,9.0,0,0,0,0,0,0,0,0,0,1,1,1,0,1,0,2,0
400915216,Nicholls Colonels,L. Rutledge,4067759,,False,8.0,1,2,0,0,1,2,2,3,0,2,2,0,0,0,1,1,5
400915216,Nicholls Colonels,D. Harris,3132449,,False,29.0,10,20,9,14,1,6,7,9,2,5,7,4,4,0,3,3,28
400915216,Nicholls Colonels,S. Repichowski,66776,,False,8.0,1,3,0,1,1,2,0,0,0,1,1,0,1,0,0,1,3
400915216,Nicholls Colonels,TEAM,TOTAL,TOTAL,False,,30,61,25,43,5,18,14,25,10,25,35,16,8,4,10,18,79
400915216,Boston College Eagles,A.J. Turner,3943608,,True,26.0,4,6,2,4,2,2,2,5,1,4,5,4,0,1,0,0,12
400915216,Boston College Eagles,M. Jeffers,61901,,True,26.0,3,6,3,6,0,0,0,1,1,5,6,0,0,0,1,3,6
400915216,Boston College Eagles,C. Tava,61446,,True,13.0,2,3,2,3,0,0,0,0,1,1,2,0,1,0,5,4,4
400915216,Boston College Eagles,K. Bowman,4065635,,True,10.0,2,5,2,4,0,1,0,0,1,1,2,0,1,0,2,3,4
400915216,Boston College Eagles,J. Robinson,3943606,,True,33.0,4,12,3,8,1,4,5,8,0,6,6,4,1,0,2,4,14
400915216,Boston College Eagles,N. Popovic,4065637,,False,13.0,2,5,2,5,0,0,2,5,1,3,4,2,0,0,2,1,6
400915216,Boston College Eagles,E. Meznieks,3943607,,False,2.0,0,0,0,0,0,0,0,0,0,0,0,0,0,0,0,1,0
400915216,Boston College Eagles,G. Owens,66277,,False,23.0,1,2,1,2,0,0,2,2,0,1,1,2,0,2,1,5,4
400915216,Boston College Eagles,T. Graves,4065636,,False,31.0,5,8,1,1,4,7,1,2,0,2,2,3,0,0,2,1,15
400915216,Boston College Eagles,J. Chatman,3135095,,False,23.0,3,5,1,1,2,4,0,0,0,2,2,0,1,1,1,1,8
400915216,Boston College Eagles,TEAM,TOTAL,TOTAL,False,,26,52,17,34,9,18,12,23,7,28,35,15,4,4,16,23,73
400915215,Louisville Cardinals,M. Mathiang,63035,,True,20.0,4,10,4,10,0,0,1,2,4,3,7,0,0,2,1,2,9
400915215,Louisville Cardinals,D. Adel,3908807,,True,23.0,1,8,1,5,0,3,4,5,1,4,5,2,1,0,1,0,6
400915215,Louisville Cardinals,J. Johnson,3147362,,True,24.0,9,11,8,10,1,1,0,2,7,7,14,1,0,3,3,0,19
400915215,Louisville Cardinals,D. Mitchell,3908809,,True,26.0,6,11,4,5,2,6,1,2,2,3,5,3,4,0,3,0,15
400915215,Louisville Cardinals,Q. Snider,3147360,,True,18.0,0,1,0,0,0,1,3,4,0,2,2,3,0,0,1,3,3
400915215,Louisville Cardinals,V.J. King,4065666,,False,14.0,0,1,0,0,0,1,6,8,0,2,2,0,0,1,0,1,6
400915215,Louisville Cardinals,R. Spalding,3908806,,False,15.0,1,4,1,3,0,1,0,0,1,3,4,1,1,1,1,5,2
400915215,Louisville Cardinals,A. Mahmoud,3147363,,False,17.0,5,5,5,5,0,0,0,0,1,4,5,1,1,3,1,2,10
400915215,Louisville Cardinals,M. Stockman,3147361,,False,3.0,2,3,2,3,0,0,0,2,2,0,2,0,0,0,0,1,4
400915215,Louisville Cardinals,T. Sharpe,4065667,,False,1.0,0,0,0,0,0,0,0,0,0,0,0,0,0,0,0,0,0
400915215,Louisville Cardinals,R. McMahon,3908808,,False,6.0,0,2,0,1,0,1,0,0,0,0,0,0,0,0,0,3,0
400915215,Louisville Cardinals,J. Henderson,3155491,,False,3.0,0,0,0,0,0,0,0,0,0,0,0,0,0,0,0,0,0
400915215,Louisville Cardinals,D. Levitch,66592,,False,12.0,0,2,0,2,0,0,0,0,0,3,3,2,1,0,0,0,0
400915215,Louisville Cardinals,T. Hicks,62752,,False,18.0,2,5,2,4,0,1,0,2,0,2,2,2,2,0,1,0,4
400915215,Louisville Cardinals,TEAM,TOTAL,TOTAL,False,,30,63,27,48,3,15,15,27,19,33,52,15,10,10,12,17,78
400915215,Evansville Purple Aces,W. Wiley,3148987,,True,12.0,0,2,0,2,0,0,0,2,1,2,3,0,1,0,1,3,0
400915215,Evansville Purple Aces,D. Howard,62366,,True,21.0,1,3,1,3,0,0,0,0,3,4,7,0,0,0,1,1,2
400915215,Evansville Purple Aces,R. Taylor,3137001,,True,26.0,2,14,1,9,1,5,0,0,3,2,5,1,3,1,3,3,5
400915215,Evansville Purple Aces,D. Gibson,67743,,True,24.0,1,4,1,4,0,0,0,0,0,0,0,2,0,0,1,0,2
400915215,Evansville Purple Aces,J. Brown,67742,,True,33.0,5,13,2,7,3,6,6,10,0,1,1,1,1,0,1,0,19
400915215,Evansville Purple Aces,S. Hainna,4066992,,False,10.0,0,2,0,1,0,1,0,0,0,1,1,0,0,0,0,1,0
400915215,Evansville Purple Aces,D. Traore,4066994,,False,13.0,2,2,2,2,0,0,0,1,0,1,1,0,0,0,0,0,4
400915215,Evansville Purple Aces,S. Vucetic,62742,,False,12.0,2,7,2,7,0,0,1,2,1,1,2,0,0,1,1,2,5
400915215,Evansville Purple Aces,D. Smith,4066993,,False,22.0,1,5,1,3,0,2,3,3,0,3,3,2,1,0,2,4,5
400915215,Evansville Purple Aces,J. Eaves,4066991,,False,9.0,0,1,0,0,0,1,0,0,0,2,2,0,0,0,2,1,0
400915215,Evansville Purple Aces,C. Benzon,67741,,False,18.0,2,4,2,4,0,0,1,2,2,1,3,0,1,0,0,3,5
400915215,Evansville Purple Aces,TEAM,TOTAL,TOTAL,False,,16,57,12,42,4,15,11,20,11,18,29,6,7,2,13,18,47
400915214,Marist Red Foxes,I. Lamb,3936028,,True,23.0,1,11,1,7,0,4,0,0,0,5,5,2,2,0,1,3,2
400915214,Marist Red Foxes,R. Funk,3936026,,True,21.0,3,9,2,3,1,6,0,0,0,1,1,0,0,0,1,3,7
400915214,Marist Red Foxes,K. Brooks,67365,,True,10.0,0,1,0,1,0,0,5,6,1,3,4,0,0,0,0,3,5
400915214,Marist Red Foxes,D. Knudsen,3936027,,True,14.0,0,4,0,2,0,2,0,0,1,1,2,0,0,0,3,0,0
400915214,Marist Red Foxes,K. Hart,61943,,True,33.0,4,14,3,8,1,6,4,4,1,2,3,2,2,0,3,2,13
400915214,Marist Red Foxes,O. Momah,3138476,,False,3.0,0,0,0,0,0,0,0,0,0,0,0,0,0,0,0,0,0
400915214,Marist Red Foxes,T. Sjoberg,4067328,,False,13.0,1,1,1,1,0,0,1,2,2,2,4,1,0,0,1,4,3
400915214,Marist Red Foxes,C. McClenaghan,3138475,,False,13.0,0,0,0,0,0,0,0,0,0,3,3,0,0,0,2,1,0
400915214,Marist Red Foxes,R. Mitchell,4067327,,False,23.0,2,5,2,5,0,0,5,5,0,2,2,1,1,0,0,3,9
400915214,Marist Red Foxes,B. Parker,3936030,,False,25.0,2,12,2,11,0,1,1,2,0,2,2,1,0,0,2,2,5
400915214,Marist Red Foxes,K. Palsson,3936029,,False,22.0,2,8,1,2,1,6,0,0,0,2,2,1,0,0,1,1,5
400915214,Marist Red Foxes,TEAM,TOTAL,TOTAL,False,,15,65,12,40,3,25,16,19,8,25,33,8,5,0,14,22,49
400915214,Duke Blue Devils,A. Jefferson,61586,,True,22.0,1,4,1,4,0,0,3,6,0,9,9,1,1,3,0,1,5
400915214,Duke Blue Devils,C. Jeter,3913173,,True,18.0,4,4,4,4,0,0,3,4,5,3,8,1,0,2,0,1,11
400915214,Duke Blue Devils,L. Kennard,3913174,,True,29.0,7,14,5,9,2,5,0,0,1,8,9,2,0,0,0,3,16
400915214,Duke Blue Devils,G. Allen,3135045,,True,22.0,3,11,1,6,2,5,8,9,1,3,4,3,1,1,2,1,16
400915214,Duke Blue Devils,M. Jones,66563,,True,27.0,4,9,1,3,3,6,0,0,0,3,3,1,3,0,2,3,11
400915214,Duke Blue Devils,J. White,4065653,,False,12.0,0,0,0,0,0,0,5,6,0,2,2,0,0,0,1,1,5
400915214,Duke Blue Devils,J. DeLaurier,4065650,,False,17.0,3,3,3,3,0,0,0,2,1,7,8,0,0,1,1,4,6
400915214,Duke Blue Devils,J. Robinson,3913178,,False,5.0,0,0,0,0,0,0,1,2,0,1,1,0,0,0,0,0,1
400915214,Duke Blue Devils,A. Vrankovic,3913177,,False,19.0,2,6,2,6,0,0,1,2,7,3,10,1,0,0,2,2,5
400915214,Duke Blue Devils,F. Jackson,4065651,,False,25.0,6,15,5,11,1,4,5,6,1,0,1,4,4,0,2,4,18
400915214,Duke Blue Devils,B. Besser,3913179,,False,2.0,0,1,0,0,0,1,0,0,0,0,0,0,0,0,0,1,0
400915214,Duke Blue Devils,N. Pagliuca,66630,,False,2.0,0,1,0,0,0,1,0,0,0,0,0,0,0,0,0,0,0
400915214,Duke Blue Devils,TEAM,TOTAL,TOTAL,False,,30,68,22,46,8,22,26,37,16,40,56,13,9,7,10,21,94
400915213,Pittsburgh Panthers,M. Young,66290,,True,43.0,7,10,6,8,1,2,11,15,3,7,10,5,0,1,7,0,26
400915213,Pittsburgh Panthers,S. Jeter,61756,,True,39.0,2,8,1,4,1,4,7,7,2,7,9,0,3,0,2,3,12
400915213,Pittsburgh Panthers,J. Artis,66287,,True,45.0,6,16,2,4,4,12,11,12,2,7,9,3,0,1,0,4,27
400915213,Pittsburgh Panthers,C. Johnson,3138196,,True,23.0,4,9,3,3,1,6,0,0,1,1,2,0,0,0,1,5,9
400915213,Pittsburgh Panthers,C. Jones,61219,,True,45.0,3,9,3,6,0,3,4,7,1,2,3,6,0,0,0,2,10
400915213,Pittsburgh Panthers,R. Luther,3138197,,False,18.0,1,5,1,4,0,1,2,2,1,0,1,0,0,0,0,1,4
400915213,Pittsburgh Panthers,J. Kithcart,4065713,,False,27.0,1,3,0,0,1,3,0,2,0,2,2,2,0,1,0,4,3
400915213,Pittsburgh Panthers,J. Milligan,3934655,,False,8.0,1,3,1,1,0,2,0,0,0,0,0,1,0,0,1,3,2
400915213,Pittsburgh Panthers,D. Wilson,3934652,,False,2.0,0,0,0,0,0,0,0,0,0,2,2,0,0,0,0,0,0
400915213,Pittsburgh Panthers,TEAM,TOTAL,TOTAL,False,,25,63,17,30,8,33,35,45,11,30,41,17,3,3,12,22,93
400915213,Eastern Michigan Eagles,N. Madray,66488,,True,23.0,0,2,0,0,0,2,2,2,0,2,2,0,0,0,0,3,2
400915213,Eastern Michigan Eagles,J. Thompson IV,3913762,,True,33.0,4,9,4,9,0,0,0,0,7,6,13,1,0,1,3,5,8
400915213,Eastern Michigan Eagles,T. Bond,3148983,,True,26.0,7,9,6,8,1,1,6,8,0,2,2,1,2,2,3,5,21
400915213,Eastern Michigan Eagles,T. Toney,67225,,True,37.0,4,14,4,10,0,4,4,5,0,3,3,6,1,0,1,4,12
400915213,Eastern Michigan Eagles,R. Lee,62353,,True,42.0,9,22,7,13,2,9,7,7,1,1,2,3,2,0,3,1,27
400915213,Eastern Michigan Eagles,L. Wofford-Humphrey,3913767,,False,17.0,1,2,1,2,0,0,0,0,1,2,3,0,0,0,0,2,2
400915213,Eastern Michigan Eagles,J. Nobles,3148984,,False,25.0,1,2,0,1,1,1,0,0,1,2,3,0,0,0,0,2,3
400915213,Eastern Michigan Eagles,B. Steele,4067383,,False,27.0,3,5,3,5,0,0,0,1,1,4,5,0,2,2,0,5,6
400915213,Eastern Michigan Eagles,W. Mangum IV,3913764,,False,20.0,4,12,3,8,1,4,0,0,1,3,4,1,1,0,1,3,9
400915213,Eastern Michigan Eagles,TEAM,TOTAL,TOTAL,False,,33,77,28,56,5,21,19,23,15,30,45,12,8,5,11,30,90
400915212,Syracuse Orange,T. Lydon,3934662,,True,26.0,1,6,1,3,0,3,0,0,2,4,6,3,1,3,0,2,2
400915212,Syracuse Orange,T. Roberson,67633,,True,24.0,9,13,9,13,0,0,0,0,1,3,4,1,1,0,2,3,18
400915212,Syracuse Orange,D. Coleman,61821,,True,15.0,3,4,3,4,0,0,0,0,3,3,6,1,1,1,1,4,6
400915212,Syracuse Orange,F. Howard,3934659,,True,22.0,4,4,1,1,3,3,0,2,0,4,4,9,4,0,3,2,11
400915212,Syracuse Orange,A. White III,61616,,True,29.0,7,12,5,5,2,7,1,2,1,4,5,1,1,0,1,3,17
400915212,Syracuse Orange,T. Thompson,4065721,,False,18.0,1,4,1,4,0,0,1,2,2,5,7,1,0,0,1,2,3
400915212,Syracuse Orange,D. Akintobi-Adeyeye,3155403,,False,1.0,0,0,0,0,0,0,0,0,0,0,0,0,0,0,0,0,0
400915212,Syracuse Orange,P. Chukwu,3136471,,False,17.0,2,2,2,2,0,0,0,6,1,4,5,0,1,1,1,1,4
400915212,Syracuse Orange,T. Battle,4065722,,False,23.0,1,7,1,4,0,3,4,4,0,1,1,0,0,0,0,2,6
400915212,Syracuse Orange,K. Feldman,3934665,,False,1.0,0,0,0,0,0,0,0,0,0,0,0,0,0,0,0,0,0
400915212,Syracuse Orange,E. Dourdas,3934664,,False,1.0,0,0,0,0,0,0,0,0,0,0,0,0,0,0,0,0,0
400915212,Syracuse Orange,A. Autry,3934661,,False,1.0,1,1,0,0,1,1,0,0,0,0,0,0,0,0,0,0,3
400915212,Syracuse Orange,S. Belbey,3934660,,False,1.0,0,1,0,0,0,1,0,0,0,0,0,1,0,0,0,0,0
400915212,Syracuse Orange,J. Gillon,61915,,False,21.0,5,8,4,6,1,2,2,3,0,2,2,6,1,0,0,1,13
400915212,Syracuse Orange,TEAM,TOTAL,TOTAL,False,,34,62,27,42,7,20,8,19,13,33,46,23,10,5,11,20,83
400915212,Colgate Raiders,T. Rivard,67172,,True,21.0,1,4,1,4,0,0,5,6,1,1,2,4,1,0,0,4,7
400915212,Colgate Raiders,J. Swopshire,66418,,True,25.0,2,12,1,3,1,9,0,0,1,2,3,1,1,0,2,0,5
400915212,Colgate Raiders,M. Regisford,3921437,,True,26.0,3,8,3,8,0,0,4,9,3,3,6,1,0,0,3,1,10
400915212,Colgate Raiders,J. Robertson,3130557,,True,26.0,2,7,0,1,2,6,2,2,2,4,6,1,0,0,3,1,8
400915212,Colgate Raiders,S. O'Brien,3130556,,True,30.0,3,7,0,0,3,7,0,0,1,0,1,2,2,0,2,5,9
400915212,Colgate Raiders,W. Rayman,4067106,,False,21.0,2,12,2,5,0,7,2,4,3,1,4,4,0,1,3,3,6
400915212,Colgate Raiders,D. Krmpotich,3921439,,False,3.0,2,3,2,3,0,0,0,0,1,0,1,0,0,0,0,0,4
400915212,Colgate Raiders,S. Lindgren,3921436,,False,1.0,0,0,0,0,0,0,0,0,0,0,0,1,0,0,0,0,0
400915212,Colgate Raiders,D. Batt,3921438,,False,13.0,2,2,2,2,0,0,0,0,2,5,7,0,0,0,0,4,4
400915212,Colgate Raiders,R. Diew,3948820,,False,0.0,0,1,0,0,0,1,0,0,0,0,0,0,0,0,0,0,0
400915212,Colgate Raiders,F. Amiel,3921440,,False,17.0,0,6,0,0,0,6,0,0,0,0,0,2,0,0,1,2,0
400915212,Colgate Raiders,D. Favorite,3921435,,False,1.0,0,0,0,0,0,0,0,0,0,0,0,0,0,0,0,0,0
400915212,Colgate Raiders,A. Bargmann,67194,,False,6.0,0,0,0,0,0,0,0,0,0,1,1,0,0,0,0,0,0
400915212,Colgate Raiders,N. Harries,67191,,False,10.0,1,2,1,1,0,1,0,0,0,0,0,1,0,0,0,2,2
400915212,Colgate Raiders,TEAM,TOTAL,TOTAL,False,,18,64,12,27,6,37,13,21,19,21,40,17,4,1,14,22,55
400915211,NC State Wolfpack,A. Abu,3138158,,True,31.0,6,10,6,10,0,0,3,6,4,7,11,2,0,6,2,4,15
400915211,NC State Wolfpack,D. Smith Jr.,4065697,,True,36.0,3,13,3,8,0,5,5,6,0,1,1,5,1,0,1,2,11
400915211,NC State Wolfpack,M. Rowan,3947151,,True,38.0,5,11,4,6,1,5,6,7,4,5,9,1,0,0,1,3,17
400915211,NC State Wolfpack,T. Dorn,3132359,,True,31.0,6,10,6,8,0,2,0,2,2,9,11,3,1,0,2,4,12
400915211,NC State Wolfpack,T. Henderson,61215,,True,35.0,6,15,3,4,3,11,8,9,1,6,7,2,0,1,0,3,23
400915211,NC State Wolfpack,D. Hicks,4065698,,False,7.0,0,0,0,0,0,0,0,1,2,0,2,0,0,0,0,1,0
400915211,NC State Wolfpack,B. Anya,66134,,False,10.0,1,2,1,2,0,0,1,2,1,0,1,1,0,1,2,4,3
400915211,NC State Wolfpack,M. Johnson,4065699,,False,12.0,0,2,0,1,0,1,0,0,1,0,1,0,0,0,1,1,0
400915211,NC State Wolfpack,TEAM,TOTAL,TOTAL,False,,27,63,23,39,4,24,23,33,15,29,44,14,2,8,9,22,81
400915211,Georgia Southern Eagles,M. Glenn,3906660,,True,17.0,2,6,2,6,0,0,1,2,3,3,6,0,0,2,0,5,5
400915211,Georgia Southern Eagles,S. O'Connell,3141256,,True,29.0,3,9,3,7,0,2,3,4,4,3,7,0,0,0,1,4,9
400915211,Georgia Southern Eagles,T. Brown,3906662,,True,36.0,8,23,6,12,2,11,8,12,1,9,10,3,2,0,0,1,26
400915211,Georgia Southern Eagles,I. Smith,3906661,,True,24.0,8,17,8,15,0,2,4,6,3,1,4,0,0,0,0,4,20
400915211,Georgia Southern Eagles,D. Boykins,3141253,,True,29.0,0,2,0,1,0,1,0,0,0,4,4,2,2,0,4,4,0
400915211,Georgia Southern Eagles,C. Simmons,3141258,,False,19.0,1,5,1,5,0,0,2,2,3,3,6,0,0,1,0,3,4
400915211,Georgia Southern Eagles,B.J. Gladden,67030,,False,17.0,1,6,1,4,0,2,2,6,3,1,4,0,0,0,1,2,4
400915211,Georgia Southern Eagles,J. Allsmiller,3141255,,False,29.0,4,5,1,1,3,4,0,0,0,0,0,0,0,0,1,4,11
400915211,Georgia Southern Eagles,TEAM,TOTAL,TOTAL,False,,27,73,22,51,5,22,20,32,20,26,46,5,4,3,7,27,79
400915210,Western Carolina Catamounts,M. Gosselin,3936283,,True,14.0,1,3,1,1,0,2,0,0,0,2,2,0,1,0,2,4,2
400915210,Western Carolina Catamounts,C. Brooks,67282,,True,7.0,0,0,0,0,0,0,0,0,1,0,1,0,0,0,2,3,0
400915210,Western Carolina Catamounts,D. Parks,3936284,,True,28.0,4,12,2,3,2,9,0,0,3,2,5,3,1,0,2,1,10
400915210,Western Carolina Catamounts,E. Pughsley,3936282,,True,26.0,0,14,0,5,0,9,0,0,1,3,4,2,0,0,6,3,0
400915210,Western Carolina Catamounts,D. Peterson,3151469,,True,25.0,2,10,2,10,0,0,2,2,0,2,2,0,1,0,0,4,6
400915210,Western Carolina Catamounts,A. Sledd,4067647,,False,11.0,0,0,0,0,0,0,0,0,0,1,1,0,0,0,0,3,0
400915210,Western Carolina Catamounts,Y. Olcay,4067646,,False,17.0,2,4,2,4,0,0,0,1,2,5,7,0,0,0,0,5,4
400915210,Western Carolina Catamounts,O. Steger,4067645,,False,26.0,4,9,2,4,2,5,0,0,2,4,6,2,0,1,2,2,10
400915210,Western Carolina Catamounts,J. Deloach,3936285,,False,15.0,1,3,1,3,0,0,0,0,0,0,0,0,0,2,0,3,2
400915210,Western Carolina Catamounts,J. McMillan,4067644,,False,9.0,3,6,0,0,3,6,0,0,0,0,0,0,0,0,0,0,9
400915210,Western Carolina Catamounts,M. Smith,4067643,,False,17.0,0,4,0,3,0,1,0,0,0,3,3,2,0,0,1,1,0
400915210,Western Carolina Catamounts,D. Fuller,3957795,,False,5.0,0,2,0,1,0,1,0,0,1,0,1,1,0,0,1,0,0
400915210,Western Carolina Catamounts,TEAM,TOTAL,TOTAL,False,,17,67,10,34,7,33,2,3,14,22,36,10,3,3,16,29,43
400915210,Miami Hurricanes,K. Murphy,61668,,True,24.0,5,9,5,9,0,0,3,4,3,5,8,0,1,1,2,1,13
400915210,Miami Hurricanes,E. Izundu,3904629,,True,13.0,5,5,5,5,0,0,4,4,2,3,5,1,1,1,3,3,14
400915210,Miami Hurricanes,A. Lawrence II,3904628,,True,23.0,3,5,2,4,1,1,1,1,1,5,6,3,3,3,1,2,8
400915210,Miami Hurricanes,J. Newton,3138145,,True,25.0,3,8,3,8,0,0,7,10,0,4,4,2,1,0,2,2,13
400915210,Miami Hurricanes,D. Reed,66130,,True,24.0,3,6,1,3,2,3,0,2,1,4,5,1,1,1,0,0,8
400915210,Miami Hurricanes,D. Hernandez,4065672,,False,25.0,5,9,5,9,0,0,3,3,2,5,7,1,0,1,1,2,13
400915210,Miami Hurricanes,C. Stowell,3138149,,False,3.0,0,0,0,0,0,0,0,0,0,0,0,0,0,0,0,0,0
400915210,Miami Hurricanes,R. Miller Jr.,4065671,,False,10.0,1,4,1,4,0,0,3,6,2,0,2,0,0,0,0,1,5
400915210,Miami Hurricanes,B. Brown,4065670,,False,25.0,2,8,2,6,0,2,3,6,1,7,8,5,0,1,1,0,7
400915210,Miami Hurricanes,D. Vasiljevic,4065669,,False,23.0,4,8,1,1,3,7,0,0,1,1,2,2,1,0,0,4,11
400915210,Miami Hurricanes,M. Robinson,3947140,,False,5.0,0,0,0,0,0,0,0,0,0,0,0,0,1,0,0,0,0
400915210,Miami Hurricanes,TEAM,TOTAL,TOTAL,False,,31,62,25,49,6,13,24,36,15,37,52,15,9,8,10,15,92
400915209,Tennessee Tech Golden Eagles,M. Henry,3919448,,True,26.0,7,10,7,10,0,0,1,2,4,1,5,0,1,2,1,2,15
400915209,Tennessee Tech Golden Eagles,M. Ramsey,67802,,True,19.0,0,4,0,3,0,1,0,2,2,2,4,1,0,0,2,4,0
400915209,Tennessee Tech Golden Eagles,H. Rogers,3919446,,True,9.0,1,5,1,2,0,3,0,0,1,2,3,0,0,0,0,5,2
400915209,Tennessee Tech Golden Eagles,A. Jugovic,3138584,,True,35.0,1,9,0,3,1,6,2,2,0,1,1,3,0,0,1,0,5
400915209,Tennessee Tech Golden Eagles,K. Mack,61344,,True,32.0,3,9,2,4,1,5,2,3,2,0,2,0,0,0,2,2,9
400915209,Tennessee Tech Golden Eagles,J. Hawkins,4067258,,False,12.0,4,8,3,6,1,2,1,2,2,2,4,1,1,0,1,2,10
400915209,Tennessee Tech Golden Eagles,C. Alexander II,3919450,,False,23.0,2,4,2,4,0,0,0,2,3,3,6,1,1,1,3,1,4
400915209,Tennessee Tech Golden Eagles,S. Adams,4067257,,False,13.0,1,3,0,0,1,3,2,2,1,2,3,3,1,0,1,0,5
400915209,Tennessee Tech Golden Eagles,M. Henderson,3919445,,False,18.0,2,10,1,4,1,6,0,0,2,1,3,1,1,0,0,1,5
400915209,Tennessee Tech Golden Eagles,S. Frazier,3138586,,False,13.0,0,1,0,1,0,0,0,1,1,1,2,2,0,0,3,1,0
400915209,Tennessee Tech Golden Eagles,TEAM,TOTAL,TOTAL,False,,21,63,16,37,5,26,8,16,21,16,37,12,5,3,14,18,55
400915209,Georgia Tech Yellow Jackets,A. Gueye,3135059,,True,33.0,2,5,2,5,0,0,0,0,1,3,4,4,0,1,5,2,4
400915209,Georgia Tech Yellow Jackets,Q. Stephens,66128,,True,30.0,3,9,2,5,1,4,5,7,1,5,6,4,1,1,2,2,12
400915209,Georgia Tech Yellow Jackets,B. Lammers,3135061,,True,33.0,7,9,7,9,0,0,1,1,2,6,8,1,0,5,1,2,15
400915209,Georgia Tech Yellow Jackets,J. Okogie,4065663,,True,21.0,7,9,6,7,1,2,3,6,2,3,5,1,1,0,1,3,18
400915209,Georgia Tech Yellow Jackets,J. Moore,4065662,,True,32.0,3,7,3,6,0,1,0,0,0,1,1,4,1,0,1,1,6
400915209,Georgia Tech Yellow Jackets,C. Matthews,4065665,,False,12.0,2,4,1,1,1,3,0,0,0,0,0,0,0,2,2,3,5
400915209,Georgia Tech Yellow Jackets,S. Ogbonda,3904627,,False,7.0,0,1,0,1,0,0,0,0,0,3,3,0,0,0,1,1,0
400915209,Georgia Tech Yellow Jackets,K. McCormick,61453,,False,4.0,1,1,1,1,0,0,0,0,0,0,0,0,0,0,0,0,2
400915209,Georgia Tech Yellow Jackets,J. Price,61778,,False,3.0,0,0,0,0,0,0,0,0,0,0,0,0,0,0,0,0,0
400915209,Georgia Tech Yellow Jackets,C. Heyward,61609,,False,25.0,3,5,3,4,0,1,2,2,2,1,3,3,2,0,2,1,8
400915209,Georgia Tech Yellow Jackets,TEAM,TOTAL,TOTAL,False,,28,50,25,39,3,11,11,16,8,26,34,17,5,9,15,15,70
400915208,Georgia Bulldogs,D. Ogbeide,3914273,,True,19.0,4,5,4,5,0,0,1,1,3,3,6,1,0,1,1,4,9
400915208,Georgia Bulldogs,Y. Maten,3136183,,True,35.0,7,15,5,11,2,4,3,4,2,10,12,2,0,2,2,1,19
400915208,Georgia Bulldogs,K. Geno,66249,,True,17.0,0,1,0,1,0,0,0,0,0,1,1,1,0,1,0,1,0
400915208,Georgia Bulldogs,J. Parker,66251,,True,28.0,3,10,3,7,0,3,3,4,3,5,8,3,1,0,0,3,9
400915208,Georgia Bulldogs,J.J. Frazier,66248,,True,33.0,5,13,4,10,1,3,0,0,0,1,1,5,2,0,4,5,11
400915208,Georgia Bulldogs,P. Diatta,4066267,,False,8.0,1,2,1,2,0,0,0,0,0,1,1,0,0,0,1,0,2
400915208,Georgia Bulldogs,M. Edwards,3914271,,False,21.0,2,5,2,5,0,0,0,2,2,3,5,1,1,1,1,3,4
400915208,Georgia Bulldogs,E. Wilridge,3914270,,False,11.0,1,1,1,1,0,0,0,0,0,1,1,1,0,0,2,1,2
400915208,Georgia Bulldogs,H. Kessler,61603,,False,5.0,0,0,0,0,0,0,0,0,0,2,2,0,0,0,1,1,0
400915208,Georgia Bulldogs,T. Crump,4066266,,False,7.0,1,3,1,2,0,1,0,0,0,0,0,0,0,0,1,1,2
400915208,Georgia Bulldogs,W. Jackson II,3914269,,False,16.0,2,6,0,2,2,4,0,0,0,0,0,0,1,0,1,0,6
400915208,Georgia Bulldogs,TEAM,TOTAL,TOTAL,False,,26,61,21,46,5,15,7,11,13,27,40,14,5,5,14,20,64
400915208,Clemson Tigers,D. Grantham,3129674,,True,39.0,4,13,4,7,0,6,1,1,2,5,7,2,0,2,0,2,9
400915208,Clemson Tigers,J. Blossomgame,61835,,True,32.0,5,10,5,9,0,1,3,4,1,5,6,3,0,0,1,3,13
400915208,Clemson Tigers,S. Djitte,66122,,True,19.0,4,5,4,5,0,0,0,0,5,4,9,1,1,1,1,5,8
400915208,Clemson Tigers,G. DeVoe,3129673,,True,29.0,6,12,3,7,3,5,0,1,1,0,1,1,0,1,2,1,15
400915208,Clemson Tigers,A. Holmes,62043,,True,39.0,3,10,2,6,1,4,3,4,0,2,2,2,0,0,1,1,10
400915208,Clemson Tigers,L. Robertin,3917985,,False,13.0,0,0,0,0,0,0,0,0,0,2,2,0,0,1,0,4,0
400915208,Clemson Tigers,S. Spencer,4065646,,False,1.0,0,1,0,1,0,0,0,0,0,0,0,0,0,0,0,0,0
400915208,Clemson Tigers,M. Reed,3133969,,False,28.0,5,11,2,5,3,6,6,6,0,4,4,1,3,0,2,2,19
400915208,Clemson Tigers,TEAM,TOTAL,TOTAL,False,,27,62,20,40,7,22,13,16,10,24,34,10,4,5,8,18,74
400915201,Rutgers Scarlet Knights,I. Thiam,4066412,,True,23.0,0,2,0,0,0,2,0,0,0,1,1,0,0,0,0,0,0
400915201,Rutgers Scarlet Knights,D. Freeman,3946035,,True,28.0,4,12,4,12,0,0,3,4,1,3,4,0,0,1,1,4,11
400915201,Rutgers Scarlet Knights,C.J. Gettys,61988,,True,15.0,2,2,2,2,0,0,0,0,1,2,3,1,0,0,1,3,4
400915201,Rutgers Scarlet Knights,J. Laurent,3946036,,True,22.0,0,3,0,2,0,1,4,4,1,3,4,1,1,0,0,2,4
400915201,Rutgers Scarlet Knights,C. Sanders,3946037,,True,33.0,6,16,6,15,0,1,0,0,0,3,3,2,1,0,4,0,12
400915201,Rutgers Scarlet Knights,C. Sa,4066411,,False,22.0,1,4,1,2,0,2,2,3,2,0,2,1,0,0,1,4,4
400915201,Rutgers Scarlet Knights,E. Omoruyi,4066410,,False,11.0,0,3,0,2,0,1,2,2,0,0,0,2,3,0,0,3,2
400915201,Rutgers Scarlet Knights,S. Doorson,3149899,,False,9.0,2,3,2,3,0,0,0,0,3,1,4,0,0,1,0,0,4
400915201,Rutgers Scarlet Knights,M. Williams,3149902,,False,19.0,6,9,3,3,3,6,1,2,0,0,0,0,4,0,0,2,16
400915201,Rutgers Scarlet Knights,K. Batie,3081912,,False,0.0,0,0,0,0,0,0,0,0,0,0,0,0,0,0,0,0,0
400915201,Rutgers Scarlet Knights,N. Johnson,67250,,False,18.0,2,9,2,6,0,3,0,1,1,2,3,2,3,0,2,0,4
400915201,Rutgers Scarlet Knights,TEAM,TOTAL,TOTAL,False,,23,63,20,47,3,16,12,16,13,17,30,9,12,2,11,18,61
400915201,Miami Hurricanes,D. Hernandez,4065672,,True,25.0,6,14,6,14,0,0,2,2,5,2,7,0,2,1,0,0,14
400915201,Miami Hurricanes,K. Murphy,61668,,True,30.0,1,2,1,2,0,0,2,3,2,2,4,0,1,3,3,5,4
400915201,Miami Hurricanes,B. Brown,4065670,,True,28.0,4,6,4,5,0,1,3,3,2,7,9,2,0,0,5,3,11
400915201,Miami Hurricanes,J. Newton,3138145,,True,34.0,5,13,5,11,0,2,1,1,2,4,6,3,1,1,6,0,11
400915201,Miami Hurricanes,D. Reed,66130,,True,33.0,6,10,4,6,2,4,4,5,0,6,6,3,1,0,2,3,18
400915201,Miami Hurricanes,R. Miller Jr.,4065671,,False,2.0,0,0,0,0,0,0,0,1,0,0,0,0,0,0,0,1,0
400915201,Miami Hurricanes,E. Izundu,3904629,,False,12.0,2,2,2,2,0,0,0,0,0,2,2,0,0,3,2,4,4
400915201,Miami Hurricanes,A. Lawrence II,3904628,,False,25.0,2,6,1,2,1,4,3,4,0,4,4,0,2,0,1,0,8
400915201,Miami Hurricanes,D. Vasiljevic,4065669,,False,11.0,0,1,0,0,0,1,3,3,0,1,1,1,0,0,0,1,3
400915201,Miami Hurricanes,TEAM,TOTAL,TOTAL,False,,26,54,23,42,3,12,18,22,15,29,44,9,7,8,19,17,73
400915191,Purdue Boilermakers,C. Swanigan,3906671,,True,31.0,11,19,10,17,1,2,3,3,1,9,10,1,1,4,2,4,26
400915191,Purdue Boilermakers,I. Haas,3136990,,True,14.0,2,8,2,8,0,0,2,2,1,1,2,0,0,0,2,2,6
400915191,Purdue Boilermakers,C. Edwards,4066407,,True,32.0,3,8,2,5,1,3,4,6,2,1,3,3,2,0,1,2,11
400915191,Purdue Boilermakers,P.J. Thompson,3136993,,True,34.0,3,6,1,2,2,4,1,2,1,3,4,6,0,0,0,2,9
400915191,Purdue Boilermakers,D. Mathias,3136991,,True,32.0,2,8,2,5,0,3,1,2,0,4,4,5,1,0,0,2,5
400915191,Purdue Boilermakers,V. Edwards,3136989,,False,32.0,7,12,5,8,2,4,4,4,6,4,10,2,0,1,3,0,20
400915191,Purdue Boilermakers,B. Smotherman,66195,,False,7.0,1,3,1,3,0,0,0,0,2,2,4,1,0,0,0,0,2
400915191,Purdue Boilermakers,R. Cline,3906675,,False,18.0,1,2,0,0,1,2,4,4,0,2,2,1,0,0,1,1,7
400915191,Purdue Boilermakers,TEAM,TOTAL,TOTAL,False,,30,66,23,48,7,18,19,23,14,26,40,19,4,5,9,13,86
400915191,Notre Dame Fighting Irish,B. Colson,3138192,,True,31.0,11,21,11,19,0,2,1,1,4,6,10,0,2,2,2,4,23
400915191,Notre Dame Fighting Irish,M. Geben,3138191,,True,22.0,3,4,3,4,0,0,3,4,1,5,6,3,1,0,1,3,9
400915191,Notre Dame Fighting Irish,V.J. Beachem,66283,,True,35.0,4,8,2,5,2,3,0,0,0,4,4,2,0,1,2,0,10
400915191,Notre Dame Fighting Irish,M. Farrell,3138190,,True,39.0,8,15,5,9,3,6,3,3,1,4,5,10,0,0,2,2,22
400915191,Notre Dame Fighting Irish,S. Vasturia,66285,,True,33.0,1,8,0,5,1,3,0,0,0,2,2,3,0,0,3,5,3
400915191,Notre Dame Fighting Irish,A. Torres,66286,,False,5.0,1,1,1,1,0,0,0,0,0,0,0,0,1,0,0,3,2
400915191,Notre Dame Fighting Irish,M. Ryan,3908336,,False,7.0,1,2,0,0,1,2,0,0,0,0,0,0,0,0,0,1,3
400915191,Notre Dame Fighting Irish,T. Gibbs,4065703,,False,14.0,3,6,2,3,1,3,0,0,1,1,2,0,0,0,0,1,7
400915191,Notre Dame Fighting Irish,R. Pflueger,3908335,,False,14.0,1,2,1,1,0,1,0,0,0,0,0,0,0,0,0,2,2
400915191,Notre Dame Fighting Irish,TEAM,TOTAL,TOTAL,False,,33,67,25,47,8,20,7,8,8,22,30,18,4,3,10,21,81
400915187,Purdue Boilermakers,C. Swanigan,3906671,,True,35.0,3,7,1,4,2,3,6,8,3,8,11,3,2,0,6,4,14
400915187,Purdue Boilermakers,V. Edwards,3136989,,True,22.0,0,4,0,2,0,2,1,2,0,3,3,3,0,1,3,3,1
400915187,Purdue Boilermakers,I. Haas,3136990,,True,24.0,2,9,2,9,0,0,4,6,3,2,5,0,0,0,1,2,8
400915187,Purdue Boilermakers,P.J. Thompson,3136993,,True,22.0,4,7,1,3,3,4,2,2,0,0,0,1,0,0,0,4,13
400915187,Purdue Boilermakers,D. Mathias,3136991,,True,31.0,1,4,1,2,0,2,3,4,0,5,5,4,1,0,1,1,5
400915187,Purdue Boilermakers,B. Smotherman,66195,,False,11.0,2,2,1,1,1,1,0,0,2,1,3,1,0,0,1,1,5
400915187,Purdue Boilermakers,C. Edwards,4066407,,False,23.0,4,15,3,9,1,6,0,0,0,1,1,0,2,0,3,2,9
400915187,Purdue Boilermakers,R. Cline,3906675,,False,23.0,3,3,0,0,3,3,0,0,0,4,4,1,1,0,1,1,9
400915187,Purdue Boilermakers,S. Albrecht,61807,,False,9.0,0,2,0,0,0,2,0,0,1,1,2,0,0,0,1,1,0
400915187,Purdue Boilermakers,TEAM,TOTAL,TOTAL,False,,19,53,9,30,10,23,16,22,9,25,34,13,6,1,17,19,64
400915187,Louisville Cardinals,M. Mathiang,63035,,True,25.0,5,11,5,11,0,0,1,2,2,6,8,1,1,0,2,3,11
400915187,Louisville Cardinals,D. Adel,3908807,,True,31.0,3,7,1,3,2,4,1,2,1,4,5,2,1,0,3,1,9
400915187,Louisville Cardinals,J. Johnson,3147362,,True,13.0,3,5,3,5,0,0,0,0,2,0,2,0,1,0,0,2,6
400915187,Louisville Cardinals,D. Mitchell,3908809,,True,22.0,3,9,3,6,0,3,2,2,1,4,5,1,1,1,2,4,8
400915187,Louisville Cardinals,Q. Snider,3147360,,True,31.0,2,11,2,7,0,4,5,7,1,1,2,2,0,0,2,0,9
400915187,Louisville Cardinals,V.J. King,4065666,,False,10.0,0,3,0,3,0,0,0,0,0,2,2,0,0,0,0,0,0
400915187,Louisville Cardinals,R. Spalding,3908806,,False,26.0,5,5,5,5,0,0,1,2,1,8,9,1,0,1,2,3,11
400915187,Louisville Cardinals,A. Mahmoud,3147363,,False,14.0,4,4,4,4,0,0,1,2,0,1,1,2,1,1,0,5,9
400915187,Louisville Cardinals,M. Stockman,3147361,,False,1.0,0,0,0,0,0,0,0,0,0,0,0,0,0,0,0,0,0
400915187,Louisville Cardinals,R. McMahon,3908808,,False,9.0,2,2,0,0,2,2,0,0,0,1,1,1,1,0,0,1,6
400915187,Louisville Cardinals,D. Levitch,66592,,False,5.0,1,1,1,1,0,0,0,0,0,0,0,0,0,0,0,0,2
400915187,Louisville Cardinals,T. Hicks,62752,,False,13.0,0,0,0,0,0,0,0,0,0,1,1,1,0,0,1,0,0
400915187,Louisville Cardinals,TEAM,TOTAL,TOTAL,False,,28,58,24,45,4,13,11,17,8,28,36,11,6,3,12,19,71
400915173,Pittsburgh Panthers,M. Young,66290,,True,32.0,8,17,6,13,2,4,11,14,1,8,9,2,0,0,1,2,29
400915173,Pittsburgh Panthers,S. Jeter,61756,,True,30.0,2,9,0,6,2,3,2,2,3,7,10,3,1,5,1,3,8
400915173,Pittsburgh Panthers,J. Artis,66287,,True,34.0,5,12,2,7,3,5,3,4,1,7,8,5,0,1,8,2,16
400915173,Pittsburgh Panthers,C. Johnson,3138196,,True,33.0,4,10,2,3,2,7,0,1,1,3,4,3,1,0,0,5,10
400915173,Pittsburgh Panthers,C. Jones,61219,,True,36.0,4,7,4,7,0,0,1,2,0,1,1,0,2,0,1,4,9
400915173,Pittsburgh Panthers,C. Manigault,4065714,,False,2.0,1,1,1,1,0,0,0,0,0,0,0,0,0,0,0,1,2
400915173,Pittsburgh Panthers,R. Luther,3138197,,False,15.0,2,3,1,2,1,1,0,0,4,0,4,0,0,1,1,2,5
400915173,Pittsburgh Panthers,J. Kithcart,4065713,,False,18.0,1,4,1,2,0,2,0,1,2,0,2,1,1,0,0,1,2
400915173,Pittsburgh Panthers,TEAM,TOTAL,TOTAL,False,,27,63,17,41,10,22,17,24,13,29,42,14,5,7,12,20,81
400915173,Penn State Nittany Lions,M. Watkins,3912279,,True,28.0,7,11,7,11,0,0,3,4,3,12,15,0,0,2,1,2,17
400915173,Penn State Nittany Lions,L. Stevens,4066405,,True,32.0,1,10,1,10,0,0,6,6,3,2,5,4,0,1,1,3,8
400915173,Penn State Nittany Lions,T. Carr,4066404,,True,31.0,4,14,4,10,0,4,5,6,1,3,4,2,1,0,2,3,13
400915173,Penn State Nittany Lions,J. Reaves,3912278,,True,28.0,4,8,4,6,0,2,0,0,2,4,6,3,3,0,2,4,8
400915173,Penn State Nittany Lions,S. Garner,3136782,,True,32.0,3,10,0,1,3,9,3,4,0,2,2,2,2,0,2,4,12
400915173,Penn State Nittany Lions,D. Zemgulis,3912277,,False,2.0,0,0,0,0,0,0,0,0,0,0,0,0,0,0,0,1,0
400915173,Penn State Nittany Lions,J. Moore,66193,,False,7.0,0,1,0,1,0,0,0,0,0,0,0,0,0,0,1,1,0
400915173,Penn State Nittany Lions,P. Banks,66190,,False,25.0,4,8,1,2,3,6,2,2,2,2,4,3,0,0,2,3,13
400915173,Penn State Nittany Lions,N. Bostick,4066403,,False,6.0,1,3,1,2,0,1,0,0,0,0,0,0,0,1,0,1,2
400915173,Penn State Nittany Lions,T. Samuel,66681,,False,9.0,0,2,0,2,0,0,0,0,0,1,1,0,0,0,1,0,0
400915173,Penn State Nittany Lions,TEAM,TOTAL,TOTAL,False,,24,67,18,45,6,22,19,22,14,27,41,14,6,4,12,22,73
400915170,Penn State Nittany Lions,L. Stevens,4066405,,True,32.0,5,10,5,10,0,0,0,0,3,6,9,3,2,0,1,1,10
400915170,Penn State Nittany Lions,M. Watkins,3912279,,True,26.0,5,8,5,8,0,0,2,4,4,8,12,0,0,5,3,2,12
400915170,Penn State Nittany Lions,P. Banks,66190,,True,22.0,2,6,2,3,0,3,0,0,0,1,1,3,0,0,1,1,4
400915170,Penn State Nittany Lions,T. Carr,4066404,,True,30.0,1,9,1,8,0,1,2,2,1,2,3,3,2,0,2,1,4
400915170,Penn State Nittany Lions,S. Garner,3136782,,True,31.0,6,14,3,6,3,8,2,2,0,2,2,4,2,1,2,1,17
400915170,Penn State Nittany Lions,J. Moore,66193,,False,14.0,2,3,2,3,0,0,1,1,1,1,2,0,0,0,0,1,5
400915170,Penn State Nittany Lions,J. Reaves,3912278,,False,25.0,4,7,3,4,1,3,0,0,1,4,5,1,4,1,2,3,9
400915170,Penn State Nittany Lions,T. Samuel,66681,,False,20.0,1,4,1,4,0,0,4,6,0,2,2,0,1,1,0,1,6
400915170,Penn State Nittany Lions,TEAM,TOTAL,TOTAL,False,,26,61,22,46,4,15,11,15,11,27,38,14,11,8,12,11,67
400915170,Georgia Tech Yellow Jackets,Q. Stephens,66128,,True,38.0,5,11,2,3,3,8,0,0,1,10,11,2,1,1,2,0,13
400915170,Georgia Tech Yellow Jackets,B. Lammers,3135061,,True,35.0,6,12,6,12,0,0,0,0,3,7,10,2,2,4,3,5,12
400915170,Georgia Tech Yellow Jackets,J. Okogie,4065663,,True,27.0,5,21,3,17,2,4,1,2,2,1,3,1,1,0,1,3,13
400915170,Georgia Tech Yellow Jackets,J. Moore,4065662,,True,30.0,3,5,3,5,0,0,0,0,1,0,1,4,0,1,4,1,6
400915170,Georgia Tech Yellow Jackets,C. Heyward,61609,,True,13.0,0,0,0,0,0,0,0,0,0,0,0,0,0,0,2,1,0
400915170,Georgia Tech Yellow Jackets,C. Matthews,4065665,,False,0.0,0,0,0,0,0,0,0,0,0,0,0,0,0,0,0,0,0
400915170,Georgia Tech Yellow Jackets,S. Ogbonda,3904627,,False,3.0,0,0,0,0,0,0,2,2,0,0,0,0,0,0,0,1,2
400915170,Georgia Tech Yellow Jackets,A. Gueye,3135059,,False,4.0,0,2,0,2,0,0,0,0,4,2,6,0,0,0,2,0,0
400915170,Georgia Tech Yellow Jackets,K. McCormick,61453,,False,0.0,0,0,0,0,0,0,0,0,0,0,0,0,0,0,0,0,0
400915170,Georgia Tech Yellow Jackets,T. Jackson,3135057,,False,24.0,2,9,1,6,1,3,2,3,0,2,2,3,0,0,2,2,7
400915170,Georgia Tech Yellow Jackets,J. Heath,67623,,False,26.0,3,6,2,5,1,1,0,0,0,2,2,3,2,2,0,3,7
400915170,Georgia Tech Yellow Jackets,TEAM,TOTAL,TOTAL,False,,24,66,17,50,7,16,5,7,16,27,43,15,6,8,17,16,60
400915167,Penn State Nittany Lions,L. Stevens,4066405,,True,31.0,5,9,5,8,0,1,1,2,3,3,6,1,1,3,2,5,11
400915167,Penn State Nittany Lions,M. Watkins,3912279,,True,10.0,2,4,2,4,0,0,0,0,0,3,3,0,1,0,0,3,4
400915167,Penn State Nittany Lions,P. Banks,66190,,True,32.0,4,11,1,3,3,8,2,3,0,2,2,2,0,0,1,1,13
400915167,Penn State Nittany Lions,T. Carr,4066404,,True,36.0,8,19,6,13,2,6,2,2,1,5,6,3,0,0,3,2,20
400915167,Penn State Nittany Lions,S. Garner,3136782,,True,35.0,7,14,6,9,1,5,0,0,2,1,3,3,0,0,2,3,15
400915167,Penn State Nittany Lions,D. Zemgulis,3912277,,False,8.0,0,0,0,0,0,0,0,0,0,1,1,0,0,0,2,4,0
400915167,Penn State Nittany Lions,J. Moore,66193,,False,24.0,1,2,1,2,0,0,0,3,2,4,6,1,0,0,2,2,2
400915167,Penn State Nittany Lions,N. Bostick,4066403,,False,4.0,0,0,0,0,0,0,0,0,0,0,0,0,1,0,0,0,0
400915167,Penn State Nittany Lions,T. Samuel,66681,,False,20.0,1,5,1,4,0,1,1,1,1,5,6,2,0,0,2,3,3
400915167,Penn State Nittany Lions,TEAM,TOTAL,TOTAL,False,,28,64,22,43,6,21,6,11,12,25,37,12,3,3,14,23,68
400915167,Duke Blue Devils,A. Jefferson,61586,,True,37.0,6,9,6,9,0,0,4,10,5,10,15,0,0,4,1,4,16
400915167,Duke Blue Devils,C. Jeter,3913173,,True,6.0,0,0,0,0,0,0,1,2,0,0,0,1,0,0,0,0,1
400915167,Duke Blue Devils,L. Kennard,3913174,,True,40.0,5,16,2,8,3,8,2,2,1,3,4,3,1,0,2,1,15
400915167,Duke Blue Devils,G. Allen,3135045,,True,35.0,4,10,3,4,1,6,3,3,0,8,8,4,2,0,3,0,12
400915167,Duke Blue Devils,M. Jones,66563,,True,37.0,6,8,3,4,3,4,0,0,0,1,1,1,0,0,3,4,15
400915167,Duke Blue Devils,J. DeLaurier,4065650,,False,3.0,0,0,0,0,0,0,0,0,0,0,0,0,0,0,0,2,0
400915167,Duke Blue Devils,A. Vrankovic,3913177,,False,7.0,0,0,0,0,0,0,2,2,1,2,3,0,0,0,1,3,2
400915167,Duke Blue Devils,F. Jackson,4065651,,False,35.0,6,14,4,8,2,6,3,4,2,2,4,3,0,0,2,2,17
400915167,Duke Blue Devils,TEAM,TOTAL,TOTAL,False,,27,57,18,33,9,24,15,23,10,28,38,12,3,4,13,16,78
400915152,Virginia Cavaliers,I. Wilkins,3138203,,True,31.0,1,5,1,4,0,1,2,3,4,1,5,1,2,2,0,1,4
400915152,Virginia Cavaliers,J. Salt,3138200,,True,17.0,1,2,1,2,0,0,0,0,3,3,6,0,1,1,1,4,2
400915152,Virginia Cavaliers,D. Thompson,66274,,True,30.0,2,6,2,6,0,0,0,0,1,2,3,3,2,3,1,1,4
400915152,Virginia Cavaliers,L. Perrantes,66139,,True,33.0,6,12,2,4,4,8,3,4,0,2,2,2,1,0,4,1,19
400915152,Virginia Cavaliers,D. Hall,66138,,True,31.0,4,10,2,6,2,4,2,3,0,3,3,3,2,0,0,1,12
400915152,Virginia Cavaliers,M. Diakite,3947156,,False,7.0,0,3,0,3,0,0,0,0,2,0,2,0,0,0,1,0,0
400915152,Virginia Cavaliers,J. Reuter,3908374,,False,17.0,1,2,1,2,0,0,5,6,1,3,4,0,0,0,1,0,7
400915152,Virginia Cavaliers,T. Jerome,4065733,,False,4.0,2,3,1,1,1,2,0,0,0,0,0,0,0,0,1,0,5
400915152,Virginia Cavaliers,K. Guy,4065730,,False,11.0,0,3,0,2,0,1,2,2,0,0,0,0,0,0,0,1,2
400915152,Virginia Cavaliers,M. Shayok,3138201,,False,19.0,4,10,4,10,0,0,0,2,0,1,1,0,1,0,1,2,8
400915152,Virginia Cavaliers,TEAM,TOTAL,TOTAL,False,,21,56,14,40,7,16,14,20,13,18,31,9,9,6,10,11,63
400915152,Ohio State Buckeyes,M. Potter,4066399,,True,18.0,3,5,2,3,1,2,0,0,1,2,3,0,0,0,1,2,7
400915152,Ohio State Buckeyes,J. Tate,3136777,,True,30.0,5,9,4,7,1,2,3,4,2,7,9,1,0,0,3,4,14
400915152,Ohio State Buckeyes,M. Loving,66343,,True,39.0,3,8,2,4,1,4,0,0,1,5,6,4,0,1,3,3,7
400915152,Ohio State Buckeyes,J. Lyle,3134899,,True,37.0,5,10,5,8,0,2,2,2,1,2,3,5,2,1,8,1,12
400915152,Ohio State Buckeyes,K. Williams,66344,,True,24.0,0,4,0,2,0,2,2,2,0,0,0,0,1,0,0,2,2
400915152,Ohio State Buckeyes,A. Wesson,4066402,,False,6.0,1,2,1,1,0,1,1,1,0,0,0,0,0,0,0,0,3
400915152,Ohio State Buckeyes,T. Thompson,66295,,False,23.0,2,2,2,2,0,0,3,4,0,4,4,1,0,1,1,5,7
400915152,Ohio State Buckeyes,C.J. Jackson,4066400,,False,23.0,3,4,0,0,3,4,0,0,0,4,4,3,1,0,3,3,9
400915152,Ohio State Buckeyes,TEAM,TOTAL,TOTAL,False,,22,44,16,27,6,17,11,13,6,25,31,14,4,3,20,20,61
400915132,Wake Forest Demon Deacons,J. Collins,3908845,,True,27.0,6,13,6,13,0,0,0,2,8,8,16,0,0,2,1,3,12
400915132,Wake Forest Demon Deacons,D. Mitoglou,3138224,,True,32.0,4,10,3,5,1,5,2,2,4,7,11,1,1,0,3,2,11
400915132,Wake Forest Demon Deacons,A. Arians,61378,,True,23.0,1,4,1,2,0,2,3,3,2,1,3,1,1,0,0,1,5
400915132,Wake Forest Demon Deacons,B. Crawford,3908844,,True,28.0,3,12,3,8,0,4,2,2,1,4,5,4,0,0,9,3,8
400915132,Wake Forest Demon Deacons,M. Wilbekin,3138222,,True,24.0,1,5,0,1,1,4,2,2,0,1,1,0,0,0,0,2,5
400915132,Wake Forest Demon Deacons,G. McClinton,66140,,False,14.0,0,2,0,2,0,0,0,0,0,1,1,0,0,0,1,2,0
400915132,Wake Forest Demon Deacons,D. Moore,3908843,,False,5.0,0,0,0,0,0,0,0,0,0,0,0,0,0,0,1,1,0
400915132,Wake Forest Demon Deacons,B. Childress,4065750,,False,15.0,2,8,1,6,1,2,0,0,0,2,2,0,2,0,1,0,5
400915132,Wake Forest Demon Deacons,K. Woods,3132360,,False,32.0,2,7,0,3,2,4,6,6,1,5,6,4,1,0,2,2,12
400915132,Wake Forest Demon Deacons,TEAM,TOTAL,TOTAL,False,,19,61,14,40,5,21,15,17,19,29,48,10,5,2,19,16,58
400915132,Northwestern Wildcats,V. Law,3136746,,True,33.0,3,11,2,5,1,6,0,2,0,2,2,2,2,0,0,3,7
400915132,Northwestern Wildcats,B. McIntosh,3136749,,True,34.0,10,16,8,13,2,3,1,2,1,3,4,2,0,0,2,3,23
400915132,Northwestern Wildcats,D. Pardon,3913246,,True,16.0,1,2,1,2,0,0,0,0,3,3,6,1,0,2,1,4,2
400915132,Northwestern Wildcats,S. Lumpkin,61268,,True,33.0,4,7,4,5,0,2,2,2,5,2,7,3,3,1,1,1,10
400915132,Northwestern Wildcats,S. Lindsey,3136747,,True,31.0,5,14,3,6,2,8,0,0,0,4,4,4,1,0,0,3,12
400915132,Northwestern Wildcats,G. Skelly,3136750,,False,29.0,4,8,3,4,1,4,2,3,2,4,6,4,2,2,3,3,11
400915132,Northwestern Wildcats,N. Taphorn,66189,,False,5.0,0,1,0,0,0,1,0,0,0,1,1,1,0,0,1,0,0
400915132,Northwestern Wildcats,B. Benson,4066397,,False,1.0,0,1,0,1,0,0,0,0,0,1,1,0,0,0,1,0,0
400915132,Northwestern Wildcats,I. Brown,4066394,,False,7.0,0,4,0,3,0,1,0,0,0,0,0,1,0,0,1,0,0
400915132,Northwestern Wildcats,J. Ash,3913247,,False,11.0,0,2,0,1,0,1,0,0,0,1,1,0,1,1,0,0,0
400915132,Northwestern Wildcats,TEAM,TOTAL,TOTAL,False,,27,66,21,40,6,26,5,9,13,24,37,18,9,6,10,17,65
400915122,North Carolina Tar Heels,J. Jackson,3138156,,True,31.0,7,13,3,6,4,7,3,4,2,6,8,1,0,0,0,0,21
400915122,North Carolina Tar Heels,I. Hicks,66874,,True,27.0,2,4,2,4,0,0,3,4,2,4,6,0,1,2,3,5,7
400915122,North Carolina Tar Heels,K. Meeks,66873,,True,25.0,5,9,5,9,0,0,0,0,2,6,8,1,0,0,3,4,10
400915122,North Carolina Tar Heels,J. Berry II,3138155,,True,31.0,3,13,2,7,1,6,1,2,1,3,4,8,1,0,2,3,8
400915122,North Carolina Tar Heels,N. Britt,66872,,True,28.0,3,9,2,5,1,4,0,0,1,0,1,2,1,1,1,2,7
400915122,North Carolina Tar Heels,T. Bradley,4065673,,False,15.0,2,3,2,3,0,0,0,1,1,1,2,0,0,0,0,4,4
400915122,North Carolina Tar Heels,L. Maye,3911620,,False,8.0,0,2,0,1,0,1,2,3,1,0,1,2,0,1,0,3,2
400915122,North Carolina Tar Heels,S. Woods,4065676,,False,9.0,0,1,0,1,0,0,1,2,0,1,1,1,2,0,1,0,1
400915122,North Carolina Tar Heels,B. Robinson,4065675,,False,9.0,0,2,0,1,0,1,0,3,0,0,0,0,0,0,0,0,0
400915122,North Carolina Tar Heels,K. Williams,3911619,,False,17.0,2,5,2,3,0,2,3,3,2,0,2,1,0,1,2,0,7
400915122,North Carolina Tar Heels,TEAM,TOTAL,TOTAL,False,,24,61,18,40,6,21,13,22,13,24,37,16,5,5,12,21,67
400915122,Indiana Hoosiers,O. Anunoby,3934719,,True,29.0,6,8,5,5,1,3,3,7,0,5,5,2,0,2,2,3,16
400915122,Indiana Hoosiers,T. Bryant,3934723,,True,27.0,4,7,3,5,1,2,3,4,2,5,7,0,2,0,2,3,12
400915122,Indiana Hoosiers,R. Johnson,3147671,,True,30.0,4,8,2,4,2,4,1,2,0,6,6,2,3,0,2,2,11
400915122,Indiana Hoosiers,J. Blackmon Jr.,3147669,,True,28.0,3,8,0,2,3,6,5,6,2,7,9,3,0,0,2,0,14
400915122,Indiana Hoosiers,J. Newkirk,66288,,True,34.0,4,10,3,6,1,4,1,2,0,1,1,3,1,1,3,4,10
400915122,Indiana Hoosiers,D. Davis,4066362,,False,13.0,1,2,1,2,0,0,3,4,1,2,3,0,1,2,0,1,5
400915122,Indiana Hoosiers,J. Morgan,3934721,,False,21.0,2,5,2,4,0,1,2,2,0,3,3,1,0,1,0,3,6
400915122,Indiana Hoosiers,D. Green,4066361,,False,5.0,0,1,0,0,0,1,0,0,0,0,0,0,0,0,0,1,0
400915122,Indiana Hoosiers,C. Jones,4066359,,False,7.0,1,3,1,3,0,0,0,0,1,0,1,0,0,0,1,1,2
400915122,Indiana Hoosiers,Z. Mcroberts,3948561,,False,6.0,0,0,0,0,0,0,0,0,1,0,1,1,0,0,1,4,0
400915122,Indiana Hoosiers,TEAM,TOTAL,TOTAL,False,,25,52,17,31,8,21,18,27,8,29,37,12,7,6,16,22,76
400915105,Nebraska Cornhuskers,E. Morrow,3911896,,True,31.0,4,10,4,10,0,0,2,2,7,5,12,0,1,3,3,2,10
400915105,Nebraska Cornhuskers,M. Jacobson,3911895,,True,32.0,5,9,4,6,1,3,0,0,2,5,7,0,1,1,1,3,11
400915105,Nebraska Cornhuskers,J. McVeigh,3911893,,True,23.0,0,2,0,0,0,2,0,0,1,2,3,0,0,0,1,0,0
400915105,Nebraska Cornhuskers,G. Watson Jr.,3911892,,True,36.0,9,19,7,14,2,5,0,0,1,5,6,4,4,0,5,1,20
400915105,Nebraska Cornhuskers,T. Webster,67619,,True,36.0,5,14,4,9,1,5,1,3,0,4,4,1,2,0,2,4,12
400915105,Nebraska Cornhuskers,I. Roby,4066392,,False,8.0,0,0,0,0,0,0,0,0,1,1,2,0,0,1,1,0,0
400915105,Nebraska Cornhuskers,J. Tshimanga,4066393,,False,9.0,1,1,1,1,0,0,1,2,1,2,3,0,0,0,0,4,3
400915105,Nebraska Cornhuskers,E. Taylor,3137222,,False,10.0,1,4,1,3,0,1,0,0,0,0,0,0,0,0,1,3,2
400915105,Nebraska Cornhuskers,A. Gill,66588,,False,15.0,0,4,0,2,0,2,0,0,1,0,1,1,1,0,2,3,0
400915105,Nebraska Cornhuskers,TEAM,TOTAL,TOTAL,False,,25,63,21,45,4,18,4,7,18,24,42,6,9,5,17,20,58
400915105,Clemson Tigers,D. Grantham,3129674,,True,29.0,3,7,1,4,2,3,1,2,1,4,5,0,1,1,3,3,9
400915105,Clemson Tigers,J. Blossomgame,61835,,True,35.0,5,13,5,11,0,2,5,7,0,4,4,2,1,3,1,1,15
400915105,Clemson Tigers,S. Djitte,66122,,True,33.0,2,7,2,7,0,0,2,2,5,4,9,3,1,2,3,5,6
400915105,Clemson Tigers,G. DeVoe,3129673,,True,26.0,3,10,2,6,1,4,2,3,1,4,5,2,2,0,3,0,9
400915105,Clemson Tigers,A. Holmes,62043,,True,30.0,2,5,0,2,2,3,1,2,1,2,3,0,1,0,2,0,7
400915105,Clemson Tigers,L. Robertin,3917985,,False,5.0,0,0,0,0,0,0,0,0,0,1,1,0,0,0,0,1,0
400915105,Clemson Tigers,S. Mitchell,3136699,,False,27.0,2,6,1,4,1,2,2,2,0,1,1,0,2,1,2,0,7
400915105,Clemson Tigers,M. Reed,3133969,,False,14.0,1,1,0,0,1,1,4,4,0,2,2,0,0,0,3,0,7
400915105,Clemson Tigers,TEAM,TOTAL,TOTAL,False,,18,49,11,34,7,15,17,22,11,23,34,7,8,7,17,10,60
400915088,Minnesota Golden Gophers,J. Murphy,3911889,,True,24.0,0,6,0,5,0,1,5,6,1,5,6,3,0,2,3,4,5
400915088,Minnesota Golden Gophers,R. Lynch,66429,,True,15.0,2,6,2,6,0,0,3,6,2,2,4,0,0,1,2,2,7
400915088,Minnesota Golden Gophers,A. Coffey,4066387,,True,18.0,3,10,3,7,0,3,1,1,2,0,2,0,1,0,1,4,7
400915088,Minnesota Golden Gophers,D. McBrayer,3911888,,True,31.0,2,11,1,5,1,6,2,4,0,2,2,2,0,0,3,2,7
400915088,Minnesota Golden Gophers,N. Mason,3136499,,True,34.0,4,11,3,9,1,2,2,6,1,0,1,3,0,0,1,5,11
400915088,Minnesota Golden Gophers,E. Curry,4066388,,False,25.0,1,3,1,3,0,0,3,4,2,6,8,0,1,0,2,4,5
400915088,Minnesota Golden Gophers,B. Konate,3136497,,False,14.0,1,1,1,1,0,0,5,7,1,5,6,0,1,1,1,2,7
400915088,Minnesota Golden Gophers,S. Sharp,3911890,,False,2.0,0,0,0,0,0,0,0,0,0,0,0,0,1,0,0,0,0
400915088,Minnesota Golden Gophers,A. Gilbert,3911886,,False,13.0,2,4,0,0,2,4,1,2,0,0,0,0,0,0,3,2,7
400915088,Minnesota Golden Gophers,A. Springs,62805,,False,24.0,4,7,1,2,3,5,0,0,1,1,2,0,1,0,1,3,11
400915088,Minnesota Golden Gophers,TEAM,TOTAL,TOTAL,False,,19,59,12,38,7,21,22,36,14,21,35,8,5,4,17,28,67
400915088,Florida State Seminoles,J. Isaac,4065654,,True,32.0,5,10,5,7,0,3,4,6,3,10,13,1,2,2,3,2,14
400915088,Florida State Seminoles,M. Ojo,61596,,True,17.0,3,4,3,4,0,0,6,9,3,2,5,0,0,1,1,4,12
400915088,Florida State Seminoles,T. Mann,3907823,,True,28.0,1,4,1,3,0,1,2,2,0,5,5,1,2,0,2,3,4
400915088,Florida State Seminoles,D. Bacon,3907821,,True,33.0,6,11,4,7,2,4,4,6,2,3,5,2,0,0,2,1,18
400915088,Florida State Seminoles,X. Rathan-Mayes,66125,,True,22.0,3,7,3,5,0,2,1,2,0,3,3,1,0,0,2,3,7
400915088,Florida State Seminoles,P. Cofer,3135054,,False,15.0,0,3,0,1,0,2,0,0,0,0,0,0,0,0,1,0,0
400915088,Florida State Seminoles,J. Smith,66126,,False,7.0,1,2,1,2,0,0,1,2,0,0,0,0,0,0,0,3,3
400915088,Florida State Seminoles,C. Koumadje,3907824,,False,15.0,3,4,3,4,0,0,1,3,0,3,3,1,0,1,0,3,7
400915088,Florida State Seminoles,B. Angola-Rodas,4065658,,False,4.0,0,0,0,0,0,0,1,2,0,1,1,1,1,0,2,1,1
400915088,Florida State Seminoles,P. Savoy,4065657,,False,0.0,0,1,0,0,0,1,0,0,0,0,0,0,0,0,0,0,0
400915088,Florida State Seminoles,T. Forrest,4065656,,False,14.0,0,3,0,2,0,1,5,6,1,2,3,2,0,0,0,3,5
400915088,Florida State Seminoles,C. Walker,4065655,,False,13.0,1,5,1,3,0,2,2,2,0,0,0,1,0,0,2,2,4
400915088,Florida State Seminoles,TEAM,TOTAL,TOTAL,False,,23,54,21,38,2,16,27,40,12,29,41,10,5,4,15,25,75
400915066,Michigan State Spartans,K. Goins,3147689,,True,26.0,4,5,4,5,0,0,2,2,1,4,5,1,0,0,0,2,10
400915066,Michigan State Spartans,M. Bridges,4066383,,True,34.0,4,13,3,9,1,4,2,4,2,7,9,0,1,0,3,5,11
400915066,Michigan State Spartans,M. McQuaid,3937103,,True,19.0,1,4,0,1,1,3,5,6,1,0,1,0,0,0,1,3,8
400915066,Michigan State Spartans,L. Nairn Jr.,3147690,,True,21.0,2,4,2,4,0,0,0,0,1,5,6,3,0,0,2,0,4
400915066,Michigan State Spartans,E. Harris,61214,,True,31.0,6,11,4,7,2,4,0,0,0,3,3,2,0,0,3,1,14
400915066,Michigan State Spartans,N. Ward,4066384,,False,14.0,5,7,5,7,0,0,1,2,1,2,3,1,0,1,3,1,11
400915066,Michigan State Spartans,M. Van Dyk,3157466,,False,0.0,0,0,0,0,0,0,0,0,0,0,0,0,0,0,0,0,0
400915066,Michigan State Spartans,C. Winston,4066382,,False,21.0,2,5,2,3,0,2,0,0,0,2,2,7,1,0,3,1,4
400915066,Michigan State Spartans,J. Langford,4066381,,False,22.0,3,6,2,3,1,3,0,0,2,2,4,0,0,0,2,3,7
400915066,Michigan State Spartans,K. Ahrens,3937100,,False,7.0,0,0,0,0,0,0,0,0,0,3,3,1,1,0,0,2,0
400915066,Michigan State Spartans,A. Ellis III,67026,,False,5.0,0,0,0,0,0,0,0,0,0,2,2,1,0,0,0,2,0
400915066,Michigan State Spartans,TEAM,TOTAL,TOTAL,False,,27,55,22,39,5,16,10,14,8,31,39,16,3,1,18,20,69
400915066,Duke Blue Devils,A. Jefferson,61586,,True,35.0,7,12,7,12,0,0,3,6,5,8,13,3,1,1,1,3,17
400915066,Duke Blue Devils,F. Jackson,4065651,,True,27.0,5,6,4,4,1,2,0,0,2,2,4,3,0,0,1,4,11
400915066,Duke Blue Devils,L. Kennard,3913174,,True,40.0,8,18,7,11,1,7,3,5,1,5,6,0,1,1,2,0,20
400915066,Duke Blue Devils,G. Allen,3135045,,True,37.0,7,21,2,10,5,11,5,7,0,3,3,4,2,0,4,4,24
400915066,Duke Blue Devils,M. Jones,66563,,True,40.0,1,7,1,1,0,6,0,2,0,1,1,4,4,0,1,3,2
400915066,Duke Blue Devils,C. Jeter,3913173,,False,21.0,2,2,2,2,0,0,0,0,1,3,4,0,0,1,0,2,4
400915066,Duke Blue Devils,TEAM,TOTAL,TOTAL,False,,30,66,23,40,7,26,11,20,11,22,33,14,8,3,9,16,78
400915046,Virginia Tech Hokies,K. Sy,4065740,,True,13.0,4,5,4,5,0,0,0,1,2,2,4,0,1,0,2,1,8
400915046,Virginia Tech Hokies,C. Clarke,3945567,,True,30.0,3,5,3,5,0,0,3,3,0,6,6,3,0,0,1,2,9
400915046,Virginia Tech Hokies,A. Hill,3147501,,True,21.0,3,8,2,5,1,3,0,0,2,2,4,0,0,0,3,5,7
400915046,Virginia Tech Hokies,J. Robinson,3945566,,True,38.0,3,8,2,5,1,3,4,4,0,0,0,4,1,0,1,2,11
400915046,Virginia Tech Hokies,J. Bibbs,3147500,,True,36.0,2,6,0,1,2,5,4,4,0,3,3,0,0,0,2,1,10
400915046,Virginia Tech Hokies,Z. LeDay,61698,,False,25.0,5,8,5,8,0,0,8,9,2,4,6,0,1,1,2,4,18
400915046,Virginia Tech Hokies,T. Outlaw,67275,,False,8.0,0,0,0,0,0,0,0,0,0,2,2,0,0,0,0,0,0
400915046,Virginia Tech Hokies,S. Allen,61795,,False,29.0,4,6,2,3,2,3,0,0,0,2,2,1,1,0,3,2,10
400915046,Virginia Tech Hokies,TEAM,TOTAL,TOTAL,False,,24,46,18,32,6,14,19,21,6,22,28,8,4,1,14,17,73
400915046,Michigan Wolverines,M. Wagner,3150844,,True,18.0,5,6,5,6,0,0,1,2,1,1,2,1,1,0,1,2,11
400915046,Michigan Wolverines,D.J. Wilson,3136491,,True,11.0,1,4,1,4,0,0,0,0,2,1,3,0,0,1,1,5,2
400915046,Michigan Wolverines,Z. Irvin,66186,,True,37.0,10,20,7,12,3,8,0,0,1,4,5,0,0,0,3,2,23
400915046,Michigan Wolverines,M. Abdur-Rahkman,3136492,,True,36.0,4,10,2,6,2,4,3,4,1,5,6,2,2,0,1,2,13
400915046,Michigan Wolverines,D. Walton Jr.,66184,,True,39.0,2,6,0,1,2,5,0,1,1,4,5,5,0,0,1,1,6
400915046,Michigan Wolverines,M. Donnal,66187,,False,17.0,0,1,0,0,0,1,0,0,0,2,2,0,0,0,2,3,0
400915046,Michigan Wolverines,J. Teske,4066378,,False,4.0,0,0,0,0,0,0,0,0,1,1,2,0,0,0,0,1,0
400915046,Michigan Wolverines,I. Watson,4066379,,False,3.0,0,1,0,0,0,1,0,0,0,0,0,0,0,0,0,0,0
400915046,Michigan Wolverines,Z. Simpson,4066377,,False,5.0,0,0,0,0,0,0,0,0,0,0,0,2,0,0,0,2,0
400915046,Michigan Wolverines,D. Robinson,3157465,,False,30.0,6,11,3,3,3,8,0,0,0,0,0,1,0,0,0,3,15
400915046,Michigan Wolverines,TEAM,TOTAL,TOTAL,False,,28,59,18,32,10,27,4,7,8,18,26,11,3,1,9,21,70
400915024,Pittsburgh Panthers,M. Young,66290,,True,33.0,7,17,5,13,2,4,9,10,1,8,9,1,0,1,2,2,25
400915024,Pittsburgh Panthers,S. Jeter,61756,,True,23.0,1,3,1,2,0,1,0,2,0,6,6,0,1,0,2,4,2
400915024,Pittsburgh Panthers,J. Artis,66287,,True,37.0,8,15,6,10,2,5,4,5,1,5,6,3,2,0,2,2,22
400915024,Pittsburgh Panthers,C. Jones,61219,,True,30.0,3,4,3,4,0,0,0,1,4,2,6,2,1,0,1,3,6
400915024,Pittsburgh Panthers,C. Johnson,3138196,,True,35.0,3,7,2,3,1,4,4,4,0,3,3,1,0,1,0,1,11
400915024,Pittsburgh Panthers,R. Luther,3138197,,False,26.0,2,5,2,3,0,2,1,1,0,7,7,0,1,0,1,0,5
400915024,Pittsburgh Panthers,J. Kithcart,4065713,,False,7.0,1,2,1,1,0,1,0,0,0,0,0,0,0,0,0,1,2
400915024,Pittsburgh Panthers,J. Milligan,3934655,,False,7.0,0,1,0,0,0,1,0,0,0,0,0,0,0,0,0,2,0
400915024,Pittsburgh Panthers,D. Wilson,3934652,,False,2.0,0,0,0,0,0,0,0,0,0,0,0,0,0,0,0,0,0
400915024,Pittsburgh Panthers,TEAM,TOTAL,TOTAL,False,,25,54,20,36,5,18,18,23,6,32,38,7,5,2,9,15,73
400915024,Maryland Terrapins,J. Jackson,4066373,,True,27.0,3,8,1,4,2,4,0,0,0,3,3,0,0,0,1,2,8
400915024,Maryland Terrapins,D. Dodd,66280,,True,13.0,1,3,1,3,0,0,0,0,3,4,7,1,0,3,3,5,2
400915024,Maryland Terrapins,K. Huerter,4066372,,True,30.0,2,9,0,0,2,9,0,0,0,9,9,1,0,1,3,1,6
400915024,Maryland Terrapins,A. Cowan Jr.,4066371,,True,29.0,4,11,3,7,1,4,2,4,1,0,1,3,0,0,3,3,11
400915024,Maryland Terrapins,M. Trimble,3131632,,True,35.0,4,13,2,5,2,8,3,4,2,4,6,5,2,0,3,4,13
400915024,Maryland Terrapins,I. Bender,3165262,,False,10.0,0,0,0,0,0,0,0,0,0,3,3,0,0,0,0,1,0
400915024,Maryland Terrapins,L.G. Gill,66386,,False,3.0,0,0,0,0,0,0,0,0,0,0,0,0,0,0,0,0,0
400915024,Maryland Terrapins,M. Cekovsky,3131630,,False,20.0,4,4,4,4,0,0,2,4,2,1,3,0,0,2,0,1,10
400915024,Maryland Terrapins,J. Brantley,3924879,,False,14.0,0,3,0,1,0,2,0,0,1,0,1,2,0,0,0,2,0
400915024,Maryland Terrapins,D. Wiley,3131633,,False,11.0,2,4,0,0,2,4,0,0,0,1,1,0,0,0,1,0,6
400915024,Maryland Terrapins,J. Nickens,3131631,,False,8.0,1,6,0,1,1,5,0,0,0,0,0,0,0,0,0,0,3
400915024,Maryland Terrapins,TEAM,TOTAL,TOTAL,False,,21,61,11,25,10,36,7,12,11,25,36,12,2,6,14,19,59
400914997,Notre Dame Fighting Irish,B. Colson,3138192,,True,37.0,6,14,6,11,0,3,12,12,6,11,17,0,0,3,1,3,24
400914997,Notre Dame Fighting Irish,M. Geben,3138191,,True,11.0,1,1,1,1,0,0,0,2,2,7,9,0,0,1,1,5,2
400914997,Notre Dame Fighting Irish,V.J. Beachem,66283,,True,36.0,5,10,1,2,4,8,2,2,0,5,5,1,1,0,2,2,16
400914997,Notre Dame Fighting Irish,M. Farrell,3138190,,True,38.0,5,12,3,6,2,6,4,4,0,1,1,7,0,1,5,1,16
400914997,Notre Dame Fighting Irish,S. Vasturia,66285,,True,38.0,6,12,3,7,3,5,7,7,2,7,9,3,1,0,2,3,22
400914997,Notre Dame Fighting Irish,A. Torres,66286,,False,5.0,1,2,1,2,0,0,0,0,1,0,1,0,0,0,0,2,2
400914997,Notre Dame Fighting Irish,M. Ryan,3908336,,False,8.0,0,0,0,0,0,0,3,3,0,0,0,0,1,0,1,0,3
400914997,Notre Dame Fighting Irish,T. Gibbs,4065703,,False,3.0,1,2,1,2,0,0,2,3,0,0,0,0,0,0,2,0,4
400914997,Notre Dame Fighting Irish,R. Pflueger,3908335,,False,24.0,1,2,0,1,1,1,0,0,0,2,2,0,1,1,0,1,3
400914997,Notre Dame Fighting Irish,TEAM,TOTAL,TOTAL,False,,26,55,16,32,10,23,30,33,11,34,45,11,4,6,14,17,92
400914997,Iowa Hawkeyes,C. Pemsl,4066370,,True,23.0,8,9,8,9,0,0,2,3,0,2,2,3,1,0,1,4,18
400914997,Iowa Hawkeyes,N. Baer,3155509,,True,27.0,3,10,2,6,1,4,1,2,6,6,12,1,3,0,0,2,8
400914997,Iowa Hawkeyes,J. Bohannon,4066366,,True,32.0,7,18,0,3,7,15,2,2,1,1,2,7,0,0,1,3,23
400914997,Iowa Hawkeyes,I. Moss,3935015,,True,24.0,2,4,1,2,1,2,0,0,0,2,2,5,0,1,0,2,5
400914997,Iowa Hawkeyes,P. Jok,67675,,True,36.0,4,20,2,9,2,11,5,7,1,5,6,1,2,0,2,3,15
400914997,Iowa Hawkeyes,R. Kriener,4066368,,False,2.0,0,1,0,1,0,0,0,0,0,0,0,0,1,0,1,2,0
400914997,Iowa Hawkeyes,A. Wagner,3935018,,False,6.0,0,2,0,2,0,0,0,0,0,0,0,1,0,0,0,3,0
400914997,Iowa Hawkeyes,D. Uhl,3136489,,False,16.0,0,2,0,1,0,1,2,2,1,0,1,2,0,1,1,0,2
400914997,Iowa Hawkeyes,C. Williams,3935019,,False,15.0,1,2,1,2,0,0,0,0,1,2,3,2,0,0,0,2,2
400914997,Iowa Hawkeyes,B. Ellingson,3136488,,False,19.0,2,3,1,1,1,2,0,0,0,0,0,0,1,0,0,1,5
400914997,Iowa Hawkeyes,TEAM,TOTAL,TOTAL,False,,27,71,15,36,12,35,12,16,12,20,32,22,8,2,6,22,78
400914996,Virginia Cavaliers,I. Wilkins,3138203,,True,26.0,4,5,4,5,0,0,3,4,2,1,3,3,1,2,1,1,11
400914996,Virginia Cavaliers,J. Salt,3138200,,True,17.0,2,4,2,4,0,0,0,0,0,1,1,0,0,1,0,3,4
400914996,Virginia Cavaliers,D. Thompson,66274,,True,22.0,2,6,0,2,2,4,4,4,1,2,3,4,0,0,0,0,10
400914996,Virginia Cavaliers,L. Perrantes,66139,,True,29.0,5,9,3,5,2,4,0,0,0,3,3,4,2,0,1,0,12
400914996,Virginia Cavaliers,D. Hall,66138,,True,19.0,2,5,0,2,2,3,0,0,0,3,3,1,1,0,1,0,6
400914996,Virginia Cavaliers,M. Diakite,3947156,,False,16.0,2,5,2,5,0,0,1,2,2,2,4,0,0,2,0,3,5
400914996,Virginia Cavaliers,J. Reuter,3908374,,False,21.0,7,9,7,9,0,0,0,0,2,7,9,2,1,0,1,2,14
400914996,Virginia Cavaliers,T. Jerome,4065733,,False,11.0,1,1,0,0,1,1,0,1,0,0,0,1,0,0,0,1,3
400914996,Virginia Cavaliers,K. Guy,4065730,,False,20.0,1,7,0,4,1,3,0,2,1,3,4,3,1,0,1,0,3
400914996,Virginia Cavaliers,M. Shayok,3138201,,False,19.0,3,9,3,7,0,2,0,0,1,2,3,0,3,0,0,3,6
400914996,Virginia Cavaliers,TEAM,TOTAL,TOTAL,False,,29,60,21,43,8,17,8,13,11,25,36,18,9,5,5,13,74
400914996,Iowa Hawkeyes,T. Cook,4066367,,True,29.0,2,6,2,5,0,1,2,5,3,3,6,2,1,1,4,1,6
400914996,Iowa Hawkeyes,N. Baer,3155509,,True,16.0,1,1,1,1,0,0,2,2,4,2,6,1,0,0,1,3,4
400914996,Iowa Hawkeyes,D. Uhl,3136489,,True,21.0,4,9,3,5,1,4,0,0,1,4,5,0,0,0,5,1,9
400914996,Iowa Hawkeyes,C. Williams,3935019,,True,22.0,0,2,0,2,0,0,0,0,0,1,1,1,0,0,0,4,0
400914996,Iowa Hawkeyes,P. Jok,67675,,True,27.0,5,14,2,6,3,8,0,0,0,1,1,2,0,0,1,2,13
400914996,Iowa Hawkeyes,C. Pemsl,4066370,,False,17.0,0,0,0,0,0,0,1,3,2,3,5,0,0,1,2,1,1
400914996,Iowa Hawkeyes,R. Kriener,4066368,,False,5.0,0,1,0,0,0,1,0,0,0,0,0,0,0,0,0,0,0
400914996,Iowa Hawkeyes,A. Wagner,3935018,,False,18.0,1,3,1,3,0,0,0,0,0,0,0,2,2,0,1,2,2
400914996,Iowa Hawkeyes,J. Bohannon,4066366,,False,23.0,2,8,0,2,2,6,0,0,1,3,4,0,0,0,3,1,6
400914996,Iowa Hawkeyes,M. Dailey,4066365,,False,2.0,0,0,0,0,0,0,0,0,0,1,1,0,0,0,0,0,0
400914996,Iowa Hawkeyes,I. Moss,3935015,,False,12.0,0,3,0,1,0,2,0,0,0,1,1,0,0,0,1,0,0
400914996,Iowa Hawkeyes,B. Ellingson,3136488,,False,8.0,0,1,0,0,0,1,0,0,0,0,0,0,0,0,0,2,0
400914996,Iowa Hawkeyes,TEAM,TOTAL,TOTAL,False,,15,48,9,25,6,23,5,10,12,22,34,8,3,2,18,17,41
400914976,Louisville Cardinals,V.J. King,4065666,,True,13.0,1,2,1,2,0,0,0,0,0,1,1,0,0,0,2,2,2
400914976,Louisville Cardinals,D. Adel,3908807,,True,32.0,5,10,2,4,3,6,4,4,0,4,4,4,0,1,0,3,17
400914976,Louisville Cardinals,R. Spalding,3908806,,True,12.0,1,1,1,1,0,0,0,0,0,3,3,0,1,0,0,4,2
400914976,Louisville Cardinals,A. Mahmoud,3147363,,True,34.0,5,8,5,8,0,0,0,0,0,2,2,2,2,3,1,4,10
400914976,Louisville Cardinals,Q. Snider,3147360,,True,36.0,2,8,1,4,1,4,2,2,0,1,1,3,3,0,3,1,7
400914976,Louisville Cardinals,J. Johnson,3147362,,False,28.0,5,5,5,5,0,0,3,4,4,3,7,2,0,1,3,2,13
400914976,Louisville Cardinals,M. Mathiang,63035,,False,6.0,0,0,0,0,0,0,1,2,0,1,1,0,0,0,0,3,1
400914976,Louisville Cardinals,M. Stockman,3147361,,False,1.0,0,0,0,0,0,0,0,0,0,0,0,0,0,0,0,1,0
400914976,Louisville Cardinals,D. Mitchell,3908809,,False,33.0,8,15,4,7,4,8,5,6,1,2,3,3,1,0,1,2,25
400914976,Louisville Cardinals,D. Levitch,66592,,False,2.0,0,0,0,0,0,0,0,0,0,0,0,0,0,0,0,1,0
400914976,Louisville Cardinals,T. Hicks,62752,,False,3.0,0,2,0,1,0,1,0,0,0,2,2,0,0,0,0,0,0
400914976,Louisville Cardinals,TEAM,TOTAL,TOTAL,False,,27,51,19,32,8,19,15,18,6,22,28,14,7,5,10,23,77
400914976,Indiana Hoosiers,D. Davis,4066362,,True,18.0,3,10,3,10,0,0,2,5,6,2,8,0,0,0,1,2,8
400914976,Indiana Hoosiers,T. Bryant,3934723,,True,26.0,2,5,1,4,1,1,3,4,2,1,3,1,0,1,2,3,8
400914976,Indiana Hoosiers,R. Johnson,3147671,,True,24.0,1,13,1,5,0,8,7,9,0,1,1,2,0,0,2,1,9
400914976,Indiana Hoosiers,J. Blackmon Jr.,3147669,,True,28.0,3,8,1,4,2,4,2,2,2,9,11,0,2,0,2,0,10
400914976,Indiana Hoosiers,J. Newkirk,66288,,True,25.0,3,4,3,4,0,0,0,0,1,3,4,1,0,0,2,3,6
400914976,Indiana Hoosiers,F. McSwain Jr.,4066363,,False,5.0,0,1,0,1,0,0,0,0,0,0,0,0,0,0,0,0,0
400914976,Indiana Hoosiers,J. Morgan,3934721,,False,31.0,1,3,0,1,1,2,4,4,3,1,4,2,1,1,1,4,7
400914976,Indiana Hoosiers,O. Anunoby,3934719,,False,30.0,6,10,6,7,0,3,2,5,1,2,3,1,2,0,1,3,14
400914976,Indiana Hoosiers,C. Jones,4066359,,False,11.0,0,5,0,2,0,3,0,0,0,1,1,1,1,0,2,0,0
400914976,Indiana Hoosiers,Z. Mcroberts,3948561,,False,2.0,0,0,0,0,0,0,0,0,0,0,0,0,0,0,0,1,0
400914976,Indiana Hoosiers,TEAM,TOTAL,TOTAL,False,,19,59,15,38,4,21,20,29,19,20,39,8,6,2,14,17,62
400914952,NC State Wolfpack,A. Abu,3138158,,True,31.0,6,9,6,9,0,0,4,4,2,3,5,1,1,2,4,4,16
400914952,NC State Wolfpack,B. Anya,66134,,True,6.0,0,0,0,0,0,0,0,0,0,0,0,0,0,0,2,3,0
400914952,NC State Wolfpack,D. Smith Jr.,4065697,,True,38.0,4,11,4,9,0,2,4,4,0,7,7,3,0,0,4,3,12
400914952,NC State Wolfpack,T. Dorn,3132359,,True,31.0,7,11,4,7,3,4,0,0,0,7,7,1,0,0,1,2,17
400914952,NC State Wolfpack,T. Henderson,61215,,True,39.0,2,8,1,1,1,7,2,3,0,0,0,5,3,0,2,0,7
400914952,NC State Wolfpack,T. Kapita,4065701,,False,28.0,6,9,6,9,0,0,1,1,2,3,5,0,0,1,2,3,13
400914952,NC State Wolfpack,D. Hicks,4065698,,False,2.0,0,0,0,0,0,0,0,0,0,0,0,0,0,0,0,1,0
400914952,NC State Wolfpack,M. Johnson,4065699,,False,25.0,3,5,1,2,2,3,1,1,0,1,1,1,1,1,3,5,9
400914952,NC State Wolfpack,S. Kirk,3947150,,False,0.0,0,0,0,0,0,0,0,0,0,0,0,0,0,0,1,0,0
400914952,NC State Wolfpack,TEAM,TOTAL,TOTAL,False,,28,53,22,37,6,16,12,13,6,21,27,11,5,4,19,21,74
400914952,Illinois Fighting Illini,M. Finke,3131629,,True,15.0,1,4,0,0,1,4,0,0,0,1,1,0,1,0,0,0,3
400914952,Illinois Fighting Illini,M. Thorne Jr.,56783,,True,16.0,2,3,2,3,0,0,3,4,1,0,1,0,0,0,2,1,7
400914952,Illinois Fighting Illini,M. Hill,66179,,True,35.0,5,12,5,10,0,2,12,15,2,7,9,4,1,1,1,2,22
400914952,Illinois Fighting Illini,J. Tate,66178,,True,9.0,0,1,0,1,0,0,0,0,0,1,1,2,0,0,1,1,0
400914952,Illinois Fighting Illini,T. Abrams,56643,,True,31.0,6,10,3,5,3,5,2,2,0,1,1,1,3,0,0,1,17
400914952,Illinois Fighting Illini,L. Black,3131628,,False,26.0,7,14,7,13,0,1,1,1,4,4,8,2,0,0,1,4,15
400914952,Illinois Fighting Illini,M. Morgan,66180,,False,23.0,3,5,3,5,0,0,3,4,1,5,6,0,1,2,1,1,9
400914952,Illinois Fighting Illini,T. Lucas,4066357,,False,16.0,2,3,2,3,0,0,0,0,0,0,0,0,2,0,2,2,4
400914952,Illinois Fighting Illini,A. Jordan,3911843,,False,2.0,0,1,0,0,0,1,0,0,1,0,1,1,0,0,0,0,0
400914952,Illinois Fighting Illini,J. Coleman-Lands,3911842,,False,25.0,4,7,1,2,3,5,0,0,1,0,1,1,1,0,1,3,11
400914952,Illinois Fighting Illini,D.J. Williams,3911841,,False,2.0,0,0,0,0,0,0,0,0,0,0,0,1,0,0,1,1,0
400914952,Illinois Fighting Illini,TEAM,TOTAL,TOTAL,False,,30,60,23,42,7,18,21,26,11,19,30,12,9,3,11,16,88
400914925,Wisconsin Badgers,E. Happ,3136996,,True,32.0,10,12,10,12,0,0,4,8,6,7,13,4,1,1,4,0,24
400914925,Wisconsin Badgers,V. Brown,66201,,True,33.0,4,10,2,4,2,6,0,0,1,2,3,2,1,0,2,0,10
400914925,Wisconsin Badgers,N. Hayes,66198,,True,32.0,4,11,4,11,0,0,1,3,5,6,11,10,1,0,3,3,9
400914925,Wisconsin Badgers,B. Koenig,66200,,True,27.0,7,11,1,2,6,9,0,0,0,2,2,1,0,0,0,3,20
400914925,Wisconsin Badgers,Z. Showalter,61279,,True,29.0,2,5,1,3,1,2,3,4,0,1,1,4,1,0,1,3,8
400914925,Wisconsin Badgers,A. Van Vliet,3919167,,False,1.0,0,1,0,0,0,1,0,0,0,0,0,0,0,0,0,1,0
400914925,Wisconsin Badgers,A. Illikainen,3908323,,False,6.0,0,1,0,1,0,0,0,1,0,1,1,0,0,0,1,0,0
400914925,Wisconsin Badgers,C. Thomas IV,3908321,,False,7.0,0,2,0,2,0,0,0,0,0,1,1,0,0,0,1,3,0
400914925,Wisconsin Badgers,A. Moesch,66197,,False,1.0,0,0,0,0,0,0,0,0,0,0,0,0,0,0,0,0,0
400914925,Wisconsin Badgers,D. Trice,4066413,,False,17.0,2,5,0,1,2,4,0,0,0,3,3,0,0,0,0,0,6
400914925,Wisconsin Badgers,K. Iverson,3908322,,False,5.0,0,0,0,0,0,0,0,0,0,0,0,0,0,0,0,0,0
400914925,Wisconsin Badgers,B. Pritzl,3908320,,False,1.0,0,0,0,0,0,0,0,0,1,0,1,0,0,0,0,0,0
400914925,Wisconsin Badgers,T.J. Schlundt,3136995,,False,1.0,0,0,0,0,0,0,0,0,0,0,0,0,0,0,0,0,0
400914925,Wisconsin Badgers,M. Ferris,3136994,,False,1.0,0,0,0,0,0,0,0,0,0,1,1,0,0,0,0,0,0
400914925,Wisconsin Badgers,J. Hill,66199,,False,7.0,0,1,0,0,0,1,0,0,0,1,1,0,0,0,0,1,0
400914925,Wisconsin Badgers,TEAM,TOTAL,TOTAL,False,,29,59,18,36,11,23,8,16,14,26,40,21,4,1,12,14,77
400914925,Syracuse Orange,T. Lydon,3934662,,True,36.0,4,9,3,3,1,6,0,0,2,3,5,2,0,0,1,3,9
400914925,Syracuse Orange,T. Roberson,67633,,True,13.0,0,2,0,2,0,0,0,0,1,1,2,0,1,1,0,3,0
400914925,Syracuse Orange,D. Coleman,61821,,True,30.0,5,7,5,7,0,0,2,2,1,2,3,0,1,0,0,3,12
400914925,Syracuse Orange,F. Howard,3934659,,True,16.0,2,8,1,4,1,4,2,2,0,1,1,2,3,0,1,0,7
400914925,Syracuse Orange,A. White III,61616,,True,38.0,5,15,1,6,4,9,0,0,1,4,5,0,2,1,2,2,14
400914925,Syracuse Orange,T. Thompson,4065721,,False,16.0,1,4,1,4,0,0,2,2,2,2,4,0,1,1,1,2,4
400914925,Syracuse Orange,D. Akintobi-Adeyeye,3155403,,False,0.0,0,0,0,0,0,0,0,0,0,0,0,0,0,0,0,0,0
400914925,Syracuse Orange,P. Chukwu,3136471,,False,7.0,0,0,0,0,0,0,0,0,0,1,1,0,0,0,1,0,0
400914925,Syracuse Orange,T. Battle,4065722,,False,20.0,1,4,1,2,0,2,2,2,0,2,2,1,0,0,2,4,4
400914925,Syracuse Orange,J. Gillon,61915,,False,24.0,3,6,3,4,0,2,4,5,0,1,1,4,1,0,2,1,10
400914925,Syracuse Orange,TEAM,TOTAL,TOTAL,False,,21,55,15,32,6,23,12,13,7,18,25,9,9,3,10,18,60
400910797,Tennessee Volunteers,G. Williams,4066218,,True,23.0,3,6,3,5,0,1,1,2,0,6,6,2,0,4,3,5,7
400910797,Tennessee Volunteers,J. Fulkerson,4066215,,True,24.0,4,4,4,4,0,0,0,0,0,4,4,1,2,1,2,3,8
400910797,Tennessee Volunteers,J. Bowden,4066213,,True,34.0,5,10,3,4,2,6,0,0,0,5,5,2,2,0,0,1,12
400910797,Tennessee Volunteers,S. Phillips,3918425,,True,28.0,2,5,2,5,0,0,3,4,0,0,0,2,0,0,4,2,7
400910797,Tennessee Volunteers,R. Hubbs III,66272,,True,33.0,9,11,9,11,0,0,3,3,4,2,6,1,1,1,1,1,21
400910797,Tennessee Volunteers,K. Alexander,3918424,,False,2.0,1,1,1,1,0,0,0,0,1,0,1,0,0,0,0,1,2
400910797,Tennessee Volunteers,L. Evans,66773,,False,13.0,1,3,1,2,0,1,1,2,1,0,1,0,0,0,1,3,3
400910797,Tennessee Volunteers,A. Schofield,3918423,,False,13.0,0,1,0,0,0,1,0,0,0,1,1,1,0,0,1,0,0
400910797,Tennessee Volunteers,L. Turner,3948642,,False,23.0,3,11,2,7,1,4,2,2,0,1,1,1,0,0,4,3,9
400910797,Tennessee Volunteers,D. Mostella,3149058,,False,7.0,0,2,0,2,0,0,2,2,0,3,3,1,0,0,0,3,2
400910797,Tennessee Volunteers,TEAM,TOTAL,TOTAL,False,,28,54,25,41,3,13,12,15,7,25,32,11,5,6,16,22,71
400910797,North Carolina Tar Heels,J. Jackson,3138156,,True,34.0,3,15,3,9,0,6,1,2,0,3,3,1,0,0,0,1,7
400910797,North Carolina Tar Heels,I. Hicks,66874,,True,14.0,2,7,2,7,0,0,2,2,3,3,6,0,0,2,0,5,6
400910797,North Carolina Tar Heels,K. Meeks,66873,,True,16.0,4,7,4,7,0,0,1,4,2,1,3,0,0,0,0,3,9
400910797,North Carolina Tar Heels,K. Williams,3911619,,True,29.0,5,10,4,5,1,5,1,3,1,1,2,1,0,1,3,3,12
400910797,North Carolina Tar Heels,N. Britt,66872,,True,33.0,4,14,3,10,1,4,2,3,2,3,5,7,5,0,3,2,11
400910797,North Carolina Tar Heels,T. Bradley,4065673,,False,20.0,3,4,3,4,0,0,4,6,7,3,10,1,0,1,1,0,10
400910797,North Carolina Tar Heels,L. Maye,3911620,,False,17.0,1,6,1,5,0,1,2,4,2,0,2,0,1,0,0,1,4
400910797,North Carolina Tar Heels,S. Woods,4065676,,False,8.0,3,3,3,3,0,0,0,0,1,1,2,0,1,0,3,0,6
400910797,North Carolina Tar Heels,B. Robinson,4065675,,False,17.0,3,5,3,4,0,1,0,0,1,2,3,3,0,0,0,1,6
400910797,North Carolina Tar Heels,S. White,56963,,False,12.0,1,2,1,2,0,0,0,0,0,1,1,1,0,0,0,0,2
400910797,North Carolina Tar Heels,TEAM,TOTAL,TOTAL,False,,29,73,27,56,2,17,13,24,22,19,41,14,7,4,10,16,73
400910795,Tennessee Volunteers,G. Williams,4066218,,True,20.0,6,11,6,10,0,1,2,2,4,2,6,1,2,0,6,2,14
400910795,Tennessee Volunteers,J. Fulkerson,4066215,,True,24.0,5,9,5,9,0,0,2,3,3,5,8,1,1,1,0,2,12
400910795,Tennessee Volunteers,J. Bowden,4066213,,True,23.0,2,6,1,3,1,3,0,0,0,0,0,2,0,0,1,1,5
400910795,Tennessee Volunteers,S. Phillips,3918425,,True,30.0,4,5,2,3,2,2,4,4,1,4,5,7,0,0,1,2,14
400910795,Tennessee Volunteers,R. Hubbs III,66272,,True,25.0,3,7,3,7,0,0,4,4,1,2,3,0,2,0,1,4,10
400910795,Tennessee Volunteers,K. Alexander,3918424,,False,13.0,2,4,2,4,0,0,0,1,1,2,3,1,0,0,0,2,4
400910795,Tennessee Volunteers,L. Evans,66773,,False,22.0,2,2,1,1,1,1,2,2,2,4,6,3,1,0,2,4,7
400910795,Tennessee Volunteers,K. Parker,4066217,,False,8.0,0,0,0,0,0,0,0,0,0,0,0,0,1,0,2,2,0
400910795,Tennessee Volunteers,L. Turner,3948642,,False,19.0,2,3,1,2,1,1,3,4,0,2,2,2,0,0,2,2,8
400910795,Tennessee Volunteers,D. Mostella,3149058,,False,16.0,2,6,1,3,1,3,2,4,0,3,3,1,1,0,1,2,7
400910795,Tennessee Volunteers,TEAM,TOTAL,TOTAL,False,,28,53,22,42,6,11,19,24,12,25,37,18,8,1,16,23,81
400910795,Georgia Tech Yellow Jackets,Q. Stephens,66128,,True,28.0,6,13,3,8,3,5,0,1,1,2,3,0,0,1,5,4,15
400910795,Georgia Tech Yellow Jackets,B. Lammers,3135061,,True,32.0,3,7,3,7,0,0,4,4,9,5,14,2,1,1,1,2,10
400910795,Georgia Tech Yellow Jackets,J. Okogie,4065663,,True,24.0,3,9,3,8,0,1,5,6,0,1,1,1,3,0,1,4,11
400910795,Georgia Tech Yellow Jackets,J. Heath,67623,,True,36.0,0,7,0,7,0,0,2,2,1,1,2,4,2,0,3,2,2
400910795,Georgia Tech Yellow Jackets,C. Heyward,61609,,True,26.0,1,6,0,3,1,3,0,0,1,3,4,3,1,0,0,1,3
400910795,Georgia Tech Yellow Jackets,C. Matthews,4065665,,False,13.0,4,7,2,4,2,3,4,5,0,0,0,1,1,0,1,2,14
400910795,Georgia Tech Yellow Jackets,S. Ogbonda,3904627,,False,8.0,0,0,0,0,0,0,1,2,0,0,0,0,1,0,1,2,1
400910795,Georgia Tech Yellow Jackets,A. Gueye,3135059,,False,7.0,0,0,0,0,0,0,0,0,0,1,1,0,0,0,3,3,0
400910795,Georgia Tech Yellow Jackets,K. McCormick,61453,,False,9.0,0,0,0,0,0,0,0,0,0,1,1,0,0,0,0,0,0
400910795,Georgia Tech Yellow Jackets,T. Jackson,3135057,,False,10.0,1,4,1,4,0,0,0,0,0,1,1,0,0,0,3,2,2
400910795,Georgia Tech Yellow Jackets,J. Price,61778,,False,7.0,0,2,0,1,0,1,0,0,0,0,0,1,0,0,0,0,0
400910795,Georgia Tech Yellow Jackets,TEAM,TOTAL,TOTAL,False,,18,55,12,42,6,13,16,20,15,16,31,12,9,2,19,22,58
400910785,South Carolina Gamecocks,M. Kotsar,4066224,,True,27.0,5,13,5,13,0,0,0,1,6,2,8,0,2,0,0,2,10
400910785,South Carolina Gamecocks,C. Silva,3923253,,True,22.0,4,5,4,5,0,0,6,7,1,3,4,1,0,1,1,5,14
400910785,South Carolina Gamecocks,P. Dozier,3923250,,True,34.0,10,22,8,17,2,5,4,5,3,5,8,5,4,2,4,2,26
400910785,South Carolina Gamecocks,D. Notice,66266,,True,36.0,1,9,1,4,0,5,2,3,1,1,2,2,0,0,2,3,4
400910785,South Carolina Gamecocks,J. McKie,66265,,True,29.0,1,5,1,2,0,3,1,2,1,4,5,2,1,0,2,2,3
400910785,South Carolina Gamecocks,S. Keita,4066223,,False,7.0,0,1,0,1,0,0,0,0,0,1,1,0,0,0,0,2,0
400910785,South Carolina Gamecocks,K. Gueye,4066222,,False,17.0,0,0,0,0,0,0,1,2,1,0,1,0,0,0,0,4,1
400910785,South Carolina Gamecocks,J. Holliman,3084581,,False,5.0,0,1,0,1,0,0,0,0,0,2,2,0,0,0,0,0,0
400910785,South Carolina Gamecocks,H. Gravett,4066221,,False,18.0,1,4,1,2,0,2,0,0,0,0,0,0,1,0,1,1,2
400910785,South Carolina Gamecocks,R. Felder,4066220,,False,5.0,0,2,0,1,0,1,0,0,0,1,1,0,0,1,3,1,0
400910785,South Carolina Gamecocks,TEAM,TOTAL,TOTAL,False,,22,62,20,46,2,16,14,20,14,21,35,10,8,4,14,22,60
400910785,Clemson Tigers,D. Grantham,3129674,,True,28.0,3,7,1,3,2,4,0,0,1,3,4,1,1,1,3,0,8
400910785,Clemson Tigers,J. Blossomgame,61835,,True,34.0,6,15,6,11,0,4,3,5,3,7,10,2,2,1,2,3,15
400910785,Clemson Tigers,S. Djitte,66122,,True,14.0,0,0,0,0,0,0,0,0,1,2,3,1,1,1,1,5,0
400910785,Clemson Tigers,S. Mitchell,3136699,,True,24.0,2,8,2,7,0,1,0,0,0,1,1,1,0,1,7,4,4
400910785,Clemson Tigers,A. Holmes,62043,,True,27.0,1,6,0,1,1,5,3,4,0,1,1,1,1,0,1,2,6
400910785,Clemson Tigers,E. Thomas,3947075,,False,26.0,4,6,4,6,0,0,4,6,2,5,7,0,1,1,0,4,12
400910785,Clemson Tigers,M. Reed,3133969,,False,23.0,4,7,4,5,0,2,6,6,2,1,3,1,2,0,0,1,14
400910785,Clemson Tigers,G. DeVoe,3129673,,False,24.0,1,2,1,2,0,0,1,6,2,3,5,1,1,0,0,2,3
400910785,Clemson Tigers,TEAM,TOTAL,TOTAL,False,,21,51,18,35,3,16,17,27,11,25,36,8,9,5,15,21,62
400910780,Syracuse Orange,T. Lydon,3934662,,True,35.0,5,12,2,7,3,5,5,6,0,7,7,0,1,0,6,2,18
400910780,Syracuse Orange,T. Roberson,67633,,True,21.0,0,3,0,3,0,0,1,2,3,3,6,0,0,0,2,2,1
400910780,Syracuse Orange,D. Coleman,61821,,True,15.0,1,2,1,2,0,0,2,4,1,3,4,1,1,0,0,2,4
400910780,Syracuse Orange,F. Howard,3934659,,True,24.0,3,7,2,5,1,2,3,7,0,0,0,3,2,0,1,3,10
400910780,Syracuse Orange,A. White III,61616,,True,34.0,3,9,2,4,1,5,3,4,0,3,3,0,1,0,1,2,10
400910780,Syracuse Orange,T. Thompson,4065721,,False,13.0,1,6,1,5,0,1,2,2,1,1,2,0,0,0,2,4,4
400910780,Syracuse Orange,P. Chukwu,3136471,,False,17.0,0,2,0,2,0,0,0,0,3,1,4,0,0,1,0,4,0
400910780,Syracuse Orange,T. Battle,4065722,,False,13.0,0,2,0,1,0,1,0,0,0,0,0,2,0,1,0,0,0
400910780,Syracuse Orange,J. Gillon,61915,,False,28.0,1,1,0,0,1,1,0,1,0,1,1,3,1,0,5,0,3
400910780,Syracuse Orange,TEAM,TOTAL,TOTAL,False,,14,44,8,29,6,15,16,26,9,21,30,9,6,2,17,19,50
400910780,South Carolina Gamecocks,M. Kotsar,4066224,,True,30.0,7,9,7,9,0,0,2,2,0,2,2,0,2,0,2,3,16
400910780,South Carolina Gamecocks,C. Silva,3923253,,True,16.0,1,4,1,4,0,0,1,2,4,2,6,1,0,0,2,3,3
400910780,South Carolina Gamecocks,P. Dozier,3923250,,True,29.0,7,16,6,12,1,4,0,0,2,8,10,1,3,0,3,3,15
400910780,South Carolina Gamecocks,S. Thornwell,66270,,True,31.0,3,6,2,4,1,2,9,10,2,4,6,5,3,0,3,3,16
400910780,South Carolina Gamecocks,D. Notice,66266,,True,32.0,2,7,0,3,2,4,1,2,1,2,3,2,1,0,1,3,7
400910780,South Carolina Gamecocks,S. Keita,4066223,,False,15.0,0,2,0,2,0,0,0,0,0,1,1,1,1,1,1,1,0
400910780,South Carolina Gamecocks,K. Gueye,4066222,,False,4.0,0,0,0,0,0,0,0,0,0,0,0,0,0,0,0,2,0
400910780,South Carolina Gamecocks,H. Gravett,4066221,,False,21.0,1,4,1,2,0,2,0,0,0,3,3,2,2,0,1,1,2
400910780,South Carolina Gamecocks,R. Felder,4066220,,False,2.0,0,0,0,0,0,0,0,0,0,0,0,0,0,0,0,2,0
400910780,South Carolina Gamecocks,T. Blanton,3136542,,False,4.0,1,1,1,1,0,0,0,0,0,0,0,0,0,0,0,0,2
400910780,South Carolina Gamecocks,J. McKie,66265,,False,16.0,1,2,1,1,0,1,1,3,0,2,2,1,0,0,2,0,3
400910780,South Carolina Gamecocks,TEAM,TOTAL,TOTAL,False,,23,51,19,38,4,13,14,19,10,27,37,13,12,1,15,21,64
400910764,Virginia Tech Hokies,K. Sy,4065740,,True,10.0,3,3,3,3,0,0,0,0,1,0,1,0,0,1,2,2,6
400910764,Virginia Tech Hokies,C. Clarke,3945567,,True,33.0,4,6,3,5,1,1,3,6,1,4,5,5,3,0,2,2,12
400910764,Virginia Tech Hokies,J. Robinson,3945566,,True,35.0,1,6,0,2,1,4,3,4,1,1,2,6,0,0,2,3,6
400910764,Virginia Tech Hokies,A. Hill,3147501,,True,34.0,5,10,2,4,3,6,7,10,3,6,9,3,1,0,1,0,20
400910764,Virginia Tech Hokies,J. Bibbs,3147500,,True,26.0,3,8,0,1,3,7,0,0,0,2,2,1,0,0,1,4,9
400910764,Virginia Tech Hokies,Z. LeDay,61698,,False,30.0,5,13,4,9,1,4,4,8,3,4,7,0,0,0,2,3,15
400910764,Virginia Tech Hokies,T. Outlaw,67275,,False,2.0,1,2,0,0,1,2,0,0,0,1,1,0,0,0,0,0,3
400910764,Virginia Tech Hokies,S. Allen,61795,,False,30.0,4,8,4,6,0,2,1,2,0,2,2,3,1,0,3,1,9
400910764,Virginia Tech Hokies,TEAM,TOTAL,TOTAL,False,,26,56,16,30,10,26,18,30,10,25,35,18,5,1,13,15,80
400910764,Ole Miss Rebels,M. Hymon,3136220,,True,22.0,1,3,1,3,0,0,0,0,2,3,5,1,0,1,1,4,2
400910764,Ole Miss Rebels,S. Saiz,66624,,True,38.0,9,13,9,13,0,0,3,4,3,6,9,0,0,2,1,3,21
400910764,Ole Miss Rebels,B. Tyree,4066276,,True,17.0,0,4,0,2,0,2,0,0,0,0,0,3,0,0,0,2,0
400910764,Ole Miss Rebels,T. Davis,3919454,,True,27.0,6,13,3,7,3,6,3,3,3,9,12,0,0,1,3,3,18
400910764,Ole Miss Rebels,D. Burnett,66129,,True,25.0,2,9,2,4,0,5,3,4,0,1,1,2,0,0,4,2,7
400910764,Ole Miss Rebels,J. Furmanavicius,4066280,,False,18.0,3,5,3,4,0,1,0,0,2,1,3,0,0,0,2,3,6
400910764,Ole Miss Rebels,N. Morris,4066279,,False,2.0,0,0,0,0,0,0,0,0,0,0,0,0,0,0,1,0,0
400910764,Ole Miss Rebels,D. Fitzpatrick-Dorsey,3919458,,False,3.0,0,0,0,0,0,0,0,0,0,0,0,0,0,0,0,0,0
400910764,Ole Miss Rebels,R. Brooks,3919453,,False,25.0,3,10,0,3,3,7,0,0,0,4,4,2,0,0,1,2,9
400910764,Ole Miss Rebels,C. Neal,67735,,False,23.0,5,10,3,4,2,6,0,0,2,2,4,3,0,0,3,3,12
400910764,Ole Miss Rebels,TEAM,TOTAL,TOTAL,False,,29,67,21,40,8,27,9,11,14,26,40,11,0,4,16,22,75
400910711,Wake Forest Demon Deacons,J. Collins,3908845,,True,18.0,5,8,5,8,0,0,5,6,3,3,6,1,0,1,1,4,15
400910711,Wake Forest Demon Deacons,D. Mitoglou,3138224,,True,31.0,10,14,2,3,8,11,0,0,0,7,7,0,2,0,3,3,28
400910711,Wake Forest Demon Deacons,A. Arians,61378,,True,16.0,5,8,2,3,3,5,2,2,0,0,0,0,1,0,0,3,15
400910711,Wake Forest Demon Deacons,B. Crawford,3908844,,True,36.0,8,13,6,9,2,4,2,2,2,4,6,11,4,0,3,4,20
400910711,Wake Forest Demon Deacons,K. Woods,3132360,,True,35.0,6,7,6,6,0,1,2,3,1,4,5,6,0,0,1,2,14
400910711,Wake Forest Demon Deacons,T. Rike,3155405,,False,1.0,1,1,1,1,0,0,0,1,1,0,1,0,0,0,0,1,2
400910711,Wake Forest Demon Deacons,G. McClinton,66140,,False,3.0,0,0,0,0,0,0,0,0,0,0,0,0,0,0,1,2,0
400910711,Wake Forest Demon Deacons,S. Japhet-Mathias,4065752,,False,9.0,0,0,0,0,0,0,0,0,0,2,2,0,0,1,1,4,0
400910711,Wake Forest Demon Deacons,D. Moore,3908843,,False,11.0,0,4,0,4,0,0,0,2,2,2,4,0,0,4,1,2,0
400910711,Wake Forest Demon Deacons,A. Spivey,4074937,,False,1.0,0,0,0,0,0,0,0,0,0,1,1,0,0,0,0,0,0
400910711,Wake Forest Demon Deacons,B. Childress,4065750,,False,16.0,2,7,2,6,0,1,0,0,1,2,3,4,0,0,2,1,4
400910711,Wake Forest Demon Deacons,A. Bilas,3908846,,False,1.0,0,1,0,1,0,0,0,0,0,0,0,0,0,0,0,0,0
400910711,Wake Forest Demon Deacons,M. Wilbekin,3138222,,False,21.0,3,5,0,1,3,4,1,2,0,1,1,0,0,0,0,2,10
400910711,Wake Forest Demon Deacons,T. VanHorn,3078214,,False,1.0,1,1,1,1,0,0,0,0,0,0,0,0,0,0,1,0,2
400910711,Wake Forest Demon Deacons,TEAM,TOTAL,TOTAL,False,,41,69,25,43,16,26,12,18,12,27,39,22,7,6,14,28,110
400910711,LSU Tigers,D. Reath,4066268,,True,19.0,4,10,4,10,0,0,4,8,3,1,4,0,1,1,2,3,12
400910711,LSU Tigers,C. Victor II,3134883,,True,34.0,6,15,6,15,0,0,2,5,4,5,9,0,2,0,1,1,14
400910711,LSU Tigers,S. Mays,4066269,,True,23.0,1,4,1,3,0,1,4,4,1,2,3,3,3,1,3,1,6
400910711,LSU Tigers,A. Blakeney,3907386,,True,34.0,7,14,6,9,1,5,6,9,1,3,4,1,1,0,5,3,21
400910711,LSU Tigers,B. Sampson,3907385,,True,22.0,2,6,2,3,0,3,4,5,1,2,3,0,1,0,2,1,8
400910711,LSU Tigers,W. Sims,4066274,,False,19.0,2,4,1,3,1,1,0,0,1,2,3,0,1,0,0,2,5
400910711,LSU Tigers,B. Bridgewater,66254,,False,4.0,0,1,0,1,0,0,2,2,0,0,0,0,0,0,0,0,2
400910711,LSU Tigers,E. Robinson III,3136215,,False,4.0,0,0,0,0,0,0,2,2,0,0,0,1,0,1,1,4,2
400910711,LSU Tigers,R. Vial,4066273,,False,1.0,0,0,0,0,0,0,0,0,0,0,0,0,0,0,0,0,0
400910711,LSU Tigers,M. Graves,4066272,,False,1.0,0,0,0,0,0,0,0,0,0,1,1,0,0,0,0,0,0
400910711,LSU Tigers,K. Hayward,4066270,,False,14.0,0,3,0,2,0,1,0,0,0,0,0,1,0,0,0,0,0
400910711,LSU Tigers,J. Patterson,3136216,,False,25.0,2,3,0,0,2,3,0,0,0,4,4,2,1,0,2,1,6
400910711,LSU Tigers,TEAM,TOTAL,TOTAL,False,,24,60,20,46,4,14,24,35,16,21,37,8,10,3,16,16,76
400910690,Louisville Cardinals,M. Mathiang,63035,,True,25.0,0,2,0,2,0,0,0,0,1,4,5,0,0,2,2,4,0
400910690,Louisville Cardinals,D. Adel,3908807,,True,37.0,5,10,3,7,2,3,6,6,1,5,6,2,1,0,1,4,18
400910690,Louisville Cardinals,J. Johnson,3147362,,True,26.0,7,11,7,11,0,0,0,1,3,3,6,0,1,1,1,3,14
400910690,Louisville Cardinals,D. Mitchell,3908809,,True,28.0,3,12,1,7,2,5,5,7,0,4,4,1,0,0,4,3,13
400910690,Louisville Cardinals,Q. Snider,3147360,,True,37.0,10,19,8,13,2,6,0,0,2,4,6,5,2,0,3,3,22
400910690,Louisville Cardinals,V.J. King,4065666,,False,3.0,0,1,0,1,0,0,0,0,0,0,0,0,0,0,0,1,0
400910690,Louisville Cardinals,R. Spalding,3908806,,False,13.0,1,2,1,2,0,0,4,4,2,5,7,1,0,0,1,3,6
400910690,Louisville Cardinals,A. Mahmoud,3147363,,False,16.0,0,1,0,1,0,0,0,0,2,1,3,1,0,2,2,1,0
400910690,Louisville Cardinals,D. Levitch,66592,,False,12.0,0,2,0,2,0,0,0,2,1,0,1,0,0,0,0,1,0
400910690,Louisville Cardinals,T. Hicks,62752,,False,3.0,0,0,0,0,0,0,0,0,0,2,2,0,0,0,0,0,0
400910690,Louisville Cardinals,TEAM,TOTAL,TOTAL,False,,26,60,20,46,6,14,15,20,12,28,40,10,4,5,14,23,73
400910690,Kentucky Wildcats,W. Gabriel,4066264,,True,12.0,0,2,0,1,0,1,2,2,3,4,7,0,1,2,0,3,2
400910690,Kentucky Wildcats,B. Adebayo,4066261,,True,35.0,5,6,5,6,0,0,1,6,4,5,9,1,1,2,3,3,11
400910690,Kentucky Wildcats,M. Monk,4066262,,True,29.0,6,17,5,8,1,9,3,3,0,3,3,1,1,0,3,4,16
400910690,Kentucky Wildcats,D. Fox,4066259,,True,34.0,7,15,6,12,1,3,6,10,0,2,2,3,2,0,4,3,21
400910690,Kentucky Wildcats,I. Briscoe,3936294,,True,31.0,1,5,1,5,0,0,6,6,0,5,5,3,1,0,1,4,8
400910690,Kentucky Wildcats,I. Humphries,3926491,,False,5.0,0,0,0,0,0,0,0,0,0,0,0,0,0,0,0,1,0
400910690,Kentucky Wildcats,D. Willis,66619,,False,28.0,2,7,1,2,1,5,1,2,3,6,9,1,1,0,1,1,6
400910690,Kentucky Wildcats,M. Mulder,3936298,,False,9.0,2,4,0,1,2,3,0,0,0,0,0,0,0,0,0,0,6
400910690,Kentucky Wildcats,D. Hawkins,66617,,False,17.0,0,2,0,1,0,1,0,0,1,0,1,1,0,0,0,1,0
400910690,Kentucky Wildcats,TEAM,TOTAL,TOTAL,False,,23,58,18,36,5,22,19,29,11,25,36,10,7,4,13,20,70
400910689,North Carolina Tar Heels,J. Jackson,3138156,,True,36.0,10,17,6,10,4,7,10,15,0,5,5,3,1,0,0,0,34
400910689,North Carolina Tar Heels,I. Hicks,66874,,True,15.0,5,10,5,10,0,0,0,0,1,2,3,1,0,1,0,4,10
400910689,North Carolina Tar Heels,K. Meeks,66873,,True,20.0,5,7,5,7,0,0,2,3,2,5,7,0,0,1,2,5,12
400910689,North Carolina Tar Heels,K. Williams,3911619,,True,34.0,1,2,1,1,0,1,0,0,1,2,3,5,0,1,0,1,2
400910689,North Carolina Tar Heels,J. Berry II,3138155,,True,34.0,9,15,6,10,3,5,2,2,0,5,5,7,2,0,3,5,23
400910689,North Carolina Tar Heels,T. Bradley,4065673,,False,15.0,1,5,1,5,0,0,6,6,2,2,4,1,0,1,0,3,8
400910689,North Carolina Tar Heels,L. Maye,3911620,,False,21.0,4,6,2,3,2,3,1,2,1,2,3,0,1,0,1,0,11
400910689,North Carolina Tar Heels,S. Woods,4065676,,False,4.0,0,0,0,0,0,0,0,0,0,0,0,0,0,0,2,1,0
400910689,North Carolina Tar Heels,B. Robinson,4065675,,False,7.0,0,1,0,1,0,0,0,0,0,1,1,0,0,0,0,1,0
400910689,North Carolina Tar Heels,N. Britt,66872,,False,14.0,0,3,0,2,0,1,0,0,0,0,0,1,0,1,1,1,0
400910689,North Carolina Tar Heels,TEAM,TOTAL,TOTAL,False,,35,66,26,49,9,17,21,28,10,25,35,18,4,5,9,22,100
400910689,Kentucky Wildcats,W. Gabriel,4066264,,True,21.0,1,3,1,2,0,1,2,3,3,3,6,0,0,1,2,3,4
400910689,Kentucky Wildcats,B. Adebayo,4066261,,True,19.0,6,11,6,11,0,0,1,3,4,3,7,1,0,0,0,5,13
400910689,Kentucky Wildcats,M. Monk,4066262,,True,38.0,18,28,10,16,8,12,3,5,0,0,0,2,1,0,2,0,47
400910689,Kentucky Wildcats,D. Fox,4066259,,True,35.0,9,21,9,19,0,2,6,7,0,4,4,10,2,0,2,1,24
400910689,Kentucky Wildcats,I. Briscoe,3936294,,True,38.0,4,6,3,5,1,1,1,2,3,4,7,4,0,1,1,4,10
400910689,Kentucky Wildcats,S. Killeya-Jones,4066260,,False,1.0,0,0,0,0,0,0,0,0,0,0,0,0,0,0,0,1,0
400910689,Kentucky Wildcats,I. Humphries,3926491,,False,20.0,1,3,1,3,0,0,0,1,2,3,5,0,0,0,1,3,2
400910689,Kentucky Wildcats,D. Willis,66619,,False,19.0,1,2,0,0,1,2,0,0,0,1,1,0,1,0,1,1,3
400910689,Kentucky Wildcats,D. Hawkins,66617,,False,9.0,0,0,0,0,0,0,0,0,0,2,2,2,0,0,0,2,0
400910689,Kentucky Wildcats,TEAM,TOTAL,TOTAL,False,,40,74,30,56,10,18,13,21,15,24,39,19,4,2,10,20,103
400910665,Georgia Tech Yellow Jackets,Q. Stephens,66128,,True,30.0,0,9,0,5,0,4,0,0,1,6,7,1,3,0,4,3,0
400910665,Georgia Tech Yellow Jackets,B. Lammers,3135061,,True,36.0,4,10,4,10,0,0,2,2,4,4,8,3,0,3,2,2,10
400910665,Georgia Tech Yellow Jackets,J. Okogie,4065663,,True,31.0,3,10,3,9,0,1,2,2,0,8,8,0,2,0,4,3,8
400910665,Georgia Tech Yellow Jackets,J. Moore,4065662,,True,22.0,3,6,3,6,0,0,0,0,0,1,1,2,0,0,3,0,6
400910665,Georgia Tech Yellow Jackets,C. Heyward,61609,,True,26.0,1,3,1,3,0,0,2,4,0,3,3,1,1,0,0,4,4
400910665,Georgia Tech Yellow Jackets,C. Matthews,4065665,,False,12.0,2,3,2,2,0,1,0,0,0,0,0,0,1,0,0,0,4
400910665,Georgia Tech Yellow Jackets,A. Gueye,3135059,,False,5.0,1,2,1,1,0,1,0,0,0,1,1,0,0,0,0,1,2
400910665,Georgia Tech Yellow Jackets,K. McCormick,61453,,False,1.0,0,0,0,0,0,0,0,0,0,0,0,0,0,0,0,0,0
400910665,Georgia Tech Yellow Jackets,T. Jackson,3135057,,False,21.0,2,5,1,3,1,2,0,2,0,0,0,1,0,0,0,1,5
400910665,Georgia Tech Yellow Jackets,J. Heath,67623,,False,16.0,2,4,2,3,0,1,0,0,0,0,0,0,0,1,2,2,4
400910665,Georgia Tech Yellow Jackets,TEAM,TOTAL,TOTAL,False,,18,52,17,42,1,10,6,10,5,26,31,8,7,4,16,16,43
400910665,Georgia Bulldogs,D. Ogbeide,3914273,,True,26.0,5,6,5,6,0,0,1,2,1,6,7,1,1,2,0,1,11
400910665,Georgia Bulldogs,Y. Maten,3136183,,True,34.0,5,12,5,11,0,1,6,8,2,5,7,2,1,0,2,0,16
400910665,Georgia Bulldogs,J. Harris,4066265,,True,29.0,2,4,0,0,2,4,0,0,1,3,4,5,1,0,3,3,6
400910665,Georgia Bulldogs,J. Parker,66251,,True,28.0,3,12,3,11,0,1,0,0,2,4,6,1,1,0,1,2,6
400910665,Georgia Bulldogs,J.J. Frazier,66248,,True,31.0,5,13,4,7,1,6,4,4,0,1,1,2,1,0,4,2,15
400910665,Georgia Bulldogs,P. Diatta,4066267,,False,4.0,0,3,0,0,0,3,0,0,0,2,2,0,0,0,1,0,0
400910665,Georgia Bulldogs,M. Edwards,3914271,,False,16.0,0,2,0,2,0,0,0,0,1,2,3,0,0,0,0,1,0
400910665,Georgia Bulldogs,E. Wilridge,3914270,,False,9.0,0,1,0,0,0,1,0,0,0,0,0,1,1,0,1,0,0
400910665,Georgia Bulldogs,K. Geno,66249,,False,5.0,2,3,2,2,0,1,0,0,1,1,2,0,1,0,0,3,4
400910665,Georgia Bulldogs,H. Kessler,61603,,False,3.0,0,1,0,1,0,0,0,0,1,2,3,0,0,0,0,1,0
400910665,Georgia Bulldogs,T. Crump,4066266,,False,3.0,0,3,0,2,0,1,0,0,1,0,1,1,0,0,0,0,0
400910665,Georgia Bulldogs,W. Jackson II,3914269,,False,12.0,1,2,1,2,0,0,0,0,1,0,1,0,0,0,1,1,2
400910665,Georgia Bulldogs,B. Young,66252,,False,0.0,0,0,0,0,0,0,0,0,0,0,0,0,0,0,0,0,0
400910665,Georgia Bulldogs,TEAM,TOTAL,TOTAL,False,,23,62,20,44,3,18,11,14,13,27,40,13,7,2,13,14,60
400910639,Florida State Seminoles,J. Isaac,4065654,,True,19.0,1,4,0,1,1,3,6,6,1,5,6,0,0,0,2,2,9
400910639,Florida State Seminoles,M. Ojo,61596,,True,16.0,1,4,1,4,0,0,6,6,4,3,7,1,0,1,0,3,8
400910639,Florida State Seminoles,T. Mann,3907823,,True,31.0,6,10,6,10,0,0,4,8,2,8,10,2,1,0,3,1,16
400910639,Florida State Seminoles,D. Bacon,3907821,,True,31.0,9,18,9,14,0,4,6,7,1,2,3,2,1,0,2,1,24
400910639,Florida State Seminoles,X. Rathan-Mayes,66125,,True,29.0,3,6,2,4,1,2,0,1,0,3,3,2,0,0,3,1,7
400910639,Florida State Seminoles,P. Cofer,3135054,,False,4.0,0,0,0,0,0,0,0,0,0,0,0,0,0,1,1,0,0
400910639,Florida State Seminoles,J. Smith,66126,,False,12.0,1,2,1,2,0,0,0,2,1,3,4,0,0,0,0,2,2
400910639,Florida State Seminoles,C. Koumadje,3907824,,False,13.0,0,0,0,0,0,0,0,0,0,2,2,0,1,2,1,4,0
400910639,Florida State Seminoles,B. Angola-Rodas,4065658,,False,12.0,2,4,1,2,1,2,1,1,1,4,5,2,1,0,0,1,6
400910639,Florida State Seminoles,P. Savoy,4065657,,False,5.0,1,3,0,0,1,3,0,0,0,0,0,0,0,0,0,1,3
400910639,Florida State Seminoles,T. Forrest,4065656,,False,21.0,3,5,3,5,0,0,2,2,0,1,1,1,0,0,2,1,8
400910639,Florida State Seminoles,C. Walker,4065655,,False,7.0,0,3,0,2,0,1,0,0,1,0,1,0,0,0,0,0,0
400910639,Florida State Seminoles,TEAM,TOTAL,TOTAL,False,,27,59,23,44,4,15,25,33,11,31,42,10,4,4,14,17,83
400910639,Florida Gators,J. Leon,3924899,,True,21.0,3,3,2,2,1,1,0,2,0,1,1,1,1,0,0,1,7
400910639,Florida Gators,D. Robinson,3137798,,True,16.0,2,5,2,4,0,1,4,5,2,3,5,0,1,0,0,5,8
400910639,Florida Gators,J. Egbunu,67622,,True,27.0,2,4,1,3,1,1,3,5,0,5,5,0,0,1,1,1,8
400910639,Florida Gators,K. Allen,3924896,,True,20.0,6,13,5,10,1,3,3,5,0,0,0,0,0,0,1,4,16
400910639,Florida Gators,K. Hill,66247,,True,36.0,10,15,9,13,1,2,0,0,0,3,3,3,2,0,5,2,21
400910639,Florida Gators,K. Stone,3924900,,False,17.0,1,2,1,1,0,1,0,0,1,2,3,0,0,0,0,2,2
400910639,Florida Gators,K. Hayes,3924898,,False,13.0,1,3,1,3,0,0,2,4,3,4,7,0,0,0,1,3,4
400910639,Florida Gators,E. Hester,4066256,,False,2.0,0,0,0,0,0,0,0,0,0,0,0,0,0,0,0,0,0
400910639,Florida Gators,C. Chiozza,3137795,,False,22.0,2,7,2,2,0,5,2,2,1,2,3,4,1,0,1,2,6
400910639,Florida Gators,C. Barry,61892,,False,26.0,2,10,2,8,0,2,2,2,0,2,2,1,0,1,0,3,6
400910639,Florida Gators,TEAM,TOTAL,TOTAL,False,,29,62,25,46,4,16,16,25,9,24,33,9,5,2,9,24,78
400910638,Florida Gators,J. Leon,3924899,,True,23.0,3,4,2,2,1,2,0,0,1,2,3,1,0,0,0,3,7
400910638,Florida Gators,D. Robinson,3137798,,True,31.0,3,7,2,6,1,1,4,4,2,2,4,1,2,1,0,3,11
400910638,Florida Gators,J. Egbunu,67622,,True,29.0,2,10,2,10,0,0,5,10,7,5,12,0,0,3,3,2,9
400910638,Florida Gators,K. Allen,3924896,,True,32.0,8,13,5,8,3,5,2,2,0,0,0,0,0,0,2,2,21
400910638,Florida Gators,K. Hill,66247,,True,34.0,4,11,4,11,0,0,5,7,2,5,7,6,0,1,2,4,13
400910638,Florida Gators,K. Stone,3924900,,False,12.0,1,5,0,3,1,2,0,0,0,1,1,0,1,0,1,1,3
400910638,Florida Gators,K. Hayes,3924898,,False,11.0,1,1,1,1,0,0,0,0,1,1,2,0,1,2,1,1,2
400910638,Florida Gators,C. Chiozza,3137795,,False,9.0,1,1,1,1,0,0,0,0,0,1,1,1,0,0,3,1,2
400910638,Florida Gators,C. Barry,61892,,False,19.0,3,9,3,8,0,1,0,0,0,1,1,1,2,1,1,0,6
400910638,Florida Gators,TEAM,TOTAL,TOTAL,False,,26,61,20,50,6,11,16,23,13,19,32,10,6,8,13,17,74
400910638,Duke Blue Devils,A. Jefferson,61586,,True,39.0,11,14,11,14,0,0,2,2,5,10,15,2,1,4,2,2,24
400910638,Duke Blue Devils,F. Jackson,4065651,,True,20.0,1,5,0,2,1,3,0,0,0,0,0,0,1,0,1,2,3
400910638,Duke Blue Devils,L. Kennard,3913174,,True,38.0,11,16,6,9,5,7,2,2,1,0,1,3,2,0,3,3,29
400910638,Duke Blue Devils,G. Allen,3135045,,True,35.0,2,10,1,5,1,5,1,2,0,2,2,8,1,0,2,2,6
400910638,Duke Blue Devils,M. Jones,66563,,True,36.0,0,4,0,2,0,2,0,0,1,2,3,1,1,1,1,3,0
400910638,Duke Blue Devils,J. Tatum,4065648,,False,29.0,7,12,7,12,0,0,8,8,0,8,8,2,2,1,2,3,22
400910638,Duke Blue Devils,M. Bolden,4065652,,False,2.0,0,0,0,0,0,0,0,0,0,0,0,0,0,0,0,2,0
400910638,Duke Blue Devils,C. Jeter,3913173,,False,1.0,0,0,0,0,0,0,0,0,0,0,0,0,0,0,1,1,0
400910638,Duke Blue Devils,TEAM,TOTAL,TOTAL,False,,32,61,25,44,7,17,13,14,10,25,35,16,8,6,13,18,84
400910611,Boston College Eagles,A.J. Turner,3943608,,True,35.0,5,10,3,5,2,5,1,3,1,3,4,4,0,0,4,1,13
400910611,Boston College Eagles,M. Jeffers,61901,,True,26.0,2,5,2,5,0,0,2,2,3,4,7,1,0,1,1,3,6
400910611,Boston College Eagles,C. Tava,61446,,True,20.0,1,3,1,2,0,1,0,0,0,5,5,1,0,0,2,5,2
400910611,Boston College Eagles,K. Bowman,4065635,,True,32.0,5,10,2,5,3,5,2,5,0,2,2,2,2,0,2,1,15
400910611,Boston College Eagles,J. Robinson,3943606,,True,38.0,8,18,7,14,1,4,6,9,2,9,11,1,3,0,8,4,23
400910611,Boston College Eagles,J. Reyes,3943609,,False,1.0,0,0,0,0,0,0,0,0,0,0,0,0,0,0,0,0,0
400910611,Boston College Eagles,N. Popovic,4065637,,False,13.0,4,5,4,4,0,1,0,0,1,4,5,1,0,1,1,1,8
400910611,Boston College Eagles,G. Owens,66277,,False,10.0,0,0,0,0,0,0,0,0,0,2,2,0,0,0,1,3,0
400910611,Boston College Eagles,T. Graves,4065636,,False,8.0,1,2,1,1,0,1,0,0,0,0,0,0,0,0,0,0,2
400910611,Boston College Eagles,J. Chatman,3135095,,False,17.0,1,8,0,3,1,5,0,0,0,3,3,2,1,1,3,3,3
400910611,Boston College Eagles,TEAM,TOTAL,TOTAL,False,,27,61,20,39,7,22,11,19,14,35,49,12,6,3,22,21,72
400910611,Auburn Tigers,D. Purifoy,4066249,,True,36.0,8,14,4,7,4,7,7,7,1,4,5,2,2,0,2,1,27
400910611,Auburn Tigers,H. Spencer,3908520,,True,24.0,3,6,3,6,0,0,1,3,0,4,4,0,4,6,1,4,7
400910611,Auburn Tigers,M. Heron,4066250,,True,29.0,3,9,3,7,0,2,9,10,2,5,7,1,0,1,5,4,15
400910611,Auburn Tigers,J. Harper,4066248,,True,25.0,2,10,1,4,1,6,0,1,0,2,2,3,1,0,0,2,5
400910611,Auburn Tigers,B. Brown,3908521,,True,28.0,1,8,0,3,1,5,2,2,1,1,2,1,0,2,2,4,5
400910611,Auburn Tigers,A. McLemore,4066253,,False,4.0,1,1,1,1,0,0,0,0,2,0,2,0,0,0,0,0,2
400910611,Auburn Tigers,L. Smith,61297,,False,16.0,0,1,0,1,0,0,0,0,0,3,3,0,2,2,2,2,0
400910611,Auburn Tigers,T.J. Lang,3136177,,False,17.0,2,3,0,0,2,3,0,0,0,1,1,1,2,0,2,0,6
400910611,Auburn Tigers,R. Johnson,61275,,False,21.0,2,8,2,6,0,2,0,0,0,3,3,1,2,0,2,2,4
400910611,Auburn Tigers,TEAM,TOTAL,TOTAL,False,,22,60,14,35,8,25,19,23,7,25,32,9,13,11,16,19,71
400910548,Clemson Tigers,D. Grantham,3129674,,True,25.0,0,4,0,1,0,3,0,0,1,3,4,0,0,0,2,0,0
400910548,Clemson Tigers,J. Blossomgame,61835,,True,36.0,3,8,2,6,1,2,2,2,1,3,4,0,1,1,4,2,9
400910548,Clemson Tigers,S. Djitte,66122,,True,32.0,3,8,3,7,0,1,2,2,1,6,7,0,0,0,1,4,8
400910548,Clemson Tigers,S. Mitchell,3136699,,True,29.0,6,10,4,8,2,2,4,4,1,4,5,2,1,0,2,3,18
400910548,Clemson Tigers,A. Holmes,62043,,True,22.0,3,8,0,2,3,6,0,0,0,3,3,2,2,0,0,1,9
400910548,Clemson Tigers,E. Thomas,3947075,,False,11.0,2,2,2,2,0,0,1,4,1,2,3,0,1,0,0,3,5
400910548,Clemson Tigers,M. Reed,3133969,,False,15.0,3,4,3,4,0,0,1,2,0,2,2,2,1,0,1,3,7
400910548,Clemson Tigers,G. DeVoe,3129673,,False,30.0,4,11,1,3,3,8,0,0,0,3,3,4,1,0,1,3,11
400910548,Clemson Tigers,TEAM,TOTAL,TOTAL,False,,24,55,15,33,9,22,10,14,5,27,32,10,7,1,11,19,67
400910548,Alabama Crimson Tide,D. Hall,3907408,,True,23.0,1,3,1,3,0,0,0,0,2,5,7,1,1,3,0,1,2
400910548,Alabama Crimson Tide,B. Olaniyan,61479,,True,6.0,1,1,1,1,0,0,2,2,0,1,1,0,1,0,1,2,4
400910548,Alabama Crimson Tide,B. Key,4066240,,True,27.0,2,11,2,7,0,4,2,2,1,2,3,1,1,0,1,1,6
400910548,Alabama Crimson Tide,D. Ingram,3907406,,True,25.0,0,2,0,1,0,1,3,5,1,5,6,2,1,0,3,2,3
400910548,Alabama Crimson Tide,C. Collins,61626,,True,23.0,2,6,1,2,1,4,0,0,1,3,4,0,0,0,5,1,5
400910548,Alabama Crimson Tide,J. Taylor,66684,,False,13.0,1,2,1,2,0,0,1,2,1,1,2,0,0,0,1,2,3
400910548,Alabama Crimson Tide,S. Hale,66682,,False,19.0,2,7,2,3,0,4,4,6,1,2,3,0,1,0,2,1,8
400910548,Alabama Crimson Tide,A. Davis,4066239,,False,6.0,0,1,0,1,0,0,2,2,0,2,2,0,0,0,0,0,2
400910548,Alabama Crimson Tide,B. Austin,3907407,,False,10.0,1,2,1,1,0,1,0,0,1,1,2,0,0,0,0,2,2
400910548,Alabama Crimson Tide,A. Johnson Jr.,3136622,,False,28.0,5,11,3,7,2,4,5,6,1,0,1,2,3,0,2,3,17
400910548,Alabama Crimson Tide,R. Norris,3136172,,False,20.0,1,4,1,2,0,2,0,0,1,2,3,1,1,0,1,0,2
400910548,Alabama Crimson Tide,TEAM,TOTAL,TOTAL,False,,16,50,13,30,3,20,19,25,10,27,37,7,9,3,16,15,54
401415695,St. Bonaventure Bonnies,O. Osunniyi,4397224,,True,34.0,7,10,7,10,0,0,0,3,5,5,10,1,2,0,2,2,14
401415695,St. Bonaventure Bonnies,J. Adaway,4279431,,True,40.0,4,11,3,7,1,4,2,2,0,3,3,1,2,0,2,1,11
401415695,St. Bonaventure Bonnies,J. Holmes,4701016,,True,40.0,8,12,4,8,4,4,3,4,0,4,4,3,1,1,3,2,23
401415695,St. Bonaventure Bonnies,D. Welch,4397221,,True,40.0,3,8,0,0,3,8,1,2,0,4,4,2,0,0,0,4,10
401415695,St. Bonaventure Bonnies,K. Lofton,4397220,,True,40.0,4,9,2,6,2,3,0,0,0,4,4,3,0,0,3,3,10
401415695,St. Bonaventure Bonnies,A. Coulibaly,4432889,,False,6.0,1,3,1,3,0,0,0,0,0,1,1,0,0,0,0,0,2
401415695,St. Bonaventure Bonnies,J. Ndjock-Tadjore,4897048,,False,0.0,0,0,0,0,0,0,0,0,0,0,0,0,0,0,0,0,0
401415695,St. Bonaventure Bonnies,TEAM,TOTAL,TOTAL,False,,27,53,17,34,10,19,6,11,5,22,27,10,5,1,10,12,70
401415695,Oklahoma Sooners,J. Hill,4592214,,True,38.0,5,9,5,7,0,2,3,3,1,4,5,1,0,0,2,2,13
401415695,Oklahoma Sooners,T. Groves,4278603,,True,22.0,3,9,2,5,1,4,0,0,2,6,8,2,0,0,2,2,7
401415695,Oklahoma Sooners,J. Groves,4592583,,True,21.0,1,4,0,1,1,3,0,0,0,3,3,0,0,0,0,0,3
401415695,Oklahoma Sooners,U. Gibson,4279087,,True,37.0,10,17,4,6,6,11,0,0,1,1,2,2,0,0,3,2,26
401415695,Oklahoma Sooners,J. Goldwire,4277845,,True,26.0,1,6,0,4,1,2,2,2,0,2,2,4,1,0,1,1,5
401415695,Oklahoma Sooners,E. Chargois,4278297,,False,17.0,3,5,3,4,0,1,0,0,1,2,3,6,1,0,2,5,6
401415695,Oklahoma Sooners,C.J. Noland,4694228,,False,17.0,1,1,0,0,1,1,0,1,1,0,1,2,1,0,0,0,3
401415695,Oklahoma Sooners,B. Cortes,4612129,,False,3.0,0,0,0,0,0,0,0,0,0,0,0,1,0,0,0,0,0
401415695,Oklahoma Sooners,M. Johnson,4593466,,False,19.0,2,4,1,2,1,2,0,0,0,4,4,1,1,0,2,0,5
401415695,Oklahoma Sooners,TEAM,TOTAL,TOTAL,False,,26,55,15,29,11,26,5,6,7,22,29,19,4,0,14,12,68
401415693,Saint Louis Billikens,F. Okoro,4397105,,True,31.0,6,10,6,10,0,0,0,0,5,8,13,2,0,0,2,2,12
401415693,Saint Louis Billikens,J. Nesbitt,4714246,,True,24.0,1,5,0,2,1,3,5,8,1,3,4,0,0,0,1,0,8
401415693,Saint Louis Billikens,G. Jimerson,4432008,,True,40.0,7,17,3,8,4,9,2,2,1,3,4,1,2,0,1,0,20
401415693,Saint Louis Billikens,F. Thatch Jr.,4397199,,True,32.0,5,12,5,9,0,3,1,2,2,6,8,5,0,0,4,1,11
401415693,Saint Louis Billikens,D. Jones,4278267,,True,27.0,1,3,1,1,0,2,4,4,1,1,2,4,0,1,3,2,6
401415693,Saint Louis Billikens,T. Hargrove Jr.,4592484,,False,16.0,2,3,2,3,0,0,0,0,0,2,2,0,1,0,1,0,4
401415693,Saint Louis Billikens,M. Linssen,4279174,,False,9.0,1,3,1,3,0,0,0,0,1,1,2,0,0,0,1,2,2
401415693,Saint Louis Billikens,M. Strickland,4432494,,False,18.0,2,5,2,5,0,0,1,1,0,1,1,1,0,0,0,3,5
401415693,Saint Louis Billikens,R. Williams,4399106,,False,3.0,0,2,0,1,0,1,0,0,0,0,0,0,0,0,0,0,0
401415693,Saint Louis Billikens,TEAM,TOTAL,TOTAL,False,,25,60,20,42,5,18,13,17,12,27,39,13,3,1,13,10,68
401415693,Northern Iowa Panthers,N. Carter,4431923,,True,29.0,7,14,6,7,1,7,4,4,0,4,4,5,1,0,4,3,19
401415693,Northern Iowa Panthers,N. Heise,4703912,,True,27.0,3,5,2,2,1,3,0,2,0,2,2,1,3,0,0,1,7
401415693,Northern Iowa Panthers,AJ Green,4397475,,True,35.0,7,15,2,5,5,10,2,2,0,4,4,3,3,0,0,3,21
401415693,Northern Iowa Panthers,T. Berhow,4280203,,True,38.0,6,12,0,2,6,10,0,0,1,6,7,0,0,0,2,2,18
401415693,Northern Iowa Panthers,T. Pickford,4279167,,True,25.0,2,3,1,1,1,2,0,0,1,2,3,1,1,0,0,0,5
401415693,Northern Iowa Panthers,A. Phyfe,4279169,,False,11.0,0,1,0,1,0,0,2,2,1,2,3,1,0,1,2,2,2
401415693,Northern Iowa Panthers,T. Anderson,4703914,,False,7.0,0,2,0,2,0,0,0,0,1,1,2,0,0,0,0,0,0
401415693,Northern Iowa Panthers,B. Born,4703913,,False,26.0,3,6,1,1,2,5,0,0,0,2,2,3,2,0,0,4,8
401415693,Northern Iowa Panthers,A. Kimmons,4433020,,False,2.0,0,0,0,0,0,0,0,0,0,0,0,0,0,0,0,0,0
401415693,Northern Iowa Panthers,TEAM,TOTAL,TOTAL,False,,28,58,12,21,16,37,8,10,4,25,29,14,10,1,9,15,80
401415691,VCU Rams,H. Ward,4592495,,True,22.0,4,6,4,6,0,0,0,0,1,3,4,1,0,1,0,1,8
401415691,VCU Rams,V. Williams Jr.,4397227,,True,37.0,6,9,3,3,3,6,2,2,1,10,11,6,2,0,1,2,17
401415691,VCU Rams,J. Nunn,4896614,,True,36.0,5,8,5,7,0,1,3,6,0,0,0,1,1,1,0,2,13
401415691,VCU Rams,A. Baldwin Jr.,4433182,,True,37.0,8,14,6,12,2,2,5,5,1,4,5,5,0,0,4,2,23
401415691,VCU Rams,K. Curry,4397228,,True,34.0,10,16,9,13,1,3,2,3,2,2,4,2,3,0,2,1,23
401415691,VCU Rams,M. Brown-Jones,4433224,,False,5.0,1,1,1,1,0,0,0,0,1,1,2,1,0,0,0,0,2
401415691,VCU Rams,J. DeLoach,4432483,,False,15.0,1,4,1,4,0,0,0,0,1,1,2,0,0,2,0,3,2
401415691,VCU Rams,L. Stockard III,4277897,,False,3.0,0,0,0,0,0,0,0,0,0,1,1,0,0,1,0,2,0
401415691,VCU Rams,N. Kern,4684145,,False,7.0,1,2,1,2,0,0,0,0,0,0,0,0,1,0,0,0,2
401415691,VCU Rams,M. Tsohonis,4592438,,False,4.0,0,2,0,2,0,0,0,0,0,1,1,0,0,0,0,0,0
401415691,VCU Rams,TEAM,TOTAL,TOTAL,False,,36,62,30,50,6,12,12,16,7,26,33,16,7,5,7,13,90
401415691,Princeton Tigers,T. Evbuomwan,4597865,,True,39.0,9,14,9,14,0,0,4,10,7,5,12,7,2,0,5,5,22
401415691,Princeton Tigers,D. Friberg,4398004,,True,39.0,2,5,1,1,1,4,0,1,0,5,5,2,0,0,1,1,5
401415691,Princeton Tigers,R. Langborg,4597863,,True,33.0,6,7,2,2,4,5,0,0,0,3,3,0,0,0,0,2,16
401415691,Princeton Tigers,E. Wright,4398005,,True,37.0,8,20,6,13,2,7,0,0,2,5,7,2,1,0,0,2,18
401415691,Princeton Tigers,J. Llewellyn,4398002,,True,40.0,6,17,5,10,1,7,0,0,1,3,4,1,1,0,2,1,13
401415691,Princeton Tigers,E. Barnes,4279567,,False,1.0,1,1,1,1,0,0,0,0,0,0,0,0,0,0,0,0,2
401415691,Princeton Tigers,B. Peters,4898233,,False,0.0,0,0,0,0,0,0,0,0,0,0,0,0,0,0,0,0,0
401415691,Princeton Tigers,M. Allocco,4898232,,False,11.0,1,2,0,0,1,2,0,0,1,0,1,1,0,0,2,2,3
401415691,Princeton Tigers,M. Johns,4398003,,False,0.0,0,1,0,1,0,0,0,0,0,0,0,0,0,0,0,0,0
401415691,Princeton Tigers,C. Bagin,4279564,,False,0.0,0,1,0,0,0,1,0,0,0,0,0,0,0,0,0,0,0
401415691,Princeton Tigers,TEAM,TOTAL,TOTAL,False,,33,68,24,42,9,26,4,11,13,22,35,13,4,0,10,13,79
401411717,Xavier Musketeers,J. Nunge,4277948,,True,20.0,7,9,6,8,1,1,3,4,7,1,8,3,0,1,0,1,18
401411717,Xavier Musketeers,C. Jones,4433378,,True,38.0,7,15,6,12,1,3,1,2,1,7,8,4,1,0,1,1,16
401411717,Xavier Musketeers,D. Odom,4432632,,True,24.0,2,5,2,5,0,0,0,0,0,0,0,2,1,1,1,3,4
401411717,Xavier Musketeers,A. Kunkel,4398300,,True,40.0,7,16,4,5,3,11,1,2,0,4,4,3,0,0,4,0,18
401411717,Xavier Musketeers,N. Johnson,4067338,,True,39.0,3,8,1,2,2,6,2,2,0,4,4,5,1,0,2,3,10
401411717,Xavier Musketeers,Z. Freemantle,4432869,,False,22.0,8,10,7,8,1,2,1,2,1,5,6,1,0,0,1,1,18
401411717,Xavier Musketeers,J. Hunter,4397011,,False,10.0,0,1,0,1,0,0,0,0,1,1,2,0,1,0,1,1,0
401411717,Xavier Musketeers,B. Stanley,4279788,,False,2.0,0,0,0,0,0,0,0,0,0,0,0,0,0,0,0,0,0
401411717,Xavier Musketeers,C. Edwards,4708074,,False,5.0,0,0,0,0,0,0,0,0,1,0,1,0,0,0,0,0,0
401411717,Xavier Musketeers,TEAM,TOTAL,TOTAL,False,,34,64,26,41,8,23,8,12,14,24,38,18,4,2,10,10,84
401411717,St. Bonaventure Bonnies,O. Osunniyi,4397224,,True,36.0,5,7,5,7,0,0,2,3,0,3,3,2,0,4,1,2,12
401411717,St. Bonaventure Bonnies,J. Holmes,4701016,,True,40.0,5,11,4,8,1,3,4,6,2,3,5,4,3,0,3,0,15
401411717,St. Bonaventure Bonnies,D. Welch,4397221,,True,40.0,8,15,1,5,7,10,2,2,3,4,7,1,1,0,1,4,25
401411717,St. Bonaventure Bonnies,K. Lofton,4397220,,True,40.0,6,15,5,10,1,5,2,2,3,2,5,11,0,0,1,5,15
401411717,St. Bonaventure Bonnies,J. Adaway,4279431,,True,35.0,2,8,2,4,0,4,0,0,0,4,4,0,1,0,0,2,4
401411717,St. Bonaventure Bonnies,A. Coulibaly,4432889,,False,9.0,3,6,3,6,0,0,0,0,1,1,2,0,1,0,1,0,6
401411717,St. Bonaventure Bonnies,Q. Adams,4585591,,False,0.0,0,0,0,0,0,0,0,0,0,1,1,0,0,0,0,1,0
401411717,St. Bonaventure Bonnies,TEAM,TOTAL,TOTAL,False,,29,62,20,40,9,22,10,13,10,18,28,18,6,4,7,14,77
401411713,Virginia Cavaliers,K. Shedrick,4431710,,True,27.0,3,4,3,4,0,0,2,2,2,7,9,0,1,2,2,2,8
401411713,Virginia Cavaliers,J. Gardner,4396614,,True,38.0,7,15,7,15,0,0,0,1,3,2,5,0,0,0,0,0,14
401411713,Virginia Cavaliers,R. Beekman,4432187,,True,37.0,3,6,3,5,0,1,0,0,0,6,6,6,0,0,4,5,6
401411713,Virginia Cavaliers,A. Franklin,4431744,,True,28.0,5,11,0,0,5,11,2,3,0,6,6,0,0,0,1,4,17
401411713,Virginia Cavaliers,K. Clark,4395677,,True,40.0,0,7,0,3,0,4,2,2,0,1,1,6,0,0,2,0,2
401411713,Virginia Cavaliers,F. Caffaro,4395679,,False,13.0,2,3,2,3,0,0,0,0,1,3,4,0,0,0,0,0,4
401411713,Virginia Cavaliers,M. Poindexter,4701986,,False,2.0,0,0,0,0,0,0,0,0,0,0,0,0,0,0,0,0,0
401411713,Virginia Cavaliers,K. Stattmann,4395680,,False,15.0,0,7,0,4,0,3,0,0,1,1,2,1,1,0,0,0,0
401411713,Virginia Cavaliers,TEAM,TOTAL,TOTAL,False,,20,53,15,34,5,19,6,8,8,27,35,13,2,2,9,11,51
401411713,St. Bonaventure Bonnies,O. Osunniyi,4397224,,True,27.0,3,5,3,5,0,0,4,4,2,4,6,1,0,4,4,4,10
401411713,St. Bonaventure Bonnies,J. Holmes,4701016,,True,40.0,4,12,4,10,0,2,2,2,0,5,5,0,0,0,0,1,10
401411713,St. Bonaventure Bonnies,D. Welch,4397221,,True,40.0,4,12,2,5,2,7,0,0,1,9,10,2,1,0,1,1,10
401411713,St. Bonaventure Bonnies,K. Lofton,4397220,,True,40.0,3,10,3,7,0,3,3,3,0,5,5,5,3,0,2,3,9
401411713,St. Bonaventure Bonnies,J. Adaway,4279431,,True,40.0,4,11,3,8,1,3,0,0,1,1,2,1,0,0,0,2,9
401411713,St. Bonaventure Bonnies,A. Coulibaly,4432889,,False,13.0,2,4,2,4,0,0,0,0,2,3,5,0,1,1,0,1,4
401411713,St. Bonaventure Bonnies,TEAM,TOTAL,TOTAL,False,,20,54,17,39,3,15,9,9,7,27,34,9,5,5,7,12,52
401411709,Wake Forest Demon Deacons,D. Walton,4066353,,True,30.0,5,6,3,3,2,3,4,4,0,7,7,1,2,0,1,4,16
401411709,Wake Forest Demon Deacons,I. Mucius,4395686,,True,18.0,0,1,0,0,0,1,0,0,0,0,0,1,1,1,2,4,0
401411709,Wake Forest Demon Deacons,J. LaRavia,4592691,,True,31.0,5,11,4,7,1,4,4,4,2,4,6,3,2,0,1,4,15
401411709,Wake Forest Demon Deacons,A. Williams,4592216,,True,37.0,6,13,5,9,1,4,6,12,1,3,4,5,1,0,6,2,19
401411709,Wake Forest Demon Deacons,D. Williamson,4398180,,True,33.0,3,7,1,3,2,4,6,6,0,2,2,2,0,1,1,0,14
401411709,Wake Forest Demon Deacons,K. Sy,4065740,,False,10.0,0,2,0,1,0,1,0,0,0,0,0,0,1,1,1,2,0
401411709,Wake Forest Demon Deacons,C. Hildreth,4696316,,False,21.0,2,5,2,2,0,3,6,8,1,4,5,2,3,0,2,2,10
401411709,Wake Forest Demon Deacons,D. Monsanto,4432916,,False,20.0,1,6,0,1,1,5,3,3,2,2,4,0,2,0,0,4,6
401411709,Wake Forest Demon Deacons,TEAM,TOTAL,TOTAL,False,,22,51,15,26,7,25,29,37,8,23,31,14,12,3,15,23,80
401411709,VCU Rams,H. Ward,4592495,,True,18.0,2,3,2,3,0,0,4,4,2,2,4,2,2,2,0,4,8
401411709,VCU Rams,V. Williams Jr.,4397227,,True,37.0,7,15,4,6,3,9,10,11,2,6,8,0,1,1,5,3,27
401411709,VCU Rams,J. Nunn,4896614,,True,38.0,6,11,0,1,6,10,0,0,0,3,3,2,1,0,2,4,18
401411709,VCU Rams,A. Baldwin Jr.,4433182,,True,27.0,0,7,0,4,0,3,4,6,1,2,3,4,1,0,4,5,4
401411709,VCU Rams,K. Curry,4397228,,True,28.0,1,5,1,4,0,1,4,4,0,4,4,0,2,0,1,5,6
401411709,VCU Rams,M. Brown-Jones,4433224,,False,7.0,0,1,0,0,0,1,0,0,0,2,2,0,0,0,0,2,0
401411709,VCU Rams,J. DeLoach,4432483,,False,15.0,3,3,3,3,0,0,1,2,4,4,8,2,1,0,2,0,7
401411709,VCU Rams,L. Stockard III,4277897,,False,7.0,2,4,2,4,0,0,0,0,0,0,0,0,0,1,1,2,4
401411709,VCU Rams,N. Kern,4684145,,False,14.0,0,1,0,1,0,0,0,0,0,0,0,0,1,0,3,1,0
401411709,VCU Rams,M. Tsohonis,4592438,,False,2.0,0,0,0,0,0,0,0,0,0,0,0,0,0,0,0,0,0
401411709,VCU Rams,J. Banks,4432402,,False,7.0,0,2,0,1,0,1,0,0,0,0,0,1,0,0,1,0,0
401411709,VCU Rams,TEAM,TOTAL,TOTAL,False,,21,52,12,27,9,25,23,27,9,23,32,11,9,4,19,26,74
401411708,Vanderbilt Commodores,L. Robbins,4397347,,True,21.0,2,5,2,4,0,1,0,0,3,2,5,0,0,2,0,1,4
401411708,Vanderbilt Commodores,M. Stute,4433340,,True,32.0,2,6,0,1,2,5,0,0,0,5,5,0,0,0,0,4,6
401411708,Vanderbilt Commodores,J. Wright,4432920,,True,30.0,1,8,0,5,1,3,2,2,3,3,6,1,2,0,3,4,5
401411708,Vanderbilt Commodores,S. Pippen Jr.,4431785,,True,43.0,9,24,6,15,3,9,11,13,2,2,4,7,3,0,0,2,32
401411708,Vanderbilt Commodores,R. Chatman,4067250,,True,41.0,3,9,0,3,3,6,0,2,0,3,3,3,0,0,2,2,9
401411708,Vanderbilt Commodores,Q. Millora-Brown,4397691,,False,22.0,3,4,3,4,0,0,0,0,3,3,6,0,0,2,1,5,6
401411708,Vanderbilt Commodores,T. Lawrence,4702530,,False,13.0,2,4,1,2,1,2,0,0,0,1,1,0,0,0,0,0,5
401411708,Vanderbilt Commodores,S. Dezonie,4683732,,False,7.0,0,0,0,0,0,0,0,0,0,2,2,0,0,0,0,1,0
401411708,Vanderbilt Commodores,J. Mann,4589479,,False,16.0,1,2,1,2,0,0,1,3,0,3,3,1,1,0,1,1,3
401411708,Vanderbilt Commodores,TEAM,TOTAL,TOTAL,False,,23,62,13,36,10,26,14,20,11,26,37,12,6,4,9,20,70
401411708,Dayton Flyers,R.J. Blakney,4700864,,True,26.0,0,2,0,0,0,2,2,2,2,3,5,2,0,0,0,4,2
401411708,Dayton Flyers,T. Camara,4431736,,True,29.0,3,6,3,5,0,1,5,8,1,5,6,0,2,1,2,4,11
401411708,Dayton Flyers,D. Holmes II,4433607,,True,39.0,8,11,8,11,0,0,1,4,0,8,8,1,0,2,3,2,17
401411708,Dayton Flyers,K. Elvis,4683135,,True,41.0,8,21,6,14,2,7,2,2,1,2,3,5,0,0,5,2,20
401411708,Dayton Flyers,K. Brea,4591259,,True,45.0,3,9,1,5,2,4,0,0,0,4,4,1,0,0,2,1,8
401411708,Dayton Flyers,M. Sissoko,4431824,,False,6.0,4,4,4,4,0,0,0,0,0,0,0,0,0,0,0,1,8
401411708,Dayton Flyers,M. Amzil,4711607,,False,19.0,0,1,0,0,0,1,2,2,0,5,5,0,0,0,0,3,2
401411708,Dayton Flyers,K. Washington,4684293,,False,16.0,0,1,0,1,0,0,0,0,0,1,1,0,0,0,0,2,0
401411708,Dayton Flyers,C. Wilson,4403456,,False,4.0,0,1,0,0,0,1,0,0,0,0,0,0,0,0,0,0,0
401411708,Dayton Flyers,TEAM,TOTAL,TOTAL,False,,26,56,22,40,4,16,12,18,5,30,35,9,2,3,13,19,68
401411707,Toledo Rockets,J. Shumate,4703541,,True,33.0,0,11,0,4,0,7,0,0,2,5,7,4,1,2,1,3,0
401411707,Toledo Rockets,S. Millner Jr.,4703540,,True,37.0,8,14,7,11,1,3,1,1,3,4,7,1,3,0,0,0,18
401411707,Toledo Rockets,R. Moss,4703538,,True,36.0,3,9,2,6,1,3,1,2,3,4,7,2,0,1,4,2,8
401411707,Toledo Rockets,R. Rollins,4591725,,True,36.0,6,21,5,15,1,6,1,1,0,3,3,1,1,0,0,3,14
401411707,Toledo Rockets,R. Dennis,4431941,,True,34.0,6,11,5,8,1,3,0,0,1,1,2,4,1,0,1,2,13
401411707,Toledo Rockets,M. Carcoana,4898344,,False,7.0,0,1,0,0,0,1,0,0,0,3,3,0,0,1,0,1,0
401411707,Toledo Rockets,K. Jacobi,4898343,,False,3.0,0,0,0,0,0,0,0,0,1,0,1,0,0,0,0,0,0
401411707,Toledo Rockets,E. Wilson,4898341,,False,5.0,0,0,0,0,0,0,0,0,0,1,1,0,0,0,0,0,0
401411707,Toledo Rockets,E. Farmer,4683945,,False,4.0,0,1,0,1,0,0,0,0,0,0,0,0,0,0,0,0,0
401411707,Toledo Rockets,K. Saunders,4397880,,False,5.0,1,1,1,1,0,0,0,0,0,0,0,0,0,0,1,0,2
401411707,Toledo Rockets,TEAM,TOTAL,TOTAL,False,,24,69,20,46,4,23,3,4,12,22,34,12,6,4,7,11,55
401411707,Dayton Flyers,R.J. Blakney,4700864,,True,26.0,3,7,3,4,0,3,3,3,2,1,3,4,0,0,0,0,9
401411707,Dayton Flyers,T. Camara,4431736,,True,25.0,3,7,3,6,0,1,0,0,0,7,7,1,0,2,2,3,6
401411707,Dayton Flyers,D. Holmes II,4433607,,True,30.0,10,16,10,16,0,0,0,0,2,4,6,3,1,2,3,2,20
401411707,Dayton Flyers,K. Elvis,4683135,,True,35.0,5,11,4,7,1,4,0,0,1,6,7,8,1,0,1,0,11
401411707,Dayton Flyers,K. Brea,4591259,,True,33.0,5,11,2,5,3,6,0,0,0,10,10,2,1,0,1,1,13
401411707,Dayton Flyers,M. Sissoko,4431824,,False,10.0,4,5,4,5,0,0,0,0,2,0,2,0,0,0,0,0,8
401411707,Dayton Flyers,M. Amzil,4711607,,False,21.0,1,2,1,1,0,1,0,0,1,4,5,2,1,1,1,0,2
401411707,Dayton Flyers,K. Washington,4684293,,False,12.0,2,3,1,2,1,1,0,0,0,1,1,1,1,0,0,1,5
401411707,Dayton Flyers,Z. Nwokeji,4618121,,False,2.0,0,0,0,0,0,0,0,0,0,0,0,0,0,0,0,0,0
401411707,Dayton Flyers,C. Wilson,4403456,,False,5.0,0,0,0,0,0,0,0,0,0,1,1,0,0,0,0,1,0
401411707,Dayton Flyers,D. Swerlein,4600089,,False,1.0,0,1,0,0,0,1,0,0,0,0,0,0,0,0,0,0,0
401411707,Dayton Flyers,TEAM,TOTAL,TOTAL,False,,33,63,28,46,5,17,3,3,8,34,42,21,5,5,8,8,74
401411702,St. Bonaventure Bonnies,O. Osunniyi,4397224,,True,31.0,5,9,5,9,0,0,3,4,2,8,10,1,0,4,1,4,13
401411702,St. Bonaventure Bonnies,J. Adaway,4279431,,True,39.0,7,13,4,8,3,5,0,0,0,1,1,0,2,0,2,1,17
401411702,St. Bonaventure Bonnies,J. Holmes,4701016,,True,36.0,4,9,3,7,1,2,4,4,0,4,4,6,0,1,1,3,13
401411702,St. Bonaventure Bonnies,D. Welch,4397221,,True,40.0,4,9,0,1,4,8,0,0,0,8,8,1,2,1,2,3,12
401411702,St. Bonaventure Bonnies,K. Lofton,4397220,,True,40.0,6,12,4,7,2,5,1,1,0,1,1,8,1,0,2,3,15
401411702,St. Bonaventure Bonnies,A. Coulibaly,4432889,,False,9.0,2,2,2,2,0,0,0,0,0,0,0,0,0,0,0,0,4
401411702,St. Bonaventure Bonnies,J. Ndjock-Tadjore,4897048,,False,1.0,0,0,0,0,0,0,0,0,0,0,0,0,0,0,0,0,0
401411702,St. Bonaventure Bonnies,Q. Adams,4585591,,False,4.0,1,1,1,1,0,0,0,0,0,0,0,0,0,0,0,0,2
401411702,St. Bonaventure Bonnies,TEAM,TOTAL,TOTAL,False,,29,55,19,35,10,20,8,9,2,23,25,16,5,6,9,14,76
401411702,Colorado Buffaloes,T. da Silva,4702382,,True,30.0,5,10,5,5,0,5,3,3,0,5,5,4,0,0,2,2,13
401411702,Colorado Buffaloes,J. Walker,4432446,,True,30.0,2,10,2,7,0,3,2,2,4,4,8,3,0,0,0,2,6
401411702,Colorado Buffaloes,E. Battey,4278506,,True,33.0,5,9,4,5,1,4,3,3,2,3,5,0,1,0,2,2,14
401411702,Colorado Buffaloes,N. Clifford,4702384,,True,23.0,1,7,0,4,1,3,3,4,0,3,3,3,0,0,1,2,6
401411702,Colorado Buffaloes,J. Hammond III,4692907,,True,17.0,2,3,1,2,1,1,0,0,0,3,3,2,1,1,2,1,5
401411702,Colorado Buffaloes,L. O'Brien,4702380,,False,14.0,1,3,1,2,0,1,0,0,1,1,2,0,0,0,1,0,2
401411702,Colorado Buffaloes,KJ Simpson,4683834,,False,26.0,3,9,2,5,1,4,0,0,0,2,2,2,1,0,1,2,7
401411702,Colorado Buffaloes,K. Barthelemy,4581504,,False,27.0,6,7,3,3,3,4,0,0,0,1,1,2,0,1,0,0,15
401411702,Colorado Buffaloes,TEAM,TOTAL,TOTAL,False,,25,58,18,33,7,25,11,12,8,23,31,16,3,2,11,11,68
401408911,St. Bonaventure Bonnies,O. Osunniyi,4397224,,True,36.0,9,10,9,10,0,0,3,4,2,1,3,0,0,3,1,2,21
401408911,St. Bonaventure Bonnies,J. Adaway,4279431,,True,37.0,7,14,7,12,0,2,3,6,4,2,6,4,1,0,0,4,17
401408911,St. Bonaventure Bonnies,J. Holmes,4701016,,True,38.0,7,14,6,10,1,4,3,6,0,2,2,4,0,0,1,1,18
401408911,St. Bonaventure Bonnies,D. Welch,4397221,,True,40.0,8,16,5,6,3,10,0,0,1,5,6,2,4,0,0,3,19
401408911,St. Bonaventure Bonnies,K. Lofton,4397220,,True,38.0,2,6,2,4,0,2,0,0,0,1,1,8,1,0,2,1,4
401408911,St. Bonaventure Bonnies,A. Coulibaly,4432889,,False,4.0,0,2,0,2,0,0,0,0,0,0,0,0,0,0,0,0,0
401408911,St. Bonaventure Bonnies,Q. Adams,4585591,,False,7.0,2,3,2,3,0,0,0,0,2,0,2,1,0,0,1,2,4
401408911,St. Bonaventure Bonnies,TEAM,TOTAL,TOTAL,False,,35,65,31,47,4,18,9,16,10,14,24,19,6,3,5,13,83
401408911,St. Bonaventure Bonnies,O. Osunniyi,4397224,,True,36.0,9,10,9,10,0,0,3,4,2,1,3,0,0,3,1,2,21
401408911,St. Bonaventure Bonnies,J. Adaway,4279431,,True,37.0,7,14,7,12,0,2,3,6,4,2,6,4,1,0,0,4,17
401408911,St. Bonaventure Bonnies,J. Holmes,4701016,,True,38.0,7,14,6,10,1,4,3,6,0,2,2,4,0,0,1,1,18
401408911,St. Bonaventure Bonnies,D. Welch,4397221,,True,40.0,8,16,5,6,3,10,0,0,1,5,6,2,4,0,0,3,19
401408911,St. Bonaventure Bonnies,K. Lofton,4397220,,True,38.0,2,6,2,4,0,2,0,0,0,1,1,8,1,0,2,1,4
401408911,St. Bonaventure Bonnies,A. Coulibaly,4432889,,False,4.0,0,2,0,2,0,0,0,0,0,0,0,0,0,0,0,0,0
401408911,St. Bonaventure Bonnies,Q. Adams,4585591,,False,7.0,2,3,2,3,0,0,0,0,2,0,2,1,0,0,1,2,4
401408911,St. Bonaventure Bonnies,TEAM,TOTAL,TOTAL,False,,35,65,31,47,4,18,9,16,10,14,24,19,6,3,5,13,83
401408911,Saint Louis Billikens,F. Okoro,4397105,,True,28.0,5,8,5,8,0,0,4,4,2,5,7,0,0,0,3,2,14
401408911,Saint Louis Billikens,J. Nesbitt,4714246,,True,35.0,6,11,1,4,5,7,1,2,0,1,1,2,1,0,2,1,18
401408911,Saint Louis Billikens,Y. Collins,4432957,,True,25.0,2,2,2,2,0,0,0,0,0,0,0,10,0,0,6,5,4
401408911,Saint Louis Billikens,G. Jimerson,4432008,,True,38.0,6,9,4,4,2,5,3,3,0,3,3,2,0,0,1,2,17
401408911,Saint Louis Billikens,F. Thatch Jr.,4397199,,True,36.0,5,10,4,8,1,2,6,6,1,12,13,4,1,0,1,4,17
401408911,Saint Louis Billikens,T. Hargrove Jr.,4592484,,False,12.0,0,3,0,0,0,3,0,0,0,1,1,1,0,0,0,0,0
401408911,Saint Louis Billikens,M. Linssen,4279174,,False,13.0,1,1,1,1,0,0,2,2,0,1,1,1,0,0,2,2,4
401408911,Saint Louis Billikens,D. Jones,4278267,,False,13.0,2,4,1,2,1,2,0,0,0,2,2,0,1,0,2,3,5
401408911,Saint Louis Billikens,TEAM,TOTAL,TOTAL,False,,27,48,18,29,9,19,16,17,5,25,30,20,3,0,17,19,79
401408911,Saint Louis Billikens,F. Okoro,4397105,,True,28.0,5,8,5,8,0,0,4,4,2,5,7,0,0,0,3,2,14
401408911,Saint Louis Billikens,J. Nesbitt,4714246,,True,35.0,6,11,1,4,5,7,1,2,0,1,1,2,1,0,2,1,18
401408911,Saint Louis Billikens,Y. Collins,4432957,,True,25.0,2,2,2,2,0,0,0,0,0,0,0,10,0,0,6,5,4
401408911,Saint Louis Billikens,G. Jimerson,4432008,,True,38.0,6,9,4,4,2,5,3,3,0,3,3,2,0,0,1,2,17
401408911,Saint Louis Billikens,F. Thatch Jr.,4397199,,True,36.0,5,10,4,8,1,2,6,6,1,12,13,4,1,0,1,4,17
401408911,Saint Louis Billikens,T. Hargrove Jr.,4592484,,False,12.0,0,3,0,0,0,3,0,0,0,1,1,1,0,0,0,0,0
401408911,Saint Louis Billikens,M. Linssen,4279174,,False,13.0,1,1,1,1,0,0,2,2,0,1,1,1,0,0,2,2,4
401408911,Saint Louis Billikens,D. Jones,4278267,,False,13.0,2,4,1,2,1,2,0,0,0,2,2,0,1,0,2,3,5
401408911,Saint Louis Billikens,TEAM,TOTAL,TOTAL,False,,27,48,18,29,9,19,16,17,5,25,30,20,3,0,17,19,79
401408910,Richmond Spiders,T. Burton,4431914,,True,37.0,4,13,2,6,2,7,4,5,0,5,5,2,3,1,2,3,14
401408910,Richmond Spiders,N. Cayo,4278380,,True,18.0,1,3,1,3,0,0,0,0,1,4,5,1,1,1,0,4,2
401408910,Richmond Spiders,G. Golden,4066836,,True,26.0,5,9,5,8,0,1,1,2,0,5,5,2,0,1,1,1,11
401408910,Richmond Spiders,A. Gustavson,4397193,,True,34.0,3,8,2,3,1,5,0,1,0,1,1,1,4,0,2,1,7
401408910,Richmond Spiders,J. Gilyard,4278378,,True,38.0,8,14,1,2,7,12,0,0,0,2,2,3,2,0,0,2,23
401408910,Richmond Spiders,M. Grace,4397192,,False,25.0,1,5,0,0,1,5,0,0,3,1,4,3,0,1,1,0,3
401408910,Richmond Spiders,I. Wilson,4700973,,False,5.0,0,1,0,0,0,1,0,0,0,0,0,0,0,0,0,1,0
401408910,Richmond Spiders,C. Crabtree,4396658,,False,3.0,0,1,0,1,0,0,2,2,0,0,0,0,0,0,0,0,2
401408910,Richmond Spiders,N. Sherod,4066832,,False,14.0,0,2,0,0,0,2,0,0,0,2,2,0,1,0,0,2,0
401408910,Richmond Spiders,TEAM,TOTAL,TOTAL,False,,22,56,11,23,11,33,7,10,4,20,24,12,11,4,7,14,62
401408910,Richmond Spiders,T. Burton,4431914,,True,37.0,4,13,2,6,2,7,4,5,0,5,5,2,3,1,2,3,14
401408910,Richmond Spiders,N. Cayo,4278380,,True,18.0,1,3,1,3,0,0,0,0,1,4,5,1,1,1,0,4,2
401408910,Richmond Spiders,G. Golden,4066836,,True,26.0,5,9,5,8,0,1,1,2,0,5,5,2,0,1,1,1,11
401408910,Richmond Spiders,A. Gustavson,4397193,,True,34.0,3,8,2,3,1,5,0,1,0,1,1,1,4,0,2,1,7
401408910,Richmond Spiders,J. Gilyard,4278378,,True,38.0,8,14,1,2,7,12,0,0,0,2,2,3,2,0,0,2,23
401408910,Richmond Spiders,M. Grace,4397192,,False,25.0,1,5,0,0,1,5,0,0,3,1,4,3,0,1,1,0,3
401408910,Richmond Spiders,I. Wilson,4700973,,False,5.0,0,1,0,0,0,1,0,0,0,0,0,0,0,0,0,1,0
401408910,Richmond Spiders,C. Crabtree,4396658,,False,3.0,0,1,0,1,0,0,2,2,0,0,0,0,0,0,0,0,2
401408910,Richmond Spiders,N. Sherod,4066832,,False,14.0,0,2,0,0,0,2,0,0,0,2,2,0,1,0,0,2,0
401408910,Richmond Spiders,TEAM,TOTAL,TOTAL,False,,22,56,11,23,11,33,7,10,4,20,24,12,11,4,7,14,62
401408910,George Mason Patriots,M. Henry,4606836,,True,18.0,2,6,2,6,0,0,0,2,4,3,7,0,0,0,0,0,4
401408910,George Mason Patriots,X. Johnson,4592439,,True,38.0,4,8,3,5,1,3,4,4,1,9,10,2,0,0,6,2,13
401408910,George Mason Patriots,D. Gaines,4431961,,True,37.0,4,11,4,9,0,2,9,9,1,8,9,4,1,0,3,1,17
401408910,George Mason Patriots,D. Cooper,4279876,,True,36.0,3,8,2,4,1,4,0,0,0,5,5,0,0,0,2,2,7
401408910,George Mason Patriots,D. Schwartz,4278501,,True,26.0,4,11,2,7,2,4,1,1,1,3,4,1,1,1,3,5,11
401408910,George Mason Patriots,B. Jones,4897083,,False,18.0,1,3,0,1,1,2,0,0,2,1,3,1,0,1,0,2,3
401408910,George Mason Patriots,O. Frazier III,4700882,,False,7.0,2,2,2,2,0,0,0,0,0,0,0,0,0,0,1,2,4
401408910,George Mason Patriots,B. Buchanan,4395691,,False,17.0,0,1,0,0,0,1,0,0,0,1,1,0,0,0,0,0,0
401408910,George Mason Patriots,J. Hartwell II,4396817,,False,3.0,0,0,0,0,0,0,0,0,0,1,1,0,0,0,0,0,0
401408910,George Mason Patriots,TEAM,TOTAL,TOTAL,False,,20,50,15,34,5,16,14,16,10,31,41,8,2,2,16,14,59
401408910,George Mason Patriots,M. Henry,4606836,,True,18.0,2,6,2,6,0,0,0,2,4,3,7,0,0,0,0,0,4
401408910,George Mason Patriots,X. Johnson,4592439,,True,38.0,4,8,3,5,1,3,4,4,1,9,10,2,0,0,6,2,13
401408910,George Mason Patriots,D. Gaines,4431961,,True,37.0,4,11,4,9,0,2,9,9,1,8,9,4,1,0,3,1,17
401408910,George Mason Patriots,D. Cooper,4279876,,True,36.0,3,8,2,4,1,4,0,0,0,5,5,0,0,0,2,2,7
401408910,George Mason Patriots,D. Schwartz,4278501,,True,26.0,4,11,2,7,2,4,1,1,1,3,4,1,1,1,3,5,11
401408910,George Mason Patriots,B. Jones,4897083,,False,18.0,1,3,0,1,1,2,0,0,2,1,3,1,0,1,0,2,3
401408910,George Mason Patriots,O. Frazier III,4700882,,False,7.0,2,2,2,2,0,0,0,0,0,0,0,0,0,0,1,2,4
401408910,George Mason Patriots,B. Buchanan,4395691,,False,17.0,0,1,0,0,0,1,0,0,0,1,1,0,0,0,0,0,0
401408910,George Mason Patriots,J. Hartwell II,4396817,,False,3.0,0,0,0,0,0,0,0,0,0,1,1,0,0,0,0,0,0
401408910,George Mason Patriots,TEAM,TOTAL,TOTAL,False,,20,50,15,34,5,16,14,16,10,31,41,8,2,2,16,14,59
401408607,Richmond Spiders,T. Burton,4431914,,True,34.0,1,8,0,3,1,5,2,6,1,5,6,0,2,1,1,2,5
401408607,Richmond Spiders,N. Cayo,4278380,,True,32.0,9,11,9,11,0,0,0,4,2,3,5,1,0,1,2,4,18
401408607,Richmond Spiders,G. Golden,4066836,,True,27.0,4,8,4,7,0,1,2,3,0,5,5,5,0,1,1,1,10
401408607,Richmond Spiders,A. Gustavson,4397193,,True,30.0,2,3,2,2,0,1,1,2,1,1,2,0,0,0,0,0,5
401408607,Richmond Spiders,J. Gilyard,4278378,,True,39.0,2,10,2,3,0,7,0,0,0,3,3,3,0,1,0,3,4
401408607,Richmond Spiders,M. Grace,4397192,,False,15.0,1,6,1,2,0,4,2,2,1,0,1,0,0,0,0,1,4
401408607,Richmond Spiders,S. Koureissi,4397190,,False,1.0,0,0,0,0,0,0,0,2,0,0,0,0,0,0,0,0,0
401408607,Richmond Spiders,S. Kulju,4278383,,False,0.0,0,0,0,0,0,0,0,0,0,0,0,0,0,0,0,0,0
401408607,Richmond Spiders,M. Randolph,4710356,,False,1.0,0,1,0,0,0,1,0,0,0,0,0,0,0,0,0,0,0
401408607,Richmond Spiders,D. Bailey,4700974,,False,1.0,0,0,0,0,0,0,0,0,0,0,0,0,0,0,1,0,0
401408607,Richmond Spiders,I. Wilson,4700973,,False,7.0,0,0,0,0,0,0,0,0,0,0,0,0,0,0,0,1,0
401408607,Richmond Spiders,C. Crabtree,4396658,,False,4.0,0,0,0,0,0,0,0,0,0,0,0,0,0,0,0,1,0
401408607,Richmond Spiders,J. Gaitley,4278384,,False,0.0,0,0,0,0,0,0,0,0,0,0,0,0,0,0,0,0,0
401408607,Richmond Spiders,N. Sherod,4066832,,False,9.0,2,6,2,3,0,3,1,2,0,2,2,0,0,0,1,0,5
401408607,Richmond Spiders,TEAM,TOTAL,TOTAL,False,,21,53,20,31,1,22,8,21,8,19,27,9,2,4,6,13,51
401408607,Providence Friars,N. Horchler,4278453,,True,32.0,6,10,2,4,4,6,0,0,1,13,14,1,1,1,0,4,16
401408607,Providence Friars,J. Minaya,4278111,,True,34.0,3,4,1,1,2,3,1,2,1,2,3,2,0,0,0,4,9
401408607,Providence Friars,N. Watson,4278573,,True,19.0,5,9,5,9,0,0,0,0,1,3,4,1,0,0,1,4,10
401408607,Providence Friars,A.J. Reeves,4397109,,True,24.0,3,10,1,4,2,6,4,4,0,2,2,5,0,0,1,0,12
401408607,Providence Friars,Al Durham,4277942,,True,24.0,5,7,2,3,3,4,0,0,0,4,4,3,1,0,2,1,13
401408607,Providence Friars,K. O'Haire,4897416,,False,0.0,0,0,0,0,0,0,0,0,0,0,0,0,0,0,0,0,0
401408607,Providence Friars,Ed Croswell,4397153,,False,23.0,3,5,3,5,0,0,0,0,2,3,5,0,1,2,1,1,6
401408607,Providence Friars,L. Fonts,4897415,,False,0.0,0,0,0,0,0,0,0,0,0,0,0,0,0,0,0,0,0
401408607,Providence Friars,M. Case,4702958,,False,1.0,0,0,0,0,0,0,0,0,0,1,1,0,0,0,1,0,0
401408607,Providence Friars,A. Breed,4585590,,False,13.0,1,2,1,1,0,1,1,2,0,0,0,0,1,0,0,0,3
401408607,Providence Friars,B. Goodine,4431716,,False,1.0,0,0,0,0,0,0,0,0,0,0,0,0,0,0,0,0,0
401408607,Providence Friars,J. Bynum,4397194,,False,28.0,2,7,1,5,1,2,5,6,0,2,2,6,0,0,0,1,10
401408607,Providence Friars,A. Fonts,4278575,,False,1.0,0,0,0,0,0,0,0,0,0,0,0,0,0,0,0,0,0
401408607,Providence Friars,TEAM,TOTAL,TOTAL,False,,28,54,16,32,12,22,11,14,8,30,38,18,4,3,10,15,79
401408593,Michigan State Spartans,M. Bingham Jr.,4397212,,True,17.0,3,6,3,5,0,1,0,0,3,5,8,0,2,2,1,3,6
401408593,Michigan State Spartans,G. Brown,4397210,,True,31.0,4,10,1,2,3,8,1,2,0,1,1,3,0,0,1,0,12
401408593,Michigan State Spartans,J. Hauser,4295180,,True,34.0,9,12,5,6,4,6,5,6,2,6,8,2,1,0,0,3,27
401408593,Michigan State Spartans,M. Christie,4432582,,True,27.0,1,6,1,2,0,4,0,0,1,1,2,1,1,1,0,0,2
401408593,Michigan State Spartans,A. Hoggard,4432206,,True,22.0,6,9,6,7,0,2,2,4,0,3,3,2,0,0,2,1,14
401408593,Michigan State Spartans,M. Hall,4592693,,False,17.0,1,5,1,3,0,2,0,0,2,3,5,1,0,0,3,2,2
401408593,Michigan State Spartans,J. Marble II,4433031,,False,11.0,2,3,2,3,0,0,1,1,0,1,1,1,0,1,0,3,5
401408593,Michigan State Spartans,P. Brooks,4683731,,False,3.0,0,1,0,1,0,0,0,0,1,1,2,0,0,0,0,0,0
401408593,Michigan State Spartans,J. Akins,4683730,,False,13.0,0,2,0,1,0,1,0,0,0,1,1,0,0,0,0,0,0
401408593,Michigan State Spartans,T. Walker,4432129,,False,25.0,2,5,2,3,0,2,2,2,0,2,2,3,0,0,0,2,6
401408593,Michigan State Spartans,TEAM,TOTAL,TOTAL,False,,28,59,21,33,7,26,11,15,10,25,35,13,4,4,7,14,74
401408593,Davidson Wildcats,S. Mennenga,4700862,,True,30.0,6,12,3,7,3,5,0,2,0,5,5,1,0,1,0,1,15
401408593,Davidson Wildcats,L. Brajkovic,4396787,,True,22.0,8,10,7,8,1,2,1,3,1,3,4,2,0,0,0,4,18
401408593,Davidson Wildcats,H. Lee,4592308,,True,35.0,4,11,1,4,3,7,0,0,1,3,4,1,0,0,2,4,11
401408593,Davidson Wildcats,F. Loyer,4397208,,True,28.0,3,9,2,4,1,5,5,5,1,5,6,4,0,0,1,3,12
401408593,Davidson Wildcats,M. Jones,4396784,,True,36.0,3,6,2,2,1,4,1,2,1,5,6,3,1,0,2,2,8
401408593,Davidson Wildcats,N. Boachie-Yiadom,4396786,,False,18.0,1,3,1,3,0,0,0,0,1,0,1,0,0,1,1,1,2
401408593,Davidson Wildcats,D. Watson,4897098,,False,9.0,1,2,0,1,1,1,0,0,0,0,0,0,0,0,0,0,3
401408593,Davidson Wildcats,G. Huffman,4432522,,False,22.0,2,6,2,5,0,1,0,0,1,2,3,3,2,1,1,3,4
401408593,Davidson Wildcats,TEAM,TOTAL,TOTAL,False,,28,59,18,34,10,25,7,12,8,24,32,14,3,3,8,18,73
401408577,Richmond Spiders,T. Burton,4431914,,True,40.0,4,11,3,6,1,5,9,10,2,9,11,1,3,0,5,1,18
401408577,Richmond Spiders,N. Cayo,4278380,,True,31.0,7,11,7,11,0,0,1,2,1,1,2,1,0,1,0,4,15
401408577,Richmond Spiders,G. Golden,4066836,,True,25.0,2,11,2,10,0,1,0,0,1,4,5,5,0,1,2,0,4
401408577,Richmond Spiders,A. Gustavson,4397193,,True,20.0,1,4,1,2,0,2,0,0,2,3,5,1,0,0,0,3,2
401408577,Richmond Spiders,J. Gilyard,4278378,,True,40.0,8,15,4,8,4,7,4,4,0,6,6,6,0,0,3,2,24
401408577,Richmond Spiders,M. Grace,4397192,,False,21.0,2,2,2,2,0,0,0,0,0,1,1,0,1,1,1,1,4
401408577,Richmond Spiders,I. Wilson,4700973,,False,0.0,0,0,0,0,0,0,0,0,0,0,0,0,0,0,0,0,0
401408577,Richmond Spiders,C. Crabtree,4396658,,False,13.0,0,1,0,0,0,1,0,0,0,1,1,0,0,0,0,3,0
401408577,Richmond Spiders,N. Sherod,4066832,,False,10.0,0,2,0,1,0,1,0,0,0,0,0,0,0,0,0,0,0
401408577,Richmond Spiders,TEAM,TOTAL,TOTAL,False,,24,57,19,40,5,17,14,16,8,28,36,14,4,3,12,14,67
401408577,Iowa Hawkeyes,Ke. Murray,4594327,,True,38.0,8,15,8,12,0,3,5,5,2,7,9,2,1,1,2,3,21
401408577,Iowa Hawkeyes,P. McCaffery,4432836,,True,25.0,7,17,3,10,4,7,0,0,1,1,2,1,0,0,0,1,18
401408577,Iowa Hawkeyes,F. Rebraca,4398190,,True,25.0,2,5,2,5,0,0,1,2,2,7,9,1,1,2,0,3,5
401408577,Iowa Hawkeyes,T. Perkins,4433130,,True,19.0,2,5,2,3,0,2,2,3,0,1,1,1,0,0,3,5,6
401408577,Iowa Hawkeyes,J. Bohannon,4066366,,True,33.0,2,8,0,1,2,7,0,0,0,2,2,3,1,0,1,1,6
401408577,Iowa Hawkeyes,Kr. Murray,4594326,,False,16.0,1,6,1,1,0,5,1,2,1,4,5,2,2,0,0,2,3
401408577,Iowa Hawkeyes,P. Sandfort,4697270,,False,8.0,1,5,1,2,0,3,0,0,2,1,3,0,0,0,0,1,2
401408577,Iowa Hawkeyes,J. Toussaint,4432880,,False,13.0,1,3,1,3,0,0,0,0,1,0,1,1,0,0,1,2,2
401408577,Iowa Hawkeyes,A. Ulis,4432454,,False,0.0,0,0,0,0,0,0,0,0,0,0,0,0,0,0,0,0,0
401408577,Iowa Hawkeyes,C. McCaffery,4277950,,False,23.0,0,2,0,0,0,2,0,0,1,2,3,3,0,0,2,0,0
401408577,Iowa Hawkeyes,TEAM,TOTAL,TOTAL,False,,24,66,18,37,6,29,9,12,14,26,40,14,5,3,11,18,63
401408135,George Washington Revolutionaries,H. Dean,4593273,,True,23.0,2,2,2,2,0,0,2,2,0,8,8,2,0,0,3,2,6
401408135,George Washington Revolutionaries,Q. Samuels,4592251,,True,18.0,0,1,0,1,0,0,0,0,0,2,2,2,0,0,0,2,0
401408135,George Washington Revolutionaries,B. Freeman,4613126,,True,28.0,4,8,4,7,0,1,2,2,0,4,4,3,1,0,4,0,10
401408135,George Washington Revolutionaries,J. Bamisile,4432537,,True,30.0,9,13,6,6,3,7,0,0,0,2,2,3,1,1,2,1,21
401408135,George Washington Revolutionaries,J. Bishop,4431770,,True,28.0,4,13,3,8,1,5,0,0,0,0,0,1,0,0,1,2,9
401408135,George Washington Revolutionaries,D. Nixon,4897075,,False,1.0,0,1,0,1,0,0,0,0,0,0,0,0,0,0,0,0,0
401408135,George Washington Revolutionaries,T. Warner,4897074,,False,3.0,0,0,0,0,0,0,0,0,0,1,1,1,0,0,0,1,0
401408135,George Washington Revolutionaries,M. Gally,4592445,,False,3.0,0,0,0,0,0,0,0,0,0,1,1,0,0,1,0,0,0
401408135,George Washington Revolutionaries,R. Lindo Jr.,4397186,,False,21.0,4,7,1,3,3,4,0,0,1,11,12,0,1,3,0,3,11
401408135,George Washington Revolutionaries,N. Brown,4700963,,False,11.0,1,4,1,4,0,0,0,1,3,3,6,0,0,0,0,2,2
401408135,George Washington Revolutionaries,T. Stamoulis,4897076,,False,1.0,1,2,1,1,0,1,0,0,0,1,1,0,0,0,0,0,2
401408135,George Washington Revolutionaries,A. Harris,4397216,,False,5.0,0,0,0,0,0,0,0,0,0,1,1,0,0,0,2,0,0
401408135,George Washington Revolutionaries,B. Adams,4396612,,False,24.0,4,7,3,3,1,4,3,4,0,1,1,3,2,0,1,1,12
401408135,George Washington Revolutionaries,B. Knapp,4279473,,False,4.0,0,1,0,1,0,0,0,0,0,1,1,0,0,0,1,0,0
401408135,George Washington Revolutionaries,TEAM,TOTAL,TOTAL,False,,29,59,21,37,8,22,7,9,6,36,42,15,5,5,15,14,73
401408135,George Washington Revolutionaries,H. Dean,4593273,,True,23.0,2,2,2,2,0,0,2,2,0,8,8,2,0,0,3,2,6
401408135,George Washington Revolutionaries,Q. Samuels,4592251,,True,18.0,0,1,0,1,0,0,0,0,0,2,2,2,0,0,0,2,0
401408135,George Washington Revolutionaries,B. Freeman,4613126,,True,28.0,4,8,4,7,0,1,2,2,0,4,4,3,1,0,4,0,10
401408135,George Washington Revolutionaries,J. Bamisile,4432537,,True,30.0,9,13,6,6,3,7,0,0,0,2,2,3,1,1,2,1,21
401408135,George Washington Revolutionaries,J. Bishop,4431770,,True,28.0,4,13,3,8,1,5,0,0,0,0,0,1,0,0,1,2,9
401408135,George Washington Revolutionaries,D. Nixon,4897075,,False,1.0,0,1,0,1,0,0,0,0,0,0,0,0,0,0,0,0,0
401408135,George Washington Revolutionaries,T. Warner,4897074,,False,3.0,0,0,0,0,0,0,0,0,0,1,1,1,0,0,0,1,0
401408135,George Washington Revolutionaries,M. Gally,4592445,,False,3.0,0,0,0,0,0,0,0,0,0,1,1,0,0,1,0,0,0
401408135,George Washington Revolutionaries,R. Lindo Jr.,4397186,,False,21.0,4,7,1,3,3,4,0,0,1,11,12,0,1,3,0,3,11
401408135,George Washington Revolutionaries,N. Brown,4700963,,False,11.0,1,4,1,4,0,0,0,1,3,3,6,0,0,0,0,2,2
401408135,George Washington Revolutionaries,T. Stamoulis,4897076,,False,1.0,1,2,1,1,0,1,0,0,0,1,1,0,0,0,0,0,2
401408135,George Washington Revolutionaries,A. Harris,4397216,,False,5.0,0,0,0,0,0,0,0,0,0,1,1,0,0,0,2,0,0
401408135,George Washington Revolutionaries,B. Adams,4396612,,False,24.0,4,7,3,3,1,4,3,4,0,1,1,3,2,0,1,1,12
401408135,George Washington Revolutionaries,B. Knapp,4279473,,False,4.0,0,1,0,1,0,0,0,0,0,1,1,0,0,0,1,0,0
401408135,George Washington Revolutionaries,TEAM,TOTAL,TOTAL,False,,29,59,21,37,8,22,7,9,6,36,42,15,5,5,15,14,73
401408135,Duquesne Dukes,T. Williams,4432147,,True,32.0,8,17,8,16,0,1,2,2,4,2,6,0,0,0,2,1,18
401408135,Duquesne Dukes,K. Easley,4398159,,True,26.0,0,12,0,5,0,7,0,0,4,7,11,1,3,0,0,0,0
401408135,Duquesne Dukes,A. Spears,4897090,,True,32.0,6,17,5,15,1,2,2,2,1,3,4,2,1,0,4,0,15
401408135,Duquesne Dukes,J. Johnson III,4897088,,True,19.0,2,7,2,3,0,4,0,0,0,1,1,1,0,0,1,0,4
401408135,Duquesne Dukes,M. Bekelja,4700874,,True,11.0,0,1,0,0,0,1,0,0,1,0,1,0,1,0,1,0,0
401408135,Duquesne Dukes,M. Hima,4700878,,False,17.0,1,5,1,5,0,0,2,2,3,3,6,0,0,3,1,3,4
401408135,Duquesne Dukes,D. Larson,4897091,,False,6.0,0,2,0,1,0,1,0,0,2,0,2,1,1,0,0,0,0
401408135,Duquesne Dukes,L. Ayers III,4703813,,False,21.0,1,4,1,3,0,1,0,1,2,2,4,1,0,0,0,2,2
401408135,Duquesne Dukes,T. Okani,4700873,,False,14.0,1,5,1,4,0,1,0,0,1,3,4,0,0,1,0,1,2
401408135,Duquesne Dukes,T. Acuff,4606831,,False,21.0,2,4,2,3,0,1,3,4,0,3,3,1,0,0,0,2,7
401408135,Duquesne Dukes,N. Buono,4279744,,False,1.0,0,2,0,0,0,2,0,0,0,0,0,0,0,0,0,0,0
401408135,Duquesne Dukes,TEAM,TOTAL,TOTAL,False,,21,76,20,55,1,21,9,11,21,25,46,7,6,4,10,9,52
401408135,Duquesne Dukes,T. Williams,4432147,,True,32.0,8,17,8,16,0,1,2,2,4,2,6,0,0,0,2,1,18
401408135,Duquesne Dukes,K. Easley,4398159,,True,26.0,0,12,0,5,0,7,0,0,4,7,11,1,3,0,0,0,0
401408135,Duquesne Dukes,A. Spears,4897090,,True,32.0,6,17,5,15,1,2,2,2,1,3,4,2,1,0,4,0,15
401408135,Duquesne Dukes,J. Johnson III,4897088,,True,19.0,2,7,2,3,0,4,0,0,0,1,1,1,0,0,1,0,4
401408135,Duquesne Dukes,M. Bekelja,4700874,,True,11.0,0,1,0,0,0,1,0,0,1,0,1,0,1,0,1,0,0
401408135,Duquesne Dukes,M. Hima,4700878,,False,17.0,1,5,1,5,0,0,2,2,3,3,6,0,0,3,1,3,4
401408135,Duquesne Dukes,D. Larson,4897091,,False,6.0,0,2,0,1,0,1,0,0,2,0,2,1,1,0,0,0,0
401408135,Duquesne Dukes,L. Ayers III,4703813,,False,21.0,1,4,1,3,0,1,0,1,2,2,4,1,0,0,0,2,2
401408135,Duquesne Dukes,T. Okani,4700873,,False,14.0,1,5,1,4,0,1,0,0,1,3,4,0,0,1,0,1,2
401408135,Duquesne Dukes,T. Acuff,4606831,,False,21.0,2,4,2,3,0,1,3,4,0,3,3,1,0,0,0,2,7
401408135,Duquesne Dukes,N. Buono,4279744,,False,1.0,0,2,0,0,0,2,0,0,0,0,0,0,0,0,0,0,0
401408135,Duquesne Dukes,TEAM,TOTAL,TOTAL,False,,21,76,20,55,1,21,9,11,21,25,46,7,6,4,10,9,52
401408133,Duquesne Dukes,T. Williams,4432147,,True,35.0,3,11,3,10,0,1,0,0,1,3,4,3,1,2,0,0,6
401408133,Duquesne Dukes,K. Easley,4398159,,True,36.0,5,11,3,7,2,4,0,0,2,5,7,0,0,0,1,1,12
401408133,Duquesne Dukes,D. Larson,4897091,,True,12.0,0,0,0,0,0,0,0,0,0,1,1,0,0,0,0,0,0
401408133,Duquesne Dukes,J. Johnson III,4897088,,True,21.0,5,11,4,6,1,5,3,3,0,5,5,1,2,0,0,4,14
401408133,Duquesne Dukes,T. Acuff,4606831,,True,15.0,0,0,0,0,0,0,1,3,0,2,2,0,1,0,2,1,1
401408133,Duquesne Dukes,M. Hima,4700878,,False,7.0,1,2,1,2,0,0,0,0,0,2,2,0,0,0,0,1,2
401408133,Duquesne Dukes,A. Spears,4897090,,False,32.0,8,17,6,9,2,8,2,4,1,4,5,2,1,0,1,4,20
401408133,Duquesne Dukes,L. Ayers III,4703813,,False,23.0,1,3,1,1,0,2,2,2,1,1,2,1,0,0,3,3,4
401408133,Duquesne Dukes,M. Bekelja,4700874,,False,4.0,0,0,0,0,0,0,0,0,0,0,0,0,0,0,0,0,0
401408133,Duquesne Dukes,T. Okani,4700873,,False,15.0,1,3,1,3,0,0,0,0,1,3,4,0,1,0,2,3,2
401408133,Duquesne Dukes,TEAM,TOTAL,TOTAL,False,,24,58,19,38,5,20,8,12,6,27,33,7,6,2,9,17,61
401408133,Duquesne Dukes,T. Williams,4432147,,True,35.0,3,11,3,10,0,1,0,0,1,3,4,3,1,2,0,0,6
401408133,Duquesne Dukes,K. Easley,4398159,,True,36.0,5,11,3,7,2,4,0,0,2,5,7,0,0,0,1,1,12
401408133,Duquesne Dukes,D. Larson,4897091,,True,12.0,0,0,0,0,0,0,0,0,0,1,1,0,0,0,0,0,0
401408133,Duquesne Dukes,J. Johnson III,4897088,,True,21.0,5,11,4,6,1,5,3,3,0,5,5,1,2,0,0,4,14
401408133,Duquesne Dukes,T. Acuff,4606831,,True,15.0,0,0,0,0,0,0,1,3,0,2,2,0,1,0,2,1,1
401408133,Duquesne Dukes,M. Hima,4700878,,False,7.0,1,2,1,2,0,0,0,0,0,2,2,0,0,0,0,1,2
401408133,Duquesne Dukes,A. Spears,4897090,,False,32.0,8,17,6,9,2,8,2,4,1,4,5,2,1,0,1,4,20
401408133,Duquesne Dukes,L. Ayers III,4703813,,False,23.0,1,3,1,1,0,2,2,2,1,1,2,1,0,0,3,3,4
401408133,Duquesne Dukes,M. Bekelja,4700874,,False,4.0,0,0,0,0,0,0,0,0,0,0,0,0,0,0,0,0,0
401408133,Duquesne Dukes,T. Okani,4700873,,False,15.0,1,3,1,3,0,0,0,0,1,3,4,0,1,0,2,3,2
401408133,Duquesne Dukes,TEAM,TOTAL,TOTAL,False,,24,58,19,38,5,20,8,12,6,27,33,7,6,2,9,17,61
401408133,Davidson Wildcats,S. Mennenga,4700862,,True,29.0,3,6,3,6,0,0,1,2,2,5,7,2,0,0,1,0,7
401408133,Davidson Wildcats,L. Brajkovic,4396787,,True,31.0,3,6,2,4,1,2,2,4,1,10,11,3,0,0,1,2,9
401408133,Davidson Wildcats,H. Lee,4592308,,True,36.0,8,15,5,7,3,8,1,1,0,6,6,1,2,1,2,2,20
401408133,Davidson Wildcats,F. Loyer,4397208,,True,30.0,6,10,4,4,2,6,10,11,0,2,2,4,0,0,3,2,24
401408133,Davidson Wildcats,M. Jones,4396784,,True,35.0,4,12,2,4,2,8,0,0,0,4,4,3,0,0,1,0,10
401408133,Davidson Wildcats,D. Kristensen,4432020,,False,2.0,0,0,0,0,0,0,0,0,0,0,0,0,0,1,0,1,0
401408133,Davidson Wildcats,N. Boachie-Yiadom,4396786,,False,11.0,0,1,0,1,0,0,0,0,0,1,1,1,0,0,0,1,0
401408133,Davidson Wildcats,D. Watson,4897098,,False,9.0,1,1,1,1,0,0,0,0,0,0,0,2,0,0,0,1,2
401408133,Davidson Wildcats,G. Huffman,4432522,,False,17.0,0,3,0,2,0,1,0,0,0,0,0,1,1,0,0,3,0
401408133,Davidson Wildcats,TEAM,TOTAL,TOTAL,False,,25,54,17,29,8,25,14,18,4,28,32,17,3,2,9,12,72
401408133,Davidson Wildcats,S. Mennenga,4700862,,True,29.0,3,6,3,6,0,0,1,2,2,5,7,2,0,0,1,0,7
401408133,Davidson Wildcats,L. Brajkovic,4396787,,True,31.0,3,6,2,4,1,2,2,4,1,10,11,3,0,0,1,2,9
401408133,Davidson Wildcats,H. Lee,4592308,,True,36.0,8,15,5,7,3,8,1,1,0,6,6,1,2,1,2,2,20
401408133,Davidson Wildcats,F. Loyer,4397208,,True,30.0,6,10,4,4,2,6,10,11,0,2,2,4,0,0,3,2,24
401408133,Davidson Wildcats,M. Jones,4396784,,True,35.0,4,12,2,4,2,8,0,0,0,4,4,3,0,0,1,0,10
401408133,Davidson Wildcats,D. Kristensen,4432020,,False,2.0,0,0,0,0,0,0,0,0,0,0,0,0,0,1,0,1,0
401408133,Davidson Wildcats,N. Boachie-Yiadom,4396786,,False,11.0,0,1,0,1,0,0,0,0,0,1,1,1,0,0,0,1,0
401408133,Davidson Wildcats,D. Watson,4897098,,False,9.0,1,1,1,1,0,0,0,0,0,0,0,2,0,0,0,1,2
401408133,Davidson Wildcats,G. Huffman,4432522,,False,17.0,0,3,0,2,0,1,0,0,0,0,0,1,1,0,0,3,0
401408133,Davidson Wildcats,TEAM,TOTAL,TOTAL,False,,25,54,17,29,8,25,14,18,4,28,32,17,3,2,9,12,72
401406714,Massachusetts Minutemen,M. Steadman,4397393,,True,14.0,6,13,5,10,1,3,0,0,0,3,3,0,0,0,1,3,13
401406714,Massachusetts Minutemen,T. Buttrick,4277981,,True,24.0,1,2,1,1,0,1,0,0,1,6,7,1,2,1,0,3,2
401406714,Massachusetts Minutemen,T.J. Weeks,4433108,,True,25.0,3,6,3,4,0,2,3,3,3,3,6,1,1,1,2,1,9
401406714,Massachusetts Minutemen,N. Fernandes,4431791,,True,26.0,5,10,4,7,1,3,2,2,1,1,2,4,0,0,3,3,13
401406714,Massachusetts Minutemen,R. Kelly,4279741,,True,25.0,5,6,5,5,0,1,2,2,0,0,0,2,1,0,3,1,12
401406714,Massachusetts Minutemen,D. Dominguez,4701126,,False,18.0,3,12,1,4,2,8,0,0,1,3,4,1,0,0,0,1,8
401406714,Massachusetts Minutemen,G. Jones,4279211,,False,15.0,1,1,0,0,1,1,0,0,2,2,4,0,0,0,1,1,3
401406714,Massachusetts Minutemen,J. Garcia,4701125,,False,27.0,3,9,3,5,0,4,0,0,2,1,3,1,0,1,0,3,6
401406714,Massachusetts Minutemen,P. Santos,4432104,,False,3.0,0,3,0,0,0,3,0,0,0,0,0,0,0,0,1,1,0
401406714,Massachusetts Minutemen,C.J. Kelly,4398208,,False,23.0,2,5,1,2,1,3,2,2,0,1,1,1,0,0,3,0,7
401406714,Massachusetts Minutemen,TEAM,TOTAL,TOTAL,False,,29,67,23,38,6,29,9,9,15,22,37,11,4,3,14,17,73
401406714,Massachusetts Minutemen,M. Steadman,4397393,,True,14.0,6,13,5,10,1,3,0,0,0,3,3,0,0,0,1,3,13
401406714,Massachusetts Minutemen,T. Buttrick,4277981,,True,24.0,1,2,1,1,0,1,0,0,1,6,7,1,2,1,0,3,2
401406714,Massachusetts Minutemen,T.J. Weeks,4433108,,True,25.0,3,6,3,4,0,2,3,3,3,3,6,1,1,1,2,1,9
401406714,Massachusetts Minutemen,N. Fernandes,4431791,,True,26.0,5,10,4,7,1,3,2,2,1,1,2,4,0,0,3,3,13
401406714,Massachusetts Minutemen,R. Kelly,4279741,,True,25.0,5,6,5,5,0,1,2,2,0,0,0,2,1,0,3,1,12
401406714,Massachusetts Minutemen,D. Dominguez,4701126,,False,18.0,3,12,1,4,2,8,0,0,1,3,4,1,0,0,0,1,8
401406714,Massachusetts Minutemen,G. Jones,4279211,,False,15.0,1,1,0,0,1,1,0,0,2,2,4,0,0,0,1,1,3
401406714,Massachusetts Minutemen,J. Garcia,4701125,,False,27.0,3,9,3,5,0,4,0,0,2,1,3,1,0,1,0,3,6
401406714,Massachusetts Minutemen,P. Santos,4432104,,False,3.0,0,3,0,0,0,3,0,0,0,0,0,0,0,0,1,1,0
401406714,Massachusetts Minutemen,C.J. Kelly,4398208,,False,23.0,2,5,1,2,1,3,2,2,0,1,1,1,0,0,3,0,7
401406714,Massachusetts Minutemen,TEAM,TOTAL,TOTAL,False,,29,67,23,38,6,29,9,9,15,22,37,11,4,3,14,17,73
401406714,Fordham Rams,A. Tsimbila,4702329,,True,11.0,3,5,3,5,0,0,0,0,3,2,5,0,0,1,1,2,6
401406714,Fordham Rams,C. Ohams,4066856,,True,36.0,10,17,10,17,0,0,3,4,4,7,11,5,0,0,2,1,23
401406714,Fordham Rams,A. Charlton,4897085,,True,33.0,3,7,1,4,2,3,0,0,1,6,7,6,3,0,4,1,8
401406714,Fordham Rams,J. Navarro,4592316,,True,30.0,3,8,0,4,3,4,5,5,1,1,2,3,0,0,1,2,14
401406714,Fordham Rams,K. Rose,4592315,,True,37.0,1,4,0,1,1,3,2,2,1,3,4,1,2,0,3,2,5
401406714,Fordham Rams,P. Kelly,4432014,,False,9.0,2,4,0,1,2,3,0,0,1,0,1,0,1,0,0,1,6
401406714,Fordham Rams,R. Novitskyi,4897084,,False,13.0,4,4,2,2,2,2,0,0,1,1,2,0,2,1,1,3,10
401406714,Fordham Rams,D. Quisenberry,4397790,,False,27.0,3,11,3,8,0,3,2,4,1,1,2,0,2,0,1,0,8
401406714,Fordham Rams,Z. Riley,4914388,,False,4.0,2,3,1,2,1,1,0,1,0,0,0,0,0,0,0,0,5
401406714,Fordham Rams,TEAM,TOTAL,TOTAL,False,,31,63,20,44,11,19,12,16,13,23,36,15,10,2,13,12,85
401406714,Fordham Rams,A. Tsimbila,4702329,,True,11.0,3,5,3,5,0,0,0,0,3,2,5,0,0,1,1,2,6
401406714,Fordham Rams,C. Ohams,4066856,,True,36.0,10,17,10,17,0,0,3,4,4,7,11,5,0,0,2,1,23
401406714,Fordham Rams,A. Charlton,4897085,,True,33.0,3,7,1,4,2,3,0,0,1,6,7,6,3,0,4,1,8
401406714,Fordham Rams,J. Navarro,4592316,,True,30.0,3,8,0,4,3,4,5,5,1,1,2,3,0,0,1,2,14
401406714,Fordham Rams,K. Rose,4592315,,True,37.0,1,4,0,1,1,3,2,2,1,3,4,1,2,0,3,2,5
401406714,Fordham Rams,P. Kelly,4432014,,False,9.0,2,4,0,1,2,3,0,0,1,0,1,0,1,0,0,1,6
401406714,Fordham Rams,R. Novitskyi,4897084,,False,13.0,4,4,2,2,2,2,0,0,1,1,2,0,2,1,1,3,10
401406714,Fordham Rams,D. Quisenberry,4397790,,False,27.0,3,11,3,8,0,3,2,4,1,1,2,0,2,0,1,0,8
401406714,Fordham Rams,Z. Riley,4914388,,False,4.0,2,3,1,2,1,1,0,1,0,0,0,0,0,0,0,0,5
401406714,Fordham Rams,TEAM,TOTAL,TOTAL,False,,31,63,20,44,11,19,12,16,13,23,36,15,10,2,13,12,85
401406708,Saint Joseph's Hawks,T. Funk,4278395,,True,36.0,6,9,1,2,5,7,0,0,0,5,5,2,0,0,3,3,17
401406708,Saint Joseph's Hawks,E. Obinna,4278125,,True,26.0,3,4,3,4,0,0,2,4,2,1,3,0,0,0,2,3,8
401406708,Saint Joseph's Hawks,J. Hall,4701031,,True,36.0,6,14,3,6,3,8,0,0,1,8,9,9,1,0,3,2,15
401406708,Saint Joseph's Hawks,E. Reynolds II,4683952,,True,33.0,7,12,3,5,4,7,0,0,0,2,2,3,1,0,1,1,18
401406708,Saint Joseph's Hawks,C. Brown,4592476,,True,38.0,4,7,3,5,1,2,0,0,0,3,3,1,0,0,2,0,9
401406708,Saint Joseph's Hawks,C. Coleman,4431807,,False,13.0,1,1,1,1,0,0,0,0,0,2,2,2,0,2,0,2,2
401406708,Saint Joseph's Hawks,A. Jansson,4701029,,False,1.0,0,0,0,0,0,0,0,0,0,0,0,0,0,0,2,1,0
401406708,Saint Joseph's Hawks,D. Bishop,4701028,,False,17.0,1,3,1,1,0,2,0,0,0,2,2,0,0,0,3,3,2
401406708,Saint Joseph's Hawks,TEAM,TOTAL,TOTAL,False,,28,50,15,24,13,26,2,4,5,25,30,17,2,2,17,15,71
401406708,Saint Joseph's Hawks,T. Funk,4278395,,True,36.0,6,9,1,2,5,7,0,0,0,5,5,2,0,0,3,3,17
401406708,Saint Joseph's Hawks,E. Obinna,4278125,,True,26.0,3,4,3,4,0,0,2,4,2,1,3,0,0,0,2,3,8
401406708,Saint Joseph's Hawks,J. Hall,4701031,,True,36.0,6,14,3,6,3,8,0,0,1,8,9,9,1,0,3,2,15
401406708,Saint Joseph's Hawks,E. Reynolds II,4683952,,True,33.0,7,12,3,5,4,7,0,0,0,2,2,3,1,0,1,1,18
401406708,Saint Joseph's Hawks,C. Brown,4592476,,True,38.0,4,7,3,5,1,2,0,0,0,3,3,1,0,0,2,0,9
401406708,Saint Joseph's Hawks,C. Coleman,4431807,,False,13.0,1,1,1,1,0,0,0,0,0,2,2,2,0,2,0,2,2
401406708,Saint Joseph's Hawks,A. Jansson,4701029,,False,1.0,0,0,0,0,0,0,0,0,0,0,0,0,0,0,2,1,0
401406708,Saint Joseph's Hawks,D. Bishop,4701028,,False,17.0,1,3,1,1,0,2,0,0,0,2,2,0,0,0,3,3,2
401406708,Saint Joseph's Hawks,TEAM,TOTAL,TOTAL,False,,28,50,15,24,13,26,2,4,5,25,30,17,2,2,17,15,71
401406708,George Mason Patriots,J. Oduro,4432068,,True,31.0,12,22,11,18,1,4,6,7,0,5,5,3,2,0,0,3,31
401406708,George Mason Patriots,X. Johnson,4592439,,True,31.0,3,6,3,4,0,2,0,0,0,3,3,5,1,0,0,0,6
401406708,George Mason Patriots,D. Gaines,4431961,,True,38.0,4,5,3,3,1,2,0,1,3,6,9,1,0,0,1,3,9
401406708,George Mason Patriots,D. Cooper,4279876,,True,34.0,3,7,3,4,0,3,0,0,0,0,0,0,0,0,0,1,6
401406708,George Mason Patriots,D. Schwartz,4278501,,True,38.0,6,12,4,5,2,7,0,0,0,1,1,1,0,0,1,1,14
401406708,George Mason Patriots,B. Jones,4897083,,False,4.0,0,0,0,0,0,0,0,0,0,0,0,0,0,0,0,0,0
401406708,George Mason Patriots,M. Henry,4606836,,False,7.0,1,2,1,2,0,0,0,0,1,0,1,0,0,1,1,1,2
401406708,George Mason Patriots,O. Frazier III,4700882,,False,2.0,0,1,0,0,0,1,0,0,0,0,0,0,0,0,0,0,0
401406708,George Mason Patriots,R. Polite III,4567711,,False,15.0,4,6,3,3,1,3,0,0,0,1,1,2,2,0,0,0,9
401406708,George Mason Patriots,TEAM,TOTAL,TOTAL,False,,33,61,28,39,5,22,6,8,5,18,23,12,5,1,4,9,77
401406708,George Mason Patriots,J. Oduro,4432068,,True,31.0,12,22,11,18,1,4,6,7,0,5,5,3,2,0,0,3,31
401406708,George Mason Patriots,X. Johnson,4592439,,True,31.0,3,6,3,4,0,2,0,0,0,3,3,5,1,0,0,0,6
401406708,George Mason Patriots,D. Gaines,4431961,,True,38.0,4,5,3,3,1,2,0,1,3,6,9,1,0,0,1,3,9
401406708,George Mason Patriots,D. Cooper,4279876,,True,34.0,3,7,3,4,0,3,0,0,0,0,0,0,0,0,0,1,6
401406708,George Mason Patriots,D. Schwartz,4278501,,True,38.0,6,12,4,5,2,7,0,0,0,1,1,1,0,0,1,1,14
401406708,George Mason Patriots,B. Jones,4897083,,False,4.0,0,0,0,0,0,0,0,0,0,0,0,0,0,0,0,0,0
401406708,George Mason Patriots,M. Henry,4606836,,False,7.0,1,2,1,2,0,0,0,0,1,0,1,0,0,1,1,1,2
401406708,George Mason Patriots,O. Frazier III,4700882,,False,2.0,0,1,0,0,0,1,0,0,0,0,0,0,0,0,0,0,0
401406708,George Mason Patriots,R. Polite III,4567711,,False,15.0,4,6,3,3,1,3,0,0,0,1,1,2,2,0,0,0,9
401406708,George Mason Patriots,TEAM,TOTAL,TOTAL,False,,33,61,28,39,5,22,6,8,5,18,23,12,5,1,4,9,77
401405190,Rhode Island Rams,Makhel Mitchell,4431777,,True,32.0,4,6,4,6,0,0,2,6,0,2,2,1,1,4,1,0,10
401405190,Rhode Island Rams,Makhi Mitchell,4431708,,True,22.0,4,9,4,9,0,0,2,2,1,3,4,1,2,2,2,3,10
401405190,Rhode Island Rams,I. Leggett,4606837,,True,20.0,3,5,3,4,0,1,1,4,2,0,2,2,2,0,3,1,7
401405190,Rhode Island Rams,I. El-Amin,4279313,,True,25.0,1,4,1,2,0,2,2,2,0,0,0,2,1,0,1,3,4
401405190,Rhode Island Rams,J. Sheppard,4066445,,True,32.0,2,10,0,4,2,6,0,1,0,4,4,3,1,0,2,2,6
401405190,Rhode Island Rams,A. Walker,4278567,,False,26.0,3,8,3,6,0,2,0,2,2,7,9,1,0,0,3,3,6
401405190,Rhode Island Rams,M. Martin,4397470,,False,15.0,0,1,0,1,0,0,0,0,1,1,2,1,0,0,1,0,0
401405190,Rhode Island Rams,J. Carey,4395673,,False,14.0,2,4,1,3,1,1,2,4,0,1,1,0,0,0,0,0,7
401405190,Rhode Island Rams,S. Thomas,4897065,,False,14.0,3,4,3,3,0,1,0,1,0,2,2,0,0,0,0,1,6
401405190,Rhode Island Rams,TEAM,TOTAL,TOTAL,False,,22,51,19,38,3,13,9,22,8,22,30,11,7,6,13,13,56
401405190,Rhode Island Rams,Makhel Mitchell,4431777,,True,32.0,4,6,4,6,0,0,2,6,0,2,2,1,1,4,1,0,10
401405190,Rhode Island Rams,Makhi Mitchell,4431708,,True,22.0,4,9,4,9,0,0,2,2,1,3,4,1,2,2,2,3,10
401405190,Rhode Island Rams,I. Leggett,4606837,,True,20.0,3,5,3,4,0,1,1,4,2,0,2,2,2,0,3,1,7
401405190,Rhode Island Rams,I. El-Amin,4279313,,True,25.0,1,4,1,2,0,2,2,2,0,0,0,2,1,0,1,3,4
401405190,Rhode Island Rams,J. Sheppard,4066445,,True,32.0,2,10,0,4,2,6,0,1,0,4,4,3,1,0,2,2,6
401405190,Rhode Island Rams,A. Walker,4278567,,False,26.0,3,8,3,6,0,2,0,2,2,7,9,1,0,0,3,3,6
401405190,Rhode Island Rams,M. Martin,4397470,,False,15.0,0,1,0,1,0,0,0,0,1,1,2,1,0,0,1,0,0
401405190,Rhode Island Rams,J. Carey,4395673,,False,14.0,2,4,1,3,1,1,2,4,0,1,1,0,0,0,0,0,7
401405190,Rhode Island Rams,S. Thomas,4897065,,False,14.0,3,4,3,3,0,1,0,1,0,2,2,0,0,0,0,1,6
401405190,Rhode Island Rams,TEAM,TOTAL,TOTAL,False,,22,51,19,38,3,13,9,22,8,22,30,11,7,6,13,13,56
401405190,La Salle Explorers,M. Doucoure,4277988,,True,24.0,3,6,3,6,0,0,0,0,3,4,7,0,0,1,0,3,6
401405190,La Salle Explorers,C. Moore,4277945,,True,29.0,3,9,2,5,1,4,3,5,2,1,3,0,0,1,2,4,10
401405190,La Salle Explorers,J. Clark,4397152,,True,32.0,4,11,3,8,1,3,0,0,2,7,9,2,3,0,4,2,9
401405190,La Salle Explorers,K. Brantley,4709132,,True,27.0,4,11,4,8,0,3,0,1,1,3,4,2,1,0,2,1,8
401405190,La Salle Explorers,A. Gill,4700969,,True,20.0,2,5,2,5,0,0,0,0,0,0,0,1,2,0,3,0,4
401405190,La Salle Explorers,M. McFarlane,4897068,,False,9.0,1,4,1,2,0,2,0,0,0,1,1,0,1,0,1,2,2
401405190,La Salle Explorers,J. Brickus,4700970,,False,20.0,1,3,1,1,0,2,4,4,0,4,4,2,0,0,5,1,6
401405190,La Salle Explorers,C. Ray,4592448,,False,20.0,2,3,2,2,0,1,0,0,3,3,6,0,1,0,0,4,4
401405190,La Salle Explorers,J. Nickelberry,4432845,,False,19.0,1,4,0,2,1,2,2,2,0,1,1,0,0,0,0,2,5
401405190,La Salle Explorers,TEAM,TOTAL,TOTAL,False,,21,56,18,39,3,17,9,12,14,27,41,7,8,2,20,19,54
401405190,La Salle Explorers,M. Doucoure,4277988,,True,24.0,3,6,3,6,0,0,0,0,3,4,7,0,0,1,0,3,6
401405190,La Salle Explorers,C. Moore,4277945,,True,29.0,3,9,2,5,1,4,3,5,2,1,3,0,0,1,2,4,10
401405190,La Salle Explorers,J. Clark,4397152,,True,32.0,4,11,3,8,1,3,0,0,2,7,9,2,3,0,4,2,9
401405190,La Salle Explorers,K. Brantley,4709132,,True,27.0,4,11,4,8,0,3,0,1,1,3,4,2,1,0,2,1,8
401405190,La Salle Explorers,A. Gill,4700969,,True,20.0,2,5,2,5,0,0,0,0,0,0,0,1,2,0,3,0,4
401405190,La Salle Explorers,M. McFarlane,4897068,,False,9.0,1,4,1,2,0,2,0,0,0,1,1,0,1,0,1,2,2
401405190,La Salle Explorers,J. Brickus,4700970,,False,20.0,1,3,1,1,0,2,4,4,0,4,4,2,0,0,5,1,6
401405190,La Salle Explorers,C. Ray,4592448,,False,20.0,2,3,2,2,0,1,0,0,3,3,6,0,1,0,0,4,4
401405190,La Salle Explorers,J. Nickelberry,4432845,,False,19.0,1,4,0,2,1,2,2,2,0,1,1,0,0,0,0,2,5
401405190,La Salle Explorers,TEAM,TOTAL,TOTAL,False,,21,56,18,39,3,17,9,12,14,27,41,7,8,2,20,19,54
401405189,Richmond Spiders,T. Burton,4431914,,True,36.0,2,8,2,6,0,2,3,4,0,5,5,3,0,0,4,2,7
401405189,Richmond Spiders,N. Cayo,4278380,,True,22.0,6,9,6,9,0,0,1,5,4,2,6,2,2,1,0,1,13
401405189,Richmond Spiders,G. Golden,4066836,,True,20.0,4,11,4,8,0,3,3,3,0,3,3,0,0,0,0,1,11
401405189,Richmond Spiders,A. Gustavson,4397193,,True,29.0,2,2,2,2,0,0,7,8,1,6,7,1,2,1,2,2,11
401405189,Richmond Spiders,J. Gilyard,4278378,,True,40.0,11,15,5,5,6,10,3,3,2,1,3,2,3,0,2,2,31
401405189,Richmond Spiders,M. Grace,4397192,,False,20.0,1,3,0,1,1,2,0,0,0,0,0,3,2,1,1,1,3
401405189,Richmond Spiders,I. Wilson,4700973,,False,3.0,0,1,0,0,0,1,0,0,0,0,0,1,0,0,1,1,0
401405189,Richmond Spiders,C. Crabtree,4396658,,False,8.0,1,1,0,0,1,1,0,0,0,0,0,0,0,0,1,1,3
401405189,Richmond Spiders,N. Sherod,4066832,,False,22.0,2,8,2,4,0,4,0,0,1,0,1,1,0,0,0,1,4
401405189,Richmond Spiders,TEAM,TOTAL,TOTAL,False,,29,58,21,35,8,23,17,23,8,21,29,13,9,3,11,12,83
401405189,Richmond Spiders,T. Burton,4431914,,True,36.0,2,8,2,6,0,2,3,4,0,5,5,3,0,0,4,2,7
401405189,Richmond Spiders,N. Cayo,4278380,,True,22.0,6,9,6,9,0,0,1,5,4,2,6,2,2,1,0,1,13
401405189,Richmond Spiders,G. Golden,4066836,,True,20.0,4,11,4,8,0,3,3,3,0,3,3,0,0,0,0,1,11
401405189,Richmond Spiders,A. Gustavson,4397193,,True,29.0,2,2,2,2,0,0,7,8,1,6,7,1,2,1,2,2,11
401405189,Richmond Spiders,J. Gilyard,4278378,,True,40.0,11,15,5,5,6,10,3,3,2,1,3,2,3,0,2,2,31
401405189,Richmond Spiders,M. Grace,4397192,,False,20.0,1,3,0,1,1,2,0,0,0,0,0,3,2,1,1,1,3
401405189,Richmond Spiders,I. Wilson,4700973,,False,3.0,0,1,0,0,0,1,0,0,0,0,0,1,0,0,1,1,0
401405189,Richmond Spiders,C. Crabtree,4396658,,False,8.0,1,1,0,0,1,1,0,0,0,0,0,0,0,0,1,1,3
401405189,Richmond Spiders,N. Sherod,4066832,,False,22.0,2,8,2,4,0,4,0,0,1,0,1,1,0,0,0,1,4
401405189,Richmond Spiders,TEAM,TOTAL,TOTAL,False,,29,58,21,35,8,23,17,23,8,21,29,13,9,3,11,12,83
401405189,Fordham Rams,C. Ohams,4066856,,True,33.0,5,8,5,8,0,0,0,0,2,9,11,1,0,1,7,3,10
401405189,Fordham Rams,A. Charlton,4897085,,True,28.0,4,8,1,3,3,5,2,2,0,3,3,3,0,1,2,4,13
401405189,Fordham Rams,J. Navarro,4592316,,True,33.0,1,5,0,1,1,4,0,0,0,0,0,3,0,0,4,1,3
401405189,Fordham Rams,K. Rose,4592315,,True,37.0,6,9,2,2,4,7,0,0,0,2,2,2,3,0,3,3,16
401405189,Fordham Rams,D. Quisenberry,4397790,,True,37.0,8,15,5,6,3,9,4,7,1,4,5,8,1,0,4,3,23
401405189,Fordham Rams,A. Tsimbila,4702329,,False,10.0,0,2,0,2,0,0,0,0,3,4,7,0,1,0,0,2,0
401405189,Fordham Rams,P. Kelly,4432014,,False,11.0,1,3,0,0,1,3,0,0,1,1,2,0,0,1,0,1,3
401405189,Fordham Rams,A. Harrison,4897086,,False,3.0,1,1,1,1,0,0,0,0,1,0,1,0,0,0,2,1,2
401405189,Fordham Rams,K. Cunningham,4705891,,False,8.0,0,2,0,1,0,1,0,0,0,0,0,0,0,0,0,2,0
401405189,Fordham Rams,TEAM,TOTAL,TOTAL,False,,26,53,14,24,12,29,6,9,8,25,33,17,5,3,22,20,70
401405189,Fordham Rams,C. Ohams,4066856,,True,33.0,5,8,5,8,0,0,0,0,2,9,11,1,0,1,7,3,10
401405189,Fordham Rams,A. Charlton,4897085,,True,28.0,4,8,1,3,3,5,2,2,0,3,3,3,0,1,2,4,13
401405189,Fordham Rams,J. Navarro,4592316,,True,33.0,1,5,0,1,1,4,0,0,0,0,0,3,0,0,4,1,3
401405189,Fordham Rams,K. Rose,4592315,,True,37.0,6,9,2,2,4,7,0,0,0,2,2,2,3,0,3,3,16
401405189,Fordham Rams,D. Quisenberry,4397790,,True,37.0,8,15,5,6,3,9,4,7,1,4,5,8,1,0,4,3,23
401405189,Fordham Rams,A. Tsimbila,4702329,,False,10.0,0,2,0,2,0,0,0,0,3,4,7,0,1,0,0,2,0
401405189,Fordham Rams,P. Kelly,4432014,,False,11.0,1,3,0,0,1,3,0,0,1,1,2,0,0,1,0,1,3
401405189,Fordham Rams,A. Harrison,4897086,,False,3.0,1,1,1,1,0,0,0,0,1,0,1,0,0,0,2,1,2
401405189,Fordham Rams,K. Cunningham,4705891,,False,8.0,0,2,0,1,0,1,0,0,0,0,0,0,0,0,0,2,0
401405189,Fordham Rams,TEAM,TOTAL,TOTAL,False,,26,53,14,24,12,29,6,9,8,25,33,17,5,3,22,20,70
401403383,Richmond Spiders,T. Burton,4431914,,True,28.0,6,14,5,11,1,3,3,4,1,11,12,0,0,0,4,4,16
401403383,Richmond Spiders,N. Cayo,4278380,,True,33.0,3,6,3,6,0,0,3,4,0,7,7,3,0,0,1,3,9
401403383,Richmond Spiders,G. Golden,4066836,,True,30.0,2,4,2,4,0,0,2,2,0,2,2,2,1,0,2,2,6
401403383,Richmond Spiders,A. Gustavson,4397193,,True,28.0,0,2,0,1,0,1,0,0,1,0,1,0,1,0,1,4,0
401403383,Richmond Spiders,J. Gilyard,4278378,,True,40.0,9,17,5,9,4,8,4,5,1,3,4,2,2,0,1,1,26
401403383,Richmond Spiders,M. Grace,4397192,,False,16.0,1,5,1,2,0,3,1,1,0,1,1,0,0,0,1,0,3
401403383,Richmond Spiders,I. Wilson,4700973,,False,6.0,0,0,0,0,0,0,0,0,0,0,0,0,0,0,0,1,0
401403383,Richmond Spiders,C. Crabtree,4396658,,False,6.0,0,0,0,0,0,0,2,2,0,0,0,0,0,0,0,1,2
401403383,Richmond Spiders,N. Sherod,4066832,,False,13.0,1,3,1,2,0,1,0,0,0,3,3,1,1,0,0,1,2
401403383,Richmond Spiders,TEAM,TOTAL,TOTAL,False,,22,51,17,35,5,16,15,18,4,29,33,8,5,0,11,17,64
401403383,Richmond Spiders,T. Burton,4431914,,True,28.0,6,14,5,11,1,3,3,4,1,11,12,0,0,0,4,4,16
401403383,Richmond Spiders,N. Cayo,4278380,,True,33.0,3,6,3,6,0,0,3,4,0,7,7,3,0,0,1,3,9
401403383,Richmond Spiders,G. Golden,4066836,,True,30.0,2,4,2,4,0,0,2,2,0,2,2,2,1,0,2,2,6
401403383,Richmond Spiders,A. Gustavson,4397193,,True,28.0,0,2,0,1,0,1,0,0,1,0,1,0,1,0,1,4,0
401403383,Richmond Spiders,J. Gilyard,4278378,,True,40.0,9,17,5,9,4,8,4,5,1,3,4,2,2,0,1,1,26
401403383,Richmond Spiders,M. Grace,4397192,,False,16.0,1,5,1,2,0,3,1,1,0,1,1,0,0,0,1,0,3
401403383,Richmond Spiders,I. Wilson,4700973,,False,6.0,0,0,0,0,0,0,0,0,0,0,0,0,0,0,0,1,0
401403383,Richmond Spiders,C. Crabtree,4396658,,False,6.0,0,0,0,0,0,0,2,2,0,0,0,0,0,0,0,1,2
401403383,Richmond Spiders,N. Sherod,4066832,,False,13.0,1,3,1,2,0,1,0,0,0,3,3,1,1,0,0,1,2
401403383,Richmond Spiders,TEAM,TOTAL,TOTAL,False,,22,51,17,35,5,16,15,18,4,29,33,8,5,0,11,17,64
401403383,Davidson Wildcats,S. Mennenga,4700862,,True,27.0,5,8,1,4,4,4,4,4,0,5,5,1,1,0,0,3,18
401403383,Davidson Wildcats,L. Brajkovic,4396787,,True,36.0,5,9,5,7,0,2,3,4,3,8,11,1,0,0,0,2,13
401403383,Davidson Wildcats,H. Lee,4592308,,True,34.0,1,9,0,2,1,7,2,2,0,4,4,2,0,2,4,1,5
401403383,Davidson Wildcats,F. Loyer,4397208,,True,21.0,1,7,0,3,1,4,4,4,0,0,0,4,1,0,2,3,7
401403383,Davidson Wildcats,M. Jones,4396784,,True,38.0,6,14,3,5,3,9,2,2,0,5,5,1,1,0,0,4,17
401403383,Davidson Wildcats,N. Boachie-Yiadom,4396786,,False,17.0,0,1,0,1,0,0,0,0,1,0,1,1,1,0,0,0,0
401403383,Davidson Wildcats,D. Watson,4897098,,False,2.0,0,0,0,0,0,0,0,0,0,0,0,0,0,0,0,0,0
401403383,Davidson Wildcats,G. Huffman,4432522,,False,25.0,1,3,1,2,0,1,0,1,0,3,3,2,0,0,1,3,2
401403383,Davidson Wildcats,TEAM,TOTAL,TOTAL,False,,19,51,10,24,9,27,15,17,4,26,30,12,4,2,9,16,62
401403383,Davidson Wildcats,S. Mennenga,4700862,,True,27.0,5,8,1,4,4,4,4,4,0,5,5,1,1,0,0,3,18
401403383,Davidson Wildcats,L. Brajkovic,4396787,,True,36.0,5,9,5,7,0,2,3,4,3,8,11,1,0,0,0,2,13
401403383,Davidson Wildcats,H. Lee,4592308,,True,34.0,1,9,0,2,1,7,2,2,0,4,4,2,0,2,4,1,5
401403383,Davidson Wildcats,F. Loyer,4397208,,True,21.0,1,7,0,3,1,4,4,4,0,0,0,4,1,0,2,3,7
401403383,Davidson Wildcats,M. Jones,4396784,,True,38.0,6,14,3,5,3,9,2,2,0,5,5,1,1,0,0,4,17
401403383,Davidson Wildcats,N. Boachie-Yiadom,4396786,,False,17.0,0,1,0,1,0,0,0,0,1,0,1,1,1,0,0,0,0
401403383,Davidson Wildcats,D. Watson,4897098,,False,2.0,0,0,0,0,0,0,0,0,0,0,0,0,0,0,0,0,0
401403383,Davidson Wildcats,G. Huffman,4432522,,False,25.0,1,3,1,2,0,1,0,1,0,3,3,2,0,0,1,3,2
401403383,Davidson Wildcats,TEAM,TOTAL,TOTAL,False,,19,51,10,24,9,27,15,17,4,26,30,12,4,2,9,16,62
401403382,Richmond Spiders,T. Burton,4431914,,True,34.0,5,10,5,8,0,2,6,6,1,7,8,0,0,1,1,1,16
401403382,Richmond Spiders,N. Cayo,4278380,,True,22.0,1,7,1,7,0,0,0,0,1,1,2,1,0,0,0,3,2
401403382,Richmond Spiders,G. Golden,4066836,,True,30.0,8,17,8,16,0,1,2,2,4,5,9,4,0,0,2,1,18
401403382,Richmond Spiders,A. Gustavson,4397193,,True,33.0,0,2,0,1,0,1,2,4,1,3,4,3,2,1,1,4,2
401403382,Richmond Spiders,J. Gilyard,4278378,,True,40.0,3,13,2,6,1,7,4,6,0,2,2,5,4,0,1,3,11
401403382,Richmond Spiders,M. Grace,4397192,,False,22.0,5,6,3,3,2,3,0,0,0,4,4,0,1,0,0,0,12
401403382,Richmond Spiders,I. Wilson,4700973,,False,5.0,1,1,0,0,1,1,0,0,0,0,0,0,0,0,0,0,3
401403382,Richmond Spiders,C. Crabtree,4396658,,False,3.0,0,0,0,0,0,0,0,0,0,0,0,0,0,0,0,0,0
401403382,Richmond Spiders,N. Sherod,4066832,,False,11.0,2,3,2,2,0,1,0,0,0,1,1,0,0,0,0,1,4
401403382,Richmond Spiders,TEAM,TOTAL,TOTAL,False,,25,59,21,43,4,16,14,18,8,24,32,13,7,2,5,13,68
401403382,Richmond Spiders,T. Burton,4431914,,True,34.0,5,10,5,8,0,2,6,6,1,7,8,0,0,1,1,1,16
401403382,Richmond Spiders,N. Cayo,4278380,,True,22.0,1,7,1,7,0,0,0,0,1,1,2,1,0,0,0,3,2
401403382,Richmond Spiders,G. Golden,4066836,,True,30.0,8,17,8,16,0,1,2,2,4,5,9,4,0,0,2,1,18
401403382,Richmond Spiders,A. Gustavson,4397193,,True,33.0,0,2,0,1,0,1,2,4,1,3,4,3,2,1,1,4,2
401403382,Richmond Spiders,J. Gilyard,4278378,,True,40.0,3,13,2,6,1,7,4,6,0,2,2,5,4,0,1,3,11
401403382,Richmond Spiders,M. Grace,4397192,,False,22.0,5,6,3,3,2,3,0,0,0,4,4,0,1,0,0,0,12
401403382,Richmond Spiders,I. Wilson,4700973,,False,5.0,1,1,0,0,1,1,0,0,0,0,0,0,0,0,0,0,3
401403382,Richmond Spiders,C. Crabtree,4396658,,False,3.0,0,0,0,0,0,0,0,0,0,0,0,0,0,0,0,0,0
401403382,Richmond Spiders,N. Sherod,4066832,,False,11.0,2,3,2,2,0,1,0,0,0,1,1,0,0,0,0,1,4
401403382,Richmond Spiders,TEAM,TOTAL,TOTAL,False,,25,59,21,43,4,16,14,18,8,24,32,13,7,2,5,13,68
401403382,Dayton Flyers,R.J. Blakney,4700864,,True,27.0,4,9,4,5,0,4,0,0,1,3,4,1,0,0,1,4,8
401403382,Dayton Flyers,T. Camara,4431736,,True,34.0,6,8,5,6,1,2,4,8,2,12,14,2,1,2,3,3,17
401403382,Dayton Flyers,D. Holmes II,4433607,,True,36.0,6,11,6,10,0,1,3,3,1,4,5,1,0,3,0,1,15
401403382,Dayton Flyers,M. Smith,4683861,,True,18.0,3,6,2,5,1,1,0,0,0,1,1,2,2,0,0,1,7
401403382,Dayton Flyers,K. Elvis,4683135,,True,35.0,2,10,1,5,1,5,0,0,0,2,2,5,0,0,2,2,5
401403382,Dayton Flyers,M. Amzil,4711607,,False,15.0,0,2,0,0,0,2,2,2,2,2,4,1,0,0,1,1,2
401403382,Dayton Flyers,Z. Nwokeji,4618121,,False,2.0,0,0,0,0,0,0,0,0,0,1,1,0,0,0,1,0,0
401403382,Dayton Flyers,K. Brea,4591259,,False,33.0,4,8,2,3,2,5,0,0,0,1,1,1,0,1,1,2,10
401403382,Dayton Flyers,TEAM,TOTAL,TOTAL,False,,25,54,20,34,5,20,9,13,7,28,35,13,3,6,12,14,64
401403382,Dayton Flyers,R.J. Blakney,4700864,,True,27.0,4,9,4,5,0,4,0,0,1,3,4,1,0,0,1,4,8
401403382,Dayton Flyers,T. Camara,4431736,,True,34.0,6,8,5,6,1,2,4,8,2,12,14,2,1,2,3,3,17
401403382,Dayton Flyers,D. Holmes II,4433607,,True,36.0,6,11,6,10,0,1,3,3,1,4,5,1,0,3,0,1,15
401403382,Dayton Flyers,M. Smith,4683861,,True,18.0,3,6,2,5,1,1,0,0,0,1,1,2,2,0,0,1,7
401403382,Dayton Flyers,K. Elvis,4683135,,True,35.0,2,10,1,5,1,5,0,0,0,2,2,5,0,0,2,2,5
401403382,Dayton Flyers,M. Amzil,4711607,,False,15.0,0,2,0,0,0,2,2,2,2,2,4,1,0,0,1,1,2
401403382,Dayton Flyers,Z. Nwokeji,4618121,,False,2.0,0,0,0,0,0,0,0,0,0,1,1,0,0,0,1,0,0
401403382,Dayton Flyers,K. Brea,4591259,,False,33.0,4,8,2,3,2,5,0,0,0,1,1,1,0,1,1,2,10
401403382,Dayton Flyers,TEAM,TOTAL,TOTAL,False,,25,54,20,34,5,20,9,13,7,28,35,13,3,6,12,14,64
401403381,Saint Louis Billikens,F. Okoro,4397105,,True,29.0,0,5,0,5,0,0,3,4,2,3,5,0,1,2,0,4,3
401403381,Saint Louis Billikens,J. Nesbitt,4714246,,True,22.0,1,2,0,1,1,1,0,0,0,1,1,2,0,1,1,1,3
401403381,Saint Louis Billikens,Y. Collins,4432957,,True,29.0,4,8,4,8,0,0,5,5,0,5,5,7,0,0,3,5,13
401403381,Saint Louis Billikens,G. Jimerson,4432008,,True,38.0,3,12,0,2,3,10,0,0,0,1,1,1,1,0,2,2,9
401403381,Saint Louis Billikens,F. Thatch Jr.,4397199,,True,23.0,3,9,3,6,0,3,2,2,1,2,3,2,2,1,2,4,8
401403381,Saint Louis Billikens,T. Hargrove Jr.,4592484,,False,27.0,5,10,1,5,4,5,0,0,0,6,6,1,0,0,0,0,14
401403381,Saint Louis Billikens,M. Linssen,4279174,,False,11.0,4,5,4,5,0,0,0,3,0,2,2,0,0,1,1,1,8
401403381,Saint Louis Billikens,D. Jones,4278267,,False,21.0,5,8,4,4,1,4,0,0,0,2,2,2,1,0,0,4,11
401403381,Saint Louis Billikens,TEAM,TOTAL,TOTAL,False,,25,59,16,36,9,23,10,14,5,24,29,15,5,5,9,21,69
401403381,Saint Louis Billikens,F. Okoro,4397105,,True,29.0,0,5,0,5,0,0,3,4,2,3,5,0,1,2,0,4,3
401403381,Saint Louis Billikens,J. Nesbitt,4714246,,True,22.0,1,2,0,1,1,1,0,0,0,1,1,2,0,1,1,1,3
401403381,Saint Louis Billikens,Y. Collins,4432957,,True,29.0,4,8,4,8,0,0,5,5,0,5,5,7,0,0,3,5,13
401403381,Saint Louis Billikens,G. Jimerson,4432008,,True,38.0,3,12,0,2,3,10,0,0,0,1,1,1,1,0,2,2,9
401403381,Saint Louis Billikens,F. Thatch Jr.,4397199,,True,23.0,3,9,3,6,0,3,2,2,1,2,3,2,2,1,2,4,8
401403381,Saint Louis Billikens,T. Hargrove Jr.,4592484,,False,27.0,5,10,1,5,4,5,0,0,0,6,6,1,0,0,0,0,14
401403381,Saint Louis Billikens,M. Linssen,4279174,,False,11.0,4,5,4,5,0,0,0,3,0,2,2,0,0,1,1,1,8
401403381,Saint Louis Billikens,D. Jones,4278267,,False,21.0,5,8,4,4,1,4,0,0,0,2,2,2,1,0,0,4,11
401403381,Saint Louis Billikens,TEAM,TOTAL,TOTAL,False,,25,59,16,36,9,23,10,14,5,24,29,15,5,5,9,21,69
401403381,Davidson Wildcats,S. Mennenga,4700862,,True,15.0,2,2,2,2,0,0,0,0,0,4,4,2,0,0,1,3,4
401403381,Davidson Wildcats,L. Brajkovic,4396787,,True,34.0,6,16,5,11,1,5,1,2,1,9,10,5,0,0,2,1,14
401403381,Davidson Wildcats,H. Lee,4592308,,True,32.0,5,9,3,3,2,6,4,5,0,6,6,2,0,0,1,1,16
401403381,Davidson Wildcats,F. Loyer,4397208,,True,23.0,6,10,3,5,3,5,6,6,1,4,5,0,1,0,1,0,21
401403381,Davidson Wildcats,M. Jones,4396784,,True,37.0,5,7,3,3,2,4,1,1,0,3,3,0,0,2,1,2,13
401403381,Davidson Wildcats,D. Kristensen,4432020,,False,1.0,0,1,0,0,0,1,0,0,0,1,1,1,0,0,0,0,0
401403381,Davidson Wildcats,N. Boachie-Yiadom,4396786,,False,22.0,0,3,0,3,0,0,0,0,2,1,3,4,0,0,1,1,0
401403381,Davidson Wildcats,S. Thrastarson,4897100,,False,1.0,0,0,0,0,0,0,0,0,0,1,1,0,0,0,0,0,0
401403381,Davidson Wildcats,D. Watson,4897098,,False,11.0,1,5,1,5,0,0,2,2,0,2,2,0,0,0,1,0,4
401403381,Davidson Wildcats,E. Lanier,4567082,,False,2.0,0,0,0,0,0,0,0,0,0,0,0,0,0,0,0,0,0
401403381,Davidson Wildcats,G. Huffman,4432522,,False,22.0,4,4,2,2,2,2,2,2,0,1,1,2,2,0,0,4,12
401403381,Davidson Wildcats,TEAM,TOTAL,TOTAL,False,,29,57,19,34,10,23,16,18,5,32,37,16,3,2,8,12,84
401403381,Davidson Wildcats,S. Mennenga,4700862,,True,15.0,2,2,2,2,0,0,0,0,0,4,4,2,0,0,1,3,4
401403381,Davidson Wildcats,L. Brajkovic,4396787,,True,34.0,6,16,5,11,1,5,1,2,1,9,10,5,0,0,2,1,14
401403381,Davidson Wildcats,H. Lee,4592308,,True,32.0,5,9,3,3,2,6,4,5,0,6,6,2,0,0,1,1,16
401403381,Davidson Wildcats,F. Loyer,4397208,,True,23.0,6,10,3,5,3,5,6,6,1,4,5,0,1,0,1,0,21
401403381,Davidson Wildcats,M. Jones,4396784,,True,37.0,5,7,3,3,2,4,1,1,0,3,3,0,0,2,1,2,13
401403381,Davidson Wildcats,D. Kristensen,4432020,,False,1.0,0,1,0,0,0,1,0,0,0,1,1,1,0,0,0,0,0
401403381,Davidson Wildcats,N. Boachie-Yiadom,4396786,,False,22.0,0,3,0,3,0,0,0,0,2,1,3,4,0,0,1,1,0
401403381,Davidson Wildcats,S. Thrastarson,4897100,,False,1.0,0,0,0,0,0,0,0,0,0,1,1,0,0,0,0,0,0
401403381,Davidson Wildcats,D. Watson,4897098,,False,11.0,1,5,1,5,0,0,2,2,0,2,2,0,0,0,1,0,4
401403381,Davidson Wildcats,E. Lanier,4567082,,False,2.0,0,0,0,0,0,0,0,0,0,0,0,0,0,0,0,0,0
401403381,Davidson Wildcats,G. Huffman,4432522,,False,22.0,4,4,2,2,2,2,2,2,0,1,1,2,2,0,0,4,12
401403381,Davidson Wildcats,TEAM,TOTAL,TOTAL,False,,29,57,19,34,10,23,16,18,5,32,37,16,3,2,8,12,84
401403380,Massachusetts Minutemen,G. Jones,4279211,,True,29.0,2,6,1,3,1,3,2,2,2,2,4,0,1,0,2,3,7
401403380,Massachusetts Minutemen,T. Buttrick,4277981,,True,18.0,3,6,2,3,1,3,0,0,1,5,6,0,1,0,1,5,7
401403380,Massachusetts Minutemen,T.J. Weeks,4433108,,True,27.0,3,8,2,5,1,3,3,4,2,4,6,1,0,0,0,1,10
401403380,Massachusetts Minutemen,N. Fernandes,4431791,,True,38.0,10,20,9,15,1,5,5,6,0,4,4,4,2,0,2,3,26
401403380,Massachusetts Minutemen,R. Kelly,4279741,,True,33.0,2,8,2,6,0,2,1,2,0,1,1,1,1,1,0,2,5
401403380,Massachusetts Minutemen,M. Steadman,4397393,,False,12.0,2,3,2,3,0,0,0,0,1,3,4,0,0,0,0,2,4
401403380,Massachusetts Minutemen,J. Garcia,4701125,,False,26.0,5,7,4,5,1,2,2,4,4,1,5,2,0,0,0,3,13
401403380,Massachusetts Minutemen,C.J. Kelly,4398208,,False,17.0,0,2,0,0,0,2,0,0,0,0,0,1,0,0,0,2,0
401403380,Massachusetts Minutemen,TEAM,TOTAL,TOTAL,False,,27,60,22,40,5,20,13,18,11,22,33,9,5,1,6,21,72
401403380,Massachusetts Minutemen,G. Jones,4279211,,True,29.0,2,6,1,3,1,3,2,2,2,2,4,0,1,0,2,3,7
401403380,Massachusetts Minutemen,T. Buttrick,4277981,,True,18.0,3,6,2,3,1,3,0,0,1,5,6,0,1,0,1,5,7
401403380,Massachusetts Minutemen,T.J. Weeks,4433108,,True,27.0,3,8,2,5,1,3,3,4,2,4,6,1,0,0,0,1,10
401403380,Massachusetts Minutemen,N. Fernandes,4431791,,True,38.0,10,20,9,15,1,5,5,6,0,4,4,4,2,0,2,3,26
401403380,Massachusetts Minutemen,R. Kelly,4279741,,True,33.0,2,8,2,6,0,2,1,2,0,1,1,1,1,1,0,2,5
401403380,Massachusetts Minutemen,M. Steadman,4397393,,False,12.0,2,3,2,3,0,0,0,0,1,3,4,0,0,0,0,2,4
401403380,Massachusetts Minutemen,J. Garcia,4701125,,False,26.0,5,7,4,5,1,2,2,4,4,1,5,2,0,0,0,3,13
401403380,Massachusetts Minutemen,C.J. Kelly,4398208,,False,17.0,0,2,0,0,0,2,0,0,0,0,0,1,0,0,0,2,0
401403380,Massachusetts Minutemen,TEAM,TOTAL,TOTAL,False,,27,60,22,40,5,20,13,18,11,22,33,9,5,1,6,21,72
401403380,Dayton Flyers,R.J. Blakney,4700864,,True,33.0,3,5,1,1,2,4,2,3,1,1,2,2,0,0,1,3,10
401403380,Dayton Flyers,T. Camara,4431736,,True,26.0,4,8,3,6,1,2,3,4,3,4,7,1,0,0,1,3,12
401403380,Dayton Flyers,D. Holmes II,4433607,,True,37.0,12,15,12,15,0,0,4,7,1,4,5,1,0,3,2,2,28
401403380,Dayton Flyers,M. Smith,4683861,,True,35.0,3,7,2,4,1,3,8,10,0,5,5,6,1,0,1,1,15
401403380,Dayton Flyers,K. Elvis,4683135,,True,26.0,2,7,2,4,0,3,0,0,0,1,1,2,0,0,3,2,4
401403380,Dayton Flyers,M. Sissoko,4431824,,False,2.0,0,0,0,0,0,0,1,2,0,1,1,0,0,0,0,0,1
401403380,Dayton Flyers,M. Amzil,4711607,,False,15.0,0,2,0,0,0,2,0,0,1,4,5,2,0,0,1,3,0
401403380,Dayton Flyers,K. Brea,4591259,,False,26.0,2,6,2,4,0,2,1,2,1,2,3,0,1,0,0,2,5
401403380,Dayton Flyers,TEAM,TOTAL,TOTAL,False,,26,50,22,34,4,16,19,28,8,24,32,14,2,3,9,17,75
401403380,Dayton Flyers,R.J. Blakney,4700864,,True,33.0,3,5,1,1,2,4,2,3,1,1,2,2,0,0,1,3,10
401403380,Dayton Flyers,T. Camara,4431736,,True,26.0,4,8,3,6,1,2,3,4,3,4,7,1,0,0,1,3,12
401403380,Dayton Flyers,D. Holmes II,4433607,,True,37.0,12,15,12,15,0,0,4,7,1,4,5,1,0,3,2,2,28
401403380,Dayton Flyers,M. Smith,4683861,,True,35.0,3,7,2,4,1,3,8,10,0,5,5,6,1,0,1,1,15
401403380,Dayton Flyers,K. Elvis,4683135,,True,26.0,2,7,2,4,0,3,0,0,0,1,1,2,0,0,3,2,4
401403380,Dayton Flyers,M. Sissoko,4431824,,False,2.0,0,0,0,0,0,0,1,2,0,1,1,0,0,0,0,0,1
401403380,Dayton Flyers,M. Amzil,4711607,,False,15.0,0,2,0,0,0,2,0,0,1,4,5,2,0,0,1,3,0
401403380,Dayton Flyers,K. Brea,4591259,,False,26.0,2,6,2,4,0,2,1,2,1,2,3,0,1,0,0,2,5
401403380,Dayton Flyers,TEAM,TOTAL,TOTAL,False,,26,50,22,34,4,16,19,28,8,24,32,14,2,3,9,17,75
401403379,VCU Rams,H. Ward,4592495,,True,26.0,2,2,2,2,0,0,2,3,1,3,4,1,0,3,0,1,6
401403379,VCU Rams,V. Williams Jr.,4397227,,True,37.0,7,14,3,6,4,8,0,0,3,6,9,2,2,1,4,5,18
401403379,VCU Rams,J. Nunn,4896614,,True,29.0,2,4,1,1,1,3,0,0,0,1,1,1,1,0,2,1,5
401403379,VCU Rams,A. Baldwin Jr.,4433182,,True,39.0,5,13,3,7,2,6,0,0,1,3,4,7,0,1,5,3,12
401403379,VCU Rams,K. Curry,4397228,,True,30.0,5,8,5,7,0,1,4,6,0,5,5,0,2,1,4,5,14
401403379,VCU Rams,M. Brown-Jones,4433224,,False,9.0,0,2,0,1,0,1,0,0,0,0,0,0,0,0,0,3,0
401403379,VCU Rams,J. DeLoach,4432483,,False,6.0,0,0,0,0,0,0,0,0,0,1,1,0,0,1,0,2,0
401403379,VCU Rams,L. Stockard III,4277897,,False,8.0,2,3,2,3,0,0,0,0,0,0,0,0,0,0,0,2,4
401403379,VCU Rams,N. Kern,4684145,,False,5.0,1,2,1,2,0,0,0,0,0,2,2,0,0,0,1,2,2
401403379,VCU Rams,M. Tsohonis,4592438,,False,11.0,1,3,0,0,1,3,0,0,0,0,0,0,1,0,0,1,3
401403379,VCU Rams,J. Banks,4432402,,False,0.0,0,0,0,0,0,0,0,0,0,0,0,0,0,0,0,0,0
401403379,VCU Rams,TEAM,TOTAL,TOTAL,False,,25,51,17,29,8,22,6,9,6,22,28,11,6,7,16,25,64
401403379,VCU Rams,H. Ward,4592495,,True,26.0,2,2,2,2,0,0,2,3,1,3,4,1,0,3,0,1,6
401403379,VCU Rams,V. Williams Jr.,4397227,,True,37.0,7,14,3,6,4,8,0,0,3,6,9,2,2,1,4,5,18
401403379,VCU Rams,J. Nunn,4896614,,True,29.0,2,4,1,1,1,3,0,0,0,1,1,1,1,0,2,1,5
401403379,VCU Rams,A. Baldwin Jr.,4433182,,True,39.0,5,13,3,7,2,6,0,0,1,3,4,7,0,1,5,3,12
401403379,VCU Rams,K. Curry,4397228,,True,30.0,5,8,5,7,0,1,4,6,0,5,5,0,2,1,4,5,14
401403379,VCU Rams,M. Brown-Jones,4433224,,False,9.0,0,2,0,1,0,1,0,0,0,0,0,0,0,0,0,3,0
401403379,VCU Rams,J. DeLoach,4432483,,False,6.0,0,0,0,0,0,0,0,0,0,1,1,0,0,1,0,2,0
401403379,VCU Rams,L. Stockard III,4277897,,False,8.0,2,3,2,3,0,0,0,0,0,0,0,0,0,0,0,2,4
401403379,VCU Rams,N. Kern,4684145,,False,5.0,1,2,1,2,0,0,0,0,0,2,2,0,0,0,1,2,2
401403379,VCU Rams,M. Tsohonis,4592438,,False,11.0,1,3,0,0,1,3,0,0,0,0,0,0,1,0,0,1,3
401403379,VCU Rams,J. Banks,4432402,,False,0.0,0,0,0,0,0,0,0,0,0,0,0,0,0,0,0,0,0
401403379,VCU Rams,TEAM,TOTAL,TOTAL,False,,25,51,17,29,8,22,6,9,6,22,28,11,6,7,16,25,64
401403379,Richmond Spiders,T. Burton,4431914,,True,39.0,2,7,1,5,1,2,9,11,0,8,8,2,1,0,1,4,14
401403379,Richmond Spiders,N. Cayo,4278380,,True,33.0,3,7,3,7,0,0,5,6,2,1,3,1,1,1,2,3,11
401403379,Richmond Spiders,G. Golden,4066836,,True,25.0,1,6,1,5,0,1,2,3,1,4,5,1,0,0,3,1,4
401403379,Richmond Spiders,A. Gustavson,4397193,,True,32.0,3,4,2,2,1,2,3,5,0,3,3,1,2,0,1,3,10
401403379,Richmond Spiders,J. Gilyard,4278378,,True,40.0,9,17,2,5,7,12,7,7,0,0,0,3,4,0,2,1,32
401403379,Richmond Spiders,M. Grace,4397192,,False,17.0,2,5,2,3,0,2,0,0,2,3,5,2,2,0,2,3,4
401403379,Richmond Spiders,I. Wilson,4700973,,False,7.0,0,0,0,0,0,0,0,0,0,0,0,0,0,0,0,3,0
401403379,Richmond Spiders,C. Crabtree,4396658,,False,1.0,0,0,0,0,0,0,0,0,0,0,0,0,0,0,0,0,0
401403379,Richmond Spiders,N. Sherod,4066832,,False,6.0,0,1,0,1,0,0,0,0,0,2,2,0,0,0,0,0,0
401403379,Richmond Spiders,TEAM,TOTAL,TOTAL,False,,20,47,11,28,9,19,26,32,6,22,28,10,10,1,11,18,75
401403379,Richmond Spiders,T. Burton,4431914,,True,39.0,2,7,1,5,1,2,9,11,0,8,8,2,1,0,1,4,14
401403379,Richmond Spiders,N. Cayo,4278380,,True,33.0,3,7,3,7,0,0,5,6,2,1,3,1,1,1,2,3,11
401403379,Richmond Spiders,G. Golden,4066836,,True,25.0,1,6,1,5,0,1,2,3,1,4,5,1,0,0,3,1,4
401403379,Richmond Spiders,A. Gustavson,4397193,,True,32.0,3,4,2,2,1,2,3,5,0,3,3,1,2,0,1,3,10
401403379,Richmond Spiders,J. Gilyard,4278378,,True,40.0,9,17,2,5,7,12,7,7,0,0,0,3,4,0,2,1,32
401403379,Richmond Spiders,M. Grace,4397192,,False,17.0,2,5,2,3,0,2,0,0,2,3,5,2,2,0,2,3,4
401403379,Richmond Spiders,I. Wilson,4700973,,False,7.0,0,0,0,0,0,0,0,0,0,0,0,0,0,0,0,3,0
401403379,Richmond Spiders,C. Crabtree,4396658,,False,1.0,0,0,0,0,0,0,0,0,0,0,0,0,0,0,0,0,0
401403379,Richmond Spiders,N. Sherod,4066832,,False,6.0,0,1,0,1,0,0,0,0,0,2,2,0,0,0,0,0,0
401403379,Richmond Spiders,TEAM,TOTAL,TOTAL,False,,20,47,11,28,9,19,26,32,6,22,28,10,10,1,11,18,75
401403378,St. Bonaventure Bonnies,O. Osunniyi,4397224,,True,32.0,2,2,2,2,0,0,2,5,2,7,9,4,0,3,4,2,6
401403378,St. Bonaventure Bonnies,J. Adaway,4279431,,True,40.0,7,17,4,11,3,6,1,1,1,4,5,1,2,1,1,1,18
401403378,St. Bonaventure Bonnies,J. Holmes,4701016,,True,38.0,2,13,2,9,0,4,0,0,1,1,2,3,2,1,0,1,4
401403378,St. Bonaventure Bonnies,D. Welch,4397221,,True,40.0,6,11,4,5,2,6,0,0,3,4,7,1,1,0,1,2,14
401403378,St. Bonaventure Bonnies,K. Lofton,4397220,,True,40.0,5,15,5,11,0,4,0,2,3,0,3,4,2,1,4,4,10
401403378,St. Bonaventure Bonnies,A. Coulibaly,4432889,,False,8.0,2,5,2,5,0,0,0,0,1,0,1,1,2,1,0,1,4
401403378,St. Bonaventure Bonnies,Q. Adams,4585591,,False,2.0,0,0,0,0,0,0,0,0,0,0,0,0,0,0,0,0,0
401403378,St. Bonaventure Bonnies,TEAM,TOTAL,TOTAL,False,,24,63,19,43,5,20,3,8,13,18,31,14,9,7,10,11,56
401403378,St. Bonaventure Bonnies,O. Osunniyi,4397224,,True,32.0,2,2,2,2,0,0,2,5,2,7,9,4,0,3,4,2,6
401403378,St. Bonaventure Bonnies,J. Adaway,4279431,,True,40.0,7,17,4,11,3,6,1,1,1,4,5,1,2,1,1,1,18
401403378,St. Bonaventure Bonnies,J. Holmes,4701016,,True,38.0,2,13,2,9,0,4,0,0,1,1,2,3,2,1,0,1,4
401403378,St. Bonaventure Bonnies,D. Welch,4397221,,True,40.0,6,11,4,5,2,6,0,0,3,4,7,1,1,0,1,2,14
401403378,St. Bonaventure Bonnies,K. Lofton,4397220,,True,40.0,5,15,5,11,0,4,0,2,3,0,3,4,2,1,4,4,10
401403378,St. Bonaventure Bonnies,A. Coulibaly,4432889,,False,8.0,2,5,2,5,0,0,0,0,1,0,1,1,2,1,0,1,4
401403378,St. Bonaventure Bonnies,Q. Adams,4585591,,False,2.0,0,0,0,0,0,0,0,0,0,0,0,0,0,0,0,0,0
401403378,St. Bonaventure Bonnies,TEAM,TOTAL,TOTAL,False,,24,63,19,43,5,20,3,8,13,18,31,14,9,7,10,11,56
401403378,Saint Louis Billikens,F. Okoro,4397105,,True,33.0,5,7,5,7,0,0,4,4,5,7,12,0,2,0,3,3,14
401403378,Saint Louis Billikens,J. Nesbitt,4714246,,True,34.0,0,8,0,6,0,2,0,0,3,2,5,0,1,0,1,4,0
401403378,Saint Louis Billikens,Y. Collins,4432957,,True,40.0,4,13,4,12,0,1,3,4,0,7,7,9,0,1,6,3,11
401403378,Saint Louis Billikens,G. Jimerson,4432008,,True,40.0,7,14,1,5,6,9,0,0,0,2,2,1,0,0,2,1,20
401403378,Saint Louis Billikens,F. Thatch Jr.,4397199,,True,27.0,4,9,4,9,0,0,0,0,1,2,3,1,0,0,2,3,8
401403378,Saint Louis Billikens,T. Hargrove Jr.,4592484,,False,13.0,1,2,1,1,0,1,0,0,0,2,2,0,0,0,0,0,2
401403378,Saint Louis Billikens,M. Linssen,4279174,,False,6.0,1,2,1,2,0,0,0,0,0,2,2,0,0,0,0,1,2
401403378,Saint Louis Billikens,D. Jones,4278267,,False,7.0,0,1,0,0,0,1,0,0,1,0,1,0,0,0,1,1,0
401403378,Saint Louis Billikens,TEAM,TOTAL,TOTAL,False,,22,56,16,42,6,14,7,8,14,26,40,11,3,1,17,16,57
401403378,Saint Louis Billikens,F. Okoro,4397105,,True,33.0,5,7,5,7,0,0,4,4,5,7,12,0,2,0,3,3,14
401403378,Saint Louis Billikens,J. Nesbitt,4714246,,True,34.0,0,8,0,6,0,2,0,0,3,2,5,0,1,0,1,4,0
401403378,Saint Louis Billikens,Y. Collins,4432957,,True,40.0,4,13,4,12,0,1,3,4,0,7,7,9,0,1,6,3,11
401403378,Saint Louis Billikens,G. Jimerson,4432008,,True,40.0,7,14,1,5,6,9,0,0,0,2,2,1,0,0,2,1,20
401403378,Saint Louis Billikens,F. Thatch Jr.,4397199,,True,27.0,4,9,4,9,0,0,0,0,1,2,3,1,0,0,2,3,8
401403378,Saint Louis Billikens,T. Hargrove Jr.,4592484,,False,13.0,1,2,1,1,0,1,0,0,0,2,2,0,0,0,0,0,2
401403378,Saint Louis Billikens,M. Linssen,4279174,,False,6.0,1,2,1,2,0,0,0,0,0,2,2,0,0,0,0,1,2
401403378,Saint Louis Billikens,D. Jones,4278267,,False,7.0,0,1,0,0,0,1,0,0,1,0,1,0,0,0,1,1,0
401403378,Saint Louis Billikens,TEAM,TOTAL,TOTAL,False,,22,56,16,42,6,14,7,8,14,26,40,11,3,1,17,16,57
401403377,Fordham Rams,A. Tsimbila,4702329,,True,8.0,0,0,0,0,0,0,0,0,0,4,4,0,0,0,1,5,0
401403377,Fordham Rams,C. Ohams,4066856,,True,27.0,4,6,4,6,0,0,6,7,0,9,9,1,0,0,3,1,14
401403377,Fordham Rams,A. Charlton,4897085,,True,30.0,1,6,0,3,1,3,0,1,1,5,6,3,2,0,3,5,3
401403377,Fordham Rams,J. Navarro,4592316,,True,26.0,1,7,0,2,1,5,0,0,1,2,3,0,0,0,1,0,3
401403377,Fordham Rams,K. Rose,4592315,,True,26.0,3,10,2,4,1,6,2,4,2,0,2,1,0,0,1,2,9
401403377,Fordham Rams,P. Kelly,4432014,,False,16.0,1,7,1,2,0,5,0,0,1,0,1,0,0,0,0,1,2
401403377,Fordham Rams,R. Novitskyi,4897084,,False,32.0,7,12,6,10,1,2,3,4,3,2,5,1,1,3,1,2,18
401403377,Fordham Rams,K. Cunningham,4705891,,False,10.0,1,2,1,1,0,1,0,0,0,1,1,0,0,0,1,1,2
401403377,Fordham Rams,A. Evans,4700881,,False,1.0,0,0,0,0,0,0,0,0,1,0,1,0,0,0,0,0,0
401403377,Fordham Rams,Z. Riley,4914388,,False,24.0,1,7,1,1,0,6,3,4,1,3,4,1,0,0,0,4,5
401403377,Fordham Rams,TEAM,TOTAL,TOTAL,False,,19,57,15,29,4,28,14,20,11,26,37,7,3,3,12,21,56
401403377,Fordham Rams,A. Tsimbila,4702329,,True,8.0,0,0,0,0,0,0,0,0,0,4,4,0,0,0,1,5,0
401403377,Fordham Rams,C. Ohams,4066856,,True,27.0,4,6,4,6,0,0,6,7,0,9,9,1,0,0,3,1,14
401403377,Fordham Rams,A. Charlton,4897085,,True,30.0,1,6,0,3,1,3,0,1,1,5,6,3,2,0,3,5,3
401403377,Fordham Rams,J. Navarro,4592316,,True,26.0,1,7,0,2,1,5,0,0,1,2,3,0,0,0,1,0,3
401403377,Fordham Rams,K. Rose,4592315,,True,26.0,3,10,2,4,1,6,2,4,2,0,2,1,0,0,1,2,9
401403377,Fordham Rams,P. Kelly,4432014,,False,16.0,1,7,1,2,0,5,0,0,1,0,1,0,0,0,0,1,2
401403377,Fordham Rams,R. Novitskyi,4897084,,False,32.0,7,12,6,10,1,2,3,4,3,2,5,1,1,3,1,2,18
401403377,Fordham Rams,K. Cunningham,4705891,,False,10.0,1,2,1,1,0,1,0,0,0,1,1,0,0,0,1,1,2
401403377,Fordham Rams,A. Evans,4700881,,False,1.0,0,0,0,0,0,0,0,0,1,0,1,0,0,0,0,0,0
401403377,Fordham Rams,Z. Riley,4914388,,False,24.0,1,7,1,1,0,6,3,4,1,3,4,1,0,0,0,4,5
401403377,Fordham Rams,TEAM,TOTAL,TOTAL,False,,19,57,15,29,4,28,14,20,11,26,37,7,3,3,12,21,56
401403377,Davidson Wildcats,S. Mennenga,4700862,,True,28.0,4,11,4,10,0,1,7,8,2,7,9,5,0,1,0,1,15
401403377,Davidson Wildcats,L. Brajkovic,4396787,,True,21.0,2,3,1,2,1,1,1,2,0,1,1,2,0,1,1,2,6
401403377,Davidson Wildcats,H. Lee,4592308,,True,30.0,4,7,3,6,1,1,2,3,1,7,8,0,0,0,1,3,11
401403377,Davidson Wildcats,F. Loyer,4397208,,True,22.0,3,7,2,3,1,4,1,2,0,2,2,2,0,0,0,2,8
401403377,Davidson Wildcats,M. Jones,4396784,,True,33.0,2,7,2,4,0,3,4,4,0,5,5,2,0,1,0,3,8
401403377,Davidson Wildcats,C. Ford,4897099,,False,1.0,1,1,1,1,0,0,0,0,0,0,0,0,0,0,0,0,2
401403377,Davidson Wildcats,D. Kristensen,4432020,,False,2.0,0,0,0,0,0,0,0,0,0,1,1,0,0,0,0,1,0
401403377,Davidson Wildcats,N. Boachie-Yiadom,4396786,,False,14.0,1,1,1,1,0,0,0,0,0,1,1,2,0,0,0,3,2
401403377,Davidson Wildcats,S. Thrastarson,4897100,,False,2.0,0,0,0,0,0,0,0,0,1,0,1,0,0,0,0,0,0
401403377,Davidson Wildcats,D. Watson,4897098,,False,15.0,6,12,6,11,0,1,1,2,1,1,2,1,0,0,3,1,13
401403377,Davidson Wildcats,E. Lanier,4567082,,False,2.0,0,1,0,0,0,1,0,0,0,0,0,0,0,0,0,1,0
401403377,Davidson Wildcats,G. Huffman,4432522,,False,29.0,3,4,0,0,3,4,0,0,0,5,5,2,1,0,3,2,9
401403377,Davidson Wildcats,TEAM,TOTAL,TOTAL,False,,26,54,20,38,6,16,16,21,6,31,37,16,1,3,8,19,74
401403377,Davidson Wildcats,S. Mennenga,4700862,,True,28.0,4,11,4,10,0,1,7,8,2,7,9,5,0,1,0,1,15
401403377,Davidson Wildcats,L. Brajkovic,4396787,,True,21.0,2,3,1,2,1,1,1,2,0,1,1,2,0,1,1,2,6
401403377,Davidson Wildcats,H. Lee,4592308,,True,30.0,4,7,3,6,1,1,2,3,1,7,8,0,0,0,1,3,11
401403377,Davidson Wildcats,F. Loyer,4397208,,True,22.0,3,7,2,3,1,4,1,2,0,2,2,2,0,0,0,2,8
401403377,Davidson Wildcats,M. Jones,4396784,,True,33.0,2,7,2,4,0,3,4,4,0,5,5,2,0,1,0,3,8
401403377,Davidson Wildcats,C. Ford,4897099,,False,1.0,1,1,1,1,0,0,0,0,0,0,0,0,0,0,0,0,2
401403377,Davidson Wildcats,D. Kristensen,4432020,,False,2.0,0,0,0,0,0,0,0,0,0,1,1,0,0,0,0,1,0
401403377,Davidson Wildcats,N. Boachie-Yiadom,4396786,,False,14.0,1,1,1,1,0,0,0,0,0,1,1,2,0,0,0,3,2
401403377,Davidson Wildcats,S. Thrastarson,4897100,,False,2.0,0,0,0,0,0,0,0,0,1,0,1,0,0,0,0,0,0
401403377,Davidson Wildcats,D. Watson,4897098,,False,15.0,6,12,6,11,0,1,1,2,1,1,2,1,0,0,3,1,13
401403377,Davidson Wildcats,E. Lanier,4567082,,False,2.0,0,1,0,0,0,1,0,0,0,0,0,0,0,0,0,1,0
401403377,Davidson Wildcats,G. Huffman,4432522,,False,29.0,3,4,0,0,3,4,0,0,0,5,5,2,1,0,3,2,9
401403377,Davidson Wildcats,TEAM,TOTAL,TOTAL,False,,26,54,20,38,6,16,16,21,6,31,37,16,1,3,8,19,74
401403376,Massachusetts Minutemen,G. Jones,4279211,,True,27.0,3,8,3,8,0,0,0,0,2,1,3,1,1,1,0,1,6
401403376,Massachusetts Minutemen,T. Buttrick,4277981,,True,34.0,5,9,2,4,3,5,0,0,4,12,16,1,1,2,3,0,13
401403376,Massachusetts Minutemen,T.J. Weeks,4433108,,True,17.0,4,8,0,1,4,7,3,3,2,2,4,0,0,0,1,5,15
401403376,Massachusetts Minutemen,N. Fernandes,4431791,,True,39.0,11,17,9,11,2,6,5,6,0,1,1,7,7,0,4,3,29
401403376,Massachusetts Minutemen,R. Kelly,4279741,,True,31.0,6,15,5,10,1,5,0,0,0,2,2,5,1,0,3,2,13
401403376,Massachusetts Minutemen,J. Garcia,4701125,,False,29.0,3,7,3,5,0,2,2,2,1,2,3,3,1,1,0,3,8
401403376,Massachusetts Minutemen,C.J. Kelly,4398208,,False,23.0,5,7,3,3,2,4,3,4,0,1,1,0,3,0,0,2,15
401403376,Massachusetts Minutemen,TEAM,TOTAL,TOTAL,False,,37,71,25,42,12,29,13,15,11,22,33,17,14,4,11,16,99
401403376,Massachusetts Minutemen,G. Jones,4279211,,True,27.0,3,8,3,8,0,0,0,0,2,1,3,1,1,1,0,1,6
401403376,Massachusetts Minutemen,T. Buttrick,4277981,,True,34.0,5,9,2,4,3,5,0,0,4,12,16,1,1,2,3,0,13
401403376,Massachusetts Minutemen,T.J. Weeks,4433108,,True,17.0,4,8,0,1,4,7,3,3,2,2,4,0,0,0,1,5,15
401403376,Massachusetts Minutemen,N. Fernandes,4431791,,True,39.0,11,17,9,11,2,6,5,6,0,1,1,7,7,0,4,3,29
401403376,Massachusetts Minutemen,R. Kelly,4279741,,True,31.0,6,15,5,10,1,5,0,0,0,2,2,5,1,0,3,2,13
401403376,Massachusetts Minutemen,J. Garcia,4701125,,False,29.0,3,7,3,5,0,2,2,2,1,2,3,3,1,1,0,3,8
401403376,Massachusetts Minutemen,C.J. Kelly,4398208,,False,23.0,5,7,3,3,2,4,3,4,0,1,1,0,3,0,0,2,15
401403376,Massachusetts Minutemen,TEAM,TOTAL,TOTAL,False,,37,71,25,42,12,29,13,15,11,22,33,17,14,4,11,16,99
401403376,George Washington Revolutionaries,H. Dean,4593273,,True,16.0,1,2,1,2,0,0,2,2,1,3,4,2,0,0,0,2,4
401403376,George Washington Revolutionaries,R. Lindo Jr.,4397186,,True,27.0,4,4,2,2,2,2,0,0,2,9,11,0,2,1,3,5,10
401403376,George Washington Revolutionaries,B. Freeman,4613126,,True,37.0,4,8,3,6,1,2,9,11,0,2,2,7,1,1,6,1,18
401403376,George Washington Revolutionaries,J. Bamisile,4432537,,True,36.0,11,20,10,14,1,6,2,3,2,3,5,1,1,2,2,2,25
401403376,George Washington Revolutionaries,J. Bishop,4431770,,True,38.0,5,15,4,10,1,5,4,5,0,0,0,0,1,0,4,2,15
401403376,George Washington Revolutionaries,Q. Samuels,4592251,,False,15.0,2,3,1,2,1,1,1,2,0,3,3,1,0,0,1,1,6
401403376,George Washington Revolutionaries,A. Harris,4397216,,False,1.0,0,2,0,2,0,0,0,0,2,1,3,0,0,0,0,0,0
401403376,George Washington Revolutionaries,B. Adams,4396612,,False,30.0,4,5,2,3,2,2,0,0,1,3,4,2,1,0,2,0,10
401403376,George Washington Revolutionaries,TEAM,TOTAL,TOTAL,False,,31,59,23,41,8,18,18,23,10,25,35,13,6,4,18,13,88
401403376,George Washington Revolutionaries,H. Dean,4593273,,True,16.0,1,2,1,2,0,0,2,2,1,3,4,2,0,0,0,2,4
401403376,George Washington Revolutionaries,R. Lindo Jr.,4397186,,True,27.0,4,4,2,2,2,2,0,0,2,9,11,0,2,1,3,5,10
401403376,George Washington Revolutionaries,B. Freeman,4613126,,True,37.0,4,8,3,6,1,2,9,11,0,2,2,7,1,1,6,1,18
401403376,George Washington Revolutionaries,J. Bamisile,4432537,,True,36.0,11,20,10,14,1,6,2,3,2,3,5,1,1,2,2,2,25
401403376,George Washington Revolutionaries,J. Bishop,4431770,,True,38.0,5,15,4,10,1,5,4,5,0,0,0,0,1,0,4,2,15
401403376,George Washington Revolutionaries,Q. Samuels,4592251,,False,15.0,2,3,1,2,1,1,1,2,0,3,3,1,0,0,1,1,6
401403376,George Washington Revolutionaries,A. Harris,4397216,,False,1.0,0,2,0,2,0,0,0,0,2,1,3,0,0,0,0,0,0
401403376,George Washington Revolutionaries,B. Adams,4396612,,False,30.0,4,5,2,3,2,2,0,0,1,3,4,2,1,0,2,0,10
401403376,George Washington Revolutionaries,TEAM,TOTAL,TOTAL,False,,31,59,23,41,8,18,18,23,10,25,35,13,6,4,18,13,88
401403375,Richmond Spiders,T. Burton,4431914,,True,38.0,2,8,1,5,1,3,7,8,1,10,11,2,1,0,2,3,12
401403375,Richmond Spiders,N. Cayo,4278380,,True,34.0,4,6,4,6,0,0,1,6,1,5,6,3,0,1,2,2,9
401403375,Richmond Spiders,G. Golden,4066836,,True,28.0,6,12,6,12,0,0,7,10,0,3,3,1,1,0,2,3,19
401403375,Richmond Spiders,A. Gustavson,4397193,,True,29.0,2,6,0,0,2,6,2,2,0,2,2,1,1,0,0,3,8
401403375,Richmond Spiders,J. Gilyard,4278378,,True,40.0,3,8,1,3,2,5,2,2,1,2,3,4,6,0,1,2,10
401403375,Richmond Spiders,M. Grace,4397192,,False,15.0,1,3,0,1,1,2,0,0,0,3,3,1,0,1,2,2,3
401403375,Richmond Spiders,C. Crabtree,4396658,,False,11.0,0,1,0,0,0,1,3,5,0,0,0,0,0,0,0,0,3
401403375,Richmond Spiders,N. Sherod,4066832,,False,5.0,0,3,0,0,0,3,0,0,0,1,1,0,0,0,0,0,0
401403375,Richmond Spiders,TEAM,TOTAL,TOTAL,False,,18,47,12,27,6,20,22,33,3,26,29,12,9,2,10,15,64
401403375,Richmond Spiders,T. Burton,4431914,,True,38.0,2,8,1,5,1,3,7,8,1,10,11,2,1,0,2,3,12
401403375,Richmond Spiders,N. Cayo,4278380,,True,34.0,4,6,4,6,0,0,1,6,1,5,6,3,0,1,2,2,9
401403375,Richmond Spiders,G. Golden,4066836,,True,28.0,6,12,6,12,0,0,7,10,0,3,3,1,1,0,2,3,19
401403375,Richmond Spiders,A. Gustavson,4397193,,True,29.0,2,6,0,0,2,6,2,2,0,2,2,1,1,0,0,3,8
401403375,Richmond Spiders,J. Gilyard,4278378,,True,40.0,3,8,1,3,2,5,2,2,1,2,3,4,6,0,1,2,10
401403375,Richmond Spiders,M. Grace,4397192,,False,15.0,1,3,0,1,1,2,0,0,0,3,3,1,0,1,2,2,3
401403375,Richmond Spiders,C. Crabtree,4396658,,False,11.0,0,1,0,0,0,1,3,5,0,0,0,0,0,0,0,0,3
401403375,Richmond Spiders,N. Sherod,4066832,,False,5.0,0,3,0,0,0,3,0,0,0,1,1,0,0,0,0,0,0
401403375,Richmond Spiders,TEAM,TOTAL,TOTAL,False,,18,47,12,27,6,20,22,33,3,26,29,12,9,2,10,15,64
401403375,Rhode Island Rams,A. Walker,4278567,,True,20.0,2,4,2,3,0,1,0,0,1,2,3,0,0,0,2,3,4
401403375,Rhode Island Rams,I. Leggett,4606837,,True,25.0,0,6,0,3,0,3,3,5,1,1,2,1,1,0,1,2,3
401403375,Rhode Island Rams,M. Martin,4397470,,True,33.0,8,11,6,7,2,4,2,3,4,5,9,0,2,2,3,1,20
401403375,Rhode Island Rams,I. El-Amin,4279313,,True,23.0,1,5,1,2,0,3,0,0,1,3,4,0,0,0,0,4,2
401403375,Rhode Island Rams,J. Sheppard,4066445,,True,29.0,0,4,0,1,0,3,0,0,0,1,1,4,2,0,5,4,0
401403375,Rhode Island Rams,Makhel Mitchell,4431777,,False,17.0,4,8,4,8,0,0,1,3,2,4,6,1,0,0,0,4,9
401403375,Rhode Island Rams,Makhi Mitchell,4431708,,False,23.0,6,13,6,11,0,2,1,2,0,8,8,0,1,1,0,3,13
401403375,Rhode Island Rams,J. Carey,4395673,,False,19.0,4,6,4,5,0,1,0,0,1,5,6,1,2,0,2,3,8
401403375,Rhode Island Rams,S. Thomas,4897065,,False,11.0,0,3,0,3,0,0,0,2,1,0,1,0,0,0,1,0,0
401403375,Rhode Island Rams,TEAM,TOTAL,TOTAL,False,,25,60,23,43,2,17,7,15,13,32,45,7,8,3,18,24,59
401403375,Rhode Island Rams,A. Walker,4278567,,True,20.0,2,4,2,3,0,1,0,0,1,2,3,0,0,0,2,3,4
401403375,Rhode Island Rams,I. Leggett,4606837,,True,25.0,0,6,0,3,0,3,3,5,1,1,2,1,1,0,1,2,3
401403375,Rhode Island Rams,M. Martin,4397470,,True,33.0,8,11,6,7,2,4,2,3,4,5,9,0,2,2,3,1,20
401403375,Rhode Island Rams,I. El-Amin,4279313,,True,23.0,1,5,1,2,0,3,0,0,1,3,4,0,0,0,0,4,2
401403375,Rhode Island Rams,J. Sheppard,4066445,,True,29.0,0,4,0,1,0,3,0,0,0,1,1,4,2,0,5,4,0
401403375,Rhode Island Rams,Makhel Mitchell,4431777,,False,17.0,4,8,4,8,0,0,1,3,2,4,6,1,0,0,0,4,9
401403375,Rhode Island Rams,Makhi Mitchell,4431708,,False,23.0,6,13,6,11,0,2,1,2,0,8,8,0,1,1,0,3,13
401403375,Rhode Island Rams,J. Carey,4395673,,False,19.0,4,6,4,5,0,1,0,0,1,5,6,1,2,0,2,3,8
401403375,Rhode Island Rams,S. Thomas,4897065,,False,11.0,0,3,0,3,0,0,0,2,1,0,1,0,0,0,1,0,0
401403375,Rhode Island Rams,TEAM,TOTAL,TOTAL,False,,25,60,23,43,2,17,7,15,13,32,45,7,8,3,18,24,59
401403374,Saint Louis Billikens,F. Okoro,4397105,,True,24.0,8,11,8,11,0,0,1,2,3,10,13,1,0,2,2,1,17
401403374,Saint Louis Billikens,J. Nesbitt,4714246,,True,25.0,0,1,0,0,0,1,2,5,1,5,6,3,2,0,1,5,2
401403374,Saint Louis Billikens,Y. Collins,4432957,,True,29.0,5,9,5,7,0,2,3,4,0,3,3,3,1,0,3,3,13
401403374,Saint Louis Billikens,G. Jimerson,4432008,,True,27.0,7,14,4,6,3,8,2,2,1,1,2,2,0,0,0,0,19
401403374,Saint Louis Billikens,F. Thatch Jr.,4397199,,True,29.0,4,11,3,9,1,2,1,2,4,7,11,4,1,0,1,1,10
401403374,Saint Louis Billikens,L. Traore,4897052,,False,2.0,0,0,0,0,0,0,0,0,1,1,2,0,1,0,0,0,0
401403374,Saint Louis Billikens,A. Lorentsson,4701121,,False,2.0,0,1,0,0,0,1,0,0,0,0,0,0,0,0,0,0,0
401403374,Saint Louis Billikens,T. Hargrove Jr.,4592484,,False,17.0,1,5,1,4,0,1,0,0,1,3,4,0,0,0,0,0,2
401403374,Saint Louis Billikens,M. Linssen,4279174,,False,14.0,1,4,1,4,0,0,0,0,1,3,4,1,0,0,1,3,2
401403374,Saint Louis Billikens,M. Strickland,4432494,,False,3.0,0,0,0,0,0,0,0,0,0,0,0,0,0,0,2,0,0
401403374,Saint Louis Billikens,R. Williams,4399106,,False,7.0,0,4,0,0,0,4,0,0,0,0,0,1,0,0,1,0,0
401403374,Saint Louis Billikens,D. Jones,4278267,,False,21.0,1,1,0,0,1,1,3,4,0,1,1,1,0,1,0,4,6
401403374,Saint Louis Billikens,TEAM,TOTAL,TOTAL,False,,27,61,22,41,5,20,12,19,13,35,48,16,5,3,11,17,71
401403374,Saint Louis Billikens,F. Okoro,4397105,,True,24.0,8,11,8,11,0,0,1,2,3,10,13,1,0,2,2,1,17
401403374,Saint Louis Billikens,J. Nesbitt,4714246,,True,25.0,0,1,0,0,0,1,2,5,1,5,6,3,2,0,1,5,2
401403374,Saint Louis Billikens,Y. Collins,4432957,,True,29.0,5,9,5,7,0,2,3,4,0,3,3,3,1,0,3,3,13
401403374,Saint Louis Billikens,G. Jimerson,4432008,,True,27.0,7,14,4,6,3,8,2,2,1,1,2,2,0,0,0,0,19
401403374,Saint Louis Billikens,F. Thatch Jr.,4397199,,True,29.0,4,11,3,9,1,2,1,2,4,7,11,4,1,0,1,1,10
401403374,Saint Louis Billikens,L. Traore,4897052,,False,2.0,0,0,0,0,0,0,0,0,1,1,2,0,1,0,0,0,0
401403374,Saint Louis Billikens,A. Lorentsson,4701121,,False,2.0,0,1,0,0,0,1,0,0,0,0,0,0,0,0,0,0,0
401403374,Saint Louis Billikens,T. Hargrove Jr.,4592484,,False,17.0,1,5,1,4,0,1,0,0,1,3,4,0,0,0,0,0,2
401403374,Saint Louis Billikens,M. Linssen,4279174,,False,14.0,1,4,1,4,0,0,0,0,1,3,4,1,0,0,1,3,2
401403374,Saint Louis Billikens,M. Strickland,4432494,,False,3.0,0,0,0,0,0,0,0,0,0,0,0,0,0,0,2,0,0
401403374,Saint Louis Billikens,R. Williams,4399106,,False,7.0,0,4,0,0,0,4,0,0,0,0,0,1,0,0,1,0,0
401403374,Saint Louis Billikens,D. Jones,4278267,,False,21.0,1,1,0,0,1,1,3,4,0,1,1,1,0,1,0,4,6
401403374,Saint Louis Billikens,TEAM,TOTAL,TOTAL,False,,27,61,22,41,5,20,12,19,13,35,48,16,5,3,11,17,71
401403374,La Salle Explorers,C. Moore,4277945,,True,25.0,1,10,1,9,0,1,1,1,0,2,2,0,0,2,1,2,3
401403374,La Salle Explorers,J. Clark,4397152,,True,32.0,1,9,1,4,0,5,2,2,1,8,9,3,0,0,0,3,4
401403374,La Salle Explorers,J. Brickus,4700970,,True,22.0,4,6,3,4,1,2,2,2,0,3,3,0,0,0,1,1,11
401403374,La Salle Explorers,A. Gill,4700969,,True,24.0,2,8,2,7,0,1,1,1,1,2,3,1,1,0,1,3,5
401403374,La Salle Explorers,C. Ray,4592448,,True,27.0,2,3,2,3,0,0,1,2,2,4,6,0,0,0,1,0,5
401403374,La Salle Explorers,M. McFarlane,4897068,,False,3.0,0,0,0,0,0,0,0,0,0,0,0,0,0,0,0,0,0
401403374,La Salle Explorers,M. Doucoure,4277988,,False,11.0,1,1,1,1,0,0,1,2,0,3,3,0,1,0,1,1,3
401403374,La Salle Explorers,D. Shepherd,4710357,,False,12.0,2,3,2,3,0,0,0,0,0,1,1,0,0,0,1,0,4
401403374,La Salle Explorers,K. Brantley,4709132,,False,20.0,3,10,3,8,0,2,5,8,0,0,0,3,2,1,2,3,11
401403374,La Salle Explorers,K. Thompson,4592449,,False,2.0,0,1,0,1,0,0,0,0,0,1,1,0,0,0,0,0,0
401403374,La Salle Explorers,J. Nickelberry,4432845,,False,20.0,1,3,0,1,1,2,2,2,0,2,2,0,2,0,3,5,5
401403374,La Salle Explorers,A. Lafond,4404355,,False,2.0,0,0,0,0,0,0,0,0,0,0,0,0,0,0,0,0,0
401403374,La Salle Explorers,TEAM,TOTAL,TOTAL,False,,17,54,15,41,2,13,15,20,6,27,33,7,6,3,11,18,51
401403374,La Salle Explorers,C. Moore,4277945,,True,25.0,1,10,1,9,0,1,1,1,0,2,2,0,0,2,1,2,3
401403374,La Salle Explorers,J. Clark,4397152,,True,32.0,1,9,1,4,0,5,2,2,1,8,9,3,0,0,0,3,4
401403374,La Salle Explorers,J. Brickus,4700970,,True,22.0,4,6,3,4,1,2,2,2,0,3,3,0,0,0,1,1,11
401403374,La Salle Explorers,A. Gill,4700969,,True,24.0,2,8,2,7,0,1,1,1,1,2,3,1,1,0,1,3,5
401403374,La Salle Explorers,C. Ray,4592448,,True,27.0,2,3,2,3,0,0,1,2,2,4,6,0,0,0,1,0,5
401403374,La Salle Explorers,M. McFarlane,4897068,,False,3.0,0,0,0,0,0,0,0,0,0,0,0,0,0,0,0,0,0
401403374,La Salle Explorers,M. Doucoure,4277988,,False,11.0,1,1,1,1,0,0,1,2,0,3,3,0,1,0,1,1,3
401403374,La Salle Explorers,D. Shepherd,4710357,,False,12.0,2,3,2,3,0,0,0,0,0,1,1,0,0,0,1,0,4
401403374,La Salle Explorers,K. Brantley,4709132,,False,20.0,3,10,3,8,0,2,5,8,0,0,0,3,2,1,2,3,11
401403374,La Salle Explorers,K. Thompson,4592449,,False,2.0,0,1,0,1,0,0,0,0,0,1,1,0,0,0,0,0,0
401403374,La Salle Explorers,J. Nickelberry,4432845,,False,20.0,1,3,0,1,1,2,2,2,0,2,2,0,2,0,3,5,5
401403374,La Salle Explorers,A. Lafond,4404355,,False,2.0,0,0,0,0,0,0,0,0,0,0,0,0,0,0,0,0,0
401403374,La Salle Explorers,TEAM,TOTAL,TOTAL,False,,17,54,15,41,2,13,15,20,6,27,33,7,6,3,11,18,51
401403373,George Mason Patriots,J. Oduro,4432068,,True,29.0,5,9,5,8,0,1,1,4,2,8,10,2,2,3,5,4,11
401403373,George Mason Patriots,X. Johnson,4592439,,True,20.0,3,8,1,3,2,5,0,0,0,2,2,3,3,0,2,3,8
401403373,George Mason Patriots,D. Gaines,4431961,,True,36.0,0,7,0,2,0,5,0,1,2,8,10,2,0,1,1,0,0
401403373,George Mason Patriots,D. Cooper,4279876,,True,36.0,3,9,1,3,2,6,1,1,0,3,3,2,0,0,0,2,9
401403373,George Mason Patriots,D. Schwartz,4278501,,True,38.0,3,8,2,5,1,3,0,0,0,5,5,0,1,0,1,1,7
401403373,George Mason Patriots,B. Jones,4897083,,False,9.0,1,2,1,1,0,1,0,0,1,0,1,0,0,0,0,2,2
401403373,George Mason Patriots,R. Polite III,4567711,,False,18.0,3,11,2,5,1,6,3,3,0,0,0,2,0,0,2,2,10
401403373,George Mason Patriots,J. Hartwell II,4396817,,False,14.0,1,1,1,1,0,0,0,0,0,1,1,0,0,0,0,2,2
401403373,George Mason Patriots,TEAM,TOTAL,TOTAL,False,,19,55,13,28,6,27,5,9,5,28,33,11,6,4,11,16,49
401403373,George Mason Patriots,J. Oduro,4432068,,True,29.0,5,9,5,8,0,1,1,4,2,8,10,2,2,3,5,4,11
401403373,George Mason Patriots,X. Johnson,4592439,,True,20.0,3,8,1,3,2,5,0,0,0,2,2,3,3,0,2,3,8
401403373,George Mason Patriots,D. Gaines,4431961,,True,36.0,0,7,0,2,0,5,0,1,2,8,10,2,0,1,1,0,0
401403373,George Mason Patriots,D. Cooper,4279876,,True,36.0,3,9,1,3,2,6,1,1,0,3,3,2,0,0,0,2,9
401403373,George Mason Patriots,D. Schwartz,4278501,,True,38.0,3,8,2,5,1,3,0,0,0,5,5,0,1,0,1,1,7
401403373,George Mason Patriots,B. Jones,4897083,,False,9.0,1,2,1,1,0,1,0,0,1,0,1,0,0,0,0,2,2
401403373,George Mason Patriots,R. Polite III,4567711,,False,18.0,3,11,2,5,1,6,3,3,0,0,0,2,0,0,2,2,10
401403373,George Mason Patriots,J. Hartwell II,4396817,,False,14.0,1,1,1,1,0,0,0,0,0,1,1,0,0,0,0,2,2
401403373,George Mason Patriots,TEAM,TOTAL,TOTAL,False,,19,55,13,28,6,27,5,9,5,28,33,11,6,4,11,16,49
401403373,Fordham Rams,A. Tsimbila,4702329,,True,15.0,1,4,1,4,0,0,3,4,7,3,10,0,0,1,1,0,5
401403373,Fordham Rams,C. Ohams,4066856,,True,34.0,7,20,7,20,0,0,6,10,3,13,16,0,2,0,1,2,20
401403373,Fordham Rams,J. Navarro,4592316,,True,24.0,1,6,0,3,1,3,0,0,0,2,2,2,1,0,1,1,3
401403373,Fordham Rams,K. Rose,4592315,,True,31.0,0,3,0,0,0,3,0,0,0,1,1,1,1,0,1,0,0
401403373,Fordham Rams,D. Quisenberry,4397790,,True,22.0,0,6,0,2,0,4,0,0,0,1,1,0,0,0,1,0,0
401403373,Fordham Rams,P. Kelly,4432014,,False,21.0,3,3,0,0,3,3,0,1,1,3,4,0,0,1,0,4,9
401403373,Fordham Rams,R. Novitskyi,4897084,,False,10.0,0,2,0,1,0,1,0,0,1,3,4,0,0,0,1,2,0
401403373,Fordham Rams,A. Charlton,4897085,,False,34.0,5,11,4,6,1,5,0,0,0,7,7,5,2,0,5,4,11
401403373,Fordham Rams,Z. Riley,4914388,,False,9.0,1,1,1,1,0,0,4,4,0,0,0,0,1,0,0,0,6
401403373,Fordham Rams,TEAM,TOTAL,TOTAL,False,,18,56,13,37,5,19,13,19,13,34,47,8,7,2,11,13,54
401403373,Fordham Rams,A. Tsimbila,4702329,,True,15.0,1,4,1,4,0,0,3,4,7,3,10,0,0,1,1,0,5
401403373,Fordham Rams,C. Ohams,4066856,,True,34.0,7,20,7,20,0,0,6,10,3,13,16,0,2,0,1,2,20
401403373,Fordham Rams,J. Navarro,4592316,,True,24.0,1,6,0,3,1,3,0,0,0,2,2,2,1,0,1,1,3
401403373,Fordham Rams,K. Rose,4592315,,True,31.0,0,3,0,0,0,3,0,0,0,1,1,1,1,0,1,0,0
401403373,Fordham Rams,D. Quisenberry,4397790,,True,22.0,0,6,0,2,0,4,0,0,0,1,1,0,0,0,1,0,0
401403373,Fordham Rams,P. Kelly,4432014,,False,21.0,3,3,0,0,3,3,0,1,1,3,4,0,0,1,0,4,9
401403373,Fordham Rams,R. Novitskyi,4897084,,False,10.0,0,2,0,1,0,1,0,0,1,3,4,0,0,0,1,2,0
401403373,Fordham Rams,A. Charlton,4897085,,False,34.0,5,11,4,6,1,5,0,0,0,7,7,5,2,0,5,4,11
401403373,Fordham Rams,Z. Riley,4914388,,False,9.0,1,1,1,1,0,0,4,4,0,0,0,0,1,0,0,0,6
401403373,Fordham Rams,TEAM,TOTAL,TOTAL,False,,18,56,13,37,5,19,13,19,13,34,47,8,7,2,11,13,54
401403372,Rhode Island Rams,A. Walker,4278567,,True,33.0,6,8,3,5,3,3,2,2,4,7,11,1,1,2,2,0,17
401403372,Rhode Island Rams,I. Leggett,4606837,,True,24.0,5,10,3,7,2,3,0,1,4,3,7,0,1,0,0,4,12
401403372,Rhode Island Rams,M. Martin,4397470,,True,33.0,3,5,2,2,1,3,1,1,1,3,4,0,2,2,2,3,8
401403372,Rhode Island Rams,I. El-Amin,4279313,,True,19.0,2,3,1,1,1,2,0,0,0,2,2,2,0,0,2,1,5
401403372,Rhode Island Rams,J. Sheppard,4066445,,True,30.0,4,11,2,5,2,6,5,8,0,2,2,6,1,0,5,4,15
401403372,Rhode Island Rams,Makhel Mitchell,4431777,,False,18.0,5,8,5,7,0,1,0,0,1,3,4,0,0,3,2,0,10
401403372,Rhode Island Rams,Makhi Mitchell,4431708,,False,12.0,3,6,2,5,1,1,3,6,2,6,8,0,0,0,0,0,10
401403372,Rhode Island Rams,J. Carey,4395673,,False,13.0,0,4,0,3,0,1,0,0,0,0,0,3,0,1,1,1,0
401403372,Rhode Island Rams,S. Thomas,4897065,,False,18.0,1,4,1,4,0,0,0,0,0,0,0,3,2,0,3,1,2
401403372,Rhode Island Rams,TEAM,TOTAL,TOTAL,False,,29,59,19,39,10,20,11,18,13,26,39,15,7,8,19,14,79
401403372,Rhode Island Rams,A. Walker,4278567,,True,33.0,6,8,3,5,3,3,2,2,4,7,11,1,1,2,2,0,17
401403372,Rhode Island Rams,I. Leggett,4606837,,True,24.0,5,10,3,7,2,3,0,1,4,3,7,0,1,0,0,4,12
401403372,Rhode Island Rams,M. Martin,4397470,,True,33.0,3,5,2,2,1,3,1,1,1,3,4,0,2,2,2,3,8
401403372,Rhode Island Rams,I. El-Amin,4279313,,True,19.0,2,3,1,1,1,2,0,0,0,2,2,2,0,0,2,1,5
401403372,Rhode Island Rams,J. Sheppard,4066445,,True,30.0,4,11,2,5,2,6,5,8,0,2,2,6,1,0,5,4,15
401403372,Rhode Island Rams,Makhel Mitchell,4431777,,False,18.0,5,8,5,7,0,1,0,0,1,3,4,0,0,3,2,0,10
401403372,Rhode Island Rams,Makhi Mitchell,4431708,,False,12.0,3,6,2,5,1,1,3,6,2,6,8,0,0,0,0,0,10
401403372,Rhode Island Rams,J. Carey,4395673,,False,13.0,0,4,0,3,0,1,0,0,0,0,0,3,0,1,1,1,0
401403372,Rhode Island Rams,S. Thomas,4897065,,False,18.0,1,4,1,4,0,0,0,0,0,0,0,3,2,0,3,1,2
401403372,Rhode Island Rams,TEAM,TOTAL,TOTAL,False,,29,59,19,39,10,20,11,18,13,26,39,15,7,8,19,14,79
401403372,Duquesne Dukes,M. Hima,4700878,,True,7.0,2,2,2,2,0,0,0,0,1,0,1,0,0,1,1,4,4
401403372,Duquesne Dukes,K. Easley,4398159,,True,37.0,8,12,6,7,2,5,2,3,4,3,7,3,4,0,2,3,20
401403372,Duquesne Dukes,D. Larson,4897091,,True,33.0,1,7,1,5,0,2,1,2,1,3,4,0,2,0,1,4,3
401403372,Duquesne Dukes,A. Spears,4897090,,True,40.0,12,25,9,16,3,9,3,4,0,6,6,5,2,0,1,1,30
401403372,Duquesne Dukes,T. Acuff,4606831,,True,24.0,1,4,1,2,0,2,0,0,0,4,4,3,1,0,0,2,2
401403372,Duquesne Dukes,J. Johnson III,4897088,,False,23.0,5,10,4,8,1,2,2,3,0,2,2,0,1,0,2,1,13
401403372,Duquesne Dukes,M. Bekelja,4700874,,False,13.0,0,1,0,0,0,1,0,0,0,0,0,0,0,0,0,1,0
401403372,Duquesne Dukes,T. Okani,4700873,,False,23.0,2,4,2,4,0,0,1,2,1,2,3,1,2,2,1,4,5
401403372,Duquesne Dukes,TEAM,TOTAL,TOTAL,False,,31,65,25,44,6,21,9,14,8,22,30,12,12,3,8,20,77
401403372,Duquesne Dukes,M. Hima,4700878,,True,7.0,2,2,2,2,0,0,0,0,1,0,1,0,0,1,1,4,4
401403372,Duquesne Dukes,K. Easley,4398159,,True,37.0,8,12,6,7,2,5,2,3,4,3,7,3,4,0,2,3,20
401403372,Duquesne Dukes,D. Larson,4897091,,True,33.0,1,7,1,5,0,2,1,2,1,3,4,0,2,0,1,4,3
401403372,Duquesne Dukes,A. Spears,4897090,,True,40.0,12,25,9,16,3,9,3,4,0,6,6,5,2,0,1,1,30
401403372,Duquesne Dukes,T. Acuff,4606831,,True,24.0,1,4,1,2,0,2,0,0,0,4,4,3,1,0,0,2,2
401403372,Duquesne Dukes,J. Johnson III,4897088,,False,23.0,5,10,4,8,1,2,2,3,0,2,2,0,1,0,2,1,13
401403372,Duquesne Dukes,M. Bekelja,4700874,,False,13.0,0,1,0,0,0,1,0,0,0,0,0,0,0,0,0,1,0
401403372,Duquesne Dukes,T. Okani,4700873,,False,23.0,2,4,2,4,0,0,1,2,1,2,3,1,2,2,1,4,5
401403372,Duquesne Dukes,TEAM,TOTAL,TOTAL,False,,31,65,25,44,6,21,9,14,8,22,30,12,12,3,8,20,77
401403371,Saint Joseph's Hawks,A. Jansson,4701029,,True,4.0,0,0,0,0,0,0,0,0,0,0,0,0,0,0,0,0,0
401403371,Saint Joseph's Hawks,E. Obinna,4278125,,True,36.0,7,10,7,10,0,0,0,2,6,8,14,1,0,0,1,2,14
401403371,Saint Joseph's Hawks,J. Hall,4701031,,True,39.0,4,17,1,12,3,5,0,0,1,8,9,6,2,0,4,1,11
401403371,Saint Joseph's Hawks,E. Reynolds II,4683952,,True,39.0,3,17,3,7,0,10,0,0,0,2,2,2,2,0,7,5,6
401403371,Saint Joseph's Hawks,C. Brown,4592476,,True,31.0,3,13,2,6,1,7,0,0,2,2,4,1,2,1,0,1,7
401403371,Saint Joseph's Hawks,C. Coleman,4431807,,False,27.0,7,9,3,4,4,5,0,0,2,9,11,1,0,0,1,3,18
401403371,Saint Joseph's Hawks,J. Forrest,4701032,,False,19.0,0,2,0,1,0,1,0,0,0,1,1,0,0,1,0,4,0
401403371,Saint Joseph's Hawks,D. Bishop,4701028,,False,5.0,0,0,0,0,0,0,0,0,0,0,0,0,0,0,0,0,0
401403371,Saint Joseph's Hawks,TEAM,TOTAL,TOTAL,False,,24,68,16,40,8,28,0,2,14,32,46,11,6,2,14,16,56
401403371,Saint Joseph's Hawks,A. Jansson,4701029,,True,4.0,0,0,0,0,0,0,0,0,0,0,0,0,0,0,0,0,0
401403371,Saint Joseph's Hawks,E. Obinna,4278125,,True,36.0,7,10,7,10,0,0,0,2,6,8,14,1,0,0,1,2,14
401403371,Saint Joseph's Hawks,J. Hall,4701031,,True,39.0,4,17,1,12,3,5,0,0,1,8,9,6,2,0,4,1,11
401403371,Saint Joseph's Hawks,E. Reynolds II,4683952,,True,39.0,3,17,3,7,0,10,0,0,0,2,2,2,2,0,7,5,6
401403371,Saint Joseph's Hawks,C. Brown,4592476,,True,31.0,3,13,2,6,1,7,0,0,2,2,4,1,2,1,0,1,7
401403371,Saint Joseph's Hawks,C. Coleman,4431807,,False,27.0,7,9,3,4,4,5,0,0,2,9,11,1,0,0,1,3,18
401403371,Saint Joseph's Hawks,J. Forrest,4701032,,False,19.0,0,2,0,1,0,1,0,0,0,1,1,0,0,1,0,4,0
401403371,Saint Joseph's Hawks,D. Bishop,4701028,,False,5.0,0,0,0,0,0,0,0,0,0,0,0,0,0,0,0,0,0
401403371,Saint Joseph's Hawks,TEAM,TOTAL,TOTAL,False,,24,68,16,40,8,28,0,2,14,32,46,11,6,2,14,16,56
401403371,La Salle Explorers,C. Moore,4277945,,True,36.0,7,15,5,10,2,5,3,6,2,5,7,1,0,4,0,0,19
401403371,La Salle Explorers,J. Clark,4397152,,True,33.0,9,20,8,17,1,3,1,3,3,10,13,3,1,0,1,2,20
401403371,La Salle Explorers,J. Brickus,4700970,,True,24.0,0,3,0,0,0,3,0,2,0,3,3,1,3,0,2,1,0
401403371,La Salle Explorers,A. Gill,4700969,,True,24.0,3,5,2,4,1,1,0,0,1,2,3,4,0,1,3,3,7
401403371,La Salle Explorers,C. Ray,4592448,,True,36.0,2,5,0,0,2,5,0,0,1,3,4,0,2,1,1,1,6
401403371,La Salle Explorers,M. Doucoure,4277988,,False,7.0,0,0,0,0,0,0,0,0,0,1,1,0,0,0,0,0,0
401403371,La Salle Explorers,D. Shepherd,4710357,,False,1.0,0,0,0,0,0,0,0,0,0,0,0,0,0,0,0,0,0
401403371,La Salle Explorers,K. Brantley,4709132,,False,20.0,1,6,1,4,0,2,4,5,0,2,2,0,3,0,2,0,6
401403371,La Salle Explorers,J. Nickelberry,4432845,,False,19.0,2,5,1,2,1,3,0,0,0,3,3,3,0,0,0,0,5
401403371,La Salle Explorers,TEAM,TOTAL,TOTAL,False,,24,59,17,37,7,22,8,16,9,29,38,12,9,6,9,7,63
401403371,La Salle Explorers,C. Moore,4277945,,True,36.0,7,15,5,10,2,5,3,6,2,5,7,1,0,4,0,0,19
401403371,La Salle Explorers,J. Clark,4397152,,True,33.0,9,20,8,17,1,3,1,3,3,10,13,3,1,0,1,2,20
401403371,La Salle Explorers,J. Brickus,4700970,,True,24.0,0,3,0,0,0,3,0,2,0,3,3,1,3,0,2,1,0
401403371,La Salle Explorers,A. Gill,4700969,,True,24.0,3,5,2,4,1,1,0,0,1,2,3,4,0,1,3,3,7
401403371,La Salle Explorers,C. Ray,4592448,,True,36.0,2,5,0,0,2,5,0,0,1,3,4,0,2,1,1,1,6
401403371,La Salle Explorers,M. Doucoure,4277988,,False,7.0,0,0,0,0,0,0,0,0,0,1,1,0,0,0,0,0,0
401403371,La Salle Explorers,D. Shepherd,4710357,,False,1.0,0,0,0,0,0,0,0,0,0,0,0,0,0,0,0,0,0
401403371,La Salle Explorers,K. Brantley,4709132,,False,20.0,1,6,1,4,0,2,4,5,0,2,2,0,3,0,2,0,6
401403371,La Salle Explorers,J. Nickelberry,4432845,,False,19.0,2,5,1,2,1,3,0,0,0,3,3,3,0,0,0,0,5
401403371,La Salle Explorers,TEAM,TOTAL,TOTAL,False,,24,59,17,37,7,22,8,16,9,29,38,12,9,6,9,7,63
401403072,Fordham Rams,A. Tsimbila,4702329,,True,23.0,1,2,1,2,0,0,0,0,1,3,4,0,2,4,0,4,2
401403072,Fordham Rams,A. Charlton,4897085,,True,34.0,2,13,1,9,1,4,0,0,0,5,5,5,3,0,1,4,5
401403072,Fordham Rams,J. Navarro,4592316,,True,30.0,6,10,3,3,3,7,0,0,0,1,1,2,4,0,3,2,15
401403072,Fordham Rams,K. Rose,4592315,,True,29.0,4,6,1,1,3,5,0,0,1,1,2,0,2,0,1,2,11
401403072,Fordham Rams,D. Quisenberry,4397790,,True,36.0,4,16,2,8,2,8,7,7,0,5,5,4,1,0,2,1,17
401403072,Fordham Rams,P. Kelly,4432014,,False,14.0,3,6,1,2,2,4,0,0,2,2,4,0,0,0,2,1,8
401403072,Fordham Rams,R. Novitskyi,4897084,,False,9.0,0,1,0,1,0,0,0,0,0,3,3,1,0,1,0,3,0
401403072,Fordham Rams,A. Harrison,4897086,,False,14.0,0,3,0,2,0,1,0,0,0,0,0,2,1,0,1,0,0
401403072,Fordham Rams,K. Cunningham,4705891,,False,11.0,1,2,0,0,1,2,0,0,0,0,0,0,0,0,0,0,3
401403072,Fordham Rams,TEAM,TOTAL,TOTAL,False,,21,59,9,28,12,31,7,7,4,20,24,14,13,5,10,17,61
401403072,Fordham Rams,A. Tsimbila,4702329,,True,23.0,1,2,1,2,0,0,0,0,1,3,4,0,2,4,0,4,2
401403072,Fordham Rams,A. Charlton,4897085,,True,34.0,2,13,1,9,1,4,0,0,0,5,5,5,3,0,1,4,5
401403072,Fordham Rams,J. Navarro,4592316,,True,30.0,6,10,3,3,3,7,0,0,0,1,1,2,4,0,3,2,15
401403072,Fordham Rams,K. Rose,4592315,,True,29.0,4,6,1,1,3,5,0,0,1,1,2,0,2,0,1,2,11
401403072,Fordham Rams,D. Quisenberry,4397790,,True,36.0,4,16,2,8,2,8,7,7,0,5,5,4,1,0,2,1,17
401403072,Fordham Rams,P. Kelly,4432014,,False,14.0,3,6,1,2,2,4,0,0,2,2,4,0,0,0,2,1,8
401403072,Fordham Rams,R. Novitskyi,4897084,,False,9.0,0,1,0,1,0,0,0,0,0,3,3,1,0,1,0,3,0
401403072,Fordham Rams,A. Harrison,4897086,,False,14.0,0,3,0,2,0,1,0,0,0,0,0,2,1,0,1,0,0
401403072,Fordham Rams,K. Cunningham,4705891,,False,11.0,1,2,0,0,1,2,0,0,0,0,0,0,0,0,0,0,3
401403072,Fordham Rams,TEAM,TOTAL,TOTAL,False,,21,59,9,28,12,31,7,7,4,20,24,14,13,5,10,17,61
401403072,Dayton Flyers,R.J. Blakney,4700864,,True,25.0,2,4,0,0,2,4,2,2,0,4,4,0,1,1,1,2,8
401403072,Dayton Flyers,T. Camara,4431736,,True,25.0,4,13,3,10,1,3,2,2,1,3,4,1,2,0,3,1,11
401403072,Dayton Flyers,D. Holmes II,4433607,,True,36.0,8,13,8,13,0,0,3,5,3,9,12,2,0,3,4,1,19
401403072,Dayton Flyers,M. Smith,4683861,,True,28.0,4,8,3,4,1,4,4,5,0,5,5,1,2,0,3,2,13
401403072,Dayton Flyers,K. Elvis,4683135,,True,30.0,2,5,2,5,0,0,0,0,0,1,1,5,1,0,2,2,4
401403072,Dayton Flyers,M. Sissoko,4431824,,False,4.0,0,0,0,0,0,0,2,2,2,2,4,0,0,0,2,0,2
401403072,Dayton Flyers,M. Amzil,4711607,,False,25.0,2,5,1,1,1,4,1,2,1,3,4,4,0,0,1,0,6
401403072,Dayton Flyers,K. Brea,4591259,,False,27.0,1,2,0,0,1,2,2,2,0,4,4,1,0,0,1,0,5
401403072,Dayton Flyers,TEAM,TOTAL,TOTAL,False,,23,50,17,33,6,17,16,20,10,34,44,14,6,4,18,8,68
401403072,Dayton Flyers,R.J. Blakney,4700864,,True,25.0,2,4,0,0,2,4,2,2,0,4,4,0,1,1,1,2,8
401403072,Dayton Flyers,T. Camara,4431736,,True,25.0,4,13,3,10,1,3,2,2,1,3,4,1,2,0,3,1,11
401403072,Dayton Flyers,D. Holmes II,4433607,,True,36.0,8,13,8,13,0,0,3,5,3,9,12,2,0,3,4,1,19
401403072,Dayton Flyers,M. Smith,4683861,,True,28.0,4,8,3,4,1,4,4,5,0,5,5,1,2,0,3,2,13
401403072,Dayton Flyers,K. Elvis,4683135,,True,30.0,2,5,2,5,0,0,0,0,0,1,1,5,1,0,2,2,4
401403072,Dayton Flyers,M. Sissoko,4431824,,False,4.0,0,0,0,0,0,0,2,2,2,2,4,0,0,0,2,0,2
401403072,Dayton Flyers,M. Amzil,4711607,,False,25.0,2,5,1,1,1,4,1,2,1,3,4,4,0,0,1,0,6
401403072,Dayton Flyers,K. Brea,4591259,,False,27.0,1,2,0,0,1,2,2,2,0,4,4,1,0,0,1,0,5
401403072,Dayton Flyers,TEAM,TOTAL,TOTAL,False,,23,50,17,33,6,17,16,20,10,34,44,14,6,4,18,8,68
401403071,St. Bonaventure Bonnies,O. Osunniyi,4397224,,True,30.0,4,7,4,7,0,0,1,2,2,2,4,1,0,4,1,1,9
401403071,St. Bonaventure Bonnies,J. Adaway,4279431,,True,38.0,6,12,3,7,3,5,0,0,1,5,6,0,0,1,0,3,15
401403071,St. Bonaventure Bonnies,J. Holmes,4701016,,True,40.0,1,12,1,6,0,6,3,4,2,3,5,2,1,0,3,3,5
401403071,St. Bonaventure Bonnies,D. Welch,4397221,,True,38.0,1,6,1,1,0,5,2,2,0,6,6,2,1,0,1,0,4
401403071,St. Bonaventure Bonnies,K. Lofton,4397220,,True,33.0,3,11,2,4,1,7,0,0,0,0,0,5,0,0,1,2,7
401403071,St. Bonaventure Bonnies,A. Coulibaly,4432889,,False,10.0,3,5,3,5,0,0,2,3,3,0,3,0,0,1,0,2,8
401403071,St. Bonaventure Bonnies,J. Ndjock-Tadjore,4897048,,False,1.0,0,0,0,0,0,0,0,0,0,0,0,0,0,0,0,0,0
401403071,St. Bonaventure Bonnies,J. Saizonou,4897046,,False,1.0,0,0,0,0,0,0,0,0,0,0,0,0,0,0,1,0,0
401403071,St. Bonaventure Bonnies,Q. Adams,4585591,,False,9.0,1,1,1,1,0,0,0,0,0,0,0,0,0,0,0,0,2
401403071,St. Bonaventure Bonnies,TEAM,TOTAL,TOTAL,False,,19,54,15,31,4,23,8,11,9,21,30,10,2,6,8,11,50
401403071,St. Bonaventure Bonnies,O. Osunniyi,4397224,,True,30.0,4,7,4,7,0,0,1,2,2,2,4,1,0,4,1,1,9
401403071,St. Bonaventure Bonnies,J. Adaway,4279431,,True,38.0,6,12,3,7,3,5,0,0,1,5,6,0,0,1,0,3,15
401403071,St. Bonaventure Bonnies,J. Holmes,4701016,,True,40.0,1,12,1,6,0,6,3,4,2,3,5,2,1,0,3,3,5
401403071,St. Bonaventure Bonnies,D. Welch,4397221,,True,38.0,1,6,1,1,0,5,2,2,0,6,6,2,1,0,1,0,4
401403071,St. Bonaventure Bonnies,K. Lofton,4397220,,True,33.0,3,11,2,4,1,7,0,0,0,0,0,5,0,0,1,2,7
401403071,St. Bonaventure Bonnies,A. Coulibaly,4432889,,False,10.0,3,5,3,5,0,0,2,3,3,0,3,0,0,1,0,2,8
401403071,St. Bonaventure Bonnies,J. Ndjock-Tadjore,4897048,,False,1.0,0,0,0,0,0,0,0,0,0,0,0,0,0,0,0,0,0
401403071,St. Bonaventure Bonnies,J. Saizonou,4897046,,False,1.0,0,0,0,0,0,0,0,0,0,0,0,0,0,0,1,0,0
401403071,St. Bonaventure Bonnies,Q. Adams,4585591,,False,9.0,1,1,1,1,0,0,0,0,0,0,0,0,0,0,0,0,2
401403071,St. Bonaventure Bonnies,TEAM,TOTAL,TOTAL,False,,19,54,15,31,4,23,8,11,9,21,30,10,2,6,8,11,50
401403071,Dayton Flyers,R.J. Blakney,4700864,,True,17.0,1,4,1,2,0,2,0,0,1,1,2,0,1,0,0,0,2
401403071,Dayton Flyers,T. Camara,4431736,,True,32.0,3,7,3,7,0,0,0,2,0,7,7,4,0,1,0,3,6
401403071,Dayton Flyers,D. Holmes II,4433607,,True,35.0,10,12,10,12,0,0,0,2,1,6,7,1,0,3,1,2,20
401403071,Dayton Flyers,M. Smith,4683861,,True,34.0,2,7,2,7,0,0,2,2,0,3,3,12,1,0,3,2,6
401403071,Dayton Flyers,K. Elvis,4683135,,True,21.0,5,10,1,4,4,6,0,0,0,0,0,0,0,0,2,1,14
401403071,Dayton Flyers,M. Amzil,4711607,,False,28.0,0,3,0,0,0,3,0,0,1,6,7,0,0,2,1,2,0
401403071,Dayton Flyers,K. Washington,4684293,,False,0.0,0,0,0,0,0,0,0,0,0,0,0,0,0,0,0,0,0
401403071,Dayton Flyers,Z. Nwokeji,4618121,,False,0.0,0,0,0,0,0,0,0,0,0,0,0,0,0,0,0,0,0
401403071,Dayton Flyers,C. Wilson,4403456,,False,0.0,0,0,0,0,0,0,0,0,0,0,0,0,1,0,0,0,0
401403071,Dayton Flyers,B. Uhl,4897094,,False,0.0,0,0,0,0,0,0,0,0,0,0,0,0,0,0,0,0,0
401403071,Dayton Flyers,D. Swerlein,4600089,,False,0.0,0,0,0,0,0,0,0,0,0,0,0,0,0,0,0,0,0
401403071,Dayton Flyers,K. Brea,4591259,,False,24.0,7,9,1,2,6,7,0,0,0,1,1,2,0,1,0,1,20
401403071,Dayton Flyers,E. Weaver,4397139,,False,9.0,0,0,0,0,0,0,0,0,0,0,0,1,0,0,0,0,0
401403071,Dayton Flyers,TEAM,TOTAL,TOTAL,False,,28,52,18,34,10,18,2,6,6,26,32,20,3,7,9,11,68
401403071,Dayton Flyers,R.J. Blakney,4700864,,True,17.0,1,4,1,2,0,2,0,0,1,1,2,0,1,0,0,0,2
401403071,Dayton Flyers,T. Camara,4431736,,True,32.0,3,7,3,7,0,0,0,2,0,7,7,4,0,1,0,3,6
401403071,Dayton Flyers,D. Holmes II,4433607,,True,35.0,10,12,10,12,0,0,0,2,1,6,7,1,0,3,1,2,20
401403071,Dayton Flyers,M. Smith,4683861,,True,34.0,2,7,2,7,0,0,2,2,0,3,3,12,1,0,3,2,6
401403071,Dayton Flyers,K. Elvis,4683135,,True,21.0,5,10,1,4,4,6,0,0,0,0,0,0,0,0,2,1,14
401403071,Dayton Flyers,M. Amzil,4711607,,False,28.0,0,3,0,0,0,3,0,0,1,6,7,0,0,2,1,2,0
401403071,Dayton Flyers,K. Washington,4684293,,False,0.0,0,0,0,0,0,0,0,0,0,0,0,0,0,0,0,0,0
401403071,Dayton Flyers,Z. Nwokeji,4618121,,False,0.0,0,0,0,0,0,0,0,0,0,0,0,0,0,0,0,0,0
401403071,Dayton Flyers,C. Wilson,4403456,,False,0.0,0,0,0,0,0,0,0,0,0,0,0,0,1,0,0,0,0
401403071,Dayton Flyers,B. Uhl,4897094,,False,0.0,0,0,0,0,0,0,0,0,0,0,0,0,0,0,0,0,0
401403071,Dayton Flyers,D. Swerlein,4600089,,False,0.0,0,0,0,0,0,0,0,0,0,0,0,0,0,0,0,0,0
401403071,Dayton Flyers,K. Brea,4591259,,False,24.0,7,9,1,2,6,7,0,0,0,1,1,2,0,1,0,1,20
401403071,Dayton Flyers,E. Weaver,4397139,,False,9.0,0,0,0,0,0,0,0,0,0,0,0,1,0,0,0,0,0
401403071,Dayton Flyers,TEAM,TOTAL,TOTAL,False,,28,52,18,34,10,18,2,6,6,26,32,20,3,7,9,11,68
401402792,Saint Louis Billikens,T. Hargrove Jr.,4592484,,True,25.0,2,8,1,3,1,5,2,2,2,5,7,1,1,1,4,0,7
401402792,Saint Louis Billikens,F. Okoro,4397105,,True,29.0,5,8,5,8,0,0,3,4,5,9,14,0,0,4,3,4,13
401402792,Saint Louis Billikens,J. Nesbitt,4714246,,True,34.0,3,11,2,8,1,3,8,8,4,1,5,1,0,0,2,5,15
401402792,Saint Louis Billikens,Y. Collins,4432957,,True,37.0,1,7,0,6,1,1,8,8,1,7,8,3,0,0,3,3,11
401402792,Saint Louis Billikens,G. Jimerson,4432008,,True,35.0,5,13,5,9,0,4,3,3,0,1,1,1,3,0,1,2,13
401402792,Saint Louis Billikens,L. Traore,4897052,,False,11.0,0,0,0,0,0,0,0,0,1,0,1,0,0,1,1,2,0
401402792,Saint Louis Billikens,M. Strickland,4432494,,False,2.0,0,2,0,2,0,0,0,0,0,0,0,0,0,0,0,0,0
401402792,Saint Louis Billikens,F. Thatch Jr.,4397199,,False,22.0,4,9,4,8,0,1,1,1,4,3,7,1,3,0,2,4,9
401402792,Saint Louis Billikens,D. Jones,4278267,,False,5.0,0,0,0,0,0,0,0,0,0,0,0,0,0,0,1,0,0
401402792,Saint Louis Billikens,TEAM,TOTAL,TOTAL,False,,20,58,17,44,3,14,25,26,21,27,48,7,7,6,19,20,68
401402792,Iona Gaels,Q. Slazinski,4431768,,True,25.0,3,7,2,3,1,4,8,8,1,2,3,0,2,1,1,1,15
401402792,Iona Gaels,N. Junior Joseph,4703015,,True,30.0,3,10,3,10,0,0,4,6,4,2,6,2,2,4,3,1,10
401402792,Iona Gaels,B. JeanLouis,4703008,,True,15.0,0,1,0,1,0,0,0,0,3,0,3,2,1,0,0,5,0
401402792,Iona Gaels,E. Joiner,4278407,,True,32.0,3,15,3,8,0,7,1,2,1,4,5,2,2,0,0,4,7
401402792,Iona Gaels,T. Jolly,4066291,,True,38.0,5,13,4,9,1,4,5,8,2,2,4,2,2,2,3,1,16
401402792,Iona Gaels,T. James,4715444,,False,0.0,0,0,0,0,0,0,0,0,0,0,0,0,0,0,0,0,0
401402792,Iona Gaels,O. Shema,4703016,,False,10.0,0,0,0,0,0,0,0,0,1,0,1,0,0,0,0,1,0
401402792,Iona Gaels,D. van Eyck,4593320,,False,15.0,1,4,1,2,0,2,1,2,2,0,2,2,0,0,0,1,3
401402792,Iona Gaels,W. Clayton Jr.,4896372,,False,18.0,3,5,3,4,0,1,0,0,0,3,3,0,0,1,2,3,6
401402792,Iona Gaels,R. Myers,4703009,,False,12.0,4,7,2,3,2,4,0,0,0,1,1,0,0,1,0,3,10
401402792,Iona Gaels,C. Cashaw,4593318,,False,2.0,0,0,0,0,0,0,0,0,0,0,0,0,0,0,0,0,0
401402792,Iona Gaels,P. Weiss,4593317,,False,3.0,0,0,0,0,0,0,0,0,0,0,0,0,2,0,0,1,0
401402792,Iona Gaels,TEAM,TOTAL,TOTAL,False,,22,62,18,40,4,22,19,26,17,17,34,10,11,9,9,21,67
401402160,Rhode Island Rams,Makhel Mitchell,4431777,,True,21.0,3,9,3,9,0,0,2,2,1,7,8,1,0,1,2,4,8
401402160,Rhode Island Rams,Makhi Mitchell,4431708,,True,29.0,3,12,3,11,0,1,1,2,3,8,11,1,0,3,1,2,7
401402160,Rhode Island Rams,I. Leggett,4606837,,True,27.0,3,6,3,4,0,2,3,4,0,4,4,2,1,0,1,3,9
401402160,Rhode Island Rams,I. El-Amin,4279313,,True,17.0,2,4,1,2,1,2,0,0,0,1,1,0,0,0,1,1,5
401402160,Rhode Island Rams,J. Sheppard,4066445,,True,29.0,3,5,2,2,1,3,2,2,1,1,2,4,1,0,3,2,9
401402160,Rhode Island Rams,A. Walker,4278567,,False,25.0,4,7,3,6,1,1,0,0,1,3,4,2,0,1,0,0,9
401402160,Rhode Island Rams,M. Martin,4397470,,False,18.0,0,3,0,2,0,1,2,2,1,3,4,0,0,0,1,0,2
401402160,Rhode Island Rams,J. Carey,4395673,,False,23.0,3,7,2,6,1,1,1,2,0,3,3,2,1,0,1,2,8
401402160,Rhode Island Rams,S. Thomas,4897065,,False,11.0,0,2,0,1,0,1,0,0,0,1,1,2,1,0,0,0,0
401402160,Rhode Island Rams,TEAM,TOTAL,TOTAL,False,,21,55,17,43,4,12,11,14,7,31,38,14,4,5,11,14,57
401402160,Rhode Island Rams,Makhel Mitchell,4431777,,True,21.0,3,9,3,9,0,0,2,2,1,7,8,1,0,1,2,4,8
401402160,Rhode Island Rams,Makhi Mitchell,4431708,,True,29.0,3,12,3,11,0,1,1,2,3,8,11,1,0,3,1,2,7
401402160,Rhode Island Rams,I. Leggett,4606837,,True,27.0,3,6,3,4,0,2,3,4,0,4,4,2,1,0,1,3,9
401402160,Rhode Island Rams,I. El-Amin,4279313,,True,17.0,2,4,1,2,1,2,0,0,0,1,1,0,0,0,1,1,5
401402160,Rhode Island Rams,J. Sheppard,4066445,,True,29.0,3,5,2,2,1,3,2,2,1,1,2,4,1,0,3,2,9
401402160,Rhode Island Rams,A. Walker,4278567,,False,25.0,4,7,3,6,1,1,0,0,1,3,4,2,0,1,0,0,9
401402160,Rhode Island Rams,M. Martin,4397470,,False,18.0,0,3,0,2,0,1,2,2,1,3,4,0,0,0,1,0,2
401402160,Rhode Island Rams,J. Carey,4395673,,False,23.0,3,7,2,6,1,1,1,2,0,3,3,2,1,0,1,2,8
401402160,Rhode Island Rams,S. Thomas,4897065,,False,11.0,0,2,0,1,0,1,0,0,0,1,1,2,1,0,0,0,0
401402160,Rhode Island Rams,TEAM,TOTAL,TOTAL,False,,21,55,17,43,4,12,11,14,7,31,38,14,4,5,11,14,57
401402160,Dayton Flyers,R.J. Blakney,4700864,,True,27.0,2,8,0,3,2,5,4,4,3,5,8,1,2,1,1,1,10
401402160,Dayton Flyers,T. Camara,4431736,,True,33.0,7,13,4,8,3,5,0,1,1,6,7,1,1,1,2,4,17
401402160,Dayton Flyers,D. Holmes II,4433607,,True,22.0,3,8,3,8,0,0,2,5,3,2,5,1,0,0,1,3,8
401402160,Dayton Flyers,M. Smith,4683861,,True,36.0,0,6,0,6,0,0,2,2,1,3,4,6,3,0,1,2,2
401402160,Dayton Flyers,K. Elvis,4683135,,True,23.0,1,6,0,3,1,3,0,0,1,2,3,3,1,0,2,2,3
401402160,Dayton Flyers,M. Sissoko,4431824,,False,4.0,0,0,0,0,0,0,0,0,0,2,2,0,0,1,0,0,0
401402160,Dayton Flyers,M. Amzil,4711607,,False,24.0,2,5,1,2,1,3,6,8,0,4,4,1,0,1,1,2,11
401402160,Dayton Flyers,K. Brea,4591259,,False,27.0,4,11,0,3,4,8,0,0,0,3,3,2,0,0,0,0,12
401402160,Dayton Flyers,E. Weaver,4397139,,False,4.0,0,0,0,0,0,0,0,0,0,0,0,0,0,0,0,0,0
401402160,Dayton Flyers,TEAM,TOTAL,TOTAL,False,,19,57,8,33,11,24,14,20,10,28,38,15,7,4,9,14,63
401402160,Dayton Flyers,R.J. Blakney,4700864,,True,27.0,2,8,0,3,2,5,4,4,3,5,8,1,2,1,1,1,10
401402160,Dayton Flyers,T. Camara,4431736,,True,33.0,7,13,4,8,3,5,0,1,1,6,7,1,1,1,2,4,17
401402160,Dayton Flyers,D. Holmes II,4433607,,True,22.0,3,8,3,8,0,0,2,5,3,2,5,1,0,0,1,3,8
401402160,Dayton Flyers,M. Smith,4683861,,True,36.0,0,6,0,6,0,0,2,2,1,3,4,6,3,0,1,2,2
401402160,Dayton Flyers,K. Elvis,4683135,,True,23.0,1,6,0,3,1,3,0,0,1,2,3,3,1,0,2,2,3
401402160,Dayton Flyers,M. Sissoko,4431824,,False,4.0,0,0,0,0,0,0,0,0,0,2,2,0,0,1,0,0,0
401402160,Dayton Flyers,M. Amzil,4711607,,False,24.0,2,5,1,2,1,3,6,8,0,4,4,1,0,1,1,2,11
401402160,Dayton Flyers,K. Brea,4591259,,False,27.0,4,11,0,3,4,8,0,0,0,3,3,2,0,0,0,0,12
401402160,Dayton Flyers,E. Weaver,4397139,,False,4.0,0,0,0,0,0,0,0,0,0,0,0,0,0,0,0,0,0
401402160,Dayton Flyers,TEAM,TOTAL,TOTAL,False,,19,57,8,33,11,24,14,20,10,28,38,15,7,4,9,14,63
401402051,VCU Rams,H. Ward,4592495,,True,10.0,0,3,0,3,0,0,0,0,0,0,0,0,0,0,0,0,0
401402051,VCU Rams,V. Williams Jr.,4397227,,True,34.0,3,6,2,2,1,4,1,1,0,3,3,1,0,1,3,3,8
401402051,VCU Rams,J. Nunn,4896614,,True,34.0,5,9,3,6,2,3,1,2,0,5,5,0,1,0,1,1,13
401402051,VCU Rams,A. Baldwin Jr.,4433182,,True,38.0,5,15,4,10,1,5,7,8,2,5,7,4,6,1,3,3,18
401402051,VCU Rams,K. Curry,4397228,,True,38.0,5,8,5,6,0,2,2,3,2,4,6,2,2,0,1,3,12
401402051,VCU Rams,M. Brown-Jones,4433224,,False,15.0,4,4,4,4,0,0,7,8,2,4,6,0,1,0,0,1,15
401402051,VCU Rams,J. DeLoach,4432483,,False,9.0,1,1,1,1,0,0,2,3,2,1,3,0,1,0,2,6,4
401402051,VCU Rams,L. Stockard III,4277897,,False,12.0,0,3,0,3,0,0,0,2,0,0,0,1,2,0,1,1,0
401402051,VCU Rams,N. Kern,4684145,,False,4.0,1,1,1,1,0,0,0,0,1,1,2,0,0,0,0,1,2
401402051,VCU Rams,M. Tsohonis,4592438,,False,6.0,0,2,0,1,0,1,0,0,0,0,0,0,0,0,2,0,0
401402051,VCU Rams,TEAM,TOTAL,TOTAL,False,,24,52,20,37,4,15,20,27,10,25,35,8,13,2,13,19,72
401402051,VCU Rams,H. Ward,4592495,,True,10.0,0,3,0,3,0,0,0,0,0,0,0,0,0,0,0,0,0
401402051,VCU Rams,V. Williams Jr.,4397227,,True,34.0,3,6,2,2,1,4,1,1,0,3,3,1,0,1,3,3,8
401402051,VCU Rams,J. Nunn,4896614,,True,34.0,5,9,3,6,2,3,1,2,0,5,5,0,1,0,1,1,13
401402051,VCU Rams,A. Baldwin Jr.,4433182,,True,38.0,5,15,4,10,1,5,7,8,2,5,7,4,6,1,3,3,18
401402051,VCU Rams,K. Curry,4397228,,True,38.0,5,8,5,6,0,2,2,3,2,4,6,2,2,0,1,3,12
401402051,VCU Rams,M. Brown-Jones,4433224,,False,15.0,4,4,4,4,0,0,7,8,2,4,6,0,1,0,0,1,15
401402051,VCU Rams,J. DeLoach,4432483,,False,9.0,1,1,1,1,0,0,2,3,2,1,3,0,1,0,2,6,4
401402051,VCU Rams,L. Stockard III,4277897,,False,12.0,0,3,0,3,0,0,0,2,0,0,0,1,2,0,1,1,0
401402051,VCU Rams,N. Kern,4684145,,False,4.0,1,1,1,1,0,0,0,0,1,1,2,0,0,0,0,1,2
401402051,VCU Rams,M. Tsohonis,4592438,,False,6.0,0,2,0,1,0,1,0,0,0,0,0,0,0,0,2,0,0
401402051,VCU Rams,TEAM,TOTAL,TOTAL,False,,24,52,20,37,4,15,20,27,10,25,35,8,13,2,13,19,72
401402051,George Mason Patriots,J. Oduro,4432068,,True,24.0,6,8,6,8,0,0,1,4,3,4,7,2,0,0,2,4,13
401402051,George Mason Patriots,X. Johnson,4592439,,True,28.0,3,7,2,4,1,3,0,0,0,4,4,5,1,0,3,5,7
401402051,George Mason Patriots,D. Gaines,4431961,,True,36.0,2,9,0,2,2,7,2,2,1,6,7,1,1,0,2,3,8
401402051,George Mason Patriots,D. Cooper,4279876,,True,36.0,1,7,0,0,1,7,0,0,0,4,4,3,1,0,2,3,3
401402051,George Mason Patriots,D. Schwartz,4278501,,True,36.0,8,15,5,7,3,8,3,5,1,1,2,2,1,0,2,2,22
401402051,George Mason Patriots,M. Henry,4606836,,False,4.0,0,0,0,0,0,0,0,0,0,0,0,0,0,1,1,1,0
401402051,George Mason Patriots,O. Frazier III,4700882,,False,12.0,4,4,4,4,0,0,0,1,1,0,1,1,1,0,1,4,8
401402051,George Mason Patriots,B. Buchanan,4395691,,False,8.0,0,0,0,0,0,0,0,0,0,0,0,0,1,0,2,1,0
401402051,George Mason Patriots,T. Gadsden,4719466,,False,2.0,0,0,0,0,0,0,0,0,0,0,0,0,0,0,0,0,0
401402051,George Mason Patriots,R. Polite III,4567711,,False,14.0,2,6,1,3,1,3,0,0,1,2,3,1,2,0,2,1,5
401402051,George Mason Patriots,TEAM,TOTAL,TOTAL,False,,26,56,18,28,8,28,6,12,9,22,31,15,8,1,18,24,66
401402051,George Mason Patriots,J. Oduro,4432068,,True,24.0,6,8,6,8,0,0,1,4,3,4,7,2,0,0,2,4,13
401402051,George Mason Patriots,X. Johnson,4592439,,True,28.0,3,7,2,4,1,3,0,0,0,4,4,5,1,0,3,5,7
401402051,George Mason Patriots,D. Gaines,4431961,,True,36.0,2,9,0,2,2,7,2,2,1,6,7,1,1,0,2,3,8
401402051,George Mason Patriots,D. Cooper,4279876,,True,36.0,1,7,0,0,1,7,0,0,0,4,4,3,1,0,2,3,3
401402051,George Mason Patriots,D. Schwartz,4278501,,True,36.0,8,15,5,7,3,8,3,5,1,1,2,2,1,0,2,2,22
401402051,George Mason Patriots,M. Henry,4606836,,False,4.0,0,0,0,0,0,0,0,0,0,0,0,0,0,1,1,1,0
401402051,George Mason Patriots,O. Frazier III,4700882,,False,12.0,4,4,4,4,0,0,0,1,1,0,1,1,1,0,1,4,8
401402051,George Mason Patriots,B. Buchanan,4395691,,False,8.0,0,0,0,0,0,0,0,0,0,0,0,0,1,0,2,1,0
401402051,George Mason Patriots,T. Gadsden,4719466,,False,2.0,0,0,0,0,0,0,0,0,0,0,0,0,0,0,0,0,0
401402051,George Mason Patriots,R. Polite III,4567711,,False,14.0,2,6,1,3,1,3,0,0,1,2,3,1,2,0,2,1,5
401402051,George Mason Patriots,TEAM,TOTAL,TOTAL,False,,26,56,18,28,8,28,6,12,9,22,31,15,8,1,18,24,66
401402048,St. Bonaventure Bonnies,O. Osunniyi,4397224,,True,31.0,2,7,2,7,0,0,4,4,5,7,12,4,1,3,2,0,8
401402048,St. Bonaventure Bonnies,J. Adaway,4279431,,True,39.0,6,13,5,12,1,1,0,1,3,6,9,4,1,0,1,3,13
401402048,St. Bonaventure Bonnies,J. Holmes,4701016,,True,33.0,2,14,1,11,1,3,2,2,4,4,8,5,0,0,0,2,7
401402048,St. Bonaventure Bonnies,D. Welch,4397221,,True,39.0,8,15,3,8,5,7,0,0,2,8,10,1,2,2,1,1,21
401402048,St. Bonaventure Bonnies,K. Lofton,4397220,,True,39.0,8,15,8,13,0,2,3,3,2,3,5,1,3,0,5,1,19
401402048,St. Bonaventure Bonnies,O. Durosinmi,4684462,,False,1.0,0,0,0,0,0,0,0,0,0,0,0,0,0,0,0,0,0
401402048,St. Bonaventure Bonnies,A. Coulibaly,4432889,,False,8.0,2,5,2,4,0,1,0,1,1,1,2,0,0,0,0,3,4
401402048,St. Bonaventure Bonnies,J. Ndjock-Tadjore,4897048,,False,1.0,0,0,0,0,0,0,0,0,0,0,0,0,0,0,1,0,0
401402048,St. Bonaventure Bonnies,J. Saizonou,4897046,,False,1.0,0,0,0,0,0,0,0,0,0,0,0,0,0,0,0,0,0
401402048,St. Bonaventure Bonnies,Q. Adams,4585591,,False,8.0,2,4,2,4,0,0,0,0,0,0,0,0,0,0,1,1,4
401402048,St. Bonaventure Bonnies,TEAM,TOTAL,TOTAL,False,,30,73,23,59,7,14,9,11,19,33,52,15,7,5,11,11,76
401402048,St. Bonaventure Bonnies,O. Osunniyi,4397224,,True,31.0,2,7,2,7,0,0,4,4,5,7,12,4,1,3,2,0,8
401402048,St. Bonaventure Bonnies,J. Adaway,4279431,,True,39.0,6,13,5,12,1,1,0,1,3,6,9,4,1,0,1,3,13
401402048,St. Bonaventure Bonnies,J. Holmes,4701016,,True,33.0,2,14,1,11,1,3,2,2,4,4,8,5,0,0,0,2,7
401402048,St. Bonaventure Bonnies,D. Welch,4397221,,True,39.0,8,15,3,8,5,7,0,0,2,8,10,1,2,2,1,1,21
401402048,St. Bonaventure Bonnies,K. Lofton,4397220,,True,39.0,8,15,8,13,0,2,3,3,2,3,5,1,3,0,5,1,19
401402048,St. Bonaventure Bonnies,O. Durosinmi,4684462,,False,1.0,0,0,0,0,0,0,0,0,0,0,0,0,0,0,0,0,0
401402048,St. Bonaventure Bonnies,A. Coulibaly,4432889,,False,8.0,2,5,2,4,0,1,0,1,1,1,2,0,0,0,0,3,4
401402048,St. Bonaventure Bonnies,J. Ndjock-Tadjore,4897048,,False,1.0,0,0,0,0,0,0,0,0,0,0,0,0,0,0,1,0,0
401402048,St. Bonaventure Bonnies,J. Saizonou,4897046,,False,1.0,0,0,0,0,0,0,0,0,0,0,0,0,0,0,0,0,0
401402048,St. Bonaventure Bonnies,Q. Adams,4585591,,False,8.0,2,4,2,4,0,0,0,0,0,0,0,0,0,0,1,1,4
401402048,St. Bonaventure Bonnies,TEAM,TOTAL,TOTAL,False,,30,73,23,59,7,14,9,11,19,33,52,15,7,5,11,11,76
401402048,Fordham Rams,A. Tsimbila,4702329,,True,15.0,2,4,2,4,0,0,0,2,2,1,3,0,0,0,0,2,4
401402048,Fordham Rams,C. Ohams,4066856,,True,22.0,3,10,3,10,0,0,0,3,2,9,11,0,0,0,2,1,6
401402048,Fordham Rams,A. Charlton,4897085,,True,31.0,5,10,3,4,2,6,2,4,1,5,6,3,2,0,3,2,14
401402048,Fordham Rams,J. Navarro,4592316,,True,33.0,2,12,0,0,2,12,0,0,1,1,2,3,0,0,1,0,6
401402048,Fordham Rams,D. Quisenberry,4397790,,True,25.0,3,11,2,7,1,4,2,2,1,2,3,1,1,0,0,1,9
401402048,Fordham Rams,P. Kelly,4432014,,False,14.0,1,2,0,0,1,2,0,0,1,1,2,1,0,1,0,0,3
401402048,Fordham Rams,R. Novitskyi,4897084,,False,14.0,0,0,0,0,0,0,0,0,0,1,1,0,0,1,4,1,0
401402048,Fordham Rams,K. Cunningham,4705891,,False,11.0,2,5,2,2,0,3,0,2,1,1,2,0,1,0,1,2,4
401402048,Fordham Rams,A. Evans,4700881,,False,1.0,0,0,0,0,0,0,0,0,0,0,0,0,0,0,0,0,0
401402048,Fordham Rams,K. Rose,4592315,,False,25.0,1,4,0,0,1,4,2,2,2,2,4,1,0,0,2,2,5
401402048,Fordham Rams,Z. Riley,4914388,,False,9.0,0,2,0,1,0,1,0,0,1,0,1,0,1,0,1,0,0
401402048,Fordham Rams,TEAM,TOTAL,TOTAL,False,,19,60,12,28,7,32,6,15,13,25,38,9,5,2,14,11,51
401402048,Fordham Rams,A. Tsimbila,4702329,,True,15.0,2,4,2,4,0,0,0,2,2,1,3,0,0,0,0,2,4
401402048,Fordham Rams,C. Ohams,4066856,,True,22.0,3,10,3,10,0,0,0,3,2,9,11,0,0,0,2,1,6
401402048,Fordham Rams,A. Charlton,4897085,,True,31.0,5,10,3,4,2,6,2,4,1,5,6,3,2,0,3,2,14
401402048,Fordham Rams,J. Navarro,4592316,,True,33.0,2,12,0,0,2,12,0,0,1,1,2,3,0,0,1,0,6
401402048,Fordham Rams,D. Quisenberry,4397790,,True,25.0,3,11,2,7,1,4,2,2,1,2,3,1,1,0,0,1,9
401402048,Fordham Rams,P. Kelly,4432014,,False,14.0,1,2,0,0,1,2,0,0,1,1,2,1,0,1,0,0,3
401402048,Fordham Rams,R. Novitskyi,4897084,,False,14.0,0,0,0,0,0,0,0,0,0,1,1,0,0,1,4,1,0
401402048,Fordham Rams,K. Cunningham,4705891,,False,11.0,2,5,2,2,0,3,0,2,1,1,2,0,1,0,1,2,4
401402048,Fordham Rams,A. Evans,4700881,,False,1.0,0,0,0,0,0,0,0,0,0,0,0,0,0,0,0,0,0
401402048,Fordham Rams,K. Rose,4592315,,False,25.0,1,4,0,0,1,4,2,2,2,2,4,1,0,0,2,2,5
401402048,Fordham Rams,Z. Riley,4914388,,False,9.0,0,2,0,1,0,1,0,0,1,0,1,0,1,0,1,0,0
401402048,Fordham Rams,TEAM,TOTAL,TOTAL,False,,19,60,12,28,7,32,6,15,13,25,38,9,5,2,14,11,51
401402047,Saint Joseph's Hawks,T. Funk,4278395,,True,39.0,9,20,7,14,2,6,2,2,3,7,10,1,1,0,3,2,22
401402047,Saint Joseph's Hawks,E. Obinna,4278125,,True,35.0,8,14,8,14,0,0,0,2,6,6,12,1,0,1,3,1,16
401402047,Saint Joseph's Hawks,J. Hall,4701031,,True,29.0,0,6,0,3,0,3,4,4,0,6,6,9,1,0,2,3,4
401402047,Saint Joseph's Hawks,E. Reynolds II,4683952,,True,38.0,8,15,7,10,1,5,2,2,0,2,2,2,1,1,1,1,19
401402047,Saint Joseph's Hawks,C. Brown,4592476,,True,31.0,3,6,2,3,1,3,0,0,1,5,6,3,1,1,0,2,7
401402047,Saint Joseph's Hawks,C. Coleman,4431807,,False,5.0,0,1,0,1,0,0,0,0,2,3,5,0,0,0,1,2,0
401402047,Saint Joseph's Hawks,D. Bishop,4701028,,False,23.0,1,4,1,4,0,0,2,3,1,2,3,0,1,2,1,2,4
401402047,Saint Joseph's Hawks,TEAM,TOTAL,TOTAL,False,,29,66,25,49,4,17,10,13,13,33,46,16,5,5,11,13,72
401402047,Saint Joseph's Hawks,T. Funk,4278395,,True,39.0,9,20,7,14,2,6,2,2,3,7,10,1,1,0,3,2,22
401402047,Saint Joseph's Hawks,E. Obinna,4278125,,True,35.0,8,14,8,14,0,0,0,2,6,6,12,1,0,1,3,1,16
401402047,Saint Joseph's Hawks,J. Hall,4701031,,True,29.0,0,6,0,3,0,3,4,4,0,6,6,9,1,0,2,3,4
401402047,Saint Joseph's Hawks,E. Reynolds II,4683952,,True,38.0,8,15,7,10,1,5,2,2,0,2,2,2,1,1,1,1,19
401402047,Saint Joseph's Hawks,C. Brown,4592476,,True,31.0,3,6,2,3,1,3,0,0,1,5,6,3,1,1,0,2,7
401402047,Saint Joseph's Hawks,C. Coleman,4431807,,False,5.0,0,1,0,1,0,0,0,0,2,3,5,0,0,0,1,2,0
401402047,Saint Joseph's Hawks,D. Bishop,4701028,,False,23.0,1,4,1,4,0,0,2,3,1,2,3,0,1,2,1,2,4
401402047,Saint Joseph's Hawks,TEAM,TOTAL,TOTAL,False,,29,66,25,49,4,17,10,13,13,33,46,16,5,5,11,13,72
401402047,George Washington Revolutionaries,H. Dean,4593273,,True,34.0,2,3,2,3,0,0,0,0,4,7,11,1,2,5,0,4,4
401402047,George Washington Revolutionaries,Q. Samuels,4592251,,True,26.0,2,8,1,2,1,6,1,1,0,0,0,0,0,0,0,3,6
401402047,George Washington Revolutionaries,B. Freeman,4613126,,True,27.0,6,13,6,11,0,2,1,5,1,3,4,2,2,0,1,3,13
401402047,George Washington Revolutionaries,J. Bamisile,4432537,,True,35.0,9,21,5,12,4,9,0,0,2,2,4,3,2,1,2,1,22
401402047,George Washington Revolutionaries,J. Bishop,4431770,,True,31.0,3,11,3,11,0,0,2,3,0,5,5,3,2,0,4,2,8
401402047,George Washington Revolutionaries,A. Harris,4397216,,False,23.0,2,5,2,2,0,3,0,0,0,0,0,2,1,0,0,3,4
401402047,George Washington Revolutionaries,B. Adams,4396612,,False,22.0,2,3,2,3,0,0,0,0,0,4,4,1,0,0,1,2,4
401402047,George Washington Revolutionaries,B. Knapp,4279473,,False,2.0,0,0,0,0,0,0,0,0,0,0,0,0,0,0,0,0,0
401402047,George Washington Revolutionaries,TEAM,TOTAL,TOTAL,False,,26,64,21,44,5,20,4,9,8,24,32,12,9,6,8,18,61
401402047,George Washington Revolutionaries,H. Dean,4593273,,True,34.0,2,3,2,3,0,0,0,0,4,7,11,1,2,5,0,4,4
401402047,George Washington Revolutionaries,Q. Samuels,4592251,,True,26.0,2,8,1,2,1,6,1,1,0,0,0,0,0,0,0,3,6
401402047,George Washington Revolutionaries,B. Freeman,4613126,,True,27.0,6,13,6,11,0,2,1,5,1,3,4,2,2,0,1,3,13
401402047,George Washington Revolutionaries,J. Bamisile,4432537,,True,35.0,9,21,5,12,4,9,0,0,2,2,4,3,2,1,2,1,22
401402047,George Washington Revolutionaries,J. Bishop,4431770,,True,31.0,3,11,3,11,0,0,2,3,0,5,5,3,2,0,4,2,8
401402047,George Washington Revolutionaries,A. Harris,4397216,,False,23.0,2,5,2,2,0,3,0,0,0,0,0,2,1,0,0,3,4
401402047,George Washington Revolutionaries,B. Adams,4396612,,False,22.0,2,3,2,3,0,0,0,0,0,4,4,1,0,0,1,2,4
401402047,George Washington Revolutionaries,B. Knapp,4279473,,False,2.0,0,0,0,0,0,0,0,0,0,0,0,0,0,0,0,0,0
401402047,George Washington Revolutionaries,TEAM,TOTAL,TOTAL,False,,26,64,21,44,5,20,4,9,8,24,32,12,9,6,8,18,61
401402046,VCU Rams,V. Williams Jr.,4397227,,True,37.0,5,9,1,2,4,7,2,2,1,6,7,4,1,2,0,0,16
401402046,VCU Rams,L. Stockard III,4277897,,True,15.0,1,5,1,5,0,0,0,0,1,0,1,1,0,0,3,3,2
401402046,VCU Rams,J. Nunn,4896614,,True,33.0,3,8,3,5,0,3,3,3,0,0,0,2,2,0,1,1,9
401402046,VCU Rams,A. Baldwin Jr.,4433182,,True,39.0,3,10,1,7,2,3,2,2,1,2,3,7,5,0,0,2,10
401402046,VCU Rams,K. Curry,4397228,,True,31.0,5,6,5,6,0,0,0,0,0,1,1,2,0,0,1,4,10
401402046,VCU Rams,H. Ward,4592495,,False,20.0,4,10,4,10,0,0,0,0,0,3,3,1,1,1,1,1,8
401402046,VCU Rams,M. Brown-Jones,4433224,,False,3.0,0,0,0,0,0,0,0,0,0,0,0,0,0,0,0,0,0
401402046,VCU Rams,J. DeLoach,4432483,,False,10.0,2,2,2,2,0,0,0,2,0,2,2,0,0,1,1,4,4
401402046,VCU Rams,M. Tsohonis,4592438,,False,12.0,1,3,1,1,0,2,0,0,0,2,2,1,1,0,0,1,2
401402046,VCU Rams,TEAM,TOTAL,TOTAL,False,,24,53,18,38,6,15,7,9,3,17,20,18,10,4,7,16,61
401402046,VCU Rams,V. Williams Jr.,4397227,,True,37.0,5,9,1,2,4,7,2,2,1,6,7,4,1,2,0,0,16
401402046,VCU Rams,L. Stockard III,4277897,,True,15.0,1,5,1,5,0,0,0,0,1,0,1,1,0,0,3,3,2
401402046,VCU Rams,J. Nunn,4896614,,True,33.0,3,8,3,5,0,3,3,3,0,0,0,2,2,0,1,1,9
401402046,VCU Rams,A. Baldwin Jr.,4433182,,True,39.0,3,10,1,7,2,3,2,2,1,2,3,7,5,0,0,2,10
401402046,VCU Rams,K. Curry,4397228,,True,31.0,5,6,5,6,0,0,0,0,0,1,1,2,0,0,1,4,10
401402046,VCU Rams,H. Ward,4592495,,False,20.0,4,10,4,10,0,0,0,0,0,3,3,1,1,1,1,1,8
401402046,VCU Rams,M. Brown-Jones,4433224,,False,3.0,0,0,0,0,0,0,0,0,0,0,0,0,0,0,0,0,0
401402046,VCU Rams,J. DeLoach,4432483,,False,10.0,2,2,2,2,0,0,0,2,0,2,2,0,0,1,1,4,4
401402046,VCU Rams,M. Tsohonis,4592438,,False,12.0,1,3,1,1,0,2,0,0,0,2,2,1,1,0,0,1,2
401402046,VCU Rams,TEAM,TOTAL,TOTAL,False,,24,53,18,38,6,15,7,9,3,17,20,18,10,4,7,16,61
401402046,Davidson Wildcats,S. Mennenga,4700862,,True,30.0,1,1,1,1,0,0,0,0,0,6,6,2,0,0,1,2,2
401402046,Davidson Wildcats,L. Brajkovic,4396787,,True,31.0,6,9,4,7,2,2,5,6,0,5,5,0,0,1,1,1,19
401402046,Davidson Wildcats,H. Lee,4592308,,True,34.0,2,7,1,3,1,4,1,2,1,5,6,3,0,0,2,2,6
401402046,Davidson Wildcats,F. Loyer,4397208,,True,38.0,4,10,2,6,2,4,4,4,0,3,3,4,0,0,7,4,14
401402046,Davidson Wildcats,M. Jones,4396784,,True,33.0,5,8,2,3,3,5,0,0,3,3,6,1,1,0,3,1,13
401402046,Davidson Wildcats,N. Boachie-Yiadom,4396786,,False,13.0,1,3,1,2,0,1,0,0,1,1,2,1,0,0,0,0,2
401402046,Davidson Wildcats,D. Watson,4897098,,False,13.0,1,3,1,3,0,0,0,0,0,2,2,1,1,0,1,0,2
401402046,Davidson Wildcats,G. Huffman,4432522,,False,8.0,2,3,2,3,0,0,1,2,0,0,0,0,0,0,1,0,5
401402046,Davidson Wildcats,TEAM,TOTAL,TOTAL,False,,22,44,14,28,8,16,11,14,6,26,32,12,2,1,17,10,63
401402046,Davidson Wildcats,S. Mennenga,4700862,,True,30.0,1,1,1,1,0,0,0,0,0,6,6,2,0,0,1,2,2
401402046,Davidson Wildcats,L. Brajkovic,4396787,,True,31.0,6,9,4,7,2,2,5,6,0,5,5,0,0,1,1,1,19
401402046,Davidson Wildcats,H. Lee,4592308,,True,34.0,2,7,1,3,1,4,1,2,1,5,6,3,0,0,2,2,6
401402046,Davidson Wildcats,F. Loyer,4397208,,True,38.0,4,10,2,6,2,4,4,4,0,3,3,4,0,0,7,4,14
401402046,Davidson Wildcats,M. Jones,4396784,,True,33.0,5,8,2,3,3,5,0,0,3,3,6,1,1,0,3,1,13
401402046,Davidson Wildcats,N. Boachie-Yiadom,4396786,,False,13.0,1,3,1,2,0,1,0,0,1,1,2,1,0,0,0,0,2
401402046,Davidson Wildcats,D. Watson,4897098,,False,13.0,1,3,1,3,0,0,0,0,0,2,2,1,1,0,1,0,2
401402046,Davidson Wildcats,G. Huffman,4432522,,False,8.0,2,3,2,3,0,0,1,2,0,0,0,0,0,0,1,0,5
401402046,Davidson Wildcats,TEAM,TOTAL,TOTAL,False,,22,44,14,28,8,16,11,14,6,26,32,12,2,1,17,10,63
401402045,Saint Louis Billikens,F. Okoro,4397105,,True,22.0,2,3,2,3,0,0,2,3,1,5,6,0,1,0,1,2,6
401402045,Saint Louis Billikens,J. Nesbitt,4714246,,True,23.0,6,10,3,5,3,5,1,1,2,1,3,2,0,0,3,4,16
401402045,Saint Louis Billikens,Y. Collins,4432957,,True,23.0,2,3,2,2,0,1,1,2,0,1,1,6,1,0,1,1,5
401402045,Saint Louis Billikens,G. Jimerson,4432008,,True,27.0,5,9,3,5,2,4,0,0,0,2,2,1,0,0,0,0,12
401402045,Saint Louis Billikens,F. Thatch Jr.,4397199,,True,28.0,8,11,6,9,2,2,3,4,3,4,7,2,1,0,3,2,21
401402045,Saint Louis Billikens,L. Traore,4897052,,False,4.0,0,1,0,1,0,0,0,0,0,1,1,1,0,1,0,0,0
401402045,Saint Louis Billikens,A. Lorentsson,4701121,,False,3.0,1,1,1,1,0,0,0,0,0,0,0,0,0,0,1,0,2
401402045,Saint Louis Billikens,T. Hargrove Jr.,4592484,,False,23.0,5,8,3,5,2,3,1,2,0,4,4,2,0,0,3,1,13
401402045,Saint Louis Billikens,M. Linssen,4279174,,False,14.0,2,3,2,3,0,0,0,0,0,6,6,1,1,0,1,3,4
401402045,Saint Louis Billikens,M. Strickland,4432494,,False,5.0,3,3,3,3,0,0,0,0,1,2,3,1,1,0,0,1,6
401402045,Saint Louis Billikens,R. Williams,4399106,,False,11.0,0,0,0,0,0,0,0,0,0,1,1,2,0,0,1,0,0
401402045,Saint Louis Billikens,B. Courtney,4397197,,False,1.0,0,0,0,0,0,0,0,0,0,1,1,0,0,0,0,0,0
401402045,Saint Louis Billikens,D. Jones,4278267,,False,16.0,2,4,1,3,1,1,0,0,0,2,2,4,0,0,1,2,5
401402045,Saint Louis Billikens,TEAM,TOTAL,TOTAL,False,,36,56,26,40,10,16,8,12,9,31,40,22,5,1,16,16,90
401402045,Saint Louis Billikens,F. Okoro,4397105,,True,22.0,2,3,2,3,0,0,2,3,1,5,6,0,1,0,1,2,6
401402045,Saint Louis Billikens,J. Nesbitt,4714246,,True,23.0,6,10,3,5,3,5,1,1,2,1,3,2,0,0,3,4,16
401402045,Saint Louis Billikens,Y. Collins,4432957,,True,23.0,2,3,2,2,0,1,1,2,0,1,1,6,1,0,1,1,5
401402045,Saint Louis Billikens,G. Jimerson,4432008,,True,27.0,5,9,3,5,2,4,0,0,0,2,2,1,0,0,0,0,12
401402045,Saint Louis Billikens,F. Thatch Jr.,4397199,,True,28.0,8,11,6,9,2,2,3,4,3,4,7,2,1,0,3,2,21
401402045,Saint Louis Billikens,L. Traore,4897052,,False,4.0,0,1,0,1,0,0,0,0,0,1,1,1,0,1,0,0,0
401402045,Saint Louis Billikens,A. Lorentsson,4701121,,False,3.0,1,1,1,1,0,0,0,0,0,0,0,0,0,0,1,0,2
401402045,Saint Louis Billikens,T. Hargrove Jr.,4592484,,False,23.0,5,8,3,5,2,3,1,2,0,4,4,2,0,0,3,1,13
401402045,Saint Louis Billikens,M. Linssen,4279174,,False,14.0,2,3,2,3,0,0,0,0,0,6,6,1,1,0,1,3,4
401402045,Saint Louis Billikens,M. Strickland,4432494,,False,5.0,3,3,3,3,0,0,0,0,1,2,3,1,1,0,0,1,6
401402045,Saint Louis Billikens,R. Williams,4399106,,False,11.0,0,0,0,0,0,0,0,0,0,1,1,2,0,0,1,0,0
401402045,Saint Louis Billikens,B. Courtney,4397197,,False,1.0,0,0,0,0,0,0,0,0,0,1,1,0,0,0,0,0,0
401402045,Saint Louis Billikens,D. Jones,4278267,,False,16.0,2,4,1,3,1,1,0,0,0,2,2,4,0,0,1,2,5
401402045,Saint Louis Billikens,TEAM,TOTAL,TOTAL,False,,36,56,26,40,10,16,8,12,9,31,40,22,5,1,16,16,90
401402045,La Salle Explorers,M. Doucoure,4277988,,True,10.0,1,1,1,1,0,0,0,0,1,0,1,0,0,0,0,1,2
401402045,La Salle Explorers,C. Moore,4277945,,True,27.0,7,12,6,11,1,1,5,5,2,3,5,1,0,4,2,3,20
401402045,La Salle Explorers,J. Clark,4397152,,True,31.0,7,16,5,9,2,7,2,2,3,1,4,1,2,0,2,0,18
401402045,La Salle Explorers,J. Brickus,4700970,,True,22.0,0,4,0,0,0,4,0,0,0,2,2,2,0,0,1,2,0
401402045,La Salle Explorers,J. Nickelberry,4432845,,True,29.0,1,10,0,3,1,7,2,2,0,1,1,2,0,0,1,3,5
401402045,La Salle Explorers,M. McFarlane,4897068,,False,10.0,1,4,0,3,1,1,0,0,1,0,1,0,0,0,1,3,3
401402045,La Salle Explorers,D. Shepherd,4710357,,False,4.0,0,0,0,0,0,0,0,0,0,0,0,0,0,0,0,0,0
401402045,La Salle Explorers,K. Brantley,4709132,,False,22.0,1,5,0,2,1,3,4,4,0,0,0,1,4,0,2,1,7
401402045,La Salle Explorers,A. Gill,4700969,,False,19.0,2,4,1,2,1,2,2,3,0,0,0,2,2,0,1,2,7
401402045,La Salle Explorers,K. Thompson,4592449,,False,1.0,0,1,0,1,0,0,0,0,0,0,0,0,0,0,0,0,0
401402045,La Salle Explorers,C. Ray,4592448,,False,25.0,1,4,1,3,0,1,0,0,2,2,4,1,0,0,1,0,2
401402045,La Salle Explorers,TEAM,TOTAL,TOTAL,False,,21,61,14,35,7,26,15,16,10,11,21,10,8,4,11,15,64
401402045,La Salle Explorers,M. Doucoure,4277988,,True,10.0,1,1,1,1,0,0,0,0,1,0,1,0,0,0,0,1,2
401402045,La Salle Explorers,C. Moore,4277945,,True,27.0,7,12,6,11,1,1,5,5,2,3,5,1,0,4,2,3,20
401402045,La Salle Explorers,J. Clark,4397152,,True,31.0,7,16,5,9,2,7,2,2,3,1,4,1,2,0,2,0,18
401402045,La Salle Explorers,J. Brickus,4700970,,True,22.0,0,4,0,0,0,4,0,0,0,2,2,2,0,0,1,2,0
401402045,La Salle Explorers,J. Nickelberry,4432845,,True,29.0,1,10,0,3,1,7,2,2,0,1,1,2,0,0,1,3,5
401402045,La Salle Explorers,M. McFarlane,4897068,,False,10.0,1,4,0,3,1,1,0,0,1,0,1,0,0,0,1,3,3
401402045,La Salle Explorers,D. Shepherd,4710357,,False,4.0,0,0,0,0,0,0,0,0,0,0,0,0,0,0,0,0,0
401402045,La Salle Explorers,K. Brantley,4709132,,False,22.0,1,5,0,2,1,3,4,4,0,0,0,1,4,0,2,1,7
401402045,La Salle Explorers,A. Gill,4700969,,False,19.0,2,4,1,2,1,2,2,3,0,0,0,2,2,0,1,2,7
401402045,La Salle Explorers,K. Thompson,4592449,,False,1.0,0,1,0,1,0,0,0,0,0,0,0,0,0,0,0,0,0
401402045,La Salle Explorers,C. Ray,4592448,,False,25.0,1,4,1,3,0,1,0,0,2,2,4,1,0,0,1,0,2
401402045,La Salle Explorers,TEAM,TOTAL,TOTAL,False,,21,61,14,35,7,26,15,16,10,11,21,10,8,4,11,15,64
401402044,Saint Louis Billikens,T. Hargrove Jr.,4592484,,True,18.0,2,4,0,1,2,3,1,2,1,1,2,2,1,0,2,2,7
401402044,Saint Louis Billikens,F. Okoro,4397105,,True,21.0,7,11,7,11,0,0,2,2,2,5,7,0,0,0,1,5,16
401402044,Saint Louis Billikens,J. Nesbitt,4714246,,True,25.0,2,4,0,1,2,3,2,2,2,2,4,0,0,0,0,3,8
401402044,Saint Louis Billikens,Y. Collins,4432957,,True,33.0,1,3,1,1,0,2,0,0,0,6,6,9,0,0,3,4,2
401402044,Saint Louis Billikens,G. Jimerson,4432008,,True,38.0,7,16,5,11,2,5,7,8,1,2,3,3,0,0,0,1,23
401402044,Saint Louis Billikens,L. Traore,4897052,,False,10.0,0,1,0,1,0,0,0,0,0,1,1,0,0,0,1,3,0
401402044,Saint Louis Billikens,M. Linssen,4279174,,False,9.0,1,1,1,1,0,0,0,0,1,1,2,1,0,0,1,2,2
401402044,Saint Louis Billikens,R. Williams,4399106,,False,6.0,1,4,0,0,1,4,0,0,0,0,0,0,0,0,0,0,3
401402044,Saint Louis Billikens,F. Thatch Jr.,4397199,,False,27.0,8,14,8,12,0,2,4,4,1,4,5,4,2,0,3,4,20
401402044,Saint Louis Billikens,D. Jones,4278267,,False,13.0,1,1,1,1,0,0,2,2,0,1,1,0,0,0,0,2,4
401402044,Saint Louis Billikens,TEAM,TOTAL,TOTAL,False,,30,59,23,40,7,19,18,20,8,23,31,19,3,0,11,26,85
401402044,Saint Louis Billikens,T. Hargrove Jr.,4592484,,True,18.0,2,4,0,1,2,3,1,2,1,1,2,2,1,0,2,2,7
401402044,Saint Louis Billikens,F. Okoro,4397105,,True,21.0,7,11,7,11,0,0,2,2,2,5,7,0,0,0,1,5,16
401402044,Saint Louis Billikens,J. Nesbitt,4714246,,True,25.0,2,4,0,1,2,3,2,2,2,2,4,0,0,0,0,3,8
401402044,Saint Louis Billikens,Y. Collins,4432957,,True,33.0,1,3,1,1,0,2,0,0,0,6,6,9,0,0,3,4,2
401402044,Saint Louis Billikens,G. Jimerson,4432008,,True,38.0,7,16,5,11,2,5,7,8,1,2,3,3,0,0,0,1,23
401402044,Saint Louis Billikens,L. Traore,4897052,,False,10.0,0,1,0,1,0,0,0,0,0,1,1,0,0,0,1,3,0
401402044,Saint Louis Billikens,M. Linssen,4279174,,False,9.0,1,1,1,1,0,0,0,0,1,1,2,1,0,0,1,2,2
401402044,Saint Louis Billikens,R. Williams,4399106,,False,6.0,1,4,0,0,1,4,0,0,0,0,0,0,0,0,0,0,3
401402044,Saint Louis Billikens,F. Thatch Jr.,4397199,,False,27.0,8,14,8,12,0,2,4,4,1,4,5,4,2,0,3,4,20
401402044,Saint Louis Billikens,D. Jones,4278267,,False,13.0,1,1,1,1,0,0,2,2,0,1,1,0,0,0,0,2,4
401402044,Saint Louis Billikens,TEAM,TOTAL,TOTAL,False,,30,59,23,40,7,19,18,20,8,23,31,19,3,0,11,26,85
401402044,Massachusetts Minutemen,M. Steadman,4397393,,True,17.0,3,7,3,7,0,0,1,2,1,3,4,0,0,0,1,3,7
401402044,Massachusetts Minutemen,T. Buttrick,4277981,,True,31.0,3,5,3,3,0,2,4,5,1,3,4,0,0,0,2,4,10
401402044,Massachusetts Minutemen,T.J. Weeks,4433108,,True,19.0,3,6,2,3,1,3,0,0,1,4,5,1,0,0,0,1,7
401402044,Massachusetts Minutemen,N. Fernandes,4431791,,True,34.0,7,11,5,7,2,4,8,11,0,0,0,6,0,0,3,1,24
401402044,Massachusetts Minutemen,R. Kelly,4279741,,True,26.0,2,6,0,2,2,4,4,4,0,1,1,2,1,0,0,1,10
401402044,Massachusetts Minutemen,D. Dominguez,4701126,,False,1.0,0,1,0,0,0,1,0,0,0,0,0,0,0,0,0,2,0
401402044,Massachusetts Minutemen,G. Jones,4279211,,False,31.0,5,10,5,8,0,2,3,3,1,3,4,0,2,1,1,2,13
401402044,Massachusetts Minutemen,J. Garcia,4701125,,False,21.0,5,6,4,5,1,1,4,6,0,1,1,2,1,0,0,1,15
401402044,Massachusetts Minutemen,C.J. Kelly,4398208,,False,20.0,1,4,0,1,1,3,2,2,3,6,9,0,0,0,1,4,5
401402044,Massachusetts Minutemen,TEAM,TOTAL,TOTAL,False,,29,56,22,36,7,20,26,33,8,22,30,11,4,1,9,19,91
401402044,Massachusetts Minutemen,M. Steadman,4397393,,True,17.0,3,7,3,7,0,0,1,2,1,3,4,0,0,0,1,3,7
401402044,Massachusetts Minutemen,T. Buttrick,4277981,,True,31.0,3,5,3,3,0,2,4,5,1,3,4,0,0,0,2,4,10
401402044,Massachusetts Minutemen,T.J. Weeks,4433108,,True,19.0,3,6,2,3,1,3,0,0,1,4,5,1,0,0,0,1,7
401402044,Massachusetts Minutemen,N. Fernandes,4431791,,True,34.0,7,11,5,7,2,4,8,11,0,0,0,6,0,0,3,1,24
401402044,Massachusetts Minutemen,R. Kelly,4279741,,True,26.0,2,6,0,2,2,4,4,4,0,1,1,2,1,0,0,1,10
401402044,Massachusetts Minutemen,D. Dominguez,4701126,,False,1.0,0,1,0,0,0,1,0,0,0,0,0,0,0,0,0,2,0
401402044,Massachusetts Minutemen,G. Jones,4279211,,False,31.0,5,10,5,8,0,2,3,3,1,3,4,0,2,1,1,2,13
401402044,Massachusetts Minutemen,J. Garcia,4701125,,False,21.0,5,6,4,5,1,1,4,6,0,1,1,2,1,0,0,1,15
401402044,Massachusetts Minutemen,C.J. Kelly,4398208,,False,20.0,1,4,0,1,1,3,2,2,3,6,9,0,0,0,1,4,5
401402044,Massachusetts Minutemen,TEAM,TOTAL,TOTAL,False,,29,56,22,36,7,20,26,33,8,22,30,11,4,1,9,19,91
401400952,Rhode Island Rams,Makhel Mitchell,4431777,,True,16.0,0,4,0,4,0,0,2,2,0,4,4,1,0,1,2,3,2
401400952,Rhode Island Rams,Makhi Mitchell,4431708,,True,28.0,7,8,7,8,0,0,5,9,3,5,8,1,1,2,6,1,19
401400952,Rhode Island Rams,I. Leggett,4606837,,True,14.0,2,6,1,2,1,4,1,1,0,3,3,2,2,0,3,1,6
401400952,Rhode Island Rams,I. El-Amin,4279313,,True,23.0,5,6,1,1,4,5,0,0,0,2,2,1,0,0,0,1,14
401400952,Rhode Island Rams,J. Sheppard,4066445,,True,28.0,1,7,1,3,0,4,0,0,0,3,3,2,0,0,2,1,2
401400952,Rhode Island Rams,I. Ayo-Faleye,4701259,,False,17.0,1,5,1,3,0,2,0,0,1,2,3,0,2,1,1,1,2
401400952,Rhode Island Rams,T. Berry,4701257,,False,12.0,3,5,2,2,1,3,0,0,1,2,3,0,0,0,0,1,7
401400952,Rhode Island Rams,M. Martin,4397470,,False,22.0,2,5,2,3,0,2,5,8,4,7,11,2,1,2,1,1,9
401400952,Rhode Island Rams,J. Carey,4395673,,False,20.0,3,9,2,8,1,1,0,0,1,4,5,2,0,1,2,0,7
401400952,Rhode Island Rams,S. Thomas,4897065,,False,20.0,1,3,1,2,0,1,0,0,1,3,4,5,1,0,1,0,2
401400952,Rhode Island Rams,TEAM,TOTAL,TOTAL,False,,25,58,18,36,7,22,13,20,13,35,48,16,7,7,18,10,70
401400952,American International Yellow Jackets,F. Batista,4913578,,True,30.0,6,19,6,17,0,2,2,2,6,8,14,2,4,0,2,4,14
401400952,American International Yellow Jackets,X. Golding,4913581,,True,15.0,0,4,0,3,0,1,0,0,0,1,1,1,1,0,1,2,0
401400952,American International Yellow Jackets,J. Vidal,4913579,,True,23.0,4,7,3,5,1,2,0,0,1,1,2,2,0,1,2,3,9
401400952,American International Yellow Jackets,W. Covington,4913577,,True,14.0,0,1,0,1,0,0,0,0,0,0,0,0,1,1,2,0,0
401400952,American International Yellow Jackets,D. Miller,4913573,,True,27.0,1,6,1,4,0,2,0,0,0,1,1,2,1,0,2,1,2
401400952,American International Yellow Jackets,T. Washington,4913582,,False,15.0,0,6,0,6,0,0,2,4,2,4,6,1,0,1,0,2,2
401400952,American International Yellow Jackets,D. Weston,4913580,,False,1.0,1,1,1,1,0,0,0,0,0,0,0,0,0,0,0,0,2
401400952,American International Yellow Jackets,J. Jordan,4913576,,False,21.0,2,4,2,4,0,0,0,0,2,3,5,2,1,0,0,0,4
401400952,American International Yellow Jackets,J. Lopes,4913575,,False,1.0,0,0,0,0,0,0,0,0,0,0,0,1,0,0,0,0,0
401400952,American International Yellow Jackets,C. Hubb,4913574,,False,29.0,5,12,3,4,2,8,1,2,0,2,2,2,1,1,3,0,13
401400952,American International Yellow Jackets,S. Hicks,4913572,,False,24.0,3,9,0,2,3,7,0,0,0,3,3,1,2,0,0,3,9
401400952,American International Yellow Jackets,TEAM,TOTAL,TOTAL,False,,22,69,16,47,6,22,5,8,14,24,38,14,11,4,14,15,55
401398910,Kansas Jayhawks,J. Wilson,4431714,,True,26.0,3,9,3,4,0,5,2,3,1,6,7,2,0,0,2,2,8
401398910,Kansas Jayhawks,D. McCormack,4397019,,True,10.0,0,3,0,3,0,0,1,2,4,0,4,0,1,0,1,0,1
401398910,Kansas Jayhawks,D. Harris,4431983,,True,31.0,2,6,2,3,0,3,0,0,0,1,1,3,3,0,2,4,4
401398910,Kansas Jayhawks,C. Braun,4431767,,True,36.0,3,12,1,6,2,6,6,6,0,3,3,6,1,1,1,3,14
401398910,Kansas Jayhawks,O. Agbaji,4397018,,True,36.0,4,14,2,7,2,7,1,1,2,5,7,1,1,0,0,1,11
401398910,Kansas Jayhawks,K.J. Adams,4433259,,False,5.0,1,1,1,1,0,0,0,0,0,1,1,1,1,0,0,0,2
401398910,Kansas Jayhawks,M. Lightfoot,4066300,,False,22.0,7,7,7,7,0,0,0,2,3,1,4,1,0,0,1,0,14
401398910,Kansas Jayhawks,J. Yesufu,4431856,,False,9.0,1,2,1,2,0,0,0,0,0,2,2,1,1,0,1,0,2
401398910,Kansas Jayhawks,J. Coleman-Lands,3911842,,False,25.0,7,9,2,2,5,7,1,2,0,2,2,3,0,2,1,5,20
401398910,Kansas Jayhawks,TEAM,TOTAL,TOTAL,False,,28,63,19,35,9,28,11,16,10,22,32,18,8,3,9,15,76
401398910,George Mason Patriots,J. Oduro,4432068,,True,24.0,4,8,3,6,1,2,3,4,0,3,3,1,2,0,1,2,12
401398910,George Mason Patriots,X. Johnson,4592439,,True,36.0,2,5,1,3,1,2,6,8,0,5,5,2,0,1,3,4,11
401398910,George Mason Patriots,D. Gaines,4431961,,True,36.0,5,8,2,2,3,6,2,4,3,9,12,1,1,1,1,3,15
401398910,George Mason Patriots,D. Cooper,4279876,,True,31.0,4,8,1,2,3,6,0,0,1,2,3,2,0,0,3,4,11
401398910,George Mason Patriots,D. Schwartz,4278501,,True,40.0,5,11,3,5,2,6,3,4,0,4,4,5,0,0,1,0,15
401398910,George Mason Patriots,B. Jones,4897083,,False,6.0,0,1,0,0,0,1,0,0,0,1,1,0,0,0,0,0,0
401398910,George Mason Patriots,R. Polite III,4567711,,False,16.0,1,5,0,2,1,3,0,0,0,1,1,0,0,0,4,1,3
401398910,George Mason Patriots,J. Hartwell II,4396817,,False,11.0,0,2,0,1,0,1,0,0,0,1,1,0,0,0,1,0,0
401398910,George Mason Patriots,TEAM,TOTAL,TOTAL,False,,21,48,10,21,11,27,14,20,4,27,31,11,3,2,14,14,67
401396268,Johnson & Wales (NC) Johnson & Wales (Nc),J. Benson-Hollinhead,4901284,,True,29.0,2,7,1,5,1,2,0,0,2,7,9,0,0,1,0,2,5
401396268,Johnson & Wales (NC) Johnson & Wales (Nc),C. Stafford-Gill,4596833,,True,8.0,0,0,0,0,0,0,0,0,0,1,1,0,0,0,1,2,0
401396268,Johnson & Wales (NC) Johnson & Wales (Nc),A. Ray,4408068,,True,31.0,6,21,6,17,0,4,3,3,1,2,3,3,1,0,0,0,15
401396268,Johnson & Wales (NC) Johnson & Wales (Nc),J. Dibble,4901282,,True,16.0,2,5,1,3,1,2,2,2,1,0,1,0,1,0,1,2,7
401396268,Johnson & Wales (NC) Johnson & Wales (Nc),F. Patterson,4405305,,True,35.0,7,14,5,7,2,7,0,0,0,5,5,0,1,0,8,1,16
401396268,Johnson & Wales (NC) Johnson & Wales (Nc),B. Summers,4901286,,False,6.0,0,0,0,0,0,0,0,0,0,0,0,0,0,0,0,1,0
401396268,Johnson & Wales (NC) Johnson & Wales (Nc),J. Mars,4901285,,False,4.0,1,1,1,1,0,0,0,0,0,0,0,0,0,0,0,0,2
401396268,Johnson & Wales (NC) Johnson & Wales (Nc),A. De La Rosa,4901280,,False,15.0,1,3,1,3,0,0,0,0,0,0,0,0,0,0,0,0,2
401396268,Johnson & Wales (NC) Johnson & Wales (Nc),Z. Wilkins,4405302,,False,15.0,2,6,1,3,1,3,3,5,1,1,2,1,1,1,1,1,8
401396268,Johnson & Wales (NC) Johnson & Wales (Nc),B. Cherry,4901281,,False,2.0,0,0,0,0,0,0,0,0,0,1,1,0,0,0,0,0,0
401396268,Johnson & Wales (NC) Johnson & Wales (Nc),N. Meshida,4901279,,False,6.0,1,2,0,1,1,1,0,0,0,0,0,0,1,0,1,0,3
401396268,Johnson & Wales (NC) Johnson & Wales (Nc),C. Irby,4596834,,False,14.0,0,3,0,1,0,2,1,2,0,1,1,0,1,0,0,0,1
401396268,Johnson & Wales (NC) Johnson & Wales (Nc),D. Williams,4596832,,False,8.0,1,3,1,2,0,1,0,0,0,2,2,0,1,0,0,1,2
401396268,Johnson & Wales (NC) Johnson & Wales (Nc),J. Cooper,4596830,,False,11.0,1,4,0,1,1,3,0,0,0,1,1,3,0,0,0,0,3
401396268,Johnson & Wales (NC) Johnson & Wales (Nc),TEAM,TOTAL,TOTAL,False,,24,69,17,44,7,25,9,12,5,23,28,7,7,2,12,10,64
401396268,Davidson Wildcats,S. Mennenga,4700862,,True,14.0,4,5,4,5,0,0,0,0,1,5,6,0,0,0,1,1,8
401396268,Davidson Wildcats,L. Brajkovic,4396787,,True,14.0,3,4,2,3,1,1,0,0,1,3,4,2,1,1,1,0,7
401396268,Davidson Wildcats,H. Lee,4592308,,True,16.0,4,7,1,1,3,6,1,2,2,2,4,1,1,0,1,1,12
401396268,Davidson Wildcats,G. Huffman,4432522,,True,19.0,2,7,1,5,1,2,0,0,0,4,4,4,1,0,1,1,5
401396268,Davidson Wildcats,M. Jones,4396784,,True,16.0,3,10,0,1,3,9,0,0,0,1,1,3,0,0,1,2,9
401396268,Davidson Wildcats,C. Ford,4897099,,False,16.0,5,7,5,7,0,0,0,0,5,6,11,1,0,0,1,0,10
401396268,Davidson Wildcats,D. Kristensen,4432020,,False,18.0,7,8,6,6,1,2,1,2,0,3,3,1,1,1,1,2,16
401396268,Davidson Wildcats,N. Boachie-Yiadom,4396786,,False,14.0,3,3,3,3,0,0,0,0,0,7,7,2,0,0,1,0,6
401396268,Davidson Wildcats,M. Katsock,4902569,,False,4.0,0,3,0,0,0,3,0,0,1,1,2,1,0,0,0,1,0
401396268,Davidson Wildcats,S. Thrastarson,4897100,,False,18.0,4,6,2,3,2,3,2,2,0,2,2,3,0,0,1,0,12
401396268,Davidson Wildcats,D. Watson,4897098,,False,21.0,4,6,3,4,1,2,0,0,0,2,2,2,2,0,2,1,9
401396268,Davidson Wildcats,B. Craig,4700863,,False,4.0,1,1,1,1,0,0,0,0,0,0,0,0,0,0,0,0,2
401396268,Davidson Wildcats,D. Dibble,4592309,,False,8.0,2,2,0,0,2,2,0,0,0,1,1,0,0,0,0,0,6
401396268,Davidson Wildcats,E. Lanier,4567082,,False,18.0,1,6,1,3,0,3,2,2,1,2,3,4,0,0,1,2,4
401396268,Davidson Wildcats,TEAM,TOTAL,TOTAL,False,,43,75,29,42,14,33,6,8,11,42,53,24,6,2,12,11,106
401395130,Davidson Wildcats,S. Mennenga,4700862,,True,23.0,2,4,2,4,0,0,0,0,1,3,4,0,0,0,2,4,4
401395130,Davidson Wildcats,L. Brajkovic,4396787,,True,30.0,10,16,8,12,2,4,0,0,2,5,7,3,1,1,3,2,22
401395130,Davidson Wildcats,H. Lee,4592308,,True,30.0,6,12,2,4,4,8,1,1,1,3,4,3,0,0,2,1,17
401395130,Davidson Wildcats,F. Loyer,4397208,,True,34.0,3,7,0,0,3,7,2,2,0,5,5,8,2,0,1,2,11
401395130,Davidson Wildcats,M. Jones,4396784,,True,32.0,8,11,5,8,3,3,2,2,0,1,1,4,1,0,2,2,21
401395130,Davidson Wildcats,N. Boachie-Yiadom,4396786,,False,16.0,1,3,1,2,0,1,0,0,0,0,0,2,1,1,1,0,2
401395130,Davidson Wildcats,D. Watson,4897098,,False,17.0,0,3,0,2,0,1,0,0,0,3,3,2,1,1,0,1,0
401395130,Davidson Wildcats,G. Huffman,4432522,,False,18.0,1,2,1,2,0,0,0,0,0,1,1,0,0,0,0,1,2
401395130,Davidson Wildcats,TEAM,TOTAL,TOTAL,False,,31,58,19,34,12,24,5,5,4,23,27,22,6,3,11,13,79
401395130,Alabama Crimson Tide,J. Gary,4431707,,True,24.0,4,5,1,1,3,4,4,5,3,5,8,0,0,1,1,1,15
401395130,Alabama Crimson Tide,C. Bediako,4565203,,True,19.0,2,2,2,2,0,0,0,0,1,3,4,0,0,0,1,1,4
401395130,Alabama Crimson Tide,K. Ellis,4702177,,True,32.0,3,9,1,2,2,7,1,1,3,1,4,4,2,1,1,3,9
401395130,Alabama Crimson Tide,J. Shackelford,4432846,,True,33.0,8,15,4,4,4,11,0,0,1,4,5,1,1,0,3,3,20
401395130,Alabama Crimson Tide,Jah. Quinerly,4397132,,True,32.0,5,16,3,10,2,6,1,2,0,0,0,6,1,0,2,0,13
401395130,Alabama Crimson Tide,D. Miles,4433561,,False,14.0,2,8,2,4,0,4,0,0,2,3,5,1,0,0,1,0,4
401395130,Alabama Crimson Tide,N. Gurley,4280015,,False,21.0,4,7,3,5,1,2,0,0,3,3,6,0,1,2,2,3,9
401395130,Alabama Crimson Tide,J. Holt,4684152,,False,6.0,0,1,0,0,0,1,0,0,0,0,0,1,0,0,0,1,0
401395130,Alabama Crimson Tide,JD Davison,4576085,,False,19.0,2,4,2,3,0,1,0,0,1,3,4,4,0,0,0,0,4
401395130,Alabama Crimson Tide,TEAM,TOTAL,TOTAL,False,,30,67,18,31,12,36,6,8,16,23,39,17,5,4,11,12,78
401389450,VCU Rams,H. Ward,4592495,,True,28.0,3,8,3,7,0,1,0,1,3,3,6,3,1,1,4,3,6
401389450,VCU Rams,V. Williams Jr.,4397227,,True,37.0,7,15,4,7,3,8,0,0,1,2,3,5,2,1,5,4,17
401389450,VCU Rams,L. Stockard III,4277897,,True,30.0,5,7,5,7,0,0,3,4,4,2,6,2,3,0,1,3,13
401389450,VCU Rams,J. Nunn,4896614,,True,31.0,1,3,0,1,1,2,3,6,0,3,3,2,2,0,1,2,6
401389450,VCU Rams,K. Curry,4397228,,True,26.0,2,9,2,5,0,4,1,2,1,1,2,0,1,0,2,4,5
401389450,VCU Rams,M. Brown-Jones,4433224,,False,11.0,2,3,1,1,1,2,0,0,0,1,1,0,0,1,2,2,5
401389450,VCU Rams,J. DeLoach,4432483,,False,10.0,1,3,1,3,0,0,0,0,1,3,4,0,1,1,1,1,2
401389450,VCU Rams,N. Kern,4684145,,False,14.0,1,3,1,3,0,0,0,0,1,2,3,0,1,0,2,0,2
401389450,VCU Rams,M. Tsohonis,4592438,,False,11.0,2,5,1,2,1,3,0,0,0,2,2,2,0,1,0,0,5
401389450,VCU Rams,J. Banks,4432402,,False,2.0,0,1,0,1,0,0,0,0,0,1,1,0,0,0,0,0,0
401389450,VCU Rams,TEAM,TOTAL,TOTAL,False,,24,57,18,37,6,20,7,13,12,21,33,14,11,5,19,19,61
401389450,Baylor Bears,M. Mayer,4395697,,True,29.0,5,13,2,8,3,5,2,4,2,4,6,2,2,1,1,3,15
401389450,Baylor Bears,F. Thamba,4395692,,True,17.0,1,2,1,2,0,0,2,3,3,1,4,0,1,1,1,4,4
401389450,Baylor Bears,K. Brown,4433254,,True,29.0,6,9,6,9,0,0,2,2,2,3,5,0,1,0,1,3,14
401389450,Baylor Bears,A. Flagler,4397654,,True,29.0,3,9,2,5,1,4,2,2,1,2,3,2,1,0,1,0,9
401389450,Baylor Bears,J. Akinjo,4397072,,True,29.0,1,6,1,5,0,1,4,4,0,1,1,2,1,0,7,3,6
401389450,Baylor Bears,J. Sochan,4610139,,False,14.0,0,4,0,3,0,1,2,3,4,2,6,2,0,0,1,3,2
401389450,Baylor Bears,J. Tchamwa Tchatchoua,4397436,,False,23.0,6,8,5,7,1,1,0,0,1,7,8,1,1,0,1,2,13
401389450,Baylor Bears,D. Bonner,4601289,,False,4.0,0,0,0,0,0,0,0,0,0,0,0,1,0,0,0,0,0
401389450,Baylor Bears,LJ Cryer,4433149,,False,26.0,1,6,1,3,0,3,4,6,0,0,0,2,1,0,4,1,6
401389450,Baylor Bears,TEAM,TOTAL,TOTAL,False,,23,57,18,42,5,15,18,24,17,25,42,12,8,2,18,19,69
401385280,Saint Louis Billikens,T. Hargrove Jr.,4592484,,True,17.0,3,6,3,6,0,0,1,2,3,3,6,1,1,3,0,0,7
401385280,Saint Louis Billikens,M. Linssen,4279174,,True,16.0,4,6,4,5,0,1,4,4,1,2,3,2,2,1,0,0,12
401385280,Saint Louis Billikens,J. Nesbitt,4714246,,True,18.0,7,11,2,3,5,8,0,0,4,5,9,2,1,1,0,2,19
401385280,Saint Louis Billikens,Y. Collins,4432957,,True,15.0,2,3,2,3,0,0,0,0,0,2,2,10,3,1,0,3,4
401385280,Saint Louis Billikens,G. Jimerson,4432008,,True,17.0,8,11,5,7,3,4,2,2,1,0,1,0,0,0,1,0,21
401385280,Saint Louis Billikens,L. Traore,4897052,,False,17.0,6,8,6,8,0,0,2,3,3,4,7,1,0,0,0,3,14
401385280,Saint Louis Billikens,A. Lorentsson,4701121,,False,17.0,2,2,1,1,1,1,0,0,0,1,1,2,1,0,1,2,5
401385280,Saint Louis Billikens,F. Okoro,4397105,,False,14.0,8,9,8,9,0,0,2,2,4,4,8,0,1,1,1,4,18
401385280,Saint Louis Billikens,M. Strickland,4432494,,False,18.0,3,6,3,6,0,0,1,1,0,2,2,1,1,0,0,0,7
401385280,Saint Louis Billikens,R. Williams,4399106,,False,23.0,3,8,0,1,3,7,0,0,1,1,2,6,0,0,1,2,9
401385280,Saint Louis Billikens,F. Thatch Jr.,4397199,,False,6.0,0,2,0,1,0,1,0,0,0,0,0,0,1,0,1,1,0
401385280,Saint Louis Billikens,B. Courtney,4397197,,False,7.0,2,4,0,1,2,3,0,0,0,0,0,0,0,0,0,1,6
401385280,Saint Louis Billikens,D. Jones,4278267,,False,16.0,2,2,2,2,0,0,1,2,0,1,1,4,3,0,0,1,5
401385280,Saint Louis Billikens,TEAM,TOTAL,TOTAL,False,,50,78,36,53,14,25,13,16,18,28,46,29,14,7,5,19,127
401385280,Harris-Stowe State Hornets,M. Greer,4902953,,True,16.0,1,2,1,2,0,0,0,1,0,1,1,1,0,0,1,5,2
401385280,Harris-Stowe State Hornets,T. Long,4902942,,True,26.0,1,4,1,3,0,1,3,4,0,1,1,1,1,2,1,1,5
401385280,Harris-Stowe State Hornets,J. Burns,4902945,,True,25.0,3,12,3,12,0,0,2,2,0,0,0,1,0,0,3,2,8
401385280,Harris-Stowe State Hornets,J. Joseph,4902943,,True,27.0,3,10,2,7,1,3,2,2,1,1,2,1,0,0,4,0,9
401385280,Harris-Stowe State Hornets,R. Barnes,4407283,,True,22.0,4,10,3,7,1,3,3,4,0,2,2,1,1,0,3,4,12
401385280,Harris-Stowe State Hornets,D. Sunkett,4902955,,False,23.0,2,4,0,1,2,3,5,6,1,1,2,0,0,0,0,0,11
401385280,Harris-Stowe State Hornets,N. Hightower,4902956,,False,10.0,0,0,0,0,0,0,0,0,2,1,3,0,0,0,1,0,0
401385280,Harris-Stowe State Hornets,A. Campbell,4902954,,False,24.0,2,6,1,1,1,5,0,1,2,1,3,0,1,1,4,0,5
401385280,Harris-Stowe State Hornets,J. Edwards,4902951,,False,5.0,0,0,0,0,0,0,0,0,0,0,0,0,0,0,1,0,0
401385280,Harris-Stowe State Hornets,K. Williams,4902949,,False,7.0,0,0,0,0,0,0,0,0,0,0,0,0,0,0,1,1,0
401385280,Harris-Stowe State Hornets,S. Lightfoot,4902948,,False,14.0,0,3,0,2,0,1,2,2,0,2,2,0,0,0,1,0,2
401385280,Harris-Stowe State Hornets,TEAM,TOTAL,TOTAL,False,,16,51,11,35,5,16,17,22,11,11,22,5,3,3,21,13,54
401384961,Washington Huskies,N. Roberts,4397158,,True,31.0,2,5,2,5,0,0,0,1,2,3,5,0,1,0,2,3,4
401384961,Washington Huskies,E. Matthews Jr.,4397099,,True,37.0,3,7,3,3,0,4,2,4,2,3,5,1,1,0,2,2,8
401384961,Washington Huskies,J. Bey,4397155,,True,19.0,2,6,1,3,1,3,2,2,1,2,3,3,1,0,2,4,7
401384961,Washington Huskies,T. Brown Jr.,4395997,,True,37.0,7,13,6,12,1,1,8,9,2,6,8,4,4,1,1,1,23
401384961,Washington Huskies,D. Davis,4278522,,True,34.0,3,6,2,3,1,3,3,4,0,2,2,4,2,1,2,4,10
401384961,Washington Huskies,J. Grant,4433613,,False,9.0,2,2,2,2,0,0,0,0,1,0,1,0,0,1,0,1,4
401384961,Washington Huskies,L. Wilson,4898376,,False,0.0,0,0,0,0,0,0,0,0,0,0,0,0,0,0,0,0,0
401384961,Washington Huskies,C. Bajema,4431757,,False,7.0,0,2,0,1,0,1,0,2,0,0,0,1,0,0,1,0,0
401384961,Washington Huskies,PJ Fuller,4431717,,False,26.0,6,11,3,3,3,8,6,6,0,3,3,2,1,1,1,3,21
401384961,Washington Huskies,TEAM,TOTAL,TOTAL,False,,25,52,19,32,6,20,21,28,8,20,28,15,10,4,11,18,77
401384961,George Mason Patriots,J. Oduro,4432068,,True,34.0,6,11,6,11,0,0,9,12,2,7,9,0,1,1,2,2,21
401384961,George Mason Patriots,X. Johnson,4592439,,True,10.0,0,3,0,2,0,1,0,0,0,0,0,1,1,0,1,3,0
401384961,George Mason Patriots,D. Gaines,4431961,,True,34.0,3,5,2,4,1,1,6,6,3,7,10,2,1,0,0,4,13
401384961,George Mason Patriots,D. Cooper,4279876,,True,30.0,7,12,2,3,5,9,2,2,0,0,0,2,0,0,2,4,21
401384961,George Mason Patriots,D. Schwartz,4278501,,True,29.0,3,8,2,5,1,3,0,0,1,6,7,0,0,0,4,5,7
401384961,George Mason Patriots,B. Jones,4897083,,False,16.0,1,2,1,2,0,0,0,0,2,2,4,0,0,0,1,5,2
401384961,George Mason Patriots,M. Henry,4606836,,False,6.0,0,1,0,1,0,0,0,2,2,0,2,1,0,0,1,0,0
401384961,George Mason Patriots,M. Gray,4710354,,False,9.0,0,1,0,0,0,1,0,0,0,0,0,1,0,0,2,0,0
401384961,George Mason Patriots,J. Hartwell II,4396817,,False,32.0,2,11,0,3,2,8,4,4,0,1,1,4,0,0,1,0,10
401384961,George Mason Patriots,TEAM,TOTAL,TOTAL,False,,22,54,13,31,9,23,21,26,13,23,36,11,3,1,14,23,74
401384959,Nevada Wolf Pack,W. Baker,4431691,,True,17.0,3,5,1,2,2,3,0,0,0,0,0,1,0,0,0,4,8
401384959,Nevada Wolf Pack,T. Coleman,4433217,,True,23.0,0,2,0,0,0,2,0,0,0,2,2,2,1,0,2,2,0
401384959,Nevada Wolf Pack,W. Washington,4397093,,True,15.0,1,1,1,1,0,0,0,0,0,4,4,0,0,0,0,5,2
401384959,Nevada Wolf Pack,G. Sherfield,4431794,,True,36.0,11,17,8,11,3,6,6,6,0,6,6,6,1,0,8,1,31
401384959,Nevada Wolf Pack,D. Cambridge Jr.,4279462,,True,33.0,9,20,6,7,3,13,0,1,0,2,2,2,3,1,0,0,21
401384959,Nevada Wolf Pack,D. Henry,4581863,,False,11.0,0,1,0,1,0,0,0,0,0,1,1,0,0,0,0,3,0
401384959,Nevada Wolf Pack,D. Foster,4702876,,False,20.0,0,1,0,1,0,0,6,6,0,1,1,0,2,0,1,4,6
401384959,Nevada Wolf Pack,A. Huseinovic,4702875,,False,14.0,4,6,4,5,0,1,0,0,0,3,3,0,0,0,0,0,8
401384959,Nevada Wolf Pack,J. Weaver,4684168,,False,4.0,0,2,0,1,0,1,0,0,0,0,0,0,0,0,0,0,0
401384959,Nevada Wolf Pack,K. Blackshear,4592846,,False,27.0,2,2,0,0,2,2,6,6,2,3,5,6,0,0,0,3,12
401384959,Nevada Wolf Pack,TEAM,TOTAL,TOTAL,False,,30,57,20,29,10,28,18,19,3,23,26,17,7,1,11,22,88
401384959,George Mason Patriots,J. Oduro,4432068,,True,26.0,5,8,4,6,1,2,4,6,2,3,5,1,3,0,4,4,15
401384959,George Mason Patriots,D. Gaines,4431961,,True,30.0,4,5,3,3,1,2,8,10,2,5,7,1,2,0,0,4,17
401384959,George Mason Patriots,J. Hartwell II,4396817,,True,19.0,1,5,0,0,1,5,0,0,0,0,0,1,0,0,0,1,3
401384959,George Mason Patriots,D. Cooper,4279876,,True,31.0,3,12,0,2,3,10,4,4,0,2,2,2,1,0,4,2,13
401384959,George Mason Patriots,D. Schwartz,4278501,,True,36.0,4,15,3,5,1,10,0,0,2,3,5,3,0,0,2,1,9
401384959,George Mason Patriots,B. Jones,4897083,,False,9.0,0,0,0,0,0,0,0,0,0,1,1,0,0,0,0,2,0
401384959,George Mason Patriots,M. Henry,4606836,,False,6.0,1,1,1,1,0,0,0,0,1,1,2,0,0,0,0,2,2
401384959,George Mason Patriots,J. Kabimba,4592303,,False,3.0,0,0,0,0,0,0,0,0,0,0,0,0,0,0,0,0,0
401384959,George Mason Patriots,O. Frazier III,4700882,,False,9.0,1,3,0,1,1,2,1,2,2,0,2,0,0,1,0,2,4
401384959,George Mason Patriots,T. Gadsden,4719466,,False,8.0,0,1,0,0,0,1,0,0,0,2,2,1,0,0,0,0,0
401384959,George Mason Patriots,M. Gray,4710354,,False,4.0,2,3,2,2,0,1,1,2,0,2,2,0,0,0,2,0,5
401384959,George Mason Patriots,X. Johnson,4592439,,False,19.0,0,3,0,1,0,2,1,2,1,3,4,3,1,0,1,2,1
401384959,George Mason Patriots,TEAM,TOTAL,TOTAL,False,,21,56,13,21,8,35,19,26,10,24,34,12,7,1,14,20,69
401382754,VCU Rams,H. Ward,4592495,,True,14.0,1,5,1,4,0,1,0,0,0,1,1,0,0,0,0,2,2
401382754,VCU Rams,V. Williams Jr.,4397227,,True,40.0,3,14,2,6,1,8,2,2,0,4,4,2,0,2,1,2,9
401382754,VCU Rams,L. Stockard III,4277897,,True,18.0,4,7,4,7,0,0,0,0,0,2,2,0,0,1,0,5,8
401382754,VCU Rams,J. Nunn,4896614,,True,36.0,6,14,4,8,2,6,7,9,3,5,8,0,4,1,2,1,21
401382754,VCU Rams,K. Curry,4397228,,True,36.0,3,9,2,7,1,2,1,2,2,3,5,2,1,0,5,1,8
401382754,VCU Rams,M. Brown-Jones,4433224,,False,19.0,0,1,0,0,0,1,4,6,0,2,2,1,0,3,1,3,4
401382754,VCU Rams,J. DeLoach,4432483,,False,19.0,1,2,1,2,0,0,0,4,3,2,5,2,1,0,1,5,2
401382754,VCU Rams,J. Nichols Jr.,4397108,,False,8.0,0,1,0,1,0,0,0,1,0,0,0,0,1,1,0,1,0
401382754,VCU Rams,N. Kern,4684145,,False,16.0,2,3,2,3,0,0,0,0,0,0,0,0,1,0,0,1,4
401382754,VCU Rams,M. Tsohonis,4592438,,False,14.0,2,6,1,3,1,3,0,0,0,1,1,1,1,0,1,1,5
401382754,VCU Rams,J. Banks,4432402,,False,5.0,0,0,0,0,0,0,0,0,0,0,0,0,0,0,0,1,0
401382754,VCU Rams,TEAM,TOTAL,TOTAL,False,,22,62,17,41,5,21,14,24,13,22,35,8,9,8,14,23,63
401382754,UConn Huskies,I. Whaley,4278231,,True,36.0,6,10,3,7,3,3,1,1,3,1,4,2,2,2,2,4,16
401382754,UConn Huskies,A. Sanogo,4702023,,True,30.0,2,3,2,3,0,0,2,2,4,3,7,3,2,0,3,4,6
401382754,UConn Huskies,A. Jackson,4432190,,True,33.0,1,6,1,5,0,1,0,0,2,12,14,4,0,2,4,2,2
401382754,UConn Huskies,T. Martin,4397179,,True,31.0,2,7,1,4,1,3,2,4,2,6,8,1,0,0,4,4,7
401382754,UConn Huskies,R.J. Cole,4279789,,True,41.0,7,17,4,9,3,8,9,10,4,1,5,2,1,0,3,2,26
401382754,UConn Huskies,A. Akok,4431706,,False,4.0,0,3,0,1,0,2,0,0,0,1,1,0,0,0,0,0,0
401382754,UConn Huskies,T. Polley,4278230,,False,15.0,0,5,0,1,0,4,3,3,1,1,2,0,0,0,1,3,3
401382754,UConn Huskies,J. Hawkins,4683750,,False,13.0,1,3,1,2,0,1,0,0,0,3,3,0,0,0,1,1,2
401382754,UConn Huskies,J. Gaffney,4431732,,False,22.0,1,6,1,4,0,2,6,8,0,3,3,2,0,0,3,2,8
401382754,UConn Huskies,TEAM,TOTAL,TOTAL,False,,20,60,13,36,7,24,23,28,19,33,52,14,5,4,22,22,70
401377135,Saint Joseph's Hawks,T. Funk,4278395,,True,35.0,9,11,1,1,8,10,3,3,2,5,7,1,4,1,2,0,29
401377135,Saint Joseph's Hawks,E. Obinna,4278125,,True,29.0,6,11,6,11,0,0,5,7,2,3,5,1,0,1,0,3,17
401377135,Saint Joseph's Hawks,J. Hall,4701031,,True,37.0,5,14,2,4,3,10,0,0,0,5,5,8,0,1,2,0,13
401377135,Saint Joseph's Hawks,E. Reynolds II,4683952,,True,34.0,3,6,3,5,0,1,1,2,1,0,1,4,1,0,4,3,7
401377135,Saint Joseph's Hawks,C. Brown,4592476,,True,31.0,2,9,2,3,0,6,0,2,1,2,3,4,2,1,3,2,4
401377135,Saint Joseph's Hawks,K. Klaczek,4897053,,False,6.0,0,0,0,0,0,0,0,0,0,1,1,0,0,0,0,0,0
401377135,Saint Joseph's Hawks,A. Jansson,4701029,,False,11.0,0,2,0,2,0,0,1,2,2,1,3,0,0,0,1,4,1
401377135,Saint Joseph's Hawks,J. Forrest,4701032,,False,17.0,3,8,3,3,0,5,0,0,1,2,3,0,2,0,2,2,6
401377135,Saint Joseph's Hawks,TEAM,TOTAL,TOTAL,False,,28,61,17,29,11,32,10,16,11,25,36,18,9,4,15,14,77
401377135,Georgetown Hoyas,T. Ighoefe,4431991,,True,27.0,2,2,2,2,0,0,0,1,5,9,14,1,0,3,1,4,4
401377135,Georgetown Hoyas,D. Harris,4596531,,True,34.0,8,18,8,15,0,3,1,2,0,1,1,6,3,0,2,3,17
401377135,Georgetown Hoyas,A. Mohammed,4433252,,True,31.0,0,10,0,9,0,1,6,8,3,6,9,2,1,0,1,0,6
401377135,Georgetown Hoyas,D. Carey,4402802,,True,38.0,4,11,2,6,2,5,2,2,1,2,3,2,1,0,5,3,12
401377135,Georgetown Hoyas,K. Rice,4280011,,True,29.0,9,15,2,2,7,13,0,0,1,2,3,0,0,0,1,1,25
401377135,Georgetown Hoyas,M. Wilson,4595429,,False,5.0,0,0,0,0,0,0,0,0,0,1,1,0,0,1,0,0,0
401377135,Georgetown Hoyas,C. Holloway,4701559,,False,6.0,2,2,1,1,1,1,0,2,0,0,0,0,1,0,1,1,5
401377135,Georgetown Hoyas,J. Billingsley,4687376,,False,12.0,0,0,0,0,0,0,0,0,1,0,1,1,1,0,2,1,0
401377135,Georgetown Hoyas,R. Mutombo,4683739,,False,9.0,2,3,1,2,1,1,0,0,0,3,3,0,0,0,0,2,5
401377135,Georgetown Hoyas,J. Riley,4683942,,False,3.0,0,0,0,0,0,0,0,0,0,0,0,0,0,0,0,0,0
401377135,Georgetown Hoyas,T. Beard,4433195,,False,6.0,0,1,0,0,0,1,0,0,0,0,0,0,0,0,1,0,0
401377135,Georgetown Hoyas,TEAM,TOTAL,TOTAL,False,,27,62,16,37,11,25,9,15,12,26,38,12,7,4,14,15,74
401377053,St. Bonaventure Bonnies,O. Osunniyi,4397224,,True,30.0,8,10,8,10,0,0,0,1,1,10,11,0,1,4,0,4,16
401377053,St. Bonaventure Bonnies,J. Adaway,4279431,,True,38.0,7,11,7,10,0,1,0,0,1,3,4,0,1,1,1,4,14
401377053,St. Bonaventure Bonnies,J. Holmes,4701016,,True,38.0,5,14,4,10,1,4,8,12,3,10,13,4,1,0,1,2,19
401377053,St. Bonaventure Bonnies,D. Welch,4397221,,True,26.0,2,7,1,2,1,5,0,0,0,4,4,3,4,1,1,3,5
401377053,St. Bonaventure Bonnies,K. Lofton,4397220,,True,36.0,5,10,5,6,0,4,2,2,0,3,3,4,2,0,3,3,12
401377053,St. Bonaventure Bonnies,O. Durosinmi,4684462,,False,2.0,0,0,0,0,0,0,0,0,0,0,0,0,0,1,1,0,0
401377053,St. Bonaventure Bonnies,A. Coulibaly,4432889,,False,8.0,1,3,1,3,0,0,0,0,1,1,2,0,0,1,0,1,2
401377053,St. Bonaventure Bonnies,J. Ndjock-Tadjore,4897048,,False,2.0,0,0,0,0,0,0,0,0,0,0,0,0,0,0,0,2,0
401377053,St. Bonaventure Bonnies,L. Brown,4897047,,False,16.0,0,4,0,1,0,3,2,2,1,1,2,0,0,0,3,0,2
401377053,St. Bonaventure Bonnies,J. Saizonou,4897046,,False,2.0,0,0,0,0,0,0,0,0,0,1,1,0,0,0,1,0,0
401377053,St. Bonaventure Bonnies,Q. Adams,4585591,,False,2.0,0,0,0,0,0,0,0,0,0,0,0,0,0,0,1,2,0
401377053,St. Bonaventure Bonnies,TEAM,TOTAL,TOTAL,False,,28,59,26,42,2,17,12,17,7,33,40,11,9,8,13,21,70
401377053,Marquette Golden Eagles,O. Prosper,4595400,,True,13.0,1,5,1,3,0,2,0,0,0,3,3,1,0,0,0,1,2
401377053,Marquette Golden Eagles,J. Lewis,4432239,,True,33.0,6,13,5,7,1,6,4,4,1,10,11,0,1,0,1,4,17
401377053,Marquette Golden Eagles,K. Kuath,4397028,,True,19.0,3,3,3,3,0,0,3,5,3,2,5,1,0,1,0,1,9
401377053,Marquette Golden Eagles,T. Kolek,4433225,,True,20.0,0,5,0,3,0,2,0,0,1,2,3,0,0,0,2,2,0
401377053,Marquette Golden Eagles,D. Morsell,4277954,,True,27.0,0,8,0,5,0,3,3,4,1,1,2,3,1,0,3,2,3
401377053,Marquette Golden Eagles,D. Joplin,4684306,,False,18.0,3,9,1,3,2,6,2,4,1,3,4,1,1,1,1,1,10
401377053,Marquette Golden Eagles,O. Ighodaro,4601023,,False,10.0,0,0,0,0,0,0,0,0,0,1,1,1,0,0,1,0,0
401377053,Marquette Golden Eagles,E. Ellis,4698721,,False,9.0,1,2,0,1,1,1,1,4,2,1,3,1,0,0,1,1,4
401377053,Marquette Golden Eagles,K. Jones,4697268,,False,29.0,1,7,0,1,1,6,1,3,0,1,1,3,0,0,2,2,4
401377053,Marquette Golden Eagles,S. Mitchell,4683840,,False,12.0,1,1,1,1,0,0,0,0,0,1,1,1,1,0,4,2,2
401377053,Marquette Golden Eagles,G. Elliott,4278570,,False,10.0,1,3,0,2,1,1,0,0,0,1,1,0,1,0,2,1,3
401377053,Marquette Golden Eagles,TEAM,TOTAL,TOTAL,False,,17,56,11,29,6,27,14,24,10,26,36,12,5,2,17,17,54
401377051,St. Bonaventure Bonnies,O. Osunniyi,4397224,,True,37.0,2,4,2,4,0,0,0,0,4,7,11,3,0,2,1,4,4
401377051,St. Bonaventure Bonnies,J. Adaway,4279431,,True,36.0,6,12,4,8,2,4,0,0,0,6,6,2,1,0,2,1,14
401377051,St. Bonaventure Bonnies,J. Holmes,4701016,,True,38.0,5,13,0,5,5,8,4,4,1,4,5,5,1,2,2,1,19
401377051,St. Bonaventure Bonnies,D. Welch,4397221,,True,37.0,3,6,0,0,3,6,0,0,0,4,4,1,0,1,2,2,9
401377051,St. Bonaventure Bonnies,K. Lofton,4397220,,True,40.0,7,16,3,11,4,5,4,4,0,4,4,4,1,0,2,2,22
401377051,St. Bonaventure Bonnies,A. Coulibaly,4432889,,False,3.0,0,1,0,1,0,0,0,0,0,0,0,0,0,0,0,0,0
401377051,St. Bonaventure Bonnies,L. Brown,4897047,,False,8.0,0,2,0,1,0,1,0,0,0,1,1,0,0,0,0,0,0
401377051,St. Bonaventure Bonnies,Q. Adams,4585591,,False,1.0,0,0,0,0,0,0,0,0,0,0,0,0,0,0,0,0,0
401377051,St. Bonaventure Bonnies,TEAM,TOTAL,TOTAL,False,,23,54,9,30,14,24,8,8,5,28,33,15,3,5,9,10,68
401377051,Clemson Tigers,H. Tyson,4395620,,True,34.0,4,9,4,6,0,3,0,0,0,7,7,2,0,0,0,2,8
401377051,Clemson Tigers,PJ Hall,4701225,,True,31.0,8,15,5,10,3,5,3,4,3,5,8,2,0,3,1,1,22
401377051,Clemson Tigers,A. Dawes,4431730,,True,38.0,2,11,0,4,2,7,0,0,1,6,7,2,1,0,1,2,6
401377051,Clemson Tigers,N. Honor,4396810,,True,36.0,5,8,3,3,2,5,0,0,0,2,2,3,2,0,1,1,12
401377051,Clemson Tigers,D. Collins,4278306,,True,26.0,6,9,5,7,1,2,1,4,0,5,5,0,2,0,1,4,14
401377051,Clemson Tigers,I. Schieffelin,4693954,,False,6.0,1,1,0,0,1,1,0,0,0,1,1,0,0,0,0,1,3
401377051,Clemson Tigers,B. Middlebrooks,4684998,,False,3.0,0,0,0,0,0,0,0,0,0,0,0,0,0,0,0,1,0
401377051,Clemson Tigers,N. Bohannon,4285366,,False,18.0,0,1,0,1,0,0,0,0,0,0,0,2,0,0,1,0,0
401377051,Clemson Tigers,C. Hunter,4592184,,False,8.0,0,4,0,4,0,0,0,0,0,0,0,1,1,0,0,0,0
401377051,Clemson Tigers,TEAM,TOTAL,TOTAL,False,,26,58,17,35,9,23,4,8,6,26,32,12,6,3,6,12,65
401377040,East Carolina Pirates,V. Jackson,4066442,,True,29.0,4,10,1,2,3,8,1,1,4,7,11,1,0,0,3,1,12
401377040,East Carolina Pirates,L. Debaut,4592970,,True,24.0,1,4,1,4,0,0,1,2,0,3,3,0,0,1,1,0,3
401377040,East Carolina Pirates,B. Suggs,4592966,,True,28.0,0,5,0,3,0,2,2,2,0,5,5,1,0,0,2,2,2
401377040,East Carolina Pirates,J.J. Miles,4592967,,True,34.0,3,9,1,3,2,6,1,5,1,2,3,2,0,0,1,3,9
401377040,East Carolina Pirates,T. Newton,4592965,,True,34.0,9,14,6,9,3,5,7,8,1,4,5,5,2,0,2,2,28
401377040,East Carolina Pirates,B. Johnson,4897055,,False,11.0,0,2,0,1,0,1,2,2,1,4,5,1,0,0,0,0,2
401377040,East Carolina Pirates,A. Frink,4396950,,False,16.0,2,4,2,4,0,0,0,0,0,2,2,0,0,0,1,2,4
401377040,East Carolina Pirates,R. Felton Jr.,4708215,,False,3.0,0,0,0,0,0,0,0,0,0,0,0,0,0,0,0,2,0
401377040,East Carolina Pirates,T. Robinson-White,4592968,,False,21.0,3,5,2,3,1,2,0,1,0,1,1,3,0,0,1,2,7
401377040,East Carolina Pirates,TEAM,TOTAL,TOTAL,False,,22,53,13,29,9,24,14,21,8,29,37,13,2,1,11,14,67
401377040,Davidson Wildcats,S. Mennenga,4700862,,True,30.0,5,8,5,8,0,0,1,1,3,2,5,2,0,0,1,0,11
401377040,Davidson Wildcats,L. Brajkovic,4396787,,True,30.0,6,10,4,7,2,3,0,0,1,8,9,2,1,1,0,1,14
401377040,Davidson Wildcats,H. Lee,4592308,,True,34.0,8,15,3,5,5,10,4,5,0,10,10,1,0,0,1,3,25
401377040,Davidson Wildcats,F. Loyer,4397208,,True,24.0,3,12,1,5,2,7,2,2,0,0,0,2,0,0,0,3,10
401377040,Davidson Wildcats,M. Jones,4396784,,True,25.0,3,8,1,3,2,5,1,1,0,2,2,8,2,0,1,1,9
401377040,Davidson Wildcats,D. Kristensen,4432020,,False,3.0,0,0,0,0,0,0,0,0,0,0,0,0,0,0,0,2,0
401377040,Davidson Wildcats,N. Boachie-Yiadom,4396786,,False,16.0,1,1,1,1,0,0,0,0,1,1,2,1,0,0,0,2,2
401377040,Davidson Wildcats,D. Watson,4897098,,False,17.0,1,4,1,3,0,1,0,0,0,1,1,1,1,0,2,2,2
401377040,Davidson Wildcats,G. Huffman,4432522,,False,21.0,1,4,1,2,0,2,1,1,0,2,2,3,1,0,1,3,3
401377040,Davidson Wildcats,TEAM,TOTAL,TOTAL,False,,28,62,17,34,11,28,9,10,6,27,33,20,5,1,6,17,76
401377036,Pennsylvania Quakers,M. Martz,4593353,,True,28.0,2,8,0,1,2,7,0,0,0,3,3,2,2,0,1,2,6
401377036,Pennsylvania Quakers,M. Lorca-Lloyd,4431800,,True,28.0,3,6,3,6,0,0,1,2,2,6,8,0,0,1,1,0,7
401377036,Pennsylvania Quakers,J. Dingle,4593351,,True,27.0,5,13,2,4,3,9,0,0,0,1,1,3,0,0,3,4,13
401377036,Pennsylvania Quakers,J. Charles,4593350,,True,32.0,2,9,1,2,1,7,0,1,1,2,3,2,1,0,1,2,5
401377036,Pennsylvania Quakers,J. Williams,4279561,,True,26.0,5,6,5,6,0,0,0,0,1,1,2,1,3,1,3,3,10
401377036,Pennsylvania Quakers,N. Spinoso,4898224,,False,13.0,1,1,1,1,0,0,2,2,0,3,3,1,0,0,1,0,4
401377036,Pennsylvania Quakers,G. Larson,4898223,,False,0.0,1,1,1,1,0,0,0,0,0,0,0,0,0,0,0,0,2
401377036,Pennsylvania Quakers,M. Moshkovitz,4702956,,False,11.0,0,1,0,0,0,1,0,0,0,0,0,0,0,0,1,1,0
401377036,Pennsylvania Quakers,L. Monroe,4593352,,False,15.0,2,4,2,4,0,0,2,2,2,1,3,0,0,0,0,2,6
401377036,Pennsylvania Quakers,G. Smith,4898227,,False,10.0,1,1,0,0,1,1,1,3,0,1,1,1,0,0,0,0,4
401377036,Pennsylvania Quakers,E. Holland III,4898226,,False,1.0,0,0,0,0,0,0,0,0,0,0,0,0,0,0,0,0,0
401377036,Pennsylvania Quakers,C. Slajchert,4702954,,False,7.0,1,2,0,0,1,2,0,0,0,1,1,0,0,0,1,2,3
401377036,Pennsylvania Quakers,B. Washington,4397982,,False,3.0,0,0,0,0,0,0,0,0,0,0,0,1,0,0,0,0,0
401377036,Pennsylvania Quakers,TEAM,TOTAL,TOTAL,False,,23,52,15,25,8,27,6,10,9,21,30,11,6,2,13,16,60
401377036,Davidson Wildcats,S. Mennenga,4700862,,True,28.0,7,10,6,9,1,1,2,2,2,3,5,4,0,0,1,2,17
401377036,Davidson Wildcats,L. Brajkovic,4396787,,True,32.0,6,11,4,8,2,3,0,0,1,10,11,6,1,0,2,0,14
401377036,Davidson Wildcats,H. Lee,4592308,,True,26.0,5,8,3,4,2,4,0,0,0,4,4,2,0,0,2,2,12
401377036,Davidson Wildcats,F. Loyer,4397208,,True,27.0,3,9,3,6,0,3,2,2,0,1,1,4,2,0,1,3,8
401377036,Davidson Wildcats,M. Jones,4396784,,True,31.0,4,8,1,2,3,6,2,2,1,1,2,1,1,0,1,2,13
401377036,Davidson Wildcats,C. Ford,4897099,,False,2.0,0,0,0,0,0,0,0,0,0,0,0,0,0,0,0,0,0
401377036,Davidson Wildcats,D. Kristensen,4432020,,False,2.0,0,1,0,1,0,0,0,0,0,0,0,0,0,0,1,2,0
401377036,Davidson Wildcats,N. Boachie-Yiadom,4396786,,False,14.0,0,0,0,0,0,0,0,0,1,1,2,0,0,0,0,0,0
401377036,Davidson Wildcats,S. Thrastarson,4897100,,False,2.0,0,0,0,0,0,0,0,0,0,0,0,0,0,0,0,0,0
401377036,Davidson Wildcats,D. Watson,4897098,,False,17.0,2,4,2,4,0,0,2,3,0,0,0,1,2,0,0,1,6
401377036,Davidson Wildcats,E. Lanier,4567082,,False,2.0,0,0,0,0,0,0,0,0,0,0,0,0,0,0,0,0,0
401377036,Davidson Wildcats,G. Huffman,4432522,,False,17.0,0,3,0,2,0,1,2,2,0,0,0,1,1,0,1,0,2
401377036,Davidson Wildcats,TEAM,TOTAL,TOTAL,False,,27,54,19,36,8,18,10,11,7,22,29,19,7,0,9,12,72
401377032,Massachusetts Minutemen,D. Dominguez,4701126,,True,27.0,3,6,0,1,3,5,1,4,1,3,4,1,0,1,2,2,10
401377032,Massachusetts Minutemen,T. Buttrick,4277981,,True,30.0,6,11,5,7,1,4,6,7,3,3,6,1,0,0,3,3,19
401377032,Massachusetts Minutemen,N. Fernandes,4431791,,True,19.0,3,6,3,4,0,2,1,2,1,1,2,3,1,0,1,1,7
401377032,Massachusetts Minutemen,C.J. Kelly,4398208,,True,27.0,7,16,3,9,4,7,1,2,1,3,4,1,0,0,2,2,19
401377032,Massachusetts Minutemen,R. Kelly,4279741,,True,33.0,3,10,1,5,2,5,2,4,1,2,3,4,3,0,1,4,10
401377032,Massachusetts Minutemen,D. Walker,4399103,,False,11.0,0,3,0,0,0,3,0,0,1,0,1,0,0,0,0,4,0
401377032,Massachusetts Minutemen,G. Jones,4279211,,False,10.0,1,1,1,1,0,0,0,0,1,1,2,2,0,0,0,3,2
401377032,Massachusetts Minutemen,J. Garcia,4701125,,False,13.0,0,5,0,4,0,1,0,0,0,0,0,0,1,1,0,1,0
401377032,Massachusetts Minutemen,K. Mitchell,4592454,,False,2.0,0,0,0,0,0,0,0,0,0,0,0,0,1,0,0,1,0
401377032,Massachusetts Minutemen,T.J. Weeks,4433108,,False,28.0,8,12,5,6,3,6,0,0,2,6,8,0,1,1,1,3,19
401377032,Massachusetts Minutemen,TEAM,TOTAL,TOTAL,False,,31,70,18,37,13,33,11,19,13,21,34,12,7,3,10,24,86
401377032,Ball State Cardinals,M. Thomas,4279796,,True,18.0,3,9,2,5,1,4,2,2,0,4,4,1,1,0,2,5,9
401377032,Ball State Cardinals,P. Sparks,4898008,,True,27.0,2,7,2,7,0,0,4,5,5,3,8,1,0,0,1,3,8
401377032,Ball State Cardinals,L. Bumbalough,4593397,,True,35.0,3,5,0,1,3,4,5,8,1,1,2,2,2,0,3,2,14
401377032,Ball State Cardinals,T. Cochran,4431930,,True,28.0,7,8,6,7,1,1,7,9,2,6,8,4,2,0,7,2,22
401377032,Ball State Cardinals,D. Jacobs,4397198,,True,20.0,2,4,1,2,1,2,0,0,0,3,3,4,0,0,1,4,5
401377032,Ball State Cardinals,B. Jihad,4898009,,False,8.0,0,0,0,0,0,0,0,0,1,2,3,1,0,0,0,2,0
401377032,Ball State Cardinals,M. Pearson,4431796,,False,26.0,4,9,3,8,1,1,3,3,0,4,4,2,1,1,2,0,12
401377032,Ball State Cardinals,J. Sellers,4898010,,False,17.0,3,4,3,3,0,1,0,0,0,1,1,0,0,0,0,0,6
401377032,Ball State Cardinals,J. Bryan,4703076,,False,2.0,0,0,0,0,0,0,0,0,0,0,0,0,0,0,0,0,0
401377032,Ball State Cardinals,J. Windham,4433123,,False,19.0,3,7,1,4,2,3,5,5,0,2,2,0,0,0,0,1,13
401377032,Ball State Cardinals,TEAM,TOTAL,TOTAL,False,,27,53,18,37,9,16,26,32,9,29,38,15,6,1,16,19,89
401377031,Weber State Wildcats,D. Jones,4702159,,True,34.0,6,11,6,10,0,1,3,3,2,3,5,2,0,0,2,0,15
401377031,Weber State Wildcats,C. Carlson,4286400,,True,22.0,5,7,4,5,1,2,0,1,1,2,3,0,1,0,1,2,11
401377031,Weber State Wildcats,J. Overton,4593976,,True,32.0,9,11,6,7,3,4,0,0,1,4,5,2,1,1,2,4,21
401377031,Weber State Wildcats,S. Sisoho Jawara,4593773,,True,36.0,3,8,2,3,1,5,0,0,0,3,3,9,0,0,2,2,7
401377031,Weber State Wildcats,K. McEwen,4066755,,True,37.0,6,11,3,6,3,5,4,6,2,5,7,4,1,1,2,1,19
401377031,Weber State Wildcats,D. Koehler,4702350,,False,7.0,0,1,0,1,0,0,0,0,0,0,0,0,0,0,0,0,0
401377031,Weber State Wildcats,A. Tew,4897981,,False,10.0,1,3,1,3,0,0,0,0,2,1,3,2,0,0,2,3,2
401377031,Weber State Wildcats,Z. Porter,4405290,,False,22.0,4,6,1,2,3,4,2,2,0,6,6,1,2,0,0,2,13
401377031,Weber State Wildcats,TEAM,TOTAL,TOTAL,False,,34,58,23,37,11,21,9,12,8,25,33,20,5,2,11,14,88
401377031,Massachusetts Minutemen,D. Dominguez,4701126,,True,13.0,2,2,2,2,0,0,0,0,0,2,2,0,0,0,0,1,4
401377031,Massachusetts Minutemen,T. Buttrick,4277981,,True,24.0,4,9,1,4,3,5,1,2,1,2,3,4,1,1,2,2,12
401377031,Massachusetts Minutemen,T.J. Weeks,4433108,,True,15.0,3,7,1,1,2,6,0,0,1,1,2,0,0,0,1,3,8
401377031,Massachusetts Minutemen,N. Fernandes,4431791,,True,36.0,9,17,7,10,2,7,1,2,2,1,3,5,1,0,0,2,21
401377031,Massachusetts Minutemen,R. Kelly,4279741,,True,29.0,3,8,2,4,1,4,2,2,0,2,2,2,0,0,2,2,9
401377031,Massachusetts Minutemen,D. Walker,4399103,,False,22.0,2,3,1,1,1,2,0,0,4,1,5,1,2,0,0,3,5
401377031,Massachusetts Minutemen,G. Jones,4279211,,False,16.0,1,3,0,1,1,2,0,0,1,2,3,2,0,0,2,1,3
401377031,Massachusetts Minutemen,C. McCrory,4701127,,False,5.0,0,0,0,0,0,0,0,0,1,0,1,0,1,0,0,1,0
401377031,Massachusetts Minutemen,J. Garcia,4701125,,False,2.0,0,0,0,0,0,0,0,2,0,0,0,0,0,0,0,1,0
401377031,Massachusetts Minutemen,K. Mitchell,4592454,,False,6.0,0,2,0,1,0,1,0,0,0,1,1,1,0,0,1,0,0
401377031,Massachusetts Minutemen,P. Santos,4432104,,False,1.0,0,0,0,0,0,0,0,0,0,0,0,0,0,0,0,0,0
401377031,Massachusetts Minutemen,C.J. Kelly,4398208,,False,31.0,4,11,1,1,3,10,0,0,0,5,5,1,1,1,3,1,11
401377031,Massachusetts Minutemen,TEAM,TOTAL,TOTAL,False,,28,62,15,25,13,37,4,8,10,19,29,16,6,2,11,17,73
401376744,Duquesne Dukes,T. Williams,4432147,,True,37.0,5,12,5,9,0,3,5,7,5,2,7,0,1,3,2,3,15
401376744,Duquesne Dukes,K. Easley,4398159,,True,33.0,4,9,2,6,2,3,0,0,4,3,7,0,0,0,0,2,10
401376744,Duquesne Dukes,A. Spears,4897090,,True,30.0,5,10,4,8,1,2,3,4,0,2,2,4,0,0,5,2,14
401376744,Duquesne Dukes,T. Okani,4700873,,True,4.0,0,2,0,2,0,0,0,0,0,2,2,0,0,0,0,1,0
401376744,Duquesne Dukes,T. Acuff,4606831,,True,31.0,2,3,2,3,0,0,0,0,0,3,3,1,0,1,3,2,4
401376744,Duquesne Dukes,A. Rotroff,4396806,,False,3.0,0,0,0,0,0,0,0,0,0,0,0,0,0,0,0,1,0
401376744,Duquesne Dukes,D. Larson,4897091,,False,8.0,0,1,0,0,0,1,0,0,1,2,3,0,0,0,0,0,0
401376744,Duquesne Dukes,J. Johnson III,4897088,,False,20.0,5,8,3,6,2,2,0,0,1,2,3,0,1,0,2,0,12
401376744,Duquesne Dukes,L. Ayers III,4703813,,False,34.0,7,13,6,10,1,3,8,9,0,7,7,2,4,2,2,1,23
401376744,Duquesne Dukes,TEAM,TOTAL,TOTAL,False,,28,58,22,44,6,14,16,20,13,25,38,7,6,6,16,12,78
401376744,Bradley Braves,M. Leons,4897449,,True,23.0,3,5,0,2,3,3,0,0,1,2,3,0,0,0,1,3,9
401376744,Bradley Braves,R. Mast,4592677,,True,25.0,3,12,3,11,0,1,2,4,2,4,6,0,1,2,1,1,8
401376744,Bradley Braves,J. Henry,4397325,,True,29.0,6,12,5,10,1,2,1,2,4,6,10,0,0,1,3,4,14
401376744,Bradley Braves,T. Roberts,4897444,,True,31.0,6,13,5,11,1,2,4,5,2,1,3,3,3,0,2,2,17
401376744,Bradley Braves,V. Tahvanainen,4433093,,True,12.0,0,3,0,0,0,3,0,0,0,1,1,2,0,0,1,0,0
401376744,Bradley Braves,A. Boya,4397323,,False,14.0,3,4,3,4,0,0,0,0,3,1,4,0,2,2,2,2,6
401376744,Bradley Braves,J. Kent,4703889,,False,6.0,0,2,0,1,0,1,0,0,0,2,2,0,0,0,1,0,0
401376744,Bradley Braves,C. Hickman,4897447,,False,26.0,4,7,1,3,3,4,3,3,1,1,2,2,0,0,1,4,14
401376744,Bradley Braves,Z. Montgomery,4897446,,False,10.0,0,3,0,2,0,1,0,0,0,2,2,1,0,0,0,0,0
401376744,Bradley Braves,M. Howell,4702604,,False,24.0,1,3,1,1,0,2,0,0,0,0,0,4,2,0,2,2,2
401376744,Bradley Braves,TEAM,TOTAL,TOTAL,False,,26,64,18,45,8,19,10,14,14,20,34,12,8,5,14,18,70
401376739,Duquesne Dukes,T. Williams,4432147,,True,40.0,6,14,5,11,1,3,4,6,2,5,7,3,0,7,3,5,17
401376739,Duquesne Dukes,K. Easley,4398159,,True,40.0,7,15,5,11,2,4,3,3,5,7,12,1,1,0,2,2,19
401376739,Duquesne Dukes,A. Spears,4897090,,True,31.0,2,6,0,4,2,2,0,0,0,1,1,2,1,0,0,3,6
401376739,Duquesne Dukes,T. Okani,4700873,,True,36.0,4,8,3,4,1,4,0,0,1,2,3,0,1,0,4,3,9
401376739,Duquesne Dukes,T. Acuff,4606831,,True,20.0,2,5,1,3,1,2,0,1,1,5,6,2,0,0,0,3,5
401376739,Duquesne Dukes,A. Rotroff,4396806,,False,9.0,0,3,0,2,0,1,0,2,1,1,2,0,0,0,0,2,0
401376739,Duquesne Dukes,J. Johnson III,4897088,,False,19.0,2,5,1,3,1,2,0,0,1,1,2,4,0,0,4,1,5
401376739,Duquesne Dukes,L. Ayers III,4703813,,False,30.0,5,11,2,5,3,6,2,2,0,4,4,0,0,0,1,2,15
401376739,Duquesne Dukes,TEAM,TOTAL,TOTAL,False,,28,67,17,43,11,24,9,14,16,26,42,12,3,7,15,21,76
401376739,Colorado Buffaloes,T. da Silva,4702382,,True,30.0,4,9,3,6,1,3,1,2,3,1,4,2,1,0,2,4,10
401376739,Colorado Buffaloes,J. Walker,4432446,,True,34.0,4,15,3,10,1,5,4,5,5,8,13,1,0,1,1,1,13
401376739,Colorado Buffaloes,E. Battey,4278506,,True,32.0,7,13,7,12,0,1,4,5,3,2,5,2,3,1,2,2,18
401376739,Colorado Buffaloes,K. Barthelemy,4581504,,True,30.0,5,8,3,6,2,2,0,0,0,2,2,1,0,0,1,0,12
401376739,Colorado Buffaloes,E. Parquet,4397062,,True,30.0,3,11,3,8,0,3,3,4,0,2,2,0,1,1,1,1,9
401376739,Colorado Buffaloes,L. O'Brien,4702380,,False,16.0,2,3,2,2,0,1,0,0,2,5,7,1,0,2,1,3,4
401376739,Colorado Buffaloes,L. Lovering,4596528,,False,4.0,0,2,0,2,0,0,0,0,0,0,0,1,0,0,0,0,0
401376739,Colorado Buffaloes,N. Clifford,4702384,,False,14.0,3,6,3,5,0,1,1,1,3,2,5,0,1,0,2,3,7
401376739,Colorado Buffaloes,J. Hammond III,4692907,,False,4.0,0,1,0,0,0,1,0,0,0,1,1,0,0,0,0,0,0
401376739,Colorado Buffaloes,KJ Simpson,4683834,,False,31.0,3,8,3,6,0,2,5,6,1,2,3,4,0,1,1,1,11
401376739,Colorado Buffaloes,TEAM,TOTAL,TOTAL,False,,31,76,27,57,4,19,18,23,22,26,48,12,6,6,11,15,84
401376735,Rice Owls,M. Fiedler,4431964,,True,19.0,3,8,3,8,0,0,1,1,2,3,5,2,1,1,2,5,7
401376735,Rice Owls,T. Evee,4593712,,True,28.0,4,9,1,1,3,8,1,2,1,1,2,1,0,0,1,1,12
401376735,Rice Owls,C. Sheffield,4432321,,True,21.0,2,3,1,2,1,1,0,0,1,1,2,1,0,0,1,0,5
401376735,Rice Owls,C. Mullins,4397690,,True,27.0,2,10,2,8,0,2,2,2,0,3,3,1,0,0,4,4,6
401376735,Rice Owls,C. Pierre,4278368,,True,34.0,7,12,1,5,6,7,6,6,0,3,3,1,1,0,0,2,26
401376735,Rice Owls,M. Poteat,4590358,,False,14.0,1,5,1,5,0,0,2,2,1,4,5,0,0,0,1,3,4
401376735,Rice Owls,R. Abercrombie,4397265,,False,7.0,0,2,0,1,0,1,0,0,0,1,1,1,0,0,0,1,0
401376735,Rice Owls,J. Lieppert,4703102,,False,12.0,1,1,1,1,0,0,0,0,1,2,3,1,0,1,1,1,2
401376735,Rice Owls,Q. Olivari,4432070,,False,20.0,2,6,0,1,2,5,0,0,0,5,5,1,0,0,2,2,6
401376735,Rice Owls,T. McBride,4279474,,False,18.0,3,3,3,3,0,0,0,0,0,2,2,1,1,0,2,1,6
401376735,Rice Owls,TEAM,TOTAL,TOTAL,False,,25,59,13,35,12,24,12,13,6,25,31,10,3,2,15,20,74
401376735,Fordham Rams,C. Ohams,4066856,,True,31.0,4,8,4,8,0,0,3,6,2,5,7,1,0,3,4,3,11
401376735,Fordham Rams,A. Charlton,4897085,,True,35.0,6,11,2,4,4,7,2,2,2,10,12,2,1,0,3,3,18
401376735,Fordham Rams,K. Rose,4592315,,True,30.0,1,7,0,1,1,6,0,0,1,2,3,1,1,0,0,3,3
401376735,Fordham Rams,D. Quisenberry,4397790,,True,36.0,7,14,4,6,3,8,7,8,1,6,7,0,3,0,0,0,24
401376735,Fordham Rams,A. Daye Jr.,4397500,,True,31.0,8,15,7,12,1,3,3,3,0,2,2,4,1,0,1,3,20
401376735,Fordham Rams,A. Tsimbila,4702329,,False,3.0,0,0,0,0,0,0,0,0,0,0,0,0,0,1,0,1,0
401376735,Fordham Rams,R. Novitskyi,4897084,,False,5.0,0,0,0,0,0,0,0,0,0,1,1,0,0,1,0,1,0
401376735,Fordham Rams,A. Harrison,4897086,,False,14.0,2,2,2,2,0,0,1,2,1,0,1,0,1,0,0,0,5
401376735,Fordham Rams,K. Cunningham,4705891,,False,2.0,0,1,0,0,0,1,0,0,0,0,0,0,0,0,0,0,0
401376735,Fordham Rams,J. Navarro,4592316,,False,13.0,1,2,0,0,1,2,0,0,0,0,0,2,0,0,0,2,3
401376735,Fordham Rams,TEAM,TOTAL,TOTAL,False,,29,60,19,33,10,27,16,21,7,26,33,10,7,5,9,16,84
401376731,Fordham Rams,A. Tsimbila,4702329,,True,7.0,3,6,3,6,0,0,0,0,3,1,4,0,0,0,1,3,6
401376731,Fordham Rams,C. Ohams,4066856,,True,33.0,4,10,4,10,0,0,4,6,4,4,8,3,1,0,1,1,12
401376731,Fordham Rams,K. Rose,4592315,,True,26.0,4,6,2,2,2,4,0,0,0,0,0,0,1,0,0,3,10
401376731,Fordham Rams,D. Quisenberry,4397790,,True,34.0,3,13,1,6,2,7,2,2,0,3,3,1,2,0,3,4,10
401376731,Fordham Rams,A. Daye Jr.,4397500,,True,28.0,5,12,4,8,1,4,4,4,1,3,4,2,1,0,2,3,15
401376731,Fordham Rams,R. Novitskyi,4897084,,False,8.0,1,5,0,0,1,5,0,0,0,1,1,0,0,0,0,1,3
401376731,Fordham Rams,A. Harrison,4897086,,False,16.0,1,2,1,1,0,1,3,4,1,0,1,1,2,0,0,2,5
401376731,Fordham Rams,A. Charlton,4897085,,False,30.0,0,2,0,1,0,1,1,2,1,3,4,1,0,0,0,5,1
401376731,Fordham Rams,K. Cunningham,4705891,,False,4.0,0,2,0,0,0,2,0,0,2,3,5,1,0,0,0,0,0
401376731,Fordham Rams,A. Evans,4700881,,False,0.0,0,1,0,0,0,1,0,0,0,0,0,0,0,0,0,0,0
401376731,Fordham Rams,J. Navarro,4592316,,False,14.0,3,8,0,1,3,7,0,0,1,1,2,2,2,0,1,1,9
401376731,Fordham Rams,TEAM,TOTAL,TOTAL,False,,24,67,15,35,9,32,14,18,14,19,33,11,9,0,9,24,71
401376731,Delaware Blue Hens,A. Carr,4702743,,True,33.0,4,7,3,3,1,4,0,0,1,6,7,2,1,1,3,0,9
401376731,Delaware Blue Hens,D. Painter,4065840,,True,29.0,4,8,4,8,0,0,9,12,1,5,6,2,0,1,3,3,17
401376731,Delaware Blue Hens,J. Nelson Jr.,4592444,,True,28.0,5,6,4,5,1,1,4,4,0,3,3,1,1,0,6,3,15
401376731,Delaware Blue Hens,R. Allen,4279190,,True,36.0,1,2,0,0,1,2,6,7,0,0,0,3,0,0,2,2,9
401376731,Delaware Blue Hens,K. Anderson,4279189,,True,28.0,3,5,3,4,0,1,5,6,0,5,5,0,0,0,2,5,11
401376731,Delaware Blue Hens,J. Davis,4701989,,False,14.0,4,7,4,6,0,1,0,1,0,3,3,0,0,1,0,1,8
401376731,Delaware Blue Hens,G. Arletti,4702742,,False,19.0,2,2,1,1,1,1,2,4,0,4,4,0,0,0,1,2,7
401376731,Delaware Blue Hens,E. Asamoah,4597790,,False,13.0,1,3,0,0,1,3,2,2,0,2,2,1,0,0,0,2,5
401376731,Delaware Blue Hens,TEAM,TOTAL,TOTAL,False,,24,40,19,27,5,13,28,36,2,28,30,9,2,3,17,18,81
401376721,Dayton Flyers,R.J. Blakney,4700864,,True,12.0,1,5,1,2,0,3,0,0,1,1,2,0,0,0,1,0,2
401376721,Dayton Flyers,T. Camara,4431736,,True,31.0,4,9,4,8,0,1,1,4,2,3,5,2,0,1,1,2,9
401376721,Dayton Flyers,D. Holmes II,4433607,,True,32.0,5,7,5,7,0,0,1,2,2,8,10,2,0,6,1,3,11
401376721,Dayton Flyers,M. Smith,4683861,,True,34.0,4,9,4,8,0,1,2,2,1,4,5,6,3,0,4,3,10
401376721,Dayton Flyers,E. Weaver,4397139,,True,22.0,2,3,0,0,2,3,0,0,0,0,0,2,1,0,4,0,6
401376721,Dayton Flyers,M. Sissoko,4431824,,False,6.0,0,1,0,1,0,0,0,0,0,1,1,0,0,0,0,0,0
401376721,Dayton Flyers,M. Amzil,4711607,,False,11.0,2,3,1,1,1,2,0,0,1,0,1,0,0,0,0,0,5
401376721,Dayton Flyers,K. Elvis,4683135,,False,17.0,4,4,2,2,2,2,0,0,0,1,1,3,0,0,0,1,10
401376721,Dayton Flyers,K. Brea,4591259,,False,29.0,3,8,1,2,2,6,0,0,0,3,3,1,0,0,1,1,8
401376721,Dayton Flyers,L. Greer III,4433175,,False,6.0,1,2,1,2,0,0,0,0,0,0,0,1,0,0,0,0,2
401376721,Dayton Flyers,TEAM,TOTAL,TOTAL,False,,26,51,19,33,7,18,4,8,7,21,28,17,4,7,13,10,63
401376721,Belmont Bruins,N. Muszynski,4279923,,True,35.0,10,16,10,16,0,0,3,4,1,4,5,4,2,1,3,2,23
401376721,Belmont Bruins,W. Richard,4897262,,True,30.0,2,3,2,2,0,1,0,0,2,3,5,2,2,0,1,2,4
401376721,Belmont Bruins,B. Sheppard,4433076,,True,37.0,6,17,4,8,2,9,0,0,0,2,2,1,1,0,1,0,14
401376721,Belmont Bruins,L. Smith,4402243,,True,26.0,1,6,0,0,1,6,0,0,0,3,3,1,0,0,1,1,3
401376721,Belmont Bruins,G. Murphy,4279920,,True,35.0,3,6,3,4,0,2,1,2,0,6,6,3,1,0,2,2,7
401376721,Belmont Bruins,E. Brauns,4703219,,False,3.0,0,1,0,1,0,0,0,0,0,0,0,0,0,1,0,0,0
401376721,Belmont Bruins,F. Jakubicek,4703221,,False,1.0,0,0,0,0,0,0,1,2,0,0,0,0,0,0,1,1,1
401376721,Belmont Bruins,M. Shanks,4433075,,False,8.0,0,0,0,0,0,0,0,0,0,0,0,0,0,0,0,1,0
401376721,Belmont Bruins,J. Wood,4703220,,False,12.0,1,2,0,1,1,1,0,0,0,1,1,0,0,0,1,1,3
401376721,Belmont Bruins,T. Pierson,4279922,,False,13.0,2,4,0,1,2,3,0,0,2,1,3,1,0,0,0,0,6
401376721,Belmont Bruins,TEAM,TOTAL,TOTAL,False,,25,55,19,33,6,22,5,8,5,20,25,12,6,2,10,10,61
401376716,Kansas Jayhawks,D. McCormack,4397019,,True,25.0,2,6,2,6,0,0,1,2,4,1,5,1,5,2,2,4,5
401376716,Kansas Jayhawks,D. Harris,4431983,,True,28.0,1,1,1,1,0,0,0,0,0,0,0,2,0,0,1,2,2
401376716,Kansas Jayhawks,C. Braun,4431767,,True,35.0,8,12,8,11,0,1,1,2,2,6,8,5,4,0,0,2,17
401376716,Kansas Jayhawks,O. Agbaji,4397018,,True,33.0,8,16,6,10,2,6,3,7,2,0,2,0,0,0,0,1,21
401376716,Kansas Jayhawks,R. Martin,4278133,,True,25.0,7,11,6,7,1,4,2,4,0,3,3,0,2,0,0,3,17
401376716,Kansas Jayhawks,Z. Clemence,4683146,,False,4.0,1,1,0,0,1,1,0,0,1,0,1,0,0,0,0,1,3
401376716,Kansas Jayhawks,K.J. Adams,4433259,,False,1.0,0,0,0,0,0,0,0,0,0,0,0,0,0,0,0,0,0
401376716,Kansas Jayhawks,J. Wilson,4431714,,False,23.0,0,4,0,1,0,3,1,4,1,1,2,1,1,0,2,0,1
401376716,Kansas Jayhawks,M. Lightfoot,4066300,,False,11.0,1,2,1,2,0,0,0,0,1,2,3,0,1,0,1,3,2
401376716,Kansas Jayhawks,B. Pettiford,4683841,,False,2.0,0,0,0,0,0,0,0,0,0,0,0,0,0,0,0,0,0
401376716,Kansas Jayhawks,J. Yesufu,4431856,,False,5.0,2,4,2,2,0,2,1,1,0,0,0,1,0,0,0,0,5
401376716,Kansas Jayhawks,J. Coleman-Lands,3911842,,False,8.0,0,3,0,1,0,2,0,0,0,0,0,1,0,0,0,1,0
401376716,Kansas Jayhawks,TEAM,TOTAL,TOTAL,False,,30,60,26,41,4,19,9,20,11,13,24,11,13,2,7,17,73
401376716,Dayton Flyers,R.J. Blakney,4700864,,True,19.0,1,4,1,4,0,0,0,0,2,0,2,0,0,0,1,2,2
401376716,Dayton Flyers,T. Camara,4431736,,True,30.0,6,9,6,9,0,0,2,2,2,5,7,2,0,1,3,2,14
401376716,Dayton Flyers,D. Holmes II,4433607,,True,31.0,6,9,6,8,0,1,4,7,2,1,3,1,0,2,0,1,16
401376716,Dayton Flyers,M. Smith,4683861,,True,34.0,5,10,5,8,0,2,0,0,0,5,5,6,2,0,5,3,10
401376716,Dayton Flyers,E. Weaver,4397139,,True,30.0,4,7,1,1,3,6,3,4,0,4,4,2,0,0,2,2,14
401376716,Dayton Flyers,M. Sissoko,4431824,,False,8.0,2,4,2,4,0,0,0,0,3,1,4,0,0,0,2,0,4
401376716,Dayton Flyers,M. Amzil,4711607,,False,15.0,1,1,1,1,0,0,2,4,3,2,5,0,0,0,1,2,4
401376716,Dayton Flyers,K. Brea,4591259,,False,28.0,4,11,2,3,2,8,0,2,0,2,2,0,1,0,1,2,10
401376716,Dayton Flyers,L. Greer III,4433175,,False,5.0,0,0,0,0,0,0,0,0,0,0,0,1,0,0,2,1,0
401376716,Dayton Flyers,TEAM,TOTAL,TOTAL,False,,29,55,24,38,5,17,11,19,12,20,32,12,3,3,20,15,74
401376680,Richmond Spiders,T. Burton,4431914,,True,40.0,9,16,9,10,0,6,5,6,1,6,7,1,1,2,2,1,23
401376680,Richmond Spiders,N. Cayo,4278380,,True,33.0,2,4,2,4,0,0,1,2,2,2,4,2,0,0,1,2,5
401376680,Richmond Spiders,G. Golden,4066836,,True,32.0,5,15,2,8,3,7,0,0,0,3,3,5,3,1,2,4,13
401376680,Richmond Spiders,I. Wilson,4700973,,True,22.0,1,1,0,0,1,1,0,0,0,1,1,0,0,0,1,2,3
401376680,Richmond Spiders,J. Gilyard,4278378,,True,42.0,5,14,1,3,4,11,3,4,2,2,4,6,6,0,1,1,17
401376680,Richmond Spiders,M. Grace,4397192,,False,15.0,0,1,0,0,0,1,0,0,0,0,0,1,0,0,0,4,0
401376680,Richmond Spiders,S. Koureissi,4397190,,False,2.0,0,0,0,0,0,0,0,0,0,0,0,0,0,0,0,0,0
401376680,Richmond Spiders,D. Bailey,4700974,,False,19.0,4,6,4,5,0,1,2,3,0,0,0,0,0,0,2,2,10
401376680,Richmond Spiders,C. Crabtree,4396658,,False,7.0,0,0,0,0,0,0,0,0,0,0,0,0,0,0,0,1,0
401376680,Richmond Spiders,N. Sherod,4066832,,False,13.0,0,4,0,1,0,3,0,0,0,0,0,0,0,0,0,0,0
401376680,Richmond Spiders,TEAM,TOTAL,TOTAL,False,,26,61,18,31,8,30,11,15,5,14,19,15,10,3,9,17,71
401376680,Mississippi State Bulldogs,D.J. Jeffries,4431682,,True,35.0,4,9,3,6,1,3,4,4,1,3,4,1,0,2,4,0,13
401376680,Mississippi State Bulldogs,T. Smith,4397882,,True,32.0,10,11,10,11,0,0,2,3,5,6,11,0,1,0,1,2,22
401376680,Mississippi State Bulldogs,G. Brooks,4277908,,True,25.0,5,7,4,6,1,1,0,0,2,5,7,0,0,0,2,5,11
401376680,Mississippi State Bulldogs,S. Moore,4602027,,True,37.0,2,8,1,5,1,3,3,4,3,2,5,4,0,0,2,3,8
401376680,Mississippi State Bulldogs,I. Molinar,4432885,,True,39.0,6,13,4,7,2,6,1,2,0,4,4,7,2,0,1,0,15
401376680,Mississippi State Bulldogs,D. Fountain,4702432,,False,1.0,1,1,1,1,0,0,0,0,0,0,0,0,0,0,0,0,2
401376680,Mississippi State Bulldogs,A. Garcia,4702431,,False,10.0,0,2,0,2,0,0,4,4,2,3,5,1,0,0,2,2,4
401376680,Mississippi State Bulldogs,C. Matthews,4432394,,False,32.0,1,2,1,1,0,1,5,6,0,5,5,1,3,1,4,4,7
401376680,Mississippi State Bulldogs,R. Watts,4432818,,False,14.0,0,2,0,1,0,1,0,0,0,1,1,0,0,0,1,0,0
401376680,Mississippi State Bulldogs,TEAM,TOTAL,TOTAL,False,,29,55,24,40,5,15,19,23,13,29,42,14,6,3,17,16,82
401376649,Stephen F. Austin Lumberjacks,C. Solomon,4594155,,True,19.0,4,6,4,5,0,1,0,0,3,3,6,0,1,1,4,4,8
401376649,Stephen F. Austin Lumberjacks,G. Kensmil,4279493,,True,28.0,4,8,4,7,0,1,3,7,0,3,3,1,1,1,3,4,11
401376649,Stephen F. Austin Lumberjacks,J. Jackson-Posey,4703691,,True,20.0,0,3,0,2,0,1,2,2,0,3,3,2,1,1,0,4,2
401376649,Stephen F. Austin Lumberjacks,R. Ware,4594152,,True,37.0,2,10,1,6,1,4,4,4,0,2,2,5,2,0,3,1,9
401376649,Stephen F. Austin Lumberjacks,D. Kachelries,4278450,,True,26.0,4,6,4,5,0,1,4,4,0,1,1,1,1,0,0,4,12
401376649,Stephen F. Austin Lumberjacks,S. Hall,4713935,,False,26.0,4,10,4,10,0,0,6,8,2,5,7,0,1,3,0,3,14
401376649,Stephen F. Austin Lumberjacks,N. Antwi-Boasiako,4703693,,False,21.0,2,3,2,2,0,1,1,2,1,2,3,1,0,1,2,1,5
401376649,Stephen F. Austin Lumberjacks,D. Tezeno,4896946,,False,1.0,0,0,0,0,0,0,0,0,0,0,0,0,0,0,0,0,0
401376649,Stephen F. Austin Lumberjacks,J. Cofer,4896948,,False,2.0,0,0,0,0,0,0,0,0,0,0,0,0,0,0,0,0,0
401376649,Stephen F. Austin Lumberjacks,L. Jossell,4601284,,False,20.0,3,6,2,3,1,3,0,0,0,0,0,0,2,0,2,3,7
401376649,Stephen F. Austin Lumberjacks,TEAM,TOTAL,TOTAL,False,,23,52,21,40,2,12,20,27,8,20,28,10,9,7,15,24,68
401376649,Saint Louis Billikens,T. Hargrove Jr.,4592484,,True,22.0,1,6,0,3,1,3,0,0,2,3,5,1,0,0,1,3,3
401376649,Saint Louis Billikens,M. Linssen,4279174,,True,28.0,5,8,5,8,0,0,9,12,2,6,8,1,1,2,1,3,19
401376649,Saint Louis Billikens,J. Nesbitt,4714246,,True,28.0,4,7,3,5,1,2,0,0,0,4,4,1,0,0,0,4,9
401376649,Saint Louis Billikens,Y. Collins,4432957,,True,36.0,2,7,2,7,0,0,7,8,1,2,3,4,1,0,6,2,11
401376649,Saint Louis Billikens,G. Jimerson,4432008,,True,29.0,5,10,3,5,2,5,7,8,0,3,3,1,0,0,5,0,19
401376649,Saint Louis Billikens,L. Traore,4897052,,False,1.0,0,0,0,0,0,0,0,0,0,0,0,0,0,0,1,0,0
401376649,Saint Louis Billikens,F. Okoro,4397105,,False,16.0,0,3,0,3,0,0,0,0,1,1,2,0,0,3,1,5,0
401376649,Saint Louis Billikens,F. Thatch Jr.,4397199,,False,21.0,3,7,2,3,1,4,1,2,1,3,4,2,2,0,0,2,8
401376649,Saint Louis Billikens,D. Jones,4278267,,False,19.0,2,5,1,3,1,2,5,5,2,1,3,2,1,0,0,1,10
401376649,Saint Louis Billikens,TEAM,TOTAL,TOTAL,False,,22,53,16,37,6,16,29,35,13,23,36,12,5,5,16,20,79
401376639,Missouri State Bears,G. Prim,4592711,,True,30.0,9,17,9,16,0,1,2,3,3,6,9,1,1,3,3,2,20
401376639,Missouri State Bears,K. Hervey,4278278,,True,18.0,0,1,0,0,0,1,0,0,0,2,2,0,0,1,2,1,0
401376639,Missouri State Bears,D. Clay,4592730,,True,30.0,2,4,2,4,0,0,2,2,1,2,3,0,1,0,0,0,6
401376639,Missouri State Bears,J. Black,4592709,,True,29.0,5,11,1,2,4,9,0,0,0,5,5,1,1,0,1,1,14
401376639,Missouri State Bears,I. Mosley,4432879,,True,26.0,2,8,2,8,0,0,3,4,2,5,7,3,1,0,2,1,7
401376639,Missouri State Bears,D. Carper,4397464,,False,8.0,2,4,2,3,0,1,0,0,1,0,1,0,0,0,0,0,4
401376639,Missouri State Bears,N. Tata,4703978,,False,4.0,0,2,0,1,0,1,0,0,0,1,1,0,0,0,0,1,0
401376639,Missouri State Bears,I. Haney,4897477,,False,10.0,0,3,0,1,0,2,0,0,0,2,2,0,1,0,0,0,0
401376639,Missouri State Bears,L. Patterson,4703979,,False,25.0,1,4,1,3,0,1,3,4,1,1,2,5,1,0,2,3,5
401376639,Missouri State Bears,J. Minnett,4279244,,False,20.0,5,7,1,1,4,6,2,2,0,3,3,2,0,0,1,0,16
401376639,Missouri State Bears,TEAM,TOTAL,TOTAL,False,,26,61,18,39,8,22,12,15,10,29,39,12,6,4,11,9,72
401376639,George Washington Revolutionaries,N. Brown,4700963,,True,20.0,5,8,5,8,0,0,2,2,1,3,4,0,1,0,3,4,12
401376639,George Washington Revolutionaries,B. Freeman,4613126,,True,29.0,0,3,0,2,0,1,0,0,0,1,1,3,1,0,2,2,0
401376639,George Washington Revolutionaries,J. Bamisile,4432537,,True,27.0,5,11,3,5,2,6,0,0,1,6,7,1,0,0,3,4,12
401376639,George Washington Revolutionaries,J. Bishop,4431770,,True,37.0,6,17,3,8,3,9,2,2,1,1,2,2,0,0,1,3,17
401376639,George Washington Revolutionaries,B. Adams,4396612,,True,28.0,2,9,2,5,0,4,0,0,0,3,3,1,1,0,1,2,4
401376639,George Washington Revolutionaries,D. Nixon,4897075,,False,2.0,0,0,0,0,0,0,0,0,0,1,1,1,0,0,0,0,0
401376639,George Washington Revolutionaries,H. Dean,4593273,,False,16.0,0,3,0,3,0,0,0,0,0,2,2,0,1,1,1,2,0
401376639,George Washington Revolutionaries,M. Gally,4592445,,False,2.0,1,1,1,1,0,0,0,1,0,0,0,0,0,0,0,0,2
401376639,George Washington Revolutionaries,Q. Samuels,4592251,,False,2.0,1,1,1,1,0,0,0,0,1,1,2,0,0,0,0,0,2
401376639,George Washington Revolutionaries,R. Lindo Jr.,4397186,,False,29.0,2,4,2,4,0,0,1,2,1,5,6,1,1,0,3,2,5
401376639,George Washington Revolutionaries,T. Stamoulis,4897076,,False,1.0,0,1,0,0,0,1,0,0,0,0,0,0,0,0,0,0,0
401376639,George Washington Revolutionaries,A. Harris,4397216,,False,6.0,0,0,0,0,0,0,0,0,0,0,0,1,0,0,0,0,0
401376639,George Washington Revolutionaries,B. Knapp,4279473,,False,1.0,0,0,0,0,0,0,0,0,0,0,0,0,0,0,0,0,0
401376639,George Washington Revolutionaries,TEAM,TOTAL,TOTAL,False,,22,58,17,37,5,21,5,7,6,26,32,10,5,1,14,19,54
401376636,Kent State Golden Flashes,T. Beck,4278950,,True,25.0,5,6,5,6,0,0,0,0,1,1,2,0,0,1,3,0,10
401376636,Kent State Golden Flashes,J. Hamilton,4278334,,True,28.0,3,7,3,7,0,0,1,1,0,3,3,0,2,1,0,3,7
401376636,Kent State Golden Flashes,M. Jacobs,4703551,,True,37.0,4,8,4,6,0,2,4,6,3,4,7,7,2,0,4,3,12
401376636,Kent State Golden Flashes,G. Santiago,4593436,,True,34.0,4,11,2,4,2,7,2,3,0,2,2,3,1,0,1,2,12
401376636,Kent State Golden Flashes,S. Carry,4396807,,True,30.0,6,11,2,5,4,6,4,4,2,3,5,5,0,0,2,2,20
401376636,Kent State Golden Flashes,D.J. Johnson,4592462,,False,21.0,3,6,0,0,3,6,0,0,1,4,5,0,0,0,0,0,9
401376636,Kent State Golden Flashes,C. Hornbeak,4898317,,False,10.0,0,0,0,0,0,0,0,0,0,1,1,0,0,0,0,2,0
401376636,Kent State Golden Flashes,J. Sullinger,4898316,,False,15.0,3,5,2,3,1,2,0,0,0,0,0,2,1,1,0,2,7
401376636,Kent State Golden Flashes,TEAM,TOTAL,TOTAL,False,,28,54,18,31,10,23,11,14,8,20,28,17,6,3,11,14,77
401376636,George Washington Revolutionaries,R. Lindo Jr.,4397186,,True,20.0,2,3,2,2,0,1,0,0,0,1,1,0,0,1,0,0,4
401376636,George Washington Revolutionaries,N. Brown,4700963,,True,15.0,1,1,1,1,0,0,3,4,1,1,2,0,1,0,0,0,5
401376636,George Washington Revolutionaries,J. Bamisile,4432537,,True,37.0,6,14,3,5,3,9,0,0,0,4,4,2,0,1,2,2,15
401376636,George Washington Revolutionaries,J. Bishop,4431770,,True,38.0,7,11,6,7,1,4,4,5,0,1,1,5,1,0,3,3,19
401376636,George Washington Revolutionaries,B. Adams,4396612,,True,29.0,3,7,2,4,1,3,0,0,1,5,6,2,0,0,1,3,7
401376636,George Washington Revolutionaries,H. Dean,4593273,,False,25.0,4,7,4,6,0,1,0,1,1,3,4,0,0,0,0,3,8
401376636,George Washington Revolutionaries,Q. Samuels,4592251,,False,4.0,0,0,0,0,0,0,0,0,1,0,1,0,0,0,0,1,0
401376636,George Washington Revolutionaries,B. Freeman,4613126,,False,26.0,3,7,2,5,1,2,4,4,1,0,1,2,2,0,5,3,11
401376636,George Washington Revolutionaries,A. Harris,4397216,,False,6.0,0,0,0,0,0,0,0,0,0,1,1,0,0,0,1,0,0
401376636,George Washington Revolutionaries,TEAM,TOTAL,TOTAL,False,,26,50,20,30,6,20,11,14,6,18,24,11,4,2,13,15,69
401376534,Rhode Island Rams,Makhel Mitchell,4431777,,True,28.0,3,5,3,5,0,0,2,2,0,3,3,0,2,2,1,3,8
401376534,Rhode Island Rams,Makhi Mitchell,4431708,,True,30.0,3,4,3,4,0,0,2,2,0,5,5,3,1,0,2,3,8
401376534,Rhode Island Rams,I. Leggett,4606837,,True,18.0,1,4,1,3,0,1,1,2,0,1,1,3,1,0,2,1,3
401376534,Rhode Island Rams,I. El-Amin,4279313,,True,32.0,3,10,0,4,3,6,2,2,1,1,2,0,2,0,1,4,11
401376534,Rhode Island Rams,J. Sheppard,4066445,,True,34.0,4,8,1,2,3,6,4,6,0,3,3,5,2,0,4,1,15
401376534,Rhode Island Rams,A. Walker,4278567,,False,17.0,5,5,3,3,2,2,3,3,1,1,2,1,1,0,0,1,15
401376534,Rhode Island Rams,M. Martin,4397470,,False,29.0,3,6,0,0,3,6,2,2,0,3,3,1,1,0,0,2,11
401376534,Rhode Island Rams,J. Carey,4395673,,False,4.0,0,1,0,1,0,0,0,0,0,0,0,1,0,0,1,1,0
401376534,Rhode Island Rams,S. Thomas,4897065,,False,8.0,0,0,0,0,0,0,0,0,0,0,0,0,0,0,1,2,0
401376534,Rhode Island Rams,TEAM,TOTAL,TOTAL,False,,22,43,11,22,11,21,16,19,2,18,20,14,10,2,13,18,71
401376534,Boston College Eagles,T.J. Bickerstaff,4592778,,True,23.0,2,5,2,4,0,1,0,0,1,1,2,2,2,1,0,5,4
401376534,Boston College Eagles,J. Karnik,4280080,,True,32.0,5,8,4,5,1,3,4,5,4,9,13,1,0,0,1,3,15
401376534,Boston College Eagles,J. Zackery,4896615,,True,38.0,6,9,2,3,4,6,3,3,1,3,4,0,1,0,4,3,19
401376534,Boston College Eagles,D. Langford Jr.,4433165,,True,37.0,3,10,3,9,0,1,5,7,2,3,5,4,0,0,1,0,11
401376534,Boston College Eagles,M. Ashton-Langford,4278574,,True,32.0,4,9,2,4,2,5,2,2,1,2,3,2,2,0,4,4,12
401376534,Boston College Eagles,F. Scott,3922033,,False,8.0,0,3,0,2,0,1,0,0,0,0,0,0,0,0,0,1,0
401376534,Boston College Eagles,Q. Post,4593016,,False,17.0,0,2,0,1,0,1,0,0,1,3,4,1,0,0,2,2,0
401376534,Boston College Eagles,K. Jones,4791225,,False,13.0,1,2,1,1,0,1,2,2,0,0,0,0,0,0,2,1,4
401376534,Boston College Eagles,TEAM,TOTAL,TOTAL,False,,21,48,14,29,7,19,16,19,12,22,34,10,5,1,15,19,65
401374302,St. Thomas-Minnesota Tommies,P. Bjorklund,4897243,,True,31.0,6,9,6,9,0,0,3,8,3,7,10,0,0,0,1,4,15
401374302,St. Thomas-Minnesota Tommies,R. Lindberg,4897248,,True,31.0,4,6,1,1,3,5,3,4,0,1,1,0,0,0,0,3,14
401374302,St. Thomas-Minnesota Tommies,B. Hedstrom,4897246,,True,18.0,0,4,0,0,0,4,0,0,0,1,1,1,0,0,0,2,0
401374302,St. Thomas-Minnesota Tommies,R. Miller,4897244,,True,32.0,5,10,0,0,5,10,0,0,0,3,3,4,0,0,2,4,15
401374302,St. Thomas-Minnesota Tommies,A. Nelson,4897242,,True,32.0,13,27,11,17,2,10,1,1,4,1,5,3,1,0,2,1,29
401374302,St. Thomas-Minnesota Tommies,B. Allen,4897249,,False,19.0,0,2,0,0,0,2,0,1,0,1,1,2,1,0,0,1,0
401374302,St. Thomas-Minnesota Tommies,W. Engels,4897247,,False,13.0,1,3,1,3,0,0,0,0,1,2,3,0,1,0,1,5,2
401374302,St. Thomas-Minnesota Tommies,Z. Theisen,4897241,,False,1.0,0,0,0,0,0,0,0,0,0,0,0,0,0,0,0,0,0
401374302,St. Thomas-Minnesota Tommies,B. Nau,4897240,,False,11.0,0,2,0,1,0,1,0,1,0,1,1,0,0,0,0,1,0
401374302,St. Thomas-Minnesota Tommies,K. Cunningham,4897239,,False,12.0,1,6,0,1,1,5,0,0,3,0,3,0,1,0,0,3,3
401374302,St. Thomas-Minnesota Tommies,TEAM,TOTAL,TOTAL,False,,30,69,19,32,11,37,7,15,13,23,36,10,4,0,7,24,78
401374302,Fordham Rams,C. Ohams,4066856,,True,25.0,5,7,5,6,0,1,2,4,2,10,12,7,0,1,4,4,12
401374302,Fordham Rams,A. Charlton,4897085,,True,31.0,5,9,4,5,1,4,0,1,1,4,5,3,0,0,0,3,11
401374302,Fordham Rams,K. Rose,4592315,,True,36.0,7,11,1,1,6,10,2,4,3,3,6,2,0,2,0,3,22
401374302,Fordham Rams,D. Quisenberry,4397790,,True,37.0,5,13,4,7,1,6,1,3,1,9,10,5,1,0,1,2,12
401374302,Fordham Rams,A. Daye Jr.,4397500,,True,37.0,3,11,2,4,1,7,10,13,0,3,3,4,2,0,3,2,17
401374302,Fordham Rams,A. Tsimbila,4702329,,False,6.0,1,1,1,1,0,0,0,0,0,0,0,0,0,0,0,2,2
401374302,Fordham Rams,R. Novitskyi,4897084,,False,14.0,2,2,2,2,0,0,0,0,0,3,3,1,0,1,2,0,4
401374302,Fordham Rams,A. Harrison,4897086,,False,2.0,0,0,0,0,0,0,0,0,0,0,0,0,0,0,0,1,0
401374302,Fordham Rams,J. Navarro,4592316,,False,12.0,1,1,0,0,1,1,1,2,1,0,1,1,1,0,1,2,4
401374302,Fordham Rams,TEAM,TOTAL,TOTAL,False,,29,55,19,26,10,29,16,27,9,33,42,23,4,4,11,19,84
401373800,UNC Greensboro Spartans,K. Thompson,4398234,,True,19.0,0,2,0,1,0,1,0,0,0,4,4,1,0,0,0,2,0
401373800,UNC Greensboro Spartans,M. Abdulsalam,4398232,,True,19.0,5,7,5,7,0,0,4,6,2,0,2,1,0,0,3,4,14
401373800,UNC Greensboro Spartans,D. Treacy,4397989,,True,40.0,6,12,5,9,1,3,3,6,0,2,2,5,1,0,2,1,16
401373800,UNC Greensboro Spartans,K. Hunter,4280038,,True,36.0,6,13,2,7,4,6,2,4,0,3,3,0,1,0,3,3,18
401373800,UNC Greensboro Spartans,D. Buckingham,4066833,,True,37.0,4,6,4,5,0,1,6,7,1,11,12,2,0,0,2,4,14
401373800,UNC Greensboro Spartans,J. White,4594139,,False,13.0,2,3,2,3,0,0,0,0,0,1,1,0,0,0,3,1,4
401373800,UNC Greensboro Spartans,B. Leyte,4593682,,False,29.0,3,7,3,6,0,1,2,4,7,3,10,0,0,0,1,4,8
401373800,UNC Greensboro Spartans,M. Jones,4592762,,False,4.0,0,0,0,0,0,0,0,0,1,0,1,0,0,0,0,1,0
401373800,UNC Greensboro Spartans,R. Raynor,4703827,,False,4.0,1,2,1,2,0,0,0,0,0,1,1,0,0,0,0,1,2
401373800,UNC Greensboro Spartans,J.C. Tharrington,4433098,,False,9.0,2,3,1,1,1,2,0,0,0,1,1,1,0,0,0,1,5
401373800,UNC Greensboro Spartans,Ko. Langley,4433026,,False,15.0,3,4,1,1,2,3,1,2,0,1,1,3,1,0,1,5,9
401373800,UNC Greensboro Spartans,TEAM,TOTAL,TOTAL,False,,32,59,24,42,8,17,18,29,14,29,43,13,3,0,15,27,90
401373800,Massachusetts Minutemen,D. Dominguez,4701126,,True,19.0,1,3,1,1,0,2,0,0,1,2,3,0,0,0,0,0,2
401373800,Massachusetts Minutemen,T. Buttrick,4277981,,True,36.0,5,13,3,5,2,8,6,6,1,0,1,0,0,0,1,4,18
401373800,Massachusetts Minutemen,N. Fernandes,4431791,,True,40.0,5,12,1,3,4,9,11,12,0,1,1,2,4,0,3,3,25
401373800,Massachusetts Minutemen,C.J. Kelly,4398208,,True,34.0,2,5,0,1,2,4,2,2,0,1,1,4,1,0,1,5,8
401373800,Massachusetts Minutemen,R. Kelly,4279741,,True,36.0,4,7,2,2,2,5,4,4,0,1,1,7,0,0,1,4,14
401373800,Massachusetts Minutemen,D. Walker,4399103,,False,21.0,4,6,0,1,4,5,0,0,0,3,3,0,1,1,0,4,12
401373800,Massachusetts Minutemen,G. Jones,4279211,,False,13.0,2,3,0,0,2,3,0,0,1,1,2,0,0,0,0,3,6
401373800,Massachusetts Minutemen,K. Mitchell,4592454,,False,3.0,0,1,0,1,0,0,0,0,1,0,1,1,0,0,0,0,0
401373800,Massachusetts Minutemen,T.J. Weeks,4433108,,False,23.0,2,8,1,2,1,6,3,4,0,7,7,1,1,0,1,2,8
401373800,Massachusetts Minutemen,TEAM,TOTAL,TOTAL,False,,25,58,8,16,17,42,26,28,4,17,21,15,7,1,7,25,93
401371975,VCU Rams,V. Williams Jr.,4397227,,True,33.0,0,3,0,1,0,2,7,8,0,8,8,1,2,1,4,1,7
401371975,VCU Rams,L. Stockard III,4277897,,True,14.0,2,2,2,2,0,0,0,0,0,2,2,1,0,0,2,3,4
401371975,VCU Rams,J. Nunn,4896614,,True,32.0,4,9,4,7,0,2,1,1,0,3,3,2,4,0,2,0,9
401371975,VCU Rams,A. Baldwin Jr.,4433182,,True,27.0,2,7,2,6,0,1,2,4,0,4,4,9,0,0,3,0,6
401371975,VCU Rams,K. Curry,4397228,,True,27.0,5,7,4,6,1,1,2,4,0,0,0,0,2,0,4,1,13
401371975,VCU Rams,H. Ward,4592495,,False,15.0,2,4,2,4,0,0,0,0,1,4,5,1,4,0,3,3,4
401371975,VCU Rams,J. DeLoach,4432483,,False,13.0,4,4,4,4,0,0,1,3,0,2,2,0,0,2,2,3,9
401371975,VCU Rams,N. Kern,4684145,,False,17.0,1,2,1,1,0,1,1,1,0,1,1,0,0,0,0,0,3
401371975,VCU Rams,M. Tsohonis,4592438,,False,15.0,2,3,0,0,2,3,0,2,0,1,1,1,1,0,0,2,6
401371975,VCU Rams,J. Banks,4432402,,False,7.0,2,2,1,1,1,1,0,0,0,0,0,0,0,0,2,0,5
401371975,VCU Rams,TEAM,TOTAL,TOTAL,False,,24,43,20,32,4,11,14,23,2,27,29,15,13,3,22,13,66
401371975,Florida Atlantic Owls,B. Baruti,4066634,,True,15.0,1,3,1,1,0,2,0,0,0,1,1,0,1,0,1,2,2
401371975,Florida Atlantic Owls,V. Goldin,4700818,,True,14.0,0,1,0,1,0,0,0,2,1,1,2,0,1,1,3,1,0
401371975,Florida Atlantic Owls,A. Martin,4702656,,True,29.0,3,11,0,1,3,10,4,6,2,3,5,0,2,0,1,3,13
401371975,Florida Atlantic Owls,B. Greenlee,4592701,,True,38.0,3,9,3,6,0,3,0,0,0,2,2,3,4,0,3,4,6
401371975,Florida Atlantic Owls,M. Forrest,4397485,,True,25.0,2,7,1,1,1,6,0,0,0,2,2,0,1,0,6,3,5
401371975,Florida Atlantic Owls,G. Rosado,4585611,,False,19.0,2,6,2,6,0,0,0,0,0,1,1,1,0,0,2,2,4
401371975,Florida Atlantic Owls,M. Niang,4397482,,False,7.0,1,2,1,2,0,0,0,0,1,1,2,0,1,0,0,1,2
401371975,Florida Atlantic Owls,B. Zimonjic,4897475,,False,7.0,0,1,0,1,0,0,0,0,0,0,0,0,0,0,0,0,0
401371975,Florida Atlantic Owls,J. Davis,4702655,,False,23.0,2,3,1,2,1,1,0,0,2,5,7,0,2,0,0,3,5
401371975,Florida Atlantic Owls,A. Ralat,4592847,,False,4.0,0,0,0,0,0,0,2,2,0,0,0,0,0,0,1,0,2
401371975,Florida Atlantic Owls,E. Winchester,4067456,,False,19.0,3,6,3,5,0,1,1,2,1,3,4,0,0,0,6,5,7
401371975,Florida Atlantic Owls,TEAM,TOTAL,TOTAL,False,,17,49,12,26,5,23,7,12,7,19,26,4,12,1,25,24,46
401371974,VCU Rams,V. Williams Jr.,4397227,,True,27.0,4,6,1,2,3,4,5,8,1,8,9,1,1,2,1,3,16
401371974,VCU Rams,L. Stockard III,4277897,,True,29.0,8,14,8,14,0,0,0,0,0,4,4,1,1,2,1,3,16
401371974,VCU Rams,J. Nunn,4896614,,True,30.0,2,7,2,5,0,2,2,2,0,2,2,2,0,0,2,3,6
401371974,VCU Rams,A. Baldwin Jr.,4433182,,True,23.0,4,9,3,6,1,3,2,6,0,0,0,5,4,0,1,2,11
401371974,VCU Rams,K. Curry,4397228,,True,35.0,2,4,2,3,0,1,0,0,0,1,1,3,1,0,1,2,4
401371974,VCU Rams,J. DeLoach,4432483,,False,11.0,1,4,1,4,0,0,1,2,3,1,4,1,0,0,0,1,3
401371974,VCU Rams,J. Nichols Jr.,4397108,,False,3.0,0,1,0,1,0,0,0,0,0,1,1,0,0,0,2,1,0
401371974,VCU Rams,N. Kern,4684145,,False,15.0,1,2,1,2,0,0,0,0,2,0,2,1,1,0,2,2,2
401371974,VCU Rams,M. Tsohonis,4592438,,False,13.0,2,5,0,1,2,4,2,2,0,2,2,1,0,0,0,1,8
401371974,VCU Rams,J. Banks,4432402,,False,14.0,3,7,3,3,0,4,3,3,2,2,4,0,1,0,1,0,9
401371974,VCU Rams,TEAM,TOTAL,TOTAL,False,,27,59,21,41,6,18,15,23,11,25,36,15,9,4,11,18,75
401371974,Old Dominion Monarchs,K. Ezikpe,4397564,,True,19.0,4,7,4,7,0,0,3,4,1,4,5,1,1,1,3,5,11
401371974,Old Dominion Monarchs,M. Long,4431804,,True,36.0,4,11,4,9,0,2,2,3,2,3,5,1,2,2,0,4,10
401371974,Old Dominion Monarchs,A.J. Oliver II,4592878,,True,24.0,1,6,1,4,0,2,0,0,2,4,6,3,1,0,0,0,2
401371974,Old Dominion Monarchs,J. Hunter,4592875,,True,30.0,1,5,1,3,0,2,0,0,0,2,2,6,0,0,2,1,2
401371974,Old Dominion Monarchs,C.J. Keyser,4066455,,True,36.0,4,11,3,8,1,3,5,7,1,3,4,2,2,0,3,3,14
401371974,Old Dominion Monarchs,A. Trice,4397007,,False,27.0,7,9,7,9,0,0,2,4,1,7,8,1,0,2,3,4,16
401371974,Old Dominion Monarchs,D. Stines,4897542,,False,18.0,4,5,4,5,0,0,1,2,0,1,1,0,2,1,1,1,9
401371974,Old Dominion Monarchs,I. Essien,4897541,,False,10.0,0,2,0,2,0,0,2,2,0,0,0,0,1,0,1,0,2
401371974,Old Dominion Monarchs,TEAM,TOTAL,TOTAL,False,,25,56,24,47,1,9,15,22,10,25,35,14,9,6,13,18,66
401371973,VCU Rams,H. Ward,4592495,,True,9.0,1,2,1,1,0,1,0,0,0,1,1,0,1,0,1,2,2
401371973,VCU Rams,V. Williams Jr.,4397227,,True,39.0,4,8,2,3,2,5,4,6,1,7,8,5,5,2,5,2,14
401371973,VCU Rams,L. Stockard III,4277897,,True,25.0,4,9,4,9,0,0,2,2,3,3,6,2,0,0,2,3,10
401371973,VCU Rams,J. Nunn,4896614,,True,29.0,3,7,1,3,2,4,2,2,1,1,2,2,2,0,4,1,10
401371973,VCU Rams,K. Curry,4397228,,True,34.0,4,8,2,4,2,4,2,4,0,2,2,1,4,1,1,2,12
401371973,VCU Rams,M. Brown-Jones,4433224,,False,8.0,0,2,0,1,0,1,0,0,1,0,1,0,0,0,1,2,0
401371973,VCU Rams,J. DeLoach,4432483,,False,12.0,3,4,3,4,0,0,0,0,3,1,4,0,0,1,1,1,6
401371973,VCU Rams,N. Kern,4684145,,False,21.0,1,2,1,2,0,0,0,1,1,3,4,0,0,1,0,2,2
401371973,VCU Rams,M. Tsohonis,4592438,,False,20.0,2,10,2,7,0,3,0,0,0,2,2,2,0,0,1,0,4
401371973,VCU Rams,J. Banks,4432402,,False,3.0,2,3,1,1,1,2,0,0,0,1,1,0,0,0,0,0,5
401371973,VCU Rams,TEAM,TOTAL,TOTAL,False,,24,55,17,35,7,20,10,15,10,23,33,12,12,5,16,15,65
401371973,Campbell Fighting Camels,J. Carralero,4592654,,True,31.0,8,12,7,10,1,2,2,2,2,4,6,6,3,1,4,1,19
401371973,Campbell Fighting Camels,C. Henderson Jr.,4592657,,True,37.0,9,14,7,10,2,4,0,1,3,8,11,1,3,0,7,3,20
401371973,Campbell Fighting Camels,R. Clemons,4397332,,True,38.0,2,6,2,5,0,1,1,2,0,6,6,3,1,0,2,1,5
401371973,Campbell Fighting Camels,J. Whitfield,4278681,,True,27.0,3,10,2,4,1,6,1,2,0,1,1,0,2,0,2,3,8
401371973,Campbell Fighting Camels,A. McCullough,4278142,,True,31.0,1,2,0,0,1,2,1,2,1,1,2,0,0,0,1,2,4
401371973,Campbell Fighting Camels,J. Lusane,4592655,,False,4.0,0,1,0,1,0,0,0,0,0,0,0,0,1,0,1,1,0
401371973,Campbell Fighting Camels,M. Stajcic,4397334,,False,4.0,0,1,0,1,0,0,0,0,0,0,0,0,0,0,0,0,0
401371973,Campbell Fighting Camels,G. Mokseckas,4702004,,False,4.0,0,1,0,0,0,1,0,0,0,0,0,0,0,0,0,0,0
401371973,Campbell Fighting Camels,M. Thompson,4432127,,False,24.0,2,7,1,2,1,5,0,0,1,2,3,3,0,0,1,3,5
401371973,Campbell Fighting Camels,TEAM,TOTAL,TOTAL,False,,25,54,19,33,6,21,5,9,9,23,32,13,10,1,18,14,61
401371972,VCU Rams,H. Ward,4592495,,True,22.0,1,4,1,4,0,0,1,4,2,2,4,1,2,2,0,1,3
401371972,VCU Rams,V. Williams Jr.,4397227,,True,33.0,7,10,3,3,4,7,3,4,1,5,6,1,0,1,3,4,21
401371972,VCU Rams,L. Stockard III,4277897,,True,21.0,1,1,1,1,0,0,0,0,1,1,2,1,2,0,1,3,2
401371972,VCU Rams,M. Tsohonis,4592438,,True,13.0,0,2,0,2,0,0,0,0,0,1,1,1,0,0,1,1,0
401371972,VCU Rams,K. Curry,4397228,,True,33.0,4,10,4,9,0,1,1,1,0,0,0,0,0,0,2,0,9
401371972,VCU Rams,M. Brown-Jones,4433224,,False,12.0,1,4,1,3,0,1,0,1,0,4,4,1,1,0,3,2,2
401371972,VCU Rams,J. DeLoach,4432483,,False,10.0,1,2,1,2,0,0,1,1,0,2,2,0,0,1,0,0,3
401371972,VCU Rams,J. Nunn,4896614,,False,27.0,5,10,5,6,0,4,0,0,0,1,1,2,1,0,0,1,10
401371972,VCU Rams,N. Kern,4684145,,False,18.0,2,2,2,2,0,0,0,0,1,1,2,1,0,0,2,2,4
401371972,VCU Rams,J. Banks,4432402,,False,11.0,0,1,0,1,0,0,0,0,1,0,1,0,0,0,0,1,0
401371972,VCU Rams,TEAM,TOTAL,TOTAL,False,,22,46,18,33,4,13,6,11,7,19,26,8,6,4,14,15,54
401371972,Chattanooga Mocs,KC Hankton,4397200,,True,15.0,2,4,2,3,0,1,2,3,1,1,2,0,0,0,0,3,6
401371972,Chattanooga Mocs,S. De Sousa,4292484,,True,28.0,7,16,7,14,0,2,1,3,6,4,10,0,0,0,1,3,15
401371972,Chattanooga Mocs,D. Banks,4279210,,True,31.0,0,1,0,0,0,1,0,0,2,3,5,2,0,0,2,5,0
401371972,Chattanooga Mocs,M. Smith,4397784,,True,36.0,7,12,5,10,2,2,4,5,0,5,5,2,2,0,3,0,20
401371972,Chattanooga Mocs,D. Jean-Baptiste,4067255,,True,36.0,4,12,2,5,2,7,2,2,0,0,0,0,1,0,2,0,12
401371972,Chattanooga Mocs,J. Ayeni,4066518,,False,7.0,0,1,0,1,0,0,0,0,0,1,1,0,0,0,0,2,0
401371972,Chattanooga Mocs,A. Diggs,4278461,,False,6.0,0,0,0,0,0,0,0,0,0,0,0,0,0,0,0,2,0
401371972,Chattanooga Mocs,G. Ledford,4433029,,False,13.0,0,3,0,0,0,3,0,0,0,3,3,1,0,0,0,1,0
401371972,Chattanooga Mocs,A.J. Caldwell,4280264,,False,28.0,1,3,0,1,1,2,0,0,1,2,3,2,1,0,0,2,3
401371972,Chattanooga Mocs,TEAM,TOTAL,TOTAL,False,,21,52,16,34,5,18,9,13,11,19,30,7,4,0,13,18,56
401371971,Wagner Seahawks,R. Rogers,4289551,,True,20.0,3,6,3,6,0,0,1,2,2,2,4,0,0,0,0,2,7
401371971,Wagner Seahawks,Z. Williams,4897951,,True,18.0,1,1,1,1,0,0,0,1,1,1,2,0,1,0,1,0,2
401371971,Wagner Seahawks,D. Hunt,4703199,,True,31.0,0,7,0,4,0,3,2,2,2,1,3,3,0,0,1,1,2
401371971,Wagner Seahawks,E. Ford,4593036,,True,20.0,6,12,6,10,0,2,2,2,2,0,2,0,0,0,1,4,14
401371971,Wagner Seahawks,A. Morales,4593034,,True,33.0,6,10,4,8,2,2,6,6,4,7,11,1,2,0,5,2,20
401371971,Wagner Seahawks,R. Taylor II,4897952,,False,0.0,0,0,0,0,0,0,0,0,0,0,0,0,0,0,0,0,0
401371971,Wagner Seahawks,J. Fletcher,4593038,,False,11.0,1,3,1,3,0,0,0,0,0,5,5,1,0,1,1,2,2
401371971,Wagner Seahawks,J. Price-Noel,4397675,,False,14.0,0,2,0,0,0,2,0,0,1,3,4,0,0,0,0,2,0
401371971,Wagner Seahawks,N. Jackson,4279882,,False,15.0,1,7,0,0,1,7,0,0,0,2,2,1,1,0,1,3,3
401371971,Wagner Seahawks,J. Ezquerra,4902635,,False,9.0,0,2,0,2,0,0,0,0,1,1,2,1,2,0,1,1,0
401371971,Wagner Seahawks,W. Martinez,4593037,,False,29.0,3,7,3,6,0,1,2,2,1,2,3,4,0,0,2,2,8
401371971,Wagner Seahawks,TEAM,TOTAL,TOTAL,False,,21,57,18,40,3,17,13,15,17,25,42,11,6,1,14,19,58
401371971,VCU Rams,H. Ward,4592495,,True,32.0,2,4,2,3,0,1,0,0,0,6,6,0,0,3,2,2,4
401371971,VCU Rams,V. Williams Jr.,4397227,,True,27.0,2,8,1,4,1,4,0,0,0,2,2,2,0,0,3,2,5
401371971,VCU Rams,L. Stockard III,4277897,,True,27.0,3,7,3,7,0,0,1,2,1,2,3,1,0,0,1,2,7
401371971,VCU Rams,J. Nunn,4896614,,True,15.0,0,3,0,2,0,1,0,0,0,0,0,2,2,0,1,1,0
401371971,VCU Rams,K. Curry,4397228,,True,33.0,4,8,3,7,1,1,3,4,0,4,4,2,1,0,3,2,12
401371971,VCU Rams,M. Brown-Jones,4433224,,False,3.0,0,0,0,0,0,0,0,0,0,0,0,0,0,0,0,4,0
401371971,VCU Rams,J. DeLoach,4432483,,False,15.0,3,4,3,4,0,0,0,0,1,3,4,0,0,0,2,2,6
401371971,VCU Rams,J. Nichols Jr.,4397108,,False,3.0,0,1,0,1,0,0,0,2,1,0,1,0,0,0,0,1,0
401371971,VCU Rams,N. Kern,4684145,,False,5.0,0,1,0,0,0,1,0,0,0,1,1,0,1,0,0,0,0
401371971,VCU Rams,M. Tsohonis,4592438,,False,25.0,2,3,2,3,0,0,3,7,0,1,1,5,1,0,3,2,7
401371971,VCU Rams,J. Banks,4432402,,False,15.0,1,3,0,0,1,3,0,0,0,0,0,0,0,0,0,0,3
401371971,VCU Rams,TEAM,TOTAL,TOTAL,False,,17,42,14,31,3,11,7,15,4,20,24,12,5,3,15,18,44
401371970,North Texas Mean Green,A. Ousmane,4702773,,True,25.0,5,8,5,8,0,0,3,3,1,2,3,0,0,0,0,1,13
401371970,North Texas Mean Green,T. Bell,4592870,,True,24.0,3,6,3,4,0,2,5,6,2,3,5,4,1,0,2,4,11
401371970,North Texas Mean Green,M. McBride,4702770,,True,27.0,2,9,1,2,1,7,0,0,0,2,2,3,0,0,3,3,5
401371970,North Texas Mean Green,R. Jones,4432430,,True,36.0,5,8,2,3,3,5,0,0,1,2,3,1,0,1,2,4,13
401371970,North Texas Mean Green,JJ Murray,4397560,,True,26.0,2,6,0,0,2,6,0,0,1,3,4,2,1,0,1,1,6
401371970,North Texas Mean Green,J. Simmons,4067774,,False,11.0,3,3,3,3,0,0,0,0,0,2,2,1,0,0,0,0,6
401371970,North Texas Mean Green,T. Perry,4897518,,False,32.0,2,8,0,4,2,4,2,2,0,2,2,3,2,0,0,1,8
401371970,North Texas Mean Green,A. Scott,4897517,,False,19.0,2,5,2,4,0,1,0,0,1,4,5,2,0,0,0,3,4
401371970,North Texas Mean Green,TEAM,TOTAL,TOTAL,False,,24,53,16,28,8,25,10,11,8,22,30,16,4,1,10,17,66
401371970,Massachusetts Minutemen,G. Jones,4279211,,True,33.0,4,8,4,7,0,1,4,4,4,4,8,1,1,0,0,3,12
401371970,Massachusetts Minutemen,T. Buttrick,4277981,,True,17.0,1,4,1,1,0,3,0,0,0,4,4,0,0,1,3,2,2
401371970,Massachusetts Minutemen,N. Fernandes,4431791,,True,38.0,4,11,3,9,1,2,4,4,1,2,3,8,1,0,3,2,13
401371970,Massachusetts Minutemen,C.J. Kelly,4398208,,True,35.0,5,13,3,9,2,4,1,2,1,2,3,2,0,0,2,1,13
401371970,Massachusetts Minutemen,R. Kelly,4279741,,True,36.0,3,7,1,3,2,4,2,2,0,3,3,0,0,0,1,1,10
401371970,Massachusetts Minutemen,D. Dominguez,4701126,,False,24.0,3,6,2,4,1,2,0,1,1,3,4,2,0,1,1,1,7
401371970,Massachusetts Minutemen,M. Steadman,4397393,,False,5.0,0,0,0,0,0,0,0,0,0,0,0,0,0,0,0,1,0
401371970,Massachusetts Minutemen,T.J. Weeks,4433108,,False,11.0,0,0,0,0,0,0,0,0,0,0,0,0,0,0,0,1,0
401371970,Massachusetts Minutemen,P. Santos,4432104,,False,1.0,0,0,0,0,0,0,0,0,0,0,0,0,0,0,0,0,0
401371970,Massachusetts Minutemen,TEAM,TOTAL,TOTAL,False,,20,49,14,33,6,16,11,13,9,19,28,13,2,2,10,12,57
401371907,Vanderbilt Commodores,Q. Millora-Brown,4397691,,True,22.0,0,2,0,2,0,0,1,2,2,2,4,0,1,2,2,1,1
401371907,Vanderbilt Commodores,M. Stute,4433340,,True,21.0,0,3,0,1,0,2,1,2,1,0,1,0,0,1,4,3,1
401371907,Vanderbilt Commodores,T. Lawrence,4702530,,True,20.0,1,4,1,1,0,3,2,2,0,2,2,1,3,1,1,2,4
401371907,Vanderbilt Commodores,J. Wright,4432920,,True,36.0,6,16,5,10,1,6,2,2,3,4,7,1,0,1,4,3,15
401371907,Vanderbilt Commodores,S. Pippen Jr.,4431785,,True,35.0,2,10,2,7,0,3,4,6,2,5,7,2,2,1,5,3,8
401371907,Vanderbilt Commodores,T. Frank,4433146,,False,16.0,1,5,0,0,1,5,0,0,1,0,1,1,1,0,0,0,3
401371907,Vanderbilt Commodores,T. Thomas,4702531,,False,10.0,0,4,0,0,0,4,0,0,0,0,0,0,0,0,0,1,0
401371907,Vanderbilt Commodores,P. Daniels,4683837,,False,12.0,0,3,0,2,0,1,0,0,0,6,6,0,0,0,1,0,0
401371907,Vanderbilt Commodores,S. Dezonie,4683732,,False,8.0,0,0,0,0,0,0,0,0,0,2,2,0,0,0,1,0,0
401371907,Vanderbilt Commodores,G. Dorsey,4683639,,False,6.0,1,1,1,1,0,0,0,0,1,0,1,0,0,0,0,0,2
401371907,Vanderbilt Commodores,J. Mann,4589479,,False,14.0,1,5,1,4,0,1,1,3,3,1,4,0,1,0,0,2,3
401371907,Vanderbilt Commodores,TEAM,TOTAL,TOTAL,False,,12,53,10,28,2,25,11,17,16,22,38,5,8,6,21,15,37
401371907,VCU Rams,H. Ward,4592495,,True,31.0,1,4,1,4,0,0,0,0,1,7,8,1,1,5,3,2,2
401371907,VCU Rams,V. Williams Jr.,4397227,,True,27.0,5,10,1,2,4,8,0,0,1,5,6,1,1,0,4,4,14
401371907,VCU Rams,L. Stockard III,4277897,,True,16.0,0,2,0,2,0,0,0,0,0,0,0,2,1,1,0,3,0
401371907,VCU Rams,M. Tsohonis,4592438,,True,17.0,1,6,1,3,0,3,0,0,0,6,6,3,1,0,3,1,2
401371907,VCU Rams,K. Curry,4397228,,True,24.0,1,5,1,4,0,1,2,2,1,1,2,0,1,0,3,3,4
401371907,VCU Rams,M. Brown-Jones,4433224,,False,15.0,1,3,1,1,0,2,1,2,2,4,6,0,0,1,0,0,3
401371907,VCU Rams,J. DeLoach,4432483,,False,6.0,1,3,1,3,0,0,0,1,2,1,3,0,0,0,3,4,2
401371907,VCU Rams,J. Nichols Jr.,4397108,,False,3.0,0,0,0,0,0,0,0,0,0,0,0,0,1,0,1,0,0
401371907,VCU Rams,J. Nunn,4896614,,False,28.0,3,12,1,9,2,3,3,5,2,1,3,2,1,0,1,2,11
401371907,VCU Rams,N. Kern,4684145,,False,12.0,3,4,3,4,0,0,2,2,2,2,4,0,0,0,0,0,8
401371907,VCU Rams,J. Banks,4432402,,False,21.0,1,3,1,1,0,2,0,0,3,0,3,0,1,0,2,3,2
401371907,VCU Rams,TEAM,TOTAL,TOTAL,False,,17,52,11,33,6,19,8,12,14,29,43,9,8,7,22,22,48
401371789,Northeastern Huskies,C. Doherty,4395666,,True,27.0,3,6,3,6,0,0,2,2,4,5,9,2,0,1,4,4,8
401371789,Northeastern Huskies,J. Strong,4279220,,True,31.0,4,5,3,3,1,2,0,0,0,2,2,1,0,0,0,2,9
401371789,Northeastern Huskies,J. Telfort,4702785,,True,13.0,3,5,3,5,0,0,2,5,1,1,2,0,0,0,2,1,8
401371789,Northeastern Huskies,T. Scott-Grayson,4397725,,True,29.0,5,10,5,8,0,2,0,0,1,6,7,3,1,0,3,2,10
401371789,Northeastern Huskies,S. Walters,4280251,,True,38.0,5,11,2,5,3,6,3,4,0,3,3,5,1,0,4,3,16
401371789,Northeastern Huskies,C. Braun,4592983,,False,4.0,0,0,0,0,0,0,0,0,0,0,0,0,0,0,1,1,0
401371789,Northeastern Huskies,Q. Emanga,4592982,,False,7.0,2,2,1,1,1,1,1,1,0,2,2,0,0,0,0,0,6
401371789,Northeastern Huskies,V. Cubrilo,4592981,,False,16.0,3,4,1,1,2,3,2,3,0,1,1,0,1,0,0,1,10
401371789,Northeastern Huskies,N. Djogo,4065704,,False,35.0,3,7,1,4,2,3,7,8,1,7,8,5,4,0,0,0,15
401371789,Northeastern Huskies,TEAM,TOTAL,TOTAL,False,,28,50,19,33,9,17,17,23,7,27,34,16,7,1,15,14,82
401371789,Massachusetts Minutemen,G. Jones,4279211,,True,31.0,1,2,0,0,1,2,0,0,0,3,3,0,1,0,1,2,3
401371789,Massachusetts Minutemen,T. Buttrick,4277981,,True,33.0,6,11,5,9,1,2,2,3,5,4,9,1,2,0,0,2,15
401371789,Massachusetts Minutemen,N. Fernandes,4431791,,True,36.0,10,18,7,12,3,6,1,2,0,4,4,7,3,0,2,4,24
401371789,Massachusetts Minutemen,C.J. Kelly,4398208,,True,19.0,2,6,1,3,1,3,0,2,0,3,3,1,1,1,0,5,5
401371789,Massachusetts Minutemen,R. Kelly,4279741,,True,37.0,8,17,2,5,6,12,3,4,0,2,2,1,0,0,2,1,25
401371789,Massachusetts Minutemen,D. Dominguez,4701126,,False,5.0,0,1,0,1,0,0,0,0,2,0,2,0,0,0,1,0,0
401371789,Massachusetts Minutemen,M. Steadman,4397393,,False,10.0,1,4,1,4,0,0,0,0,2,0,2,0,0,0,2,3,2
401371789,Massachusetts Minutemen,K. Mitchell,4592454,,False,3.0,0,0,0,0,0,0,0,0,0,0,0,0,0,0,1,1,0
401371789,Massachusetts Minutemen,T.J. Weeks,4433108,,False,26.0,1,3,1,1,0,2,0,0,0,2,2,1,0,0,1,1,2
401371789,Massachusetts Minutemen,TEAM,TOTAL,TOTAL,False,,29,62,17,35,12,27,6,11,10,19,29,11,7,1,11,19,76
401371788,UMass Lowell River Hawks,M. Brooks,4700953,,True,12.0,4,6,4,6,0,0,0,0,0,0,0,0,1,0,2,1,8
401371788,UMass Lowell River Hawks,Al. Blunt,4396569,,True,33.0,6,15,2,7,4,8,2,2,2,1,3,1,1,1,2,3,18
401371788,UMass Lowell River Hawks,K. Thomas,4592912,,True,31.0,6,12,4,5,2,7,0,0,0,3,3,5,0,0,2,4,14
401371788,UMass Lowell River Hawks,E. Hammond,4397833,,True,26.0,3,6,1,3,2,3,2,2,1,0,1,1,0,0,1,3,10
401371788,UMass Lowell River Hawks,J. Faison,4290752,,True,26.0,3,9,2,5,1,4,2,3,2,4,6,1,0,0,3,3,9
401371788,UMass Lowell River Hawks,J. Hall,4066996,,False,11.0,0,3,0,2,0,1,0,0,0,0,0,0,0,2,0,1,0
401371788,UMass Lowell River Hawks,An. Blunt,4700954,,False,12.0,0,2,0,1,0,1,0,0,0,1,1,0,0,0,0,3,0
401371788,UMass Lowell River Hawks,Q. Mincey,4567710,,False,12.0,1,1,0,0,1,1,0,0,1,0,1,1,0,0,0,1,3
401371788,UMass Lowell River Hawks,A. Hikim,4431843,,False,26.0,3,6,3,6,0,0,2,3,0,2,2,7,1,0,2,4,8
401371788,UMass Lowell River Hawks,G. Hammond,4431822,,False,11.0,5,8,5,8,0,0,1,2,2,1,3,1,0,0,0,1,11
401371788,UMass Lowell River Hawks,TEAM,TOTAL,TOTAL,False,,31,68,21,43,10,25,9,12,11,15,26,17,3,3,13,24,81
401371788,Massachusetts Minutemen,D. Dominguez,4701126,,True,23.0,3,3,3,3,0,0,3,3,3,4,7,4,1,2,1,2,9
401371788,Massachusetts Minutemen,T. Buttrick,4277981,,True,23.0,4,10,4,9,0,1,3,4,2,2,4,0,2,2,5,4,11
401371788,Massachusetts Minutemen,T.J. Weeks,4433108,,True,26.0,3,6,1,2,2,4,4,5,1,5,6,2,1,0,0,1,12
401371788,Massachusetts Minutemen,C.J. Kelly,4398208,,True,25.0,4,8,1,2,3,6,1,2,2,2,4,3,1,0,2,3,12
401371788,Massachusetts Minutemen,R. Kelly,4279741,,True,31.0,4,11,3,8,1,3,2,5,0,1,1,5,1,0,3,0,11
401371788,Massachusetts Minutemen,D. Walker,4399103,,False,11.0,4,4,4,4,0,0,1,1,0,2,2,0,0,0,1,4,9
401371788,Massachusetts Minutemen,M. Steadman,4397393,,False,12.0,4,7,4,6,0,1,2,2,1,3,4,0,0,0,0,0,10
401371788,Massachusetts Minutemen,G. Jones,4279211,,False,10.0,0,2,0,2,0,0,0,0,2,2,4,0,0,0,0,0,0
401371788,Massachusetts Minutemen,J. Garcia,4701125,,False,30.0,4,5,3,4,1,1,9,11,1,4,5,4,1,0,1,3,18
401371788,Massachusetts Minutemen,K. Mitchell,4592454,,False,9.0,0,0,0,0,0,0,0,0,0,1,1,2,1,0,0,0,0
401371788,Massachusetts Minutemen,TEAM,TOTAL,TOTAL,False,,30,56,23,40,7,16,25,33,14,29,43,20,8,4,16,17,92
401371787,UMBC Retrievers,D. Spasojevic,4278250,,True,19.0,5,11,5,11,0,0,0,0,2,7,9,1,0,0,2,2,10
401371787,UMBC Retrievers,K. Kennedy,4592938,,True,32.0,4,9,3,5,1,4,4,4,3,5,8,1,1,0,2,4,13
401371787,UMBC Retrievers,L.J. Owens,4397601,,True,34.0,4,10,2,6,2,4,0,0,0,2,2,1,0,0,3,1,10
401371787,UMBC Retrievers,J. Boonyasith,4397587,,True,30.0,2,6,1,1,1,5,0,0,2,7,9,1,1,1,1,3,5
401371787,UMBC Retrievers,D. Rogers,4278386,,True,26.0,2,11,1,3,1,8,4,4,0,1,1,1,2,0,5,3,9
401371787,UMBC Retrievers,Y. Obeng-Mensah,4898002,,False,16.0,3,9,3,7,0,2,3,4,5,2,7,0,0,0,1,0,9
401371787,UMBC Retrievers,N. Johnson,4592939,,False,8.0,0,1,0,1,0,0,2,2,2,1,3,0,0,0,1,1,2
401371787,UMBC Retrievers,S. Wojcik,4397468,,False,5.0,0,1,0,0,0,1,0,0,0,1,1,1,0,0,0,0,0
401371787,UMBC Retrievers,M. Picarelli,4701172,,False,0.0,0,0,0,0,0,0,0,0,0,0,0,0,0,0,0,0,0
401371787,UMBC Retrievers,H. Byrd,4590396,,False,14.0,1,3,1,2,0,1,0,0,0,1,1,0,0,0,1,0,2
401371787,UMBC Retrievers,R. Salnave,4067329,,False,16.0,0,4,0,1,0,3,0,0,1,0,1,2,0,0,3,2,0
401371787,UMBC Retrievers,TEAM,TOTAL,TOTAL,False,,21,65,16,37,5,28,13,14,17,28,45,8,4,1,19,16,60
401371787,Massachusetts Minutemen,T. Buttrick,4277981,,True,24.0,6,12,3,4,3,8,1,2,2,5,7,1,5,1,1,1,16
401371787,Massachusetts Minutemen,C. McCrory,4701127,,True,7.0,0,0,0,0,0,0,0,0,0,0,0,0,0,0,0,1,0
401371787,Massachusetts Minutemen,T.J. Weeks,4433108,,True,31.0,5,14,4,10,1,4,5,10,4,3,7,0,3,2,1,0,16
401371787,Massachusetts Minutemen,N. Fernandes,4431791,,True,36.0,6,14,6,12,0,2,0,0,1,3,4,4,1,0,2,2,12
401371787,Massachusetts Minutemen,R. Kelly,4279741,,True,27.0,3,10,3,9,0,1,2,2,1,2,3,6,0,0,2,3,8
401371787,Massachusetts Minutemen,D. Dominguez,4701126,,False,17.0,1,2,1,1,0,1,0,0,0,3,3,0,0,0,1,3,2
401371787,Massachusetts Minutemen,D. Walker,4399103,,False,16.0,1,2,1,1,0,1,2,2,0,5,5,0,1,2,1,2,4
401371787,Massachusetts Minutemen,G. Jones,4279211,,False,16.0,4,4,4,4,0,0,1,2,0,1,1,0,0,0,0,2,9
401371787,Massachusetts Minutemen,J. Garcia,4701125,,False,13.0,2,3,2,3,0,0,0,0,0,1,1,1,0,0,1,4,4
401371787,Massachusetts Minutemen,K. Mitchell,4592454,,False,13.0,3,4,3,4,0,0,0,0,0,1,1,2,1,0,0,0,6
401371787,Massachusetts Minutemen,TEAM,TOTAL,TOTAL,False,,31,65,27,48,4,17,11,18,10,27,37,14,11,5,9,18,77
401371785,UConn Huskies,A. Akok,4431706,,True,34.0,5,6,3,4,2,2,0,0,2,3,5,0,0,3,0,1,12
401371785,UConn Huskies,I. Whaley,4278231,,True,21.0,2,3,2,2,0,1,1,2,1,1,2,3,2,3,1,5,5
401371785,UConn Huskies,J. Hawkins,4683750,,True,20.0,3,9,1,4,2,5,3,4,0,2,2,0,0,0,1,1,11
401371785,UConn Huskies,A. Jackson,4432190,,True,32.0,3,3,3,3,0,0,3,5,2,9,11,5,1,0,2,0,9
401371785,UConn Huskies,R.J. Cole,4279789,,True,34.0,5,15,4,8,1,7,4,6,1,4,5,3,0,0,1,1,15
401371785,UConn Huskies,T. Polley,4278230,,False,27.0,4,12,1,4,3,8,2,2,1,2,3,1,0,0,0,3,13
401371785,UConn Huskies,S. Johnson,4683752,,False,2.0,0,0,0,0,0,0,0,0,0,1,1,0,0,0,0,0,0
401371785,UConn Huskies,J. Gaffney,4431732,,False,30.0,2,9,2,5,0,4,5,5,0,5,5,4,0,0,3,3,9
401371785,UConn Huskies,TEAM,TOTAL,TOTAL,False,,24,57,16,30,8,27,18,24,8,29,37,16,3,6,8,14,74
401371785,St. Bonaventure Bonnies,O. Osunniyi,4397224,,True,26.0,5,7,5,7,0,0,0,0,2,3,5,0,1,0,0,2,10
401371785,St. Bonaventure Bonnies,J. Adaway,4279431,,True,40.0,5,16,3,12,2,4,2,2,1,9,10,0,0,0,3,3,14
401371785,St. Bonaventure Bonnies,J. Holmes,4701016,,True,40.0,6,14,5,11,1,3,6,7,3,5,8,5,0,0,5,4,19
401371785,St. Bonaventure Bonnies,Q. Adams,4585591,,True,27.0,2,7,2,7,0,0,0,0,2,1,3,1,2,0,1,4,4
401371785,St. Bonaventure Bonnies,D. Welch,4397221,,True,39.0,5,11,3,6,2,5,3,3,1,6,7,2,0,1,1,5,15
401371785,St. Bonaventure Bonnies,A. Coulibaly,4432889,,False,14.0,1,4,1,4,0,0,0,0,2,3,5,0,0,0,1,1,2
401371785,St. Bonaventure Bonnies,L. Brown,4897047,,False,14.0,0,3,0,1,0,2,0,1,0,0,0,0,0,0,0,2,0
401371785,St. Bonaventure Bonnies,TEAM,TOTAL,TOTAL,False,,24,62,19,48,5,14,11,13,11,29,40,8,3,1,11,21,64
401371784,St. Bonaventure Bonnies,O. Osunniyi,4397224,,True,33.0,4,8,4,8,0,0,0,0,2,5,7,4,1,2,2,0,8
401371784,St. Bonaventure Bonnies,J. Adaway,4279431,,True,38.0,9,14,7,12,2,2,2,2,2,3,5,0,1,1,0,2,22
401371784,St. Bonaventure Bonnies,J. Holmes,4701016,,True,40.0,9,12,8,9,1,3,3,3,0,4,4,9,2,0,2,2,22
401371784,St. Bonaventure Bonnies,Q. Adams,4585591,,True,20.0,6,7,6,7,0,0,0,3,2,1,3,1,2,0,1,0,12
401371784,St. Bonaventure Bonnies,D. Welch,4397221,,True,40.0,6,13,2,3,4,10,0,0,1,2,3,7,4,1,1,0,16
401371784,St. Bonaventure Bonnies,A. Coulibaly,4432889,,False,7.0,1,1,1,1,0,0,0,0,0,0,0,1,0,0,0,1,2
401371784,St. Bonaventure Bonnies,L. Brown,4897047,,False,22.0,1,5,1,1,0,4,0,0,1,4,5,1,0,0,1,1,2
401371784,St. Bonaventure Bonnies,TEAM,TOTAL,TOTAL,False,,36,60,29,41,7,19,5,8,9,20,29,23,10,4,9,6,84
401371784,Loyola Maryland Greyhounds,M. Ilic,4897890,,True,27.0,5,6,2,2,3,4,0,0,1,3,4,0,0,0,3,2,13
401371784,Loyola Maryland Greyhounds,G. Dike,4593122,,True,17.0,0,3,0,3,0,0,0,0,3,3,6,0,0,0,1,3,0
401371784,Loyola Maryland Greyhounds,C. Spencer,4433083,,True,37.0,5,9,2,3,3,6,0,0,0,2,2,6,1,0,3,1,13
401371784,Loyola Maryland Greyhounds,K. Jones,4398136,,True,33.0,1,5,0,0,1,5,0,0,0,0,0,7,1,0,1,3,3
401371784,Loyola Maryland Greyhounds,J. Andrews,4398132,,True,35.0,7,16,5,8,2,8,4,4,1,2,3,2,2,1,1,0,20
401371784,Loyola Maryland Greyhounds,V. Ilic,4897888,,False,23.0,6,8,6,8,0,0,1,2,0,3,3,1,1,0,1,1,13
401371784,Loyola Maryland Greyhounds,A. Faure,4702520,,False,8.0,0,1,0,1,0,0,0,0,1,2,3,2,0,0,0,0,0
401371784,Loyola Maryland Greyhounds,D. Brown III,4897893,,False,8.0,2,2,0,0,2,2,0,0,0,0,0,1,0,0,1,0,6
401371784,Loyola Maryland Greyhounds,W. Jackson,4589477,,False,12.0,1,4,0,0,1,4,0,0,0,0,0,2,0,0,2,1,3
401371784,Loyola Maryland Greyhounds,TEAM,TOTAL,TOTAL,False,,27,54,15,25,12,29,5,6,8,17,25,21,5,1,13,11,71
401371783,St. Bonaventure Bonnies,O. Osunniyi,4397224,,True,38.0,6,11,6,11,0,0,0,1,2,5,7,3,0,1,1,3,12
401371783,St. Bonaventure Bonnies,J. Adaway,4279431,,True,37.0,5,12,4,8,1,4,1,1,1,6,7,0,2,2,0,3,12
401371783,St. Bonaventure Bonnies,J. Holmes,4701016,,True,40.0,5,15,3,8,2,7,3,3,0,5,5,6,1,0,1,3,15
401371783,St. Bonaventure Bonnies,D. Welch,4397221,,True,37.0,7,14,1,1,6,13,0,0,1,6,7,1,1,0,1,2,20
401371783,St. Bonaventure Bonnies,K. Lofton,4397220,,True,40.0,4,11,1,5,3,6,10,11,0,2,2,7,4,0,2,1,21
401371783,St. Bonaventure Bonnies,A. Coulibaly,4432889,,False,2.0,0,0,0,0,0,0,0,0,0,0,0,0,0,0,0,1,0
401371783,St. Bonaventure Bonnies,L. Brown,4897047,,False,6.0,0,1,0,0,0,1,0,0,0,0,0,0,0,0,0,1,0
401371783,St. Bonaventure Bonnies,TEAM,TOTAL,TOTAL,False,,27,64,15,33,12,31,14,16,4,25,29,17,8,3,6,14,80
401371783,Northern Iowa Panthers,A. Phyfe,4279169,,True,22.0,6,8,4,5,2,3,1,1,0,5,5,3,0,0,2,1,15
401371783,Northern Iowa Panthers,N. Heise,4703912,,True,29.0,6,9,4,5,2,4,1,2,0,7,7,0,1,0,3,3,15
401371783,Northern Iowa Panthers,AJ Green,4397475,,True,36.0,11,18,2,3,9,15,4,5,0,5,5,4,0,0,3,0,35
401371783,Northern Iowa Panthers,T. Berhow,4280203,,True,15.0,2,5,1,2,1,3,0,0,0,2,2,1,0,0,0,0,5
401371783,Northern Iowa Panthers,T. Pickford,4279167,,True,30.0,2,3,1,2,1,1,0,0,5,4,9,2,0,0,0,0,5
401371783,Northern Iowa Panthers,C. Henry,4433004,,False,15.0,2,6,2,6,0,0,1,2,0,4,4,3,0,0,0,1,5
401371783,Northern Iowa Panthers,N. Carter,4431923,,False,17.0,2,6,2,5,0,1,0,0,0,2,2,0,0,0,0,2,4
401371783,Northern Iowa Panthers,B. Born,4703913,,False,27.0,1,5,1,1,0,4,4,4,0,2,2,4,1,0,2,3,6
401371783,Northern Iowa Panthers,A. Kimmons,4433020,,False,9.0,0,2,0,2,0,0,0,0,0,2,2,0,2,0,0,0,0
401371783,Northern Iowa Panthers,TEAM,TOTAL,TOTAL,False,,32,62,17,31,15,31,11,14,7,34,41,17,4,0,10,10,90
401371781,UAB Blazers,KJ Buffen,4396968,,True,32.0,5,9,5,8,0,1,2,3,4,3,7,0,1,0,2,3,12
401371781,UAB Blazers,T. Jemison,4395623,,True,27.0,2,3,2,3,0,0,0,1,5,6,11,0,1,1,2,3,4
401371781,UAB Blazers,J. Walker,4396656,,True,30.0,6,17,2,7,4,10,2,2,0,2,2,7,1,0,4,3,18
401371781,UAB Blazers,J. Johnson,4278281,,True,19.0,3,6,1,1,2,5,0,0,0,0,0,0,1,0,1,0,8
401371781,UAB Blazers,Q. Jackson,4067781,,True,35.0,4,10,4,7,0,3,0,1,1,5,6,4,3,1,2,2,8
401371781,UAB Blazers,J. LeBlanc Sr.,4397074,,False,18.0,3,4,3,4,0,0,0,0,1,1,2,0,0,1,0,4,6
401371781,UAB Blazers,T. Lovan,4397726,,False,15.0,2,6,2,6,0,0,1,2,1,4,5,1,1,0,0,1,5
401371781,UAB Blazers,M. Ertel,4280260,,False,24.0,6,9,3,5,3,4,1,2,1,2,3,4,1,0,0,2,16
401371781,UAB Blazers,TEAM,TOTAL,TOTAL,False,,31,64,22,41,9,23,6,11,15,23,38,16,9,3,13,18,77
401371781,Saint Louis Billikens,T. Hargrove Jr.,4592484,,True,20.0,1,3,0,1,1,2,1,2,0,6,6,0,0,0,0,0,4
401371781,Saint Louis Billikens,M. Linssen,4279174,,True,18.0,4,6,4,6,0,0,3,4,0,2,2,2,0,4,1,2,11
401371781,Saint Louis Billikens,J. Nesbitt,4714246,,True,23.0,2,8,2,6,0,2,0,0,2,3,5,1,2,0,0,0,4
401371781,Saint Louis Billikens,Y. Collins,4432957,,True,29.0,1,4,1,2,0,2,2,2,0,0,0,7,1,0,4,4,4
401371781,Saint Louis Billikens,G. Jimerson,4432008,,True,31.0,3,8,2,4,1,4,1,2,0,2,2,0,3,0,3,2,8
401371781,Saint Louis Billikens,F. Okoro,4397105,,False,22.0,3,5,3,5,0,0,6,8,2,3,5,1,0,1,0,1,12
401371781,Saint Louis Billikens,F. Thatch Jr.,4397199,,False,31.0,4,6,3,4,1,2,3,4,0,4,4,1,1,0,2,2,12
401371781,Saint Louis Billikens,D. Jones,4278267,,False,26.0,6,9,1,2,5,7,0,0,0,0,0,1,1,0,0,1,17
401371781,Saint Louis Billikens,TEAM,TOTAL,TOTAL,False,,24,49,16,30,8,19,16,22,5,22,27,13,8,5,11,12,72
401371780,Saint Louis Billikens,T. Hargrove Jr.,4592484,,True,18.0,2,3,1,2,1,1,1,2,0,2,2,0,0,0,0,2,6
401371780,Saint Louis Billikens,M. Linssen,4279174,,True,16.0,1,4,1,4,0,0,5,6,2,3,5,0,0,1,2,5,7
401371780,Saint Louis Billikens,J. Nesbitt,4714246,,True,31.0,1,8,0,4,1,4,3,4,1,7,8,1,1,1,0,1,6
401371780,Saint Louis Billikens,Y. Collins,4432957,,True,29.0,5,13,5,13,0,0,5,6,0,3,3,1,1,0,3,3,15
401371780,Saint Louis Billikens,G. Jimerson,4432008,,True,41.0,6,8,5,6,1,2,8,8,0,5,5,3,0,0,3,5,21
401371780,Saint Louis Billikens,F. Okoro,4397105,,False,29.0,3,7,3,7,0,0,2,2,1,3,4,1,0,0,1,4,8
401371780,Saint Louis Billikens,R. Williams,4399106,,False,6.0,1,2,0,0,1,2,0,0,0,0,0,0,0,0,2,1,3
401371780,Saint Louis Billikens,F. Thatch Jr.,4397199,,False,30.0,4,6,4,5,0,1,4,4,0,5,5,2,1,0,0,2,12
401371780,Saint Louis Billikens,D. Jones,4278267,,False,25.0,2,3,0,0,2,3,2,2,1,0,1,2,1,0,0,2,8
401371780,Saint Louis Billikens,TEAM,TOTAL,TOTAL,False,,25,54,19,41,6,13,30,34,6,29,35,10,4,2,12,25,86
401371780,Boise State Broncos,T. Degenhart,4898260,,True,37.0,5,7,4,4,1,3,0,1,2,4,6,0,0,3,1,2,11
401371780,Boise State Broncos,M. Armus,4280022,,True,24.0,4,7,4,7,0,0,0,3,5,5,10,3,1,4,1,3,8
401371780,Boise State Broncos,A. Kigab,4278513,,True,34.0,11,17,11,16,0,1,5,11,2,6,8,1,3,0,1,4,27
401371780,Boise State Broncos,M. Shaver Jr.,4280208,,True,33.0,5,12,2,5,3,7,1,1,1,2,3,1,0,0,1,4,14
401371780,Boise State Broncos,E. Akot,4278131,,True,39.0,3,10,2,5,1,5,3,5,0,1,1,1,0,0,3,2,10
401371780,Boise State Broncos,N. Smith,4702873,,False,14.0,0,1,0,0,0,1,0,0,0,3,3,0,0,0,2,1,0
401371780,Boise State Broncos,L. Milner,4702874,,False,4.0,0,2,0,2,0,0,0,0,0,0,0,0,0,0,0,1,0
401371780,Boise State Broncos,P. Kuzmanovic,4702872,,False,21.0,3,7,0,1,3,6,2,2,0,1,1,3,0,0,0,3,11
401371780,Boise State Broncos,M. Rice,4397263,,False,6.0,0,1,0,1,0,0,0,1,0,0,0,0,0,0,0,1,0
401371780,Boise State Broncos,D. Doutrive,4397039,,False,13.0,0,3,0,1,0,2,1,2,1,1,2,2,0,0,0,1,1
401371780,Boise State Broncos,TEAM,TOTAL,TOTAL,False,,31,67,23,42,8,25,12,26,14,26,40,11,4,7,10,22,82
401371779,Saint Louis Billikens,T. Hargrove Jr.,4592484,,True,30.0,6,7,5,6,1,1,0,0,0,3,3,2,0,0,7,2,13
401371779,Saint Louis Billikens,M. Linssen,4279174,,True,17.0,3,5,3,5,0,0,4,4,2,3,5,1,0,0,0,3,10
401371779,Saint Louis Billikens,J. Nesbitt,4714246,,True,23.0,5,7,3,3,2,4,2,2,0,1,1,1,2,0,1,4,14
401371779,Saint Louis Billikens,Y. Collins,4432957,,True,38.0,3,9,2,4,1,5,0,0,1,3,4,8,3,1,8,1,7
401371779,Saint Louis Billikens,G. Jimerson,4432008,,True,32.0,4,12,1,6,3,6,8,8,0,3,3,0,0,0,0,3,19
401371779,Saint Louis Billikens,F. Okoro,4397105,,False,22.0,2,3,2,3,0,0,2,5,4,5,9,0,1,0,0,1,6
401371779,Saint Louis Billikens,R. Williams,4399106,,False,3.0,0,1,0,0,0,1,0,0,0,1,1,0,0,0,0,0,0
401371779,Saint Louis Billikens,F. Thatch Jr.,4397199,,False,19.0,3,6,3,6,0,0,1,3,2,3,5,0,1,0,1,3,7
401371779,Saint Louis Billikens,D. Jones,4278267,,False,16.0,1,4,0,0,1,4,3,3,0,2,2,1,1,0,0,3,6
401371779,Saint Louis Billikens,TEAM,TOTAL,TOTAL,False,,27,54,19,33,8,21,20,25,10,25,35,13,8,1,18,20,82
401371779,Illinois State Redbirds,K. Lewis,4593851,,True,17.0,3,4,3,3,0,1,0,0,1,0,1,4,0,0,4,5,6
401371779,Illinois State Redbirds,Sy Chatman,4397162,,True,23.0,6,8,6,8,0,0,1,3,0,3,3,0,0,1,2,4,13
401371779,Illinois State Redbirds,A. Reeves,4592686,,True,34.0,5,12,1,6,4,6,6,7,1,3,4,0,1,0,1,1,20
401371779,Illinois State Redbirds,M. Freeman,4432988,,True,28.0,5,11,4,8,1,3,2,3,0,3,3,0,1,0,4,0,13
401371779,Illinois State Redbirds,J. Strong,4398146,,True,26.0,2,8,0,2,2,6,0,0,0,2,2,1,1,0,1,2,6
401371779,Illinois State Redbirds,R. Schmitt,4897463,,False,8.0,2,2,2,2,0,0,0,1,2,1,3,0,0,1,1,2,4
401371779,Illinois State Redbirds,A. Andrews,4703901,,False,8.0,0,0,0,0,0,0,0,0,0,0,0,1,0,0,1,1,0
401371779,Illinois State Redbirds,L. McChesney,4433038,,False,17.0,0,2,0,0,0,2,0,0,1,2,3,1,0,0,1,4,0
401371779,Illinois State Redbirds,E. Washington,4703900,,False,16.0,2,4,2,3,0,1,3,4,0,1,1,0,0,0,0,3,7
401371779,Illinois State Redbirds,H. Fleming Jr.,4703899,,False,23.0,1,3,0,0,1,3,4,4,0,1,1,5,5,1,1,1,7
401371779,Illinois State Redbirds,TEAM,TOTAL,TOTAL,False,,26,54,18,32,8,22,16,22,9,18,27,12,8,3,16,23,76
401371778,Saint Louis Billikens,T. Hargrove Jr.,4592484,,True,36.0,6,9,3,5,3,4,0,0,2,9,11,0,1,1,2,1,15
401371778,Saint Louis Billikens,M. Linssen,4279174,,True,19.0,3,6,3,6,0,0,3,4,3,2,5,1,1,1,1,2,9
401371778,Saint Louis Billikens,J. Nesbitt,4714246,,True,15.0,0,0,0,0,0,0,1,2,0,2,2,2,0,0,1,2,1
401371778,Saint Louis Billikens,Y. Collins,4432957,,True,33.0,3,11,2,10,1,1,1,2,0,1,1,7,1,0,4,3,8
401371778,Saint Louis Billikens,G. Jimerson,4432008,,True,35.0,5,12,4,8,1,4,4,6,0,1,1,0,0,0,2,0,15
401371778,Saint Louis Billikens,F. Okoro,4397105,,False,21.0,1,2,1,2,0,0,5,6,1,4,5,0,1,3,1,3,7
401371778,Saint Louis Billikens,M. Strickland,4432494,,False,1.0,0,0,0,0,0,0,0,0,0,0,0,0,0,0,0,0,0
401371778,Saint Louis Billikens,F. Thatch Jr.,4397199,,False,28.0,8,9,8,8,0,1,4,6,5,3,8,0,3,1,2,2,20
401371778,Saint Louis Billikens,D. Jones,4278267,,False,12.0,0,2,0,1,0,1,0,0,0,0,0,3,0,0,0,2,0
401371778,Saint Louis Billikens,TEAM,TOTAL,TOTAL,False,,26,51,21,40,5,11,18,26,11,24,35,13,7,6,14,15,75
401371778,Mercer Bears,J. Glisson III,4593676,,True,26.0,1,5,1,3,0,2,0,0,4,4,8,2,2,0,1,2,2
401371778,Mercer Bears,F. Haase,4278110,,True,29.0,4,6,1,1,3,5,2,2,2,1,3,1,1,1,3,4,13
401371778,Mercer Bears,S. Walker Jr.,4897379,,True,27.0,0,6,0,2,0,4,2,2,2,0,2,2,0,0,3,5,2
401371778,Mercer Bears,N. Alvarez,4398075,,True,29.0,7,14,7,13,0,1,1,2,2,2,4,3,2,0,2,2,15
401371778,Mercer Bears,J. Johnson,4066216,,True,33.0,3,8,0,1,3,7,7,9,0,3,3,1,2,0,1,3,16
401371778,Mercer Bears,S. Grant,4703815,,False,11.0,3,6,3,6,0,0,0,0,1,5,6,0,0,0,0,3,6
401371778,Mercer Bears,J. Tucker,4703816,,False,15.0,0,1,0,0,0,1,0,0,0,1,1,0,1,0,0,0,0
401371778,Mercer Bears,K. Robertson,4593674,,False,30.0,2,9,2,3,0,6,0,0,0,1,1,1,1,0,4,3,4
401371778,Mercer Bears,TEAM,TOTAL,TOTAL,False,,20,55,14,29,6,26,12,15,11,19,30,10,9,1,14,22,58
401371777,Saint Louis Billikens,T. Hargrove Jr.,4592484,,True,36.0,9,23,8,19,1,4,1,3,5,6,11,1,1,1,0,3,20
401371777,Saint Louis Billikens,M. Linssen,4279174,,True,16.0,4,8,4,8,0,0,3,4,4,2,6,0,0,1,1,5,11
401371777,Saint Louis Billikens,J. Nesbitt,4714246,,True,28.0,3,14,1,8,2,6,5,8,1,3,4,3,2,1,0,3,13
401371777,Saint Louis Billikens,Y. Collins,4432957,,True,29.0,3,13,3,10,0,3,3,3,0,1,1,7,5,0,6,2,9
401371777,Saint Louis Billikens,G. Jimerson,4432008,,True,22.0,1,3,0,1,1,2,3,4,0,0,0,0,0,0,1,1,6
401371777,Saint Louis Billikens,L. Traore,4897052,,False,2.0,0,0,0,0,0,0,0,0,0,1,1,0,0,0,0,1,0
401371777,Saint Louis Billikens,A. Lorentsson,4701121,,False,2.0,0,0,0,0,0,0,0,0,0,0,0,0,0,0,0,0,0
401371777,Saint Louis Billikens,F. Okoro,4397105,,False,22.0,1,6,1,6,0,0,5,6,9,4,13,0,2,3,1,3,7
401371777,Saint Louis Billikens,M. Strickland,4432494,,False,3.0,1,1,1,1,0,0,0,0,1,0,1,0,0,0,0,2,2
401371777,Saint Louis Billikens,R. Williams,4399106,,False,7.0,0,1,0,0,0,1,0,0,0,0,0,0,0,0,0,0,0
401371777,Saint Louis Billikens,F. Thatch Jr.,4397199,,False,15.0,0,1,0,1,0,0,1,4,1,3,4,0,1,0,3,2,1
401371777,Saint Louis Billikens,D. Jones,4278267,,False,18.0,2,7,1,1,1,6,0,0,1,0,1,1,0,0,2,1,5
401371777,Saint Louis Billikens,TEAM,TOTAL,TOTAL,False,,24,77,19,55,5,22,21,32,23,21,44,12,11,6,14,23,74
401371777,Memphis Tigers,E. Bates,4433620,,True,26.0,6,10,3,4,3,6,1,2,0,2,2,2,0,2,4,3,16
401371777,Memphis Tigers,D. Williams,4397355,,True,15.0,3,6,3,5,0,1,2,3,0,4,4,0,0,1,2,2,8
401371777,Memphis Tigers,J. Duren,4433621,,True,21.0,3,3,3,3,0,0,7,11,3,5,8,0,1,6,2,2,13
401371777,Memphis Tigers,L. Quinones,4431720,,True,18.0,1,3,1,2,0,1,3,4,2,4,6,0,2,0,2,3,5
401371777,Memphis Tigers,A. Lomax,4396633,,True,19.0,2,4,2,4,0,0,2,2,1,3,4,4,1,0,2,0,6
401371777,Memphis Tigers,M. Dandridge,4431738,,False,5.0,0,2,0,2,0,0,0,0,1,0,1,0,0,0,1,2,0
401371777,Memphis Tigers,J. Minott,4687718,,False,14.0,5,5,5,5,0,0,2,3,0,2,2,2,0,1,0,5,12
401371777,Memphis Tigers,C. Lawson,4431721,,False,4.0,1,1,1,1,0,0,0,0,0,1,1,1,0,1,0,0,2
401371777,Memphis Tigers,T. Jacobs,4897070,,False,1.0,0,0,0,0,0,0,0,0,0,0,0,0,0,0,0,0,0
401371777,Memphis Tigers,C. Glennon,4701207,,False,2.0,0,0,0,0,0,0,0,0,0,0,0,0,0,0,0,0,0
401371777,Memphis Tigers,E. Timberlake,4432193,,False,16.0,0,1,0,1,0,0,0,2,0,2,2,0,0,0,2,4,0
401371777,Memphis Tigers,J. Hardaway,4396635,,False,18.0,1,5,0,4,1,1,0,0,1,3,4,1,0,0,2,1,3
401371777,Memphis Tigers,T. Harris,4396632,,False,19.0,7,9,3,4,4,5,0,2,1,0,1,1,1,0,2,1,18
401371777,Memphis Tigers,L. Nolley II,4395684,,False,22.0,2,8,2,5,0,3,3,4,2,8,10,4,1,3,3,3,7
401371777,Memphis Tigers,TEAM,TOTAL,TOTAL,False,,31,57,23,40,8,17,20,33,13,35,48,15,6,14,24,26,90
401371776,Saint Louis Billikens,T. Hargrove Jr.,4592484,,True,21.0,3,5,3,5,0,0,0,0,1,3,4,0,0,0,1,0,6
401371776,Saint Louis Billikens,M. Linssen,4279174,,True,15.0,5,8,5,8,0,0,5,6,2,2,4,1,3,1,2,3,15
401371776,Saint Louis Billikens,J. Nesbitt,4714246,,True,16.0,3,8,3,6,0,2,0,1,0,5,5,1,0,0,0,2,6
401371776,Saint Louis Billikens,Y. Collins,4432957,,True,23.0,3,6,2,4,1,2,4,4,0,3,3,6,1,0,1,1,11
401371776,Saint Louis Billikens,G. Jimerson,4432008,,True,25.0,7,14,6,7,1,7,3,4,1,0,1,0,0,0,0,0,18
401371776,Saint Louis Billikens,L. Traore,4897052,,False,12.0,4,6,4,6,0,0,0,0,3,3,6,0,1,0,1,2,8
401371776,Saint Louis Billikens,A. Lorentsson,4701121,,False,5.0,1,1,0,0,1,1,0,0,0,2,2,0,0,0,0,1,3
401371776,Saint Louis Billikens,F. Okoro,4397105,,False,18.0,2,4,2,4,0,0,7,8,6,6,12,1,1,1,1,4,11
401371776,Saint Louis Billikens,M. Strickland,4432494,,False,7.0,1,3,1,2,0,1,0,1,0,0,0,0,0,0,0,1,2
401371776,Saint Louis Billikens,R. Williams,4399106,,False,17.0,0,1,0,0,0,1,0,0,0,0,0,2,0,0,2,1,0
401371776,Saint Louis Billikens,F. Thatch Jr.,4397199,,False,19.0,2,6,2,5,0,1,0,0,2,7,9,3,1,0,1,1,4
401371776,Saint Louis Billikens,B. Courtney,4397197,,False,2.0,0,1,0,1,0,0,0,0,0,0,0,1,0,0,0,0,0
401371776,Saint Louis Billikens,D. Jones,4278267,,False,20.0,1,2,1,2,0,0,0,0,0,0,0,0,1,0,0,1,2
401371776,Saint Louis Billikens,TEAM,TOTAL,TOTAL,False,,32,65,29,50,3,15,19,24,16,33,49,15,8,2,9,17,86
401371776,Eastern Illinois Panthers,J. Hamlin,4592609,,True,27.0,1,7,1,7,0,0,1,2,1,4,5,0,1,3,4,2,3
401371776,Eastern Illinois Panthers,R. Rufino Bolis,4897268,,True,23.0,1,7,0,4,1,3,3,4,1,2,3,0,3,0,3,0,6
401371776,Eastern Illinois Panthers,K. Clements,4897264,,True,34.0,2,6,2,5,0,1,0,0,1,2,3,2,0,0,5,2,4
401371776,Eastern Illinois Panthers,H. Abraham,4703231,,True,27.0,3,6,0,0,3,6,0,0,0,1,1,0,0,0,0,1,9
401371776,Eastern Illinois Panthers,E. Wood,4702280,,True,17.0,0,4,0,3,0,1,3,4,0,0,0,0,1,0,0,0,3
401371776,Eastern Illinois Panthers,P. Bizimana,4897265,,False,5.0,1,2,0,1,1,1,0,0,0,0,0,0,0,0,0,1,3
401371776,Eastern Illinois Panthers,B. Alleruzzo IV,4703229,,False,8.0,0,2,0,0,0,2,0,0,1,4,5,0,0,0,1,3,0
401371776,Eastern Illinois Panthers,S. Friday IV,4067353,,False,12.0,2,2,2,2,0,0,1,1,0,1,1,0,0,0,0,5,5
401371776,Eastern Illinois Panthers,C. Robinson,4897267,,False,16.0,0,5,0,5,0,0,1,2,0,1,1,1,0,0,1,1,1
401371776,Eastern Illinois Panthers,C. Lane,4897266,,False,25.0,3,8,3,4,0,4,4,4,0,4,4,1,1,1,2,3,10
401371776,Eastern Illinois Panthers,M. Schnyders,4703230,,False,6.0,0,1,0,1,0,0,0,0,0,0,0,0,0,0,0,0,0
401371776,Eastern Illinois Panthers,TEAM,TOTAL,TOTAL,False,,13,50,8,32,5,18,13,17,5,20,25,4,6,4,18,18,44
401371774,Saint Joseph's Hawks,T. Funk,4278395,,True,36.0,7,13,3,4,4,9,2,2,2,7,9,2,1,1,1,2,20
401371774,Saint Joseph's Hawks,E. Obinna,4278125,,True,27.0,6,12,6,12,0,0,1,2,3,4,7,0,2,0,0,3,13
401371774,Saint Joseph's Hawks,J. Hall,4701031,,True,36.0,4,16,3,9,1,7,1,2,2,5,7,12,0,0,4,3,10
401371774,Saint Joseph's Hawks,E. Reynolds II,4683952,,True,17.0,5,8,3,5,2,3,1,1,1,1,2,2,1,0,2,5,13
401371774,Saint Joseph's Hawks,C. Brown,4592476,,True,34.0,4,8,4,6,0,2,0,0,2,3,5,2,0,0,1,2,8
401371774,Saint Joseph's Hawks,K. Klaczek,4897053,,False,7.0,1,2,1,1,0,1,0,0,0,0,0,0,0,1,1,3,2
401371774,Saint Joseph's Hawks,A. Jansson,4701029,,False,7.0,0,0,0,0,0,0,0,0,0,1,1,0,0,0,1,3,0
401371774,Saint Joseph's Hawks,J. Forrest,4701032,,False,10.0,0,2,0,1,0,1,0,0,0,0,0,0,0,0,1,1,0
401371774,Saint Joseph's Hawks,D. Bishop,4701028,,False,26.0,3,6,2,3,1,3,0,0,0,0,0,0,1,0,1,3,7
401371774,Saint Joseph's Hawks,TEAM,TOTAL,TOTAL,False,,30,67,22,41,8,26,5,7,11,24,35,18,5,2,13,25,73
401371774,Bradley Braves,M. Leons,4897449,,True,32.0,6,9,6,7,0,2,2,2,0,1,1,0,0,2,0,2,14
401371774,Bradley Braves,R. Mast,4592677,,True,30.0,4,9,3,5,1,4,0,0,1,9,10,1,0,1,0,1,9
401371774,Bradley Braves,J. Henry,4397325,,True,33.0,7,11,7,11,0,0,4,4,3,3,6,0,0,0,3,0,18
401371774,Bradley Braves,C. Hickman,4897447,,True,26.0,2,6,1,4,1,2,5,8,3,2,5,1,2,0,0,3,10
401371774,Bradley Braves,T. Roberts,4897444,,True,31.0,6,12,6,11,0,1,1,3,1,4,5,6,2,0,5,2,13
401371774,Bradley Braves,A. Boya,4397323,,False,8.0,1,5,1,5,0,0,0,0,2,1,3,0,1,0,1,2,2
401371774,Bradley Braves,J. Kent,4703889,,False,12.0,1,2,0,0,1,2,8,8,0,2,2,0,0,1,1,0,11
401371774,Bradley Braves,M. Howell,4702604,,False,17.0,0,2,0,2,0,0,0,0,0,3,3,4,2,0,0,1,0
401371774,Bradley Braves,V. Tahvanainen,4433093,,False,11.0,0,2,0,2,0,0,0,0,0,0,0,1,0,0,0,3,0
401371774,Bradley Braves,TEAM,TOTAL,TOTAL,False,,27,58,24,47,3,11,20,25,10,26,36,13,7,4,10,14,77
401371773,Temple Owls,S. Tolbert III,4398355,,True,14.0,0,2,0,1,0,1,0,0,1,2,3,0,1,0,0,1,0
401371773,Temple Owls,J. Forrester,4397009,,True,12.0,3,6,3,6,0,0,0,1,0,1,1,0,0,2,1,3,6
401371773,Temple Owls,J. Williams,4701222,,True,36.0,5,14,5,13,0,1,2,4,1,4,5,4,1,0,1,1,12
401371773,Temple Owls,Q. Ademokoya,4602022,,True,10.0,0,3,0,0,0,3,0,0,0,1,1,0,0,0,0,2,0
401371773,Temple Owls,D. Dunn,4431946,,True,36.0,4,11,3,8,1,3,3,3,1,6,7,0,3,0,2,2,12
401371773,Temple Owls,Z. Hicks,4708214,,False,12.0,0,4,0,2,0,2,0,0,0,1,1,0,0,0,0,0,0
401371773,Temple Owls,N. Jourdain,4701221,,False,24.0,3,6,2,2,1,4,1,3,3,3,6,0,0,1,1,3,8
401371773,Temple Owls,H. Miller,4708218,,False,11.0,0,3,0,1,0,2,0,0,1,0,1,0,0,0,0,1,0
401371773,Temple Owls,J. White,4432514,,False,21.0,5,9,5,6,0,3,1,7,1,5,6,0,2,0,2,5,11
401371773,Temple Owls,T. Strickland,4397253,,False,24.0,0,6,0,5,0,1,0,0,0,1,1,0,0,0,0,1,0
401371773,Temple Owls,TEAM,TOTAL,TOTAL,False,,20,64,18,44,2,20,7,18,10,28,38,4,7,3,7,19,49
401371773,Saint Joseph's Hawks,T. Funk,4278395,,True,37.0,2,6,0,0,2,6,2,2,1,12,13,4,2,0,1,0,8
401371773,Saint Joseph's Hawks,E. Obinna,4278125,,True,24.0,6,10,6,10,0,0,2,4,0,4,4,1,0,0,0,3,14
401371773,Saint Joseph's Hawks,J. Hall,4701031,,True,36.0,8,15,4,9,4,6,6,6,2,6,8,5,3,1,7,2,26
401371773,Saint Joseph's Hawks,E. Reynolds II,4683952,,True,21.0,1,6,0,3,1,3,2,2,1,1,2,2,0,0,0,4,5
401371773,Saint Joseph's Hawks,C. Brown,4592476,,True,30.0,0,6,0,3,0,3,0,0,0,3,3,4,0,0,2,2,0
401371773,Saint Joseph's Hawks,C. Coleman,4431807,,False,8.0,1,1,1,1,0,0,1,5,0,3,3,0,1,0,1,3,3
401371773,Saint Joseph's Hawks,K. Klaczek,4897053,,False,5.0,0,1,0,0,0,1,0,0,0,1,1,0,0,0,1,1,0
401371773,Saint Joseph's Hawks,A. Jansson,4701029,,False,8.0,1,2,1,2,0,0,0,0,1,1,2,0,0,0,1,3,2
401371773,Saint Joseph's Hawks,J. Forrest,4701032,,False,10.0,0,2,0,0,0,2,3,3,0,1,1,0,0,0,0,0,3
401371773,Saint Joseph's Hawks,D. Bishop,4701028,,False,21.0,2,5,1,2,1,3,2,4,0,4,4,0,0,2,0,2,7
401371773,Saint Joseph's Hawks,TEAM,TOTAL,TOTAL,False,,21,54,13,30,8,24,18,26,9,39,48,16,6,3,13,20,68
401371772,Villanova Wildcats,E. Dixon,4431718,,True,23.0,5,10,3,7,2,3,0,0,2,4,6,2,3,0,6,3,12
401371772,Villanova Wildcats,B. Slater,4397133,,True,29.0,4,9,2,4,2,5,0,0,0,5,5,3,2,1,2,2,10
401371772,Villanova Wildcats,J. Samuels,4278588,,True,28.0,3,5,3,4,0,1,4,4,2,1,3,1,1,0,0,3,10
401371772,Villanova Wildcats,J. Moore,4592491,,True,30.0,6,13,4,7,2,6,2,3,1,6,7,4,1,0,1,1,16
401371772,Villanova Wildcats,C. Gillespie,4278585,,True,31.0,7,12,2,5,5,7,4,4,0,4,4,3,0,0,2,0,23
401371772,Villanova Wildcats,T. Patterson,4713885,,False,7.0,0,0,0,0,0,0,0,0,0,0,0,1,0,0,0,0,0
401371772,Villanova Wildcats,N. Njoku,4433274,,False,3.0,0,0,0,0,0,0,0,0,1,1,2,0,0,0,1,0,0
401371772,Villanova Wildcats,D. Cosby-Roundtree,4278586,,False,11.0,0,0,0,0,0,0,0,0,1,2,3,2,0,0,1,1,0
401371772,Villanova Wildcats,K. Voigt,4702030,,False,1.0,0,0,0,0,0,0,0,0,0,0,0,0,0,0,0,0,0
401371772,Villanova Wildcats,J. Longino,4684153,,False,11.0,1,2,1,1,0,1,0,0,0,0,0,0,0,0,0,0,2
401371772,Villanova Wildcats,C. Arcidiacono,4592490,,False,26.0,2,2,0,0,2,2,2,2,0,5,5,0,1,0,0,0,8
401371772,Villanova Wildcats,TEAM,TOTAL,TOTAL,False,,28,53,15,28,13,25,12,13,7,29,36,16,8,1,13,10,81
401371772,Saint Joseph's Hawks,T. Funk,4278395,,True,34.0,0,6,0,1,0,5,0,0,1,5,6,0,2,0,0,1,0
401371772,Saint Joseph's Hawks,E. Obinna,4278125,,True,28.0,5,6,5,6,0,0,0,2,3,1,4,1,0,0,2,2,10
401371772,Saint Joseph's Hawks,J. Hall,4701031,,True,38.0,8,20,5,10,3,10,3,3,0,1,1,5,1,1,6,2,22
401371772,Saint Joseph's Hawks,E. Reynolds II,4683952,,True,23.0,3,9,1,3,2,6,0,0,0,0,0,1,0,0,2,5,8
401371772,Saint Joseph's Hawks,C. Brown,4592476,,True,29.0,4,8,2,3,2,5,0,0,1,4,5,2,2,0,3,1,10
401371772,Saint Joseph's Hawks,C. Coleman,4431807,,False,7.0,0,1,0,1,0,0,0,0,1,2,3,0,0,0,0,0,0
401371772,Saint Joseph's Hawks,K. Klaczek,4897053,,False,8.0,0,1,0,1,0,0,0,0,0,1,1,0,0,0,0,0,0
401371772,Saint Joseph's Hawks,A. Jansson,4701029,,False,2.0,0,0,0,0,0,0,0,0,0,0,0,0,0,0,0,0,0
401371772,Saint Joseph's Hawks,J. Forrest,4701032,,False,19.0,1,5,1,2,0,3,0,0,0,2,2,1,0,0,1,0,2
401371772,Saint Joseph's Hawks,D. Bishop,4701028,,False,12.0,0,2,0,0,0,2,0,2,0,0,0,0,0,0,1,2,0
401371772,Saint Joseph's Hawks,TEAM,TOTAL,TOTAL,False,,21,58,14,27,7,31,3,7,10,18,28,10,5,1,15,13,52
401371771,USC Trojans,I. Mobley,4432815,,True,32.0,2,8,2,7,0,1,0,0,3,8,11,3,1,1,2,0,4
401371771,USC Trojans,M. Agbonkpolo,4431700,,True,24.0,3,5,3,4,0,1,0,0,1,4,5,0,0,0,1,2,6
401371771,USC Trojans,C. Goodwin,4067218,,True,18.0,5,11,5,11,0,0,0,1,4,4,8,0,0,0,0,0,10
401371771,USC Trojans,B. Ellis,4593106,,True,30.0,8,14,7,11,1,3,0,0,1,3,4,4,0,0,1,1,17
401371771,USC Trojans,D. Peterson,4397689,,True,29.0,2,9,2,7,0,2,1,2,0,5,5,4,1,2,2,0,5
401371771,USC Trojans,H. Hornery,4433617,,False,3.0,0,1,0,0,0,1,0,0,0,0,0,0,0,0,0,0,0
401371771,USC Trojans,J. Morgan,4431830,,False,21.0,4,7,4,7,0,0,5,6,2,4,6,0,1,2,0,3,13
401371771,USC Trojans,K. Johnson,4683857,,False,9.0,1,1,0,0,1,1,0,0,1,0,1,1,0,1,1,1,3
401371771,USC Trojans,R. Waters,4711593,,False,12.0,2,5,1,4,1,1,1,1,0,0,0,0,3,0,0,0,6
401371771,USC Trojans,M. Thomas,4683758,,False,3.0,0,1,0,1,0,0,0,0,0,0,0,0,0,0,0,0,0
401371771,USC Trojans,E. Anderson,4431808,,False,19.0,2,7,1,6,1,1,1,2,0,0,0,0,0,0,0,1,6
401371771,USC Trojans,TEAM,TOTAL,TOTAL,False,,29,69,25,58,4,11,8,12,14,28,42,12,6,6,7,8,70
401371771,Saint Joseph's Hawks,C. Coleman,4431807,,True,9.0,0,3,0,0,0,3,0,0,0,0,0,0,1,0,0,2,0
401371771,Saint Joseph's Hawks,T. Funk,4278395,,True,33.0,5,11,3,4,2,7,0,0,2,6,8,2,0,0,4,0,12
401371771,Saint Joseph's Hawks,E. Obinna,4278125,,True,27.0,9,13,9,13,0,0,0,1,4,6,10,0,0,0,2,1,18
401371771,Saint Joseph's Hawks,J. Hall,4701031,,True,31.0,1,12,1,7,0,5,0,0,1,5,6,6,2,1,2,2,2
401371771,Saint Joseph's Hawks,E. Reynolds II,4683952,,True,30.0,2,7,0,3,2,4,1,2,0,0,0,0,1,0,0,4,7
401371771,Saint Joseph's Hawks,K. Klaczek,4897053,,False,10.0,0,2,0,0,0,2,0,0,0,3,3,1,0,1,1,2,0
401371771,Saint Joseph's Hawks,A. Jansson,4701029,,False,3.0,1,1,1,1,0,0,0,0,0,0,0,0,0,0,1,0,2
401371771,Saint Joseph's Hawks,J. Tracey,4701030,,False,12.0,1,2,1,2,0,0,0,0,0,1,1,1,0,0,1,2,2
401371771,Saint Joseph's Hawks,C. Arizin,4706891,,False,1.0,0,0,0,0,0,0,0,0,0,0,0,0,0,0,0,0,0
401371771,Saint Joseph's Hawks,J. Forrest,4701032,,False,5.0,1,3,0,0,1,3,0,0,0,1,1,0,0,0,0,1,3
401371771,Saint Joseph's Hawks,D. Bishop,4701028,,False,18.0,1,6,1,2,0,4,2,2,0,2,2,0,0,0,3,0,4
401371771,Saint Joseph's Hawks,C. Brown,4592476,,False,21.0,2,5,1,2,1,3,0,0,2,2,4,0,0,0,0,2,5
401371771,Saint Joseph's Hawks,TEAM,TOTAL,TOTAL,False,,23,65,17,34,6,31,3,5,14,28,42,10,4,2,15,16,55
401371770,Saint Joseph's Hawks,K. Klaczek,4897053,,True,15.0,2,5,2,4,0,1,0,0,2,0,2,1,1,0,0,2,4
401371770,Saint Joseph's Hawks,T. Funk,4278395,,True,35.0,6,12,3,7,3,5,3,3,1,5,6,0,1,0,2,1,18
401371770,Saint Joseph's Hawks,E. Obinna,4278125,,True,26.0,3,5,3,5,0,0,2,2,0,4,4,1,0,0,1,5,8
401371770,Saint Joseph's Hawks,J. Hall,4701031,,True,31.0,9,19,8,12,1,7,1,2,0,7,7,6,1,0,4,4,20
401371770,Saint Joseph's Hawks,E. Reynolds II,4683952,,True,34.0,3,6,2,4,1,2,6,7,1,0,1,2,0,0,1,1,13
401371770,Saint Joseph's Hawks,C. Coleman,4431807,,False,12.0,2,3,1,1,1,2,1,2,1,1,2,1,0,0,1,4,6
401371770,Saint Joseph's Hawks,A. Jansson,4701029,,False,1.0,1,1,1,1,0,0,0,0,0,0,0,0,0,0,0,0,2
401371770,Saint Joseph's Hawks,J. Forrest,4701032,,False,5.0,0,1,0,0,0,1,0,0,0,1,1,0,0,0,1,1,0
401371770,Saint Joseph's Hawks,D. Bishop,4701028,,False,23.0,0,1,0,1,0,0,0,0,0,5,5,1,1,1,0,2,0
401371770,Saint Joseph's Hawks,C. Brown,4592476,,False,18.0,2,7,2,6,0,1,0,1,0,2,2,1,0,0,0,0,4
401371770,Saint Joseph's Hawks,TEAM,TOTAL,TOTAL,False,,28,60,22,41,6,19,13,17,7,26,33,13,4,1,10,20,75
401371770,Drexel Dragons,M. Okros,4592777,,True,30.0,2,3,0,0,2,3,2,2,1,3,4,4,0,0,1,1,8
401371770,Drexel Dragons,J. Butler,4067138,,True,28.0,7,12,5,10,2,2,7,10,2,9,11,1,1,0,0,3,23
401371770,Drexel Dragons,M. Martin,4279733,,True,28.0,1,4,1,4,0,0,1,3,1,2,3,0,0,0,1,1,3
401371770,Drexel Dragons,X. Bell,4612161,,True,17.0,4,5,4,5,0,0,2,2,0,0,0,1,1,0,0,4,10
401371770,Drexel Dragons,C. Wynter,4397427,,True,37.0,8,18,7,16,1,2,5,6,0,4,4,6,0,0,3,2,22
401371770,Drexel Dragons,A. Williams,4702745,,False,12.0,2,5,2,5,0,0,1,2,0,2,2,0,1,1,0,1,5
401371770,Drexel Dragons,T. Brown,4709927,,False,10.0,0,2,0,2,0,0,0,0,0,3,3,2,0,0,1,2,0
401371770,Drexel Dragons,L. Oden Jr.,4585866,,False,12.0,1,3,0,2,1,1,0,0,3,1,4,0,0,0,0,0,3
401371770,Drexel Dragons,M. Juric,4397428,,False,17.0,1,3,1,2,0,1,0,0,0,0,0,1,2,0,1,3,2
401371770,Drexel Dragons,C. Washington,4397425,,False,9.0,1,2,1,2,0,0,0,0,0,0,0,0,0,0,0,0,2
401371770,Drexel Dragons,TEAM,TOTAL,TOTAL,False,,27,57,21,48,6,9,18,25,8,26,34,15,5,1,8,17,78
401371750,South Dakota State Jackrabbits,D. Wilson,4593842,,True,32.0,5,9,5,9,0,0,4,7,3,3,6,1,0,0,2,4,14
401371750,South Dakota State Jackrabbits,M. Dentlinger,4279530,,True,13.0,0,2,0,2,0,0,0,0,0,4,4,0,0,0,0,3,0
401371750,South Dakota State Jackrabbits,B. Scheierman,4593841,,True,34.0,7,11,3,4,4,7,3,4,0,3,3,3,0,0,1,2,21
401371750,South Dakota State Jackrabbits,N. Freidel,4431956,,True,35.0,9,17,5,9,4,8,3,5,0,3,3,1,0,1,2,0,25
401371750,South Dakota State Jackrabbits,A. Arians,4279531,,True,24.0,0,0,0,0,0,0,4,5,0,2,2,2,0,1,2,0,4
401371750,South Dakota State Jackrabbits,L. Appel,4702644,,False,20.0,5,7,4,6,1,1,0,2,0,1,1,3,0,0,0,5,11
401371750,South Dakota State Jackrabbits,Z. Mayo,4897251,,False,14.0,1,2,1,1,0,1,0,0,0,2,2,4,0,0,0,2,2
401371750,South Dakota State Jackrabbits,C. Easley,4592707,,False,26.0,1,3,0,0,1,3,0,0,0,3,3,1,1,1,1,0,3
401371750,South Dakota State Jackrabbits,M. Mims,4398338,,False,2.0,0,0,0,0,0,0,0,0,0,0,0,0,0,0,0,0,0
401371750,South Dakota State Jackrabbits,TEAM,TOTAL,TOTAL,False,,28,51,18,31,10,20,14,23,3,24,27,15,1,3,8,16,80
401371750,George Mason Patriots,B. Jones,4897083,,True,20.0,1,3,0,0,1,3,0,0,1,4,5,1,0,0,0,4,3
401371750,George Mason Patriots,J. Oduro,4432068,,True,35.0,8,11,8,11,0,0,4,4,0,7,7,2,1,1,1,5,20
401371750,George Mason Patriots,D. Gaines,4431961,,True,30.0,0,1,0,1,0,0,0,0,1,5,6,0,0,0,1,5,0
401371750,George Mason Patriots,D. Cooper,4279876,,True,38.0,6,15,3,6,3,9,0,0,0,1,1,6,2,0,4,2,15
401371750,George Mason Patriots,D. Schwartz,4278501,,True,39.0,12,20,9,12,3,8,2,2,1,3,4,3,0,0,0,1,29
401371750,George Mason Patriots,M. Henry,4606836,,False,5.0,0,1,0,1,0,0,0,0,0,1,1,0,0,0,0,0,0
401371750,George Mason Patriots,X. Johnson,4592439,,False,19.0,1,2,1,2,0,0,2,2,0,0,0,3,0,1,1,2,4
401371750,George Mason Patriots,J. Hartwell II,4396817,,False,14.0,2,7,1,3,1,4,0,0,1,0,1,1,0,0,0,2,5
401371750,George Mason Patriots,TEAM,TOTAL,TOTAL,False,,30,60,22,36,8,24,8,8,6,23,29,16,3,2,8,21,76
401371729,Saint Joseph's Hawks,K. Klaczek,4897053,,True,23.0,0,2,0,2,0,0,0,0,1,0,1,2,1,0,4,4,0
401371729,Saint Joseph's Hawks,T. Funk,4278395,,True,31.0,6,9,2,2,4,7,2,2,2,4,6,4,0,0,2,1,18
401371729,Saint Joseph's Hawks,E. Obinna,4278125,,True,27.0,6,11,6,11,0,0,4,6,8,7,15,1,0,1,1,1,16
401371729,Saint Joseph's Hawks,J. Hall,4701031,,True,21.0,3,5,2,4,1,1,0,0,0,3,3,2,2,0,3,4,7
401371729,Saint Joseph's Hawks,E. Reynolds II,4683952,,True,26.0,6,11,5,9,1,2,0,0,0,3,3,2,0,1,2,3,13
401371729,Saint Joseph's Hawks,C. Coleman,4431807,,False,10.0,2,2,2,2,0,0,0,0,1,4,5,0,0,1,0,2,4
401371729,Saint Joseph's Hawks,A. Jansson,4701029,,False,3.0,0,0,0,0,0,0,0,0,0,0,0,0,0,0,1,2,0
401371729,Saint Joseph's Hawks,B. Geatens,4706892,,False,1.0,0,0,0,0,0,0,0,0,0,0,0,0,0,0,0,0,0
401371729,Saint Joseph's Hawks,C. Arizin,4706891,,False,2.0,0,1,0,1,0,0,0,0,0,0,0,0,0,0,0,0,0
401371729,Saint Joseph's Hawks,J. Forrest,4701032,,False,20.0,2,7,1,4,1,3,0,0,0,3,3,4,1,0,1,0,5
401371729,Saint Joseph's Hawks,D. Bishop,4701028,,False,16.0,0,1,0,1,0,0,0,0,0,2,2,0,1,0,2,2,0
401371729,Saint Joseph's Hawks,C. Brown,4592476,,False,20.0,5,9,2,4,3,5,4,4,0,1,1,0,2,1,1,0,17
401371729,Saint Joseph's Hawks,TEAM,TOTAL,TOTAL,False,,30,58,20,40,10,18,10,12,13,31,44,15,7,4,19,19,80
401371729,Mount St. Mary's Mountaineers,M. Jefferson,4397980,,True,15.0,5,11,5,11,0,0,2,2,4,2,6,1,0,1,1,2,12
401371729,Mount St. Mary's Mountaineers,M. Offurum,4396837,,True,16.0,2,8,2,7,0,1,2,2,2,5,7,1,2,0,1,0,6
401371729,Mount St. Mary's Mountaineers,N. Opoku,4279871,,True,15.0,1,4,1,4,0,0,0,0,1,2,3,0,1,0,0,1,2
401371729,Mount St. Mary's Mountaineers,J. Reaves,4703169,,True,34.0,3,8,1,4,2,4,2,2,0,0,0,0,0,0,0,1,10
401371729,Mount St. Mary's Mountaineers,J. Benjamin,4431903,,True,15.0,2,9,2,7,0,2,2,2,0,0,0,4,1,0,4,2,6
401371729,Mount St. Mary's Mountaineers,J. Cordilia,4897979,,False,20.0,1,1,1,1,0,0,0,0,0,0,0,0,0,0,0,1,2
401371729,Mount St. Mary's Mountaineers,F. Barton,4703170,,False,23.0,0,1,0,1,0,0,0,0,0,1,1,1,0,0,0,0,0
401371729,Mount St. Mary's Mountaineers,E. Elliott,4897978,,False,20.0,0,1,0,1,0,0,0,0,0,0,0,0,0,0,0,0,0
401371729,Mount St. Mary's Mountaineers,J. Gibson,4897975,,False,20.0,0,1,0,1,0,0,2,2,0,2,2,0,0,0,0,0,2
401371729,Mount St. Mary's Mountaineers,D. Thomas,4703168,,False,8.0,1,5,0,3,1,2,2,2,0,0,0,0,1,0,1,1,5
401371729,Mount St. Mary's Mountaineers,D. Leffew,4703167,,False,14.0,4,9,4,7,0,2,7,9,0,3,3,2,3,0,3,2,15
401371729,Mount St. Mary's Mountaineers,TEAM,TOTAL,TOTAL,False,,19,58,16,47,3,11,19,21,9,15,24,9,8,1,10,10,60
401371728,Saint Joseph's Hawks,K. Klaczek,4897053,,True,19.0,1,3,1,1,0,2,1,1,1,2,3,0,1,0,1,1,3
401371728,Saint Joseph's Hawks,T. Funk,4278395,,True,37.0,8,13,2,2,6,11,0,1,1,6,7,0,0,1,3,0,22
401371728,Saint Joseph's Hawks,E. Obinna,4278125,,True,23.0,5,9,5,9,0,0,3,6,3,3,6,1,0,0,3,1,13
401371728,Saint Joseph's Hawks,J. Hall,4701031,,True,37.0,5,15,4,9,1,6,0,1,0,9,9,11,2,0,3,2,11
401371728,Saint Joseph's Hawks,E. Reynolds II,4683952,,True,22.0,1,6,1,5,0,1,2,2,2,0,2,2,0,0,3,3,4
401371728,Saint Joseph's Hawks,C. Coleman,4431807,,False,10.0,1,5,1,5,0,0,0,0,1,2,3,1,0,0,0,1,2
401371728,Saint Joseph's Hawks,J. Forrest,4701032,,False,11.0,1,2,0,0,1,2,0,0,0,1,1,0,0,0,0,1,3
401371728,Saint Joseph's Hawks,D. Bishop,4701028,,False,19.0,1,5,0,1,1,4,1,2,1,1,2,1,0,1,1,1,4
401371728,Saint Joseph's Hawks,C. Brown,4592476,,False,22.0,3,8,2,3,1,5,0,3,2,2,4,2,1,0,2,1,7
401371728,Saint Joseph's Hawks,TEAM,TOTAL,TOTAL,False,,26,66,16,35,10,31,7,16,14,29,43,18,4,2,16,11,69
401371728,Maryland Eastern Shore Hawks,N. Pollard Jr.,4704102,,True,19.0,1,8,1,7,0,1,2,2,2,5,7,1,1,0,1,1,4
401371728,Maryland Eastern Shore Hawks,Z. Styles,4704099,,True,25.0,4,8,3,7,1,1,0,0,0,4,4,0,2,1,3,4,9
401371728,Maryland Eastern Shore Hawks,D. London,4700872,,True,24.0,4,7,2,2,2,5,1,2,1,4,5,3,3,0,1,2,11
401371728,Maryland Eastern Shore Hawks,D. Phillip,4593381,,True,31.0,4,11,3,9,1,2,0,1,2,2,4,5,1,0,2,2,9
401371728,Maryland Eastern Shore Hawks,K. Voyles,4593380,,True,20.0,4,12,4,10,0,2,0,0,1,1,2,1,1,0,0,1,8
401371728,Maryland Eastern Shore Hawks,M. Milivojevic,4898272,,False,3.0,0,0,0,0,0,0,0,0,0,1,1,0,0,0,0,0,0
401371728,Maryland Eastern Shore Hawks,K. Thompson,4898271,,False,24.0,3,5,0,1,3,4,0,0,2,4,6,1,0,0,0,1,9
401371728,Maryland Eastern Shore Hawks,M. Akinsanya,4704101,,False,8.0,1,1,1,1,0,0,0,1,1,2,3,0,1,1,0,2,2
401371728,Maryland Eastern Shore Hawks,L. Sanders,4898270,,False,6.0,0,1,0,1,0,0,0,0,0,0,0,0,0,0,1,0,0
401371728,Maryland Eastern Shore Hawks,C. Davis,4898269,,False,20.0,4,7,3,6,1,1,0,0,1,0,1,0,0,0,1,2,9
401371728,Maryland Eastern Shore Hawks,D. Nugent,4704097,,False,20.0,2,7,0,2,2,5,0,0,0,3,3,2,0,0,2,3,6
401371728,Maryland Eastern Shore Hawks,TEAM,TOTAL,TOTAL,False,,27,67,17,46,10,21,3,6,11,30,41,13,9,2,12,18,67
401371727,Richmond Spiders,T. Burton,4431914,,True,30.0,7,11,6,8,1,3,0,0,3,4,7,2,1,1,1,0,15
401371727,Richmond Spiders,N. Cayo,4278380,,True,15.0,4,7,4,7,0,0,1,2,0,1,1,0,2,0,3,0,9
401371727,Richmond Spiders,G. Golden,4066836,,True,28.0,10,12,8,9,2,3,0,0,2,8,10,3,3,1,3,1,22
401371727,Richmond Spiders,I. Wilson,4700973,,True,20.0,0,2,0,0,0,2,0,0,1,1,2,1,0,0,0,1,0
401371727,Richmond Spiders,J. Gilyard,4278378,,True,34.0,1,5,1,1,0,4,0,0,0,5,5,11,5,0,0,0,2
401371727,Richmond Spiders,M. Grace,4397192,,False,10.0,1,3,1,2,0,1,2,2,0,2,2,0,1,1,0,1,4
401371727,Richmond Spiders,S. Koureissi,4397190,,False,9.0,1,2,1,2,0,0,0,0,1,0,1,2,0,0,1,0,2
401371727,Richmond Spiders,S. Kulju,4278383,,False,1.0,0,0,0,0,0,0,0,0,0,0,0,0,0,0,0,0,0
401371727,Richmond Spiders,M. Randolph,4710356,,False,2.0,1,1,1,1,0,0,0,0,0,0,0,0,0,0,0,0,2
401371727,Richmond Spiders,Q. Southall,4700975,,False,1.0,0,0,0,0,0,0,0,0,0,0,0,0,0,0,0,0,0
401371727,Richmond Spiders,D. Bailey,4700974,,False,10.0,1,2,1,1,0,1,1,2,0,0,0,0,0,0,0,0,3
401371727,Richmond Spiders,G. Arizin,4592473,,False,1.0,0,0,0,0,0,0,0,0,0,1,1,0,0,0,0,0,0
401371727,Richmond Spiders,A. Gustavson,4397193,,False,8.0,1,1,1,1,0,0,0,0,0,2,2,1,0,0,0,1,2
401371727,Richmond Spiders,C. Crabtree,4396658,,False,11.0,2,4,1,1,1,3,0,0,0,4,4,2,1,0,0,1,5
401371727,Richmond Spiders,J. Gaitley,4278384,,False,1.0,0,0,0,0,0,0,0,0,0,0,0,0,0,0,0,0,0
401371727,Richmond Spiders,N. Sherod,4066832,,False,19.0,5,14,0,3,5,11,0,0,0,0,0,0,1,0,0,1,15
401371727,Richmond Spiders,TEAM,TOTAL,TOTAL,False,,34,64,25,36,9,28,4,6,8,29,37,22,14,3,8,6,81
401371727,Bucknell Bison,J. van der Heijden,4593081,,True,29.0,3,7,2,4,1,3,0,0,1,1,2,2,1,2,0,2,7
401371727,Bucknell Bison,A. Timmerman,4593082,,True,24.0,4,9,3,7,1,2,0,0,2,4,6,0,1,0,3,0,9
401371727,Bucknell Bison,E. Edmonds IV,4897911,,True,28.0,2,7,1,2,1,5,0,0,0,2,2,2,1,0,4,0,5
401371727,Bucknell Bison,X. Rice,4593080,,True,32.0,3,6,1,3,2,3,2,2,0,1,1,3,2,0,6,1,10
401371727,Bucknell Bison,A. Funk,4397650,,True,33.0,3,11,3,7,0,4,0,0,0,3,3,2,2,1,0,0,6
401371727,Bucknell Bison,B. Newton,4897912,,False,1.0,0,0,0,0,0,0,0,0,0,0,0,0,0,0,0,0,0
401371727,Bucknell Bison,I. Motta,4897910,,False,7.0,0,0,0,0,0,0,0,0,0,1,1,0,0,0,0,0,0
401371727,Bucknell Bison,M. Rhodes,4433064,,False,6.0,2,3,2,2,0,1,0,0,1,1,2,0,0,0,0,1,4
401371727,Bucknell Bison,A. Screen,4702499,,False,18.0,2,6,2,6,0,0,0,0,0,4,4,1,0,0,1,1,4
401371727,Bucknell Bison,J. Bascoe,4897913,,False,11.0,1,3,1,3,0,0,0,0,1,3,4,1,0,0,1,0,2
401371727,Bucknell Bison,J. Adoh,4702498,,False,11.0,1,3,0,2,1,1,0,0,0,0,0,1,0,0,1,2,3
401371727,Bucknell Bison,TEAM,TOTAL,TOTAL,False,,21,55,15,36,6,19,2,2,5,23,28,12,7,3,16,7,50
401371726,Richmond Spiders,T. Burton,4431914,,True,37.0,8,14,5,7,3,7,10,12,3,7,10,0,1,1,1,1,29
401371726,Richmond Spiders,N. Cayo,4278380,,True,26.0,2,2,2,2,0,0,7,10,1,5,6,1,0,0,1,0,11
401371726,Richmond Spiders,G. Golden,4066836,,True,28.0,5,8,4,7,1,1,4,5,0,4,4,2,0,2,5,3,15
401371726,Richmond Spiders,I. Wilson,4700973,,True,19.0,1,1,0,0,1,1,2,2,0,1,1,0,0,0,1,4,5
401371726,Richmond Spiders,J. Gilyard,4278378,,True,39.0,0,5,0,0,0,5,0,0,0,1,1,8,4,0,3,2,0
401371726,Richmond Spiders,M. Grace,4397192,,False,12.0,0,4,0,0,0,4,2,2,1,1,2,0,0,0,0,1,2
401371726,Richmond Spiders,D. Bailey,4700974,,False,15.0,0,1,0,1,0,0,2,2,0,3,3,1,0,1,0,0,2
401371726,Richmond Spiders,A. Gustavson,4397193,,False,2.0,0,1,0,0,0,1,0,0,0,0,0,0,0,0,0,1,0
401371726,Richmond Spiders,C. Crabtree,4396658,,False,6.0,0,0,0,0,0,0,0,0,0,0,0,0,0,0,0,1,0
401371726,Richmond Spiders,N. Sherod,4066832,,False,16.0,1,6,0,1,1,5,0,0,0,2,2,0,0,0,0,2,3
401371726,Richmond Spiders,TEAM,TOTAL,TOTAL,False,,17,42,11,18,6,24,27,33,5,26,31,12,5,4,11,15,67
401371726,Old Dominion Monarchs,K. Ezikpe,4397564,,True,23.0,3,7,3,7,0,0,2,2,3,4,7,0,1,0,0,5,8
401371726,Old Dominion Monarchs,M. Long,4431804,,True,29.0,3,6,3,5,0,1,0,2,2,2,4,1,1,0,1,5,6
401371726,Old Dominion Monarchs,A.J. Oliver II,4592878,,True,22.0,0,3,0,1,0,2,0,0,0,2,2,0,0,0,0,3,0
401371726,Old Dominion Monarchs,J. Hunter,4592875,,True,38.0,1,10,1,5,0,5,4,4,2,3,5,4,3,0,1,1,6
401371726,Old Dominion Monarchs,C.J. Keyser,4066455,,True,35.0,6,21,5,17,1,4,0,0,1,4,5,0,0,0,4,5,13
401371726,Old Dominion Monarchs,A. Trice,4397007,,False,27.0,7,11,7,11,0,0,6,9,9,7,16,1,2,1,2,3,20
401371726,Old Dominion Monarchs,D. Stines,4897542,,False,22.0,3,8,1,1,2,7,0,0,0,1,1,2,0,0,0,1,8
401371726,Old Dominion Monarchs,I. Essien,4897541,,False,2.0,0,1,0,1,0,0,0,0,0,0,0,0,0,0,0,0,0
401371726,Old Dominion Monarchs,C. Smith IV,4431798,,False,2.0,0,1,0,0,0,1,0,0,0,0,0,0,0,0,0,0,0
401371726,Old Dominion Monarchs,TEAM,TOTAL,TOTAL,False,,23,68,20,48,3,20,12,17,20,24,44,8,7,1,10,23,61
401371725,Richmond Spiders,T. Burton,4431914,,True,37.0,10,16,5,7,5,9,1,2,0,6,6,2,3,1,1,3,26
401371725,Richmond Spiders,N. Cayo,4278380,,True,26.0,3,8,3,8,0,0,1,2,3,3,6,3,1,0,1,3,7
401371725,Richmond Spiders,G. Golden,4066836,,True,30.0,3,11,2,8,1,3,1,1,0,7,7,4,0,0,2,2,8
401371725,Richmond Spiders,I. Wilson,4700973,,True,31.0,3,5,2,4,1,1,0,0,0,1,1,0,0,0,1,1,7
401371725,Richmond Spiders,J. Gilyard,4278378,,True,35.0,3,9,1,3,2,6,0,0,0,3,3,4,1,0,0,0,8
401371725,Richmond Spiders,M. Grace,4397192,,False,9.0,1,2,1,1,0,1,0,0,0,1,1,0,1,0,2,0,2
401371725,Richmond Spiders,S. Koureissi,4397190,,False,4.0,0,1,0,0,0,1,0,0,0,0,0,0,1,0,1,0,0
401371725,Richmond Spiders,D. Bailey,4700974,,False,8.0,0,1,0,0,0,1,0,0,0,1,1,0,0,0,0,0,0
401371725,Richmond Spiders,C. Crabtree,4396658,,False,3.0,0,0,0,0,0,0,0,0,0,0,0,0,0,0,0,0,0
401371725,Richmond Spiders,N. Sherod,4066832,,False,17.0,1,7,1,2,0,5,0,0,1,7,8,0,0,0,0,0,2
401371725,Richmond Spiders,TEAM,TOTAL,TOTAL,False,,24,60,15,33,9,27,3,5,5,30,35,13,7,1,9,9,60
401371725,Northern Iowa Panthers,C. Henry,4433004,,True,22.0,2,3,2,3,0,0,1,2,1,4,5,3,1,0,2,0,5
401371725,Northern Iowa Panthers,N. Heise,4703912,,True,28.0,4,7,4,5,0,2,0,0,0,4,4,0,2,0,1,2,8
401371725,Northern Iowa Panthers,AJ Green,4397475,,True,37.0,2,12,0,3,2,9,0,0,0,9,9,1,0,0,2,1,6
401371725,Northern Iowa Panthers,T. Berhow,4280203,,True,35.0,3,9,2,3,1,6,0,0,0,4,4,1,0,0,3,3,7
401371725,Northern Iowa Panthers,T. Pickford,4279167,,True,12.0,0,0,0,0,0,0,0,0,1,1,2,1,0,0,1,0,0
401371725,Northern Iowa Panthers,N. Carter,4431923,,False,24.0,5,11,5,7,0,4,3,4,0,4,4,1,0,1,1,1,13
401371725,Northern Iowa Panthers,J. Betz,4431904,,False,2.0,0,1,0,0,0,1,0,0,0,0,0,0,0,0,0,1,0
401371725,Northern Iowa Panthers,T. Anderson,4703914,,False,12.0,4,4,4,4,0,0,1,3,0,0,0,0,1,0,0,1,9
401371725,Northern Iowa Panthers,B. Born,4703913,,False,15.0,1,2,1,2,0,0,0,0,0,1,1,1,0,0,1,0,2
401371725,Northern Iowa Panthers,A. Kimmons,4433020,,False,13.0,1,4,1,4,0,0,0,0,0,1,1,0,0,0,0,1,2
401371725,Northern Iowa Panthers,TEAM,TOTAL,TOTAL,False,,22,53,19,31,3,22,5,9,3,31,34,8,4,1,12,10,52
401371724,Wofford Terriers,B.J. Mack,4431837,,True,30.0,6,12,6,11,0,1,3,4,1,5,6,1,1,0,5,4,15
401371724,Wofford Terriers,S. Godwin,4703886,,True,23.0,7,9,7,9,0,0,0,0,2,3,5,0,0,0,0,0,14
401371724,Wofford Terriers,I. Bigelow,4398275,,True,31.0,4,10,3,6,1,4,1,1,1,2,3,2,0,0,0,2,10
401371724,Wofford Terriers,M. Klesmit,4703885,,True,34.0,2,13,2,7,0,6,2,3,0,0,0,1,4,0,2,3,6
401371724,Wofford Terriers,R. Larson,4398276,,True,35.0,4,5,0,0,4,5,0,1,1,2,3,3,2,1,1,3,12
401371724,Wofford Terriers,L. Turner,4684160,,False,2.0,0,0,0,0,0,0,0,0,0,1,1,1,0,0,0,0,0
401371724,Wofford Terriers,A. Patterson,4710625,,False,15.0,2,2,1,1,1,1,0,0,0,2,2,2,0,0,2,0,5
401371724,Wofford Terriers,K. Turner,4703884,,False,2.0,0,0,0,0,0,0,0,0,0,0,0,0,0,0,0,0,0
401371724,Wofford Terriers,M. Safford,4593739,,False,28.0,1,6,1,4,0,2,0,0,2,1,3,0,1,0,0,3,2
401371724,Wofford Terriers,TEAM,TOTAL,TOTAL,False,,26,57,20,38,6,19,6,9,7,16,23,10,8,1,10,15,64
401371724,Richmond Spiders,T. Burton,4431914,,True,22.0,3,5,3,3,0,2,2,3,0,2,2,0,0,0,2,3,8
401371724,Richmond Spiders,N. Cayo,4278380,,True,33.0,3,4,3,4,0,0,3,5,0,4,4,3,0,0,0,3,9
401371724,Richmond Spiders,G. Golden,4066836,,True,27.0,10,15,9,13,1,2,0,0,0,3,3,4,0,0,0,1,21
401371724,Richmond Spiders,I. Wilson,4700973,,True,25.0,1,1,0,0,1,1,2,3,0,3,3,1,0,0,2,2,5
401371724,Richmond Spiders,J. Gilyard,4278378,,True,38.0,4,8,1,2,3,6,2,2,1,6,7,4,1,0,7,1,13
401371724,Richmond Spiders,M. Grace,4397192,,False,13.0,1,2,0,0,1,2,0,0,0,1,1,1,0,0,0,1,3
401371724,Richmond Spiders,S. Koureissi,4397190,,False,6.0,2,2,2,2,0,0,0,0,0,0,0,0,0,0,0,1,4
401371724,Richmond Spiders,D. Bailey,4700974,,False,10.0,1,1,1,1,0,0,0,0,1,0,1,0,1,0,1,0,2
401371724,Richmond Spiders,C. Crabtree,4396658,,False,15.0,3,4,1,1,2,3,0,0,0,3,3,0,0,0,0,0,8
401371724,Richmond Spiders,N. Sherod,4066832,,False,11.0,0,3,0,1,0,2,0,0,0,2,2,1,2,0,0,0,0
401371724,Richmond Spiders,TEAM,TOTAL,TOTAL,False,,28,45,20,27,8,18,9,13,2,24,26,14,4,0,12,12,73
401371723,Richmond Spiders,T. Burton,4431914,,True,32.0,9,16,5,7,4,9,0,0,1,6,7,3,0,0,2,2,22
401371723,Richmond Spiders,N. Cayo,4278380,,True,30.0,9,11,9,11,0,0,0,2,0,5,5,5,0,2,3,1,18
401371723,Richmond Spiders,G. Golden,4066836,,True,32.0,6,7,5,6,1,1,0,0,1,6,7,5,0,1,1,1,13
401371723,Richmond Spiders,I. Wilson,4700973,,True,22.0,0,5,0,2,0,3,0,0,0,1,1,1,3,0,2,2,0
401371723,Richmond Spiders,J. Gilyard,4278378,,True,39.0,5,10,0,0,5,10,2,3,1,3,4,6,0,0,2,0,17
401371723,Richmond Spiders,M. Grace,4397192,,False,9.0,0,1,0,1,0,0,0,0,1,1,2,1,0,0,0,2,0
401371723,Richmond Spiders,S. Koureissi,4397190,,False,1.0,0,0,0,0,0,0,0,0,0,0,0,0,0,0,0,0,0
401371723,Richmond Spiders,M. Randolph,4710356,,False,1.0,1,1,0,0,1,1,0,0,0,0,0,0,0,0,0,0,3
401371723,Richmond Spiders,D. Bailey,4700974,,False,6.0,0,0,0,0,0,0,0,0,1,1,2,2,0,0,0,0,0
401371723,Richmond Spiders,C. Crabtree,4396658,,False,14.0,1,2,0,0,1,2,0,0,0,3,3,3,0,0,0,1,3
401371723,Richmond Spiders,N. Sherod,4066832,,False,14.0,2,4,1,1,1,3,0,0,0,1,1,0,0,0,1,0,5
401371723,Richmond Spiders,TEAM,TOTAL,TOTAL,False,,33,57,20,28,13,29,2,5,6,29,35,26,3,3,12,9,81
401371723,Hofstra Pride,K. Cramer,4592957,,True,32.0,7,11,7,11,0,0,1,3,2,6,8,2,1,1,1,1,15
401371723,Hofstra Pride,D. Dubar,4598640,,True,37.0,8,13,6,8,2,5,0,0,2,4,6,0,1,3,0,0,18
401371723,Hofstra Pride,A. Estrada,4593385,,True,29.0,2,9,2,8,0,1,0,0,0,2,2,4,2,0,3,1,4
401371723,Hofstra Pride,J. Ray,4279206,,True,31.0,1,6,0,1,1,5,0,0,1,2,3,2,0,0,0,2,3
401371723,Hofstra Pride,Z. Cooks,4278449,,True,37.0,7,15,4,9,3,6,1,1,0,1,1,2,0,0,0,0,18
401371723,Hofstra Pride,J. Carlos,4683855,,False,3.0,0,1,0,0,0,1,0,0,0,0,0,0,0,0,0,0,0
401371723,Hofstra Pride,C. Burgess,4592954,,False,19.0,0,0,0,0,0,0,1,2,0,0,0,3,0,0,2,0,1
401371723,Hofstra Pride,O. Silverio,4397181,,False,12.0,3,6,1,2,2,4,1,2,1,2,3,0,1,0,0,0,9
401371723,Hofstra Pride,TEAM,TOTAL,TOTAL,False,,28,61,20,39,8,22,4,8,6,18,24,13,5,4,6,4,68
401371722,Richmond Spiders,T. Burton,4431914,,True,31.0,11,17,7,11,4,6,4,5,3,6,9,1,1,1,3,1,30
401371722,Richmond Spiders,N. Cayo,4278380,,True,23.0,0,5,0,5,0,0,4,6,3,1,4,0,0,1,1,3,4
401371722,Richmond Spiders,G. Golden,4066836,,True,27.0,8,14,8,12,0,2,1,2,2,4,6,5,0,0,1,2,17
401371722,Richmond Spiders,I. Wilson,4700973,,True,30.0,1,6,1,4,0,2,0,2,1,5,6,1,1,0,1,3,2
401371722,Richmond Spiders,J. Gilyard,4278378,,True,37.0,2,9,1,4,1,5,1,2,1,3,4,5,4,0,1,2,6
401371722,Richmond Spiders,M. Grace,4397192,,False,14.0,1,1,1,1,0,0,0,0,0,0,0,2,2,0,1,2,2
401371722,Richmond Spiders,S. Koureissi,4397190,,False,2.0,0,1,0,1,0,0,0,0,0,0,0,0,0,0,0,1,0
401371722,Richmond Spiders,C. Crabtree,4396658,,False,13.0,0,1,0,0,0,1,0,0,0,1,1,0,0,0,0,2,0
401371722,Richmond Spiders,N. Sherod,4066832,,False,23.0,3,7,1,3,2,4,1,2,0,1,1,0,1,0,2,3,9
401371722,Richmond Spiders,TEAM,TOTAL,TOTAL,False,,26,61,19,41,7,20,11,19,11,23,34,14,9,2,10,19,70
401371722,Drake Bulldogs,S. Hemphill,4397747,,True,18.0,1,4,1,4,0,0,0,0,1,0,1,0,1,0,1,1,2
401371722,Drake Bulldogs,T. Murphy,4397346,,True,32.0,5,10,1,2,4,8,4,4,2,5,7,0,0,1,1,2,18
401371722,Drake Bulldogs,D. Brodie,4397121,,True,23.0,3,6,3,6,0,0,0,0,1,5,6,0,0,0,1,1,6
401371722,Drake Bulldogs,D.J. Wilkins,4397350,,True,31.0,3,7,1,3,2,4,2,4,2,1,3,3,1,0,1,2,10
401371722,Drake Bulldogs,R. Penn,4279754,,True,23.0,4,8,3,4,1,4,3,3,0,3,3,4,0,0,6,4,12
401371722,Drake Bulldogs,N. Ferguson,4432981,,False,7.0,0,0,0,0,0,0,0,0,1,2,3,0,0,1,1,3,0
401371722,Drake Bulldogs,T. Devries,4837238,,False,24.0,4,12,2,5,2,7,1,3,3,3,6,2,1,1,1,3,11
401371722,Drake Bulldogs,G. Sturtz,4397348,,False,25.0,4,7,4,6,0,1,0,0,3,6,9,0,1,0,1,1,8
401371722,Drake Bulldogs,A. Akinwole,4279508,,False,17.0,2,7,1,3,1,4,1,1,0,2,2,3,0,0,1,0,6
401371722,Drake Bulldogs,TEAM,TOTAL,TOTAL,False,,26,61,16,33,10,28,11,15,13,27,40,12,4,3,15,17,73
401371721,Richmond Spiders,T. Burton,4431914,,True,31.0,6,10,2,5,4,5,4,5,0,8,8,1,3,0,2,1,20
401371721,Richmond Spiders,N. Cayo,4278380,,True,20.0,1,2,1,2,0,0,0,0,1,7,8,6,0,0,4,3,2
401371721,Richmond Spiders,G. Golden,4066836,,True,20.0,6,8,4,5,2,3,1,3,0,5,5,4,0,0,2,1,15
401371721,Richmond Spiders,I. Wilson,4700973,,True,24.0,4,5,3,3,1,2,1,2,0,0,0,1,3,0,2,4,10
401371721,Richmond Spiders,J. Gilyard,4278378,,True,29.0,0,4,0,0,0,4,2,2,0,0,0,6,3,0,1,1,2
401371721,Richmond Spiders,M. Grace,4397192,,False,13.0,5,6,1,1,4,5,0,0,0,2,2,2,0,1,0,0,14
401371721,Richmond Spiders,S. Koureissi,4397190,,False,11.0,1,3,1,2,0,1,2,3,1,3,4,1,0,0,1,4,4
401371721,Richmond Spiders,S. Kulju,4278383,,False,2.0,0,0,0,0,0,0,0,1,1,0,1,1,0,0,0,1,0
401371721,Richmond Spiders,M. Randolph,4710356,,False,6.0,0,0,0,0,0,0,0,0,0,0,0,0,0,0,0,1,0
401371721,Richmond Spiders,D. Bailey,4700974,,False,15.0,3,3,3,3,0,0,0,1,0,0,0,0,0,0,0,1,6
401371721,Richmond Spiders,C. Crabtree,4396658,,False,11.0,2,3,1,1,1,2,0,0,0,2,2,1,0,1,0,1,5
401371721,Richmond Spiders,J. Gaitley,4278384,,False,2.0,0,0,0,0,0,0,0,1,0,1,1,0,0,0,0,1,0
401371721,Richmond Spiders,N. Sherod,4066832,,False,16.0,5,10,1,3,4,7,2,3,0,3,3,1,1,0,0,1,16
401371721,Richmond Spiders,TEAM,TOTAL,TOTAL,False,,33,54,17,25,16,29,12,21,4,31,35,24,10,2,13,20,94
401371721,Georgia State Panthers,J. Thomas,4593903,,True,17.0,0,2,0,2,0,0,0,0,3,3,6,0,1,0,3,4,0
401371721,Georgia State Panthers,J. Hudson,4897218,,True,19.0,1,3,1,3,0,0,1,2,1,4,5,0,0,1,1,2,3
401371721,Georgia State Panthers,J. Roberts,4397535,,True,28.0,6,11,5,7,1,4,3,4,0,2,2,2,1,0,1,0,16
401371721,Georgia State Panthers,K. Williams,4280167,,True,25.0,7,13,4,10,3,3,0,3,0,3,3,1,2,0,3,1,17
401371721,Georgia State Panthers,C. Allen,4067418,,True,20.0,3,11,2,7,1,4,0,0,1,2,3,0,1,0,3,2,7
401371721,Georgia State Panthers,J. Clyce,4897219,,False,12.0,1,2,0,1,1,1,1,3,1,2,3,0,1,0,0,2,4
401371721,Georgia State Panthers,C. Ma,4897217,,False,4.0,2,2,1,1,1,1,0,1,0,1,1,0,0,0,0,0,5
401371721,Georgia State Panthers,K. Scott,4702111,,False,12.0,2,4,2,4,0,0,3,5,4,1,5,0,0,0,0,4,7
401371721,Georgia State Panthers,E. Johnson,4702109,,False,25.0,5,11,2,4,3,7,0,0,0,2,2,5,2,0,0,3,13
401371721,Georgia State Panthers,K. Brooks,4593901,,False,6.0,0,0,0,0,0,0,0,0,0,0,0,0,0,0,0,0,0
401371721,Georgia State Panthers,J. Rawls,4593292,,False,17.0,0,3,0,1,0,2,2,2,0,1,1,3,1,0,1,1,2
401371721,Georgia State Panthers,N. Phillips,4397533,,False,15.0,2,3,2,2,0,1,0,0,1,2,3,0,0,1,1,0,4
401371721,Georgia State Panthers,TEAM,TOTAL,TOTAL,False,,29,65,19,42,10,23,10,20,12,24,36,11,9,2,13,19,78
401371720,Utah State Aggies,B. Horvath,4279162,,True,34.0,6,11,2,5,4,6,2,2,0,4,4,4,0,0,1,3,18
401371720,Utah State Aggies,J. Bean,4278720,,True,39.0,11,16,8,12,3,4,5,7,4,9,13,3,2,1,3,1,30
401371720,Utah State Aggies,R. Jones,4431751,,True,34.0,4,9,4,7,0,2,2,2,0,4,4,6,0,0,1,2,10
401371720,Utah State Aggies,RJ Eytle-Rock,4396591,,True,19.0,1,2,0,1,1,1,3,4,0,4,4,2,1,0,3,1,6
401371720,Utah State Aggies,B. Miller,4278721,,True,31.0,2,7,2,5,0,2,0,0,0,3,3,1,0,0,2,1,4
401371720,Utah State Aggies,T. Dorius,4066764,,False,12.0,5,6,5,6,0,0,1,2,3,3,6,0,0,0,0,1,11
401371720,Utah State Aggies,Z. Hamoda,4897548,,False,7.0,1,2,1,1,0,1,0,0,0,2,2,1,0,0,0,0,2
401371720,Utah State Aggies,S. Ashworth,4701991,,False,24.0,1,3,1,1,0,2,2,2,0,3,3,4,0,0,1,1,4
401371720,Utah State Aggies,TEAM,TOTAL,TOTAL,False,,31,56,23,38,8,18,15,19,8,33,41,21,3,1,11,10,85
401371720,Richmond Spiders,T. Burton,4431914,,True,32.0,4,11,0,5,4,6,1,2,3,4,7,0,0,1,0,0,13
401371720,Richmond Spiders,N. Cayo,4278380,,True,19.0,1,4,1,4,0,0,1,4,0,1,1,2,0,1,0,3,3
401371720,Richmond Spiders,G. Golden,4066836,,True,30.0,10,17,7,10,3,7,1,2,3,5,8,3,0,1,1,3,24
401371720,Richmond Spiders,J. Gilyard,4278378,,True,40.0,5,14,1,6,4,8,2,2,1,2,3,7,3,0,3,0,16
401371720,Richmond Spiders,N. Sherod,4066832,,True,21.0,1,8,0,3,1,5,0,0,0,2,2,3,0,0,0,1,3
401371720,Richmond Spiders,M. Grace,4397192,,False,14.0,2,3,0,0,2,3,1,2,1,2,3,1,0,0,0,1,7
401371720,Richmond Spiders,S. Koureissi,4397190,,False,6.0,0,2,0,1,0,1,0,0,0,0,0,0,0,0,0,1,0
401371720,Richmond Spiders,D. Bailey,4700974,,False,6.0,1,1,1,1,0,0,0,0,2,0,2,1,2,0,0,2,2
401371720,Richmond Spiders,I. Wilson,4700973,,False,18.0,0,1,0,1,0,0,0,0,0,0,0,1,2,0,3,5,0
401371720,Richmond Spiders,C. Crabtree,4396658,,False,14.0,3,6,3,3,0,3,0,0,1,3,4,1,1,0,0,0,6
401371720,Richmond Spiders,TEAM,TOTAL,TOTAL,False,,27,67,13,34,14,33,6,12,11,20,31,19,8,3,7,16,74
401371719,Richmond Spiders,T. Burton,4431914,,True,27.0,3,7,2,4,1,3,7,7,2,4,6,0,0,0,1,3,14
401371719,Richmond Spiders,N. Cayo,4278380,,True,28.0,4,8,4,8,0,0,0,1,1,3,4,2,1,1,0,0,8
401371719,Richmond Spiders,G. Golden,4066836,,True,28.0,8,10,7,9,1,1,2,5,1,4,5,1,0,1,3,0,19
401371719,Richmond Spiders,J. Gilyard,4278378,,True,40.0,5,13,3,4,2,9,2,2,0,6,6,6,7,0,0,2,14
401371719,Richmond Spiders,N. Sherod,4066832,,True,20.0,2,9,0,2,2,7,2,2,2,2,4,0,1,0,0,0,8
401371719,Richmond Spiders,M. Grace,4397192,,False,15.0,1,4,1,2,0,2,0,0,1,2,3,1,1,2,2,3,2
401371719,Richmond Spiders,S. Koureissi,4397190,,False,7.0,0,0,0,0,0,0,3,4,0,0,0,0,0,0,4,0,3
401371719,Richmond Spiders,D. Bailey,4700974,,False,3.0,0,2,0,0,0,2,0,0,0,0,0,0,1,0,0,0,0
401371719,Richmond Spiders,I. Wilson,4700973,,False,18.0,0,4,0,1,0,3,0,0,1,1,2,2,1,0,1,2,0
401371719,Richmond Spiders,C. Crabtree,4396658,,False,14.0,1,1,1,1,0,0,0,0,1,0,1,2,1,0,0,0,2
401371719,Richmond Spiders,TEAM,TOTAL,TOTAL,False,,24,58,18,31,6,27,16,21,9,22,31,14,13,4,11,10,70
401371719,North Carolina Central Eagles,C. Butler,4898289,,True,12.0,1,2,1,2,0,0,0,0,0,4,4,0,1,0,0,3,2
401371719,North Carolina Central Eagles,K. Monroe,4397106,,True,31.0,2,10,1,4,1,6,0,0,1,6,7,1,1,1,4,4,5
401371719,North Carolina Central Eagles,A. Caldwell,4715106,,True,30.0,6,8,2,4,4,4,1,1,0,6,6,5,0,0,0,2,17
401371719,North Carolina Central Eagles,R. Miller Jr.,4398239,,True,22.0,1,7,0,4,1,3,2,2,1,1,2,3,0,0,1,1,5
401371719,North Carolina Central Eagles,M. Maultsby,4396576,,True,20.0,5,7,4,4,1,3,0,0,2,2,4,2,0,0,3,1,11
401371719,North Carolina Central Eagles,E. Boone,4702114,,False,16.0,0,4,0,3,0,1,0,0,1,1,2,1,1,0,5,0,0
401371719,North Carolina Central Eagles,D. King,4598389,,False,27.0,1,7,1,5,0,2,2,2,2,4,6,0,1,2,3,3,4
401371719,North Carolina Central Eagles,J. Harris,4593705,,False,9.0,1,1,1,1,0,0,0,0,1,1,2,0,0,0,1,1,2
401371719,North Carolina Central Eagles,A. Price,4432083,,False,24.0,3,8,2,2,1,6,0,0,0,1,1,1,3,0,2,1,7
401371719,North Carolina Central Eagles,N. Fennell,4398240,,False,9.0,3,4,2,3,1,1,0,0,3,0,3,0,0,0,0,1,7
401371719,North Carolina Central Eagles,TEAM,TOTAL,TOTAL,False,,23,58,14,32,9,26,5,5,12,26,38,13,7,3,21,17,60
401371717,Rhode Island Rams,Makhel Mitchell,4431777,,True,30.0,2,5,2,3,0,2,5,7,1,7,8,4,1,2,2,5,9
401371717,Rhode Island Rams,Makhi Mitchell,4431708,,True,30.0,7,12,7,11,0,1,2,2,4,6,10,0,0,0,4,4,16
401371717,Rhode Island Rams,I. Leggett,4606837,,True,26.0,2,8,0,3,2,5,3,4,0,2,2,3,2,0,1,4,9
401371717,Rhode Island Rams,I. El-Amin,4279313,,True,15.0,0,2,0,1,0,1,2,2,1,2,3,2,0,0,0,1,2
401371717,Rhode Island Rams,J. Sheppard,4066445,,True,30.0,8,13,5,8,3,5,6,6,0,8,8,2,2,0,3,1,25
401371717,Rhode Island Rams,I. Ayo-Faleye,4701259,,False,2.0,0,0,0,0,0,0,0,0,0,0,0,0,0,0,0,0,0
401371717,Rhode Island Rams,A. Walker,4278567,,False,16.0,3,6,3,4,0,2,0,0,1,2,3,1,1,0,1,3,6
401371717,Rhode Island Rams,T. Berry,4701257,,False,1.0,0,1,0,0,0,1,0,0,0,0,0,0,0,0,0,0,0
401371717,Rhode Island Rams,M. Martin,4397470,,False,26.0,2,3,1,1,1,2,0,0,0,1,1,0,1,0,0,4,5
401371717,Rhode Island Rams,J. Carey,4395673,,False,14.0,3,3,2,2,1,1,1,2,0,1,1,0,0,0,1,0,8
401371717,Rhode Island Rams,S. Thomas,4897065,,False,10.0,1,2,1,1,0,1,0,0,0,2,2,0,1,0,2,0,2
401371717,Rhode Island Rams,TEAM,TOTAL,TOTAL,False,,28,55,21,34,7,21,19,23,9,31,40,12,8,2,14,22,82
401371717,Milwaukee Panthers,T. Simms,4702936,,True,17.0,2,5,2,2,0,3,2,2,0,1,1,0,1,0,0,4,6
401371717,Milwaukee Panthers,J. St. Pierre,4702939,,True,16.0,1,3,1,3,0,0,3,5,2,2,4,1,1,1,2,5,5
401371717,Milwaukee Panthers,D. Gholston,4702934,,True,35.0,5,11,3,8,2,3,4,7,2,5,7,1,1,0,2,2,16
401371717,Milwaukee Panthers,P. Baldwin Jr.,4433246,,True,25.0,1,8,0,2,1,6,3,4,0,4,4,2,2,0,1,3,6
401371717,Milwaukee Panthers,J. Lathon,4397863,,True,26.0,2,6,2,3,0,3,0,0,0,3,3,2,0,0,1,3,4
401371717,Milwaukee Panthers,K. Ross,4684300,,False,1.0,0,0,0,0,0,0,0,0,0,0,0,0,0,0,0,0,0
401371717,Milwaukee Panthers,M. Bol,4593840,,False,15.0,0,0,0,0,0,0,0,0,0,0,0,0,0,0,1,2,0
401371717,Milwaukee Panthers,J. Sinani,4838557,,False,2.0,0,0,0,0,0,0,0,0,0,0,0,0,0,0,0,0,0
401371717,Milwaukee Panthers,D. Hancock,4702933,,False,2.0,0,0,0,0,0,0,0,0,0,0,0,0,0,0,0,0,0
401371717,Milwaukee Panthers,D. Newby,4702932,,False,21.0,3,4,1,1,2,3,4,4,0,0,0,1,1,0,0,2,12
401371717,Milwaukee Panthers,J. Thomas,4593291,,False,25.0,4,9,4,7,0,2,1,1,0,5,5,1,0,0,3,0,9
401371717,Milwaukee Panthers,V. Baker Jr.,4277830,,False,15.0,0,3,0,1,0,2,0,0,0,1,1,0,0,0,2,2,0
401371717,Milwaukee Panthers,TEAM,TOTAL,TOTAL,False,,18,49,13,27,5,22,17,23,4,21,25,8,6,1,13,23,58
401371716,Sacred Heart Pioneers,B. Johnson,4703180,,True,24.0,1,4,1,3,0,1,1,2,1,3,4,0,0,0,2,1,3
401371716,Sacred Heart Pioneers,N. Galette,4703183,,True,32.0,1,5,1,3,0,2,1,2,3,5,8,2,0,0,3,3,3
401371716,Sacred Heart Pioneers,M. Sixsmith,4703178,,True,20.0,1,4,1,1,0,3,0,0,0,1,1,1,2,0,0,0,2
401371716,Sacred Heart Pioneers,Ty. Thomas,4593126,,True,37.0,10,18,3,4,7,14,3,4,0,1,1,1,0,2,6,4,30
401371716,Sacred Heart Pioneers,J. Reilly,4593093,,True,34.0,3,8,1,2,2,6,0,0,0,0,0,7,0,0,0,2,8
401371716,Sacred Heart Pioneers,C. Dutreil,4396765,,False,24.0,1,2,1,2,0,0,0,0,0,4,4,0,1,0,0,2,2
401371716,Sacred Heart Pioneers,A. Watson,4279645,,False,29.0,4,7,2,2,2,5,4,4,0,3,3,4,3,0,0,1,14
401371716,Sacred Heart Pioneers,TEAM,TOTAL,TOTAL,False,,21,48,10,17,11,31,9,12,6,18,24,15,6,2,13,13,62
401371716,Rhode Island Rams,Makhel Mitchell,4431777,,True,28.0,7,12,7,12,0,0,0,0,0,5,5,1,0,3,0,1,14
401371716,Rhode Island Rams,Makhi Mitchell,4431708,,True,22.0,5,6,5,6,0,0,1,3,1,3,4,1,1,1,3,1,11
401371716,Rhode Island Rams,I. Leggett,4606837,,True,34.0,5,11,3,8,2,3,0,0,3,2,5,4,3,0,0,3,12
401371716,Rhode Island Rams,I. El-Amin,4279313,,True,24.0,4,6,2,3,2,3,1,2,2,2,4,1,3,0,2,2,11
401371716,Rhode Island Rams,J. Sheppard,4066445,,True,12.0,1,3,0,1,1,2,0,0,0,1,1,0,1,0,0,1,3
401371716,Rhode Island Rams,I. Ayo-Faleye,4701259,,False,4.0,0,1,0,1,0,0,0,0,0,0,0,0,0,0,0,0,0
401371716,Rhode Island Rams,A. Walker,4278567,,False,20.0,5,7,5,7,0,0,0,0,3,5,8,0,1,2,0,1,10
401371716,Rhode Island Rams,T. Berry,4701257,,False,4.0,0,1,0,0,0,1,0,0,0,0,0,0,0,0,0,0,0
401371716,Rhode Island Rams,M. Martin,4397470,,False,26.0,3,8,3,7,0,1,1,2,1,3,4,3,1,1,0,0,7
401371716,Rhode Island Rams,S. Thomas,4897065,,False,26.0,2,6,2,4,0,2,0,0,2,2,4,5,0,0,4,2,4
401371716,Rhode Island Rams,TEAM,TOTAL,TOTAL,False,,32,61,27,49,5,12,3,7,13,23,36,15,10,7,9,11,72
401371715,Rhode Island Rams,Makhel Mitchell,4431777,,True,18.0,4,6,4,6,0,0,1,1,0,3,3,1,1,2,0,4,9
401371715,Rhode Island Rams,Makhi Mitchell,4431708,,True,18.0,1,3,0,2,1,1,1,2,0,3,3,0,0,1,5,4,4
401371715,Rhode Island Rams,I. Leggett,4606837,,True,32.0,3,9,3,6,0,3,0,2,0,2,2,2,2,0,1,4,6
401371715,Rhode Island Rams,I. El-Amin,4279313,,True,22.0,3,8,2,5,1,3,0,0,0,1,1,0,0,1,2,1,7
401371715,Rhode Island Rams,J. Sheppard,4066445,,True,31.0,3,13,3,8,0,5,4,4,2,2,4,1,2,1,1,1,10
401371715,Rhode Island Rams,I. Ayo-Faleye,4701259,,False,8.0,1,3,1,2,0,1,0,0,1,0,1,0,0,2,0,0,2
401371715,Rhode Island Rams,A. Walker,4278567,,False,30.0,3,6,3,6,0,0,2,2,2,2,4,1,1,0,1,4,8
401371715,Rhode Island Rams,M. Martin,4397470,,False,28.0,1,1,1,1,0,0,0,0,1,7,8,0,0,0,4,1,2
401371715,Rhode Island Rams,S. Thomas,4897065,,False,13.0,2,2,2,2,0,0,0,2,0,1,1,3,0,0,0,0,4
401371715,Rhode Island Rams,TEAM,TOTAL,TOTAL,False,,21,51,19,38,2,13,8,13,8,22,30,8,6,7,14,19,52
401371715,Providence Friars,N. Horchler,4278453,,True,32.0,5,11,1,3,4,8,2,2,1,6,7,2,0,0,0,2,16
401371715,Providence Friars,N. Watson,4278573,,True,20.0,3,7,3,7,0,0,1,4,1,1,2,0,1,1,1,4,7
401371715,Providence Friars,A. Breed,4585590,,True,25.0,0,8,0,6,0,2,2,2,3,2,5,2,2,0,3,4,2
401371715,Providence Friars,A.J. Reeves,4397109,,True,30.0,3,14,1,6,2,8,0,0,1,1,2,3,1,0,1,2,8
401371715,Providence Friars,Al Durham,4277942,,True,38.0,4,11,3,9,1,2,5,5,0,3,3,6,1,0,5,1,14
401371715,Providence Friars,Ed Croswell,4397153,,False,22.0,5,6,5,6,0,0,3,3,8,7,15,0,2,1,1,2,13
401371715,Providence Friars,J. Minaya,4278111,,False,29.0,3,5,3,4,0,1,0,0,4,2,6,1,0,0,0,1,6
401371715,Providence Friars,B. Goodine,4431716,,False,4.0,0,1,0,0,0,1,0,0,0,1,1,0,0,0,1,1,0
401371715,Providence Friars,TEAM,TOTAL,TOTAL,False,,23,63,16,41,7,22,13,16,20,25,45,14,7,2,13,17,66
401371714,Rhode Island Rams,Makhel Mitchell,4431777,,True,18.0,1,7,1,7,0,0,2,2,2,2,4,5,1,3,2,3,4
401371714,Rhode Island Rams,Makhi Mitchell,4431708,,True,24.0,3,5,3,4,0,1,4,7,4,8,12,1,0,0,3,3,10
401371714,Rhode Island Rams,I. Leggett,4606837,,True,22.0,7,10,2,3,5,7,1,1,1,2,3,2,2,0,2,2,20
401371714,Rhode Island Rams,I. El-Amin,4279313,,True,27.0,2,4,0,0,2,4,0,0,0,2,2,5,0,0,1,2,6
401371714,Rhode Island Rams,J. Sheppard,4066445,,True,29.0,7,11,2,3,5,8,2,2,0,3,3,6,0,0,0,2,21
401371714,Rhode Island Rams,I. Ayo-Faleye,4701259,,False,9.0,0,1,0,1,0,0,0,0,1,1,2,0,0,0,0,0,0
401371714,Rhode Island Rams,A. Walker,4278567,,False,23.0,5,7,4,6,1,1,2,4,0,5,5,2,2,0,2,3,13
401371714,Rhode Island Rams,P. Pierre,4900664,,False,3.0,0,0,0,0,0,0,0,0,0,0,0,0,0,0,1,1,0
401371714,Rhode Island Rams,T. Berry,4701257,,False,5.0,1,1,0,0,1,1,2,4,1,1,2,0,0,0,0,1,5
401371714,Rhode Island Rams,M. Martin,4397470,,False,23.0,6,11,6,8,0,3,0,0,2,4,6,1,1,1,0,0,12
401371714,Rhode Island Rams,S. Thomas,4897065,,False,17.0,1,5,0,2,1,3,0,2,0,2,2,3,1,0,1,3,3
401371714,Rhode Island Rams,TEAM,TOTAL,TOTAL,False,,33,62,18,34,15,28,13,22,12,32,44,25,7,4,12,20,94
401371714,Georgia State Panthers,K. Scott,4702111,,True,17.0,1,2,1,2,0,0,0,0,0,0,0,1,1,1,0,5,2
401371714,Georgia State Panthers,E. Johnson,4702109,,True,38.0,2,8,0,2,2,6,2,3,0,1,1,0,1,0,5,0,8
401371714,Georgia State Panthers,K. Brooks,4593901,,True,28.0,1,3,0,2,1,1,0,0,1,7,8,0,0,0,2,3,3
401371714,Georgia State Panthers,J. Rawls,4593292,,True,37.0,3,11,2,6,1,5,7,10,1,1,2,3,0,0,2,1,14
401371714,Georgia State Panthers,K. Williams,4280167,,True,36.0,2,10,2,8,0,2,15,16,0,5,5,7,1,1,4,3,19
401371714,Georgia State Panthers,J. Clyce,4897219,,False,11.0,1,3,1,2,0,1,0,0,0,2,2,0,0,0,0,5,2
401371714,Georgia State Panthers,C. Ma,4897217,,False,28.0,4,7,1,1,3,6,0,0,0,3,3,0,0,0,1,2,11
401371714,Georgia State Panthers,D. Stubbs,4683628,,False,5.0,0,1,0,0,0,1,0,0,0,0,0,0,0,0,0,1,0
401371714,Georgia State Panthers,TEAM,TOTAL,TOTAL,False,,14,45,7,23,7,22,24,29,2,21,23,11,3,2,14,20,59
401371713,Tulsa Golden Hurricane,T. Dalger,4897153,,True,28.0,2,6,2,4,0,2,8,8,3,5,8,0,0,1,1,3,12
401371713,Tulsa Golden Hurricane,R. Idowu,4397373,,True,16.0,2,4,2,4,0,0,0,0,0,2,2,2,3,0,0,4,4
401371713,Tulsa Golden Hurricane,J. Horne,4066390,,True,34.0,7,13,6,9,1,4,2,3,2,4,6,2,1,0,3,1,17
401371713,Tulsa Golden Hurricane,S. Griffin,4432994,,True,29.0,9,16,6,9,3,7,0,0,1,2,3,3,0,0,2,1,21
401371713,Tulsa Golden Hurricane,K. Embery-Simpson,4395703,,True,26.0,1,4,0,1,1,3,0,0,1,0,1,2,1,0,1,1,3
401371713,Tulsa Golden Hurricane,N. Konstantynovskyi,4897154,,False,2.0,0,1,0,1,0,0,0,0,0,0,0,0,0,0,0,0,0
401371713,Tulsa Golden Hurricane,J. Earley,4432974,,False,2.0,0,0,0,0,0,0,0,0,0,0,0,0,0,0,0,0,0
401371713,Tulsa Golden Hurricane,A. Pritchard,4897155,,False,16.0,3,9,3,8,0,1,2,2,0,2,2,0,0,0,1,2,8
401371713,Tulsa Golden Hurricane,C. Haywood II,4593833,,False,23.0,2,2,1,1,1,1,0,0,0,3,3,2,2,0,0,3,5
401371713,Tulsa Golden Hurricane,L. Draine,4279101,,False,2.0,0,0,0,0,0,0,0,0,0,0,0,0,0,0,0,0,0
401371713,Tulsa Golden Hurricane,D. Jackson,4278408,,False,21.0,3,4,2,3,1,1,0,0,1,0,1,2,0,1,1,3,7
401371713,Tulsa Golden Hurricane,TEAM,TOTAL,TOTAL,False,,29,59,22,40,7,19,12,13,10,18,28,13,7,2,9,18,77
401371713,Rhode Island Rams,Makhel Mitchell,4431777,,True,33.0,7,9,7,9,0,0,6,11,2,4,6,1,0,3,5,3,20
401371713,Rhode Island Rams,Makhi Mitchell,4431708,,True,21.0,2,3,2,3,0,0,4,4,0,2,2,1,0,3,3,4,8
401371713,Rhode Island Rams,I. Leggett,4606837,,True,26.0,1,6,1,5,0,1,2,2,0,1,1,1,1,1,1,2,4
401371713,Rhode Island Rams,I. El-Amin,4279313,,True,24.0,2,7,2,3,0,4,2,3,1,0,1,3,0,0,0,3,6
401371713,Rhode Island Rams,J. Sheppard,4066445,,True,35.0,6,11,2,5,4,6,2,2,0,2,2,1,3,2,2,1,18
401371713,Rhode Island Rams,A. Walker,4278567,,False,21.0,3,3,2,2,1,1,1,1,1,3,4,1,1,0,3,2,8
401371713,Rhode Island Rams,M. Martin,4397470,,False,24.0,2,4,1,2,1,2,0,0,2,4,6,3,0,0,1,1,5
401371713,Rhode Island Rams,J. Carey,4395673,,False,10.0,1,2,1,2,0,0,0,0,0,0,0,0,0,0,0,0,2
401371713,Rhode Island Rams,S. Thomas,4897065,,False,5.0,0,1,0,0,0,1,0,0,0,1,1,0,0,0,0,0,0
401371713,Rhode Island Rams,TEAM,TOTAL,TOTAL,False,,24,46,18,31,6,15,17,23,7,20,27,11,5,9,15,16,71
401371712,Rhode Island Rams,Makhel Mitchell,4431777,,True,32.0,6,9,6,9,0,0,5,8,3,4,7,1,0,5,4,4,17
401371712,Rhode Island Rams,Makhi Mitchell,4431708,,True,18.0,5,11,5,11,0,0,3,4,4,14,18,3,0,0,5,4,13
401371712,Rhode Island Rams,I. Leggett,4606837,,True,38.0,4,12,2,9,2,3,3,4,1,5,6,4,1,1,2,2,13
401371712,Rhode Island Rams,I. El-Amin,4279313,,True,19.0,2,3,2,3,0,0,1,1,0,2,2,1,1,0,1,5,5
401371712,Rhode Island Rams,J. Sheppard,4066445,,True,28.0,2,7,0,2,2,5,4,4,1,4,5,4,2,1,2,2,10
401371712,Rhode Island Rams,A. Walker,4278567,,False,22.0,4,4,4,4,0,0,1,2,3,5,8,1,1,2,2,4,9
401371712,Rhode Island Rams,M. Martin,4397470,,False,25.0,3,5,3,5,0,0,3,6,2,3,5,1,1,2,1,2,9
401371712,Rhode Island Rams,S. Thomas,4897065,,False,18.0,3,7,2,2,1,5,0,0,0,0,0,0,0,1,0,2,7
401371712,Rhode Island Rams,TEAM,TOTAL,TOTAL,False,,29,58,24,45,5,13,20,29,16,39,55,15,6,12,19,25,83
401371712,Bryant Bulldogs,H. Elisias,4593267,,True,25.0,2,7,1,5,1,2,2,2,4,2,6,2,1,2,1,6,7
401371712,Bryant Bulldogs,E. Bans,4703138,,True,13.0,1,5,1,2,0,3,0,0,0,0,0,0,1,0,1,3,2
401371712,Bryant Bulldogs,T. Brelsford,4606833,,True,37.0,1,12,0,9,1,3,1,2,1,2,3,5,1,0,4,1,4
401371712,Bryant Bulldogs,A. Eleeda,4593304,,True,24.0,3,10,0,0,3,10,2,2,1,2,3,1,0,0,2,5,11
401371712,Bryant Bulldogs,C. Pride,4593263,,True,38.0,7,20,2,9,5,11,6,7,2,3,5,1,1,1,1,3,25
401371712,Bryant Bulldogs,J. Ozabor,4898366,,False,1.0,0,0,0,0,0,0,0,0,0,0,0,0,0,0,0,0,0
401371712,Bryant Bulldogs,G. Coleman,4702938,,False,8.0,1,3,1,1,0,2,3,3,0,1,1,1,0,0,0,1,5
401371712,Bryant Bulldogs,C. Childs,4703139,,False,30.0,3,9,1,3,2,6,2,2,1,2,3,0,0,0,0,3,10
401371712,Bryant Bulldogs,L. Hurtado,4279105,,False,24.0,0,3,0,1,0,2,0,0,2,4,6,3,2,0,2,1,0
401371712,Bryant Bulldogs,TEAM,TOTAL,TOTAL,False,,18,69,6,30,12,39,16,18,14,17,31,13,6,3,11,23,64
401371711,Rhode Island Rams,Makhel Mitchell,4431777,,True,18.0,2,4,2,4,0,0,0,0,1,2,3,1,1,2,2,5,4
401371711,Rhode Island Rams,Makhi Mitchell,4431708,,True,29.0,4,7,4,7,0,0,3,9,1,4,5,2,2,3,5,4,11
401371711,Rhode Island Rams,I. Leggett,4606837,,True,30.0,6,10,6,10,0,0,6,7,1,2,3,0,3,0,3,1,18
401371711,Rhode Island Rams,I. El-Amin,4279313,,True,26.0,2,3,1,2,1,1,8,8,0,1,1,2,2,2,0,4,13
401371711,Rhode Island Rams,J. Sheppard,4066445,,True,33.0,4,11,3,7,1,4,3,3,0,2,2,3,3,0,0,0,12
401371711,Rhode Island Rams,I. Ayo-Faleye,4701259,,False,0.0,0,0,0,0,0,0,0,0,0,0,0,0,0,0,0,1,0
401371711,Rhode Island Rams,A. Walker,4278567,,False,19.0,0,1,0,1,0,0,0,0,0,5,5,1,1,0,2,5,0
401371711,Rhode Island Rams,M. Martin,4397470,,False,22.0,2,6,2,5,0,1,1,2,3,2,5,0,0,1,2,1,5
401371711,Rhode Island Rams,J. Carey,4395673,,False,15.0,2,3,2,3,0,0,2,2,0,4,4,0,1,1,2,0,6
401371711,Rhode Island Rams,S. Thomas,4897065,,False,8.0,1,2,1,2,0,0,0,0,0,1,1,0,0,1,0,0,2
401371711,Rhode Island Rams,TEAM,TOTAL,TOTAL,False,,23,47,21,41,2,6,23,31,7,26,33,9,13,10,17,21,71
401371711,Boston University Terriers,S. Mathon,4280042,,True,32.0,2,5,2,5,0,0,5,7,3,8,11,1,0,1,4,3,9
401371711,Boston University Terriers,F. Tynen,4397634,,True,18.0,1,2,1,1,0,1,0,3,2,3,5,0,0,0,1,0,2
401371711,Boston University Terriers,W. Whyte,4280039,,True,30.0,3,11,2,5,1,6,4,6,2,3,5,2,4,1,3,4,11
401371711,Boston University Terriers,J. Harper,4397631,,True,31.0,3,10,1,3,2,7,0,0,0,1,1,0,0,1,1,3,8
401371711,Boston University Terriers,J. McCoy,4280041,,True,36.0,6,15,3,7,3,8,4,5,0,2,2,2,2,0,3,4,19
401371711,Boston University Terriers,M. Chimezie,4684448,,False,1.0,0,0,0,0,0,0,0,0,0,0,0,0,0,0,0,1,0
401371711,Boston University Terriers,N. Zink,4397839,,False,14.0,2,3,2,3,0,0,0,0,2,1,3,0,0,0,1,2,4
401371711,Boston University Terriers,A. Morales,4590364,,False,3.0,0,1,0,0,0,1,0,0,0,0,0,0,0,0,0,0,0
401371711,Boston University Terriers,E. Brittain-Watts,4431909,,False,14.0,1,5,1,2,0,3,0,0,0,0,0,0,0,0,2,2,2
401371711,Boston University Terriers,G. Pascoe,4397630,,False,21.0,2,3,1,2,1,1,2,2,0,1,1,2,0,0,1,3,7
401371711,Boston University Terriers,TEAM,TOTAL,TOTAL,False,,20,55,13,28,7,27,15,23,13,21,34,7,6,3,19,22,62
401371589,La Salle Explorers,C. Moore,4277945,,True,25.0,4,7,4,6,0,1,1,4,2,5,7,0,0,3,0,1,9
401371589,La Salle Explorers,J. Brickus,4700970,,True,30.0,4,8,2,3,2,5,0,0,1,4,5,3,1,0,2,1,10
401371589,La Salle Explorers,A. Gill,4700969,,True,22.0,1,5,1,5,0,0,1,1,2,4,6,5,2,0,5,2,3
401371589,La Salle Explorers,C. Ray,4592448,,True,30.0,0,2,0,1,0,1,0,0,0,3,3,0,1,0,0,1,0
401371589,La Salle Explorers,J. Nickelberry,4432845,,True,24.0,4,12,3,5,1,7,1,1,0,1,1,0,0,0,3,2,10
401371589,La Salle Explorers,M. Doucoure,4277988,,False,3.0,0,0,0,0,0,0,0,0,0,1,1,0,0,0,1,1,0
401371589,La Salle Explorers,J. Clark,4397152,,False,29.0,7,11,3,5,4,6,0,0,3,1,4,1,2,1,3,4,18
401371589,La Salle Explorers,D. Shepherd,4710357,,False,11.0,2,2,1,1,1,1,0,0,0,0,0,0,0,0,0,1,5
401371589,La Salle Explorers,K. Brantley,4709132,,False,13.0,3,10,2,8,1,2,4,4,1,2,3,0,1,0,1,3,11
401371589,La Salle Explorers,S. Kenney,4431790,,False,13.0,2,4,2,3,0,1,0,1,1,1,2,4,0,0,3,0,4
401371589,La Salle Explorers,TEAM,TOTAL,TOTAL,False,,27,61,18,37,9,24,7,11,11,22,33,13,7,4,18,16,70
401371589,Bucknell Bison,J. van der Heijden,4593081,,True,29.0,1,4,0,1,1,3,0,0,0,2,2,1,1,1,2,0,3
401371589,Bucknell Bison,A. Timmerman,4593082,,True,21.0,5,8,5,7,0,1,2,2,1,5,6,0,0,2,1,1,12
401371589,Bucknell Bison,E. Edmonds IV,4897911,,True,24.0,3,4,0,0,3,4,0,1,0,1,1,4,0,1,1,3,9
401371589,Bucknell Bison,X. Rice,4593080,,True,33.0,3,7,2,5,1,2,6,7,0,4,4,4,1,0,1,0,13
401371589,Bucknell Bison,A. Funk,4397650,,True,33.0,10,15,8,12,2,3,0,0,0,3,3,2,3,0,2,1,22
401371589,Bucknell Bison,I. Motta,4897910,,False,7.0,1,1,1,1,0,0,0,0,0,0,0,2,1,0,0,3,2
401371589,Bucknell Bison,M. Rhodes,4433064,,False,11.0,0,3,0,3,0,0,0,0,1,4,5,2,0,0,2,0,0
401371589,Bucknell Bison,A. Screen,4702499,,False,18.0,6,9,6,9,0,0,1,2,4,5,9,1,1,1,2,3,13
401371589,Bucknell Bison,J. Bascoe,4897913,,False,12.0,0,1,0,1,0,0,0,0,0,1,1,1,2,0,3,2,0
401371589,Bucknell Bison,J. Adoh,4702498,,False,10.0,3,5,2,2,1,3,1,1,0,0,0,0,0,0,0,2,8
401371589,Bucknell Bison,TEAM,TOTAL,TOTAL,False,,32,57,24,41,8,16,10,13,6,25,31,17,9,5,15,15,82
401371588,La Salle Explorers,C. Moore,4277945,,True,18.0,2,5,2,5,0,0,1,2,0,2,2,0,0,1,1,3,5
401371588,La Salle Explorers,J. Brickus,4700970,,True,31.0,3,12,0,5,3,7,0,0,1,3,4,2,0,0,1,1,9
401371588,La Salle Explorers,A. Gill,4700969,,True,29.0,3,5,2,4,1,1,0,0,1,4,5,9,1,0,5,3,7
401371588,La Salle Explorers,C. Ray,4592448,,True,18.0,2,6,2,4,0,2,0,0,1,3,4,4,0,1,1,0,4
401371588,La Salle Explorers,J. Nickelberry,4432845,,True,29.0,8,12,3,4,5,8,3,3,0,1,1,2,0,0,1,1,24
401371588,La Salle Explorers,M. McFarlane,4897068,,False,7.0,1,3,0,0,1,3,0,0,0,2,2,1,0,1,1,3,3
401371588,La Salle Explorers,M. Doucoure,4277988,,False,16.0,2,4,2,4,0,0,0,0,5,5,10,1,0,1,1,1,4
401371588,La Salle Explorers,J. Clark,4397152,,False,26.0,6,9,4,4,2,5,4,6,1,7,8,1,1,0,1,1,18
401371588,La Salle Explorers,B. Dwyer,4897069,,False,2.0,0,1,0,0,0,1,0,0,0,0,0,0,0,0,0,0,0
401371588,La Salle Explorers,C. Ireland,4897067,,False,2.0,1,1,0,0,1,1,0,0,1,0,1,0,0,0,0,0,3
401371588,La Salle Explorers,D. Shepherd,4710357,,False,17.0,2,3,2,3,0,0,0,0,2,2,4,1,0,0,0,1,4
401371588,La Salle Explorers,K. Thompson,4592449,,False,3.0,0,1,0,1,0,0,0,0,0,0,0,0,0,0,1,0,0
401371588,La Salle Explorers,A. Lafond,4404355,,False,2.0,0,0,0,0,0,0,0,0,0,1,1,0,0,0,0,0,0
401371588,La Salle Explorers,TEAM,TOTAL,TOTAL,False,,30,62,17,34,13,28,8,11,12,32,44,21,2,4,13,14,81
401371588,Fairleigh Dickinson Knights,J. Square Jr.,4703146,,True,19.0,4,6,4,6,0,0,1,2,1,0,1,2,1,0,1,3,9
401371588,Fairleigh Dickinson Knights,D. Rodriguez,4593241,,True,10.0,1,2,1,2,0,0,0,0,0,3,3,0,0,0,1,0,2
401371588,Fairleigh Dickinson Knights,O. Berry,4897999,,True,27.0,3,6,2,4,1,2,1,1,0,4,4,0,1,0,0,2,8
401371588,Fairleigh Dickinson Knights,S. Lamaute,4897996,,True,14.0,1,5,1,2,0,3,0,0,0,1,1,1,0,1,0,1,2
401371588,Fairleigh Dickinson Knights,B. Rush,4593240,,True,23.0,7,15,5,7,2,8,3,3,0,2,2,1,0,0,2,2,19
401371588,Fairleigh Dickinson Knights,I. Wattara,4897997,,False,14.0,0,3,0,3,0,0,2,2,0,1,1,0,0,1,0,0,2
401371588,Fairleigh Dickinson Knights,A. Almonor,4897995,,False,7.0,1,3,1,1,0,2,0,0,1,2,3,0,0,0,0,0,2
401371588,Fairleigh Dickinson Knights,A. Hill,4709320,,False,18.0,3,6,3,6,0,0,0,0,0,1,1,0,2,0,1,0,6
401371588,Fairleigh Dickinson Knights,P. Racine,4703145,,False,15.0,1,3,1,3,0,0,1,2,1,2,3,1,0,0,0,0,3
401371588,Fairleigh Dickinson Knights,R. Phillips,4897998,,False,2.0,0,0,0,0,0,0,0,0,2,0,2,0,0,0,0,0,0
401371588,Fairleigh Dickinson Knights,B. Upshaw,4903087,,False,2.0,0,1,0,0,0,1,0,0,0,0,0,0,1,0,0,0,0
401371588,Fairleigh Dickinson Knights,R. Ford Jr.,4897994,,False,16.0,0,3,0,2,0,1,0,0,1,2,3,2,1,1,1,2,0
401371588,Fairleigh Dickinson Knights,A. Jacks,4897993,,False,20.0,1,5,1,4,0,1,0,1,0,1,1,3,1,0,0,0,2
401371588,Fairleigh Dickinson Knights,S. Xheraj,4708611,,False,2.0,0,0,0,0,0,0,0,0,1,0,1,0,0,0,0,0,0
401371588,Fairleigh Dickinson Knights,J. Munden Jr.,4703144,,False,11.0,0,3,0,2,0,1,0,4,0,1,1,1,0,0,2,3,0
401371588,Fairleigh Dickinson Knights,TEAM,TOTAL,TOTAL,False,,22,61,19,42,3,19,8,15,10,22,32,11,7,3,10,13,55
401371587,La Salle Explorers,C. Moore,4277945,,True,34.0,6,12,6,9,0,3,3,3,2,6,8,4,0,5,2,2,15
401371587,La Salle Explorers,J. Brickus,4700970,,True,28.0,4,8,2,4,2,4,0,0,0,4,4,2,0,0,3,1,10
401371587,La Salle Explorers,C. Ray,4592448,,True,34.0,3,4,3,3,0,1,0,1,4,8,12,0,1,0,0,3,6
401371587,La Salle Explorers,J. Nickelberry,4432845,,True,35.0,10,18,6,8,4,10,4,4,1,7,8,1,1,1,0,1,28
401371587,La Salle Explorers,S. Kenney,4431790,,True,15.0,2,6,2,4,0,2,1,2,0,4,4,1,1,0,3,2,5
401371587,La Salle Explorers,M. McFarlane,4897068,,False,1.0,0,0,0,0,0,0,0,0,0,0,0,0,0,0,0,0,0
401371587,La Salle Explorers,M. Doucoure,4277988,,False,2.0,0,1,0,1,0,0,0,0,0,0,0,0,0,0,0,0,0
401371587,La Salle Explorers,J. Clark,4397152,,False,9.0,0,1,0,0,0,1,0,0,1,0,1,2,0,0,3,1,0
401371587,La Salle Explorers,D. Shepherd,4710357,,False,12.0,3,4,2,3,1,1,0,0,1,0,1,0,0,0,0,1,7
401371587,La Salle Explorers,K. Brantley,4709132,,False,12.0,2,4,2,3,0,1,0,0,0,0,0,0,0,0,0,2,4
401371587,La Salle Explorers,A. Gill,4700969,,False,18.0,4,5,4,5,0,0,1,3,2,2,4,3,2,0,0,3,9
401371587,La Salle Explorers,TEAM,TOTAL,TOTAL,False,,34,63,27,40,7,23,9,13,12,33,45,13,5,6,11,16,84
401371587,Holy Cross Crusaders,C. Kenney,4897907,,True,21.0,2,4,2,4,0,0,1,2,1,1,2,0,0,0,0,1,5
401371587,Holy Cross Crusaders,J. Martindale,4702512,,True,32.0,3,7,1,2,2,5,2,2,0,3,3,4,1,2,1,3,10
401371587,Holy Cross Crusaders,G. Gates,4398092,,True,29.0,3,9,3,9,0,0,4,5,5,7,12,1,0,1,1,2,10
401371587,Holy Cross Crusaders,K. Luc,4897904,,True,31.0,3,13,2,11,1,2,3,3,0,1,1,3,0,0,0,1,10
401371587,Holy Cross Crusaders,R. Johnson,4702508,,True,33.0,3,13,3,6,0,7,4,6,0,3,3,2,0,0,3,3,10
401371587,Holy Cross Crusaders,M. Rabinovich,4702511,,False,10.0,0,0,0,0,0,0,0,0,0,1,1,0,2,0,1,0,0
401371587,Holy Cross Crusaders,M. Townsel,4702510,,False,16.0,4,6,3,4,1,2,0,0,0,0,0,1,1,0,1,2,9
401371587,Holy Cross Crusaders,Bo Montgomery,4702509,,False,15.0,1,3,0,2,1,1,1,2,0,2,2,3,1,0,0,0,4
401371587,Holy Cross Crusaders,D. Humphrey,4589475,,False,13.0,3,4,2,2,1,2,0,0,1,2,3,0,0,0,1,3,7
401371587,Holy Cross Crusaders,TEAM,TOTAL,TOTAL,False,,22,59,16,40,6,19,15,20,7,21,28,14,5,3,8,15,65
401371586,Temple Owls,S. Tolbert III,4398355,,True,9.0,1,2,1,1,0,1,0,0,2,2,4,1,0,0,2,3,2
401371586,Temple Owls,J. Forrester,4397009,,True,22.0,6,10,6,10,0,0,0,1,3,5,8,1,1,1,0,3,12
401371586,Temple Owls,J. Williams,4701222,,True,26.0,3,7,2,5,1,2,0,1,1,4,5,6,2,1,2,2,7
401371586,Temple Owls,D. Dunn,4431946,,True,30.0,7,11,6,9,1,2,1,3,0,6,6,4,2,0,3,1,16
401371586,Temple Owls,K. Battle,4431719,,True,29.0,7,13,4,8,3,5,5,6,0,4,4,1,0,0,1,2,22
401371586,Temple Owls,Z. Hicks,4708214,,False,10.0,0,3,0,0,0,3,0,0,0,2,2,1,0,1,0,0,0
401371586,Temple Owls,N. Jourdain,4701221,,False,19.0,1,1,1,1,0,0,2,4,1,2,3,1,0,1,1,3,4
401371586,Temple Owls,A. Parks,4396652,,False,6.0,1,2,1,2,0,0,0,1,0,1,1,0,0,0,0,4,2
401371586,Temple Owls,C. Daly,4711160,,False,2.0,0,1,0,0,0,1,0,0,0,0,0,0,0,0,1,1,0
401371586,Temple Owls,H. Miller,4708218,,False,16.0,1,3,1,2,0,1,1,2,0,2,2,1,0,1,2,3,3
401371586,Temple Owls,Q. Ademokoya,4602022,,False,6.0,0,1,0,0,0,1,0,0,0,0,0,0,0,0,0,1,0
401371586,Temple Owls,J. White,4432514,,False,25.0,1,5,1,3,0,2,3,5,2,4,6,3,0,1,1,3,5
401371586,Temple Owls,TEAM,TOTAL,TOTAL,False,,28,59,23,41,5,18,12,23,12,33,45,19,5,6,13,26,73
401371586,La Salle Explorers,C. Moore,4277945,,True,30.0,2,10,2,7,0,3,5,8,1,6,7,1,1,3,1,1,9
401371586,La Salle Explorers,J. Brickus,4700970,,True,10.0,0,1,0,0,0,1,0,0,0,1,1,1,2,0,1,2,0
401371586,La Salle Explorers,C. Ray,4592448,,True,29.0,1,4,1,2,0,2,0,1,9,3,12,1,0,1,1,3,2
401371586,La Salle Explorers,J. Nickelberry,4432845,,True,18.0,0,7,0,2,0,5,0,0,0,2,2,0,0,0,1,1,0
401371586,La Salle Explorers,S. Kenney,4431790,,True,27.0,8,15,3,4,5,11,2,2,0,0,0,0,0,0,3,3,23
401371586,La Salle Explorers,M. McFarlane,4897068,,False,5.0,1,1,0,0,1,1,0,0,0,1,1,0,0,1,0,0,3
401371586,La Salle Explorers,M. Doucoure,4277988,,False,8.0,0,1,0,1,0,0,0,0,1,1,2,0,0,0,0,3,0
401371586,La Salle Explorers,J. Clark,4397152,,False,24.0,2,11,2,8,0,3,3,3,2,1,3,0,1,0,2,1,7
401371586,La Salle Explorers,T. Izay,4700971,,False,3.0,0,1,0,1,0,0,0,0,0,1,1,0,0,0,0,4,0
401371586,La Salle Explorers,K. Brantley,4709132,,False,25.0,1,12,1,10,0,2,3,5,1,2,3,2,1,1,1,1,5
401371586,La Salle Explorers,A. Gill,4700969,,False,19.0,2,4,2,4,0,0,4,6,1,6,7,6,0,0,2,5,8
401371586,La Salle Explorers,A. Lafond,4404355,,False,2.0,0,1,0,1,0,0,0,0,0,0,0,0,1,0,0,0,0
401371586,La Salle Explorers,TEAM,TOTAL,TOTAL,False,,17,68,11,40,6,28,17,25,23,24,47,11,6,6,12,24,57
401371585,La Salle Explorers,C. Moore,4277945,,True,24.0,2,6,2,6,0,0,0,0,4,3,7,1,1,6,2,2,4
401371585,La Salle Explorers,J. Clark,4397152,,True,28.0,1,8,1,6,0,2,2,2,1,8,9,1,0,0,4,2,4
401371585,La Salle Explorers,J. Brickus,4700970,,True,25.0,5,8,2,3,3,5,1,3,0,2,2,2,0,0,0,2,14
401371585,La Salle Explorers,C. Ray,4592448,,True,33.0,5,11,5,11,0,0,0,0,5,3,8,3,0,0,3,3,10
401371585,La Salle Explorers,J. Nickelberry,4432845,,True,18.0,3,9,1,3,2,6,0,0,1,1,2,0,1,0,0,1,8
401371585,La Salle Explorers,M. Doucoure,4277988,,False,11.0,0,0,0,0,0,0,0,0,1,3,4,0,0,0,0,2,0
401371585,La Salle Explorers,K. Brantley,4709132,,False,25.0,6,11,6,10,0,1,0,2,0,4,4,3,1,0,1,1,12
401371585,La Salle Explorers,A. Gill,4700969,,False,10.0,0,1,0,1,0,0,3,4,1,3,4,0,1,0,1,2,3
401371585,La Salle Explorers,S. Kenney,4431790,,False,26.0,2,7,0,2,2,5,0,0,0,1,1,2,2,2,3,4,6
401371585,La Salle Explorers,TEAM,TOTAL,TOTAL,False,,24,61,17,42,7,19,6,11,15,31,46,12,6,8,16,19,61
401371585,Army Black Knights,C. Peterson,4705305,,True,34.0,4,7,4,7,0,0,5,8,3,4,7,1,1,0,2,1,13
401371585,Army Black Knights,A. Duhart,4397609,,True,21.0,0,2,0,1,0,1,0,0,1,2,3,4,1,0,1,2,0
401371585,Army Black Knights,J. Cross,4705304,,True,23.0,1,7,0,1,1,6,0,0,1,0,1,0,0,0,0,2,3
401371585,Army Black Knights,J. Rucker,4705299,,True,34.0,5,19,3,11,2,8,1,3,1,5,6,2,1,0,2,0,13
401371585,Army Black Knights,J. Caldwell,4397607,,True,25.0,3,11,3,8,0,3,2,2,1,2,3,1,1,0,4,5,8
401371585,Army Black Knights,N. Naess,4897934,,False,6.0,1,2,1,1,0,1,0,0,0,1,1,1,0,0,0,0,2
401371585,Army Black Knights,M. Dove,4705307,,False,6.0,0,0,0,0,0,0,2,2,1,0,1,0,0,0,0,0,2
401371585,Army Black Knights,C. Mann,4593075,,False,15.0,2,3,2,2,0,1,2,2,3,2,5,0,0,0,1,2,6
401371585,Army Black Knights,T. Small,4897933,,False,22.0,3,7,0,2,3,5,0,0,1,4,5,0,1,1,0,2,9
401371585,Army Black Knights,I. Caldwell,4897929,,False,14.0,0,3,0,1,0,2,2,3,0,3,3,0,3,2,0,0,2
401371585,Army Black Knights,TEAM,TOTAL,TOTAL,False,,19,61,13,34,6,27,14,20,13,26,39,9,8,3,10,14,58
401371584,La Salle Explorers,C. Moore,4277945,,True,30.0,3,8,3,7,0,1,8,10,4,2,6,1,0,1,3,3,14
401371584,La Salle Explorers,J. Clark,4397152,,True,42.0,7,17,6,13,1,4,3,4,1,6,7,1,2,1,1,3,18
401371584,La Salle Explorers,J. Brickus,4700970,,True,34.0,6,11,4,6,2,5,1,1,0,1,1,6,1,0,1,3,15
401371584,La Salle Explorers,C. Ray,4592448,,True,42.0,5,10,3,4,2,6,2,6,7,9,16,4,0,0,4,5,14
401371584,La Salle Explorers,J. Nickelberry,4432845,,True,30.0,5,13,3,7,2,6,0,0,1,2,3,0,1,0,1,2,12
401371584,La Salle Explorers,M. Doucoure,4277988,,False,5.0,0,0,0,0,0,0,0,0,0,0,0,0,0,1,1,1,0
401371584,La Salle Explorers,T. Izay,4700971,,False,9.0,2,2,2,2,0,0,0,0,1,0,1,0,0,0,0,2,4
401371584,La Salle Explorers,K. Brantley,4709132,,False,3.0,0,1,0,1,0,0,0,0,0,0,0,0,1,0,1,0,0
401371584,La Salle Explorers,A. Gill,4700969,,False,11.0,1,1,1,1,0,0,0,0,0,3,3,2,0,1,1,5,2
401371584,La Salle Explorers,S. Kenney,4431790,,False,19.0,0,3,0,1,0,2,3,4,1,1,2,1,1,0,2,5,3
401371584,La Salle Explorers,TEAM,TOTAL,TOTAL,False,,29,66,22,42,7,24,17,25,16,27,43,15,6,4,15,29,82
401371584,Delaware Blue Hens,A. Carr,4702743,,True,22.0,1,8,1,7,0,1,3,4,1,1,2,1,0,0,2,5,5
401371584,Delaware Blue Hens,D. Painter,4065840,,True,33.0,6,8,4,5,2,3,5,6,4,8,12,5,0,1,3,5,19
401371584,Delaware Blue Hens,J. Nelson Jr.,4592444,,True,44.0,2,10,1,4,1,6,1,2,1,3,4,1,0,0,2,2,6
401371584,Delaware Blue Hens,R. Allen,4279190,,True,43.0,11,17,6,7,5,10,8,12,1,3,4,1,2,0,3,0,35
401371584,Delaware Blue Hens,K. Anderson,4279189,,True,39.0,3,11,3,7,0,4,4,4,0,4,4,3,3,0,2,2,10
401371584,Delaware Blue Hens,J. Davis,4701989,,False,10.0,0,1,0,1,0,0,3,4,0,0,0,0,0,0,0,1,3
401371584,Delaware Blue Hens,G. Arletti,4702742,,False,10.0,1,1,1,1,0,0,1,1,0,1,1,0,1,0,0,0,3
401371584,Delaware Blue Hens,E. Asamoah,4597790,,False,24.0,0,3,0,1,0,2,4,4,3,2,5,1,0,2,2,4,4
401371584,Delaware Blue Hens,TEAM,TOTAL,TOTAL,False,,24,59,16,33,8,26,29,37,11,24,35,12,6,3,14,19,85
401371583,Sacred Heart Pioneers,B. Johnson,4703180,,True,32.0,5,6,4,5,1,1,0,0,1,9,10,3,0,0,2,1,11
401371583,Sacred Heart Pioneers,N. Galette,4703183,,True,26.0,3,8,3,5,0,3,1,2,3,5,8,1,0,0,2,4,7
401371583,Sacred Heart Pioneers,Ty. Thomas,4593126,,True,43.0,9,27,7,14,2,13,4,4,3,8,11,5,1,1,2,3,24
401371583,Sacred Heart Pioneers,A. Clarke,4397995,,True,22.0,1,5,0,3,1,2,6,8,0,0,0,2,0,0,0,0,9
401371583,Sacred Heart Pioneers,A. Watson,4279645,,True,36.0,6,10,2,4,4,6,0,2,0,4,4,5,1,0,6,5,16
401371583,Sacred Heart Pioneers,Ta. Thomas,4897974,,False,9.0,1,3,1,2,0,1,0,0,1,3,4,0,0,0,2,2,2
401371583,Sacred Heart Pioneers,Z. Pfaffenberger,4397998,,False,9.0,0,2,0,2,0,0,0,0,0,1,1,0,0,0,0,2,0
401371583,Sacred Heart Pioneers,C. Dutreil,4396765,,False,14.0,2,2,2,2,0,0,0,0,1,6,7,0,0,0,0,0,4
401371583,Sacred Heart Pioneers,J. Reilly,4593093,,False,34.0,5,7,2,2,3,5,0,0,1,0,1,2,1,0,2,2,13
401371583,Sacred Heart Pioneers,TEAM,TOTAL,TOTAL,False,,32,70,21,39,11,31,11,16,11,39,50,18,3,1,17,19,86
401371583,La Salle Explorers,C. Moore,4277945,,True,23.0,2,4,2,4,0,0,0,1,2,3,5,1,0,2,1,3,4
401371583,La Salle Explorers,J. Clark,4397152,,True,37.0,5,17,3,10,2,7,0,0,3,8,11,3,0,1,1,3,12
401371583,La Salle Explorers,J. Brickus,4700970,,True,29.0,3,9,1,3,2,6,0,0,0,0,0,4,0,0,1,2,8
401371583,La Salle Explorers,C. Ray,4592448,,True,20.0,0,3,0,2,0,1,0,0,2,3,5,1,0,0,2,3,0
401371583,La Salle Explorers,J. Nickelberry,4432845,,True,34.0,8,17,2,6,6,11,0,3,1,6,7,2,0,0,1,2,22
401371583,La Salle Explorers,M. Doucoure,4277988,,False,7.0,0,1,0,1,0,0,0,0,0,1,1,0,0,0,1,0,0
401371583,La Salle Explorers,K. Brantley,4709132,,False,18.0,2,7,1,3,1,4,2,5,1,2,3,0,0,0,1,1,7
401371583,La Salle Explorers,A. Gill,4700969,,False,30.0,5,9,5,7,0,2,0,0,1,4,5,5,5,0,1,1,10
401371583,La Salle Explorers,S. Kenney,4431790,,False,27.0,5,12,1,3,4,9,4,5,0,0,0,2,1,0,0,1,18
401371583,La Salle Explorers,TEAM,TOTAL,TOTAL,False,,30,79,15,39,15,40,6,14,12,29,41,18,6,3,9,16,81
401371581,Radford Highlanders,L. Djonkam,4278422,,True,23.0,3,5,3,5,0,0,0,0,0,3,3,0,1,0,1,4,6
401371581,Radford Highlanders,R. Williams,4396643,,True,31.0,5,7,2,2,3,5,1,3,1,7,8,2,1,0,2,5,14
401371581,Radford Highlanders,C. McNeil,4897647,,True,24.0,1,7,1,6,0,1,0,0,0,4,4,1,1,0,1,2,2
401371581,Radford Highlanders,A. Stapleton,4708648,,True,26.0,3,5,3,4,0,1,0,2,1,1,2,6,0,0,3,4,6
401371581,Radford Highlanders,T. Joseph,4703215,,True,20.0,2,8,1,3,1,5,2,3,0,1,1,1,0,0,1,1,7
401371581,Radford Highlanders,S. Jules,4702215,,False,10.0,1,2,1,2,0,0,2,4,1,2,3,0,0,0,1,0,4
401371581,Radford Highlanders,D. Mangum,4397471,,False,11.0,0,3,0,2,0,1,0,0,1,3,4,0,0,0,0,0,0
401371581,Radford Highlanders,C. Walker,4279192,,False,10.0,1,2,1,2,0,0,0,0,0,3,3,0,0,0,0,4,2
401371581,Radford Highlanders,D. Jones Jr.,4897646,,False,3.0,0,0,0,0,0,0,0,0,0,0,0,0,0,0,1,0,0
401371581,Radford Highlanders,X. Lipscomb,4702218,,False,17.0,1,2,0,1,1,1,3,4,0,2,2,0,0,1,3,0,6
401371581,Radford Highlanders,B. Hart,4702216,,False,22.0,3,10,0,1,3,9,2,3,1,3,4,2,0,0,0,0,11
401371581,Radford Highlanders,K. Porter,4702212,,False,3.0,0,0,0,0,0,0,0,0,0,0,0,0,0,0,0,3,0
401371581,Radford Highlanders,TEAM,TOTAL,TOTAL,False,,20,51,12,28,8,23,10,19,5,30,35,12,3,1,14,23,58
401371581,George Washington Revolutionaries,H. Dean,4593273,,True,15.0,0,0,0,0,0,0,1,2,0,6,6,0,1,0,1,3,1
401371581,George Washington Revolutionaries,R. Lindo Jr.,4397186,,True,35.0,2,7,2,3,0,4,6,6,3,11,14,2,3,3,2,3,10
401371581,George Washington Revolutionaries,J. Bamisile,4432537,,True,29.0,3,8,3,5,0,3,1,4,3,1,4,2,0,0,1,3,7
401371581,George Washington Revolutionaries,J. Bishop,4431770,,True,33.0,8,14,6,10,2,4,3,6,0,3,3,1,2,0,0,2,21
401371581,George Washington Revolutionaries,B. Adams,4396612,,True,35.0,5,13,5,7,0,6,2,2,0,5,5,2,0,0,1,2,12
401371581,George Washington Revolutionaries,Q. Samuels,4592251,,False,14.0,0,1,0,0,0,1,0,0,0,0,0,0,0,0,0,2,0
401371581,George Washington Revolutionaries,N. Brown,4700963,,False,9.0,0,3,0,3,0,0,0,2,1,1,2,0,0,0,1,3,0
401371581,George Washington Revolutionaries,B. Freeman,4613126,,False,26.0,5,11,3,8,2,3,4,6,0,1,1,2,2,0,1,1,16
401371581,George Washington Revolutionaries,A. Harris,4397216,,False,4.0,0,0,0,0,0,0,0,0,1,0,1,0,0,0,0,0,0
401371581,George Washington Revolutionaries,TEAM,TOTAL,TOTAL,False,,23,57,19,36,4,21,17,28,9,31,40,9,8,3,7,19,67
401371580,George Washington Revolutionaries,R. Lindo Jr.,4397186,,True,23.0,4,7,4,6,0,1,0,0,2,3,5,2,1,1,2,4,8
401371580,George Washington Revolutionaries,N. Brown,4700963,,True,25.0,2,4,2,4,0,0,1,2,3,2,5,0,0,2,1,0,5
401371580,George Washington Revolutionaries,J. Bamisile,4432537,,True,28.0,3,10,1,5,2,5,0,0,3,4,7,1,1,3,4,3,8
401371580,George Washington Revolutionaries,J. Bishop,4431770,,True,33.0,9,18,4,6,5,12,0,0,0,0,0,2,1,0,3,3,23
401371580,George Washington Revolutionaries,B. Adams,4396612,,True,34.0,6,15,3,7,3,8,3,3,0,1,1,1,1,1,0,5,18
401371580,George Washington Revolutionaries,H. Dean,4593273,,False,10.0,1,2,1,2,0,0,0,0,2,3,5,1,0,1,0,2,2
401371580,George Washington Revolutionaries,B. Freeman,4613126,,False,29.0,4,8,4,8,0,0,3,4,0,1,1,8,6,0,4,2,11
401371580,George Washington Revolutionaries,A. Harris,4397216,,False,18.0,2,2,2,2,0,0,0,1,0,4,4,0,0,1,0,0,4
401371580,George Washington Revolutionaries,TEAM,TOTAL,TOTAL,False,,31,66,21,40,10,26,7,10,11,18,29,15,10,9,15,19,79
401371580,Charlotte 49ers,R. Braswell,4395675,,True,25.0,2,7,2,4,0,3,4,4,2,1,3,1,2,1,1,2,8
401371580,Charlotte 49ers,A. Khalifa,4702739,,True,24.0,5,7,5,7,0,0,0,0,2,4,6,6,1,1,2,2,10
401371580,Charlotte 49ers,J. Young,4433133,,True,35.0,6,11,3,5,3,6,11,11,0,3,3,4,1,1,4,1,26
401371580,Charlotte 49ers,A. Butler,4280070,,True,37.0,7,13,6,10,1,3,2,3,3,5,8,3,2,0,2,1,17
401371580,Charlotte 49ers,C. Trapp Jr.,4277833,,True,35.0,7,14,4,8,3,6,2,3,2,10,12,2,0,1,3,2,19
401371580,Charlotte 49ers,J. Garcia,4702740,,False,8.0,2,3,2,3,0,0,0,0,2,1,3,1,0,0,2,1,4
401371580,Charlotte 49ers,L. Vasic,4278934,,False,10.0,1,2,1,2,0,0,0,0,0,0,0,0,0,0,1,1,2
401371580,Charlotte 49ers,J. Threadgill,4702738,,False,17.0,0,1,0,0,0,1,0,0,0,0,0,1,0,0,1,1,0
401371580,Charlotte 49ers,M. Cannon,4397168,,False,9.0,0,1,0,0,0,1,0,0,1,1,2,0,0,0,0,0,0
401371580,Charlotte 49ers,TEAM,TOTAL,TOTAL,False,,30,59,23,39,7,20,19,21,13,25,38,18,6,4,17,11,86
401371579,George Washington Revolutionaries,R. Lindo Jr.,4397186,,True,33.0,3,9,3,8,0,1,2,4,1,10,11,2,3,3,0,3,8
401371579,George Washington Revolutionaries,N. Brown,4700963,,True,23.0,2,2,2,2,0,0,0,0,1,1,2,0,0,2,1,4,4
401371579,George Washington Revolutionaries,J. Bamisile,4432537,,True,28.0,2,11,1,7,1,4,0,0,2,3,5,0,1,2,1,1,5
401371579,George Washington Revolutionaries,J. Bishop,4431770,,True,35.0,10,19,7,13,3,6,0,0,0,1,1,0,1,0,3,1,23
401371579,George Washington Revolutionaries,B. Adams,4396612,,True,31.0,3,8,3,3,0,5,0,0,0,3,3,3,1,0,2,2,6
401371579,George Washington Revolutionaries,T. Warner,4897074,,False,7.0,0,0,0,0,0,0,0,0,0,0,0,0,0,0,0,1,0
401371579,George Washington Revolutionaries,H. Dean,4593273,,False,8.0,0,1,0,1,0,0,0,0,1,1,2,0,0,0,0,4,0
401371579,George Washington Revolutionaries,Q. Samuels,4592251,,False,3.0,0,0,0,0,0,0,0,0,0,0,0,0,0,0,1,0,0
401371579,George Washington Revolutionaries,B. Freeman,4613126,,False,23.0,3,9,3,6,0,3,2,2,1,2,3,4,0,0,0,1,8
401371579,George Washington Revolutionaries,A. Harris,4397216,,False,8.0,0,0,0,0,0,0,0,0,0,2,2,0,1,0,0,0,0
401371579,George Washington Revolutionaries,B. Knapp,4279473,,False,1.0,0,0,0,0,0,0,0,0,0,0,0,0,0,0,0,0,0
401371579,George Washington Revolutionaries,TEAM,TOTAL,TOTAL,False,,23,59,19,40,4,19,4,6,7,23,30,9,7,7,8,17,54
401371579,Boston University Terriers,S. Mathon,4280042,,True,30.0,7,16,7,16,0,0,3,4,1,5,6,0,0,0,2,1,17
401371579,Boston University Terriers,F. Tynen,4397634,,True,31.0,1,4,0,2,1,2,2,2,1,5,6,0,0,0,1,0,5
401371579,Boston University Terriers,M. Brewster,4702490,,True,29.0,4,6,3,4,1,2,0,0,0,3,3,2,0,0,0,2,9
401371579,Boston University Terriers,J. Harper,4397631,,True,31.0,1,7,1,2,0,5,2,2,1,1,2,1,0,0,0,2,4
401371579,Boston University Terriers,J. McCoy,4280041,,True,35.0,5,13,4,12,1,1,6,8,1,3,4,1,2,0,2,1,17
401371579,Boston University Terriers,M. Chimezie,4684448,,False,11.0,1,4,1,4,0,0,0,1,4,3,7,1,0,0,0,0,2
401371579,Boston University Terriers,A. Morales,4590364,,False,11.0,1,2,1,1,0,1,0,0,0,2,2,0,1,1,4,1,2
401371579,Boston University Terriers,D. Tate,4593079,,False,6.0,0,1,0,1,0,0,0,0,0,0,0,0,0,0,1,0,0
401371579,Boston University Terriers,G. Pascoe,4397630,,False,16.0,0,0,0,0,0,0,0,0,1,2,3,0,0,0,1,3,0
401371579,Boston University Terriers,TEAM,TOTAL,TOTAL,False,,20,53,17,42,3,11,13,17,12,28,40,5,3,1,13,10,56
401371578,UMass Lowell River Hawks,M. Brooks,4700953,,True,28.0,10,15,10,15,0,0,3,7,1,4,5,0,1,3,0,3,23
401371578,UMass Lowell River Hawks,Al. Blunt,4396569,,True,35.0,3,9,3,5,0,4,1,2,2,3,5,3,0,0,3,1,7
401371578,UMass Lowell River Hawks,K. Thomas,4592912,,True,29.0,2,7,2,2,0,5,0,1,1,4,5,3,0,0,3,4,4
401371578,UMass Lowell River Hawks,E. Hammond,4397833,,True,35.0,3,9,1,4,2,5,3,4,1,6,7,6,2,0,2,1,11
401371578,UMass Lowell River Hawks,J. Faison,4290752,,True,27.0,2,7,2,3,0,4,0,0,0,1,1,4,4,0,2,4,4
401371578,UMass Lowell River Hawks,D. Jordan-Thomas,4433017,,False,4.0,0,1,0,1,0,0,0,0,0,1,1,0,0,0,0,0,0
401371578,UMass Lowell River Hawks,J. Hall,4066996,,False,7.0,0,1,0,0,0,1,0,1,0,3,3,0,0,0,0,0,0
401371578,UMass Lowell River Hawks,An. Blunt,4700954,,False,4.0,0,1,0,1,0,0,0,0,0,1,1,0,0,0,0,0,0
401371578,UMass Lowell River Hawks,Q. Mincey,4567710,,False,5.0,0,0,0,0,0,0,0,0,0,1,1,0,0,0,0,0,0
401371578,UMass Lowell River Hawks,A. Hikim,4431843,,False,24.0,7,12,6,10,1,2,3,4,0,4,4,1,3,1,0,2,18
401371578,UMass Lowell River Hawks,G. Hammond,4431822,,False,2.0,0,0,0,0,0,0,0,0,0,0,0,0,0,0,0,2,0
401371578,UMass Lowell River Hawks,TEAM,TOTAL,TOTAL,False,,27,62,24,41,3,21,10,19,7,29,36,17,10,4,10,17,67
401371578,George Washington Revolutionaries,R. Lindo Jr.,4397186,,True,37.0,2,10,1,9,1,1,3,4,2,7,9,0,3,1,3,3,8
401371578,George Washington Revolutionaries,N. Brown,4700963,,True,9.0,0,1,0,1,0,0,0,0,0,1,1,0,0,0,4,3,0
401371578,George Washington Revolutionaries,J. Bamisile,4432537,,True,32.0,4,15,2,11,2,4,1,3,4,10,14,0,1,2,1,3,11
401371578,George Washington Revolutionaries,J. Bishop,4431770,,True,37.0,6,14,6,11,0,3,6,7,1,4,5,2,1,0,7,1,18
401371578,George Washington Revolutionaries,B. Adams,4396612,,True,36.0,1,8,0,4,1,4,3,4,1,6,7,1,1,0,1,2,6
401371578,George Washington Revolutionaries,Q. Samuels,4592251,,False,24.0,0,1,0,1,0,0,0,0,1,3,4,1,0,0,0,3,0
401371578,George Washington Revolutionaries,B. Freeman,4613126,,False,18.0,5,6,4,5,1,1,2,4,0,1,1,2,0,0,3,3,13
401371578,George Washington Revolutionaries,A. Harris,4397216,,False,7.0,0,0,0,0,0,0,0,0,0,0,0,0,0,0,0,1,0
401371578,George Washington Revolutionaries,TEAM,TOTAL,TOTAL,False,,18,55,13,42,5,13,15,22,10,33,43,6,6,3,19,19,56
401371577,George Washington Revolutionaries,R. Lindo Jr.,4397186,,True,25.0,3,6,2,4,1,2,1,2,2,6,8,2,2,1,4,4,8
401371577,George Washington Revolutionaries,N. Brown,4700963,,True,32.0,4,6,4,6,0,0,2,4,3,0,3,2,0,1,1,1,10
401371577,George Washington Revolutionaries,J. Bamisile,4432537,,True,25.0,2,8,2,6,0,2,3,4,3,1,4,0,1,2,6,4,7
401371577,George Washington Revolutionaries,J. Bishop,4431770,,True,36.0,7,21,2,7,5,14,0,0,0,2,2,3,0,0,2,3,19
401371577,George Washington Revolutionaries,B. Adams,4396612,,True,37.0,3,8,2,3,1,5,2,2,1,3,4,4,2,0,0,0,9
401371577,George Washington Revolutionaries,D. Nixon,4897075,,False,2.0,0,1,0,0,0,1,0,0,0,0,0,0,0,0,0,0,0
401371577,George Washington Revolutionaries,T. Warner,4897074,,False,2.0,0,0,0,0,0,0,0,0,0,0,0,0,0,0,0,0,0
401371577,George Washington Revolutionaries,M. Gally,4592445,,False,2.0,0,0,0,0,0,0,0,0,0,0,0,0,0,0,0,1,0
401371577,George Washington Revolutionaries,Q. Samuels,4592251,,False,13.0,1,2,1,1,0,1,0,0,0,0,0,0,0,0,0,4,2
401371577,George Washington Revolutionaries,T. Stamoulis,4897076,,False,1.0,0,0,0,0,0,0,0,0,0,0,0,0,0,0,0,0,0
401371577,George Washington Revolutionaries,B. Freeman,4613126,,False,21.0,2,6,2,6,0,0,0,0,2,5,7,0,1,0,0,3,4
401371577,George Washington Revolutionaries,A. Harris,4397216,,False,5.0,0,1,0,1,0,0,0,0,0,0,0,0,0,0,0,1,0
401371577,George Washington Revolutionaries,TEAM,TOTAL,TOTAL,False,,22,59,15,34,7,25,8,12,11,17,28,11,6,4,14,21,59
401371577,Cal State Fullerton Titans,V. Lee,4397342,,True,28.0,3,12,3,12,0,0,0,0,5,5,10,0,0,0,0,3,6
401371577,Cal State Fullerton Titans,E.J. Anosike,4279647,,True,35.0,12,16,12,16,0,0,4,5,7,4,11,0,0,0,3,1,28
401371577,Cal State Fullerton Titans,D. Maddox Jr.,4702487,,True,24.0,3,7,3,5,0,2,5,5,2,3,5,3,0,1,2,0,11
401371577,Cal State Fullerton Titans,T. San Antonio,4432108,,True,28.0,1,1,1,1,0,0,0,0,0,3,3,0,2,1,0,1,2
401371577,Cal State Fullerton Titans,D. Milstead,4280171,,True,33.0,3,9,1,5,2,4,2,2,1,3,4,2,1,0,1,1,10
401371577,Cal State Fullerton Titans,L. Laku,4703699,,False,3.0,0,0,0,0,0,0,0,0,0,0,0,0,0,0,0,1,0
401371577,Cal State Fullerton Titans,G. Carper,4897658,,False,2.0,0,0,0,0,0,0,0,0,0,0,0,0,0,0,0,0,0
401371577,Cal State Fullerton Titans,L. Wrightsell Jr.,4702484,,False,21.0,2,8,1,6,1,2,3,4,0,2,2,0,0,0,0,1,8
401371577,Cal State Fullerton Titans,J. Harris,4702482,,False,2.0,0,0,0,0,0,0,0,0,0,0,0,0,0,0,1,1,0
401371577,Cal State Fullerton Titans,T. Maddox Jr.,4397779,,False,24.0,2,7,1,4,1,3,4,4,0,5,5,1,2,0,3,3,9
401371577,Cal State Fullerton Titans,TEAM,TOTAL,TOTAL,False,,26,60,22,49,4,11,18,20,15,25,40,6,5,2,11,12,74
401371576,UC San Diego Tritons,T. Rocak,4702610,,True,21.0,3,7,2,5,1,2,4,7,0,7,7,3,1,0,3,5,11
401371576,UC San Diego Tritons,M. Gray,4397344,,True,11.0,3,4,3,4,0,0,0,1,2,5,7,0,1,0,2,3,6
401371576,UC San Diego Tritons,J. Roquemore,4702611,,True,36.0,3,5,3,4,0,1,5,6,0,4,4,5,0,0,3,1,11
401371576,UC San Diego Tritons,B. Pope,4702606,,True,27.0,2,9,1,6,1,3,0,0,0,2,2,2,0,0,4,2,5
401371576,UC San Diego Tritons,J. Killingsworth,4066807,,True,36.0,0,5,0,1,0,4,3,3,1,8,9,3,1,0,2,1,3
401371576,UC San Diego Tritons,F. Nwaokorie,4897686,,False,29.0,6,9,3,5,3,4,4,6,2,3,5,1,0,0,2,4,19
401371576,UC San Diego Tritons,J. Kosakowski,4702605,,False,14.0,4,8,0,0,4,8,0,0,0,3,3,0,0,0,0,1,12
401371576,UC San Diego Tritons,V. Vulikic,4703081,,False,13.0,0,1,0,0,0,1,0,0,0,0,0,2,0,0,2,1,0
401371576,UC San Diego Tritons,K. Rasheed,4702608,,False,13.0,2,2,0,0,2,2,2,3,0,1,1,2,3,0,1,0,8
401371576,UC San Diego Tritons,TEAM,TOTAL,TOTAL,False,,23,50,12,25,11,25,18,26,8,34,42,18,6,0,20,18,75
401371576,George Washington Revolutionaries,R. Lindo Jr.,4397186,,True,37.0,4,9,2,6,2,3,3,4,0,11,11,1,0,2,5,4,13
401371576,George Washington Revolutionaries,N. Brown,4700963,,True,12.0,1,3,1,3,0,0,0,0,1,1,2,0,0,0,0,1,2
401371576,George Washington Revolutionaries,J. Bamisile,4432537,,True,22.0,5,11,5,8,0,3,2,2,0,0,0,1,3,0,2,4,12
401371576,George Washington Revolutionaries,J. Bishop,4431770,,True,37.0,2,14,1,9,1,5,0,0,0,2,2,0,0,0,2,0,5
401371576,George Washington Revolutionaries,B. Adams,4396612,,True,37.0,4,11,4,5,0,6,4,5,1,1,2,2,1,0,1,1,12
401371576,George Washington Revolutionaries,Q. Samuels,4592251,,False,20.0,2,4,2,2,0,2,0,1,1,1,2,1,2,1,1,3,4
401371576,George Washington Revolutionaries,B. Freeman,4613126,,False,15.0,2,5,2,5,0,0,1,1,0,0,0,0,1,0,0,5,5
401371576,George Washington Revolutionaries,A. Harris,4397216,,False,19.0,1,1,1,1,0,0,0,0,0,5,5,2,1,1,2,4,2
401371576,George Washington Revolutionaries,B. Knapp,4279473,,False,1.0,0,0,0,0,0,0,0,0,0,0,0,0,0,0,0,0,0
401371576,George Washington Revolutionaries,TEAM,TOTAL,TOTAL,False,,21,58,18,39,3,19,10,13,3,23,26,7,8,4,14,22,55
401371575,Maryland Terrapins,Q. Wahab,4431739,,True,24.0,7,10,7,10,0,0,4,6,5,10,15,1,1,2,1,2,18
401371575,Maryland Terrapins,D. Scott,4432852,,True,31.0,2,6,1,2,1,4,2,2,3,7,10,1,0,2,1,0,7
401371575,Maryland Terrapins,H. Hart,4431984,,True,27.0,2,5,2,2,0,3,5,7,1,3,4,2,3,1,2,1,9
401371575,Maryland Terrapins,E. Ayala,4397184,,True,32.0,5,15,5,9,0,6,1,3,0,3,3,2,0,0,5,1,11
401371575,Maryland Terrapins,F. Russell,4278371,,True,28.0,4,10,3,9,1,1,6,7,3,3,6,1,2,1,2,3,15
401371575,Maryland Terrapins,P. Dziuba,4702377,,False,6.0,0,0,0,0,0,0,0,0,0,0,0,0,1,0,0,0,0
401371575,Maryland Terrapins,J. Reese,4683742,,False,17.0,2,9,2,8,0,1,2,2,3,2,5,0,0,0,2,2,6
401371575,Maryland Terrapins,I. Martinez,4601026,,False,20.0,1,5,0,0,1,5,0,2,0,2,2,2,2,0,0,1,3
401371575,Maryland Terrapins,X. Green,4067031,,False,15.0,1,4,1,4,0,0,0,0,1,0,1,2,0,0,0,0,2
401371575,Maryland Terrapins,TEAM,TOTAL,TOTAL,False,,24,64,21,44,3,20,20,29,17,31,48,11,9,6,13,10,71
401371575,George Washington Revolutionaries,R. Lindo Jr.,4397186,,True,34.0,5,11,2,6,3,5,0,0,3,6,9,3,2,2,2,4,13
401371575,George Washington Revolutionaries,N. Brown,4700963,,True,18.0,0,1,0,1,0,0,0,0,0,4,4,0,0,0,4,3,0
401371575,George Washington Revolutionaries,J. Bamisile,4432537,,True,35.0,9,20,9,17,0,3,2,3,3,5,8,0,2,2,2,4,20
401371575,George Washington Revolutionaries,J. Bishop,4431770,,True,35.0,5,16,5,11,0,5,3,4,0,1,1,2,0,0,1,1,13
401371575,George Washington Revolutionaries,B. Adams,4396612,,True,35.0,6,13,5,9,1,4,1,1,2,2,4,2,1,0,0,2,14
401371575,George Washington Revolutionaries,H. Dean,4593273,,False,17.0,0,0,0,0,0,0,0,0,0,3,3,0,1,2,0,3,0
401371575,George Washington Revolutionaries,Q. Samuels,4592251,,False,4.0,1,1,1,1,0,0,0,0,0,1,1,0,0,0,1,2,2
401371575,George Washington Revolutionaries,B. Freeman,4613126,,False,15.0,1,3,1,3,0,0,0,0,1,3,4,2,0,0,3,2,2
401371575,George Washington Revolutionaries,A. Harris,4397216,,False,7.0,0,1,0,1,0,0,0,0,0,0,0,0,0,0,0,1,0
401371575,George Washington Revolutionaries,TEAM,TOTAL,TOTAL,False,,27,66,23,49,4,17,6,8,10,28,38,9,6,6,13,22,64
401371574,St. Francis (PA) Red Flash,M. Thompson,4398017,,True,29.0,3,10,3,7,0,3,3,4,3,3,6,0,1,0,2,3,9
401371574,St. Francis (PA) Red Flash,M. Flagg,4280256,,True,30.0,7,12,7,12,0,0,3,5,4,13,17,0,0,2,3,5,17
401371574,St. Francis (PA) Red Flash,R. Giles Jr.,4703194,,True,36.0,2,9,2,9,0,0,5,6,2,1,3,1,1,0,4,2,9
401371574,St. Francis (PA) Red Flash,M. Land,4433582,,True,35.0,3,10,2,6,1,4,2,2,2,1,3,1,2,0,1,1,9
401371574,St. Francis (PA) Red Flash,R. Dixon-Conover,4398016,,True,33.0,6,13,6,12,0,1,5,6,0,8,8,3,2,0,1,3,17
401371574,St. Francis (PA) Red Flash,J. Cohen,4593120,,False,13.0,1,1,1,1,0,0,2,4,1,0,1,0,0,0,3,3,4
401371574,St. Francis (PA) Red Flash,M. Hargis,4398054,,False,7.0,1,3,1,2,0,1,2,2,0,0,0,0,0,0,0,1,4
401371574,St. Francis (PA) Red Flash,Z. Harrison,4703193,,False,15.0,0,3,0,3,0,0,3,4,0,0,0,3,1,0,1,1,3
401371574,St. Francis (PA) Red Flash,B. McCabe,4593119,,False,2.0,0,0,0,0,0,0,0,0,1,0,1,0,0,0,0,1,0
401371574,St. Francis (PA) Red Flash,TEAM,TOTAL,TOTAL,False,,23,61,22,52,1,9,25,33,15,29,44,8,7,2,15,20,72
401371574,George Washington Revolutionaries,R. Lindo Jr.,4397186,,True,26.0,5,9,4,7,1,2,6,8,2,7,9,0,3,6,3,4,17
401371574,George Washington Revolutionaries,N. Brown,4700963,,True,17.0,1,3,1,3,0,0,1,2,3,3,6,0,0,0,1,4,3
401371574,George Washington Revolutionaries,J. Bamisile,4432537,,True,28.0,8,16,7,11,1,5,3,5,0,5,5,3,2,3,2,3,20
401371574,George Washington Revolutionaries,J. Bishop,4431770,,True,36.0,2,13,0,4,2,9,2,2,1,2,3,1,0,0,3,2,8
401371574,George Washington Revolutionaries,B. Adams,4396612,,True,35.0,6,11,2,5,4,6,6,7,1,4,5,3,0,0,2,1,22
401371574,George Washington Revolutionaries,H. Dean,4593273,,False,10.0,0,2,0,2,0,0,0,2,1,0,1,0,0,0,0,4,0
401371574,George Washington Revolutionaries,Q. Samuels,4592251,,False,6.0,0,1,0,0,0,1,0,0,0,1,1,0,0,0,0,1,0
401371574,George Washington Revolutionaries,B. Freeman,4613126,,False,13.0,1,3,1,3,0,0,0,0,0,0,0,2,1,0,3,3,2
401371574,George Washington Revolutionaries,A. Harris,4397216,,False,29.0,1,4,0,3,1,1,0,0,1,5,6,5,2,0,1,1,3
401371574,George Washington Revolutionaries,TEAM,TOTAL,TOTAL,False,,24,62,15,38,9,24,18,26,13,28,41,14,8,9,15,24,75
401371573,George Mason Patriots,J. Oduro,4432068,,True,20.0,4,7,4,7,0,0,0,0,1,2,3,2,2,0,4,4,8
401371573,George Mason Patriots,X. Johnson,4592439,,True,29.0,1,3,1,2,0,1,1,2,0,1,1,6,0,0,0,1,3
401371573,George Mason Patriots,D. Gaines,4431961,,True,28.0,3,5,2,3,1,2,2,2,3,2,5,2,1,2,0,0,9
401371573,George Mason Patriots,D. Cooper,4279876,,True,28.0,6,10,1,3,5,7,1,1,0,1,1,0,1,0,0,2,18
401371573,George Mason Patriots,D. Schwartz,4278501,,True,34.0,5,14,2,5,3,9,2,2,1,2,3,2,0,0,0,1,15
401371573,George Mason Patriots,B. Jones,4897083,,False,4.0,0,0,0,0,0,0,0,0,0,0,0,0,0,0,0,0,0
401371573,George Mason Patriots,M. Henry,4606836,,False,10.0,0,0,0,0,0,0,0,0,1,5,6,1,0,1,0,1,0
401371573,George Mason Patriots,O. Frazier III,4700882,,False,9.0,1,2,1,1,0,1,1,2,0,3,3,0,1,1,0,1,3
401371573,George Mason Patriots,T. Gadsden,4719466,,False,4.0,0,0,0,0,0,0,0,0,0,0,0,0,0,0,1,1,0
401371573,George Mason Patriots,M. Gray,4710354,,False,4.0,0,2,0,0,0,2,0,0,0,0,0,1,1,0,0,1,0
401371573,George Mason Patriots,R. Polite III,4567711,,False,20.0,3,9,3,5,0,4,0,0,0,3,3,2,1,1,1,0,6
401371573,George Mason Patriots,J. Hartwell II,4396817,,False,10.0,2,3,1,1,1,2,0,0,0,0,0,1,0,0,1,2,5
401371573,George Mason Patriots,TEAM,TOTAL,TOTAL,False,,25,55,15,27,10,28,7,9,8,21,29,17,7,5,7,14,67
401371573,American University Eagles,J. O'Neil,4702481,,True,32.0,5,8,3,4,2,4,3,4,3,4,7,1,0,1,5,1,15
401371573,American University Eagles,C. Nelson,4593072,,True,31.0,1,8,0,2,1,6,1,2,0,4,4,2,0,1,0,1,4
401371573,American University Eagles,J. Alexander,4397585,,True,19.0,2,3,2,3,0,0,0,0,0,1,1,0,0,0,4,2,4
401371573,American University Eagles,C. Smalls,4433245,,True,25.0,1,5,1,4,0,1,0,0,1,2,3,0,1,0,2,0,2
401371573,American University Eagles,S. Beckton Jr.,4280025,,True,31.0,4,10,4,8,0,2,1,2,0,0,0,0,0,1,3,2,9
401371573,American University Eagles,C. Lorng,4702480,,False,1.0,0,0,0,0,0,0,0,0,0,0,0,0,0,0,0,0,0
401371573,American University Eagles,E. Stephens,4897139,,False,19.0,2,2,2,2,0,0,0,0,0,1,1,1,1,0,0,3,4
401371573,American University Eagles,L. Donadio,4702478,,False,5.0,0,1,0,0,0,1,0,0,0,0,0,0,0,0,1,0,0
401371573,American University Eagles,L. Ball,4700962,,False,7.0,1,3,1,1,0,2,0,0,0,1,1,0,0,0,0,1,2
401371573,American University Eagles,J. Knotek,4398212,,False,8.0,0,0,0,0,0,0,0,0,0,1,1,0,0,0,0,0,0
401371573,American University Eagles,C. Sutton,4397586,,False,1.0,0,0,0,0,0,0,0,0,0,0,0,0,0,0,0,0,0
401371573,American University Eagles,M. Bragg,4280027,,False,21.0,0,2,0,2,0,0,4,4,1,5,6,0,0,0,0,2,4
401371573,American University Eagles,TEAM,TOTAL,TOTAL,False,,16,42,13,26,3,16,9,12,7,23,30,4,2,3,17,12,44
401371572,Georgia Bulldogs,N. Baumann,4278713,,True,21.0,3,6,0,1,3,5,2,3,0,3,3,1,1,0,0,1,11
401371572,Georgia Bulldogs,B. Bridges,4593259,,True,29.0,3,4,3,4,0,0,7,9,2,5,7,3,0,1,4,3,13
401371572,Georgia Bulldogs,C. Wright,4896464,,True,21.0,1,7,1,5,0,2,5,6,1,3,4,0,0,0,1,4,7
401371572,Georgia Bulldogs,K. Oquendo,4896463,,True,28.0,3,12,3,8,0,4,2,3,2,3,5,0,0,0,2,3,8
401371572,Georgia Bulldogs,A. Cook,4067063,,True,33.0,2,10,2,6,0,4,0,0,0,1,1,5,2,0,1,2,4
401371572,Georgia Bulldogs,D. Ridgnal,4896465,,False,17.0,2,6,0,3,2,3,0,0,0,7,7,0,0,0,0,1,6
401371572,Georgia Bulldogs,T. McMillan,4702886,,False,7.0,0,0,0,0,0,0,0,0,0,0,0,0,0,0,0,0,0
401371572,Georgia Bulldogs,J. Etter,4594269,,False,22.0,3,5,2,3,1,2,2,2,2,3,5,3,1,0,2,2,9
401371572,Georgia Bulldogs,J. Abdur-Rahim,4432191,,False,22.0,3,9,0,0,3,9,0,0,0,1,1,1,0,0,2,2,9
401371572,Georgia Bulldogs,TEAM,TOTAL,TOTAL,False,,20,59,11,30,9,29,18,23,11,27,38,13,4,1,12,18,67
401371572,George Mason Patriots,J. Oduro,4432068,,True,35.0,7,14,7,13,0,1,6,8,0,11,11,2,0,6,1,3,20
401371572,George Mason Patriots,X. Johnson,4592439,,True,33.0,0,3,0,1,0,2,6,8,0,7,7,9,0,0,3,3,6
401371572,George Mason Patriots,D. Gaines,4431961,,True,19.0,5,7,3,3,2,4,1,2,1,2,3,1,1,0,1,5,13
401371572,George Mason Patriots,D. Cooper,4279876,,True,33.0,4,9,2,4,2,5,0,0,0,2,2,6,0,0,1,2,10
401371572,George Mason Patriots,D. Schwartz,4278501,,True,38.0,8,14,3,4,5,10,0,0,0,5,5,3,2,0,2,2,21
401371572,George Mason Patriots,B. Jones,4897083,,False,2.0,0,0,0,0,0,0,0,0,0,0,0,0,0,1,0,0,0
401371572,George Mason Patriots,M. Henry,4606836,,False,5.0,0,1,0,1,0,0,0,0,0,0,0,0,0,0,0,1,0
401371572,George Mason Patriots,O. Frazier III,4700882,,False,5.0,0,1,0,0,0,1,0,0,0,2,2,0,0,0,1,0,0
401371572,George Mason Patriots,R. Polite III,4567711,,False,15.0,2,2,2,2,0,0,0,0,0,1,1,1,0,0,0,1,4
401371572,George Mason Patriots,J. Hartwell II,4396817,,False,15.0,2,3,0,0,2,3,0,0,0,0,0,1,1,0,0,0,6
401371572,George Mason Patriots,TEAM,TOTAL,TOTAL,False,,28,54,17,28,11,26,13,18,1,30,31,23,4,7,9,17,80
401371571,Navy Midshipmen,D. Deaver,4593145,,True,19.0,1,3,1,3,0,0,1,2,2,1,3,3,1,0,4,3,3
401371571,Navy Midshipmen,T. Nelson,4593139,,True,26.0,3,6,3,5,0,1,2,2,1,5,6,0,2,0,0,0,8
401371571,Navy Midshipmen,S. Yoder,4433132,,True,31.0,1,4,0,1,1,3,0,0,2,1,3,1,0,0,0,4,3
401371571,Navy Midshipmen,G. Summers,4398149,,True,28.0,6,8,6,8,0,0,0,0,2,3,5,1,1,0,5,3,12
401371571,Navy Midshipmen,J. Carter Jr.,4398147,,True,34.0,5,15,0,5,5,10,6,7,0,4,4,0,1,0,3,2,21
401371571,Navy Midshipmen,J. Walker,4593141,,False,18.0,1,4,0,3,1,1,1,2,0,4,4,0,0,0,0,0,4
401371571,Navy Midshipmen,R. Njoku,4398153,,False,21.0,3,4,3,4,0,0,3,4,1,2,3,2,0,1,0,4,9
401371571,Navy Midshipmen,A. Inge,4702521,,False,9.0,0,2,0,2,0,0,0,0,0,0,0,1,0,0,0,0,0
401371571,Navy Midshipmen,P.J. Roach Jr.,4593142,,False,8.0,1,1,1,1,0,0,0,0,0,0,0,0,0,0,1,2,2
401371571,Navy Midshipmen,C. Silva,4398152,,False,6.0,1,3,0,0,1,3,0,0,0,0,0,0,0,0,0,2,3
401371571,Navy Midshipmen,TEAM,TOTAL,TOTAL,False,,22,50,14,32,8,18,13,17,8,24,32,8,5,1,15,20,65
401371571,George Mason Patriots,J. Oduro,4432068,,True,35.0,11,16,9,12,2,4,8,12,2,5,7,3,2,1,2,2,32
401371571,George Mason Patriots,D. Gaines,4431961,,True,34.0,5,9,3,4,2,5,1,2,3,6,9,2,2,0,1,4,13
401371571,George Mason Patriots,J. Hartwell II,4396817,,True,28.0,2,7,1,6,1,1,0,0,0,2,2,1,1,0,0,1,5
401371571,George Mason Patriots,D. Cooper,4279876,,True,28.0,1,9,1,4,0,5,2,3,0,2,2,2,0,0,3,0,4
401371571,George Mason Patriots,D. Schwartz,4278501,,True,34.0,4,8,3,5,1,3,0,0,1,1,2,3,0,1,2,3,9
401371571,George Mason Patriots,B. Jones,4897083,,False,5.0,0,1,0,1,0,0,0,0,0,1,1,1,0,0,0,0,0
401371571,George Mason Patriots,M. Henry,4606836,,False,8.0,1,1,1,1,0,0,0,2,2,1,3,0,0,0,0,1,2
401371571,George Mason Patriots,O. Frazier III,4700882,,False,18.0,1,2,0,1,1,1,1,2,2,2,4,0,3,0,0,1,4
401371571,George Mason Patriots,M. Gray,4710354,,False,10.0,1,2,1,1,0,1,0,0,0,0,0,2,0,0,0,1,2
401371571,George Mason Patriots,TEAM,TOTAL,TOTAL,False,,26,55,19,35,7,20,12,21,10,20,30,14,8,2,8,13,71
401371570,Old Dominion Monarchs,K. Ezikpe,4397564,,True,26.0,3,6,3,6,0,0,4,5,2,6,8,0,2,3,1,3,10
401371570,Old Dominion Monarchs,M. Long,4431804,,True,40.0,3,9,2,6,1,3,4,4,2,7,9,1,0,1,2,4,11
401371570,Old Dominion Monarchs,A.J. Oliver II,4592878,,True,19.0,1,2,1,1,0,1,0,2,0,1,1,0,1,0,3,5,2
401371570,Old Dominion Monarchs,J. Hunter,4592875,,True,37.0,5,12,4,9,1,3,5,6,1,1,2,2,2,1,2,4,16
401371570,Old Dominion Monarchs,C.J. Keyser,4066455,,True,39.0,6,13,4,10,2,3,5,5,1,4,5,1,1,0,2,2,19
401371570,Old Dominion Monarchs,A. Trice,4397007,,False,14.0,1,3,1,3,0,0,0,0,0,5,5,0,1,1,0,1,2
401371570,Old Dominion Monarchs,D. Stines,4897542,,False,19.0,0,3,0,3,0,0,0,0,0,2,2,0,1,0,0,1,0
401371570,Old Dominion Monarchs,I. Essien,4897541,,False,6.0,0,2,0,2,0,0,0,0,0,0,0,0,0,0,1,0,0
401371570,Old Dominion Monarchs,TEAM,TOTAL,TOTAL,False,,19,50,15,40,4,10,18,22,7,29,36,4,8,6,12,20,60
401371570,George Mason Patriots,J. Oduro,4432068,,True,35.0,5,11,5,9,0,2,4,6,3,9,12,1,0,2,5,4,14
401371570,George Mason Patriots,D. Gaines,4431961,,True,33.0,0,4,0,1,0,3,2,3,4,5,9,1,0,0,1,5,2
401371570,George Mason Patriots,J. Hartwell II,4396817,,True,31.0,4,12,2,5,2,7,0,1,0,1,1,3,0,0,1,1,10
401371570,George Mason Patriots,D. Cooper,4279876,,True,35.0,5,11,2,4,3,7,2,3,0,0,0,0,0,0,1,3,15
401371570,George Mason Patriots,D. Schwartz,4278501,,True,37.0,3,10,2,4,1,6,1,2,1,4,5,1,0,0,3,0,8
401371570,George Mason Patriots,B. Jones,4897083,,False,9.0,0,1,0,0,0,1,0,0,0,1,1,0,0,0,0,1,0
401371570,George Mason Patriots,M. Henry,4606836,,False,5.0,0,0,0,0,0,0,0,2,0,0,0,0,1,0,0,0,0
401371570,George Mason Patriots,B. Buchanan,4395691,,False,1.0,0,0,0,0,0,0,0,0,0,0,0,0,0,0,0,0,0
401371570,George Mason Patriots,T. Gadsden,4719466,,False,3.0,0,1,0,0,0,1,0,0,0,3,3,0,0,0,0,1,0
401371570,George Mason Patriots,M. Gray,4710354,,False,11.0,0,2,0,1,0,1,1,2,1,1,2,1,1,0,1,0,1
401371570,George Mason Patriots,TEAM,TOTAL,TOTAL,False,,17,52,11,24,6,28,10,19,11,25,36,7,2,2,13,16,50
401371115,Yale Bulldogs,I. Kelly,4398015,,True,20.0,3,4,3,4,0,0,2,3,2,2,4,0,0,0,1,5,8
401371115,Yale Bulldogs,M. Cotton,4398012,,True,33.0,8,15,3,5,5,10,2,2,0,7,7,2,0,0,0,1,23
401371115,Yale Bulldogs,E. Dike,4398011,,True,6.0,0,1,0,1,0,0,0,0,0,1,1,0,0,0,0,1,0
401371115,Yale Bulldogs,A. Swain,4279697,,True,32.0,5,13,2,7,3,6,4,4,1,1,2,4,1,0,1,1,17
401371115,Yale Bulldogs,J. Gabbidon,4279696,,True,23.0,3,6,3,5,0,1,7,8,0,1,1,2,1,0,2,4,13
401371115,Yale Bulldogs,Y. Basa-Ama,4898247,,False,17.0,4,5,4,4,0,1,0,0,0,2,2,1,0,1,3,4,8
401371115,Yale Bulldogs,M. Knowling,4898246,,False,11.0,1,1,1,1,0,0,0,0,1,2,3,1,1,0,2,1,2
401371115,Yale Bulldogs,L. Kolaja,4898245,,False,1.0,0,0,0,0,0,0,0,0,0,0,0,0,0,0,0,0,0
401371115,Yale Bulldogs,J. Molloy,4898244,,False,12.0,3,5,3,4,0,1,2,2,0,0,0,0,0,0,1,4,8
401371115,Yale Bulldogs,Y. Gharram,4898248,,False,1.0,0,0,0,0,0,0,0,0,0,0,0,0,0,0,1,0,0
401371115,Yale Bulldogs,E. Buyukhanli,4898240,,False,1.0,0,0,0,0,0,0,0,0,0,0,0,0,1,0,0,0,0
401371115,Yale Bulldogs,J. Poulakidas,4898238,,False,1.0,1,2,1,1,0,1,0,0,0,0,0,0,0,0,0,0,2
401371115,Yale Bulldogs,B. Mbeng,4898237,,False,2.0,0,1,0,1,0,0,0,0,1,1,2,0,0,0,0,0,0
401371115,Yale Bulldogs,A. Mahoney,4593361,,False,27.0,3,4,2,3,1,1,0,0,0,7,7,2,0,0,1,3,7
401371115,Yale Bulldogs,M. Feinberg,4398013,,False,13.0,1,2,1,2,0,0,1,1,0,3,3,2,0,0,0,0,3
401371115,Yale Bulldogs,TEAM,TOTAL,TOTAL,False,,32,59,23,38,9,21,18,20,5,27,32,14,4,1,13,24,91
401371115,Massachusetts Minutemen,D. Dominguez,4701126,,True,22.0,1,8,0,2,1,6,0,2,1,2,3,0,0,3,1,3,3
401371115,Massachusetts Minutemen,T. Buttrick,4277981,,True,17.0,3,4,2,2,1,2,4,4,1,3,4,1,2,0,2,4,11
401371115,Massachusetts Minutemen,T.J. Weeks,4433108,,True,26.0,1,6,1,3,0,3,1,1,2,2,4,1,2,0,0,1,3
401371115,Massachusetts Minutemen,N. Fernandes,4431791,,True,25.0,4,12,3,8,1,4,4,4,0,5,5,2,1,0,1,2,13
401371115,Massachusetts Minutemen,R. Kelly,4279741,,True,24.0,3,8,0,3,3,5,2,2,1,1,2,1,0,0,3,0,11
401371115,Massachusetts Minutemen,D. Walker,4399103,,False,5.0,0,0,0,0,0,0,2,6,1,1,2,0,0,0,0,0,2
401371115,Massachusetts Minutemen,G. Jones,4279211,,False,20.0,3,5,2,3,1,2,2,4,6,4,10,1,1,0,2,2,9
401371115,Massachusetts Minutemen,R. Marcus,4701129,,False,1.0,0,0,0,0,0,0,0,0,0,0,0,0,0,0,0,0,0
401371115,Massachusetts Minutemen,C. McCrory,4701127,,False,15.0,1,2,0,1,1,1,3,4,0,2,2,0,0,0,1,1,6
401371115,Massachusetts Minutemen,J. Garcia,4701125,,False,21.0,2,8,2,6,0,2,0,0,0,2,2,0,1,1,0,2,4
401371115,Massachusetts Minutemen,K. Mitchell,4592454,,False,9.0,0,0,0,0,0,0,1,2,0,0,0,1,1,0,1,2,1
401371115,Massachusetts Minutemen,C.J. Kelly,4398208,,False,15.0,2,4,0,1,2,3,2,4,0,2,2,1,1,0,2,2,8
401371115,Massachusetts Minutemen,TEAM,TOTAL,TOTAL,False,,20,57,10,29,10,28,21,33,12,24,36,8,9,4,13,19,71
401371111,Pennsylvania Quakers,M. Martz,4593353,,True,29.0,2,13,2,6,0,7,2,2,2,4,6,1,0,1,0,0,6
401371111,Pennsylvania Quakers,M. Wang,4397983,,True,8.0,1,3,1,2,0,1,0,0,0,0,0,2,0,0,1,1,2
401371111,Pennsylvania Quakers,J. Dingle,4593351,,True,37.0,4,12,0,3,4,9,2,4,1,3,4,3,1,0,4,2,14
401371111,Pennsylvania Quakers,B. Washington,4397982,,True,4.0,0,0,0,0,0,0,0,0,0,0,0,0,0,0,1,0,0
401371111,Pennsylvania Quakers,J. Williams,4279561,,True,27.0,5,9,4,5,1,4,0,0,0,2,2,2,3,0,2,4,11
401371111,Pennsylvania Quakers,M. Moshkovitz,4702956,,False,36.0,5,11,4,9,1,2,2,2,3,5,8,6,2,0,0,1,13
401371111,Pennsylvania Quakers,L. Monroe,4593352,,False,8.0,0,0,0,0,0,0,0,0,0,2,2,0,0,0,1,0,0
401371111,Pennsylvania Quakers,G. Smith,4898227,,False,22.0,3,4,1,2,2,2,2,4,0,1,1,1,0,0,0,2,10
401371111,Pennsylvania Quakers,J. Charles,4593350,,False,29.0,6,10,0,1,6,9,0,0,0,6,6,1,0,0,0,0,18
401371111,Pennsylvania Quakers,TEAM,TOTAL,TOTAL,False,,26,62,12,28,14,34,8,12,10,24,34,16,6,1,9,10,74
401371111,La Salle Explorers,C. Moore,4277945,,True,35.0,5,9,5,9,0,0,3,3,1,5,6,2,0,3,0,2,13
401371111,La Salle Explorers,J. Brickus,4700970,,True,35.0,5,9,2,4,3,5,0,0,0,4,4,4,0,1,2,1,13
401371111,La Salle Explorers,A. Gill,4700969,,True,23.0,5,6,5,6,0,0,2,2,0,1,1,7,3,0,1,4,12
401371111,La Salle Explorers,C. Ray,4592448,,True,34.0,4,7,2,3,2,4,0,0,2,5,7,3,1,0,1,0,10
401371111,La Salle Explorers,J. Nickelberry,4432845,,True,30.0,5,13,1,4,4,9,1,2,0,2,2,0,0,0,2,1,15
401371111,La Salle Explorers,M. Doucoure,4277988,,False,2.0,0,0,0,0,0,0,0,0,0,0,0,0,0,0,0,1,0
401371111,La Salle Explorers,J. Clark,4397152,,False,15.0,1,5,1,3,0,2,0,0,1,2,3,0,0,0,0,1,2
401371111,La Salle Explorers,D. Shepherd,4710357,,False,6.0,2,2,1,1,1,1,0,2,1,0,1,0,0,0,1,0,5
401371111,La Salle Explorers,K. Brantley,4709132,,False,4.0,1,2,1,2,0,0,0,0,0,0,0,0,0,0,0,0,2
401371111,La Salle Explorers,S. Kenney,4431790,,False,16.0,1,5,1,3,0,2,2,2,1,4,5,3,0,0,1,1,4
401371111,La Salle Explorers,TEAM,TOTAL,TOTAL,False,,29,58,19,35,10,23,8,11,6,26,32,19,4,4,9,11,76
401371110,Saint Joseph's Hawks,T. Funk,4278395,,True,39.0,2,10,0,3,2,7,0,0,2,7,9,2,0,0,0,1,6
401371110,Saint Joseph's Hawks,E. Obinna,4278125,,True,35.0,9,13,9,13,0,0,2,4,5,4,9,0,1,1,1,4,20
401371110,Saint Joseph's Hawks,J. Hall,4701031,,True,40.0,12,19,4,8,8,11,1,1,0,4,4,7,1,0,4,0,33
401371110,Saint Joseph's Hawks,E. Reynolds II,4683952,,True,34.0,3,10,2,5,1,5,3,4,0,2,2,3,0,1,2,1,10
401371110,Saint Joseph's Hawks,C. Brown,4592476,,True,20.0,2,7,1,4,1,3,0,0,0,1,1,2,0,0,2,1,5
401371110,Saint Joseph's Hawks,A. Jansson,4701029,,False,4.0,0,0,0,0,0,0,0,0,0,1,1,0,0,1,0,1,0
401371110,Saint Joseph's Hawks,J. Forrest,4701032,,False,22.0,2,5,2,2,0,3,0,0,0,6,6,1,0,0,0,2,4
401371110,Saint Joseph's Hawks,D. Bishop,4701028,,False,6.0,0,0,0,0,0,0,0,0,0,1,1,0,0,0,0,0,0
401371110,Saint Joseph's Hawks,TEAM,TOTAL,TOTAL,False,,30,64,18,35,12,29,6,9,12,26,38,15,2,3,9,10,78
401371110,Pennsylvania Quakers,M. Martz,4593353,,True,35.0,5,8,3,3,2,5,0,0,2,3,5,2,1,0,0,3,12
401371110,Pennsylvania Quakers,L. Monroe,4593352,,True,34.0,5,12,5,8,0,4,2,2,1,6,7,2,1,1,2,2,12
401371110,Pennsylvania Quakers,M. Wang,4397983,,True,23.0,4,14,4,9,0,5,0,0,0,3,3,4,0,0,0,2,8
401371110,Pennsylvania Quakers,J. Dingle,4593351,,True,38.0,11,19,9,15,2,4,2,2,0,5,5,1,2,0,3,0,26
401371110,Pennsylvania Quakers,J. Williams,4279561,,True,21.0,1,2,1,2,0,0,0,0,0,2,2,2,0,0,0,0,2
401371110,Pennsylvania Quakers,M. Moshkovitz,4702956,,False,13.0,0,2,0,1,0,1,0,0,1,1,2,3,0,0,1,0,0
401371110,Pennsylvania Quakers,G. Smith,4898227,,False,25.0,2,4,1,1,1,3,1,2,1,0,1,3,0,0,0,3,6
401371110,Pennsylvania Quakers,J. Charles,4593350,,False,9.0,1,2,0,0,1,2,2,2,1,1,2,0,0,0,0,0,5
401371110,Pennsylvania Quakers,B. Washington,4397982,,False,2.0,0,1,0,1,0,0,0,0,1,0,1,0,0,0,0,0,0
401371110,Pennsylvania Quakers,TEAM,TOTAL,TOTAL,False,,29,64,23,40,6,24,7,8,9,21,30,17,4,1,7,10,71
401371103,Pennsylvania Quakers,L. Monroe,4593352,,True,23.0,1,2,1,2,0,0,0,0,2,2,4,1,0,1,2,4,2
401371103,Pennsylvania Quakers,M. Lorca-Lloyd,4431800,,True,15.0,0,2,0,2,0,0,0,0,0,4,4,0,1,2,2,2,0
401371103,Pennsylvania Quakers,J. Dingle,4593351,,True,35.0,7,22,6,14,1,8,5,7,1,3,4,5,2,0,3,0,20
401371103,Pennsylvania Quakers,J. Charles,4593350,,True,32.0,6,12,0,0,6,12,0,0,0,1,1,1,0,0,0,2,18
401371103,Pennsylvania Quakers,J. Williams,4279561,,True,25.0,3,9,1,6,2,3,0,0,1,5,6,2,0,0,1,2,8
401371103,Pennsylvania Quakers,N. Spinoso,4898224,,False,18.0,2,3,2,3,0,0,0,0,1,3,4,2,0,0,2,4,4
401371103,Pennsylvania Quakers,M. Moshkovitz,4702956,,False,11.0,2,2,0,0,2,2,0,0,0,2,2,2,0,0,1,0,6
401371103,Pennsylvania Quakers,M. Wang,4397983,,False,13.0,2,4,2,3,0,1,0,0,0,1,1,0,0,0,1,1,4
401371103,Pennsylvania Quakers,G. Smith,4898227,,False,6.0,0,0,0,0,0,0,0,0,0,0,0,0,0,0,1,0,0
401371103,Pennsylvania Quakers,E. Holland III,4898226,,False,4.0,0,2,0,2,0,0,0,0,0,0,0,0,1,0,0,0,0
401371103,Pennsylvania Quakers,C. Slajchert,4702954,,False,18.0,1,4,1,3,0,1,2,2,0,0,0,1,0,0,1,3,4
401371103,Pennsylvania Quakers,TEAM,TOTAL,TOTAL,False,,24,62,13,35,11,27,7,9,5,21,26,14,4,3,14,18,66
401371103,George Mason Patriots,J. Oduro,4432068,,True,31.0,9,14,9,11,0,3,2,4,2,6,8,0,2,1,2,1,20
401371103,George Mason Patriots,X. Johnson,4592439,,True,31.0,5,6,4,5,1,1,1,1,0,9,9,7,3,0,4,2,12
401371103,George Mason Patriots,D. Gaines,4431961,,True,22.0,2,4,1,3,1,1,2,4,1,5,6,1,0,2,1,3,7
401371103,George Mason Patriots,D. Cooper,4279876,,True,31.0,4,9,3,5,1,4,3,4,0,0,0,1,0,0,4,3,12
401371103,George Mason Patriots,D. Schwartz,4278501,,True,30.0,5,9,1,2,4,7,4,4,0,3,3,1,1,2,0,0,18
401371103,George Mason Patriots,B. Jones,4897083,,False,12.0,1,2,0,0,1,2,0,0,0,0,0,0,1,0,0,2,3
401371103,George Mason Patriots,M. Henry,4606836,,False,10.0,1,2,1,2,0,0,1,2,0,3,3,0,1,2,0,2,3
401371103,George Mason Patriots,J. Kabimba,4592303,,False,3.0,0,0,0,0,0,0,0,0,0,0,0,0,0,0,0,0,0
401371103,George Mason Patriots,T. Gadsden,4719466,,False,3.0,0,0,0,0,0,0,0,0,0,1,1,0,1,0,1,0,0
401371103,George Mason Patriots,M. Gray,4710354,,False,9.0,0,1,0,0,0,1,0,0,0,1,1,1,0,0,1,0,0
401371103,George Mason Patriots,J. Hartwell II,4396817,,False,18.0,4,8,0,1,4,7,0,0,0,2,2,2,0,0,1,1,12
401371103,George Mason Patriots,TEAM,TOTAL,TOTAL,False,,31,55,19,29,12,26,13,19,3,30,33,13,9,7,14,14,87
401371098,Massachusetts Minutemen,G. Jones,4279211,,True,35.0,2,5,1,2,1,3,1,1,1,3,4,4,1,0,1,3,6
401371098,Massachusetts Minutemen,T. Buttrick,4277981,,True,24.0,1,6,1,3,0,3,2,2,0,4,4,0,0,0,3,1,4
401371098,Massachusetts Minutemen,N. Fernandes,4431791,,True,37.0,9,17,3,8,6,9,0,1,3,4,7,9,0,1,3,3,24
401371098,Massachusetts Minutemen,C.J. Kelly,4398208,,True,26.0,5,6,2,2,3,4,3,3,1,7,8,1,0,0,4,1,16
401371098,Massachusetts Minutemen,R. Kelly,4279741,,True,29.0,2,4,1,2,1,2,5,6,0,0,0,6,1,0,3,0,10
401371098,Massachusetts Minutemen,D. Dominguez,4701126,,False,2.0,0,0,0,0,0,0,0,0,0,0,0,0,0,0,1,0,0
401371098,Massachusetts Minutemen,M. Steadman,4397393,,False,18.0,2,3,2,3,0,0,2,2,0,5,5,0,0,2,2,4,6
401371098,Massachusetts Minutemen,K. Mitchell,4592454,,False,1.0,0,0,0,0,0,0,0,0,0,0,0,0,0,0,0,0,0
401371098,Massachusetts Minutemen,T.J. Weeks,4433108,,False,28.0,7,13,3,5,4,8,3,3,3,5,8,0,1,0,0,1,21
401371098,Massachusetts Minutemen,TEAM,TOTAL,TOTAL,False,,28,54,13,25,15,29,16,18,12,29,41,20,3,3,17,13,87
401371098,Harvard Crimson,C. Ledlum,4431728,,True,32.0,9,20,8,16,1,4,1,3,2,4,6,2,0,0,1,3,20
401371098,Harvard Crimson,L. Lesmond,4898222,,True,36.0,3,11,0,1,3,10,0,0,1,0,1,3,3,1,0,2,9
401371098,Harvard Crimson,L. Sakota,4593336,,True,34.0,6,13,3,5,3,8,0,0,0,1,1,2,0,1,1,2,15
401371098,Harvard Crimson,I. Tretout,4432930,,True,35.0,6,11,4,7,2,4,0,1,0,5,5,2,1,2,1,2,14
401371098,Harvard Crimson,N. Kirkwood,4397968,,True,31.0,7,12,6,8,1,4,1,1,0,2,2,6,2,0,3,5,16
401371098,Harvard Crimson,J. Hemmings,4702959,,False,4.0,0,0,0,0,0,0,0,0,0,0,0,1,0,0,0,2,0
401371098,Harvard Crimson,S. Silverstein,4702961,,False,16.0,1,1,0,0,1,1,0,0,3,0,3,0,0,0,0,2,3
401371098,Harvard Crimson,D. Wojcik,4610138,,False,11.0,0,1,0,0,0,1,0,0,0,1,1,1,0,0,0,0,0
401371098,Harvard Crimson,S. Freedman,4397969,,False,1.0,0,1,0,0,0,1,0,0,0,0,0,0,0,0,0,0,0
401371098,Harvard Crimson,TEAM,TOTAL,TOTAL,False,,32,70,21,37,11,33,2,5,11,16,27,17,6,4,6,18,77
401371097,Rhode Island Rams,Makhel Mitchell,4431777,,True,32.0,6,10,6,8,0,2,1,2,0,7,7,1,2,1,3,2,13
401371097,Rhode Island Rams,Makhi Mitchell,4431708,,True,14.0,2,4,2,4,0,0,0,0,0,2,2,1,1,0,4,5,4
401371097,Rhode Island Rams,J. Sheppard,4066445,,True,20.0,0,4,0,2,0,2,0,1,0,1,1,3,0,0,1,2,0
401371097,Rhode Island Rams,I. Leggett,4606837,,True,34.0,4,6,3,5,1,1,7,8,3,1,4,2,0,0,3,1,16
401371097,Rhode Island Rams,I. El-Amin,4279313,,True,28.0,3,7,3,6,0,1,1,1,0,5,5,1,1,0,2,1,7
401371097,Rhode Island Rams,A. Walker,4278567,,False,20.0,3,6,3,3,0,3,3,4,2,3,5,0,1,1,3,2,9
401371097,Rhode Island Rams,M. Martin,4397470,,False,32.0,5,9,4,4,1,5,2,2,3,6,9,1,0,3,2,1,13
401371097,Rhode Island Rams,S. Thomas,4897065,,False,20.0,0,1,0,1,0,0,2,2,0,3,3,3,2,0,0,3,2
401371097,Rhode Island Rams,TEAM,TOTAL,TOTAL,False,,23,47,21,33,2,14,16,20,9,33,42,12,7,5,19,17,64
401371097,Harvard Crimson,K. Catchings,4397971,,True,30.0,4,5,2,2,2,3,0,2,1,1,2,0,1,0,0,4,10
401371097,Harvard Crimson,C. Ledlum,4431728,,True,32.0,4,14,4,11,0,3,3,4,8,5,13,2,2,0,2,4,11
401371097,Harvard Crimson,L. Sakota,4593336,,True,28.0,3,12,2,6,1,6,1,2,0,1,1,1,2,0,0,0,8
401371097,Harvard Crimson,I. Tretout,4432930,,True,17.0,0,3,0,2,0,1,0,0,1,0,1,0,0,0,2,0,0
401371097,Harvard Crimson,N. Kirkwood,4397968,,True,36.0,5,12,5,8,0,4,1,2,1,3,4,5,3,1,4,4,11
401371097,Harvard Crimson,J. Hemmings,4702959,,False,3.0,0,0,0,0,0,0,0,0,0,0,0,0,0,0,1,1,0
401371097,Harvard Crimson,L. Lesmond,4898222,,False,24.0,5,14,0,0,5,14,0,0,0,1,1,1,1,0,1,1,15
401371097,Harvard Crimson,S. Silverstein,4702961,,False,15.0,0,1,0,1,0,0,2,2,0,2,2,1,0,0,0,3,2
401371097,Harvard Crimson,D. Wojcik,4610138,,False,9.0,0,0,0,0,0,0,0,0,0,1,1,2,0,0,2,1,0
401371097,Harvard Crimson,S. Freedman,4397969,,False,6.0,0,2,0,0,0,2,0,1,0,1,1,0,0,0,1,0,0
401371097,Harvard Crimson,TEAM,TOTAL,TOTAL,False,,21,63,13,30,8,33,7,13,14,15,29,12,9,1,13,18,57
401371089,James Madison Dukes,J. Amadi,4702765,,True,19.0,1,1,1,1,0,0,0,0,4,2,6,0,3,0,1,2,2
401371089,James Madison Dukes,J. Wooden,4433127,,True,26.0,3,5,3,3,0,2,1,1,2,5,7,1,0,0,1,4,7
401371089,James Madison Dukes,V. Morse,4397972,,True,28.0,3,13,1,6,2,7,6,6,0,1,1,3,1,0,4,2,14
401371089,James Madison Dukes,T. Molson,4279481,,True,32.0,7,16,5,11,2,5,3,6,0,5,5,2,4,0,4,1,19
401371089,James Madison Dukes,C. Falden,4279060,,True,33.0,1,7,1,4,0,3,0,0,0,5,5,1,2,0,3,2,2
401371089,James Madison Dukes,A. Sule,4280279,,False,20.0,4,9,2,6,2,3,0,1,1,6,7,2,1,1,1,2,10
401371089,James Madison Dukes,T. Strickland,4702767,,False,12.0,0,0,0,0,0,0,2,2,1,1,2,1,2,0,2,2,2
401371089,James Madison Dukes,T. Edwards,4702766,,False,8.0,0,0,0,0,0,0,2,2,0,0,0,3,0,0,3,3,2
401371089,James Madison Dukes,J. Hodge,4397575,,False,22.0,3,4,0,0,3,4,0,0,0,1,1,0,0,0,1,1,9
401371089,James Madison Dukes,TEAM,TOTAL,TOTAL,False,,22,55,13,31,9,24,14,18,11,28,39,13,13,1,20,19,67
401371089,George Mason Patriots,J. Oduro,4432068,,True,28.0,4,11,3,7,1,4,0,3,3,3,6,0,0,0,2,5,9
401371089,George Mason Patriots,X. Johnson,4592439,,True,35.0,5,10,1,3,4,7,0,1,0,5,5,3,2,0,4,2,14
401371089,George Mason Patriots,D. Gaines,4431961,,True,34.0,6,11,2,5,4,6,3,3,3,8,11,1,0,0,2,3,19
401371089,George Mason Patriots,D. Cooper,4279876,,True,34.0,1,8,0,2,1,6,3,4,1,3,4,3,0,0,5,0,6
401371089,George Mason Patriots,D. Schwartz,4278501,,True,34.0,2,10,1,5,1,5,2,2,1,2,3,4,1,2,2,4,7
401371089,George Mason Patriots,B. Jones,4897083,,False,7.0,1,2,0,0,1,2,0,0,1,0,1,0,0,0,0,1,3
401371089,George Mason Patriots,M. Henry,4606836,,False,14.0,3,3,3,3,0,0,0,0,2,1,3,0,3,0,3,3,6
401371089,George Mason Patriots,O. Frazier III,4700882,,False,1.0,0,0,0,0,0,0,0,0,0,0,0,0,0,0,0,0,0
401371089,George Mason Patriots,J. Hartwell II,4396817,,False,13.0,0,3,0,0,0,3,0,0,1,1,2,3,1,0,3,1,0
401371089,George Mason Patriots,TEAM,TOTAL,TOTAL,False,,22,58,10,25,12,33,8,13,12,25,37,14,7,2,21,19,64
401371088,Maryland Terrapins,Q. Wahab,4431739,,True,16.0,3,4,3,4,0,0,2,4,2,3,5,0,0,0,0,0,8
401371088,Maryland Terrapins,D. Scott,4432852,,True,33.0,7,12,4,7,3,5,1,1,2,8,10,0,1,1,3,3,18
401371088,Maryland Terrapins,H. Hart,4431984,,True,21.0,1,3,1,1,0,2,0,0,0,1,1,4,1,0,1,2,2
401371088,Maryland Terrapins,E. Ayala,4397184,,True,35.0,6,17,1,5,5,12,0,0,1,3,4,4,1,0,1,1,17
401371088,Maryland Terrapins,F. Russell,4278371,,True,31.0,1,7,1,4,0,3,0,2,0,0,0,6,0,0,2,2,2
401371088,Maryland Terrapins,J. Reese,4683742,,False,24.0,4,4,3,3,1,1,3,4,1,2,3,0,0,1,3,0,12
401371088,Maryland Terrapins,S. Wright,4279202,,False,2.0,0,0,0,0,0,0,0,0,0,1,1,0,0,0,0,0,0
401371088,Maryland Terrapins,I. Martinez,4601026,,False,24.0,2,5,2,2,0,3,1,2,0,2,2,1,3,2,0,5,5
401371088,Maryland Terrapins,X. Green,4067031,,False,15.0,1,3,1,1,0,2,0,0,0,1,1,1,0,0,0,0,2
401371088,Maryland Terrapins,TEAM,TOTAL,TOTAL,False,,25,55,16,27,9,28,7,13,8,22,30,16,6,4,10,13,66
401371088,George Mason Patriots,J. Oduro,4432068,,True,30.0,6,12,6,10,0,2,0,0,1,1,2,1,0,2,3,4,12
401371088,George Mason Patriots,X. Johnson,4592439,,True,28.0,0,6,0,5,0,1,0,0,1,3,4,5,0,0,1,5,0
401371088,George Mason Patriots,D. Gaines,4431961,,True,33.0,4,6,2,3,2,3,4,4,5,5,10,0,1,1,2,1,14
401371088,George Mason Patriots,D. Cooper,4279876,,True,33.0,6,13,3,7,3,6,1,2,0,2,2,5,2,0,2,1,16
401371088,George Mason Patriots,D. Schwartz,4278501,,True,38.0,8,15,2,5,6,10,2,2,1,8,9,0,3,0,3,1,24
401371088,George Mason Patriots,B. Jones,4897083,,False,4.0,1,1,0,0,1,1,0,0,0,0,0,0,0,0,1,2,3
401371088,George Mason Patriots,M. Henry,4606836,,False,10.0,1,2,1,2,0,0,0,0,1,1,2,0,0,1,0,1,2
401371088,George Mason Patriots,O. Frazier III,4700882,,False,2.0,0,0,0,0,0,0,0,0,0,0,0,0,0,0,0,0,0
401371088,George Mason Patriots,J. Hartwell II,4396817,,False,22.0,0,3,0,2,0,1,0,0,0,0,0,2,0,0,0,1,0
401371088,George Mason Patriots,TEAM,TOTAL,TOTAL,False,,26,58,14,34,12,24,7,8,11,25,36,13,6,4,12,16,71
401371087,Morgan State Bears,L. Grantsaan,4593392,,True,30.0,2,5,2,3,0,2,1,1,1,4,5,3,1,0,5,3,5
401371087,Morgan State Bears,D. Ware,4398326,,True,25.0,5,12,1,5,4,7,1,2,1,3,4,0,0,0,1,1,15
401371087,Morgan State Bears,I. Burke,4398199,,True,34.0,5,14,4,9,1,5,0,0,1,3,4,0,1,1,3,4,11
401371087,Morgan State Bears,S. Devonish,4398196,,True,34.0,1,7,1,7,0,0,0,0,0,1,1,0,3,1,1,3,2
401371087,Morgan State Bears,T. Moore,4278218,,True,25.0,0,5,0,2,0,3,2,2,0,2,2,3,1,0,3,5,2
401371087,Morgan State Bears,Ty Horner,4900679,,False,2.0,0,0,0,0,0,0,0,0,0,0,0,0,0,0,0,0,0
401371087,Morgan State Bears,C. Nnamene,4397977,,False,9.0,1,1,1,1,0,0,0,0,2,1,3,0,1,0,1,1,2
401371087,Morgan State Bears,M. Douglas,4278479,,False,6.0,0,1,0,1,0,0,0,0,0,0,0,1,1,0,0,0,0
401371087,Morgan State Bears,W. Thomas,4900680,,False,6.0,1,3,1,3,0,0,0,0,0,1,1,0,0,0,0,0,2
401371087,Morgan State Bears,E. Bowens,4598777,,False,2.0,0,0,0,0,0,0,0,0,0,0,0,1,0,0,0,0,0
401371087,Morgan State Bears,T. Vance,4593390,,False,1.0,0,0,0,0,0,0,0,0,0,1,1,0,0,0,0,0,0
401371087,Morgan State Bears,K. McGee,4397356,,False,26.0,6,13,4,6,2,7,0,0,1,0,1,0,1,0,2,2,14
401371087,Morgan State Bears,TEAM,TOTAL,TOTAL,False,,21,61,14,37,7,24,4,5,7,20,27,8,9,2,17,19,53
401371087,George Mason Patriots,J. Oduro,4432068,,True,26.0,8,9,5,6,3,3,3,4,2,4,6,0,1,3,3,2,22
401371087,George Mason Patriots,X. Johnson,4592439,,True,27.0,0,3,0,1,0,2,2,2,0,6,6,7,2,0,3,0,2
401371087,George Mason Patriots,D. Gaines,4431961,,True,24.0,4,8,2,4,2,4,5,5,4,4,8,2,3,2,1,2,15
401371087,George Mason Patriots,D. Cooper,4279876,,True,23.0,5,12,1,3,4,9,0,0,0,2,2,3,1,0,2,2,14
401371087,George Mason Patriots,D. Schwartz,4278501,,True,27.0,6,13,2,4,4,9,1,2,2,5,7,0,0,0,3,0,17
401371087,George Mason Patriots,B. Jones,4897083,,False,15.0,0,1,0,0,0,1,0,0,0,2,2,1,0,1,0,0,0
401371087,George Mason Patriots,M. Henry,4606836,,False,10.0,2,3,2,3,0,0,0,0,2,3,5,0,0,0,0,2,4
401371087,George Mason Patriots,J. Kabimba,4592303,,False,4.0,0,0,0,0,0,0,0,0,0,0,0,0,0,0,2,1,0
401371087,George Mason Patriots,O. Frazier III,4700882,,False,9.0,4,4,3,3,1,1,0,1,0,3,3,0,1,0,1,0,9
401371087,George Mason Patriots,T. Gadsden,4719466,,False,4.0,0,0,0,0,0,0,1,1,0,1,1,1,0,0,0,0,1
401371087,George Mason Patriots,M. Gray,4710354,,False,9.0,1,1,0,0,1,1,1,2,0,1,1,1,0,0,1,0,4
401371087,George Mason Patriots,J. Hartwell II,4396817,,False,22.0,0,4,0,1,0,3,2,3,0,0,0,3,1,0,0,1,2
401371087,George Mason Patriots,TEAM,TOTAL,TOTAL,False,,30,58,15,25,15,33,15,20,11,33,44,18,9,6,16,10,90
401371085,Long Island University Sharks,T. Flowers,4703209,,True,33.0,3,10,1,1,2,9,0,1,0,6,6,4,0,2,2,2,8
401371085,Long Island University Sharks,E. Penn,4279628,,True,33.0,5,13,4,9,1,4,2,4,2,5,7,3,0,0,6,4,13
401371085,Long Island University Sharks,I. Kante,4278066,,True,35.0,7,8,7,7,0,1,2,3,2,5,7,1,0,1,2,4,16
401371085,Long Island University Sharks,T. Wood,4397160,,True,29.0,3,7,3,5,0,2,0,0,0,0,0,2,0,0,2,1,6
401371085,Long Island University Sharks,A. Rivera,4396570,,True,25.0,1,5,0,1,1,4,0,0,0,5,5,1,0,0,2,0,3
401371085,Long Island University Sharks,J. Cook,4433581,,False,5.0,0,0,0,0,0,0,0,0,0,1,1,0,0,0,0,0,0
401371085,Long Island University Sharks,N. Crawford,4703207,,False,5.0,1,1,0,0,1,1,0,0,0,1,1,0,0,0,0,0,3
401371085,Long Island University Sharks,Q. Burns,4897990,,False,3.0,1,1,0,0,1,1,2,2,0,0,0,0,0,0,1,1,5
401371085,Long Island University Sharks,A. Washington,4897987,,False,12.0,0,3,0,2,0,1,0,0,0,0,0,2,0,1,0,1,0
401371085,Long Island University Sharks,K. Davis,4703205,,False,20.0,1,4,1,3,0,1,1,2,2,2,4,3,1,0,1,2,3
401371085,Long Island University Sharks,TEAM,TOTAL,TOTAL,False,,22,52,16,28,6,24,7,12,7,28,35,16,1,4,16,15,57
401371085,Fordham Rams,A. Tsimbila,4702329,,True,18.0,1,5,1,5,0,0,0,0,3,3,6,0,0,1,3,2,2
401371085,Fordham Rams,C. Ohams,4066856,,True,33.0,9,12,9,11,0,1,2,4,3,8,11,1,1,2,0,1,20
401371085,Fordham Rams,A. Harrison,4897086,,True,14.0,0,3,0,2,0,1,0,0,0,1,1,0,0,0,0,1,0
401371085,Fordham Rams,D. Quisenberry,4397790,,True,35.0,5,14,3,8,2,6,2,2,1,3,4,2,0,0,0,2,14
401371085,Fordham Rams,A. Daye Jr.,4397500,,True,33.0,4,7,2,4,2,3,7,10,1,3,4,5,3,0,1,2,17
401371085,Fordham Rams,P. Kelly,4432014,,False,7.0,0,5,0,0,0,5,0,0,0,0,0,0,1,0,0,0,0
401371085,Fordham Rams,A. Charlton,4897085,,False,25.0,4,8,2,3,2,5,0,0,1,5,6,4,2,0,0,2,10
401371085,Fordham Rams,K. Cunningham,4705891,,False,12.0,0,2,0,0,0,2,0,0,0,1,1,0,0,0,1,1,0
401371085,Fordham Rams,A. Evans,4700881,,False,0.0,0,0,0,0,0,0,0,0,0,0,0,0,0,0,0,0,0
401371085,Fordham Rams,K. Rose,4592315,,False,23.0,4,7,2,3,2,4,0,0,0,0,0,2,3,0,1,0,10
401371085,Fordham Rams,TEAM,TOTAL,TOTAL,False,,27,63,19,36,8,27,11,16,11,26,37,14,10,3,6,11,73
401371084,St. John's Red Storm,E. Nyiwe,4897419,,True,25.0,3,5,2,4,1,1,0,0,1,7,8,2,1,3,0,4,7
401371084,St. John's Red Storm,J. Champagnie,4592479,,True,38.0,7,14,6,11,1,3,1,2,0,8,8,2,3,2,2,3,16
401371084,St. John's Red Storm,D. Addae-Wusu,4590361,,True,33.0,4,7,2,3,2,4,1,2,0,4,4,11,4,0,2,3,11
401371084,St. John's Red Storm,P. Alexander,4433156,,True,38.0,11,16,11,13,0,3,1,4,3,1,4,5,3,1,5,2,23
401371084,St. John's Red Storm,M. Mathis,4397250,,True,33.0,6,10,5,8,1,2,3,4,0,4,4,1,0,0,3,2,16
401371084,St. John's Red Storm,O. Stanley,4703032,,False,7.0,1,3,1,3,0,0,0,0,0,1,1,0,0,0,0,0,2
401371084,St. John's Red Storm,A. Wheeler,4277982,,False,1.0,0,0,0,0,0,0,0,0,0,0,0,0,0,0,0,0,0
401371084,St. John's Red Storm,J. Soriano,4592317,,False,8.0,1,2,1,2,0,0,2,2,1,5,6,0,0,2,1,1,4
401371084,St. John's Red Storm,R. Pinzon,4683951,,False,6.0,0,1,0,0,0,1,0,0,0,0,0,0,1,0,1,1,0
401371084,St. John's Red Storm,S. Smith,4278244,,False,7.0,1,2,1,2,0,0,2,2,0,0,0,0,0,0,0,0,4
401371084,St. John's Red Storm,T. Coburn,4066515,,False,4.0,0,1,0,0,0,1,0,0,0,0,0,0,0,0,1,1,0
401371084,St. John's Red Storm,TEAM,TOTAL,TOTAL,False,,34,61,29,46,5,15,10,16,7,30,37,21,12,8,15,17,83
401371084,Fordham Rams,C. Ohams,4066856,,True,26.0,5,7,4,6,1,1,9,10,1,5,6,1,0,0,5,3,20
401371084,Fordham Rams,A. Charlton,4897085,,True,30.0,3,11,1,5,2,6,0,0,0,4,4,2,1,0,3,5,8
401371084,Fordham Rams,K. Rose,4592315,,True,26.0,0,3,0,0,0,3,0,0,1,3,4,3,4,1,3,0,0
401371084,Fordham Rams,D. Quisenberry,4397790,,True,39.0,5,15,2,7,3,8,3,3,1,6,7,3,1,0,0,0,16
401371084,Fordham Rams,A. Daye Jr.,4397500,,True,29.0,5,12,4,7,1,5,2,2,0,2,2,1,0,0,2,3,13
401371084,Fordham Rams,A. Tsimbila,4702329,,False,4.0,0,0,0,0,0,0,0,0,0,0,0,0,0,0,2,0,0
401371084,Fordham Rams,R. Novitskyi,4897084,,False,8.0,0,0,0,0,0,0,0,0,1,0,1,0,0,0,0,1,0
401371084,Fordham Rams,A. Harrison,4897086,,False,9.0,1,2,1,1,0,1,0,0,0,0,0,0,0,0,0,0,2
401371084,Fordham Rams,K. Cunningham,4705891,,False,11.0,2,6,0,1,2,5,0,0,0,0,0,0,1,0,1,0,6
401371084,Fordham Rams,J. Navarro,4592316,,False,18.0,1,3,0,0,1,3,1,1,1,0,1,2,0,0,1,2,4
401371084,Fordham Rams,TEAM,TOTAL,TOTAL,False,,22,59,12,27,10,32,15,16,7,22,29,12,7,1,18,14,69
401371083,St. Francis Brooklyn Terriers,P. Emilien,4397909,,True,24.0,4,12,4,11,0,1,1,3,0,2,2,3,0,1,3,4,9
401371083,St. Francis Brooklyn Terriers,J. Hemphill,4397633,,True,13.0,0,0,0,0,0,0,0,2,1,4,5,0,0,1,2,4,0
401371083,St. Francis Brooklyn Terriers,T. Wilcox Jr.,4897958,,True,12.0,1,3,0,2,1,1,0,0,1,1,2,0,1,0,2,1,3
401371083,St. Francis Brooklyn Terriers,T. Quartlebaum,4433061,,True,28.0,0,7,0,3,0,4,0,0,0,5,5,3,0,0,1,1,0
401371083,St. Francis Brooklyn Terriers,M. Cubbage,4398412,,True,26.0,5,15,5,13,0,2,3,4,2,7,9,0,4,1,2,4,13
401371083,St. Francis Brooklyn Terriers,M. Egner,4897961,,False,11.0,0,3,0,3,0,0,1,2,1,1,2,1,0,0,0,1,1
401371083,St. Francis Brooklyn Terriers,E. Hardison,4703185,,False,4.0,0,1,0,1,0,0,0,0,0,0,0,0,0,0,1,3,0
401371083,St. Francis Brooklyn Terriers,K. Suurorg,4897966,,False,31.0,1,4,0,2,1,2,0,0,1,1,2,0,1,0,1,2,3
401371083,St. Francis Brooklyn Terriers,M. Gonzalez,4897964,,False,1.0,0,0,0,0,0,0,0,0,0,1,1,0,0,0,0,0,0
401371083,St. Francis Brooklyn Terriers,B. Haidara,4592440,,False,21.0,2,6,2,5,0,1,0,2,3,2,5,0,2,0,1,2,4
401371083,St. Francis Brooklyn Terriers,L. Moreno,4398007,,False,29.0,4,12,2,6,2,6,3,4,1,2,3,0,1,0,1,0,13
401371083,St. Francis Brooklyn Terriers,TEAM,TOTAL,TOTAL,False,,17,63,13,46,4,17,8,17,14,29,43,7,9,3,14,22,46
401371083,Fordham Rams,C. Ohams,4066856,,True,33.0,8,16,8,16,0,0,4,8,8,14,22,2,1,3,3,1,20
401371083,Fordham Rams,A. Charlton,4897085,,True,36.0,4,9,4,7,0,2,0,0,4,4,8,3,3,1,3,1,8
401371083,Fordham Rams,K. Rose,4592315,,True,31.0,0,3,0,1,0,2,0,0,0,2,2,4,1,0,1,2,0
401371083,Fordham Rams,D. Quisenberry,4397790,,True,31.0,1,13,0,8,1,5,1,2,1,3,4,1,1,0,0,3,4
401371083,Fordham Rams,A. Daye Jr.,4397500,,True,32.0,8,16,6,13,2,3,4,7,1,3,4,1,3,0,3,1,22
401371083,Fordham Rams,A. Tsimbila,4702329,,False,4.0,1,1,1,1,0,0,0,0,0,0,0,0,0,0,0,3,2
401371083,Fordham Rams,R. Novitskyi,4897084,,False,6.0,0,0,0,0,0,0,2,2,0,1,1,0,0,1,1,3,2
401371083,Fordham Rams,A. Harrison,4897086,,False,8.0,0,3,0,2,0,1,0,0,0,2,2,0,0,0,0,0,0
401371083,Fordham Rams,K. Cunningham,4705891,,False,6.0,2,2,2,2,0,0,0,1,0,3,3,0,0,0,0,0,4
401371083,Fordham Rams,J. Navarro,4592316,,False,13.0,2,3,1,1,1,2,1,2,1,3,4,1,0,0,0,1,6
401371083,Fordham Rams,TEAM,TOTAL,TOTAL,False,,26,66,22,51,4,15,12,22,16,38,54,12,9,5,11,15,68
401371082,Fordham Rams,C. Ohams,4066856,,True,44.0,8,10,8,10,0,0,3,6,2,11,13,1,1,5,2,0,19
401371082,Fordham Rams,A. Charlton,4897085,,True,44.0,4,8,1,4,3,4,2,2,1,7,8,3,1,1,1,3,13
401371082,Fordham Rams,K. Rose,4592315,,True,41.0,2,10,1,3,1,7,2,2,1,4,5,0,1,0,1,1,7
401371082,Fordham Rams,D. Quisenberry,4397790,,True,44.0,6,14,3,4,3,10,10,11,0,3,3,1,4,0,3,0,25
401371082,Fordham Rams,A. Daye Jr.,4397500,,True,45.0,8,14,8,13,0,1,9,12,1,5,6,4,0,0,3,3,25
401371082,Fordham Rams,R. Novitskyi,4897084,,False,10.0,0,1,0,0,0,1,0,0,0,1,1,0,0,1,0,3,0
401371082,Fordham Rams,A. Harrison,4897086,,False,8.0,0,0,0,0,0,0,0,0,0,0,0,1,0,0,2,1,0
401371082,Fordham Rams,K. Cunningham,4705891,,False,2.0,0,1,0,0,0,1,0,0,0,0,0,0,0,0,1,2,0
401371082,Fordham Rams,J. Navarro,4592316,,False,12.0,0,2,0,0,0,2,0,0,0,1,1,0,2,0,1,0,0
401371082,Fordham Rams,TEAM,TOTAL,TOTAL,False,,28,60,21,34,7,26,26,33,5,33,38,10,9,7,16,13,89
401371082,Central Connecticut Blue Devils,J. Brown,4896536,,True,27.0,5,8,5,8,0,0,0,0,2,5,7,0,1,0,1,4,10
401371082,Central Connecticut Blue Devils,A. Snoddy,4896537,,True,29.0,3,5,3,5,0,0,2,3,1,6,7,0,0,0,1,0,8
401371082,Central Connecticut Blue Devils,N. Scantlebury,4703142,,True,29.0,4,14,3,10,1,4,2,2,0,3,3,3,0,0,0,4,11
401371082,Central Connecticut Blue Devils,Z. Newkirk,4593246,,True,27.0,4,9,3,6,1,3,4,4,1,0,1,2,1,0,1,2,13
401371082,Central Connecticut Blue Devils,I. Krishnan,4397951,,True,37.0,7,16,4,6,3,10,0,0,1,3,4,0,1,0,2,3,17
401371082,Central Connecticut Blue Devils,S. Ayangma,4593248,,False,16.0,2,5,2,4,0,1,1,2,3,2,5,0,0,0,1,3,5
401371082,Central Connecticut Blue Devils,A. Dehnavi,4896533,,False,7.0,1,2,1,2,0,0,0,0,0,1,1,0,1,0,0,0,2
401371082,Central Connecticut Blue Devils,T. McLaughlin,4896538,,False,21.0,2,3,1,1,1,2,0,0,1,3,4,0,2,0,2,1,5
401371082,Central Connecticut Blue Devils,D. Sweatman,4896531,,False,14.0,1,3,1,2,0,1,1,1,1,0,1,3,0,0,1,2,3
401371082,Central Connecticut Blue Devils,J. Ostrowsky,4896530,,False,21.0,4,5,3,4,1,1,0,0,0,3,3,2,0,0,1,2,9
401371082,Central Connecticut Blue Devils,T. Mitchell,4703143,,False,22.0,0,8,0,5,0,3,0,0,0,1,1,0,1,1,1,4,0
401371082,Central Connecticut Blue Devils,TEAM,TOTAL,TOTAL,False,,33,78,26,53,7,25,10,12,12,28,40,10,7,1,14,25,83
401371081,Maryland Eastern Shore Hawks,N. Pollard Jr.,4704102,,True,27.0,4,8,4,8,0,0,1,1,2,3,5,0,1,1,1,4,9
401371081,Maryland Eastern Shore Hawks,Z. Styles,4704099,,True,38.0,3,12,3,11,0,1,13,15,2,3,5,1,1,0,1,2,19
401371081,Maryland Eastern Shore Hawks,D. London,4700872,,True,37.0,7,11,5,6,2,5,2,4,0,1,1,2,1,0,2,3,18
401371081,Maryland Eastern Shore Hawks,D. Phillip,4593381,,True,38.0,5,9,4,6,1,3,0,0,0,4,4,2,1,0,5,4,11
401371081,Maryland Eastern Shore Hawks,K. Voyles,4593380,,True,37.0,1,5,1,5,0,0,0,0,0,3,3,4,3,1,3,4,2
401371081,Maryland Eastern Shore Hawks,K. Thompson,4898271,,False,21.0,2,3,1,1,1,2,2,2,2,3,5,1,0,0,1,1,7
401371081,Maryland Eastern Shore Hawks,M. Akinsanya,4704101,,False,12.0,0,3,0,3,0,0,0,2,1,1,2,1,0,0,2,3,0
401371081,Maryland Eastern Shore Hawks,C. Davis,4898269,,False,22.0,1,4,0,2,1,2,0,0,0,4,4,4,2,0,1,3,3
401371081,Maryland Eastern Shore Hawks,D. Nugent,4704097,,False,10.0,1,2,0,1,1,1,0,0,0,1,1,0,1,0,2,2,3
401371081,Maryland Eastern Shore Hawks,M. Mensah,4704096,,False,8.0,1,4,0,1,1,3,0,0,0,1,1,0,0,0,0,0,3
401371081,Maryland Eastern Shore Hawks,TEAM,TOTAL,TOTAL,False,,25,61,18,44,7,17,18,24,9,31,40,15,10,2,18,26,75
401371081,Fordham Rams,C. Ohams,4066856,,True,42.0,2,9,2,8,0,1,6,8,3,9,12,1,1,3,3,4,10
401371081,Fordham Rams,A. Charlton,4897085,,True,41.0,2,11,2,6,0,5,0,0,4,6,10,1,5,0,1,5,4
401371081,Fordham Rams,K. Rose,4592315,,True,31.0,2,6,1,2,1,4,3,4,4,3,7,1,2,1,0,5,8
401371081,Fordham Rams,D. Quisenberry,4397790,,True,46.0,8,18,4,8,4,10,5,7,0,1,1,1,0,0,3,3,25
401371081,Fordham Rams,A. Daye Jr.,4397500,,True,49.0,7,14,6,9,1,5,5,8,0,1,1,5,3,0,7,4,20
401371081,Fordham Rams,A. Tsimbila,4702329,,False,12.0,1,4,1,4,0,0,4,4,1,3,4,0,0,1,0,1,6
401371081,Fordham Rams,R. Novitskyi,4897084,,False,4.0,0,0,0,0,0,0,0,0,0,0,0,0,0,0,2,1,0
401371081,Fordham Rams,A. Harrison,4897086,,False,0.0,0,0,0,0,0,0,0,0,0,1,1,0,0,0,0,0,0
401371081,Fordham Rams,J. Navarro,4592316,,False,25.0,0,0,0,0,0,0,0,0,0,2,2,2,0,0,1,1,0
401371081,Fordham Rams,TEAM,TOTAL,TOTAL,False,,22,62,16,37,6,25,23,31,13,29,42,11,11,5,17,24,73
401371077,Duquesne Dukes,T. Williams,4432147,,True,30.0,8,12,8,11,0,1,1,2,6,4,10,3,2,4,1,2,17
401371077,Duquesne Dukes,K. Easley,4398159,,True,33.0,5,11,5,10,0,1,2,3,3,3,6,1,0,0,1,2,12
401371077,Duquesne Dukes,A. Spears,4897090,,True,24.0,0,8,0,7,0,1,2,2,0,0,0,2,0,0,3,0,2
401371077,Duquesne Dukes,L. Ayers III,4703813,,True,25.0,5,12,2,6,3,6,0,0,1,3,4,2,3,0,3,3,13
401371077,Duquesne Dukes,T. Okani,4700873,,True,22.0,3,8,2,6,1,2,0,2,2,2,4,1,1,0,0,2,7
401371077,Duquesne Dukes,M. Hima,4700878,,False,3.0,0,1,0,1,0,0,0,0,0,0,0,0,0,0,0,0,0
401371077,Duquesne Dukes,A. Rotroff,4396806,,False,8.0,0,0,0,0,0,0,0,1,2,2,4,0,0,0,0,2,0
401371077,Duquesne Dukes,D. Larson,4897091,,False,9.0,0,1,0,0,0,1,0,0,0,0,0,1,0,0,0,2,0
401371077,Duquesne Dukes,J. Johnson III,4897088,,False,19.0,5,10,4,7,1,3,0,0,0,1,1,2,0,0,2,0,11
401371077,Duquesne Dukes,M. Bekelja,4700874,,False,5.0,0,0,0,0,0,0,0,0,0,1,1,0,0,0,0,0,0
401371077,Duquesne Dukes,T. Acuff,4606831,,False,22.0,2,6,1,2,1,4,0,0,0,3,3,0,0,0,0,2,5
401371077,Duquesne Dukes,TEAM,TOTAL,TOTAL,False,,28,69,22,50,6,19,5,10,16,19,35,12,6,4,10,15,67
401371077,DePaul Blue Demons,D. Jones,4713010,,True,26.0,3,7,3,6,0,1,1,3,2,0,2,1,0,1,2,2,7
401371077,DePaul Blue Demons,B. Johnson,4067410,,True,21.0,5,7,2,3,3,4,0,0,2,2,4,1,1,0,1,3,13
401371077,DePaul Blue Demons,N. Ongenda,4431760,,True,23.0,5,9,5,9,0,0,3,4,2,4,6,0,1,1,3,2,13
401371077,DePaul Blue Demons,P. Gebrewhit,4397991,,True,31.0,4,6,3,3,1,3,2,4,0,4,4,4,1,0,1,2,11
401371077,DePaul Blue Demons,J. Freeman-Liberty,4397511,,True,35.0,11,17,8,11,3,6,1,1,2,7,9,5,2,1,2,1,26
401371077,DePaul Blue Demons,Y. Anei,4397046,,False,18.0,2,8,2,7,0,1,0,0,6,5,11,1,0,1,3,3,4
401371077,DePaul Blue Demons,J. Terry,4702387,,False,30.0,3,8,2,4,1,4,0,0,1,3,4,4,1,0,0,0,7
401371077,DePaul Blue Demons,M. Williams,4701558,,False,1.0,0,0,0,0,0,0,0,0,0,0,0,0,0,0,0,0,0
401371077,DePaul Blue Demons,C. McCauley,4701557,,False,11.0,1,3,0,2,1,1,0,0,0,1,1,1,0,0,0,0,3
401371077,DePaul Blue Demons,B. Favre,4592458,,False,3.0,1,1,0,0,1,1,0,0,0,0,0,0,0,0,0,0,3
401371077,DePaul Blue Demons,S. Medlock,4065664,,False,1.0,0,0,0,0,0,0,0,0,0,0,0,0,0,0,0,0,0
401371077,DePaul Blue Demons,TEAM,TOTAL,TOTAL,False,,35,66,25,45,10,21,7,12,15,28,43,17,6,4,12,13,87
401371075,UC Irvine Anteaters,A. Johnson,4592959,,True,19.0,0,3,0,3,0,0,1,2,1,1,2,0,0,3,0,0,1
401371075,UC Irvine Anteaters,JC Butler,4397596,,True,27.0,3,6,2,5,1,1,0,0,0,3,3,1,1,0,0,4,7
401371075,UC Irvine Anteaters,C. Welp,4279073,,True,26.0,5,14,4,10,1,4,1,1,2,1,3,1,1,0,2,1,12
401371075,UC Irvine Anteaters,I. Lee,4592958,,True,26.0,1,4,0,2,1,2,0,0,0,1,1,1,1,0,2,0,3
401371075,UC Irvine Anteaters,J. Hohn,4433009,,True,30.0,2,7,2,4,0,3,0,0,1,3,4,5,2,1,0,0,4
401371075,UC Irvine Anteaters,E. Tshimanga,4592961,,False,13.0,6,8,6,7,0,1,2,2,3,1,4,0,1,0,1,2,14
401371075,UC Irvine Anteaters,H. Ruck,4702630,,False,2.0,0,0,0,0,0,0,0,0,0,0,0,0,0,0,0,0,0
401371075,UC Irvine Anteaters,B. Leuchten,4897676,,False,11.0,4,5,4,5,0,0,0,1,2,1,3,0,0,0,4,0,8
401371075,UC Irvine Anteaters,L. Redfield,4897677,,False,17.0,1,2,0,1,1,1,0,0,1,1,2,1,0,0,2,1,3
401371075,UC Irvine Anteaters,DJ Davis,4702628,,False,17.0,1,4,1,1,0,3,0,0,0,1,1,2,1,0,2,3,2
401371075,UC Irvine Anteaters,O. Ujadughele,4432132,,False,12.0,0,2,0,1,0,1,0,0,0,3,3,0,0,0,0,4,0
401371075,UC Irvine Anteaters,TEAM,TOTAL,TOTAL,False,,23,55,19,39,4,16,4,6,10,16,26,11,7,4,13,15,54
401371075,Duquesne Dukes,T. Williams,4432147,,True,11.0,1,2,1,1,0,1,0,0,1,0,1,0,0,0,1,0,2
401371075,Duquesne Dukes,K. Easley,4398159,,True,36.0,5,14,4,12,1,2,1,1,3,7,10,1,2,0,2,2,12
401371075,Duquesne Dukes,A. Spears,4897090,,True,20.0,0,2,0,2,0,0,0,0,0,1,1,1,1,0,1,0,0
401371075,Duquesne Dukes,J. Johnson III,4897088,,True,25.0,4,6,3,3,1,3,0,0,0,1,1,1,1,0,1,1,9
401371075,Duquesne Dukes,L. Ayers III,4703813,,True,35.0,7,12,5,8,2,4,8,8,1,5,6,4,0,1,3,2,24
401371075,Duquesne Dukes,M. Hima,4700878,,False,3.0,1,1,1,1,0,0,0,0,0,0,0,0,0,0,0,1,2
401371075,Duquesne Dukes,A. Rotroff,4396806,,False,21.0,3,5,3,5,0,0,0,1,4,3,7,1,0,1,2,4,6
401371075,Duquesne Dukes,D. Larson,4897091,,False,2.0,0,0,0,0,0,0,0,0,0,0,0,0,1,0,0,0,0
401371075,Duquesne Dukes,M. Bekelja,4700874,,False,2.0,0,0,0,0,0,0,0,0,0,0,0,0,0,0,0,0,0
401371075,Duquesne Dukes,T. Okani,4700873,,False,21.0,2,7,1,4,1,3,0,0,5,3,8,1,0,0,0,1,5
401371075,Duquesne Dukes,T. Acuff,4606831,,False,23.0,6,11,2,6,4,5,0,0,3,3,6,0,0,0,2,2,16
401371075,Duquesne Dukes,N. Buono,4279744,,False,1.0,0,1,0,0,0,1,0,0,0,0,0,1,0,0,1,0,0
401371075,Duquesne Dukes,TEAM,TOTAL,TOTAL,False,,29,61,20,42,9,19,9,10,17,23,40,10,5,2,13,13,76
401371074,Marshall Thundering Herd,O. Anochili-Killen,4432441,,True,32.0,4,7,3,4,1,3,4,6,3,4,7,1,1,4,2,3,13
401371074,Marshall Thundering Herd,D. George,4279078,,True,20.0,1,3,1,2,0,1,0,0,2,6,8,0,0,1,1,0,2
401371074,Marshall Thundering Herd,D. Early,4702695,,True,31.0,3,9,2,3,1,6,1,2,0,5,5,2,0,0,0,3,8
401371074,Marshall Thundering Herd,A. Taylor,4592859,,True,39.0,6,14,5,9,1,5,0,0,3,4,7,3,1,0,5,1,13
401371074,Marshall Thundering Herd,T. Kinsey,4397537,,True,40.0,10,23,10,20,0,3,1,1,2,4,6,5,0,0,0,0,21
401371074,Marshall Thundering Herd,C. McKey,4897502,,False,8.0,2,2,2,2,0,0,0,0,1,2,3,1,0,0,0,0,4
401371074,Marshall Thundering Herd,M. Sarenac,4592862,,False,20.0,2,6,0,1,2,5,0,0,0,0,0,0,0,2,1,1,6
401371074,Marshall Thundering Herd,K. Braun,4897503,,False,10.0,2,5,1,2,1,3,0,0,0,0,0,1,0,0,0,0,5
401371074,Marshall Thundering Herd,TEAM,TOTAL,TOTAL,False,,30,69,24,43,6,26,6,9,12,29,41,13,2,7,9,8,72
401371074,Duquesne Dukes,T. Williams,4432147,,True,34.0,7,14,7,11,0,3,0,0,2,4,6,3,0,1,3,3,14
401371074,Duquesne Dukes,K. Easley,4398159,,True,27.0,3,8,1,5,2,3,2,2,1,4,5,0,1,1,1,2,10
401371074,Duquesne Dukes,A. Spears,4897090,,True,33.0,9,18,7,13,2,5,3,5,2,1,3,4,2,0,1,0,23
401371074,Duquesne Dukes,L. Ayers III,4703813,,True,26.0,3,10,2,6,1,4,0,0,0,8,8,0,0,0,2,0,7
401371074,Duquesne Dukes,T. Okani,4700873,,True,27.0,1,3,1,2,0,1,0,0,0,6,6,1,0,0,0,1,2
401371074,Duquesne Dukes,A. Rotroff,4396806,,False,6.0,0,0,0,0,0,0,0,0,1,0,1,1,0,1,0,2,0
401371074,Duquesne Dukes,D. Larson,4897091,,False,16.0,1,3,1,2,0,1,0,0,0,3,3,1,0,0,0,2,2
401371074,Duquesne Dukes,J. Johnson III,4897088,,False,12.0,1,3,1,2,0,1,0,0,0,1,1,2,0,1,2,0,2
401371074,Duquesne Dukes,T. Acuff,4606831,,False,19.0,4,6,1,2,3,4,0,0,0,1,1,1,2,0,1,0,11
401371074,Duquesne Dukes,TEAM,TOTAL,TOTAL,False,,29,65,21,43,8,22,5,7,8,30,38,13,5,4,10,10,71
401371073,Duquesne Dukes,T. Williams,4432147,,True,30.0,5,8,5,8,0,0,3,6,1,1,2,0,0,2,3,3,13
401371073,Duquesne Dukes,K. Easley,4398159,,True,35.0,5,7,4,5,1,2,3,4,0,6,6,1,0,0,1,1,14
401371073,Duquesne Dukes,A. Spears,4897090,,True,37.0,6,14,5,11,1,3,8,10,0,3,3,6,6,0,1,1,21
401371073,Duquesne Dukes,L. Ayers III,4703813,,True,34.0,7,12,6,8,1,4,8,8,0,6,6,1,0,0,2,0,23
401371073,Duquesne Dukes,T. Acuff,4606831,,True,29.0,2,3,2,3,0,0,2,2,0,3,3,1,1,0,0,1,6
401371073,Duquesne Dukes,A. Rotroff,4396806,,False,10.0,1,2,1,2,0,0,2,2,2,1,3,3,1,0,0,1,4
401371073,Duquesne Dukes,J. Johnson III,4897088,,False,9.0,1,2,0,1,1,1,0,1,0,0,0,0,0,0,2,0,3
401371073,Duquesne Dukes,T. Okani,4700873,,False,16.0,2,2,2,2,0,0,0,0,0,2,2,0,0,0,0,0,4
401371073,Duquesne Dukes,TEAM,TOTAL,TOTAL,False,,29,50,25,40,4,10,26,33,3,23,26,12,8,2,9,7,88
401371073,American University Eagles,J. O'Neil,4702481,,True,31.0,3,7,1,1,2,6,1,2,0,6,6,4,0,0,4,2,9
401371073,American University Eagles,C. Nelson,4593072,,True,9.0,2,4,1,2,1,2,0,0,1,0,1,0,0,0,0,0,5
401371073,American University Eagles,M. Rogers,4575108,,True,28.0,6,12,6,12,0,0,0,0,1,3,4,1,0,0,3,3,12
401371073,American University Eagles,C. Smalls,4433245,,True,32.0,10,12,8,9,2,3,0,1,0,0,0,7,1,0,3,4,22
401371073,American University Eagles,S. Beckton Jr.,4280025,,True,28.0,6,10,3,6,3,4,2,2,1,3,4,0,1,0,0,5,17
401371073,American University Eagles,E. Stephens,4897139,,False,19.0,2,3,2,3,0,0,0,0,0,0,0,2,1,0,2,5,4
401371073,American University Eagles,L. Donadio,4702478,,False,24.0,1,5,0,3,1,2,0,0,1,3,4,1,0,0,1,1,3
401371073,American University Eagles,L. Ball,4700962,,False,1.0,0,0,0,0,0,0,0,0,0,0,0,0,0,0,0,0,0
401371073,American University Eagles,J. Knotek,4398212,,False,16.0,1,3,1,2,0,1,1,2,0,2,2,0,1,1,0,2,3
401371073,American University Eagles,M. Bragg,4280027,,False,12.0,2,4,2,4,0,0,0,0,2,1,3,2,1,0,1,1,4
401371073,American University Eagles,TEAM,TOTAL,TOTAL,False,,33,60,24,42,9,18,4,7,6,20,26,17,5,1,14,23,79
401371072,Weber State Wildcats,C. Carlson,4286400,,True,26.0,5,8,5,8,0,0,0,0,1,0,1,0,1,0,1,2,10
401371072,Weber State Wildcats,D. Jones,4702159,,True,35.0,3,4,3,3,0,1,6,9,1,12,13,3,1,0,0,1,12
401371072,Weber State Wildcats,J. Overton,4593976,,True,23.0,2,4,2,4,0,0,4,6,0,3,3,3,3,3,5,5,8
401371072,Weber State Wildcats,S. Sisoho Jawara,4593773,,True,36.0,3,9,2,5,1,4,1,2,0,3,3,4,1,0,2,2,8
401371072,Weber State Wildcats,K. McEwen,4066755,,True,35.0,5,13,0,4,5,9,6,8,0,2,2,0,0,1,1,4,21
401371072,Weber State Wildcats,D. Koehler,4702350,,False,7.0,0,0,0,0,0,0,0,0,0,1,1,0,1,0,0,0,0
401371072,Weber State Wildcats,A. Tew,4897981,,False,14.0,0,2,0,2,0,0,0,0,0,1,1,0,0,1,4,1,0
401371072,Weber State Wildcats,Z. Porter,4405290,,False,24.0,1,4,1,2,0,2,2,3,0,2,2,0,2,2,3,2,4
401371072,Weber State Wildcats,TEAM,TOTAL,TOTAL,False,,19,44,13,28,6,16,19,28,2,26,28,10,9,7,17,17,63
401371072,Duquesne Dukes,T. Williams,4432147,,True,30.0,3,9,3,7,0,2,0,0,4,5,9,0,0,2,4,3,6
401371072,Duquesne Dukes,K. Easley,4398159,,True,28.0,3,9,2,6,1,3,3,6,1,4,5,1,1,0,3,5,10
401371072,Duquesne Dukes,A. Spears,4897090,,True,24.0,0,7,0,3,0,4,2,2,0,0,0,1,1,0,2,4,2
401371072,Duquesne Dukes,L. Ayers III,4703813,,True,15.0,0,2,0,0,0,2,1,2,0,1,1,2,2,0,2,0,1
401371072,Duquesne Dukes,M. Bekelja,4700874,,True,18.0,0,1,0,1,0,0,0,0,1,3,4,1,1,0,1,2,0
401371072,Duquesne Dukes,R. Gunn,4897089,,False,4.0,0,1,0,1,0,0,0,0,0,0,0,0,0,0,1,1,0
401371072,Duquesne Dukes,A. Rotroff,4396806,,False,10.0,1,1,1,1,0,0,0,2,3,2,5,0,0,0,1,1,2
401371072,Duquesne Dukes,D. Larson,4897091,,False,8.0,0,0,0,0,0,0,0,0,0,2,2,0,0,0,1,0,0
401371072,Duquesne Dukes,J. Johnson III,4897088,,False,24.0,9,19,5,11,4,8,5,6,1,0,1,0,1,0,2,3,27
401371072,Duquesne Dukes,T. Okani,4700873,,False,18.0,4,6,4,6,0,0,0,0,2,3,5,2,2,1,2,4,8
401371072,Duquesne Dukes,T. Acuff,4606831,,False,21.0,1,4,0,1,1,3,0,0,0,3,3,2,1,0,0,2,3
401371072,Duquesne Dukes,TEAM,TOTAL,TOTAL,False,,21,59,15,37,6,22,11,18,17,26,43,9,9,3,20,25,59
401371071,Hofstra Pride,A. Iyiola,4278475,,True,25.0,6,8,6,8,0,0,0,0,2,5,7,2,0,0,2,4,12
401371071,Hofstra Pride,D. Dubar,4598640,,True,40.0,4,7,1,2,3,5,3,6,2,4,6,0,0,0,1,2,14
401371071,Hofstra Pride,A. Estrada,4593385,,True,38.0,5,8,3,4,2,4,2,2,0,6,6,4,0,0,4,2,14
401371071,Hofstra Pride,C. Burgess,4592954,,True,21.0,1,2,1,1,0,1,0,0,0,4,4,7,1,0,1,2,2
401371071,Hofstra Pride,Z. Cooks,4278449,,True,40.0,12,20,7,10,5,10,0,0,1,6,7,3,1,0,2,0,29
401371071,Hofstra Pride,K. Cramer,4592957,,False,15.0,0,2,0,2,0,0,0,0,1,0,1,1,1,0,1,4,0
401371071,Hofstra Pride,J. Carlos,4683855,,False,4.0,0,0,0,0,0,0,0,0,0,2,2,0,0,0,1,1,0
401371071,Hofstra Pride,O. Silverio,4397181,,False,17.0,1,3,1,2,0,1,0,0,0,2,2,0,0,0,1,1,2
401371071,Hofstra Pride,TEAM,TOTAL,TOTAL,False,,29,50,19,29,10,21,5,8,6,30,36,17,3,0,17,16,73
401371071,Duquesne Dukes,T. Williams,4432147,,True,32.0,4,12,4,8,0,4,1,1,3,2,5,0,1,2,4,3,9
401371071,Duquesne Dukes,K. Easley,4398159,,True,33.0,5,11,5,8,0,3,4,4,5,5,10,1,0,1,1,4,14
401371071,Duquesne Dukes,A. Spears,4897090,,True,32.0,7,15,6,11,1,4,2,4,2,2,4,0,2,0,0,1,17
401371071,Duquesne Dukes,L. Ayers III,4703813,,True,32.0,3,11,3,4,0,7,1,2,1,3,4,2,3,0,0,1,7
401371071,Duquesne Dukes,T. Okani,4700873,,True,17.0,0,3,0,2,0,1,0,0,1,2,3,1,1,0,3,2,0
401371071,Duquesne Dukes,M. Hima,4700878,,False,2.0,0,0,0,0,0,0,0,0,0,0,0,0,0,0,0,0,0
401371071,Duquesne Dukes,A. Rotroff,4396806,,False,6.0,2,2,2,2,0,0,0,2,0,0,0,0,0,0,0,1,4
401371071,Duquesne Dukes,D. Larson,4897091,,False,5.0,0,0,0,0,0,0,0,0,0,0,0,1,0,0,0,2,0
401371071,Duquesne Dukes,J. Johnson III,4897088,,False,8.0,1,5,0,2,1,3,1,2,1,0,1,1,0,0,0,0,4
401371071,Duquesne Dukes,M. Bekelja,4700874,,False,16.0,1,3,0,1,1,2,1,2,0,1,1,0,0,0,0,0,4
401371071,Duquesne Dukes,T. Acuff,4606831,,False,17.0,2,4,2,4,0,0,0,0,1,1,2,1,2,0,1,0,4
401371071,Duquesne Dukes,TEAM,TOTAL,TOTAL,False,,25,66,22,42,3,24,10,17,16,16,32,7,9,3,9,14,63
401371070,Southern Jaguars,T. Williams Jr.,4594110,,True,25.0,5,10,3,5,2,5,0,0,1,2,3,1,1,0,2,2,12
401371070,Southern Jaguars,D. Sears,4067150,,True,19.0,1,5,1,5,0,0,0,0,2,2,4,0,2,1,1,2,2
401371070,Southern Jaguars,J. Saddler,4402919,,True,30.0,3,7,3,7,0,0,2,4,1,1,2,6,2,0,1,5,8
401371070,Southern Jaguars,T. Lyons,4398221,,True,20.0,4,7,2,4,2,3,1,2,1,4,5,0,4,0,4,4,11
401371070,Southern Jaguars,P. Byrd,4397229,,True,39.0,1,5,0,3,1,2,2,2,0,1,1,6,0,0,1,4,5
401371070,Southern Jaguars,J. Ewing,4897807,,False,7.0,1,4,1,4,0,0,0,1,0,1,1,0,0,0,0,2,2
401371070,Southern Jaguars,J. Holliday,4593685,,False,24.0,1,7,1,4,0,3,1,2,1,3,4,5,3,0,0,0,3
401371070,Southern Jaguars,D. Johnson,4433014,,False,4.0,0,0,0,0,0,0,0,0,0,0,0,0,1,0,0,2,0
401371070,Southern Jaguars,B. Brooks,4402918,,False,1.0,0,0,0,0,0,0,0,0,0,0,0,0,0,0,0,0,0
401371070,Southern Jaguars,I. Rollins,4398430,,False,6.0,1,3,0,1,1,2,0,0,0,1,1,0,0,0,2,0,3
401371070,Southern Jaguars,B. Whitley,4279890,,False,25.0,5,11,1,1,4,10,0,0,0,0,0,0,0,0,0,1,14
401371070,Southern Jaguars,TEAM,TOTAL,TOTAL,False,,22,59,12,34,10,25,6,11,9,16,25,18,13,1,12,22,60
401371070,Dayton Flyers,R.J. Blakney,4700864,,True,22.0,2,5,2,4,0,1,2,2,1,5,6,0,0,0,1,0,6
401371070,Dayton Flyers,T. Camara,4431736,,True,27.0,4,5,4,4,0,1,5,6,5,7,12,0,0,1,6,3,13
401371070,Dayton Flyers,D. Holmes II,4433607,,True,37.0,3,5,3,5,0,0,4,6,3,3,6,4,0,4,3,0,10
401371070,Dayton Flyers,M. Smith,4683861,,True,33.0,3,9,2,7,1,2,2,4,2,3,5,2,2,0,4,3,9
401371070,Dayton Flyers,K. Elvis,4683135,,True,30.0,5,8,3,3,2,5,3,4,0,2,2,4,0,0,2,2,15
401371070,Dayton Flyers,M. Sissoko,4431824,,False,3.0,0,0,0,0,0,0,0,0,0,0,0,0,0,0,0,1,0
401371070,Dayton Flyers,M. Amzil,4711607,,False,12.0,3,6,2,3,1,3,0,0,1,6,7,1,0,0,2,2,7
401371070,Dayton Flyers,K. Brea,4591259,,False,15.0,1,4,0,0,1,4,0,0,0,3,3,0,0,0,1,0,3
401371070,Dayton Flyers,L. Greer III,4433175,,False,10.0,0,0,0,0,0,0,2,4,0,1,1,1,1,0,1,1,2
401371070,Dayton Flyers,E. Weaver,4397139,,False,10.0,2,3,2,2,0,1,0,0,0,0,0,0,2,1,1,1,4
401371070,Dayton Flyers,TEAM,TOTAL,TOTAL,False,,23,45,18,28,5,17,18,26,12,31,43,12,5,6,21,13,69
401371050,Fordham Rams,C. Ohams,4066856,,True,31.0,4,7,4,7,0,0,5,6,3,12,15,3,1,2,4,1,13
401371050,Fordham Rams,A. Charlton,4897085,,True,35.0,5,7,3,5,2,2,0,0,0,0,0,0,2,0,0,1,12
401371050,Fordham Rams,K. Rose,4592315,,True,20.0,2,7,0,2,2,5,0,0,1,3,4,1,0,0,1,4,6
401371050,Fordham Rams,D. Quisenberry,4397790,,True,36.0,8,18,2,6,6,12,3,6,1,3,4,2,0,0,1,2,25
401371050,Fordham Rams,A. Daye Jr.,4397500,,True,33.0,4,13,3,6,1,7,3,5,1,4,5,4,1,0,2,2,12
401371050,Fordham Rams,A. Tsimbila,4702329,,False,13.0,1,1,1,1,0,0,0,0,2,1,3,1,0,0,0,2,2
401371050,Fordham Rams,R. Novitskyi,4897084,,False,14.0,0,1,0,0,0,1,0,0,0,2,2,0,0,1,0,3,0
401371050,Fordham Rams,A. Harrison,4897086,,False,1.0,0,0,0,0,0,0,0,0,0,0,0,0,0,0,0,0,0
401371050,Fordham Rams,J. Navarro,4592316,,False,16.0,2,6,1,1,1,5,0,0,1,0,1,0,2,0,0,1,5
401371050,Fordham Rams,D.J. Gordon,4591261,,False,1.0,0,0,0,0,0,0,2,2,0,0,0,0,0,0,0,0,2
401371050,Fordham Rams,TEAM,TOTAL,TOTAL,False,,26,60,14,28,12,32,13,19,11,25,36,11,6,3,10,16,77
401371050,Columbia Lions,L. Murphy,4702975,,True,23.0,6,10,5,5,1,5,0,0,1,3,4,3,1,0,2,1,13
401371050,Columbia Lions,I. Nweke,4397926,,True,27.0,5,10,5,10,0,0,1,4,0,5,5,3,0,0,3,5,11
401371050,Columbia Lions,P. Harding,4702977,,True,20.0,2,5,2,5,0,0,0,0,1,1,2,1,0,0,1,3,4
401371050,Columbia Lions,G. Rubio De La Rosa,4898213,,True,39.0,6,14,2,5,4,9,0,1,0,5,5,2,0,0,5,2,16
401371050,Columbia Lions,Z. McLean,4702974,,True,31.0,1,6,1,3,0,3,3,3,1,1,2,0,1,0,2,2,5
401371050,Columbia Lions,R. Stankard,4898214,,False,12.0,2,2,1,1,1,1,0,0,1,0,1,2,0,0,0,0,5
401371050,Columbia Lions,J. Odunowo,4702976,,False,2.0,0,0,0,0,0,0,0,0,0,0,0,0,0,0,0,0,0
401371050,Columbia Lions,N. Robledo,4683745,,False,8.0,0,0,0,0,0,0,0,0,1,2,3,0,0,0,1,0,0
401371050,Columbia Lions,C. Shockley-Okeke,4593296,,False,6.0,0,1,0,1,0,0,0,0,0,0,0,0,0,0,0,1,0
401371050,Columbia Lions,J. Cooper,4898212,,False,16.0,3,6,2,4,1,2,0,0,1,2,3,0,0,1,0,4,7
401371050,Columbia Lions,L. Bolster,4279465,,False,16.0,2,2,1,1,1,1,1,2,1,2,3,2,0,0,0,1,6
401371050,Columbia Lions,TEAM,TOTAL,TOTAL,False,,27,56,19,35,8,21,5,10,8,26,34,13,2,1,16,19,67
401371009,Ole Miss Rebels,J. Brakefield,4432169,,True,28.0,4,6,3,3,1,3,0,0,1,2,3,0,3,0,3,4,9
401371009,Ole Miss Rebels,N. Brooks,4066485,,True,36.0,8,12,8,12,0,0,0,1,4,7,11,0,3,1,1,3,16
401371009,Ole Miss Rebels,M. Murrell,4702442,,True,31.0,2,5,0,0,2,5,2,2,0,3,3,3,1,1,2,2,8
401371009,Ole Miss Rebels,L. Rodriguez,4396969,,True,19.0,2,2,1,1,1,1,0,0,0,1,1,2,0,0,1,5,5
401371009,Ole Miss Rebels,J. Joiner,4278729,,True,35.0,4,11,4,6,0,5,4,4,0,2,2,3,2,0,1,3,12
401371009,Ole Miss Rebels,S. Hunter,4433011,,False,11.0,1,2,1,1,0,1,0,0,0,1,1,0,1,0,1,2,2
401371009,Ole Miss Rebels,D. Ruffin,4432638,,False,17.0,5,9,5,6,0,3,9,12,0,0,0,2,1,0,3,0,19
401371009,Ole Miss Rebels,A. Crowley,4431758,,False,5.0,0,0,0,0,0,0,0,0,0,0,0,1,0,0,0,2,0
401371009,Ole Miss Rebels,T. Fagan,4395719,,False,18.0,2,3,2,2,0,1,1,2,0,4,4,2,0,0,3,0,5
401371009,Ole Miss Rebels,TEAM,TOTAL,TOTAL,False,,28,50,24,31,4,19,16,21,6,21,27,13,11,2,16,21,76
401371009,Dayton Flyers,R.J. Blakney,4700864,,True,29.0,3,8,2,4,1,4,2,2,1,3,4,0,2,0,0,1,9
401371009,Dayton Flyers,T. Camara,4431736,,True,31.0,6,11,5,8,1,3,2,3,2,7,9,2,0,1,8,3,15
401371009,Dayton Flyers,D. Holmes II,4433607,,True,32.0,7,9,7,8,0,1,0,2,0,0,0,1,2,2,1,2,14
401371009,Dayton Flyers,M. Smith,4683861,,True,36.0,5,10,4,7,1,3,5,7,0,3,3,11,2,0,2,5,16
401371009,Dayton Flyers,K. Elvis,4683135,,True,24.0,1,3,0,0,1,3,0,0,1,0,1,2,1,0,2,4,3
401371009,Dayton Flyers,M. Sissoko,4431824,,False,8.0,2,2,2,2,0,0,0,0,0,1,1,0,0,0,1,3,4
401371009,Dayton Flyers,M. Amzil,4711607,,False,10.0,1,2,1,1,0,1,0,0,1,0,1,0,0,0,2,1,2
401371009,Dayton Flyers,K. Brea,4591259,,False,13.0,1,4,1,2,0,2,2,2,2,1,3,0,1,0,2,1,4
401371009,Dayton Flyers,L. Greer III,4433175,,False,2.0,0,0,0,0,0,0,0,0,0,0,0,0,0,0,0,0,0
401371009,Dayton Flyers,E. Weaver,4397139,,False,15.0,0,3,0,2,0,1,1,2,0,0,0,1,0,0,1,1,1
401371009,Dayton Flyers,TEAM,TOTAL,TOTAL,False,,26,52,22,34,4,18,12,18,8,19,27,17,8,3,19,21,68
401371008,SMU Mustangs,I. Jasey,4278120,,True,18.0,1,1,1,1,0,0,0,0,0,2,2,0,0,4,0,1,2
401371008,SMU Mustangs,J. Smith,4690767,,True,14.0,2,2,1,1,1,1,0,0,0,1,1,0,0,0,0,0,5
401371008,SMU Mustangs,E. Bandoumel,4593107,,True,26.0,1,7,0,4,1,3,2,2,1,4,5,1,1,1,2,1,5
401371008,SMU Mustangs,Z. Nutall,4398281,,True,24.0,4,8,2,3,2,5,1,1,0,3,3,0,0,0,2,1,11
401371008,SMU Mustangs,K. Davis,4397066,,True,34.0,8,15,5,11,3,4,0,1,0,3,3,5,3,0,0,2,19
401371008,SMU Mustangs,J. Young Jr.,4396640,,False,5.0,0,0,0,0,0,0,0,0,0,0,0,1,0,0,1,2,0
401371008,SMU Mustangs,T. Clark,4277885,,False,17.0,3,3,3,3,0,0,3,5,1,3,4,0,1,0,0,2,9
401371008,SMU Mustangs,Ma. Weathers,4067390,,False,24.0,0,1,0,1,0,0,3,4,0,4,4,2,1,0,2,3,3
401371008,SMU Mustangs,Z. Phelps,4699725,,False,16.0,6,8,5,7,1,1,0,0,1,1,2,1,2,0,0,1,13
401371008,SMU Mustangs,Mi. Weathers,4067391,,False,22.0,3,9,3,9,0,0,4,4,0,7,7,3,1,1,2,2,10
401371008,SMU Mustangs,TEAM,TOTAL,TOTAL,False,,28,54,20,40,8,14,13,17,3,29,32,13,9,6,9,15,77
401371008,Dayton Flyers,R.J. Blakney,4700864,,True,6.0,1,2,1,1,0,1,0,0,0,3,3,0,0,0,1,3,2
401371008,Dayton Flyers,T. Camara,4431736,,True,31.0,2,5,2,4,0,1,1,2,3,5,8,5,2,1,3,2,5
401371008,Dayton Flyers,D. Holmes II,4433607,,True,32.0,7,11,7,10,0,1,1,3,1,5,6,1,1,0,0,2,15
401371008,Dayton Flyers,M. Smith,4683861,,True,36.0,5,13,4,11,1,2,2,2,1,2,3,6,2,0,0,4,13
401371008,Dayton Flyers,K. Elvis,4683135,,True,20.0,2,7,1,3,1,4,0,0,0,2,2,0,0,0,0,1,5
401371008,Dayton Flyers,M. Sissoko,4431824,,False,5.0,0,0,0,0,0,0,0,0,1,0,1,2,0,1,0,0,0
401371008,Dayton Flyers,M. Amzil,4711607,,False,19.0,2,5,0,1,2,4,2,2,0,2,2,0,0,1,1,4,8
401371008,Dayton Flyers,K. Brea,4591259,,False,18.0,2,7,1,2,1,5,0,0,0,4,4,0,0,0,0,0,5
401371008,Dayton Flyers,L. Greer III,4433175,,False,4.0,1,1,1,1,0,0,0,0,0,2,2,0,0,0,2,0,2
401371008,Dayton Flyers,E. Weaver,4397139,,False,29.0,4,10,3,6,1,4,5,6,0,0,0,3,0,0,2,2,14
401371008,Dayton Flyers,TEAM,TOTAL,TOTAL,False,,26,61,20,39,6,22,11,15,7,26,33,17,5,3,9,18,69
401371007,Dayton Flyers,R.J. Blakney,4700864,,True,22.0,3,5,2,3,1,2,1,1,2,3,5,2,1,0,1,2,8
401371007,Dayton Flyers,T. Camara,4431736,,True,19.0,4,12,3,8,1,4,7,8,3,4,7,1,0,0,0,3,16
401371007,Dayton Flyers,D. Holmes II,4433607,,True,25.0,2,2,2,2,0,0,0,0,1,7,8,1,0,2,1,1,4
401371007,Dayton Flyers,M. Smith,4683861,,True,26.0,3,5,2,4,1,1,8,8,1,6,7,5,5,0,1,2,15
401371007,Dayton Flyers,K. Elvis,4683135,,True,22.0,5,8,3,5,2,3,3,4,0,0,0,1,0,0,0,1,15
401371007,Dayton Flyers,M. Sissoko,4431824,,False,15.0,4,5,4,5,0,0,0,0,2,1,3,0,0,0,0,1,8
401371007,Dayton Flyers,M. Amzil,4711607,,False,23.0,4,7,1,3,3,4,0,0,1,0,1,0,0,0,0,2,11
401371007,Dayton Flyers,K. Washington,4684293,,False,5.0,0,0,0,0,0,0,2,2,0,0,0,1,0,0,1,1,2
401371007,Dayton Flyers,Z. Nwokeji,4618121,,False,9.0,0,1,0,0,0,1,0,0,0,1,1,1,0,0,1,3,0
401371007,Dayton Flyers,C. Wilson,4403456,,False,3.0,0,2,0,2,0,0,1,2,1,0,1,0,2,0,1,1,1
401371007,Dayton Flyers,B. Uhl,4897094,,False,0.0,0,0,0,0,0,0,0,0,0,0,0,0,0,0,0,0,0
401371007,Dayton Flyers,D. Swerlein,4600089,,False,0.0,0,0,0,0,0,0,0,0,0,0,0,0,0,0,0,0,0
401371007,Dayton Flyers,K. Brea,4591259,,False,17.0,3,9,1,3,2,6,0,0,1,1,2,1,1,0,1,1,8
401371007,Dayton Flyers,L. Greer III,4433175,,False,14.0,2,7,2,7,0,0,1,2,0,3,3,3,1,0,0,1,5
401371007,Dayton Flyers,TEAM,TOTAL,TOTAL,False,,30,63,20,42,10,21,23,27,15,28,43,16,10,2,8,19,93
401371007,Alabama State Hornets,J. O'Neal,4703116,,True,29.0,5,10,5,10,0,0,0,0,0,2,2,1,0,4,0,5,10
401371007,Alabama State Hornets,M. Barber,4398165,,True,27.0,1,3,1,2,0,1,2,2,4,3,7,1,1,0,2,0,4
401371007,Alabama State Hornets,G. Liddell,4397076,,True,27.0,2,8,1,5,1,3,0,0,1,3,4,2,0,1,4,3,5
401371007,Alabama State Hornets,I. Range,4705379,,True,22.0,1,5,1,3,0,2,2,2,0,2,2,2,0,0,2,3,4
401371007,Alabama State Hornets,K. Strawbridge,4395991,,True,24.0,1,3,0,2,1,1,0,3,1,5,6,2,0,0,1,3,3
401371007,Alabama State Hornets,J. Mitchell,4897873,,False,7.0,1,1,1,1,0,0,0,0,0,0,0,0,0,0,1,0,2
401371007,Alabama State Hornets,J. Reyna,4897872,,False,18.0,1,5,1,2,0,3,0,0,0,1,1,1,0,0,3,3,2
401371007,Alabama State Hornets,K. Clark,4703120,,False,6.0,0,2,0,2,0,0,0,0,0,0,0,0,0,0,1,0,0
401371007,Alabama State Hornets,E. Clark,4703117,,False,7.0,2,3,2,3,0,0,0,0,0,0,0,1,0,0,1,1,4
401371007,Alabama State Hornets,C. McCray,4702483,,False,13.0,3,6,2,5,1,1,0,0,1,2,3,0,0,0,0,0,7
401371007,Alabama State Hornets,A. McClelland,4397950,,False,11.0,1,5,0,1,1,4,0,0,0,1,1,2,0,0,0,1,3
401371007,Alabama State Hornets,K. Stewart,4067233,,False,9.0,1,3,0,1,1,2,7,8,1,1,2,1,0,0,0,1,10
401371007,Alabama State Hornets,TEAM,TOTAL,TOTAL,False,,19,54,14,37,5,17,11,15,10,20,30,13,1,5,17,19,54
401371006,Dayton Flyers,R.J. Blakney,4700864,,True,13.0,1,4,1,2,0,2,1,2,0,0,0,0,1,0,1,0,3
401371006,Dayton Flyers,T. Camara,4431736,,True,25.0,6,9,6,7,0,2,2,5,2,4,6,3,3,0,3,4,14
401371006,Dayton Flyers,D. Holmes II,4433607,,True,18.0,1,2,1,1,0,1,3,4,1,4,5,1,0,2,1,4,5
401371006,Dayton Flyers,M. Smith,4683861,,True,17.0,2,4,2,4,0,0,0,0,2,1,3,5,0,0,1,5,4
401371006,Dayton Flyers,E. Weaver,4397139,,True,26.0,2,6,2,3,0,3,2,2,0,1,1,1,3,0,4,2,6
401371006,Dayton Flyers,M. Sissoko,4431824,,False,13.0,5,7,5,7,0,0,2,2,3,1,4,0,0,0,0,4,12
401371006,Dayton Flyers,M. Amzil,4711607,,False,26.0,1,6,1,2,0,4,4,4,2,5,7,0,0,0,1,4,6
401371006,Dayton Flyers,K. Elvis,4683135,,False,23.0,4,8,3,3,1,5,1,2,0,1,1,1,1,0,2,1,10
401371006,Dayton Flyers,K. Brea,4591259,,False,18.0,4,8,2,4,2,4,3,3,0,3,3,0,1,0,2,1,13
401371006,Dayton Flyers,L. Greer III,4433175,,False,21.0,3,6,3,6,0,0,2,2,0,1,1,3,1,1,0,2,8
401371006,Dayton Flyers,TEAM,TOTAL,TOTAL,False,,29,60,26,39,3,21,20,26,14,21,35,14,10,3,15,27,81
401371006,Austin Peay Governors,C. Merritt,4592215,,True,7.0,1,3,0,0,1,3,0,0,0,1,1,2,0,0,1,5,3
401371006,Austin Peay Governors,C. Stone-Carrawell,4592841,,True,33.0,7,12,4,8,3,4,1,2,1,4,5,3,1,0,2,2,18
401371006,Austin Peay Governors,E. Hutchins-Everett,4433161,,True,35.0,6,13,6,11,0,2,13,16,6,8,14,2,0,0,2,3,25
401371006,Austin Peay Governors,C. Paez,4433055,,True,38.0,1,3,0,1,1,2,4,4,0,1,1,6,1,0,3,4,7
401371006,Austin Peay Governors,T. Silver,4279332,,True,38.0,3,7,1,3,2,4,7,11,0,1,1,4,0,1,2,1,15
401371006,Austin Peay Governors,E. Walker,4703214,,False,11.0,1,1,1,1,0,0,1,2,0,0,0,0,0,0,1,1,3
401371006,Austin Peay Governors,A. Diouf,4397276,,False,3.0,0,0,0,0,0,0,0,0,0,0,0,0,0,0,0,3,0
401371006,Austin Peay Governors,C. Copeland,4396777,,False,24.0,5,12,3,7,2,5,1,2,1,4,5,1,0,0,1,0,13
401371006,Austin Peay Governors,D. Calderon,4897237,,False,9.0,1,1,0,0,1,1,0,0,0,0,0,0,0,0,0,0,3
401371006,Austin Peay Governors,N. Scott,4897236,,False,1.0,0,0,0,0,0,0,0,0,0,0,0,0,0,0,0,0,0
401371006,Austin Peay Governors,D. Peavy,4398224,,False,1.0,0,0,0,0,0,0,0,0,0,0,0,1,0,0,0,0,0
401371006,Austin Peay Governors,TEAM,TOTAL,TOTAL,False,,25,52,15,31,10,21,27,37,11,21,32,19,2,1,15,19,87
401371005,Lipscomb Bisons,P. Hazen,4279172,,True,30.0,3,7,3,6,0,1,2,4,0,5,5,0,1,0,2,2,8
401371005,Lipscomb Bisons,A. Asadullah,4278445,,True,29.0,9,13,8,11,1,2,2,3,0,8,8,3,1,3,2,2,21
401371005,Lipscomb Bisons,KJ Johnson,4592273,,True,24.0,3,4,3,4,0,0,2,2,0,1,1,5,1,0,4,1,8
401371005,Lipscomb Bisons,W. Pruitt,4590356,,True,30.0,1,3,0,2,1,1,0,0,1,2,3,8,0,0,0,3,3
401371005,Lipscomb Bisons,G. Jones,4278444,,True,35.0,4,7,1,1,3,6,4,4,0,3,3,1,2,0,2,2,15
401371005,Lipscomb Bisons,J. Ognacevic,4703983,,False,20.0,2,5,2,3,0,2,0,0,0,3,3,0,0,1,1,2,4
401371005,Lipscomb Bisons,K. Coleman,4592274,,False,1.0,0,1,0,0,0,1,0,0,0,0,0,0,0,0,0,0,0
401371005,Lipscomb Bisons,Q. Clark,4897581,,False,5.0,0,0,0,0,0,0,0,0,0,0,0,0,0,0,0,0,0
401371005,Lipscomb Bisons,T. Benham,4897579,,False,1.0,0,0,0,0,0,0,0,0,0,0,0,0,0,0,0,0,0
401371005,Lipscomb Bisons,T. Murr,4700835,,False,24.0,7,9,2,4,5,5,0,0,0,2,2,2,2,0,0,4,19
401371005,Lipscomb Bisons,T. Shulman,4592275,,False,1.0,0,0,0,0,0,0,0,0,0,0,0,0,0,0,0,0,0
401371005,Lipscomb Bisons,TEAM,TOTAL,TOTAL,False,,29,49,19,31,10,18,10,13,2,26,28,19,7,4,12,16,78
401371005,Dayton Flyers,R.J. Blakney,4700864,,True,12.0,0,0,0,0,0,0,1,2,1,0,1,0,0,1,2,3,1
401371005,Dayton Flyers,T. Camara,4431736,,True,31.0,5,12,4,6,1,6,0,0,2,4,6,1,1,1,3,3,11
401371005,Dayton Flyers,D. Holmes II,4433607,,True,18.0,1,6,1,6,0,0,0,0,0,1,1,0,0,2,0,0,2
401371005,Dayton Flyers,K. Elvis,4683135,,True,21.0,3,6,3,5,0,1,3,3,0,1,1,0,2,0,3,0,9
401371005,Dayton Flyers,E. Weaver,4397139,,True,31.0,3,7,2,4,1,3,4,4,0,3,3,3,0,0,1,1,11
401371005,Dayton Flyers,M. Sissoko,4431824,,False,19.0,1,1,1,1,0,0,1,3,4,4,8,0,0,0,0,1,3
401371005,Dayton Flyers,M. Amzil,4711607,,False,24.0,3,10,1,3,2,7,0,0,0,1,1,1,0,0,0,1,8
401371005,Dayton Flyers,M. Smith,4683861,,False,31.0,3,6,2,4,1,2,4,5,0,4,4,4,2,1,3,1,11
401371005,Dayton Flyers,K. Brea,4591259,,False,13.0,1,4,0,2,1,2,0,0,0,1,1,0,0,0,0,1,3
401371005,Dayton Flyers,TEAM,TOTAL,TOTAL,False,,20,52,14,31,6,21,13,17,8,19,27,9,5,5,13,11,59
401371004,UMass Lowell River Hawks,M. Brooks,4700953,,True,17.0,2,5,2,5,0,0,1,2,0,0,0,0,1,1,1,4,5
401371004,UMass Lowell River Hawks,Al. Blunt,4396569,,True,28.0,2,5,1,3,1,2,2,2,1,0,1,0,0,0,2,2,7
401371004,UMass Lowell River Hawks,K. Thomas,4592912,,True,26.0,3,9,3,4,0,5,0,0,1,2,3,1,1,0,0,2,6
401371004,UMass Lowell River Hawks,E. Hammond,4397833,,True,29.0,2,7,2,5,0,2,4,5,1,3,4,0,3,0,0,1,8
401371004,UMass Lowell River Hawks,J. Faison,4290752,,True,31.0,8,16,3,5,5,11,0,0,0,4,4,0,0,0,3,3,21
401371004,UMass Lowell River Hawks,D. Jordan-Thomas,4433017,,False,10.0,0,2,0,2,0,0,0,0,1,3,4,0,0,0,0,4,0
401371004,UMass Lowell River Hawks,J. Hall,4066996,,False,13.0,1,7,1,5,0,2,0,0,4,1,5,1,0,0,0,1,2
401371004,UMass Lowell River Hawks,An. Blunt,4700954,,False,10.0,0,1,0,1,0,0,0,0,0,1,1,0,0,0,0,0,0
401371004,UMass Lowell River Hawks,Q. Mincey,4567710,,False,11.0,1,2,1,1,0,1,0,0,0,2,2,0,0,0,0,1,2
401371004,UMass Lowell River Hawks,A. Hikim,4431843,,False,18.0,3,6,1,3,2,3,0,0,0,2,2,3,1,0,2,1,8
401371004,UMass Lowell River Hawks,G. Hammond,4431822,,False,7.0,0,2,0,2,0,0,0,0,1,2,3,0,0,0,0,1,0
401371004,UMass Lowell River Hawks,TEAM,TOTAL,TOTAL,False,,22,62,14,36,8,26,7,9,14,20,34,5,6,1,8,20,59
401371004,Dayton Flyers,R.J. Blakney,4700864,,True,31.0,3,7,1,2,2,5,4,4,0,9,9,3,0,0,0,2,12
401371004,Dayton Flyers,T. Camara,4431736,,True,30.0,1,2,1,2,0,0,2,3,2,5,7,2,0,0,3,3,4
401371004,Dayton Flyers,D. Holmes II,4433607,,True,33.0,6,10,6,10,0,0,1,2,6,0,6,0,0,6,2,1,13
401371004,Dayton Flyers,K. Elvis,4683135,,True,18.0,0,4,0,1,0,3,0,0,1,3,4,1,1,0,1,0,0
401371004,Dayton Flyers,K. Brea,4591259,,True,20.0,2,7,0,1,2,6,0,0,0,1,1,1,0,1,1,0,6
401371004,Dayton Flyers,M. Sissoko,4431824,,False,2.0,0,0,0,0,0,0,0,0,0,0,0,0,0,0,0,0,0
401371004,Dayton Flyers,M. Amzil,4711607,,False,15.0,1,4,0,0,1,4,0,2,0,3,3,1,0,0,2,1,3
401371004,Dayton Flyers,M. Smith,4683861,,False,25.0,1,1,1,1,0,0,6,7,0,0,0,1,0,0,2,1,8
401371004,Dayton Flyers,L. Greer III,4433175,,False,1.0,0,2,0,2,0,0,0,0,0,1,1,0,0,0,0,0,0
401371004,Dayton Flyers,E. Weaver,4397139,,False,25.0,4,9,2,4,2,5,2,3,0,4,4,0,0,0,3,3,12
401371004,Dayton Flyers,TEAM,TOTAL,TOTAL,False,,18,46,11,23,7,23,15,21,11,27,38,9,1,7,15,11,58
401371003,UIC Flames,Z. Griffin,4396988,,True,25.0,6,11,1,3,5,8,0,0,1,2,3,1,1,0,1,5,17
401371003,UIC Flames,M. Diggins,4279245,,True,21.0,2,7,2,5,0,2,0,0,1,4,5,0,0,1,1,3,4
401371003,UIC Flames,D. Franklin,4703420,,True,28.0,5,13,2,4,3,9,0,0,1,3,4,1,2,0,1,4,13
401371003,UIC Flames,J. Ahale,4397767,,True,31.0,2,7,0,1,2,6,0,0,0,3,3,0,0,0,0,3,6
401371003,UIC Flames,K. Johnson,4278304,,True,38.0,5,8,5,8,0,0,0,0,0,2,2,7,1,0,3,1,10
401371003,UIC Flames,B. Battle,4594022,,False,19.0,0,2,0,2,0,0,0,0,0,2,2,2,0,1,2,2,0
401371003,UIC Flames,J. Carter,4898186,,False,17.0,1,4,1,2,0,2,0,0,2,4,6,1,0,0,0,3,2
401371003,UIC Flames,J. Warren,4592250,,False,21.0,0,5,0,4,0,1,2,2,0,1,1,3,1,0,0,1,2
401371003,UIC Flames,TEAM,TOTAL,TOTAL,False,,21,57,11,29,10,28,2,2,6,21,27,15,5,2,10,22,54
401371003,Dayton Flyers,R.J. Blakney,4700864,,True,25.0,3,4,2,2,1,2,2,4,1,2,3,2,1,0,1,4,9
401371003,Dayton Flyers,T. Camara,4431736,,True,30.0,7,10,7,9,0,1,1,1,2,8,10,2,1,0,2,1,15
401371003,Dayton Flyers,D. Holmes II,4433607,,True,30.0,4,8,4,8,0,0,1,3,1,3,4,1,0,1,1,0,9
401371003,Dayton Flyers,K. Elvis,4683135,,True,36.0,4,12,3,8,1,4,1,2,1,6,7,2,0,0,3,2,10
401371003,Dayton Flyers,K. Brea,4591259,,True,26.0,2,6,2,4,0,2,2,4,1,3,4,2,0,0,1,0,6
401371003,Dayton Flyers,M. Sissoko,4431824,,False,2.0,0,0,0,0,0,0,0,0,0,0,0,0,0,0,0,0,0
401371003,Dayton Flyers,M. Amzil,4711607,,False,18.0,0,2,0,0,0,2,5,7,3,3,6,0,1,0,0,1,5
401371003,Dayton Flyers,M. Smith,4683861,,False,9.0,1,2,1,2,0,0,0,0,0,2,2,0,0,0,1,1,2
401371003,Dayton Flyers,E. Weaver,4397139,,False,24.0,3,7,3,4,0,3,2,2,0,2,2,2,0,0,0,0,8
401371003,Dayton Flyers,TEAM,TOTAL,TOTAL,False,,24,51,22,37,2,14,14,23,12,29,41,11,3,1,9,9,64
401371001,Radford Highlanders,L. Djonkam,4278422,,True,8.0,0,0,0,0,0,0,2,2,1,0,1,0,0,0,1,3,2
401371001,Radford Highlanders,R. Williams,4396643,,True,28.0,3,9,1,3,2,6,0,0,2,5,7,1,0,0,5,2,8
401371001,Radford Highlanders,C. McNeil,4897647,,True,19.0,1,8,1,4,0,4,0,0,1,0,1,2,0,0,2,0,2
401371001,Radford Highlanders,X. Lipscomb,4702218,,True,15.0,0,1,0,0,0,1,0,0,1,1,2,3,0,0,1,1,0
401371001,Radford Highlanders,B. Hart,4702216,,True,28.0,4,8,2,2,2,6,2,2,0,2,2,2,0,0,0,1,12
401371001,Radford Highlanders,S. Jules,4702215,,False,17.0,4,4,4,4,0,0,4,6,3,4,7,0,0,0,0,2,12
401371001,Radford Highlanders,J. Walker,4702214,,False,4.0,0,0,0,0,0,0,0,0,0,0,0,0,0,0,0,0,0
401371001,Radford Highlanders,D. Mangum,4397471,,False,17.0,3,8,1,3,2,5,0,0,0,2,2,0,0,0,1,1,8
401371001,Radford Highlanders,C. Walker,4279192,,False,10.0,0,1,0,1,0,0,0,0,0,1,1,1,1,0,1,2,0
401371001,Radford Highlanders,A. Brown,4902374,,False,1.0,0,1,0,0,0,1,0,0,0,0,0,0,0,0,0,0,0
401371001,Radford Highlanders,D. Jones Jr.,4897646,,False,3.0,0,0,0,0,0,0,0,0,0,0,0,0,0,0,0,1,0
401371001,Radford Highlanders,A. Stapleton,4708648,,False,25.0,2,4,2,3,0,1,0,0,2,0,2,1,1,0,6,3,4
401371001,Radford Highlanders,T. Joseph,4703215,,False,17.0,2,3,0,0,2,3,0,0,0,2,2,0,1,0,1,2,6
401371001,Radford Highlanders,K. Porter,4702212,,False,8.0,0,1,0,0,0,1,0,0,0,1,1,0,0,0,1,0,0
401371001,Radford Highlanders,TEAM,TOTAL,TOTAL,False,,19,48,11,20,8,28,8,10,10,19,29,10,3,0,20,18,54
401371001,Davidson Wildcats,S. Mennenga,4700862,,True,19.0,1,3,1,3,0,0,0,0,1,3,4,1,1,0,3,2,2
401371001,Davidson Wildcats,L. Brajkovic,4396787,,True,19.0,6,7,6,7,0,0,0,0,2,4,6,1,1,1,3,4,12
401371001,Davidson Wildcats,H. Lee,4592308,,True,28.0,5,9,4,5,1,4,3,4,0,6,6,3,1,0,0,2,14
401371001,Davidson Wildcats,F. Loyer,4397208,,True,30.0,8,14,4,4,4,10,4,4,0,0,0,4,0,0,1,3,24
401371001,Davidson Wildcats,M. Jones,4396784,,True,27.0,5,9,3,4,2,5,3,3,1,1,2,2,3,0,1,0,15
401371001,Davidson Wildcats,C. Ford,4897099,,False,2.0,0,0,0,0,0,0,0,0,0,0,0,0,0,0,0,0,0
401371001,Davidson Wildcats,D. Kristensen,4432020,,False,8.0,1,1,1,1,0,0,0,0,0,0,0,1,0,0,0,2,2
401371001,Davidson Wildcats,N. Boachie-Yiadom,4396786,,False,19.0,0,0,0,0,0,0,0,0,0,0,0,1,1,1,0,0,0
401371001,Davidson Wildcats,M. Katsock,4902569,,False,1.0,0,0,0,0,0,0,0,0,0,0,0,0,0,0,0,0,0
401371001,Davidson Wildcats,S. Thrastarson,4897100,,False,3.0,0,1,0,1,0,0,0,0,0,0,0,1,0,0,0,0,0
401371001,Davidson Wildcats,D. Watson,4897098,,False,15.0,0,1,0,1,0,0,0,0,0,0,0,2,0,0,1,1,0
401371001,Davidson Wildcats,B. Craig,4700863,,False,1.0,0,0,0,0,0,0,0,0,0,1,1,0,0,0,0,0,0
401371001,Davidson Wildcats,D. Dibble,4592309,,False,1.0,1,1,0,0,1,1,0,0,0,0,0,0,0,0,0,0,3
401371001,Davidson Wildcats,E. Lanier,4567082,,False,4.0,0,0,0,0,0,0,2,2,0,1,1,0,0,0,1,0,2
401371001,Davidson Wildcats,G. Huffman,4432522,,False,23.0,0,3,0,1,0,2,0,2,0,2,2,1,0,0,0,2,0
401371001,Davidson Wildcats,TEAM,TOTAL,TOTAL,False,,27,49,19,27,8,22,12,15,4,20,24,17,7,2,10,16,74
401371000,Northeastern Huskies,C. Doherty,4395666,,True,39.0,3,9,3,8,0,1,4,4,2,4,6,0,0,0,1,0,10
401371000,Northeastern Huskies,J. Strong,4279220,,True,26.0,3,10,1,5,2,5,2,2,0,3,3,3,0,0,2,1,10
401371000,Northeastern Huskies,T. Scott-Grayson,4397725,,True,36.0,7,13,5,8,2,5,4,5,0,6,6,5,1,1,1,3,20
401371000,Northeastern Huskies,S. Walters,4280251,,True,33.0,2,5,1,1,1,4,1,2,0,4,4,3,0,0,1,1,6
401371000,Northeastern Huskies,N. Djogo,4065704,,True,35.0,5,8,2,3,3,5,2,3,0,5,5,2,2,0,1,2,15
401371000,Northeastern Huskies,C. Braun,4592983,,False,1.0,0,0,0,0,0,0,0,0,0,0,0,0,0,0,0,0,0
401371000,Northeastern Huskies,J. Telfort,4702785,,False,4.0,0,1,0,0,0,1,0,0,0,0,0,0,0,0,2,1,0
401371000,Northeastern Huskies,T. Randriasalama,4897707,,False,9.0,2,3,1,1,1,2,0,0,0,0,0,0,0,0,0,0,5
401371000,Northeastern Huskies,Q. Emanga,4592982,,False,17.0,1,1,0,0,1,1,0,0,0,0,0,0,0,1,0,2,3
401371000,Northeastern Huskies,TEAM,TOTAL,TOTAL,False,,23,50,13,26,10,24,13,16,2,22,24,13,3,2,11,10,69
401371000,Davidson Wildcats,S. Mennenga,4700862,,True,25.0,2,5,2,5,0,0,0,0,2,1,3,2,0,0,1,1,4
401371000,Davidson Wildcats,L. Brajkovic,4396787,,True,33.0,2,5,2,4,0,1,0,0,1,6,7,3,0,3,1,2,4
401371000,Davidson Wildcats,H. Lee,4592308,,True,33.0,9,18,5,6,4,12,1,1,1,4,5,2,0,0,3,4,23
401371000,Davidson Wildcats,F. Loyer,4397208,,True,31.0,10,18,2,6,8,12,7,7,1,2,3,0,3,0,0,2,35
401371000,Davidson Wildcats,M. Jones,4396784,,True,28.0,5,9,5,6,0,3,0,0,0,3,3,5,2,0,0,2,10
401371000,Davidson Wildcats,D. Kristensen,4432020,,False,4.0,0,0,0,0,0,0,0,0,0,2,2,0,0,0,0,0,0
401371000,Davidson Wildcats,N. Boachie-Yiadom,4396786,,False,16.0,0,0,0,0,0,0,0,0,1,2,3,2,0,0,0,1,0
401371000,Davidson Wildcats,D. Watson,4897098,,False,13.0,0,3,0,2,0,1,0,0,0,2,2,1,0,0,1,0,0
401371000,Davidson Wildcats,G. Huffman,4432522,,False,17.0,1,1,0,0,1,1,0,0,0,1,1,2,0,0,1,2,3
401371000,Davidson Wildcats,TEAM,TOTAL,TOTAL,False,,29,59,16,29,13,30,8,8,6,23,29,17,5,3,8,14,79
401370999,William & Mary Tribe,B. Wight,4433119,,True,23.0,1,3,1,2,0,1,0,0,0,2,2,1,1,0,2,5,2
401370999,William & Mary Tribe,L. Hatton,4897719,,True,29.0,0,1,0,1,0,0,4,8,1,1,2,0,0,1,0,3,4
401370999,William & Mary Tribe,Y. Covington,4702871,,True,30.0,3,8,1,3,2,5,6,8,0,3,3,0,0,0,2,3,14
401370999,William & Mary Tribe,R. Hermanovskis,4592987,,True,13.0,0,2,0,1,0,1,0,0,0,0,0,0,0,0,1,0,0
401370999,William & Mary Tribe,C. Kochera,4585606,,True,35.0,6,14,4,7,2,7,4,6,0,9,9,3,0,0,2,1,18
401370999,William & Mary Tribe,T. Rice,4897718,,False,25.0,0,4,0,2,0,2,0,0,0,1,1,2,2,0,2,1,0
401370999,William & Mary Tribe,J. Lewis,4897717,,False,27.0,2,8,0,3,2,5,2,4,1,4,5,0,2,0,2,1,8
401370999,William & Mary Tribe,M. Ayesa,4592988,,False,6.0,0,2,0,0,0,2,0,0,0,0,0,0,0,0,1,2,0
401370999,William & Mary Tribe,A. Washburn,4397605,,False,1.0,0,1,0,0,0,1,0,0,0,1,1,0,0,0,0,0,0
401370999,William & Mary Tribe,B. Carroll,4067526,,False,11.0,0,3,0,1,0,2,0,0,0,3,3,0,0,0,2,2,0
401370999,William & Mary Tribe,TEAM,TOTAL,TOTAL,False,,12,46,6,20,6,26,16,26,3,26,29,6,5,1,14,18,46
401370999,Davidson Wildcats,S. Mennenga,4700862,,True,22.0,1,3,1,3,0,0,0,0,2,4,6,2,0,0,0,2,2
401370999,Davidson Wildcats,L. Brajkovic,4396787,,True,34.0,8,14,8,10,0,4,0,1,2,5,7,1,1,2,4,2,16
401370999,Davidson Wildcats,H. Lee,4592308,,True,28.0,3,8,2,5,1,3,5,7,2,8,10,4,1,0,3,2,12
401370999,Davidson Wildcats,F. Loyer,4397208,,True,26.0,5,13,2,7,3,6,2,2,1,2,3,2,1,0,1,4,15
401370999,Davidson Wildcats,M. Jones,4396784,,True,17.0,3,4,1,2,2,2,0,0,0,3,3,2,2,0,0,3,8
401370999,Davidson Wildcats,C. Ford,4897099,,False,1.0,0,0,0,0,0,0,0,0,0,0,0,0,0,0,0,0,0
401370999,Davidson Wildcats,D. Kristensen,4432020,,False,5.0,1,2,1,2,0,0,0,0,2,1,3,0,0,0,1,2,2
401370999,Davidson Wildcats,N. Boachie-Yiadom,4396786,,False,16.0,0,1,0,0,0,1,0,1,2,3,5,0,0,0,2,2,0
401370999,Davidson Wildcats,S. Thrastarson,4897100,,False,4.0,0,0,0,0,0,0,0,2,0,0,0,0,0,0,1,0,0
401370999,Davidson Wildcats,D. Watson,4897098,,False,21.0,4,6,3,3,1,3,0,0,0,2,2,0,0,0,1,1,9
401370999,Davidson Wildcats,E. Lanier,4567082,,False,4.0,0,2,0,1,0,1,0,0,0,3,3,0,1,1,0,1,0
401370999,Davidson Wildcats,G. Huffman,4432522,,False,22.0,3,8,3,5,0,3,0,2,0,3,3,1,2,0,2,2,6
401370999,Davidson Wildcats,TEAM,TOTAL,TOTAL,False,,28,61,21,38,7,23,7,15,13,36,49,12,8,3,15,21,70
401370998,Davidson Wildcats,S. Mennenga,4700862,,True,26.0,1,5,1,5,0,0,0,0,1,2,3,4,1,0,2,0,2
401370998,Davidson Wildcats,L. Brajkovic,4396787,,True,29.0,1,4,1,3,0,1,1,2,1,5,6,2,0,2,2,3,3
401370998,Davidson Wildcats,H. Lee,4592308,,True,35.0,9,17,3,5,6,12,8,8,1,13,14,0,0,0,2,1,32
401370998,Davidson Wildcats,F. Loyer,4397208,,True,24.0,2,4,0,0,2,4,2,2,1,1,2,2,1,0,2,1,8
401370998,Davidson Wildcats,M. Jones,4396784,,True,26.0,5,7,2,3,3,4,5,5,1,2,3,2,2,0,1,0,18
401370998,Davidson Wildcats,D. Kristensen,4432020,,False,4.0,0,1,0,1,0,0,0,0,0,0,0,1,0,1,0,1,0
401370998,Davidson Wildcats,N. Boachie-Yiadom,4396786,,False,13.0,1,1,1,1,0,0,0,0,0,1,1,2,1,0,0,3,2
401370998,Davidson Wildcats,D. Watson,4897098,,False,19.0,2,5,2,5,0,0,2,2,0,1,1,0,0,0,0,1,6
401370998,Davidson Wildcats,G. Huffman,4432522,,False,24.0,2,5,2,5,0,0,0,0,1,1,2,1,3,0,2,1,4
401370998,Davidson Wildcats,TEAM,TOTAL,TOTAL,False,,23,49,12,28,11,21,18,19,6,27,33,14,8,3,12,11,75
401370998,Charlotte 49ers,A. Khalifa,4702739,,True,33.0,7,12,4,7,3,5,1,1,2,4,6,2,1,0,2,2,18
401370998,Charlotte 49ers,J. Threadgill,4702738,,True,23.0,0,2,0,1,0,1,0,0,0,1,1,0,0,1,1,0,0
401370998,Charlotte 49ers,J. Young,4433133,,True,38.0,3,11,1,4,2,7,2,2,0,3,3,4,1,1,3,1,10
401370998,Charlotte 49ers,A. Butler,4280070,,True,25.0,1,8,1,4,0,4,0,0,2,5,7,1,1,0,4,3,2
401370998,Charlotte 49ers,C. Trapp Jr.,4277833,,True,35.0,3,7,3,4,0,3,0,0,0,4,4,4,1,0,0,3,6
401370998,Charlotte 49ers,J. Garcia,4702740,,False,6.0,1,3,1,3,0,0,0,0,0,1,1,0,0,0,0,0,2
401370998,Charlotte 49ers,R. Braswell,4395675,,False,12.0,2,5,0,1,2,4,2,2,0,0,0,0,0,0,0,5,8
401370998,Charlotte 49ers,L. Vasic,4278934,,False,9.0,1,3,0,2,1,1,0,0,0,1,1,0,1,0,1,0,3
401370998,Charlotte 49ers,I. Folkes,4712255,,False,0.0,0,0,0,0,0,0,0,0,0,0,0,0,0,0,1,0,0
401370998,Charlotte 49ers,M. Cannon,4397168,,False,19.0,4,6,3,4,1,2,0,0,3,1,4,2,1,1,1,0,9
401370998,Charlotte 49ers,TEAM,TOTAL,TOTAL,False,,22,57,13,30,9,27,5,5,8,21,29,13,6,3,13,14,58
401370997,Robert Morris Colonials,J. Williams,4703403,,True,31.0,6,10,5,7,1,3,0,2,0,3,3,2,1,0,3,4,13
401370997,Robert Morris Colonials,K. Spear,4702997,,True,30.0,6,17,6,15,0,2,3,5,1,8,9,2,1,1,1,3,15
401370997,Robert Morris Colonials,J. Winston,4431854,,True,24.0,4,8,3,5,1,3,0,0,0,2,2,0,0,0,2,1,9
401370997,Robert Morris Colonials,E. Cheeks,4703000,,True,32.0,1,3,0,1,1,2,1,2,0,2,2,3,0,0,0,2,4
401370997,Robert Morris Colonials,R. Dunn,4067955,,True,28.0,1,6,1,5,0,1,2,2,2,2,4,3,0,0,2,3,4
401370997,Robert Morris Colonials,M. Mayers,4898180,,False,13.0,2,2,2,2,0,0,3,3,0,3,3,2,0,0,0,0,7
401370997,Robert Morris Colonials,B. Stone,4432906,,False,10.0,3,4,2,2,1,2,0,0,0,1,1,0,0,1,0,1,7
401370997,Robert Morris Colonials,T. Jeffries,4898179,,False,3.0,0,0,0,0,0,0,0,0,0,0,0,0,1,0,0,1,0
401370997,Robert Morris Colonials,K. Farris,4702996,,False,29.0,4,6,1,1,3,5,0,0,0,1,1,3,0,0,2,1,11
401370997,Robert Morris Colonials,TEAM,TOTAL,TOTAL,False,,27,56,20,38,7,18,9,14,3,23,26,15,3,2,10,16,70
401370997,Davidson Wildcats,S. Mennenga,4700862,,True,21.0,3,6,3,5,0,1,0,0,2,2,4,1,0,0,0,1,6
401370997,Davidson Wildcats,L. Brajkovic,4396787,,True,30.0,5,11,5,9,0,2,0,0,3,5,8,3,1,1,2,1,10
401370997,Davidson Wildcats,H. Lee,4592308,,True,27.0,10,15,8,9,2,6,1,1,0,3,3,4,1,0,0,2,23
401370997,Davidson Wildcats,F. Loyer,4397208,,True,22.0,3,6,1,2,2,4,0,0,0,4,4,5,1,0,1,1,8
401370997,Davidson Wildcats,M. Jones,4396784,,True,26.0,4,8,1,1,3,7,4,4,0,3,3,3,1,0,0,0,15
401370997,Davidson Wildcats,C. Ford,4897099,,False,3.0,0,2,0,2,0,0,0,0,0,0,0,0,0,0,0,0,0
401370997,Davidson Wildcats,N. Boachie-Yiadom,4396786,,False,19.0,2,3,2,3,0,0,0,0,1,4,5,1,0,0,1,2,4
401370997,Davidson Wildcats,M. Katsock,4902569,,False,2.0,0,0,0,0,0,0,0,0,0,0,0,0,0,0,1,0,0
401370997,Davidson Wildcats,S. Thrastarson,4897100,,False,4.0,0,0,0,0,0,0,2,2,1,0,1,0,0,1,0,1,2
401370997,Davidson Wildcats,D. Watson,4897098,,False,17.0,5,6,4,5,1,1,0,1,0,2,2,2,0,0,1,0,11
401370997,Davidson Wildcats,B. Craig,4700863,,False,2.0,0,1,0,1,0,0,0,0,0,0,0,0,0,0,0,0,0
401370997,Davidson Wildcats,D. Dibble,4592309,,False,2.0,0,0,0,0,0,0,0,0,0,0,0,0,0,0,0,0,0
401370997,Davidson Wildcats,E. Lanier,4567082,,False,4.0,0,1,0,1,0,0,1,2,0,1,1,0,0,0,0,1,1
401370997,Davidson Wildcats,G. Huffman,4432522,,False,21.0,3,4,3,4,0,0,2,4,0,5,5,2,1,0,1,1,8
401370997,Davidson Wildcats,TEAM,TOTAL,TOTAL,False,,35,63,27,42,8,21,10,14,7,29,36,21,5,2,7,10,88
401370996,San Francisco Dons,Y. Massalski,4285624,,True,21.0,3,5,3,4,0,1,1,5,3,4,7,0,0,1,3,4,7
401370996,San Francisco Dons,P. Tapé,4066805,,True,12.0,0,0,0,0,0,0,0,0,0,0,0,0,0,0,1,3,0
401370996,San Francisco Dons,K. Shabazz,4397745,,True,32.0,3,10,2,5,1,5,1,2,0,3,3,4,6,0,1,2,8
401370996,San Francisco Dons,J. Bouyea,4280245,,True,38.0,6,14,4,7,2,7,0,0,1,4,5,1,4,0,5,3,14
401370996,San Francisco Dons,G. Stefanini,4279467,,True,30.0,3,9,2,5,1,4,5,5,0,2,2,4,1,0,2,0,12
401370996,San Francisco Dons,J. Kunen,4432026,,False,32.0,3,6,0,0,3,6,2,2,1,5,6,2,2,0,2,4,11
401370996,San Francisco Dons,D. Ryuny,4397744,,False,10.0,2,2,1,1,1,1,2,2,0,0,0,0,0,1,0,0,7
401370996,San Francisco Dons,V. Markovetskyy,4592672,,False,14.0,2,2,2,2,0,0,2,3,1,3,4,0,0,1,1,2,6
401370996,San Francisco Dons,J. Rishwain,4431875,,False,10.0,0,0,0,0,0,0,0,0,0,3,3,0,0,0,2,2,0
401370996,San Francisco Dons,TEAM,TOTAL,TOTAL,False,,22,48,14,24,8,24,13,19,6,25,31,11,13,3,18,20,65
401370996,Davidson Wildcats,S. Mennenga,4700862,,True,33.0,6,11,5,10,1,1,1,2,1,8,9,0,2,1,2,4,14
401370996,Davidson Wildcats,L. Brajkovic,4396787,,True,21.0,6,8,5,6,1,2,4,7,0,3,3,0,0,1,3,4,17
401370996,Davidson Wildcats,H. Lee,4592308,,True,37.0,3,9,2,5,1,4,4,4,2,7,9,2,2,0,4,1,11
401370996,Davidson Wildcats,F. Loyer,4397208,,True,33.0,3,12,2,9,1,3,0,2,0,2,2,3,2,0,4,2,7
401370996,Davidson Wildcats,M. Jones,4396784,,True,31.0,1,5,1,3,0,2,3,4,1,1,2,0,2,0,1,4,5
401370996,Davidson Wildcats,D. Kristensen,4432020,,False,5.0,0,0,0,0,0,0,0,0,0,0,0,0,0,0,2,1,0
401370996,Davidson Wildcats,N. Boachie-Yiadom,4396786,,False,18.0,0,1,0,1,0,0,0,0,0,1,1,0,2,0,0,2,0
401370996,Davidson Wildcats,D. Watson,4897098,,False,5.0,0,2,0,1,0,1,0,0,0,0,0,0,0,0,0,1,0
401370996,Davidson Wildcats,G. Huffman,4432522,,False,17.0,2,2,1,1,1,1,1,2,1,1,2,0,1,0,1,0,6
401370996,Davidson Wildcats,TEAM,TOTAL,TOTAL,False,,21,50,16,36,5,14,13,21,7,25,32,5,11,2,17,19,60
401370995,Delaware Blue Hens,A. Carr,4702743,,True,25.0,4,7,4,6,0,1,1,1,1,3,4,0,0,0,1,1,9
401370995,Delaware Blue Hens,D. Painter,4065840,,True,30.0,4,6,4,6,0,0,9,10,5,1,6,1,2,0,0,1,17
401370995,Delaware Blue Hens,J. Nelson Jr.,4592444,,True,31.0,4,13,2,6,2,7,1,1,3,3,6,3,1,0,2,5,11
401370995,Delaware Blue Hens,R. Allen,4279190,,True,29.0,3,13,2,7,1,6,2,2,0,3,3,3,2,1,5,0,9
401370995,Delaware Blue Hens,K. Anderson,4279189,,True,26.0,4,6,2,2,2,4,1,4,0,4,4,0,0,0,2,3,11
401370995,Delaware Blue Hens,O. Ogunbo,4708951,,False,2.0,0,0,0,0,0,0,1,2,1,0,1,0,0,0,1,0,1
401370995,Delaware Blue Hens,J. Davis,4701989,,False,16.0,2,7,2,5,0,2,0,0,1,0,1,1,0,0,0,1,4
401370995,Delaware Blue Hens,W. Peterson,4897008,,False,10.0,1,1,1,1,0,0,0,0,1,0,1,1,0,0,1,1,2
401370995,Delaware Blue Hens,G. Arletti,4702742,,False,11.0,1,3,0,1,1,2,0,0,0,1,1,0,1,0,0,2,3
401370995,Delaware Blue Hens,E. Asamoah,4597790,,False,10.0,0,0,0,0,0,0,2,2,1,0,1,0,0,0,1,4,2
401370995,Delaware Blue Hens,F. Rullo IV,4597789,,False,1.0,0,0,0,0,0,0,0,0,0,2,2,0,0,0,0,0,0
401370995,Delaware Blue Hens,L. Curtis,4432963,,False,3.0,0,1,0,1,0,0,2,2,0,0,0,0,0,0,0,0,2
401370995,Delaware Blue Hens,R. Gardner Jr.,4398238,,False,5.0,0,0,0,0,0,0,0,0,0,0,0,0,0,0,0,0,0
401370995,Delaware Blue Hens,D. Long,4397403,,False,1.0,0,0,0,0,0,0,0,0,0,0,0,0,0,0,0,0,0
401370995,Delaware Blue Hens,TEAM,TOTAL,TOTAL,False,,23,57,17,35,6,22,19,24,13,18,31,9,6,1,14,18,71
401370995,Davidson Wildcats,S. Mennenga,4700862,,True,30.0,5,9,4,7,1,2,2,4,2,8,10,5,0,1,4,3,13
401370995,Davidson Wildcats,L. Brajkovic,4396787,,True,13.0,3,4,2,3,1,1,0,0,2,2,4,1,0,0,1,5,7
401370995,Davidson Wildcats,H. Lee,4592308,,True,29.0,5,9,2,6,3,3,2,3,0,5,5,5,0,1,0,1,15
401370995,Davidson Wildcats,F. Loyer,4397208,,True,23.0,10,12,4,6,6,6,1,2,0,2,2,1,0,0,1,3,27
401370995,Davidson Wildcats,M. Jones,4396784,,True,25.0,3,7,1,2,2,5,5,6,0,2,2,0,1,1,1,4,13
401370995,Davidson Wildcats,C. Ford,4897099,,False,2.0,0,0,0,0,0,0,0,0,0,0,0,0,0,0,0,0,0
401370995,Davidson Wildcats,D. Kristensen,4432020,,False,8.0,1,1,1,1,0,0,0,0,0,0,0,1,0,0,0,1,2
401370995,Davidson Wildcats,N. Boachie-Yiadom,4396786,,False,22.0,1,2,1,2,0,0,2,2,1,2,3,3,0,0,0,1,4
401370995,Davidson Wildcats,S. Thrastarson,4897100,,False,2.0,0,1,0,0,0,1,0,0,0,2,2,0,0,0,0,1,0
401370995,Davidson Wildcats,D. Watson,4897098,,False,16.0,2,5,1,2,1,3,1,1,0,0,0,1,1,0,0,1,6
401370995,Davidson Wildcats,B. Craig,4700863,,False,1.0,0,0,0,0,0,0,0,0,0,0,0,0,0,0,0,0,0
401370995,Davidson Wildcats,D. Dibble,4592309,,False,1.0,0,1,0,0,0,1,0,0,0,0,0,0,0,0,0,0,0
401370995,Davidson Wildcats,E. Lanier,4567082,,False,2.0,0,0,0,0,0,0,0,0,0,0,0,1,0,0,0,1,0
401370995,Davidson Wildcats,G. Huffman,4432522,,False,26.0,2,3,2,2,0,1,2,2,0,1,1,2,3,0,3,2,6
401370995,Davidson Wildcats,TEAM,TOTAL,TOTAL,False,,32,54,18,31,14,23,15,20,5,24,29,20,5,3,10,23,93
401370984,Stony Brook Seawolves,M. Diallo,4701164,,True,13.0,1,2,1,1,0,1,0,0,0,2,2,1,2,1,0,1,2
401370984,Stony Brook Seawolves,J. Rodriguez,4701163,,True,23.0,3,6,3,4,0,2,0,0,0,0,0,0,0,0,0,1,6
401370984,Stony Brook Seawolves,A. Roberts,4701015,,True,26.0,4,13,3,9,1,4,1,1,0,3,3,0,1,0,1,2,10
401370984,Stony Brook Seawolves,J. Jenkins,4279625,,True,32.0,5,14,2,8,3,6,0,0,0,1,1,0,3,0,5,2,13
401370984,Stony Brook Seawolves,E. Olaniyi,4278240,,True,32.0,3,10,2,5,1,5,1,2,0,4,4,1,2,0,2,1,8
401370984,Stony Brook Seawolves,Pa. Shumpert,4710328,,False,2.0,0,2,0,0,0,2,0,0,0,0,0,0,0,0,0,0,0
401370984,Stony Brook Seawolves,F. Policelli,4396789,,False,14.0,1,6,1,2,0,4,0,0,2,2,4,0,0,0,1,2,2
401370984,Stony Brook Seawolves,J. Sayles,4279310,,False,10.0,0,0,0,0,0,0,0,0,0,0,0,0,0,0,0,0,0
401370984,Stony Brook Seawolves,A. Christie,4396587,,False,1.0,0,0,0,0,0,0,0,0,0,0,0,0,0,0,0,0,0
401370984,Stony Brook Seawolves,T. Pettway,4897992,,False,1.0,0,0,0,0,0,0,0,0,0,0,0,0,0,0,0,0,0
401370984,Stony Brook Seawolves,K. Roberts,4897991,,False,3.0,0,0,0,0,0,0,0,0,0,0,0,0,0,0,1,0,0
401370984,Stony Brook Seawolves,T. Stephenson-Moore,4592935,,False,4.0,1,1,1,1,0,0,0,0,0,0,0,0,0,0,0,0,2
401370984,Stony Brook Seawolves,T. Greene,4398108,,False,23.0,2,5,1,3,1,2,0,1,1,5,6,0,0,0,1,1,5
401370984,Stony Brook Seawolves,O. Habwe,4279868,,False,16.0,2,5,2,3,0,2,0,0,2,2,4,0,0,0,1,0,4
401370984,Stony Brook Seawolves,TEAM,TOTAL,TOTAL,False,,22,64,16,36,6,28,2,4,8,23,31,2,8,1,12,10,52
401370984,George Mason Patriots,J. Oduro,4432068,,True,24.0,8,12,8,10,0,2,0,0,3,2,5,2,0,2,2,3,16
401370984,George Mason Patriots,X. Johnson,4592439,,True,29.0,5,9,4,5,1,4,0,0,0,1,1,1,4,0,3,2,11
401370984,George Mason Patriots,D. Gaines,4431961,,True,28.0,4,9,3,7,1,2,0,0,2,7,9,2,0,0,0,3,9
401370984,George Mason Patriots,D. Cooper,4279876,,True,30.0,6,9,4,4,2,5,0,0,0,6,6,3,0,0,4,2,14
401370984,George Mason Patriots,D. Schwartz,4278501,,True,34.0,5,8,4,5,1,3,0,0,1,6,7,2,2,0,2,2,11
401370984,George Mason Patriots,B. Jones,4897083,,False,15.0,1,4,0,1,1,3,1,2,1,3,4,1,0,2,1,0,4
401370984,George Mason Patriots,M. Henry,4606836,,False,8.0,1,1,1,1,0,0,1,2,1,2,3,0,0,1,0,1,3
401370984,George Mason Patriots,J. Kabimba,4592303,,False,2.0,0,0,0,0,0,0,0,0,0,1,1,0,0,0,0,0,0
401370984,George Mason Patriots,B. Buchanan,4395691,,False,1.0,0,0,0,0,0,0,0,0,0,0,0,0,0,0,0,0,0
401370984,George Mason Patriots,T. Gadsden,4719466,,False,2.0,0,1,0,0,0,1,0,0,0,0,0,1,0,0,0,0,0
401370984,George Mason Patriots,M. Gray,4710354,,False,2.0,0,0,0,0,0,0,0,0,0,0,0,0,1,0,0,0,0
401370984,George Mason Patriots,J. Hartwell II,4396817,,False,25.0,2,8,1,3,1,5,1,2,0,3,3,3,0,0,2,0,6
401370984,George Mason Patriots,TEAM,TOTAL,TOTAL,False,,32,61,25,36,7,25,3,6,8,36,44,15,7,5,14,13,74
401370980,New Hampshire Wildcats,J. Martinez,4396579,,True,38.0,3,7,0,2,3,5,2,2,1,6,7,0,0,1,2,0,11
401370980,New Hampshire Wildcats,N. Guadarrama,4396578,,True,34.0,4,15,2,7,2,8,0,0,1,3,4,4,0,1,2,3,10
401370980,New Hampshire Wildcats,T. Mattos,4397814,,True,29.0,2,7,2,7,0,0,4,4,3,13,16,0,0,0,2,3,8
401370980,New Hampshire Wildcats,B. Tchoukuiegno,4593989,,True,36.0,3,6,2,4,1,2,5,6,0,4,4,4,1,0,3,3,12
401370980,New Hampshire Wildcats,N. Johnson,4593988,,True,12.0,2,4,2,3,0,1,0,0,0,1,1,0,0,0,1,1,4
401370980,New Hampshire Wildcats,S. Seymour,4398391,,False,4.0,0,1,0,0,0,1,0,0,0,0,0,0,0,0,0,0,0
401370980,New Hampshire Wildcats,C. Lester,4066728,,False,4.0,0,1,0,1,0,0,0,0,0,0,0,0,1,0,0,0,0
401370980,New Hampshire Wildcats,M. Foster,4897193,,False,11.0,2,3,1,2,1,1,0,0,0,3,3,2,0,0,0,1,5
401370980,New Hampshire Wildcats,J. Hopkins,4278238,,False,32.0,5,10,3,5,2,5,0,0,2,1,3,1,0,1,0,1,12
401370980,New Hampshire Wildcats,TEAM,TOTAL,TOTAL,False,,21,54,12,31,9,23,11,12,8,34,42,11,2,3,10,12,62
401370980,Duquesne Dukes,T. Williams,4432147,,True,33.0,0,7,0,5,0,2,1,5,2,3,5,1,0,2,1,4,1
401370980,Duquesne Dukes,K. Easley,4398159,,True,28.0,5,9,4,7,1,2,1,3,2,2,4,0,1,0,0,3,12
401370980,Duquesne Dukes,A. Spears,4897090,,True,27.0,5,13,4,9,1,4,1,1,1,3,4,1,1,0,0,4,12
401370980,Duquesne Dukes,J. Johnson III,4897088,,True,24.0,4,12,2,7,2,5,1,1,0,2,2,1,0,1,0,0,11
401370980,Duquesne Dukes,T. Okani,4700873,,True,18.0,0,3,0,1,0,2,0,0,1,1,2,1,2,1,1,0,0
401370980,Duquesne Dukes,A. Rotroff,4396806,,False,19.0,5,5,5,5,0,0,0,0,3,6,9,1,0,1,0,0,10
401370980,Duquesne Dukes,L. Ayers III,4703813,,False,22.0,2,11,2,6,0,5,0,0,0,2,2,4,1,0,1,0,4
401370980,Duquesne Dukes,M. Bekelja,4700874,,False,5.0,1,1,0,0,1,1,0,0,0,1,1,1,0,0,0,0,3
401370980,Duquesne Dukes,T. Acuff,4606831,,False,24.0,4,5,2,3,2,2,1,2,0,5,5,1,2,0,0,1,11
401370980,Duquesne Dukes,TEAM,TOTAL,TOTAL,False,,26,66,19,43,7,23,5,12,11,26,37,11,7,5,3,12,64
401370949,Saint Joseph's Hawks,T. Funk,4278395,,True,24.0,3,7,2,4,1,3,0,0,0,2,2,3,2,0,4,3,7
401370949,Saint Joseph's Hawks,E. Obinna,4278125,,True,22.0,5,5,5,5,0,0,4,4,1,5,6,0,0,1,3,1,14
401370949,Saint Joseph's Hawks,J. Hall,4701031,,True,29.0,5,13,4,9,1,4,4,7,3,9,12,3,1,0,2,1,15
401370949,Saint Joseph's Hawks,E. Reynolds II,4683952,,True,27.0,1,5,0,3,1,2,0,0,1,2,3,1,1,0,1,3,3
401370949,Saint Joseph's Hawks,C. Brown,4592476,,True,27.0,5,9,4,7,1,2,2,2,2,1,3,1,2,1,0,0,13
401370949,Saint Joseph's Hawks,C. Coleman,4431807,,False,7.0,0,2,0,2,0,0,0,2,2,2,4,0,0,0,1,1,0
401370949,Saint Joseph's Hawks,K. Klaczek,4897053,,False,14.0,4,7,4,4,0,3,0,0,0,3,3,3,0,2,0,2,8
401370949,Saint Joseph's Hawks,J. Tracey,4701030,,False,7.0,0,3,0,3,0,0,0,0,2,0,2,0,1,0,0,2,0
401370949,Saint Joseph's Hawks,N. Luna-Nash,4710985,,False,1.0,1,1,1,1,0,0,0,0,0,0,0,0,0,0,0,0,2
401370949,Saint Joseph's Hawks,B. Geatens,4706892,,False,1.0,0,0,0,0,0,0,0,0,0,0,0,0,0,0,0,0,0
401370949,Saint Joseph's Hawks,C. Arizin,4706891,,False,1.0,0,0,0,0,0,0,0,0,0,1,1,0,0,0,0,0,0
401370949,Saint Joseph's Hawks,J. Forrest,4701032,,False,23.0,4,8,1,1,3,7,0,0,0,1,1,1,0,0,0,1,11
401370949,Saint Joseph's Hawks,D. Bishop,4701028,,False,17.0,2,3,2,2,0,1,2,4,0,2,2,0,1,1,2,0,6
401370949,Saint Joseph's Hawks,TEAM,TOTAL,TOTAL,False,,30,63,23,41,7,22,12,19,13,30,43,12,8,5,13,14,79
401370949,Binghamton Bearcats,G. Tinsley,4432126,,True,23.0,0,1,0,1,0,0,2,2,2,3,5,2,0,1,0,3,2
401370949,Binghamton Bearcats,Y. Willis,4592897,,True,9.0,2,3,2,3,0,0,0,0,0,0,0,0,2,0,1,2,4
401370949,Binghamton Bearcats,J. Falko,4702061,,True,25.0,1,9,1,8,0,1,0,1,0,2,2,1,3,0,3,1,2
401370949,Binghamton Bearcats,J. McGriff,4432056,,True,25.0,6,11,6,10,0,1,2,2,0,2,2,1,0,0,5,1,14
401370949,Binghamton Bearcats,T. Bertram,4397473,,True,21.0,2,8,2,3,0,5,1,1,1,3,4,0,0,0,1,1,5
401370949,Binghamton Bearcats,B. Beamer,4701165,,False,7.0,3,5,1,1,2,4,0,0,0,1,1,0,0,0,0,0,8
401370949,Binghamton Bearcats,T. White,4432139,,False,24.0,2,4,2,4,0,0,1,2,2,4,6,1,2,2,2,3,5
401370949,Binghamton Bearcats,K. Amos,4701166,,False,16.0,2,7,2,6,0,1,2,4,0,1,1,0,1,0,0,0,6
401370949,Binghamton Bearcats,D. Petcash,4592893,,False,18.0,1,3,1,2,0,1,0,0,0,2,2,1,0,0,0,1,2
401370949,Binghamton Bearcats,H. Hjalmarsson,4592890,,False,14.0,2,5,2,3,0,2,0,0,1,2,3,2,0,0,1,2,4
401370949,Binghamton Bearcats,C. Hinckson,4398106,,False,18.0,2,2,1,1,1,1,0,2,0,2,2,0,0,1,1,4,5
401370949,Binghamton Bearcats,TEAM,TOTAL,TOTAL,False,,23,58,20,42,3,16,8,14,6,24,30,8,8,4,14,18,57
401370934,UAlbany Great Danes,D. Perry,4278335,,True,34.0,7,11,7,9,0,2,4,4,0,3,3,3,1,0,4,4,18
401370934,UAlbany Great Danes,T. Hutcheson,4433012,,True,19.0,3,3,0,0,3,3,2,2,1,2,3,1,1,0,0,3,11
401370934,UAlbany Great Danes,P. Newman,4280043,,True,12.0,2,3,2,3,0,0,1,2,4,0,4,0,1,0,3,3,5
401370934,UAlbany Great Danes,M. Cerruti,4896617,,True,27.0,5,10,2,6,3,4,0,0,0,1,1,0,3,1,2,4,13
401370934,UAlbany Great Danes,J. Horton,4700941,,True,36.0,5,9,4,6,1,3,2,5,0,2,2,4,5,0,6,3,13
401370934,UAlbany Great Danes,A. Reddish,4896621,,False,6.0,0,0,0,0,0,0,0,0,0,0,0,1,1,0,2,1,0
401370934,UAlbany Great Danes,J. Neely,4896620,,False,22.0,0,5,0,5,0,0,2,2,0,6,6,1,1,0,0,0,2
401370934,UAlbany Great Danes,T. Ketner,4896618,,False,4.0,0,2,0,2,0,0,0,0,0,0,0,0,0,0,0,0,0
401370934,UAlbany Great Danes,J. Doles,4279195,,False,18.0,0,4,0,2,0,2,0,0,1,2,3,0,1,0,1,1,0
401370934,UAlbany Great Danes,N. Little,4896619,,False,12.0,0,0,0,0,0,0,2,4,0,0,0,1,0,0,4,5,2
401370934,UAlbany Great Danes,C. Champion,4067132,,False,10.0,0,1,0,0,0,1,0,0,0,0,0,1,1,0,0,0,0
401370934,UAlbany Great Danes,TEAM,TOTAL,TOTAL,False,,22,48,15,33,7,15,13,19,8,17,25,12,15,1,26,24,64
401370934,La Salle Explorers,C. Moore,4277945,,True,20.0,4,5,3,3,1,2,2,2,0,1,1,0,2,1,3,5,11
401370934,La Salle Explorers,J. Clark,4397152,,True,28.0,3,9,2,4,1,5,2,2,2,0,2,1,1,0,1,0,9
401370934,La Salle Explorers,J. Brickus,4700970,,True,20.0,3,5,3,4,0,1,2,2,0,1,1,3,2,0,4,2,8
401370934,La Salle Explorers,C. Ray,4592448,,True,24.0,4,6,3,4,1,2,3,4,2,4,6,3,1,1,2,3,12
401370934,La Salle Explorers,J. Nickelberry,4432845,,True,22.0,3,8,3,5,0,3,1,1,1,0,1,0,0,0,1,2,7
401370934,La Salle Explorers,M. Doucoure,4277988,,False,20.0,1,2,1,2,0,0,0,0,1,2,3,0,1,0,1,1,2
401370934,La Salle Explorers,K. Brantley,4709132,,False,15.0,2,3,2,2,0,1,2,3,1,2,3,1,1,0,1,2,6
401370934,La Salle Explorers,A. Gill,4700969,,False,24.0,2,5,2,4,0,1,0,1,0,4,4,3,2,2,5,5,4
401370934,La Salle Explorers,S. Kenney,4431790,,False,27.0,1,4,0,1,1,3,5,6,0,6,6,5,2,1,4,1,8
401370934,La Salle Explorers,TEAM,TOTAL,TOTAL,False,,23,47,19,29,4,18,17,21,9,21,30,16,12,5,23,21,67
401370802,George Washington Revolutionaries,R. Lindo Jr.,4397186,,True,35.0,2,6,1,2,1,4,3,4,0,9,9,3,3,2,2,1,8
401370802,George Washington Revolutionaries,N. Brown,4700963,,True,14.0,2,5,2,5,0,0,0,1,1,1,2,0,0,0,0,4,4
401370802,George Washington Revolutionaries,J. Bamisile,4432537,,True,31.0,11,14,8,9,3,5,0,0,1,9,10,1,2,1,4,2,25
401370802,George Washington Revolutionaries,J. Bishop,4431770,,True,29.0,3,11,3,9,0,2,0,0,0,1,1,2,0,0,0,0,6
401370802,George Washington Revolutionaries,B. Adams,4396612,,True,32.0,5,11,2,4,3,7,0,0,1,7,8,1,0,0,1,0,13
401370802,George Washington Revolutionaries,H. Dean,4593273,,False,15.0,1,3,1,3,0,0,2,4,3,3,6,0,0,1,2,2,4
401370802,George Washington Revolutionaries,Q. Samuels,4592251,,False,5.0,2,2,1,1,1,1,0,0,0,1,1,0,0,0,0,1,5
401370802,George Washington Revolutionaries,B. Freeman,4613126,,False,27.0,4,9,3,7,1,2,1,2,0,1,1,8,3,0,1,2,10
401370802,George Washington Revolutionaries,A. Harris,4397216,,False,12.0,0,1,0,1,0,0,0,0,0,0,0,2,0,0,1,0,0
401370802,George Washington Revolutionaries,TEAM,TOTAL,TOTAL,False,,30,62,21,41,9,21,6,11,8,33,41,17,8,4,11,12,75
401370802,Coppin State Eagles,T. Corbett,4703126,,True,33.0,7,17,7,15,0,2,1,3,4,8,12,0,1,1,2,0,15
401370802,Coppin State Eagles,J. Zarzuela,4897759,,True,37.0,6,14,3,4,3,10,4,4,0,1,1,4,1,0,3,3,19
401370802,Coppin State Eagles,N. Tarke,4704077,,True,28.0,5,9,3,5,2,4,1,2,0,7,7,0,2,0,1,2,13
401370802,Coppin State Eagles,M. Hood,4702075,,True,29.0,3,6,2,3,1,3,2,3,0,2,2,2,0,0,2,3,9
401370802,Coppin State Eagles,R. James,4593000,,True,5.0,0,0,0,0,0,0,0,0,0,0,0,0,1,0,2,1,0
401370802,Coppin State Eagles,D. Titus,4897758,,False,15.0,1,3,0,0,1,3,0,0,0,1,1,0,2,2,0,1,3
401370802,Coppin State Eagles,S. Conteh,4593442,,False,5.0,0,0,0,0,0,0,0,0,0,2,2,0,0,0,3,0,0
401370802,Coppin State Eagles,N. Stokes,4593262,,False,25.0,1,5,0,2,1,3,0,0,0,1,1,0,1,1,0,2,3
401370802,Coppin State Eagles,G. Spurlock,4897755,,False,4.0,0,0,0,0,0,0,0,0,0,1,1,0,0,0,0,0,0
401370802,Coppin State Eagles,J. Steers,4398112,,False,2.0,0,0,0,0,0,0,0,0,0,0,0,0,0,0,0,0,0
401370802,Coppin State Eagles,K. Cardaci,4397944,,False,17.0,0,5,0,1,0,4,0,0,0,2,2,0,0,0,0,1,0
401370802,Coppin State Eagles,TEAM,TOTAL,TOTAL,False,,23,59,15,30,8,29,8,12,6,27,33,6,8,4,13,13,62
401370800,St. Bonaventure Bonnies,O. Osunniyi,4397224,,True,30.0,8,12,8,12,0,0,1,1,3,2,5,1,0,3,3,3,17
401370800,St. Bonaventure Bonnies,J. Adaway,4279431,,True,37.0,4,13,4,12,0,1,5,5,5,11,16,2,1,0,1,1,13
401370800,St. Bonaventure Bonnies,J. Holmes,4701016,,True,37.0,10,14,7,9,3,5,1,2,2,8,10,6,2,1,3,2,24
401370800,St. Bonaventure Bonnies,D. Welch,4397221,,True,24.0,3,11,0,1,3,10,0,0,2,2,4,1,1,0,1,4,9
401370800,St. Bonaventure Bonnies,K. Lofton,4397220,,True,39.0,3,8,1,3,2,5,8,8,1,5,6,9,1,0,1,1,16
401370800,St. Bonaventure Bonnies,A. Coulibaly,4432889,,False,10.0,3,7,2,6,1,1,3,4,0,0,0,0,0,0,0,1,10
401370800,St. Bonaventure Bonnies,J. Ndjock-Tadjore,4897048,,False,3.0,0,1,0,1,0,0,0,0,0,0,0,0,0,0,0,1,0
401370800,St. Bonaventure Bonnies,Q. Adams,4585591,,False,20.0,2,3,2,3,0,0,0,1,1,1,2,1,0,0,0,0,4
401370800,St. Bonaventure Bonnies,TEAM,TOTAL,TOTAL,False,,33,69,24,47,9,22,18,21,15,29,44,20,5,4,9,13,93
401370800,Coppin State Eagles,T. Corbett,4703126,,True,34.0,7,16,7,11,0,5,3,3,5,5,10,3,0,2,1,4,17
401370800,Coppin State Eagles,J. Zarzuela,4897759,,True,37.0,10,20,6,11,4,9,3,3,1,1,2,3,2,0,2,1,27
401370800,Coppin State Eagles,N. Tarke,4704077,,True,36.0,5,12,3,6,2,6,4,6,0,6,6,4,5,0,3,2,16
401370800,Coppin State Eagles,M. Hood,4702075,,True,33.0,2,7,0,1,2,6,0,0,0,1,1,2,1,0,1,4,6
401370800,Coppin State Eagles,R. James,4593000,,True,24.0,2,2,2,2,0,0,0,1,2,3,5,0,0,0,0,2,4
401370800,Coppin State Eagles,D. Titus,4897758,,False,5.0,0,0,0,0,0,0,0,0,0,0,0,0,0,1,0,0,0
401370800,Coppin State Eagles,S. Conteh,4593442,,False,3.0,1,1,0,0,1,1,0,0,0,1,1,0,0,0,2,2,3
401370800,Coppin State Eagles,A. Rojas,4897756,,False,1.0,0,0,0,0,0,0,0,0,0,0,0,0,0,0,0,1,0
401370800,Coppin State Eagles,J. Steers,4398112,,False,14.0,3,7,2,5,1,2,1,1,0,2,2,0,1,0,1,1,8
401370800,Coppin State Eagles,K. Cardaci,4397944,,False,13.0,0,2,0,0,0,2,0,0,0,1,1,1,0,0,0,0,0
401370800,Coppin State Eagles,TEAM,TOTAL,TOTAL,False,,30,67,20,36,10,31,11,14,9,23,32,13,9,3,10,17,81
401370101,Richmond Spiders,T. Burton,4431914,,True,28.0,6,11,4,7,2,4,2,4,1,7,8,1,0,0,1,3,16
401370101,Richmond Spiders,N. Cayo,4278380,,True,30.0,7,12,7,12,0,0,0,0,2,2,4,4,1,1,0,5,14
401370101,Richmond Spiders,G. Golden,4066836,,True,31.0,8,15,8,12,0,3,3,3,0,7,7,2,0,0,3,3,19
401370101,Richmond Spiders,I. Wilson,4700973,,True,28.0,3,3,1,1,2,2,1,2,0,2,2,1,0,0,2,3,9
401370101,Richmond Spiders,J. Gilyard,4278378,,True,39.0,3,7,2,3,1,4,6,6,0,6,6,10,2,0,3,2,13
401370101,Richmond Spiders,M. Grace,4397192,,False,10.0,2,2,1,1,1,1,0,0,1,1,2,1,1,2,0,0,5
401370101,Richmond Spiders,D. Bailey,4700974,,False,2.0,1,1,1,1,0,0,0,0,0,0,0,0,0,0,0,2,2
401370101,Richmond Spiders,A. Gustavson,4397193,,False,6.0,0,1,0,1,0,0,2,2,0,0,0,0,0,0,1,1,2
401370101,Richmond Spiders,C. Crabtree,4396658,,False,7.0,0,1,0,0,0,1,0,0,0,0,0,0,0,0,0,1,0
401370101,Richmond Spiders,N. Sherod,4066832,,False,19.0,1,6,0,2,1,4,0,1,0,2,2,0,1,0,0,1,3
401370101,Richmond Spiders,TEAM,TOTAL,TOTAL,False,,31,59,24,40,7,19,14,18,6,27,33,19,5,3,10,21,83
401370101,NC State Wolfpack,E. Dowuona,4432447,,True,31.0,2,3,2,3,0,0,1,2,4,4,8,0,0,3,0,3,5
401370101,NC State Wolfpack,J. Hellems,4395661,,True,39.0,2,6,1,3,1,3,7,10,1,3,4,1,3,0,1,3,12
401370101,NC State Wolfpack,C. Hayes,4701837,,True,27.0,6,14,2,6,4,8,0,0,0,2,2,3,0,0,0,5,16
401370101,NC State Wolfpack,T. Smith,4683940,,True,33.0,4,14,3,9,1,5,9,10,0,2,2,0,0,0,2,2,18
401370101,NC State Wolfpack,D. Seabron,4431811,,True,36.0,8,16,7,14,1,2,4,10,5,8,13,3,0,0,3,3,21
401370101,NC State Wolfpack,J. Gibson,4576139,,False,9.0,1,1,1,1,0,0,0,0,0,0,0,1,1,0,0,1,2
401370101,NC State Wolfpack,B. Pass,4697269,,False,4.0,0,2,0,1,0,1,0,0,0,0,0,0,0,0,1,0,0
401370101,NC State Wolfpack,C. Morsell,4431704,,False,18.0,0,5,0,2,0,3,0,2,1,3,4,0,0,0,0,2,0
401370101,NC State Wolfpack,T. Allen,4277968,,False,3.0,0,0,0,0,0,0,0,0,0,0,0,0,1,0,0,0,0
401370101,NC State Wolfpack,TEAM,TOTAL,TOTAL,False,,23,61,16,39,7,22,21,34,15,22,37,8,5,3,7,19,74
401370080,Miami Hurricanes,S. Waardenburg,4079701,,True,27.0,0,2,0,2,0,0,0,0,4,1,5,1,0,0,2,3,0
401370080,Miami Hurricanes,I. Wong,4431727,,True,37.0,6,15,4,10,2,5,3,5,0,7,7,2,0,0,2,1,17
401370080,Miami Hurricanes,J. Miller,4396818,,True,36.0,2,6,1,5,1,1,3,4,2,7,9,1,0,0,1,1,8
401370080,Miami Hurricanes,C. Moore,4066345,,True,38.0,7,13,5,7,2,6,2,2,0,7,7,2,3,0,0,1,18
401370080,Miami Hurricanes,K. McGusty,4066310,,True,28.0,6,12,6,9,0,3,3,3,0,4,4,1,0,0,3,4,15
401370080,Miami Hurricanes,A. Walker,4592205,,False,9.0,3,7,3,7,0,0,2,3,1,1,2,0,1,0,2,3,8
401370080,Miami Hurricanes,D. Gak,4277891,,False,6.0,0,1,0,1,0,0,2,2,2,2,4,0,0,0,0,2,2
401370080,Miami Hurricanes,W. Poplar,4897397,,False,13.0,2,3,2,2,0,1,0,0,0,1,1,0,0,0,0,0,4
401370080,Miami Hurricanes,B. Joseph,4683753,,False,6.0,0,0,0,0,0,0,0,0,0,0,0,1,0,0,1,0,0
401370080,Miami Hurricanes,TEAM,TOTAL,TOTAL,False,,26,59,21,43,5,16,15,19,10,31,41,8,4,0,11,15,72
401370080,Fordham Rams,C. Ohams,4066856,,True,29.0,6,6,6,6,0,0,3,4,2,4,6,0,0,3,3,3,15
401370080,Fordham Rams,A. Charlton,4897085,,True,37.0,3,12,2,4,1,8,0,0,2,7,9,3,1,0,0,4,7
401370080,Fordham Rams,K. Rose,4592315,,True,18.0,1,6,0,1,1,5,0,0,0,1,1,1,0,0,0,4,3
401370080,Fordham Rams,D. Quisenberry,4397790,,True,37.0,4,15,2,4,2,11,2,3,0,5,5,0,1,0,0,2,12
401370080,Fordham Rams,A. Daye Jr.,4397500,,True,38.0,4,11,3,5,1,6,4,4,1,4,5,6,0,1,4,2,13
401370080,Fordham Rams,A. Tsimbila,4702329,,False,6.0,0,0,0,0,0,0,0,0,0,1,1,0,0,2,1,1,0
401370080,Fordham Rams,P. Kelly,4432014,,False,5.0,0,1,0,0,0,1,0,0,0,1,1,0,0,0,0,0,0
401370080,Fordham Rams,A. Harrison,4897086,,False,5.0,0,0,0,0,0,0,0,0,0,1,1,0,1,1,1,1,0
401370080,Fordham Rams,K. Cunningham,4705891,,False,13.0,3,5,0,0,3,5,0,0,0,1,1,0,1,0,0,0,9
401370080,Fordham Rams,J. Navarro,4592316,,False,12.0,2,4,2,2,0,2,3,3,1,1,2,1,0,0,0,0,7
401370080,Fordham Rams,TEAM,TOTAL,TOTAL,False,,23,60,15,22,8,38,12,14,6,26,32,11,4,7,11,17,66
401370076,Miami Hurricanes,S. Waardenburg,4079701,,True,23.0,2,3,2,2,0,1,0,0,0,1,1,0,0,0,0,1,4
401370076,Miami Hurricanes,R. Miller Jr.,4065671,,True,10.0,2,3,2,3,0,0,1,2,0,2,2,1,0,0,1,2,5
401370076,Miami Hurricanes,I. Wong,4431727,,True,30.0,4,9,3,7,1,2,1,2,1,3,4,1,0,0,0,1,10
401370076,Miami Hurricanes,C. Moore,4066345,,True,27.0,1,7,1,3,0,4,0,0,0,2,2,2,3,0,1,3,2
401370076,Miami Hurricanes,K. McGusty,4066310,,True,24.0,2,8,2,5,0,3,4,4,1,2,3,0,1,0,3,0,8
401370076,Miami Hurricanes,A. Walker,4592205,,False,19.0,2,10,1,6,1,4,0,0,1,3,4,2,1,0,1,1,5
401370076,Miami Hurricanes,D. Gak,4277891,,False,6.0,1,2,1,2,0,0,0,0,0,0,0,0,0,0,0,0,2
401370076,Miami Hurricanes,W. Poplar,4897397,,False,18.0,2,7,2,5,0,2,4,4,0,1,1,0,1,0,1,1,8
401370076,Miami Hurricanes,B. Joseph,4683753,,False,13.0,3,4,1,1,2,3,0,0,0,1,1,1,1,0,1,2,8
401370076,Miami Hurricanes,H. Beverly,4431701,,False,7.0,1,3,1,2,0,1,0,0,0,1,1,0,0,0,0,2,2
401370076,Miami Hurricanes,J. Miller,4396818,,False,23.0,3,4,3,4,0,0,0,0,3,2,5,1,2,0,0,1,6
401370076,Miami Hurricanes,TEAM,TOTAL,TOTAL,False,,23,60,19,40,4,20,10,12,6,18,24,8,9,0,9,14,60
401370076,Dayton Flyers,R.J. Blakney,4700864,,True,24.0,2,5,0,1,2,4,0,0,1,0,1,1,1,0,3,1,6
401370076,Dayton Flyers,T. Camara,4431736,,True,16.0,2,6,2,6,0,0,3,4,0,6,6,0,2,1,1,3,7
401370076,Dayton Flyers,D. Holmes II,4433607,,True,32.0,5,6,5,6,0,0,5,9,0,3,3,2,0,2,1,0,15
401370076,Dayton Flyers,M. Smith,4683861,,True,32.0,6,7,5,6,1,1,1,1,0,6,6,7,2,0,0,0,14
401370076,Dayton Flyers,E. Weaver,4397139,,True,25.0,5,6,1,1,4,5,0,0,0,1,1,2,1,0,6,0,14
401370076,Dayton Flyers,M. Sissoko,4431824,,False,3.0,0,0,0,0,0,0,0,0,0,0,0,0,0,0,0,0,0
401370076,Dayton Flyers,M. Amzil,4711607,,False,30.0,4,10,1,3,3,7,0,0,1,5,6,1,1,0,4,1,11
401370076,Dayton Flyers,Z. Nwokeji,4618121,,False,8.0,0,1,0,1,0,0,0,0,0,1,1,0,0,0,1,1,0
401370076,Dayton Flyers,K. Elvis,4683135,,False,4.0,0,0,0,0,0,0,0,0,0,1,1,0,0,0,0,0,0
401370076,Dayton Flyers,K. Brea,4591259,,False,16.0,2,3,1,1,1,2,0,0,0,4,4,1,0,1,0,3,5
401370076,Dayton Flyers,L. Greer III,4433175,,False,10.0,1,2,1,2,0,0,2,2,0,0,0,0,0,0,0,0,4
401370076,Dayton Flyers,TEAM,TOTAL,TOTAL,False,,27,46,16,27,11,19,11,16,2,27,29,14,7,4,16,9,76
401370026,Virginia Tech Hokies,K. Aluma,4280120,,True,24.0,5,11,5,9,0,2,2,2,1,2,3,4,3,2,0,1,12
401370026,Virginia Tech Hokies,J. Mutts,4278693,,True,23.0,1,1,1,1,0,0,0,0,1,6,7,2,2,0,3,1,2
401370026,Virginia Tech Hokies,H. Cattoor,4432954,,True,26.0,6,7,1,2,5,5,4,5,1,4,5,0,1,0,1,1,21
401370026,Virginia Tech Hokies,N. Alleyne,4432934,,True,30.0,3,10,1,2,2,8,1,2,0,3,3,1,0,0,1,0,9
401370026,Virginia Tech Hokies,S. Murphy,4280118,,True,24.0,7,10,3,3,4,7,0,0,1,1,2,3,1,0,1,0,18
401370026,Virginia Tech Hokies,J. Haynes,4709151,,False,5.0,1,1,1,1,0,0,1,2,1,0,1,0,0,0,1,0,3
401370026,Virginia Tech Hokies,L. Kidd,4701224,,False,6.0,0,0,0,0,0,0,0,0,0,0,0,0,0,1,1,0,0
401370026,Virginia Tech Hokies,J. Ojiako,4592425,,False,9.0,0,0,0,0,0,0,5,6,2,0,2,0,0,2,2,1,5
401370026,Virginia Tech Hokies,D. N'Guessan,4701984,,False,15.0,1,2,1,2,0,0,1,2,1,5,6,1,0,0,2,2,3
401370026,Virginia Tech Hokies,B. Varga,4897406,,False,3.0,0,2,0,1,0,1,0,0,0,0,0,0,0,0,0,0,0
401370026,Virginia Tech Hokies,C. Johnson,4897405,,False,3.0,0,1,0,0,0,1,0,0,0,0,0,0,0,0,0,1,0
401370026,Virginia Tech Hokies,S. Pedulla,4709131,,False,15.0,2,2,1,1,1,1,0,0,0,0,0,2,1,0,1,5,5
401370026,Virginia Tech Hokies,D. Maddox,4432257,,False,17.0,2,4,1,1,1,3,3,4,1,1,2,1,0,0,0,1,8
401370026,Virginia Tech Hokies,TEAM,TOTAL,TOTAL,False,,28,51,15,23,13,28,17,23,9,25,34,14,8,5,14,13,86
401370026,St. Bonaventure Bonnies,O. Osunniyi,4397224,,True,21.0,4,6,4,6,0,0,0,3,2,1,3,1,1,4,1,2,8
401370026,St. Bonaventure Bonnies,J. Adaway,4279431,,True,33.0,1,11,0,6,1,5,2,2,2,4,6,1,0,0,1,1,5
401370026,St. Bonaventure Bonnies,J. Holmes,4701016,,True,30.0,0,6,0,3,0,3,0,0,0,2,2,1,0,0,3,2,0
401370026,St. Bonaventure Bonnies,D. Welch,4397221,,True,32.0,4,11,1,3,3,8,0,0,2,0,2,1,1,1,5,3,11
401370026,St. Bonaventure Bonnies,K. Lofton,4397220,,True,26.0,1,4,0,2,1,2,0,0,0,3,3,3,2,0,5,2,3
401370026,St. Bonaventure Bonnies,O. Durosinmi,4684462,,False,2.0,0,0,0,0,0,0,0,0,0,0,0,0,0,0,0,1,0
401370026,St. Bonaventure Bonnies,A. Coulibaly,4432889,,False,17.0,2,4,2,3,0,1,2,4,2,2,4,0,1,0,1,3,6
401370026,St. Bonaventure Bonnies,J. Ndjock-Tadjore,4897048,,False,4.0,0,0,0,0,0,0,0,0,0,0,0,0,1,0,1,0,0
401370026,St. Bonaventure Bonnies,L. Brown,4897047,,False,13.0,2,5,1,2,1,3,0,0,0,0,0,0,1,0,1,2,5
401370026,St. Bonaventure Bonnies,J. Saizonou,4897046,,False,4.0,0,1,0,1,0,0,2,2,0,0,0,0,0,0,1,0,2
401370026,St. Bonaventure Bonnies,Q. Adams,4585591,,False,18.0,4,6,4,5,0,1,1,2,0,3,3,1,0,0,0,1,9
401370026,St. Bonaventure Bonnies,TEAM,TOTAL,TOTAL,False,,18,54,12,31,6,23,7,13,12,15,27,8,7,5,20,17,49
401370001,VCU Rams,H. Ward,4592495,,True,25.0,3,8,3,8,0,0,0,0,0,4,4,0,2,3,1,1,6
401370001,VCU Rams,V. Williams Jr.,4397227,,True,32.0,2,10,2,3,0,7,0,0,0,4,4,4,2,2,4,2,4
401370001,VCU Rams,L. Stockard III,4277897,,True,25.0,5,10,5,10,0,0,5,5,1,3,4,4,1,1,1,3,15
401370001,VCU Rams,J. Nunn,4896614,,True,21.0,3,4,1,1,2,3,0,0,0,2,2,1,1,0,4,1,8
401370001,VCU Rams,K. Curry,4397228,,True,32.0,3,4,1,1,2,3,3,4,2,3,5,2,1,0,0,4,11
401370001,VCU Rams,M. Brown-Jones,4433224,,False,11.0,2,5,2,5,0,0,2,3,0,4,4,1,1,0,0,0,6
401370001,VCU Rams,J. DeLoach,4432483,,False,13.0,1,2,1,2,0,0,0,1,3,2,5,2,0,2,2,2,2
401370001,VCU Rams,J. Nichols Jr.,4397108,,False,3.0,1,2,1,2,0,0,1,2,1,1,2,0,0,0,0,0,3
401370001,VCU Rams,N. Kern,4684145,,False,13.0,0,5,0,5,0,0,0,0,0,3,3,1,1,0,1,0,0
401370001,VCU Rams,M. Tsohonis,4592438,,False,22.0,4,6,1,2,3,4,1,2,0,1,1,3,1,0,0,0,12
401370001,VCU Rams,J. Banks,4432402,,False,3.0,0,1,0,0,0,1,0,0,0,0,0,1,0,0,0,0,0
401370001,VCU Rams,TEAM,TOTAL,TOTAL,False,,24,57,17,39,7,18,12,17,8,30,38,19,10,8,14,13,67
401370001,Syracuse Orange,C. Swider,4397134,,True,36.0,2,14,2,7,0,7,2,2,2,5,7,2,0,0,3,3,6
401370001,Syracuse Orange,J. Boeheim,4279472,,True,36.0,5,13,4,12,1,1,6,7,5,7,12,1,3,1,2,1,17
401370001,Syracuse Orange,J. Edwards,4431816,,True,16.0,3,6,3,6,0,0,0,0,1,3,4,1,0,3,0,5,6
401370001,Syracuse Orange,J. Girard III,4431746,,True,37.0,2,9,0,4,2,5,0,0,0,3,3,0,0,0,6,0,6
401370001,Syracuse Orange,B. Boeheim,4395676,,True,39.0,6,17,4,7,2,10,6,7,3,3,6,2,3,0,1,2,20
401370001,Syracuse Orange,B. Williams,4575472,,False,17.0,0,1,0,1,0,0,0,0,1,2,3,0,0,1,2,1,0
401370001,Syracuse Orange,F. Anselem,4701842,,False,15.0,0,1,0,1,0,0,0,0,0,1,1,0,1,0,1,3,0
401370001,Syracuse Orange,S. Torrence,4431696,,False,4.0,0,1,0,1,0,0,0,0,0,0,0,2,0,0,0,0,0
401370001,Syracuse Orange,TEAM,TOTAL,TOTAL,False,,18,62,13,39,5,23,14,16,15,28,43,8,7,5,16,15,55
401369836,Wright State Raiders,G. Basile,4397787,,True,29.0,1,8,1,4,0,4,9,12,4,9,13,2,0,3,3,5,11
401369836,Wright State Raiders,K. Norris,4898194,,True,29.0,0,5,0,1,0,4,1,2,0,3,3,1,1,0,1,4,1
401369836,Wright State Raiders,T. Holden,4431990,,True,37.0,10,21,10,20,0,1,4,4,5,3,8,4,2,1,3,4,24
401369836,Wright State Raiders,T. Calvin,4431915,,True,35.0,2,12,1,5,1,7,0,0,0,2,2,2,1,1,3,1,5
401369836,Wright State Raiders,T. Finke,4396017,,True,38.0,5,12,3,6,2,6,0,0,3,6,9,1,2,1,3,0,12
401369836,Wright State Raiders,A. Braun,4709318,,False,14.0,4,5,4,5,0,0,0,0,2,0,2,0,0,0,0,0,8
401369836,Wright State Raiders,C. Wilbourn,4432141,,False,8.0,0,0,0,0,0,0,0,0,0,0,0,1,0,0,0,1,0
401369836,Wright State Raiders,A. Welage,4702995,,False,10.0,1,2,1,1,0,1,0,0,0,0,0,0,0,0,0,1,2
401369836,Wright State Raiders,TEAM,TOTAL,TOTAL,False,,23,65,20,42,3,23,14,18,16,25,41,11,6,6,13,16,63
401369836,George Washington Revolutionaries,R. Lindo Jr.,4397186,,True,33.0,5,13,3,8,2,5,0,2,1,5,6,6,3,1,2,1,12
401369836,George Washington Revolutionaries,N. Brown,4700963,,True,10.0,2,4,2,4,0,0,1,2,2,1,3,0,0,1,0,1,5
401369836,George Washington Revolutionaries,J. Bamisile,4432537,,True,29.0,7,13,7,12,0,1,1,1,6,3,9,1,2,2,3,4,15
401369836,George Washington Revolutionaries,J. Bishop,4431770,,True,34.0,6,11,4,6,2,5,4,4,0,5,5,1,1,0,3,2,18
401369836,George Washington Revolutionaries,B. Adams,4396612,,True,34.0,4,13,3,6,1,7,1,2,2,2,4,2,1,0,0,1,10
401369836,George Washington Revolutionaries,H. Dean,4593273,,False,29.0,3,3,3,3,0,0,0,2,1,8,9,1,1,1,0,3,6
401369836,George Washington Revolutionaries,M. Gally,4592445,,False,0.0,0,0,0,0,0,0,0,0,0,0,0,0,0,0,0,0,0
401369836,George Washington Revolutionaries,Q. Samuels,4592251,,False,8.0,0,0,0,0,0,0,0,0,0,0,0,0,0,0,0,1,0
401369836,George Washington Revolutionaries,B. Freeman,4613126,,False,17.0,2,4,1,2,1,2,3,6,0,1,1,1,1,0,1,3,8
401369836,George Washington Revolutionaries,A. Harris,4397216,,False,6.0,0,0,0,0,0,0,0,0,0,0,0,0,0,0,0,1,0
401369836,George Washington Revolutionaries,TEAM,TOTAL,TOTAL,False,,29,61,23,41,6,20,10,19,12,27,39,12,9,5,10,17,74
401369826,Richmond Spiders,T. Burton,4431914,,True,37.0,4,11,4,9,0,2,3,4,1,4,5,0,2,1,1,1,11
401369826,Richmond Spiders,N. Cayo,4278380,,True,22.0,4,9,4,9,0,0,0,0,4,4,8,1,0,0,2,4,8
401369826,Richmond Spiders,G. Golden,4066836,,True,28.0,7,12,6,11,1,1,3,5,0,6,6,5,1,1,2,3,18
401369826,Richmond Spiders,I. Wilson,4700973,,True,27.0,3,7,3,6,0,1,3,6,0,2,2,2,0,0,0,3,9
401369826,Richmond Spiders,J. Gilyard,4278378,,True,38.0,4,9,1,1,3,8,3,5,0,3,3,4,3,0,4,2,14
401369826,Richmond Spiders,M. Grace,4397192,,False,16.0,2,6,2,2,0,4,0,0,0,2,2,2,0,0,1,3,4
401369826,Richmond Spiders,D. Bailey,4700974,,False,3.0,0,0,0,0,0,0,0,0,0,0,0,0,0,0,0,0,0
401369826,Richmond Spiders,C. Crabtree,4396658,,False,10.0,1,2,1,2,0,0,0,0,0,0,0,0,1,0,1,1,2
401369826,Richmond Spiders,N. Sherod,4066832,,False,19.0,5,9,1,3,4,6,0,0,0,2,2,0,0,0,0,1,14
401369826,Richmond Spiders,TEAM,TOTAL,TOTAL,False,,30,65,22,43,8,22,12,20,8,24,32,14,7,2,11,18,80
401369826,Maryland Terrapins,Q. Wahab,4431739,,True,23.0,3,8,3,8,0,0,7,8,1,5,6,0,0,1,0,2,13
401369826,Maryland Terrapins,D. Scott,4432852,,True,35.0,3,8,2,5,1,3,2,2,1,4,5,1,1,3,1,1,9
401369826,Maryland Terrapins,H. Hart,4431984,,True,37.0,8,9,4,4,4,5,4,4,0,2,2,3,4,0,0,0,24
401369826,Maryland Terrapins,E. Ayala,4397184,,True,35.0,7,13,4,5,3,8,3,5,0,9,9,5,1,0,3,2,20
401369826,Maryland Terrapins,F. Russell,4278371,,True,29.0,5,10,4,5,1,5,4,6,1,3,4,6,2,0,5,3,15
401369826,Maryland Terrapins,J. Reese,4683742,,False,17.0,1,3,1,3,0,0,0,0,2,4,6,0,0,1,4,2,2
401369826,Maryland Terrapins,I. Martinez,4601026,,False,14.0,1,5,0,3,1,2,0,0,0,1,1,1,0,0,1,2,3
401369826,Maryland Terrapins,X. Green,4067031,,False,10.0,0,1,0,1,0,0,0,0,1,2,3,1,0,0,0,1,0
401369826,Maryland Terrapins,TEAM,TOTAL,TOTAL,False,,28,57,18,34,10,23,20,25,7,30,37,17,8,5,14,13,86
401369816,Northeastern Huskies,C. Doherty,4395666,,True,29.0,5,5,5,5,0,0,0,0,2,3,5,3,0,0,1,4,10
401369816,Northeastern Huskies,J. Telfort,4702785,,True,27.0,2,8,2,4,0,4,4,6,0,1,1,3,0,0,4,1,8
401369816,Northeastern Huskies,V. Cubrilo,4592981,,True,35.0,5,7,4,5,1,2,0,0,0,4,4,2,3,0,3,2,11
401369816,Northeastern Huskies,S. Walters,4280251,,True,38.0,7,10,4,7,3,3,4,7,0,5,5,0,1,0,6,2,21
401369816,Northeastern Huskies,N. Djogo,4065704,,True,34.0,4,9,3,6,1,3,0,0,0,8,8,4,1,0,0,2,9
401369816,Northeastern Huskies,A. Nwagha,4610401,,False,2.0,0,0,0,0,0,0,0,0,0,1,1,0,0,0,0,1,0
401369816,Northeastern Huskies,C. Braun,4592983,,False,9.0,1,1,1,1,0,0,0,0,1,1,2,0,0,0,0,0,2
401369816,Northeastern Huskies,C. Stucke,4589480,,False,4.0,1,1,0,0,1,1,0,0,0,1,1,0,0,0,1,1,3
401369816,Northeastern Huskies,J. Strong,4279220,,False,10.0,1,2,1,1,0,1,2,2,0,0,0,2,1,0,3,0,4
401369816,Northeastern Huskies,T. Randriasalama,4897707,,False,1.0,0,0,0,0,0,0,0,0,0,0,0,0,0,0,0,0,0
401369816,Northeastern Huskies,Q. Emanga,4592982,,False,11.0,1,2,0,0,1,2,0,0,0,1,1,2,0,0,0,2,3
401369816,Northeastern Huskies,TEAM,TOTAL,TOTAL,False,,27,45,20,29,7,16,10,15,3,27,30,16,6,0,19,15,71
401369816,Duquesne Dukes,T. Williams,4432147,,True,35.0,4,10,4,7,0,3,3,4,4,7,11,0,1,1,2,0,11
401369816,Duquesne Dukes,K. Easley,4398159,,True,29.0,2,6,1,5,1,1,2,2,4,1,5,1,1,0,1,1,7
401369816,Duquesne Dukes,A. Spears,4897090,,True,29.0,4,13,4,10,0,3,7,9,2,1,3,1,1,0,3,2,15
401369816,Duquesne Dukes,M. Bekelja,4700874,,True,8.0,0,2,0,1,0,1,0,0,0,0,0,1,0,0,0,1,0
401369816,Duquesne Dukes,T. Acuff,4606831,,True,17.0,1,3,0,0,1,3,0,0,0,1,1,1,0,0,0,1,3
401369816,Duquesne Dukes,M. Hima,4700878,,False,2.0,0,2,0,2,0,0,0,0,2,0,2,0,1,0,0,1,0
401369816,Duquesne Dukes,A. Rotroff,4396806,,False,10.0,0,0,0,0,0,0,0,2,1,2,3,0,0,0,1,0,0
401369816,Duquesne Dukes,D. Larson,4897091,,False,6.0,0,2,0,2,0,0,0,0,0,1,1,0,0,0,1,0,0
401369816,Duquesne Dukes,J. Johnson III,4897088,,False,21.0,4,8,3,5,1,3,0,0,1,0,1,1,0,1,2,1,9
401369816,Duquesne Dukes,L. Ayers III,4703813,,False,26.0,2,12,1,5,1,7,1,2,1,2,3,1,4,0,1,1,6
401369816,Duquesne Dukes,T. Okani,4700873,,False,17.0,2,3,2,3,0,0,0,0,2,2,4,0,0,0,1,5,4
401369816,Duquesne Dukes,TEAM,TOTAL,TOTAL,False,,19,61,15,40,4,21,13,19,17,18,35,6,8,2,13,13,55
401369194,VCU Rams,V. Williams Jr.,4397227,,True,34.0,1,8,1,2,0,6,0,0,1,6,7,3,2,1,6,5,2
401369194,VCU Rams,L. Stockard III,4277897,,True,23.0,4,8,4,8,0,0,0,1,3,5,8,2,2,0,2,0,8
401369194,VCU Rams,J. Nunn,4896614,,True,36.0,7,8,5,5,2,3,4,4,0,3,3,0,2,0,1,1,20
401369194,VCU Rams,A. Baldwin Jr.,4433182,,True,19.0,3,5,2,2,1,3,6,6,0,0,0,0,6,0,1,1,13
401369194,VCU Rams,K. Curry,4397228,,True,29.0,3,8,3,6,0,2,4,6,0,1,1,1,1,1,1,4,10
401369194,VCU Rams,J. DeLoach,4432483,,False,17.0,2,2,2,2,0,0,0,0,1,2,3,1,0,2,1,3,4
401369194,VCU Rams,J. Nichols Jr.,4397108,,False,3.0,0,0,0,0,0,0,0,0,0,0,0,0,0,0,0,0,0
401369194,VCU Rams,N. Kern,4684145,,False,15.0,0,2,0,1,0,1,0,0,0,2,2,1,0,0,1,0,0
401369194,VCU Rams,M. Tsohonis,4592438,,False,16.0,4,9,3,6,1,3,0,0,1,1,2,2,0,0,0,0,9
401369194,VCU Rams,J. Banks,4432402,,False,8.0,0,2,0,1,0,1,0,0,0,1,1,0,0,0,0,1,0
401369194,VCU Rams,TEAM,TOTAL,TOTAL,False,,24,52,20,33,4,19,14,17,6,23,29,10,13,4,13,15,66
401369194,Jacksonville State Gamecocks,K. Henry,4593671,,True,10.0,0,0,0,0,0,0,2,4,1,0,1,1,1,0,1,3,2
401369194,Jacksonville State Gamecocks,B. Huffman,4277912,,True,22.0,4,8,4,8,0,0,0,0,2,5,7,1,1,0,3,0,8
401369194,Jacksonville State Gamecocks,J. Finch,4703243,,True,32.0,3,7,2,6,1,1,1,1,0,3,3,3,1,0,4,3,8
401369194,Jacksonville State Gamecocks,J. Gibbs,4278993,,True,33.0,3,12,0,3,3,9,3,3,0,4,4,1,0,0,0,4,12
401369194,Jacksonville State Gamecocks,D. Adams,4067814,,True,29.0,1,3,1,1,0,2,0,0,0,5,5,1,3,0,2,5,2
401369194,Jacksonville State Gamecocks,J. Pal,4703247,,False,33.0,5,8,4,5,1,3,0,2,2,2,4,1,1,0,5,2,11
401369194,Jacksonville State Gamecocks,M. Brigham Jr.,4703246,,False,2.0,0,0,0,0,0,0,0,0,1,0,1,1,0,0,0,0,0
401369194,Jacksonville State Gamecocks,M. Zeliznak,4398323,,False,13.0,3,5,3,5,0,0,0,4,2,2,4,0,0,0,0,2,6
401369194,Jacksonville State Gamecocks,T. Touze,4898253,,False,1.0,0,0,0,0,0,0,0,0,0,0,0,0,0,0,1,0,0
401369194,Jacksonville State Gamecocks,S. Henderson,4703245,,False,3.0,0,1,0,0,0,1,1,2,0,0,0,1,0,0,0,0,1
401369194,Jacksonville State Gamecocks,D. King,4703244,,False,15.0,1,3,1,1,0,2,0,0,0,0,0,1,1,0,1,1,2
401369194,Jacksonville State Gamecocks,C. Byrd,4702737,,False,7.0,0,0,0,0,0,0,0,0,0,2,2,1,0,0,3,0,0
401369194,Jacksonville State Gamecocks,TEAM,TOTAL,TOTAL,False,,20,47,15,29,5,18,7,16,10,23,33,12,8,0,23,20,52
401369165,Rhode Island Rams,Makhel Mitchell,4431777,,True,31.0,6,8,6,8,0,0,4,4,2,3,5,2,2,2,3,2,16
401369165,Rhode Island Rams,Makhi Mitchell,4431708,,True,28.0,6,10,6,8,0,2,0,0,4,2,6,1,1,1,3,4,12
401369165,Rhode Island Rams,I. Leggett,4606837,,True,26.0,0,4,0,4,0,0,0,2,0,3,3,1,0,0,1,1,0
401369165,Rhode Island Rams,I. El-Amin,4279313,,True,26.0,2,3,1,2,1,1,0,0,0,1,1,0,1,0,0,3,5
401369165,Rhode Island Rams,J. Sheppard,4066445,,True,33.0,3,10,2,4,1,6,0,0,0,3,3,4,0,0,4,2,7
401369165,Rhode Island Rams,A. Walker,4278567,,False,18.0,6,8,5,6,1,2,0,0,2,3,5,3,1,0,2,1,13
401369165,Rhode Island Rams,M. Martin,4397470,,False,31.0,1,7,1,3,0,4,8,10,2,4,6,2,2,0,1,1,10
401369165,Rhode Island Rams,S. Thomas,4897065,,False,7.0,1,1,1,1,0,0,1,2,0,0,0,1,0,0,0,1,3
401369165,Rhode Island Rams,TEAM,TOTAL,TOTAL,False,,25,51,22,36,3,15,13,18,10,22,32,14,7,3,14,15,66
401369165,Florida Gulf Coast Eagles,D. Rivers,4592248,,True,13.0,1,4,0,0,1,4,0,0,1,2,3,0,0,1,1,1,3
401369165,Florida Gulf Coast Eagles,K. Samuel,4277915,,True,33.0,2,5,2,5,0,0,1,2,4,4,8,0,1,1,2,3,5
401369165,Florida Gulf Coast Eagles,C. Largie,4592249,,True,26.0,2,7,1,3,1,4,0,1,2,1,3,2,1,0,1,3,5
401369165,Florida Gulf Coast Eagles,C. Catto,4396688,,True,29.0,5,7,1,3,4,4,0,0,0,2,2,1,3,0,0,1,14
401369165,Florida Gulf Coast Eagles,T. Dunn-Martin,4067358,,True,36.0,8,13,6,9,2,4,8,8,0,1,1,2,0,0,6,1,26
401369165,Florida Gulf Coast Eagles,Z. Anderson,4700870,,False,22.0,1,2,0,1,1,1,0,0,1,2,3,3,3,0,0,1,3
401369165,Florida Gulf Coast Eagles,A. Weir,4741885,,False,7.0,1,1,1,1,0,0,0,0,1,1,2,0,0,0,0,1,2
401369165,Florida Gulf Coast Eagles,L. Rolon,4700869,,False,8.0,0,3,0,2,0,1,0,0,0,0,0,3,0,0,3,1,0
401369165,Florida Gulf Coast Eagles,A. Richie,4397858,,False,14.0,2,7,1,4,1,3,0,0,0,0,0,1,0,0,1,0,5
401369165,Florida Gulf Coast Eagles,M. Halvorsen,4280115,,False,12.0,1,5,0,0,1,5,1,2,0,2,2,0,0,0,0,1,4
401369165,Florida Gulf Coast Eagles,TEAM,TOTAL,TOTAL,False,,23,54,12,28,11,26,10,13,10,15,25,12,8,2,14,13,67
401369134,Saint Louis Billikens,T. Hargrove Jr.,4592484,,True,20.0,3,6,2,4,1,2,0,0,0,3,3,0,1,0,1,2,7
401369134,Saint Louis Billikens,M. Linssen,4279174,,True,13.0,4,4,4,4,0,0,0,0,0,1,1,0,1,0,1,2,8
401369134,Saint Louis Billikens,J. Nesbitt,4714246,,True,22.0,6,11,6,8,0,3,3,4,2,4,6,0,0,1,1,2,15
401369134,Saint Louis Billikens,Y. Collins,4432957,,True,24.0,5,9,4,7,1,2,3,4,0,3,3,12,4,0,2,0,14
401369134,Saint Louis Billikens,G. Jimerson,4432008,,True,26.0,6,16,3,9,3,7,2,2,1,1,2,0,1,0,1,0,17
401369134,Saint Louis Billikens,L. Traore,4897052,,False,10.0,2,2,2,2,0,0,0,1,3,4,7,0,1,0,2,2,4
401369134,Saint Louis Billikens,A. Lorentsson,4701121,,False,10.0,0,0,0,0,0,0,0,0,0,0,0,1,0,0,1,0,0
401369134,Saint Louis Billikens,F. Okoro,4397105,,False,17.0,1,5,1,5,0,0,2,4,2,5,7,1,0,1,0,2,4
401369134,Saint Louis Billikens,M. Strickland,4432494,,False,10.0,3,4,3,4,0,0,1,2,0,0,0,0,2,0,0,1,7
401369134,Saint Louis Billikens,R. Williams,4399106,,False,13.0,2,4,0,0,2,4,0,0,0,1,1,0,0,0,0,1,6
401369134,Saint Louis Billikens,F. Thatch Jr.,4397199,,False,14.0,2,3,2,2,0,1,2,3,1,2,3,2,2,0,1,2,6
401369134,Saint Louis Billikens,B. Courtney,4397197,,False,3.0,0,2,0,2,0,0,0,0,0,1,1,0,0,0,0,0,0
401369134,Saint Louis Billikens,D. Jones,4278267,,False,18.0,3,6,1,3,2,3,0,0,2,2,4,1,0,0,1,1,8
401369134,Saint Louis Billikens,TEAM,TOTAL,TOTAL,False,,37,72,28,50,9,22,13,20,16,28,44,17,12,2,12,15,96
401369134,Central Arkansas Bears,J. Chatham,4067640,,True,19.0,2,7,2,7,0,0,0,0,0,4,4,0,1,1,0,2,4
401369134,Central Arkansas Bears,J. Baker,4397988,,True,21.0,1,4,1,2,0,2,2,2,0,2,2,2,0,1,2,2,4
401369134,Central Arkansas Bears,D. Hall,4278050,,True,26.0,2,7,2,6,0,1,3,4,1,7,8,2,2,1,5,4,7
401369134,Central Arkansas Bears,C. Hunter,4897018,,True,26.0,3,10,1,4,2,6,2,3,1,1,2,1,0,1,8,1,10
401369134,Central Arkansas Bears,C. Cooper,4431932,,True,32.0,5,8,3,4,2,4,0,0,1,1,2,3,2,0,2,0,12
401369134,Central Arkansas Bears,SK Shittu,4278264,,False,9.0,2,3,0,0,2,3,0,0,0,2,2,0,0,1,0,2,6
401369134,Central Arkansas Bears,C. Bounds,4703608,,False,8.0,1,4,1,4,0,0,0,2,1,0,1,0,0,1,0,4,2
401369134,Central Arkansas Bears,E. Cato,4897019,,False,12.0,2,2,2,2,0,0,1,2,1,1,2,2,0,0,1,1,5
401369134,Central Arkansas Bears,J. Munson,4433053,,False,3.0,0,0,0,0,0,0,0,0,0,0,0,0,0,0,1,0,0
401369134,Central Arkansas Bears,V. Reeves,4897017,,False,16.0,1,3,1,3,0,0,0,0,0,0,0,1,0,0,0,0,2
401369134,Central Arkansas Bears,I. Klintman,4897015,,False,18.0,1,3,0,1,1,2,0,0,0,2,2,0,0,0,3,1,3
401369134,Central Arkansas Bears,B. Simmons,4703607,,False,2.0,0,0,0,0,0,0,0,0,0,0,0,0,0,0,0,0,0
401369134,Central Arkansas Bears,E. Kayouloud,4397987,,False,9.0,3,6,3,5,0,1,0,0,1,1,2,0,1,0,0,0,6
401369134,Central Arkansas Bears,TEAM,TOTAL,TOTAL,False,,23,57,16,38,7,19,8,13,8,22,30,11,6,6,22,17,61
401365887,St. Bonaventure Bonnies,O. Osunniyi,4397224,,True,35.0,3,7,3,7,0,0,1,2,4,3,7,3,0,4,2,0,7
401365887,St. Bonaventure Bonnies,J. Holmes,4701016,,True,39.0,3,9,2,6,1,3,7,8,2,8,10,2,0,0,0,2,14
401365887,St. Bonaventure Bonnies,D. Welch,4397221,,True,37.0,4,12,2,3,2,9,2,2,1,6,7,0,0,1,2,2,12
401365887,St. Bonaventure Bonnies,K. Lofton,4397220,,True,40.0,6,14,6,11,0,3,5,6,0,1,1,7,0,0,4,4,17
401365887,St. Bonaventure Bonnies,J. Adaway,4279431,,True,30.0,5,6,5,6,0,0,0,0,1,4,5,3,0,0,0,4,10
401365887,St. Bonaventure Bonnies,A. Coulibaly,4432889,,False,5.0,1,1,1,1,0,0,0,0,0,1,1,0,0,1,0,1,2
401365887,St. Bonaventure Bonnies,L. Brown,4897047,,False,9.0,2,4,1,2,1,2,0,0,1,1,2,0,0,0,0,1,5
401365887,St. Bonaventure Bonnies,Q. Adams,4585591,,False,5.0,0,0,0,0,0,0,0,0,0,0,0,0,0,0,0,0,0
401365887,St. Bonaventure Bonnies,TEAM,TOTAL,TOTAL,False,,24,53,20,36,4,17,15,18,9,27,36,15,0,6,8,14,67
401365887,Boise State Broncos,M. ARMUS,4280022,,True,32.0,1,7,1,7,0,0,5,6,5,5,10,1,0,3,3,2,7
401365887,Boise State Broncos,A. KIGAB,4278513,,True,26.0,2,10,2,5,0,5,3,4,2,7,9,3,1,0,2,4,7
401365887,Boise State Broncos,D. DOUTRIVE,4397039,,True,31.0,2,6,1,4,1,2,2,2,0,1,1,1,1,0,0,3,7
401365887,Boise State Broncos,M. Shaver Jr.,4280208,,True,33.0,3,11,1,5,2,6,2,2,1,3,4,2,0,0,2,3,10
401365887,Boise State Broncos,E. AKOT,4278131,,True,37.0,8,16,2,7,6,9,2,2,0,1,1,3,1,0,1,2,24
401365887,Boise State Broncos,T. DEGENHART,4898260,,False,15.0,2,3,2,2,0,1,0,0,1,0,1,1,0,1,0,2,4
401365887,Boise State Broncos,N. SMITH,4702873,,False,11.0,1,2,1,1,0,1,0,0,0,0,0,0,0,0,0,0,2
401365887,Boise State Broncos,L. MILNER,4702874,,False,1.0,0,0,0,0,0,0,0,0,0,0,0,0,0,0,0,0,0
401365887,Boise State Broncos,M. RICE,4397263,,False,14.0,0,3,0,1,0,2,0,0,1,1,2,1,1,0,0,1,0
401365887,Boise State Broncos,TEAM,TOTAL,TOTAL,False,,19,58,10,32,9,26,14,16,12,22,34,12,4,4,8,17,61
401365883,New Mexico State Aggies,W. McNair Jr.,4396012,,True,25.0,2,4,2,3,0,1,2,2,2,4,6,2,1,3,0,3,6
401365883,New Mexico State Aggies,D. Tillman,4278536,,True,29.0,5,7,4,4,1,3,3,5,1,2,3,1,1,0,1,1,14
401365883,New Mexico State Aggies,J. McCants,4067472,,True,28.0,5,8,4,5,1,3,0,1,1,2,3,4,1,1,4,2,11
401365883,New Mexico State Aggies,J. Rice,4280181,,True,33.0,4,7,0,2,4,5,5,7,0,7,7,7,1,0,4,0,17
401365883,New Mexico State Aggies,T. Allen,4277932,,True,36.0,7,19,4,9,3,10,4,5,2,3,5,1,0,0,0,3,21
401365883,New Mexico State Aggies,M. Avery,4896927,,False,12.0,0,0,0,0,0,0,0,0,1,2,3,0,0,2,0,1,0
401365883,New Mexico State Aggies,M. Peake,4572450,,False,16.0,2,2,0,0,2,2,0,1,1,2,3,0,1,0,0,2,6
401365883,New Mexico State Aggies,Y. Alok,4397070,,False,6.0,0,2,0,2,0,0,0,0,1,1,2,0,0,0,0,2,0
401365883,New Mexico State Aggies,M. Caston,4896929,,False,4.0,0,1,0,0,0,1,0,0,0,1,1,0,0,0,1,1,0
401365883,New Mexico State Aggies,M. McKinney Jr.,4896928,,False,11.0,0,1,0,1,0,0,0,0,0,0,0,0,0,0,2,0,0
401365883,New Mexico State Aggies,TEAM,TOTAL,TOTAL,False,,25,51,14,26,11,25,14,21,11,27,38,15,5,6,14,15,75
401365883,Davidson Wildcats,S. Mennenga,4700862,,True,17.0,1,3,0,1,1,2,0,2,0,3,3,0,0,0,1,5,3
401365883,Davidson Wildcats,L. Brajkovic,4396787,,True,37.0,7,16,7,14,0,2,5,7,3,4,7,4,0,1,2,2,19
401365883,Davidson Wildcats,H. Lee,4592308,,True,36.0,6,15,4,6,2,9,0,0,1,2,3,0,1,0,1,4,14
401365883,Davidson Wildcats,F. Loyer,4397208,,True,28.0,5,10,1,5,4,5,0,0,0,2,2,2,1,0,1,2,14
401365883,Davidson Wildcats,M. Jones,4396784,,True,32.0,4,11,2,4,2,7,2,2,1,2,3,0,2,0,1,0,12
401365883,Davidson Wildcats,D. Kristensen,4432020,,False,2.0,0,1,0,1,0,0,0,0,0,0,0,0,0,0,0,1,0
401365883,Davidson Wildcats,N. Boachie-Yiadom,4396786,,False,25.0,0,0,0,0,0,0,0,0,1,2,3,3,0,0,1,2,0
401365883,Davidson Wildcats,D. Watson,4897098,,False,8.0,0,2,0,2,0,0,0,0,0,0,0,0,0,0,0,0,0
401365883,Davidson Wildcats,G. Huffman,4432522,,False,15.0,0,2,0,1,0,1,2,2,0,1,1,2,0,0,0,1,2
401365883,Davidson Wildcats,TEAM,TOTAL,TOTAL,False,,23,60,14,34,9,26,9,13,10,18,28,11,4,1,7,17,64
401365879,VCU Rams,H. Ward,4592495,,True,19.0,1,2,1,2,0,0,0,0,2,2,4,0,1,1,3,4,2
401365879,VCU Rams,V. Williams Jr.,4397227,,True,40.0,7,12,4,4,3,8,9,11,1,3,4,0,0,1,5,1,26
401365879,VCU Rams,J. Nunn,4896614,,True,30.0,4,9,4,5,0,4,0,0,2,2,4,2,2,0,1,1,8
401365879,VCU Rams,A. Baldwin Jr.,4433182,,True,38.0,6,14,6,11,0,3,0,0,2,4,6,6,2,0,2,3,12
401365879,VCU Rams,K. Curry,4397228,,True,33.0,4,9,4,8,0,1,0,0,2,3,5,2,3,1,4,3,8
401365879,VCU Rams,M. Brown-Jones,4433224,,False,6.0,0,0,0,0,0,0,2,2,1,1,2,0,0,2,0,1,2
401365879,VCU Rams,J. DeLoach,4432483,,False,9.0,0,2,0,2,0,0,0,0,0,2,2,0,0,0,0,5,0
401365879,VCU Rams,L. Stockard III,4277897,,False,12.0,1,2,1,2,0,0,1,2,0,2,2,0,2,1,1,1,3
401365879,VCU Rams,N. Kern,4684145,,False,9.0,2,3,2,3,0,0,0,0,0,0,0,1,1,0,1,1,4
401365879,VCU Rams,J. Banks,4432402,,False,4.0,0,2,0,1,0,1,0,0,0,0,0,0,0,0,0,0,0
401365879,VCU Rams,TEAM,TOTAL,TOTAL,False,,25,55,22,38,3,17,12,15,10,19,29,11,11,6,17,20,65
401365879,VCU Rams,H. Ward,4592495,,True,19.0,1,2,1,2,0,0,0,0,2,2,4,0,1,1,3,4,2
401365879,VCU Rams,V. Williams Jr.,4397227,,True,40.0,7,12,4,4,3,8,9,11,1,3,4,0,0,1,5,1,26
401365879,VCU Rams,J. Nunn,4896614,,True,30.0,4,9,4,5,0,4,0,0,2,2,4,2,2,0,1,1,8
401365879,VCU Rams,A. Baldwin Jr.,4433182,,True,38.0,6,14,6,11,0,3,0,0,2,4,6,6,2,0,2,3,12
401365879,VCU Rams,K. Curry,4397228,,True,33.0,4,9,4,8,0,1,0,0,2,3,5,2,3,1,4,3,8
401365879,VCU Rams,M. Brown-Jones,4433224,,False,6.0,0,0,0,0,0,0,2,2,1,1,2,0,0,2,0,1,2
401365879,VCU Rams,J. DeLoach,4432483,,False,9.0,0,2,0,2,0,0,0,0,0,2,2,0,0,0,0,5,0
401365879,VCU Rams,L. Stockard III,4277897,,False,12.0,1,2,1,2,0,0,1,2,0,2,2,0,2,1,1,1,3
401365879,VCU Rams,N. Kern,4684145,,False,9.0,2,3,2,3,0,0,0,0,0,0,0,1,1,0,1,1,4
401365879,VCU Rams,J. Banks,4432402,,False,4.0,0,2,0,1,0,1,0,0,0,0,0,0,0,0,0,0,0
401365879,VCU Rams,TEAM,TOTAL,TOTAL,False,,25,55,22,38,3,17,12,15,10,19,29,11,11,6,17,20,65
401365879,Saint Louis Billikens,M. Linssen,4279174,,True,19.0,2,5,2,5,0,0,2,4,0,6,6,1,0,2,2,1,6
401365879,Saint Louis Billikens,Y. Collins,4432957,,True,36.0,4,7,4,7,0,0,4,5,0,5,5,7,2,0,5,3,12
401365879,Saint Louis Billikens,F. Thatch Jr.,4397199,,True,28.0,1,7,1,5,0,2,7,8,1,3,4,3,0,0,4,4,9
401365879,Saint Louis Billikens,B. Courtney,4397197,,True,1.0,1,1,0,0,1,1,0,0,0,0,0,0,0,0,0,0,3
401365879,Saint Louis Billikens,D. Jones,4278267,,True,38.0,2,6,0,2,2,4,0,0,1,1,2,4,3,0,0,0,6
401365879,Saint Louis Billikens,T. Hargrove Jr.,4592484,,False,15.0,2,5,2,4,0,1,0,0,3,1,4,0,1,0,2,2,4
401365879,Saint Louis Billikens,F. Okoro,4397105,,False,21.0,3,5,3,5,0,0,2,2,2,4,6,0,1,1,1,4,8
401365879,Saint Louis Billikens,J. Nesbitt,4714246,,False,7.0,0,0,0,0,0,0,2,2,0,0,0,0,0,0,2,1,2
401365879,Saint Louis Billikens,G. Jimerson,4432008,,False,35.0,6,10,3,5,3,5,4,4,1,2,3,0,0,0,1,2,19
401365879,Saint Louis Billikens,TEAM,TOTAL,TOTAL,False,,21,46,15,33,6,13,21,25,8,22,30,15,7,3,18,17,69
401365879,Saint Louis Billikens,M. Linssen,4279174,,True,19.0,2,5,2,5,0,0,2,4,0,6,6,1,0,2,2,1,6
401365879,Saint Louis Billikens,Y. Collins,4432957,,True,36.0,4,7,4,7,0,0,4,5,0,5,5,7,2,0,5,3,12
401365879,Saint Louis Billikens,F. Thatch Jr.,4397199,,True,28.0,1,7,1,5,0,2,7,8,1,3,4,3,0,0,4,4,9
401365879,Saint Louis Billikens,B. Courtney,4397197,,True,1.0,1,1,0,0,1,1,0,0,0,0,0,0,0,0,0,0,3
401365879,Saint Louis Billikens,D. Jones,4278267,,True,38.0,2,6,0,2,2,4,0,0,1,1,2,4,3,0,0,0,6
401365879,Saint Louis Billikens,T. Hargrove Jr.,4592484,,False,15.0,2,5,2,4,0,1,0,0,3,1,4,0,1,0,2,2,4
401365879,Saint Louis Billikens,F. Okoro,4397105,,False,21.0,3,5,3,5,0,0,2,2,2,4,6,0,1,1,1,4,8
401365879,Saint Louis Billikens,J. Nesbitt,4714246,,False,7.0,0,0,0,0,0,0,2,2,0,0,0,0,0,0,2,1,2
401365879,Saint Louis Billikens,G. Jimerson,4432008,,False,35.0,6,10,3,5,3,5,4,4,1,2,3,0,0,0,1,2,19
401365879,Saint Louis Billikens,TEAM,TOTAL,TOTAL,False,,21,46,15,33,6,13,21,25,8,22,30,15,7,3,18,17,69
401365878,Saint Joseph's Hawks,A. Jansson,4701029,,True,14.0,1,1,1,1,0,0,0,2,1,4,5,1,0,0,0,2,2
401365878,Saint Joseph's Hawks,E. Obinna,4278125,,True,27.0,3,8,3,8,0,0,1,2,1,7,8,0,0,0,3,3,7
401365878,Saint Joseph's Hawks,J. Forrest,4701032,,True,14.0,2,5,0,1,2,4,2,2,1,1,2,0,0,0,0,2,8
401365878,Saint Joseph's Hawks,E. Reynolds II,4683952,,True,36.0,10,14,5,6,5,8,2,2,0,1,1,4,2,1,4,4,27
401365878,Saint Joseph's Hawks,C. Brown,4592476,,True,32.0,3,8,0,2,3,6,0,0,0,4,4,5,0,1,3,2,9
401365878,Saint Joseph's Hawks,C. Coleman,4431807,,False,25.0,1,4,1,2,0,2,0,0,1,3,4,1,0,2,2,2,2
401365878,Saint Joseph's Hawks,J. Hall,4701031,,False,34.0,6,10,5,6,1,4,2,2,1,7,8,4,2,0,2,2,15
401365878,Saint Joseph's Hawks,D. Bishop,4701028,,False,18.0,0,1,0,0,0,1,0,0,0,4,4,0,0,1,1,1,0
401365878,Saint Joseph's Hawks,TEAM,TOTAL,TOTAL,False,,26,51,15,26,11,25,7,10,6,32,38,15,4,5,16,18,70
401365878,Saint Joseph's Hawks,A. Jansson,4701029,,True,14.0,1,1,1,1,0,0,0,2,1,4,5,1,0,0,0,2,2
401365878,Saint Joseph's Hawks,E. Obinna,4278125,,True,27.0,3,8,3,8,0,0,1,2,1,7,8,0,0,0,3,3,7
401365878,Saint Joseph's Hawks,J. Forrest,4701032,,True,14.0,2,5,0,1,2,4,2,2,1,1,2,0,0,0,0,2,8
401365878,Saint Joseph's Hawks,E. Reynolds II,4683952,,True,36.0,10,14,5,6,5,8,2,2,0,1,1,4,2,1,4,4,27
401365878,Saint Joseph's Hawks,C. Brown,4592476,,True,32.0,3,8,0,2,3,6,0,0,0,4,4,5,0,1,3,2,9
401365878,Saint Joseph's Hawks,C. Coleman,4431807,,False,25.0,1,4,1,2,0,2,0,0,1,3,4,1,0,2,2,2,2
401365878,Saint Joseph's Hawks,J. Hall,4701031,,False,34.0,6,10,5,6,1,4,2,2,1,7,8,4,2,0,2,2,15
401365878,Saint Joseph's Hawks,D. Bishop,4701028,,False,18.0,0,1,0,0,0,1,0,0,0,4,4,0,0,1,1,1,0
401365878,Saint Joseph's Hawks,TEAM,TOTAL,TOTAL,False,,26,51,15,26,11,25,7,10,6,32,38,15,4,5,16,18,70
401365878,Rhode Island Rams,A. Walker,4278567,,True,17.0,2,6,2,2,0,4,1,2,1,5,6,0,0,1,0,3,5
401365878,Rhode Island Rams,I. Leggett,4606837,,True,23.0,2,7,1,4,1,3,0,0,4,2,6,3,0,0,2,3,5
401365878,Rhode Island Rams,M. Martin,4397470,,True,28.0,4,6,2,3,2,3,1,2,3,3,6,0,1,0,0,0,11
401365878,Rhode Island Rams,I. El-Amin,4279313,,True,20.0,2,7,0,3,2,4,0,0,2,1,3,1,1,0,1,1,6
401365878,Rhode Island Rams,J. Sheppard,4066445,,True,19.0,1,5,1,2,0,3,1,2,0,0,0,1,2,0,0,0,3
401365878,Rhode Island Rams,Makhel Mitchell,4431777,,False,24.0,4,15,4,14,0,1,0,1,2,0,2,0,2,2,1,2,8
401365878,Rhode Island Rams,Makhi Mitchell,4431708,,False,24.0,2,8,1,5,1,3,3,4,0,2,2,1,2,1,3,3,8
401365878,Rhode Island Rams,J. Carey,4395673,,False,19.0,2,7,0,4,2,3,0,0,0,2,2,3,2,0,1,1,6
401365878,Rhode Island Rams,S. Thomas,4897065,,False,26.0,2,2,2,2,0,0,4,8,1,1,2,3,1,0,1,0,8
401365878,Rhode Island Rams,TEAM,TOTAL,TOTAL,False,,21,63,13,39,8,24,10,19,15,16,31,12,11,4,9,13,60
401365878,Rhode Island Rams,A. Walker,4278567,,True,17.0,2,6,2,2,0,4,1,2,1,5,6,0,0,1,0,3,5
401365878,Rhode Island Rams,I. Leggett,4606837,,True,23.0,2,7,1,4,1,3,0,0,4,2,6,3,0,0,2,3,5
401365878,Rhode Island Rams,M. Martin,4397470,,True,28.0,4,6,2,3,2,3,1,2,3,3,6,0,1,0,0,0,11
401365878,Rhode Island Rams,I. El-Amin,4279313,,True,20.0,2,7,0,3,2,4,0,0,2,1,3,1,1,0,1,1,6
401365878,Rhode Island Rams,J. Sheppard,4066445,,True,19.0,1,5,1,2,0,3,1,2,0,0,0,1,2,0,0,0,3
401365878,Rhode Island Rams,Makhel Mitchell,4431777,,False,24.0,4,15,4,14,0,1,0,1,2,0,2,0,2,2,1,2,8
401365878,Rhode Island Rams,Makhi Mitchell,4431708,,False,24.0,2,8,1,5,1,3,3,4,0,2,2,1,2,1,3,3,8
401365878,Rhode Island Rams,J. Carey,4395673,,False,19.0,2,7,0,4,2,3,0,0,0,2,2,3,2,0,1,1,6
401365878,Rhode Island Rams,S. Thomas,4897065,,False,26.0,2,2,2,2,0,0,4,8,1,1,2,3,1,0,1,0,8
401365878,Rhode Island Rams,TEAM,TOTAL,TOTAL,False,,21,63,13,39,8,24,10,19,15,16,31,12,11,4,9,13,60
401365877,Massachusetts Minutemen,M. Steadman,4397393,,True,15.0,2,7,2,7,0,0,0,0,2,2,4,1,1,0,1,0,4
401365877,Massachusetts Minutemen,T. Buttrick,4277981,,True,33.0,3,6,3,5,0,1,3,4,2,6,8,1,0,0,1,4,9
401365877,Massachusetts Minutemen,T.J. Weeks,4433108,,True,21.0,1,4,1,2,0,2,2,2,1,2,3,2,0,0,0,0,4
401365877,Massachusetts Minutemen,N. Fernandes,4431791,,True,40.0,10,19,6,13,4,6,4,6,1,4,5,2,1,0,2,4,28
401365877,Massachusetts Minutemen,R. Kelly,4279741,,True,33.0,6,11,5,7,1,4,7,7,1,3,4,2,0,0,1,3,20
401365877,Massachusetts Minutemen,D. Dominguez,4701126,,False,2.0,0,1,0,1,0,0,0,0,0,0,0,0,0,0,0,1,0
401365877,Massachusetts Minutemen,G. Jones,4279211,,False,34.0,3,9,2,6,1,3,2,3,5,4,9,1,2,4,0,2,9
401365877,Massachusetts Minutemen,J. Garcia,4701125,,False,19.0,0,2,0,1,0,1,0,0,0,2,2,0,0,1,0,3,0
401365877,Massachusetts Minutemen,C.J. Kelly,4398208,,False,28.0,3,9,2,5,1,4,2,2,1,3,4,0,2,0,3,3,9
401365877,Massachusetts Minutemen,TEAM,TOTAL,TOTAL,False,,28,68,21,47,7,21,20,24,17,28,45,9,6,5,9,20,83
401365877,Massachusetts Minutemen,M. Steadman,4397393,,True,15.0,2,7,2,7,0,0,0,0,2,2,4,1,1,0,1,0,4
401365877,Massachusetts Minutemen,T. Buttrick,4277981,,True,33.0,3,6,3,5,0,1,3,4,2,6,8,1,0,0,1,4,9
401365877,Massachusetts Minutemen,T.J. Weeks,4433108,,True,21.0,1,4,1,2,0,2,2,2,1,2,3,2,0,0,0,0,4
401365877,Massachusetts Minutemen,N. Fernandes,4431791,,True,40.0,10,19,6,13,4,6,4,6,1,4,5,2,1,0,2,4,28
401365877,Massachusetts Minutemen,R. Kelly,4279741,,True,33.0,6,11,5,7,1,4,7,7,1,3,4,2,0,0,1,3,20
401365877,Massachusetts Minutemen,D. Dominguez,4701126,,False,2.0,0,1,0,1,0,0,0,0,0,0,0,0,0,0,0,1,0
401365877,Massachusetts Minutemen,G. Jones,4279211,,False,34.0,3,9,2,6,1,3,2,3,5,4,9,1,2,4,0,2,9
401365877,Massachusetts Minutemen,J. Garcia,4701125,,False,19.0,0,2,0,1,0,1,0,0,0,2,2,0,0,1,0,3,0
401365877,Massachusetts Minutemen,C.J. Kelly,4398208,,False,28.0,3,9,2,5,1,4,2,2,1,3,4,0,2,0,3,3,9
401365877,Massachusetts Minutemen,TEAM,TOTAL,TOTAL,False,,28,68,21,47,7,21,20,24,17,28,45,9,6,5,9,20,83
401365877,George Mason Patriots,J. Oduro,4432068,,True,40.0,7,15,7,13,0,2,2,4,3,3,6,2,1,3,2,4,16
401365877,George Mason Patriots,B. Buchanan,4395691,,True,8.0,1,2,1,1,0,1,0,0,0,1,1,0,0,0,0,1,2
401365877,George Mason Patriots,J. Hartwell II,4396817,,True,11.0,0,4,0,2,0,2,0,0,0,2,2,0,0,0,0,2,0
401365877,George Mason Patriots,D. Cooper,4279876,,True,37.0,6,9,1,1,5,8,2,3,0,2,2,0,0,0,1,2,19
401365877,George Mason Patriots,D. Schwartz,4278501,,True,42.0,6,15,4,9,2,6,7,8,2,4,6,4,0,0,1,4,21
401365877,George Mason Patriots,B. Jones,4897083,,False,1.0,0,0,0,0,0,0,0,0,0,0,0,0,0,0,0,0,0
401365877,George Mason Patriots,M. Henry,4606836,,False,5.0,1,1,1,1,0,0,1,2,0,0,0,1,1,0,0,0,3
401365877,George Mason Patriots,O. Frazier III,4700882,,False,4.0,0,0,0,0,0,0,0,0,0,1,1,0,1,0,0,0,0
401365877,George Mason Patriots,X. Johnson,4592439,,False,24.0,0,5,0,2,0,3,0,1,2,2,4,5,0,0,2,3,0
401365877,George Mason Patriots,R. Polite III,4567711,,False,21.0,2,6,1,4,1,2,3,4,0,1,1,2,2,0,3,1,8
401365877,George Mason Patriots,D. Gaines,4431961,,False,32.0,3,4,1,1,2,3,3,4,1,5,6,1,0,1,1,2,11
401365877,George Mason Patriots,TEAM,TOTAL,TOTAL,False,,26,61,16,34,10,27,18,26,11,24,35,15,5,4,11,20,80
401365877,George Mason Patriots,J. Oduro,4432068,,True,40.0,7,15,7,13,0,2,2,4,3,3,6,2,1,3,2,4,16
401365877,George Mason Patriots,B. Buchanan,4395691,,True,8.0,1,2,1,1,0,1,0,0,0,1,1,0,0,0,0,1,2
401365877,George Mason Patriots,J. Hartwell II,4396817,,True,11.0,0,4,0,2,0,2,0,0,0,2,2,0,0,0,0,2,0
401365877,George Mason Patriots,D. Cooper,4279876,,True,37.0,6,9,1,1,5,8,2,3,0,2,2,0,0,0,1,2,19
401365877,George Mason Patriots,D. Schwartz,4278501,,True,42.0,6,15,4,9,2,6,7,8,2,4,6,4,0,0,1,4,21
401365877,George Mason Patriots,B. Jones,4897083,,False,1.0,0,0,0,0,0,0,0,0,0,0,0,0,0,0,0,0,0
401365877,George Mason Patriots,M. Henry,4606836,,False,5.0,1,1,1,1,0,0,1,2,0,0,0,1,1,0,0,0,3
401365877,George Mason Patriots,O. Frazier III,4700882,,False,4.0,0,0,0,0,0,0,0,0,0,1,1,0,1,0,0,0,0
401365877,George Mason Patriots,X. Johnson,4592439,,False,24.0,0,5,0,2,0,3,0,1,2,2,4,5,0,0,2,3,0
401365877,George Mason Patriots,R. Polite III,4567711,,False,21.0,2,6,1,4,1,2,3,4,0,1,1,2,2,0,3,1,8
401365877,George Mason Patriots,D. Gaines,4431961,,False,32.0,3,4,1,1,2,3,3,4,1,5,6,1,0,1,1,2,11
401365877,George Mason Patriots,TEAM,TOTAL,TOTAL,False,,26,61,16,34,10,27,18,26,11,24,35,15,5,4,11,20,80
401365876,George Washington Revolutionaries,H. Dean,4593273,,True,19.0,2,5,2,5,0,0,1,2,0,7,7,1,0,0,1,3,5
401365876,George Washington Revolutionaries,R. Lindo Jr.,4397186,,True,22.0,2,4,2,2,0,2,0,4,1,7,8,3,1,0,0,3,4
401365876,George Washington Revolutionaries,B. Freeman,4613126,,True,36.0,7,14,5,12,2,2,1,3,1,1,2,5,1,0,1,4,17
401365876,George Washington Revolutionaries,J. Bamisile,4432537,,True,36.0,3,9,0,4,3,5,2,4,1,0,1,1,0,1,3,1,11
401365876,George Washington Revolutionaries,J. Bishop,4431770,,True,37.0,3,12,3,8,0,4,2,2,1,2,3,2,1,1,3,2,8
401365876,George Washington Revolutionaries,Q. Samuels,4592251,,False,14.0,3,4,0,1,3,3,0,0,0,3,3,0,1,0,0,2,9
401365876,George Washington Revolutionaries,N. Brown,4700963,,False,5.0,0,0,0,0,0,0,0,0,0,3,3,0,0,0,0,0,0
401365876,George Washington Revolutionaries,A. Harris,4397216,,False,0.0,0,0,0,0,0,0,0,0,0,0,0,0,0,0,0,0,0
401365876,George Washington Revolutionaries,B. Adams,4396612,,False,31.0,4,9,2,6,2,3,2,4,1,5,6,2,0,1,1,4,12
401365876,George Washington Revolutionaries,TEAM,TOTAL,TOTAL,False,,24,57,14,38,10,19,8,19,6,28,34,14,4,3,9,19,66
401365876,George Washington Revolutionaries,H. Dean,4593273,,True,19.0,2,5,2,5,0,0,1,2,0,7,7,1,0,0,1,3,5
401365876,George Washington Revolutionaries,R. Lindo Jr.,4397186,,True,22.0,2,4,2,2,0,2,0,4,1,7,8,3,1,0,0,3,4
401365876,George Washington Revolutionaries,B. Freeman,4613126,,True,36.0,7,14,5,12,2,2,1,3,1,1,2,5,1,0,1,4,17
401365876,George Washington Revolutionaries,J. Bamisile,4432537,,True,36.0,3,9,0,4,3,5,2,4,1,0,1,1,0,1,3,1,11
401365876,George Washington Revolutionaries,J. Bishop,4431770,,True,37.0,3,12,3,8,0,4,2,2,1,2,3,2,1,1,3,2,8
401365876,George Washington Revolutionaries,Q. Samuels,4592251,,False,14.0,3,4,0,1,3,3,0,0,0,3,3,0,1,0,0,2,9
401365876,George Washington Revolutionaries,N. Brown,4700963,,False,5.0,0,0,0,0,0,0,0,0,0,3,3,0,0,0,0,0,0
401365876,George Washington Revolutionaries,A. Harris,4397216,,False,0.0,0,0,0,0,0,0,0,0,0,0,0,0,0,0,0,0,0
401365876,George Washington Revolutionaries,B. Adams,4396612,,False,31.0,4,9,2,6,2,3,2,4,1,5,6,2,0,1,1,4,12
401365876,George Washington Revolutionaries,TEAM,TOTAL,TOTAL,False,,24,57,14,38,10,19,8,19,6,28,34,14,4,3,9,19,66
401365876,Fordham Rams,A. Tsimbila,4702329,,True,8.0,0,1,0,1,0,0,0,0,0,3,3,0,0,0,1,1,0
401365876,Fordham Rams,C. Ohams,4066856,,True,33.0,9,17,9,17,0,0,5,8,3,13,16,5,0,3,2,3,23
401365876,Fordham Rams,J. Navarro,4592316,,True,31.0,4,8,3,5,1,3,4,5,0,3,3,2,0,0,0,1,13
401365876,Fordham Rams,K. Rose,4592315,,True,36.0,2,6,0,1,2,5,1,2,0,3,3,1,3,0,1,2,7
401365876,Fordham Rams,D. Quisenberry,4397790,,True,33.0,6,12,4,7,2,5,4,5,0,1,1,1,2,0,2,1,18
401365876,Fordham Rams,P. Kelly,4432014,,False,3.0,0,1,0,0,0,1,0,0,1,0,1,0,0,0,0,0,0
401365876,Fordham Rams,R. Novitskyi,4897084,,False,11.0,1,2,0,1,1,1,0,0,0,1,1,0,0,3,1,3,3
401365876,Fordham Rams,A. Charlton,4897085,,False,32.0,1,5,1,2,0,3,0,0,0,6,6,6,1,1,2,3,2
401365876,Fordham Rams,K. Cunningham,4705891,,False,2.0,1,2,1,1,0,1,0,0,0,0,0,0,0,0,0,0,2
401365876,Fordham Rams,Z. Riley,4914388,,False,11.0,1,2,1,2,0,0,0,0,0,1,1,0,0,0,0,2,2
401365876,Fordham Rams,TEAM,TOTAL,TOTAL,False,,25,56,19,37,6,19,14,20,8,33,41,15,6,7,12,16,70
401365876,Fordham Rams,A. Tsimbila,4702329,,True,8.0,0,1,0,1,0,0,0,0,0,3,3,0,0,0,1,1,0
401365876,Fordham Rams,C. Ohams,4066856,,True,33.0,9,17,9,17,0,0,5,8,3,13,16,5,0,3,2,3,23
401365876,Fordham Rams,J. Navarro,4592316,,True,31.0,4,8,3,5,1,3,4,5,0,3,3,2,0,0,0,1,13
401365876,Fordham Rams,K. Rose,4592315,,True,36.0,2,6,0,1,2,5,1,2,0,3,3,1,3,0,1,2,7
401365876,Fordham Rams,D. Quisenberry,4397790,,True,33.0,6,12,4,7,2,5,4,5,0,1,1,1,2,0,2,1,18
401365876,Fordham Rams,P. Kelly,4432014,,False,3.0,0,1,0,0,0,1,0,0,1,0,1,0,0,0,0,0,0
401365876,Fordham Rams,R. Novitskyi,4897084,,False,11.0,1,2,0,1,1,1,0,0,0,1,1,0,0,3,1,3,3
401365876,Fordham Rams,A. Charlton,4897085,,False,32.0,1,5,1,2,0,3,0,0,0,6,6,6,1,1,2,3,2
401365876,Fordham Rams,K. Cunningham,4705891,,False,2.0,1,2,1,1,0,1,0,0,0,0,0,0,0,0,0,0,2
401365876,Fordham Rams,Z. Riley,4914388,,False,11.0,1,2,1,2,0,0,0,0,0,1,1,0,0,0,0,2,2
401365876,Fordham Rams,TEAM,TOTAL,TOTAL,False,,25,56,19,37,6,19,14,20,8,33,41,15,6,7,12,16,70
401365875,La Salle Explorers,C. Moore,4277945,,True,15.0,3,5,3,5,0,0,0,0,1,3,4,1,0,1,1,1,6
401365875,La Salle Explorers,J. Clark,4397152,,True,37.0,13,19,9,13,4,6,0,1,3,5,8,3,1,0,2,2,30
401365875,La Salle Explorers,J. Brickus,4700970,,True,23.0,4,5,3,3,1,2,0,3,0,1,1,7,0,1,3,3,9
401365875,La Salle Explorers,A. Gill,4700969,,True,25.0,0,1,0,1,0,0,0,0,0,1,1,6,1,0,1,1,0
401365875,La Salle Explorers,C. Ray,4592448,,True,35.0,3,6,1,2,2,4,1,2,2,6,8,1,1,0,2,3,9
401365875,La Salle Explorers,M. Doucoure,4277988,,False,12.0,1,1,1,1,0,0,0,0,1,0,1,0,1,0,1,1,2
401365875,La Salle Explorers,D. Shepherd,4710357,,False,0.0,0,0,0,0,0,0,0,0,0,0,0,0,0,0,0,0,0
401365875,La Salle Explorers,K. Brantley,4709132,,False,26.0,2,8,2,6,0,2,2,2,1,3,4,3,3,0,2,3,6
401365875,La Salle Explorers,J. Nickelberry,4432845,,False,27.0,9,13,4,6,5,7,0,0,1,2,3,0,0,0,1,0,23
401365875,La Salle Explorers,TEAM,TOTAL,TOTAL,False,,35,58,23,37,12,21,3,8,10,22,32,21,7,2,13,14,85
401365875,La Salle Explorers,C. Moore,4277945,,True,15.0,3,5,3,5,0,0,0,0,1,3,4,1,0,1,1,1,6
401365875,La Salle Explorers,J. Clark,4397152,,True,37.0,13,19,9,13,4,6,0,1,3,5,8,3,1,0,2,2,30
401365875,La Salle Explorers,J. Brickus,4700970,,True,23.0,4,5,3,3,1,2,0,3,0,1,1,7,0,1,3,3,9
401365875,La Salle Explorers,A. Gill,4700969,,True,25.0,0,1,0,1,0,0,0,0,0,1,1,6,1,0,1,1,0
401365875,La Salle Explorers,C. Ray,4592448,,True,35.0,3,6,1,2,2,4,1,2,2,6,8,1,1,0,2,3,9
401365875,La Salle Explorers,M. Doucoure,4277988,,False,12.0,1,1,1,1,0,0,0,0,1,0,1,0,1,0,1,1,2
401365875,La Salle Explorers,D. Shepherd,4710357,,False,0.0,0,0,0,0,0,0,0,0,0,0,0,0,0,0,0,0,0
401365875,La Salle Explorers,K. Brantley,4709132,,False,26.0,2,8,2,6,0,2,2,2,1,3,4,3,3,0,2,3,6
401365875,La Salle Explorers,J. Nickelberry,4432845,,False,27.0,9,13,4,6,5,7,0,0,1,2,3,0,0,0,1,0,23
401365875,La Salle Explorers,TEAM,TOTAL,TOTAL,False,,35,58,23,37,12,21,3,8,10,22,32,21,7,2,13,14,85
401365875,Duquesne Dukes,M. Hima,4700878,,True,19.0,1,2,1,2,0,0,0,0,3,2,5,0,0,2,0,2,2
401365875,Duquesne Dukes,D. Larson,4897091,,True,31.0,4,5,4,5,0,0,0,0,1,1,2,1,0,0,0,3,8
401365875,Duquesne Dukes,A. Spears,4897090,,True,39.0,12,24,10,19,2,5,8,10,0,3,3,5,3,1,3,2,34
401365875,Duquesne Dukes,T. Okani,4700873,,True,19.0,1,3,1,2,0,1,0,0,2,0,2,2,1,0,2,1,2
401365875,Duquesne Dukes,T. Acuff,4606831,,True,34.0,1,4,1,2,0,2,0,0,1,2,3,2,2,0,0,1,2
401365875,Duquesne Dukes,K. Easley,4398159,,False,30.0,5,8,4,6,1,2,2,2,0,6,6,1,1,1,0,2,13
401365875,Duquesne Dukes,J. Johnson III,4897088,,False,24.0,5,11,0,4,5,7,0,0,0,1,1,1,0,0,4,1,15
401365875,Duquesne Dukes,M. Bekelja,4700874,,False,4.0,0,0,0,0,0,0,0,0,0,1,1,0,0,0,1,0,0
401365875,Duquesne Dukes,TEAM,TOTAL,TOTAL,False,,29,57,21,40,8,17,10,12,7,16,23,12,7,4,10,12,76
401365875,Duquesne Dukes,M. Hima,4700878,,True,19.0,1,2,1,2,0,0,0,0,3,2,5,0,0,2,0,2,2
401365875,Duquesne Dukes,D. Larson,4897091,,True,31.0,4,5,4,5,0,0,0,0,1,1,2,1,0,0,0,3,8
401365875,Duquesne Dukes,A. Spears,4897090,,True,39.0,12,24,10,19,2,5,8,10,0,3,3,5,3,1,3,2,34
401365875,Duquesne Dukes,T. Okani,4700873,,True,19.0,1,3,1,2,0,1,0,0,2,0,2,2,1,0,2,1,2
401365875,Duquesne Dukes,T. Acuff,4606831,,True,34.0,1,4,1,2,0,2,0,0,1,2,3,2,2,0,0,1,2
401365875,Duquesne Dukes,K. Easley,4398159,,False,30.0,5,8,4,6,1,2,2,2,0,6,6,1,1,1,0,2,13
401365875,Duquesne Dukes,J. Johnson III,4897088,,False,24.0,5,11,0,4,5,7,0,0,0,1,1,1,0,0,4,1,15
401365875,Duquesne Dukes,M. Bekelja,4700874,,False,4.0,0,0,0,0,0,0,0,0,0,1,1,0,0,0,1,0,0
401365875,Duquesne Dukes,TEAM,TOTAL,TOTAL,False,,29,57,21,40,8,17,10,12,7,16,23,12,7,4,10,12,76
401365874,Dayton Flyers,R.J. Blakney,4700864,,True,25.0,2,4,0,2,2,2,2,2,0,3,3,1,0,2,1,2,8
401365874,Dayton Flyers,T. Camara,4431736,,True,19.0,3,4,2,3,1,1,0,0,1,9,10,0,0,0,3,5,7
401365874,Dayton Flyers,D. Holmes II,4433607,,True,37.0,5,7,5,7,0,0,10,13,0,6,6,1,2,0,0,3,20
401365874,Dayton Flyers,C. Wilson,4403456,,True,1.0,0,0,0,0,0,0,0,0,0,0,0,0,0,0,0,0,0
401365874,Dayton Flyers,D. Swerlein,4600089,,True,1.0,0,1,0,1,0,0,0,0,0,0,0,0,0,0,0,1,0
401365874,Dayton Flyers,M. Sissoko,4431824,,False,3.0,0,0,0,0,0,0,0,0,0,1,1,0,0,0,0,1,0
401365874,Dayton Flyers,M. Amzil,4711607,,False,28.0,4,8,3,5,1,3,0,0,1,4,5,1,0,0,0,1,9
401365874,Dayton Flyers,M. Smith,4683861,,False,27.0,3,5,2,4,1,1,2,2,0,1,1,6,0,0,0,4,9
401365874,Dayton Flyers,K. Elvis,4683135,,False,34.0,4,12,3,6,1,6,2,2,1,0,1,6,0,0,0,2,11
401365874,Dayton Flyers,K. Brea,4591259,,False,25.0,7,10,3,4,4,6,0,2,1,2,3,1,0,0,0,0,18
401365874,Dayton Flyers,TEAM,TOTAL,TOTAL,False,,28,51,18,32,10,19,16,21,4,27,31,16,2,2,4,19,82
401365874,Dayton Flyers,R.J. Blakney,4700864,,True,25.0,2,4,0,2,2,2,2,2,0,3,3,1,0,2,1,2,8
401365874,Dayton Flyers,T. Camara,4431736,,True,19.0,3,4,2,3,1,1,0,0,1,9,10,0,0,0,3,5,7
401365874,Dayton Flyers,D. Holmes II,4433607,,True,37.0,5,7,5,7,0,0,10,13,0,6,6,1,2,0,0,3,20
401365874,Dayton Flyers,C. Wilson,4403456,,True,1.0,0,0,0,0,0,0,0,0,0,0,0,0,0,0,0,0,0
401365874,Dayton Flyers,D. Swerlein,4600089,,True,1.0,0,1,0,1,0,0,0,0,0,0,0,0,0,0,0,1,0
401365874,Dayton Flyers,M. Sissoko,4431824,,False,3.0,0,0,0,0,0,0,0,0,0,1,1,0,0,0,0,1,0
401365874,Dayton Flyers,M. Amzil,4711607,,False,28.0,4,8,3,5,1,3,0,0,1,4,5,1,0,0,0,1,9
401365874,Dayton Flyers,M. Smith,4683861,,False,27.0,3,5,2,4,1,1,2,2,0,1,1,6,0,0,0,4,9
401365874,Dayton Flyers,K. Elvis,4683135,,False,34.0,4,12,3,6,1,6,2,2,1,0,1,6,0,0,0,2,11
401365874,Dayton Flyers,K. Brea,4591259,,False,25.0,7,10,3,4,4,6,0,2,1,2,3,1,0,0,0,0,18
401365874,Dayton Flyers,TEAM,TOTAL,TOTAL,False,,28,51,18,32,10,19,16,21,4,27,31,16,2,2,4,19,82
401365874,Davidson Wildcats,S. Mennenga,4700862,,True,35.0,5,11,4,9,1,2,3,4,0,3,3,1,0,1,1,3,14
401365874,Davidson Wildcats,L. Brajkovic,4396787,,True,17.0,3,5,3,5,0,0,0,0,0,3,3,3,0,1,1,5,6
401365874,Davidson Wildcats,H. Lee,4592308,,True,34.0,7,14,4,6,3,8,0,1,0,7,7,3,0,1,0,2,17
401365874,Davidson Wildcats,G. Huffman,4432522,,True,20.0,1,2,1,2,0,0,0,1,1,3,4,1,0,0,0,1,2
401365874,Davidson Wildcats,M. Jones,4396784,,True,36.0,2,6,0,1,2,5,2,3,2,3,5,1,1,0,0,3,8
401365874,Davidson Wildcats,N. Boachie-Yiadom,4396786,,False,17.0,1,1,1,1,0,0,2,2,0,1,1,2,0,0,1,5,4
401365874,Davidson Wildcats,D. Watson,4897098,,False,6.0,0,1,0,0,0,1,0,0,0,1,1,1,0,0,1,1,0
401365874,Davidson Wildcats,F. Loyer,4397208,,False,35.0,7,13,2,6,5,7,6,7,0,1,1,2,0,0,1,0,25
401365874,Davidson Wildcats,TEAM,TOTAL,TOTAL,False,,26,53,15,30,11,23,13,18,4,22,26,14,1,3,5,20,76
401365874,Davidson Wildcats,S. Mennenga,4700862,,True,35.0,5,11,4,9,1,2,3,4,0,3,3,1,0,1,1,3,14
401365874,Davidson Wildcats,L. Brajkovic,4396787,,True,17.0,3,5,3,5,0,0,0,0,0,3,3,3,0,1,1,5,6
401365874,Davidson Wildcats,H. Lee,4592308,,True,34.0,7,14,4,6,3,8,0,1,0,7,7,3,0,1,0,2,17
401365874,Davidson Wildcats,G. Huffman,4432522,,True,20.0,1,2,1,2,0,0,0,1,1,3,4,1,0,0,0,1,2
401365874,Davidson Wildcats,M. Jones,4396784,,True,36.0,2,6,0,1,2,5,2,3,2,3,5,1,1,0,0,3,8
401365874,Davidson Wildcats,N. Boachie-Yiadom,4396786,,False,17.0,1,1,1,1,0,0,2,2,0,1,1,2,0,0,1,5,4
401365874,Davidson Wildcats,D. Watson,4897098,,False,6.0,0,1,0,0,0,1,0,0,0,1,1,1,0,0,1,1,0
401365874,Davidson Wildcats,F. Loyer,4397208,,False,35.0,7,13,2,6,5,7,6,7,0,1,1,2,0,0,1,0,25
401365874,Davidson Wildcats,TEAM,TOTAL,TOTAL,False,,26,53,15,30,11,23,13,18,4,22,26,14,1,3,5,20,76
401365873,St. Bonaventure Bonnies,O. Osunniyi,4397224,,True,36.0,8,12,8,12,0,0,0,2,3,3,6,1,2,3,0,1,16
401365873,St. Bonaventure Bonnies,J. Adaway,4279431,,True,40.0,8,13,6,9,2,4,3,3,0,7,7,0,0,1,1,4,21
401365873,St. Bonaventure Bonnies,J. Holmes,4701016,,True,36.0,5,13,5,9,0,4,3,4,0,3,3,2,4,0,1,0,13
401365873,St. Bonaventure Bonnies,D. Welch,4397221,,True,36.0,3,6,2,2,1,4,0,0,1,2,3,1,0,1,3,4,7
401365873,St. Bonaventure Bonnies,K. Lofton,4397220,,True,40.0,6,11,5,10,1,1,2,3,0,4,4,3,0,0,1,1,15
401365873,St. Bonaventure Bonnies,P. Rossi,4897049,,False,0.0,0,0,0,0,0,0,0,0,0,0,0,0,0,0,0,0,0
401365873,St. Bonaventure Bonnies,O. Durosinmi,4684462,,False,0.0,0,0,0,0,0,0,0,0,0,0,0,0,0,0,0,0,0
401365873,St. Bonaventure Bonnies,A. Coulibaly,4432889,,False,4.0,0,0,0,0,0,0,0,0,0,0,0,0,0,0,0,1,0
401365873,St. Bonaventure Bonnies,J. Ndjock-Tadjore,4897048,,False,0.0,0,0,0,0,0,0,0,0,0,0,0,0,0,0,0,0,0
401365873,St. Bonaventure Bonnies,J. Saizonou,4897046,,False,0.0,0,0,0,0,0,0,0,0,0,0,0,0,0,0,0,0,0
401365873,St. Bonaventure Bonnies,Q. Adams,4585591,,False,8.0,0,0,0,0,0,0,0,0,0,0,0,0,0,0,0,0,0
401365873,St. Bonaventure Bonnies,TEAM,TOTAL,TOTAL,False,,30,55,26,42,4,13,8,12,5,22,27,7,6,5,8,11,72
401365873,St. Bonaventure Bonnies,O. Osunniyi,4397224,,True,36.0,8,12,8,12,0,0,0,2,3,3,6,1,2,3,0,1,16
401365873,St. Bonaventure Bonnies,J. Adaway,4279431,,True,40.0,8,13,6,9,2,4,3,3,0,7,7,0,0,1,1,4,21
401365873,St. Bonaventure Bonnies,J. Holmes,4701016,,True,36.0,5,13,5,9,0,4,3,4,0,3,3,2,4,0,1,0,13
401365873,St. Bonaventure Bonnies,D. Welch,4397221,,True,36.0,3,6,2,2,1,4,0,0,1,2,3,1,0,1,3,4,7
401365873,St. Bonaventure Bonnies,K. Lofton,4397220,,True,40.0,6,11,5,10,1,1,2,3,0,4,4,3,0,0,1,1,15
401365873,St. Bonaventure Bonnies,P. Rossi,4897049,,False,0.0,0,0,0,0,0,0,0,0,0,0,0,0,0,0,0,0,0
401365873,St. Bonaventure Bonnies,O. Durosinmi,4684462,,False,0.0,0,0,0,0,0,0,0,0,0,0,0,0,0,0,0,0,0
401365873,St. Bonaventure Bonnies,A. Coulibaly,4432889,,False,4.0,0,0,0,0,0,0,0,0,0,0,0,0,0,0,0,1,0
401365873,St. Bonaventure Bonnies,J. Ndjock-Tadjore,4897048,,False,0.0,0,0,0,0,0,0,0,0,0,0,0,0,0,0,0,0,0
401365873,St. Bonaventure Bonnies,J. Saizonou,4897046,,False,0.0,0,0,0,0,0,0,0,0,0,0,0,0,0,0,0,0,0
401365873,St. Bonaventure Bonnies,Q. Adams,4585591,,False,8.0,0,0,0,0,0,0,0,0,0,0,0,0,0,0,0,0,0
401365873,St. Bonaventure Bonnies,TEAM,TOTAL,TOTAL,False,,30,55,26,42,4,13,8,12,5,22,27,7,6,5,8,11,72
401365873,Richmond Spiders,T. Burton,4431914,,True,34.0,9,13,8,10,1,3,2,4,2,6,8,0,1,0,1,1,21
401365873,Richmond Spiders,N. Cayo,4278380,,True,32.0,5,10,5,10,0,0,1,2,2,5,7,4,2,0,2,1,11
401365873,Richmond Spiders,G. Golden,4066836,,True,28.0,5,10,5,7,0,3,1,2,0,3,3,3,1,0,3,1,11
401365873,Richmond Spiders,A. Gustavson,4397193,,True,24.0,0,5,0,1,0,4,0,0,1,1,2,2,0,0,1,2,0
401365873,Richmond Spiders,J. Gilyard,4278378,,True,40.0,2,7,0,0,2,7,0,0,0,3,3,3,1,0,0,2,6
401365873,Richmond Spiders,M. Grace,4397192,,False,18.0,2,4,0,1,2,3,2,2,2,1,3,1,1,1,1,2,8
401365873,Richmond Spiders,I. Wilson,4700973,,False,9.0,0,3,0,1,0,2,0,0,0,1,1,2,0,0,1,5,0
401365873,Richmond Spiders,C. Crabtree,4396658,,False,5.0,0,0,0,0,0,0,0,0,1,0,1,0,0,0,0,0,0
401365873,Richmond Spiders,N. Sherod,4066832,,False,10.0,2,5,0,0,2,5,2,3,0,2,2,1,0,0,0,0,8
401365873,Richmond Spiders,TEAM,TOTAL,TOTAL,False,,25,57,18,30,7,27,8,13,9,23,32,16,6,1,11,14,65
401365873,Richmond Spiders,T. Burton,4431914,,True,34.0,9,13,8,10,1,3,2,4,2,6,8,0,1,0,1,1,21
401365873,Richmond Spiders,N. Cayo,4278380,,True,32.0,5,10,5,10,0,0,1,2,2,5,7,4,2,0,2,1,11
401365873,Richmond Spiders,G. Golden,4066836,,True,28.0,5,10,5,7,0,3,1,2,0,3,3,3,1,0,3,1,11
401365873,Richmond Spiders,A. Gustavson,4397193,,True,24.0,0,5,0,1,0,4,0,0,1,1,2,2,0,0,1,2,0
401365873,Richmond Spiders,J. Gilyard,4278378,,True,40.0,2,7,0,0,2,7,0,0,0,3,3,3,1,0,0,2,6
401365873,Richmond Spiders,M. Grace,4397192,,False,18.0,2,4,0,1,2,3,2,2,2,1,3,1,1,1,1,2,8
401365873,Richmond Spiders,I. Wilson,4700973,,False,9.0,0,3,0,1,0,2,0,0,0,1,1,2,0,0,1,5,0
401365873,Richmond Spiders,C. Crabtree,4396658,,False,5.0,0,0,0,0,0,0,0,0,1,0,1,0,0,0,0,0,0
401365873,Richmond Spiders,N. Sherod,4066832,,False,10.0,2,5,0,0,2,5,2,3,0,2,2,1,0,0,0,0,8
401365873,Richmond Spiders,TEAM,TOTAL,TOTAL,False,,25,57,18,30,7,27,8,13,9,23,32,16,6,1,11,14,65
401365872,Saint Louis Billikens,F. Okoro,4397105,,True,24.0,3,8,3,8,0,0,3,5,1,6,7,1,0,1,2,4,9
401365872,Saint Louis Billikens,J. Nesbitt,4714246,,True,28.0,4,8,4,7,0,1,3,4,2,2,4,2,1,0,0,2,11
401365872,Saint Louis Billikens,Y. Collins,4432957,,True,33.0,4,8,3,6,1,2,1,2,1,4,5,9,5,0,5,3,10
401365872,Saint Louis Billikens,G. Jimerson,4432008,,True,36.0,7,13,2,4,5,9,3,5,0,1,1,0,0,0,0,1,22
401365872,Saint Louis Billikens,F. Thatch Jr.,4397199,,True,38.0,8,17,5,12,3,5,2,4,3,10,13,1,1,1,0,1,21
401365872,Saint Louis Billikens,T. Hargrove Jr.,4592484,,False,15.0,1,4,1,3,0,1,0,0,0,2,2,0,0,0,0,3,2
401365872,Saint Louis Billikens,M. Linssen,4279174,,False,16.0,1,4,1,4,0,0,3,4,3,2,5,0,1,0,2,4,5
401365872,Saint Louis Billikens,D. Jones,4278267,,False,10.0,0,1,0,0,0,1,0,0,0,1,1,2,0,0,0,1,0
401365872,Saint Louis Billikens,TEAM,TOTAL,TOTAL,False,,28,63,19,44,9,19,15,24,12,30,42,15,8,2,9,19,80
401365872,Saint Louis Billikens,F. Okoro,4397105,,True,24.0,3,8,3,8,0,0,3,5,1,6,7,1,0,1,2,4,9
401365872,Saint Louis Billikens,J. Nesbitt,4714246,,True,28.0,4,8,4,7,0,1,3,4,2,2,4,2,1,0,0,2,11
401365872,Saint Louis Billikens,Y. Collins,4432957,,True,33.0,4,8,3,6,1,2,1,2,1,4,5,9,5,0,5,3,10
401365872,Saint Louis Billikens,G. Jimerson,4432008,,True,36.0,7,13,2,4,5,9,3,5,0,1,1,0,0,0,0,1,22
401365872,Saint Louis Billikens,F. Thatch Jr.,4397199,,True,38.0,8,17,5,12,3,5,2,4,3,10,13,1,1,1,0,1,21
401365872,Saint Louis Billikens,T. Hargrove Jr.,4592484,,False,15.0,1,4,1,3,0,1,0,0,0,2,2,0,0,0,0,3,2
401365872,Saint Louis Billikens,M. Linssen,4279174,,False,16.0,1,4,1,4,0,0,3,4,3,2,5,0,1,0,2,4,5
401365872,Saint Louis Billikens,D. Jones,4278267,,False,10.0,0,1,0,0,0,1,0,0,0,1,1,2,0,0,0,1,0
401365872,Saint Louis Billikens,TEAM,TOTAL,TOTAL,False,,28,63,19,44,9,19,15,24,12,30,42,15,8,2,9,19,80
401365872,Rhode Island Rams,A. Walker,4278567,,True,14.0,0,3,0,2,0,1,0,1,0,2,2,1,1,0,1,4,0
401365872,Rhode Island Rams,I. Leggett,4606837,,True,25.0,2,7,1,4,1,3,3,5,3,1,4,0,0,0,0,2,8
401365872,Rhode Island Rams,M. Martin,4397470,,True,32.0,2,5,2,2,0,3,1,2,3,2,5,1,0,1,2,0,5
401365872,Rhode Island Rams,I. El-Amin,4279313,,True,12.0,2,3,0,0,2,3,0,0,0,1,1,0,0,0,0,4,6
401365872,Rhode Island Rams,J. Sheppard,4066445,,True,27.0,7,9,5,6,2,3,0,0,0,5,5,1,0,0,0,2,16
401365872,Rhode Island Rams,Makhel Mitchell,4431777,,False,26.0,3,16,3,16,0,0,4,6,2,5,7,2,1,0,1,3,10
401365872,Rhode Island Rams,Makhi Mitchell,4431708,,False,25.0,6,9,6,8,0,1,1,3,3,5,8,3,2,6,6,2,13
401365872,Rhode Island Rams,J. Carey,4395673,,False,17.0,4,6,3,5,1,1,0,3,0,2,2,1,2,0,0,2,9
401365872,Rhode Island Rams,S. Thomas,4897065,,False,22.0,3,5,3,4,0,1,1,2,1,4,5,2,0,0,0,1,7
401365872,Rhode Island Rams,TEAM,TOTAL,TOTAL,False,,29,63,23,47,6,16,10,22,12,29,41,11,6,7,10,20,74
401365872,Rhode Island Rams,A. Walker,4278567,,True,14.0,0,3,0,2,0,1,0,1,0,2,2,1,1,0,1,4,0
401365872,Rhode Island Rams,I. Leggett,4606837,,True,25.0,2,7,1,4,1,3,3,5,3,1,4,0,0,0,0,2,8
401365872,Rhode Island Rams,M. Martin,4397470,,True,32.0,2,5,2,2,0,3,1,2,3,2,5,1,0,1,2,0,5
401365872,Rhode Island Rams,I. El-Amin,4279313,,True,12.0,2,3,0,0,2,3,0,0,0,1,1,0,0,0,0,4,6
401365872,Rhode Island Rams,J. Sheppard,4066445,,True,27.0,7,9,5,6,2,3,0,0,0,5,5,1,0,0,0,2,16
401365872,Rhode Island Rams,Makhel Mitchell,4431777,,False,26.0,3,16,3,16,0,0,4,6,2,5,7,2,1,0,1,3,10
401365872,Rhode Island Rams,Makhi Mitchell,4431708,,False,25.0,6,9,6,8,0,1,1,3,3,5,8,3,2,6,6,2,13
401365872,Rhode Island Rams,J. Carey,4395673,,False,17.0,4,6,3,5,1,1,0,3,0,2,2,1,2,0,0,2,9
401365872,Rhode Island Rams,S. Thomas,4897065,,False,22.0,3,5,3,4,0,1,1,2,1,4,5,2,0,0,0,1,7
401365872,Rhode Island Rams,TEAM,TOTAL,TOTAL,False,,29,63,23,47,6,16,10,22,12,29,41,11,6,7,10,20,74
401365871,Saint Joseph's Hawks,T. Funk,4278395,,True,36.0,2,10,0,1,2,9,2,2,0,5,5,1,0,0,1,1,8
401365871,Saint Joseph's Hawks,E. Obinna,4278125,,True,32.0,5,14,5,14,0,0,4,4,7,11,18,0,1,0,2,3,14
401365871,Saint Joseph's Hawks,J. Hall,4701031,,True,38.0,5,14,3,8,2,6,0,0,3,10,13,5,2,0,6,4,12
401365871,Saint Joseph's Hawks,E. Reynolds II,4683952,,True,37.0,4,14,1,7,3,7,0,0,0,3,3,3,1,1,1,2,11
401365871,Saint Joseph's Hawks,C. Brown,4592476,,True,35.0,0,6,0,4,0,2,0,0,2,3,5,1,2,0,0,0,0
401365871,Saint Joseph's Hawks,A. Jansson,4701029,,False,8.0,1,2,1,2,0,0,0,0,0,0,0,0,0,1,0,0,2
401365871,Saint Joseph's Hawks,J. Forrest,4701032,,False,10.0,0,2,0,2,0,0,0,0,0,1,1,0,0,0,0,1,0
401365871,Saint Joseph's Hawks,D. Bishop,4701028,,False,4.0,0,0,0,0,0,0,1,2,0,0,0,0,1,0,0,0,1
401365871,Saint Joseph's Hawks,TEAM,TOTAL,TOTAL,False,,17,62,10,38,7,24,7,8,12,33,45,10,7,2,11,11,48
401365871,Saint Joseph's Hawks,T. Funk,4278395,,True,36.0,2,10,0,1,2,9,2,2,0,5,5,1,0,0,1,1,8
401365871,Saint Joseph's Hawks,E. Obinna,4278125,,True,32.0,5,14,5,14,0,0,4,4,7,11,18,0,1,0,2,3,14
401365871,Saint Joseph's Hawks,J. Hall,4701031,,True,38.0,5,14,3,8,2,6,0,0,3,10,13,5,2,0,6,4,12
401365871,Saint Joseph's Hawks,E. Reynolds II,4683952,,True,37.0,4,14,1,7,3,7,0,0,0,3,3,3,1,1,1,2,11
401365871,Saint Joseph's Hawks,C. Brown,4592476,,True,35.0,0,6,0,4,0,2,0,0,2,3,5,1,2,0,0,0,0
401365871,Saint Joseph's Hawks,A. Jansson,4701029,,False,8.0,1,2,1,2,0,0,0,0,0,0,0,0,0,1,0,0,2
401365871,Saint Joseph's Hawks,J. Forrest,4701032,,False,10.0,0,2,0,2,0,0,0,0,0,1,1,0,0,0,0,1,0
401365871,Saint Joseph's Hawks,D. Bishop,4701028,,False,4.0,0,0,0,0,0,0,1,2,0,0,0,0,1,0,0,0,1
401365871,Saint Joseph's Hawks,TEAM,TOTAL,TOTAL,False,,17,62,10,38,7,24,7,8,12,33,45,10,7,2,11,11,48
401365871,La Salle Explorers,C. Moore,4277945,,True,37.0,2,7,2,3,0,4,1,2,0,8,8,3,1,7,3,1,5
401365871,La Salle Explorers,J. Clark,4397152,,True,31.0,3,12,3,8,0,4,0,0,3,3,6,2,1,0,2,3,6
401365871,La Salle Explorers,J. Brickus,4700970,,True,34.0,4,9,2,4,2,5,0,0,0,3,3,1,0,0,0,0,10
401365871,La Salle Explorers,A. Gill,4700969,,True,17.0,2,8,0,2,2,6,0,0,2,2,4,1,0,1,1,1,6
401365871,La Salle Explorers,C. Ray,4592448,,True,34.0,2,5,2,3,0,2,0,0,3,7,10,1,1,0,0,2,4
401365871,La Salle Explorers,D. Shepherd,4710357,,False,2.0,0,0,0,0,0,0,0,0,1,0,1,0,0,0,1,0,0
401365871,La Salle Explorers,K. Brantley,4709132,,False,21.0,4,12,3,8,1,4,2,2,1,4,5,1,2,0,3,3,11
401365871,La Salle Explorers,J. Nickelberry,4432845,,False,24.0,3,8,2,5,1,3,0,1,0,3,3,1,0,0,0,0,7
401365871,La Salle Explorers,TEAM,TOTAL,TOTAL,False,,20,61,14,33,6,28,3,5,10,31,41,10,5,8,10,10,49
401365871,La Salle Explorers,C. Moore,4277945,,True,37.0,2,7,2,3,0,4,1,2,0,8,8,3,1,7,3,1,5
401365871,La Salle Explorers,J. Clark,4397152,,True,31.0,3,12,3,8,0,4,0,0,3,3,6,2,1,0,2,3,6
401365871,La Salle Explorers,J. Brickus,4700970,,True,34.0,4,9,2,4,2,5,0,0,0,3,3,1,0,0,0,0,10
401365871,La Salle Explorers,A. Gill,4700969,,True,17.0,2,8,0,2,2,6,0,0,2,2,4,1,0,1,1,1,6
401365871,La Salle Explorers,C. Ray,4592448,,True,34.0,2,5,2,3,0,2,0,0,3,7,10,1,1,0,0,2,4
401365871,La Salle Explorers,D. Shepherd,4710357,,False,2.0,0,0,0,0,0,0,0,0,1,0,1,0,0,0,1,0,0
401365871,La Salle Explorers,K. Brantley,4709132,,False,21.0,4,12,3,8,1,4,2,2,1,4,5,1,2,0,3,3,11
401365871,La Salle Explorers,J. Nickelberry,4432845,,False,24.0,3,8,2,5,1,3,0,1,0,3,3,1,0,0,0,0,7
401365871,La Salle Explorers,TEAM,TOTAL,TOTAL,False,,20,61,14,33,6,28,3,5,10,31,41,10,5,8,10,10,49
401365870,Massachusetts Minutemen,M. Steadman,4397393,,True,10.0,2,4,2,4,0,0,0,2,1,2,3,1,0,0,4,1,4
401365870,Massachusetts Minutemen,G. Jones,4279211,,True,11.0,1,1,0,0,1,1,2,2,0,2,2,0,0,0,0,3,5
401365870,Massachusetts Minutemen,T. Buttrick,4277981,,True,33.0,3,5,1,2,2,3,3,4,0,8,8,1,1,0,1,3,11
401365870,Massachusetts Minutemen,N. Fernandes,4431791,,True,33.0,2,5,2,4,0,1,4,4,0,1,1,6,1,0,5,4,8
401365870,Massachusetts Minutemen,R. Kelly,4279741,,True,32.0,5,11,3,7,2,4,3,4,2,0,2,3,0,0,1,1,15
401365870,Massachusetts Minutemen,D. Dominguez,4701126,,False,9.0,3,7,2,3,1,4,2,2,1,1,2,0,0,0,0,1,9
401365870,Massachusetts Minutemen,J. Kelly,4593279,,False,0.0,0,0,0,0,0,0,0,0,0,0,0,0,0,0,0,0,0
401365870,Massachusetts Minutemen,R. Marcus,4701129,,False,0.0,0,0,0,0,0,0,0,0,0,0,0,0,0,0,0,0,0
401365870,Massachusetts Minutemen,J. Garcia,4701125,,False,19.0,4,10,4,5,0,5,1,3,0,2,2,0,2,0,2,4,9
401365870,Massachusetts Minutemen,T.J. Weeks,4433108,,False,36.0,6,10,5,7,1,3,4,4,5,5,10,0,1,0,2,3,17
401365870,Massachusetts Minutemen,P. Santos,4432104,,False,0.0,0,0,0,0,0,0,0,0,0,0,0,0,0,0,0,0,0
401365870,Massachusetts Minutemen,C.J. Kelly,4398208,,False,17.0,1,4,1,4,0,0,1,3,0,4,4,3,1,0,1,2,3
401365870,Massachusetts Minutemen,TEAM,TOTAL,TOTAL,False,,27,57,20,36,7,21,20,28,12,26,38,14,6,0,16,22,81
401365870,Massachusetts Minutemen,M. Steadman,4397393,,True,10.0,2,4,2,4,0,0,0,2,1,2,3,1,0,0,4,1,4
401365870,Massachusetts Minutemen,G. Jones,4279211,,True,11.0,1,1,0,0,1,1,2,2,0,2,2,0,0,0,0,3,5
401365870,Massachusetts Minutemen,T. Buttrick,4277981,,True,33.0,3,5,1,2,2,3,3,4,0,8,8,1,1,0,1,3,11
401365870,Massachusetts Minutemen,N. Fernandes,4431791,,True,33.0,2,5,2,4,0,1,4,4,0,1,1,6,1,0,5,4,8
401365870,Massachusetts Minutemen,R. Kelly,4279741,,True,32.0,5,11,3,7,2,4,3,4,2,0,2,3,0,0,1,1,15
401365870,Massachusetts Minutemen,D. Dominguez,4701126,,False,9.0,3,7,2,3,1,4,2,2,1,1,2,0,0,0,0,1,9
401365870,Massachusetts Minutemen,J. Kelly,4593279,,False,0.0,0,0,0,0,0,0,0,0,0,0,0,0,0,0,0,0,0
401365870,Massachusetts Minutemen,R. Marcus,4701129,,False,0.0,0,0,0,0,0,0,0,0,0,0,0,0,0,0,0,0,0
401365870,Massachusetts Minutemen,J. Garcia,4701125,,False,19.0,4,10,4,5,0,5,1,3,0,2,2,0,2,0,2,4,9
401365870,Massachusetts Minutemen,T.J. Weeks,4433108,,False,36.0,6,10,5,7,1,3,4,4,5,5,10,0,1,0,2,3,17
401365870,Massachusetts Minutemen,P. Santos,4432104,,False,0.0,0,0,0,0,0,0,0,0,0,0,0,0,0,0,0,0,0
401365870,Massachusetts Minutemen,C.J. Kelly,4398208,,False,17.0,1,4,1,4,0,0,1,3,0,4,4,3,1,0,1,2,3
401365870,Massachusetts Minutemen,TEAM,TOTAL,TOTAL,False,,27,57,20,36,7,21,20,28,12,26,38,14,6,0,16,22,81
401365870,Fordham Rams,A. Tsimbila,4702329,,True,19.0,5,9,5,9,0,0,0,0,5,1,6,0,0,1,2,2,10
401365870,Fordham Rams,C. Ohams,4066856,,True,36.0,4,11,4,11,0,0,6,6,2,10,12,5,1,2,0,3,14
401365870,Fordham Rams,A. Charlton,4897085,,True,21.0,2,7,1,4,1,3,4,4,1,2,3,5,2,0,0,5,9
401365870,Fordham Rams,J. Navarro,4592316,,True,32.0,3,10,0,4,3,6,1,2,1,4,5,1,1,0,3,2,10
401365870,Fordham Rams,K. Rose,4592315,,True,32.0,2,8,1,2,1,6,2,2,3,1,4,1,0,0,1,3,7
401365870,Fordham Rams,P. Kelly,4432014,,False,8.0,0,1,0,0,0,1,0,0,0,0,0,0,0,0,0,0,0
401365870,Fordham Rams,R. Novitskyi,4897084,,False,4.0,0,0,0,0,0,0,0,0,1,0,1,1,0,1,2,3,0
401365870,Fordham Rams,D. Quisenberry,4397790,,False,31.0,4,13,3,5,1,8,6,7,0,3,3,2,2,0,5,3,15
401365870,Fordham Rams,Z. Riley,4914388,,False,17.0,3,4,1,1,2,3,0,0,1,0,1,0,0,0,2,1,8
401365870,Fordham Rams,TEAM,TOTAL,TOTAL,False,,23,63,15,36,8,27,19,21,16,21,37,15,6,4,15,22,73
401365870,Fordham Rams,A. Tsimbila,4702329,,True,19.0,5,9,5,9,0,0,0,0,5,1,6,0,0,1,2,2,10
401365870,Fordham Rams,C. Ohams,4066856,,True,36.0,4,11,4,11,0,0,6,6,2,10,12,5,1,2,0,3,14
401365870,Fordham Rams,A. Charlton,4897085,,True,21.0,2,7,1,4,1,3,4,4,1,2,3,5,2,0,0,5,9
401365870,Fordham Rams,J. Navarro,4592316,,True,32.0,3,10,0,4,3,6,1,2,1,4,5,1,1,0,3,2,10
401365870,Fordham Rams,K. Rose,4592315,,True,32.0,2,8,1,2,1,6,2,2,3,1,4,1,0,0,1,3,7
401365870,Fordham Rams,P. Kelly,4432014,,False,8.0,0,1,0,0,0,1,0,0,0,0,0,0,0,0,0,0,0
401365870,Fordham Rams,R. Novitskyi,4897084,,False,4.0,0,0,0,0,0,0,0,0,1,0,1,1,0,1,2,3,0
401365870,Fordham Rams,D. Quisenberry,4397790,,False,31.0,4,13,3,5,1,8,6,7,0,3,3,2,2,0,5,3,15
401365870,Fordham Rams,Z. Riley,4914388,,False,17.0,3,4,1,1,2,3,0,0,1,0,1,0,0,0,2,1,8
401365870,Fordham Rams,TEAM,TOTAL,TOTAL,False,,23,63,15,36,8,27,19,21,16,21,37,15,6,4,15,22,73
401365869,George Washington Revolutionaries,M. Gally,4592445,,True,3.0,1,2,0,0,1,2,0,0,0,1,1,0,0,0,0,0,3
401365869,George Washington Revolutionaries,R. Lindo Jr.,4397186,,True,39.0,6,11,6,11,0,0,0,0,1,13,14,1,2,1,4,5,12
401365869,George Washington Revolutionaries,T. Stamoulis,4897076,,True,3.0,0,1,0,1,0,0,0,0,0,1,1,0,0,0,0,0,0
401365869,George Washington Revolutionaries,A. Harris,4397216,,True,3.0,1,1,1,1,0,0,0,0,0,1,1,1,0,0,1,0,2
401365869,George Washington Revolutionaries,B. Knapp,4279473,,True,3.0,0,0,0,0,0,0,0,0,0,1,1,0,0,0,0,0,0
401365869,George Washington Revolutionaries,H. Dean,4593273,,False,39.0,3,5,3,5,0,0,5,8,2,9,11,2,1,0,3,4,11
401365869,George Washington Revolutionaries,Q. Samuels,4592251,,False,14.0,1,3,1,2,0,1,0,0,1,3,4,1,0,0,1,2,2
401365869,George Washington Revolutionaries,N. Brown,4700963,,False,1.0,0,0,0,0,0,0,0,0,0,0,0,0,0,0,0,0,0
401365869,George Washington Revolutionaries,B. Freeman,4613126,,False,45.0,5,14,4,13,1,1,0,0,0,2,2,6,0,0,3,3,11
401365869,George Washington Revolutionaries,J. Bamisile,4432537,,False,49.0,11,19,8,13,3,6,5,6,1,6,7,1,1,1,3,2,30
401365869,George Washington Revolutionaries,J. Bishop,4431770,,False,41.0,6,12,3,7,3,5,8,8,0,2,2,2,0,1,2,2,23
401365869,George Washington Revolutionaries,B. Adams,4396612,,False,35.0,0,3,0,2,0,1,4,4,1,4,5,3,1,0,2,0,4
401365869,George Washington Revolutionaries,TEAM,TOTAL,TOTAL,False,,34,71,26,55,8,16,22,26,8,48,56,17,5,3,19,18,98
401365869,George Washington Revolutionaries,M. Gally,4592445,,True,3.0,1,2,0,0,1,2,0,0,0,1,1,0,0,0,0,0,3
401365869,George Washington Revolutionaries,R. Lindo Jr.,4397186,,True,39.0,6,11,6,11,0,0,0,0,1,13,14,1,2,1,4,5,12
401365869,George Washington Revolutionaries,T. Stamoulis,4897076,,True,3.0,0,1,0,1,0,0,0,0,0,1,1,0,0,0,0,0,0
401365869,George Washington Revolutionaries,A. Harris,4397216,,True,3.0,1,1,1,1,0,0,0,0,0,1,1,1,0,0,1,0,2
401365869,George Washington Revolutionaries,B. Knapp,4279473,,True,3.0,0,0,0,0,0,0,0,0,0,1,1,0,0,0,0,0,0
401365869,George Washington Revolutionaries,H. Dean,4593273,,False,39.0,3,5,3,5,0,0,5,8,2,9,11,2,1,0,3,4,11
401365869,George Washington Revolutionaries,Q. Samuels,4592251,,False,14.0,1,3,1,2,0,1,0,0,1,3,4,1,0,0,1,2,2
401365869,George Washington Revolutionaries,N. Brown,4700963,,False,1.0,0,0,0,0,0,0,0,0,0,0,0,0,0,0,0,0,0
401365869,George Washington Revolutionaries,B. Freeman,4613126,,False,45.0,5,14,4,13,1,1,0,0,0,2,2,6,0,0,3,3,11
401365869,George Washington Revolutionaries,J. Bamisile,4432537,,False,49.0,11,19,8,13,3,6,5,6,1,6,7,1,1,1,3,2,30
401365869,George Washington Revolutionaries,J. Bishop,4431770,,False,41.0,6,12,3,7,3,5,8,8,0,2,2,2,0,1,2,2,23
401365869,George Washington Revolutionaries,B. Adams,4396612,,False,35.0,0,3,0,2,0,1,4,4,1,4,5,3,1,0,2,0,4
401365869,George Washington Revolutionaries,TEAM,TOTAL,TOTAL,False,,34,71,26,55,8,16,22,26,8,48,56,17,5,3,19,18,98
401365869,Duquesne Dukes,M. Hima,4700878,,True,22.0,2,4,2,4,0,0,0,0,2,4,6,1,1,2,1,2,4
401365869,Duquesne Dukes,A. Spears,4897090,,True,52.0,11,26,11,22,0,4,3,5,0,2,2,6,2,1,1,2,25
401365869,Duquesne Dukes,M. Bekelja,4700874,,True,18.0,0,3,0,2,0,1,0,0,0,1,1,0,0,0,2,4,0
401365869,Duquesne Dukes,T. Okani,4700873,,True,25.0,2,8,2,6,0,2,1,2,0,1,1,0,1,1,1,3,5
401365869,Duquesne Dukes,T. Acuff,4606831,,True,47.0,7,13,6,7,1,6,0,0,1,4,5,1,2,2,1,2,15
401365869,Duquesne Dukes,K. Easley,4398159,,False,44.0,3,12,3,6,0,6,0,0,5,6,11,0,6,4,1,3,6
401365869,Duquesne Dukes,D. Larson,4897091,,False,29.0,3,5,1,3,2,2,0,0,3,6,9,1,1,0,0,3,8
401365869,Duquesne Dukes,J. Johnson III,4897088,,False,38.0,9,20,5,9,4,11,8,12,0,4,4,2,2,0,1,1,30
401365869,Duquesne Dukes,TEAM,TOTAL,TOTAL,False,,37,91,30,59,7,32,12,19,11,30,41,11,15,10,8,20,93
401365869,Duquesne Dukes,M. Hima,4700878,,True,22.0,2,4,2,4,0,0,0,0,2,4,6,1,1,2,1,2,4
401365869,Duquesne Dukes,A. Spears,4897090,,True,52.0,11,26,11,22,0,4,3,5,0,2,2,6,2,1,1,2,25
401365869,Duquesne Dukes,M. Bekelja,4700874,,True,18.0,0,3,0,2,0,1,0,0,0,1,1,0,0,0,2,4,0
401365869,Duquesne Dukes,T. Okani,4700873,,True,25.0,2,8,2,6,0,2,1,2,0,1,1,0,1,1,1,3,5
401365869,Duquesne Dukes,T. Acuff,4606831,,True,47.0,7,13,6,7,1,6,0,0,1,4,5,1,2,2,1,2,15
401365869,Duquesne Dukes,K. Easley,4398159,,False,44.0,3,12,3,6,0,6,0,0,5,6,11,0,6,4,1,3,6
401365869,Duquesne Dukes,D. Larson,4897091,,False,29.0,3,5,1,3,2,2,0,0,3,6,9,1,1,0,0,3,8
401365869,Duquesne Dukes,J. Johnson III,4897088,,False,38.0,9,20,5,9,4,11,8,12,0,4,4,2,2,0,1,1,30
401365869,Duquesne Dukes,TEAM,TOTAL,TOTAL,False,,37,91,30,59,7,32,12,19,11,30,41,11,15,10,8,20,93
401365868,George Mason Patriots,J. Oduro,4432068,,True,35.0,4,17,4,16,0,1,3,4,3,6,9,1,2,0,0,1,11
401365868,George Mason Patriots,R. Polite III,4567711,,True,18.0,2,5,1,2,1,3,0,0,0,1,1,3,1,0,3,0,5
401365868,George Mason Patriots,D. Gaines,4431961,,True,32.0,3,7,0,2,3,5,2,3,2,5,7,2,0,0,1,5,11
401365868,George Mason Patriots,D. Cooper,4279876,,True,29.0,3,9,0,2,3,7,2,2,0,2,2,1,0,0,0,2,11
401365868,George Mason Patriots,D. Schwartz,4278501,,True,35.0,4,9,3,4,1,5,2,3,0,0,0,1,0,0,2,5,11
401365868,George Mason Patriots,B. Jones,4897083,,False,16.0,3,3,2,2,1,1,0,0,0,4,4,0,2,0,0,0,7
401365868,George Mason Patriots,O. Frazier III,4700882,,False,3.0,0,0,0,0,0,0,0,0,0,0,0,0,0,0,0,0,0
401365868,George Mason Patriots,B. Buchanan,4395691,,False,2.0,0,0,0,0,0,0,0,0,0,0,0,0,0,0,0,1,0
401365868,George Mason Patriots,X. Johnson,4592439,,False,16.0,0,0,0,0,0,0,0,0,0,2,2,2,0,0,2,1,0
401365868,George Mason Patriots,J. Hartwell II,4396817,,False,14.0,2,5,0,0,2,5,0,0,0,1,1,1,0,0,0,2,6
401365868,George Mason Patriots,TEAM,TOTAL,TOTAL,False,,21,55,10,28,11,27,9,12,6,22,28,11,5,0,9,17,62
401365868,George Mason Patriots,J. Oduro,4432068,,True,35.0,4,17,4,16,0,1,3,4,3,6,9,1,2,0,0,1,11
401365868,George Mason Patriots,R. Polite III,4567711,,True,18.0,2,5,1,2,1,3,0,0,0,1,1,3,1,0,3,0,5
401365868,George Mason Patriots,D. Gaines,4431961,,True,32.0,3,7,0,2,3,5,2,3,2,5,7,2,0,0,1,5,11
401365868,George Mason Patriots,D. Cooper,4279876,,True,29.0,3,9,0,2,3,7,2,2,0,2,2,1,0,0,0,2,11
401365868,George Mason Patriots,D. Schwartz,4278501,,True,35.0,4,9,3,4,1,5,2,3,0,0,0,1,0,0,2,5,11
401365868,George Mason Patriots,B. Jones,4897083,,False,16.0,3,3,2,2,1,1,0,0,0,4,4,0,2,0,0,0,7
401365868,George Mason Patriots,O. Frazier III,4700882,,False,3.0,0,0,0,0,0,0,0,0,0,0,0,0,0,0,0,0,0
401365868,George Mason Patriots,B. Buchanan,4395691,,False,2.0,0,0,0,0,0,0,0,0,0,0,0,0,0,0,0,1,0
401365868,George Mason Patriots,X. Johnson,4592439,,False,16.0,0,0,0,0,0,0,0,0,0,2,2,2,0,0,2,1,0
401365868,George Mason Patriots,J. Hartwell II,4396817,,False,14.0,2,5,0,0,2,5,0,0,0,1,1,1,0,0,0,2,6
401365868,George Mason Patriots,TEAM,TOTAL,TOTAL,False,,21,55,10,28,11,27,9,12,6,22,28,11,5,0,9,17,62
401365868,Davidson Wildcats,L. Brajkovic,4396787,,True,35.0,6,10,4,4,2,6,1,2,1,5,6,3,0,1,3,3,15
401365868,Davidson Wildcats,N. Boachie-Yiadom,4396786,,True,20.0,3,6,3,6,0,0,2,2,3,0,3,3,0,1,1,3,8
401365868,Davidson Wildcats,B. Craig,4700863,,True,3.0,0,0,0,0,0,0,0,0,0,0,0,0,0,0,0,0,0
401365868,Davidson Wildcats,D. Dibble,4592309,,True,3.0,0,0,0,0,0,0,0,0,0,2,2,0,0,0,0,0,0
401365868,Davidson Wildcats,M. Jones,4396784,,True,34.0,1,8,1,5,0,3,4,6,1,3,4,0,1,1,1,0,6
401365868,Davidson Wildcats,S. Mennenga,4700862,,False,22.0,4,8,3,7,1,1,0,2,3,3,6,0,1,0,2,1,9
401365868,Davidson Wildcats,D. Kristensen,4432020,,False,0.0,0,0,0,0,0,0,0,0,0,1,1,0,0,0,0,0,0
401365868,Davidson Wildcats,S. Thrastarson,4897100,,False,0.0,0,0,0,0,0,0,0,0,0,0,0,0,0,0,0,0,0
401365868,Davidson Wildcats,D. Watson,4897098,,False,13.0,3,4,3,4,0,0,0,0,1,2,3,1,0,0,0,2,6
401365868,Davidson Wildcats,H. Lee,4592308,,False,33.0,7,12,4,6,3,6,1,4,0,8,8,1,0,0,1,1,18
401365868,Davidson Wildcats,E. Lanier,4567082,,False,3.0,0,0,0,0,0,0,0,0,0,0,0,1,0,0,1,0,0
401365868,Davidson Wildcats,G. Huffman,4432522,,False,34.0,4,7,4,5,0,2,3,4,0,3,3,3,0,0,0,0,11
401365868,Davidson Wildcats,TEAM,TOTAL,TOTAL,False,,28,55,22,37,6,18,11,20,9,27,36,12,2,3,9,10,73
401365868,Davidson Wildcats,L. Brajkovic,4396787,,True,35.0,6,10,4,4,2,6,1,2,1,5,6,3,0,1,3,3,15
401365868,Davidson Wildcats,N. Boachie-Yiadom,4396786,,True,20.0,3,6,3,6,0,0,2,2,3,0,3,3,0,1,1,3,8
401365868,Davidson Wildcats,B. Craig,4700863,,True,3.0,0,0,0,0,0,0,0,0,0,0,0,0,0,0,0,0,0
401365868,Davidson Wildcats,D. Dibble,4592309,,True,3.0,0,0,0,0,0,0,0,0,0,2,2,0,0,0,0,0,0
401365868,Davidson Wildcats,M. Jones,4396784,,True,34.0,1,8,1,5,0,3,4,6,1,3,4,0,1,1,1,0,6
401365868,Davidson Wildcats,S. Mennenga,4700862,,False,22.0,4,8,3,7,1,1,0,2,3,3,6,0,1,0,2,1,9
401365868,Davidson Wildcats,D. Kristensen,4432020,,False,0.0,0,0,0,0,0,0,0,0,0,1,1,0,0,0,0,0,0
401365868,Davidson Wildcats,S. Thrastarson,4897100,,False,0.0,0,0,0,0,0,0,0,0,0,0,0,0,0,0,0,0,0
401365868,Davidson Wildcats,D. Watson,4897098,,False,13.0,3,4,3,4,0,0,0,0,1,2,3,1,0,0,0,2,6
401365868,Davidson Wildcats,H. Lee,4592308,,False,33.0,7,12,4,6,3,6,1,4,0,8,8,1,0,0,1,1,18
401365868,Davidson Wildcats,E. Lanier,4567082,,False,3.0,0,0,0,0,0,0,0,0,0,0,0,1,0,0,1,0,0
401365868,Davidson Wildcats,G. Huffman,4432522,,False,34.0,4,7,4,5,0,2,3,4,0,3,3,3,0,0,0,0,11
401365868,Davidson Wildcats,TEAM,TOTAL,TOTAL,False,,28,55,22,37,6,18,11,20,9,27,36,12,2,3,9,10,73
401365867,VCU Rams,H. Ward,4592495,,True,18.0,4,4,4,4,0,0,1,1,1,3,4,2,1,6,3,4,9
401365867,VCU Rams,V. Williams Jr.,4397227,,True,35.0,3,11,2,4,1,7,6,6,0,7,7,6,2,1,3,3,13
401365867,VCU Rams,J. Nunn,4896614,,True,33.0,3,6,1,3,2,3,1,2,0,3,3,5,1,0,3,1,9
401365867,VCU Rams,A. Baldwin Jr.,4433182,,True,37.0,5,11,4,7,1,4,1,2,1,6,7,3,2,1,6,2,12
401365867,VCU Rams,K. Curry,4397228,,True,28.0,5,7,5,5,0,2,4,4,0,6,6,2,1,0,3,2,14
401365867,VCU Rams,M. Brown-Jones,4433224,,False,12.0,3,4,3,4,0,0,2,4,3,2,5,0,1,0,2,1,8
401365867,VCU Rams,J. DeLoach,4432483,,False,16.0,3,4,3,4,0,0,1,1,2,2,4,0,0,0,0,3,7
401365867,VCU Rams,L. Stockard III,4277897,,False,6.0,1,2,1,2,0,0,0,0,0,1,1,0,0,0,0,0,2
401365867,VCU Rams,N. Kern,4684145,,False,9.0,0,2,0,2,0,0,0,0,1,1,2,0,0,0,0,0,0
401365867,VCU Rams,A. Henderson VI,4592494,,False,1.0,0,1,0,1,0,0,0,0,0,0,0,0,0,0,0,0,0
401365867,VCU Rams,J. Banks,4432402,,False,5.0,0,1,0,0,0,1,0,0,0,0,0,0,0,0,0,0,0
401365867,VCU Rams,TEAM,TOTAL,TOTAL,False,,27,53,23,36,4,17,16,20,8,32,40,18,8,8,20,16,74
401365867,VCU Rams,H. Ward,4592495,,True,18.0,4,4,4,4,0,0,1,1,1,3,4,2,1,6,3,4,9
401365867,VCU Rams,V. Williams Jr.,4397227,,True,35.0,3,11,2,4,1,7,6,6,0,7,7,6,2,1,3,3,13
401365867,VCU Rams,J. Nunn,4896614,,True,33.0,3,6,1,3,2,3,1,2,0,3,3,5,1,0,3,1,9
401365867,VCU Rams,A. Baldwin Jr.,4433182,,True,37.0,5,11,4,7,1,4,1,2,1,6,7,3,2,1,6,2,12
401365867,VCU Rams,K. Curry,4397228,,True,28.0,5,7,5,5,0,2,4,4,0,6,6,2,1,0,3,2,14
401365867,VCU Rams,M. Brown-Jones,4433224,,False,12.0,3,4,3,4,0,0,2,4,3,2,5,0,1,0,2,1,8
401365867,VCU Rams,J. DeLoach,4432483,,False,16.0,3,4,3,4,0,0,1,1,2,2,4,0,0,0,0,3,7
401365867,VCU Rams,L. Stockard III,4277897,,False,6.0,1,2,1,2,0,0,0,0,0,1,1,0,0,0,0,0,2
401365867,VCU Rams,N. Kern,4684145,,False,9.0,0,2,0,2,0,0,0,0,1,1,2,0,0,0,0,0,0
401365867,VCU Rams,A. Henderson VI,4592494,,False,1.0,0,1,0,1,0,0,0,0,0,0,0,0,0,0,0,0,0
401365867,VCU Rams,J. Banks,4432402,,False,5.0,0,1,0,0,0,1,0,0,0,0,0,0,0,0,0,0,0
401365867,VCU Rams,TEAM,TOTAL,TOTAL,False,,27,53,23,36,4,17,16,20,8,32,40,18,8,8,20,16,74
401365867,St. Bonaventure Bonnies,A. Coulibaly,4432889,,True,17.0,3,8,3,8,0,0,1,2,2,2,4,0,0,0,0,4,7
401365867,St. Bonaventure Bonnies,J. Adaway,4279431,,True,38.0,4,16,4,11,0,5,4,6,0,7,7,2,3,0,1,2,12
401365867,St. Bonaventure Bonnies,J. Holmes,4701016,,True,40.0,3,6,2,4,1,2,3,6,0,1,1,2,1,1,1,1,10
401365867,St. Bonaventure Bonnies,D. Welch,4397221,,True,36.0,3,13,1,6,2,7,2,2,2,5,7,0,4,1,4,0,10
401365867,St. Bonaventure Bonnies,K. Lofton,4397220,,True,38.0,4,11,4,9,0,2,0,0,1,0,1,5,6,0,8,3,8
401365867,St. Bonaventure Bonnies,O. Durosinmi,4684462,,False,22.0,1,1,1,1,0,0,0,2,1,4,5,1,0,2,1,4,2
401365867,St. Bonaventure Bonnies,J. Ndjock-Tadjore,4897048,,False,1.0,0,0,0,0,0,0,0,0,0,0,0,0,0,0,0,0,0
401365867,St. Bonaventure Bonnies,J. Saizonou,4897046,,False,2.0,0,0,0,0,0,0,2,2,0,0,0,0,0,0,0,0,2
401365867,St. Bonaventure Bonnies,Q. Adams,4585591,,False,6.0,0,0,0,0,0,0,0,0,0,0,0,1,0,0,1,0,0
401365867,St. Bonaventure Bonnies,TEAM,TOTAL,TOTAL,False,,18,55,15,39,3,16,12,20,9,20,29,11,14,4,17,14,51
401365867,St. Bonaventure Bonnies,A. Coulibaly,4432889,,True,17.0,3,8,3,8,0,0,1,2,2,2,4,0,0,0,0,4,7
401365867,St. Bonaventure Bonnies,J. Adaway,4279431,,True,38.0,4,16,4,11,0,5,4,6,0,7,7,2,3,0,1,2,12
401365867,St. Bonaventure Bonnies,J. Holmes,4701016,,True,40.0,3,6,2,4,1,2,3,6,0,1,1,2,1,1,1,1,10
401365867,St. Bonaventure Bonnies,D. Welch,4397221,,True,36.0,3,13,1,6,2,7,2,2,2,5,7,0,4,1,4,0,10
401365867,St. Bonaventure Bonnies,K. Lofton,4397220,,True,38.0,4,11,4,9,0,2,0,0,1,0,1,5,6,0,8,3,8
401365867,St. Bonaventure Bonnies,O. Durosinmi,4684462,,False,22.0,1,1,1,1,0,0,0,2,1,4,5,1,0,2,1,4,2
401365867,St. Bonaventure Bonnies,J. Ndjock-Tadjore,4897048,,False,1.0,0,0,0,0,0,0,0,0,0,0,0,0,0,0,0,0,0
401365867,St. Bonaventure Bonnies,J. Saizonou,4897046,,False,2.0,0,0,0,0,0,0,2,2,0,0,0,0,0,0,0,0,2
401365867,St. Bonaventure Bonnies,Q. Adams,4585591,,False,6.0,0,0,0,0,0,0,0,0,0,0,0,1,0,0,1,0,0
401365867,St. Bonaventure Bonnies,TEAM,TOTAL,TOTAL,False,,18,55,15,39,3,16,12,20,9,20,29,11,14,4,17,14,51
401365866,Richmond Spiders,T. Burton,4431914,,True,23.0,0,5,0,4,0,1,3,4,0,4,4,1,2,1,2,2,3
401365866,Richmond Spiders,N. Cayo,4278380,,True,27.0,4,8,4,8,0,0,1,2,1,1,2,0,1,0,1,4,9
401365866,Richmond Spiders,G. Golden,4066836,,True,30.0,6,13,6,13,0,0,3,3,2,8,10,1,0,2,0,1,15
401365866,Richmond Spiders,A. Gustavson,4397193,,True,39.0,1,4,1,2,0,2,0,0,1,4,5,2,0,0,1,0,2
401365866,Richmond Spiders,J. Gilyard,4278378,,True,40.0,4,12,1,5,3,7,1,2,0,1,1,3,3,3,4,3,12
401365866,Richmond Spiders,M. Grace,4397192,,False,21.0,3,7,3,5,0,2,0,0,0,1,1,1,1,0,0,2,6
401365866,Richmond Spiders,D. Bailey,4700974,,False,7.0,0,0,0,0,0,0,0,0,0,0,0,0,1,0,0,0,0
401365866,Richmond Spiders,I. Wilson,4700973,,False,0.0,0,0,0,0,0,0,0,0,0,0,0,0,0,0,0,0,0
401365866,Richmond Spiders,C. Crabtree,4396658,,False,3.0,1,2,1,1,0,1,1,1,1,0,1,0,0,0,1,0,3
401365866,Richmond Spiders,N. Sherod,4066832,,False,10.0,1,5,0,2,1,3,0,0,0,2,2,0,0,0,0,0,3
401365866,Richmond Spiders,TEAM,TOTAL,TOTAL,False,,20,56,16,40,4,16,9,12,6,23,29,8,8,6,10,12,53
401365866,Richmond Spiders,T. Burton,4431914,,True,23.0,0,5,0,4,0,1,3,4,0,4,4,1,2,1,2,2,3
401365866,Richmond Spiders,N. Cayo,4278380,,True,27.0,4,8,4,8,0,0,1,2,1,1,2,0,1,0,1,4,9
401365866,Richmond Spiders,G. Golden,4066836,,True,30.0,6,13,6,13,0,0,3,3,2,8,10,1,0,2,0,1,15
401365866,Richmond Spiders,A. Gustavson,4397193,,True,39.0,1,4,1,2,0,2,0,0,1,4,5,2,0,0,1,0,2
401365866,Richmond Spiders,J. Gilyard,4278378,,True,40.0,4,12,1,5,3,7,1,2,0,1,1,3,3,3,4,3,12
401365866,Richmond Spiders,M. Grace,4397192,,False,21.0,3,7,3,5,0,2,0,0,0,1,1,1,1,0,0,2,6
401365866,Richmond Spiders,D. Bailey,4700974,,False,7.0,0,0,0,0,0,0,0,0,0,0,0,0,1,0,0,0,0
401365866,Richmond Spiders,I. Wilson,4700973,,False,0.0,0,0,0,0,0,0,0,0,0,0,0,0,0,0,0,0,0
401365866,Richmond Spiders,C. Crabtree,4396658,,False,3.0,1,2,1,1,0,1,1,1,1,0,1,0,0,0,1,0,3
401365866,Richmond Spiders,N. Sherod,4066832,,False,10.0,1,5,0,2,1,3,0,0,0,2,2,0,0,0,0,0,3
401365866,Richmond Spiders,TEAM,TOTAL,TOTAL,False,,20,56,16,40,4,16,9,12,6,23,29,8,8,6,10,12,53
401365866,Dayton Flyers,R.J. Blakney,4700864,,True,35.0,3,11,2,6,1,5,3,6,3,4,7,1,0,0,0,2,10
401365866,Dayton Flyers,T. Camara,4431736,,True,35.0,4,10,3,6,1,4,2,2,3,9,12,1,1,1,2,3,11
401365866,Dayton Flyers,D. Holmes II,4433607,,True,35.0,4,6,4,6,0,0,0,0,0,9,9,2,0,1,2,1,8
401365866,Dayton Flyers,M. Smith,4683861,,True,37.0,4,11,3,8,1,3,1,1,1,2,3,4,2,1,1,3,10
401365866,Dayton Flyers,K. Elvis,4683135,,True,26.0,2,8,0,3,2,5,0,0,0,2,2,2,1,0,3,2,6
401365866,Dayton Flyers,M. Amzil,4711607,,False,10.0,0,1,0,1,0,0,0,0,1,2,3,0,0,0,4,0,0
401365866,Dayton Flyers,K. Brea,4591259,,False,22.0,4,9,2,5,2,4,0,0,0,1,1,1,2,0,2,2,10
401365866,Dayton Flyers,TEAM,TOTAL,TOTAL,False,,21,56,14,35,7,21,6,9,10,29,39,11,6,3,15,13,55
401365866,Dayton Flyers,R.J. Blakney,4700864,,True,35.0,3,11,2,6,1,5,3,6,3,4,7,1,0,0,0,2,10
401365866,Dayton Flyers,T. Camara,4431736,,True,35.0,4,10,3,6,1,4,2,2,3,9,12,1,1,1,2,3,11
401365866,Dayton Flyers,D. Holmes II,4433607,,True,35.0,4,6,4,6,0,0,0,0,0,9,9,2,0,1,2,1,8
401365866,Dayton Flyers,M. Smith,4683861,,True,37.0,4,11,3,8,1,3,1,1,1,2,3,4,2,1,1,3,10
401365866,Dayton Flyers,K. Elvis,4683135,,True,26.0,2,8,0,3,2,5,0,0,0,2,2,2,1,0,3,2,6
401365866,Dayton Flyers,M. Amzil,4711607,,False,10.0,0,1,0,1,0,0,0,0,1,2,3,0,0,0,4,0,0
401365866,Dayton Flyers,K. Brea,4591259,,False,22.0,4,9,2,5,2,4,0,0,0,1,1,1,2,0,2,2,10
401365866,Dayton Flyers,TEAM,TOTAL,TOTAL,False,,21,56,14,35,7,21,6,9,10,29,39,11,6,3,15,13,55
401365865,George Washington Revolutionaries,H. Dean,4593273,,True,21.0,0,1,0,1,0,0,0,0,0,2,2,0,0,1,1,3,0
401365865,George Washington Revolutionaries,R. Lindo Jr.,4397186,,True,24.0,2,4,1,2,1,2,3,4,1,3,4,0,2,1,0,5,8
401365865,George Washington Revolutionaries,B. Freeman,4613126,,True,27.0,5,10,3,8,2,2,0,1,1,0,1,2,2,0,1,4,12
401365865,George Washington Revolutionaries,J. Bamisile,4432537,,True,31.0,5,16,2,6,3,10,5,6,0,4,4,0,0,0,3,0,18
401365865,George Washington Revolutionaries,J. Bishop,4431770,,True,37.0,3,17,1,7,2,10,8,9,0,4,4,1,1,1,1,2,16
401365865,George Washington Revolutionaries,Q. Samuels,4592251,,False,14.0,0,0,0,0,0,0,0,0,0,1,1,0,1,0,0,3,0
401365865,George Washington Revolutionaries,N. Brown,4700963,,False,9.0,1,2,1,2,0,0,0,0,1,0,1,1,0,0,0,4,2
401365865,George Washington Revolutionaries,A. Harris,4397216,,False,4.0,0,0,0,0,0,0,0,0,0,1,1,0,0,0,1,0,0
401365865,George Washington Revolutionaries,B. Adams,4396612,,False,33.0,3,7,3,6,0,1,0,0,2,5,7,3,2,0,2,1,6
401365865,George Washington Revolutionaries,TEAM,TOTAL,TOTAL,False,,19,57,11,32,8,25,16,20,8,22,30,7,8,3,9,22,62
401365865,George Washington Revolutionaries,H. Dean,4593273,,True,21.0,0,1,0,1,0,0,0,0,0,2,2,0,0,1,1,3,0
401365865,George Washington Revolutionaries,R. Lindo Jr.,4397186,,True,24.0,2,4,1,2,1,2,3,4,1,3,4,0,2,1,0,5,8
401365865,George Washington Revolutionaries,B. Freeman,4613126,,True,27.0,5,10,3,8,2,2,0,1,1,0,1,2,2,0,1,4,12
401365865,George Washington Revolutionaries,J. Bamisile,4432537,,True,31.0,5,16,2,6,3,10,5,6,0,4,4,0,0,0,3,0,18
401365865,George Washington Revolutionaries,J. Bishop,4431770,,True,37.0,3,17,1,7,2,10,8,9,0,4,4,1,1,1,1,2,16
401365865,George Washington Revolutionaries,Q. Samuels,4592251,,False,14.0,0,0,0,0,0,0,0,0,0,1,1,0,1,0,0,3,0
401365865,George Washington Revolutionaries,N. Brown,4700963,,False,9.0,1,2,1,2,0,0,0,0,1,0,1,1,0,0,0,4,2
401365865,George Washington Revolutionaries,A. Harris,4397216,,False,4.0,0,0,0,0,0,0,0,0,0,1,1,0,0,0,1,0,0
401365865,George Washington Revolutionaries,B. Adams,4396612,,False,33.0,3,7,3,6,0,1,0,0,2,5,7,3,2,0,2,1,6
401365865,George Washington Revolutionaries,TEAM,TOTAL,TOTAL,False,,19,57,11,32,8,25,16,20,8,22,30,7,8,3,9,22,62
401365865,George Mason Patriots,J. Oduro,4432068,,True,38.0,8,16,8,15,0,1,11,14,6,8,14,2,1,2,4,0,27
401365865,George Mason Patriots,R. Polite III,4567711,,True,27.0,4,10,4,7,0,3,0,0,0,3,3,1,0,1,2,2,8
401365865,George Mason Patriots,D. Gaines,4431961,,True,28.0,1,3,1,1,0,2,5,6,2,6,8,1,0,0,1,4,7
401365865,George Mason Patriots,D. Cooper,4279876,,True,30.0,1,6,0,0,1,6,0,0,0,2,2,1,1,1,2,1,3
401365865,George Mason Patriots,D. Schwartz,4278501,,True,36.0,7,16,3,6,4,10,1,2,3,5,8,2,0,1,1,3,19
401365865,George Mason Patriots,B. Jones,4897083,,False,1.0,0,0,0,0,0,0,0,0,0,0,0,0,0,0,0,1,0
401365865,George Mason Patriots,O. Frazier III,4700882,,False,11.0,0,2,0,1,0,1,1,2,2,1,3,0,0,0,0,0,1
401365865,George Mason Patriots,B. Buchanan,4395691,,False,2.0,0,0,0,0,0,0,0,0,0,0,0,0,0,0,0,1,0
401365865,George Mason Patriots,X. Johnson,4592439,,False,24.0,0,3,0,1,0,2,4,4,0,3,3,2,0,0,2,1,4
401365865,George Mason Patriots,J. Hartwell II,4396817,,False,3.0,0,0,0,0,0,0,0,0,0,1,1,0,0,0,1,0,0
401365865,George Mason Patriots,TEAM,TOTAL,TOTAL,False,,21,56,16,31,5,25,22,28,16,32,48,9,2,5,13,13,69
401365865,George Mason Patriots,J. Oduro,4432068,,True,38.0,8,16,8,15,0,1,11,14,6,8,14,2,1,2,4,0,27
401365865,George Mason Patriots,R. Polite III,4567711,,True,27.0,4,10,4,7,0,3,0,0,0,3,3,1,0,1,2,2,8
401365865,George Mason Patriots,D. Gaines,4431961,,True,28.0,1,3,1,1,0,2,5,6,2,6,8,1,0,0,1,4,7
401365865,George Mason Patriots,D. Cooper,4279876,,True,30.0,1,6,0,0,1,6,0,0,0,2,2,1,1,1,2,1,3
401365865,George Mason Patriots,D. Schwartz,4278501,,True,36.0,7,16,3,6,4,10,1,2,3,5,8,2,0,1,1,3,19
401365865,George Mason Patriots,B. Jones,4897083,,False,1.0,0,0,0,0,0,0,0,0,0,0,0,0,0,0,0,1,0
401365865,George Mason Patriots,O. Frazier III,4700882,,False,11.0,0,2,0,1,0,1,1,2,2,1,3,0,0,0,0,0,1
401365865,George Mason Patriots,B. Buchanan,4395691,,False,2.0,0,0,0,0,0,0,0,0,0,0,0,0,0,0,0,1,0
401365865,George Mason Patriots,X. Johnson,4592439,,False,24.0,0,3,0,1,0,2,4,4,0,3,3,2,0,0,2,1,4
401365865,George Mason Patriots,J. Hartwell II,4396817,,False,3.0,0,0,0,0,0,0,0,0,0,1,1,0,0,0,1,0,0
401365865,George Mason Patriots,TEAM,TOTAL,TOTAL,False,,21,56,16,31,5,25,22,28,16,32,48,9,2,5,13,13,69
401365864,St. Bonaventure Bonnies,O. Osunniyi,4397224,,True,27.0,3,7,3,7,0,0,0,0,1,6,7,2,1,5,1,3,6
401365864,St. Bonaventure Bonnies,J. Adaway,4279431,,True,40.0,6,12,6,8,0,4,2,3,1,6,7,1,3,0,0,0,14
401365864,St. Bonaventure Bonnies,J. Holmes,4701016,,True,37.0,4,10,4,6,0,4,1,3,1,4,5,6,2,1,2,0,9
401365864,St. Bonaventure Bonnies,D. Welch,4397221,,True,40.0,4,9,2,4,2,5,1,2,0,4,4,1,0,1,3,4,11
401365864,St. Bonaventure Bonnies,K. Lofton,4397220,,True,40.0,6,20,6,15,0,5,0,0,3,5,8,4,1,0,2,1,12
401365864,St. Bonaventure Bonnies,A. Coulibaly,4432889,,False,13.0,1,4,1,4,0,0,0,0,2,2,4,0,0,1,1,2,2
401365864,St. Bonaventure Bonnies,Q. Adams,4585591,,False,3.0,0,0,0,0,0,0,0,0,0,0,0,0,0,0,0,0,0
401365864,St. Bonaventure Bonnies,TEAM,TOTAL,TOTAL,False,,24,62,22,44,2,18,4,8,8,29,37,14,7,8,9,10,54
401365864,St. Bonaventure Bonnies,O. Osunniyi,4397224,,True,27.0,3,7,3,7,0,0,0,0,1,6,7,2,1,5,1,3,6
401365864,St. Bonaventure Bonnies,J. Adaway,4279431,,True,40.0,6,12,6,8,0,4,2,3,1,6,7,1,3,0,0,0,14
401365864,St. Bonaventure Bonnies,J. Holmes,4701016,,True,37.0,4,10,4,6,0,4,1,3,1,4,5,6,2,1,2,0,9
401365864,St. Bonaventure Bonnies,D. Welch,4397221,,True,40.0,4,9,2,4,2,5,1,2,0,4,4,1,0,1,3,4,11
401365864,St. Bonaventure Bonnies,K. Lofton,4397220,,True,40.0,6,20,6,15,0,5,0,0,3,5,8,4,1,0,2,1,12
401365864,St. Bonaventure Bonnies,A. Coulibaly,4432889,,False,13.0,1,4,1,4,0,0,0,0,2,2,4,0,0,1,1,2,2
401365864,St. Bonaventure Bonnies,Q. Adams,4585591,,False,3.0,0,0,0,0,0,0,0,0,0,0,0,0,0,0,0,0,0
401365864,St. Bonaventure Bonnies,TEAM,TOTAL,TOTAL,False,,24,62,22,44,2,18,4,8,8,29,37,14,7,8,9,10,54
401365864,Saint Joseph's Hawks,T. Funk,4278395,,True,40.0,6,13,1,3,5,10,2,2,2,8,10,1,0,0,1,0,19
401365864,Saint Joseph's Hawks,E. Obinna,4278125,,True,40.0,1,7,1,7,0,0,1,6,3,6,9,4,1,0,6,4,3
401365864,Saint Joseph's Hawks,J. Hall,4701031,,True,29.0,6,14,2,5,4,9,0,0,0,2,2,2,1,0,2,3,16
401365864,Saint Joseph's Hawks,E. Reynolds II,4683952,,True,40.0,4,10,2,5,2,5,0,1,0,4,4,2,4,0,3,2,10
401365864,Saint Joseph's Hawks,C. Brown,4592476,,True,39.0,1,8,1,5,0,3,0,0,0,9,9,2,0,0,2,3,2
401365864,Saint Joseph's Hawks,J. Forrest,4701032,,False,5.0,1,1,1,1,0,0,0,0,0,0,0,0,0,1,2,0,2
401365864,Saint Joseph's Hawks,D. Bishop,4701028,,False,7.0,0,0,0,0,0,0,0,0,0,1,1,0,0,0,1,0,0
401365864,Saint Joseph's Hawks,TEAM,TOTAL,TOTAL,False,,19,53,8,26,11,27,3,9,9,32,41,11,6,1,17,12,52
401365864,Saint Joseph's Hawks,T. Funk,4278395,,True,40.0,6,13,1,3,5,10,2,2,2,8,10,1,0,0,1,0,19
401365864,Saint Joseph's Hawks,E. Obinna,4278125,,True,40.0,1,7,1,7,0,0,1,6,3,6,9,4,1,0,6,4,3
401365864,Saint Joseph's Hawks,J. Hall,4701031,,True,29.0,6,14,2,5,4,9,0,0,0,2,2,2,1,0,2,3,16
401365864,Saint Joseph's Hawks,E. Reynolds II,4683952,,True,40.0,4,10,2,5,2,5,0,1,0,4,4,2,4,0,3,2,10
401365864,Saint Joseph's Hawks,C. Brown,4592476,,True,39.0,1,8,1,5,0,3,0,0,0,9,9,2,0,0,2,3,2
401365864,Saint Joseph's Hawks,J. Forrest,4701032,,False,5.0,1,1,1,1,0,0,0,0,0,0,0,0,0,1,2,0,2
401365864,Saint Joseph's Hawks,D. Bishop,4701028,,False,7.0,0,0,0,0,0,0,0,0,0,1,1,0,0,0,1,0,0
401365864,Saint Joseph's Hawks,TEAM,TOTAL,TOTAL,False,,19,53,8,26,11,27,3,9,9,32,41,11,6,1,17,12,52
401365863,La Salle Explorers,C. Moore,4277945,,True,32.0,6,10,6,10,0,0,4,5,3,4,7,0,0,3,1,4,16
401365863,La Salle Explorers,J. Clark,4397152,,True,38.0,4,10,2,4,2,6,3,4,1,8,9,1,2,1,1,2,13
401365863,La Salle Explorers,K. Thompson,4592449,,True,0.0,0,1,0,0,0,1,0,0,0,0,0,0,0,0,0,0,0
401365863,La Salle Explorers,C. Ray,4592448,,True,27.0,2,6,2,3,0,3,0,0,3,2,5,2,0,0,1,1,4
401365863,La Salle Explorers,A. Lafond,4404355,,True,0.0,0,0,0,0,0,0,0,0,0,0,0,0,0,0,0,1,0
401365863,La Salle Explorers,M. McFarlane,4897068,,False,6.0,0,1,0,0,0,1,0,0,0,1,1,0,0,0,0,2,0
401365863,La Salle Explorers,M. Doucoure,4277988,,False,3.0,0,0,0,0,0,0,0,0,1,1,2,0,0,0,0,0,0
401365863,La Salle Explorers,K. Brantley,4709132,,False,25.0,6,10,4,8,2,2,3,5,0,3,3,1,0,0,0,2,17
401365863,La Salle Explorers,J. Brickus,4700970,,False,31.0,4,10,3,6,1,4,0,0,0,3,3,4,0,0,2,2,9
401365863,La Salle Explorers,A. Gill,4700969,,False,29.0,0,4,0,1,0,3,0,0,1,4,5,2,1,2,2,2,0
401365863,La Salle Explorers,J. Nickelberry,4432845,,False,9.0,1,4,0,1,1,3,0,0,0,1,1,1,0,0,0,1,3
401365863,La Salle Explorers,TEAM,TOTAL,TOTAL,False,,23,56,17,33,6,23,10,14,11,27,38,11,3,6,10,17,62
401365863,La Salle Explorers,C. Moore,4277945,,True,32.0,6,10,6,10,0,0,4,5,3,4,7,0,0,3,1,4,16
401365863,La Salle Explorers,J. Clark,4397152,,True,38.0,4,10,2,4,2,6,3,4,1,8,9,1,2,1,1,2,13
401365863,La Salle Explorers,K. Thompson,4592449,,True,0.0,0,1,0,0,0,1,0,0,0,0,0,0,0,0,0,0,0
401365863,La Salle Explorers,C. Ray,4592448,,True,27.0,2,6,2,3,0,3,0,0,3,2,5,2,0,0,1,1,4
401365863,La Salle Explorers,A. Lafond,4404355,,True,0.0,0,0,0,0,0,0,0,0,0,0,0,0,0,0,0,1,0
401365863,La Salle Explorers,M. McFarlane,4897068,,False,6.0,0,1,0,0,0,1,0,0,0,1,1,0,0,0,0,2,0
401365863,La Salle Explorers,M. Doucoure,4277988,,False,3.0,0,0,0,0,0,0,0,0,1,1,2,0,0,0,0,0,0
401365863,La Salle Explorers,K. Brantley,4709132,,False,25.0,6,10,4,8,2,2,3,5,0,3,3,1,0,0,0,2,17
401365863,La Salle Explorers,J. Brickus,4700970,,False,31.0,4,10,3,6,1,4,0,0,0,3,3,4,0,0,2,2,9
401365863,La Salle Explorers,A. Gill,4700969,,False,29.0,0,4,0,1,0,3,0,0,1,4,5,2,1,2,2,2,0
401365863,La Salle Explorers,J. Nickelberry,4432845,,False,9.0,1,4,0,1,1,3,0,0,0,1,1,1,0,0,0,1,3
401365863,La Salle Explorers,TEAM,TOTAL,TOTAL,False,,23,56,17,33,6,23,10,14,11,27,38,11,3,6,10,17,62
401365863,Dayton Flyers,M. Amzil,4711607,,True,35.0,2,6,1,3,1,3,1,2,1,3,4,1,0,0,0,3,6
401365863,Dayton Flyers,R.J. Blakney,4700864,,True,29.0,2,4,1,1,1,3,0,0,1,3,4,2,0,0,3,3,5
401365863,Dayton Flyers,D. Holmes II,4433607,,True,38.0,7,12,7,12,0,0,4,7,5,7,12,0,1,4,2,1,18
401365863,Dayton Flyers,M. Smith,4683861,,True,38.0,4,12,4,10,0,2,1,2,0,2,2,9,2,0,1,2,9
401365863,Dayton Flyers,K. Elvis,4683135,,True,23.0,1,6,1,3,0,3,0,0,0,1,1,2,1,0,1,0,2
401365863,Dayton Flyers,M. Sissoko,4431824,,False,2.0,0,0,0,0,0,0,0,0,0,0,0,0,0,0,0,0,0
401365863,Dayton Flyers,Z. Nwokeji,4618121,,False,7.0,0,1,0,0,0,1,2,2,0,0,0,0,0,0,0,0,2
401365863,Dayton Flyers,K. Brea,4591259,,False,28.0,7,14,4,7,3,7,1,1,0,3,3,0,0,0,0,1,18
401365863,Dayton Flyers,TEAM,TOTAL,TOTAL,False,,23,55,18,36,5,19,9,14,7,22,29,14,4,4,7,10,60
401365863,Dayton Flyers,M. Amzil,4711607,,True,35.0,2,6,1,3,1,3,1,2,1,3,4,1,0,0,0,3,6
401365863,Dayton Flyers,R.J. Blakney,4700864,,True,29.0,2,4,1,1,1,3,0,0,1,3,4,2,0,0,3,3,5
401365863,Dayton Flyers,D. Holmes II,4433607,,True,38.0,7,12,7,12,0,0,4,7,5,7,12,0,1,4,2,1,18
401365863,Dayton Flyers,M. Smith,4683861,,True,38.0,4,12,4,10,0,2,1,2,0,2,2,9,2,0,1,2,9
401365863,Dayton Flyers,K. Elvis,4683135,,True,23.0,1,6,1,3,0,3,0,0,0,1,1,2,1,0,1,0,2
401365863,Dayton Flyers,M. Sissoko,4431824,,False,2.0,0,0,0,0,0,0,0,0,0,0,0,0,0,0,0,0,0
401365863,Dayton Flyers,Z. Nwokeji,4618121,,False,7.0,0,1,0,0,0,1,2,2,0,0,0,0,0,0,0,0,2
401365863,Dayton Flyers,K. Brea,4591259,,False,28.0,7,14,4,7,3,7,1,1,0,3,3,0,0,0,0,1,18
401365863,Dayton Flyers,TEAM,TOTAL,TOTAL,False,,23,55,18,36,5,19,9,14,7,22,29,14,4,4,7,10,60
401365862,VCU Rams,H. Ward,4592495,,True,12.0,2,6,2,6,0,0,0,0,2,4,6,0,0,1,3,5,4
401365862,VCU Rams,V. Williams Jr.,4397227,,True,26.0,3,7,2,4,1,3,3,4,0,2,2,0,4,2,2,2,10
401365862,VCU Rams,J. Nunn,4896614,,True,26.0,1,4,1,3,0,1,3,4,0,2,2,5,1,0,1,2,5
401365862,VCU Rams,A. Baldwin Jr.,4433182,,True,33.0,2,3,0,1,2,2,0,0,1,3,4,9,1,0,2,0,6
401365862,VCU Rams,K. Curry,4397228,,True,30.0,7,11,6,10,1,1,3,4,0,4,4,3,4,0,2,3,18
401365862,VCU Rams,M. Brown-Jones,4433224,,False,16.0,3,3,3,3,0,0,1,1,0,2,2,0,0,1,5,2,7
401365862,VCU Rams,J. DeLoach,4432483,,False,10.0,2,3,2,3,0,0,0,0,0,0,0,1,0,1,0,3,4
401365862,VCU Rams,L. Stockard III,4277897,,False,16.0,2,4,2,4,0,0,0,1,1,2,3,0,2,0,0,0,4
401365862,VCU Rams,N. Kern,4684145,,False,10.0,1,2,1,1,0,1,1,1,0,2,2,0,1,0,0,2,3
401365862,VCU Rams,M. Tsohonis,4592438,,False,17.0,5,11,5,9,0,2,2,2,1,0,1,2,0,0,2,1,12
401365862,VCU Rams,J. Banks,4432402,,False,4.0,1,1,0,0,1,1,1,2,0,0,0,0,0,0,0,0,4
401365862,VCU Rams,TEAM,TOTAL,TOTAL,False,,29,55,24,44,5,11,14,19,5,22,27,20,13,5,17,20,77
401365862,VCU Rams,H. Ward,4592495,,True,12.0,2,6,2,6,0,0,0,0,2,4,6,0,0,1,3,5,4
401365862,VCU Rams,V. Williams Jr.,4397227,,True,26.0,3,7,2,4,1,3,3,4,0,2,2,0,4,2,2,2,10
401365862,VCU Rams,J. Nunn,4896614,,True,26.0,1,4,1,3,0,1,3,4,0,2,2,5,1,0,1,2,5
401365862,VCU Rams,A. Baldwin Jr.,4433182,,True,33.0,2,3,0,1,2,2,0,0,1,3,4,9,1,0,2,0,6
401365862,VCU Rams,K. Curry,4397228,,True,30.0,7,11,6,10,1,1,3,4,0,4,4,3,4,0,2,3,18
401365862,VCU Rams,M. Brown-Jones,4433224,,False,16.0,3,3,3,3,0,0,1,1,0,2,2,0,0,1,5,2,7
401365862,VCU Rams,J. DeLoach,4432483,,False,10.0,2,3,2,3,0,0,0,0,0,0,0,1,0,1,0,3,4
401365862,VCU Rams,L. Stockard III,4277897,,False,16.0,2,4,2,4,0,0,0,1,1,2,3,0,2,0,0,0,4
401365862,VCU Rams,N. Kern,4684145,,False,10.0,1,2,1,1,0,1,1,1,0,2,2,0,1,0,0,2,3
401365862,VCU Rams,M. Tsohonis,4592438,,False,17.0,5,11,5,9,0,2,2,2,1,0,1,2,0,0,2,1,12
401365862,VCU Rams,J. Banks,4432402,,False,4.0,1,1,0,0,1,1,1,2,0,0,0,0,0,0,0,0,4
401365862,VCU Rams,TEAM,TOTAL,TOTAL,False,,29,55,24,44,5,11,14,19,5,22,27,20,13,5,17,20,77
401365862,Massachusetts Minutemen,M. Steadman,4397393,,True,21.0,4,9,4,9,0,0,3,4,3,5,8,1,1,0,2,0,11
401365862,Massachusetts Minutemen,T. Buttrick,4277981,,True,24.0,4,8,3,5,1,3,3,3,3,5,8,1,1,0,2,1,12
401365862,Massachusetts Minutemen,T.J. Weeks,4433108,,True,26.0,0,2,0,0,0,2,3,6,0,1,1,1,2,0,1,2,3
401365862,Massachusetts Minutemen,N. Fernandes,4431791,,True,34.0,3,11,2,7,1,4,2,3,2,1,3,4,1,0,5,1,9
401365862,Massachusetts Minutemen,R. Kelly,4279741,,True,20.0,0,4,0,2,0,2,0,0,0,0,0,1,0,0,4,3,0
401365862,Massachusetts Minutemen,D. Dominguez,4701126,,False,9.0,2,4,2,3,0,1,0,0,0,3,3,1,1,0,0,0,4
401365862,Massachusetts Minutemen,J. Kelly,4593279,,False,2.0,0,1,0,1,0,0,0,0,0,0,0,0,0,0,0,0,0
401365862,Massachusetts Minutemen,G. Jones,4279211,,False,19.0,3,4,2,3,1,1,2,2,1,6,7,0,0,0,0,3,9
401365862,Massachusetts Minutemen,R. Marcus,4701129,,False,2.0,0,1,0,0,0,1,0,0,0,0,0,1,1,0,1,0,0
401365862,Massachusetts Minutemen,J. Garcia,4701125,,False,23.0,1,3,1,2,0,1,4,6,0,0,0,3,1,0,1,5,6
401365862,Massachusetts Minutemen,P. Santos,4432104,,False,5.0,2,2,2,2,0,0,0,0,1,0,1,0,0,1,0,0,4
401365862,Massachusetts Minutemen,C.J. Kelly,4398208,,False,15.0,2,6,2,2,0,4,0,0,1,2,3,0,1,0,5,4,4
401365862,Massachusetts Minutemen,TEAM,TOTAL,TOTAL,False,,21,55,18,36,3,19,17,24,12,24,36,13,9,1,22,19,62
401365862,Massachusetts Minutemen,M. Steadman,4397393,,True,21.0,4,9,4,9,0,0,3,4,3,5,8,1,1,0,2,0,11
401365862,Massachusetts Minutemen,T. Buttrick,4277981,,True,24.0,4,8,3,5,1,3,3,3,3,5,8,1,1,0,2,1,12
401365862,Massachusetts Minutemen,T.J. Weeks,4433108,,True,26.0,0,2,0,0,0,2,3,6,0,1,1,1,2,0,1,2,3
401365862,Massachusetts Minutemen,N. Fernandes,4431791,,True,34.0,3,11,2,7,1,4,2,3,2,1,3,4,1,0,5,1,9
401365862,Massachusetts Minutemen,R. Kelly,4279741,,True,20.0,0,4,0,2,0,2,0,0,0,0,0,1,0,0,4,3,0
401365862,Massachusetts Minutemen,D. Dominguez,4701126,,False,9.0,2,4,2,3,0,1,0,0,0,3,3,1,1,0,0,0,4
401365862,Massachusetts Minutemen,J. Kelly,4593279,,False,2.0,0,1,0,1,0,0,0,0,0,0,0,0,0,0,0,0,0
401365862,Massachusetts Minutemen,G. Jones,4279211,,False,19.0,3,4,2,3,1,1,2,2,1,6,7,0,0,0,0,3,9
401365862,Massachusetts Minutemen,R. Marcus,4701129,,False,2.0,0,1,0,0,0,1,0,0,0,0,0,1,1,0,1,0,0
401365862,Massachusetts Minutemen,J. Garcia,4701125,,False,23.0,1,3,1,2,0,1,4,6,0,0,0,3,1,0,1,5,6
401365862,Massachusetts Minutemen,P. Santos,4432104,,False,5.0,2,2,2,2,0,0,0,0,1,0,1,0,0,1,0,0,4
401365862,Massachusetts Minutemen,C.J. Kelly,4398208,,False,15.0,2,6,2,2,0,4,0,0,1,2,3,0,1,0,5,4,4
401365862,Massachusetts Minutemen,TEAM,TOTAL,TOTAL,False,,21,55,18,36,3,19,17,24,12,24,36,13,9,1,22,19,62
401365861,Fordham Rams,A. Tsimbila,4702329,,True,16.0,1,4,1,4,0,0,2,2,1,2,3,0,0,0,1,4,4
401365861,Fordham Rams,C. Ohams,4066856,,True,27.0,4,11,4,9,0,2,7,10,2,8,10,1,1,0,6,4,15
401365861,Fordham Rams,A. Charlton,4897085,,True,34.0,2,6,2,3,0,3,2,2,0,7,7,1,1,0,2,3,6
401365861,Fordham Rams,J. Navarro,4592316,,True,34.0,1,9,0,2,1,7,3,5,0,0,0,1,3,0,1,2,6
401365861,Fordham Rams,K. Rose,4592315,,True,34.0,2,7,0,0,2,7,0,0,0,1,1,0,0,0,5,4,6
401365861,Fordham Rams,P. Kelly,4432014,,False,21.0,0,5,0,0,0,5,0,0,3,5,8,0,0,0,1,3,0
401365861,Fordham Rams,R. Novitskyi,4897084,,False,8.0,0,0,0,0,0,0,2,2,1,3,4,0,0,0,1,2,2
401365861,Fordham Rams,A. Harrison,4897086,,False,2.0,0,1,0,0,0,1,0,0,0,0,0,0,0,0,1,0,0
401365861,Fordham Rams,A. Evans,4700881,,False,5.0,1,2,0,0,1,2,0,0,0,1,1,0,0,0,1,1,3
401365861,Fordham Rams,Z. Riley,4914388,,False,19.0,1,4,1,1,0,3,1,1,0,1,1,1,0,0,1,3,3
401365861,Fordham Rams,TEAM,TOTAL,TOTAL,False,,12,49,8,19,4,30,17,22,7,30,37,4,5,0,21,26,45
401365861,Fordham Rams,A. Tsimbila,4702329,,True,16.0,1,4,1,4,0,0,2,2,1,2,3,0,0,0,1,4,4
401365861,Fordham Rams,C. Ohams,4066856,,True,27.0,4,11,4,9,0,2,7,10,2,8,10,1,1,0,6,4,15
401365861,Fordham Rams,A. Charlton,4897085,,True,34.0,2,6,2,3,0,3,2,2,0,7,7,1,1,0,2,3,6
401365861,Fordham Rams,J. Navarro,4592316,,True,34.0,1,9,0,2,1,7,3,5,0,0,0,1,3,0,1,2,6
401365861,Fordham Rams,K. Rose,4592315,,True,34.0,2,7,0,0,2,7,0,0,0,1,1,0,0,0,5,4,6
401365861,Fordham Rams,P. Kelly,4432014,,False,21.0,0,5,0,0,0,5,0,0,3,5,8,0,0,0,1,3,0
401365861,Fordham Rams,R. Novitskyi,4897084,,False,8.0,0,0,0,0,0,0,2,2,1,3,4,0,0,0,1,2,2
401365861,Fordham Rams,A. Harrison,4897086,,False,2.0,0,1,0,0,0,1,0,0,0,0,0,0,0,0,1,0,0
401365861,Fordham Rams,A. Evans,4700881,,False,5.0,1,2,0,0,1,2,0,0,0,1,1,0,0,0,1,1,3
401365861,Fordham Rams,Z. Riley,4914388,,False,19.0,1,4,1,1,0,3,1,1,0,1,1,1,0,0,1,3,3
401365861,Fordham Rams,TEAM,TOTAL,TOTAL,False,,12,49,8,19,4,30,17,22,7,30,37,4,5,0,21,26,45
401365861,Davidson Wildcats,S. Mennenga,4700862,,True,29.0,4,8,4,6,0,2,9,10,5,4,9,1,1,0,2,0,17
401365861,Davidson Wildcats,L. Brajkovic,4396787,,True,28.0,6,12,4,7,2,5,1,3,4,6,10,0,1,0,2,3,15
401365861,Davidson Wildcats,H. Lee,4592308,,True,29.0,4,8,3,4,1,4,1,1,1,3,4,2,2,0,0,1,10
401365861,Davidson Wildcats,G. Huffman,4432522,,True,22.0,0,1,0,1,0,0,0,0,0,5,5,1,1,0,6,4,0
401365861,Davidson Wildcats,M. Jones,4396784,,True,31.0,3,7,1,4,2,3,4,5,0,4,4,2,1,0,1,3,12
401365861,Davidson Wildcats,D. Kristensen,4432020,,False,4.0,0,0,0,0,0,0,0,0,0,0,0,0,0,0,1,1,0
401365861,Davidson Wildcats,N. Boachie-Yiadom,4396786,,False,17.0,1,4,1,3,0,1,0,2,1,2,3,0,0,1,0,1,2
401365861,Davidson Wildcats,M. Katsock,4902569,,False,2.0,0,2,0,0,0,2,0,0,0,0,0,0,0,0,0,0,0
401365861,Davidson Wildcats,S. Thrastarson,4897100,,False,2.0,0,1,0,0,0,1,0,2,0,1,1,0,0,0,1,1,0
401365861,Davidson Wildcats,D. Watson,4897098,,False,9.0,1,5,1,2,0,3,0,0,1,3,4,0,1,0,0,1,2
401365861,Davidson Wildcats,B. Craig,4700863,,False,2.0,0,0,0,0,0,0,0,0,0,0,0,0,0,0,0,0,0
401365861,Davidson Wildcats,D. Dibble,4592309,,False,2.0,0,0,0,0,0,0,0,0,0,0,0,0,0,0,0,0,0
401365861,Davidson Wildcats,E. Lanier,4567082,,False,23.0,3,10,3,4,0,6,2,4,0,2,2,3,0,0,0,3,8
401365861,Davidson Wildcats,TEAM,TOTAL,TOTAL,False,,22,58,17,31,5,27,17,27,12,34,46,9,7,1,13,18,66
401365861,Davidson Wildcats,S. Mennenga,4700862,,True,29.0,4,8,4,6,0,2,9,10,5,4,9,1,1,0,2,0,17
401365861,Davidson Wildcats,L. Brajkovic,4396787,,True,28.0,6,12,4,7,2,5,1,3,4,6,10,0,1,0,2,3,15
401365861,Davidson Wildcats,H. Lee,4592308,,True,29.0,4,8,3,4,1,4,1,1,1,3,4,2,2,0,0,1,10
401365861,Davidson Wildcats,G. Huffman,4432522,,True,22.0,0,1,0,1,0,0,0,0,0,5,5,1,1,0,6,4,0
401365861,Davidson Wildcats,M. Jones,4396784,,True,31.0,3,7,1,4,2,3,4,5,0,4,4,2,1,0,1,3,12
401365861,Davidson Wildcats,D. Kristensen,4432020,,False,4.0,0,0,0,0,0,0,0,0,0,0,0,0,0,0,1,1,0
401365861,Davidson Wildcats,N. Boachie-Yiadom,4396786,,False,17.0,1,4,1,3,0,1,0,2,1,2,3,0,0,1,0,1,2
401365861,Davidson Wildcats,M. Katsock,4902569,,False,2.0,0,2,0,0,0,2,0,0,0,0,0,0,0,0,0,0,0
401365861,Davidson Wildcats,S. Thrastarson,4897100,,False,2.0,0,1,0,0,0,1,0,2,0,1,1,0,0,0,1,1,0
401365861,Davidson Wildcats,D. Watson,4897098,,False,9.0,1,5,1,2,0,3,0,0,1,3,4,0,1,0,0,1,2
401365861,Davidson Wildcats,B. Craig,4700863,,False,2.0,0,0,0,0,0,0,0,0,0,0,0,0,0,0,0,0,0
401365861,Davidson Wildcats,D. Dibble,4592309,,False,2.0,0,0,0,0,0,0,0,0,0,0,0,0,0,0,0,0,0
401365861,Davidson Wildcats,E. Lanier,4567082,,False,23.0,3,10,3,4,0,6,2,4,0,2,2,3,0,0,0,3,8
401365861,Davidson Wildcats,TEAM,TOTAL,TOTAL,False,,22,58,17,31,5,27,17,27,12,34,46,9,7,1,13,18,66
401365860,Rhode Island Rams,Makhel Mitchell,4431777,,True,17.0,1,7,1,7,0,0,0,0,0,4,4,1,0,1,2,1,2
401365860,Rhode Island Rams,Makhi Mitchell,4431708,,True,16.0,2,3,2,3,0,0,1,4,1,2,3,2,0,0,3,1,5
401365860,Rhode Island Rams,I. Leggett,4606837,,True,27.0,6,10,6,9,0,1,1,1,0,1,1,2,2,0,0,2,13
401365860,Rhode Island Rams,I. El-Amin,4279313,,True,28.0,7,12,4,5,3,7,4,5,1,6,7,0,2,0,0,3,21
401365860,Rhode Island Rams,J. Sheppard,4066445,,True,32.0,4,8,3,4,1,4,2,2,1,1,2,1,2,0,3,3,11
401365860,Rhode Island Rams,I. Ayo-Faleye,4701259,,False,1.0,0,0,0,0,0,0,0,0,0,0,0,0,0,0,0,0,0
401365860,Rhode Island Rams,A. Walker,4278567,,False,25.0,2,4,2,4,0,0,0,0,2,3,5,1,0,3,2,2,4
401365860,Rhode Island Rams,M. Martin,4397470,,False,25.0,3,6,3,4,0,2,1,3,3,4,7,2,0,0,0,2,7
401365860,Rhode Island Rams,J. Carey,4395673,,False,13.0,1,5,1,3,0,2,1,4,0,2,2,0,5,0,0,0,3
401365860,Rhode Island Rams,S. Thomas,4897065,,False,16.0,1,2,1,2,0,0,2,3,0,1,1,3,1,0,1,1,4
401365860,Rhode Island Rams,TEAM,TOTAL,TOTAL,False,,27,57,23,41,4,16,12,22,10,27,37,12,12,4,11,15,70
401365860,Rhode Island Rams,Makhel Mitchell,4431777,,True,17.0,1,7,1,7,0,0,0,0,0,4,4,1,0,1,2,1,2
401365860,Rhode Island Rams,Makhi Mitchell,4431708,,True,16.0,2,3,2,3,0,0,1,4,1,2,3,2,0,0,3,1,5
401365860,Rhode Island Rams,I. Leggett,4606837,,True,27.0,6,10,6,9,0,1,1,1,0,1,1,2,2,0,0,2,13
401365860,Rhode Island Rams,I. El-Amin,4279313,,True,28.0,7,12,4,5,3,7,4,5,1,6,7,0,2,0,0,3,21
401365860,Rhode Island Rams,J. Sheppard,4066445,,True,32.0,4,8,3,4,1,4,2,2,1,1,2,1,2,0,3,3,11
401365860,Rhode Island Rams,I. Ayo-Faleye,4701259,,False,1.0,0,0,0,0,0,0,0,0,0,0,0,0,0,0,0,0,0
401365860,Rhode Island Rams,A. Walker,4278567,,False,25.0,2,4,2,4,0,0,0,0,2,3,5,1,0,3,2,2,4
401365860,Rhode Island Rams,M. Martin,4397470,,False,25.0,3,6,3,4,0,2,1,3,3,4,7,2,0,0,0,2,7
401365860,Rhode Island Rams,J. Carey,4395673,,False,13.0,1,5,1,3,0,2,1,4,0,2,2,0,5,0,0,0,3
401365860,Rhode Island Rams,S. Thomas,4897065,,False,16.0,1,2,1,2,0,0,2,3,0,1,1,3,1,0,1,1,4
401365860,Rhode Island Rams,TEAM,TOTAL,TOTAL,False,,27,57,23,41,4,16,12,22,10,27,37,12,12,4,11,15,70
401365860,Duquesne Dukes,M. Hima,4700878,,True,15.0,2,6,2,6,0,0,0,0,1,3,4,0,0,0,2,3,4
401365860,Duquesne Dukes,A. Spears,4897090,,True,32.0,2,12,2,9,0,3,2,2,0,0,0,3,0,0,3,1,6
401365860,Duquesne Dukes,M. Bekelja,4700874,,True,22.0,1,2,0,1,1,1,2,2,1,3,4,2,1,0,0,4,5
401365860,Duquesne Dukes,T. Okani,4700873,,True,36.0,3,8,3,7,0,1,1,1,6,5,11,1,3,0,1,3,7
401365860,Duquesne Dukes,T. Acuff,4606831,,True,31.0,1,4,1,1,0,3,5,5,0,4,4,1,0,0,2,3,7
401365860,Duquesne Dukes,K. Easley,4398159,,False,29.0,5,10,2,4,3,6,0,1,1,4,5,2,1,1,5,3,13
401365860,Duquesne Dukes,J. Johnson III,4897088,,False,19.0,3,10,1,3,2,7,2,2,1,1,2,1,1,0,1,1,10
401365860,Duquesne Dukes,L. Ayers III,4703813,,False,16.0,1,3,1,1,0,2,0,0,0,2,2,1,0,2,2,3,2
401365860,Duquesne Dukes,TEAM,TOTAL,TOTAL,False,,18,55,12,32,6,23,12,13,11,25,36,11,6,3,16,21,54
401365860,Duquesne Dukes,M. Hima,4700878,,True,15.0,2,6,2,6,0,0,0,0,1,3,4,0,0,0,2,3,4
401365860,Duquesne Dukes,A. Spears,4897090,,True,32.0,2,12,2,9,0,3,2,2,0,0,0,3,0,0,3,1,6
401365860,Duquesne Dukes,M. Bekelja,4700874,,True,22.0,1,2,0,1,1,1,2,2,1,3,4,2,1,0,0,4,5
401365860,Duquesne Dukes,T. Okani,4700873,,True,36.0,3,8,3,7,0,1,1,1,6,5,11,1,3,0,1,3,7
401365860,Duquesne Dukes,T. Acuff,4606831,,True,31.0,1,4,1,1,0,3,5,5,0,4,4,1,0,0,2,3,7
401365860,Duquesne Dukes,K. Easley,4398159,,False,29.0,5,10,2,4,3,6,0,1,1,4,5,2,1,1,5,3,13
401365860,Duquesne Dukes,J. Johnson III,4897088,,False,19.0,3,10,1,3,2,7,2,2,1,1,2,1,1,0,1,1,10
401365860,Duquesne Dukes,L. Ayers III,4703813,,False,16.0,1,3,1,1,0,2,0,0,0,2,2,1,0,2,2,3,2
401365860,Duquesne Dukes,TEAM,TOTAL,TOTAL,False,,18,55,12,32,6,23,12,13,11,25,36,11,6,3,16,21,54
401365859,Saint Louis Billikens,F. Okoro,4397105,,True,36.0,8,11,8,11,0,0,7,8,4,11,15,0,0,0,3,3,23
401365859,Saint Louis Billikens,J. Nesbitt,4714246,,True,34.0,2,7,2,2,0,5,0,0,5,2,7,2,1,0,2,1,4
401365859,Saint Louis Billikens,Y. Collins,4432957,,True,35.0,1,8,1,7,0,1,0,0,1,3,4,4,0,0,4,4,2
401365859,Saint Louis Billikens,G. Jimerson,4432008,,True,37.0,4,8,4,6,0,2,0,2,0,0,0,1,1,0,0,1,8
401365859,Saint Louis Billikens,F. Thatch Jr.,4397199,,True,34.0,7,14,7,12,0,2,1,1,0,3,3,1,3,1,1,2,15
401365859,Saint Louis Billikens,T. Hargrove Jr.,4592484,,False,11.0,2,4,1,2,1,2,2,2,0,0,0,0,0,0,1,1,7
401365859,Saint Louis Billikens,M. Linssen,4279174,,False,5.0,1,1,1,1,0,0,2,2,1,0,1,0,0,0,1,2,4
401365859,Saint Louis Billikens,D. Jones,4278267,,False,8.0,1,2,0,1,1,1,0,0,0,0,0,1,0,0,2,0,3
401365859,Saint Louis Billikens,TEAM,TOTAL,TOTAL,False,,26,55,24,42,2,13,12,15,12,20,32,9,5,1,15,14,66
401365859,Saint Louis Billikens,F. Okoro,4397105,,True,36.0,8,11,8,11,0,0,7,8,4,11,15,0,0,0,3,3,23
401365859,Saint Louis Billikens,J. Nesbitt,4714246,,True,34.0,2,7,2,2,0,5,0,0,5,2,7,2,1,0,2,1,4
401365859,Saint Louis Billikens,Y. Collins,4432957,,True,35.0,1,8,1,7,0,1,0,0,1,3,4,4,0,0,4,4,2
401365859,Saint Louis Billikens,G. Jimerson,4432008,,True,37.0,4,8,4,6,0,2,0,2,0,0,0,1,1,0,0,1,8
401365859,Saint Louis Billikens,F. Thatch Jr.,4397199,,True,34.0,7,14,7,12,0,2,1,1,0,3,3,1,3,1,1,2,15
401365859,Saint Louis Billikens,T. Hargrove Jr.,4592484,,False,11.0,2,4,1,2,1,2,2,2,0,0,0,0,0,0,1,1,7
401365859,Saint Louis Billikens,M. Linssen,4279174,,False,5.0,1,1,1,1,0,0,2,2,1,0,1,0,0,0,1,2,4
401365859,Saint Louis Billikens,D. Jones,4278267,,False,8.0,1,2,0,1,1,1,0,0,0,0,0,1,0,0,2,0,3
401365859,Saint Louis Billikens,TEAM,TOTAL,TOTAL,False,,26,55,24,42,2,13,12,15,12,20,32,9,5,1,15,14,66
401365859,Richmond Spiders,T. Burton,4431914,,True,38.0,7,11,7,11,0,0,9,10,1,9,10,1,1,0,1,2,23
401365859,Richmond Spiders,N. Cayo,4278380,,True,25.0,2,7,2,7,0,0,1,2,1,2,3,1,0,1,3,4,5
401365859,Richmond Spiders,G. Golden,4066836,,True,31.0,2,4,2,3,0,1,2,4,0,2,2,2,0,3,1,2,6
401365859,Richmond Spiders,A. Gustavson,4397193,,True,32.0,1,5,1,3,0,2,0,0,0,1,1,1,2,0,0,2,2
401365859,Richmond Spiders,J. Gilyard,4278378,,True,40.0,5,11,2,3,3,8,2,2,1,1,2,2,4,1,3,1,15
401365859,Richmond Spiders,M. Grace,4397192,,False,12.0,1,2,1,1,0,1,0,0,1,2,3,1,0,0,1,1,2
401365859,Richmond Spiders,C. Crabtree,4396658,,False,8.0,1,2,1,1,0,1,0,0,0,0,0,0,1,0,1,1,2
401365859,Richmond Spiders,N. Sherod,4066832,,False,14.0,4,5,1,1,3,4,2,2,1,2,3,0,1,0,0,1,13
401365859,Richmond Spiders,TEAM,TOTAL,TOTAL,False,,23,47,17,30,6,17,16,20,5,20,25,8,9,5,11,14,68
401365859,Richmond Spiders,T. Burton,4431914,,True,38.0,7,11,7,11,0,0,9,10,1,9,10,1,1,0,1,2,23
401365859,Richmond Spiders,N. Cayo,4278380,,True,25.0,2,7,2,7,0,0,1,2,1,2,3,1,0,1,3,4,5
401365859,Richmond Spiders,G. Golden,4066836,,True,31.0,2,4,2,3,0,1,2,4,0,2,2,2,0,3,1,2,6
401365859,Richmond Spiders,A. Gustavson,4397193,,True,32.0,1,5,1,3,0,2,0,0,0,1,1,1,2,0,0,2,2
401365859,Richmond Spiders,J. Gilyard,4278378,,True,40.0,5,11,2,3,3,8,2,2,1,1,2,2,4,1,3,1,15
401365859,Richmond Spiders,M. Grace,4397192,,False,12.0,1,2,1,1,0,1,0,0,1,2,3,1,0,0,1,1,2
401365859,Richmond Spiders,C. Crabtree,4396658,,False,8.0,1,2,1,1,0,1,0,0,0,0,0,0,1,0,1,1,2
401365859,Richmond Spiders,N. Sherod,4066832,,False,14.0,4,5,1,1,3,4,2,2,1,2,3,0,1,0,0,1,13
401365859,Richmond Spiders,TEAM,TOTAL,TOTAL,False,,23,47,17,30,6,17,16,20,5,20,25,8,9,5,11,14,68
401365858,La Salle Explorers,C. Moore,4277945,,True,37.0,4,7,4,6,0,1,1,2,2,3,5,1,1,3,4,2,9
401365858,La Salle Explorers,J. Clark,4397152,,True,36.0,3,10,1,4,2,6,0,0,1,4,5,0,1,0,2,1,8
401365858,La Salle Explorers,J. Brickus,4700970,,True,33.0,3,9,3,6,0,3,1,2,0,3,3,4,2,0,1,1,7
401365858,La Salle Explorers,C. Ray,4592448,,True,37.0,4,8,1,2,3,6,2,3,0,7,7,2,1,0,3,2,13
401365858,La Salle Explorers,J. Nickelberry,4432845,,True,26.0,1,6,1,2,0,4,3,4,0,2,2,0,0,0,1,2,5
401365858,La Salle Explorers,M. Doucoure,4277988,,False,3.0,0,0,0,0,0,0,0,0,0,0,0,0,0,0,0,0,0
401365858,La Salle Explorers,K. Brantley,4709132,,False,21.0,4,8,4,7,0,1,4,4,0,3,3,0,1,0,1,3,12
401365858,La Salle Explorers,A. Gill,4700969,,False,7.0,0,2,0,0,0,2,0,0,0,1,1,0,0,0,0,1,0
401365858,La Salle Explorers,TEAM,TOTAL,TOTAL,False,,19,50,14,27,5,23,11,15,6,26,32,7,6,3,13,12,54
401365858,La Salle Explorers,C. Moore,4277945,,True,37.0,4,7,4,6,0,1,1,2,2,3,5,1,1,3,4,2,9
401365858,La Salle Explorers,J. Clark,4397152,,True,36.0,3,10,1,4,2,6,0,0,1,4,5,0,1,0,2,1,8
401365858,La Salle Explorers,J. Brickus,4700970,,True,33.0,3,9,3,6,0,3,1,2,0,3,3,4,2,0,1,1,7
401365858,La Salle Explorers,C. Ray,4592448,,True,37.0,4,8,1,2,3,6,2,3,0,7,7,2,1,0,3,2,13
401365858,La Salle Explorers,J. Nickelberry,4432845,,True,26.0,1,6,1,2,0,4,3,4,0,2,2,0,0,0,1,2,5
401365858,La Salle Explorers,M. Doucoure,4277988,,False,3.0,0,0,0,0,0,0,0,0,0,0,0,0,0,0,0,0,0
401365858,La Salle Explorers,K. Brantley,4709132,,False,21.0,4,8,4,7,0,1,4,4,0,3,3,0,1,0,1,3,12
401365858,La Salle Explorers,A. Gill,4700969,,False,7.0,0,2,0,0,0,2,0,0,0,1,1,0,0,0,0,1,0
401365858,La Salle Explorers,TEAM,TOTAL,TOTAL,False,,19,50,14,27,5,23,11,15,6,26,32,7,6,3,13,12,54
401365858,Fordham Rams,A. Tsimbila,4702329,,True,15.0,2,6,2,6,0,0,0,0,4,1,5,0,0,1,0,2,4
401365858,Fordham Rams,C. Ohams,4066856,,True,34.0,7,14,6,13,1,1,5,6,1,12,13,0,3,1,3,1,20
401365858,Fordham Rams,A. Charlton,4897085,,True,37.0,3,9,3,5,0,4,0,0,0,6,6,10,2,0,2,1,6
401365858,Fordham Rams,J. Navarro,4592316,,True,36.0,5,16,2,6,3,10,2,2,0,1,1,0,1,0,1,4,15
401365858,Fordham Rams,K. Rose,4592315,,True,35.0,3,8,2,3,1,5,3,3,1,4,5,0,0,0,2,1,10
401365858,Fordham Rams,P. Kelly,4432014,,False,15.0,1,2,0,0,1,2,0,0,0,0,0,0,1,0,0,2,3
401365858,Fordham Rams,R. Novitskyi,4897084,,False,14.0,1,3,1,2,0,1,0,0,1,3,4,1,0,0,2,2,2
401365858,Fordham Rams,A. Harrison,4897086,,False,3.0,0,0,0,0,0,0,0,0,0,0,0,0,0,0,0,0,0
401365858,Fordham Rams,Z. Riley,4914388,,False,11.0,0,1,0,1,0,0,0,0,1,0,1,1,0,0,1,3,0
401365858,Fordham Rams,TEAM,TOTAL,TOTAL,False,,22,59,16,36,6,23,10,11,11,27,38,12,7,2,11,16,60
401365858,Fordham Rams,A. Tsimbila,4702329,,True,15.0,2,6,2,6,0,0,0,0,4,1,5,0,0,1,0,2,4
401365858,Fordham Rams,C. Ohams,4066856,,True,34.0,7,14,6,13,1,1,5,6,1,12,13,0,3,1,3,1,20
401365858,Fordham Rams,A. Charlton,4897085,,True,37.0,3,9,3,5,0,4,0,0,0,6,6,10,2,0,2,1,6
401365858,Fordham Rams,J. Navarro,4592316,,True,36.0,5,16,2,6,3,10,2,2,0,1,1,0,1,0,1,4,15
401365858,Fordham Rams,K. Rose,4592315,,True,35.0,3,8,2,3,1,5,3,3,1,4,5,0,0,0,2,1,10
401365858,Fordham Rams,P. Kelly,4432014,,False,15.0,1,2,0,0,1,2,0,0,0,0,0,0,1,0,0,2,3
401365858,Fordham Rams,R. Novitskyi,4897084,,False,14.0,1,3,1,2,0,1,0,0,1,3,4,1,0,0,2,2,2
401365858,Fordham Rams,A. Harrison,4897086,,False,3.0,0,0,0,0,0,0,0,0,0,0,0,0,0,0,0,0,0
401365858,Fordham Rams,Z. Riley,4914388,,False,11.0,0,1,0,1,0,0,0,0,1,0,1,1,0,0,1,3,0
401365858,Fordham Rams,TEAM,TOTAL,TOTAL,False,,22,59,16,36,6,23,10,11,11,27,38,12,7,2,11,16,60
401365857,Massachusetts Minutemen,M. Steadman,4397393,,True,21.0,4,9,4,9,0,0,6,8,2,1,3,0,0,0,0,1,14
401365857,Massachusetts Minutemen,T. Buttrick,4277981,,True,28.0,2,3,0,0,2,3,0,0,0,2,2,1,1,1,2,1,6
401365857,Massachusetts Minutemen,T.J. Weeks,4433108,,True,26.0,2,8,0,2,2,6,0,0,1,3,4,1,0,0,0,1,6
401365857,Massachusetts Minutemen,N. Fernandes,4431791,,True,22.0,0,5,0,1,0,4,0,0,1,2,3,1,0,0,1,4,0
401365857,Massachusetts Minutemen,R. Kelly,4279741,,True,31.0,4,8,3,5,1,3,0,0,0,1,1,4,0,0,1,1,9
401365857,Massachusetts Minutemen,D. Dominguez,4701126,,False,9.0,0,0,0,0,0,0,0,0,1,0,1,0,0,0,0,0,0
401365857,Massachusetts Minutemen,G. Jones,4279211,,False,13.0,2,3,2,2,0,1,0,0,2,1,3,1,0,0,1,1,4
401365857,Massachusetts Minutemen,R. Marcus,4701129,,False,1.0,0,0,0,0,0,0,0,0,1,0,1,0,0,0,0,0,0
401365857,Massachusetts Minutemen,J. Garcia,4701125,,False,24.0,3,7,3,6,0,1,2,2,2,2,4,0,3,1,1,4,8
401365857,Massachusetts Minutemen,P. Santos,4432104,,False,3.0,1,2,0,0,1,2,0,0,0,1,1,0,0,1,0,0,3
401365857,Massachusetts Minutemen,C.J. Kelly,4398208,,False,22.0,4,10,1,2,3,8,0,0,0,1,1,4,0,1,3,2,11
401365857,Massachusetts Minutemen,TEAM,TOTAL,TOTAL,False,,22,55,13,27,9,28,8,10,10,14,24,12,4,4,9,15,61
401365857,Massachusetts Minutemen,M. Steadman,4397393,,True,21.0,4,9,4,9,0,0,6,8,2,1,3,0,0,0,0,1,14
401365857,Massachusetts Minutemen,T. Buttrick,4277981,,True,28.0,2,3,0,0,2,3,0,0,0,2,2,1,1,1,2,1,6
401365857,Massachusetts Minutemen,T.J. Weeks,4433108,,True,26.0,2,8,0,2,2,6,0,0,1,3,4,1,0,0,0,1,6
401365857,Massachusetts Minutemen,N. Fernandes,4431791,,True,22.0,0,5,0,1,0,4,0,0,1,2,3,1,0,0,1,4,0
401365857,Massachusetts Minutemen,R. Kelly,4279741,,True,31.0,4,8,3,5,1,3,0,0,0,1,1,4,0,0,1,1,9
401365857,Massachusetts Minutemen,D. Dominguez,4701126,,False,9.0,0,0,0,0,0,0,0,0,1,0,1,0,0,0,0,0,0
401365857,Massachusetts Minutemen,G. Jones,4279211,,False,13.0,2,3,2,2,0,1,0,0,2,1,3,1,0,0,1,1,4
401365857,Massachusetts Minutemen,R. Marcus,4701129,,False,1.0,0,0,0,0,0,0,0,0,1,0,1,0,0,0,0,0,0
401365857,Massachusetts Minutemen,J. Garcia,4701125,,False,24.0,3,7,3,6,0,1,2,2,2,2,4,0,3,1,1,4,8
401365857,Massachusetts Minutemen,P. Santos,4432104,,False,3.0,1,2,0,0,1,2,0,0,0,1,1,0,0,1,0,0,3
401365857,Massachusetts Minutemen,C.J. Kelly,4398208,,False,22.0,4,10,1,2,3,8,0,0,0,1,1,4,0,1,3,2,11
401365857,Massachusetts Minutemen,TEAM,TOTAL,TOTAL,False,,22,55,13,27,9,28,8,10,10,14,24,12,4,4,9,15,61
401365857,Dayton Flyers,R.J. Blakney,4700864,,True,25.0,4,5,3,4,1,1,2,2,2,3,5,0,3,0,0,1,11
401365857,Dayton Flyers,T. Camara,4431736,,True,29.0,6,9,6,9,0,0,0,0,0,6,6,1,1,0,1,1,12
401365857,Dayton Flyers,D. Holmes II,4433607,,True,22.0,4,5,4,5,0,0,2,4,1,3,4,1,0,0,2,3,10
401365857,Dayton Flyers,M. Smith,4683861,,True,31.0,2,8,2,7,0,1,2,5,1,5,6,9,1,1,2,2,6
401365857,Dayton Flyers,K. Elvis,4683135,,True,26.0,3,6,2,3,1,3,0,0,0,1,1,2,0,0,1,1,7
401365857,Dayton Flyers,M. Sissoko,4431824,,False,9.0,1,1,1,1,0,0,0,0,1,1,2,0,0,0,0,0,2
401365857,Dayton Flyers,M. Amzil,4711607,,False,22.0,6,11,2,6,4,5,0,0,5,1,6,0,0,0,1,3,16
401365857,Dayton Flyers,Z. Nwokeji,4618121,,False,5.0,0,2,0,2,0,0,0,0,2,0,2,0,0,0,1,0,0
401365857,Dayton Flyers,C. Wilson,4403456,,False,4.0,0,0,0,0,0,0,2,2,0,0,0,0,0,0,0,0,2
401365857,Dayton Flyers,B. Uhl,4897094,,False,1.0,0,0,0,0,0,0,0,0,0,0,0,0,0,0,0,0,0
401365857,Dayton Flyers,D. Swerlein,4600089,,False,1.0,0,0,0,0,0,0,0,0,0,1,1,1,0,0,0,0,0
401365857,Dayton Flyers,K. Brea,4591259,,False,25.0,6,9,2,2,4,7,0,0,0,1,1,3,2,0,1,2,16
401365857,Dayton Flyers,TEAM,TOTAL,TOTAL,False,,32,56,22,39,10,17,8,13,12,24,36,17,7,1,9,13,82
401365857,Dayton Flyers,R.J. Blakney,4700864,,True,25.0,4,5,3,4,1,1,2,2,2,3,5,0,3,0,0,1,11
401365857,Dayton Flyers,T. Camara,4431736,,True,29.0,6,9,6,9,0,0,0,0,0,6,6,1,1,0,1,1,12
401365857,Dayton Flyers,D. Holmes II,4433607,,True,22.0,4,5,4,5,0,0,2,4,1,3,4,1,0,0,2,3,10
401365857,Dayton Flyers,M. Smith,4683861,,True,31.0,2,8,2,7,0,1,2,5,1,5,6,9,1,1,2,2,6
401365857,Dayton Flyers,K. Elvis,4683135,,True,26.0,3,6,2,3,1,3,0,0,0,1,1,2,0,0,1,1,7
401365857,Dayton Flyers,M. Sissoko,4431824,,False,9.0,1,1,1,1,0,0,0,0,1,1,2,0,0,0,0,0,2
401365857,Dayton Flyers,M. Amzil,4711607,,False,22.0,6,11,2,6,4,5,0,0,5,1,6,0,0,0,1,3,16
401365857,Dayton Flyers,Z. Nwokeji,4618121,,False,5.0,0,2,0,2,0,0,0,0,2,0,2,0,0,0,1,0,0
401365857,Dayton Flyers,C. Wilson,4403456,,False,4.0,0,0,0,0,0,0,2,2,0,0,0,0,0,0,0,0,2
401365857,Dayton Flyers,B. Uhl,4897094,,False,1.0,0,0,0,0,0,0,0,0,0,0,0,0,0,0,0,0,0
401365857,Dayton Flyers,D. Swerlein,4600089,,False,1.0,0,0,0,0,0,0,0,0,0,1,1,1,0,0,0,0,0
401365857,Dayton Flyers,K. Brea,4591259,,False,25.0,6,9,2,2,4,7,0,0,0,1,1,3,2,0,1,2,16
401365857,Dayton Flyers,TEAM,TOTAL,TOTAL,False,,32,56,22,39,10,17,8,13,12,24,36,17,7,1,9,13,82
401365856,Duquesne Dukes,M. Hima,4700878,,True,31.0,2,4,2,4,0,0,0,0,3,7,10,0,0,1,1,4,4
401365856,Duquesne Dukes,T. Williams,4432147,,True,11.0,2,4,2,4,0,0,1,2,0,2,2,0,1,0,2,2,5
401365856,Duquesne Dukes,M. Bekelja,4700874,,True,19.0,0,2,0,0,0,2,1,2,0,1,1,3,0,0,4,1,1
401365856,Duquesne Dukes,T. Okani,4700873,,True,26.0,1,3,1,3,0,0,0,0,0,1,1,2,0,2,1,1,2
401365856,Duquesne Dukes,T. Acuff,4606831,,True,33.0,6,10,3,5,3,5,0,0,0,3,3,1,0,1,0,1,15
401365856,Duquesne Dukes,K. Easley,4398159,,False,29.0,7,17,5,11,2,6,0,1,1,4,5,5,3,0,2,0,16
401365856,Duquesne Dukes,D. Larson,4897091,,False,6.0,0,1,0,0,0,1,0,0,0,1,1,0,0,0,0,2,0
401365856,Duquesne Dukes,A. Spears,4897090,,False,22.0,0,3,0,2,0,1,0,0,0,1,1,2,0,0,1,0,0
401365856,Duquesne Dukes,J. Johnson III,4897088,,False,9.0,1,3,0,1,1,2,2,2,0,0,0,0,0,0,1,0,5
401365856,Duquesne Dukes,L. Ayers III,4703813,,False,14.0,1,3,1,1,0,2,0,0,1,1,2,1,1,0,0,0,2
401365856,Duquesne Dukes,TEAM,TOTAL,TOTAL,False,,20,50,14,31,6,19,4,7,6,21,27,14,5,4,13,11,50
401365856,Duquesne Dukes,M. Hima,4700878,,True,31.0,2,4,2,4,0,0,0,0,3,7,10,0,0,1,1,4,4
401365856,Duquesne Dukes,T. Williams,4432147,,True,11.0,2,4,2,4,0,0,1,2,0,2,2,0,1,0,2,2,5
401365856,Duquesne Dukes,M. Bekelja,4700874,,True,19.0,0,2,0,0,0,2,1,2,0,1,1,3,0,0,4,1,1
401365856,Duquesne Dukes,T. Okani,4700873,,True,26.0,1,3,1,3,0,0,0,0,0,1,1,2,0,2,1,1,2
401365856,Duquesne Dukes,T. Acuff,4606831,,True,33.0,6,10,3,5,3,5,0,0,0,3,3,1,0,1,0,1,15
401365856,Duquesne Dukes,K. Easley,4398159,,False,29.0,7,17,5,11,2,6,0,1,1,4,5,5,3,0,2,0,16
401365856,Duquesne Dukes,D. Larson,4897091,,False,6.0,0,1,0,0,0,1,0,0,0,1,1,0,0,0,0,2,0
401365856,Duquesne Dukes,A. Spears,4897090,,False,22.0,0,3,0,2,0,1,0,0,0,1,1,2,0,0,1,0,0
401365856,Duquesne Dukes,J. Johnson III,4897088,,False,9.0,1,3,0,1,1,2,2,2,0,0,0,0,0,0,1,0,5
401365856,Duquesne Dukes,L. Ayers III,4703813,,False,14.0,1,3,1,1,0,2,0,0,1,1,2,1,1,0,0,0,2
401365856,Duquesne Dukes,TEAM,TOTAL,TOTAL,False,,20,50,14,31,6,19,4,7,6,21,27,14,5,4,13,11,50
401365856,Davidson Wildcats,S. Mennenga,4700862,,True,22.0,5,6,5,6,0,0,2,2,3,2,5,1,0,2,1,3,12
401365856,Davidson Wildcats,L. Brajkovic,4396787,,True,34.0,5,9,3,5,2,4,0,0,1,7,8,5,0,2,0,1,12
401365856,Davidson Wildcats,H. Lee,4592308,,True,31.0,10,17,4,8,6,9,1,2,0,3,3,3,0,0,2,0,27
401365856,Davidson Wildcats,G. Huffman,4432522,,True,32.0,4,5,3,4,1,1,0,0,0,3,3,4,4,0,1,1,9
401365856,Davidson Wildcats,M. Jones,4396784,,True,26.0,3,7,1,3,2,4,0,0,0,5,5,1,1,0,3,1,8
401365856,Davidson Wildcats,D. Kristensen,4432020,,False,2.0,0,1,0,0,0,1,0,0,0,0,0,0,0,0,0,0,0
401365856,Davidson Wildcats,N. Boachie-Yiadom,4396786,,False,20.0,1,3,1,1,0,2,0,1,1,0,1,2,1,0,0,0,2
401365856,Davidson Wildcats,S. Thrastarson,4897100,,False,2.0,0,0,0,0,0,0,0,0,0,1,1,0,0,0,0,0,0
401365856,Davidson Wildcats,D. Watson,4897098,,False,19.0,0,5,0,3,0,2,1,2,0,3,3,2,0,0,1,0,1
401365856,Davidson Wildcats,B. Craig,4700863,,False,2.0,1,1,1,1,0,0,0,0,0,1,1,0,1,0,0,0,2
401365856,Davidson Wildcats,D. Dibble,4592309,,False,2.0,0,0,0,0,0,0,0,0,0,0,0,1,0,0,0,0,0
401365856,Davidson Wildcats,E. Lanier,4567082,,False,8.0,0,1,0,1,0,0,1,2,0,0,0,1,1,0,1,2,1
401365856,Davidson Wildcats,TEAM,TOTAL,TOTAL,False,,29,55,18,32,11,23,5,9,9,25,34,20,8,4,10,8,74
401365856,Davidson Wildcats,S. Mennenga,4700862,,True,22.0,5,6,5,6,0,0,2,2,3,2,5,1,0,2,1,3,12
401365856,Davidson Wildcats,L. Brajkovic,4396787,,True,34.0,5,9,3,5,2,4,0,0,1,7,8,5,0,2,0,1,12
401365856,Davidson Wildcats,H. Lee,4592308,,True,31.0,10,17,4,8,6,9,1,2,0,3,3,3,0,0,2,0,27
401365856,Davidson Wildcats,G. Huffman,4432522,,True,32.0,4,5,3,4,1,1,0,0,0,3,3,4,4,0,1,1,9
401365856,Davidson Wildcats,M. Jones,4396784,,True,26.0,3,7,1,3,2,4,0,0,0,5,5,1,1,0,3,1,8
401365856,Davidson Wildcats,D. Kristensen,4432020,,False,2.0,0,1,0,0,0,1,0,0,0,0,0,0,0,0,0,0,0
401365856,Davidson Wildcats,N. Boachie-Yiadom,4396786,,False,20.0,1,3,1,1,0,2,0,1,1,0,1,2,1,0,0,0,2
401365856,Davidson Wildcats,S. Thrastarson,4897100,,False,2.0,0,0,0,0,0,0,0,0,0,1,1,0,0,0,0,0,0
401365856,Davidson Wildcats,D. Watson,4897098,,False,19.0,0,5,0,3,0,2,1,2,0,3,3,2,0,0,1,0,1
401365856,Davidson Wildcats,B. Craig,4700863,,False,2.0,1,1,1,1,0,0,0,0,0,1,1,0,1,0,0,0,2
401365856,Davidson Wildcats,D. Dibble,4592309,,False,2.0,0,0,0,0,0,0,0,0,0,0,0,1,0,0,0,0,0
401365856,Davidson Wildcats,E. Lanier,4567082,,False,8.0,0,1,0,1,0,0,1,2,0,0,0,1,1,0,1,2,1
401365856,Davidson Wildcats,TEAM,TOTAL,TOTAL,False,,29,55,18,32,11,23,5,9,9,25,34,20,8,4,10,8,74
401365855,Saint Louis Billikens,F. Okoro,4397105,,True,29.0,6,11,6,11,0,0,3,4,3,7,10,2,1,3,0,3,15
401365855,Saint Louis Billikens,J. Nesbitt,4714246,,True,22.0,2,4,1,2,1,2,0,0,1,1,2,0,0,0,1,3,5
401365855,Saint Louis Billikens,Y. Collins,4432957,,True,38.0,7,10,6,9,1,1,2,2,0,2,2,6,1,0,3,1,17
401365855,Saint Louis Billikens,G. Jimerson,4432008,,True,34.0,5,14,5,10,0,4,4,6,0,4,4,2,0,0,0,1,14
401365855,Saint Louis Billikens,F. Thatch Jr.,4397199,,True,33.0,4,6,3,5,1,1,1,3,2,6,8,1,0,0,0,1,10
401365855,Saint Louis Billikens,T. Hargrove Jr.,4592484,,False,13.0,0,1,0,0,0,1,0,0,0,3,3,1,0,0,0,1,0
401365855,Saint Louis Billikens,M. Linssen,4279174,,False,11.0,3,5,3,5,0,0,0,1,0,2,2,1,0,1,1,2,6
401365855,Saint Louis Billikens,D. Jones,4278267,,False,20.0,2,4,1,2,1,2,0,0,0,1,1,1,2,0,1,2,5
401365855,Saint Louis Billikens,TEAM,TOTAL,TOTAL,False,,29,55,25,44,4,11,10,16,6,29,35,14,4,4,7,14,72
401365855,Saint Louis Billikens,F. Okoro,4397105,,True,29.0,6,11,6,11,0,0,3,4,3,7,10,2,1,3,0,3,15
401365855,Saint Louis Billikens,J. Nesbitt,4714246,,True,22.0,2,4,1,2,1,2,0,0,1,1,2,0,0,0,1,3,5
401365855,Saint Louis Billikens,Y. Collins,4432957,,True,38.0,7,10,6,9,1,1,2,2,0,2,2,6,1,0,3,1,17
401365855,Saint Louis Billikens,G. Jimerson,4432008,,True,34.0,5,14,5,10,0,4,4,6,0,4,4,2,0,0,0,1,14
401365855,Saint Louis Billikens,F. Thatch Jr.,4397199,,True,33.0,4,6,3,5,1,1,1,3,2,6,8,1,0,0,0,1,10
401365855,Saint Louis Billikens,T. Hargrove Jr.,4592484,,False,13.0,0,1,0,0,0,1,0,0,0,3,3,1,0,0,0,1,0
401365855,Saint Louis Billikens,M. Linssen,4279174,,False,11.0,3,5,3,5,0,0,0,1,0,2,2,1,0,1,1,2,6
401365855,Saint Louis Billikens,D. Jones,4278267,,False,20.0,2,4,1,2,1,2,0,0,0,1,1,1,2,0,1,2,5
401365855,Saint Louis Billikens,TEAM,TOTAL,TOTAL,False,,29,55,25,44,4,11,10,16,6,29,35,14,4,4,7,14,72
401365855,Saint Joseph's Hawks,T. Funk,4278395,,True,36.0,4,12,2,4,2,8,0,0,4,10,14,4,1,1,1,2,10
401365855,Saint Joseph's Hawks,E. Obinna,4278125,,True,25.0,6,7,6,7,0,0,0,3,2,3,5,0,0,0,0,3,12
401365855,Saint Joseph's Hawks,J. Hall,4701031,,True,37.0,6,15,4,8,2,7,0,0,0,3,3,2,0,0,2,2,14
401365855,Saint Joseph's Hawks,E. Reynolds II,4683952,,True,34.0,6,13,2,6,4,7,1,3,0,1,1,4,1,0,1,2,17
401365855,Saint Joseph's Hawks,C. Brown,4592476,,True,30.0,2,6,2,3,0,3,0,2,2,1,3,3,0,1,1,2,4
401365855,Saint Joseph's Hawks,A. Jansson,4701029,,False,9.0,1,1,1,1,0,0,0,0,0,2,2,0,0,0,1,2,2
401365855,Saint Joseph's Hawks,J. Forrest,4701032,,False,12.0,1,5,1,3,0,2,0,0,0,0,0,0,0,0,0,1,2
401365855,Saint Joseph's Hawks,D. Bishop,4701028,,False,17.0,0,3,0,2,0,1,0,0,1,1,2,0,0,0,0,0,0
401365855,Saint Joseph's Hawks,TEAM,TOTAL,TOTAL,False,,26,62,18,34,8,28,1,8,10,22,32,13,2,2,7,14,61
401365855,Saint Joseph's Hawks,T. Funk,4278395,,True,36.0,4,12,2,4,2,8,0,0,4,10,14,4,1,1,1,2,10
401365855,Saint Joseph's Hawks,E. Obinna,4278125,,True,25.0,6,7,6,7,0,0,0,3,2,3,5,0,0,0,0,3,12
401365855,Saint Joseph's Hawks,J. Hall,4701031,,True,37.0,6,15,4,8,2,7,0,0,0,3,3,2,0,0,2,2,14
401365855,Saint Joseph's Hawks,E. Reynolds II,4683952,,True,34.0,6,13,2,6,4,7,1,3,0,1,1,4,1,0,1,2,17
401365855,Saint Joseph's Hawks,C. Brown,4592476,,True,30.0,2,6,2,3,0,3,0,2,2,1,3,3,0,1,1,2,4
401365855,Saint Joseph's Hawks,A. Jansson,4701029,,False,9.0,1,1,1,1,0,0,0,0,0,2,2,0,0,0,1,2,2
401365855,Saint Joseph's Hawks,J. Forrest,4701032,,False,12.0,1,5,1,3,0,2,0,0,0,0,0,0,0,0,0,1,2
401365855,Saint Joseph's Hawks,D. Bishop,4701028,,False,17.0,0,3,0,2,0,1,0,0,1,1,2,0,0,0,0,0,0
401365855,Saint Joseph's Hawks,TEAM,TOTAL,TOTAL,False,,26,62,18,34,8,28,1,8,10,22,32,13,2,2,7,14,61
401365854,St. Bonaventure Bonnies,O. Osunniyi,4397224,,True,31.0,4,8,3,7,1,1,5,5,3,6,9,1,1,2,1,1,14
401365854,St. Bonaventure Bonnies,J. Adaway,4279431,,True,39.0,9,17,7,12,2,5,3,3,0,6,6,2,1,0,1,2,23
401365854,St. Bonaventure Bonnies,J. Holmes,4701016,,True,39.0,5,12,4,8,1,4,0,0,1,2,3,4,2,0,4,1,11
401365854,St. Bonaventure Bonnies,D. Welch,4397221,,True,37.0,3,10,0,3,3,7,0,0,0,9,9,4,3,1,2,4,9
401365854,St. Bonaventure Bonnies,K. Lofton,4397220,,True,39.0,4,11,3,7,1,4,3,3,1,1,2,5,4,0,2,1,12
401365854,St. Bonaventure Bonnies,P. Rossi,4897049,,False,1.0,0,0,0,0,0,0,0,0,0,0,0,0,0,0,0,0,0
401365854,St. Bonaventure Bonnies,O. Durosinmi,4684462,,False,1.0,0,0,0,0,0,0,0,0,0,0,0,0,0,0,0,0,0
401365854,St. Bonaventure Bonnies,A. Coulibaly,4432889,,False,10.0,2,2,2,2,0,0,0,0,0,1,1,0,0,0,1,2,4
401365854,St. Bonaventure Bonnies,J. Ndjock-Tadjore,4897048,,False,1.0,0,0,0,0,0,0,0,0,0,0,0,0,0,0,0,0,0
401365854,St. Bonaventure Bonnies,J. Saizonou,4897046,,False,1.0,0,0,0,0,0,0,0,0,0,0,0,0,0,0,0,0,0
401365854,St. Bonaventure Bonnies,Q. Adams,4585591,,False,1.0,0,0,0,0,0,0,0,0,0,0,0,0,0,0,0,1,0
401365854,St. Bonaventure Bonnies,TEAM,TOTAL,TOTAL,False,,27,60,19,39,8,21,11,11,6,26,32,16,11,3,12,12,73
401365854,St. Bonaventure Bonnies,O. Osunniyi,4397224,,True,31.0,4,8,3,7,1,1,5,5,3,6,9,1,1,2,1,1,14
401365854,St. Bonaventure Bonnies,J. Adaway,4279431,,True,39.0,9,17,7,12,2,5,3,3,0,6,6,2,1,0,1,2,23
401365854,St. Bonaventure Bonnies,J. Holmes,4701016,,True,39.0,5,12,4,8,1,4,0,0,1,2,3,4,2,0,4,1,11
401365854,St. Bonaventure Bonnies,D. Welch,4397221,,True,37.0,3,10,0,3,3,7,0,0,0,9,9,4,3,1,2,4,9
401365854,St. Bonaventure Bonnies,K. Lofton,4397220,,True,39.0,4,11,3,7,1,4,3,3,1,1,2,5,4,0,2,1,12
401365854,St. Bonaventure Bonnies,P. Rossi,4897049,,False,1.0,0,0,0,0,0,0,0,0,0,0,0,0,0,0,0,0,0
401365854,St. Bonaventure Bonnies,O. Durosinmi,4684462,,False,1.0,0,0,0,0,0,0,0,0,0,0,0,0,0,0,0,0,0
401365854,St. Bonaventure Bonnies,A. Coulibaly,4432889,,False,10.0,2,2,2,2,0,0,0,0,0,1,1,0,0,0,1,2,4
401365854,St. Bonaventure Bonnies,J. Ndjock-Tadjore,4897048,,False,1.0,0,0,0,0,0,0,0,0,0,0,0,0,0,0,0,0,0
401365854,St. Bonaventure Bonnies,J. Saizonou,4897046,,False,1.0,0,0,0,0,0,0,0,0,0,0,0,0,0,0,0,0,0
401365854,St. Bonaventure Bonnies,Q. Adams,4585591,,False,1.0,0,0,0,0,0,0,0,0,0,0,0,0,0,0,0,1,0
401365854,St. Bonaventure Bonnies,TEAM,TOTAL,TOTAL,False,,27,60,19,39,8,21,11,11,6,26,32,16,11,3,12,12,73
401365854,Rhode Island Rams,Makhel Mitchell,4431777,,True,32.0,5,8,5,8,0,0,3,6,0,7,7,2,0,2,2,2,13
401365854,Rhode Island Rams,Makhi Mitchell,4431708,,True,30.0,7,12,7,10,0,2,0,0,0,9,9,1,2,3,1,4,14
401365854,Rhode Island Rams,I. Leggett,4606837,,True,19.0,2,5,1,2,1,3,0,0,1,0,1,0,0,0,3,3,5
401365854,Rhode Island Rams,I. El-Amin,4279313,,True,19.0,0,4,0,1,0,3,0,0,0,2,2,2,0,0,3,1,0
401365854,Rhode Island Rams,J. Sheppard,4066445,,True,24.0,0,4,0,1,0,3,0,0,0,1,1,2,1,0,0,2,0
401365854,Rhode Island Rams,A. Walker,4278567,,False,24.0,3,5,3,4,0,1,1,3,0,1,1,0,2,0,2,1,7
401365854,Rhode Island Rams,M. Martin,4397470,,False,29.0,4,7,4,6,0,1,1,2,2,2,4,0,0,1,1,1,9
401365854,Rhode Island Rams,J. Carey,4395673,,False,21.0,1,2,0,0,1,2,4,5,0,2,2,2,0,0,4,0,7
401365854,Rhode Island Rams,S. Thomas,4897065,,False,2.0,0,0,0,0,0,0,0,0,0,0,0,0,0,0,0,0,0
401365854,Rhode Island Rams,TEAM,TOTAL,TOTAL,False,,22,47,20,32,2,15,9,16,3,25,28,9,5,6,16,14,55
401365854,Rhode Island Rams,Makhel Mitchell,4431777,,True,32.0,5,8,5,8,0,0,3,6,0,7,7,2,0,2,2,2,13
401365854,Rhode Island Rams,Makhi Mitchell,4431708,,True,30.0,7,12,7,10,0,2,0,0,0,9,9,1,2,3,1,4,14
401365854,Rhode Island Rams,I. Leggett,4606837,,True,19.0,2,5,1,2,1,3,0,0,1,0,1,0,0,0,3,3,5
401365854,Rhode Island Rams,I. El-Amin,4279313,,True,19.0,0,4,0,1,0,3,0,0,0,2,2,2,0,0,3,1,0
401365854,Rhode Island Rams,J. Sheppard,4066445,,True,24.0,0,4,0,1,0,3,0,0,0,1,1,2,1,0,0,2,0
401365854,Rhode Island Rams,A. Walker,4278567,,False,24.0,3,5,3,4,0,1,1,3,0,1,1,0,2,0,2,1,7
401365854,Rhode Island Rams,M. Martin,4397470,,False,29.0,4,7,4,6,0,1,1,2,2,2,4,0,0,1,1,1,9
401365854,Rhode Island Rams,J. Carey,4395673,,False,21.0,1,2,0,0,1,2,4,5,0,2,2,2,0,0,4,0,7
401365854,Rhode Island Rams,S. Thomas,4897065,,False,2.0,0,0,0,0,0,0,0,0,0,0,0,0,0,0,0,0,0
401365854,Rhode Island Rams,TEAM,TOTAL,TOTAL,False,,22,47,20,32,2,15,9,16,3,25,28,9,5,6,16,14,55
401365853,Richmond Spiders,T. Burton,4431914,,True,22.0,5,8,3,6,2,2,5,5,0,4,4,1,1,0,0,4,17
401365853,Richmond Spiders,N. Cayo,4278380,,True,34.0,9,11,9,11,0,0,1,4,1,7,8,3,0,1,4,4,19
401365853,Richmond Spiders,G. Golden,4066836,,True,31.0,6,11,6,9,0,2,3,3,0,6,6,6,0,0,2,0,15
401365853,Richmond Spiders,A. Gustavson,4397193,,True,34.0,1,3,1,2,0,1,0,0,0,2,2,1,1,0,1,3,2
401365853,Richmond Spiders,J. Gilyard,4278378,,True,39.0,4,7,0,0,4,7,3,3,0,5,5,3,1,0,0,1,15
401365853,Richmond Spiders,M. Grace,4397192,,False,15.0,2,4,1,1,1,3,2,2,2,5,7,1,0,0,0,0,7
401365853,Richmond Spiders,I. Wilson,4700973,,False,6.0,0,1,0,0,0,1,0,0,0,0,0,0,0,0,0,1,0
401365853,Richmond Spiders,C. Crabtree,4396658,,False,6.0,1,2,0,1,1,1,0,0,0,0,0,0,0,0,2,1,3
401365853,Richmond Spiders,N. Sherod,4066832,,False,13.0,2,7,0,0,2,7,0,0,0,2,2,0,0,0,0,1,6
401365853,Richmond Spiders,TEAM,TOTAL,TOTAL,False,,30,54,20,30,10,24,14,17,3,31,34,15,3,1,9,15,84
401365853,Richmond Spiders,T. Burton,4431914,,True,22.0,5,8,3,6,2,2,5,5,0,4,4,1,1,0,0,4,17
401365853,Richmond Spiders,N. Cayo,4278380,,True,34.0,9,11,9,11,0,0,1,4,1,7,8,3,0,1,4,4,19
401365853,Richmond Spiders,G. Golden,4066836,,True,31.0,6,11,6,9,0,2,3,3,0,6,6,6,0,0,2,0,15
401365853,Richmond Spiders,A. Gustavson,4397193,,True,34.0,1,3,1,2,0,1,0,0,0,2,2,1,1,0,1,3,2
401365853,Richmond Spiders,J. Gilyard,4278378,,True,39.0,4,7,0,0,4,7,3,3,0,5,5,3,1,0,0,1,15
401365853,Richmond Spiders,M. Grace,4397192,,False,15.0,2,4,1,1,1,3,2,2,2,5,7,1,0,0,0,0,7
401365853,Richmond Spiders,I. Wilson,4700973,,False,6.0,0,1,0,0,0,1,0,0,0,0,0,0,0,0,0,1,0
401365853,Richmond Spiders,C. Crabtree,4396658,,False,6.0,1,2,0,1,1,1,0,0,0,0,0,0,0,0,2,1,3
401365853,Richmond Spiders,N. Sherod,4066832,,False,13.0,2,7,0,0,2,7,0,0,0,2,2,0,0,0,0,1,6
401365853,Richmond Spiders,TEAM,TOTAL,TOTAL,False,,30,54,20,30,10,24,14,17,3,31,34,15,3,1,9,15,84
401365853,George Washington Revolutionaries,H. Dean,4593273,,True,31.0,3,3,3,3,0,0,0,0,0,4,4,1,2,1,1,2,6
401365853,George Washington Revolutionaries,Q. Samuels,4592251,,True,12.0,0,1,0,0,0,1,0,0,1,3,4,1,0,1,1,2,0
401365853,George Washington Revolutionaries,B. Freeman,4613126,,True,37.0,6,13,4,10,2,3,5,5,2,3,5,5,2,0,0,2,19
401365853,George Washington Revolutionaries,J. Bamisile,4432537,,True,39.0,11,22,8,14,3,8,4,4,1,6,7,1,0,0,1,3,29
401365853,George Washington Revolutionaries,J. Bishop,4431770,,True,36.0,4,15,1,7,3,8,2,3,1,1,2,3,1,0,0,1,13
401365853,George Washington Revolutionaries,R. Lindo Jr.,4397186,,False,26.0,2,5,2,3,0,2,0,1,2,5,7,1,0,1,1,2,4
401365853,George Washington Revolutionaries,N. Brown,4700963,,False,2.0,0,0,0,0,0,0,0,0,0,0,0,0,0,0,0,0,0
401365853,George Washington Revolutionaries,B. Adams,4396612,,False,17.0,0,4,0,3,0,1,0,0,0,0,0,2,0,0,0,0,0
401365853,George Washington Revolutionaries,TEAM,TOTAL,TOTAL,False,,26,63,18,40,8,23,11,13,7,22,29,14,5,3,4,12,71
401365853,George Washington Revolutionaries,H. Dean,4593273,,True,31.0,3,3,3,3,0,0,0,0,0,4,4,1,2,1,1,2,6
401365853,George Washington Revolutionaries,Q. Samuels,4592251,,True,12.0,0,1,0,0,0,1,0,0,1,3,4,1,0,1,1,2,0
401365853,George Washington Revolutionaries,B. Freeman,4613126,,True,37.0,6,13,4,10,2,3,5,5,2,3,5,5,2,0,0,2,19
401365853,George Washington Revolutionaries,J. Bamisile,4432537,,True,39.0,11,22,8,14,3,8,4,4,1,6,7,1,0,0,1,3,29
401365853,George Washington Revolutionaries,J. Bishop,4431770,,True,36.0,4,15,1,7,3,8,2,3,1,1,2,3,1,0,0,1,13
401365853,George Washington Revolutionaries,R. Lindo Jr.,4397186,,False,26.0,2,5,2,3,0,2,0,1,2,5,7,1,0,1,1,2,4
401365853,George Washington Revolutionaries,N. Brown,4700963,,False,2.0,0,0,0,0,0,0,0,0,0,0,0,0,0,0,0,0,0
401365853,George Washington Revolutionaries,B. Adams,4396612,,False,17.0,0,4,0,3,0,1,0,0,0,0,0,2,0,0,0,0,0
401365853,George Washington Revolutionaries,TEAM,TOTAL,TOTAL,False,,26,63,18,40,8,23,11,13,7,22,29,14,5,3,4,12,71
401365852,George Mason Patriots,J. Oduro,4432068,,True,27.0,4,12,4,11,0,1,1,2,2,8,10,1,1,4,5,4,9
401365852,George Mason Patriots,X. Johnson,4592439,,True,37.0,6,16,1,2,5,14,2,2,0,2,2,2,3,0,4,2,19
401365852,George Mason Patriots,D. Gaines,4431961,,True,25.0,1,2,1,2,0,0,1,1,1,5,6,0,1,0,2,5,3
401365852,George Mason Patriots,D. Cooper,4279876,,True,37.0,2,6,1,1,1,5,0,0,0,2,2,4,0,0,0,1,5
401365852,George Mason Patriots,D. Schwartz,4278501,,True,37.0,4,9,3,3,1,6,0,0,1,2,3,3,0,0,2,0,9
401365852,George Mason Patriots,B. Jones,4897083,,False,7.0,1,1,1,1,0,0,0,0,0,2,2,0,0,0,0,0,2
401365852,George Mason Patriots,M. Henry,4606836,,False,3.0,0,0,0,0,0,0,0,0,0,0,0,1,0,0,0,2,0
401365852,George Mason Patriots,O. Frazier III,4700882,,False,3.0,0,2,0,2,0,0,0,0,0,3,3,0,0,0,0,0,0
401365852,George Mason Patriots,B. Buchanan,4395691,,False,12.0,0,0,0,0,0,0,0,0,0,1,1,0,0,0,1,1,0
401365852,George Mason Patriots,J. Hartwell II,4396817,,False,12.0,0,3,0,1,0,2,0,0,1,0,1,1,1,0,0,1,0
401365852,George Mason Patriots,TEAM,TOTAL,TOTAL,False,,18,51,11,23,7,28,4,5,7,28,35,12,6,4,16,16,47
401365852,George Mason Patriots,J. Oduro,4432068,,True,27.0,4,12,4,11,0,1,1,2,2,8,10,1,1,4,5,4,9
401365852,George Mason Patriots,X. Johnson,4592439,,True,37.0,6,16,1,2,5,14,2,2,0,2,2,2,3,0,4,2,19
401365852,George Mason Patriots,D. Gaines,4431961,,True,25.0,1,2,1,2,0,0,1,1,1,5,6,0,1,0,2,5,3
401365852,George Mason Patriots,D. Cooper,4279876,,True,37.0,2,6,1,1,1,5,0,0,0,2,2,4,0,0,0,1,5
401365852,George Mason Patriots,D. Schwartz,4278501,,True,37.0,4,9,3,3,1,6,0,0,1,2,3,3,0,0,2,0,9
401365852,George Mason Patriots,B. Jones,4897083,,False,7.0,1,1,1,1,0,0,0,0,0,2,2,0,0,0,0,0,2
401365852,George Mason Patriots,M. Henry,4606836,,False,3.0,0,0,0,0,0,0,0,0,0,0,0,1,0,0,0,2,0
401365852,George Mason Patriots,O. Frazier III,4700882,,False,3.0,0,2,0,2,0,0,0,0,0,3,3,0,0,0,0,0,0
401365852,George Mason Patriots,B. Buchanan,4395691,,False,12.0,0,0,0,0,0,0,0,0,0,1,1,0,0,0,1,1,0
401365852,George Mason Patriots,J. Hartwell II,4396817,,False,12.0,0,3,0,1,0,2,0,0,1,0,1,1,1,0,0,1,0
401365852,George Mason Patriots,TEAM,TOTAL,TOTAL,False,,18,51,11,23,7,28,4,5,7,28,35,12,6,4,16,16,47
401365852,Fordham Rams,A. Tsimbila,4702329,,True,14.0,2,5,2,5,0,0,0,0,3,3,6,0,0,1,1,0,4
401365852,Fordham Rams,C. Ohams,4066856,,True,34.0,8,13,8,13,0,0,1,4,2,10,12,0,2,3,6,1,17
401365852,Fordham Rams,A. Charlton,4897085,,True,40.0,2,6,1,2,1,4,1,3,2,4,6,6,3,0,1,1,6
401365852,Fordham Rams,J. Navarro,4592316,,True,35.0,2,10,1,3,1,7,0,1,1,0,1,1,1,0,2,3,5
401365852,Fordham Rams,K. Rose,4592315,,True,26.0,3,7,0,0,3,7,0,0,0,3,3,2,0,0,0,3,9
401365852,Fordham Rams,P. Kelly,4432014,,False,17.0,2,3,0,0,2,3,0,0,0,2,2,1,0,0,0,2,6
401365852,Fordham Rams,R. Novitskyi,4897084,,False,11.0,1,2,0,0,1,2,0,0,0,1,1,0,1,0,1,2,3
401365852,Fordham Rams,A. Harrison,4897086,,False,9.0,0,2,0,2,0,0,0,0,0,3,3,1,0,0,0,0,0
401365852,Fordham Rams,Z. Riley,4914388,,False,14.0,0,2,0,1,0,1,0,1,0,1,1,0,1,0,2,2,0
401365852,Fordham Rams,TEAM,TOTAL,TOTAL,False,,20,50,12,26,8,24,2,9,8,27,35,11,8,4,14,14,50
401365852,Fordham Rams,A. Tsimbila,4702329,,True,14.0,2,5,2,5,0,0,0,0,3,3,6,0,0,1,1,0,4
401365852,Fordham Rams,C. Ohams,4066856,,True,34.0,8,13,8,13,0,0,1,4,2,10,12,0,2,3,6,1,17
401365852,Fordham Rams,A. Charlton,4897085,,True,40.0,2,6,1,2,1,4,1,3,2,4,6,6,3,0,1,1,6
401365852,Fordham Rams,J. Navarro,4592316,,True,35.0,2,10,1,3,1,7,0,1,1,0,1,1,1,0,2,3,5
401365852,Fordham Rams,K. Rose,4592315,,True,26.0,3,7,0,0,3,7,0,0,0,3,3,2,0,0,0,3,9
401365852,Fordham Rams,P. Kelly,4432014,,False,17.0,2,3,0,0,2,3,0,0,0,2,2,1,0,0,0,2,6
401365852,Fordham Rams,R. Novitskyi,4897084,,False,11.0,1,2,0,0,1,2,0,0,0,1,1,0,1,0,1,2,3
401365852,Fordham Rams,A. Harrison,4897086,,False,9.0,0,2,0,2,0,0,0,0,0,3,3,1,0,0,0,0,0
401365852,Fordham Rams,Z. Riley,4914388,,False,14.0,0,2,0,1,0,1,0,1,0,1,1,0,1,0,2,2,0
401365852,Fordham Rams,TEAM,TOTAL,TOTAL,False,,20,50,12,26,8,24,2,9,8,27,35,11,8,4,14,14,50
401365851,Massachusetts Minutemen,M. Steadman,4397393,,True,22.0,5,10,5,10,0,0,2,2,2,5,7,1,0,0,2,0,12
401365851,Massachusetts Minutemen,T. Buttrick,4277981,,True,15.0,2,4,2,4,0,0,0,0,1,2,3,0,1,0,1,3,4
401365851,Massachusetts Minutemen,T.J. Weeks,4433108,,True,29.0,0,4,0,2,0,2,2,2,0,3,3,0,1,0,0,3,2
401365851,Massachusetts Minutemen,N. Fernandes,4431791,,True,35.0,3,12,2,5,1,7,3,4,0,1,1,4,2,0,1,3,10
401365851,Massachusetts Minutemen,R. Kelly,4279741,,True,32.0,4,7,2,3,2,4,7,8,0,1,1,5,1,0,4,1,17
401365851,Massachusetts Minutemen,G. Jones,4279211,,False,19.0,3,5,1,3,2,2,2,2,1,2,3,1,0,1,0,3,10
401365851,Massachusetts Minutemen,J. Garcia,4701125,,False,21.0,2,6,2,5,0,1,3,4,2,1,3,0,2,0,1,1,7
401365851,Massachusetts Minutemen,C.J. Kelly,4398208,,False,27.0,6,8,4,5,2,3,4,5,1,7,8,1,1,1,1,3,18
401365851,Massachusetts Minutemen,TEAM,TOTAL,TOTAL,False,,25,56,18,37,7,19,23,27,8,24,32,12,8,2,10,17,80
401365851,Massachusetts Minutemen,M. Steadman,4397393,,True,22.0,5,10,5,10,0,0,2,2,2,5,7,1,0,0,2,0,12
401365851,Massachusetts Minutemen,T. Buttrick,4277981,,True,15.0,2,4,2,4,0,0,0,0,1,2,3,0,1,0,1,3,4
401365851,Massachusetts Minutemen,T.J. Weeks,4433108,,True,29.0,0,4,0,2,0,2,2,2,0,3,3,0,1,0,0,3,2
401365851,Massachusetts Minutemen,N. Fernandes,4431791,,True,35.0,3,12,2,5,1,7,3,4,0,1,1,4,2,0,1,3,10
401365851,Massachusetts Minutemen,R. Kelly,4279741,,True,32.0,4,7,2,3,2,4,7,8,0,1,1,5,1,0,4,1,17
401365851,Massachusetts Minutemen,G. Jones,4279211,,False,19.0,3,5,1,3,2,2,2,2,1,2,3,1,0,1,0,3,10
401365851,Massachusetts Minutemen,J. Garcia,4701125,,False,21.0,2,6,2,5,0,1,3,4,2,1,3,0,2,0,1,1,7
401365851,Massachusetts Minutemen,C.J. Kelly,4398208,,False,27.0,6,8,4,5,2,3,4,5,1,7,8,1,1,1,1,3,18
401365851,Massachusetts Minutemen,TEAM,TOTAL,TOTAL,False,,25,56,18,37,7,19,23,27,8,24,32,12,8,2,10,17,80
401365851,La Salle Explorers,C. Moore,4277945,,True,34.0,6,12,5,7,1,5,3,3,1,3,4,4,0,2,4,5,16
401365851,La Salle Explorers,J. Clark,4397152,,True,28.0,5,12,2,4,3,8,5,7,0,2,2,0,4,0,4,4,18
401365851,La Salle Explorers,J. Brickus,4700970,,True,37.0,7,10,5,6,2,4,2,2,3,3,6,6,1,0,7,1,18
401365851,La Salle Explorers,C. Ray,4592448,,True,27.0,2,3,1,1,1,2,1,2,1,5,6,1,0,0,0,2,6
401365851,La Salle Explorers,J. Nickelberry,4432845,,True,28.0,4,8,2,3,2,5,0,0,1,4,5,0,0,0,1,3,10
401365851,La Salle Explorers,M. McFarlane,4897068,,False,5.0,0,2,0,1,0,1,0,0,1,0,1,0,0,0,0,1,0
401365851,La Salle Explorers,M. Doucoure,4277988,,False,4.0,0,0,0,0,0,0,0,0,1,0,1,1,0,0,0,1,0
401365851,La Salle Explorers,D. Shepherd,4710357,,False,9.0,0,1,0,0,0,1,0,2,0,1,1,0,0,0,0,1,0
401365851,La Salle Explorers,K. Brantley,4709132,,False,5.0,0,2,0,1,0,1,0,0,0,1,1,0,0,0,1,1,0
401365851,La Salle Explorers,A. Gill,4700969,,False,23.0,2,6,1,4,1,2,1,2,0,5,5,3,0,0,1,5,6
401365851,La Salle Explorers,TEAM,TOTAL,TOTAL,False,,26,56,16,27,10,29,12,18,9,25,34,15,5,2,18,24,74
401365851,La Salle Explorers,C. Moore,4277945,,True,34.0,6,12,5,7,1,5,3,3,1,3,4,4,0,2,4,5,16
401365851,La Salle Explorers,J. Clark,4397152,,True,28.0,5,12,2,4,3,8,5,7,0,2,2,0,4,0,4,4,18
401365851,La Salle Explorers,J. Brickus,4700970,,True,37.0,7,10,5,6,2,4,2,2,3,3,6,6,1,0,7,1,18
401365851,La Salle Explorers,C. Ray,4592448,,True,27.0,2,3,1,1,1,2,1,2,1,5,6,1,0,0,0,2,6
401365851,La Salle Explorers,J. Nickelberry,4432845,,True,28.0,4,8,2,3,2,5,0,0,1,4,5,0,0,0,1,3,10
401365851,La Salle Explorers,M. McFarlane,4897068,,False,5.0,0,2,0,1,0,1,0,0,1,0,1,0,0,0,0,1,0
401365851,La Salle Explorers,M. Doucoure,4277988,,False,4.0,0,0,0,0,0,0,0,0,1,0,1,1,0,0,0,1,0
401365851,La Salle Explorers,D. Shepherd,4710357,,False,9.0,0,1,0,0,0,1,0,2,0,1,1,0,0,0,0,1,0
401365851,La Salle Explorers,K. Brantley,4709132,,False,5.0,0,2,0,1,0,1,0,0,0,1,1,0,0,0,1,1,0
401365851,La Salle Explorers,A. Gill,4700969,,False,23.0,2,6,1,4,1,2,1,2,0,5,5,3,0,0,1,5,6
401365851,La Salle Explorers,TEAM,TOTAL,TOTAL,False,,26,56,16,27,10,29,12,18,9,25,34,15,5,2,18,24,74
401365850,Rhode Island Rams,Makhel Mitchell,4431777,,True,34.0,5,12,5,12,0,0,5,13,2,6,8,1,1,1,1,0,15
401365850,Rhode Island Rams,Makhi Mitchell,4431708,,True,30.0,5,7,4,6,1,1,2,2,0,10,10,2,0,0,5,2,13
401365850,Rhode Island Rams,I. Leggett,4606837,,True,28.0,3,9,3,6,0,3,1,1,0,2,2,2,0,1,3,2,7
401365850,Rhode Island Rams,I. El-Amin,4279313,,True,15.0,1,1,1,1,0,0,0,0,0,0,0,0,0,1,1,0,2
401365850,Rhode Island Rams,J. Sheppard,4066445,,True,34.0,3,8,1,3,2,5,0,0,0,3,3,6,3,0,2,1,8
401365850,Rhode Island Rams,A. Walker,4278567,,False,15.0,0,4,0,2,0,2,0,0,1,2,3,1,0,0,0,1,0
401365850,Rhode Island Rams,M. Martin,4397470,,False,25.0,6,7,6,7,0,0,0,2,5,4,9,2,0,0,2,1,12
401365850,Rhode Island Rams,J. Carey,4395673,,False,14.0,2,6,2,4,0,2,0,0,0,1,1,0,1,2,1,1,4
401365850,Rhode Island Rams,S. Thomas,4897065,,False,5.0,0,1,0,1,0,0,0,0,0,0,0,1,1,0,1,1,0
401365850,Rhode Island Rams,TEAM,TOTAL,TOTAL,False,,25,55,22,42,3,13,8,18,10,28,38,15,6,5,17,9,61
401365850,Rhode Island Rams,Makhel Mitchell,4431777,,True,34.0,5,12,5,12,0,0,5,13,2,6,8,1,1,1,1,0,15
401365850,Rhode Island Rams,Makhi Mitchell,4431708,,True,30.0,5,7,4,6,1,1,2,2,0,10,10,2,0,0,5,2,13
401365850,Rhode Island Rams,I. Leggett,4606837,,True,28.0,3,9,3,6,0,3,1,1,0,2,2,2,0,1,3,2,7
401365850,Rhode Island Rams,I. El-Amin,4279313,,True,15.0,1,1,1,1,0,0,0,0,0,0,0,0,0,1,1,0,2
401365850,Rhode Island Rams,J. Sheppard,4066445,,True,34.0,3,8,1,3,2,5,0,0,0,3,3,6,3,0,2,1,8
401365850,Rhode Island Rams,A. Walker,4278567,,False,15.0,0,4,0,2,0,2,0,0,1,2,3,1,0,0,0,1,0
401365850,Rhode Island Rams,M. Martin,4397470,,False,25.0,6,7,6,7,0,0,0,2,5,4,9,2,0,0,2,1,12
401365850,Rhode Island Rams,J. Carey,4395673,,False,14.0,2,6,2,4,0,2,0,0,0,1,1,0,1,2,1,1,4
401365850,Rhode Island Rams,S. Thomas,4897065,,False,5.0,0,1,0,1,0,0,0,0,0,0,0,1,1,0,1,1,0
401365850,Rhode Island Rams,TEAM,TOTAL,TOTAL,False,,25,55,22,42,3,13,8,18,10,28,38,15,6,5,17,9,61
401365850,George Washington Revolutionaries,H. Dean,4593273,,True,21.0,3,4,3,4,0,0,1,3,1,8,9,0,1,1,0,3,7
401365850,George Washington Revolutionaries,Q. Samuels,4592251,,True,19.0,2,7,0,3,2,4,0,0,3,1,4,2,2,0,1,3,6
401365850,George Washington Revolutionaries,B. Freeman,4613126,,True,28.0,5,8,4,6,1,2,2,3,0,2,2,3,1,0,4,1,13
401365850,George Washington Revolutionaries,J. Bamisile,4432537,,True,37.0,8,19,4,7,4,12,0,0,1,3,4,3,2,0,1,1,20
401365850,George Washington Revolutionaries,J. Bishop,4431770,,True,34.0,4,13,2,7,2,6,2,2,0,3,3,2,1,0,1,1,12
401365850,George Washington Revolutionaries,R. Lindo Jr.,4397186,,False,27.0,2,6,2,2,0,4,0,0,1,4,5,4,0,2,1,4,4
401365850,George Washington Revolutionaries,N. Brown,4700963,,False,11.0,1,1,1,1,0,0,0,0,0,1,1,0,1,0,1,0,2
401365850,George Washington Revolutionaries,B. Adams,4396612,,False,23.0,3,5,1,1,2,4,0,0,0,2,2,2,1,0,1,1,8
401365850,George Washington Revolutionaries,TEAM,TOTAL,TOTAL,False,,28,63,17,31,11,32,5,8,8,24,32,16,9,3,11,14,72
401365850,George Washington Revolutionaries,H. Dean,4593273,,True,21.0,3,4,3,4,0,0,1,3,1,8,9,0,1,1,0,3,7
401365850,George Washington Revolutionaries,Q. Samuels,4592251,,True,19.0,2,7,0,3,2,4,0,0,3,1,4,2,2,0,1,3,6
401365850,George Washington Revolutionaries,B. Freeman,4613126,,True,28.0,5,8,4,6,1,2,2,3,0,2,2,3,1,0,4,1,13
401365850,George Washington Revolutionaries,J. Bamisile,4432537,,True,37.0,8,19,4,7,4,12,0,0,1,3,4,3,2,0,1,1,20
401365850,George Washington Revolutionaries,J. Bishop,4431770,,True,34.0,4,13,2,7,2,6,2,2,0,3,3,2,1,0,1,1,12
401365850,George Washington Revolutionaries,R. Lindo Jr.,4397186,,False,27.0,2,6,2,2,0,4,0,0,1,4,5,4,0,2,1,4,4
401365850,George Washington Revolutionaries,N. Brown,4700963,,False,11.0,1,1,1,1,0,0,0,0,0,1,1,0,1,0,1,0,2
401365850,George Washington Revolutionaries,B. Adams,4396612,,False,23.0,3,5,1,1,2,4,0,0,0,2,2,2,1,0,1,1,8
401365850,George Washington Revolutionaries,TEAM,TOTAL,TOTAL,False,,28,63,17,31,11,32,5,8,8,24,32,16,9,3,11,14,72
401365849,St. Bonaventure Bonnies,O. Osunniyi,4397224,,True,23.0,7,7,7,7,0,0,4,4,1,9,10,1,1,2,0,2,18
401365849,St. Bonaventure Bonnies,J. Adaway,4279431,,True,32.0,8,14,5,8,3,6,2,2,2,4,6,2,2,0,1,0,21
401365849,St. Bonaventure Bonnies,J. Holmes,4701016,,True,30.0,2,8,2,5,0,3,2,2,1,3,4,3,1,0,4,2,6
401365849,St. Bonaventure Bonnies,D. Welch,4397221,,True,38.0,6,11,3,4,3,7,1,2,1,5,6,2,1,0,2,3,16
401365849,St. Bonaventure Bonnies,K. Lofton,4397220,,True,31.0,3,9,3,8,0,1,0,0,2,6,8,6,1,0,1,1,6
401365849,St. Bonaventure Bonnies,P. Rossi,4897049,,False,2.0,0,0,0,0,0,0,0,0,0,0,0,0,0,0,0,0,0
401365849,St. Bonaventure Bonnies,O. Durosinmi,4684462,,False,4.0,0,1,0,1,0,0,0,0,0,1,1,1,0,0,0,1,0
401365849,St. Bonaventure Bonnies,A. Coulibaly,4432889,,False,13.0,2,3,2,3,0,0,2,2,2,1,3,1,1,1,1,4,6
401365849,St. Bonaventure Bonnies,J. Ndjock-Tadjore,4897048,,False,8.0,1,1,1,1,0,0,2,2,1,0,1,0,0,0,1,0,4
401365849,St. Bonaventure Bonnies,J. Saizonou,4897046,,False,4.0,1,2,1,2,0,0,0,1,0,1,1,0,0,0,2,0,2
401365849,St. Bonaventure Bonnies,Q. Adams,4585591,,False,15.0,1,3,1,3,0,0,0,0,0,0,0,1,0,0,0,2,2
401365849,St. Bonaventure Bonnies,TEAM,TOTAL,TOTAL,False,,31,59,25,42,6,17,13,15,11,31,42,17,7,3,12,15,81
401365849,St. Bonaventure Bonnies,O. Osunniyi,4397224,,True,23.0,7,7,7,7,0,0,4,4,1,9,10,1,1,2,0,2,18
401365849,St. Bonaventure Bonnies,J. Adaway,4279431,,True,32.0,8,14,5,8,3,6,2,2,2,4,6,2,2,0,1,0,21
401365849,St. Bonaventure Bonnies,J. Holmes,4701016,,True,30.0,2,8,2,5,0,3,2,2,1,3,4,3,1,0,4,2,6
401365849,St. Bonaventure Bonnies,D. Welch,4397221,,True,38.0,6,11,3,4,3,7,1,2,1,5,6,2,1,0,2,3,16
401365849,St. Bonaventure Bonnies,K. Lofton,4397220,,True,31.0,3,9,3,8,0,1,0,0,2,6,8,6,1,0,1,1,6
401365849,St. Bonaventure Bonnies,P. Rossi,4897049,,False,2.0,0,0,0,0,0,0,0,0,0,0,0,0,0,0,0,0,0
401365849,St. Bonaventure Bonnies,O. Durosinmi,4684462,,False,4.0,0,1,0,1,0,0,0,0,0,1,1,1,0,0,0,1,0
401365849,St. Bonaventure Bonnies,A. Coulibaly,4432889,,False,13.0,2,3,2,3,0,0,2,2,2,1,3,1,1,1,1,4,6
401365849,St. Bonaventure Bonnies,J. Ndjock-Tadjore,4897048,,False,8.0,1,1,1,1,0,0,2,2,1,0,1,0,0,0,1,0,4
401365849,St. Bonaventure Bonnies,J. Saizonou,4897046,,False,4.0,1,2,1,2,0,0,0,1,0,1,1,0,0,0,2,0,2
401365849,St. Bonaventure Bonnies,Q. Adams,4585591,,False,15.0,1,3,1,3,0,0,0,0,0,0,0,1,0,0,0,2,2
401365849,St. Bonaventure Bonnies,TEAM,TOTAL,TOTAL,False,,31,59,25,42,6,17,13,15,11,31,42,17,7,3,12,15,81
401365849,Duquesne Dukes,T. Williams,4432147,,True,32.0,3,10,3,7,0,3,3,6,2,2,4,2,0,0,0,2,9
401365849,Duquesne Dukes,K. Easley,4398159,,True,24.0,1,7,1,5,0,2,0,0,0,2,2,1,1,0,2,4,2
401365849,Duquesne Dukes,A. Spears,4897090,,True,29.0,0,9,0,6,0,3,2,2,0,1,1,3,1,1,2,1,2
401365849,Duquesne Dukes,J. Johnson III,4897088,,True,10.0,1,5,1,2,0,3,0,0,0,0,0,0,1,0,1,1,2
401365849,Duquesne Dukes,T. Acuff,4606831,,True,16.0,3,5,1,2,2,3,0,0,0,2,2,0,1,0,0,1,8
401365849,Duquesne Dukes,M. Hima,4700878,,False,15.0,3,3,3,3,0,0,3,4,0,2,2,0,0,2,0,1,9
401365849,Duquesne Dukes,D. Larson,4897091,,False,9.0,1,2,1,2,0,0,0,0,1,1,2,0,0,0,1,0,2
401365849,Duquesne Dukes,L. Ayers III,4703813,,False,24.0,5,12,3,7,2,5,0,0,0,2,2,0,0,0,3,1,12
401365849,Duquesne Dukes,M. Bekelja,4700874,,False,22.0,2,3,1,1,1,2,0,0,0,4,4,1,0,0,0,2,5
401365849,Duquesne Dukes,T. Okani,4700873,,False,19.0,1,1,1,1,0,0,2,2,2,1,3,3,0,1,0,1,4
401365849,Duquesne Dukes,TEAM,TOTAL,TOTAL,False,,20,57,15,36,5,21,10,14,8,17,25,10,4,4,10,14,55
401365849,Duquesne Dukes,T. Williams,4432147,,True,32.0,3,10,3,7,0,3,3,6,2,2,4,2,0,0,0,2,9
401365849,Duquesne Dukes,K. Easley,4398159,,True,24.0,1,7,1,5,0,2,0,0,0,2,2,1,1,0,2,4,2
401365849,Duquesne Dukes,A. Spears,4897090,,True,29.0,0,9,0,6,0,3,2,2,0,1,1,3,1,1,2,1,2
401365849,Duquesne Dukes,J. Johnson III,4897088,,True,10.0,1,5,1,2,0,3,0,0,0,0,0,0,1,0,1,1,2
401365849,Duquesne Dukes,T. Acuff,4606831,,True,16.0,3,5,1,2,2,3,0,0,0,2,2,0,1,0,0,1,8
401365849,Duquesne Dukes,M. Hima,4700878,,False,15.0,3,3,3,3,0,0,3,4,0,2,2,0,0,2,0,1,9
401365849,Duquesne Dukes,D. Larson,4897091,,False,9.0,1,2,1,2,0,0,0,0,1,1,2,0,0,0,1,0,2
401365849,Duquesne Dukes,L. Ayers III,4703813,,False,24.0,5,12,3,7,2,5,0,0,0,2,2,0,0,0,3,1,12
401365849,Duquesne Dukes,M. Bekelja,4700874,,False,22.0,2,3,1,1,1,2,0,0,0,4,4,1,0,0,0,2,5
401365849,Duquesne Dukes,T. Okani,4700873,,False,19.0,1,1,1,1,0,0,2,2,2,1,3,3,0,1,0,1,4
401365849,Duquesne Dukes,TEAM,TOTAL,TOTAL,False,,20,57,15,36,5,21,10,14,8,17,25,10,4,4,10,14,55
401365848,Saint Joseph's Hawks,T. Funk,4278395,,True,34.0,1,4,0,2,1,2,1,1,0,4,4,1,1,0,3,4,4
401365848,Saint Joseph's Hawks,E. Obinna,4278125,,True,27.0,5,12,5,12,0,0,2,6,6,4,10,0,2,1,1,5,12
401365848,Saint Joseph's Hawks,J. Hall,4701031,,True,34.0,3,11,2,6,1,5,2,2,0,2,2,2,0,0,1,5,9
401365848,Saint Joseph's Hawks,E. Reynolds II,4683952,,True,35.0,5,14,4,8,1,6,5,5,0,2,2,4,0,0,0,2,16
401365848,Saint Joseph's Hawks,C. Brown,4592476,,True,33.0,4,6,1,1,3,5,0,1,0,6,6,1,4,0,2,3,11
401365848,Saint Joseph's Hawks,C. Coleman,4431807,,False,4.0,0,0,0,0,0,0,0,0,0,0,0,0,0,0,0,2,0
401365848,Saint Joseph's Hawks,J. Forrest,4701032,,False,13.0,1,2,1,1,0,1,2,2,0,1,1,1,2,0,1,2,4
401365848,Saint Joseph's Hawks,D. Bishop,4701028,,False,20.0,2,4,0,1,2,3,0,0,0,1,1,2,1,0,0,0,6
401365848,Saint Joseph's Hawks,TEAM,TOTAL,TOTAL,False,,21,53,13,31,8,22,12,17,6,20,26,11,10,1,10,23,62
401365848,Saint Joseph's Hawks,T. Funk,4278395,,True,34.0,1,4,0,2,1,2,1,1,0,4,4,1,1,0,3,4,4
401365848,Saint Joseph's Hawks,E. Obinna,4278125,,True,27.0,5,12,5,12,0,0,2,6,6,4,10,0,2,1,1,5,12
401365848,Saint Joseph's Hawks,J. Hall,4701031,,True,34.0,3,11,2,6,1,5,2,2,0,2,2,2,0,0,1,5,9
401365848,Saint Joseph's Hawks,E. Reynolds II,4683952,,True,35.0,5,14,4,8,1,6,5,5,0,2,2,4,0,0,0,2,16
401365848,Saint Joseph's Hawks,C. Brown,4592476,,True,33.0,4,6,1,1,3,5,0,1,0,6,6,1,4,0,2,3,11
401365848,Saint Joseph's Hawks,C. Coleman,4431807,,False,4.0,0,0,0,0,0,0,0,0,0,0,0,0,0,0,0,2,0
401365848,Saint Joseph's Hawks,J. Forrest,4701032,,False,13.0,1,2,1,1,0,1,2,2,0,1,1,1,2,0,1,2,4
401365848,Saint Joseph's Hawks,D. Bishop,4701028,,False,20.0,2,4,0,1,2,3,0,0,0,1,1,2,1,0,0,0,6
401365848,Saint Joseph's Hawks,TEAM,TOTAL,TOTAL,False,,21,53,13,31,8,22,12,17,6,20,26,11,10,1,10,23,62
401365848,Dayton Flyers,R.J. Blakney,4700864,,True,23.0,0,1,0,0,0,1,0,0,0,0,0,0,1,0,0,2,0
401365848,Dayton Flyers,T. Camara,4431736,,True,29.0,5,7,4,5,1,2,1,5,1,3,4,3,0,1,3,3,12
401365848,Dayton Flyers,D. Holmes II,4433607,,True,36.0,6,10,6,10,0,0,6,10,1,4,5,2,1,4,2,3,18
401365848,Dayton Flyers,M. Smith,4683861,,True,39.0,4,10,2,8,2,2,6,6,2,8,10,6,0,0,3,2,16
401365848,Dayton Flyers,K. Elvis,4683135,,True,28.0,5,9,5,6,0,3,3,3,0,3,3,1,1,0,0,3,13
401365848,Dayton Flyers,M. Sissoko,4431824,,False,2.0,0,1,0,1,0,0,0,0,0,0,0,0,0,0,0,0,0
401365848,Dayton Flyers,M. Amzil,4711607,,False,14.0,1,3,1,3,0,0,1,1,0,4,4,0,0,0,1,3,3
401365848,Dayton Flyers,K. Brea,4591259,,False,22.0,4,6,2,3,2,3,0,0,1,4,5,0,0,0,2,1,10
401365848,Dayton Flyers,E. Weaver,4397139,,False,7.0,1,1,1,1,0,0,0,0,0,1,1,0,0,0,0,0,2
401365848,Dayton Flyers,TEAM,TOTAL,TOTAL,False,,26,48,21,37,5,11,17,25,5,28,33,12,3,5,11,17,74
401365848,Dayton Flyers,R.J. Blakney,4700864,,True,23.0,0,1,0,0,0,1,0,0,0,0,0,0,1,0,0,2,0
401365848,Dayton Flyers,T. Camara,4431736,,True,29.0,5,7,4,5,1,2,1,5,1,3,4,3,0,1,3,3,12
401365848,Dayton Flyers,D. Holmes II,4433607,,True,36.0,6,10,6,10,0,0,6,10,1,4,5,2,1,4,2,3,18
401365848,Dayton Flyers,M. Smith,4683861,,True,39.0,4,10,2,8,2,2,6,6,2,8,10,6,0,0,3,2,16
401365848,Dayton Flyers,K. Elvis,4683135,,True,28.0,5,9,5,6,0,3,3,3,0,3,3,1,1,0,0,3,13
401365848,Dayton Flyers,M. Sissoko,4431824,,False,2.0,0,1,0,1,0,0,0,0,0,0,0,0,0,0,0,0,0
401365848,Dayton Flyers,M. Amzil,4711607,,False,14.0,1,3,1,3,0,0,1,1,0,4,4,0,0,0,1,3,3
401365848,Dayton Flyers,K. Brea,4591259,,False,22.0,4,6,2,3,2,3,0,0,1,4,5,0,0,0,2,1,10
401365848,Dayton Flyers,E. Weaver,4397139,,False,7.0,1,1,1,1,0,0,0,0,0,1,1,0,0,0,0,0,2
401365848,Dayton Flyers,TEAM,TOTAL,TOTAL,False,,26,48,21,37,5,11,17,25,5,28,33,12,3,5,11,17,74
401365847,Saint Louis Billikens,F. Okoro,4397105,,True,27.0,4,8,4,8,0,0,1,2,2,9,11,0,0,0,1,4,9
401365847,Saint Louis Billikens,J. Nesbitt,4714246,,True,26.0,2,8,1,5,1,3,0,0,1,3,4,1,0,0,1,4,5
401365847,Saint Louis Billikens,Y. Collins,4432957,,True,35.0,3,7,3,7,0,0,4,4,0,2,2,5,1,0,3,4,10
401365847,Saint Louis Billikens,G. Jimerson,4432008,,True,31.0,3,10,1,6,2,4,0,0,1,0,1,0,1,0,1,0,8
401365847,Saint Louis Billikens,F. Thatch Jr.,4397199,,True,36.0,2,9,0,5,2,4,2,3,2,2,4,6,0,1,1,3,8
401365847,Saint Louis Billikens,T. Hargrove Jr.,4592484,,False,19.0,4,9,3,3,1,6,0,0,2,2,4,0,0,0,0,1,9
401365847,Saint Louis Billikens,M. Linssen,4279174,,False,13.0,1,5,1,5,0,0,0,0,1,5,6,0,0,0,0,2,2
401365847,Saint Louis Billikens,R. Williams,4399106,,False,3.0,1,1,0,0,1,1,0,0,0,1,1,0,0,0,1,2,3
401365847,Saint Louis Billikens,D. Jones,4278267,,False,10.0,1,4,0,1,1,3,1,2,0,0,0,0,1,0,2,1,4
401365847,Saint Louis Billikens,TEAM,TOTAL,TOTAL,False,,21,61,13,40,8,21,8,11,10,24,34,12,3,1,10,21,58
401365847,Saint Louis Billikens,F. Okoro,4397105,,True,27.0,4,8,4,8,0,0,1,2,2,9,11,0,0,0,1,4,9
401365847,Saint Louis Billikens,J. Nesbitt,4714246,,True,26.0,2,8,1,5,1,3,0,0,1,3,4,1,0,0,1,4,5
401365847,Saint Louis Billikens,Y. Collins,4432957,,True,35.0,3,7,3,7,0,0,4,4,0,2,2,5,1,0,3,4,10
401365847,Saint Louis Billikens,G. Jimerson,4432008,,True,31.0,3,10,1,6,2,4,0,0,1,0,1,0,1,0,1,0,8
401365847,Saint Louis Billikens,F. Thatch Jr.,4397199,,True,36.0,2,9,0,5,2,4,2,3,2,2,4,6,0,1,1,3,8
401365847,Saint Louis Billikens,T. Hargrove Jr.,4592484,,False,19.0,4,9,3,3,1,6,0,0,2,2,4,0,0,0,0,1,9
401365847,Saint Louis Billikens,M. Linssen,4279174,,False,13.0,1,5,1,5,0,0,0,0,1,5,6,0,0,0,0,2,2
401365847,Saint Louis Billikens,R. Williams,4399106,,False,3.0,1,1,0,0,1,1,0,0,0,1,1,0,0,0,1,2,3
401365847,Saint Louis Billikens,D. Jones,4278267,,False,10.0,1,4,0,1,1,3,1,2,0,0,0,0,1,0,2,1,4
401365847,Saint Louis Billikens,TEAM,TOTAL,TOTAL,False,,21,61,13,40,8,21,8,11,10,24,34,12,3,1,10,21,58
401365847,Davidson Wildcats,S. Mennenga,4700862,,True,28.0,0,4,0,4,0,0,1,2,0,3,3,1,0,0,3,1,1
401365847,Davidson Wildcats,L. Brajkovic,4396787,,True,31.0,6,10,2,6,4,4,0,2,2,6,8,3,0,3,0,1,16
401365847,Davidson Wildcats,H. Lee,4592308,,True,30.0,8,12,4,6,4,6,9,10,0,4,4,2,2,1,1,2,29
401365847,Davidson Wildcats,G. Huffman,4432522,,True,27.0,3,5,2,2,1,3,2,4,1,5,6,4,1,0,3,2,9
401365847,Davidson Wildcats,M. Jones,4396784,,True,32.0,5,10,1,5,4,5,4,5,0,5,5,2,1,0,1,2,18
401365847,Davidson Wildcats,D. Kristensen,4432020,,False,1.0,0,1,0,0,0,1,0,0,0,0,0,0,0,0,0,0,0
401365847,Davidson Wildcats,N. Boachie-Yiadom,4396786,,False,17.0,0,1,0,1,0,0,1,2,1,2,3,1,0,1,1,2,1
401365847,Davidson Wildcats,M. Katsock,4902569,,False,1.0,0,0,0,0,0,0,0,0,0,0,0,0,0,0,0,0,0
401365847,Davidson Wildcats,S. Thrastarson,4897100,,False,2.0,0,0,0,0,0,0,0,0,0,0,0,0,0,0,1,0,0
401365847,Davidson Wildcats,D. Watson,4897098,,False,17.0,1,4,0,2,1,2,0,0,2,1,3,1,0,0,1,1,3
401365847,Davidson Wildcats,B. Craig,4700863,,False,1.0,0,0,0,0,0,0,0,0,0,0,0,0,0,0,0,0,0
401365847,Davidson Wildcats,D. Dibble,4592309,,False,1.0,0,0,0,0,0,0,0,0,0,0,0,0,0,0,0,0,0
401365847,Davidson Wildcats,E. Lanier,4567082,,False,12.0,1,4,1,1,0,3,0,0,0,2,2,1,0,0,0,4,2
401365847,Davidson Wildcats,TEAM,TOTAL,TOTAL,False,,24,51,10,27,14,24,17,25,8,31,39,15,4,5,11,15,79
401365847,Davidson Wildcats,S. Mennenga,4700862,,True,28.0,0,4,0,4,0,0,1,2,0,3,3,1,0,0,3,1,1
401365847,Davidson Wildcats,L. Brajkovic,4396787,,True,31.0,6,10,2,6,4,4,0,2,2,6,8,3,0,3,0,1,16
401365847,Davidson Wildcats,H. Lee,4592308,,True,30.0,8,12,4,6,4,6,9,10,0,4,4,2,2,1,1,2,29
401365847,Davidson Wildcats,G. Huffman,4432522,,True,27.0,3,5,2,2,1,3,2,4,1,5,6,4,1,0,3,2,9
401365847,Davidson Wildcats,M. Jones,4396784,,True,32.0,5,10,1,5,4,5,4,5,0,5,5,2,1,0,1,2,18
401365847,Davidson Wildcats,D. Kristensen,4432020,,False,1.0,0,1,0,0,0,1,0,0,0,0,0,0,0,0,0,0,0
401365847,Davidson Wildcats,N. Boachie-Yiadom,4396786,,False,17.0,0,1,0,1,0,0,1,2,1,2,3,1,0,1,1,2,1
401365847,Davidson Wildcats,M. Katsock,4902569,,False,1.0,0,0,0,0,0,0,0,0,0,0,0,0,0,0,0,0,0
401365847,Davidson Wildcats,S. Thrastarson,4897100,,False,2.0,0,0,0,0,0,0,0,0,0,0,0,0,0,0,1,0,0
401365847,Davidson Wildcats,D. Watson,4897098,,False,17.0,1,4,0,2,1,2,0,0,2,1,3,1,0,0,1,1,3
401365847,Davidson Wildcats,B. Craig,4700863,,False,1.0,0,0,0,0,0,0,0,0,0,0,0,0,0,0,0,0,0
401365847,Davidson Wildcats,D. Dibble,4592309,,False,1.0,0,0,0,0,0,0,0,0,0,0,0,0,0,0,0,0,0
401365847,Davidson Wildcats,E. Lanier,4567082,,False,12.0,1,4,1,1,0,3,0,0,0,2,2,1,0,0,0,4,2
401365847,Davidson Wildcats,TEAM,TOTAL,TOTAL,False,,24,51,10,27,14,24,17,25,8,31,39,15,4,5,11,15,79
401365846,VCU Rams,J. DeLoach,4432483,,True,23.0,3,7,3,7,0,0,1,3,4,3,7,1,0,0,0,2,7
401365846,VCU Rams,V. Williams Jr.,4397227,,True,29.0,5,7,2,2,3,5,2,2,0,4,4,2,1,2,3,4,15
401365846,VCU Rams,J. Nunn,4896614,,True,32.0,3,9,3,8,0,1,3,3,0,2,2,2,0,1,1,1,9
401365846,VCU Rams,A. Baldwin Jr.,4433182,,True,29.0,6,11,5,8,1,3,2,2,0,3,3,5,2,1,1,4,15
401365846,VCU Rams,K. Curry,4397228,,True,19.0,2,5,1,3,1,2,1,1,0,3,3,0,1,0,0,1,6
401365846,VCU Rams,M. Brown-Jones,4433224,,False,10.0,4,5,4,5,0,0,3,4,3,4,7,0,0,0,0,2,11
401365846,VCU Rams,L. Stockard III,4277897,,False,17.0,1,3,1,3,0,0,0,0,0,3,3,2,0,0,1,0,2
401365846,VCU Rams,N. Kern,4684145,,False,21.0,2,8,2,8,0,0,3,3,4,1,5,1,1,0,0,4,7
401365846,VCU Rams,A. Henderson VI,4592494,,False,1.0,0,0,0,0,0,0,0,0,0,0,0,0,0,0,0,0,0
401365846,VCU Rams,M. Tsohonis,4592438,,False,16.0,2,6,1,3,1,3,0,0,0,4,4,1,0,0,1,0,5
401365846,VCU Rams,J. Banks,4432402,,False,3.0,0,0,0,0,0,0,0,0,0,1,1,0,0,0,0,0,0
401365846,VCU Rams,TEAM,TOTAL,TOTAL,False,,28,61,22,47,6,14,15,18,12,30,42,14,5,4,8,18,77
401365846,VCU Rams,J. DeLoach,4432483,,True,23.0,3,7,3,7,0,0,1,3,4,3,7,1,0,0,0,2,7
401365846,VCU Rams,V. Williams Jr.,4397227,,True,29.0,5,7,2,2,3,5,2,2,0,4,4,2,1,2,3,4,15
401365846,VCU Rams,J. Nunn,4896614,,True,32.0,3,9,3,8,0,1,3,3,0,2,2,2,0,1,1,1,9
401365846,VCU Rams,A. Baldwin Jr.,4433182,,True,29.0,6,11,5,8,1,3,2,2,0,3,3,5,2,1,1,4,15
401365846,VCU Rams,K. Curry,4397228,,True,19.0,2,5,1,3,1,2,1,1,0,3,3,0,1,0,0,1,6
401365846,VCU Rams,M. Brown-Jones,4433224,,False,10.0,4,5,4,5,0,0,3,4,3,4,7,0,0,0,0,2,11
401365846,VCU Rams,L. Stockard III,4277897,,False,17.0,1,3,1,3,0,0,0,0,0,3,3,2,0,0,1,0,2
401365846,VCU Rams,N. Kern,4684145,,False,21.0,2,8,2,8,0,0,3,3,4,1,5,1,1,0,0,4,7
401365846,VCU Rams,A. Henderson VI,4592494,,False,1.0,0,0,0,0,0,0,0,0,0,0,0,0,0,0,0,0,0
401365846,VCU Rams,M. Tsohonis,4592438,,False,16.0,2,6,1,3,1,3,0,0,0,4,4,1,0,0,1,0,5
401365846,VCU Rams,J. Banks,4432402,,False,3.0,0,0,0,0,0,0,0,0,0,1,1,0,0,0,0,0,0
401365846,VCU Rams,TEAM,TOTAL,TOTAL,False,,28,61,22,47,6,14,15,18,12,30,42,14,5,4,8,18,77
401365846,Richmond Spiders,T. Burton,4431914,,True,36.0,4,9,4,6,0,3,5,8,2,9,11,1,0,1,1,0,13
401365846,Richmond Spiders,N. Cayo,4278380,,True,25.0,3,8,3,8,0,0,3,4,2,3,5,2,1,0,2,4,9
401365846,Richmond Spiders,G. Golden,4066836,,True,25.0,4,9,4,7,0,2,3,4,1,3,4,2,0,0,1,1,11
401365846,Richmond Spiders,A. Gustavson,4397193,,True,37.0,4,8,2,4,2,4,0,2,0,1,1,3,0,0,0,4,10
401365846,Richmond Spiders,J. Gilyard,4278378,,True,39.0,3,10,1,3,2,7,0,0,2,3,5,4,0,0,1,1,8
401365846,Richmond Spiders,M. Grace,4397192,,False,16.0,0,4,0,1,0,3,0,0,1,1,2,0,1,0,1,2,0
401365846,Richmond Spiders,M. Randolph,4710356,,False,1.0,0,0,0,0,0,0,0,0,0,0,0,0,0,0,1,1,0
401365846,Richmond Spiders,C. Crabtree,4396658,,False,2.0,0,0,0,0,0,0,0,0,0,1,1,0,0,0,0,1,0
401365846,Richmond Spiders,N. Sherod,4066832,,False,19.0,2,7,0,1,2,6,0,0,0,1,1,0,1,0,1,2,6
401365846,Richmond Spiders,TEAM,TOTAL,TOTAL,False,,20,55,14,30,6,25,11,18,9,22,31,12,3,1,8,16,57
401365846,Richmond Spiders,T. Burton,4431914,,True,36.0,4,9,4,6,0,3,5,8,2,9,11,1,0,1,1,0,13
401365846,Richmond Spiders,N. Cayo,4278380,,True,25.0,3,8,3,8,0,0,3,4,2,3,5,2,1,0,2,4,9
401365846,Richmond Spiders,G. Golden,4066836,,True,25.0,4,9,4,7,0,2,3,4,1,3,4,2,0,0,1,1,11
401365846,Richmond Spiders,A. Gustavson,4397193,,True,37.0,4,8,2,4,2,4,0,2,0,1,1,3,0,0,0,4,10
401365846,Richmond Spiders,J. Gilyard,4278378,,True,39.0,3,10,1,3,2,7,0,0,2,3,5,4,0,0,1,1,8
401365846,Richmond Spiders,M. Grace,4397192,,False,16.0,0,4,0,1,0,3,0,0,1,1,2,0,1,0,1,2,0
401365846,Richmond Spiders,M. Randolph,4710356,,False,1.0,0,0,0,0,0,0,0,0,0,0,0,0,0,0,1,1,0
401365846,Richmond Spiders,C. Crabtree,4396658,,False,2.0,0,0,0,0,0,0,0,0,0,1,1,0,0,0,0,1,0
401365846,Richmond Spiders,N. Sherod,4066832,,False,19.0,2,7,0,1,2,6,0,0,0,1,1,0,1,0,1,2,6
401365846,Richmond Spiders,TEAM,TOTAL,TOTAL,False,,20,55,14,30,6,25,11,18,9,22,31,12,3,1,8,16,57
401365845,St. Bonaventure Bonnies,O. Osunniyi,4397224,,True,25.0,7,9,7,9,0,0,0,1,0,5,5,0,0,2,0,3,14
401365845,St. Bonaventure Bonnies,J. Adaway,4279431,,True,40.0,6,16,6,14,0,2,4,4,0,2,2,2,2,1,0,1,16
401365845,St. Bonaventure Bonnies,J. Holmes,4701016,,True,40.0,5,12,4,6,1,6,2,2,0,6,6,3,0,1,2,0,13
401365845,St. Bonaventure Bonnies,D. Welch,4397221,,True,38.0,8,10,1,1,7,9,0,0,2,8,10,1,1,1,3,2,23
401365845,St. Bonaventure Bonnies,K. Lofton,4397220,,True,40.0,3,4,1,1,2,3,3,4,0,1,1,17,5,0,3,2,11
401365845,St. Bonaventure Bonnies,A. Coulibaly,4432889,,False,15.0,2,5,2,5,0,0,2,2,0,1,1,2,1,0,0,1,6
401365845,St. Bonaventure Bonnies,Q. Adams,4585591,,False,2.0,0,0,0,0,0,0,0,0,0,0,0,0,0,0,0,1,0
401365845,St. Bonaventure Bonnies,TEAM,TOTAL,TOTAL,False,,31,56,21,36,10,20,11,13,2,24,26,25,9,5,8,10,83
401365845,St. Bonaventure Bonnies,O. Osunniyi,4397224,,True,25.0,7,9,7,9,0,0,0,1,0,5,5,0,0,2,0,3,14
401365845,St. Bonaventure Bonnies,J. Adaway,4279431,,True,40.0,6,16,6,14,0,2,4,4,0,2,2,2,2,1,0,1,16
401365845,St. Bonaventure Bonnies,J. Holmes,4701016,,True,40.0,5,12,4,6,1,6,2,2,0,6,6,3,0,1,2,0,13
401365845,St. Bonaventure Bonnies,D. Welch,4397221,,True,38.0,8,10,1,1,7,9,0,0,2,8,10,1,1,1,3,2,23
401365845,St. Bonaventure Bonnies,K. Lofton,4397220,,True,40.0,3,4,1,1,2,3,3,4,0,1,1,17,5,0,3,2,11
401365845,St. Bonaventure Bonnies,A. Coulibaly,4432889,,False,15.0,2,5,2,5,0,0,2,2,0,1,1,2,1,0,0,1,6
401365845,St. Bonaventure Bonnies,Q. Adams,4585591,,False,2.0,0,0,0,0,0,0,0,0,0,0,0,0,0,0,0,1,0
401365845,St. Bonaventure Bonnies,TEAM,TOTAL,TOTAL,False,,31,56,21,36,10,20,11,13,2,24,26,25,9,5,8,10,83
401365845,Massachusetts Minutemen,M. Steadman,4397393,,True,18.0,1,5,1,5,0,0,3,4,1,2,3,0,1,0,2,2,5
401365845,Massachusetts Minutemen,T. Buttrick,4277981,,True,34.0,3,7,0,1,3,6,0,0,2,9,11,1,0,0,3,2,9
401365845,Massachusetts Minutemen,T.J. Weeks,4433108,,True,36.0,7,13,2,4,5,9,0,0,0,6,6,0,2,0,0,1,19
401365845,Massachusetts Minutemen,N. Fernandes,4431791,,True,40.0,5,16,2,9,3,7,1,2,0,1,1,12,0,0,5,4,14
401365845,Massachusetts Minutemen,R. Kelly,4279741,,True,34.0,5,8,1,1,4,7,0,0,0,1,1,3,1,0,1,1,14
401365845,Massachusetts Minutemen,G. Jones,4279211,,False,16.0,2,3,2,2,0,1,1,1,0,3,3,0,1,0,1,1,5
401365845,Massachusetts Minutemen,J. Garcia,4701125,,False,16.0,2,2,1,1,1,1,0,0,0,0,0,1,0,1,1,3,5
401365845,Massachusetts Minutemen,C.J. Kelly,4398208,,False,6.0,0,3,0,1,0,2,0,0,2,1,3,0,1,0,2,0,0
401365845,Massachusetts Minutemen,TEAM,TOTAL,TOTAL,False,,25,57,9,24,16,33,5,7,8,24,32,17,6,1,15,14,71
401365845,Massachusetts Minutemen,M. Steadman,4397393,,True,18.0,1,5,1,5,0,0,3,4,1,2,3,0,1,0,2,2,5
401365845,Massachusetts Minutemen,T. Buttrick,4277981,,True,34.0,3,7,0,1,3,6,0,0,2,9,11,1,0,0,3,2,9
401365845,Massachusetts Minutemen,T.J. Weeks,4433108,,True,36.0,7,13,2,4,5,9,0,0,0,6,6,0,2,0,0,1,19
401365845,Massachusetts Minutemen,N. Fernandes,4431791,,True,40.0,5,16,2,9,3,7,1,2,0,1,1,12,0,0,5,4,14
401365845,Massachusetts Minutemen,R. Kelly,4279741,,True,34.0,5,8,1,1,4,7,0,0,0,1,1,3,1,0,1,1,14
401365845,Massachusetts Minutemen,G. Jones,4279211,,False,16.0,2,3,2,2,0,1,1,1,0,3,3,0,1,0,1,1,5
401365845,Massachusetts Minutemen,J. Garcia,4701125,,False,16.0,2,2,1,1,1,1,0,0,0,0,0,1,0,1,1,3,5
401365845,Massachusetts Minutemen,C.J. Kelly,4398208,,False,6.0,0,3,0,1,0,2,0,0,2,1,3,0,1,0,2,0,0
401365845,Massachusetts Minutemen,TEAM,TOTAL,TOTAL,False,,25,57,9,24,16,33,5,7,8,24,32,17,6,1,15,14,71
401365844,Saint Joseph's Hawks,T. Funk,4278395,,True,41.0,2,8,0,0,2,8,3,5,2,3,5,2,2,1,2,3,9
401365844,Saint Joseph's Hawks,E. Obinna,4278125,,True,31.0,5,6,5,6,0,0,2,6,3,6,9,2,0,1,3,5,12
401365844,Saint Joseph's Hawks,J. Hall,4701031,,True,40.0,7,14,4,7,3,7,0,0,0,6,6,6,0,0,2,2,17
401365844,Saint Joseph's Hawks,E. Reynolds II,4683952,,True,45.0,5,12,4,5,1,7,5,6,0,8,8,3,2,0,3,3,16
401365844,Saint Joseph's Hawks,C. Brown,4592476,,True,37.0,5,12,1,3,4,9,1,1,0,7,7,2,1,0,2,3,15
401365844,Saint Joseph's Hawks,C. Coleman,4431807,,False,14.0,0,1,0,0,0,1,0,1,1,2,3,0,0,0,0,2,0
401365844,Saint Joseph's Hawks,J. Forrest,4701032,,False,6.0,0,2,0,1,0,1,1,2,0,0,0,0,0,0,0,2,1
401365844,Saint Joseph's Hawks,D. Bishop,4701028,,False,11.0,0,3,0,1,0,2,0,0,0,0,0,0,0,0,0,0,0
401365844,Saint Joseph's Hawks,TEAM,TOTAL,TOTAL,False,,24,58,14,23,10,35,12,21,6,32,38,15,5,2,13,20,70
401365844,Saint Joseph's Hawks,T. Funk,4278395,,True,41.0,2,8,0,0,2,8,3,5,2,3,5,2,2,1,2,3,9
401365844,Saint Joseph's Hawks,E. Obinna,4278125,,True,31.0,5,6,5,6,0,0,2,6,3,6,9,2,0,1,3,5,12
401365844,Saint Joseph's Hawks,J. Hall,4701031,,True,40.0,7,14,4,7,3,7,0,0,0,6,6,6,0,0,2,2,17
401365844,Saint Joseph's Hawks,E. Reynolds II,4683952,,True,45.0,5,12,4,5,1,7,5,6,0,8,8,3,2,0,3,3,16
401365844,Saint Joseph's Hawks,C. Brown,4592476,,True,37.0,5,12,1,3,4,9,1,1,0,7,7,2,1,0,2,3,15
401365844,Saint Joseph's Hawks,C. Coleman,4431807,,False,14.0,0,1,0,0,0,1,0,1,1,2,3,0,0,0,0,2,0
401365844,Saint Joseph's Hawks,J. Forrest,4701032,,False,6.0,0,2,0,1,0,1,1,2,0,0,0,0,0,0,0,2,1
401365844,Saint Joseph's Hawks,D. Bishop,4701028,,False,11.0,0,3,0,1,0,2,0,0,0,0,0,0,0,0,0,0,0
401365844,Saint Joseph's Hawks,TEAM,TOTAL,TOTAL,False,,24,58,14,23,10,35,12,21,6,32,38,15,5,2,13,20,70
401365844,George Mason Patriots,J. Oduro,4432068,,True,39.0,12,18,10,15,2,3,7,8,0,8,8,1,1,1,4,4,33
401365844,George Mason Patriots,X. Johnson,4592439,,True,44.0,3,10,1,2,2,8,5,8,1,4,5,3,2,0,0,1,13
401365844,George Mason Patriots,D. Gaines,4431961,,True,40.0,2,6,1,4,1,2,1,4,1,6,7,3,1,0,1,3,6
401365844,George Mason Patriots,D. Cooper,4279876,,True,36.0,2,6,1,2,1,4,0,0,0,5,5,5,0,0,1,1,5
401365844,George Mason Patriots,D. Schwartz,4278501,,True,41.0,7,13,4,7,3,6,1,2,1,2,3,4,1,0,1,3,18
401365844,George Mason Patriots,B. Jones,4897083,,False,6.0,0,4,0,1,0,3,0,0,0,0,0,0,0,0,0,2,0
401365844,George Mason Patriots,B. Buchanan,4395691,,False,15.0,0,1,0,0,0,1,0,0,0,1,1,1,0,0,0,2,0
401365844,George Mason Patriots,J. Hartwell II,4396817,,False,4.0,0,1,0,0,0,1,0,0,0,0,0,1,0,0,0,1,0
401365844,George Mason Patriots,TEAM,TOTAL,TOTAL,False,,26,59,17,31,9,28,14,22,4,29,33,18,5,1,7,17,75
401365844,George Mason Patriots,J. Oduro,4432068,,True,39.0,12,18,10,15,2,3,7,8,0,8,8,1,1,1,4,4,33
401365844,George Mason Patriots,X. Johnson,4592439,,True,44.0,3,10,1,2,2,8,5,8,1,4,5,3,2,0,0,1,13
401365844,George Mason Patriots,D. Gaines,4431961,,True,40.0,2,6,1,4,1,2,1,4,1,6,7,3,1,0,1,3,6
401365844,George Mason Patriots,D. Cooper,4279876,,True,36.0,2,6,1,2,1,4,0,0,0,5,5,5,0,0,1,1,5
401365844,George Mason Patriots,D. Schwartz,4278501,,True,41.0,7,13,4,7,3,6,1,2,1,2,3,4,1,0,1,3,18
401365844,George Mason Patriots,B. Jones,4897083,,False,6.0,0,4,0,1,0,3,0,0,0,0,0,0,0,0,0,2,0
401365844,George Mason Patriots,B. Buchanan,4395691,,False,15.0,0,1,0,0,0,1,0,0,0,1,1,1,0,0,0,2,0
401365844,George Mason Patriots,J. Hartwell II,4396817,,False,4.0,0,1,0,0,0,1,0,0,0,0,0,1,0,0,0,1,0
401365844,George Mason Patriots,TEAM,TOTAL,TOTAL,False,,26,59,17,31,9,28,14,22,4,29,33,18,5,1,7,17,75
401365843,VCU Rams,H. Ward,4592495,,True,7.0,3,3,3,3,0,0,0,0,1,1,2,0,1,0,2,0,6
401365843,VCU Rams,V. Williams Jr.,4397227,,True,32.0,7,9,5,6,2,3,3,3,1,6,7,1,1,0,3,4,19
401365843,VCU Rams,J. Nunn,4896614,,True,31.0,1,7,1,6,0,1,0,0,1,6,7,5,1,2,3,2,2
401365843,VCU Rams,A. Baldwin Jr.,4433182,,True,40.0,2,9,2,8,0,1,0,0,0,4,4,7,0,0,3,2,4
401365843,VCU Rams,K. Curry,4397228,,True,26.0,7,11,7,10,0,1,7,8,0,2,2,1,2,0,1,3,21
401365843,VCU Rams,M. Brown-Jones,4433224,,False,6.0,2,3,1,2,1,1,0,0,0,0,0,0,1,0,0,0,5
401365843,VCU Rams,J. DeLoach,4432483,,False,15.0,1,2,1,2,0,0,0,0,0,2,2,1,1,1,1,4,2
401365843,VCU Rams,L. Stockard III,4277897,,False,18.0,2,6,2,6,0,0,0,3,0,3,3,0,0,0,0,2,4
401365843,VCU Rams,N. Kern,4684145,,False,2.0,0,0,0,0,0,0,0,0,0,0,0,0,1,0,0,0,0
401365843,VCU Rams,M. Tsohonis,4592438,,False,9.0,0,1,0,1,0,0,0,0,0,1,1,1,0,0,1,2,0
401365843,VCU Rams,J. Banks,4432402,,False,14.0,1,1,0,0,1,1,0,0,0,0,0,0,0,0,2,2,3
401365843,VCU Rams,TEAM,TOTAL,TOTAL,False,,26,52,22,44,4,8,10,14,6,28,34,16,8,3,17,21,66
401365843,VCU Rams,H. Ward,4592495,,True,7.0,3,3,3,3,0,0,0,0,1,1,2,0,1,0,2,0,6
401365843,VCU Rams,V. Williams Jr.,4397227,,True,32.0,7,9,5,6,2,3,3,3,1,6,7,1,1,0,3,4,19
401365843,VCU Rams,J. Nunn,4896614,,True,31.0,1,7,1,6,0,1,0,0,1,6,7,5,1,2,3,2,2
401365843,VCU Rams,A. Baldwin Jr.,4433182,,True,40.0,2,9,2,8,0,1,0,0,0,4,4,7,0,0,3,2,4
401365843,VCU Rams,K. Curry,4397228,,True,26.0,7,11,7,10,0,1,7,8,0,2,2,1,2,0,1,3,21
401365843,VCU Rams,M. Brown-Jones,4433224,,False,6.0,2,3,1,2,1,1,0,0,0,0,0,0,1,0,0,0,5
401365843,VCU Rams,J. DeLoach,4432483,,False,15.0,1,2,1,2,0,0,0,0,0,2,2,1,1,1,1,4,2
401365843,VCU Rams,L. Stockard III,4277897,,False,18.0,2,6,2,6,0,0,0,3,0,3,3,0,0,0,0,2,4
401365843,VCU Rams,N. Kern,4684145,,False,2.0,0,0,0,0,0,0,0,0,0,0,0,0,1,0,0,0,0
401365843,VCU Rams,M. Tsohonis,4592438,,False,9.0,0,1,0,1,0,0,0,0,0,1,1,1,0,0,1,2,0
401365843,VCU Rams,J. Banks,4432402,,False,14.0,1,1,0,0,1,1,0,0,0,0,0,0,0,0,2,2,3
401365843,VCU Rams,TEAM,TOTAL,TOTAL,False,,26,52,22,44,4,8,10,14,6,28,34,16,8,3,17,21,66
401365843,Fordham Rams,A. Tsimbila,4702329,,True,12.0,1,3,1,3,0,0,1,2,2,0,2,0,0,1,0,1,3
401365843,Fordham Rams,C. Ohams,4066856,,True,30.0,5,10,5,10,0,0,4,8,4,8,12,1,1,2,6,4,14
401365843,Fordham Rams,A. Charlton,4897085,,True,28.0,0,5,0,3,0,2,1,2,1,2,3,2,1,0,1,5,1
401365843,Fordham Rams,J. Navarro,4592316,,True,34.0,5,13,4,8,1,5,9,9,0,2,2,0,2,0,2,2,20
401365843,Fordham Rams,K. Rose,4592315,,True,33.0,3,8,1,1,2,7,4,4,1,1,2,1,2,1,3,1,12
401365843,Fordham Rams,P. Kelly,4432014,,False,18.0,2,7,1,1,1,6,0,0,0,1,1,1,0,0,0,0,5
401365843,Fordham Rams,R. Novitskyi,4897084,,False,4.0,0,0,0,0,0,0,0,0,0,0,0,1,0,1,0,0,0
401365843,Fordham Rams,A. Harrison,4897086,,False,19.0,1,4,1,3,0,1,2,2,0,4,4,1,1,0,3,3,4
401365843,Fordham Rams,K. Cunningham,4705891,,False,2.0,0,1,0,0,0,1,0,0,1,0,1,0,0,0,1,1,0
401365843,Fordham Rams,Z. Riley,4914388,,False,20.0,1,4,1,2,0,2,0,0,1,3,4,2,2,0,0,2,2
401365843,Fordham Rams,TEAM,TOTAL,TOTAL,False,,18,55,14,31,4,24,21,27,13,22,35,9,9,5,17,19,61
401365843,Fordham Rams,A. Tsimbila,4702329,,True,12.0,1,3,1,3,0,0,1,2,2,0,2,0,0,1,0,1,3
401365843,Fordham Rams,C. Ohams,4066856,,True,30.0,5,10,5,10,0,0,4,8,4,8,12,1,1,2,6,4,14
401365843,Fordham Rams,A. Charlton,4897085,,True,28.0,0,5,0,3,0,2,1,2,1,2,3,2,1,0,1,5,1
401365843,Fordham Rams,J. Navarro,4592316,,True,34.0,5,13,4,8,1,5,9,9,0,2,2,0,2,0,2,2,20
401365843,Fordham Rams,K. Rose,4592315,,True,33.0,3,8,1,1,2,7,4,4,1,1,2,1,2,1,3,1,12
401365843,Fordham Rams,P. Kelly,4432014,,False,18.0,2,7,1,1,1,6,0,0,0,1,1,1,0,0,0,0,5
401365843,Fordham Rams,R. Novitskyi,4897084,,False,4.0,0,0,0,0,0,0,0,0,0,0,0,1,0,1,0,0,0
401365843,Fordham Rams,A. Harrison,4897086,,False,19.0,1,4,1,3,0,1,2,2,0,4,4,1,1,0,3,3,4
401365843,Fordham Rams,K. Cunningham,4705891,,False,2.0,0,1,0,0,0,1,0,0,1,0,1,0,0,0,1,1,0
401365843,Fordham Rams,Z. Riley,4914388,,False,20.0,1,4,1,2,0,2,0,0,1,3,4,2,2,0,0,2,2
401365843,Fordham Rams,TEAM,TOTAL,TOTAL,False,,18,55,14,31,4,24,21,27,13,22,35,9,9,5,17,19,61
401365842,VCU Rams,H. Ward,4592495,,True,17.0,4,4,4,4,0,0,2,2,1,5,6,1,1,0,0,4,10
401365842,VCU Rams,V. Williams Jr.,4397227,,True,27.0,7,10,5,6,2,4,2,2,1,2,3,2,0,0,3,4,18
401365842,VCU Rams,J. Nunn,4896614,,True,31.0,5,8,2,3,3,5,2,2,0,6,6,4,2,0,0,1,15
401365842,VCU Rams,A. Baldwin Jr.,4433182,,True,40.0,5,10,2,5,3,5,5,6,0,3,3,10,2,0,3,3,18
401365842,VCU Rams,K. Curry,4397228,,True,38.0,5,11,4,6,1,5,0,0,0,3,3,2,0,0,4,3,11
401365842,VCU Rams,M. Brown-Jones,4433224,,False,13.0,1,3,1,2,0,1,2,2,2,1,3,0,1,0,0,0,4
401365842,VCU Rams,J. DeLoach,4432483,,False,13.0,2,3,2,3,0,0,1,2,2,1,3,0,0,1,0,3,5
401365842,VCU Rams,L. Stockard III,4277897,,False,10.0,0,1,0,1,0,0,0,0,0,1,1,0,1,0,2,2,0
401365842,VCU Rams,N. Kern,4684145,,False,2.0,0,1,0,1,0,0,0,0,0,0,0,0,0,0,0,1,0
401365842,VCU Rams,M. Tsohonis,4592438,,False,9.0,1,3,1,3,0,0,2,2,1,1,2,0,0,0,0,0,4
401365842,VCU Rams,TEAM,TOTAL,TOTAL,False,,30,54,21,34,9,20,16,18,7,23,30,19,7,1,12,21,85
401365842,VCU Rams,H. Ward,4592495,,True,17.0,4,4,4,4,0,0,2,2,1,5,6,1,1,0,0,4,10
401365842,VCU Rams,V. Williams Jr.,4397227,,True,27.0,7,10,5,6,2,4,2,2,1,2,3,2,0,0,3,4,18
401365842,VCU Rams,J. Nunn,4896614,,True,31.0,5,8,2,3,3,5,2,2,0,6,6,4,2,0,0,1,15
401365842,VCU Rams,A. Baldwin Jr.,4433182,,True,40.0,5,10,2,5,3,5,5,6,0,3,3,10,2,0,3,3,18
401365842,VCU Rams,K. Curry,4397228,,True,38.0,5,11,4,6,1,5,0,0,0,3,3,2,0,0,4,3,11
401365842,VCU Rams,M. Brown-Jones,4433224,,False,13.0,1,3,1,2,0,1,2,2,2,1,3,0,1,0,0,0,4
401365842,VCU Rams,J. DeLoach,4432483,,False,13.0,2,3,2,3,0,0,1,2,2,1,3,0,0,1,0,3,5
401365842,VCU Rams,L. Stockard III,4277897,,False,10.0,0,1,0,1,0,0,0,0,0,1,1,0,1,0,2,2,0
401365842,VCU Rams,N. Kern,4684145,,False,2.0,0,1,0,1,0,0,0,0,0,0,0,0,0,0,0,1,0
401365842,VCU Rams,M. Tsohonis,4592438,,False,9.0,1,3,1,3,0,0,2,2,1,1,2,0,0,0,0,0,4
401365842,VCU Rams,TEAM,TOTAL,TOTAL,False,,30,54,21,34,9,20,16,18,7,23,30,19,7,1,12,21,85
401365842,George Mason Patriots,J. Oduro,4432068,,True,35.0,7,15,7,14,0,1,4,5,3,6,9,2,1,1,3,4,18
401365842,George Mason Patriots,X. Johnson,4592439,,True,39.0,2,5,1,3,1,2,6,7,0,3,3,9,0,0,4,4,11
401365842,George Mason Patriots,D. Gaines,4431961,,True,32.0,4,8,1,1,3,7,5,7,0,2,2,3,2,0,3,2,16
401365842,George Mason Patriots,D. Cooper,4279876,,True,36.0,5,9,1,1,4,8,0,0,0,1,1,0,1,0,3,1,14
401365842,George Mason Patriots,D. Schwartz,4278501,,True,36.0,3,9,2,4,1,5,2,4,1,3,4,0,1,0,1,2,9
401365842,George Mason Patriots,B. Jones,4897083,,False,4.0,0,2,0,0,0,2,0,0,0,0,0,0,0,0,0,0,0
401365842,George Mason Patriots,M. Henry,4606836,,False,3.0,0,0,0,0,0,0,0,0,1,1,2,1,0,0,0,0,0
401365842,George Mason Patriots,O. Frazier III,4700882,,False,3.0,1,1,1,1,0,0,0,0,0,0,0,0,1,0,0,1,2
401365842,George Mason Patriots,B. Buchanan,4395691,,False,9.0,0,1,0,0,0,1,0,0,0,1,1,0,0,0,0,1,0
401365842,George Mason Patriots,J. Hartwell II,4396817,,False,3.0,0,1,0,0,0,1,0,0,0,0,0,0,0,0,0,0,0
401365842,George Mason Patriots,TEAM,TOTAL,TOTAL,False,,22,51,13,24,9,27,17,23,6,19,25,15,6,1,17,15,70
401365842,George Mason Patriots,J. Oduro,4432068,,True,35.0,7,15,7,14,0,1,4,5,3,6,9,2,1,1,3,4,18
401365842,George Mason Patriots,X. Johnson,4592439,,True,39.0,2,5,1,3,1,2,6,7,0,3,3,9,0,0,4,4,11
401365842,George Mason Patriots,D. Gaines,4431961,,True,32.0,4,8,1,1,3,7,5,7,0,2,2,3,2,0,3,2,16
401365842,George Mason Patriots,D. Cooper,4279876,,True,36.0,5,9,1,1,4,8,0,0,0,1,1,0,1,0,3,1,14
401365842,George Mason Patriots,D. Schwartz,4278501,,True,36.0,3,9,2,4,1,5,2,4,1,3,4,0,1,0,1,2,9
401365842,George Mason Patriots,B. Jones,4897083,,False,4.0,0,2,0,0,0,2,0,0,0,0,0,0,0,0,0,0,0
401365842,George Mason Patriots,M. Henry,4606836,,False,3.0,0,0,0,0,0,0,0,0,1,1,2,1,0,0,0,0,0
401365842,George Mason Patriots,O. Frazier III,4700882,,False,3.0,1,1,1,1,0,0,0,0,0,0,0,0,1,0,0,1,2
401365842,George Mason Patriots,B. Buchanan,4395691,,False,9.0,0,1,0,0,0,1,0,0,0,1,1,0,0,0,0,1,0
401365842,George Mason Patriots,J. Hartwell II,4396817,,False,3.0,0,1,0,0,0,1,0,0,0,0,0,0,0,0,0,0,0
401365842,George Mason Patriots,TEAM,TOTAL,TOTAL,False,,22,51,13,24,9,27,17,23,6,19,25,15,6,1,17,15,70
401365841,Saint Joseph's Hawks,T. Funk,4278395,,True,38.0,3,10,1,2,2,8,0,0,1,6,7,0,0,0,1,2,8
401365841,Saint Joseph's Hawks,E. Obinna,4278125,,True,29.0,5,8,5,8,0,0,0,1,1,3,4,2,1,0,3,3,10
401365841,Saint Joseph's Hawks,J. Hall,4701031,,True,35.0,5,13,3,8,2,5,1,2,1,3,4,7,1,0,5,3,13
401365841,Saint Joseph's Hawks,E. Reynolds II,4683952,,True,33.0,3,9,2,5,1,4,0,0,0,5,5,4,1,0,4,1,7
401365841,Saint Joseph's Hawks,C. Brown,4592476,,True,36.0,6,10,3,3,3,7,0,0,0,2,2,2,0,1,0,2,15
401365841,Saint Joseph's Hawks,C. Coleman,4431807,,False,10.0,3,4,2,2,1,2,0,0,0,2,2,1,0,0,1,1,7
401365841,Saint Joseph's Hawks,D. Bishop,4701028,,False,18.0,3,4,2,3,1,1,0,0,0,2,2,2,1,0,0,1,7
401365841,Saint Joseph's Hawks,TEAM,TOTAL,TOTAL,False,,28,58,18,31,10,27,1,3,7,28,35,18,4,1,14,13,67
401365841,Saint Joseph's Hawks,T. Funk,4278395,,True,38.0,3,10,1,2,2,8,0,0,1,6,7,0,0,0,1,2,8
401365841,Saint Joseph's Hawks,E. Obinna,4278125,,True,29.0,5,8,5,8,0,0,0,1,1,3,4,2,1,0,3,3,10
401365841,Saint Joseph's Hawks,J. Hall,4701031,,True,35.0,5,13,3,8,2,5,1,2,1,3,4,7,1,0,5,3,13
401365841,Saint Joseph's Hawks,E. Reynolds II,4683952,,True,33.0,3,9,2,5,1,4,0,0,0,5,5,4,1,0,4,1,7
401365841,Saint Joseph's Hawks,C. Brown,4592476,,True,36.0,6,10,3,3,3,7,0,0,0,2,2,2,0,1,0,2,15
401365841,Saint Joseph's Hawks,C. Coleman,4431807,,False,10.0,3,4,2,2,1,2,0,0,0,2,2,1,0,0,1,1,7
401365841,Saint Joseph's Hawks,D. Bishop,4701028,,False,18.0,3,4,2,3,1,1,0,0,0,2,2,2,1,0,0,1,7
401365841,Saint Joseph's Hawks,TEAM,TOTAL,TOTAL,False,,28,58,18,31,10,27,1,3,7,28,35,18,4,1,14,13,67
401365841,Massachusetts Minutemen,M. Steadman,4397393,,True,25.0,9,14,8,13,1,1,0,0,2,1,3,0,2,1,4,2,19
401365841,Massachusetts Minutemen,T. Buttrick,4277981,,True,32.0,4,12,2,4,2,8,1,4,3,6,9,0,0,0,2,4,11
401365841,Massachusetts Minutemen,T.J. Weeks,4433108,,True,34.0,4,6,3,5,1,1,3,5,0,5,5,4,3,1,0,0,12
401365841,Massachusetts Minutemen,N. Fernandes,4431791,,True,38.0,2,7,1,4,1,3,5,5,0,3,3,9,0,0,1,1,10
401365841,Massachusetts Minutemen,R. Kelly,4279741,,True,30.0,1,8,1,4,0,4,1,1,0,4,4,5,1,0,1,1,3
401365841,Massachusetts Minutemen,G. Jones,4279211,,False,7.0,1,3,0,0,1,3,0,0,0,1,1,0,0,0,0,1,3
401365841,Massachusetts Minutemen,J. Garcia,4701125,,False,19.0,2,3,2,2,0,1,4,4,0,0,0,0,1,1,0,1,8
401365841,Massachusetts Minutemen,C.J. Kelly,4398208,,False,15.0,1,5,0,1,1,4,0,0,1,5,6,0,1,0,1,1,3
401365841,Massachusetts Minutemen,TEAM,TOTAL,TOTAL,False,,24,58,17,33,7,25,14,19,8,25,33,18,8,3,9,11,69
401365841,Massachusetts Minutemen,M. Steadman,4397393,,True,25.0,9,14,8,13,1,1,0,0,2,1,3,0,2,1,4,2,19
401365841,Massachusetts Minutemen,T. Buttrick,4277981,,True,32.0,4,12,2,4,2,8,1,4,3,6,9,0,0,0,2,4,11
401365841,Massachusetts Minutemen,T.J. Weeks,4433108,,True,34.0,4,6,3,5,1,1,3,5,0,5,5,4,3,1,0,0,12
401365841,Massachusetts Minutemen,N. Fernandes,4431791,,True,38.0,2,7,1,4,1,3,5,5,0,3,3,9,0,0,1,1,10
401365841,Massachusetts Minutemen,R. Kelly,4279741,,True,30.0,1,8,1,4,0,4,1,1,0,4,4,5,1,0,1,1,3
401365841,Massachusetts Minutemen,G. Jones,4279211,,False,7.0,1,3,0,0,1,3,0,0,0,1,1,0,0,0,0,1,3
401365841,Massachusetts Minutemen,J. Garcia,4701125,,False,19.0,2,3,2,2,0,1,4,4,0,0,0,0,1,1,0,1,8
401365841,Massachusetts Minutemen,C.J. Kelly,4398208,,False,15.0,1,5,0,1,1,4,0,0,1,5,6,0,1,0,1,1,3
401365841,Massachusetts Minutemen,TEAM,TOTAL,TOTAL,False,,24,58,17,33,7,25,14,19,8,25,33,18,8,3,9,11,69
401365840,Fordham Rams,A. Tsimbila,4702329,,True,14.0,2,5,2,5,0,0,0,0,3,5,8,0,0,1,0,3,4
401365840,Fordham Rams,C. Ohams,4066856,,True,34.0,8,16,8,16,0,0,2,3,6,8,14,1,0,1,3,1,18
401365840,Fordham Rams,A. Charlton,4897085,,True,38.0,5,14,4,12,1,2,0,0,1,5,6,6,2,0,4,3,11
401365840,Fordham Rams,J. Navarro,4592316,,True,36.0,4,9,1,2,3,7,4,4,1,4,5,2,0,0,6,1,15
401365840,Fordham Rams,K. Rose,4592315,,True,36.0,3,9,1,4,2,5,2,2,1,5,6,5,3,1,1,2,10
401365840,Fordham Rams,P. Kelly,4432014,,False,18.0,2,5,1,2,1,3,0,0,2,2,4,0,0,0,0,0,5
401365840,Fordham Rams,R. Novitskyi,4897084,,False,11.0,1,2,1,2,0,0,0,0,1,1,2,1,0,0,1,3,2
401365840,Fordham Rams,A. Harrison,4897086,,False,9.0,0,1,0,1,0,0,0,0,0,0,0,1,0,0,0,2,0
401365840,Fordham Rams,K. Cunningham,4705891,,False,4.0,0,0,0,0,0,0,0,0,0,0,0,0,0,0,0,1,0
401365840,Fordham Rams,TEAM,TOTAL,TOTAL,False,,25,61,18,44,7,17,8,9,16,32,48,16,5,3,16,16,65
401365840,Fordham Rams,A. Tsimbila,4702329,,True,14.0,2,5,2,5,0,0,0,0,3,5,8,0,0,1,0,3,4
401365840,Fordham Rams,C. Ohams,4066856,,True,34.0,8,16,8,16,0,0,2,3,6,8,14,1,0,1,3,1,18
401365840,Fordham Rams,A. Charlton,4897085,,True,38.0,5,14,4,12,1,2,0,0,1,5,6,6,2,0,4,3,11
401365840,Fordham Rams,J. Navarro,4592316,,True,36.0,4,9,1,2,3,7,4,4,1,4,5,2,0,0,6,1,15
401365840,Fordham Rams,K. Rose,4592315,,True,36.0,3,9,1,4,2,5,2,2,1,5,6,5,3,1,1,2,10
401365840,Fordham Rams,P. Kelly,4432014,,False,18.0,2,5,1,2,1,3,0,0,2,2,4,0,0,0,0,0,5
401365840,Fordham Rams,R. Novitskyi,4897084,,False,11.0,1,2,1,2,0,0,0,0,1,1,2,1,0,0,1,3,2
401365840,Fordham Rams,A. Harrison,4897086,,False,9.0,0,1,0,1,0,0,0,0,0,0,0,1,0,0,0,2,0
401365840,Fordham Rams,K. Cunningham,4705891,,False,4.0,0,0,0,0,0,0,0,0,0,0,0,0,0,0,0,1,0
401365840,Fordham Rams,TEAM,TOTAL,TOTAL,False,,25,61,18,44,7,17,8,9,16,32,48,16,5,3,16,16,65
401365840,Duquesne Dukes,T. Williams,4432147,,True,34.0,5,12,5,12,0,0,4,4,1,2,3,1,1,5,3,3,14
401365840,Duquesne Dukes,K. Easley,4398159,,True,28.0,2,7,2,4,0,3,0,0,3,0,3,0,1,1,0,2,4
401365840,Duquesne Dukes,A. Spears,4897090,,True,37.0,3,10,3,8,0,2,2,4,0,2,2,2,3,0,2,1,8
401365840,Duquesne Dukes,T. Okani,4700873,,True,10.0,0,6,0,2,0,4,0,0,0,0,0,0,1,1,0,2,0
401365840,Duquesne Dukes,T. Acuff,4606831,,True,17.0,0,2,0,1,0,1,2,2,1,3,4,0,1,0,1,0,2
401365840,Duquesne Dukes,M. Hima,4700878,,False,6.0,0,0,0,0,0,0,0,0,0,2,2,0,0,0,1,1,0
401365840,Duquesne Dukes,D. Larson,4897091,,False,15.0,2,2,1,1,1,1,0,0,0,2,2,1,0,1,0,1,5
401365840,Duquesne Dukes,J. Johnson III,4897088,,False,19.0,4,7,3,4,1,3,0,0,0,1,1,0,1,0,1,1,9
401365840,Duquesne Dukes,L. Ayers III,4703813,,False,29.0,3,7,1,4,2,3,4,6,0,6,6,3,0,0,1,3,12
401365840,Duquesne Dukes,M. Bekelja,4700874,,False,5.0,0,0,0,0,0,0,0,0,0,0,0,0,0,0,0,0,0
401365840,Duquesne Dukes,TEAM,TOTAL,TOTAL,False,,19,53,15,36,4,17,12,16,5,20,25,7,8,8,9,14,54
401365840,Duquesne Dukes,T. Williams,4432147,,True,34.0,5,12,5,12,0,0,4,4,1,2,3,1,1,5,3,3,14
401365840,Duquesne Dukes,K. Easley,4398159,,True,28.0,2,7,2,4,0,3,0,0,3,0,3,0,1,1,0,2,4
401365840,Duquesne Dukes,A. Spears,4897090,,True,37.0,3,10,3,8,0,2,2,4,0,2,2,2,3,0,2,1,8
401365840,Duquesne Dukes,T. Okani,4700873,,True,10.0,0,6,0,2,0,4,0,0,0,0,0,0,1,1,0,2,0
401365840,Duquesne Dukes,T. Acuff,4606831,,True,17.0,0,2,0,1,0,1,2,2,1,3,4,0,1,0,1,0,2
401365840,Duquesne Dukes,M. Hima,4700878,,False,6.0,0,0,0,0,0,0,0,0,0,2,2,0,0,0,1,1,0
401365840,Duquesne Dukes,D. Larson,4897091,,False,15.0,2,2,1,1,1,1,0,0,0,2,2,1,0,1,0,1,5
401365840,Duquesne Dukes,J. Johnson III,4897088,,False,19.0,4,7,3,4,1,3,0,0,0,1,1,0,1,0,1,1,9
401365840,Duquesne Dukes,L. Ayers III,4703813,,False,29.0,3,7,1,4,2,3,4,6,0,6,6,3,0,0,1,3,12
401365840,Duquesne Dukes,M. Bekelja,4700874,,False,5.0,0,0,0,0,0,0,0,0,0,0,0,0,0,0,0,0,0
401365840,Duquesne Dukes,TEAM,TOTAL,TOTAL,False,,19,53,15,36,4,17,12,16,5,20,25,7,8,8,9,14,54
401365839,George Washington Revolutionaries,H. Dean,4593273,,True,23.0,2,3,2,3,0,0,0,0,0,2,2,1,0,0,1,2,4
401365839,George Washington Revolutionaries,Q. Samuels,4592251,,True,11.0,1,2,0,0,1,2,0,0,0,1,1,1,0,0,0,0,3
401365839,George Washington Revolutionaries,B. Freeman,4613126,,True,34.0,3,9,3,7,0,2,2,4,1,0,1,4,1,0,3,0,8
401365839,George Washington Revolutionaries,J. Bamisile,4432537,,True,23.0,2,8,1,3,1,5,0,0,0,2,2,1,0,0,2,2,5
401365839,George Washington Revolutionaries,J. Bishop,4431770,,True,29.0,4,13,3,5,1,8,1,1,0,0,0,3,0,0,1,2,10
401365839,George Washington Revolutionaries,D. Nixon,4897075,,False,1.0,0,0,0,0,0,0,1,2,0,0,0,0,0,0,0,0,1
401365839,George Washington Revolutionaries,M. Gally,4592445,,False,1.0,0,0,0,0,0,0,0,0,0,0,0,0,0,0,0,1,0
401365839,George Washington Revolutionaries,R. Lindo Jr.,4397186,,False,26.0,4,9,2,4,2,5,0,0,2,7,9,1,3,3,4,2,10
401365839,George Washington Revolutionaries,N. Brown,4700963,,False,13.0,3,4,3,4,0,0,1,2,2,2,4,0,1,0,0,1,7
401365839,George Washington Revolutionaries,T. Stamoulis,4897076,,False,1.0,0,0,0,0,0,0,0,0,0,0,0,0,0,0,0,0,0
401365839,George Washington Revolutionaries,A. Harris,4397216,,False,8.0,0,1,0,1,0,0,1,4,0,1,1,0,0,1,0,0,1
401365839,George Washington Revolutionaries,B. Adams,4396612,,False,26.0,1,5,1,4,0,1,0,0,0,2,2,0,0,0,1,1,2
401365839,George Washington Revolutionaries,B. Knapp,4279473,,False,4.0,1,1,0,0,1,1,0,0,0,0,0,0,0,0,0,0,3
401365839,George Washington Revolutionaries,TEAM,TOTAL,TOTAL,False,,21,55,15,31,6,24,6,13,7,17,24,11,5,4,13,11,54
401365839,George Washington Revolutionaries,H. Dean,4593273,,True,23.0,2,3,2,3,0,0,0,0,0,2,2,1,0,0,1,2,4
401365839,George Washington Revolutionaries,Q. Samuels,4592251,,True,11.0,1,2,0,0,1,2,0,0,0,1,1,1,0,0,0,0,3
401365839,George Washington Revolutionaries,B. Freeman,4613126,,True,34.0,3,9,3,7,0,2,2,4,1,0,1,4,1,0,3,0,8
401365839,George Washington Revolutionaries,J. Bamisile,4432537,,True,23.0,2,8,1,3,1,5,0,0,0,2,2,1,0,0,2,2,5
401365839,George Washington Revolutionaries,J. Bishop,4431770,,True,29.0,4,13,3,5,1,8,1,1,0,0,0,3,0,0,1,2,10
401365839,George Washington Revolutionaries,D. Nixon,4897075,,False,1.0,0,0,0,0,0,0,1,2,0,0,0,0,0,0,0,0,1
401365839,George Washington Revolutionaries,M. Gally,4592445,,False,1.0,0,0,0,0,0,0,0,0,0,0,0,0,0,0,0,1,0
401365839,George Washington Revolutionaries,R. Lindo Jr.,4397186,,False,26.0,4,9,2,4,2,5,0,0,2,7,9,1,3,3,4,2,10
401365839,George Washington Revolutionaries,N. Brown,4700963,,False,13.0,3,4,3,4,0,0,1,2,2,2,4,0,1,0,0,1,7
401365839,George Washington Revolutionaries,T. Stamoulis,4897076,,False,1.0,0,0,0,0,0,0,0,0,0,0,0,0,0,0,0,0,0
401365839,George Washington Revolutionaries,A. Harris,4397216,,False,8.0,0,1,0,1,0,0,1,4,0,1,1,0,0,1,0,0,1
401365839,George Washington Revolutionaries,B. Adams,4396612,,False,26.0,1,5,1,4,0,1,0,0,0,2,2,0,0,0,1,1,2
401365839,George Washington Revolutionaries,B. Knapp,4279473,,False,4.0,1,1,0,0,1,1,0,0,0,0,0,0,0,0,0,0,3
401365839,George Washington Revolutionaries,TEAM,TOTAL,TOTAL,False,,21,55,15,31,6,24,6,13,7,17,24,11,5,4,13,11,54
401365839,Dayton Flyers,R.J. Blakney,4700864,,True,20.0,4,5,1,2,3,3,0,1,1,5,6,2,0,0,2,1,11
401365839,Dayton Flyers,T. Camara,4431736,,True,18.0,5,8,3,5,2,3,0,0,1,4,5,1,0,1,2,1,12
401365839,Dayton Flyers,D. Holmes II,4433607,,True,26.0,4,5,4,5,0,0,4,6,0,3,3,2,0,2,1,0,12
401365839,Dayton Flyers,M. Smith,4683861,,True,25.0,2,4,1,3,1,1,0,1,0,3,3,9,3,0,4,0,5
401365839,Dayton Flyers,K. Elvis,4683135,,True,27.0,6,9,5,6,1,3,0,0,0,2,2,4,0,0,1,1,13
401365839,Dayton Flyers,M. Sissoko,4431824,,False,13.0,2,3,2,3,0,0,0,0,1,3,4,0,0,0,1,0,4
401365839,Dayton Flyers,M. Amzil,4711607,,False,14.0,3,7,2,4,1,3,0,0,3,1,4,0,1,0,0,0,7
401365839,Dayton Flyers,K. Washington,4684293,,False,8.0,2,2,2,2,0,0,0,0,0,0,0,0,1,0,0,1,4
401365839,Dayton Flyers,Z. Nwokeji,4618121,,False,8.0,0,0,0,0,0,0,0,0,0,1,1,1,0,0,2,4,0
401365839,Dayton Flyers,C. Wilson,4403456,,False,3.0,1,1,1,1,0,0,0,0,0,0,0,0,0,0,0,0,2
401365839,Dayton Flyers,B. Uhl,4897094,,False,1.0,0,0,0,0,0,0,0,0,0,0,0,0,0,0,0,0,0
401365839,Dayton Flyers,D. Swerlein,4600089,,False,2.0,0,1,0,1,0,0,0,0,0,1,1,0,0,0,1,0,0
401365839,Dayton Flyers,K. Brea,4591259,,False,17.0,2,5,1,3,1,2,0,0,0,6,6,1,0,0,1,2,5
401365839,Dayton Flyers,E. Weaver,4397139,,False,18.0,2,3,1,2,1,1,0,0,0,0,0,2,0,0,1,3,5
401365839,Dayton Flyers,TEAM,TOTAL,TOTAL,False,,33,53,23,37,10,16,4,8,6,30,36,22,5,3,16,13,80
401365839,Dayton Flyers,R.J. Blakney,4700864,,True,20.0,4,5,1,2,3,3,0,1,1,5,6,2,0,0,2,1,11
401365839,Dayton Flyers,T. Camara,4431736,,True,18.0,5,8,3,5,2,3,0,0,1,4,5,1,0,1,2,1,12
401365839,Dayton Flyers,D. Holmes II,4433607,,True,26.0,4,5,4,5,0,0,4,6,0,3,3,2,0,2,1,0,12
401365839,Dayton Flyers,M. Smith,4683861,,True,25.0,2,4,1,3,1,1,0,1,0,3,3,9,3,0,4,0,5
401365839,Dayton Flyers,K. Elvis,4683135,,True,27.0,6,9,5,6,1,3,0,0,0,2,2,4,0,0,1,1,13
401365839,Dayton Flyers,M. Sissoko,4431824,,False,13.0,2,3,2,3,0,0,0,0,1,3,4,0,0,0,1,0,4
401365839,Dayton Flyers,M. Amzil,4711607,,False,14.0,3,7,2,4,1,3,0,0,3,1,4,0,1,0,0,0,7
401365839,Dayton Flyers,K. Washington,4684293,,False,8.0,2,2,2,2,0,0,0,0,0,0,0,0,1,0,0,1,4
401365839,Dayton Flyers,Z. Nwokeji,4618121,,False,8.0,0,0,0,0,0,0,0,0,0,1,1,1,0,0,2,4,0
401365839,Dayton Flyers,C. Wilson,4403456,,False,3.0,1,1,1,1,0,0,0,0,0,0,0,0,0,0,0,0,2
401365839,Dayton Flyers,B. Uhl,4897094,,False,1.0,0,0,0,0,0,0,0,0,0,0,0,0,0,0,0,0,0
401365839,Dayton Flyers,D. Swerlein,4600089,,False,2.0,0,1,0,1,0,0,0,0,0,1,1,0,0,0,1,0,0
401365839,Dayton Flyers,K. Brea,4591259,,False,17.0,2,5,1,3,1,2,0,0,0,6,6,1,0,0,1,2,5
401365839,Dayton Flyers,E. Weaver,4397139,,False,18.0,2,3,1,2,1,1,0,0,0,0,0,2,0,0,1,3,5
401365839,Dayton Flyers,TEAM,TOTAL,TOTAL,False,,33,53,23,37,10,16,4,8,6,30,36,22,5,3,16,13,80
401365838,Rhode Island Rams,Makhel Mitchell,4431777,,True,25.0,5,12,5,12,0,0,1,3,0,7,7,0,0,1,2,4,11
401365838,Rhode Island Rams,Makhi Mitchell,4431708,,True,29.0,5,9,4,8,1,1,5,6,4,7,11,2,0,2,0,4,16
401365838,Rhode Island Rams,I. Leggett,4606837,,True,29.0,0,4,0,3,0,1,6,6,2,3,5,2,0,1,0,2,6
401365838,Rhode Island Rams,I. El-Amin,4279313,,True,17.0,1,3,0,0,1,3,0,0,0,1,1,0,0,0,1,1,3
401365838,Rhode Island Rams,J. Sheppard,4066445,,True,27.0,7,11,4,6,3,5,6,6,0,3,3,3,1,0,4,0,23
401365838,Rhode Island Rams,A. Walker,4278567,,False,22.0,3,5,2,3,1,2,0,0,2,5,7,4,0,1,2,2,7
401365838,Rhode Island Rams,M. Martin,4397470,,False,23.0,0,1,0,1,0,0,1,2,1,2,3,0,2,0,1,1,1
401365838,Rhode Island Rams,J. Carey,4395673,,False,16.0,2,7,1,6,1,1,0,0,1,1,2,1,0,0,0,0,5
401365838,Rhode Island Rams,S. Thomas,4897065,,False,12.0,0,1,0,1,0,0,0,0,0,2,2,1,0,0,2,0,0
401365838,Rhode Island Rams,TEAM,TOTAL,TOTAL,False,,23,53,16,40,7,13,19,23,13,33,46,13,3,5,13,14,72
401365838,Rhode Island Rams,Makhel Mitchell,4431777,,True,25.0,5,12,5,12,0,0,1,3,0,7,7,0,0,1,2,4,11
401365838,Rhode Island Rams,Makhi Mitchell,4431708,,True,29.0,5,9,4,8,1,1,5,6,4,7,11,2,0,2,0,4,16
401365838,Rhode Island Rams,I. Leggett,4606837,,True,29.0,0,4,0,3,0,1,6,6,2,3,5,2,0,1,0,2,6
401365838,Rhode Island Rams,I. El-Amin,4279313,,True,17.0,1,3,0,0,1,3,0,0,0,1,1,0,0,0,1,1,3
401365838,Rhode Island Rams,J. Sheppard,4066445,,True,27.0,7,11,4,6,3,5,6,6,0,3,3,3,1,0,4,0,23
401365838,Rhode Island Rams,A. Walker,4278567,,False,22.0,3,5,2,3,1,2,0,0,2,5,7,4,0,1,2,2,7
401365838,Rhode Island Rams,M. Martin,4397470,,False,23.0,0,1,0,1,0,0,1,2,1,2,3,0,2,0,1,1,1
401365838,Rhode Island Rams,J. Carey,4395673,,False,16.0,2,7,1,6,1,1,0,0,1,1,2,1,0,0,0,0,5
401365838,Rhode Island Rams,S. Thomas,4897065,,False,12.0,0,1,0,1,0,0,0,0,0,2,2,1,0,0,2,0,0
401365838,Rhode Island Rams,TEAM,TOTAL,TOTAL,False,,23,53,16,40,7,13,19,23,13,33,46,13,3,5,13,14,72
401365838,Davidson Wildcats,S. Mennenga,4700862,,True,27.0,0,0,0,0,0,0,3,4,1,2,3,0,0,0,0,0,3
401365838,Davidson Wildcats,L. Brajkovic,4396787,,True,33.0,4,12,4,8,0,4,0,0,2,5,7,2,0,3,0,4,8
401365838,Davidson Wildcats,H. Lee,4592308,,True,30.0,6,15,6,10,0,5,5,5,1,2,3,1,1,1,1,4,17
401365838,Davidson Wildcats,F. Loyer,4397208,,True,32.0,8,18,4,8,4,10,0,0,0,3,3,2,3,0,1,3,20
401365838,Davidson Wildcats,M. Jones,4396784,,True,38.0,5,12,3,5,2,7,1,1,1,6,7,1,1,0,0,3,13
401365838,Davidson Wildcats,N. Boachie-Yiadom,4396786,,False,17.0,0,1,0,1,0,0,0,0,1,0,1,1,0,0,0,3,0
401365838,Davidson Wildcats,D. Watson,4897098,,False,2.0,0,0,0,0,0,0,0,0,0,0,0,0,0,0,1,0,0
401365838,Davidson Wildcats,G. Huffman,4432522,,False,21.0,1,5,0,3,1,2,1,2,1,2,3,0,1,0,0,1,4
401365838,Davidson Wildcats,TEAM,TOTAL,TOTAL,False,,24,63,17,35,7,28,10,12,8,20,28,7,6,4,4,18,65
401365838,Davidson Wildcats,S. Mennenga,4700862,,True,27.0,0,0,0,0,0,0,3,4,1,2,3,0,0,0,0,0,3
401365838,Davidson Wildcats,L. Brajkovic,4396787,,True,33.0,4,12,4,8,0,4,0,0,2,5,7,2,0,3,0,4,8
401365838,Davidson Wildcats,H. Lee,4592308,,True,30.0,6,15,6,10,0,5,5,5,1,2,3,1,1,1,1,4,17
401365838,Davidson Wildcats,F. Loyer,4397208,,True,32.0,8,18,4,8,4,10,0,0,0,3,3,2,3,0,1,3,20
401365838,Davidson Wildcats,M. Jones,4396784,,True,38.0,5,12,3,5,2,7,1,1,1,6,7,1,1,0,0,3,13
401365838,Davidson Wildcats,N. Boachie-Yiadom,4396786,,False,17.0,0,1,0,1,0,0,0,0,1,0,1,1,0,0,0,3,0
401365838,Davidson Wildcats,D. Watson,4897098,,False,2.0,0,0,0,0,0,0,0,0,0,0,0,0,0,0,1,0,0
401365838,Davidson Wildcats,G. Huffman,4432522,,False,21.0,1,5,0,3,1,2,1,2,1,2,3,0,1,0,0,1,4
401365838,Davidson Wildcats,TEAM,TOTAL,TOTAL,False,,24,63,17,35,7,28,10,12,8,20,28,7,6,4,4,18,65
401365837,Richmond Spiders,T. Burton,4431914,,True,36.0,5,10,4,7,1,3,4,4,3,7,10,0,0,1,2,1,15
401365837,Richmond Spiders,N. Cayo,4278380,,True,19.0,4,6,4,6,0,0,4,6,0,1,1,1,1,0,0,4,12
401365837,Richmond Spiders,G. Golden,4066836,,True,28.0,7,13,7,12,0,1,1,1,1,7,8,4,0,0,3,0,15
401365837,Richmond Spiders,A. Gustavson,4397193,,True,33.0,1,3,0,2,1,1,3,5,2,1,3,6,0,0,1,2,6
401365837,Richmond Spiders,J. Gilyard,4278378,,True,39.0,4,12,3,9,1,3,2,2,1,5,6,5,4,1,1,1,11
401365837,Richmond Spiders,M. Grace,4397192,,False,19.0,1,3,1,1,0,2,2,2,0,6,6,1,0,0,0,0,4
401365837,Richmond Spiders,S. Koureissi,4397190,,False,1.0,0,0,0,0,0,0,0,0,0,0,0,0,0,0,0,0,0
401365837,Richmond Spiders,M. Randolph,4710356,,False,3.0,0,0,0,0,0,0,0,0,0,0,0,0,0,0,0,0,0
401365837,Richmond Spiders,C. Crabtree,4396658,,False,5.0,0,0,0,0,0,0,2,2,0,1,1,0,0,0,0,0,2
401365837,Richmond Spiders,N. Sherod,4066832,,False,17.0,4,8,0,0,4,8,0,0,0,0,0,0,0,0,2,1,12
401365837,Richmond Spiders,TEAM,TOTAL,TOTAL,False,,26,55,19,37,7,18,18,22,8,29,37,17,5,2,9,9,77
401365837,Richmond Spiders,T. Burton,4431914,,True,36.0,5,10,4,7,1,3,4,4,3,7,10,0,0,1,2,1,15
401365837,Richmond Spiders,N. Cayo,4278380,,True,19.0,4,6,4,6,0,0,4,6,0,1,1,1,1,0,0,4,12
401365837,Richmond Spiders,G. Golden,4066836,,True,28.0,7,13,7,12,0,1,1,1,1,7,8,4,0,0,3,0,15
401365837,Richmond Spiders,A. Gustavson,4397193,,True,33.0,1,3,0,2,1,1,3,5,2,1,3,6,0,0,1,2,6
401365837,Richmond Spiders,J. Gilyard,4278378,,True,39.0,4,12,3,9,1,3,2,2,1,5,6,5,4,1,1,1,11
401365837,Richmond Spiders,M. Grace,4397192,,False,19.0,1,3,1,1,0,2,2,2,0,6,6,1,0,0,0,0,4
401365837,Richmond Spiders,S. Koureissi,4397190,,False,1.0,0,0,0,0,0,0,0,0,0,0,0,0,0,0,0,0,0
401365837,Richmond Spiders,M. Randolph,4710356,,False,3.0,0,0,0,0,0,0,0,0,0,0,0,0,0,0,0,0,0
401365837,Richmond Spiders,C. Crabtree,4396658,,False,5.0,0,0,0,0,0,0,2,2,0,1,1,0,0,0,0,0,2
401365837,Richmond Spiders,N. Sherod,4066832,,False,17.0,4,8,0,0,4,8,0,0,0,0,0,0,0,0,2,1,12
401365837,Richmond Spiders,TEAM,TOTAL,TOTAL,False,,26,55,19,37,7,18,18,22,8,29,37,17,5,2,9,9,77
401365837,La Salle Explorers,M. Doucoure,4277988,,True,14.0,0,1,0,1,0,0,0,0,0,1,1,0,0,0,1,2,0
401365837,La Salle Explorers,C. Moore,4277945,,True,33.0,6,12,5,8,1,4,4,5,2,3,5,2,0,3,1,4,17
401365837,La Salle Explorers,J. Clark,4397152,,True,38.0,7,17,4,6,3,11,2,3,0,5,5,0,4,0,2,5,19
401365837,La Salle Explorers,J. Brickus,4700970,,True,34.0,3,9,2,7,1,2,0,0,2,2,4,4,0,0,2,3,7
401365837,La Salle Explorers,J. Nickelberry,4432845,,True,33.0,4,7,3,4,1,3,0,1,0,5,5,0,0,0,2,4,9
401365837,La Salle Explorers,D. Shepherd,4710357,,False,9.0,1,3,0,1,1,2,0,0,0,0,0,1,0,0,0,0,3
401365837,La Salle Explorers,K. Brantley,4709132,,False,18.0,2,4,1,3,1,1,3,4,0,1,1,1,1,0,1,1,8
401365837,La Salle Explorers,C. Ray,4592448,,False,21.0,0,1,0,1,0,0,0,0,1,6,7,3,0,0,2,4,0
401365837,La Salle Explorers,TEAM,TOTAL,TOTAL,False,,23,54,15,31,8,23,9,13,5,23,28,11,5,3,13,23,63
401365837,La Salle Explorers,M. Doucoure,4277988,,True,14.0,0,1,0,1,0,0,0,0,0,1,1,0,0,0,1,2,0
401365837,La Salle Explorers,C. Moore,4277945,,True,33.0,6,12,5,8,1,4,4,5,2,3,5,2,0,3,1,4,17
401365837,La Salle Explorers,J. Clark,4397152,,True,38.0,7,17,4,6,3,11,2,3,0,5,5,0,4,0,2,5,19
401365837,La Salle Explorers,J. Brickus,4700970,,True,34.0,3,9,2,7,1,2,0,0,2,2,4,4,0,0,2,3,7
401365837,La Salle Explorers,J. Nickelberry,4432845,,True,33.0,4,7,3,4,1,3,0,1,0,5,5,0,0,0,2,4,9
401365837,La Salle Explorers,D. Shepherd,4710357,,False,9.0,1,3,0,1,1,2,0,0,0,0,0,1,0,0,0,0,3
401365837,La Salle Explorers,K. Brantley,4709132,,False,18.0,2,4,1,3,1,1,3,4,0,1,1,1,1,0,1,1,8
401365837,La Salle Explorers,C. Ray,4592448,,False,21.0,0,1,0,1,0,0,0,0,1,6,7,3,0,0,2,4,0
401365837,La Salle Explorers,TEAM,TOTAL,TOTAL,False,,23,54,15,31,8,23,9,13,5,23,28,11,5,3,13,23,63
401365836,St. Bonaventure Bonnies,O. Osunniyi,4397224,,True,26.0,6,8,6,8,0,0,0,2,2,4,6,2,1,6,0,4,12
401365836,St. Bonaventure Bonnies,J. Adaway,4279431,,True,37.0,5,14,4,11,1,3,4,5,0,5,5,0,0,0,0,1,15
401365836,St. Bonaventure Bonnies,J. Holmes,4701016,,True,40.0,5,10,4,7,1,3,1,3,1,7,8,1,2,0,4,2,12
401365836,St. Bonaventure Bonnies,D. Welch,4397221,,True,40.0,4,9,3,4,1,5,0,0,1,4,5,0,1,1,1,2,9
401365836,St. Bonaventure Bonnies,K. Lofton,4397220,,True,40.0,7,12,7,10,0,2,2,2,0,2,2,8,4,1,2,0,16
401365836,St. Bonaventure Bonnies,A. Coulibaly,4432889,,False,14.0,2,4,2,4,0,0,0,0,0,0,0,0,3,0,0,5,4
401365836,St. Bonaventure Bonnies,Q. Adams,4585591,,False,3.0,0,1,0,1,0,0,0,0,0,0,0,0,1,0,0,0,0
401365836,St. Bonaventure Bonnies,TEAM,TOTAL,TOTAL,False,,29,58,26,45,3,13,7,12,5,25,30,11,12,8,7,14,68
401365836,St. Bonaventure Bonnies,O. Osunniyi,4397224,,True,26.0,6,8,6,8,0,0,0,2,2,4,6,2,1,6,0,4,12
401365836,St. Bonaventure Bonnies,J. Adaway,4279431,,True,37.0,5,14,4,11,1,3,4,5,0,5,5,0,0,0,0,1,15
401365836,St. Bonaventure Bonnies,J. Holmes,4701016,,True,40.0,5,10,4,7,1,3,1,3,1,7,8,1,2,0,4,2,12
401365836,St. Bonaventure Bonnies,D. Welch,4397221,,True,40.0,4,9,3,4,1,5,0,0,1,4,5,0,1,1,1,2,9
401365836,St. Bonaventure Bonnies,K. Lofton,4397220,,True,40.0,7,12,7,10,0,2,2,2,0,2,2,8,4,1,2,0,16
401365836,St. Bonaventure Bonnies,A. Coulibaly,4432889,,False,14.0,2,4,2,4,0,0,0,0,0,0,0,0,3,0,0,5,4
401365836,St. Bonaventure Bonnies,Q. Adams,4585591,,False,3.0,0,1,0,1,0,0,0,0,0,0,0,0,1,0,0,0,0
401365836,St. Bonaventure Bonnies,TEAM,TOTAL,TOTAL,False,,29,58,26,45,3,13,7,12,5,25,30,11,12,8,7,14,68
401365836,Saint Louis Billikens,F. Okoro,4397105,,True,25.0,6,10,6,10,0,0,2,3,1,3,4,0,1,1,3,1,14
401365836,Saint Louis Billikens,J. Nesbitt,4714246,,True,24.0,0,4,0,2,0,2,0,0,2,5,7,1,0,1,3,2,0
401365836,Saint Louis Billikens,Y. Collins,4432957,,True,40.0,8,15,7,13,1,2,1,1,0,4,4,7,2,0,8,3,18
401365836,Saint Louis Billikens,G. Jimerson,4432008,,True,38.0,2,10,0,1,2,9,0,2,0,3,3,0,0,0,0,2,6
401365836,Saint Louis Billikens,F. Thatch Jr.,4397199,,True,29.0,3,9,1,6,2,3,0,0,2,5,7,0,2,0,3,5,8
401365836,Saint Louis Billikens,T. Hargrove Jr.,4592484,,False,24.0,2,5,1,1,1,4,0,0,1,4,5,1,0,0,1,0,5
401365836,Saint Louis Billikens,M. Linssen,4279174,,False,15.0,3,3,3,3,0,0,4,6,0,3,3,0,0,0,0,2,10
401365836,Saint Louis Billikens,R. Williams,4399106,,False,5.0,0,1,0,0,0,1,0,0,0,0,0,0,0,0,0,1,0
401365836,Saint Louis Billikens,TEAM,TOTAL,TOTAL,False,,24,57,18,36,6,21,7,12,11,28,39,9,5,2,18,16,61
401365836,Saint Louis Billikens,F. Okoro,4397105,,True,25.0,6,10,6,10,0,0,2,3,1,3,4,0,1,1,3,1,14
401365836,Saint Louis Billikens,J. Nesbitt,4714246,,True,24.0,0,4,0,2,0,2,0,0,2,5,7,1,0,1,3,2,0
401365836,Saint Louis Billikens,Y. Collins,4432957,,True,40.0,8,15,7,13,1,2,1,1,0,4,4,7,2,0,8,3,18
401365836,Saint Louis Billikens,G. Jimerson,4432008,,True,38.0,2,10,0,1,2,9,0,2,0,3,3,0,0,0,0,2,6
401365836,Saint Louis Billikens,F. Thatch Jr.,4397199,,True,29.0,3,9,1,6,2,3,0,0,2,5,7,0,2,0,3,5,8
401365836,Saint Louis Billikens,T. Hargrove Jr.,4592484,,False,24.0,2,5,1,1,1,4,0,0,1,4,5,1,0,0,1,0,5
401365836,Saint Louis Billikens,M. Linssen,4279174,,False,15.0,3,3,3,3,0,0,4,6,0,3,3,0,0,0,0,2,10
401365836,Saint Louis Billikens,R. Williams,4399106,,False,5.0,0,1,0,0,0,1,0,0,0,0,0,0,0,0,0,1,0
401365836,Saint Louis Billikens,TEAM,TOTAL,TOTAL,False,,24,57,18,36,6,21,7,12,11,28,39,9,5,2,18,16,61
401365835,Massachusetts Minutemen,T. Buttrick,4277981,,True,32.0,5,11,3,6,2,5,5,6,2,9,11,1,1,1,2,1,17
401365835,Massachusetts Minutemen,T.J. Weeks,4433108,,True,29.0,3,8,1,1,2,7,0,2,1,1,2,2,0,1,0,2,8
401365835,Massachusetts Minutemen,N. Fernandes,4431791,,True,32.0,1,11,1,8,0,3,2,2,0,2,2,4,1,0,1,4,4
401365835,Massachusetts Minutemen,C.J. Kelly,4398208,,True,27.0,3,9,2,4,1,5,3,3,0,4,4,4,0,1,1,1,10
401365835,Massachusetts Minutemen,R. Kelly,4279741,,True,35.0,6,8,4,4,2,4,1,1,0,2,2,4,2,0,2,3,15
401365835,Massachusetts Minutemen,M. Steadman,4397393,,False,10.0,3,4,3,4,0,0,1,1,2,2,4,0,1,0,1,1,7
401365835,Massachusetts Minutemen,G. Jones,4279211,,False,13.0,2,4,2,3,0,1,0,0,0,0,0,0,0,0,2,1,4
401365835,Massachusetts Minutemen,J. Garcia,4701125,,False,22.0,1,4,0,2,1,2,0,0,0,1,1,0,1,1,0,3,3
401365835,Massachusetts Minutemen,TEAM,TOTAL,TOTAL,False,,24,59,16,32,8,27,12,15,6,23,29,15,6,4,9,16,68
401365835,Massachusetts Minutemen,T. Buttrick,4277981,,True,32.0,5,11,3,6,2,5,5,6,2,9,11,1,1,1,2,1,17
401365835,Massachusetts Minutemen,T.J. Weeks,4433108,,True,29.0,3,8,1,1,2,7,0,2,1,1,2,2,0,1,0,2,8
401365835,Massachusetts Minutemen,N. Fernandes,4431791,,True,32.0,1,11,1,8,0,3,2,2,0,2,2,4,1,0,1,4,4
401365835,Massachusetts Minutemen,C.J. Kelly,4398208,,True,27.0,3,9,2,4,1,5,3,3,0,4,4,4,0,1,1,1,10
401365835,Massachusetts Minutemen,R. Kelly,4279741,,True,35.0,6,8,4,4,2,4,1,1,0,2,2,4,2,0,2,3,15
401365835,Massachusetts Minutemen,M. Steadman,4397393,,False,10.0,3,4,3,4,0,0,1,1,2,2,4,0,1,0,1,1,7
401365835,Massachusetts Minutemen,G. Jones,4279211,,False,13.0,2,4,2,3,0,1,0,0,0,0,0,0,0,0,2,1,4
401365835,Massachusetts Minutemen,J. Garcia,4701125,,False,22.0,1,4,0,2,1,2,0,0,0,1,1,0,1,1,0,3,3
401365835,Massachusetts Minutemen,TEAM,TOTAL,TOTAL,False,,24,59,16,32,8,27,12,15,6,23,29,15,6,4,9,16,68
401365835,George Washington Revolutionaries,H. Dean,4593273,,True,32.0,4,5,4,5,0,0,2,3,4,8,12,2,0,0,1,3,10
401365835,George Washington Revolutionaries,Q. Samuels,4592251,,True,12.0,0,2,0,2,0,0,0,0,1,1,2,0,0,0,0,1,0
401365835,George Washington Revolutionaries,J. Bamisile,4432537,,True,26.0,5,12,4,8,1,4,2,2,1,4,5,0,0,0,2,3,13
401365835,George Washington Revolutionaries,J. Bishop,4431770,,True,34.0,8,18,8,13,0,5,8,11,0,1,1,3,1,0,2,2,24
401365835,George Washington Revolutionaries,B. Adams,4396612,,True,34.0,3,9,0,4,3,5,4,4,0,1,1,5,2,0,1,2,13
401365835,George Washington Revolutionaries,R. Lindo Jr.,4397186,,False,19.0,1,3,1,2,0,1,0,0,1,6,7,1,0,1,3,1,2
401365835,George Washington Revolutionaries,N. Brown,4700963,,False,3.0,0,0,0,0,0,0,0,0,0,0,0,0,0,0,1,1,0
401365835,George Washington Revolutionaries,B. Freeman,4613126,,False,36.0,7,11,6,9,1,2,0,1,1,4,5,5,1,0,3,3,15
401365835,George Washington Revolutionaries,A. Harris,4397216,,False,4.0,0,0,0,0,0,0,0,0,1,0,1,0,0,0,0,0,0
401365835,George Washington Revolutionaries,TEAM,TOTAL,TOTAL,False,,28,60,23,43,5,17,16,21,12,29,41,16,4,1,13,16,77
401365835,George Washington Revolutionaries,H. Dean,4593273,,True,32.0,4,5,4,5,0,0,2,3,4,8,12,2,0,0,1,3,10
401365835,George Washington Revolutionaries,Q. Samuels,4592251,,True,12.0,0,2,0,2,0,0,0,0,1,1,2,0,0,0,0,1,0
401365835,George Washington Revolutionaries,J. Bamisile,4432537,,True,26.0,5,12,4,8,1,4,2,2,1,4,5,0,0,0,2,3,13
401365835,George Washington Revolutionaries,J. Bishop,4431770,,True,34.0,8,18,8,13,0,5,8,11,0,1,1,3,1,0,2,2,24
401365835,George Washington Revolutionaries,B. Adams,4396612,,True,34.0,3,9,0,4,3,5,4,4,0,1,1,5,2,0,1,2,13
401365835,George Washington Revolutionaries,R. Lindo Jr.,4397186,,False,19.0,1,3,1,2,0,1,0,0,1,6,7,1,0,1,3,1,2
401365835,George Washington Revolutionaries,N. Brown,4700963,,False,3.0,0,0,0,0,0,0,0,0,0,0,0,0,0,0,1,1,0
401365835,George Washington Revolutionaries,B. Freeman,4613126,,False,36.0,7,11,6,9,1,2,0,1,1,4,5,5,1,0,3,3,15
401365835,George Washington Revolutionaries,A. Harris,4397216,,False,4.0,0,0,0,0,0,0,0,0,1,0,1,0,0,0,0,0,0
401365835,George Washington Revolutionaries,TEAM,TOTAL,TOTAL,False,,28,60,23,43,5,17,16,21,12,29,41,16,4,1,13,16,77
401365834,Richmond Spiders,T. Burton,4431914,,True,40.0,6,14,6,12,0,2,3,3,0,8,8,1,1,1,4,4,15
401365834,Richmond Spiders,N. Cayo,4278380,,True,29.0,3,5,3,5,0,0,4,8,3,3,6,1,0,0,3,4,10
401365834,Richmond Spiders,G. Golden,4066836,,True,31.0,9,15,7,10,2,5,3,4,2,6,8,1,0,0,2,3,23
401365834,Richmond Spiders,A. Gustavson,4397193,,True,33.0,3,4,0,1,3,3,0,0,1,2,3,2,1,1,1,0,9
401365834,Richmond Spiders,J. Gilyard,4278378,,True,45.0,4,14,1,6,3,8,2,2,0,7,7,11,1,0,1,3,13
401365834,Richmond Spiders,M. Grace,4397192,,False,18.0,2,2,0,0,2,2,0,0,0,2,2,0,0,1,1,3,6
401365834,Richmond Spiders,I. Wilson,4700973,,False,5.0,0,2,0,0,0,2,0,0,0,0,0,0,0,0,0,0,0
401365834,Richmond Spiders,C. Crabtree,4396658,,False,7.0,1,4,1,3,0,1,0,0,0,0,0,0,0,0,1,0,2
401365834,Richmond Spiders,N. Sherod,4066832,,False,17.0,2,3,0,0,2,3,0,0,0,0,0,0,1,0,0,0,6
401365834,Richmond Spiders,TEAM,TOTAL,TOTAL,False,,30,63,18,37,12,26,12,17,9,29,38,16,4,3,14,17,84
401365834,Richmond Spiders,T. Burton,4431914,,True,40.0,6,14,6,12,0,2,3,3,0,8,8,1,1,1,4,4,15
401365834,Richmond Spiders,N. Cayo,4278380,,True,29.0,3,5,3,5,0,0,4,8,3,3,6,1,0,0,3,4,10
401365834,Richmond Spiders,G. Golden,4066836,,True,31.0,9,15,7,10,2,5,3,4,2,6,8,1,0,0,2,3,23
401365834,Richmond Spiders,A. Gustavson,4397193,,True,33.0,3,4,0,1,3,3,0,0,1,2,3,2,1,1,1,0,9
401365834,Richmond Spiders,J. Gilyard,4278378,,True,45.0,4,14,1,6,3,8,2,2,0,7,7,11,1,0,1,3,13
401365834,Richmond Spiders,M. Grace,4397192,,False,18.0,2,2,0,0,2,2,0,0,0,2,2,0,0,1,1,3,6
401365834,Richmond Spiders,I. Wilson,4700973,,False,5.0,0,2,0,0,0,2,0,0,0,0,0,0,0,0,0,0,0
401365834,Richmond Spiders,C. Crabtree,4396658,,False,7.0,1,4,1,3,0,1,0,0,0,0,0,0,0,0,1,0,2
401365834,Richmond Spiders,N. Sherod,4066832,,False,17.0,2,3,0,0,2,3,0,0,0,0,0,0,1,0,0,0,6
401365834,Richmond Spiders,TEAM,TOTAL,TOTAL,False,,30,63,18,37,12,26,12,17,9,29,38,16,4,3,14,17,84
401365834,George Mason Patriots,J. Oduro,4432068,,True,39.0,9,21,9,19,0,2,4,4,8,6,14,5,2,2,4,4,22
401365834,George Mason Patriots,X. Johnson,4592439,,True,44.0,6,11,3,6,3,5,2,3,0,3,3,9,1,0,2,3,17
401365834,George Mason Patriots,D. Gaines,4431961,,True,38.0,1,10,1,6,0,4,3,4,1,7,8,0,1,1,0,4,5
401365834,George Mason Patriots,D. Cooper,4279876,,True,38.0,4,9,1,2,3,7,0,0,0,2,2,1,0,0,0,3,11
401365834,George Mason Patriots,D. Schwartz,4278501,,True,33.0,7,14,1,3,6,11,4,4,0,4,4,0,1,0,0,2,24
401365834,George Mason Patriots,B. Jones,4897083,,False,6.0,0,1,0,0,0,1,0,0,0,1,1,1,0,1,1,1,0
401365834,George Mason Patriots,M. Henry,4606836,,False,0.0,0,0,0,0,0,0,0,0,0,0,0,0,0,0,0,0,0
401365834,George Mason Patriots,O. Frazier III,4700882,,False,6.0,2,3,1,1,1,2,0,0,0,1,1,0,0,0,0,1,5
401365834,George Mason Patriots,B. Buchanan,4395691,,False,20.0,1,2,0,0,1,2,0,0,2,2,4,0,0,0,0,0,3
401365834,George Mason Patriots,J. Hartwell II,4396817,,False,1.0,0,0,0,0,0,0,0,0,0,0,0,0,1,0,0,0,0
401365834,George Mason Patriots,TEAM,TOTAL,TOTAL,False,,30,71,16,37,14,34,13,15,12,26,38,16,6,4,8,18,87
401365834,George Mason Patriots,J. Oduro,4432068,,True,39.0,9,21,9,19,0,2,4,4,8,6,14,5,2,2,4,4,22
401365834,George Mason Patriots,X. Johnson,4592439,,True,44.0,6,11,3,6,3,5,2,3,0,3,3,9,1,0,2,3,17
401365834,George Mason Patriots,D. Gaines,4431961,,True,38.0,1,10,1,6,0,4,3,4,1,7,8,0,1,1,0,4,5
401365834,George Mason Patriots,D. Cooper,4279876,,True,38.0,4,9,1,2,3,7,0,0,0,2,2,1,0,0,0,3,11
401365834,George Mason Patriots,D. Schwartz,4278501,,True,33.0,7,14,1,3,6,11,4,4,0,4,4,0,1,0,0,2,24
401365834,George Mason Patriots,B. Jones,4897083,,False,6.0,0,1,0,0,0,1,0,0,0,1,1,1,0,1,1,1,0
401365834,George Mason Patriots,M. Henry,4606836,,False,0.0,0,0,0,0,0,0,0,0,0,0,0,0,0,0,0,0,0
401365834,George Mason Patriots,O. Frazier III,4700882,,False,6.0,2,3,1,1,1,2,0,0,0,1,1,0,0,0,0,1,5
401365834,George Mason Patriots,B. Buchanan,4395691,,False,20.0,1,2,0,0,1,2,0,0,2,2,4,0,0,0,0,0,3
401365834,George Mason Patriots,J. Hartwell II,4396817,,False,1.0,0,0,0,0,0,0,0,0,0,0,0,0,1,0,0,0,0
401365834,George Mason Patriots,TEAM,TOTAL,TOTAL,False,,30,71,16,37,14,34,13,15,12,26,38,16,6,4,8,18,87
401365833,Duquesne Dukes,T. Williams,4432147,,True,35.0,5,9,4,8,1,1,1,2,2,1,3,2,2,2,1,2,12
401365833,Duquesne Dukes,K. Easley,4398159,,True,29.0,2,8,1,4,1,4,0,0,1,5,6,0,1,0,0,2,5
401365833,Duquesne Dukes,A. Spears,4897090,,True,37.0,4,12,2,9,2,3,0,0,0,5,5,3,0,1,4,1,10
401365833,Duquesne Dukes,T. Okani,4700873,,True,27.0,2,5,1,4,1,1,1,2,4,0,4,2,1,0,2,0,6
401365833,Duquesne Dukes,T. Acuff,4606831,,True,22.0,3,6,3,4,0,2,0,0,1,1,2,1,0,0,0,0,6
401365833,Duquesne Dukes,M. Hima,4700878,,False,10.0,0,1,0,1,0,0,0,0,2,2,4,0,0,1,0,2,0
401365833,Duquesne Dukes,D. Larson,4897091,,False,7.0,1,2,1,2,0,0,2,2,1,1,2,0,0,0,0,0,4
401365833,Duquesne Dukes,J. Johnson III,4897088,,False,16.0,4,6,3,3,1,3,2,2,0,0,0,1,1,0,2,0,11
401365833,Duquesne Dukes,L. Ayers III,4703813,,False,14.0,0,3,0,1,0,2,0,0,0,0,0,1,0,1,2,1,0
401365833,Duquesne Dukes,M. Bekelja,4700874,,False,3.0,0,0,0,0,0,0,0,0,0,0,0,0,0,0,0,0,0
401365833,Duquesne Dukes,TEAM,TOTAL,TOTAL,False,,21,52,15,36,6,16,6,8,11,15,26,10,5,5,11,8,54
401365833,Duquesne Dukes,T. Williams,4432147,,True,35.0,5,9,4,8,1,1,1,2,2,1,3,2,2,2,1,2,12
401365833,Duquesne Dukes,K. Easley,4398159,,True,29.0,2,8,1,4,1,4,0,0,1,5,6,0,1,0,0,2,5
401365833,Duquesne Dukes,A. Spears,4897090,,True,37.0,4,12,2,9,2,3,0,0,0,5,5,3,0,1,4,1,10
401365833,Duquesne Dukes,T. Okani,4700873,,True,27.0,2,5,1,4,1,1,1,2,4,0,4,2,1,0,2,0,6
401365833,Duquesne Dukes,T. Acuff,4606831,,True,22.0,3,6,3,4,0,2,0,0,1,1,2,1,0,0,0,0,6
401365833,Duquesne Dukes,M. Hima,4700878,,False,10.0,0,1,0,1,0,0,0,0,2,2,4,0,0,1,0,2,0
401365833,Duquesne Dukes,D. Larson,4897091,,False,7.0,1,2,1,2,0,0,2,2,1,1,2,0,0,0,0,0,4
401365833,Duquesne Dukes,J. Johnson III,4897088,,False,16.0,4,6,3,3,1,3,2,2,0,0,0,1,1,0,2,0,11
401365833,Duquesne Dukes,L. Ayers III,4703813,,False,14.0,0,3,0,1,0,2,0,0,0,0,0,1,0,1,2,1,0
401365833,Duquesne Dukes,M. Bekelja,4700874,,False,3.0,0,0,0,0,0,0,0,0,0,0,0,0,0,0,0,0,0
401365833,Duquesne Dukes,TEAM,TOTAL,TOTAL,False,,21,52,15,36,6,16,6,8,11,15,26,10,5,5,11,8,54
401365833,Dayton Flyers,R.J. Blakney,4700864,,True,19.0,4,6,4,6,0,0,0,0,0,0,0,0,1,0,1,0,8
401365833,Dayton Flyers,T. Camara,4431736,,True,16.0,5,7,5,7,0,0,0,0,1,1,2,0,1,1,2,3,10
401365833,Dayton Flyers,D. Holmes II,4433607,,True,23.0,3,4,3,4,0,0,1,2,1,5,6,3,0,0,0,0,7
401365833,Dayton Flyers,M. Smith,4683861,,True,26.0,3,8,3,8,0,0,1,2,2,2,4,8,1,0,1,0,7
401365833,Dayton Flyers,K. Elvis,4683135,,True,27.0,5,6,2,2,3,4,0,2,0,0,0,3,3,0,1,1,13
401365833,Dayton Flyers,M. Sissoko,4431824,,False,14.0,3,3,3,3,0,0,0,0,0,1,1,0,0,0,0,2,6
401365833,Dayton Flyers,M. Amzil,4711607,,False,23.0,3,3,3,3,0,0,0,0,3,4,7,1,0,1,0,1,6
401365833,Dayton Flyers,K. Washington,4684293,,False,5.0,0,0,0,0,0,0,0,0,0,1,1,0,0,0,0,0,0
401365833,Dayton Flyers,Z. Nwokeji,4618121,,False,4.0,0,2,0,1,0,1,0,0,1,0,1,0,0,0,0,0,0
401365833,Dayton Flyers,C. Wilson,4403456,,False,3.0,1,1,0,0,1,1,0,0,0,0,0,0,0,0,0,0,3
401365833,Dayton Flyers,D. Swerlein,4600089,,False,1.0,1,1,1,1,0,0,0,0,0,0,0,0,0,0,0,1,2
401365833,Dayton Flyers,K. Brea,4591259,,False,22.0,2,5,0,1,2,4,0,0,1,5,6,1,0,0,1,1,6
401365833,Dayton Flyers,E. Weaver,4397139,,False,17.0,3,9,2,6,1,3,0,0,0,0,0,1,0,0,1,2,7
401365833,Dayton Flyers,TEAM,TOTAL,TOTAL,False,,33,55,26,42,7,13,2,6,9,21,30,17,6,2,7,11,75
401365833,Dayton Flyers,R.J. Blakney,4700864,,True,19.0,4,6,4,6,0,0,0,0,0,0,0,0,1,0,1,0,8
401365833,Dayton Flyers,T. Camara,4431736,,True,16.0,5,7,5,7,0,0,0,0,1,1,2,0,1,1,2,3,10
401365833,Dayton Flyers,D. Holmes II,4433607,,True,23.0,3,4,3,4,0,0,1,2,1,5,6,3,0,0,0,0,7
401365833,Dayton Flyers,M. Smith,4683861,,True,26.0,3,8,3,8,0,0,1,2,2,2,4,8,1,0,1,0,7
401365833,Dayton Flyers,K. Elvis,4683135,,True,27.0,5,6,2,2,3,4,0,2,0,0,0,3,3,0,1,1,13
401365833,Dayton Flyers,M. Sissoko,4431824,,False,14.0,3,3,3,3,0,0,0,0,0,1,1,0,0,0,0,2,6
401365833,Dayton Flyers,M. Amzil,4711607,,False,23.0,3,3,3,3,0,0,0,0,3,4,7,1,0,1,0,1,6
401365833,Dayton Flyers,K. Washington,4684293,,False,5.0,0,0,0,0,0,0,0,0,0,1,1,0,0,0,0,0,0
401365833,Dayton Flyers,Z. Nwokeji,4618121,,False,4.0,0,2,0,1,0,1,0,0,1,0,1,0,0,0,0,0,0
401365833,Dayton Flyers,C. Wilson,4403456,,False,3.0,1,1,0,0,1,1,0,0,0,0,0,0,0,0,0,0,3
401365833,Dayton Flyers,D. Swerlein,4600089,,False,1.0,1,1,1,1,0,0,0,0,0,0,0,0,0,0,0,1,2
401365833,Dayton Flyers,K. Brea,4591259,,False,22.0,2,5,0,1,2,4,0,0,1,5,6,1,0,0,1,1,6
401365833,Dayton Flyers,E. Weaver,4397139,,False,17.0,3,9,2,6,1,3,0,0,0,0,0,1,0,0,1,2,7
401365833,Dayton Flyers,TEAM,TOTAL,TOTAL,False,,33,55,26,42,7,13,2,6,9,21,30,17,6,2,7,11,75
401365832,Saint Joseph's Hawks,T. Funk,4278395,,True,42.0,4,16,2,2,2,14,6,6,0,1,1,2,0,1,1,2,16
401365832,Saint Joseph's Hawks,E. Obinna,4278125,,True,37.0,7,10,7,10,0,0,2,5,7,6,13,1,0,0,6,3,16
401365832,Saint Joseph's Hawks,J. Hall,4701031,,True,45.0,2,12,1,4,1,8,0,0,2,3,5,5,1,0,2,3,5
401365832,Saint Joseph's Hawks,E. Reynolds II,4683952,,True,42.0,7,14,3,6,4,8,2,2,0,1,1,2,1,0,1,5,20
401365832,Saint Joseph's Hawks,C. Brown,4592476,,True,40.0,4,8,2,5,2,3,0,0,1,11,12,3,0,0,1,3,10
401365832,Saint Joseph's Hawks,C. Coleman,4431807,,False,8.0,0,0,0,0,0,0,0,0,0,3,3,1,0,1,1,2,0
401365832,Saint Joseph's Hawks,D. Bishop,4701028,,False,11.0,0,3,0,3,0,0,0,0,1,0,1,0,0,0,0,0,0
401365832,Saint Joseph's Hawks,TEAM,TOTAL,TOTAL,False,,24,63,15,30,9,33,10,13,14,27,41,14,2,2,12,18,67
401365832,Saint Joseph's Hawks,T. Funk,4278395,,True,42.0,4,16,2,2,2,14,6,6,0,1,1,2,0,1,1,2,16
401365832,Saint Joseph's Hawks,E. Obinna,4278125,,True,37.0,7,10,7,10,0,0,2,5,7,6,13,1,0,0,6,3,16
401365832,Saint Joseph's Hawks,J. Hall,4701031,,True,45.0,2,12,1,4,1,8,0,0,2,3,5,5,1,0,2,3,5
401365832,Saint Joseph's Hawks,E. Reynolds II,4683952,,True,42.0,7,14,3,6,4,8,2,2,0,1,1,2,1,0,1,5,20
401365832,Saint Joseph's Hawks,C. Brown,4592476,,True,40.0,4,8,2,5,2,3,0,0,1,11,12,3,0,0,1,3,10
401365832,Saint Joseph's Hawks,C. Coleman,4431807,,False,8.0,0,0,0,0,0,0,0,0,0,3,3,1,0,1,1,2,0
401365832,Saint Joseph's Hawks,D. Bishop,4701028,,False,11.0,0,3,0,3,0,0,0,0,1,0,1,0,0,0,0,0,0
401365832,Saint Joseph's Hawks,TEAM,TOTAL,TOTAL,False,,24,63,15,30,9,33,10,13,14,27,41,14,2,2,12,18,67
401365832,Davidson Wildcats,S. Mennenga,4700862,,True,34.0,3,3,3,3,0,0,1,4,0,1,1,2,0,2,0,1,7
401365832,Davidson Wildcats,L. Brajkovic,4396787,,True,36.0,7,14,7,9,0,5,3,4,2,5,7,3,1,2,2,1,17
401365832,Davidson Wildcats,H. Lee,4592308,,True,40.0,6,16,5,11,1,5,2,2,1,7,8,0,2,1,1,3,15
401365832,Davidson Wildcats,F. Loyer,4397208,,True,42.0,6,15,5,9,1,6,8,8,2,5,7,2,0,0,0,2,21
401365832,Davidson Wildcats,M. Jones,4396784,,True,36.0,4,10,4,6,0,4,3,3,2,2,4,2,1,0,2,0,11
401365832,Davidson Wildcats,N. Boachie-Yiadom,4396786,,False,14.0,1,1,1,1,0,0,0,0,2,3,5,0,0,1,0,2,2
401365832,Davidson Wildcats,D. Watson,4897098,,False,8.0,0,3,0,1,0,2,0,0,1,0,1,0,1,0,0,0,0
401365832,Davidson Wildcats,G. Huffman,4432522,,False,15.0,0,1,0,0,0,1,0,0,1,2,3,0,0,0,0,1,0
401365832,Davidson Wildcats,TEAM,TOTAL,TOTAL,False,,27,63,25,40,2,23,17,21,11,27,38,9,5,6,6,10,73
401365832,Davidson Wildcats,S. Mennenga,4700862,,True,34.0,3,3,3,3,0,0,1,4,0,1,1,2,0,2,0,1,7
401365832,Davidson Wildcats,L. Brajkovic,4396787,,True,36.0,7,14,7,9,0,5,3,4,2,5,7,3,1,2,2,1,17
401365832,Davidson Wildcats,H. Lee,4592308,,True,40.0,6,16,5,11,1,5,2,2,1,7,8,0,2,1,1,3,15
401365832,Davidson Wildcats,F. Loyer,4397208,,True,42.0,6,15,5,9,1,6,8,8,2,5,7,2,0,0,0,2,21
401365832,Davidson Wildcats,M. Jones,4396784,,True,36.0,4,10,4,6,0,4,3,3,2,2,4,2,1,0,2,0,11
401365832,Davidson Wildcats,N. Boachie-Yiadom,4396786,,False,14.0,1,1,1,1,0,0,0,0,2,3,5,0,0,1,0,2,2
401365832,Davidson Wildcats,D. Watson,4897098,,False,8.0,0,3,0,1,0,2,0,0,1,0,1,0,1,0,0,0,0
401365832,Davidson Wildcats,G. Huffman,4432522,,False,15.0,0,1,0,0,0,1,0,0,1,2,3,0,0,0,0,1,0
401365832,Davidson Wildcats,TEAM,TOTAL,TOTAL,False,,27,63,25,40,2,23,17,21,11,27,38,9,5,6,6,10,73
401365831,VCU Rams,H. Ward,4592495,,True,23.0,5,6,5,6,0,0,3,3,2,8,10,1,1,0,4,3,13
401365831,VCU Rams,M. Brown-Jones,4433224,,True,11.0,2,3,2,3,0,0,0,0,1,2,3,0,1,0,1,2,4
401365831,VCU Rams,J. Nunn,4896614,,True,22.0,0,4,0,3,0,1,2,3,0,1,1,1,4,0,1,1,2
401365831,VCU Rams,A. Baldwin Jr.,4433182,,True,36.0,2,6,1,4,1,2,2,4,1,2,3,4,4,0,6,2,7
401365831,VCU Rams,K. Curry,4397228,,True,33.0,9,11,6,8,3,3,7,10,1,4,5,2,0,0,3,3,28
401365831,VCU Rams,J. DeLoach,4432483,,False,16.0,4,6,4,6,0,0,0,0,5,6,11,1,1,2,2,3,8
401365831,VCU Rams,V. Williams Jr.,4397227,,False,26.0,2,10,1,5,1,5,1,2,1,2,3,7,2,1,1,2,6
401365831,VCU Rams,L. Stockard III,4277897,,False,4.0,0,0,0,0,0,0,0,0,0,0,0,0,0,0,2,2,0
401365831,VCU Rams,N. Kern,4684145,,False,6.0,1,1,1,1,0,0,0,0,0,0,0,0,0,0,0,2,2
401365831,VCU Rams,M. Tsohonis,4592438,,False,22.0,1,6,0,1,1,5,0,2,0,2,2,1,1,0,1,0,3
401365831,VCU Rams,J. Banks,4432402,,False,1.0,0,0,0,0,0,0,0,0,0,0,0,0,0,0,0,1,0
401365831,VCU Rams,TEAM,TOTAL,TOTAL,False,,26,53,20,37,6,16,15,24,11,28,39,17,14,3,21,21,73
401365831,VCU Rams,H. Ward,4592495,,True,23.0,5,6,5,6,0,0,3,3,2,8,10,1,1,0,4,3,13
401365831,VCU Rams,M. Brown-Jones,4433224,,True,11.0,2,3,2,3,0,0,0,0,1,2,3,0,1,0,1,2,4
401365831,VCU Rams,J. Nunn,4896614,,True,22.0,0,4,0,3,0,1,2,3,0,1,1,1,4,0,1,1,2
401365831,VCU Rams,A. Baldwin Jr.,4433182,,True,36.0,2,6,1,4,1,2,2,4,1,2,3,4,4,0,6,2,7
401365831,VCU Rams,K. Curry,4397228,,True,33.0,9,11,6,8,3,3,7,10,1,4,5,2,0,0,3,3,28
401365831,VCU Rams,J. DeLoach,4432483,,False,16.0,4,6,4,6,0,0,0,0,5,6,11,1,1,2,2,3,8
401365831,VCU Rams,V. Williams Jr.,4397227,,False,26.0,2,10,1,5,1,5,1,2,1,2,3,7,2,1,1,2,6
401365831,VCU Rams,L. Stockard III,4277897,,False,4.0,0,0,0,0,0,0,0,0,0,0,0,0,0,0,2,2,0
401365831,VCU Rams,N. Kern,4684145,,False,6.0,1,1,1,1,0,0,0,0,0,0,0,0,0,0,0,2,2
401365831,VCU Rams,M. Tsohonis,4592438,,False,22.0,1,6,0,1,1,5,0,2,0,2,2,1,1,0,1,0,3
401365831,VCU Rams,J. Banks,4432402,,False,1.0,0,0,0,0,0,0,0,0,0,0,0,0,0,0,0,1,0
401365831,VCU Rams,TEAM,TOTAL,TOTAL,False,,26,53,20,37,6,16,15,24,11,28,39,17,14,3,21,21,73
401365831,Rhode Island Rams,Makhel Mitchell,4431777,,True,26.0,4,8,4,8,0,0,4,9,4,6,10,0,1,2,2,4,12
401365831,Rhode Island Rams,Makhi Mitchell,4431708,,True,30.0,5,13,5,13,0,0,1,5,4,3,7,1,3,0,3,4,11
401365831,Rhode Island Rams,S. Thomas,4897065,,True,3.0,0,0,0,0,0,0,0,0,0,0,0,0,0,0,1,1,0
401365831,Rhode Island Rams,I. Leggett,4606837,,True,27.0,3,8,1,4,2,4,2,5,0,0,0,0,1,0,4,1,10
401365831,Rhode Island Rams,I. El-Amin,4279313,,True,14.0,0,2,0,2,0,0,0,0,0,0,0,0,0,0,0,2,0
401365831,Rhode Island Rams,A. Walker,4278567,,False,17.0,3,8,2,6,1,2,0,0,4,2,6,1,0,0,1,4,7
401365831,Rhode Island Rams,M. Martin,4397470,,False,25.0,4,6,4,6,0,0,1,4,2,5,7,1,1,0,3,0,9
401365831,Rhode Island Rams,J. Carey,4395673,,False,21.0,1,4,1,2,0,2,2,2,0,1,1,4,1,0,2,2,4
401365831,Rhode Island Rams,J. Sheppard,4066445,,False,37.0,3,8,0,2,3,6,2,4,1,2,3,7,2,0,4,2,11
401365831,Rhode Island Rams,TEAM,TOTAL,TOTAL,False,,23,57,17,43,6,14,12,29,16,20,36,14,9,2,21,20,64
401365831,Rhode Island Rams,Makhel Mitchell,4431777,,True,26.0,4,8,4,8,0,0,4,9,4,6,10,0,1,2,2,4,12
401365831,Rhode Island Rams,Makhi Mitchell,4431708,,True,30.0,5,13,5,13,0,0,1,5,4,3,7,1,3,0,3,4,11
401365831,Rhode Island Rams,S. Thomas,4897065,,True,3.0,0,0,0,0,0,0,0,0,0,0,0,0,0,0,1,1,0
401365831,Rhode Island Rams,I. Leggett,4606837,,True,27.0,3,8,1,4,2,4,2,5,0,0,0,0,1,0,4,1,10
401365831,Rhode Island Rams,I. El-Amin,4279313,,True,14.0,0,2,0,2,0,0,0,0,0,0,0,0,0,0,0,2,0
401365831,Rhode Island Rams,A. Walker,4278567,,False,17.0,3,8,2,6,1,2,0,0,4,2,6,1,0,0,1,4,7
401365831,Rhode Island Rams,M. Martin,4397470,,False,25.0,4,6,4,6,0,0,1,4,2,5,7,1,1,0,3,0,9
401365831,Rhode Island Rams,J. Carey,4395673,,False,21.0,1,4,1,2,0,2,2,2,0,1,1,4,1,0,2,2,4
401365831,Rhode Island Rams,J. Sheppard,4066445,,False,37.0,3,8,0,2,3,6,2,4,1,2,3,7,2,0,4,2,11
401365831,Rhode Island Rams,TEAM,TOTAL,TOTAL,False,,23,57,17,43,6,14,12,29,16,20,36,14,9,2,21,20,64
401365830,Saint Louis Billikens,F. Okoro,4397105,,True,26.0,9,11,9,11,0,0,1,1,1,6,7,0,0,2,0,4,19
401365830,Saint Louis Billikens,J. Nesbitt,4714246,,True,34.0,2,5,2,3,0,2,4,5,1,3,4,1,0,0,0,3,8
401365830,Saint Louis Billikens,Y. Collins,4432957,,True,37.0,4,11,4,11,0,0,0,0,0,5,5,8,3,2,2,2,8
401365830,Saint Louis Billikens,G. Jimerson,4432008,,True,35.0,4,14,3,10,1,4,4,6,2,6,8,2,0,0,0,0,13
401365830,Saint Louis Billikens,F. Thatch Jr.,4397199,,True,29.0,5,9,5,9,0,0,4,6,4,6,10,2,1,1,1,1,14
401365830,Saint Louis Billikens,L. Traore,4897052,,False,5.0,1,1,1,1,0,0,0,0,1,0,1,0,0,0,0,1,2
401365830,Saint Louis Billikens,T. Hargrove Jr.,4592484,,False,17.0,3,5,1,2,2,3,0,0,1,4,5,0,0,0,3,2,8
401365830,Saint Louis Billikens,M. Linssen,4279174,,False,9.0,0,2,0,2,0,0,1,2,0,2,2,1,0,0,2,3,1
401365830,Saint Louis Billikens,D. Jones,4278267,,False,8.0,0,3,0,1,0,2,2,2,1,0,1,0,1,0,0,0,2
401365830,Saint Louis Billikens,TEAM,TOTAL,TOTAL,False,,28,61,25,50,3,11,16,22,11,32,43,14,5,5,8,16,75
401365830,Saint Louis Billikens,F. Okoro,4397105,,True,26.0,9,11,9,11,0,0,1,1,1,6,7,0,0,2,0,4,19
401365830,Saint Louis Billikens,J. Nesbitt,4714246,,True,34.0,2,5,2,3,0,2,4,5,1,3,4,1,0,0,0,3,8
401365830,Saint Louis Billikens,Y. Collins,4432957,,True,37.0,4,11,4,11,0,0,0,0,0,5,5,8,3,2,2,2,8
401365830,Saint Louis Billikens,G. Jimerson,4432008,,True,35.0,4,14,3,10,1,4,4,6,2,6,8,2,0,0,0,0,13
401365830,Saint Louis Billikens,F. Thatch Jr.,4397199,,True,29.0,5,9,5,9,0,0,4,6,4,6,10,2,1,1,1,1,14
401365830,Saint Louis Billikens,L. Traore,4897052,,False,5.0,1,1,1,1,0,0,0,0,1,0,1,0,0,0,0,1,2
401365830,Saint Louis Billikens,T. Hargrove Jr.,4592484,,False,17.0,3,5,1,2,2,3,0,0,1,4,5,0,0,0,3,2,8
401365830,Saint Louis Billikens,M. Linssen,4279174,,False,9.0,0,2,0,2,0,0,1,2,0,2,2,1,0,0,2,3,1
401365830,Saint Louis Billikens,D. Jones,4278267,,False,8.0,0,3,0,1,0,2,2,2,1,0,1,0,1,0,0,0,2
401365830,Saint Louis Billikens,TEAM,TOTAL,TOTAL,False,,28,61,25,50,3,11,16,22,11,32,43,14,5,5,8,16,75
401365830,La Salle Explorers,M. Doucoure,4277988,,True,10.0,0,2,0,2,0,0,0,0,1,2,3,0,0,0,0,3,0
401365830,La Salle Explorers,C. Moore,4277945,,True,34.0,8,16,6,13,2,3,5,8,0,5,5,1,0,4,0,2,23
401365830,La Salle Explorers,J. Clark,4397152,,True,26.0,1,8,1,5,0,3,0,0,2,1,3,3,1,0,2,3,2
401365830,La Salle Explorers,J. Brickus,4700970,,True,29.0,3,7,2,3,1,4,0,1,0,2,2,3,0,0,4,3,7
401365830,La Salle Explorers,J. Nickelberry,4432845,,True,35.0,6,13,3,5,3,8,2,3,1,3,4,1,0,0,0,0,17
401365830,La Salle Explorers,D. Shepherd,4710357,,False,9.0,1,2,1,2,0,0,0,0,0,0,0,0,0,0,0,0,2
401365830,La Salle Explorers,K. Brantley,4709132,,False,16.0,1,5,1,4,0,1,2,4,2,2,4,2,1,1,2,2,4
401365830,La Salle Explorers,A. Gill,4700969,,False,5.0,0,2,0,1,0,1,0,0,0,0,0,0,0,0,0,1,0
401365830,La Salle Explorers,C. Ray,4592448,,False,36.0,1,4,1,3,0,1,0,0,3,7,10,3,0,0,2,1,2
401365830,La Salle Explorers,TEAM,TOTAL,TOTAL,False,,21,59,15,38,6,21,9,16,9,22,31,13,2,5,21,15,57
401365830,La Salle Explorers,M. Doucoure,4277988,,True,10.0,0,2,0,2,0,0,0,0,1,2,3,0,0,0,0,3,0
401365830,La Salle Explorers,C. Moore,4277945,,True,34.0,8,16,6,13,2,3,5,8,0,5,5,1,0,4,0,2,23
401365830,La Salle Explorers,J. Clark,4397152,,True,26.0,1,8,1,5,0,3,0,0,2,1,3,3,1,0,2,3,2
401365830,La Salle Explorers,J. Brickus,4700970,,True,29.0,3,7,2,3,1,4,0,1,0,2,2,3,0,0,4,3,7
401365830,La Salle Explorers,J. Nickelberry,4432845,,True,35.0,6,13,3,5,3,8,2,3,1,3,4,1,0,0,0,0,17
401365830,La Salle Explorers,D. Shepherd,4710357,,False,9.0,1,2,1,2,0,0,0,0,0,0,0,0,0,0,0,0,2
401365830,La Salle Explorers,K. Brantley,4709132,,False,16.0,1,5,1,4,0,1,2,4,2,2,4,2,1,1,2,2,4
401365830,La Salle Explorers,A. Gill,4700969,,False,5.0,0,2,0,1,0,1,0,0,0,0,0,0,0,0,0,1,0
401365830,La Salle Explorers,C. Ray,4592448,,False,36.0,1,4,1,3,0,1,0,0,3,7,10,3,0,0,2,1,2
401365830,La Salle Explorers,TEAM,TOTAL,TOTAL,False,,21,59,15,38,6,21,9,16,9,22,31,13,2,5,21,15,57
401365829,Rhode Island Rams,Makhel Mitchell,4431777,,True,24.0,1,4,1,4,0,0,1,4,1,3,4,1,0,2,4,0,3
401365829,Rhode Island Rams,Makhi Mitchell,4431708,,True,25.0,4,6,4,6,0,0,5,7,3,10,13,6,0,4,3,1,13
401365829,Rhode Island Rams,S. Thomas,4897065,,True,23.0,1,7,1,4,0,3,0,2,1,2,3,4,0,0,3,3,2
401365829,Rhode Island Rams,I. Leggett,4606837,,True,27.0,8,11,5,6,3,5,2,3,2,3,5,0,3,0,2,5,21
401365829,Rhode Island Rams,I. El-Amin,4279313,,True,28.0,2,7,2,3,0,4,0,0,0,2,2,1,3,0,5,3,4
401365829,Rhode Island Rams,A. Walker,4278567,,False,19.0,6,10,6,10,0,0,1,2,3,2,5,1,1,0,2,1,13
401365829,Rhode Island Rams,T. Berry,4701257,,False,3.0,0,0,0,0,0,0,0,0,0,0,0,0,0,0,0,0,0
401365829,Rhode Island Rams,M. Martin,4397470,,False,27.0,1,4,1,2,0,2,0,0,1,0,1,1,0,2,1,1,2
401365829,Rhode Island Rams,J. Sheppard,4066445,,False,24.0,3,10,0,3,3,7,0,0,0,2,2,1,1,0,0,3,9
401365829,Rhode Island Rams,TEAM,TOTAL,TOTAL,False,,26,59,20,38,6,21,9,18,12,26,38,15,8,8,20,17,67
401365829,Rhode Island Rams,Makhel Mitchell,4431777,,True,24.0,1,4,1,4,0,0,1,4,1,3,4,1,0,2,4,0,3
401365829,Rhode Island Rams,Makhi Mitchell,4431708,,True,25.0,4,6,4,6,0,0,5,7,3,10,13,6,0,4,3,1,13
401365829,Rhode Island Rams,S. Thomas,4897065,,True,23.0,1,7,1,4,0,3,0,2,1,2,3,4,0,0,3,3,2
401365829,Rhode Island Rams,I. Leggett,4606837,,True,27.0,8,11,5,6,3,5,2,3,2,3,5,0,3,0,2,5,21
401365829,Rhode Island Rams,I. El-Amin,4279313,,True,28.0,2,7,2,3,0,4,0,0,0,2,2,1,3,0,5,3,4
401365829,Rhode Island Rams,A. Walker,4278567,,False,19.0,6,10,6,10,0,0,1,2,3,2,5,1,1,0,2,1,13
401365829,Rhode Island Rams,T. Berry,4701257,,False,3.0,0,0,0,0,0,0,0,0,0,0,0,0,0,0,0,0,0
401365829,Rhode Island Rams,M. Martin,4397470,,False,27.0,1,4,1,2,0,2,0,0,1,0,1,1,0,2,1,1,2
401365829,Rhode Island Rams,J. Sheppard,4066445,,False,24.0,3,10,0,3,3,7,0,0,0,2,2,1,1,0,0,3,9
401365829,Rhode Island Rams,TEAM,TOTAL,TOTAL,False,,26,59,20,38,6,21,9,18,12,26,38,15,8,8,20,17,67
401365829,Massachusetts Minutemen,T. Buttrick,4277981,,True,23.0,1,6,0,3,1,3,2,5,3,3,6,2,1,1,1,4,5
401365829,Massachusetts Minutemen,T.J. Weeks,4433108,,True,33.0,12,17,6,8,6,9,0,0,3,3,6,1,5,1,1,2,30
401365829,Massachusetts Minutemen,N. Fernandes,4431791,,True,39.0,5,11,4,7,1,4,0,2,0,2,2,7,2,0,5,1,11
401365829,Massachusetts Minutemen,C.J. Kelly,4398208,,True,38.0,4,11,4,8,0,3,4,4,1,10,11,7,4,0,3,3,12
401365829,Massachusetts Minutemen,R. Kelly,4279741,,True,31.0,3,6,1,1,2,5,6,7,0,2,2,0,0,0,2,2,14
401365829,Massachusetts Minutemen,D. Dominguez,4701126,,False,3.0,0,1,0,0,0,1,0,0,0,1,1,0,0,0,0,0,0
401365829,Massachusetts Minutemen,M. Steadman,4397393,,False,20.0,2,8,2,8,0,0,0,0,3,2,5,1,0,0,1,5,4
401365829,Massachusetts Minutemen,J. Garcia,4701125,,False,13.0,1,2,1,2,0,0,0,0,0,3,3,0,1,1,3,2,2
401365829,Massachusetts Minutemen,TEAM,TOTAL,TOTAL,False,,28,62,18,37,10,25,12,18,11,27,38,18,13,3,16,19,78
401365829,Massachusetts Minutemen,T. Buttrick,4277981,,True,23.0,1,6,0,3,1,3,2,5,3,3,6,2,1,1,1,4,5
401365829,Massachusetts Minutemen,T.J. Weeks,4433108,,True,33.0,12,17,6,8,6,9,0,0,3,3,6,1,5,1,1,2,30
401365829,Massachusetts Minutemen,N. Fernandes,4431791,,True,39.0,5,11,4,7,1,4,0,2,0,2,2,7,2,0,5,1,11
401365829,Massachusetts Minutemen,C.J. Kelly,4398208,,True,38.0,4,11,4,8,0,3,4,4,1,10,11,7,4,0,3,3,12
401365829,Massachusetts Minutemen,R. Kelly,4279741,,True,31.0,3,6,1,1,2,5,6,7,0,2,2,0,0,0,2,2,14
401365829,Massachusetts Minutemen,D. Dominguez,4701126,,False,3.0,0,1,0,0,0,1,0,0,0,1,1,0,0,0,0,0,0
401365829,Massachusetts Minutemen,M. Steadman,4397393,,False,20.0,2,8,2,8,0,0,0,0,3,2,5,1,0,0,1,5,4
401365829,Massachusetts Minutemen,J. Garcia,4701125,,False,13.0,1,2,1,2,0,0,0,0,0,3,3,0,1,1,3,2,2
401365829,Massachusetts Minutemen,TEAM,TOTAL,TOTAL,False,,28,62,18,37,10,25,12,18,11,27,38,18,13,3,16,19,78
401365828,La Salle Explorers,M. Doucoure,4277988,,True,9.0,0,0,0,0,0,0,0,0,0,2,2,0,0,0,1,1,0
401365828,La Salle Explorers,C. Moore,4277945,,True,34.0,4,6,3,5,1,1,6,8,0,4,4,2,0,4,3,2,15
401365828,La Salle Explorers,J. Clark,4397152,,True,38.0,6,11,3,5,3,6,3,3,0,4,4,3,2,2,0,0,18
401365828,La Salle Explorers,J. Brickus,4700970,,True,32.0,7,11,4,4,3,7,1,4,1,3,4,3,0,1,1,3,18
401365828,La Salle Explorers,J. Nickelberry,4432845,,True,27.0,6,14,1,4,5,10,0,2,0,1,1,1,1,0,2,2,17
401365828,La Salle Explorers,D. Shepherd,4710357,,False,8.0,1,2,1,2,0,0,0,0,0,1,1,1,0,0,0,2,2
401365828,La Salle Explorers,K. Brantley,4709132,,False,26.0,3,7,2,4,1,3,2,4,1,2,3,3,0,1,0,1,9
401365828,La Salle Explorers,C. Ray,4592448,,False,26.0,1,2,0,0,1,2,1,2,0,8,8,3,0,1,0,3,4
401365828,La Salle Explorers,TEAM,TOTAL,TOTAL,False,,28,53,14,24,14,29,13,23,5,28,33,16,3,9,7,14,83
401365828,La Salle Explorers,M. Doucoure,4277988,,True,9.0,0,0,0,0,0,0,0,0,0,2,2,0,0,0,1,1,0
401365828,La Salle Explorers,C. Moore,4277945,,True,34.0,4,6,3,5,1,1,6,8,0,4,4,2,0,4,3,2,15
401365828,La Salle Explorers,J. Clark,4397152,,True,38.0,6,11,3,5,3,6,3,3,0,4,4,3,2,2,0,0,18
401365828,La Salle Explorers,J. Brickus,4700970,,True,32.0,7,11,4,4,3,7,1,4,1,3,4,3,0,1,1,3,18
401365828,La Salle Explorers,J. Nickelberry,4432845,,True,27.0,6,14,1,4,5,10,0,2,0,1,1,1,1,0,2,2,17
401365828,La Salle Explorers,D. Shepherd,4710357,,False,8.0,1,2,1,2,0,0,0,0,0,1,1,1,0,0,0,2,2
401365828,La Salle Explorers,K. Brantley,4709132,,False,26.0,3,7,2,4,1,3,2,4,1,2,3,3,0,1,0,1,9
401365828,La Salle Explorers,C. Ray,4592448,,False,26.0,1,2,0,0,1,2,1,2,0,8,8,3,0,1,0,3,4
401365828,La Salle Explorers,TEAM,TOTAL,TOTAL,False,,28,53,14,24,14,29,13,23,5,28,33,16,3,9,7,14,83
401365828,George Mason Patriots,M. Henry,4606836,,True,14.0,2,4,2,4,0,0,0,1,0,2,2,0,1,1,0,2,4
401365828,George Mason Patriots,X. Johnson,4592439,,True,36.0,5,11,3,8,2,3,4,4,0,6,6,10,0,0,1,3,16
401365828,George Mason Patriots,D. Gaines,4431961,,True,38.0,3,9,1,4,2,5,2,4,1,8,9,3,0,0,0,1,10
401365828,George Mason Patriots,D. Cooper,4279876,,True,33.0,6,9,2,4,4,5,0,0,0,1,1,1,1,0,2,4,16
401365828,George Mason Patriots,D. Schwartz,4278501,,True,35.0,6,16,2,9,4,7,1,2,2,4,6,3,0,0,2,3,17
401365828,George Mason Patriots,B. Jones,4897083,,False,1.0,0,0,0,0,0,0,0,0,0,0,0,0,0,0,0,0,0
401365828,George Mason Patriots,O. Frazier III,4700882,,False,25.0,3,8,3,7,0,1,0,1,3,2,5,2,2,0,2,3,6
401365828,George Mason Patriots,B. Buchanan,4395691,,False,14.0,2,3,0,0,2,3,0,0,0,1,1,1,0,0,0,1,6
401365828,George Mason Patriots,J. Hartwell II,4396817,,False,4.0,1,2,0,1,1,1,0,0,0,0,0,0,0,0,0,0,3
401365828,George Mason Patriots,TEAM,TOTAL,TOTAL,False,,28,62,13,37,15,25,7,12,8,25,33,20,4,1,8,17,78
401365828,George Mason Patriots,M. Henry,4606836,,True,14.0,2,4,2,4,0,0,0,1,0,2,2,0,1,1,0,2,4
401365828,George Mason Patriots,X. Johnson,4592439,,True,36.0,5,11,3,8,2,3,4,4,0,6,6,10,0,0,1,3,16
401365828,George Mason Patriots,D. Gaines,4431961,,True,38.0,3,9,1,4,2,5,2,4,1,8,9,3,0,0,0,1,10
401365828,George Mason Patriots,D. Cooper,4279876,,True,33.0,6,9,2,4,4,5,0,0,0,1,1,1,1,0,2,4,16
401365828,George Mason Patriots,D. Schwartz,4278501,,True,35.0,6,16,2,9,4,7,1,2,2,4,6,3,0,0,2,3,17
401365828,George Mason Patriots,B. Jones,4897083,,False,1.0,0,0,0,0,0,0,0,0,0,0,0,0,0,0,0,0,0
401365828,George Mason Patriots,O. Frazier III,4700882,,False,25.0,3,8,3,7,0,1,0,1,3,2,5,2,2,0,2,3,6
401365828,George Mason Patriots,B. Buchanan,4395691,,False,14.0,2,3,0,0,2,3,0,0,0,1,1,1,0,0,0,1,6
401365828,George Mason Patriots,J. Hartwell II,4396817,,False,4.0,1,2,0,1,1,1,0,0,0,0,0,0,0,0,0,0,3
401365828,George Mason Patriots,TEAM,TOTAL,TOTAL,False,,28,62,13,37,15,25,7,12,8,25,33,20,4,1,8,17,78
401365827,Saint Joseph's Hawks,T. Funk,4278395,,True,38.0,1,3,1,2,0,1,5,6,0,1,1,4,1,0,0,3,7
401365827,Saint Joseph's Hawks,E. Obinna,4278125,,True,33.0,7,11,7,11,0,0,1,4,0,3,3,1,0,1,1,5,15
401365827,Saint Joseph's Hawks,J. Hall,4701031,,True,40.0,6,10,3,4,3,6,0,1,1,9,10,5,0,0,6,2,15
401365827,Saint Joseph's Hawks,E. Reynolds II,4683952,,True,40.0,8,15,5,7,3,8,4,4,0,3,3,3,0,2,0,3,23
401365827,Saint Joseph's Hawks,C. Brown,4592476,,True,38.0,3,7,1,1,2,6,4,6,0,6,6,0,0,0,3,2,12
401365827,Saint Joseph's Hawks,C. Coleman,4431807,,False,6.0,0,0,0,0,0,0,0,0,0,0,0,0,0,0,0,1,0
401365827,Saint Joseph's Hawks,D. Bishop,4701028,,False,5.0,0,5,0,1,0,4,0,2,1,0,1,0,0,0,0,0,0
401365827,Saint Joseph's Hawks,TEAM,TOTAL,TOTAL,False,,25,51,17,26,8,25,14,23,4,24,28,13,1,3,10,16,72
401365827,Saint Joseph's Hawks,T. Funk,4278395,,True,38.0,1,3,1,2,0,1,5,6,0,1,1,4,1,0,0,3,7
401365827,Saint Joseph's Hawks,E. Obinna,4278125,,True,33.0,7,11,7,11,0,0,1,4,0,3,3,1,0,1,1,5,15
401365827,Saint Joseph's Hawks,J. Hall,4701031,,True,40.0,6,10,3,4,3,6,0,1,1,9,10,5,0,0,6,2,15
401365827,Saint Joseph's Hawks,E. Reynolds II,4683952,,True,40.0,8,15,5,7,3,8,4,4,0,3,3,3,0,2,0,3,23
401365827,Saint Joseph's Hawks,C. Brown,4592476,,True,38.0,3,7,1,1,2,6,4,6,0,6,6,0,0,0,3,2,12
401365827,Saint Joseph's Hawks,C. Coleman,4431807,,False,6.0,0,0,0,0,0,0,0,0,0,0,0,0,0,0,0,1,0
401365827,Saint Joseph's Hawks,D. Bishop,4701028,,False,5.0,0,5,0,1,0,4,0,2,1,0,1,0,0,0,0,0,0
401365827,Saint Joseph's Hawks,TEAM,TOTAL,TOTAL,False,,25,51,17,26,8,25,14,23,4,24,28,13,1,3,10,16,72
401365827,Fordham Rams,A. Tsimbila,4702329,,True,21.0,3,4,3,4,0,0,0,0,4,3,7,0,0,0,1,1,6
401365827,Fordham Rams,C. Ohams,4066856,,True,23.0,5,12,5,12,0,0,2,5,4,2,6,2,0,1,2,4,12
401365827,Fordham Rams,A. Charlton,4897085,,True,26.0,0,4,0,2,0,2,2,2,1,4,5,3,1,1,2,4,2
401365827,Fordham Rams,K. Rose,4592315,,True,35.0,6,9,5,5,1,4,2,3,2,2,4,1,2,1,2,1,15
401365827,Fordham Rams,D. Quisenberry,4397790,,True,37.0,8,23,7,15,1,8,2,3,1,2,3,1,2,0,0,2,19
401365827,Fordham Rams,P. Kelly,4432014,,False,21.0,2,6,1,1,1,5,0,0,0,3,3,0,0,0,0,4,5
401365827,Fordham Rams,R. Novitskyi,4897084,,False,8.0,1,1,1,1,0,0,0,0,1,3,4,0,2,0,0,2,2
401365827,Fordham Rams,J. Navarro,4592316,,False,27.0,2,6,2,4,0,2,4,4,0,4,4,0,0,0,1,3,8
401365827,Fordham Rams,Z. Riley,4914388,,False,2.0,0,0,0,0,0,0,0,0,0,1,1,0,0,0,1,0,0
401365827,Fordham Rams,TEAM,TOTAL,TOTAL,False,,27,65,24,44,3,21,12,17,14,27,41,7,7,3,10,21,69
401365827,Fordham Rams,A. Tsimbila,4702329,,True,21.0,3,4,3,4,0,0,0,0,4,3,7,0,0,0,1,1,6
401365827,Fordham Rams,C. Ohams,4066856,,True,23.0,5,12,5,12,0,0,2,5,4,2,6,2,0,1,2,4,12
401365827,Fordham Rams,A. Charlton,4897085,,True,26.0,0,4,0,2,0,2,2,2,1,4,5,3,1,1,2,4,2
401365827,Fordham Rams,K. Rose,4592315,,True,35.0,6,9,5,5,1,4,2,3,2,2,4,1,2,1,2,1,15
401365827,Fordham Rams,D. Quisenberry,4397790,,True,37.0,8,23,7,15,1,8,2,3,1,2,3,1,2,0,0,2,19
401365827,Fordham Rams,P. Kelly,4432014,,False,21.0,2,6,1,1,1,5,0,0,0,3,3,0,0,0,0,4,5
401365827,Fordham Rams,R. Novitskyi,4897084,,False,8.0,1,1,1,1,0,0,0,0,1,3,4,0,2,0,0,2,2
401365827,Fordham Rams,J. Navarro,4592316,,False,27.0,2,6,2,4,0,2,4,4,0,4,4,0,0,0,1,3,8
401365827,Fordham Rams,Z. Riley,4914388,,False,2.0,0,0,0,0,0,0,0,0,0,1,1,0,0,0,1,0,0
401365827,Fordham Rams,TEAM,TOTAL,TOTAL,False,,27,65,24,44,3,21,12,17,14,27,41,7,7,3,10,21,69
401365826,VCU Rams,H. Ward,4592495,,True,32.0,6,9,6,9,0,0,1,2,3,7,10,1,2,5,4,1,13
401365826,VCU Rams,M. Brown-Jones,4433224,,True,24.0,2,3,2,3,0,0,0,0,0,5,5,1,1,0,1,1,4
401365826,VCU Rams,J. Nunn,4896614,,True,26.0,3,9,2,7,1,2,0,1,2,2,4,1,0,1,1,1,7
401365826,VCU Rams,A. Baldwin Jr.,4433182,,True,32.0,4,10,3,7,1,3,4,4,0,3,3,7,3,0,2,4,13
401365826,VCU Rams,K. Curry,4397228,,True,31.0,4,9,4,8,0,1,4,4,0,5,5,3,2,1,3,1,12
401365826,VCU Rams,J. DeLoach,4432483,,False,15.0,2,2,2,2,0,0,0,1,1,4,5,0,0,0,3,4,4
401365826,VCU Rams,L. Stockard III,4277897,,False,9.0,2,4,2,4,0,0,0,0,0,1,1,0,0,0,1,1,4
401365826,VCU Rams,N. Kern,4684145,,False,10.0,0,2,0,2,0,0,3,5,0,1,1,1,1,1,2,0,3
401365826,VCU Rams,M. Tsohonis,4592438,,False,18.0,4,8,1,2,3,6,0,0,0,1,1,0,0,0,0,5,11
401365826,VCU Rams,J. Banks,4432402,,False,3.0,0,0,0,0,0,0,0,0,0,0,0,0,0,1,0,1,0
401365826,VCU Rams,TEAM,TOTAL,TOTAL,False,,27,56,22,44,5,12,12,17,7,31,38,14,9,9,17,19,71
401365826,VCU Rams,H. Ward,4592495,,True,32.0,6,9,6,9,0,0,1,2,3,7,10,1,2,5,4,1,13
401365826,VCU Rams,M. Brown-Jones,4433224,,True,24.0,2,3,2,3,0,0,0,0,0,5,5,1,1,0,1,1,4
401365826,VCU Rams,J. Nunn,4896614,,True,26.0,3,9,2,7,1,2,0,1,2,2,4,1,0,1,1,1,7
401365826,VCU Rams,A. Baldwin Jr.,4433182,,True,32.0,4,10,3,7,1,3,4,4,0,3,3,7,3,0,2,4,13
401365826,VCU Rams,K. Curry,4397228,,True,31.0,4,9,4,8,0,1,4,4,0,5,5,3,2,1,3,1,12
401365826,VCU Rams,J. DeLoach,4432483,,False,15.0,2,2,2,2,0,0,0,1,1,4,5,0,0,0,3,4,4
401365826,VCU Rams,L. Stockard III,4277897,,False,9.0,2,4,2,4,0,0,0,0,0,1,1,0,0,0,1,1,4
401365826,VCU Rams,N. Kern,4684145,,False,10.0,0,2,0,2,0,0,3,5,0,1,1,1,1,1,2,0,3
401365826,VCU Rams,M. Tsohonis,4592438,,False,18.0,4,8,1,2,3,6,0,0,0,1,1,0,0,0,0,5,11
401365826,VCU Rams,J. Banks,4432402,,False,3.0,0,0,0,0,0,0,0,0,0,0,0,0,0,1,0,1,0
401365826,VCU Rams,TEAM,TOTAL,TOTAL,False,,27,56,22,44,5,12,12,17,7,31,38,14,9,9,17,19,71
401365826,Duquesne Dukes,T. Williams,4432147,,True,30.0,9,13,8,11,1,2,0,2,0,3,3,0,2,1,2,4,19
401365826,Duquesne Dukes,K. Easley,4398159,,True,34.0,4,13,3,10,1,3,2,3,0,7,7,1,0,0,0,1,11
401365826,Duquesne Dukes,A. Spears,4897090,,True,38.0,3,12,3,9,0,3,5,6,0,7,7,4,0,0,4,2,11
401365826,Duquesne Dukes,T. Okani,4700873,,True,30.0,2,7,2,5,0,2,3,4,4,4,8,2,3,1,4,4,7
401365826,Duquesne Dukes,T. Acuff,4606831,,True,24.0,3,5,0,1,3,4,0,0,1,1,2,1,0,0,1,1,9
401365826,Duquesne Dukes,M. Hima,4700878,,False,1.0,0,0,0,0,0,0,0,0,0,0,0,0,0,0,0,0,0
401365826,Duquesne Dukes,D. Larson,4897091,,False,6.0,0,0,0,0,0,0,0,0,0,0,0,0,0,0,1,1,0
401365826,Duquesne Dukes,J. Johnson III,4897088,,False,11.0,0,6,0,6,0,0,0,0,0,0,0,0,1,0,0,1,0
401365826,Duquesne Dukes,L. Ayers III,4703813,,False,26.0,2,6,2,4,0,2,1,2,0,3,3,0,0,0,5,2,5
401365826,Duquesne Dukes,TEAM,TOTAL,TOTAL,False,,23,62,18,46,5,16,11,17,13,25,38,8,6,2,19,16,62
401365826,Duquesne Dukes,T. Williams,4432147,,True,30.0,9,13,8,11,1,2,0,2,0,3,3,0,2,1,2,4,19
401365826,Duquesne Dukes,K. Easley,4398159,,True,34.0,4,13,3,10,1,3,2,3,0,7,7,1,0,0,0,1,11
401365826,Duquesne Dukes,A. Spears,4897090,,True,38.0,3,12,3,9,0,3,5,6,0,7,7,4,0,0,4,2,11
401365826,Duquesne Dukes,T. Okani,4700873,,True,30.0,2,7,2,5,0,2,3,4,4,4,8,2,3,1,4,4,7
401365826,Duquesne Dukes,T. Acuff,4606831,,True,24.0,3,5,0,1,3,4,0,0,1,1,2,1,0,0,1,1,9
401365826,Duquesne Dukes,M. Hima,4700878,,False,1.0,0,0,0,0,0,0,0,0,0,0,0,0,0,0,0,0,0
401365826,Duquesne Dukes,D. Larson,4897091,,False,6.0,0,0,0,0,0,0,0,0,0,0,0,0,0,0,1,1,0
401365826,Duquesne Dukes,J. Johnson III,4897088,,False,11.0,0,6,0,6,0,0,0,0,0,0,0,0,1,0,0,1,0
401365826,Duquesne Dukes,L. Ayers III,4703813,,False,26.0,2,6,2,4,0,2,1,2,0,3,3,0,0,0,5,2,5
401365826,Duquesne Dukes,TEAM,TOTAL,TOTAL,False,,23,62,18,46,5,16,11,17,13,25,38,8,6,2,19,16,62
401365825,Saint Louis Billikens,F. Okoro,4397105,,True,21.0,2,3,2,3,0,0,1,2,2,5,7,1,0,2,0,3,5
401365825,Saint Louis Billikens,J. Nesbitt,4714246,,True,25.0,1,6,1,4,0,2,0,0,1,3,4,0,1,0,1,2,2
401365825,Saint Louis Billikens,Y. Collins,4432957,,True,36.0,4,6,2,3,2,3,6,7,1,7,8,6,2,1,6,2,16
401365825,Saint Louis Billikens,G. Jimerson,4432008,,True,38.0,5,12,1,6,4,6,0,0,0,2,2,0,0,0,0,3,14
401365825,Saint Louis Billikens,F. Thatch Jr.,4397199,,True,30.0,4,9,4,7,0,2,4,4,2,3,5,3,1,0,1,2,12
401365825,Saint Louis Billikens,T. Hargrove Jr.,4592484,,False,15.0,1,2,0,1,1,1,0,0,0,4,4,1,0,1,2,2,3
401365825,Saint Louis Billikens,M. Linssen,4279174,,False,19.0,5,5,5,5,0,0,7,8,0,2,2,1,0,1,0,2,17
401365825,Saint Louis Billikens,R. Williams,4399106,,False,3.0,1,3,0,0,1,3,0,0,0,0,0,0,0,0,0,0,3
401365825,Saint Louis Billikens,D. Jones,4278267,,False,13.0,0,1,0,0,0,1,0,0,0,0,0,1,0,0,1,4,0
401365825,Saint Louis Billikens,TEAM,TOTAL,TOTAL,False,,23,47,15,29,8,18,18,21,7,27,34,13,4,5,11,20,72
401365825,Saint Louis Billikens,F. Okoro,4397105,,True,21.0,2,3,2,3,0,0,1,2,2,5,7,1,0,2,0,3,5
401365825,Saint Louis Billikens,J. Nesbitt,4714246,,True,25.0,1,6,1,4,0,2,0,0,1,3,4,0,1,0,1,2,2
401365825,Saint Louis Billikens,Y. Collins,4432957,,True,36.0,4,6,2,3,2,3,6,7,1,7,8,6,2,1,6,2,16
401365825,Saint Louis Billikens,G. Jimerson,4432008,,True,38.0,5,12,1,6,4,6,0,0,0,2,2,0,0,0,0,3,14
401365825,Saint Louis Billikens,F. Thatch Jr.,4397199,,True,30.0,4,9,4,7,0,2,4,4,2,3,5,3,1,0,1,2,12
401365825,Saint Louis Billikens,T. Hargrove Jr.,4592484,,False,15.0,1,2,0,1,1,1,0,0,0,4,4,1,0,1,2,2,3
401365825,Saint Louis Billikens,M. Linssen,4279174,,False,19.0,5,5,5,5,0,0,7,8,0,2,2,1,0,1,0,2,17
401365825,Saint Louis Billikens,R. Williams,4399106,,False,3.0,1,3,0,0,1,3,0,0,0,0,0,0,0,0,0,0,3
401365825,Saint Louis Billikens,D. Jones,4278267,,False,13.0,0,1,0,0,0,1,0,0,0,0,0,1,0,0,1,4,0
401365825,Saint Louis Billikens,TEAM,TOTAL,TOTAL,False,,23,47,15,29,8,18,18,21,7,27,34,13,4,5,11,20,72
401365825,Dayton Flyers,R.J. Blakney,4700864,,True,25.0,3,5,2,4,1,1,1,2,3,3,6,1,0,0,0,1,8
401365825,Dayton Flyers,T. Camara,4431736,,True,26.0,3,9,3,7,0,2,0,0,1,4,5,1,3,2,1,3,6
401365825,Dayton Flyers,D. Holmes II,4433607,,True,30.0,1,5,1,5,0,0,2,4,1,6,7,2,0,3,2,2,4
401365825,Dayton Flyers,M. Smith,4683861,,True,36.0,4,15,4,14,0,1,0,1,3,2,5,4,2,0,1,4,8
401365825,Dayton Flyers,K. Elvis,4683135,,True,36.0,5,9,1,3,4,6,6,8,0,1,1,0,0,0,3,3,20
401365825,Dayton Flyers,M. Sissoko,4431824,,False,4.0,0,0,0,0,0,0,0,0,0,0,0,0,0,0,0,1,0
401365825,Dayton Flyers,M. Amzil,4711607,,False,18.0,2,4,2,2,0,2,2,5,1,1,2,1,0,0,0,2,6
401365825,Dayton Flyers,K. Washington,4684293,,False,1.0,0,0,0,0,0,0,0,0,0,0,0,0,0,0,0,0,0
401365825,Dayton Flyers,Z. Nwokeji,4618121,,False,1.0,1,1,1,1,0,0,0,0,0,0,0,0,0,0,0,0,2
401365825,Dayton Flyers,C. Wilson,4403456,,False,2.0,0,0,0,0,0,0,0,0,0,0,0,0,1,0,0,0,0
401365825,Dayton Flyers,D. Swerlein,4600089,,False,1.0,0,0,0,0,0,0,1,2,0,0,0,0,0,0,0,0,1
401365825,Dayton Flyers,K. Brea,4591259,,False,20.0,3,5,3,4,0,1,0,1,0,1,1,0,1,0,0,2,6
401365825,Dayton Flyers,TEAM,TOTAL,TOTAL,False,,22,53,17,40,5,13,12,23,10,18,28,9,7,5,8,18,61
401365825,Dayton Flyers,R.J. Blakney,4700864,,True,25.0,3,5,2,4,1,1,1,2,3,3,6,1,0,0,0,1,8
401365825,Dayton Flyers,T. Camara,4431736,,True,26.0,3,9,3,7,0,2,0,0,1,4,5,1,3,2,1,3,6
401365825,Dayton Flyers,D. Holmes II,4433607,,True,30.0,1,5,1,5,0,0,2,4,1,6,7,2,0,3,2,2,4
401365825,Dayton Flyers,M. Smith,4683861,,True,36.0,4,15,4,14,0,1,0,1,3,2,5,4,2,0,1,4,8
401365825,Dayton Flyers,K. Elvis,4683135,,True,36.0,5,9,1,3,4,6,6,8,0,1,1,0,0,0,3,3,20
401365825,Dayton Flyers,M. Sissoko,4431824,,False,4.0,0,0,0,0,0,0,0,0,0,0,0,0,0,0,0,1,0
401365825,Dayton Flyers,M. Amzil,4711607,,False,18.0,2,4,2,2,0,2,2,5,1,1,2,1,0,0,0,2,6
401365825,Dayton Flyers,K. Washington,4684293,,False,1.0,0,0,0,0,0,0,0,0,0,0,0,0,0,0,0,0,0
401365825,Dayton Flyers,Z. Nwokeji,4618121,,False,1.0,1,1,1,1,0,0,0,0,0,0,0,0,0,0,0,0,2
401365825,Dayton Flyers,C. Wilson,4403456,,False,2.0,0,0,0,0,0,0,0,0,0,0,0,0,1,0,0,0,0
401365825,Dayton Flyers,D. Swerlein,4600089,,False,1.0,0,0,0,0,0,0,1,2,0,0,0,0,0,0,0,0,1
401365825,Dayton Flyers,K. Brea,4591259,,False,20.0,3,5,3,4,0,1,0,1,0,1,1,0,1,0,0,2,6
401365825,Dayton Flyers,TEAM,TOTAL,TOTAL,False,,22,53,17,40,5,13,12,23,10,18,28,9,7,5,8,18,61
401365824,George Washington Revolutionaries,H. Dean,4593273,,True,35.0,0,1,0,1,0,0,0,0,0,3,3,1,1,0,1,5,0
401365824,George Washington Revolutionaries,Q. Samuels,4592251,,True,17.0,1,3,0,0,1,3,0,0,0,2,2,1,0,0,1,3,3
401365824,George Washington Revolutionaries,B. Freeman,4613126,,True,26.0,3,7,2,4,1,3,0,0,0,3,3,4,2,0,3,2,7
401365824,George Washington Revolutionaries,J. Bamisile,4432537,,True,31.0,5,10,2,3,3,7,6,8,0,4,4,1,1,1,1,2,19
401365824,George Washington Revolutionaries,J. Bishop,4431770,,True,35.0,9,18,3,8,6,10,2,2,1,2,3,1,3,0,1,1,26
401365824,George Washington Revolutionaries,R. Lindo Jr.,4397186,,False,19.0,3,6,1,1,2,5,0,0,1,2,3,1,0,0,1,4,8
401365824,George Washington Revolutionaries,N. Brown,4700963,,False,7.0,2,2,2,2,0,0,1,1,1,1,2,0,0,0,0,4,5
401365824,George Washington Revolutionaries,B. Adams,4396612,,False,30.0,2,5,2,3,0,2,1,1,0,1,1,3,0,0,1,0,5
401365824,George Washington Revolutionaries,TEAM,TOTAL,TOTAL,False,,25,52,12,22,13,30,10,12,3,18,21,12,7,1,9,21,73
401365824,George Washington Revolutionaries,H. Dean,4593273,,True,35.0,0,1,0,1,0,0,0,0,0,3,3,1,1,0,1,5,0
401365824,George Washington Revolutionaries,Q. Samuels,4592251,,True,17.0,1,3,0,0,1,3,0,0,0,2,2,1,0,0,1,3,3
401365824,George Washington Revolutionaries,B. Freeman,4613126,,True,26.0,3,7,2,4,1,3,0,0,0,3,3,4,2,0,3,2,7
401365824,George Washington Revolutionaries,J. Bamisile,4432537,,True,31.0,5,10,2,3,3,7,6,8,0,4,4,1,1,1,1,2,19
401365824,George Washington Revolutionaries,J. Bishop,4431770,,True,35.0,9,18,3,8,6,10,2,2,1,2,3,1,3,0,1,1,26
401365824,George Washington Revolutionaries,R. Lindo Jr.,4397186,,False,19.0,3,6,1,1,2,5,0,0,1,2,3,1,0,0,1,4,8
401365824,George Washington Revolutionaries,N. Brown,4700963,,False,7.0,2,2,2,2,0,0,1,1,1,1,2,0,0,0,0,4,5
401365824,George Washington Revolutionaries,B. Adams,4396612,,False,30.0,2,5,2,3,0,2,1,1,0,1,1,3,0,0,1,0,5
401365824,George Washington Revolutionaries,TEAM,TOTAL,TOTAL,False,,25,52,12,22,13,30,10,12,3,18,21,12,7,1,9,21,73
401365824,Davidson Wildcats,S. Mennenga,4700862,,True,23.0,4,5,4,5,0,0,3,4,3,0,3,0,0,1,0,2,11
401365824,Davidson Wildcats,L. Brajkovic,4396787,,True,35.0,11,14,9,11,2,3,6,7,1,7,8,3,1,1,2,3,30
401365824,Davidson Wildcats,H. Lee,4592308,,True,33.0,1,8,0,1,1,7,3,6,0,3,3,2,0,0,1,2,6
401365824,Davidson Wildcats,F. Loyer,4397208,,True,37.0,6,11,3,5,3,6,1,2,0,3,3,5,2,0,3,2,16
401365824,Davidson Wildcats,M. Jones,4396784,,True,33.0,1,4,0,0,1,4,1,2,1,2,3,2,0,0,1,3,4
401365824,Davidson Wildcats,N. Boachie-Yiadom,4396786,,False,14.0,1,2,1,1,0,1,0,0,0,2,2,0,1,0,1,1,2
401365824,Davidson Wildcats,D. Watson,4897098,,False,8.0,0,1,0,1,0,0,2,2,0,0,0,0,0,0,1,1,2
401365824,Davidson Wildcats,G. Huffman,4432522,,False,17.0,3,3,2,2,1,1,0,0,0,4,4,2,0,0,0,0,7
401365824,Davidson Wildcats,TEAM,TOTAL,TOTAL,False,,27,48,19,26,8,22,16,23,5,24,29,14,4,2,10,14,78
401365824,Davidson Wildcats,S. Mennenga,4700862,,True,23.0,4,5,4,5,0,0,3,4,3,0,3,0,0,1,0,2,11
401365824,Davidson Wildcats,L. Brajkovic,4396787,,True,35.0,11,14,9,11,2,3,6,7,1,7,8,3,1,1,2,3,30
401365824,Davidson Wildcats,H. Lee,4592308,,True,33.0,1,8,0,1,1,7,3,6,0,3,3,2,0,0,1,2,6
401365824,Davidson Wildcats,F. Loyer,4397208,,True,37.0,6,11,3,5,3,6,1,2,0,3,3,5,2,0,3,2,16
401365824,Davidson Wildcats,M. Jones,4396784,,True,33.0,1,4,0,0,1,4,1,2,1,2,3,2,0,0,1,3,4
401365824,Davidson Wildcats,N. Boachie-Yiadom,4396786,,False,14.0,1,2,1,1,0,1,0,0,0,2,2,0,1,0,1,1,2
401365824,Davidson Wildcats,D. Watson,4897098,,False,8.0,0,1,0,1,0,0,2,2,0,0,0,0,0,0,1,1,2
401365824,Davidson Wildcats,G. Huffman,4432522,,False,17.0,3,3,2,2,1,1,0,0,0,4,4,2,0,0,0,0,7
401365824,Davidson Wildcats,TEAM,TOTAL,TOTAL,False,,27,48,19,26,8,22,16,23,5,24,29,14,4,2,10,14,78
401365823,St. Bonaventure Bonnies,O. Osunniyi,4397224,,True,33.0,5,7,5,7,0,0,0,0,0,7,7,3,0,1,0,1,10
401365823,St. Bonaventure Bonnies,J. Adaway,4279431,,True,38.0,6,12,3,5,3,7,1,2,1,4,5,1,0,0,2,1,16
401365823,St. Bonaventure Bonnies,J. Holmes,4701016,,True,34.0,4,10,3,8,1,2,0,1,0,3,3,2,2,0,3,4,9
401365823,St. Bonaventure Bonnies,D. Welch,4397221,,True,40.0,4,12,1,2,3,10,0,0,1,1,2,2,0,1,2,3,11
401365823,St. Bonaventure Bonnies,K. Lofton,4397220,,True,38.0,3,7,1,4,2,3,0,0,0,0,0,6,1,0,3,1,8
401365823,St. Bonaventure Bonnies,A. Coulibaly,4432889,,False,7.0,2,4,2,4,0,0,1,2,1,2,3,0,0,0,1,2,5
401365823,St. Bonaventure Bonnies,Q. Adams,4585591,,False,10.0,1,1,1,1,0,0,0,0,1,1,2,1,0,0,1,0,2
401365823,St. Bonaventure Bonnies,TEAM,TOTAL,TOTAL,False,,25,53,16,31,9,22,2,5,5,19,24,15,3,2,13,12,61
401365823,St. Bonaventure Bonnies,O. Osunniyi,4397224,,True,33.0,5,7,5,7,0,0,0,0,0,7,7,3,0,1,0,1,10
401365823,St. Bonaventure Bonnies,J. Adaway,4279431,,True,38.0,6,12,3,5,3,7,1,2,1,4,5,1,0,0,2,1,16
401365823,St. Bonaventure Bonnies,J. Holmes,4701016,,True,34.0,4,10,3,8,1,2,0,1,0,3,3,2,2,0,3,4,9
401365823,St. Bonaventure Bonnies,D. Welch,4397221,,True,40.0,4,12,1,2,3,10,0,0,1,1,2,2,0,1,2,3,11
401365823,St. Bonaventure Bonnies,K. Lofton,4397220,,True,38.0,3,7,1,4,2,3,0,0,0,0,0,6,1,0,3,1,8
401365823,St. Bonaventure Bonnies,A. Coulibaly,4432889,,False,7.0,2,4,2,4,0,0,1,2,1,2,3,0,0,0,1,2,5
401365823,St. Bonaventure Bonnies,Q. Adams,4585591,,False,10.0,1,1,1,1,0,0,0,0,1,1,2,1,0,0,1,0,2
401365823,St. Bonaventure Bonnies,TEAM,TOTAL,TOTAL,False,,25,53,16,31,9,22,2,5,5,19,24,15,3,2,13,12,61
401365823,Richmond Spiders,T. Burton,4431914,,True,36.0,13,20,10,14,3,6,7,9,4,3,7,0,2,0,4,1,36
401365823,Richmond Spiders,N. Cayo,4278380,,True,33.0,3,7,3,7,0,0,0,0,0,3,3,3,1,0,0,1,6
401365823,Richmond Spiders,G. Golden,4066836,,True,22.0,5,9,5,7,0,2,2,2,2,8,10,2,0,0,1,2,12
401365823,Richmond Spiders,A. Gustavson,4397193,,True,34.0,2,6,1,1,1,5,4,4,0,3,3,0,3,0,0,1,9
401365823,Richmond Spiders,J. Gilyard,4278378,,True,40.0,1,6,0,0,1,6,0,0,1,3,4,8,2,0,3,3,3
401365823,Richmond Spiders,M. Grace,4397192,,False,18.0,2,4,1,2,1,2,0,0,2,3,5,2,0,1,0,1,5
401365823,Richmond Spiders,I. Wilson,4700973,,False,4.0,0,1,0,0,0,1,0,0,0,0,0,0,0,0,1,0,0
401365823,Richmond Spiders,C. Crabtree,4396658,,False,2.0,0,0,0,0,0,0,0,0,0,0,0,0,0,0,0,0,0
401365823,Richmond Spiders,N. Sherod,4066832,,False,11.0,0,2,0,1,0,1,0,0,0,1,1,0,1,0,0,1,0
401365823,Richmond Spiders,TEAM,TOTAL,TOTAL,False,,26,55,20,32,6,23,13,15,10,25,35,15,9,1,12,10,71
401365823,Richmond Spiders,T. Burton,4431914,,True,36.0,13,20,10,14,3,6,7,9,4,3,7,0,2,0,4,1,36
401365823,Richmond Spiders,N. Cayo,4278380,,True,33.0,3,7,3,7,0,0,0,0,0,3,3,3,1,0,0,1,6
401365823,Richmond Spiders,G. Golden,4066836,,True,22.0,5,9,5,7,0,2,2,2,2,8,10,2,0,0,1,2,12
401365823,Richmond Spiders,A. Gustavson,4397193,,True,34.0,2,6,1,1,1,5,4,4,0,3,3,0,3,0,0,1,9
401365823,Richmond Spiders,J. Gilyard,4278378,,True,40.0,1,6,0,0,1,6,0,0,1,3,4,8,2,0,3,3,3
401365823,Richmond Spiders,M. Grace,4397192,,False,18.0,2,4,1,2,1,2,0,0,2,3,5,2,0,1,0,1,5
401365823,Richmond Spiders,I. Wilson,4700973,,False,4.0,0,1,0,0,0,1,0,0,0,0,0,0,0,0,1,0,0
401365823,Richmond Spiders,C. Crabtree,4396658,,False,2.0,0,0,0,0,0,0,0,0,0,0,0,0,0,0,0,0,0
401365823,Richmond Spiders,N. Sherod,4066832,,False,11.0,0,2,0,1,0,1,0,0,0,1,1,0,1,0,0,1,0
401365823,Richmond Spiders,TEAM,TOTAL,TOTAL,False,,26,55,20,32,6,23,13,15,10,25,35,15,9,1,12,10,71
401365822,La Salle Explorers,M. Doucoure,4277988,,True,19.0,4,6,4,6,0,0,0,0,3,3,6,0,0,0,1,2,8
401365822,La Salle Explorers,C. Moore,4277945,,True,31.0,4,12,3,10,1,2,4,6,6,4,10,2,0,1,3,2,13
401365822,La Salle Explorers,J. Clark,4397152,,True,36.0,5,18,3,10,2,8,5,6,4,7,11,2,3,0,0,1,17
401365822,La Salle Explorers,J. Brickus,4700970,,True,32.0,7,12,2,4,5,8,1,1,1,1,2,8,1,0,2,3,20
401365822,La Salle Explorers,J. Nickelberry,4432845,,True,22.0,5,8,4,4,1,4,2,2,0,2,2,0,0,0,3,2,13
401365822,La Salle Explorers,K. Brantley,4709132,,False,18.0,4,7,2,4,2,3,1,2,2,2,4,4,1,0,2,3,11
401365822,La Salle Explorers,A. Gill,4700969,,False,18.0,0,2,0,0,0,2,0,0,0,2,2,1,0,0,2,1,0
401365822,La Salle Explorers,C. Ray,4592448,,False,24.0,2,5,1,2,1,3,0,0,3,3,6,1,0,0,0,3,5
401365822,La Salle Explorers,TEAM,TOTAL,TOTAL,False,,31,70,19,40,12,30,13,17,21,25,46,18,5,1,13,17,87
401365822,La Salle Explorers,M. Doucoure,4277988,,True,19.0,4,6,4,6,0,0,0,0,3,3,6,0,0,0,1,2,8
401365822,La Salle Explorers,C. Moore,4277945,,True,31.0,4,12,3,10,1,2,4,6,6,4,10,2,0,1,3,2,13
401365822,La Salle Explorers,J. Clark,4397152,,True,36.0,5,18,3,10,2,8,5,6,4,7,11,2,3,0,0,1,17
401365822,La Salle Explorers,J. Brickus,4700970,,True,32.0,7,12,2,4,5,8,1,1,1,1,2,8,1,0,2,3,20
401365822,La Salle Explorers,J. Nickelberry,4432845,,True,22.0,5,8,4,4,1,4,2,2,0,2,2,0,0,0,3,2,13
401365822,La Salle Explorers,K. Brantley,4709132,,False,18.0,4,7,2,4,2,3,1,2,2,2,4,4,1,0,2,3,11
401365822,La Salle Explorers,A. Gill,4700969,,False,18.0,0,2,0,0,0,2,0,0,0,2,2,1,0,0,2,1,0
401365822,La Salle Explorers,C. Ray,4592448,,False,24.0,2,5,1,2,1,3,0,0,3,3,6,1,0,0,0,3,5
401365822,La Salle Explorers,TEAM,TOTAL,TOTAL,False,,31,70,19,40,12,30,13,17,21,25,46,18,5,1,13,17,87
401365822,George Washington Revolutionaries,H. Dean,4593273,,True,29.0,4,6,4,6,0,0,5,5,3,3,6,0,1,5,1,4,13
401365822,George Washington Revolutionaries,Q. Samuels,4592251,,True,27.0,3,4,1,1,2,3,0,0,1,3,4,2,1,1,0,3,8
401365822,George Washington Revolutionaries,B. Freeman,4613126,,True,31.0,4,9,3,8,1,1,3,4,2,1,3,8,2,0,1,2,12
401365822,George Washington Revolutionaries,J. Bamisile,4432537,,True,35.0,8,14,1,4,7,10,1,2,0,2,2,2,4,0,3,2,24
401365822,George Washington Revolutionaries,J. Bishop,4431770,,True,32.0,7,14,5,9,2,5,11,14,0,4,4,2,1,0,0,2,27
401365822,George Washington Revolutionaries,R. Lindo Jr.,4397186,,False,14.0,1,3,1,3,0,0,0,0,0,3,3,1,2,0,3,2,2
401365822,George Washington Revolutionaries,A. Harris,4397216,,False,3.0,0,1,0,1,0,0,0,0,0,0,0,0,0,0,0,0,0
401365822,George Washington Revolutionaries,B. Adams,4396612,,False,29.0,1,5,0,2,1,3,0,0,0,4,4,4,1,0,0,1,3
401365822,George Washington Revolutionaries,TEAM,TOTAL,TOTAL,False,,28,56,15,34,13,22,20,25,6,20,26,19,12,6,9,16,89
401365822,George Washington Revolutionaries,H. Dean,4593273,,True,29.0,4,6,4,6,0,0,5,5,3,3,6,0,1,5,1,4,13
401365822,George Washington Revolutionaries,Q. Samuels,4592251,,True,27.0,3,4,1,1,2,3,0,0,1,3,4,2,1,1,0,3,8
401365822,George Washington Revolutionaries,B. Freeman,4613126,,True,31.0,4,9,3,8,1,1,3,4,2,1,3,8,2,0,1,2,12
401365822,George Washington Revolutionaries,J. Bamisile,4432537,,True,35.0,8,14,1,4,7,10,1,2,0,2,2,2,4,0,3,2,24
401365822,George Washington Revolutionaries,J. Bishop,4431770,,True,32.0,7,14,5,9,2,5,11,14,0,4,4,2,1,0,0,2,27
401365822,George Washington Revolutionaries,R. Lindo Jr.,4397186,,False,14.0,1,3,1,3,0,0,0,0,0,3,3,1,2,0,3,2,2
401365822,George Washington Revolutionaries,A. Harris,4397216,,False,3.0,0,1,0,1,0,0,0,0,0,0,0,0,0,0,0,0,0
401365822,George Washington Revolutionaries,B. Adams,4396612,,False,29.0,1,5,0,2,1,3,0,0,0,4,4,4,1,0,0,1,3
401365822,George Washington Revolutionaries,TEAM,TOTAL,TOTAL,False,,28,56,15,34,13,22,20,25,6,20,26,19,12,6,9,16,89
401365821,Saint Louis Billikens,F. Okoro,4397105,,True,25.0,6,8,6,8,0,0,2,2,4,5,9,1,1,1,0,5,14
401365821,Saint Louis Billikens,J. Nesbitt,4714246,,True,43.0,4,9,2,3,2,6,4,5,1,4,5,1,2,2,6,4,14
401365821,Saint Louis Billikens,Y. Collins,4432957,,True,47.0,11,24,8,17,3,7,10,10,0,5,5,13,5,0,3,3,35
401365821,Saint Louis Billikens,G. Jimerson,4432008,,True,39.0,3,14,1,7,2,7,0,0,1,2,3,0,1,0,2,4,8
401365821,Saint Louis Billikens,F. Thatch Jr.,4397199,,True,32.0,2,7,1,5,1,2,0,0,0,2,2,0,2,0,1,3,5
401365821,Saint Louis Billikens,L. Traore,4897052,,False,8.0,0,0,0,0,0,0,0,0,0,1,1,0,0,0,0,3,0
401365821,Saint Louis Billikens,T. Hargrove Jr.,4592484,,False,27.0,2,6,1,4,1,2,0,1,2,2,4,1,0,1,0,1,5
401365821,Saint Louis Billikens,M. Linssen,4279174,,False,11.0,1,2,1,2,0,0,3,4,0,3,3,0,0,0,0,5,5
401365821,Saint Louis Billikens,R. Williams,4399106,,False,10.0,1,4,0,1,1,3,0,0,1,1,2,0,1,0,0,0,3
401365821,Saint Louis Billikens,D. Jones,4278267,,False,8.0,1,3,0,0,1,3,0,0,0,0,0,2,0,0,0,2,3
401365821,Saint Louis Billikens,TEAM,TOTAL,TOTAL,False,,31,77,20,47,11,30,19,22,12,28,40,18,12,4,12,30,92
401365821,Saint Louis Billikens,F. Okoro,4397105,,True,25.0,6,8,6,8,0,0,2,2,4,5,9,1,1,1,0,5,14
401365821,Saint Louis Billikens,J. Nesbitt,4714246,,True,43.0,4,9,2,3,2,6,4,5,1,4,5,1,2,2,6,4,14
401365821,Saint Louis Billikens,Y. Collins,4432957,,True,47.0,11,24,8,17,3,7,10,10,0,5,5,13,5,0,3,3,35
401365821,Saint Louis Billikens,G. Jimerson,4432008,,True,39.0,3,14,1,7,2,7,0,0,1,2,3,0,1,0,2,4,8
401365821,Saint Louis Billikens,F. Thatch Jr.,4397199,,True,32.0,2,7,1,5,1,2,0,0,0,2,2,0,2,0,1,3,5
401365821,Saint Louis Billikens,L. Traore,4897052,,False,8.0,0,0,0,0,0,0,0,0,0,1,1,0,0,0,0,3,0
401365821,Saint Louis Billikens,T. Hargrove Jr.,4592484,,False,27.0,2,6,1,4,1,2,0,1,2,2,4,1,0,1,0,1,5
401365821,Saint Louis Billikens,M. Linssen,4279174,,False,11.0,1,2,1,2,0,0,3,4,0,3,3,0,0,0,0,5,5
401365821,Saint Louis Billikens,R. Williams,4399106,,False,10.0,1,4,0,1,1,3,0,0,1,1,2,0,1,0,0,0,3
401365821,Saint Louis Billikens,D. Jones,4278267,,False,8.0,1,3,0,0,1,3,0,0,0,0,0,2,0,0,0,2,3
401365821,Saint Louis Billikens,TEAM,TOTAL,TOTAL,False,,31,77,20,47,11,30,19,22,12,28,40,18,12,4,12,30,92
401365821,George Mason Patriots,J. Oduro,4432068,,True,42.0,11,22,10,20,1,2,9,13,3,3,6,2,0,3,4,3,32
401365821,George Mason Patriots,X. Johnson,4592439,,True,45.0,3,10,2,7,1,3,0,0,0,3,3,4,3,0,5,4,7
401365821,George Mason Patriots,D. Gaines,4431961,,True,50.0,2,3,2,2,0,1,8,9,5,12,17,1,1,1,1,3,12
401365821,George Mason Patriots,D. Cooper,4279876,,True,44.0,8,15,3,4,5,11,1,2,0,4,4,1,0,0,5,3,22
401365821,George Mason Patriots,D. Schwartz,4278501,,True,48.0,6,14,4,10,2,4,1,4,2,7,9,3,0,0,0,2,15
401365821,George Mason Patriots,M. Henry,4606836,,False,3.0,0,2,0,2,0,0,0,0,1,1,2,0,0,0,0,1,0
401365821,George Mason Patriots,O. Frazier III,4700882,,False,11.0,1,1,1,1,0,0,0,0,0,1,1,0,0,1,1,2,2
401365821,George Mason Patriots,T. Gadsden,4719466,,False,1.0,0,0,0,0,0,0,0,0,0,0,0,0,0,0,0,1,0
401365821,George Mason Patriots,R. Polite III,4567711,,False,5.0,0,1,0,1,0,0,0,0,0,0,0,0,0,0,1,0,0
401365821,George Mason Patriots,J. Hartwell II,4396817,,False,1.0,0,0,0,0,0,0,0,0,0,0,0,0,0,0,0,0,0
401365821,George Mason Patriots,TEAM,TOTAL,TOTAL,False,,31,68,22,47,9,21,19,28,13,35,48,11,4,5,17,19,90
401365821,George Mason Patriots,J. Oduro,4432068,,True,42.0,11,22,10,20,1,2,9,13,3,3,6,2,0,3,4,3,32
401365821,George Mason Patriots,X. Johnson,4592439,,True,45.0,3,10,2,7,1,3,0,0,0,3,3,4,3,0,5,4,7
401365821,George Mason Patriots,D. Gaines,4431961,,True,50.0,2,3,2,2,0,1,8,9,5,12,17,1,1,1,1,3,12
401365821,George Mason Patriots,D. Cooper,4279876,,True,44.0,8,15,3,4,5,11,1,2,0,4,4,1,0,0,5,3,22
401365821,George Mason Patriots,D. Schwartz,4278501,,True,48.0,6,14,4,10,2,4,1,4,2,7,9,3,0,0,0,2,15
401365821,George Mason Patriots,M. Henry,4606836,,False,3.0,0,2,0,2,0,0,0,0,1,1,2,0,0,0,0,1,0
401365821,George Mason Patriots,O. Frazier III,4700882,,False,11.0,1,1,1,1,0,0,0,0,0,1,1,0,0,1,1,2,2
401365821,George Mason Patriots,T. Gadsden,4719466,,False,1.0,0,0,0,0,0,0,0,0,0,0,0,0,0,0,0,1,0
401365821,George Mason Patriots,R. Polite III,4567711,,False,5.0,0,1,0,1,0,0,0,0,0,0,0,0,0,0,1,0,0
401365821,George Mason Patriots,J. Hartwell II,4396817,,False,1.0,0,0,0,0,0,0,0,0,0,0,0,0,0,0,0,0,0
401365821,George Mason Patriots,TEAM,TOTAL,TOTAL,False,,31,68,22,47,9,21,19,28,13,35,48,11,4,5,17,19,90
401365820,Rhode Island Rams,Makhel Mitchell,4431777,,True,28.0,5,9,5,9,0,0,3,9,2,7,9,1,3,4,3,4,13
401365820,Rhode Island Rams,Makhi Mitchell,4431708,,True,19.0,1,4,1,4,0,0,1,3,1,3,4,2,2,1,1,3,3
401365820,Rhode Island Rams,I. Leggett,4606837,,True,31.0,1,7,0,4,1,3,1,2,1,2,3,1,1,0,3,5,4
401365820,Rhode Island Rams,I. El-Amin,4279313,,True,17.0,1,2,0,1,1,1,0,0,0,1,1,2,0,0,1,1,3
401365820,Rhode Island Rams,J. Sheppard,4066445,,True,26.0,1,7,1,4,0,3,0,0,0,1,1,3,1,0,1,1,2
401365820,Rhode Island Rams,A. Walker,4278567,,False,25.0,1,2,1,2,0,0,0,2,2,5,7,1,1,0,0,0,2
401365820,Rhode Island Rams,M. Martin,4397470,,False,18.0,2,8,1,5,1,3,2,2,1,0,1,0,0,0,0,1,7
401365820,Rhode Island Rams,J. Carey,4395673,,False,22.0,5,11,4,8,1,3,1,2,0,1,1,3,0,0,2,1,12
401365820,Rhode Island Rams,S. Thomas,4897065,,False,14.0,3,4,0,0,3,4,0,0,1,2,3,2,2,0,3,1,9
401365820,Rhode Island Rams,TEAM,TOTAL,TOTAL,False,,20,54,13,37,7,17,8,20,13,25,38,15,10,5,14,17,55
401365820,Rhode Island Rams,Makhel Mitchell,4431777,,True,28.0,5,9,5,9,0,0,3,9,2,7,9,1,3,4,3,4,13
401365820,Rhode Island Rams,Makhi Mitchell,4431708,,True,19.0,1,4,1,4,0,0,1,3,1,3,4,2,2,1,1,3,3
401365820,Rhode Island Rams,I. Leggett,4606837,,True,31.0,1,7,0,4,1,3,1,2,1,2,3,1,1,0,3,5,4
401365820,Rhode Island Rams,I. El-Amin,4279313,,True,17.0,1,2,0,1,1,1,0,0,0,1,1,2,0,0,1,1,3
401365820,Rhode Island Rams,J. Sheppard,4066445,,True,26.0,1,7,1,4,0,3,0,0,0,1,1,3,1,0,1,1,2
401365820,Rhode Island Rams,A. Walker,4278567,,False,25.0,1,2,1,2,0,0,0,2,2,5,7,1,1,0,0,0,2
401365820,Rhode Island Rams,M. Martin,4397470,,False,18.0,2,8,1,5,1,3,2,2,1,0,1,0,0,0,0,1,7
401365820,Rhode Island Rams,J. Carey,4395673,,False,22.0,5,11,4,8,1,3,1,2,0,1,1,3,0,0,2,1,12
401365820,Rhode Island Rams,S. Thomas,4897065,,False,14.0,3,4,0,0,3,4,0,0,1,2,3,2,2,0,3,1,9
401365820,Rhode Island Rams,TEAM,TOTAL,TOTAL,False,,20,54,13,37,7,17,8,20,13,25,38,15,10,5,14,17,55
401365820,Fordham Rams,A. Tsimbila,4702329,,True,18.0,2,4,2,4,0,0,0,1,2,3,5,0,0,4,1,4,4
401365820,Fordham Rams,C. Ohams,4066856,,True,31.0,6,10,6,9,0,1,2,6,1,12,13,4,0,1,5,2,14
401365820,Fordham Rams,A. Charlton,4897085,,True,33.0,1,7,0,2,1,5,2,2,0,4,4,3,1,0,4,2,5
401365820,Fordham Rams,K. Rose,4592315,,True,24.0,1,7,0,2,1,5,0,0,1,2,3,1,1,0,3,3,3
401365820,Fordham Rams,D. Quisenberry,4397790,,True,38.0,6,18,3,8,3,10,0,0,0,3,3,7,3,1,1,1,15
401365820,Fordham Rams,P. Kelly,4432014,,False,15.0,2,3,0,1,2,2,0,0,1,0,1,0,0,0,0,2,6
401365820,Fordham Rams,R. Novitskyi,4897084,,False,14.0,0,0,0,0,0,0,2,2,1,1,2,0,0,2,2,3,2
401365820,Fordham Rams,A. Harrison,4897086,,False,2.0,0,0,0,0,0,0,0,0,0,0,0,0,0,0,0,1,0
401365820,Fordham Rams,J. Navarro,4592316,,False,25.0,4,6,3,3,1,3,3,3,2,3,5,3,2,0,1,2,12
401365820,Fordham Rams,TEAM,TOTAL,TOTAL,False,,22,55,14,29,8,26,9,14,11,29,40,18,7,8,17,20,61
401365820,Fordham Rams,A. Tsimbila,4702329,,True,18.0,2,4,2,4,0,0,0,1,2,3,5,0,0,4,1,4,4
401365820,Fordham Rams,C. Ohams,4066856,,True,31.0,6,10,6,9,0,1,2,6,1,12,13,4,0,1,5,2,14
401365820,Fordham Rams,A. Charlton,4897085,,True,33.0,1,7,0,2,1,5,2,2,0,4,4,3,1,0,4,2,5
401365820,Fordham Rams,K. Rose,4592315,,True,24.0,1,7,0,2,1,5,0,0,1,2,3,1,1,0,3,3,3
401365820,Fordham Rams,D. Quisenberry,4397790,,True,38.0,6,18,3,8,3,10,0,0,0,3,3,7,3,1,1,1,15
401365820,Fordham Rams,P. Kelly,4432014,,False,15.0,2,3,0,1,2,2,0,0,1,0,1,0,0,0,0,2,6
401365820,Fordham Rams,R. Novitskyi,4897084,,False,14.0,0,0,0,0,0,0,2,2,1,1,2,0,0,2,2,3,2
401365820,Fordham Rams,A. Harrison,4897086,,False,2.0,0,0,0,0,0,0,0,0,0,0,0,0,0,0,0,1,0
401365820,Fordham Rams,J. Navarro,4592316,,False,25.0,4,6,3,3,1,3,3,3,2,3,5,3,2,0,1,2,12
401365820,Fordham Rams,TEAM,TOTAL,TOTAL,False,,22,55,14,29,8,26,9,14,11,29,40,18,7,8,17,20,61
401365819,VCU Rams,H. Ward,4592495,,True,31.0,4,6,4,6,0,0,0,1,4,4,8,2,1,2,1,3,8
401365819,VCU Rams,L. Stockard III,4277897,,True,20.0,1,1,1,1,0,0,0,0,0,3,3,1,1,0,2,4,2
401365819,VCU Rams,J. Nunn,4896614,,True,25.0,1,6,1,5,0,1,3,3,0,2,2,1,0,0,3,1,5
401365819,VCU Rams,A. Baldwin Jr.,4433182,,True,33.0,4,8,2,5,2,3,2,2,0,2,2,4,1,1,4,0,12
401365819,VCU Rams,K. Curry,4397228,,True,27.0,2,8,2,7,0,1,3,4,0,0,0,1,0,0,1,1,7
401365819,VCU Rams,M. Brown-Jones,4433224,,False,22.0,4,5,4,5,0,0,2,2,2,1,3,1,2,0,0,3,10
401365819,VCU Rams,J. Nichols Jr.,4397108,,False,7.0,0,0,0,0,0,0,2,2,0,1,1,0,0,3,3,1,2
401365819,VCU Rams,N. Kern,4684145,,False,10.0,1,3,1,2,0,1,2,2,0,0,0,0,0,0,0,0,4
401365819,VCU Rams,A. Henderson VI,4592494,,False,1.0,0,1,0,0,0,1,0,0,0,0,0,0,1,0,0,0,0
401365819,VCU Rams,M. Tsohonis,4592438,,False,12.0,0,3,0,1,0,2,0,0,0,0,0,0,0,0,1,1,0
401365819,VCU Rams,J. Banks,4432402,,False,12.0,1,3,1,1,0,2,0,0,0,1,1,0,0,0,1,0,2
401365819,VCU Rams,TEAM,TOTAL,TOTAL,False,,18,44,16,33,2,11,14,16,6,16,22,10,6,6,17,14,52
401365819,VCU Rams,H. Ward,4592495,,True,31.0,4,6,4,6,0,0,0,1,4,4,8,2,1,2,1,3,8
401365819,VCU Rams,L. Stockard III,4277897,,True,20.0,1,1,1,1,0,0,0,0,0,3,3,1,1,0,2,4,2
401365819,VCU Rams,J. Nunn,4896614,,True,25.0,1,6,1,5,0,1,3,3,0,2,2,1,0,0,3,1,5
401365819,VCU Rams,A. Baldwin Jr.,4433182,,True,33.0,4,8,2,5,2,3,2,2,0,2,2,4,1,1,4,0,12
401365819,VCU Rams,K. Curry,4397228,,True,27.0,2,8,2,7,0,1,3,4,0,0,0,1,0,0,1,1,7
401365819,VCU Rams,M. Brown-Jones,4433224,,False,22.0,4,5,4,5,0,0,2,2,2,1,3,1,2,0,0,3,10
401365819,VCU Rams,J. Nichols Jr.,4397108,,False,7.0,0,0,0,0,0,0,2,2,0,1,1,0,0,3,3,1,2
401365819,VCU Rams,N. Kern,4684145,,False,10.0,1,3,1,2,0,1,2,2,0,0,0,0,0,0,0,0,4
401365819,VCU Rams,A. Henderson VI,4592494,,False,1.0,0,1,0,0,0,1,0,0,0,0,0,0,1,0,0,0,0
401365819,VCU Rams,M. Tsohonis,4592438,,False,12.0,0,3,0,1,0,2,0,0,0,0,0,0,0,0,1,1,0
401365819,VCU Rams,J. Banks,4432402,,False,12.0,1,3,1,1,0,2,0,0,0,1,1,0,0,0,1,0,2
401365819,VCU Rams,TEAM,TOTAL,TOTAL,False,,18,44,16,33,2,11,14,16,6,16,22,10,6,6,17,14,52
401365819,Dayton Flyers,R.J. Blakney,4700864,,True,22.0,2,4,2,3,0,1,1,2,3,2,5,4,1,1,0,0,5
401365819,Dayton Flyers,T. Camara,4431736,,True,31.0,7,13,3,8,4,5,0,2,2,6,8,3,3,0,5,3,18
401365819,Dayton Flyers,D. Holmes II,4433607,,True,34.0,8,13,8,13,0,0,5,6,4,3,7,1,1,1,0,1,21
401365819,Dayton Flyers,M. Smith,4683861,,True,33.0,2,4,1,3,1,1,0,1,0,2,2,3,3,0,1,2,5
401365819,Dayton Flyers,K. Elvis,4683135,,True,32.0,9,14,9,11,0,3,2,2,1,2,3,3,0,0,1,1,20
401365819,Dayton Flyers,M. Sissoko,4431824,,False,5.0,1,3,1,3,0,0,1,1,4,1,5,1,0,0,1,1,3
401365819,Dayton Flyers,M. Amzil,4711607,,False,10.0,0,1,0,0,0,1,0,0,1,1,2,0,0,0,2,4,0
401365819,Dayton Flyers,K. Washington,4684293,,False,6.0,1,2,1,2,0,0,0,0,0,3,3,1,0,0,0,0,2
401365819,Dayton Flyers,Z. Nwokeji,4618121,,False,4.0,1,4,0,3,1,1,0,0,0,0,0,0,0,0,0,3,3
401365819,Dayton Flyers,C. Wilson,4403456,,False,3.0,0,0,0,0,0,0,0,0,1,0,1,0,0,0,1,0,0
401365819,Dayton Flyers,D. Swerlein,4600089,,False,1.0,0,0,0,0,0,0,0,0,0,0,0,0,0,0,0,0,0
401365819,Dayton Flyers,K. Brea,4591259,,False,19.0,2,5,1,2,1,3,0,0,0,2,2,2,1,0,0,1,5
401365819,Dayton Flyers,TEAM,TOTAL,TOTAL,False,,33,63,26,48,7,15,9,14,18,22,40,18,9,2,12,16,82
401365819,Dayton Flyers,R.J. Blakney,4700864,,True,22.0,2,4,2,3,0,1,1,2,3,2,5,4,1,1,0,0,5
401365819,Dayton Flyers,T. Camara,4431736,,True,31.0,7,13,3,8,4,5,0,2,2,6,8,3,3,0,5,3,18
401365819,Dayton Flyers,D. Holmes II,4433607,,True,34.0,8,13,8,13,0,0,5,6,4,3,7,1,1,1,0,1,21
401365819,Dayton Flyers,M. Smith,4683861,,True,33.0,2,4,1,3,1,1,0,1,0,2,2,3,3,0,1,2,5
401365819,Dayton Flyers,K. Elvis,4683135,,True,32.0,9,14,9,11,0,3,2,2,1,2,3,3,0,0,1,1,20
401365819,Dayton Flyers,M. Sissoko,4431824,,False,5.0,1,3,1,3,0,0,1,1,4,1,5,1,0,0,1,1,3
401365819,Dayton Flyers,M. Amzil,4711607,,False,10.0,0,1,0,0,0,1,0,0,1,1,2,0,0,0,2,4,0
401365819,Dayton Flyers,K. Washington,4684293,,False,6.0,1,2,1,2,0,0,0,0,0,3,3,1,0,0,0,0,2
401365819,Dayton Flyers,Z. Nwokeji,4618121,,False,4.0,1,4,0,3,1,1,0,0,0,0,0,0,0,0,0,3,3
401365819,Dayton Flyers,C. Wilson,4403456,,False,3.0,0,0,0,0,0,0,0,0,1,0,1,0,0,0,1,0,0
401365819,Dayton Flyers,D. Swerlein,4600089,,False,1.0,0,0,0,0,0,0,0,0,0,0,0,0,0,0,0,0,0
401365819,Dayton Flyers,K. Brea,4591259,,False,19.0,2,5,1,2,1,3,0,0,0,2,2,2,1,0,0,1,5
401365819,Dayton Flyers,TEAM,TOTAL,TOTAL,False,,33,63,26,48,7,15,9,14,18,22,40,18,9,2,12,16,82
401365818,Richmond Spiders,T. Burton,4431914,,True,31.0,5,13,2,6,3,7,5,8,3,9,12,3,0,1,1,0,18
401365818,Richmond Spiders,N. Cayo,4278380,,True,26.0,5,8,5,8,0,0,0,1,2,0,2,1,0,0,0,2,10
401365818,Richmond Spiders,G. Golden,4066836,,True,22.0,3,4,3,3,0,1,1,2,0,7,7,4,1,1,3,1,7
401365818,Richmond Spiders,A. Gustavson,4397193,,True,28.0,3,6,0,2,3,4,0,0,0,0,0,1,0,0,1,1,9
401365818,Richmond Spiders,J. Gilyard,4278378,,True,35.0,5,8,1,1,4,7,3,3,0,2,2,3,4,0,2,1,17
401365818,Richmond Spiders,M. Grace,4397192,,False,18.0,1,1,1,1,0,0,0,0,0,3,3,3,1,1,1,0,2
401365818,Richmond Spiders,S. Koureissi,4397190,,False,3.0,0,0,0,0,0,0,0,0,0,0,0,0,0,0,0,0,0
401365818,Richmond Spiders,M. Randolph,4710356,,False,6.0,0,2,0,2,0,0,0,0,0,0,0,1,0,0,1,2,0
401365818,Richmond Spiders,I. Wilson,4700973,,False,18.0,2,3,1,1,1,2,0,0,0,2,2,1,2,1,1,2,5
401365818,Richmond Spiders,N. Sherod,4066832,,False,13.0,2,7,0,4,2,3,0,0,1,1,2,2,0,0,0,1,6
401365818,Richmond Spiders,TEAM,TOTAL,TOTAL,False,,26,52,13,28,13,24,9,14,9,25,34,19,8,4,12,10,74
401365818,Richmond Spiders,T. Burton,4431914,,True,31.0,5,13,2,6,3,7,5,8,3,9,12,3,0,1,1,0,18
401365818,Richmond Spiders,N. Cayo,4278380,,True,26.0,5,8,5,8,0,0,0,1,2,0,2,1,0,0,0,2,10
401365818,Richmond Spiders,G. Golden,4066836,,True,22.0,3,4,3,3,0,1,1,2,0,7,7,4,1,1,3,1,7
401365818,Richmond Spiders,A. Gustavson,4397193,,True,28.0,3,6,0,2,3,4,0,0,0,0,0,1,0,0,1,1,9
401365818,Richmond Spiders,J. Gilyard,4278378,,True,35.0,5,8,1,1,4,7,3,3,0,2,2,3,4,0,2,1,17
401365818,Richmond Spiders,M. Grace,4397192,,False,18.0,1,1,1,1,0,0,0,0,0,3,3,3,1,1,1,0,2
401365818,Richmond Spiders,S. Koureissi,4397190,,False,3.0,0,0,0,0,0,0,0,0,0,0,0,0,0,0,0,0,0
401365818,Richmond Spiders,M. Randolph,4710356,,False,6.0,0,2,0,2,0,0,0,0,0,0,0,1,0,0,1,2,0
401365818,Richmond Spiders,I. Wilson,4700973,,False,18.0,2,3,1,1,1,2,0,0,0,2,2,1,2,1,1,2,5
401365818,Richmond Spiders,N. Sherod,4066832,,False,13.0,2,7,0,4,2,3,0,0,1,1,2,2,0,0,0,1,6
401365818,Richmond Spiders,TEAM,TOTAL,TOTAL,False,,26,52,13,28,13,24,9,14,9,25,34,19,8,4,12,10,74
401365818,Duquesne Dukes,T. Williams,4432147,,True,32.0,5,11,5,9,0,2,0,1,5,2,7,0,0,0,0,2,10
401365818,Duquesne Dukes,K. Easley,4398159,,True,28.0,3,8,3,4,0,4,0,0,4,4,8,3,3,0,1,0,6
401365818,Duquesne Dukes,A. Spears,4897090,,True,30.0,2,9,1,6,1,3,0,0,0,4,4,7,0,0,3,3,5
401365818,Duquesne Dukes,T. Okani,4700873,,True,25.0,5,7,5,6,0,1,3,4,1,3,4,0,1,1,0,2,13
401365818,Duquesne Dukes,T. Acuff,4606831,,True,22.0,2,4,1,1,1,3,0,0,1,1,2,0,0,0,1,1,5
401365818,Duquesne Dukes,M. Hima,4700878,,False,11.0,0,3,0,3,0,0,0,0,1,2,3,0,1,1,0,4,0
401365818,Duquesne Dukes,D. Larson,4897091,,False,3.0,0,0,0,0,0,0,0,0,0,0,0,0,0,0,0,0,0
401365818,Duquesne Dukes,J. Johnson III,4897088,,False,22.0,2,7,2,4,0,3,0,0,0,2,2,2,1,0,1,0,4
401365818,Duquesne Dukes,L. Ayers III,4703813,,False,24.0,5,12,3,7,2,5,2,2,1,1,2,0,0,1,3,1,14
401365818,Duquesne Dukes,M. Bekelja,4700874,,False,3.0,0,0,0,0,0,0,0,0,0,0,0,0,0,0,0,0,0
401365818,Duquesne Dukes,TEAM,TOTAL,TOTAL,False,,24,61,20,40,4,21,5,7,13,19,32,12,6,3,10,13,57
401365818,Duquesne Dukes,T. Williams,4432147,,True,32.0,5,11,5,9,0,2,0,1,5,2,7,0,0,0,0,2,10
401365818,Duquesne Dukes,K. Easley,4398159,,True,28.0,3,8,3,4,0,4,0,0,4,4,8,3,3,0,1,0,6
401365818,Duquesne Dukes,A. Spears,4897090,,True,30.0,2,9,1,6,1,3,0,0,0,4,4,7,0,0,3,3,5
401365818,Duquesne Dukes,T. Okani,4700873,,True,25.0,5,7,5,6,0,1,3,4,1,3,4,0,1,1,0,2,13
401365818,Duquesne Dukes,T. Acuff,4606831,,True,22.0,2,4,1,1,1,3,0,0,1,1,2,0,0,0,1,1,5
401365818,Duquesne Dukes,M. Hima,4700878,,False,11.0,0,3,0,3,0,0,0,0,1,2,3,0,1,1,0,4,0
401365818,Duquesne Dukes,D. Larson,4897091,,False,3.0,0,0,0,0,0,0,0,0,0,0,0,0,0,0,0,0,0
401365818,Duquesne Dukes,J. Johnson III,4897088,,False,22.0,2,7,2,4,0,3,0,0,0,2,2,2,1,0,1,0,4
401365818,Duquesne Dukes,L. Ayers III,4703813,,False,24.0,5,12,3,7,2,5,2,2,1,1,2,0,0,1,3,1,14
401365818,Duquesne Dukes,M. Bekelja,4700874,,False,3.0,0,0,0,0,0,0,0,0,0,0,0,0,0,0,0,0,0
401365818,Duquesne Dukes,TEAM,TOTAL,TOTAL,False,,24,61,20,40,4,21,5,7,13,19,32,12,6,3,10,13,57
401365817,St. Bonaventure Bonnies,O. Osunniyi,4397224,,True,33.0,3,6,3,6,0,0,1,1,1,4,5,0,0,1,3,5,7
401365817,St. Bonaventure Bonnies,J. Adaway,4279431,,True,35.0,8,12,7,9,1,3,4,5,0,3,3,0,1,0,0,4,21
401365817,St. Bonaventure Bonnies,J. Holmes,4701016,,True,40.0,1,10,1,7,0,3,7,8,4,1,5,4,0,0,4,1,9
401365817,St. Bonaventure Bonnies,D. Welch,4397221,,True,40.0,6,11,3,3,3,8,3,5,1,2,3,1,1,0,3,4,18
401365817,St. Bonaventure Bonnies,K. Lofton,4397220,,True,40.0,7,15,6,12,1,3,4,6,3,6,9,8,4,0,1,3,19
401365817,St. Bonaventure Bonnies,A. Coulibaly,4432889,,False,7.0,0,0,0,0,0,0,0,0,0,2,2,0,0,1,0,1,0
401365817,St. Bonaventure Bonnies,Q. Adams,4585591,,False,5.0,1,2,1,2,0,0,0,0,0,2,2,0,0,0,1,1,2
401365817,St. Bonaventure Bonnies,TEAM,TOTAL,TOTAL,False,,26,56,21,39,5,17,19,25,11,21,32,13,6,2,12,19,76
401365817,St. Bonaventure Bonnies,O. Osunniyi,4397224,,True,33.0,3,6,3,6,0,0,1,1,1,4,5,0,0,1,3,5,7
401365817,St. Bonaventure Bonnies,J. Adaway,4279431,,True,35.0,8,12,7,9,1,3,4,5,0,3,3,0,1,0,0,4,21
401365817,St. Bonaventure Bonnies,J. Holmes,4701016,,True,40.0,1,10,1,7,0,3,7,8,4,1,5,4,0,0,4,1,9
401365817,St. Bonaventure Bonnies,D. Welch,4397221,,True,40.0,6,11,3,3,3,8,3,5,1,2,3,1,1,0,3,4,18
401365817,St. Bonaventure Bonnies,K. Lofton,4397220,,True,40.0,7,15,6,12,1,3,4,6,3,6,9,8,4,0,1,3,19
401365817,St. Bonaventure Bonnies,A. Coulibaly,4432889,,False,7.0,0,0,0,0,0,0,0,0,0,2,2,0,0,1,0,1,0
401365817,St. Bonaventure Bonnies,Q. Adams,4585591,,False,5.0,1,2,1,2,0,0,0,0,0,2,2,0,0,0,1,1,2
401365817,St. Bonaventure Bonnies,TEAM,TOTAL,TOTAL,False,,26,56,21,39,5,17,19,25,11,21,32,13,6,2,12,19,76
401365817,Davidson Wildcats,S. Mennenga,4700862,,True,28.0,2,4,2,4,0,0,3,6,2,3,5,0,2,0,2,5,7
401365817,Davidson Wildcats,L. Brajkovic,4396787,,True,32.0,5,9,3,6,2,3,1,2,3,5,8,4,1,0,3,3,13
401365817,Davidson Wildcats,H. Lee,4592308,,True,36.0,5,14,1,3,4,11,4,6,3,3,6,3,1,0,3,3,18
401365817,Davidson Wildcats,F. Loyer,4397208,,True,34.0,5,11,2,3,3,8,8,8,0,5,5,7,0,0,1,4,21
401365817,Davidson Wildcats,M. Jones,4396784,,True,34.0,5,9,2,3,3,6,4,5,1,3,4,3,0,1,0,0,17
401365817,Davidson Wildcats,N. Boachie-Yiadom,4396786,,False,15.0,1,2,1,2,0,0,0,0,0,0,0,1,0,0,1,1,2
401365817,Davidson Wildcats,D. Watson,4897098,,False,11.0,1,1,1,1,0,0,0,0,0,2,2,0,0,0,1,2,2
401365817,Davidson Wildcats,G. Huffman,4432522,,False,10.0,0,1,0,1,0,0,1,2,0,0,0,0,0,0,0,2,1
401365817,Davidson Wildcats,TEAM,TOTAL,TOTAL,False,,24,51,12,23,12,28,21,29,9,21,30,18,4,1,12,20,81
401365817,Davidson Wildcats,S. Mennenga,4700862,,True,28.0,2,4,2,4,0,0,3,6,2,3,5,0,2,0,2,5,7
401365817,Davidson Wildcats,L. Brajkovic,4396787,,True,32.0,5,9,3,6,2,3,1,2,3,5,8,4,1,0,3,3,13
401365817,Davidson Wildcats,H. Lee,4592308,,True,36.0,5,14,1,3,4,11,4,6,3,3,6,3,1,0,3,3,18
401365817,Davidson Wildcats,F. Loyer,4397208,,True,34.0,5,11,2,3,3,8,8,8,0,5,5,7,0,0,1,4,21
401365817,Davidson Wildcats,M. Jones,4396784,,True,34.0,5,9,2,3,3,6,4,5,1,3,4,3,0,1,0,0,17
401365817,Davidson Wildcats,N. Boachie-Yiadom,4396786,,False,15.0,1,2,1,2,0,0,0,0,0,0,0,1,0,0,1,1,2
401365817,Davidson Wildcats,D. Watson,4897098,,False,11.0,1,1,1,1,0,0,0,0,0,2,2,0,0,0,1,2,2
401365817,Davidson Wildcats,G. Huffman,4432522,,False,10.0,0,1,0,1,0,0,1,2,0,0,0,0,0,0,0,2,1
401365817,Davidson Wildcats,TEAM,TOTAL,TOTAL,False,,24,51,12,23,12,28,21,29,9,21,30,18,4,1,12,20,81
401365816,Massachusetts Minutemen,G. Jones,4279211,,True,30.0,3,6,2,4,1,2,2,3,2,3,5,0,1,0,1,1,9
401365816,Massachusetts Minutemen,T. Buttrick,4277981,,True,29.0,3,5,1,2,2,3,2,2,2,4,6,3,0,2,3,1,10
401365816,Massachusetts Minutemen,T.J. Weeks,4433108,,True,18.0,1,7,0,1,1,6,2,2,2,3,5,1,2,0,0,3,5
401365816,Massachusetts Minutemen,C.J. Kelly,4398208,,True,26.0,2,10,1,3,1,7,0,0,1,2,3,2,1,0,2,2,5
401365816,Massachusetts Minutemen,R. Kelly,4279741,,True,36.0,4,11,1,6,3,5,2,3,0,4,4,2,0,0,0,3,13
401365816,Massachusetts Minutemen,M. Steadman,4397393,,False,13.0,2,6,2,6,0,0,1,2,2,1,3,0,0,0,0,1,5
401365816,Massachusetts Minutemen,J. Garcia,4701125,,False,30.0,3,10,2,9,1,1,6,7,1,5,6,5,1,0,1,4,13
401365816,Massachusetts Minutemen,K. Mitchell,4592454,,False,10.0,1,2,1,1,0,1,0,0,0,0,0,2,2,0,0,1,2
401365816,Massachusetts Minutemen,P. Santos,4432104,,False,8.0,0,3,0,0,0,3,0,0,0,0,0,0,0,0,0,0,0
401365816,Massachusetts Minutemen,TEAM,TOTAL,TOTAL,False,,19,60,10,32,9,28,15,19,13,24,37,15,7,2,7,16,62
401365816,Massachusetts Minutemen,G. Jones,4279211,,True,30.0,3,6,2,4,1,2,2,3,2,3,5,0,1,0,1,1,9
401365816,Massachusetts Minutemen,T. Buttrick,4277981,,True,29.0,3,5,1,2,2,3,2,2,2,4,6,3,0,2,3,1,10
401365816,Massachusetts Minutemen,T.J. Weeks,4433108,,True,18.0,1,7,0,1,1,6,2,2,2,3,5,1,2,0,0,3,5
401365816,Massachusetts Minutemen,C.J. Kelly,4398208,,True,26.0,2,10,1,3,1,7,0,0,1,2,3,2,1,0,2,2,5
401365816,Massachusetts Minutemen,R. Kelly,4279741,,True,36.0,4,11,1,6,3,5,2,3,0,4,4,2,0,0,0,3,13
401365816,Massachusetts Minutemen,M. Steadman,4397393,,False,13.0,2,6,2,6,0,0,1,2,2,1,3,0,0,0,0,1,5
401365816,Massachusetts Minutemen,J. Garcia,4701125,,False,30.0,3,10,2,9,1,1,6,7,1,5,6,5,1,0,1,4,13
401365816,Massachusetts Minutemen,K. Mitchell,4592454,,False,10.0,1,2,1,1,0,1,0,0,0,0,0,2,2,0,0,1,2
401365816,Massachusetts Minutemen,P. Santos,4432104,,False,8.0,0,3,0,0,0,3,0,0,0,0,0,0,0,0,0,0,0
401365816,Massachusetts Minutemen,TEAM,TOTAL,TOTAL,False,,19,60,10,32,9,28,15,19,13,24,37,15,7,2,7,16,62
401365816,George Mason Patriots,J. Oduro,4432068,,True,21.0,3,5,3,5,0,0,0,2,1,2,3,2,0,0,1,4,6
401365816,George Mason Patriots,X. Johnson,4592439,,True,31.0,3,6,1,2,2,4,0,0,0,6,6,9,0,0,1,1,8
401365816,George Mason Patriots,D. Gaines,4431961,,True,34.0,3,6,1,2,2,4,6,8,1,7,8,1,0,0,1,1,14
401365816,George Mason Patriots,D. Cooper,4279876,,True,28.0,4,7,1,3,3,4,1,2,0,4,4,4,3,0,1,4,12
401365816,George Mason Patriots,D. Schwartz,4278501,,True,31.0,6,11,4,5,2,6,1,1,0,2,2,3,0,0,3,3,15
401365816,George Mason Patriots,B. Jones,4897083,,False,4.0,0,1,0,1,0,0,0,0,0,0,0,0,0,0,0,0,0
401365816,George Mason Patriots,M. Henry,4606836,,False,14.0,3,4,3,4,0,0,0,3,1,2,3,0,0,1,1,1,6
401365816,George Mason Patriots,O. Frazier III,4700882,,False,14.0,3,4,3,4,0,0,0,2,2,4,6,0,0,0,1,0,6
401365816,George Mason Patriots,R. Polite III,4567711,,False,14.0,1,4,0,1,1,3,2,2,0,1,1,1,0,0,0,2,5
401365816,George Mason Patriots,J. Hartwell II,4396817,,False,9.0,0,3,0,1,0,2,0,0,0,1,1,0,0,0,0,0,0
401365816,George Mason Patriots,TEAM,TOTAL,TOTAL,False,,26,51,16,28,10,23,10,20,6,31,37,20,3,1,9,16,72
401365816,George Mason Patriots,J. Oduro,4432068,,True,21.0,3,5,3,5,0,0,0,2,1,2,3,2,0,0,1,4,6
401365816,George Mason Patriots,X. Johnson,4592439,,True,31.0,3,6,1,2,2,4,0,0,0,6,6,9,0,0,1,1,8
401365816,George Mason Patriots,D. Gaines,4431961,,True,34.0,3,6,1,2,2,4,6,8,1,7,8,1,0,0,1,1,14
401365816,George Mason Patriots,D. Cooper,4279876,,True,28.0,4,7,1,3,3,4,1,2,0,4,4,4,3,0,1,4,12
401365816,George Mason Patriots,D. Schwartz,4278501,,True,31.0,6,11,4,5,2,6,1,1,0,2,2,3,0,0,3,3,15
401365816,George Mason Patriots,B. Jones,4897083,,False,4.0,0,1,0,1,0,0,0,0,0,0,0,0,0,0,0,0,0
401365816,George Mason Patriots,M. Henry,4606836,,False,14.0,3,4,3,4,0,0,0,3,1,2,3,0,0,1,1,1,6
401365816,George Mason Patriots,O. Frazier III,4700882,,False,14.0,3,4,3,4,0,0,0,2,2,4,6,0,0,0,1,0,6
401365816,George Mason Patriots,R. Polite III,4567711,,False,14.0,1,4,0,1,1,3,2,2,0,1,1,1,0,0,0,2,5
401365816,George Mason Patriots,J. Hartwell II,4396817,,False,9.0,0,3,0,1,0,2,0,0,0,1,1,0,0,0,0,0,0
401365816,George Mason Patriots,TEAM,TOTAL,TOTAL,False,,26,51,16,28,10,23,10,20,6,31,37,20,3,1,9,16,72
401365815,George Washington Revolutionaries,H. Dean,4593273,,True,35.0,3,6,3,6,0,0,1,2,3,11,14,3,2,2,1,2,7
401365815,George Washington Revolutionaries,Q. Samuels,4592251,,True,16.0,1,4,0,1,1,3,0,0,0,0,0,2,1,0,1,1,3
401365815,George Washington Revolutionaries,B. Freeman,4613126,,True,29.0,3,13,3,11,0,2,0,1,1,5,6,3,0,0,4,0,6
401365815,George Washington Revolutionaries,J. Bamisile,4432537,,True,28.0,2,5,1,2,1,3,1,2,1,4,5,3,2,0,2,2,6
401365815,George Washington Revolutionaries,J. Bishop,4431770,,True,36.0,9,18,6,11,3,7,4,5,0,1,1,1,1,0,2,3,25
401365815,George Washington Revolutionaries,R. Lindo Jr.,4397186,,False,29.0,4,6,2,2,2,4,0,0,5,5,10,2,1,1,6,3,10
401365815,George Washington Revolutionaries,B. Adams,4396612,,False,27.0,2,5,1,2,1,3,2,2,0,2,2,0,1,0,1,0,7
401365815,George Washington Revolutionaries,TEAM,TOTAL,TOTAL,False,,24,57,16,35,8,22,8,12,12,28,40,14,8,3,18,11,64
401365815,George Washington Revolutionaries,H. Dean,4593273,,True,35.0,3,6,3,6,0,0,1,2,3,11,14,3,2,2,1,2,7
401365815,George Washington Revolutionaries,Q. Samuels,4592251,,True,16.0,1,4,0,1,1,3,0,0,0,0,0,2,1,0,1,1,3
401365815,George Washington Revolutionaries,B. Freeman,4613126,,True,29.0,3,13,3,11,0,2,0,1,1,5,6,3,0,0,4,0,6
401365815,George Washington Revolutionaries,J. Bamisile,4432537,,True,28.0,2,5,1,2,1,3,1,2,1,4,5,3,2,0,2,2,6
401365815,George Washington Revolutionaries,J. Bishop,4431770,,True,36.0,9,18,6,11,3,7,4,5,0,1,1,1,1,0,2,3,25
401365815,George Washington Revolutionaries,R. Lindo Jr.,4397186,,False,29.0,4,6,2,2,2,4,0,0,5,5,10,2,1,1,6,3,10
401365815,George Washington Revolutionaries,B. Adams,4396612,,False,27.0,2,5,1,2,1,3,2,2,0,2,2,0,1,0,1,0,7
401365815,George Washington Revolutionaries,TEAM,TOTAL,TOTAL,False,,24,57,16,35,8,22,8,12,12,28,40,14,8,3,18,11,64
401365815,Fordham Rams,C. Ohams,4066856,,True,32.0,4,11,4,11,0,0,5,6,2,8,10,1,0,2,3,1,13
401365815,Fordham Rams,A. Charlton,4897085,,True,32.0,1,4,0,1,1,3,0,0,1,4,5,2,3,0,6,4,3
401365815,Fordham Rams,J. Navarro,4592316,,True,25.0,3,8,1,3,2,5,0,0,1,0,1,2,2,0,1,3,8
401365815,Fordham Rams,K. Rose,4592315,,True,35.0,5,13,2,4,3,9,0,0,0,4,4,0,2,0,1,0,13
401365815,Fordham Rams,D. Quisenberry,4397790,,True,37.0,6,16,5,12,1,4,2,2,0,4,4,0,2,0,1,3,15
401365815,Fordham Rams,A. Tsimbila,4702329,,False,11.0,0,1,0,1,0,0,0,0,1,1,2,0,1,1,0,1,0
401365815,Fordham Rams,P. Kelly,4432014,,False,2.0,0,0,0,0,0,0,0,0,0,1,1,0,0,0,0,0,0
401365815,Fordham Rams,R. Novitskyi,4897084,,False,7.0,0,2,0,1,0,1,0,0,1,0,1,1,0,1,0,1,0
401365815,Fordham Rams,A. Harrison,4897086,,False,15.0,0,0,0,0,0,0,0,0,2,0,2,0,0,1,2,1,0
401365815,Fordham Rams,Z. Riley,4914388,,False,4.0,1,1,0,0,1,1,0,0,0,0,0,0,0,0,0,0,3
401365815,Fordham Rams,TEAM,TOTAL,TOTAL,False,,20,56,12,33,8,23,7,8,8,24,32,6,10,5,14,14,55
401365815,Fordham Rams,C. Ohams,4066856,,True,32.0,4,11,4,11,0,0,5,6,2,8,10,1,0,2,3,1,13
401365815,Fordham Rams,A. Charlton,4897085,,True,32.0,1,4,0,1,1,3,0,0,1,4,5,2,3,0,6,4,3
401365815,Fordham Rams,J. Navarro,4592316,,True,25.0,3,8,1,3,2,5,0,0,1,0,1,2,2,0,1,3,8
401365815,Fordham Rams,K. Rose,4592315,,True,35.0,5,13,2,4,3,9,0,0,0,4,4,0,2,0,1,0,13
401365815,Fordham Rams,D. Quisenberry,4397790,,True,37.0,6,16,5,12,1,4,2,2,0,4,4,0,2,0,1,3,15
401365815,Fordham Rams,A. Tsimbila,4702329,,False,11.0,0,1,0,1,0,0,0,0,1,1,2,0,1,1,0,1,0
401365815,Fordham Rams,P. Kelly,4432014,,False,2.0,0,0,0,0,0,0,0,0,0,1,1,0,0,0,0,0,0
401365815,Fordham Rams,R. Novitskyi,4897084,,False,7.0,0,2,0,1,0,1,0,0,1,0,1,1,0,1,0,1,0
401365815,Fordham Rams,A. Harrison,4897086,,False,15.0,0,0,0,0,0,0,0,0,2,0,2,0,0,1,2,1,0
401365815,Fordham Rams,Z. Riley,4914388,,False,4.0,1,1,0,0,1,1,0,0,0,0,0,0,0,0,0,0,3
401365815,Fordham Rams,TEAM,TOTAL,TOTAL,False,,20,56,12,33,8,23,7,8,8,24,32,6,10,5,14,14,55
401365814,VCU Rams,V. Williams Jr.,4397227,,True,37.0,9,13,6,7,3,6,1,3,1,9,10,8,1,2,2,3,22
401365814,VCU Rams,L. Stockard III,4277897,,True,6.0,0,2,0,2,0,0,0,0,1,1,2,0,0,0,4,0,0
401365814,VCU Rams,J. Nunn,4896614,,True,32.0,1,5,1,4,0,1,1,2,0,0,0,0,1,0,1,0,3
401365814,VCU Rams,A. Baldwin Jr.,4433182,,True,31.0,3,8,2,6,1,2,2,2,0,3,3,6,3,0,3,5,9
401365814,VCU Rams,K. Curry,4397228,,True,34.0,5,11,5,10,0,1,0,0,0,4,4,2,1,1,3,4,10
401365814,VCU Rams,H. Ward,4592495,,False,25.0,7,10,7,10,0,0,0,0,4,6,10,0,1,0,1,4,14
401365814,VCU Rams,M. Brown-Jones,4433224,,False,4.0,0,0,0,0,0,0,0,0,1,0,1,0,0,1,2,1,0
401365814,VCU Rams,J. DeLoach,4432483,,False,13.0,3,5,3,5,0,0,0,0,1,2,3,0,0,0,1,1,6
401365814,VCU Rams,N. Kern,4684145,,False,1.0,0,0,0,0,0,0,0,0,0,0,0,0,0,0,0,2,0
401365814,VCU Rams,M. Tsohonis,4592438,,False,10.0,0,1,0,1,0,0,0,0,1,0,1,0,0,0,1,0,0
401365814,VCU Rams,J. Banks,4432402,,False,7.0,0,0,0,0,0,0,0,0,0,0,0,0,1,0,0,0,0
401365814,VCU Rams,TEAM,TOTAL,TOTAL,False,,28,55,24,45,4,10,4,7,10,27,37,16,8,4,19,20,64
401365814,VCU Rams,V. Williams Jr.,4397227,,True,37.0,9,13,6,7,3,6,1,3,1,9,10,8,1,2,2,3,22
401365814,VCU Rams,L. Stockard III,4277897,,True,6.0,0,2,0,2,0,0,0,0,1,1,2,0,0,0,4,0,0
401365814,VCU Rams,J. Nunn,4896614,,True,32.0,1,5,1,4,0,1,1,2,0,0,0,0,1,0,1,0,3
401365814,VCU Rams,A. Baldwin Jr.,4433182,,True,31.0,3,8,2,6,1,2,2,2,0,3,3,6,3,0,3,5,9
401365814,VCU Rams,K. Curry,4397228,,True,34.0,5,11,5,10,0,1,0,0,0,4,4,2,1,1,3,4,10
401365814,VCU Rams,H. Ward,4592495,,False,25.0,7,10,7,10,0,0,0,0,4,6,10,0,1,0,1,4,14
401365814,VCU Rams,M. Brown-Jones,4433224,,False,4.0,0,0,0,0,0,0,0,0,1,0,1,0,0,1,2,1,0
401365814,VCU Rams,J. DeLoach,4432483,,False,13.0,3,5,3,5,0,0,0,0,1,2,3,0,0,0,1,1,6
401365814,VCU Rams,N. Kern,4684145,,False,1.0,0,0,0,0,0,0,0,0,0,0,0,0,0,0,0,2,0
401365814,VCU Rams,M. Tsohonis,4592438,,False,10.0,0,1,0,1,0,0,0,0,1,0,1,0,0,0,1,0,0
401365814,VCU Rams,J. Banks,4432402,,False,7.0,0,0,0,0,0,0,0,0,0,0,0,0,1,0,0,0,0
401365814,VCU Rams,TEAM,TOTAL,TOTAL,False,,28,55,24,45,4,10,4,7,10,27,37,16,8,4,19,20,64
401365814,Richmond Spiders,T. Burton,4431914,,True,34.0,1,12,1,7,0,5,3,5,2,2,4,2,2,1,1,1,5
401365814,Richmond Spiders,N. Cayo,4278380,,True,21.0,4,5,4,5,0,0,1,3,3,1,4,0,0,0,3,3,9
401365814,Richmond Spiders,G. Golden,4066836,,True,32.0,7,9,7,9,0,0,4,6,5,4,9,1,2,1,3,0,18
401365814,Richmond Spiders,A. Gustavson,4397193,,True,29.0,2,8,2,7,0,1,0,0,3,6,9,0,1,0,2,3,4
401365814,Richmond Spiders,J. Gilyard,4278378,,True,40.0,5,16,3,8,2,8,2,3,0,3,3,6,3,0,0,2,14
401365814,Richmond Spiders,M. Grace,4397192,,False,10.0,0,1,0,0,0,1,2,2,3,0,3,1,2,1,0,1,2
401365814,Richmond Spiders,M. Randolph,4710356,,False,2.0,0,1,0,1,0,0,0,0,0,0,0,0,0,0,1,0,0
401365814,Richmond Spiders,I. Wilson,4700973,,False,11.0,0,0,0,0,0,0,2,2,0,0,0,0,1,0,1,2,2
401365814,Richmond Spiders,N. Sherod,4066832,,False,21.0,3,10,1,3,2,7,0,0,0,2,2,0,1,0,2,0,8
401365814,Richmond Spiders,TEAM,TOTAL,TOTAL,False,,22,62,18,40,4,22,14,21,17,19,36,10,12,3,13,12,62
401365814,Richmond Spiders,T. Burton,4431914,,True,34.0,1,12,1,7,0,5,3,5,2,2,4,2,2,1,1,1,5
401365814,Richmond Spiders,N. Cayo,4278380,,True,21.0,4,5,4,5,0,0,1,3,3,1,4,0,0,0,3,3,9
401365814,Richmond Spiders,G. Golden,4066836,,True,32.0,7,9,7,9,0,0,4,6,5,4,9,1,2,1,3,0,18
401365814,Richmond Spiders,A. Gustavson,4397193,,True,29.0,2,8,2,7,0,1,0,0,3,6,9,0,1,0,2,3,4
401365814,Richmond Spiders,J. Gilyard,4278378,,True,40.0,5,16,3,8,2,8,2,3,0,3,3,6,3,0,0,2,14
401365814,Richmond Spiders,M. Grace,4397192,,False,10.0,0,1,0,0,0,1,2,2,3,0,3,1,2,1,0,1,2
401365814,Richmond Spiders,M. Randolph,4710356,,False,2.0,0,1,0,1,0,0,0,0,0,0,0,0,0,0,1,0,0
401365814,Richmond Spiders,I. Wilson,4700973,,False,11.0,0,0,0,0,0,0,2,2,0,0,0,0,1,0,1,2,2
401365814,Richmond Spiders,N. Sherod,4066832,,False,21.0,3,10,1,3,2,7,0,0,0,2,2,0,1,0,2,0,8
401365814,Richmond Spiders,TEAM,TOTAL,TOTAL,False,,22,62,18,40,4,22,14,21,17,19,36,10,12,3,13,12,62
401365813,Saint Louis Billikens,F. Okoro,4397105,,True,18.0,7,9,7,9,0,0,0,0,2,6,8,0,2,1,1,4,14
401365813,Saint Louis Billikens,J. Nesbitt,4714246,,True,25.0,3,7,3,5,0,2,1,1,2,1,3,1,0,1,0,1,7
401365813,Saint Louis Billikens,Y. Collins,4432957,,True,34.0,4,8,3,6,1,2,2,2,0,7,7,10,4,0,5,1,11
401365813,Saint Louis Billikens,G. Jimerson,4432008,,True,30.0,5,14,3,6,2,8,0,0,0,3,3,2,0,0,1,1,12
401365813,Saint Louis Billikens,F. Thatch Jr.,4397199,,True,26.0,6,9,5,7,1,2,1,2,3,0,3,2,1,1,1,2,14
401365813,Saint Louis Billikens,L. Traore,4897052,,False,12.0,0,1,0,1,0,0,0,0,1,4,5,2,1,0,2,0,0
401365813,Saint Louis Billikens,T. Hargrove Jr.,4592484,,False,16.0,1,6,1,5,0,1,0,0,1,2,3,0,1,1,0,0,2
401365813,Saint Louis Billikens,M. Linssen,4279174,,False,10.0,1,4,1,4,0,0,1,2,3,1,4,0,0,0,0,4,3
401365813,Saint Louis Billikens,M. Strickland,4432494,,False,4.0,1,3,1,3,0,0,0,0,0,0,0,0,0,0,1,1,2
401365813,Saint Louis Billikens,R. Williams,4399106,,False,13.0,2,6,0,1,2,5,0,0,0,0,0,0,0,0,1,2,6
401365813,Saint Louis Billikens,D. Jones,4278267,,False,12.0,2,5,0,1,2,4,0,0,0,2,2,1,1,0,0,2,6
401365813,Saint Louis Billikens,TEAM,TOTAL,TOTAL,False,,32,72,24,48,8,24,5,7,15,28,43,18,10,4,12,18,77
401365813,Saint Louis Billikens,F. Okoro,4397105,,True,18.0,7,9,7,9,0,0,0,0,2,6,8,0,2,1,1,4,14
401365813,Saint Louis Billikens,J. Nesbitt,4714246,,True,25.0,3,7,3,5,0,2,1,1,2,1,3,1,0,1,0,1,7
401365813,Saint Louis Billikens,Y. Collins,4432957,,True,34.0,4,8,3,6,1,2,2,2,0,7,7,10,4,0,5,1,11
401365813,Saint Louis Billikens,G. Jimerson,4432008,,True,30.0,5,14,3,6,2,8,0,0,0,3,3,2,0,0,1,1,12
401365813,Saint Louis Billikens,F. Thatch Jr.,4397199,,True,26.0,6,9,5,7,1,2,1,2,3,0,3,2,1,1,1,2,14
401365813,Saint Louis Billikens,L. Traore,4897052,,False,12.0,0,1,0,1,0,0,0,0,1,4,5,2,1,0,2,0,0
401365813,Saint Louis Billikens,T. Hargrove Jr.,4592484,,False,16.0,1,6,1,5,0,1,0,0,1,2,3,0,1,1,0,0,2
401365813,Saint Louis Billikens,M. Linssen,4279174,,False,10.0,1,4,1,4,0,0,1,2,3,1,4,0,0,0,0,4,3
401365813,Saint Louis Billikens,M. Strickland,4432494,,False,4.0,1,3,1,3,0,0,0,0,0,0,0,0,0,0,1,1,2
401365813,Saint Louis Billikens,R. Williams,4399106,,False,13.0,2,6,0,1,2,5,0,0,0,0,0,0,0,0,1,2,6
401365813,Saint Louis Billikens,D. Jones,4278267,,False,12.0,2,5,0,1,2,4,0,0,0,2,2,1,1,0,0,2,6
401365813,Saint Louis Billikens,TEAM,TOTAL,TOTAL,False,,32,72,24,48,8,24,5,7,15,28,43,18,10,4,12,18,77
401365813,Duquesne Dukes,T. Williams,4432147,,True,30.0,2,8,2,7,0,1,0,0,3,0,3,0,0,1,2,0,4
401365813,Duquesne Dukes,K. Easley,4398159,,True,29.0,4,10,1,4,3,6,0,0,0,5,5,0,2,0,4,3,11
401365813,Duquesne Dukes,A. Spears,4897090,,True,28.0,0,5,0,5,0,0,1,4,0,4,4,3,1,0,2,0,1
401365813,Duquesne Dukes,J. Johnson III,4897088,,True,23.0,2,7,2,3,0,4,5,7,1,3,4,2,2,1,4,1,9
401365813,Duquesne Dukes,L. Ayers III,4703813,,True,26.0,3,6,2,4,1,2,2,3,0,2,2,1,1,0,3,2,9
401365813,Duquesne Dukes,M. Hima,4700878,,False,12.0,2,4,2,4,0,0,0,0,3,3,6,0,1,5,0,2,4
401365813,Duquesne Dukes,D. Larson,4897091,,False,3.0,0,0,0,0,0,0,0,0,0,0,0,0,0,0,0,0,0
401365813,Duquesne Dukes,M. Bekelja,4700874,,False,4.0,0,0,0,0,0,0,2,2,0,0,0,0,0,0,0,0,2
401365813,Duquesne Dukes,T. Okani,4700873,,False,25.0,3,7,3,6,0,1,0,0,3,4,7,1,0,2,2,1,6
401365813,Duquesne Dukes,T. Acuff,4606831,,False,20.0,3,7,2,4,1,3,0,0,0,2,2,0,0,0,3,2,7
401365813,Duquesne Dukes,TEAM,TOTAL,TOTAL,False,,19,54,14,37,5,17,10,16,10,27,37,7,7,9,20,11,53
401365813,Duquesne Dukes,T. Williams,4432147,,True,30.0,2,8,2,7,0,1,0,0,3,0,3,0,0,1,2,0,4
401365813,Duquesne Dukes,K. Easley,4398159,,True,29.0,4,10,1,4,3,6,0,0,0,5,5,0,2,0,4,3,11
401365813,Duquesne Dukes,A. Spears,4897090,,True,28.0,0,5,0,5,0,0,1,4,0,4,4,3,1,0,2,0,1
401365813,Duquesne Dukes,J. Johnson III,4897088,,True,23.0,2,7,2,3,0,4,5,7,1,3,4,2,2,1,4,1,9
401365813,Duquesne Dukes,L. Ayers III,4703813,,True,26.0,3,6,2,4,1,2,2,3,0,2,2,1,1,0,3,2,9
401365813,Duquesne Dukes,M. Hima,4700878,,False,12.0,2,4,2,4,0,0,0,0,3,3,6,0,1,5,0,2,4
401365813,Duquesne Dukes,D. Larson,4897091,,False,3.0,0,0,0,0,0,0,0,0,0,0,0,0,0,0,0,0,0
401365813,Duquesne Dukes,M. Bekelja,4700874,,False,4.0,0,0,0,0,0,0,2,2,0,0,0,0,0,0,0,0,2
401365813,Duquesne Dukes,T. Okani,4700873,,False,25.0,3,7,3,6,0,1,0,0,3,4,7,1,0,2,2,1,6
401365813,Duquesne Dukes,T. Acuff,4606831,,False,20.0,3,7,2,4,1,3,0,0,0,2,2,0,0,0,3,2,7
401365813,Duquesne Dukes,TEAM,TOTAL,TOTAL,False,,19,54,14,37,5,17,10,16,10,27,37,7,7,9,20,11,53
401365812,St. Bonaventure Bonnies,O. Osunniyi,4397224,,True,33.0,2,7,2,7,0,0,4,4,2,8,10,1,1,1,4,2,8
401365812,St. Bonaventure Bonnies,J. Adaway,4279431,,True,38.0,7,11,7,11,0,0,8,11,1,4,5,0,0,0,2,1,22
401365812,St. Bonaventure Bonnies,J. Holmes,4701016,,True,40.0,7,8,7,7,0,1,6,6,0,2,2,3,2,0,0,2,20
401365812,St. Bonaventure Bonnies,D. Welch,4397221,,True,39.0,5,11,3,5,2,6,1,2,1,4,5,4,2,0,0,4,13
401365812,St. Bonaventure Bonnies,K. Lofton,4397220,,True,40.0,4,12,4,12,0,0,5,6,1,6,7,4,0,0,3,0,13
401365812,St. Bonaventure Bonnies,A. Coulibaly,4432889,,False,7.0,2,3,2,3,0,0,0,0,0,1,1,0,0,0,1,1,4
401365812,St. Bonaventure Bonnies,Q. Adams,4585591,,False,3.0,0,0,0,0,0,0,0,0,0,1,1,0,0,0,0,2,0
401365812,St. Bonaventure Bonnies,TEAM,TOTAL,TOTAL,False,,27,52,25,45,2,7,24,29,5,28,33,12,5,1,10,12,80
401365812,St. Bonaventure Bonnies,O. Osunniyi,4397224,,True,33.0,2,7,2,7,0,0,4,4,2,8,10,1,1,1,4,2,8
401365812,St. Bonaventure Bonnies,J. Adaway,4279431,,True,38.0,7,11,7,11,0,0,8,11,1,4,5,0,0,0,2,1,22
401365812,St. Bonaventure Bonnies,J. Holmes,4701016,,True,40.0,7,8,7,7,0,1,6,6,0,2,2,3,2,0,0,2,20
401365812,St. Bonaventure Bonnies,D. Welch,4397221,,True,39.0,5,11,3,5,2,6,1,2,1,4,5,4,2,0,0,4,13
401365812,St. Bonaventure Bonnies,K. Lofton,4397220,,True,40.0,4,12,4,12,0,0,5,6,1,6,7,4,0,0,3,0,13
401365812,St. Bonaventure Bonnies,A. Coulibaly,4432889,,False,7.0,2,3,2,3,0,0,0,0,0,1,1,0,0,0,1,1,4
401365812,St. Bonaventure Bonnies,Q. Adams,4585591,,False,3.0,0,0,0,0,0,0,0,0,0,1,1,0,0,0,0,2,0
401365812,St. Bonaventure Bonnies,TEAM,TOTAL,TOTAL,False,,27,52,25,45,2,7,24,29,5,28,33,12,5,1,10,12,80
401365812,Saint Joseph's Hawks,T. Funk,4278395,,True,38.0,3,9,1,2,2,7,2,3,0,2,2,2,0,0,1,2,10
401365812,Saint Joseph's Hawks,E. Obinna,4278125,,True,25.0,4,8,4,8,0,0,2,2,1,6,7,0,0,0,1,3,10
401365812,Saint Joseph's Hawks,J. Hall,4701031,,True,30.0,3,12,1,5,2,7,0,0,2,5,7,6,1,0,5,4,8
401365812,Saint Joseph's Hawks,E. Reynolds II,4683952,,True,38.0,8,16,5,6,3,10,2,2,1,2,3,4,0,1,1,1,21
401365812,Saint Joseph's Hawks,C. Brown,4592476,,True,37.0,6,11,3,5,3,6,0,0,1,1,2,1,3,0,1,5,15
401365812,Saint Joseph's Hawks,C. Coleman,4431807,,False,10.0,0,2,0,1,0,1,0,0,3,0,3,0,0,0,0,1,0
401365812,Saint Joseph's Hawks,C. Arizin,4706891,,False,0.0,0,0,0,0,0,0,0,0,0,0,0,0,0,0,0,1,0
401365812,Saint Joseph's Hawks,D. Bishop,4701028,,False,22.0,2,6,2,3,0,3,1,1,0,3,3,2,1,0,3,5,5
401365812,Saint Joseph's Hawks,TEAM,TOTAL,TOTAL,False,,26,64,16,30,10,34,7,8,9,21,30,15,5,1,12,22,69
401365812,Saint Joseph's Hawks,T. Funk,4278395,,True,38.0,3,9,1,2,2,7,2,3,0,2,2,2,0,0,1,2,10
401365812,Saint Joseph's Hawks,E. Obinna,4278125,,True,25.0,4,8,4,8,0,0,2,2,1,6,7,0,0,0,1,3,10
401365812,Saint Joseph's Hawks,J. Hall,4701031,,True,30.0,3,12,1,5,2,7,0,0,2,5,7,6,1,0,5,4,8
401365812,Saint Joseph's Hawks,E. Reynolds II,4683952,,True,38.0,8,16,5,6,3,10,2,2,1,2,3,4,0,1,1,1,21
401365812,Saint Joseph's Hawks,C. Brown,4592476,,True,37.0,6,11,3,5,3,6,0,0,1,1,2,1,3,0,1,5,15
401365812,Saint Joseph's Hawks,C. Coleman,4431807,,False,10.0,0,2,0,1,0,1,0,0,3,0,3,0,0,0,0,1,0
401365812,Saint Joseph's Hawks,C. Arizin,4706891,,False,0.0,0,0,0,0,0,0,0,0,0,0,0,0,0,0,0,1,0
401365812,Saint Joseph's Hawks,D. Bishop,4701028,,False,22.0,2,6,2,3,0,3,1,1,0,3,3,2,1,0,3,5,5
401365812,Saint Joseph's Hawks,TEAM,TOTAL,TOTAL,False,,26,64,16,30,10,34,7,8,9,21,30,15,5,1,12,22,69
401365811,La Salle Explorers,M. Doucoure,4277988,,True,11.0,0,1,0,1,0,0,0,0,1,2,3,0,0,0,1,1,0
401365811,La Salle Explorers,C. Moore,4277945,,True,35.0,6,11,6,7,0,4,2,2,2,3,5,3,1,1,0,3,14
401365811,La Salle Explorers,J. Clark,4397152,,True,38.0,7,18,3,4,4,14,0,0,4,2,6,1,1,0,1,4,18
401365811,La Salle Explorers,J. Brickus,4700970,,True,25.0,3,6,3,4,0,2,2,3,0,1,1,3,2,0,2,3,8
401365811,La Salle Explorers,J. Nickelberry,4432845,,True,19.0,2,11,0,3,2,8,0,0,0,2,2,0,0,0,1,3,6
401365811,La Salle Explorers,D. Shepherd,4710357,,False,9.0,2,3,2,2,0,1,0,0,0,0,0,0,0,0,0,2,4
401365811,La Salle Explorers,K. Brantley,4709132,,False,21.0,2,5,2,3,0,2,7,8,1,1,2,4,0,0,2,3,11
401365811,La Salle Explorers,A. Gill,4700969,,False,17.0,0,3,0,3,0,0,1,2,0,3,3,2,0,0,0,5,1
401365811,La Salle Explorers,C. Ray,4592448,,False,25.0,3,5,2,4,1,1,0,0,2,7,9,1,2,0,0,2,7
401365811,La Salle Explorers,TEAM,TOTAL,TOTAL,False,,25,63,18,31,7,32,12,15,10,22,32,14,6,1,8,26,69
401365811,La Salle Explorers,M. Doucoure,4277988,,True,11.0,0,1,0,1,0,0,0,0,1,2,3,0,0,0,1,1,0
401365811,La Salle Explorers,C. Moore,4277945,,True,35.0,6,11,6,7,0,4,2,2,2,3,5,3,1,1,0,3,14
401365811,La Salle Explorers,J. Clark,4397152,,True,38.0,7,18,3,4,4,14,0,0,4,2,6,1,1,0,1,4,18
401365811,La Salle Explorers,J. Brickus,4700970,,True,25.0,3,6,3,4,0,2,2,3,0,1,1,3,2,0,2,3,8
401365811,La Salle Explorers,J. Nickelberry,4432845,,True,19.0,2,11,0,3,2,8,0,0,0,2,2,0,0,0,1,3,6
401365811,La Salle Explorers,D. Shepherd,4710357,,False,9.0,2,3,2,2,0,1,0,0,0,0,0,0,0,0,0,2,4
401365811,La Salle Explorers,K. Brantley,4709132,,False,21.0,2,5,2,3,0,2,7,8,1,1,2,4,0,0,2,3,11
401365811,La Salle Explorers,A. Gill,4700969,,False,17.0,0,3,0,3,0,0,1,2,0,3,3,2,0,0,0,5,1
401365811,La Salle Explorers,C. Ray,4592448,,False,25.0,3,5,2,4,1,1,0,0,2,7,9,1,2,0,0,2,7
401365811,La Salle Explorers,TEAM,TOTAL,TOTAL,False,,25,63,18,31,7,32,12,15,10,22,32,14,6,1,8,26,69
401365811,Davidson Wildcats,S. Mennenga,4700862,,True,21.0,2,5,2,5,0,0,4,5,3,5,8,2,1,0,2,2,8
401365811,Davidson Wildcats,L. Brajkovic,4396787,,True,34.0,7,10,5,8,2,2,6,7,2,4,6,3,0,1,2,3,22
401365811,Davidson Wildcats,H. Lee,4592308,,True,30.0,4,12,4,7,0,5,6,8,1,3,4,1,1,0,0,2,14
401365811,Davidson Wildcats,F. Loyer,4397208,,True,36.0,4,9,2,4,2,5,4,4,0,7,7,5,0,0,2,3,14
401365811,Davidson Wildcats,M. Jones,4396784,,True,35.0,3,8,2,4,1,4,2,2,0,3,3,1,1,0,2,3,9
401365811,Davidson Wildcats,N. Boachie-Yiadom,4396786,,False,25.0,2,4,1,3,1,1,0,2,2,3,5,0,1,0,0,1,5
401365811,Davidson Wildcats,D. Watson,4897098,,False,11.0,1,3,1,2,0,1,0,0,0,2,2,0,0,0,0,2,2
401365811,Davidson Wildcats,E. Lanier,4567082,,False,8.0,1,1,0,0,1,1,0,0,0,0,0,0,0,0,1,1,3
401365811,Davidson Wildcats,TEAM,TOTAL,TOTAL,False,,24,52,17,33,7,19,22,28,9,29,38,12,4,1,10,17,77
401365811,Davidson Wildcats,S. Mennenga,4700862,,True,21.0,2,5,2,5,0,0,4,5,3,5,8,2,1,0,2,2,8
401365811,Davidson Wildcats,L. Brajkovic,4396787,,True,34.0,7,10,5,8,2,2,6,7,2,4,6,3,0,1,2,3,22
401365811,Davidson Wildcats,H. Lee,4592308,,True,30.0,4,12,4,7,0,5,6,8,1,3,4,1,1,0,0,2,14
401365811,Davidson Wildcats,F. Loyer,4397208,,True,36.0,4,9,2,4,2,5,4,4,0,7,7,5,0,0,2,3,14
401365811,Davidson Wildcats,M. Jones,4396784,,True,35.0,3,8,2,4,1,4,2,2,0,3,3,1,1,0,2,3,9
401365811,Davidson Wildcats,N. Boachie-Yiadom,4396786,,False,25.0,2,4,1,3,1,1,0,2,2,3,5,0,1,0,0,1,5
401365811,Davidson Wildcats,D. Watson,4897098,,False,11.0,1,3,1,2,0,1,0,0,0,2,2,0,0,0,0,2,2
401365811,Davidson Wildcats,E. Lanier,4567082,,False,8.0,1,1,0,0,1,1,0,0,0,0,0,0,0,0,1,1,3
401365811,Davidson Wildcats,TEAM,TOTAL,TOTAL,False,,24,52,17,33,7,19,22,28,9,29,38,12,4,1,10,17,77
401365810,Rhode Island Rams,Makhel Mitchell,4431777,,True,27.0,4,7,4,7,0,0,1,2,0,3,3,0,1,0,2,4,9
401365810,Rhode Island Rams,Makhi Mitchell,4431708,,True,29.0,6,11,6,11,0,0,0,1,2,9,11,1,3,2,4,3,12
401365810,Rhode Island Rams,I. Leggett,4606837,,True,22.0,1,4,1,4,0,0,0,0,0,1,1,1,1,1,2,1,2
401365810,Rhode Island Rams,I. El-Amin,4279313,,True,20.0,2,7,1,4,1,3,0,0,0,1,1,0,0,0,1,0,5
401365810,Rhode Island Rams,J. Sheppard,4066445,,True,20.0,2,6,2,4,0,2,0,0,0,5,5,1,0,0,1,0,4
401365810,Rhode Island Rams,I. Ayo-Faleye,4701259,,False,0.0,0,0,0,0,0,0,0,0,0,0,0,0,0,0,0,0,0
401365810,Rhode Island Rams,A. Walker,4278567,,False,17.0,2,4,2,3,0,1,0,0,0,1,1,1,0,1,3,3,4
401365810,Rhode Island Rams,M. Martin,4397470,,False,25.0,2,4,2,3,0,1,0,0,2,3,5,1,0,3,0,1,4
401365810,Rhode Island Rams,J. Carey,4395673,,False,18.0,1,4,0,2,1,2,4,4,0,3,3,2,1,0,1,3,7
401365810,Rhode Island Rams,S. Thomas,4897065,,False,22.0,2,5,2,5,0,0,0,0,0,2,2,4,1,0,1,2,4
401365810,Rhode Island Rams,TEAM,TOTAL,TOTAL,False,,22,52,20,43,2,9,5,7,6,29,35,11,7,7,16,17,51
401365810,Rhode Island Rams,Makhel Mitchell,4431777,,True,27.0,4,7,4,7,0,0,1,2,0,3,3,0,1,0,2,4,9
401365810,Rhode Island Rams,Makhi Mitchell,4431708,,True,29.0,6,11,6,11,0,0,0,1,2,9,11,1,3,2,4,3,12
401365810,Rhode Island Rams,I. Leggett,4606837,,True,22.0,1,4,1,4,0,0,0,0,0,1,1,1,1,1,2,1,2
401365810,Rhode Island Rams,I. El-Amin,4279313,,True,20.0,2,7,1,4,1,3,0,0,0,1,1,0,0,0,1,0,5
401365810,Rhode Island Rams,J. Sheppard,4066445,,True,20.0,2,6,2,4,0,2,0,0,0,5,5,1,0,0,1,0,4
401365810,Rhode Island Rams,I. Ayo-Faleye,4701259,,False,0.0,0,0,0,0,0,0,0,0,0,0,0,0,0,0,0,0,0
401365810,Rhode Island Rams,A. Walker,4278567,,False,17.0,2,4,2,3,0,1,0,0,0,1,1,1,0,1,3,3,4
401365810,Rhode Island Rams,M. Martin,4397470,,False,25.0,2,4,2,3,0,1,0,0,2,3,5,1,0,3,0,1,4
401365810,Rhode Island Rams,J. Carey,4395673,,False,18.0,1,4,0,2,1,2,4,4,0,3,3,2,1,0,1,3,7
401365810,Rhode Island Rams,S. Thomas,4897065,,False,22.0,2,5,2,5,0,0,0,0,0,2,2,4,1,0,1,2,4
401365810,Rhode Island Rams,TEAM,TOTAL,TOTAL,False,,22,52,20,43,2,9,5,7,6,29,35,11,7,7,16,17,51
401365810,Dayton Flyers,R.J. Blakney,4700864,,True,18.0,0,2,0,1,0,1,0,0,0,0,0,1,1,0,1,1,0
401365810,Dayton Flyers,T. Camara,4431736,,True,35.0,6,12,5,9,1,3,5,7,3,7,10,4,0,1,2,3,18
401365810,Dayton Flyers,D. Holmes II,4433607,,True,26.0,5,6,4,5,1,1,1,2,4,2,6,1,1,6,3,3,12
401365810,Dayton Flyers,M. Smith,4683861,,True,37.0,0,8,0,8,0,0,4,4,0,6,6,6,1,0,5,2,4
401365810,Dayton Flyers,K. Elvis,4683135,,True,28.0,4,13,1,6,3,7,0,0,0,4,4,1,0,0,0,1,11
401365810,Dayton Flyers,M. Sissoko,4431824,,False,8.0,1,2,1,2,0,0,1,1,1,2,3,0,2,0,0,0,3
401365810,Dayton Flyers,M. Amzil,4711607,,False,22.0,0,6,0,1,0,5,2,2,1,2,3,0,0,0,0,0,2
401365810,Dayton Flyers,K. Brea,4591259,,False,26.0,1,6,0,1,1,5,0,2,0,1,1,0,0,0,1,1,3
401365810,Dayton Flyers,TEAM,TOTAL,TOTAL,False,,17,55,11,33,6,22,13,18,11,26,37,13,5,7,12,11,53
401365810,Dayton Flyers,R.J. Blakney,4700864,,True,18.0,0,2,0,1,0,1,0,0,0,0,0,1,1,0,1,1,0
401365810,Dayton Flyers,T. Camara,4431736,,True,35.0,6,12,5,9,1,3,5,7,3,7,10,4,0,1,2,3,18
401365810,Dayton Flyers,D. Holmes II,4433607,,True,26.0,5,6,4,5,1,1,1,2,4,2,6,1,1,6,3,3,12
401365810,Dayton Flyers,M. Smith,4683861,,True,37.0,0,8,0,8,0,0,4,4,0,6,6,6,1,0,5,2,4
401365810,Dayton Flyers,K. Elvis,4683135,,True,28.0,4,13,1,6,3,7,0,0,0,4,4,1,0,0,0,1,11
401365810,Dayton Flyers,M. Sissoko,4431824,,False,8.0,1,2,1,2,0,0,1,1,1,2,3,0,2,0,0,0,3
401365810,Dayton Flyers,M. Amzil,4711607,,False,22.0,0,6,0,1,0,5,2,2,1,2,3,0,0,0,0,0,2
401365810,Dayton Flyers,K. Brea,4591259,,False,26.0,1,6,0,1,1,5,0,2,0,1,1,0,0,0,1,1,3
401365810,Dayton Flyers,TEAM,TOTAL,TOTAL,False,,17,55,11,33,6,22,13,18,11,26,37,13,5,7,12,11,53
401365809,Massachusetts Minutemen,M. Steadman,4397393,,True,17.0,2,7,2,6,0,1,0,0,1,1,2,1,1,0,2,0,4
401365809,Massachusetts Minutemen,T. Buttrick,4277981,,True,37.0,5,9,2,3,3,6,3,4,1,5,6,2,0,1,1,1,16
401365809,Massachusetts Minutemen,T.J. Weeks,4433108,,True,34.0,3,12,1,6,2,6,3,4,6,4,10,3,0,2,2,2,11
401365809,Massachusetts Minutemen,C.J. Kelly,4398208,,True,30.0,2,8,2,5,0,3,5,6,2,8,10,1,1,0,5,3,9
401365809,Massachusetts Minutemen,R. Kelly,4279741,,True,34.0,7,13,5,9,2,4,5,6,0,2,2,6,0,0,1,0,21
401365809,Massachusetts Minutemen,G. Jones,4279211,,False,22.0,2,7,1,6,1,1,0,0,3,2,5,1,1,0,0,3,5
401365809,Massachusetts Minutemen,J. Garcia,4701125,,False,25.0,3,5,3,4,0,1,5,6,0,2,2,1,2,1,1,4,11
401365809,Massachusetts Minutemen,P. Santos,4432104,,False,1.0,0,0,0,0,0,0,0,0,0,0,0,0,0,0,0,0,0
401365809,Massachusetts Minutemen,TEAM,TOTAL,TOTAL,False,,24,61,16,39,8,22,21,26,17,27,44,15,5,4,12,13,77
401365809,Massachusetts Minutemen,M. Steadman,4397393,,True,17.0,2,7,2,6,0,1,0,0,1,1,2,1,1,0,2,0,4
401365809,Massachusetts Minutemen,T. Buttrick,4277981,,True,37.0,5,9,2,3,3,6,3,4,1,5,6,2,0,1,1,1,16
401365809,Massachusetts Minutemen,T.J. Weeks,4433108,,True,34.0,3,12,1,6,2,6,3,4,6,4,10,3,0,2,2,2,11
401365809,Massachusetts Minutemen,C.J. Kelly,4398208,,True,30.0,2,8,2,5,0,3,5,6,2,8,10,1,1,0,5,3,9
401365809,Massachusetts Minutemen,R. Kelly,4279741,,True,34.0,7,13,5,9,2,4,5,6,0,2,2,6,0,0,1,0,21
401365809,Massachusetts Minutemen,G. Jones,4279211,,False,22.0,2,7,1,6,1,1,0,0,3,2,5,1,1,0,0,3,5
401365809,Massachusetts Minutemen,J. Garcia,4701125,,False,25.0,3,5,3,4,0,1,5,6,0,2,2,1,2,1,1,4,11
401365809,Massachusetts Minutemen,P. Santos,4432104,,False,1.0,0,0,0,0,0,0,0,0,0,0,0,0,0,0,0,0,0
401365809,Massachusetts Minutemen,TEAM,TOTAL,TOTAL,False,,24,61,16,39,8,22,21,26,17,27,44,15,5,4,12,13,77
401365809,La Salle Explorers,M. Doucoure,4277988,,True,19.0,2,3,2,3,0,0,0,0,1,0,1,1,1,0,0,3,4
401365809,La Salle Explorers,C. Moore,4277945,,True,27.0,6,14,4,8,2,6,0,0,2,2,4,0,1,3,2,4,14
401365809,La Salle Explorers,J. Clark,4397152,,True,37.0,6,11,4,5,2,6,2,2,0,5,5,5,0,1,3,1,16
401365809,La Salle Explorers,J. Brickus,4700970,,True,36.0,2,6,2,4,0,2,4,4,1,2,3,8,1,0,3,4,8
401365809,La Salle Explorers,J. Nickelberry,4432845,,True,35.0,7,12,4,5,3,7,1,3,1,3,4,4,1,0,1,2,18
401365809,La Salle Explorers,D. Shepherd,4710357,,False,7.0,1,3,1,3,0,0,0,0,0,0,0,0,0,1,2,0,2
401365809,La Salle Explorers,K. Brantley,4709132,,False,1.0,0,2,0,1,0,1,0,0,0,1,1,0,0,0,0,0,0
401365809,La Salle Explorers,A. Gill,4700969,,False,22.0,3,6,1,2,2,4,1,2,0,1,1,0,2,2,1,1,9
401365809,La Salle Explorers,C. Ray,4592448,,False,16.0,0,2,0,1,0,1,0,0,0,2,2,0,1,0,0,2,0
401365809,La Salle Explorers,TEAM,TOTAL,TOTAL,False,,27,59,18,32,9,27,8,11,7,20,27,18,7,7,12,17,71
401365809,La Salle Explorers,M. Doucoure,4277988,,True,19.0,2,3,2,3,0,0,0,0,1,0,1,1,1,0,0,3,4
401365809,La Salle Explorers,C. Moore,4277945,,True,27.0,6,14,4,8,2,6,0,0,2,2,4,0,1,3,2,4,14
401365809,La Salle Explorers,J. Clark,4397152,,True,37.0,6,11,4,5,2,6,2,2,0,5,5,5,0,1,3,1,16
401365809,La Salle Explorers,J. Brickus,4700970,,True,36.0,2,6,2,4,0,2,4,4,1,2,3,8,1,0,3,4,8
401365809,La Salle Explorers,J. Nickelberry,4432845,,True,35.0,7,12,4,5,3,7,1,3,1,3,4,4,1,0,1,2,18
401365809,La Salle Explorers,D. Shepherd,4710357,,False,7.0,1,3,1,3,0,0,0,0,0,0,0,0,0,1,2,0,2
401365809,La Salle Explorers,K. Brantley,4709132,,False,1.0,0,2,0,1,0,1,0,0,0,1,1,0,0,0,0,0,0
401365809,La Salle Explorers,A. Gill,4700969,,False,22.0,3,6,1,2,2,4,1,2,0,1,1,0,2,2,1,1,9
401365809,La Salle Explorers,C. Ray,4592448,,False,16.0,0,2,0,1,0,1,0,0,0,2,2,0,1,0,0,2,0
401365809,La Salle Explorers,TEAM,TOTAL,TOTAL,False,,27,59,18,32,9,27,8,11,7,20,27,18,7,7,12,17,71
401365808,Saint Louis Billikens,F. Okoro,4397105,,True,24.0,9,14,9,14,0,0,4,4,4,7,11,1,1,0,2,2,22
401365808,Saint Louis Billikens,J. Nesbitt,4714246,,True,24.0,1,5,1,5,0,0,3,4,1,1,2,3,3,0,0,0,5
401365808,Saint Louis Billikens,Y. Collins,4432957,,True,31.0,5,5,5,5,0,0,1,1,0,5,5,12,2,0,2,3,11
401365808,Saint Louis Billikens,G. Jimerson,4432008,,True,31.0,11,20,5,9,6,11,0,0,3,1,4,0,0,0,1,1,28
401365808,Saint Louis Billikens,F. Thatch Jr.,4397199,,True,29.0,1,4,1,4,0,0,0,0,2,3,5,0,1,3,2,2,2
401365808,Saint Louis Billikens,L. Traore,4897052,,False,3.0,2,3,2,3,0,0,0,0,0,1,1,0,0,0,1,1,4
401365808,Saint Louis Billikens,A. Lorentsson,4701121,,False,2.0,1,1,1,1,0,0,0,0,0,2,2,0,0,0,0,0,2
401365808,Saint Louis Billikens,T. Hargrove Jr.,4592484,,False,15.0,0,5,0,2,0,3,0,0,0,0,0,0,0,0,0,1,0
401365808,Saint Louis Billikens,M. Linssen,4279174,,False,16.0,1,3,1,3,0,0,2,2,3,2,5,1,0,0,0,2,4
401365808,Saint Louis Billikens,R. Williams,4399106,,False,9.0,0,5,0,1,0,4,2,2,0,0,0,1,0,0,0,1,2
401365808,Saint Louis Billikens,D. Jones,4278267,,False,16.0,0,3,0,2,0,1,0,0,0,2,2,1,1,0,0,1,0
401365808,Saint Louis Billikens,TEAM,TOTAL,TOTAL,False,,31,68,25,49,6,19,12,13,14,25,39,19,8,3,8,14,80
401365808,Saint Louis Billikens,F. Okoro,4397105,,True,24.0,9,14,9,14,0,0,4,4,4,7,11,1,1,0,2,2,22
401365808,Saint Louis Billikens,J. Nesbitt,4714246,,True,24.0,1,5,1,5,0,0,3,4,1,1,2,3,3,0,0,0,5
401365808,Saint Louis Billikens,Y. Collins,4432957,,True,31.0,5,5,5,5,0,0,1,1,0,5,5,12,2,0,2,3,11
401365808,Saint Louis Billikens,G. Jimerson,4432008,,True,31.0,11,20,5,9,6,11,0,0,3,1,4,0,0,0,1,1,28
401365808,Saint Louis Billikens,F. Thatch Jr.,4397199,,True,29.0,1,4,1,4,0,0,0,0,2,3,5,0,1,3,2,2,2
401365808,Saint Louis Billikens,L. Traore,4897052,,False,3.0,2,3,2,3,0,0,0,0,0,1,1,0,0,0,1,1,4
401365808,Saint Louis Billikens,A. Lorentsson,4701121,,False,2.0,1,1,1,1,0,0,0,0,0,2,2,0,0,0,0,0,2
401365808,Saint Louis Billikens,T. Hargrove Jr.,4592484,,False,15.0,0,5,0,2,0,3,0,0,0,0,0,0,0,0,0,1,0
401365808,Saint Louis Billikens,M. Linssen,4279174,,False,16.0,1,3,1,3,0,0,2,2,3,2,5,1,0,0,0,2,4
401365808,Saint Louis Billikens,R. Williams,4399106,,False,9.0,0,5,0,1,0,4,2,2,0,0,0,1,0,0,0,1,2
401365808,Saint Louis Billikens,D. Jones,4278267,,False,16.0,0,3,0,2,0,1,0,0,0,2,2,1,1,0,0,1,0
401365808,Saint Louis Billikens,TEAM,TOTAL,TOTAL,False,,31,68,25,49,6,19,12,13,14,25,39,19,8,3,8,14,80
401365808,George Washington Revolutionaries,H. Dean,4593273,,True,34.0,0,3,0,2,0,1,0,0,1,9,10,1,1,0,4,1,0
401365808,George Washington Revolutionaries,Q. Samuels,4592251,,True,19.0,0,0,0,0,0,0,0,0,0,3,3,0,0,0,1,1,0
401365808,George Washington Revolutionaries,B. Freeman,4613126,,True,26.0,2,7,2,5,0,2,4,4,0,1,1,3,1,0,2,3,8
401365808,George Washington Revolutionaries,J. Bamisile,4432537,,True,25.0,8,14,6,9,2,5,0,0,0,3,3,1,1,0,2,0,18
401365808,George Washington Revolutionaries,J. Bishop,4431770,,True,34.0,9,19,5,12,4,7,8,9,1,0,1,2,1,1,2,1,30
401365808,George Washington Revolutionaries,T. Warner,4897074,,False,1.0,0,0,0,0,0,0,0,0,0,0,0,0,0,0,0,1,0
401365808,George Washington Revolutionaries,R. Lindo Jr.,4397186,,False,22.0,1,2,1,2,0,0,0,0,1,3,4,0,0,2,0,2,2
401365808,George Washington Revolutionaries,A. Harris,4397216,,False,11.0,1,2,1,2,0,0,0,0,0,1,1,1,0,0,0,1,2
401365808,George Washington Revolutionaries,B. Adams,4396612,,False,28.0,2,5,1,4,1,1,2,5,1,3,4,3,0,0,1,1,7
401365808,George Washington Revolutionaries,TEAM,TOTAL,TOTAL,False,,23,52,16,36,7,16,14,18,6,24,30,11,4,3,14,11,67
401365808,George Washington Revolutionaries,H. Dean,4593273,,True,34.0,0,3,0,2,0,1,0,0,1,9,10,1,1,0,4,1,0
401365808,George Washington Revolutionaries,Q. Samuels,4592251,,True,19.0,0,0,0,0,0,0,0,0,0,3,3,0,0,0,1,1,0
401365808,George Washington Revolutionaries,B. Freeman,4613126,,True,26.0,2,7,2,5,0,2,4,4,0,1,1,3,1,0,2,3,8
401365808,George Washington Revolutionaries,J. Bamisile,4432537,,True,25.0,8,14,6,9,2,5,0,0,0,3,3,1,1,0,2,0,18
401365808,George Washington Revolutionaries,J. Bishop,4431770,,True,34.0,9,19,5,12,4,7,8,9,1,0,1,2,1,1,2,1,30
401365808,George Washington Revolutionaries,T. Warner,4897074,,False,1.0,0,0,0,0,0,0,0,0,0,0,0,0,0,0,0,1,0
401365808,George Washington Revolutionaries,R. Lindo Jr.,4397186,,False,22.0,1,2,1,2,0,0,0,0,1,3,4,0,0,2,0,2,2
401365808,George Washington Revolutionaries,A. Harris,4397216,,False,11.0,1,2,1,2,0,0,0,0,0,1,1,1,0,0,0,1,2
401365808,George Washington Revolutionaries,B. Adams,4396612,,False,28.0,2,5,1,4,1,1,2,5,1,3,4,3,0,0,1,1,7
401365808,George Washington Revolutionaries,TEAM,TOTAL,TOTAL,False,,23,52,16,36,7,16,14,18,6,24,30,11,4,3,14,11,67
401365807,St. Bonaventure Bonnies,O. Osunniyi,4397224,,True,31.0,2,6,2,6,0,0,4,6,4,3,7,0,0,0,2,3,8
401365807,St. Bonaventure Bonnies,J. Adaway,4279431,,True,36.0,4,7,1,2,3,5,4,5,0,4,4,0,1,0,1,1,15
401365807,St. Bonaventure Bonnies,J. Holmes,4701016,,True,40.0,4,15,4,11,0,4,6,7,2,2,4,5,1,0,3,3,14
401365807,St. Bonaventure Bonnies,D. Welch,4397221,,True,40.0,5,12,1,2,4,10,0,0,2,5,7,0,1,0,1,2,14
401365807,St. Bonaventure Bonnies,K. Lofton,4397220,,True,39.0,5,11,4,7,1,4,4,6,1,2,3,4,4,0,1,3,15
401365807,St. Bonaventure Bonnies,A. Coulibaly,4432889,,False,9.0,0,0,0,0,0,0,0,0,0,0,0,0,0,0,1,2,0
401365807,St. Bonaventure Bonnies,Q. Adams,4585591,,False,5.0,0,0,0,0,0,0,0,0,0,0,0,0,0,0,2,1,0
401365807,St. Bonaventure Bonnies,TEAM,TOTAL,TOTAL,False,,20,51,12,28,8,23,18,24,11,18,29,9,7,0,12,15,66
401365807,St. Bonaventure Bonnies,O. Osunniyi,4397224,,True,31.0,2,6,2,6,0,0,4,6,4,3,7,0,0,0,2,3,8
401365807,St. Bonaventure Bonnies,J. Adaway,4279431,,True,36.0,4,7,1,2,3,5,4,5,0,4,4,0,1,0,1,1,15
401365807,St. Bonaventure Bonnies,J. Holmes,4701016,,True,40.0,4,15,4,11,0,4,6,7,2,2,4,5,1,0,3,3,14
401365807,St. Bonaventure Bonnies,D. Welch,4397221,,True,40.0,5,12,1,2,4,10,0,0,2,5,7,0,1,0,1,2,14
401365807,St. Bonaventure Bonnies,K. Lofton,4397220,,True,39.0,5,11,4,7,1,4,4,6,1,2,3,4,4,0,1,3,15
401365807,St. Bonaventure Bonnies,A. Coulibaly,4432889,,False,9.0,0,0,0,0,0,0,0,0,0,0,0,0,0,0,1,2,0
401365807,St. Bonaventure Bonnies,Q. Adams,4585591,,False,5.0,0,0,0,0,0,0,0,0,0,0,0,0,0,0,2,1,0
401365807,St. Bonaventure Bonnies,TEAM,TOTAL,TOTAL,False,,20,51,12,28,8,23,18,24,11,18,29,9,7,0,12,15,66
401365807,George Mason Patriots,J. Oduro,4432068,,True,35.0,5,9,5,8,0,1,5,6,1,6,7,4,2,5,4,4,15
401365807,George Mason Patriots,X. Johnson,4592439,,True,35.0,2,3,0,1,2,2,0,0,0,6,6,2,2,0,4,4,6
401365807,George Mason Patriots,D. Gaines,4431961,,True,37.0,5,11,2,3,3,8,1,1,3,5,8,4,0,0,0,1,14
401365807,George Mason Patriots,D. Cooper,4279876,,True,35.0,6,12,1,1,5,11,1,2,0,2,2,3,1,0,0,2,18
401365807,George Mason Patriots,D. Schwartz,4278501,,True,39.0,7,12,2,3,5,9,1,1,2,2,4,2,1,0,3,4,20
401365807,George Mason Patriots,B. Jones,4897083,,False,1.0,0,1,0,0,0,1,0,0,0,0,0,0,0,0,0,0,0
401365807,George Mason Patriots,M. Henry,4606836,,False,3.0,0,0,0,0,0,0,0,0,0,0,0,0,0,0,0,0,0
401365807,George Mason Patriots,R. Polite III,4567711,,False,15.0,1,2,1,2,0,0,0,1,0,0,0,4,0,0,3,1,2
401365807,George Mason Patriots,TEAM,TOTAL,TOTAL,False,,26,50,11,18,15,32,8,11,8,24,32,19,6,5,14,16,75
401365807,George Mason Patriots,J. Oduro,4432068,,True,35.0,5,9,5,8,0,1,5,6,1,6,7,4,2,5,4,4,15
401365807,George Mason Patriots,X. Johnson,4592439,,True,35.0,2,3,0,1,2,2,0,0,0,6,6,2,2,0,4,4,6
401365807,George Mason Patriots,D. Gaines,4431961,,True,37.0,5,11,2,3,3,8,1,1,3,5,8,4,0,0,0,1,14
401365807,George Mason Patriots,D. Cooper,4279876,,True,35.0,6,12,1,1,5,11,1,2,0,2,2,3,1,0,0,2,18
401365807,George Mason Patriots,D. Schwartz,4278501,,True,39.0,7,12,2,3,5,9,1,1,2,2,4,2,1,0,3,4,20
401365807,George Mason Patriots,B. Jones,4897083,,False,1.0,0,1,0,0,0,1,0,0,0,0,0,0,0,0,0,0,0
401365807,George Mason Patriots,M. Henry,4606836,,False,3.0,0,0,0,0,0,0,0,0,0,0,0,0,0,0,0,0,0
401365807,George Mason Patriots,R. Polite III,4567711,,False,15.0,1,2,1,2,0,0,0,1,0,0,0,4,0,0,3,1,2
401365807,George Mason Patriots,TEAM,TOTAL,TOTAL,False,,26,50,11,18,15,32,8,11,8,24,32,19,6,5,14,16,75
401365806,Saint Joseph's Hawks,T. Funk,4278395,,True,39.0,5,15,2,6,3,9,0,0,2,4,6,2,0,1,1,0,13
401365806,Saint Joseph's Hawks,E. Obinna,4278125,,True,30.0,6,12,6,12,0,0,0,2,1,4,5,1,0,0,0,3,12
401365806,Saint Joseph's Hawks,J. Hall,4701031,,True,33.0,7,12,4,8,3,4,1,1,1,9,10,6,0,0,3,3,18
401365806,Saint Joseph's Hawks,E. Reynolds II,4683952,,True,39.0,5,11,2,4,3,7,0,0,0,3,3,1,0,1,4,1,13
401365806,Saint Joseph's Hawks,C. Brown,4592476,,True,34.0,4,8,1,3,3,5,2,2,3,3,6,4,1,0,1,0,13
401365806,Saint Joseph's Hawks,C. Coleman,4431807,,False,10.0,0,0,0,0,0,0,2,2,0,1,1,0,0,1,0,2,2
401365806,Saint Joseph's Hawks,D. Bishop,4701028,,False,15.0,0,1,0,0,0,1,1,2,1,2,3,0,0,0,1,1,1
401365806,Saint Joseph's Hawks,TEAM,TOTAL,TOTAL,False,,27,59,15,33,12,26,6,9,11,26,37,14,1,3,11,10,72
401365806,Saint Joseph's Hawks,T. Funk,4278395,,True,39.0,5,15,2,6,3,9,0,0,2,4,6,2,0,1,1,0,13
401365806,Saint Joseph's Hawks,E. Obinna,4278125,,True,30.0,6,12,6,12,0,0,0,2,1,4,5,1,0,0,0,3,12
401365806,Saint Joseph's Hawks,J. Hall,4701031,,True,33.0,7,12,4,8,3,4,1,1,1,9,10,6,0,0,3,3,18
401365806,Saint Joseph's Hawks,E. Reynolds II,4683952,,True,39.0,5,11,2,4,3,7,0,0,0,3,3,1,0,1,4,1,13
401365806,Saint Joseph's Hawks,C. Brown,4592476,,True,34.0,4,8,1,3,3,5,2,2,3,3,6,4,1,0,1,0,13
401365806,Saint Joseph's Hawks,C. Coleman,4431807,,False,10.0,0,0,0,0,0,0,2,2,0,1,1,0,0,1,0,2,2
401365806,Saint Joseph's Hawks,D. Bishop,4701028,,False,15.0,0,1,0,0,0,1,1,2,1,2,3,0,0,0,1,1,1
401365806,Saint Joseph's Hawks,TEAM,TOTAL,TOTAL,False,,27,59,15,33,12,26,6,9,11,26,37,14,1,3,11,10,72
401365806,Duquesne Dukes,T. Williams,4432147,,True,32.0,4,9,3,7,1,2,0,2,3,3,6,0,0,2,5,4,9
401365806,Duquesne Dukes,K. Easley,4398159,,True,34.0,2,8,1,6,1,2,1,1,4,4,8,0,2,0,0,1,6
401365806,Duquesne Dukes,A. Spears,4897090,,True,36.0,5,16,3,13,2,3,0,0,0,2,2,2,0,0,3,1,12
401365806,Duquesne Dukes,J. Johnson III,4897088,,True,27.0,6,11,2,6,4,5,3,4,0,2,2,0,2,0,0,1,19
401365806,Duquesne Dukes,L. Ayers III,4703813,,True,28.0,5,11,5,9,0,2,1,1,0,4,4,2,2,0,2,0,11
401365806,Duquesne Dukes,M. Hima,4700878,,False,8.0,0,0,0,0,0,0,0,0,0,1,1,0,0,2,1,2,0
401365806,Duquesne Dukes,M. Bekelja,4700874,,False,2.0,0,0,0,0,0,0,0,0,0,0,0,0,0,0,0,0,0
401365806,Duquesne Dukes,T. Okani,4700873,,False,13.0,1,1,1,1,0,0,0,0,1,3,4,0,0,0,0,0,2
401365806,Duquesne Dukes,T. Acuff,4606831,,False,20.0,1,3,1,3,0,0,0,0,0,2,2,0,0,0,0,1,2
401365806,Duquesne Dukes,TEAM,TOTAL,TOTAL,False,,24,59,16,45,8,14,5,8,10,22,32,4,6,4,11,10,61
401365806,Duquesne Dukes,T. Williams,4432147,,True,32.0,4,9,3,7,1,2,0,2,3,3,6,0,0,2,5,4,9
401365806,Duquesne Dukes,K. Easley,4398159,,True,34.0,2,8,1,6,1,2,1,1,4,4,8,0,2,0,0,1,6
401365806,Duquesne Dukes,A. Spears,4897090,,True,36.0,5,16,3,13,2,3,0,0,0,2,2,2,0,0,3,1,12
401365806,Duquesne Dukes,J. Johnson III,4897088,,True,27.0,6,11,2,6,4,5,3,4,0,2,2,0,2,0,0,1,19
401365806,Duquesne Dukes,L. Ayers III,4703813,,True,28.0,5,11,5,9,0,2,1,1,0,4,4,2,2,0,2,0,11
401365806,Duquesne Dukes,M. Hima,4700878,,False,8.0,0,0,0,0,0,0,0,0,0,1,1,0,0,2,1,2,0
401365806,Duquesne Dukes,M. Bekelja,4700874,,False,2.0,0,0,0,0,0,0,0,0,0,0,0,0,0,0,0,0,0
401365806,Duquesne Dukes,T. Okani,4700873,,False,13.0,1,1,1,1,0,0,0,0,1,3,4,0,0,0,0,0,2
401365806,Duquesne Dukes,T. Acuff,4606831,,False,20.0,1,3,1,3,0,0,0,0,0,2,2,0,0,0,0,1,2
401365806,Duquesne Dukes,TEAM,TOTAL,TOTAL,False,,24,59,16,45,8,14,5,8,10,22,32,4,6,4,11,10,61
401365805,VCU Rams,V. Williams Jr.,4397227,,True,31.0,6,9,4,6,2,3,2,3,0,6,6,2,1,0,1,4,16
401365805,VCU Rams,L. Stockard III,4277897,,True,17.0,4,6,4,6,0,0,4,5,0,0,0,0,1,0,2,5,12
401365805,VCU Rams,J. Nunn,4896614,,True,30.0,3,8,0,2,3,6,0,0,0,1,1,3,0,1,0,3,9
401365805,VCU Rams,A. Baldwin Jr.,4433182,,True,40.0,6,9,4,7,2,2,1,5,0,2,2,2,5,0,2,3,15
401365805,VCU Rams,K. Curry,4397228,,True,35.0,4,4,4,4,0,0,0,0,0,4,4,3,1,0,1,1,8
401365805,VCU Rams,H. Ward,4592495,,False,11.0,0,4,0,3,0,1,2,2,0,2,2,0,0,0,1,5,2
401365805,VCU Rams,M. Brown-Jones,4433224,,False,8.0,1,3,1,3,0,0,0,2,1,3,4,0,0,1,0,1,2
401365805,VCU Rams,J. DeLoach,4432483,,False,13.0,1,4,1,4,0,0,0,1,1,0,1,1,0,0,0,4,2
401365805,VCU Rams,N. Kern,4684145,,False,5.0,0,0,0,0,0,0,0,0,0,0,0,0,0,0,0,0,0
401365805,VCU Rams,M. Tsohonis,4592438,,False,7.0,2,5,2,3,0,2,0,0,0,1,1,0,0,0,0,0,4
401365805,VCU Rams,J. Banks,4432402,,False,3.0,0,1,0,1,0,0,0,0,1,0,1,0,0,0,0,0,0
401365805,VCU Rams,TEAM,TOTAL,TOTAL,False,,27,53,20,39,7,14,9,18,4,20,24,11,8,2,7,26,70
401365805,VCU Rams,V. Williams Jr.,4397227,,True,31.0,6,9,4,6,2,3,2,3,0,6,6,2,1,0,1,4,16
401365805,VCU Rams,L. Stockard III,4277897,,True,17.0,4,6,4,6,0,0,4,5,0,0,0,0,1,0,2,5,12
401365805,VCU Rams,J. Nunn,4896614,,True,30.0,3,8,0,2,3,6,0,0,0,1,1,3,0,1,0,3,9
401365805,VCU Rams,A. Baldwin Jr.,4433182,,True,40.0,6,9,4,7,2,2,1,5,0,2,2,2,5,0,2,3,15
401365805,VCU Rams,K. Curry,4397228,,True,35.0,4,4,4,4,0,0,0,0,0,4,4,3,1,0,1,1,8
401365805,VCU Rams,H. Ward,4592495,,False,11.0,0,4,0,3,0,1,2,2,0,2,2,0,0,0,1,5,2
401365805,VCU Rams,M. Brown-Jones,4433224,,False,8.0,1,3,1,3,0,0,0,2,1,3,4,0,0,1,0,1,2
401365805,VCU Rams,J. DeLoach,4432483,,False,13.0,1,4,1,4,0,0,0,1,1,0,1,1,0,0,0,4,2
401365805,VCU Rams,N. Kern,4684145,,False,5.0,0,0,0,0,0,0,0,0,0,0,0,0,0,0,0,0,0
401365805,VCU Rams,M. Tsohonis,4592438,,False,7.0,2,5,2,3,0,2,0,0,0,1,1,0,0,0,0,0,4
401365805,VCU Rams,J. Banks,4432402,,False,3.0,0,1,0,1,0,0,0,0,1,0,1,0,0,0,0,0,0
401365805,VCU Rams,TEAM,TOTAL,TOTAL,False,,27,53,20,39,7,14,9,18,4,20,24,11,8,2,7,26,70
401365805,Davidson Wildcats,S. Mennenga,4700862,,True,23.0,1,4,1,4,0,0,0,2,1,4,5,1,0,0,1,1,2
401365805,Davidson Wildcats,L. Brajkovic,4396787,,True,36.0,9,15,9,14,0,1,5,7,4,8,12,2,0,1,4,4,23
401365805,Davidson Wildcats,H. Lee,4592308,,True,33.0,2,5,1,1,1,4,8,8,1,4,5,0,1,0,1,1,13
401365805,Davidson Wildcats,F. Loyer,4397208,,True,37.0,1,5,1,4,0,1,10,10,0,2,2,1,1,0,5,4,12
401365805,Davidson Wildcats,M. Jones,4396784,,True,35.0,3,11,1,3,2,8,2,4,0,3,3,1,1,0,1,1,10
401365805,Davidson Wildcats,N. Boachie-Yiadom,4396786,,False,18.0,3,3,3,3,0,0,2,2,2,3,5,2,1,1,0,3,8
401365805,Davidson Wildcats,D. Watson,4897098,,False,15.0,0,1,0,1,0,0,0,0,0,2,2,0,0,1,2,2,0
401365805,Davidson Wildcats,E. Lanier,4567082,,False,3.0,0,0,0,0,0,0,0,0,0,0,0,0,0,0,0,2,0
401365805,Davidson Wildcats,TEAM,TOTAL,TOTAL,False,,19,44,16,30,3,14,27,33,8,27,35,7,4,3,15,18,68
401365805,Davidson Wildcats,S. Mennenga,4700862,,True,23.0,1,4,1,4,0,0,0,2,1,4,5,1,0,0,1,1,2
401365805,Davidson Wildcats,L. Brajkovic,4396787,,True,36.0,9,15,9,14,0,1,5,7,4,8,12,2,0,1,4,4,23
401365805,Davidson Wildcats,H. Lee,4592308,,True,33.0,2,5,1,1,1,4,8,8,1,4,5,0,1,0,1,1,13
401365805,Davidson Wildcats,F. Loyer,4397208,,True,37.0,1,5,1,4,0,1,10,10,0,2,2,1,1,0,5,4,12
401365805,Davidson Wildcats,M. Jones,4396784,,True,35.0,3,11,1,3,2,8,2,4,0,3,3,1,1,0,1,1,10
401365805,Davidson Wildcats,N. Boachie-Yiadom,4396786,,False,18.0,3,3,3,3,0,0,2,2,2,3,5,2,1,1,0,3,8
401365805,Davidson Wildcats,D. Watson,4897098,,False,15.0,0,1,0,1,0,0,0,0,0,2,2,0,0,1,2,2,0
401365805,Davidson Wildcats,E. Lanier,4567082,,False,3.0,0,0,0,0,0,0,0,0,0,0,0,0,0,0,0,2,0
401365805,Davidson Wildcats,TEAM,TOTAL,TOTAL,False,,19,44,16,30,3,14,27,33,8,27,35,7,4,3,15,18,68
401365804,Richmond Spiders,T. Burton,4431914,,True,35.0,5,11,4,7,1,4,3,4,4,9,13,2,1,0,2,2,14
401365804,Richmond Spiders,N. Cayo,4278380,,True,24.0,2,7,2,7,0,0,1,2,0,4,4,2,0,0,1,3,5
401365804,Richmond Spiders,G. Golden,4066836,,True,26.0,6,12,4,8,2,4,1,1,1,8,9,3,0,0,1,2,15
401365804,Richmond Spiders,A. Gustavson,4397193,,True,22.0,1,6,1,5,0,1,0,0,2,1,3,1,1,0,0,3,2
401365804,Richmond Spiders,J. Gilyard,4278378,,True,39.0,3,11,3,4,0,7,9,9,0,1,1,6,3,0,1,1,15
401365804,Richmond Spiders,M. Grace,4397192,,False,21.0,3,7,1,1,2,6,2,2,4,1,5,2,0,1,0,3,10
401365804,Richmond Spiders,I. Wilson,4700973,,False,10.0,0,1,0,1,0,0,0,0,0,3,3,0,1,0,2,0,0
401365804,Richmond Spiders,C. Crabtree,4396658,,False,7.0,0,0,0,0,0,0,1,2,0,2,2,0,0,0,0,1,1
401365804,Richmond Spiders,N. Sherod,4066832,,False,16.0,3,9,1,2,2,7,0,0,0,1,1,1,0,0,0,0,8
401365804,Richmond Spiders,TEAM,TOTAL,TOTAL,False,,23,64,16,35,7,29,17,20,14,31,45,17,6,1,7,15,70
401365804,Richmond Spiders,T. Burton,4431914,,True,35.0,5,11,4,7,1,4,3,4,4,9,13,2,1,0,2,2,14
401365804,Richmond Spiders,N. Cayo,4278380,,True,24.0,2,7,2,7,0,0,1,2,0,4,4,2,0,0,1,3,5
401365804,Richmond Spiders,G. Golden,4066836,,True,26.0,6,12,4,8,2,4,1,1,1,8,9,3,0,0,1,2,15
401365804,Richmond Spiders,A. Gustavson,4397193,,True,22.0,1,6,1,5,0,1,0,0,2,1,3,1,1,0,0,3,2
401365804,Richmond Spiders,J. Gilyard,4278378,,True,39.0,3,11,3,4,0,7,9,9,0,1,1,6,3,0,1,1,15
401365804,Richmond Spiders,M. Grace,4397192,,False,21.0,3,7,1,1,2,6,2,2,4,1,5,2,0,1,0,3,10
401365804,Richmond Spiders,I. Wilson,4700973,,False,10.0,0,1,0,1,0,0,0,0,0,3,3,0,1,0,2,0,0
401365804,Richmond Spiders,C. Crabtree,4396658,,False,7.0,0,0,0,0,0,0,1,2,0,2,2,0,0,0,0,1,1
401365804,Richmond Spiders,N. Sherod,4066832,,False,16.0,3,9,1,2,2,7,0,0,0,1,1,1,0,0,0,0,8
401365804,Richmond Spiders,TEAM,TOTAL,TOTAL,False,,23,64,16,35,7,29,17,20,14,31,45,17,6,1,7,15,70
401365804,Rhode Island Rams,Makhel Mitchell,4431777,,True,32.0,5,11,5,11,0,0,0,0,2,5,7,3,1,4,1,3,10
401365804,Rhode Island Rams,Makhi Mitchell,4431708,,True,28.0,4,12,4,10,0,2,1,3,3,9,12,0,2,2,1,2,9
401365804,Rhode Island Rams,S. Thomas,4897065,,True,38.0,0,8,0,7,0,1,0,0,0,2,2,7,1,0,2,5,0
401365804,Rhode Island Rams,I. Leggett,4606837,,True,19.0,3,7,3,4,0,3,4,4,1,1,2,2,1,0,1,2,10
401365804,Rhode Island Rams,I. El-Amin,4279313,,True,27.0,2,6,0,2,2,4,0,0,1,2,3,1,0,0,2,2,6
401365804,Rhode Island Rams,A. Walker,4278567,,False,20.0,5,8,3,4,2,4,0,1,1,3,4,1,0,1,0,3,12
401365804,Rhode Island Rams,M. Martin,4397470,,False,26.0,3,5,2,2,1,3,4,4,0,4,4,2,0,1,2,1,11
401365804,Rhode Island Rams,J. Carey,4395673,,False,10.0,2,3,1,2,1,1,0,0,0,1,1,0,0,1,1,0,5
401365804,Rhode Island Rams,TEAM,TOTAL,TOTAL,False,,24,60,18,42,6,18,9,12,8,28,36,16,5,9,10,18,63
401365804,Rhode Island Rams,Makhel Mitchell,4431777,,True,32.0,5,11,5,11,0,0,0,0,2,5,7,3,1,4,1,3,10
401365804,Rhode Island Rams,Makhi Mitchell,4431708,,True,28.0,4,12,4,10,0,2,1,3,3,9,12,0,2,2,1,2,9
401365804,Rhode Island Rams,S. Thomas,4897065,,True,38.0,0,8,0,7,0,1,0,0,0,2,2,7,1,0,2,5,0
401365804,Rhode Island Rams,I. Leggett,4606837,,True,19.0,3,7,3,4,0,3,4,4,1,1,2,2,1,0,1,2,10
401365804,Rhode Island Rams,I. El-Amin,4279313,,True,27.0,2,6,0,2,2,4,0,0,1,2,3,1,0,0,2,2,6
401365804,Rhode Island Rams,A. Walker,4278567,,False,20.0,5,8,3,4,2,4,0,1,1,3,4,1,0,1,0,3,12
401365804,Rhode Island Rams,M. Martin,4397470,,False,26.0,3,5,2,2,1,3,4,4,0,4,4,2,0,1,2,1,11
401365804,Rhode Island Rams,J. Carey,4395673,,False,10.0,2,3,1,2,1,1,0,0,0,1,1,0,0,1,1,0,5
401365804,Rhode Island Rams,TEAM,TOTAL,TOTAL,False,,24,60,18,42,6,18,9,12,8,28,36,16,5,9,10,18,63
401365803,Saint Louis Billikens,F. Okoro,4397105,,True,14.0,0,1,0,1,0,0,1,2,2,4,6,0,0,1,1,2,1
401365803,Saint Louis Billikens,J. Nesbitt,4714246,,True,20.0,7,10,7,8,0,2,3,5,4,8,12,2,0,1,0,4,17
401365803,Saint Louis Billikens,Y. Collins,4432957,,True,30.0,4,11,3,5,1,6,1,1,1,4,5,12,3,0,1,1,10
401365803,Saint Louis Billikens,G. Jimerson,4432008,,True,35.0,11,17,4,7,7,10,2,3,0,1,1,0,2,0,2,1,31
401365803,Saint Louis Billikens,F. Thatch Jr.,4397199,,True,26.0,3,6,3,6,0,0,0,0,2,5,7,0,1,0,1,4,6
401365803,Saint Louis Billikens,L. Traore,4897052,,False,10.0,2,4,2,4,0,0,0,0,4,2,6,0,1,0,1,2,4
401365803,Saint Louis Billikens,A. Lorentsson,4701121,,False,2.0,0,0,0,0,0,0,0,0,0,0,0,1,0,0,0,0,0
401365803,Saint Louis Billikens,T. Hargrove Jr.,4592484,,False,18.0,3,9,3,3,0,6,0,4,3,3,6,1,0,0,0,0,6
401365803,Saint Louis Billikens,M. Linssen,4279174,,False,16.0,2,6,2,6,0,0,4,4,2,2,4,0,0,1,1,1,8
401365803,Saint Louis Billikens,M. Strickland,4432494,,False,5.0,0,2,0,2,0,0,2,4,1,1,2,0,1,0,0,0,2
401365803,Saint Louis Billikens,R. Williams,4399106,,False,11.0,1,7,0,1,1,6,0,0,0,1,1,0,0,0,0,0,3
401365803,Saint Louis Billikens,B. Courtney,4397197,,False,3.0,1,1,1,1,0,0,0,0,1,1,2,0,0,0,0,1,2
401365803,Saint Louis Billikens,D. Jones,4278267,,False,10.0,0,0,0,0,0,0,0,0,0,0,0,3,0,0,0,1,0
401365803,Saint Louis Billikens,TEAM,TOTAL,TOTAL,False,,34,74,25,44,9,30,13,23,22,33,55,19,8,3,8,17,90
401365803,Saint Louis Billikens,F. Okoro,4397105,,True,14.0,0,1,0,1,0,0,1,2,2,4,6,0,0,1,1,2,1
401365803,Saint Louis Billikens,J. Nesbitt,4714246,,True,20.0,7,10,7,8,0,2,3,5,4,8,12,2,0,1,0,4,17
401365803,Saint Louis Billikens,Y. Collins,4432957,,True,30.0,4,11,3,5,1,6,1,1,1,4,5,12,3,0,1,1,10
401365803,Saint Louis Billikens,G. Jimerson,4432008,,True,35.0,11,17,4,7,7,10,2,3,0,1,1,0,2,0,2,1,31
401365803,Saint Louis Billikens,F. Thatch Jr.,4397199,,True,26.0,3,6,3,6,0,0,0,0,2,5,7,0,1,0,1,4,6
401365803,Saint Louis Billikens,L. Traore,4897052,,False,10.0,2,4,2,4,0,0,0,0,4,2,6,0,1,0,1,2,4
401365803,Saint Louis Billikens,A. Lorentsson,4701121,,False,2.0,0,0,0,0,0,0,0,0,0,0,0,1,0,0,0,0,0
401365803,Saint Louis Billikens,T. Hargrove Jr.,4592484,,False,18.0,3,9,3,3,0,6,0,4,3,3,6,1,0,0,0,0,6
401365803,Saint Louis Billikens,M. Linssen,4279174,,False,16.0,2,6,2,6,0,0,4,4,2,2,4,0,0,1,1,1,8
401365803,Saint Louis Billikens,M. Strickland,4432494,,False,5.0,0,2,0,2,0,0,2,4,1,1,2,0,1,0,0,0,2
401365803,Saint Louis Billikens,R. Williams,4399106,,False,11.0,1,7,0,1,1,6,0,0,0,1,1,0,0,0,0,0,3
401365803,Saint Louis Billikens,B. Courtney,4397197,,False,3.0,1,1,1,1,0,0,0,0,1,1,2,0,0,0,0,1,2
401365803,Saint Louis Billikens,D. Jones,4278267,,False,10.0,0,0,0,0,0,0,0,0,0,0,0,3,0,0,0,1,0
401365803,Saint Louis Billikens,TEAM,TOTAL,TOTAL,False,,34,74,25,44,9,30,13,23,22,33,55,19,8,3,8,17,90
401365803,Massachusetts Minutemen,M. Steadman,4397393,,True,19.0,2,6,2,6,0,0,4,4,1,1,2,0,1,1,2,2,8
401365803,Massachusetts Minutemen,T. Buttrick,4277981,,True,27.0,6,12,2,4,4,8,1,2,1,4,5,0,0,0,0,1,17
401365803,Massachusetts Minutemen,T.J. Weeks,4433108,,True,21.0,0,4,0,1,0,3,2,3,4,1,5,1,0,0,1,1,2
401365803,Massachusetts Minutemen,N. Fernandes,4431791,,True,19.0,1,8,0,4,1,4,0,0,0,2,2,2,1,0,1,3,3
401365803,Massachusetts Minutemen,R. Kelly,4279741,,True,24.0,2,6,1,2,1,4,0,0,1,1,2,2,0,0,2,1,5
401365803,Massachusetts Minutemen,D. Dominguez,4701126,,False,13.0,0,3,0,1,0,2,0,0,0,5,5,0,0,0,1,1,0
401365803,Massachusetts Minutemen,G. Jones,4279211,,False,15.0,1,5,1,3,0,2,2,2,1,1,2,0,0,0,2,0,4
401365803,Massachusetts Minutemen,R. Marcus,4701129,,False,3.0,0,1,0,0,0,1,4,4,0,0,0,0,0,0,0,0,4
401365803,Massachusetts Minutemen,J. Garcia,4701125,,False,22.0,5,11,2,5,3,6,1,2,2,1,3,1,0,0,1,1,14
401365803,Massachusetts Minutemen,K. Mitchell,4592454,,False,10.0,0,0,0,0,0,0,0,0,0,1,1,1,0,0,2,0,0
401365803,Massachusetts Minutemen,P. Santos,4432104,,False,9.0,1,2,1,1,0,1,0,0,0,1,1,0,0,0,0,4,2
401365803,Massachusetts Minutemen,C.J. Kelly,4398208,,False,18.0,0,4,0,2,0,2,0,0,0,2,2,1,0,2,1,2,0
401365803,Massachusetts Minutemen,TEAM,TOTAL,TOTAL,False,,18,62,9,29,9,33,14,17,13,22,35,8,2,3,13,17,59
401365803,Massachusetts Minutemen,M. Steadman,4397393,,True,19.0,2,6,2,6,0,0,4,4,1,1,2,0,1,1,2,2,8
401365803,Massachusetts Minutemen,T. Buttrick,4277981,,True,27.0,6,12,2,4,4,8,1,2,1,4,5,0,0,0,0,1,17
401365803,Massachusetts Minutemen,T.J. Weeks,4433108,,True,21.0,0,4,0,1,0,3,2,3,4,1,5,1,0,0,1,1,2
401365803,Massachusetts Minutemen,N. Fernandes,4431791,,True,19.0,1,8,0,4,1,4,0,0,0,2,2,2,1,0,1,3,3
401365803,Massachusetts Minutemen,R. Kelly,4279741,,True,24.0,2,6,1,2,1,4,0,0,1,1,2,2,0,0,2,1,5
401365803,Massachusetts Minutemen,D. Dominguez,4701126,,False,13.0,0,3,0,1,0,2,0,0,0,5,5,0,0,0,1,1,0
401365803,Massachusetts Minutemen,G. Jones,4279211,,False,15.0,1,5,1,3,0,2,2,2,1,1,2,0,0,0,2,0,4
401365803,Massachusetts Minutemen,R. Marcus,4701129,,False,3.0,0,1,0,0,0,1,4,4,0,0,0,0,0,0,0,0,4
401365803,Massachusetts Minutemen,J. Garcia,4701125,,False,22.0,5,11,2,5,3,6,1,2,2,1,3,1,0,0,1,1,14
401365803,Massachusetts Minutemen,K. Mitchell,4592454,,False,10.0,0,0,0,0,0,0,0,0,0,1,1,1,0,0,2,0,0
401365803,Massachusetts Minutemen,P. Santos,4432104,,False,9.0,1,2,1,1,0,1,0,0,0,1,1,0,0,0,0,4,2
401365803,Massachusetts Minutemen,C.J. Kelly,4398208,,False,18.0,0,4,0,2,0,2,0,0,0,2,2,1,0,2,1,2,0
401365803,Massachusetts Minutemen,TEAM,TOTAL,TOTAL,False,,18,62,9,29,9,33,14,17,13,22,35,8,2,3,13,17,59
401365802,George Mason Patriots,J. Oduro,4432068,,True,34.0,4,11,2,7,2,4,4,4,3,7,10,2,0,4,4,1,14
401365802,George Mason Patriots,X. Johnson,4592439,,True,34.0,2,7,1,3,1,4,0,3,0,7,7,4,0,1,6,3,5
401365802,George Mason Patriots,D. Gaines,4431961,,True,30.0,3,6,1,2,2,4,0,0,2,4,6,3,1,0,0,4,8
401365802,George Mason Patriots,D. Cooper,4279876,,True,28.0,2,6,0,1,2,5,0,1,0,3,3,0,0,0,0,1,6
401365802,George Mason Patriots,D. Schwartz,4278501,,True,35.0,6,13,3,6,3,7,2,3,0,6,6,2,0,0,0,0,17
401365802,George Mason Patriots,B. Jones,4897083,,False,14.0,0,0,0,0,0,0,0,0,0,2,2,1,0,0,1,3,0
401365802,George Mason Patriots,M. Henry,4606836,,False,6.0,0,0,0,0,0,0,0,0,0,0,0,0,0,0,0,1,0
401365802,George Mason Patriots,R. Polite III,4567711,,False,19.0,0,4,0,3,0,1,0,0,0,1,1,0,0,0,1,1,0
401365802,George Mason Patriots,TEAM,TOTAL,TOTAL,False,,17,47,7,22,10,25,6,11,5,32,37,12,1,5,12,14,50
401365802,George Mason Patriots,J. Oduro,4432068,,True,34.0,4,11,2,7,2,4,4,4,3,7,10,2,0,4,4,1,14
401365802,George Mason Patriots,X. Johnson,4592439,,True,34.0,2,7,1,3,1,4,0,3,0,7,7,4,0,1,6,3,5
401365802,George Mason Patriots,D. Gaines,4431961,,True,30.0,3,6,1,2,2,4,0,0,2,4,6,3,1,0,0,4,8
401365802,George Mason Patriots,D. Cooper,4279876,,True,28.0,2,6,0,1,2,5,0,1,0,3,3,0,0,0,0,1,6
401365802,George Mason Patriots,D. Schwartz,4278501,,True,35.0,6,13,3,6,3,7,2,3,0,6,6,2,0,0,0,0,17
401365802,George Mason Patriots,B. Jones,4897083,,False,14.0,0,0,0,0,0,0,0,0,0,2,2,1,0,0,1,3,0
401365802,George Mason Patriots,M. Henry,4606836,,False,6.0,0,0,0,0,0,0,0,0,0,0,0,0,0,0,0,1,0
401365802,George Mason Patriots,R. Polite III,4567711,,False,19.0,0,4,0,3,0,1,0,0,0,1,1,0,0,0,1,1,0
401365802,George Mason Patriots,TEAM,TOTAL,TOTAL,False,,17,47,7,22,10,25,6,11,5,32,37,12,1,5,12,14,50
401365802,Dayton Flyers,R.J. Blakney,4700864,,True,14.0,0,3,0,0,0,3,0,0,0,4,4,1,0,0,1,1,0
401365802,Dayton Flyers,T. Camara,4431736,,True,23.0,3,9,3,8,0,1,0,1,2,3,5,0,0,0,2,3,6
401365802,Dayton Flyers,D. Holmes II,4433607,,True,33.0,1,3,1,3,0,0,2,2,0,7,7,1,0,2,1,3,4
401365802,Dayton Flyers,M. Smith,4683861,,True,36.0,5,17,4,13,1,4,1,1,1,4,5,3,5,0,2,4,12
401365802,Dayton Flyers,K. Elvis,4683135,,True,27.0,5,11,4,8,1,3,0,0,0,0,0,0,2,0,0,2,11
401365802,Dayton Flyers,M. Amzil,4711607,,False,24.0,2,6,1,3,1,3,0,0,1,4,5,1,0,0,1,3,5
401365802,Dayton Flyers,K. Brea,4591259,,False,26.0,2,7,0,0,2,7,5,5,0,2,2,0,1,0,1,1,11
401365802,Dayton Flyers,E. Weaver,4397139,,False,17.0,0,2,0,0,0,2,0,0,0,5,5,1,0,0,0,0,0
401365802,Dayton Flyers,TEAM,TOTAL,TOTAL,False,,18,58,13,35,5,23,8,9,8,29,37,7,8,2,9,17,49
401365802,Dayton Flyers,R.J. Blakney,4700864,,True,14.0,0,3,0,0,0,3,0,0,0,4,4,1,0,0,1,1,0
401365802,Dayton Flyers,T. Camara,4431736,,True,23.0,3,9,3,8,0,1,0,1,2,3,5,0,0,0,2,3,6
401365802,Dayton Flyers,D. Holmes II,4433607,,True,33.0,1,3,1,3,0,0,2,2,0,7,7,1,0,2,1,3,4
401365802,Dayton Flyers,M. Smith,4683861,,True,36.0,5,17,4,13,1,4,1,1,1,4,5,3,5,0,2,4,12
401365802,Dayton Flyers,K. Elvis,4683135,,True,27.0,5,11,4,8,1,3,0,0,0,0,0,0,2,0,0,2,11
401365802,Dayton Flyers,M. Amzil,4711607,,False,24.0,2,6,1,3,1,3,0,0,1,4,5,1,0,0,1,3,5
401365802,Dayton Flyers,K. Brea,4591259,,False,26.0,2,7,0,0,2,7,5,5,0,2,2,0,1,0,1,1,11
401365802,Dayton Flyers,E. Weaver,4397139,,False,17.0,0,2,0,0,0,2,0,0,0,5,5,1,0,0,0,0,0
401365802,Dayton Flyers,TEAM,TOTAL,TOTAL,False,,18,58,13,35,5,23,8,9,8,29,37,7,8,2,9,17,49
401365801,Fordham Rams,A. Tsimbila,4702329,,True,11.0,1,3,1,3,0,0,1,1,1,1,2,0,0,0,2,5,3
401365801,Fordham Rams,A. Harrison,4897086,,True,17.0,1,3,1,2,0,1,1,2,0,1,1,1,1,0,0,4,3
401365801,Fordham Rams,A. Charlton,4897085,,True,28.0,4,10,3,6,1,4,0,0,0,2,2,3,0,0,3,5,9
401365801,Fordham Rams,J. Navarro,4592316,,True,28.0,3,7,1,2,2,5,0,0,3,1,4,2,0,0,0,3,8
401365801,Fordham Rams,D. Quisenberry,4397790,,True,40.0,10,20,4,7,6,13,10,10,1,4,5,4,3,0,0,1,36
401365801,Fordham Rams,P. Kelly,4432014,,False,13.0,0,2,0,0,0,2,0,0,0,2,2,0,0,1,1,3,0
401365801,Fordham Rams,R. Novitskyi,4897084,,False,19.0,0,0,0,0,0,0,0,0,0,1,1,0,0,2,1,2,0
401365801,Fordham Rams,Z. Riley,4914388,,False,3.0,0,1,0,0,0,1,0,0,0,1,1,0,0,0,0,0,0
401365801,Fordham Rams,K. Cunningham,4705891,,False,12.0,2,5,1,2,1,3,0,0,1,2,3,0,0,0,1,2,5
401365801,Fordham Rams,K. Rose,4592315,,False,29.0,0,4,0,2,0,2,2,2,1,4,5,0,0,1,1,2,2
401365801,Fordham Rams,TEAM,TOTAL,TOTAL,False,,21,55,11,24,10,31,14,15,7,21,28,10,4,4,9,27,66
401365801,Fordham Rams,A. Tsimbila,4702329,,True,11.0,1,3,1,3,0,0,1,1,1,1,2,0,0,0,2,5,3
401365801,Fordham Rams,A. Harrison,4897086,,True,17.0,1,3,1,2,0,1,1,2,0,1,1,1,1,0,0,4,3
401365801,Fordham Rams,A. Charlton,4897085,,True,28.0,4,10,3,6,1,4,0,0,0,2,2,3,0,0,3,5,9
401365801,Fordham Rams,J. Navarro,4592316,,True,28.0,3,7,1,2,2,5,0,0,3,1,4,2,0,0,0,3,8
401365801,Fordham Rams,D. Quisenberry,4397790,,True,40.0,10,20,4,7,6,13,10,10,1,4,5,4,3,0,0,1,36
401365801,Fordham Rams,P. Kelly,4432014,,False,13.0,0,2,0,0,0,2,0,0,0,2,2,0,0,1,1,3,0
401365801,Fordham Rams,R. Novitskyi,4897084,,False,19.0,0,0,0,0,0,0,0,0,0,1,1,0,0,2,1,2,0
401365801,Fordham Rams,Z. Riley,4914388,,False,3.0,0,1,0,0,0,1,0,0,0,1,1,0,0,0,0,0,0
401365801,Fordham Rams,K. Cunningham,4705891,,False,12.0,2,5,1,2,1,3,0,0,1,2,3,0,0,0,1,2,5
401365801,Fordham Rams,K. Rose,4592315,,False,29.0,0,4,0,2,0,2,2,2,1,4,5,0,0,1,1,2,2
401365801,Fordham Rams,TEAM,TOTAL,TOTAL,False,,21,55,11,24,10,31,14,15,7,21,28,10,4,4,9,27,66
401365801,Davidson Wildcats,S. Mennenga,4700862,,True,32.0,8,16,8,14,0,2,0,2,5,6,11,1,1,1,1,1,16
401365801,Davidson Wildcats,L. Brajkovic,4396787,,True,26.0,7,10,6,8,1,2,6,9,1,0,1,3,0,1,2,2,21
401365801,Davidson Wildcats,H. Lee,4592308,,True,36.0,1,4,0,1,1,3,2,2,1,7,8,2,0,1,2,3,5
401365801,Davidson Wildcats,F. Loyer,4397208,,True,38.0,3,8,2,5,1,3,8,8,0,6,6,0,0,0,3,4,15
401365801,Davidson Wildcats,M. Jones,4396784,,True,33.0,0,3,0,3,0,0,4,4,0,5,5,2,0,0,1,4,4
401365801,Davidson Wildcats,N. Boachie-Yiadom,4396786,,False,20.0,2,2,2,2,0,0,4,4,0,0,0,1,0,0,0,1,8
401365801,Davidson Wildcats,D. Watson,4897098,,False,12.0,0,6,0,3,0,3,0,0,0,1,1,0,0,0,1,1,0
401365801,Davidson Wildcats,E. Lanier,4567082,,False,3.0,0,0,0,0,0,0,0,0,0,0,0,0,0,0,0,0,0
401365801,Davidson Wildcats,TEAM,TOTAL,TOTAL,False,,21,49,18,36,3,13,24,29,10,28,38,9,1,3,10,16,69
401365801,Davidson Wildcats,S. Mennenga,4700862,,True,32.0,8,16,8,14,0,2,0,2,5,6,11,1,1,1,1,1,16
401365801,Davidson Wildcats,L. Brajkovic,4396787,,True,26.0,7,10,6,8,1,2,6,9,1,0,1,3,0,1,2,2,21
401365801,Davidson Wildcats,H. Lee,4592308,,True,36.0,1,4,0,1,1,3,2,2,1,7,8,2,0,1,2,3,5
401365801,Davidson Wildcats,F. Loyer,4397208,,True,38.0,3,8,2,5,1,3,8,8,0,6,6,0,0,0,3,4,15
401365801,Davidson Wildcats,M. Jones,4396784,,True,33.0,0,3,0,3,0,0,4,4,0,5,5,2,0,0,1,4,4
401365801,Davidson Wildcats,N. Boachie-Yiadom,4396786,,False,20.0,2,2,2,2,0,0,4,4,0,0,0,1,0,0,0,1,8
401365801,Davidson Wildcats,D. Watson,4897098,,False,12.0,0,6,0,3,0,3,0,0,0,1,1,0,0,0,1,1,0
401365801,Davidson Wildcats,E. Lanier,4567082,,False,3.0,0,0,0,0,0,0,0,0,0,0,0,0,0,0,0,0,0
401365801,Davidson Wildcats,TEAM,TOTAL,TOTAL,False,,21,49,18,36,3,13,24,29,10,28,38,9,1,3,10,16,69
401365800,Richmond Spiders,T. Burton,4431914,,True,27.0,2,6,0,2,2,4,6,7,0,3,3,0,2,0,0,2,12
401365800,Richmond Spiders,N. Cayo,4278380,,True,30.0,9,11,9,11,0,0,0,1,1,3,4,1,1,0,0,2,18
401365800,Richmond Spiders,G. Golden,4066836,,True,27.0,7,15,7,12,0,3,4,5,0,5,5,1,2,0,1,1,18
401365800,Richmond Spiders,A. Gustavson,4397193,,True,33.0,3,5,3,4,0,1,2,2,0,5,5,1,5,1,3,2,8
401365800,Richmond Spiders,J. Gilyard,4278378,,True,40.0,2,6,1,1,1,5,1,2,0,2,2,7,2,1,1,1,6
401365800,Richmond Spiders,M. Grace,4397192,,False,16.0,1,3,1,2,0,1,0,0,1,3,4,0,0,0,0,2,2
401365800,Richmond Spiders,S. Koureissi,4397190,,False,3.0,0,1,0,1,0,0,0,0,0,0,0,1,0,0,1,0,0
401365800,Richmond Spiders,M. Randolph,4710356,,False,6.0,0,1,0,0,0,1,0,0,0,0,0,0,0,0,0,0,0
401365800,Richmond Spiders,I. Wilson,4700973,,False,5.0,0,2,0,0,0,2,0,0,0,1,1,0,0,0,0,2,0
401365800,Richmond Spiders,C. Crabtree,4396658,,False,2.0,0,0,0,0,0,0,0,0,0,0,0,0,0,0,0,0,0
401365800,Richmond Spiders,N. Sherod,4066832,,False,11.0,0,3,0,1,0,2,0,0,0,1,1,1,0,0,1,1,0
401365800,Richmond Spiders,TEAM,TOTAL,TOTAL,False,,24,53,21,34,3,19,13,17,4,24,28,12,12,2,8,13,64
401365800,Richmond Spiders,T. Burton,4431914,,True,27.0,2,6,0,2,2,4,6,7,0,3,3,0,2,0,0,2,12
401365800,Richmond Spiders,N. Cayo,4278380,,True,30.0,9,11,9,11,0,0,0,1,1,3,4,1,1,0,0,2,18
401365800,Richmond Spiders,G. Golden,4066836,,True,27.0,7,15,7,12,0,3,4,5,0,5,5,1,2,0,1,1,18
401365800,Richmond Spiders,A. Gustavson,4397193,,True,33.0,3,5,3,4,0,1,2,2,0,5,5,1,5,1,3,2,8
401365800,Richmond Spiders,J. Gilyard,4278378,,True,40.0,2,6,1,1,1,5,1,2,0,2,2,7,2,1,1,1,6
401365800,Richmond Spiders,M. Grace,4397192,,False,16.0,1,3,1,2,0,1,0,0,1,3,4,0,0,0,0,2,2
401365800,Richmond Spiders,S. Koureissi,4397190,,False,3.0,0,1,0,1,0,0,0,0,0,0,0,1,0,0,1,0,0
401365800,Richmond Spiders,M. Randolph,4710356,,False,6.0,0,1,0,0,0,1,0,0,0,0,0,0,0,0,0,0,0
401365800,Richmond Spiders,I. Wilson,4700973,,False,5.0,0,2,0,0,0,2,0,0,0,1,1,0,0,0,0,2,0
401365800,Richmond Spiders,C. Crabtree,4396658,,False,2.0,0,0,0,0,0,0,0,0,0,0,0,0,0,0,0,0,0
401365800,Richmond Spiders,N. Sherod,4066832,,False,11.0,0,3,0,1,0,2,0,0,0,1,1,1,0,0,1,1,0
401365800,Richmond Spiders,TEAM,TOTAL,TOTAL,False,,24,53,21,34,3,19,13,17,4,24,28,12,12,2,8,13,64
401365800,La Salle Explorers,M. Doucoure,4277988,,True,17.0,1,3,1,3,0,0,0,0,0,1,1,0,0,1,0,1,2
401365800,La Salle Explorers,C. Moore,4277945,,True,36.0,9,12,9,12,0,0,1,2,3,9,12,0,1,2,2,0,19
401365800,La Salle Explorers,J. Clark,4397152,,True,35.0,4,13,4,8,0,5,5,5,2,6,8,3,0,0,4,1,13
401365800,La Salle Explorers,K. Brantley,4709132,,True,16.0,1,4,1,3,0,1,0,0,0,0,0,1,1,0,4,1,2
401365800,La Salle Explorers,J. Nickelberry,4432845,,True,29.0,3,9,2,5,1,4,2,2,0,5,5,3,0,0,3,3,9
401365800,La Salle Explorers,M. McFarlane,4897068,,False,3.0,0,1,0,1,0,0,0,0,0,0,0,0,0,0,0,2,0
401365800,La Salle Explorers,J. Brickus,4700970,,False,24.0,2,6,0,2,2,4,0,0,1,2,3,3,0,0,2,3,6
401365800,La Salle Explorers,A. Gill,4700969,,False,14.0,0,4,0,4,0,0,0,0,1,2,3,2,1,0,0,3,0
401365800,La Salle Explorers,C. Ray,4592448,,False,26.0,1,3,1,2,0,1,3,4,4,4,8,3,0,1,1,3,5
401365800,La Salle Explorers,TEAM,TOTAL,TOTAL,False,,21,55,18,40,3,15,11,13,11,29,40,15,3,4,16,17,56
401365800,La Salle Explorers,M. Doucoure,4277988,,True,17.0,1,3,1,3,0,0,0,0,0,1,1,0,0,1,0,1,2
401365800,La Salle Explorers,C. Moore,4277945,,True,36.0,9,12,9,12,0,0,1,2,3,9,12,0,1,2,2,0,19
401365800,La Salle Explorers,J. Clark,4397152,,True,35.0,4,13,4,8,0,5,5,5,2,6,8,3,0,0,4,1,13
401365800,La Salle Explorers,K. Brantley,4709132,,True,16.0,1,4,1,3,0,1,0,0,0,0,0,1,1,0,4,1,2
401365800,La Salle Explorers,J. Nickelberry,4432845,,True,29.0,3,9,2,5,1,4,2,2,0,5,5,3,0,0,3,3,9
401365800,La Salle Explorers,M. McFarlane,4897068,,False,3.0,0,1,0,1,0,0,0,0,0,0,0,0,0,0,0,2,0
401365800,La Salle Explorers,J. Brickus,4700970,,False,24.0,2,6,0,2,2,4,0,0,1,2,3,3,0,0,2,3,6
401365800,La Salle Explorers,A. Gill,4700969,,False,14.0,0,4,0,4,0,0,0,0,1,2,3,2,1,0,0,3,0
401365800,La Salle Explorers,C. Ray,4592448,,False,26.0,1,3,1,2,0,1,3,4,4,4,8,3,0,1,1,3,5
401365800,La Salle Explorers,TEAM,TOTAL,TOTAL,False,,21,55,18,40,3,15,11,13,11,29,40,15,3,4,16,17,56
401365799,VCU Rams,V. Williams Jr.,4397227,,True,35.0,7,12,3,5,4,7,3,4,1,6,7,2,3,0,2,3,21
401365799,VCU Rams,L. Stockard III,4277897,,True,19.0,3,7,3,7,0,0,0,0,0,0,0,0,2,1,2,0,6
401365799,VCU Rams,J. Nunn,4896614,,True,27.0,1,5,1,3,0,2,5,6,0,3,3,0,2,0,1,2,7
401365799,VCU Rams,A. Baldwin Jr.,4433182,,True,38.0,4,10,3,7,1,3,2,2,1,4,5,6,7,0,8,3,11
401365799,VCU Rams,K. Curry,4397228,,True,31.0,5,8,5,8,0,0,2,2,2,3,5,2,1,0,2,2,12
401365799,VCU Rams,H. Ward,4592495,,False,14.0,3,4,3,4,0,0,1,1,2,1,3,1,0,0,2,5,7
401365799,VCU Rams,M. Brown-Jones,4433224,,False,9.0,1,2,0,1,1,1,1,2,1,1,2,0,0,0,0,1,4
401365799,VCU Rams,J. DeLoach,4432483,,False,18.0,1,4,1,4,0,0,0,2,2,1,3,1,1,2,2,1,2
401365799,VCU Rams,N. Kern,4684145,,False,4.0,0,0,0,0,0,0,0,0,0,0,0,0,0,0,1,0,0
401365799,VCU Rams,J. Banks,4432402,,False,5.0,0,1,0,1,0,0,0,0,0,0,0,0,0,0,0,1,0
401365799,VCU Rams,TEAM,TOTAL,TOTAL,False,,25,53,19,40,6,13,14,19,11,21,32,12,16,3,20,18,70
401365799,VCU Rams,V. Williams Jr.,4397227,,True,35.0,7,12,3,5,4,7,3,4,1,6,7,2,3,0,2,3,21
401365799,VCU Rams,L. Stockard III,4277897,,True,19.0,3,7,3,7,0,0,0,0,0,0,0,0,2,1,2,0,6
401365799,VCU Rams,J. Nunn,4896614,,True,27.0,1,5,1,3,0,2,5,6,0,3,3,0,2,0,1,2,7
401365799,VCU Rams,A. Baldwin Jr.,4433182,,True,38.0,4,10,3,7,1,3,2,2,1,4,5,6,7,0,8,3,11
401365799,VCU Rams,K. Curry,4397228,,True,31.0,5,8,5,8,0,0,2,2,2,3,5,2,1,0,2,2,12
401365799,VCU Rams,H. Ward,4592495,,False,14.0,3,4,3,4,0,0,1,1,2,1,3,1,0,0,2,5,7
401365799,VCU Rams,M. Brown-Jones,4433224,,False,9.0,1,2,0,1,1,1,1,2,1,1,2,0,0,0,0,1,4
401365799,VCU Rams,J. DeLoach,4432483,,False,18.0,1,4,1,4,0,0,0,2,2,1,3,1,1,2,2,1,2
401365799,VCU Rams,N. Kern,4684145,,False,4.0,0,0,0,0,0,0,0,0,0,0,0,0,0,0,1,0,0
401365799,VCU Rams,J. Banks,4432402,,False,5.0,0,1,0,1,0,0,0,0,0,0,0,0,0,0,0,1,0
401365799,VCU Rams,TEAM,TOTAL,TOTAL,False,,25,53,19,40,6,13,14,19,11,21,32,12,16,3,20,18,70
401365799,Saint Joseph's Hawks,T. Funk,4278395,,True,40.0,4,14,1,5,3,9,11,11,4,2,6,1,1,1,0,1,22
401365799,Saint Joseph's Hawks,E. Obinna,4278125,,True,26.0,1,4,1,4,0,0,8,9,3,4,7,0,0,1,4,3,10
401365799,Saint Joseph's Hawks,J. Hall,4701031,,True,40.0,4,13,3,8,1,5,2,2,0,7,7,5,3,1,7,3,11
401365799,Saint Joseph's Hawks,E. Reynolds II,4683952,,True,28.0,0,3,0,2,0,1,0,0,0,1,1,3,0,1,3,5,0
401365799,Saint Joseph's Hawks,C. Brown,4592476,,True,32.0,3,6,2,2,1,4,0,0,0,2,2,1,3,0,5,2,7
401365799,Saint Joseph's Hawks,C. Coleman,4431807,,False,9.0,1,1,1,1,0,0,0,0,0,2,2,0,1,0,1,2,2
401365799,Saint Joseph's Hawks,A. Jansson,4701029,,False,4.0,0,2,0,2,0,0,0,0,1,2,3,0,0,0,1,0,0
401365799,Saint Joseph's Hawks,D. Bishop,4701028,,False,21.0,0,0,0,0,0,0,2,4,2,0,2,0,0,0,5,2,2
401365799,Saint Joseph's Hawks,TEAM,TOTAL,TOTAL,False,,13,43,8,24,5,19,23,26,11,20,31,10,8,4,27,18,54
401365799,Saint Joseph's Hawks,T. Funk,4278395,,True,40.0,4,14,1,5,3,9,11,11,4,2,6,1,1,1,0,1,22
401365799,Saint Joseph's Hawks,E. Obinna,4278125,,True,26.0,1,4,1,4,0,0,8,9,3,4,7,0,0,1,4,3,10
401365799,Saint Joseph's Hawks,J. Hall,4701031,,True,40.0,4,13,3,8,1,5,2,2,0,7,7,5,3,1,7,3,11
401365799,Saint Joseph's Hawks,E. Reynolds II,4683952,,True,28.0,0,3,0,2,0,1,0,0,0,1,1,3,0,1,3,5,0
401365799,Saint Joseph's Hawks,C. Brown,4592476,,True,32.0,3,6,2,2,1,4,0,0,0,2,2,1,3,0,5,2,7
401365799,Saint Joseph's Hawks,C. Coleman,4431807,,False,9.0,1,1,1,1,0,0,0,0,0,2,2,0,1,0,1,2,2
401365799,Saint Joseph's Hawks,A. Jansson,4701029,,False,4.0,0,2,0,2,0,0,0,0,1,2,3,0,0,0,1,0,0
401365799,Saint Joseph's Hawks,D. Bishop,4701028,,False,21.0,0,0,0,0,0,0,2,4,2,0,2,0,0,0,5,2,2
401365799,Saint Joseph's Hawks,TEAM,TOTAL,TOTAL,False,,13,43,8,24,5,19,23,26,11,20,31,10,8,4,27,18,54
401365798,Rhode Island Rams,Makhel Mitchell,4431777,,True,30.0,5,6,5,6,0,0,1,4,1,6,7,2,1,6,0,2,11
401365798,Rhode Island Rams,Makhi Mitchell,4431708,,True,24.0,1,3,1,2,0,1,2,12,1,9,10,0,2,0,2,4,4
401365798,Rhode Island Rams,I. Leggett,4606837,,True,32.0,2,9,2,5,0,4,7,8,4,5,9,1,0,0,1,1,11
401365798,Rhode Island Rams,I. El-Amin,4279313,,True,31.0,3,8,2,4,1,4,0,0,0,0,0,0,2,0,1,4,7
401365798,Rhode Island Rams,J. Sheppard,4066445,,True,29.0,4,9,4,5,0,4,4,6,0,1,1,2,2,0,1,4,12
401365798,Rhode Island Rams,A. Walker,4278567,,False,26.0,4,9,4,7,0,2,0,0,2,3,5,0,0,0,4,3,8
401365798,Rhode Island Rams,T. Berry,4701257,,False,5.0,0,1,0,0,0,1,0,0,0,0,0,0,0,0,0,1,0
401365798,Rhode Island Rams,J. Carey,4395673,,False,12.0,1,5,0,2,1,3,0,0,0,0,0,1,0,0,1,0,3
401365798,Rhode Island Rams,S. Thomas,4897065,,False,11.0,2,2,2,2,0,0,1,1,0,1,1,2,0,0,0,2,5
401365798,Rhode Island Rams,TEAM,TOTAL,TOTAL,False,,22,52,20,33,2,19,15,31,10,25,35,8,7,6,11,21,61
401365798,Rhode Island Rams,Makhel Mitchell,4431777,,True,30.0,5,6,5,6,0,0,1,4,1,6,7,2,1,6,0,2,11
401365798,Rhode Island Rams,Makhi Mitchell,4431708,,True,24.0,1,3,1,2,0,1,2,12,1,9,10,0,2,0,2,4,4
401365798,Rhode Island Rams,I. Leggett,4606837,,True,32.0,2,9,2,5,0,4,7,8,4,5,9,1,0,0,1,1,11
401365798,Rhode Island Rams,I. El-Amin,4279313,,True,31.0,3,8,2,4,1,4,0,0,0,0,0,0,2,0,1,4,7
401365798,Rhode Island Rams,J. Sheppard,4066445,,True,29.0,4,9,4,5,0,4,4,6,0,1,1,2,2,0,1,4,12
401365798,Rhode Island Rams,A. Walker,4278567,,False,26.0,4,9,4,7,0,2,0,0,2,3,5,0,0,0,4,3,8
401365798,Rhode Island Rams,T. Berry,4701257,,False,5.0,0,1,0,0,0,1,0,0,0,0,0,0,0,0,0,1,0
401365798,Rhode Island Rams,J. Carey,4395673,,False,12.0,1,5,0,2,1,3,0,0,0,0,0,1,0,0,1,0,3
401365798,Rhode Island Rams,S. Thomas,4897065,,False,11.0,2,2,2,2,0,0,1,1,0,1,1,2,0,0,0,2,5
401365798,Rhode Island Rams,TEAM,TOTAL,TOTAL,False,,22,52,20,33,2,19,15,31,10,25,35,8,7,6,11,21,61
401365798,George Washington Revolutionaries,H. Dean,4593273,,True,38.0,6,8,6,8,0,0,3,4,2,9,11,1,1,3,2,4,15
401365798,George Washington Revolutionaries,Q. Samuels,4592251,,True,26.0,2,4,1,2,1,2,1,2,1,1,2,1,2,0,1,4,6
401365798,George Washington Revolutionaries,B. Freeman,4613126,,True,22.0,3,7,3,7,0,0,3,4,0,2,2,5,0,0,2,4,9
401365798,George Washington Revolutionaries,J. Bamisile,4432537,,True,26.0,2,9,1,4,1,5,3,3,0,4,4,0,0,0,4,4,8
401365798,George Washington Revolutionaries,J. Bishop,4431770,,True,23.0,4,9,2,6,2,3,5,6,0,0,0,2,0,0,1,1,15
401365798,George Washington Revolutionaries,T. Warner,4897074,,False,4.0,1,1,1,1,0,0,0,0,0,1,1,0,0,1,0,2,2
401365798,George Washington Revolutionaries,A. Harris,4397216,,False,20.0,0,0,0,0,0,0,0,0,0,2,2,2,0,0,2,2,0
401365798,George Washington Revolutionaries,B. Adams,4396612,,False,34.0,3,8,3,6,0,2,2,4,1,4,5,1,0,0,1,4,8
401365798,George Washington Revolutionaries,B. Knapp,4279473,,False,7.0,0,1,0,1,0,0,0,0,0,2,2,0,0,0,0,1,0
401365798,George Washington Revolutionaries,TEAM,TOTAL,TOTAL,False,,21,47,17,35,4,12,17,23,5,29,34,12,3,4,15,26,63
401365798,George Washington Revolutionaries,H. Dean,4593273,,True,38.0,6,8,6,8,0,0,3,4,2,9,11,1,1,3,2,4,15
401365798,George Washington Revolutionaries,Q. Samuels,4592251,,True,26.0,2,4,1,2,1,2,1,2,1,1,2,1,2,0,1,4,6
401365798,George Washington Revolutionaries,B. Freeman,4613126,,True,22.0,3,7,3,7,0,0,3,4,0,2,2,5,0,0,2,4,9
401365798,George Washington Revolutionaries,J. Bamisile,4432537,,True,26.0,2,9,1,4,1,5,3,3,0,4,4,0,0,0,4,4,8
401365798,George Washington Revolutionaries,J. Bishop,4431770,,True,23.0,4,9,2,6,2,3,5,6,0,0,0,2,0,0,1,1,15
401365798,George Washington Revolutionaries,T. Warner,4897074,,False,4.0,1,1,1,1,0,0,0,0,0,1,1,0,0,1,0,2,2
401365798,George Washington Revolutionaries,A. Harris,4397216,,False,20.0,0,0,0,0,0,0,0,0,0,2,2,2,0,0,2,2,0
401365798,George Washington Revolutionaries,B. Adams,4396612,,False,34.0,3,8,3,6,0,2,2,4,1,4,5,1,0,0,1,4,8
401365798,George Washington Revolutionaries,B. Knapp,4279473,,False,7.0,0,1,0,1,0,0,0,0,0,2,2,0,0,0,0,1,0
401365798,George Washington Revolutionaries,TEAM,TOTAL,TOTAL,False,,21,47,17,35,4,12,17,23,5,29,34,12,3,4,15,26,63
401365797,St. Bonaventure Bonnies,O. Osunniyi,4397224,,True,35.0,9,14,9,14,0,0,3,4,13,4,17,2,1,6,3,1,21
401365797,St. Bonaventure Bonnies,J. Adaway,4279431,,True,40.0,7,14,6,11,1,3,1,2,0,5,5,1,1,1,1,1,16
401365797,St. Bonaventure Bonnies,J. Holmes,4701016,,True,36.0,7,15,6,13,1,2,1,1,2,1,3,1,0,1,0,1,16
401365797,St. Bonaventure Bonnies,D. Welch,4397221,,True,37.0,3,9,3,3,0,6,0,0,0,5,5,2,0,0,1,3,6
401365797,St. Bonaventure Bonnies,K. Lofton,4397220,,True,39.0,1,7,0,6,1,1,0,1,0,3,3,3,2,0,2,3,3
401365797,St. Bonaventure Bonnies,A. Coulibaly,4432889,,False,5.0,1,3,1,3,0,0,0,0,1,1,2,1,0,0,1,1,2
401365797,St. Bonaventure Bonnies,Q. Adams,4585591,,False,8.0,0,0,0,0,0,0,0,0,1,2,3,1,1,0,0,2,0
401365797,St. Bonaventure Bonnies,TEAM,TOTAL,TOTAL,False,,28,62,25,50,3,12,5,8,18,23,41,11,5,8,9,12,64
401365797,St. Bonaventure Bonnies,O. Osunniyi,4397224,,True,35.0,9,14,9,14,0,0,3,4,13,4,17,2,1,6,3,1,21
401365797,St. Bonaventure Bonnies,J. Adaway,4279431,,True,40.0,7,14,6,11,1,3,1,2,0,5,5,1,1,1,1,1,16
401365797,St. Bonaventure Bonnies,J. Holmes,4701016,,True,36.0,7,15,6,13,1,2,1,1,2,1,3,1,0,1,0,1,16
401365797,St. Bonaventure Bonnies,D. Welch,4397221,,True,37.0,3,9,3,3,0,6,0,0,0,5,5,2,0,0,1,3,6
401365797,St. Bonaventure Bonnies,K. Lofton,4397220,,True,39.0,1,7,0,6,1,1,0,1,0,3,3,3,2,0,2,3,3
401365797,St. Bonaventure Bonnies,A. Coulibaly,4432889,,False,5.0,1,3,1,3,0,0,0,0,1,1,2,1,0,0,1,1,2
401365797,St. Bonaventure Bonnies,Q. Adams,4585591,,False,8.0,0,0,0,0,0,0,0,0,1,2,3,1,1,0,0,2,0
401365797,St. Bonaventure Bonnies,TEAM,TOTAL,TOTAL,False,,28,62,25,50,3,12,5,8,18,23,41,11,5,8,9,12,64
401365797,Duquesne Dukes,T. Williams,4432147,,True,37.0,5,11,5,8,0,3,5,6,3,8,11,2,0,3,2,1,15
401365797,Duquesne Dukes,K. Easley,4398159,,True,33.0,6,11,4,7,2,4,0,0,4,5,9,0,1,1,0,3,14
401365797,Duquesne Dukes,A. Spears,4897090,,True,34.0,7,13,5,10,2,3,2,4,1,1,2,6,0,0,1,3,18
401365797,Duquesne Dukes,J. Johnson III,4897088,,True,16.0,0,3,0,1,0,2,0,0,0,0,0,0,0,0,1,1,0
401365797,Duquesne Dukes,L. Ayers III,4703813,,True,33.0,4,20,3,12,1,8,0,0,6,2,8,3,1,0,2,3,9
401365797,Duquesne Dukes,M. Hima,4700878,,False,3.0,0,0,0,0,0,0,0,0,1,0,1,0,0,0,2,0,0
401365797,Duquesne Dukes,M. Bekelja,4700874,,False,14.0,0,0,0,0,0,0,0,0,1,0,1,0,1,0,1,0,0
401365797,Duquesne Dukes,T. Okani,4700873,,False,15.0,0,1,0,1,0,0,0,0,1,1,2,0,0,0,1,3,0
401365797,Duquesne Dukes,T. Acuff,4606831,,False,15.0,0,3,0,1,0,2,0,0,0,1,1,0,0,0,1,0,0
401365797,Duquesne Dukes,TEAM,TOTAL,TOTAL,False,,22,62,17,40,5,22,7,10,19,18,37,11,3,4,11,14,56
401365797,Duquesne Dukes,T. Williams,4432147,,True,37.0,5,11,5,8,0,3,5,6,3,8,11,2,0,3,2,1,15
401365797,Duquesne Dukes,K. Easley,4398159,,True,33.0,6,11,4,7,2,4,0,0,4,5,9,0,1,1,0,3,14
401365797,Duquesne Dukes,A. Spears,4897090,,True,34.0,7,13,5,10,2,3,2,4,1,1,2,6,0,0,1,3,18
401365797,Duquesne Dukes,J. Johnson III,4897088,,True,16.0,0,3,0,1,0,2,0,0,0,0,0,0,0,0,1,1,0
401365797,Duquesne Dukes,L. Ayers III,4703813,,True,33.0,4,20,3,12,1,8,0,0,6,2,8,3,1,0,2,3,9
401365797,Duquesne Dukes,M. Hima,4700878,,False,3.0,0,0,0,0,0,0,0,0,1,0,1,0,0,0,2,0,0
401365797,Duquesne Dukes,M. Bekelja,4700874,,False,14.0,0,0,0,0,0,0,0,0,1,0,1,0,1,0,1,0,0
401365797,Duquesne Dukes,T. Okani,4700873,,False,15.0,0,1,0,1,0,0,0,0,1,1,2,0,0,0,1,3,0
401365797,Duquesne Dukes,T. Acuff,4606831,,False,15.0,0,3,0,1,0,2,0,0,0,1,1,0,0,0,1,0,0
401365797,Duquesne Dukes,TEAM,TOTAL,TOTAL,False,,22,62,17,40,5,22,7,10,19,18,37,11,3,4,11,14,56
401365795,Saint Joseph's Hawks,T. Funk,4278395,,True,36.0,5,10,1,3,4,7,2,4,3,6,9,3,1,1,0,1,16
401365795,Saint Joseph's Hawks,E. Obinna,4278125,,True,24.0,3,6,3,6,0,0,3,5,1,4,5,0,0,0,2,4,9
401365795,Saint Joseph's Hawks,J. Hall,4701031,,True,35.0,4,12,1,3,3,9,0,1,0,5,5,4,1,0,3,3,11
401365795,Saint Joseph's Hawks,E. Reynolds II,4683952,,True,27.0,2,10,2,7,0,3,2,4,1,0,1,1,1,0,3,5,6
401365795,Saint Joseph's Hawks,C. Brown,4592476,,True,23.0,3,5,1,2,2,3,2,2,2,2,4,1,1,0,3,1,10
401365795,Saint Joseph's Hawks,C. Coleman,4431807,,False,11.0,1,3,1,3,0,0,0,1,0,0,0,1,0,0,0,0,2
401365795,Saint Joseph's Hawks,J. Forrest,4701032,,False,25.0,2,10,1,6,1,4,0,0,0,5,5,1,2,1,1,4,5
401365795,Saint Joseph's Hawks,D. Bishop,4701028,,False,19.0,2,5,1,3,1,2,0,0,0,1,1,0,0,0,1,1,5
401365795,Saint Joseph's Hawks,TEAM,TOTAL,TOTAL,False,,22,61,11,33,11,28,9,17,9,25,34,11,6,2,13,19,64
401365795,Saint Joseph's Hawks,T. Funk,4278395,,True,36.0,5,10,1,3,4,7,2,4,3,6,9,3,1,1,0,1,16
401365795,Saint Joseph's Hawks,E. Obinna,4278125,,True,24.0,3,6,3,6,0,0,3,5,1,4,5,0,0,0,2,4,9
401365795,Saint Joseph's Hawks,J. Hall,4701031,,True,35.0,4,12,1,3,3,9,0,1,0,5,5,4,1,0,3,3,11
401365795,Saint Joseph's Hawks,E. Reynolds II,4683952,,True,27.0,2,10,2,7,0,3,2,4,1,0,1,1,1,0,3,5,6
401365795,Saint Joseph's Hawks,C. Brown,4592476,,True,23.0,3,5,1,2,2,3,2,2,2,2,4,1,1,0,3,1,10
401365795,Saint Joseph's Hawks,C. Coleman,4431807,,False,11.0,1,3,1,3,0,0,0,1,0,0,0,1,0,0,0,0,2
401365795,Saint Joseph's Hawks,J. Forrest,4701032,,False,25.0,2,10,1,6,1,4,0,0,0,5,5,1,2,1,1,4,5
401365795,Saint Joseph's Hawks,D. Bishop,4701028,,False,19.0,2,5,1,3,1,2,0,0,0,1,1,0,0,0,1,1,5
401365795,Saint Joseph's Hawks,TEAM,TOTAL,TOTAL,False,,22,61,11,33,11,28,9,17,9,25,34,11,6,2,13,19,64
401365795,La Salle Explorers,M. Doucoure,4277988,,True,15.0,1,3,1,3,0,0,2,2,4,2,6,0,3,0,0,3,4
401365795,La Salle Explorers,C. Moore,4277945,,True,34.0,6,14,6,11,0,3,4,4,3,7,10,1,0,2,0,2,16
401365795,La Salle Explorers,J. Clark,4397152,,True,34.0,7,15,2,5,5,10,2,2,1,5,6,2,1,0,1,0,21
401365795,La Salle Explorers,K. Brantley,4709132,,True,20.0,2,5,2,5,0,0,6,9,0,3,3,0,0,0,2,1,10
401365795,La Salle Explorers,A. Gill,4700969,,True,18.0,0,5,0,5,0,0,1,2,0,4,4,1,2,1,3,1,1
401365795,La Salle Explorers,M. McFarlane,4897068,,False,8.0,0,1,0,1,0,0,0,0,0,1,1,0,0,0,0,0,0
401365795,La Salle Explorers,D. Shepherd,4710357,,False,5.0,0,1,0,0,0,1,0,0,0,0,0,0,0,0,0,0,0
401365795,La Salle Explorers,J. Brickus,4700970,,False,17.0,1,3,1,3,0,0,0,0,0,1,1,2,2,0,1,2,2
401365795,La Salle Explorers,C. Ray,4592448,,False,24.0,1,4,1,2,0,2,0,0,2,4,6,1,2,0,1,4,2
401365795,La Salle Explorers,J. Nickelberry,4432845,,False,25.0,7,12,5,9,2,3,3,3,1,3,4,2,0,0,0,1,19
401365795,La Salle Explorers,TEAM,TOTAL,TOTAL,False,,25,63,18,44,7,19,18,22,12,31,43,9,10,3,9,14,75
401365795,La Salle Explorers,M. Doucoure,4277988,,True,15.0,1,3,1,3,0,0,2,2,4,2,6,0,3,0,0,3,4
401365795,La Salle Explorers,C. Moore,4277945,,True,34.0,6,14,6,11,0,3,4,4,3,7,10,1,0,2,0,2,16
401365795,La Salle Explorers,J. Clark,4397152,,True,34.0,7,15,2,5,5,10,2,2,1,5,6,2,1,0,1,0,21
401365795,La Salle Explorers,K. Brantley,4709132,,True,20.0,2,5,2,5,0,0,6,9,0,3,3,0,0,0,2,1,10
401365795,La Salle Explorers,A. Gill,4700969,,True,18.0,0,5,0,5,0,0,1,2,0,4,4,1,2,1,3,1,1
401365795,La Salle Explorers,M. McFarlane,4897068,,False,8.0,0,1,0,1,0,0,0,0,0,1,1,0,0,0,0,0,0
401365795,La Salle Explorers,D. Shepherd,4710357,,False,5.0,0,1,0,0,0,1,0,0,0,0,0,0,0,0,0,0,0
401365795,La Salle Explorers,J. Brickus,4700970,,False,17.0,1,3,1,3,0,0,0,0,0,1,1,2,2,0,1,2,2
401365795,La Salle Explorers,C. Ray,4592448,,False,24.0,1,4,1,2,0,2,0,0,2,4,6,1,2,0,1,4,2
401365795,La Salle Explorers,J. Nickelberry,4432845,,False,25.0,7,12,5,9,2,3,3,3,1,3,4,2,0,0,0,1,19
401365795,La Salle Explorers,TEAM,TOTAL,TOTAL,False,,25,63,18,44,7,19,18,22,12,31,43,9,10,3,9,14,75
401365794,George Washington Revolutionaries,H. Dean,4593273,,True,20.0,3,3,3,3,0,0,0,0,1,2,3,1,1,0,0,4,6
401365794,George Washington Revolutionaries,Q. Samuels,4592251,,True,21.0,2,3,2,2,0,1,0,0,1,1,2,0,1,0,0,2,4
401365794,George Washington Revolutionaries,B. Freeman,4613126,,True,33.0,6,11,5,7,1,4,0,0,0,2,2,3,2,0,3,3,13
401365794,George Washington Revolutionaries,J. Bamisile,4432537,,True,39.0,10,24,7,13,3,11,3,3,2,4,6,2,1,2,1,1,26
401365794,George Washington Revolutionaries,J. Bishop,4431770,,True,38.0,8,16,7,11,1,5,6,6,2,3,5,6,3,0,0,3,23
401365794,George Washington Revolutionaries,T. Warner,4897074,,False,2.0,0,0,0,0,0,0,0,0,0,0,0,0,0,0,0,0,0
401365794,George Washington Revolutionaries,A. Harris,4397216,,False,29.0,1,1,1,1,0,0,0,0,0,4,4,1,1,1,1,0,2
401365794,George Washington Revolutionaries,B. Knapp,4279473,,False,18.0,1,5,0,2,1,3,0,0,0,2,2,0,0,1,0,2,3
401365794,George Washington Revolutionaries,TEAM,TOTAL,TOTAL,False,,31,63,25,39,6,24,9,9,6,18,24,13,9,4,6,15,77
401365794,George Washington Revolutionaries,H. Dean,4593273,,True,20.0,3,3,3,3,0,0,0,0,1,2,3,1,1,0,0,4,6
401365794,George Washington Revolutionaries,Q. Samuels,4592251,,True,21.0,2,3,2,2,0,1,0,0,1,1,2,0,1,0,0,2,4
401365794,George Washington Revolutionaries,B. Freeman,4613126,,True,33.0,6,11,5,7,1,4,0,0,0,2,2,3,2,0,3,3,13
401365794,George Washington Revolutionaries,J. Bamisile,4432537,,True,39.0,10,24,7,13,3,11,3,3,2,4,6,2,1,2,1,1,26
401365794,George Washington Revolutionaries,J. Bishop,4431770,,True,38.0,8,16,7,11,1,5,6,6,2,3,5,6,3,0,0,3,23
401365794,George Washington Revolutionaries,T. Warner,4897074,,False,2.0,0,0,0,0,0,0,0,0,0,0,0,0,0,0,0,0,0
401365794,George Washington Revolutionaries,A. Harris,4397216,,False,29.0,1,1,1,1,0,0,0,0,0,4,4,1,1,1,1,0,2
401365794,George Washington Revolutionaries,B. Knapp,4279473,,False,18.0,1,5,0,2,1,3,0,0,0,2,2,0,0,1,0,2,3
401365794,George Washington Revolutionaries,TEAM,TOTAL,TOTAL,False,,31,63,25,39,6,24,9,9,6,18,24,13,9,4,6,15,77
401365794,George Mason Patriots,M. Henry,4606836,,True,19.0,5,5,5,5,0,0,0,0,2,2,4,0,0,0,0,4,10
401365794,George Mason Patriots,X. Johnson,4592439,,True,34.0,5,10,5,8,0,2,2,4,1,2,3,6,1,1,5,1,12
401365794,George Mason Patriots,D. Gaines,4431961,,True,40.0,4,8,4,6,0,2,2,4,4,7,11,3,1,1,2,2,10
401365794,George Mason Patriots,D. Cooper,4279876,,True,34.0,4,10,1,6,3,4,2,2,0,5,5,2,1,1,3,1,13
401365794,George Mason Patriots,D. Schwartz,4278501,,True,38.0,10,20,9,13,1,7,6,8,2,4,6,4,0,2,1,1,27
401365794,George Mason Patriots,B. Jones,4897083,,False,16.0,0,0,0,0,0,0,0,0,1,1,2,1,0,0,0,1,0
401365794,George Mason Patriots,O. Frazier III,4700882,,False,5.0,0,0,0,0,0,0,0,1,0,2,2,0,0,0,0,0,0
401365794,George Mason Patriots,R. Polite III,4567711,,False,13.0,2,4,2,3,0,1,0,0,0,0,0,0,0,0,1,1,4
401365794,George Mason Patriots,J. Hartwell II,4396817,,False,1.0,0,0,0,0,0,0,0,0,0,0,0,0,0,0,0,0,0
401365794,George Mason Patriots,TEAM,TOTAL,TOTAL,False,,30,57,26,41,4,16,12,19,11,24,35,16,3,5,13,11,76
401365794,George Mason Patriots,M. Henry,4606836,,True,19.0,5,5,5,5,0,0,0,0,2,2,4,0,0,0,0,4,10
401365794,George Mason Patriots,X. Johnson,4592439,,True,34.0,5,10,5,8,0,2,2,4,1,2,3,6,1,1,5,1,12
401365794,George Mason Patriots,D. Gaines,4431961,,True,40.0,4,8,4,6,0,2,2,4,4,7,11,3,1,1,2,2,10
401365794,George Mason Patriots,D. Cooper,4279876,,True,34.0,4,10,1,6,3,4,2,2,0,5,5,2,1,1,3,1,13
401365794,George Mason Patriots,D. Schwartz,4278501,,True,38.0,10,20,9,13,1,7,6,8,2,4,6,4,0,2,1,1,27
401365794,George Mason Patriots,B. Jones,4897083,,False,16.0,0,0,0,0,0,0,0,0,1,1,2,1,0,0,0,1,0
401365794,George Mason Patriots,O. Frazier III,4700882,,False,5.0,0,0,0,0,0,0,0,1,0,2,2,0,0,0,0,0,0
401365794,George Mason Patriots,R. Polite III,4567711,,False,13.0,2,4,2,3,0,1,0,0,0,0,0,0,0,0,1,1,4
401365794,George Mason Patriots,J. Hartwell II,4396817,,False,1.0,0,0,0,0,0,0,0,0,0,0,0,0,0,0,0,0,0
401365794,George Mason Patriots,TEAM,TOTAL,TOTAL,False,,30,57,26,41,4,16,12,19,11,24,35,16,3,5,13,11,76
401365793,Rhode Island Rams,Makhel Mitchell,4431777,,True,30.0,10,15,10,14,0,1,0,1,1,4,5,1,0,4,0,2,20
401365793,Rhode Island Rams,Makhi Mitchell,4431708,,True,29.0,2,6,1,4,1,2,2,2,0,4,4,8,0,2,2,2,7
401365793,Rhode Island Rams,I. Leggett,4606837,,True,16.0,1,4,1,3,0,1,0,0,1,1,2,2,1,0,3,3,2
401365793,Rhode Island Rams,I. El-Amin,4279313,,True,30.0,4,7,0,2,4,5,4,4,2,2,4,1,2,0,1,2,16
401365793,Rhode Island Rams,J. Sheppard,4066445,,True,29.0,1,8,1,4,0,4,3,4,0,4,4,5,2,0,3,2,5
401365793,Rhode Island Rams,A. Walker,4278567,,False,12.0,4,6,4,5,0,1,1,1,1,1,2,0,0,0,1,3,9
401365793,Rhode Island Rams,M. Martin,4397470,,False,23.0,5,7,5,6,0,1,1,3,2,5,7,1,0,0,0,0,11
401365793,Rhode Island Rams,J. Carey,4395673,,False,18.0,4,6,4,6,0,0,3,3,1,4,5,1,1,1,4,1,11
401365793,Rhode Island Rams,S. Thomas,4897065,,False,13.0,0,0,0,0,0,0,0,0,0,0,0,3,0,0,0,3,0
401365793,Rhode Island Rams,TEAM,TOTAL,TOTAL,False,,31,59,26,44,5,15,14,18,10,26,36,22,6,7,14,18,81
401365793,Rhode Island Rams,Makhel Mitchell,4431777,,True,30.0,10,15,10,14,0,1,0,1,1,4,5,1,0,4,0,2,20
401365793,Rhode Island Rams,Makhi Mitchell,4431708,,True,29.0,2,6,1,4,1,2,2,2,0,4,4,8,0,2,2,2,7
401365793,Rhode Island Rams,I. Leggett,4606837,,True,16.0,1,4,1,3,0,1,0,0,1,1,2,2,1,0,3,3,2
401365793,Rhode Island Rams,I. El-Amin,4279313,,True,30.0,4,7,0,2,4,5,4,4,2,2,4,1,2,0,1,2,16
401365793,Rhode Island Rams,J. Sheppard,4066445,,True,29.0,1,8,1,4,0,4,3,4,0,4,4,5,2,0,3,2,5
401365793,Rhode Island Rams,A. Walker,4278567,,False,12.0,4,6,4,5,0,1,1,1,1,1,2,0,0,0,1,3,9
401365793,Rhode Island Rams,M. Martin,4397470,,False,23.0,5,7,5,6,0,1,1,3,2,5,7,1,0,0,0,0,11
401365793,Rhode Island Rams,J. Carey,4395673,,False,18.0,4,6,4,6,0,0,3,3,1,4,5,1,1,1,4,1,11
401365793,Rhode Island Rams,S. Thomas,4897065,,False,13.0,0,0,0,0,0,0,0,0,0,0,0,3,0,0,0,3,0
401365793,Rhode Island Rams,TEAM,TOTAL,TOTAL,False,,31,59,26,44,5,15,14,18,10,26,36,22,6,7,14,18,81
401365793,Massachusetts Minutemen,M. Steadman,4397393,,True,21.0,2,5,2,5,0,0,2,2,1,1,2,0,0,0,0,1,6
401365793,Massachusetts Minutemen,T. Buttrick,4277981,,True,25.0,3,7,0,3,3,4,2,3,1,7,8,1,2,0,1,5,11
401365793,Massachusetts Minutemen,T.J. Weeks,4433108,,True,30.0,2,9,0,5,2,4,0,1,4,3,7,1,0,0,2,3,6
401365793,Massachusetts Minutemen,N. Fernandes,4431791,,True,39.0,5,10,3,6,2,4,6,10,0,3,3,7,4,0,4,3,18
401365793,Massachusetts Minutemen,R. Kelly,4279741,,True,34.0,4,11,0,4,4,7,2,2,1,3,4,3,1,0,3,0,14
401365793,Massachusetts Minutemen,D. Dominguez,4701126,,False,6.0,0,1,0,0,0,1,0,0,0,1,1,1,0,0,1,0,0
401365793,Massachusetts Minutemen,G. Jones,4279211,,False,24.0,3,9,2,6,1,3,3,4,3,1,4,0,1,0,0,5,10
401365793,Massachusetts Minutemen,J. Garcia,4701125,,False,18.0,1,3,0,2,1,1,0,0,0,1,1,0,0,0,1,3,3
401365793,Massachusetts Minutemen,K. Mitchell,4592454,,False,3.0,0,1,0,1,0,0,0,0,1,0,1,0,0,0,0,0,0
401365793,Massachusetts Minutemen,TEAM,TOTAL,TOTAL,False,,20,56,7,32,13,24,15,22,14,20,34,13,8,0,14,20,68
401365793,Massachusetts Minutemen,M. Steadman,4397393,,True,21.0,2,5,2,5,0,0,2,2,1,1,2,0,0,0,0,1,6
401365793,Massachusetts Minutemen,T. Buttrick,4277981,,True,25.0,3,7,0,3,3,4,2,3,1,7,8,1,2,0,1,5,11
401365793,Massachusetts Minutemen,T.J. Weeks,4433108,,True,30.0,2,9,0,5,2,4,0,1,4,3,7,1,0,0,2,3,6
401365793,Massachusetts Minutemen,N. Fernandes,4431791,,True,39.0,5,10,3,6,2,4,6,10,0,3,3,7,4,0,4,3,18
401365793,Massachusetts Minutemen,R. Kelly,4279741,,True,34.0,4,11,0,4,4,7,2,2,1,3,4,3,1,0,3,0,14
401365793,Massachusetts Minutemen,D. Dominguez,4701126,,False,6.0,0,1,0,0,0,1,0,0,0,1,1,1,0,0,1,0,0
401365793,Massachusetts Minutemen,G. Jones,4279211,,False,24.0,3,9,2,6,1,3,3,4,3,1,4,0,1,0,0,5,10
401365793,Massachusetts Minutemen,J. Garcia,4701125,,False,18.0,1,3,0,2,1,1,0,0,0,1,1,0,0,0,1,3,3
401365793,Massachusetts Minutemen,K. Mitchell,4592454,,False,3.0,0,1,0,1,0,0,0,0,1,0,1,0,0,0,0,0,0
401365793,Massachusetts Minutemen,TEAM,TOTAL,TOTAL,False,,20,56,7,32,13,24,15,22,14,20,34,13,8,0,14,20,68
401365792,Saint Louis Billikens,T. Hargrove Jr.,4592484,,True,28.0,4,10,4,10,0,0,0,0,2,1,3,1,0,0,0,2,8
401365792,Saint Louis Billikens,F. Okoro,4397105,,True,23.0,5,9,5,9,0,0,1,1,0,10,10,0,0,0,2,3,11
401365792,Saint Louis Billikens,J. Nesbitt,4714246,,True,21.0,2,4,1,2,1,2,0,0,0,3,3,1,0,0,2,3,5
401365792,Saint Louis Billikens,Y. Collins,4432957,,True,37.0,3,9,2,8,1,1,4,6,0,4,4,9,4,0,5,1,11
401365792,Saint Louis Billikens,G. Jimerson,4432008,,True,40.0,7,13,5,10,2,3,3,4,2,0,2,0,0,0,1,1,19
401365792,Saint Louis Billikens,L. Traore,4897052,,False,17.0,0,1,0,1,0,0,0,0,3,6,9,1,0,0,4,4,0
401365792,Saint Louis Billikens,M. Strickland,4432494,,False,4.0,0,0,0,0,0,0,0,0,0,0,0,0,0,0,2,0,0
401365792,Saint Louis Billikens,R. Williams,4399106,,False,3.0,0,1,0,0,0,1,0,0,0,0,0,0,0,0,0,0,0
401365792,Saint Louis Billikens,D. Jones,4278267,,False,27.0,3,6,2,3,1,3,2,2,3,7,10,3,1,0,2,4,9
401365792,Saint Louis Billikens,TEAM,TOTAL,TOTAL,False,,24,53,19,43,5,10,10,13,13,35,48,15,5,0,20,18,63
401365792,Saint Louis Billikens,T. Hargrove Jr.,4592484,,True,28.0,4,10,4,10,0,0,0,0,2,1,3,1,0,0,0,2,8
401365792,Saint Louis Billikens,F. Okoro,4397105,,True,23.0,5,9,5,9,0,0,1,1,0,10,10,0,0,0,2,3,11
401365792,Saint Louis Billikens,J. Nesbitt,4714246,,True,21.0,2,4,1,2,1,2,0,0,0,3,3,1,0,0,2,3,5
401365792,Saint Louis Billikens,Y. Collins,4432957,,True,37.0,3,9,2,8,1,1,4,6,0,4,4,9,4,0,5,1,11
401365792,Saint Louis Billikens,G. Jimerson,4432008,,True,40.0,7,13,5,10,2,3,3,4,2,0,2,0,0,0,1,1,19
401365792,Saint Louis Billikens,L. Traore,4897052,,False,17.0,0,1,0,1,0,0,0,0,3,6,9,1,0,0,4,4,0
401365792,Saint Louis Billikens,M. Strickland,4432494,,False,4.0,0,0,0,0,0,0,0,0,0,0,0,0,0,0,2,0,0
401365792,Saint Louis Billikens,R. Williams,4399106,,False,3.0,0,1,0,0,0,1,0,0,0,0,0,0,0,0,0,0,0
401365792,Saint Louis Billikens,D. Jones,4278267,,False,27.0,3,6,2,3,1,3,2,2,3,7,10,3,1,0,2,4,9
401365792,Saint Louis Billikens,TEAM,TOTAL,TOTAL,False,,24,53,19,43,5,10,10,13,13,35,48,15,5,0,20,18,63
401365792,Fordham Rams,C. Ohams,4066856,,True,28.0,4,13,4,13,0,0,0,4,2,6,8,2,1,0,3,3,8
401365792,Fordham Rams,A. Charlton,4897085,,True,39.0,2,12,1,6,1,6,1,2,0,1,1,4,3,0,0,2,6
401365792,Fordham Rams,J. Navarro,4592316,,True,29.0,2,5,2,3,0,2,0,0,0,1,1,2,0,0,1,2,4
401365792,Fordham Rams,K. Rose,4592315,,True,35.0,1,1,0,0,1,1,1,2,0,4,4,0,2,0,0,3,4
401365792,Fordham Rams,D. Quisenberry,4397790,,True,34.0,5,13,2,6,3,7,2,3,0,1,1,0,3,0,6,3,15
401365792,Fordham Rams,A. Tsimbila,4702329,,False,12.0,0,3,0,3,0,0,2,2,3,1,4,0,0,0,0,2,2
401365792,Fordham Rams,P. Kelly,4432014,,False,3.0,0,2,0,0,0,2,0,0,1,0,1,0,0,0,0,0,0
401365792,Fordham Rams,A. Harrison,4897086,,False,10.0,0,2,0,2,0,0,2,3,1,1,2,0,0,0,0,3,2
401365792,Fordham Rams,K. Cunningham,4705891,,False,10.0,2,5,2,3,0,2,0,0,0,2,2,0,0,0,0,1,4
401365792,Fordham Rams,TEAM,TOTAL,TOTAL,False,,16,56,11,36,5,20,8,16,8,18,26,8,9,0,10,19,45
401365792,Fordham Rams,C. Ohams,4066856,,True,28.0,4,13,4,13,0,0,0,4,2,6,8,2,1,0,3,3,8
401365792,Fordham Rams,A. Charlton,4897085,,True,39.0,2,12,1,6,1,6,1,2,0,1,1,4,3,0,0,2,6
401365792,Fordham Rams,J. Navarro,4592316,,True,29.0,2,5,2,3,0,2,0,0,0,1,1,2,0,0,1,2,4
401365792,Fordham Rams,K. Rose,4592315,,True,35.0,1,1,0,0,1,1,1,2,0,4,4,0,2,0,0,3,4
401365792,Fordham Rams,D. Quisenberry,4397790,,True,34.0,5,13,2,6,3,7,2,3,0,1,1,0,3,0,6,3,15
401365792,Fordham Rams,A. Tsimbila,4702329,,False,12.0,0,3,0,3,0,0,2,2,3,1,4,0,0,0,0,2,2
401365792,Fordham Rams,P. Kelly,4432014,,False,3.0,0,2,0,0,0,2,0,0,1,0,1,0,0,0,0,0,0
401365792,Fordham Rams,A. Harrison,4897086,,False,10.0,0,2,0,2,0,0,2,3,1,1,2,0,0,0,0,3,2
401365792,Fordham Rams,K. Cunningham,4705891,,False,10.0,2,5,2,3,0,2,0,0,0,2,2,0,0,0,0,1,4
401365792,Fordham Rams,TEAM,TOTAL,TOTAL,False,,16,56,11,36,5,20,8,16,8,18,26,8,9,0,10,19,45
401365791,Duquesne Dukes,T. Williams,4432147,,True,35.0,6,11,6,10,0,1,0,0,2,2,4,0,1,2,3,2,12
401365791,Duquesne Dukes,K. Easley,4398159,,True,32.0,4,9,2,5,2,4,0,0,1,5,6,1,1,0,1,0,10
401365791,Duquesne Dukes,A. Spears,4897090,,True,33.0,4,11,4,7,0,4,4,4,0,0,0,1,1,0,0,0,12
401365791,Duquesne Dukes,J. Johnson III,4897088,,True,25.0,1,5,1,3,0,2,0,0,0,2,2,3,0,0,2,0,2
401365791,Duquesne Dukes,L. Ayers III,4703813,,True,30.0,4,9,1,2,3,7,1,1,0,4,4,1,1,1,0,0,12
401365791,Duquesne Dukes,M. Hima,4700878,,False,6.0,0,0,0,0,0,0,0,0,0,2,2,0,0,1,1,2,0
401365791,Duquesne Dukes,D. Larson,4897091,,False,1.0,0,1,0,1,0,0,0,0,0,1,1,0,0,0,1,0,0
401365791,Duquesne Dukes,M. Bekelja,4700874,,False,3.0,0,0,0,0,0,0,0,0,0,0,0,0,0,0,0,0,0
401365791,Duquesne Dukes,T. Okani,4700873,,False,14.0,1,4,1,3,0,1,0,0,1,0,1,0,1,1,1,1,2
401365791,Duquesne Dukes,T. Acuff,4606831,,False,21.0,1,2,1,2,0,0,0,0,0,0,0,2,1,0,1,3,2
401365791,Duquesne Dukes,TEAM,TOTAL,TOTAL,False,,21,52,16,33,5,19,5,5,5,19,24,8,6,5,12,8,52
401365791,Duquesne Dukes,T. Williams,4432147,,True,35.0,6,11,6,10,0,1,0,0,2,2,4,0,1,2,3,2,12
401365791,Duquesne Dukes,K. Easley,4398159,,True,32.0,4,9,2,5,2,4,0,0,1,5,6,1,1,0,1,0,10
401365791,Duquesne Dukes,A. Spears,4897090,,True,33.0,4,11,4,7,0,4,4,4,0,0,0,1,1,0,0,0,12
401365791,Duquesne Dukes,J. Johnson III,4897088,,True,25.0,1,5,1,3,0,2,0,0,0,2,2,3,0,0,2,0,2
401365791,Duquesne Dukes,L. Ayers III,4703813,,True,30.0,4,9,1,2,3,7,1,1,0,4,4,1,1,1,0,0,12
401365791,Duquesne Dukes,M. Hima,4700878,,False,6.0,0,0,0,0,0,0,0,0,0,2,2,0,0,1,1,2,0
401365791,Duquesne Dukes,D. Larson,4897091,,False,1.0,0,1,0,1,0,0,0,0,0,1,1,0,0,0,1,0,0
401365791,Duquesne Dukes,M. Bekelja,4700874,,False,3.0,0,0,0,0,0,0,0,0,0,0,0,0,0,0,0,0,0
401365791,Duquesne Dukes,T. Okani,4700873,,False,14.0,1,4,1,3,0,1,0,0,1,0,1,0,1,1,1,1,2
401365791,Duquesne Dukes,T. Acuff,4606831,,False,21.0,1,2,1,2,0,0,0,0,0,0,0,2,1,0,1,3,2
401365791,Duquesne Dukes,TEAM,TOTAL,TOTAL,False,,21,52,16,33,5,19,5,5,5,19,24,8,6,5,12,8,52
401365791,Dayton Flyers,R.J. Blakney,4700864,,True,21.0,3,6,2,3,1,3,0,0,1,4,5,0,0,0,2,1,7
401365791,Dayton Flyers,T. Camara,4431736,,True,27.0,4,7,4,7,0,0,1,2,4,2,6,4,0,1,1,0,9
401365791,Dayton Flyers,D. Holmes II,4433607,,True,30.0,9,12,9,11,0,1,0,0,1,4,5,1,0,1,1,1,18
401365791,Dayton Flyers,M. Smith,4683861,,True,29.0,3,9,3,7,0,2,0,0,0,2,2,7,0,1,1,3,6
401365791,Dayton Flyers,K. Elvis,4683135,,True,28.0,6,8,2,4,4,4,0,0,0,1,1,3,1,0,1,0,16
401365791,Dayton Flyers,M. Sissoko,4431824,,False,8.0,1,2,1,2,0,0,0,0,0,1,1,0,1,0,0,0,2
401365791,Dayton Flyers,M. Amzil,4711607,,False,19.0,3,5,2,3,1,2,1,1,1,2,3,1,1,0,1,0,8
401365791,Dayton Flyers,K. Washington,4684293,,False,1.0,0,1,0,1,0,0,0,0,0,0,0,0,0,0,0,0,0
401365791,Dayton Flyers,Z. Nwokeji,4618121,,False,3.0,0,1,0,1,0,0,0,0,0,0,0,0,0,0,0,0,0
401365791,Dayton Flyers,C. Wilson,4403456,,False,1.0,0,0,0,0,0,0,0,0,0,0,0,0,0,0,0,0,0
401365791,Dayton Flyers,D. Swerlein,4600089,,False,1.0,0,0,0,0,0,0,0,0,0,1,1,0,1,0,0,0,0
401365791,Dayton Flyers,K. Brea,4591259,,False,16.0,2,6,0,1,2,5,0,0,1,5,6,2,0,0,1,0,6
401365791,Dayton Flyers,E. Weaver,4397139,,False,16.0,0,1,0,0,0,1,0,0,0,2,2,1,1,0,2,1,0
401365791,Dayton Flyers,TEAM,TOTAL,TOTAL,False,,31,58,23,40,8,18,2,3,9,26,35,19,5,3,10,6,72
401365791,Dayton Flyers,R.J. Blakney,4700864,,True,21.0,3,6,2,3,1,3,0,0,1,4,5,0,0,0,2,1,7
401365791,Dayton Flyers,T. Camara,4431736,,True,27.0,4,7,4,7,0,0,1,2,4,2,6,4,0,1,1,0,9
401365791,Dayton Flyers,D. Holmes II,4433607,,True,30.0,9,12,9,11,0,1,0,0,1,4,5,1,0,1,1,1,18
401365791,Dayton Flyers,M. Smith,4683861,,True,29.0,3,9,3,7,0,2,0,0,0,2,2,7,0,1,1,3,6
401365791,Dayton Flyers,K. Elvis,4683135,,True,28.0,6,8,2,4,4,4,0,0,0,1,1,3,1,0,1,0,16
401365791,Dayton Flyers,M. Sissoko,4431824,,False,8.0,1,2,1,2,0,0,0,0,0,1,1,0,1,0,0,0,2
401365791,Dayton Flyers,M. Amzil,4711607,,False,19.0,3,5,2,3,1,2,1,1,1,2,3,1,1,0,1,0,8
401365791,Dayton Flyers,K. Washington,4684293,,False,1.0,0,1,0,1,0,0,0,0,0,0,0,0,0,0,0,0,0
401365791,Dayton Flyers,Z. Nwokeji,4618121,,False,3.0,0,1,0,1,0,0,0,0,0,0,0,0,0,0,0,0,0
401365791,Dayton Flyers,C. Wilson,4403456,,False,1.0,0,0,0,0,0,0,0,0,0,0,0,0,0,0,0,0,0
401365791,Dayton Flyers,D. Swerlein,4600089,,False,1.0,0,0,0,0,0,0,0,0,0,1,1,0,1,0,0,0,0
401365791,Dayton Flyers,K. Brea,4591259,,False,16.0,2,6,0,1,2,5,0,0,1,5,6,2,0,0,1,0,6
401365791,Dayton Flyers,E. Weaver,4397139,,False,16.0,0,1,0,0,0,1,0,0,0,2,2,1,1,0,2,1,0
401365791,Dayton Flyers,TEAM,TOTAL,TOTAL,False,,31,58,23,40,8,18,2,3,9,26,35,19,5,3,10,6,72
401365790,VCU Rams,H. Ward,4592495,,True,19.0,1,2,1,2,0,0,0,0,1,2,3,1,0,0,0,2,2
401365790,VCU Rams,V. Williams Jr.,4397227,,True,30.0,4,5,2,2,2,3,2,2,0,4,4,3,3,0,2,4,12
401365790,VCU Rams,J. Nunn,4896614,,True,27.0,0,7,0,4,0,3,0,0,1,1,2,3,0,2,2,2,0
401365790,VCU Rams,A. Baldwin Jr.,4433182,,True,31.0,3,10,2,7,1,3,0,0,1,3,4,5,1,0,4,3,7
401365790,VCU Rams,K. Curry,4397228,,True,23.0,4,8,4,6,0,2,1,2,0,1,1,1,1,0,1,0,9
401365790,VCU Rams,M. Brown-Jones,4433224,,False,10.0,1,2,1,2,0,0,0,0,0,2,2,0,0,0,0,2,2
401365790,VCU Rams,J. DeLoach,4432483,,False,18.0,2,3,2,3,0,0,0,0,0,4,4,0,0,0,1,4,4
401365790,VCU Rams,L. Stockard III,4277897,,False,5.0,1,1,1,1,0,0,1,2,0,0,0,1,0,1,2,4,3
401365790,VCU Rams,N. Kern,4684145,,False,7.0,0,1,0,1,0,0,0,0,0,1,1,0,0,0,0,0,0
401365790,VCU Rams,M. Tsohonis,4592438,,False,24.0,4,10,0,2,4,8,2,2,0,2,2,0,0,0,1,1,14
401365790,VCU Rams,J. Banks,4432402,,False,6.0,0,3,0,2,0,1,0,0,0,1,1,1,1,0,0,0,0
401365790,VCU Rams,TEAM,TOTAL,TOTAL,False,,20,52,13,32,7,20,6,8,4,23,27,15,6,3,13,22,53
401365790,VCU Rams,H. Ward,4592495,,True,19.0,1,2,1,2,0,0,0,0,1,2,3,1,0,0,0,2,2
401365790,VCU Rams,V. Williams Jr.,4397227,,True,30.0,4,5,2,2,2,3,2,2,0,4,4,3,3,0,2,4,12
401365790,VCU Rams,J. Nunn,4896614,,True,27.0,0,7,0,4,0,3,0,0,1,1,2,3,0,2,2,2,0
401365790,VCU Rams,A. Baldwin Jr.,4433182,,True,31.0,3,10,2,7,1,3,0,0,1,3,4,5,1,0,4,3,7
401365790,VCU Rams,K. Curry,4397228,,True,23.0,4,8,4,6,0,2,1,2,0,1,1,1,1,0,1,0,9
401365790,VCU Rams,M. Brown-Jones,4433224,,False,10.0,1,2,1,2,0,0,0,0,0,2,2,0,0,0,0,2,2
401365790,VCU Rams,J. DeLoach,4432483,,False,18.0,2,3,2,3,0,0,0,0,0,4,4,0,0,0,1,4,4
401365790,VCU Rams,L. Stockard III,4277897,,False,5.0,1,1,1,1,0,0,1,2,0,0,0,1,0,1,2,4,3
401365790,VCU Rams,N. Kern,4684145,,False,7.0,0,1,0,1,0,0,0,0,0,1,1,0,0,0,0,0,0
401365790,VCU Rams,M. Tsohonis,4592438,,False,24.0,4,10,0,2,4,8,2,2,0,2,2,0,0,0,1,1,14
401365790,VCU Rams,J. Banks,4432402,,False,6.0,0,3,0,2,0,1,0,0,0,1,1,1,1,0,0,0,0
401365790,VCU Rams,TEAM,TOTAL,TOTAL,False,,20,52,13,32,7,20,6,8,4,23,27,15,6,3,13,22,53
401365790,St. Bonaventure Bonnies,O. Osunniyi,4397224,,True,36.0,3,9,3,8,0,1,3,6,2,5,7,3,0,3,0,2,9
401365790,St. Bonaventure Bonnies,J. Adaway,4279431,,True,40.0,8,14,6,9,2,5,7,7,1,7,8,0,1,1,1,3,25
401365790,St. Bonaventure Bonnies,J. Holmes,4701016,,True,37.0,4,9,3,5,1,4,8,8,0,5,5,3,0,0,2,2,17
401365790,St. Bonaventure Bonnies,D. Welch,4397221,,True,34.0,1,7,0,2,1,5,0,0,3,4,7,2,1,0,1,4,3
401365790,St. Bonaventure Bonnies,K. Lofton,4397220,,True,38.0,3,8,1,2,2,6,5,6,0,2,2,6,5,1,3,0,13
401365790,St. Bonaventure Bonnies,A. Coulibaly,4432889,,False,4.0,1,1,1,1,0,0,0,0,0,0,0,0,0,0,1,0,2
401365790,St. Bonaventure Bonnies,Q. Adams,4585591,,False,11.0,2,3,2,3,0,0,0,0,0,1,1,1,1,0,1,1,4
401365790,St. Bonaventure Bonnies,TEAM,TOTAL,TOTAL,False,,22,51,16,30,6,21,23,27,8,29,37,15,8,5,11,12,73
401365790,St. Bonaventure Bonnies,O. Osunniyi,4397224,,True,36.0,3,9,3,8,0,1,3,6,2,5,7,3,0,3,0,2,9
401365790,St. Bonaventure Bonnies,J. Adaway,4279431,,True,40.0,8,14,6,9,2,5,7,7,1,7,8,0,1,1,1,3,25
401365790,St. Bonaventure Bonnies,J. Holmes,4701016,,True,37.0,4,9,3,5,1,4,8,8,0,5,5,3,0,0,2,2,17
401365790,St. Bonaventure Bonnies,D. Welch,4397221,,True,34.0,1,7,0,2,1,5,0,0,3,4,7,2,1,0,1,4,3
401365790,St. Bonaventure Bonnies,K. Lofton,4397220,,True,38.0,3,8,1,2,2,6,5,6,0,2,2,6,5,1,3,0,13
401365790,St. Bonaventure Bonnies,A. Coulibaly,4432889,,False,4.0,1,1,1,1,0,0,0,0,0,0,0,0,0,0,1,0,2
401365790,St. Bonaventure Bonnies,Q. Adams,4585591,,False,11.0,2,3,2,3,0,0,0,0,0,1,1,1,1,0,1,1,4
401365790,St. Bonaventure Bonnies,TEAM,TOTAL,TOTAL,False,,22,51,16,30,6,21,23,27,8,29,37,15,8,5,11,12,73
401365789,Richmond Spiders,T. Burton,4431914,,True,31.0,2,9,0,5,2,4,3,4,2,1,3,0,2,1,0,2,9
401365789,Richmond Spiders,N. Cayo,4278380,,True,23.0,4,5,4,5,0,0,0,0,3,1,4,0,1,0,0,2,8
401365789,Richmond Spiders,G. Golden,4066836,,True,27.0,4,13,4,9,0,4,4,4,1,4,5,4,1,0,3,1,12
401365789,Richmond Spiders,I. Wilson,4700973,,True,11.0,0,1,0,0,0,1,0,0,0,0,0,1,0,0,0,3,0
401365789,Richmond Spiders,J. Gilyard,4278378,,True,38.0,8,13,3,4,5,9,7,9,0,4,4,5,3,0,0,1,28
401365789,Richmond Spiders,M. Grace,4397192,,False,12.0,0,3,0,1,0,2,0,0,0,0,0,0,0,0,0,0,0
401365789,Richmond Spiders,A. Gustavson,4397193,,False,30.0,2,4,2,2,0,2,1,2,0,1,1,1,2,1,0,3,5
401365789,Richmond Spiders,C. Crabtree,4396658,,False,3.0,1,1,1,1,0,0,0,0,0,0,0,0,0,0,2,1,2
401365789,Richmond Spiders,N. Sherod,4066832,,False,25.0,7,12,2,2,5,10,1,1,0,2,2,0,0,0,0,3,20
401365789,Richmond Spiders,TEAM,TOTAL,TOTAL,False,,28,61,16,29,12,32,16,20,8,14,22,11,9,2,5,16,84
401365789,Richmond Spiders,T. Burton,4431914,,True,31.0,2,9,0,5,2,4,3,4,2,1,3,0,2,1,0,2,9
401365789,Richmond Spiders,N. Cayo,4278380,,True,23.0,4,5,4,5,0,0,0,0,3,1,4,0,1,0,0,2,8
401365789,Richmond Spiders,G. Golden,4066836,,True,27.0,4,13,4,9,0,4,4,4,1,4,5,4,1,0,3,1,12
401365789,Richmond Spiders,I. Wilson,4700973,,True,11.0,0,1,0,0,0,1,0,0,0,0,0,1,0,0,0,3,0
401365789,Richmond Spiders,J. Gilyard,4278378,,True,38.0,8,13,3,4,5,9,7,9,0,4,4,5,3,0,0,1,28
401365789,Richmond Spiders,M. Grace,4397192,,False,12.0,0,3,0,1,0,2,0,0,0,0,0,0,0,0,0,0,0
401365789,Richmond Spiders,A. Gustavson,4397193,,False,30.0,2,4,2,2,0,2,1,2,0,1,1,1,2,1,0,3,5
401365789,Richmond Spiders,C. Crabtree,4396658,,False,3.0,1,1,1,1,0,0,0,0,0,0,0,0,0,0,2,1,2
401365789,Richmond Spiders,N. Sherod,4066832,,False,25.0,7,12,2,2,5,10,1,1,0,2,2,0,0,0,0,3,20
401365789,Richmond Spiders,TEAM,TOTAL,TOTAL,False,,28,61,16,29,12,32,16,20,8,14,22,11,9,2,5,16,84
401365789,Davidson Wildcats,S. Mennenga,4700862,,True,24.0,1,2,1,2,0,0,1,2,4,4,8,2,0,0,2,1,3
401365789,Davidson Wildcats,L. Brajkovic,4396787,,True,33.0,5,9,4,7,1,2,2,2,4,7,11,5,0,0,3,2,13
401365789,Davidson Wildcats,H. Lee,4592308,,True,36.0,7,12,5,7,2,5,3,3,2,6,8,2,2,0,6,1,19
401365789,Davidson Wildcats,F. Loyer,4397208,,True,33.0,5,14,4,7,1,7,5,5,0,7,7,5,1,0,2,4,16
401365789,Davidson Wildcats,M. Jones,4396784,,True,31.0,9,12,1,3,8,9,3,4,1,3,4,1,0,0,0,1,29
401365789,Davidson Wildcats,N. Boachie-Yiadom,4396786,,False,15.0,0,1,0,1,0,0,0,0,0,0,0,2,0,1,0,2,0
401365789,Davidson Wildcats,D. Watson,4897098,,False,15.0,1,4,0,0,1,4,0,0,0,0,0,1,0,0,2,0,3
401365789,Davidson Wildcats,G. Huffman,4432522,,False,13.0,2,2,2,2,0,0,0,0,0,0,0,0,0,0,0,1,4
401365789,Davidson Wildcats,TEAM,TOTAL,TOTAL,False,,30,56,17,29,13,27,14,16,12,27,39,18,3,1,16,12,87
401365789,Davidson Wildcats,S. Mennenga,4700862,,True,24.0,1,2,1,2,0,0,1,2,4,4,8,2,0,0,2,1,3
401365789,Davidson Wildcats,L. Brajkovic,4396787,,True,33.0,5,9,4,7,1,2,2,2,4,7,11,5,0,0,3,2,13
401365789,Davidson Wildcats,H. Lee,4592308,,True,36.0,7,12,5,7,2,5,3,3,2,6,8,2,2,0,6,1,19
401365789,Davidson Wildcats,F. Loyer,4397208,,True,33.0,5,14,4,7,1,7,5,5,0,7,7,5,1,0,2,4,16
401365789,Davidson Wildcats,M. Jones,4396784,,True,31.0,9,12,1,3,8,9,3,4,1,3,4,1,0,0,0,1,29
401365789,Davidson Wildcats,N. Boachie-Yiadom,4396786,,False,15.0,0,1,0,1,0,0,0,0,0,0,0,2,0,1,0,2,0
401365789,Davidson Wildcats,D. Watson,4897098,,False,15.0,1,4,0,0,1,4,0,0,0,0,0,1,0,0,2,0,3
401365789,Davidson Wildcats,G. Huffman,4432522,,False,13.0,2,2,2,2,0,0,0,0,0,0,0,0,0,0,0,1,4
401365789,Davidson Wildcats,TEAM,TOTAL,TOTAL,False,,30,56,17,29,13,27,14,16,12,27,39,18,3,1,16,12,87
401365788,Saint Joseph's Hawks,T. Funk,4278395,,True,35.0,3,7,1,1,2,6,2,2,1,6,7,2,2,0,2,2,10
401365788,Saint Joseph's Hawks,E. Obinna,4278125,,True,32.0,6,8,6,8,0,0,6,14,1,10,11,0,0,1,4,2,18
401365788,Saint Joseph's Hawks,J. Hall,4701031,,True,38.0,7,14,4,9,3,5,0,1,2,8,10,7,4,0,3,4,17
401365788,Saint Joseph's Hawks,D. Bishop,4701028,,True,17.0,0,3,0,1,0,2,0,0,0,2,2,0,0,0,2,2,0
401365788,Saint Joseph's Hawks,C. Brown,4592476,,True,25.0,2,6,1,2,1,4,0,0,0,0,0,0,1,0,3,3,5
401365788,Saint Joseph's Hawks,C. Coleman,4431807,,False,6.0,0,1,0,1,0,0,3,4,0,2,2,0,0,0,1,2,3
401365788,Saint Joseph's Hawks,J. Forrest,4701032,,False,19.0,0,2,0,1,0,1,1,2,0,3,3,0,0,0,0,1,1
401365788,Saint Joseph's Hawks,E. Reynolds II,4683952,,False,28.0,3,9,3,4,0,5,4,4,0,1,1,0,1,0,4,3,10
401365788,Saint Joseph's Hawks,TEAM,TOTAL,TOTAL,False,,21,50,15,27,6,23,16,27,7,34,41,9,8,1,19,19,64
401365788,Saint Joseph's Hawks,T. Funk,4278395,,True,35.0,3,7,1,1,2,6,2,2,1,6,7,2,2,0,2,2,10
401365788,Saint Joseph's Hawks,E. Obinna,4278125,,True,32.0,6,8,6,8,0,0,6,14,1,10,11,0,0,1,4,2,18
401365788,Saint Joseph's Hawks,J. Hall,4701031,,True,38.0,7,14,4,9,3,5,0,1,2,8,10,7,4,0,3,4,17
401365788,Saint Joseph's Hawks,D. Bishop,4701028,,True,17.0,0,3,0,1,0,2,0,0,0,2,2,0,0,0,2,2,0
401365788,Saint Joseph's Hawks,C. Brown,4592476,,True,25.0,2,6,1,2,1,4,0,0,0,0,0,0,1,0,3,3,5
401365788,Saint Joseph's Hawks,C. Coleman,4431807,,False,6.0,0,1,0,1,0,0,3,4,0,2,2,0,0,0,1,2,3
401365788,Saint Joseph's Hawks,J. Forrest,4701032,,False,19.0,0,2,0,1,0,1,1,2,0,3,3,0,0,0,0,1,1
401365788,Saint Joseph's Hawks,E. Reynolds II,4683952,,False,28.0,3,9,3,4,0,5,4,4,0,1,1,0,1,0,4,3,10
401365788,Saint Joseph's Hawks,TEAM,TOTAL,TOTAL,False,,21,50,15,27,6,23,16,27,7,34,41,9,8,1,19,19,64
401365788,Rhode Island Rams,Makhel Mitchell,4431777,,True,28.0,7,11,7,11,0,0,1,4,0,6,6,1,0,1,1,5,15
401365788,Rhode Island Rams,Makhi Mitchell,4431708,,True,21.0,5,9,5,9,0,0,2,3,1,2,3,1,2,1,2,2,12
401365788,Rhode Island Rams,I. Leggett,4606837,,True,28.0,1,7,1,5,0,2,1,2,0,1,1,1,1,1,2,3,3
401365788,Rhode Island Rams,I. El-Amin,4279313,,True,19.0,1,3,0,2,1,1,2,2,0,0,0,4,1,1,1,1,5
401365788,Rhode Island Rams,J. Sheppard,4066445,,True,33.0,4,12,1,7,3,5,2,2,0,4,4,6,1,0,1,3,13
401365788,Rhode Island Rams,A. Walker,4278567,,False,22.0,2,3,0,1,2,2,0,1,1,4,5,0,1,1,1,1,6
401365788,Rhode Island Rams,M. Martin,4397470,,False,26.0,2,5,2,4,0,1,5,5,2,10,12,2,1,0,0,1,9
401365788,Rhode Island Rams,J. Carey,4395673,,False,13.0,2,4,1,2,1,2,0,0,0,0,0,0,1,1,1,0,5
401365788,Rhode Island Rams,S. Thomas,4897065,,False,10.0,3,5,2,3,1,2,0,3,0,0,0,2,1,0,0,1,7
401365788,Rhode Island Rams,TEAM,TOTAL,TOTAL,False,,27,59,19,44,8,15,13,22,4,30,34,17,9,6,9,17,75
401365788,Rhode Island Rams,Makhel Mitchell,4431777,,True,28.0,7,11,7,11,0,0,1,4,0,6,6,1,0,1,1,5,15
401365788,Rhode Island Rams,Makhi Mitchell,4431708,,True,21.0,5,9,5,9,0,0,2,3,1,2,3,1,2,1,2,2,12
401365788,Rhode Island Rams,I. Leggett,4606837,,True,28.0,1,7,1,5,0,2,1,2,0,1,1,1,1,1,2,3,3
401365788,Rhode Island Rams,I. El-Amin,4279313,,True,19.0,1,3,0,2,1,1,2,2,0,0,0,4,1,1,1,1,5
401365788,Rhode Island Rams,J. Sheppard,4066445,,True,33.0,4,12,1,7,3,5,2,2,0,4,4,6,1,0,1,3,13
401365788,Rhode Island Rams,A. Walker,4278567,,False,22.0,2,3,0,1,2,2,0,1,1,4,5,0,1,1,1,1,6
401365788,Rhode Island Rams,M. Martin,4397470,,False,26.0,2,5,2,4,0,1,5,5,2,10,12,2,1,0,0,1,9
401365788,Rhode Island Rams,J. Carey,4395673,,False,13.0,2,4,1,2,1,2,0,0,0,0,0,0,1,1,1,0,5
401365788,Rhode Island Rams,S. Thomas,4897065,,False,10.0,3,5,2,3,1,2,0,3,0,0,0,2,1,0,0,1,7
401365788,Rhode Island Rams,TEAM,TOTAL,TOTAL,False,,27,59,19,44,8,15,13,22,4,30,34,17,9,6,9,17,75
401365787,Fordham Rams,C. Ohams,4066856,,True,34.0,7,19,7,19,0,0,0,2,8,8,16,3,3,8,3,1,14
401365787,Fordham Rams,A. Charlton,4897085,,True,33.0,2,8,2,5,0,3,0,0,0,6,6,4,3,2,2,3,4
401365787,Fordham Rams,K. Rose,4592315,,True,31.0,5,6,2,3,3,3,0,0,0,5,5,4,2,0,0,1,13
401365787,Fordham Rams,D. Quisenberry,4397790,,True,34.0,6,15,4,10,2,5,2,4,0,4,4,2,2,0,4,3,16
401365787,Fordham Rams,A. Daye Jr.,4397500,,True,36.0,7,17,7,15,0,2,2,2,0,2,2,4,0,0,1,3,16
401365787,Fordham Rams,A. Tsimbila,4702329,,False,4.0,1,2,1,2,0,0,0,0,0,0,0,0,0,0,0,0,2
401365787,Fordham Rams,P. Kelly,4432014,,False,4.0,0,0,0,0,0,0,0,0,0,0,0,1,0,0,0,0,0
401365787,Fordham Rams,A. Harrison,4897086,,False,1.0,0,0,0,0,0,0,0,0,0,0,0,0,0,0,0,0,0
401365787,Fordham Rams,K. Cunningham,4705891,,False,7.0,0,1,0,0,0,1,2,2,0,0,0,0,0,0,0,0,2
401365787,Fordham Rams,J. Navarro,4592316,,False,16.0,1,2,0,0,1,2,2,2,0,0,0,2,2,0,0,2,5
401365787,Fordham Rams,TEAM,TOTAL,TOTAL,False,,29,70,23,54,6,16,8,12,15,26,41,20,12,10,10,13,72
401365787,Fordham Rams,C. Ohams,4066856,,True,34.0,7,19,7,19,0,0,0,2,8,8,16,3,3,8,3,1,14
401365787,Fordham Rams,A. Charlton,4897085,,True,33.0,2,8,2,5,0,3,0,0,0,6,6,4,3,2,2,3,4
401365787,Fordham Rams,K. Rose,4592315,,True,31.0,5,6,2,3,3,3,0,0,0,5,5,4,2,0,0,1,13
401365787,Fordham Rams,D. Quisenberry,4397790,,True,34.0,6,15,4,10,2,5,2,4,0,4,4,2,2,0,4,3,16
401365787,Fordham Rams,A. Daye Jr.,4397500,,True,36.0,7,17,7,15,0,2,2,2,0,2,2,4,0,0,1,3,16
401365787,Fordham Rams,A. Tsimbila,4702329,,False,4.0,1,2,1,2,0,0,0,0,0,0,0,0,0,0,0,0,2
401365787,Fordham Rams,P. Kelly,4432014,,False,4.0,0,0,0,0,0,0,0,0,0,0,0,1,0,0,0,0,0
401365787,Fordham Rams,A. Harrison,4897086,,False,1.0,0,0,0,0,0,0,0,0,0,0,0,0,0,0,0,0,0
401365787,Fordham Rams,K. Cunningham,4705891,,False,7.0,0,1,0,0,0,1,2,2,0,0,0,0,0,0,0,0,2
401365787,Fordham Rams,J. Navarro,4592316,,False,16.0,1,2,0,0,1,2,2,2,0,0,0,2,2,0,0,2,5
401365787,Fordham Rams,TEAM,TOTAL,TOTAL,False,,29,70,23,54,6,16,8,12,15,26,41,20,12,10,10,13,72
401365787,Duquesne Dukes,T. Williams,4432147,,True,33.0,6,13,6,12,0,1,0,0,2,5,7,2,0,7,1,1,12
401365787,Duquesne Dukes,K. Easley,4398159,,True,34.0,3,13,2,8,1,5,0,1,3,6,9,0,1,1,0,2,7
401365787,Duquesne Dukes,A. Spears,4897090,,True,35.0,8,12,5,8,3,4,1,2,0,2,2,3,1,0,5,2,20
401365787,Duquesne Dukes,J. Johnson III,4897088,,True,31.0,5,14,2,8,3,6,0,0,0,3,3,4,1,0,2,1,13
401365787,Duquesne Dukes,L. Ayers III,4703813,,True,29.0,4,9,2,6,2,3,3,4,1,5,6,1,1,0,4,1,13
401365787,Duquesne Dukes,A. Rotroff,4396806,,False,13.0,3,4,3,4,0,0,0,0,3,3,6,0,1,0,0,3,6
401365787,Duquesne Dukes,T. Okani,4700873,,False,6.0,0,0,0,0,0,0,0,0,1,0,1,0,0,0,2,0,0
401365787,Duquesne Dukes,T. Acuff,4606831,,False,19.0,0,1,0,1,0,0,0,0,0,2,2,0,0,0,1,0,0
401365787,Duquesne Dukes,TEAM,TOTAL,TOTAL,False,,29,66,20,47,9,19,4,7,13,27,40,10,5,8,15,11,71
401365787,Duquesne Dukes,T. Williams,4432147,,True,33.0,6,13,6,12,0,1,0,0,2,5,7,2,0,7,1,1,12
401365787,Duquesne Dukes,K. Easley,4398159,,True,34.0,3,13,2,8,1,5,0,1,3,6,9,0,1,1,0,2,7
401365787,Duquesne Dukes,A. Spears,4897090,,True,35.0,8,12,5,8,3,4,1,2,0,2,2,3,1,0,5,2,20
401365787,Duquesne Dukes,J. Johnson III,4897088,,True,31.0,5,14,2,8,3,6,0,0,0,3,3,4,1,0,2,1,13
401365787,Duquesne Dukes,L. Ayers III,4703813,,True,29.0,4,9,2,6,2,3,3,4,1,5,6,1,1,0,4,1,13
401365787,Duquesne Dukes,A. Rotroff,4396806,,False,13.0,3,4,3,4,0,0,0,0,3,3,6,0,1,0,0,3,6
401365787,Duquesne Dukes,T. Okani,4700873,,False,6.0,0,0,0,0,0,0,0,0,1,0,1,0,0,0,2,0,0
401365787,Duquesne Dukes,T. Acuff,4606831,,False,19.0,0,1,0,1,0,0,0,0,0,2,2,0,0,0,1,0,0
401365787,Duquesne Dukes,TEAM,TOTAL,TOTAL,False,,29,66,20,47,9,19,4,7,13,27,40,10,5,8,15,11,71
401365786,St. Bonaventure Bonnies,O. Osunniyi,4397224,,True,43.0,6,12,6,12,0,0,3,3,8,7,15,2,1,4,3,2,15
401365786,St. Bonaventure Bonnies,J. Adaway,4279431,,True,45.0,6,9,5,7,1,2,0,0,1,5,6,0,0,1,3,3,13
401365786,St. Bonaventure Bonnies,J. Holmes,4701016,,True,45.0,5,13,3,8,2,5,5,7,1,4,5,3,2,0,2,3,17
401365786,St. Bonaventure Bonnies,D. Welch,4397221,,True,45.0,4,13,0,4,4,9,5,6,1,7,8,1,1,0,1,1,17
401365786,St. Bonaventure Bonnies,K. Lofton,4397220,,True,44.0,6,15,5,11,1,4,5,8,2,2,4,8,0,0,5,3,18
401365786,St. Bonaventure Bonnies,A. Coulibaly,4432889,,False,2.0,0,1,0,1,0,0,0,0,0,0,0,0,0,0,0,1,0
401365786,St. Bonaventure Bonnies,Q. Adams,4585591,,False,1.0,0,0,0,0,0,0,0,0,0,0,0,0,0,0,0,1,0
401365786,St. Bonaventure Bonnies,TEAM,TOTAL,TOTAL,False,,27,63,19,43,8,20,18,24,15,30,45,14,4,5,14,14,80
401365786,St. Bonaventure Bonnies,O. Osunniyi,4397224,,True,43.0,6,12,6,12,0,0,3,3,8,7,15,2,1,4,3,2,15
401365786,St. Bonaventure Bonnies,J. Adaway,4279431,,True,45.0,6,9,5,7,1,2,0,0,1,5,6,0,0,1,3,3,13
401365786,St. Bonaventure Bonnies,J. Holmes,4701016,,True,45.0,5,13,3,8,2,5,5,7,1,4,5,3,2,0,2,3,17
401365786,St. Bonaventure Bonnies,D. Welch,4397221,,True,45.0,4,13,0,4,4,9,5,6,1,7,8,1,1,0,1,1,17
401365786,St. Bonaventure Bonnies,K. Lofton,4397220,,True,44.0,6,15,5,11,1,4,5,8,2,2,4,8,0,0,5,3,18
401365786,St. Bonaventure Bonnies,A. Coulibaly,4432889,,False,2.0,0,1,0,1,0,0,0,0,0,0,0,0,0,0,0,1,0
401365786,St. Bonaventure Bonnies,Q. Adams,4585591,,False,1.0,0,0,0,0,0,0,0,0,0,0,0,0,0,0,0,1,0
401365786,St. Bonaventure Bonnies,TEAM,TOTAL,TOTAL,False,,27,63,19,43,8,20,18,24,15,30,45,14,4,5,14,14,80
401365786,La Salle Explorers,M. Doucoure,4277988,,True,21.0,2,3,2,3,0,0,0,0,0,5,5,0,1,0,3,3,4
401365786,La Salle Explorers,C. Moore,4277945,,True,43.0,7,13,6,11,1,2,2,2,3,7,10,1,1,2,2,5,17
401365786,La Salle Explorers,K. Brantley,4709132,,True,41.0,5,15,5,10,0,5,0,0,2,1,3,8,1,0,1,2,10
401365786,La Salle Explorers,A. Gill,4700969,,True,27.0,4,9,2,7,2,2,0,0,0,1,1,7,2,1,4,3,10
401365786,La Salle Explorers,J. Nickelberry,4432845,,True,26.0,6,16,1,2,5,14,0,0,0,2,2,0,1,0,0,2,17
401365786,La Salle Explorers,M. McFarlane,4897068,,False,16.0,3,6,1,1,2,5,0,0,1,0,1,1,0,0,0,1,8
401365786,La Salle Explorers,J. Clark,4397152,,False,21.0,4,10,2,4,2,6,0,0,1,1,2,1,0,0,0,2,10
401365786,La Salle Explorers,D. Shepherd,4710357,,False,7.0,0,1,0,1,0,0,0,0,0,1,1,0,0,0,0,1,0
401365786,La Salle Explorers,C. Ray,4592448,,False,23.0,0,3,0,0,0,3,0,0,1,4,5,3,1,0,0,1,0
401365786,La Salle Explorers,TEAM,TOTAL,TOTAL,False,,31,76,19,39,12,37,2,2,14,23,37,21,7,3,10,20,76
401365786,La Salle Explorers,M. Doucoure,4277988,,True,21.0,2,3,2,3,0,0,0,0,0,5,5,0,1,0,3,3,4
401365786,La Salle Explorers,C. Moore,4277945,,True,43.0,7,13,6,11,1,2,2,2,3,7,10,1,1,2,2,5,17
401365786,La Salle Explorers,K. Brantley,4709132,,True,41.0,5,15,5,10,0,5,0,0,2,1,3,8,1,0,1,2,10
401365786,La Salle Explorers,A. Gill,4700969,,True,27.0,4,9,2,7,2,2,0,0,0,1,1,7,2,1,4,3,10
401365786,La Salle Explorers,J. Nickelberry,4432845,,True,26.0,6,16,1,2,5,14,0,0,0,2,2,0,1,0,0,2,17
401365786,La Salle Explorers,M. McFarlane,4897068,,False,16.0,3,6,1,1,2,5,0,0,1,0,1,1,0,0,0,1,8
401365786,La Salle Explorers,J. Clark,4397152,,False,21.0,4,10,2,4,2,6,0,0,1,1,2,1,0,0,0,2,10
401365786,La Salle Explorers,D. Shepherd,4710357,,False,7.0,0,1,0,1,0,0,0,0,0,1,1,0,0,0,0,1,0
401365786,La Salle Explorers,C. Ray,4592448,,False,23.0,0,3,0,0,0,3,0,0,1,4,5,3,1,0,0,1,0
401365786,La Salle Explorers,TEAM,TOTAL,TOTAL,False,,31,76,19,39,12,37,2,2,14,23,37,21,7,3,10,20,76
401365785,VCU Rams,H. Ward,4592495,,True,18.0,4,5,4,5,0,0,0,0,0,2,2,0,1,1,1,1,8
401365785,VCU Rams,V. Williams Jr.,4397227,,True,27.0,3,8,1,3,2,5,3,4,3,2,5,8,2,2,3,2,11
401365785,VCU Rams,J. Nunn,4896614,,True,20.0,2,5,1,2,1,3,4,4,0,2,2,1,2,0,2,2,9
401365785,VCU Rams,A. Baldwin Jr.,4433182,,True,29.0,5,8,1,3,4,5,2,2,1,5,6,4,2,0,5,3,16
401365785,VCU Rams,K. Curry,4397228,,True,28.0,6,13,6,11,0,2,1,1,1,4,5,1,2,2,1,3,13
401365785,VCU Rams,M. Brown-Jones,4433224,,False,13.0,2,4,2,4,0,0,0,0,2,1,3,1,0,2,1,0,4
401365785,VCU Rams,J. DeLoach,4432483,,False,14.0,3,5,3,5,0,0,0,1,1,6,7,1,0,3,0,3,6
401365785,VCU Rams,L. Stockard III,4277897,,False,11.0,1,5,1,5,0,0,0,0,3,0,3,1,1,1,0,0,2
401365785,VCU Rams,N. Kern,4684145,,False,12.0,0,1,0,0,0,1,0,0,0,2,2,1,0,0,0,1,0
401365785,VCU Rams,A. Henderson VI,4592494,,False,1.0,1,1,1,1,0,0,0,0,1,0,1,0,0,0,0,1,2
401365785,VCU Rams,M. Tsohonis,4592438,,False,18.0,4,9,2,5,2,4,0,0,2,3,5,1,0,0,2,2,10
401365785,VCU Rams,J. Banks,4432402,,False,9.0,1,4,0,1,1,3,0,0,1,2,3,0,0,0,0,0,3
401365785,VCU Rams,TEAM,TOTAL,TOTAL,False,,32,68,22,45,10,23,10,12,19,29,48,19,10,11,17,18,84
401365785,VCU Rams,H. Ward,4592495,,True,18.0,4,5,4,5,0,0,0,0,0,2,2,0,1,1,1,1,8
401365785,VCU Rams,V. Williams Jr.,4397227,,True,27.0,3,8,1,3,2,5,3,4,3,2,5,8,2,2,3,2,11
401365785,VCU Rams,J. Nunn,4896614,,True,20.0,2,5,1,2,1,3,4,4,0,2,2,1,2,0,2,2,9
401365785,VCU Rams,A. Baldwin Jr.,4433182,,True,29.0,5,8,1,3,4,5,2,2,1,5,6,4,2,0,5,3,16
401365785,VCU Rams,K. Curry,4397228,,True,28.0,6,13,6,11,0,2,1,1,1,4,5,1,2,2,1,3,13
401365785,VCU Rams,M. Brown-Jones,4433224,,False,13.0,2,4,2,4,0,0,0,0,2,1,3,1,0,2,1,0,4
401365785,VCU Rams,J. DeLoach,4432483,,False,14.0,3,5,3,5,0,0,0,1,1,6,7,1,0,3,0,3,6
401365785,VCU Rams,L. Stockard III,4277897,,False,11.0,1,5,1,5,0,0,0,0,3,0,3,1,1,1,0,0,2
401365785,VCU Rams,N. Kern,4684145,,False,12.0,0,1,0,0,0,1,0,0,0,2,2,1,0,0,0,1,0
401365785,VCU Rams,A. Henderson VI,4592494,,False,1.0,1,1,1,1,0,0,0,0,1,0,1,0,0,0,0,1,2
401365785,VCU Rams,M. Tsohonis,4592438,,False,18.0,4,9,2,5,2,4,0,0,2,3,5,1,0,0,2,2,10
401365785,VCU Rams,J. Banks,4432402,,False,9.0,1,4,0,1,1,3,0,0,1,2,3,0,0,0,0,0,3
401365785,VCU Rams,TEAM,TOTAL,TOTAL,False,,32,68,22,45,10,23,10,12,19,29,48,19,10,11,17,18,84
401365785,George Washington Revolutionaries,H. Dean,4593273,,True,17.0,1,3,1,3,0,0,1,3,1,2,3,0,1,1,1,3,3
401365785,George Washington Revolutionaries,R. Lindo Jr.,4397186,,True,32.0,4,10,4,9,0,1,0,1,4,6,10,0,3,3,5,4,8
401365785,George Washington Revolutionaries,B. Freeman,4613126,,True,25.0,3,13,3,12,0,1,4,4,0,1,1,3,0,0,3,3,10
401365785,George Washington Revolutionaries,J. Bamisile,4432537,,True,31.0,5,9,4,7,1,2,0,3,1,2,3,1,2,1,3,3,11
401365785,George Washington Revolutionaries,J. Bishop,4431770,,True,28.0,6,17,3,9,3,8,1,3,2,1,3,1,0,0,3,2,16
401365785,George Washington Revolutionaries,Q. Samuels,4592251,,False,15.0,1,3,1,2,0,1,2,2,3,2,5,1,0,1,0,1,4
401365785,George Washington Revolutionaries,N. Brown,4700963,,False,7.0,0,0,0,0,0,0,0,0,0,0,0,0,1,1,0,1,0
401365785,George Washington Revolutionaries,A. Harris,4397216,,False,18.0,0,0,0,0,0,0,0,0,1,1,2,1,2,0,2,0,0
401365785,George Washington Revolutionaries,B. Adams,4396612,,False,19.0,0,1,0,0,0,1,0,0,0,2,2,1,0,0,1,0,0
401365785,George Washington Revolutionaries,B. Knapp,4279473,,False,8.0,2,4,1,2,1,2,0,0,0,0,0,0,1,0,0,0,5
401365785,George Washington Revolutionaries,TEAM,TOTAL,TOTAL,False,,22,60,17,44,5,16,8,16,13,17,30,8,10,7,18,17,57
401365785,George Washington Revolutionaries,H. Dean,4593273,,True,17.0,1,3,1,3,0,0,1,3,1,2,3,0,1,1,1,3,3
401365785,George Washington Revolutionaries,R. Lindo Jr.,4397186,,True,32.0,4,10,4,9,0,1,0,1,4,6,10,0,3,3,5,4,8
401365785,George Washington Revolutionaries,B. Freeman,4613126,,True,25.0,3,13,3,12,0,1,4,4,0,1,1,3,0,0,3,3,10
401365785,George Washington Revolutionaries,J. Bamisile,4432537,,True,31.0,5,9,4,7,1,2,0,3,1,2,3,1,2,1,3,3,11
401365785,George Washington Revolutionaries,J. Bishop,4431770,,True,28.0,6,17,3,9,3,8,1,3,2,1,3,1,0,0,3,2,16
401365785,George Washington Revolutionaries,Q. Samuels,4592251,,False,15.0,1,3,1,2,0,1,2,2,3,2,5,1,0,1,0,1,4
401365785,George Washington Revolutionaries,N. Brown,4700963,,False,7.0,0,0,0,0,0,0,0,0,0,0,0,0,1,1,0,1,0
401365785,George Washington Revolutionaries,A. Harris,4397216,,False,18.0,0,0,0,0,0,0,0,0,1,1,2,1,2,0,2,0,0
401365785,George Washington Revolutionaries,B. Adams,4396612,,False,19.0,0,1,0,0,0,1,0,0,0,2,2,1,0,0,1,0,0
401365785,George Washington Revolutionaries,B. Knapp,4279473,,False,8.0,2,4,1,2,1,2,0,0,0,0,0,0,1,0,0,0,5
401365785,George Washington Revolutionaries,TEAM,TOTAL,TOTAL,False,,22,60,17,44,5,16,8,16,13,17,30,8,10,7,18,17,57
401365784,Saint Louis Billikens,T. Hargrove Jr.,4592484,,True,28.0,5,7,1,2,4,5,0,0,2,3,5,1,1,1,2,2,14
401365784,Saint Louis Billikens,F. Okoro,4397105,,True,36.0,3,8,3,8,0,0,1,1,3,5,8,0,0,3,1,1,7
401365784,Saint Louis Billikens,J. Nesbitt,4714246,,True,30.0,2,7,1,4,1,3,0,2,0,3,3,1,0,0,2,4,5
401365784,Saint Louis Billikens,Y. Collins,4432957,,True,33.0,1,5,1,4,0,1,2,2,0,1,1,9,0,0,7,5,4
401365784,Saint Louis Billikens,G. Jimerson,4432008,,True,37.0,8,14,5,10,3,4,4,4,0,2,2,1,0,0,0,2,23
401365784,Saint Louis Billikens,L. Traore,4897052,,False,4.0,0,0,0,0,0,0,0,0,0,1,1,0,0,0,0,0,0
401365784,Saint Louis Billikens,M. Strickland,4432494,,False,0.0,0,0,0,0,0,0,0,0,0,0,0,0,0,0,1,0,0
401365784,Saint Louis Billikens,F. Thatch Jr.,4397199,,False,25.0,3,10,2,8,1,2,3,3,2,3,5,1,0,1,0,3,10
401365784,Saint Louis Billikens,D. Jones,4278267,,False,7.0,0,1,0,0,0,1,0,0,0,0,0,1,0,0,1,3,0
401365784,Saint Louis Billikens,TEAM,TOTAL,TOTAL,False,,22,52,13,36,9,16,10,12,9,19,28,14,1,5,15,20,63
401365784,Saint Louis Billikens,T. Hargrove Jr.,4592484,,True,28.0,5,7,1,2,4,5,0,0,2,3,5,1,1,1,2,2,14
401365784,Saint Louis Billikens,F. Okoro,4397105,,True,36.0,3,8,3,8,0,0,1,1,3,5,8,0,0,3,1,1,7
401365784,Saint Louis Billikens,J. Nesbitt,4714246,,True,30.0,2,7,1,4,1,3,0,2,0,3,3,1,0,0,2,4,5
401365784,Saint Louis Billikens,Y. Collins,4432957,,True,33.0,1,5,1,4,0,1,2,2,0,1,1,9,0,0,7,5,4
401365784,Saint Louis Billikens,G. Jimerson,4432008,,True,37.0,8,14,5,10,3,4,4,4,0,2,2,1,0,0,0,2,23
401365784,Saint Louis Billikens,L. Traore,4897052,,False,4.0,0,0,0,0,0,0,0,0,0,1,1,0,0,0,0,0,0
401365784,Saint Louis Billikens,M. Strickland,4432494,,False,0.0,0,0,0,0,0,0,0,0,0,0,0,0,0,0,1,0,0
401365784,Saint Louis Billikens,F. Thatch Jr.,4397199,,False,25.0,3,10,2,8,1,2,3,3,2,3,5,1,0,1,0,3,10
401365784,Saint Louis Billikens,D. Jones,4278267,,False,7.0,0,1,0,0,0,1,0,0,0,0,0,1,0,0,1,3,0
401365784,Saint Louis Billikens,TEAM,TOTAL,TOTAL,False,,22,52,13,36,9,16,10,12,9,19,28,14,1,5,15,20,63
401365784,Dayton Flyers,R.J. Blakney,4700864,,True,17.0,2,5,1,3,1,2,1,2,0,0,0,0,2,0,0,0,6
401365784,Dayton Flyers,T. Camara,4431736,,True,31.0,1,5,1,3,0,2,3,6,4,5,9,0,0,0,1,3,5
401365784,Dayton Flyers,D. Holmes II,4433607,,True,32.0,4,8,4,8,0,0,3,4,1,3,4,0,1,5,1,3,11
401365784,Dayton Flyers,M. Smith,4683861,,True,37.0,4,10,3,8,1,2,5,6,2,6,8,5,1,0,5,2,14
401365784,Dayton Flyers,K. Elvis,4683135,,True,28.0,6,11,4,7,2,4,0,0,0,2,2,2,1,0,0,1,14
401365784,Dayton Flyers,M. Sissoko,4431824,,False,3.0,0,0,0,0,0,0,0,0,1,1,2,0,1,0,0,0,0
401365784,Dayton Flyers,M. Amzil,4711607,,False,25.0,3,4,1,1,2,3,1,2,1,1,2,1,1,0,1,0,9
401365784,Dayton Flyers,K. Brea,4591259,,False,9.0,1,1,0,0,1,1,1,2,0,2,2,0,0,0,1,2,4
401365784,Dayton Flyers,E. Weaver,4397139,,False,18.0,1,6,1,4,0,2,3,4,0,0,0,2,1,0,2,2,5
401365784,Dayton Flyers,TEAM,TOTAL,TOTAL,False,,22,50,15,34,7,16,17,26,12,22,34,10,8,5,12,13,68
401365784,Dayton Flyers,R.J. Blakney,4700864,,True,17.0,2,5,1,3,1,2,1,2,0,0,0,0,2,0,0,0,6
401365784,Dayton Flyers,T. Camara,4431736,,True,31.0,1,5,1,3,0,2,3,6,4,5,9,0,0,0,1,3,5
401365784,Dayton Flyers,D. Holmes II,4433607,,True,32.0,4,8,4,8,0,0,3,4,1,3,4,0,1,5,1,3,11
401365784,Dayton Flyers,M. Smith,4683861,,True,37.0,4,10,3,8,1,2,5,6,2,6,8,5,1,0,5,2,14
401365784,Dayton Flyers,K. Elvis,4683135,,True,28.0,6,11,4,7,2,4,0,0,0,2,2,2,1,0,0,1,14
401365784,Dayton Flyers,M. Sissoko,4431824,,False,3.0,0,0,0,0,0,0,0,0,1,1,2,0,1,0,0,0,0
401365784,Dayton Flyers,M. Amzil,4711607,,False,25.0,3,4,1,1,2,3,1,2,1,1,2,1,1,0,1,0,9
401365784,Dayton Flyers,K. Brea,4591259,,False,9.0,1,1,0,0,1,1,1,2,0,2,2,0,0,0,1,2,4
401365784,Dayton Flyers,E. Weaver,4397139,,False,18.0,1,6,1,4,0,2,3,4,0,0,0,2,1,0,2,2,5
401365784,Dayton Flyers,TEAM,TOTAL,TOTAL,False,,22,50,15,34,7,16,17,26,12,22,34,10,8,5,12,13,68
401365783,Massachusetts Minutemen,M. Steadman,4397393,,True,18.0,0,5,0,5,0,0,0,0,0,3,3,0,0,0,0,1,0
401365783,Massachusetts Minutemen,T. Buttrick,4277981,,True,37.0,4,15,2,5,2,10,0,0,1,9,10,3,0,2,2,3,10
401365783,Massachusetts Minutemen,T.J. Weeks,4433108,,True,36.0,6,11,1,2,5,9,4,4,1,6,7,0,0,1,0,1,21
401365783,Massachusetts Minutemen,N. Fernandes,4431791,,True,39.0,8,19,6,12,2,7,1,1,0,5,5,9,1,0,2,3,19
401365783,Massachusetts Minutemen,R. Kelly,4279741,,True,31.0,5,8,1,2,4,6,0,0,0,0,0,2,0,0,3,2,14
401365783,Massachusetts Minutemen,D. Dominguez,4701126,,False,4.0,0,0,0,0,0,0,0,0,0,0,0,0,0,1,0,1,0
401365783,Massachusetts Minutemen,G. Jones,4279211,,False,21.0,1,3,0,2,1,1,0,0,3,6,9,0,0,0,1,2,3
401365783,Massachusetts Minutemen,J. Garcia,4701125,,False,10.0,0,1,0,1,0,0,0,0,0,1,1,0,0,1,0,3,0
401365783,Massachusetts Minutemen,K. Mitchell,4592454,,False,4.0,0,0,0,0,0,0,0,0,0,0,0,0,0,0,0,1,0
401365783,Massachusetts Minutemen,TEAM,TOTAL,TOTAL,False,,24,62,10,29,14,33,5,5,6,31,37,14,1,5,8,17,67
401365783,Massachusetts Minutemen,M. Steadman,4397393,,True,18.0,0,5,0,5,0,0,0,0,0,3,3,0,0,0,0,1,0
401365783,Massachusetts Minutemen,T. Buttrick,4277981,,True,37.0,4,15,2,5,2,10,0,0,1,9,10,3,0,2,2,3,10
401365783,Massachusetts Minutemen,T.J. Weeks,4433108,,True,36.0,6,11,1,2,5,9,4,4,1,6,7,0,0,1,0,1,21
401365783,Massachusetts Minutemen,N. Fernandes,4431791,,True,39.0,8,19,6,12,2,7,1,1,0,5,5,9,1,0,2,3,19
401365783,Massachusetts Minutemen,R. Kelly,4279741,,True,31.0,5,8,1,2,4,6,0,0,0,0,0,2,0,0,3,2,14
401365783,Massachusetts Minutemen,D. Dominguez,4701126,,False,4.0,0,0,0,0,0,0,0,0,0,0,0,0,0,1,0,1,0
401365783,Massachusetts Minutemen,G. Jones,4279211,,False,21.0,1,3,0,2,1,1,0,0,3,6,9,0,0,0,1,2,3
401365783,Massachusetts Minutemen,J. Garcia,4701125,,False,10.0,0,1,0,1,0,0,0,0,0,1,1,0,0,1,0,3,0
401365783,Massachusetts Minutemen,K. Mitchell,4592454,,False,4.0,0,0,0,0,0,0,0,0,0,0,0,0,0,0,0,1,0
401365783,Massachusetts Minutemen,TEAM,TOTAL,TOTAL,False,,24,62,10,29,14,33,5,5,6,31,37,14,1,5,8,17,67
401365783,Davidson Wildcats,S. Mennenga,4700862,,True,32.0,5,9,5,7,0,2,0,2,0,4,4,3,2,0,0,0,10
401365783,Davidson Wildcats,L. Brajkovic,4396787,,True,31.0,11,13,9,10,2,3,1,4,4,7,11,0,0,3,0,0,25
401365783,Davidson Wildcats,H. Lee,4592308,,True,33.0,7,15,3,7,4,8,0,1,0,7,7,1,0,0,1,4,18
401365783,Davidson Wildcats,F. Loyer,4397208,,True,28.0,3,9,1,3,2,6,3,3,0,2,2,6,0,0,0,1,11
401365783,Davidson Wildcats,M. Jones,4396784,,True,33.0,2,7,0,4,2,3,2,2,1,3,4,3,2,2,1,0,8
401365783,Davidson Wildcats,D. Kristensen,4432020,,False,1.0,0,0,0,0,0,0,0,0,0,0,0,0,0,0,0,0,0
401365783,Davidson Wildcats,N. Boachie-Yiadom,4396786,,False,15.0,0,0,0,0,0,0,0,0,0,2,2,1,1,0,0,1,0
401365783,Davidson Wildcats,D. Watson,4897098,,False,14.0,1,5,1,2,0,3,0,0,0,1,1,0,0,0,0,1,2
401365783,Davidson Wildcats,G. Huffman,4432522,,False,13.0,1,4,0,3,1,1,0,0,0,1,1,1,0,0,1,0,3
401365783,Davidson Wildcats,TEAM,TOTAL,TOTAL,False,,30,62,19,36,11,26,6,12,6,32,38,15,5,5,3,7,77
401365783,Davidson Wildcats,S. Mennenga,4700862,,True,32.0,5,9,5,7,0,2,0,2,0,4,4,3,2,0,0,0,10
401365783,Davidson Wildcats,L. Brajkovic,4396787,,True,31.0,11,13,9,10,2,3,1,4,4,7,11,0,0,3,0,0,25
401365783,Davidson Wildcats,H. Lee,4592308,,True,33.0,7,15,3,7,4,8,0,1,0,7,7,1,0,0,1,4,18
401365783,Davidson Wildcats,F. Loyer,4397208,,True,28.0,3,9,1,3,2,6,3,3,0,2,2,6,0,0,0,1,11
401365783,Davidson Wildcats,M. Jones,4396784,,True,33.0,2,7,0,4,2,3,2,2,1,3,4,3,2,2,1,0,8
401365783,Davidson Wildcats,D. Kristensen,4432020,,False,1.0,0,0,0,0,0,0,0,0,0,0,0,0,0,0,0,0,0
401365783,Davidson Wildcats,N. Boachie-Yiadom,4396786,,False,15.0,0,0,0,0,0,0,0,0,0,2,2,1,1,0,0,1,0
401365783,Davidson Wildcats,D. Watson,4897098,,False,14.0,1,5,1,2,0,3,0,0,0,1,1,0,0,0,0,1,2
401365783,Davidson Wildcats,G. Huffman,4432522,,False,13.0,1,4,0,3,1,1,0,0,0,1,1,1,0,0,1,0,3
401365783,Davidson Wildcats,TEAM,TOTAL,TOTAL,False,,30,62,19,36,11,26,6,12,6,32,38,15,5,5,3,7,77
401365778,Massachusetts Minutemen,M. Steadman,4397393,,True,28.0,5,9,5,8,0,1,3,3,4,2,6,2,0,2,2,0,13
401365778,Massachusetts Minutemen,T. Buttrick,4277981,,True,32.0,2,6,1,3,1,3,2,2,1,9,10,1,0,2,3,2,7
401365778,Massachusetts Minutemen,N. Fernandes,4431791,,True,31.0,5,11,3,7,2,4,2,2,0,6,6,4,2,0,5,4,14
401365778,Massachusetts Minutemen,C.J. Kelly,4398208,,True,34.0,7,18,5,11,2,7,3,3,1,2,3,1,1,0,4,2,19
401365778,Massachusetts Minutemen,R. Kelly,4279741,,True,33.0,4,9,3,6,1,3,7,8,0,2,2,4,0,0,1,4,16
401365778,Massachusetts Minutemen,G. Jones,4279211,,False,20.0,1,2,0,1,1,1,2,2,1,0,1,0,0,0,0,0,5
401365778,Massachusetts Minutemen,K. Mitchell,4592454,,False,10.0,0,1,0,1,0,0,0,0,0,3,3,2,0,0,1,2,0
401365778,Massachusetts Minutemen,T.J. Weeks,4433108,,False,12.0,0,1,0,0,0,1,0,0,1,1,2,0,0,0,0,1,0
401365778,Massachusetts Minutemen,TEAM,TOTAL,TOTAL,False,,24,57,17,37,7,20,19,20,9,28,37,14,3,4,17,15,74
401365778,Massachusetts Minutemen,M. Steadman,4397393,,True,28.0,5,9,5,8,0,1,3,3,4,2,6,2,0,2,2,0,13
401365778,Massachusetts Minutemen,T. Buttrick,4277981,,True,32.0,2,6,1,3,1,3,2,2,1,9,10,1,0,2,3,2,7
401365778,Massachusetts Minutemen,N. Fernandes,4431791,,True,31.0,5,11,3,7,2,4,2,2,0,6,6,4,2,0,5,4,14
401365778,Massachusetts Minutemen,C.J. Kelly,4398208,,True,34.0,7,18,5,11,2,7,3,3,1,2,3,1,1,0,4,2,19
401365778,Massachusetts Minutemen,R. Kelly,4279741,,True,33.0,4,9,3,6,1,3,7,8,0,2,2,4,0,0,1,4,16
401365778,Massachusetts Minutemen,G. Jones,4279211,,False,20.0,1,2,0,1,1,1,2,2,1,0,1,0,0,0,0,0,5
401365778,Massachusetts Minutemen,K. Mitchell,4592454,,False,10.0,0,1,0,1,0,0,0,0,0,3,3,2,0,0,1,2,0
401365778,Massachusetts Minutemen,T.J. Weeks,4433108,,False,12.0,0,1,0,0,0,1,0,0,1,1,2,0,0,0,0,1,0
401365778,Massachusetts Minutemen,TEAM,TOTAL,TOTAL,False,,24,57,17,37,7,20,19,20,9,28,37,14,3,4,17,15,74
401365778,Duquesne Dukes,T. Williams,4432147,,True,23.0,2,5,2,4,0,1,0,0,0,8,8,0,0,1,0,5,4
401365778,Duquesne Dukes,K. Easley,4398159,,True,37.0,5,13,5,9,0,4,0,0,2,1,3,2,5,1,0,1,10
401365778,Duquesne Dukes,A. Spears,4897090,,True,31.0,7,16,5,11,2,5,5,5,0,0,0,1,3,0,0,1,21
401365778,Duquesne Dukes,J. Johnson III,4897088,,True,33.0,10,14,7,7,3,7,4,4,0,1,1,4,0,0,2,3,27
401365778,Duquesne Dukes,L. Ayers III,4703813,,True,27.0,3,9,2,5,1,4,0,0,0,7,7,4,1,0,2,2,7
401365778,Duquesne Dukes,A. Rotroff,4396806,,False,20.0,2,2,2,2,0,0,0,1,4,2,6,0,0,1,1,4,4
401365778,Duquesne Dukes,T. Okani,4700873,,False,13.0,1,2,1,2,0,0,0,0,1,1,2,1,0,0,3,2,2
401365778,Duquesne Dukes,T. Acuff,4606831,,False,16.0,1,6,0,2,1,4,0,0,0,1,1,1,0,0,1,0,3
401365778,Duquesne Dukes,TEAM,TOTAL,TOTAL,False,,31,67,24,42,7,25,9,10,9,24,33,13,9,3,9,18,78
401365778,Duquesne Dukes,T. Williams,4432147,,True,23.0,2,5,2,4,0,1,0,0,0,8,8,0,0,1,0,5,4
401365778,Duquesne Dukes,K. Easley,4398159,,True,37.0,5,13,5,9,0,4,0,0,2,1,3,2,5,1,0,1,10
401365778,Duquesne Dukes,A. Spears,4897090,,True,31.0,7,16,5,11,2,5,5,5,0,0,0,1,3,0,0,1,21
401365778,Duquesne Dukes,J. Johnson III,4897088,,True,33.0,10,14,7,7,3,7,4,4,0,1,1,4,0,0,2,3,27
401365778,Duquesne Dukes,L. Ayers III,4703813,,True,27.0,3,9,2,5,1,4,0,0,0,7,7,4,1,0,2,2,7
401365778,Duquesne Dukes,A. Rotroff,4396806,,False,20.0,2,2,2,2,0,0,0,1,4,2,6,0,0,1,1,4,4
401365778,Duquesne Dukes,T. Okani,4700873,,False,13.0,1,2,1,2,0,0,0,0,1,1,2,1,0,0,3,2,2
401365778,Duquesne Dukes,T. Acuff,4606831,,False,16.0,1,6,0,2,1,4,0,0,0,1,1,1,0,0,1,0,3
401365778,Duquesne Dukes,TEAM,TOTAL,TOTAL,False,,31,67,24,42,7,25,9,10,9,24,33,13,9,3,9,18,78
401365777,Rhode Island Rams,Makhel Mitchell,4431777,,True,36.0,7,12,7,12,0,0,5,6,1,4,5,2,0,2,4,4,19
401365777,Rhode Island Rams,Makhi Mitchell,4431708,,True,13.0,1,3,1,3,0,0,0,1,0,4,4,0,0,0,1,4,2
401365777,Rhode Island Rams,I. Leggett,4606837,,True,31.0,4,12,4,10,0,2,1,2,3,1,4,1,0,0,1,4,9
401365777,Rhode Island Rams,I. El-Amin,4279313,,True,18.0,1,2,1,1,0,1,0,0,0,0,0,0,1,0,1,3,2
401365777,Rhode Island Rams,J. Sheppard,4066445,,True,34.0,6,11,5,7,1,4,4,6,0,2,2,2,3,0,2,1,17
401365777,Rhode Island Rams,I. Ayo-Faleye,4701259,,False,1.0,0,0,0,0,0,0,0,0,0,0,0,0,0,0,0,0,0
401365777,Rhode Island Rams,A. Walker,4278567,,False,26.0,5,6,2,3,3,3,0,0,0,4,4,5,0,0,2,3,13
401365777,Rhode Island Rams,M. Martin,4397470,,False,25.0,1,2,1,2,0,0,2,2,2,3,5,2,0,0,0,1,4
401365777,Rhode Island Rams,J. Carey,4395673,,False,7.0,0,1,0,1,0,0,0,0,0,1,1,0,0,0,0,0,0
401365777,Rhode Island Rams,S. Thomas,4897065,,False,9.0,1,1,1,1,0,0,0,0,0,0,0,1,1,0,0,1,2
401365777,Rhode Island Rams,TEAM,TOTAL,TOTAL,False,,26,50,22,40,4,10,12,17,7,20,27,13,5,2,12,21,68
401365777,Rhode Island Rams,Makhel Mitchell,4431777,,True,36.0,7,12,7,12,0,0,5,6,1,4,5,2,0,2,4,4,19
401365777,Rhode Island Rams,Makhi Mitchell,4431708,,True,13.0,1,3,1,3,0,0,0,1,0,4,4,0,0,0,1,4,2
401365777,Rhode Island Rams,I. Leggett,4606837,,True,31.0,4,12,4,10,0,2,1,2,3,1,4,1,0,0,1,4,9
401365777,Rhode Island Rams,I. El-Amin,4279313,,True,18.0,1,2,1,1,0,1,0,0,0,0,0,0,1,0,1,3,2
401365777,Rhode Island Rams,J. Sheppard,4066445,,True,34.0,6,11,5,7,1,4,4,6,0,2,2,2,3,0,2,1,17
401365777,Rhode Island Rams,I. Ayo-Faleye,4701259,,False,1.0,0,0,0,0,0,0,0,0,0,0,0,0,0,0,0,0,0
401365777,Rhode Island Rams,A. Walker,4278567,,False,26.0,5,6,2,3,3,3,0,0,0,4,4,5,0,0,2,3,13
401365777,Rhode Island Rams,M. Martin,4397470,,False,25.0,1,2,1,2,0,0,2,2,2,3,5,2,0,0,0,1,4
401365777,Rhode Island Rams,J. Carey,4395673,,False,7.0,0,1,0,1,0,0,0,0,0,1,1,0,0,0,0,0,0
401365777,Rhode Island Rams,S. Thomas,4897065,,False,9.0,1,1,1,1,0,0,0,0,0,0,0,1,1,0,0,1,2
401365777,Rhode Island Rams,TEAM,TOTAL,TOTAL,False,,26,50,22,40,4,10,12,17,7,20,27,13,5,2,12,21,68
401365777,Davidson Wildcats,S. Mennenga,4700862,,True,17.0,2,6,2,4,0,2,0,0,1,2,3,1,1,0,0,3,4
401365777,Davidson Wildcats,L. Brajkovic,4396787,,True,35.0,7,10,7,8,0,2,3,4,4,4,8,2,0,1,3,4,17
401365777,Davidson Wildcats,H. Lee,4592308,,True,36.0,5,9,3,3,2,6,4,6,1,3,4,3,2,0,1,3,16
401365777,Davidson Wildcats,F. Loyer,4397208,,True,28.0,3,8,1,1,2,7,11,12,0,4,4,5,0,0,1,4,19
401365777,Davidson Wildcats,M. Jones,4396784,,True,34.0,4,7,2,3,2,4,0,1,0,2,2,2,0,2,2,1,10
401365777,Davidson Wildcats,N. Boachie-Yiadom,4396786,,False,18.0,1,2,1,1,0,1,0,0,0,2,2,1,1,2,1,2,2
401365777,Davidson Wildcats,D. Watson,4897098,,False,12.0,1,4,1,3,0,1,0,0,1,0,1,0,0,0,2,0,2
401365777,Davidson Wildcats,G. Huffman,4432522,,False,20.0,1,3,1,2,0,1,0,0,0,1,1,0,0,0,0,0,2
401365777,Davidson Wildcats,TEAM,TOTAL,TOTAL,False,,24,49,18,25,6,24,18,23,7,20,27,14,4,5,10,17,72
401365777,Davidson Wildcats,S. Mennenga,4700862,,True,17.0,2,6,2,4,0,2,0,0,1,2,3,1,1,0,0,3,4
401365777,Davidson Wildcats,L. Brajkovic,4396787,,True,35.0,7,10,7,8,0,2,3,4,4,4,8,2,0,1,3,4,17
401365777,Davidson Wildcats,H. Lee,4592308,,True,36.0,5,9,3,3,2,6,4,6,1,3,4,3,2,0,1,3,16
401365777,Davidson Wildcats,F. Loyer,4397208,,True,28.0,3,8,1,1,2,7,11,12,0,4,4,5,0,0,1,4,19
401365777,Davidson Wildcats,M. Jones,4396784,,True,34.0,4,7,2,3,2,4,0,1,0,2,2,2,0,2,2,1,10
401365777,Davidson Wildcats,N. Boachie-Yiadom,4396786,,False,18.0,1,2,1,1,0,1,0,0,0,2,2,1,1,2,1,2,2
401365777,Davidson Wildcats,D. Watson,4897098,,False,12.0,1,4,1,3,0,1,0,0,1,0,1,0,0,0,2,0,2
401365777,Davidson Wildcats,G. Huffman,4432522,,False,20.0,1,3,1,2,0,1,0,0,0,1,1,0,0,0,0,0,2
401365777,Davidson Wildcats,TEAM,TOTAL,TOTAL,False,,24,49,18,25,6,24,18,23,7,20,27,14,4,5,10,17,72
401365776,VCU Rams,H. Ward,4592495,,True,23.0,6,10,6,10,0,0,1,2,4,2,6,2,1,0,0,3,13
401365776,VCU Rams,V. Williams Jr.,4397227,,True,25.0,5,7,3,3,2,4,4,4,1,5,6,5,3,1,1,3,16
401365776,VCU Rams,J. Nunn,4896614,,True,30.0,3,6,1,2,2,4,1,2,0,2,2,1,1,0,1,1,9
401365776,VCU Rams,A. Baldwin Jr.,4433182,,True,31.0,3,10,3,7,0,3,1,2,0,1,1,6,3,0,3,0,7
401365776,VCU Rams,K. Curry,4397228,,True,24.0,2,8,2,7,0,1,1,2,0,1,1,2,1,1,1,1,5
401365776,VCU Rams,M. Brown-Jones,4433224,,False,12.0,1,4,1,3,0,1,1,4,0,2,2,1,0,1,0,2,3
401365776,VCU Rams,J. DeLoach,4432483,,False,19.0,4,6,4,6,0,0,1,3,3,4,7,2,0,1,0,4,9
401365776,VCU Rams,N. Kern,4684145,,False,16.0,2,2,2,2,0,0,0,0,0,1,1,1,0,0,1,3,4
401365776,VCU Rams,M. Tsohonis,4592438,,False,13.0,5,6,0,0,5,6,2,2,0,2,2,2,0,0,0,2,17
401365776,VCU Rams,J. Banks,4432402,,False,7.0,1,3,1,1,0,2,0,0,0,0,0,0,0,0,1,1,2
401365776,VCU Rams,TEAM,TOTAL,TOTAL,False,,32,62,23,41,9,21,12,21,10,22,32,22,9,4,8,20,85
401365776,VCU Rams,H. Ward,4592495,,True,23.0,6,10,6,10,0,0,1,2,4,2,6,2,1,0,0,3,13
401365776,VCU Rams,V. Williams Jr.,4397227,,True,25.0,5,7,3,3,2,4,4,4,1,5,6,5,3,1,1,3,16
401365776,VCU Rams,J. Nunn,4896614,,True,30.0,3,6,1,2,2,4,1,2,0,2,2,1,1,0,1,1,9
401365776,VCU Rams,A. Baldwin Jr.,4433182,,True,31.0,3,10,3,7,0,3,1,2,0,1,1,6,3,0,3,0,7
401365776,VCU Rams,K. Curry,4397228,,True,24.0,2,8,2,7,0,1,1,2,0,1,1,2,1,1,1,1,5
401365776,VCU Rams,M. Brown-Jones,4433224,,False,12.0,1,4,1,3,0,1,1,4,0,2,2,1,0,1,0,2,3
401365776,VCU Rams,J. DeLoach,4432483,,False,19.0,4,6,4,6,0,0,1,3,3,4,7,2,0,1,0,4,9
401365776,VCU Rams,N. Kern,4684145,,False,16.0,2,2,2,2,0,0,0,0,0,1,1,1,0,0,1,3,4
401365776,VCU Rams,M. Tsohonis,4592438,,False,13.0,5,6,0,0,5,6,2,2,0,2,2,2,0,0,0,2,17
401365776,VCU Rams,J. Banks,4432402,,False,7.0,1,3,1,1,0,2,0,0,0,0,0,0,0,0,1,1,2
401365776,VCU Rams,TEAM,TOTAL,TOTAL,False,,32,62,23,41,9,21,12,21,10,22,32,22,9,4,8,20,85
401365776,La Salle Explorers,M. Doucoure,4277988,,True,13.0,0,3,0,3,0,0,2,4,1,3,4,0,0,0,0,0,2
401365776,La Salle Explorers,C. Moore,4277945,,True,35.0,8,12,8,11,0,1,5,7,4,8,12,3,0,3,0,4,21
401365776,La Salle Explorers,J. Clark,4397152,,True,24.0,2,6,0,2,2,4,0,0,0,0,0,2,1,0,5,2,6
401365776,La Salle Explorers,A. Gill,4700969,,True,25.0,3,4,3,4,0,0,0,0,0,1,1,7,2,0,7,2,6
401365776,La Salle Explorers,C. Ray,4592448,,True,36.0,3,6,3,6,0,0,2,3,1,6,7,2,2,0,3,3,8
401365776,La Salle Explorers,M. McFarlane,4897068,,False,15.0,1,3,0,1,1,2,0,0,1,3,4,0,0,0,0,3,3
401365776,La Salle Explorers,D. Shepherd,4710357,,False,18.0,1,4,1,2,0,2,0,0,1,1,2,0,0,0,2,0,2
401365776,La Salle Explorers,K. Brantley,4709132,,False,34.0,6,15,4,10,2,5,4,7,0,1,1,2,2,0,2,4,18
401365776,La Salle Explorers,TEAM,TOTAL,TOTAL,False,,24,53,19,39,5,14,13,21,10,24,34,16,7,3,19,18,66
401365776,La Salle Explorers,M. Doucoure,4277988,,True,13.0,0,3,0,3,0,0,2,4,1,3,4,0,0,0,0,0,2
401365776,La Salle Explorers,C. Moore,4277945,,True,35.0,8,12,8,11,0,1,5,7,4,8,12,3,0,3,0,4,21
401365776,La Salle Explorers,J. Clark,4397152,,True,24.0,2,6,0,2,2,4,0,0,0,0,0,2,1,0,5,2,6
401365776,La Salle Explorers,A. Gill,4700969,,True,25.0,3,4,3,4,0,0,0,0,0,1,1,7,2,0,7,2,6
401365776,La Salle Explorers,C. Ray,4592448,,True,36.0,3,6,3,6,0,0,2,3,1,6,7,2,2,0,3,3,8
401365776,La Salle Explorers,M. McFarlane,4897068,,False,15.0,1,3,0,1,1,2,0,0,1,3,4,0,0,0,0,3,3
401365776,La Salle Explorers,D. Shepherd,4710357,,False,18.0,1,4,1,2,0,2,0,0,1,1,2,0,0,0,2,0,2
401365776,La Salle Explorers,K. Brantley,4709132,,False,34.0,6,15,4,10,2,5,4,7,0,1,1,2,2,0,2,4,18
401365776,La Salle Explorers,TEAM,TOTAL,TOTAL,False,,24,53,19,39,5,14,13,21,10,24,34,16,7,3,19,18,66
401365775,George Washington Revolutionaries,H. Dean,4593273,,True,11.0,0,0,0,0,0,0,0,0,0,1,1,0,0,1,0,0,0
401365775,George Washington Revolutionaries,R. Lindo Jr.,4397186,,True,28.0,0,3,0,3,0,0,0,0,3,3,6,1,0,2,3,2,0
401365775,George Washington Revolutionaries,J. Bamisile,4432537,,True,34.0,10,18,8,12,2,6,3,3,5,1,6,3,4,1,4,4,25
401365775,George Washington Revolutionaries,J. Bishop,4431770,,True,35.0,5,16,3,6,2,10,0,0,0,3,3,2,2,1,4,2,12
401365775,George Washington Revolutionaries,B. Adams,4396612,,True,30.0,2,8,2,4,0,4,0,0,1,3,4,1,1,0,0,1,4
401365775,George Washington Revolutionaries,D. Nixon,4897075,,False,1.0,0,0,0,0,0,0,0,0,0,0,0,0,0,0,1,0,0
401365775,George Washington Revolutionaries,M. Gally,4592445,,False,3.0,0,0,0,0,0,0,0,2,0,1,1,0,0,0,0,0,0
401365775,George Washington Revolutionaries,Q. Samuels,4592251,,False,18.0,0,3,0,2,0,1,0,0,1,2,3,0,0,0,2,1,0
401365775,George Washington Revolutionaries,N. Brown,4700963,,False,1.0,0,1,0,1,0,0,0,0,0,0,0,0,0,0,0,0,0
401365775,George Washington Revolutionaries,B. Freeman,4613126,,False,29.0,5,12,0,3,5,9,2,4,0,1,1,5,2,0,3,3,17
401365775,George Washington Revolutionaries,A. Harris,4397216,,False,7.0,0,0,0,0,0,0,0,0,1,0,1,2,0,0,0,0,0
401365775,George Washington Revolutionaries,B. Knapp,4279473,,False,3.0,0,0,0,0,0,0,0,0,0,0,0,0,0,0,0,0,0
401365775,George Washington Revolutionaries,TEAM,TOTAL,TOTAL,False,,22,61,13,31,9,30,5,9,12,16,28,14,9,5,17,13,58
401365775,George Washington Revolutionaries,H. Dean,4593273,,True,11.0,0,0,0,0,0,0,0,0,0,1,1,0,0,1,0,0,0
401365775,George Washington Revolutionaries,R. Lindo Jr.,4397186,,True,28.0,0,3,0,3,0,0,0,0,3,3,6,1,0,2,3,2,0
401365775,George Washington Revolutionaries,J. Bamisile,4432537,,True,34.0,10,18,8,12,2,6,3,3,5,1,6,3,4,1,4,4,25
401365775,George Washington Revolutionaries,J. Bishop,4431770,,True,35.0,5,16,3,6,2,10,0,0,0,3,3,2,2,1,4,2,12
401365775,George Washington Revolutionaries,B. Adams,4396612,,True,30.0,2,8,2,4,0,4,0,0,1,3,4,1,1,0,0,1,4
401365775,George Washington Revolutionaries,D. Nixon,4897075,,False,1.0,0,0,0,0,0,0,0,0,0,0,0,0,0,0,1,0,0
401365775,George Washington Revolutionaries,M. Gally,4592445,,False,3.0,0,0,0,0,0,0,0,2,0,1,1,0,0,0,0,0,0
401365775,George Washington Revolutionaries,Q. Samuels,4592251,,False,18.0,0,3,0,2,0,1,0,0,1,2,3,0,0,0,2,1,0
401365775,George Washington Revolutionaries,N. Brown,4700963,,False,1.0,0,1,0,1,0,0,0,0,0,0,0,0,0,0,0,0,0
401365775,George Washington Revolutionaries,B. Freeman,4613126,,False,29.0,5,12,0,3,5,9,2,4,0,1,1,5,2,0,3,3,17
401365775,George Washington Revolutionaries,A. Harris,4397216,,False,7.0,0,0,0,0,0,0,0,0,1,0,1,2,0,0,0,0,0
401365775,George Washington Revolutionaries,B. Knapp,4279473,,False,3.0,0,0,0,0,0,0,0,0,0,0,0,0,0,0,0,0,0
401365775,George Washington Revolutionaries,TEAM,TOTAL,TOTAL,False,,22,61,13,31,9,30,5,9,12,16,28,14,9,5,17,13,58
401365775,Dayton Flyers,R.J. Blakney,4700864,,True,13.0,2,3,1,1,1,2,0,0,0,1,1,0,0,0,1,1,5
401365775,Dayton Flyers,T. Camara,4431736,,True,23.0,7,10,7,10,0,0,0,1,3,2,5,1,1,2,5,3,14
401365775,Dayton Flyers,D. Holmes II,4433607,,True,29.0,6,8,6,8,0,0,0,0,1,6,7,3,1,2,1,0,12
401365775,Dayton Flyers,M. Smith,4683861,,True,33.0,6,12,5,9,1,3,0,0,1,5,6,6,3,0,4,2,13
401365775,Dayton Flyers,K. Elvis,4683135,,True,19.0,2,3,1,1,1,2,0,0,0,2,2,5,0,0,2,0,5
401365775,Dayton Flyers,M. Sissoko,4431824,,False,11.0,0,2,0,2,0,0,0,0,2,0,2,0,1,0,0,2,0
401365775,Dayton Flyers,M. Amzil,4711607,,False,23.0,4,6,3,5,1,1,1,1,0,6,6,2,0,1,1,2,10
401365775,Dayton Flyers,K. Washington,4684293,,False,3.0,0,2,0,2,0,0,0,1,0,2,2,1,1,0,0,1,0
401365775,Dayton Flyers,Z. Nwokeji,4618121,,False,3.0,2,2,2,2,0,0,0,0,0,0,0,0,0,0,0,0,4
401365775,Dayton Flyers,C. Wilson,4403456,,False,0.0,0,0,0,0,0,0,0,0,0,0,0,0,0,0,0,0,0
401365775,Dayton Flyers,D. Swerlein,4600089,,False,1.0,0,0,0,0,0,0,0,0,0,0,0,0,0,0,0,0,0
401365775,Dayton Flyers,K. Brea,4591259,,False,22.0,3,8,1,3,2,5,0,0,0,3,3,1,1,0,1,1,8
401365775,Dayton Flyers,E. Weaver,4397139,,False,20.0,5,7,3,4,2,3,0,0,0,1,1,3,3,0,2,2,12
401365775,Dayton Flyers,TEAM,TOTAL,TOTAL,False,,37,63,29,47,8,16,1,3,12,29,41,22,11,5,18,14,83
401365775,Dayton Flyers,R.J. Blakney,4700864,,True,13.0,2,3,1,1,1,2,0,0,0,1,1,0,0,0,1,1,5
401365775,Dayton Flyers,T. Camara,4431736,,True,23.0,7,10,7,10,0,0,0,1,3,2,5,1,1,2,5,3,14
401365775,Dayton Flyers,D. Holmes II,4433607,,True,29.0,6,8,6,8,0,0,0,0,1,6,7,3,1,2,1,0,12
401365775,Dayton Flyers,M. Smith,4683861,,True,33.0,6,12,5,9,1,3,0,0,1,5,6,6,3,0,4,2,13
401365775,Dayton Flyers,K. Elvis,4683135,,True,19.0,2,3,1,1,1,2,0,0,0,2,2,5,0,0,2,0,5
401365775,Dayton Flyers,M. Sissoko,4431824,,False,11.0,0,2,0,2,0,0,0,0,2,0,2,0,1,0,0,2,0
401365775,Dayton Flyers,M. Amzil,4711607,,False,23.0,4,6,3,5,1,1,1,1,0,6,6,2,0,1,1,2,10
401365775,Dayton Flyers,K. Washington,4684293,,False,3.0,0,2,0,2,0,0,0,1,0,2,2,1,1,0,0,1,0
401365775,Dayton Flyers,Z. Nwokeji,4618121,,False,3.0,2,2,2,2,0,0,0,0,0,0,0,0,0,0,0,0,4
401365775,Dayton Flyers,C. Wilson,4403456,,False,0.0,0,0,0,0,0,0,0,0,0,0,0,0,0,0,0,0,0
401365775,Dayton Flyers,D. Swerlein,4600089,,False,1.0,0,0,0,0,0,0,0,0,0,0,0,0,0,0,0,0,0
401365775,Dayton Flyers,K. Brea,4591259,,False,22.0,3,8,1,3,2,5,0,0,0,3,3,1,1,0,1,1,8
401365775,Dayton Flyers,E. Weaver,4397139,,False,20.0,5,7,3,4,2,3,0,0,0,1,1,3,3,0,2,2,12
401365775,Dayton Flyers,TEAM,TOTAL,TOTAL,False,,37,63,29,47,8,16,1,3,12,29,41,22,11,5,18,14,83
401365771,VCU Rams,H. Ward,4592495,,True,20.0,2,6,2,6,0,0,0,0,2,3,5,0,0,2,0,4,4
401365771,VCU Rams,V. Williams Jr.,4397227,,True,38.0,4,14,1,6,3,8,2,2,3,8,11,3,2,2,3,2,13
401365771,VCU Rams,M. Tsohonis,4592438,,True,25.0,2,6,1,3,1,3,0,0,0,1,1,2,0,0,0,0,5
401365771,VCU Rams,A. Baldwin Jr.,4433182,,True,37.0,5,11,3,6,2,5,0,0,1,2,3,7,1,0,3,4,12
401365771,VCU Rams,K. Curry,4397228,,True,23.0,2,9,2,9,0,0,0,0,1,1,2,0,0,0,1,4,4
401365771,VCU Rams,M. Brown-Jones,4433224,,False,12.0,3,4,3,4,0,0,0,0,1,1,2,1,0,0,0,1,6
401365771,VCU Rams,J. DeLoach,4432483,,False,19.0,2,2,2,2,0,0,0,0,1,3,4,0,0,1,2,3,4
401365771,VCU Rams,N. Kern,4684145,,False,8.0,0,1,0,1,0,0,0,0,0,0,0,0,0,0,0,2,0
401365771,VCU Rams,J. Banks,4432402,,False,18.0,2,6,1,1,1,5,0,0,0,1,1,1,2,0,2,0,5
401365771,VCU Rams,TEAM,TOTAL,TOTAL,False,,22,59,15,38,7,21,2,2,12,22,34,14,5,5,12,20,53
401365771,VCU Rams,H. Ward,4592495,,True,20.0,2,6,2,6,0,0,0,0,2,3,5,0,0,2,0,4,4
401365771,VCU Rams,V. Williams Jr.,4397227,,True,38.0,4,14,1,6,3,8,2,2,3,8,11,3,2,2,3,2,13
401365771,VCU Rams,M. Tsohonis,4592438,,True,25.0,2,6,1,3,1,3,0,0,0,1,1,2,0,0,0,0,5
401365771,VCU Rams,A. Baldwin Jr.,4433182,,True,37.0,5,11,3,6,2,5,0,0,1,2,3,7,1,0,3,4,12
401365771,VCU Rams,K. Curry,4397228,,True,23.0,2,9,2,9,0,0,0,0,1,1,2,0,0,0,1,4,4
401365771,VCU Rams,M. Brown-Jones,4433224,,False,12.0,3,4,3,4,0,0,0,0,1,1,2,1,0,0,0,1,6
401365771,VCU Rams,J. DeLoach,4432483,,False,19.0,2,2,2,2,0,0,0,0,1,3,4,0,0,1,2,3,4
401365771,VCU Rams,N. Kern,4684145,,False,8.0,0,1,0,1,0,0,0,0,0,0,0,0,0,0,0,2,0
401365771,VCU Rams,J. Banks,4432402,,False,18.0,2,6,1,1,1,5,0,0,0,1,1,1,2,0,2,0,5
401365771,VCU Rams,TEAM,TOTAL,TOTAL,False,,22,59,15,38,7,21,2,2,12,22,34,14,5,5,12,20,53
401365771,Dayton Flyers,R.J. Blakney,4700864,,True,32.0,2,6,1,2,1,4,5,10,1,4,5,0,0,1,2,0,10
401365771,Dayton Flyers,T. Camara,4431736,,True,35.0,6,10,4,6,2,4,2,2,1,4,5,3,1,0,3,1,16
401365771,Dayton Flyers,D. Holmes II,4433607,,True,36.0,3,6,3,6,0,0,6,8,2,9,11,1,2,4,1,2,12
401365771,Dayton Flyers,M. Smith,4683861,,True,37.0,3,6,3,6,0,0,5,6,0,1,1,2,0,0,3,4,11
401365771,Dayton Flyers,K. Elvis,4683135,,True,17.0,0,3,0,2,0,1,0,0,0,1,1,1,0,0,1,0,0
401365771,Dayton Flyers,M. Sissoko,4431824,,False,1.0,0,0,0,0,0,0,0,0,0,1,1,0,0,0,1,0,0
401365771,Dayton Flyers,M. Amzil,4711607,,False,11.0,0,3,0,0,0,3,0,0,1,0,1,1,0,0,1,1,0
401365771,Dayton Flyers,Z. Nwokeji,4618121,,False,3.0,0,1,0,1,0,0,0,0,1,0,1,0,1,0,1,1,0
401365771,Dayton Flyers,K. Brea,4591259,,False,6.0,1,2,1,1,0,1,1,1,0,1,1,0,0,0,1,0,3
401365771,Dayton Flyers,E. Weaver,4397139,,False,22.0,0,2,0,0,0,2,0,0,0,1,1,2,1,0,1,1,0
401365771,Dayton Flyers,TEAM,TOTAL,TOTAL,False,,15,39,12,24,3,15,19,27,7,24,31,10,5,5,15,10,52
401365771,Dayton Flyers,R.J. Blakney,4700864,,True,32.0,2,6,1,2,1,4,5,10,1,4,5,0,0,1,2,0,10
401365771,Dayton Flyers,T. Camara,4431736,,True,35.0,6,10,4,6,2,4,2,2,1,4,5,3,1,0,3,1,16
401365771,Dayton Flyers,D. Holmes II,4433607,,True,36.0,3,6,3,6,0,0,6,8,2,9,11,1,2,4,1,2,12
401365771,Dayton Flyers,M. Smith,4683861,,True,37.0,3,6,3,6,0,0,5,6,0,1,1,2,0,0,3,4,11
401365771,Dayton Flyers,K. Elvis,4683135,,True,17.0,0,3,0,2,0,1,0,0,0,1,1,1,0,0,1,0,0
401365771,Dayton Flyers,M. Sissoko,4431824,,False,1.0,0,0,0,0,0,0,0,0,0,1,1,0,0,0,1,0,0
401365771,Dayton Flyers,M. Amzil,4711607,,False,11.0,0,3,0,0,0,3,0,0,1,0,1,1,0,0,1,1,0
401365771,Dayton Flyers,Z. Nwokeji,4618121,,False,3.0,0,1,0,1,0,0,0,0,1,0,1,0,1,0,1,1,0
401365771,Dayton Flyers,K. Brea,4591259,,False,6.0,1,2,1,1,0,1,1,1,0,1,1,0,0,0,1,0,3
401365771,Dayton Flyers,E. Weaver,4397139,,False,22.0,0,2,0,0,0,2,0,0,0,1,1,2,1,0,1,1,0
401365771,Dayton Flyers,TEAM,TOTAL,TOTAL,False,,15,39,12,24,3,15,19,27,7,24,31,10,5,5,15,10,52
401365770,Saint Joseph's Hawks,T. Funk,4278395,,True,33.0,2,9,1,2,1,7,0,1,3,5,8,3,1,0,1,2,5
401365770,Saint Joseph's Hawks,E. Obinna,4278125,,True,25.0,2,5,2,5,0,0,1,2,0,5,5,0,0,0,1,3,5
401365770,Saint Joseph's Hawks,J. Hall,4701031,,True,35.0,5,14,2,7,3,7,4,4,0,4,4,6,1,0,3,3,17
401365770,Saint Joseph's Hawks,E. Reynolds II,4683952,,True,26.0,4,11,4,8,0,3,1,1,0,0,0,2,0,0,1,3,9
401365770,Saint Joseph's Hawks,C. Brown,4592476,,True,21.0,2,5,1,4,1,1,0,0,1,2,3,2,0,0,2,0,5
401365770,Saint Joseph's Hawks,C. Coleman,4431807,,False,6.0,0,1,0,1,0,0,0,0,0,1,1,0,0,1,0,1,0
401365770,Saint Joseph's Hawks,A. Jansson,4701029,,False,1.0,0,0,0,0,0,0,0,0,0,0,0,0,0,0,0,0,0
401365770,Saint Joseph's Hawks,C. Arizin,4706891,,False,1.0,1,1,1,1,0,0,0,0,1,0,1,0,0,0,0,0,2
401365770,Saint Joseph's Hawks,J. Forrest,4701032,,False,24.0,5,7,2,3,3,4,0,0,1,2,3,1,1,0,0,3,13
401365770,Saint Joseph's Hawks,D. Bishop,4701028,,False,28.0,6,12,3,6,3,6,2,3,0,6,6,0,0,0,0,0,17
401365770,Saint Joseph's Hawks,TEAM,TOTAL,TOTAL,False,,27,65,16,37,11,28,8,11,7,27,34,14,3,1,8,15,73
401365770,Saint Joseph's Hawks,T. Funk,4278395,,True,33.0,2,9,1,2,1,7,0,1,3,5,8,3,1,0,1,2,5
401365770,Saint Joseph's Hawks,E. Obinna,4278125,,True,25.0,2,5,2,5,0,0,1,2,0,5,5,0,0,0,1,3,5
401365770,Saint Joseph's Hawks,J. Hall,4701031,,True,35.0,5,14,2,7,3,7,4,4,0,4,4,6,1,0,3,3,17
401365770,Saint Joseph's Hawks,E. Reynolds II,4683952,,True,26.0,4,11,4,8,0,3,1,1,0,0,0,2,0,0,1,3,9
401365770,Saint Joseph's Hawks,C. Brown,4592476,,True,21.0,2,5,1,4,1,1,0,0,1,2,3,2,0,0,2,0,5
401365770,Saint Joseph's Hawks,C. Coleman,4431807,,False,6.0,0,1,0,1,0,0,0,0,0,1,1,0,0,1,0,1,0
401365770,Saint Joseph's Hawks,A. Jansson,4701029,,False,1.0,0,0,0,0,0,0,0,0,0,0,0,0,0,0,0,0,0
401365770,Saint Joseph's Hawks,C. Arizin,4706891,,False,1.0,1,1,1,1,0,0,0,0,1,0,1,0,0,0,0,0,2
401365770,Saint Joseph's Hawks,J. Forrest,4701032,,False,24.0,5,7,2,3,3,4,0,0,1,2,3,1,1,0,0,3,13
401365770,Saint Joseph's Hawks,D. Bishop,4701028,,False,28.0,6,12,3,6,3,6,2,3,0,6,6,0,0,0,0,0,17
401365770,Saint Joseph's Hawks,TEAM,TOTAL,TOTAL,False,,27,65,16,37,11,28,8,11,7,27,34,14,3,1,8,15,73
401365770,Davidson Wildcats,S. Mennenga,4700862,,True,30.0,5,9,4,7,1,2,2,2,0,4,4,1,0,1,0,2,13
401365770,Davidson Wildcats,L. Brajkovic,4396787,,True,30.0,5,13,4,9,1,4,0,0,1,7,8,3,0,0,0,2,11
401365770,Davidson Wildcats,H. Lee,4592308,,True,31.0,5,11,3,7,2,4,5,7,1,9,10,2,1,0,0,2,17
401365770,Davidson Wildcats,F. Loyer,4397208,,True,29.0,10,17,5,9,5,8,0,0,1,3,4,5,0,0,2,3,25
401365770,Davidson Wildcats,M. Jones,4396784,,True,30.0,6,8,4,4,2,4,4,4,0,5,5,2,0,0,3,0,18
401365770,Davidson Wildcats,C. Ford,4897099,,False,1.0,0,0,0,0,0,0,0,0,0,0,0,0,0,0,0,0,0
401365770,Davidson Wildcats,D. Kristensen,4432020,,False,1.0,0,0,0,0,0,0,0,0,0,0,0,0,0,0,0,1,0
401365770,Davidson Wildcats,N. Boachie-Yiadom,4396786,,False,15.0,1,1,1,1,0,0,0,0,1,1,2,0,1,2,0,2,2
401365770,Davidson Wildcats,M. Katsock,4902569,,False,1.0,0,1,0,1,0,0,0,0,0,0,0,0,0,0,0,0,0
401365770,Davidson Wildcats,S. Thrastarson,4897100,,False,1.0,0,1,0,0,0,1,0,0,0,0,0,0,0,0,0,0,0
401365770,Davidson Wildcats,D. Watson,4897098,,False,13.0,0,3,0,2,0,1,0,0,0,1,1,0,0,0,1,0,0
401365770,Davidson Wildcats,E. Lanier,4567082,,False,1.0,0,0,0,0,0,0,0,0,0,0,0,0,0,0,0,0,0
401365770,Davidson Wildcats,G. Huffman,4432522,,False,17.0,1,1,1,1,0,0,0,0,0,1,1,3,0,0,0,1,2
401365770,Davidson Wildcats,TEAM,TOTAL,TOTAL,False,,33,65,22,41,11,24,11,13,5,33,38,16,2,3,6,13,88
401365770,Davidson Wildcats,S. Mennenga,4700862,,True,30.0,5,9,4,7,1,2,2,2,0,4,4,1,0,1,0,2,13
401365770,Davidson Wildcats,L. Brajkovic,4396787,,True,30.0,5,13,4,9,1,4,0,0,1,7,8,3,0,0,0,2,11
401365770,Davidson Wildcats,H. Lee,4592308,,True,31.0,5,11,3,7,2,4,5,7,1,9,10,2,1,0,0,2,17
401365770,Davidson Wildcats,F. Loyer,4397208,,True,29.0,10,17,5,9,5,8,0,0,1,3,4,5,0,0,2,3,25
401365770,Davidson Wildcats,M. Jones,4396784,,True,30.0,6,8,4,4,2,4,4,4,0,5,5,2,0,0,3,0,18
401365770,Davidson Wildcats,C. Ford,4897099,,False,1.0,0,0,0,0,0,0,0,0,0,0,0,0,0,0,0,0,0
401365770,Davidson Wildcats,D. Kristensen,4432020,,False,1.0,0,0,0,0,0,0,0,0,0,0,0,0,0,0,0,1,0
401365770,Davidson Wildcats,N. Boachie-Yiadom,4396786,,False,15.0,1,1,1,1,0,0,0,0,1,1,2,0,1,2,0,2,2
401365770,Davidson Wildcats,M. Katsock,4902569,,False,1.0,0,1,0,1,0,0,0,0,0,0,0,0,0,0,0,0,0
401365770,Davidson Wildcats,S. Thrastarson,4897100,,False,1.0,0,1,0,0,0,1,0,0,0,0,0,0,0,0,0,0,0
401365770,Davidson Wildcats,D. Watson,4897098,,False,13.0,0,3,0,2,0,1,0,0,0,1,1,0,0,0,1,0,0
401365770,Davidson Wildcats,E. Lanier,4567082,,False,1.0,0,0,0,0,0,0,0,0,0,0,0,0,0,0,0,0,0
401365770,Davidson Wildcats,G. Huffman,4432522,,False,17.0,1,1,1,1,0,0,0,0,0,1,1,3,0,0,0,1,2
401365770,Davidson Wildcats,TEAM,TOTAL,TOTAL,False,,33,65,22,41,11,24,11,13,5,33,38,16,2,3,6,13,88
401365769,Richmond Spiders,T. Burton,4431914,,True,33.0,5,11,4,7,1,4,1,1,2,11,13,2,3,0,1,0,12
401365769,Richmond Spiders,N. Cayo,4278380,,True,27.0,7,9,7,9,0,0,0,2,1,1,2,1,1,0,2,2,14
401365769,Richmond Spiders,G. Golden,4066836,,True,27.0,3,7,3,6,0,1,1,4,0,5,5,3,0,0,3,3,7
401365769,Richmond Spiders,I. Wilson,4700973,,True,18.0,1,2,1,2,0,0,2,2,2,0,2,2,0,0,2,1,4
401365769,Richmond Spiders,J. Gilyard,4278378,,True,35.0,5,12,4,7,1,5,6,6,1,2,3,10,4,0,3,0,17
401365769,Richmond Spiders,M. Grace,4397192,,False,13.0,1,3,0,0,1,3,0,0,0,2,2,1,0,0,0,1,3
401365769,Richmond Spiders,D. Bailey,4700974,,False,4.0,0,0,0,0,0,0,0,0,0,0,0,0,0,0,1,1,0
401365769,Richmond Spiders,A. Gustavson,4397193,,False,15.0,2,3,0,1,2,2,0,0,0,2,2,1,2,0,1,0,6
401365769,Richmond Spiders,C. Crabtree,4396658,,False,11.0,2,2,1,1,1,1,0,0,0,0,0,1,0,0,0,1,5
401365769,Richmond Spiders,N. Sherod,4066832,,False,17.0,5,9,3,3,2,6,0,0,0,2,2,0,1,0,0,1,12
401365769,Richmond Spiders,TEAM,TOTAL,TOTAL,False,,31,58,23,36,8,22,10,15,7,26,33,21,11,0,13,10,80
401365769,Richmond Spiders,T. Burton,4431914,,True,33.0,5,11,4,7,1,4,1,1,2,11,13,2,3,0,1,0,12
401365769,Richmond Spiders,N. Cayo,4278380,,True,27.0,7,9,7,9,0,0,0,2,1,1,2,1,1,0,2,2,14
401365769,Richmond Spiders,G. Golden,4066836,,True,27.0,3,7,3,6,0,1,1,4,0,5,5,3,0,0,3,3,7
401365769,Richmond Spiders,I. Wilson,4700973,,True,18.0,1,2,1,2,0,0,2,2,2,0,2,2,0,0,2,1,4
401365769,Richmond Spiders,J. Gilyard,4278378,,True,35.0,5,12,4,7,1,5,6,6,1,2,3,10,4,0,3,0,17
401365769,Richmond Spiders,M. Grace,4397192,,False,13.0,1,3,0,0,1,3,0,0,0,2,2,1,0,0,0,1,3
401365769,Richmond Spiders,D. Bailey,4700974,,False,4.0,0,0,0,0,0,0,0,0,0,0,0,0,0,0,1,1,0
401365769,Richmond Spiders,A. Gustavson,4397193,,False,15.0,2,3,0,1,2,2,0,0,0,2,2,1,2,0,1,0,6
401365769,Richmond Spiders,C. Crabtree,4396658,,False,11.0,2,2,1,1,1,1,0,0,0,0,0,1,0,0,0,1,5
401365769,Richmond Spiders,N. Sherod,4066832,,False,17.0,5,9,3,3,2,6,0,0,0,2,2,0,1,0,0,1,12
401365769,Richmond Spiders,TEAM,TOTAL,TOTAL,False,,31,58,23,36,8,22,10,15,7,26,33,21,11,0,13,10,80
401365769,Massachusetts Minutemen,G. Jones,4279211,,True,19.0,1,4,1,3,0,1,0,0,2,3,5,0,0,0,0,3,2
401365769,Massachusetts Minutemen,T. Buttrick,4277981,,True,35.0,6,12,3,7,3,5,1,2,1,6,7,2,2,1,2,0,16
401365769,Massachusetts Minutemen,N. Fernandes,4431791,,True,28.0,4,9,2,7,2,2,0,0,0,2,2,1,0,0,3,5,10
401365769,Massachusetts Minutemen,C.J. Kelly,4398208,,True,32.0,5,12,3,6,2,6,4,4,1,2,3,1,1,0,5,2,16
401365769,Massachusetts Minutemen,R. Kelly,4279741,,True,37.0,8,12,4,7,4,5,0,0,0,0,0,5,1,0,3,2,20
401365769,Massachusetts Minutemen,D. Dominguez,4701126,,False,10.0,0,2,0,1,0,1,0,0,0,0,0,0,0,0,1,0,0
401365769,Massachusetts Minutemen,M. Steadman,4397393,,False,23.0,3,10,3,10,0,0,2,4,2,7,9,1,0,0,1,2,8
401365769,Massachusetts Minutemen,K. Mitchell,4592454,,False,16.0,0,0,0,0,0,0,0,0,3,0,3,0,2,0,0,0,0
401365769,Massachusetts Minutemen,TEAM,TOTAL,TOTAL,False,,27,61,16,41,11,20,7,10,10,21,31,10,6,1,15,14,72
401365769,Massachusetts Minutemen,G. Jones,4279211,,True,19.0,1,4,1,3,0,1,0,0,2,3,5,0,0,0,0,3,2
401365769,Massachusetts Minutemen,T. Buttrick,4277981,,True,35.0,6,12,3,7,3,5,1,2,1,6,7,2,2,1,2,0,16
401365769,Massachusetts Minutemen,N. Fernandes,4431791,,True,28.0,4,9,2,7,2,2,0,0,0,2,2,1,0,0,3,5,10
401365769,Massachusetts Minutemen,C.J. Kelly,4398208,,True,32.0,5,12,3,6,2,6,4,4,1,2,3,1,1,0,5,2,16
401365769,Massachusetts Minutemen,R. Kelly,4279741,,True,37.0,8,12,4,7,4,5,0,0,0,0,0,5,1,0,3,2,20
401365769,Massachusetts Minutemen,D. Dominguez,4701126,,False,10.0,0,2,0,1,0,1,0,0,0,0,0,0,0,0,1,0,0
401365769,Massachusetts Minutemen,M. Steadman,4397393,,False,23.0,3,10,3,10,0,0,2,4,2,7,9,1,0,0,1,2,8
401365769,Massachusetts Minutemen,K. Mitchell,4592454,,False,16.0,0,0,0,0,0,0,0,0,3,0,3,0,2,0,0,0,0
401365769,Massachusetts Minutemen,TEAM,TOTAL,TOTAL,False,,27,61,16,41,11,20,7,10,10,21,31,10,6,1,15,14,72
401365767,Saint Louis Billikens,F. Okoro,4397105,,True,30.0,4,7,4,7,0,0,1,1,1,7,8,1,3,1,0,2,9
401365767,Saint Louis Billikens,Y. Collins,4432957,,True,37.0,10,17,7,12,3,5,1,3,0,6,6,8,2,0,6,2,24
401365767,Saint Louis Billikens,M. Strickland,4432494,,True,3.0,1,3,1,3,0,0,1,1,1,0,1,0,0,0,0,2,3
401365767,Saint Louis Billikens,G. Jimerson,4432008,,True,35.0,5,14,4,10,1,4,6,7,0,1,1,0,2,1,1,0,17
401365767,Saint Louis Billikens,F. Thatch Jr.,4397199,,True,21.0,1,2,1,2,0,0,1,2,1,1,2,1,0,2,0,4,3
401365767,Saint Louis Billikens,L. Traore,4897052,,False,10.0,2,3,2,3,0,0,2,2,1,3,4,0,0,0,1,2,6
401365767,Saint Louis Billikens,T. Hargrove Jr.,4592484,,False,29.0,1,9,1,5,0,4,0,0,2,3,5,1,0,0,0,2,2
401365767,Saint Louis Billikens,J. Nesbitt,4714246,,False,25.0,4,7,3,4,1,3,3,4,1,2,3,1,2,0,0,3,12
401365767,Saint Louis Billikens,R. Williams,4399106,,False,3.0,0,2,0,0,0,2,0,0,0,0,0,0,0,0,1,0,0
401365767,Saint Louis Billikens,D. Jones,4278267,,False,7.0,0,2,0,1,0,1,0,0,1,1,2,0,0,0,0,0,0
401365767,Saint Louis Billikens,TEAM,TOTAL,TOTAL,False,,28,66,23,47,5,19,15,20,10,26,36,12,9,4,9,17,76
401365767,Saint Louis Billikens,F. Okoro,4397105,,True,30.0,4,7,4,7,0,0,1,1,1,7,8,1,3,1,0,2,9
401365767,Saint Louis Billikens,Y. Collins,4432957,,True,37.0,10,17,7,12,3,5,1,3,0,6,6,8,2,0,6,2,24
401365767,Saint Louis Billikens,M. Strickland,4432494,,True,3.0,1,3,1,3,0,0,1,1,1,0,1,0,0,0,0,2,3
401365767,Saint Louis Billikens,G. Jimerson,4432008,,True,35.0,5,14,4,10,1,4,6,7,0,1,1,0,2,1,1,0,17
401365767,Saint Louis Billikens,F. Thatch Jr.,4397199,,True,21.0,1,2,1,2,0,0,1,2,1,1,2,1,0,2,0,4,3
401365767,Saint Louis Billikens,L. Traore,4897052,,False,10.0,2,3,2,3,0,0,2,2,1,3,4,0,0,0,1,2,6
401365767,Saint Louis Billikens,T. Hargrove Jr.,4592484,,False,29.0,1,9,1,5,0,4,0,0,2,3,5,1,0,0,0,2,2
401365767,Saint Louis Billikens,J. Nesbitt,4714246,,False,25.0,4,7,3,4,1,3,3,4,1,2,3,1,2,0,0,3,12
401365767,Saint Louis Billikens,R. Williams,4399106,,False,3.0,0,2,0,0,0,2,0,0,0,0,0,0,0,0,1,0,0
401365767,Saint Louis Billikens,D. Jones,4278267,,False,7.0,0,2,0,1,0,1,0,0,1,1,2,0,0,0,0,0,0
401365767,Saint Louis Billikens,TEAM,TOTAL,TOTAL,False,,28,66,23,47,5,19,15,20,10,26,36,12,9,4,9,17,76
401365767,Richmond Spiders,T. Burton,4431914,,True,34.0,5,13,3,9,2,4,12,14,3,9,12,1,1,0,2,4,24
401365767,Richmond Spiders,N. Cayo,4278380,,True,32.0,3,9,3,9,0,0,0,0,5,6,11,4,1,0,0,1,6
401365767,Richmond Spiders,G. Golden,4066836,,True,31.0,6,14,5,12,1,2,1,2,2,8,10,3,0,2,3,2,14
401365767,Richmond Spiders,I. Wilson,4700973,,True,31.0,2,7,2,6,0,1,1,2,0,2,2,2,1,0,3,2,5
401365767,Richmond Spiders,J. Gilyard,4278378,,True,39.0,5,12,3,5,2,7,0,0,2,2,4,4,4,0,2,2,12
401365767,Richmond Spiders,M. Grace,4397192,,False,11.0,2,6,1,2,1,4,1,2,0,1,1,1,0,0,0,3,6
401365767,Richmond Spiders,D. Bailey,4700974,,False,2.0,0,0,0,0,0,0,0,0,0,1,1,0,0,0,1,1,0
401365767,Richmond Spiders,A. Gustavson,4397193,,False,2.0,0,0,0,0,0,0,0,0,0,1,1,0,0,0,0,0,0
401365767,Richmond Spiders,C. Crabtree,4396658,,False,7.0,1,2,1,1,0,1,0,0,0,1,1,0,0,0,0,0,2
401365767,Richmond Spiders,N. Sherod,4066832,,False,11.0,0,2,0,1,0,1,0,0,0,1,1,0,0,0,0,1,0
401365767,Richmond Spiders,TEAM,TOTAL,TOTAL,False,,24,65,18,45,6,20,15,20,14,32,46,15,7,2,11,16,69
401365767,Richmond Spiders,T. Burton,4431914,,True,34.0,5,13,3,9,2,4,12,14,3,9,12,1,1,0,2,4,24
401365767,Richmond Spiders,N. Cayo,4278380,,True,32.0,3,9,3,9,0,0,0,0,5,6,11,4,1,0,0,1,6
401365767,Richmond Spiders,G. Golden,4066836,,True,31.0,6,14,5,12,1,2,1,2,2,8,10,3,0,2,3,2,14
401365767,Richmond Spiders,I. Wilson,4700973,,True,31.0,2,7,2,6,0,1,1,2,0,2,2,2,1,0,3,2,5
401365767,Richmond Spiders,J. Gilyard,4278378,,True,39.0,5,12,3,5,2,7,0,0,2,2,4,4,4,0,2,2,12
401365767,Richmond Spiders,M. Grace,4397192,,False,11.0,2,6,1,2,1,4,1,2,0,1,1,1,0,0,0,3,6
401365767,Richmond Spiders,D. Bailey,4700974,,False,2.0,0,0,0,0,0,0,0,0,0,1,1,0,0,0,1,1,0
401365767,Richmond Spiders,A. Gustavson,4397193,,False,2.0,0,0,0,0,0,0,0,0,0,1,1,0,0,0,0,0,0
401365767,Richmond Spiders,C. Crabtree,4396658,,False,7.0,1,2,1,1,0,1,0,0,0,1,1,0,0,0,0,0,2
401365767,Richmond Spiders,N. Sherod,4066832,,False,11.0,0,2,0,1,0,1,0,0,0,1,1,0,0,0,0,1,0
401365767,Richmond Spiders,TEAM,TOTAL,TOTAL,False,,24,65,18,45,6,20,15,20,14,32,46,15,7,2,11,16,69
401365757,La Salle Explorers,M. Doucoure,4277988,,True,21.0,4,5,4,5,0,0,4,6,3,5,8,0,0,1,0,3,12
401365757,La Salle Explorers,C. Moore,4277945,,True,35.0,12,17,11,14,1,3,1,2,3,5,8,0,2,5,1,0,26
401365757,La Salle Explorers,J. Clark,4397152,,True,31.0,2,8,2,4,0,4,1,2,4,4,8,2,0,0,5,4,5
401365757,La Salle Explorers,J. Brickus,4700970,,True,35.0,1,6,1,3,0,3,2,2,0,2,2,4,1,0,1,4,4
401365757,La Salle Explorers,A. Gill,4700969,,True,6.0,0,2,0,1,0,1,0,0,1,3,4,1,0,0,2,0,0
401365757,La Salle Explorers,M. McFarlane,4897068,,False,19.0,2,6,1,4,1,2,0,2,1,2,3,0,2,1,0,0,5
401365757,La Salle Explorers,D. Shepherd,4710357,,False,7.0,0,0,0,0,0,0,0,0,0,1,1,0,0,0,0,0,0
401365757,La Salle Explorers,K. Brantley,4709132,,False,23.0,2,11,1,8,1,3,1,2,0,5,5,4,1,0,2,4,6
401365757,La Salle Explorers,J. Nickelberry,4432845,,False,23.0,1,5,0,1,1,4,0,0,0,1,1,0,0,0,3,2,3
401365757,La Salle Explorers,TEAM,TOTAL,TOTAL,False,,24,60,20,40,4,20,9,16,13,29,42,11,6,7,14,17,61
401365757,La Salle Explorers,M. Doucoure,4277988,,True,21.0,4,5,4,5,0,0,4,6,3,5,8,0,0,1,0,3,12
401365757,La Salle Explorers,C. Moore,4277945,,True,35.0,12,17,11,14,1,3,1,2,3,5,8,0,2,5,1,0,26
401365757,La Salle Explorers,J. Clark,4397152,,True,31.0,2,8,2,4,0,4,1,2,4,4,8,2,0,0,5,4,5
401365757,La Salle Explorers,J. Brickus,4700970,,True,35.0,1,6,1,3,0,3,2,2,0,2,2,4,1,0,1,4,4
401365757,La Salle Explorers,A. Gill,4700969,,True,6.0,0,2,0,1,0,1,0,0,1,3,4,1,0,0,2,0,0
401365757,La Salle Explorers,M. McFarlane,4897068,,False,19.0,2,6,1,4,1,2,0,2,1,2,3,0,2,1,0,0,5
401365757,La Salle Explorers,D. Shepherd,4710357,,False,7.0,0,0,0,0,0,0,0,0,0,1,1,0,0,0,0,0,0
401365757,La Salle Explorers,K. Brantley,4709132,,False,23.0,2,11,1,8,1,3,1,2,0,5,5,4,1,0,2,4,6
401365757,La Salle Explorers,J. Nickelberry,4432845,,False,23.0,1,5,0,1,1,4,0,0,0,1,1,0,0,0,3,2,3
401365757,La Salle Explorers,TEAM,TOTAL,TOTAL,False,,24,60,20,40,4,20,9,16,13,29,42,11,6,7,14,17,61
401365757,Fordham Rams,C. Ohams,4066856,,True,36.0,7,15,7,15,0,0,1,2,2,9,11,2,0,0,1,1,15
401365757,Fordham Rams,A. Charlton,4897085,,True,35.0,1,7,1,4,0,3,1,2,1,2,3,9,2,0,0,4,3
401365757,Fordham Rams,K. Rose,4592315,,True,22.0,3,6,2,2,1,4,0,0,1,1,2,0,0,0,1,4,7
401365757,Fordham Rams,D. Quisenberry,4397790,,True,35.0,5,9,2,5,3,4,6,6,0,3,3,2,0,0,1,2,19
401365757,Fordham Rams,A. Daye Jr.,4397500,,True,29.0,3,7,2,5,1,2,1,3,0,3,3,3,2,0,8,2,8
401365757,Fordham Rams,A. Tsimbila,4702329,,False,8.0,0,0,0,0,0,0,0,0,0,1,1,0,1,0,0,0,0
401365757,Fordham Rams,K. Cunningham,4705891,,False,11.0,0,5,0,1,0,4,0,0,0,4,4,0,1,0,0,1,0
401365757,Fordham Rams,J. Navarro,4592316,,False,24.0,5,8,0,0,5,8,2,2,1,2,3,0,1,0,0,1,17
401365757,Fordham Rams,TEAM,TOTAL,TOTAL,False,,24,57,14,32,10,25,11,15,6,26,32,16,7,0,11,15,69
401365757,Fordham Rams,C. Ohams,4066856,,True,36.0,7,15,7,15,0,0,1,2,2,9,11,2,0,0,1,1,15
401365757,Fordham Rams,A. Charlton,4897085,,True,35.0,1,7,1,4,0,3,1,2,1,2,3,9,2,0,0,4,3
401365757,Fordham Rams,K. Rose,4592315,,True,22.0,3,6,2,2,1,4,0,0,1,1,2,0,0,0,1,4,7
401365757,Fordham Rams,D. Quisenberry,4397790,,True,35.0,5,9,2,5,3,4,6,6,0,3,3,2,0,0,1,2,19
401365757,Fordham Rams,A. Daye Jr.,4397500,,True,29.0,3,7,2,5,1,2,1,3,0,3,3,3,2,0,8,2,8
401365757,Fordham Rams,A. Tsimbila,4702329,,False,8.0,0,0,0,0,0,0,0,0,0,1,1,0,1,0,0,0,0
401365757,Fordham Rams,K. Cunningham,4705891,,False,11.0,0,5,0,1,0,4,0,0,0,4,4,0,1,0,0,1,0
401365757,Fordham Rams,J. Navarro,4592316,,False,24.0,5,8,0,0,5,8,2,2,1,2,3,0,1,0,0,1,17
401365757,Fordham Rams,TEAM,TOTAL,TOTAL,False,,24,57,14,32,10,25,11,15,6,26,32,16,7,0,11,15,69
401365754,Saint Joseph's Hawks,T. Funk,4278395,,True,37.0,5,10,3,4,2,6,6,7,2,5,7,0,0,0,0,2,18
401365754,Saint Joseph's Hawks,E. Obinna,4278125,,True,33.0,6,11,6,11,0,0,1,2,1,13,14,1,0,2,4,3,13
401365754,Saint Joseph's Hawks,J. Hall,4701031,,True,34.0,4,10,3,7,1,3,4,6,2,6,8,8,2,0,4,1,13
401365754,Saint Joseph's Hawks,E. Reynolds II,4683952,,True,29.0,7,12,4,6,3,6,0,0,0,4,4,1,0,0,3,2,17
401365754,Saint Joseph's Hawks,C. Brown,4592476,,True,34.0,7,11,6,7,1,4,1,2,1,10,11,2,0,1,2,2,16
401365754,Saint Joseph's Hawks,C. Coleman,4431807,,False,6.0,0,0,0,0,0,0,0,0,0,0,0,0,0,0,0,0,0
401365754,Saint Joseph's Hawks,K. Klaczek,4897053,,False,3.0,0,1,0,0,0,1,0,0,0,0,0,0,0,0,0,0,0
401365754,Saint Joseph's Hawks,J. Forrest,4701032,,False,16.0,2,5,1,3,1,2,1,2,0,3,3,0,0,0,0,1,6
401365754,Saint Joseph's Hawks,D. Bishop,4701028,,False,8.0,0,0,0,0,0,0,0,0,0,1,1,0,0,0,2,0,0
401365754,Saint Joseph's Hawks,TEAM,TOTAL,TOTAL,False,,31,60,23,38,8,22,13,19,7,44,51,12,2,3,15,11,83
401365754,Saint Joseph's Hawks,T. Funk,4278395,,True,37.0,5,10,3,4,2,6,6,7,2,5,7,0,0,0,0,2,18
401365754,Saint Joseph's Hawks,E. Obinna,4278125,,True,33.0,6,11,6,11,0,0,1,2,1,13,14,1,0,2,4,3,13
401365754,Saint Joseph's Hawks,J. Hall,4701031,,True,34.0,4,10,3,7,1,3,4,6,2,6,8,8,2,0,4,1,13
401365754,Saint Joseph's Hawks,E. Reynolds II,4683952,,True,29.0,7,12,4,6,3,6,0,0,0,4,4,1,0,0,3,2,17
401365754,Saint Joseph's Hawks,C. Brown,4592476,,True,34.0,7,11,6,7,1,4,1,2,1,10,11,2,0,1,2,2,16
401365754,Saint Joseph's Hawks,C. Coleman,4431807,,False,6.0,0,0,0,0,0,0,0,0,0,0,0,0,0,0,0,0,0
401365754,Saint Joseph's Hawks,K. Klaczek,4897053,,False,3.0,0,1,0,0,0,1,0,0,0,0,0,0,0,0,0,0,0
401365754,Saint Joseph's Hawks,J. Forrest,4701032,,False,16.0,2,5,1,3,1,2,1,2,0,3,3,0,0,0,0,1,6
401365754,Saint Joseph's Hawks,D. Bishop,4701028,,False,8.0,0,0,0,0,0,0,0,0,0,1,1,0,0,0,2,0,0
401365754,Saint Joseph's Hawks,TEAM,TOTAL,TOTAL,False,,31,60,23,38,8,22,13,19,7,44,51,12,2,3,15,11,83
401365754,Richmond Spiders,T. Burton,4431914,,True,31.0,3,10,2,4,1,6,4,4,2,4,6,0,1,0,1,1,11
401365754,Richmond Spiders,N. Cayo,4278380,,True,20.0,2,5,2,5,0,0,0,0,2,0,2,1,0,1,0,1,4
401365754,Richmond Spiders,G. Golden,4066836,,True,26.0,5,17,3,10,2,7,2,2,0,7,7,3,0,0,1,0,14
401365754,Richmond Spiders,I. Wilson,4700973,,True,20.0,2,5,2,4,0,1,1,2,0,1,1,0,3,0,0,4,5
401365754,Richmond Spiders,J. Gilyard,4278378,,True,35.0,2,10,2,7,0,3,0,0,0,4,4,6,4,0,1,4,4
401365754,Richmond Spiders,M. Grace,4397192,,False,14.0,2,9,1,3,1,6,0,0,1,2,3,0,0,2,0,0,5
401365754,Richmond Spiders,D. Bailey,4700974,,False,13.0,1,2,1,2,0,0,1,2,0,1,1,0,1,0,1,2,3
401365754,Richmond Spiders,A. Gustavson,4397193,,False,9.0,1,1,1,1,0,0,0,0,0,2,2,0,0,0,1,0,2
401365754,Richmond Spiders,C. Crabtree,4396658,,False,11.0,0,4,0,1,0,3,0,0,0,3,3,0,0,0,0,1,0
401365754,Richmond Spiders,N. Sherod,4066832,,False,21.0,2,9,0,2,2,7,2,2,2,0,2,0,0,0,0,2,8
401365754,Richmond Spiders,TEAM,TOTAL,TOTAL,False,,20,72,14,39,6,33,10,12,10,26,36,10,9,3,5,15,56
401365754,Richmond Spiders,T. Burton,4431914,,True,31.0,3,10,2,4,1,6,4,4,2,4,6,0,1,0,1,1,11
401365754,Richmond Spiders,N. Cayo,4278380,,True,20.0,2,5,2,5,0,0,0,0,2,0,2,1,0,1,0,1,4
401365754,Richmond Spiders,G. Golden,4066836,,True,26.0,5,17,3,10,2,7,2,2,0,7,7,3,0,0,1,0,14
401365754,Richmond Spiders,I. Wilson,4700973,,True,20.0,2,5,2,4,0,1,1,2,0,1,1,0,3,0,0,4,5
401365754,Richmond Spiders,J. Gilyard,4278378,,True,35.0,2,10,2,7,0,3,0,0,0,4,4,6,4,0,1,4,4
401365754,Richmond Spiders,M. Grace,4397192,,False,14.0,2,9,1,3,1,6,0,0,1,2,3,0,0,2,0,0,5
401365754,Richmond Spiders,D. Bailey,4700974,,False,13.0,1,2,1,2,0,0,1,2,0,1,1,0,1,0,1,2,3
401365754,Richmond Spiders,A. Gustavson,4397193,,False,9.0,1,1,1,1,0,0,0,0,0,2,2,0,0,0,1,0,2
401365754,Richmond Spiders,C. Crabtree,4396658,,False,11.0,0,4,0,1,0,3,0,0,0,3,3,0,0,0,0,1,0
401365754,Richmond Spiders,N. Sherod,4066832,,False,21.0,2,9,0,2,2,7,2,2,2,0,2,0,0,0,0,2,8
401365754,Richmond Spiders,TEAM,TOTAL,TOTAL,False,,20,72,14,39,6,33,10,12,10,26,36,10,9,3,5,15,56
401365753,Saint Louis Billikens,T. Hargrove Jr.,4592484,,True,35.0,7,13,6,8,1,5,2,2,3,4,7,0,3,1,1,2,17
401365753,Saint Louis Billikens,M. Linssen,4279174,,True,13.0,2,7,2,7,0,0,2,2,2,1,3,0,0,0,0,1,6
401365753,Saint Louis Billikens,J. Nesbitt,4714246,,True,37.0,3,13,2,7,1,6,4,6,2,4,6,1,2,1,3,2,11
401365753,Saint Louis Billikens,Y. Collins,4432957,,True,38.0,6,11,5,9,1,2,0,2,1,11,12,8,3,0,6,5,13
401365753,Saint Louis Billikens,G. Jimerson,4432008,,True,36.0,2,6,1,2,1,4,6,6,0,2,2,2,0,0,0,1,11
401365753,Saint Louis Billikens,L. Traore,4897052,,False,1.0,0,0,0,0,0,0,0,0,0,0,0,0,0,0,1,0,0
401365753,Saint Louis Billikens,F. Okoro,4397105,,False,27.0,5,9,5,9,0,0,2,6,6,2,8,0,0,1,0,2,12
401365753,Saint Louis Billikens,F. Thatch Jr.,4397199,,False,9.0,0,1,0,1,0,0,0,0,0,0,0,1,0,0,2,1,0
401365753,Saint Louis Billikens,D. Jones,4278267,,False,4.0,0,0,0,0,0,0,0,0,0,1,1,0,0,0,1,0,0
401365753,Saint Louis Billikens,TEAM,TOTAL,TOTAL,False,,25,60,21,43,4,17,16,24,19,27,46,12,8,3,17,14,70
401365753,Auburn Tigers,J. Smith,4432639,,True,29.0,5,11,2,6,3,5,0,0,0,4,4,0,2,0,2,2,13
401365753,Auburn Tigers,D. Cambridge,4567588,,True,20.0,0,2,0,1,0,1,0,0,1,1,2,1,1,0,2,3,0
401365753,Auburn Tigers,W. Kessler,4433136,,True,30.0,8,12,8,10,0,2,3,4,1,8,9,1,1,4,2,3,19
401365753,Auburn Tigers,K. Johnson,4432363,,True,29.0,3,10,2,6,1,4,4,8,0,0,0,3,2,0,3,1,11
401365753,Auburn Tigers,Z. Jasper,4311618,,True,20.0,2,4,1,1,1,3,0,0,1,0,1,1,0,0,0,2,5
401365753,Auburn Tigers,C. Moore,4433200,,False,8.0,0,0,0,0,0,0,0,0,0,0,0,1,1,0,0,2,0
401365753,Auburn Tigers,J. Williams,4431776,,False,11.0,2,5,2,4,0,1,0,0,0,1,1,0,0,0,0,1,4
401365753,Auburn Tigers,D. Cardwell,4433174,,False,10.0,1,2,1,2,0,0,0,0,1,2,3,1,0,2,0,2,2
401365753,Auburn Tigers,L. Berman,4592748,,False,16.0,2,2,1,1,1,1,0,1,1,0,1,0,0,0,0,4,5
401365753,Auburn Tigers,W. Green Jr.,4433198,,False,27.0,5,12,2,6,3,6,2,2,0,0,0,8,1,0,2,0,15
401365753,Auburn Tigers,TEAM,TOTAL,TOTAL,False,,28,60,19,37,9,23,9,15,8,19,27,16,8,6,11,21,74
401365751,Virginia Tech Hokies,K. Aluma,4280120,,True,37.0,7,15,7,13,0,2,0,2,3,3,6,2,1,0,3,2,14
401365751,Virginia Tech Hokies,J. Mutts,4278693,,True,27.0,3,9,3,5,0,4,2,5,3,7,10,1,0,1,2,4,8
401365751,Virginia Tech Hokies,H. Cattoor,4432954,,True,37.0,4,9,2,3,2,6,4,4,1,5,6,2,2,0,1,1,14
401365751,Virginia Tech Hokies,N. Alleyne,4432934,,True,39.0,1,10,1,6,0,4,0,0,0,2,2,1,1,0,2,0,2
401365751,Virginia Tech Hokies,S. Murphy,4280118,,True,26.0,3,6,1,2,2,4,0,0,0,2,2,5,0,0,3,2,8
401365751,Virginia Tech Hokies,D. N'Guessan,4701984,,False,13.0,2,2,1,1,1,1,1,1,0,1,1,0,0,1,1,3,6
401365751,Virginia Tech Hokies,S. Pedulla,4709131,,False,10.0,1,2,0,1,1,1,2,2,0,2,2,0,1,0,1,2,5
401365751,Virginia Tech Hokies,D. Maddox,4432257,,False,11.0,0,2,0,2,0,0,0,0,1,0,1,0,0,0,0,3,0
401365751,Virginia Tech Hokies,TEAM,TOTAL,TOTAL,False,,21,55,15,33,6,22,9,14,9,23,32,11,5,2,13,17,57
401365751,Dayton Flyers,R.J. Blakney,4700864,,True,29.0,7,9,2,4,5,5,0,0,3,3,6,2,3,0,1,2,19
401365751,Dayton Flyers,T. Camara,4431736,,True,28.0,3,12,3,9,0,3,1,2,0,4,4,1,1,0,6,3,7
401365751,Dayton Flyers,D. Holmes II,4433607,,True,29.0,3,4,3,4,0,0,1,5,2,6,8,1,0,0,1,4,7
401365751,Dayton Flyers,M. Smith,4683861,,True,33.0,3,9,2,6,1,3,0,2,3,2,5,4,2,0,1,3,7
401365751,Dayton Flyers,K. Elvis,4683135,,True,22.0,0,2,0,1,0,1,2,2,0,2,2,1,1,0,2,1,2
401365751,Dayton Flyers,M. Amzil,4711607,,False,22.0,3,5,2,3,1,2,4,4,1,6,7,1,1,0,3,2,11
401365751,Dayton Flyers,Z. Nwokeji,4618121,,False,5.0,0,2,0,1,0,1,0,0,0,2,2,0,1,0,0,2,0
401365751,Dayton Flyers,K. Brea,4591259,,False,9.0,0,3,0,1,0,2,0,0,0,0,0,0,0,0,0,0,0
401365751,Dayton Flyers,E. Weaver,4397139,,False,23.0,2,4,2,3,0,1,5,6,0,1,1,5,0,0,0,1,9
401365751,Dayton Flyers,TEAM,TOTAL,TOTAL,False,,21,50,14,32,7,18,13,21,10,28,38,15,9,0,15,18,62
401365750,Saint Louis Billikens,T. Hargrove Jr.,4592484,,True,29.0,4,10,3,5,1,5,0,0,0,2,2,0,0,1,2,2,9
401365750,Saint Louis Billikens,M. Linssen,4279174,,True,12.0,1,1,1,1,0,0,2,2,2,1,3,0,0,0,2,4,4
401365750,Saint Louis Billikens,J. Nesbitt,4714246,,True,27.0,4,9,1,3,3,6,0,0,0,2,2,0,2,0,3,5,11
401365750,Saint Louis Billikens,Y. Collins,4432957,,True,38.0,5,5,4,4,1,1,3,5,0,4,4,19,2,0,2,1,14
401365750,Saint Louis Billikens,G. Jimerson,4432008,,True,38.0,6,18,1,5,5,13,2,2,0,1,1,1,0,0,1,0,19
401365750,Saint Louis Billikens,F. Okoro,4397105,,False,28.0,7,8,7,8,0,0,3,3,1,5,6,0,1,3,2,4,17
401365750,Saint Louis Billikens,F. Thatch Jr.,4397199,,False,20.0,2,3,1,2,1,1,0,0,1,5,6,0,0,0,1,2,5
401365750,Saint Louis Billikens,D. Jones,4278267,,False,8.0,0,1,0,0,0,1,0,0,2,0,2,0,0,0,1,1,0
401365750,Saint Louis Billikens,TEAM,TOTAL,TOTAL,False,,29,55,18,28,11,27,10,12,6,25,31,20,5,4,15,19,79
401365750,Boston College Eagles,T.J. Bickerstaff,4592778,,True,27.0,3,8,3,7,0,1,0,0,2,2,4,1,0,0,1,2,6
401365750,Boston College Eagles,J. Karnik,4280080,,True,22.0,2,5,2,4,0,1,0,0,3,2,5,0,1,0,1,3,4
401365750,Boston College Eagles,J. Zackery,4896615,,True,36.0,5,11,4,8,1,3,1,2,0,4,4,5,3,0,3,2,12
401365750,Boston College Eagles,D. Langford Jr.,4433165,,True,38.0,3,6,3,6,0,0,8,10,3,2,5,2,4,1,2,0,14
401365750,Boston College Eagles,M. Ashton-Langford,4278574,,True,36.0,6,14,5,10,1,4,5,6,0,0,0,3,0,0,1,5,18
401365750,Boston College Eagles,G. Thompson,4684304,,False,2.0,0,0,0,0,0,0,0,0,0,0,0,0,0,0,0,0,0
401365750,Boston College Eagles,Q. Post,4593016,,False,23.0,4,8,4,5,0,3,1,2,0,2,2,2,2,1,0,4,9
401365750,Boston College Eagles,K. Jones,4791225,,False,16.0,2,7,1,2,1,5,0,0,0,3,3,1,0,0,3,1,5
401365750,Boston College Eagles,TEAM,TOTAL,TOTAL,False,,25,59,22,42,3,17,15,20,11,21,32,14,10,2,11,17,68
401365749,Saint Louis Billikens,T. Hargrove Jr.,4592484,,True,28.0,2,8,1,4,1,4,0,0,1,4,5,0,0,0,2,1,5
401365749,Saint Louis Billikens,M. Linssen,4279174,,True,26.0,4,7,4,7,0,0,1,2,1,6,7,2,1,1,1,4,9
401365749,Saint Louis Billikens,J. Nesbitt,4714246,,True,28.0,2,4,2,3,0,1,3,6,3,2,5,2,2,1,1,3,7
401365749,Saint Louis Billikens,Y. Collins,4432957,,True,37.0,5,13,5,11,0,2,1,3,0,5,5,6,2,0,6,1,11
401365749,Saint Louis Billikens,G. Jimerson,4432008,,True,38.0,8,17,5,12,3,5,2,2,2,0,2,1,0,0,1,0,21
401365749,Saint Louis Billikens,L. Traore,4897052,,False,9.0,1,2,1,2,0,0,2,2,0,1,1,0,0,1,2,0,4
401365749,Saint Louis Billikens,F. Okoro,4397105,,False,5.0,1,3,1,3,0,0,0,0,2,0,2,0,1,0,1,2,2
401365749,Saint Louis Billikens,F. Thatch Jr.,4397199,,False,15.0,0,1,0,1,0,0,0,0,0,5,5,1,1,0,0,1,0
401365749,Saint Louis Billikens,D. Jones,4278267,,False,14.0,0,3,0,1,0,2,0,0,0,3,3,0,0,0,0,0,0
401365749,Saint Louis Billikens,TEAM,TOTAL,TOTAL,False,,23,58,19,44,4,14,9,15,13,27,40,12,7,3,14,12,59
401365749,Belmont Bruins,N. Muszynski,4279923,,True,25.0,5,13,5,10,0,3,2,4,2,4,6,1,0,4,3,1,12
401365749,Belmont Bruins,W. Richard,4897262,,True,31.0,6,9,3,3,3,6,0,0,0,6,6,0,1,0,2,1,15
401365749,Belmont Bruins,B. Sheppard,4433076,,True,35.0,3,11,1,4,2,7,1,2,2,3,5,0,4,0,1,3,9
401365749,Belmont Bruins,L. Smith,4402243,,True,28.0,0,3,0,1,0,2,0,0,0,0,0,4,2,0,0,2,0
401365749,Belmont Bruins,G. Murphy,4279920,,True,35.0,6,11,6,8,0,3,2,2,2,6,8,9,3,1,3,2,14
401365749,Belmont Bruins,E. Brauns,4703219,,False,4.0,0,0,0,0,0,0,0,0,0,1,1,0,0,0,0,0,0
401365749,Belmont Bruins,F. Jakubicek,4703221,,False,10.0,3,3,3,3,0,0,0,0,1,1,2,0,1,0,0,0,6
401365749,Belmont Bruins,C. Hollander,4279921,,False,3.0,1,2,1,2,0,0,0,0,0,0,0,0,0,0,1,1,2
401365749,Belmont Bruins,J. Wood,4703220,,False,13.0,1,3,1,2,0,1,1,1,0,0,0,1,0,0,2,1,3
401365749,Belmont Bruins,EJ Bellinger,4593461,,False,3.0,0,0,0,0,0,0,0,0,0,0,0,0,0,0,0,0,0
401365749,Belmont Bruins,T. Pierson,4279922,,False,13.0,1,4,0,2,1,2,0,0,0,2,2,1,2,0,0,1,3
401365749,Belmont Bruins,TEAM,TOTAL,TOTAL,False,,26,59,20,35,6,24,6,9,8,24,32,16,13,5,12,12,64
401365748,St. Bonaventure Bonnies,O. Osunniyi,4397224,,True,26.0,7,9,7,9,0,0,0,0,5,2,7,1,0,4,2,3,14
401365748,St. Bonaventure Bonnies,J. Adaway,4279431,,True,39.0,5,12,3,9,2,3,4,4,1,10,11,0,1,2,2,0,16
401365748,St. Bonaventure Bonnies,J. Holmes,4701016,,True,40.0,3,17,3,15,0,2,2,3,0,3,3,8,1,1,1,1,8
401365748,St. Bonaventure Bonnies,Q. Adams,4585591,,True,20.0,2,4,2,3,0,1,2,2,0,2,2,0,1,0,2,1,6
401365748,St. Bonaventure Bonnies,D. Welch,4397221,,True,40.0,2,8,0,1,2,7,2,2,1,8,9,2,0,2,5,4,8
401365748,St. Bonaventure Bonnies,A. Coulibaly,4432889,,False,14.0,3,4,3,4,0,0,0,0,1,3,4,0,0,0,2,2,6
401365748,St. Bonaventure Bonnies,L. Brown,4897047,,False,20.0,3,5,1,1,2,4,2,3,0,2,2,1,0,0,0,1,10
401365748,St. Bonaventure Bonnies,J. Saizonou,4897046,,False,1.0,0,0,0,0,0,0,0,0,0,0,0,0,0,0,1,2,0
401365748,St. Bonaventure Bonnies,TEAM,TOTAL,TOTAL,False,,25,59,19,42,6,17,12,14,11,31,42,12,3,9,15,14,68
401365748,Buffalo Bulls,D. Skogman,4593409,,True,23.0,2,3,1,1,1,2,0,0,0,4,4,0,0,0,0,2,5
401365748,Buffalo Bulls,J. Williams,4397821,,True,31.0,10,19,9,14,1,5,2,2,1,1,2,1,4,1,6,3,23
401365748,Buffalo Bulls,J. Mballa,4397084,,True,26.0,1,7,1,6,0,1,0,0,2,1,3,0,1,0,1,3,2
401365748,Buffalo Bulls,R. Segu,4397820,,True,38.0,5,17,3,13,2,4,1,3,3,3,6,4,1,0,1,1,13
401365748,Buffalo Bulls,M. Jack,4278495,,True,27.0,4,10,2,4,2,6,1,1,0,4,4,1,1,2,1,3,11
401365748,Buffalo Bulls,T. Fagan,4397823,,False,17.0,3,4,3,3,0,1,1,1,1,6,7,1,2,2,1,0,7
401365748,Buffalo Bulls,L. Hardnett,4396610,,False,17.0,0,0,0,0,0,0,1,2,1,2,3,0,1,1,0,2,1
401365748,Buffalo Bulls,C. Jones,4898369,,False,10.0,0,1,0,0,0,1,0,0,0,0,0,1,0,0,0,1,0
401365748,Buffalo Bulls,K. Brewton,4593881,,False,11.0,1,4,0,0,1,4,0,0,0,1,1,1,1,0,1,0,3
401365748,Buffalo Bulls,TEAM,TOTAL,TOTAL,False,,26,65,19,41,7,24,6,9,11,23,34,9,11,6,11,15,65
401365747,Villanova Wildcats,E. Dixon,4431718,,True,21.0,5,7,4,6,1,1,0,0,5,3,8,2,0,1,1,3,11
401365747,Villanova Wildcats,B. Slater,4397133,,True,29.0,5,12,4,5,1,7,1,2,0,5,5,1,0,0,2,1,12
401365747,Villanova Wildcats,J. Samuels,4278588,,True,26.0,2,6,2,5,0,1,4,6,1,5,6,0,1,2,3,3,8
401365747,Villanova Wildcats,J. Moore,4592491,,True,27.0,3,7,2,4,1,3,2,2,0,4,4,1,1,0,3,2,9
401365747,Villanova Wildcats,C. Gillespie,4278585,,True,29.0,4,10,1,2,3,8,2,2,1,5,6,5,1,0,2,1,13
401365747,Villanova Wildcats,T. Patterson,4713885,,False,15.0,0,1,0,1,0,0,0,1,2,3,5,0,0,0,1,1,0
401365747,Villanova Wildcats,N. Njoku,4433274,,False,1.0,0,0,0,0,0,0,0,0,0,0,0,0,0,0,0,1,0
401365747,Villanova Wildcats,D. Cosby-Roundtree,4278586,,False,5.0,1,1,1,1,0,0,0,0,2,0,2,1,0,0,0,1,2
401365747,Villanova Wildcats,K. Voigt,4702030,,False,1.0,0,0,0,0,0,0,0,0,0,0,0,0,0,0,0,0,0
401365747,Villanova Wildcats,C. Arcidiacono,4592490,,False,21.0,2,5,0,1,2,4,0,0,0,3,3,0,1,0,0,1,6
401365747,Villanova Wildcats,C. Daniels,4278373,,False,25.0,3,9,0,2,3,7,2,2,1,6,7,1,0,0,1,3,11
401365747,Villanova Wildcats,TEAM,TOTAL,TOTAL,False,,25,58,14,27,11,31,11,15,13,37,50,11,4,3,14,17,72
401365747,La Salle Explorers,C. Moore,4277945,,True,20.0,0,4,0,3,0,1,3,4,1,4,5,1,0,1,1,3,3
401365747,La Salle Explorers,J. Brickus,4700970,,True,31.0,5,13,3,7,2,6,1,1,1,0,1,0,1,0,3,2,13
401365747,La Salle Explorers,C. Ray,4592448,,True,23.0,0,1,0,0,0,1,0,0,1,2,3,0,1,0,0,4,0
401365747,La Salle Explorers,J. Nickelberry,4432845,,True,20.0,0,7,0,4,0,3,2,2,0,2,2,0,0,0,0,0,2
401365747,La Salle Explorers,S. Kenney,4431790,,True,25.0,2,8,1,4,1,4,2,4,0,2,2,0,0,0,3,2,7
401365747,La Salle Explorers,M. Doucoure,4277988,,False,6.0,0,2,0,2,0,0,0,0,1,1,2,0,1,0,0,0,0
401365747,La Salle Explorers,J. Clark,4397152,,False,20.0,1,4,1,3,0,1,0,0,1,3,4,0,0,0,0,0,2
401365747,La Salle Explorers,T. Izay,4700971,,False,10.0,0,1,0,1,0,0,0,0,2,2,4,0,0,0,0,0,0
401365747,La Salle Explorers,K. Brantley,4709132,,False,26.0,5,10,2,6,3,4,4,5,0,3,3,0,1,0,2,3,17
401365747,La Salle Explorers,A. Gill,4700969,,False,19.0,1,5,1,4,0,1,0,0,0,0,0,0,1,1,2,3,2
401365747,La Salle Explorers,TEAM,TOTAL,TOTAL,False,,14,55,8,34,6,21,12,16,7,23,30,1,5,2,11,17,46
401365746,Rutgers Scarlet Knights,J. Jones,4712921,,True,19.0,5,11,4,6,1,5,0,0,3,1,4,0,0,0,0,1,11
401365746,Rutgers Scarlet Knights,R. Harper Jr.,4397251,,True,32.0,4,10,3,5,1,5,2,2,0,5,5,5,0,0,4,3,11
401365746,Rutgers Scarlet Knights,C. Omoruyi,4433155,,True,27.0,7,9,7,9,0,0,2,4,2,6,8,2,0,1,0,4,16
401365746,Rutgers Scarlet Knights,P. Mulcahy,4432849,,True,36.0,5,10,4,8,1,2,0,0,0,5,5,6,0,0,1,1,11
401365746,Rutgers Scarlet Knights,C. McConnell,4397249,,True,35.0,3,7,3,7,0,0,0,1,2,4,6,9,6,0,1,2,6
401365746,Rutgers Scarlet Knights,M. Mag,4602948,,False,22.0,5,7,5,7,0,0,2,2,3,1,4,0,1,1,3,3,12
401365746,Rutgers Scarlet Knights,O. Palmquist,4600664,,False,7.0,0,1,0,0,0,1,2,2,0,0,0,1,2,0,0,2,2
401365746,Rutgers Scarlet Knights,A. Hyatt,4396975,,False,9.0,0,2,0,2,0,0,0,0,0,1,1,1,0,0,0,1,0
401365746,Rutgers Scarlet Knights,R. Gonzales-Agee,4074930,,False,13.0,5,5,5,5,0,0,4,4,0,1,1,1,0,0,0,0,14
401365746,Rutgers Scarlet Knights,TEAM,TOTAL,TOTAL,False,,34,62,31,49,3,13,12,15,10,26,36,25,9,2,10,17,83
401365746,Massachusetts Minutemen,D. Dominguez,4701126,,True,5.0,1,2,0,0,1,2,0,0,0,1,1,0,0,0,0,1,3
401365746,Massachusetts Minutemen,T. Buttrick,4277981,,True,25.0,2,4,1,1,1,3,2,2,0,0,0,2,1,1,3,1,7
401365746,Massachusetts Minutemen,N. Fernandes,4431791,,True,39.0,3,6,1,2,2,4,8,9,0,0,0,11,1,0,2,3,16
401365746,Massachusetts Minutemen,C.J. Kelly,4398208,,True,27.0,7,12,2,5,5,7,5,5,1,3,4,1,0,0,0,1,24
401365746,Massachusetts Minutemen,R. Kelly,4279741,,True,26.0,4,7,0,0,4,7,0,0,0,1,1,2,3,0,3,1,12
401365746,Massachusetts Minutemen,D. Walker,4399103,,False,15.0,0,2,0,0,0,2,1,2,0,4,4,1,0,0,0,1,1
401365746,Massachusetts Minutemen,M. Steadman,4397393,,False,9.0,1,4,1,4,0,0,0,0,1,1,2,0,0,0,0,2,2
401365746,Massachusetts Minutemen,G. Jones,4279211,,False,26.0,2,6,1,4,1,2,2,2,1,5,6,0,0,0,0,1,7
401365746,Massachusetts Minutemen,J. Garcia,4701125,,False,11.0,1,2,1,1,0,1,0,2,1,3,4,0,1,0,0,1,2
401365746,Massachusetts Minutemen,T.J. Weeks,4433108,,False,17.0,3,6,1,2,2,4,3,5,0,1,1,1,0,0,1,0,11
401365746,Massachusetts Minutemen,TEAM,TOTAL,TOTAL,False,,24,51,8,19,16,32,21,27,4,20,24,18,6,1,9,12,85
401365745,Rhode Island Rams,Makhel Mitchell,4431777,,True,30.0,4,6,4,6,0,0,0,0,1,6,7,2,1,8,4,3,8
401365745,Rhode Island Rams,Makhi Mitchell,4431708,,True,26.0,4,4,3,3,1,1,1,3,0,8,8,2,0,2,4,5,10
401365745,Rhode Island Rams,I. Leggett,4606837,,True,24.0,0,5,0,4,0,1,3,6,1,1,2,3,1,0,0,3,3
401365745,Rhode Island Rams,I. El-Amin,4279313,,True,27.0,4,8,2,3,2,5,2,2,0,1,1,1,0,0,0,2,12
401365745,Rhode Island Rams,J. Sheppard,4066445,,True,31.0,2,7,0,3,2,4,3,3,0,1,1,3,2,0,2,3,9
401365745,Rhode Island Rams,A. Walker,4278567,,False,18.0,0,4,0,2,0,2,0,2,1,0,1,2,1,3,0,1,0
401365745,Rhode Island Rams,M. Martin,4397470,,False,23.0,2,3,1,2,1,1,2,2,1,2,3,0,2,0,1,3,7
401365745,Rhode Island Rams,J. Carey,4395673,,False,12.0,3,3,3,3,0,0,2,2,0,3,3,1,1,0,3,1,8
401365745,Rhode Island Rams,S. Thomas,4897065,,False,9.0,0,3,0,1,0,2,0,0,0,2,2,2,0,0,0,1,0
401365745,Rhode Island Rams,TEAM,TOTAL,TOTAL,False,,19,43,13,27,6,16,13,20,5,24,29,16,8,13,14,22,57
401365745,Boston College Eagles,T.J. Bickerstaff,4592778,,True,35.0,7,14,5,11,2,3,6,7,8,7,15,0,3,2,2,2,22
401365745,Boston College Eagles,Q. Post,4593016,,True,33.0,4,14,4,13,0,1,3,3,2,2,4,1,0,0,3,4,11
401365745,Boston College Eagles,J. Zackery,4896615,,True,39.0,2,9,1,5,1,4,2,4,0,3,3,1,0,0,0,3,7
401365745,Boston College Eagles,D. Langford Jr.,4433165,,True,39.0,1,8,1,8,0,0,0,2,4,3,7,2,1,1,0,0,2
401365745,Boston College Eagles,M. Ashton-Langford,4278574,,True,38.0,0,6,0,3,0,3,5,6,0,4,4,5,3,1,4,4,5
401365745,Boston College Eagles,A. Kenny,4592183,,False,1.0,0,0,0,0,0,0,0,0,0,0,0,0,0,0,0,0,0
401365745,Boston College Eagles,F. Scott,3922033,,False,5.0,0,3,0,2,0,1,0,0,1,1,2,0,0,0,0,2,0
401365745,Boston College Eagles,J. Karnik,4280080,,False,7.0,0,2,0,2,0,0,2,2,0,1,1,0,0,0,2,3,2
401365745,Boston College Eagles,K. Jones,4791225,,False,3.0,0,0,0,0,0,0,0,0,0,0,0,0,0,0,0,0,0
401365745,Boston College Eagles,TEAM,TOTAL,TOTAL,False,,14,56,11,44,3,12,18,24,19,23,42,9,7,4,13,18,49
401365744,Penn State Nittany Lions,J. Harrar,4277980,,True,24.0,3,8,3,8,0,0,2,4,3,9,12,0,0,0,4,4,8
401365744,Penn State Nittany Lions,S. Lundy,4431775,,True,27.0,4,7,2,3,2,4,4,4,0,4,4,1,0,0,2,2,14
401365744,Penn State Nittany Lions,J. Pickett,4398390,,True,34.0,2,9,2,7,0,2,3,3,1,1,2,7,0,0,2,2,7
401365744,Penn State Nittany Lions,S. Sessoms,4395880,,True,22.0,4,8,3,7,1,1,3,4,1,2,3,0,1,0,3,3,12
401365744,Penn State Nittany Lions,J. Cornwall,4278690,,True,29.0,1,4,1,2,0,2,2,2,0,2,2,3,0,0,1,0,4
401365744,Penn State Nittany Lions,C. Dorsey,4581505,,False,6.0,0,0,0,0,0,0,0,0,0,0,0,0,0,0,1,0,0
401365744,Penn State Nittany Lions,J. White,4279478,,False,21.0,3,6,3,6,0,0,0,0,3,3,6,0,1,0,0,2,6
401365744,Penn State Nittany Lions,D. Johnson,4433567,,False,11.0,1,4,1,2,0,2,0,0,0,1,1,0,0,0,0,2,2
401365744,Penn State Nittany Lions,M. Dread,4397239,,False,26.0,1,5,0,1,1,4,0,1,1,2,3,0,0,0,1,3,3
401365744,Penn State Nittany Lions,TEAM,TOTAL,TOTAL,False,,19,51,15,36,4,15,14,18,10,25,35,11,2,0,15,18,56
401365744,Massachusetts Minutemen,D. Dominguez,4701126,,True,22.0,2,3,1,1,1,2,0,0,1,2,3,0,0,0,1,2,5
401365744,Massachusetts Minutemen,T. Buttrick,4277981,,True,37.0,4,12,1,4,3,8,8,9,3,6,9,6,3,2,1,1,19
401365744,Massachusetts Minutemen,T.J. Weeks,4433108,,True,16.0,0,4,0,2,0,2,0,0,0,3,3,0,0,0,0,2,0
401365744,Massachusetts Minutemen,N. Fernandes,4431791,,True,29.0,5,8,5,6,0,2,3,3,0,2,2,3,2,0,2,3,13
401365744,Massachusetts Minutemen,R. Kelly,4279741,,True,35.0,6,10,2,3,4,7,1,2,0,1,1,4,1,0,2,1,17
401365744,Massachusetts Minutemen,D. Walker,4399103,,False,15.0,4,6,2,3,2,3,0,3,2,2,4,0,0,0,0,2,10
401365744,Massachusetts Minutemen,G. Jones,4279211,,False,6.0,0,1,0,1,0,0,0,0,0,0,0,0,0,0,1,3,0
401365744,Massachusetts Minutemen,K. Mitchell,4592454,,False,9.0,0,1,0,1,0,0,0,0,1,0,1,0,0,0,0,2,0
401365744,Massachusetts Minutemen,C.J. Kelly,4398208,,False,31.0,5,9,2,4,3,5,4,6,0,3,3,1,2,0,1,2,17
401365744,Massachusetts Minutemen,TEAM,TOTAL,TOTAL,False,,26,54,13,25,13,29,16,23,7,22,29,14,8,2,8,18,81
401365297,Massachusetts Minutemen,G. Jones,4279211,,True,35.0,2,4,1,2,1,2,2,2,2,4,6,2,0,1,0,1,7
401365297,Massachusetts Minutemen,T. Buttrick,4277981,,True,29.0,3,10,3,5,0,5,0,2,1,3,4,1,1,1,2,1,6
401365297,Massachusetts Minutemen,K. Mitchell,4592454,,True,18.0,2,2,2,2,0,0,2,2,0,0,0,1,2,0,3,2,6
401365297,Massachusetts Minutemen,C.J. Kelly,4398208,,True,41.0,5,17,5,13,0,4,3,4,1,4,5,3,0,1,1,3,13
401365297,Massachusetts Minutemen,R. Kelly,4279741,,True,35.0,3,8,1,5,2,3,4,7,2,4,6,2,1,0,1,2,12
401365297,Massachusetts Minutemen,M. Steadman,4397393,,False,26.0,8,11,8,10,0,1,4,6,1,3,4,1,0,0,1,5,20
401365297,Massachusetts Minutemen,J. Garcia,4701125,,False,34.0,6,11,6,9,0,2,1,3,1,2,3,0,4,1,0,1,13
401365297,Massachusetts Minutemen,P. Santos,4432104,,False,7.0,0,0,0,0,0,0,0,0,0,0,0,1,0,0,0,0,0
401365297,Massachusetts Minutemen,TEAM,TOTAL,TOTAL,False,,29,63,26,46,3,17,16,26,11,22,33,11,8,4,9,15,77
401365297,Fairfield Stags,S. Cook,4702946,,True,34.0,6,11,6,11,0,0,3,4,4,9,13,1,2,0,3,4,15
401365297,Fairfield Stags,A. Jeanne-Rose,4593277,,True,31.0,8,11,8,10,0,1,5,7,0,3,3,1,1,2,3,0,21
401365297,Fairfield Stags,Z. Crisler,4431936,,True,17.0,3,3,1,1,2,2,0,0,2,2,4,0,1,0,2,0,8
401365297,Fairfield Stags,C. Green,4280068,,True,40.0,4,9,3,7,1,2,0,0,1,1,2,2,0,0,3,4,9
401365297,Fairfield Stags,T. Benning,4279483,,True,33.0,2,8,2,6,0,2,0,0,0,4,4,2,0,0,2,4,4
401365297,Fairfield Stags,C. Maidoh,4593276,,False,11.0,0,1,0,1,0,0,2,2,0,3,3,0,1,1,1,2,2
401365297,Fairfield Stags,TJ Long,4896370,,False,6.0,0,2,0,1,0,1,1,2,0,1,1,1,0,0,1,0,1
401365297,Fairfield Stags,J. Wojcik,4397191,,False,25.0,2,9,1,6,1,3,0,1,1,0,1,2,0,0,0,3,5
401365297,Fairfield Stags,J. Cruz,4279488,,False,28.0,4,9,4,8,0,1,0,0,1,5,6,3,1,0,1,3,8
401365297,Fairfield Stags,TEAM,TOTAL,TOTAL,False,,29,63,25,51,4,12,11,16,13,28,41,12,6,3,16,20,73
401365237,Saint Joseph's Hawks,K. Klaczek,4897053,,True,20.0,0,3,0,2,0,1,0,0,1,1,2,2,0,1,2,4,0
401365237,Saint Joseph's Hawks,T. Funk,4278395,,True,33.0,4,11,0,1,4,10,4,4,0,5,5,0,1,0,2,2,16
401365237,Saint Joseph's Hawks,E. Obinna,4278125,,True,16.0,1,3,1,3,0,0,1,4,3,1,4,0,2,0,0,0,3
401365237,Saint Joseph's Hawks,J. Hall,4701031,,True,32.0,7,15,3,7,4,8,6,9,4,6,10,5,1,0,3,2,24
401365237,Saint Joseph's Hawks,E. Reynolds II,4683952,,True,28.0,3,7,2,4,1,3,6,6,0,1,1,1,2,0,1,4,13
401365237,Saint Joseph's Hawks,C. Coleman,4431807,,False,19.0,1,2,1,1,0,1,0,0,2,5,7,1,1,0,0,0,2
401365237,Saint Joseph's Hawks,J. Forrest,4701032,,False,5.0,0,3,0,1,0,2,0,0,0,0,0,0,0,0,0,4,0
401365237,Saint Joseph's Hawks,D. Bishop,4701028,,False,24.0,4,8,1,3,3,5,1,2,1,2,3,1,0,3,0,1,12
401365237,Saint Joseph's Hawks,C. Brown,4592476,,False,23.0,2,9,1,2,1,7,0,0,0,2,2,2,0,0,3,2,5
401365237,Saint Joseph's Hawks,TEAM,TOTAL,TOTAL,False,,22,61,9,24,13,37,18,25,11,23,34,12,7,4,11,19,75
401365237,Monmouth Hawks,N. Rutty,4398408,,True,38.0,1,1,1,1,0,0,0,0,2,8,10,0,0,0,0,4,2
401365237,Monmouth Hawks,W. Miller,4277910,,True,38.0,5,13,3,10,2,3,3,3,4,8,12,2,1,1,5,2,15
401365237,Monmouth Hawks,M. McClary,4279736,,True,37.0,11,17,9,15,2,2,0,0,2,5,7,1,1,0,2,1,24
401365237,Monmouth Hawks,G. Papas,4279735,,True,39.0,5,9,3,5,2,4,6,7,0,6,6,3,1,2,1,2,18
401365237,Monmouth Hawks,S. Reynolds,4278578,,True,36.0,7,16,5,12,2,4,9,9,0,4,4,1,0,0,3,3,25
401365237,Monmouth Hawks,M. Foster,4703425,,False,4.0,1,2,1,2,0,0,0,0,1,1,2,0,0,0,0,0,2
401365237,Monmouth Hawks,M. Ruth,4703427,,False,6.0,0,4,0,2,0,2,1,2,1,1,2,0,1,0,0,4,1
401365237,Monmouth Hawks,S. Chaput,4398409,,False,2.0,0,0,0,0,0,0,0,0,0,0,0,0,0,0,0,0,0
401365237,Monmouth Hawks,TEAM,TOTAL,TOTAL,False,,30,62,22,47,8,15,19,21,10,33,43,7,4,3,12,16,87
401365222,St. Bonaventure Bonnies,O. Osunniyi,4397224,,True,13.0,2,4,2,4,0,0,1,1,0,4,4,0,0,2,2,0,5
401365222,St. Bonaventure Bonnies,J. Adaway,4279431,,True,37.0,7,12,7,11,0,1,2,2,1,5,6,2,0,0,1,1,16
401365222,St. Bonaventure Bonnies,J. Holmes,4701016,,True,35.0,5,10,5,6,0,4,7,11,0,9,9,3,2,0,5,3,17
401365222,St. Bonaventure Bonnies,D. Welch,4397221,,True,37.0,2,5,1,1,1,4,2,2,3,2,5,2,1,3,2,2,7
401365222,St. Bonaventure Bonnies,K. Lofton,4397220,,True,40.0,4,15,3,9,1,6,8,9,0,5,5,4,2,0,2,3,17
401365222,St. Bonaventure Bonnies,O. Durosinmi,4684462,,False,2.0,0,0,0,0,0,0,0,0,0,1,1,0,0,0,0,1,0
401365222,St. Bonaventure Bonnies,A. Coulibaly,4432889,,False,25.0,3,6,3,6,0,0,1,2,1,0,1,0,0,3,1,4,7
401365222,St. Bonaventure Bonnies,L. Brown,4897047,,False,5.0,0,0,0,0,0,0,0,0,0,0,0,0,0,0,0,1,0
401365222,St. Bonaventure Bonnies,Q. Adams,4585591,,False,6.0,0,1,0,1,0,0,0,0,0,1,1,0,0,0,1,1,0
401365222,St. Bonaventure Bonnies,TEAM,TOTAL,TOTAL,False,,23,53,21,38,2,15,21,27,8,29,37,11,5,8,14,16,69
401365222,Canisius Golden Griffins,J. Fritz,4593148,,True,33.0,3,7,3,7,0,0,4,5,6,5,11,2,0,0,2,5,10
401365222,Canisius Golden Griffins,M. Green,4279878,,True,30.0,6,16,5,13,1,3,1,1,4,4,8,1,2,0,3,4,14
401365222,Canisius Golden Griffins,A. Fofana,4702949,,True,34.0,3,9,3,4,0,5,4,4,1,2,3,4,0,0,2,2,10
401365222,Canisius Golden Griffins,A. Harried,4593149,,True,24.0,2,11,0,5,2,6,2,2,1,2,3,0,0,0,0,3,8
401365222,Canisius Golden Griffins,J. Henderson,4398046,,True,26.0,3,6,1,3,2,3,0,0,0,0,0,1,0,0,2,4,8
401365222,Canisius Golden Griffins,G. Maslennikov,4702952,,False,2.0,0,1,0,1,0,0,0,0,0,0,0,0,0,0,0,0,0
401365222,Canisius Golden Griffins,S. Hitchon,4279482,,False,9.0,0,3,0,2,0,1,0,0,1,0,1,0,0,0,2,1,0
401365222,Canisius Golden Griffins,X. Long,4896367,,False,6.0,0,2,0,1,0,1,0,0,0,1,1,0,0,0,1,2,0
401365222,Canisius Golden Griffins,S. Uijtendaal,4702950,,False,19.0,1,4,0,0,1,4,0,0,1,3,4,0,0,0,2,2,3
401365222,Canisius Golden Griffins,A. Ahemed,4593147,,False,17.0,3,7,2,2,1,5,0,0,0,3,3,2,1,0,1,0,7
401365222,Canisius Golden Griffins,TEAM,TOTAL,TOTAL,False,,21,66,14,38,7,28,11,12,15,21,36,10,3,0,15,23,60
401365213,Manhattan Jaspers,J. Roberts,4397122,,True,16.0,3,5,3,5,0,0,0,0,0,2,2,1,0,1,1,2,6
401365213,Manhattan Jaspers,W. Williams,4279701,,True,25.0,4,8,4,8,0,0,6,10,3,3,6,0,3,2,2,1,14
401365213,Manhattan Jaspers,E. Buchanan,4398103,,True,36.0,8,13,8,13,0,0,1,2,2,5,7,1,6,0,6,3,17
401365213,Manhattan Jaspers,J. Perez,4397528,,True,34.0,3,16,3,14,0,2,4,9,2,3,5,7,0,1,4,2,10
401365213,Manhattan Jaspers,A. Nelson,4397118,,True,19.0,1,3,1,2,0,1,0,0,1,1,2,0,0,0,4,3,2
401365213,Manhattan Jaspers,A. Cisse,4593329,,False,1.0,0,0,0,0,0,0,0,0,0,0,0,0,0,0,0,1,0
401365213,Manhattan Jaspers,S. Diallo,4397161,,False,19.0,1,3,1,2,0,1,2,2,2,4,6,1,3,0,0,4,4
401365213,Manhattan Jaspers,N. Brennen,4703175,,False,9.0,0,4,0,3,0,1,0,0,4,1,5,1,0,0,0,0,0
401365213,Manhattan Jaspers,M. Watson,4703172,,False,10.0,0,0,0,0,0,0,0,0,0,0,0,2,1,0,0,1,0
401365213,Manhattan Jaspers,S. Stewart,4398104,,False,31.0,3,7,1,1,2,6,5,6,0,2,2,2,1,0,1,2,13
401365213,Manhattan Jaspers,TEAM,TOTAL,TOTAL,False,,23,59,21,48,2,11,18,29,15,22,37,15,14,4,19,19,66
401365213,Fordham Rams,C. Ohams,4066856,,True,29.0,5,10,5,10,0,0,7,8,4,14,18,1,1,1,8,4,17
401365213,Fordham Rams,A. Charlton,4897085,,True,37.0,4,10,4,7,0,3,0,1,0,4,4,1,1,0,2,4,8
401365213,Fordham Rams,K. Rose,4592315,,True,21.0,0,4,0,2,0,2,0,0,1,1,2,1,2,1,1,2,0
401365213,Fordham Rams,D. Quisenberry,4397790,,True,39.0,5,8,3,4,2,4,0,0,0,2,2,1,1,0,4,1,12
401365213,Fordham Rams,A. Daye Jr.,4397500,,True,38.0,6,12,6,11,0,1,6,7,0,5,5,3,3,0,7,5,18
401365213,Fordham Rams,A. Tsimbila,4702329,,False,7.0,0,0,0,0,0,0,0,0,0,1,1,0,0,1,0,2,0
401365213,Fordham Rams,R. Novitskyi,4897084,,False,11.0,1,4,1,3,0,1,0,0,3,0,3,0,0,1,3,5,2
401365213,Fordham Rams,J. Navarro,4592316,,False,18.0,1,4,0,0,1,4,0,0,1,0,1,3,1,0,0,3,3
401365213,Fordham Rams,TEAM,TOTAL,TOTAL,False,,22,52,19,37,3,15,13,16,10,30,40,10,9,4,26,26,60
401365208,St. Bonaventure Bonnies,O. Osunniyi,4397224,,True,21.0,4,6,4,6,0,0,1,2,2,4,6,0,1,7,2,2,9
401365208,St. Bonaventure Bonnies,L. Brown,4897047,,True,17.0,1,2,1,2,0,0,4,4,1,2,3,0,0,0,1,0,6
401365208,St. Bonaventure Bonnies,J. Holmes,4701016,,True,38.0,6,13,4,9,2,4,3,5,1,3,4,1,1,0,1,3,17
401365208,St. Bonaventure Bonnies,D. Welch,4397221,,True,32.0,4,12,2,5,2,7,1,2,3,4,7,1,2,0,1,3,11
401365208,St. Bonaventure Bonnies,K. Lofton,4397220,,True,38.0,7,14,7,12,0,2,3,4,1,5,6,6,1,0,1,1,17
401365208,St. Bonaventure Bonnies,O. Durosinmi,4684462,,False,2.0,0,0,0,0,0,0,0,0,0,1,1,0,0,0,0,0,0
401365208,St. Bonaventure Bonnies,A. Coulibaly,4432889,,False,17.0,6,7,6,7,0,0,0,1,2,2,4,1,1,1,0,3,12
401365208,St. Bonaventure Bonnies,J. Ndjock-Tadjore,4897048,,False,8.0,0,1,0,0,0,1,0,0,0,1,1,0,0,0,0,0,0
401365208,St. Bonaventure Bonnies,J. Saizonou,4897046,,False,2.0,0,0,0,0,0,0,0,0,0,0,0,0,0,0,0,0,0
401365208,St. Bonaventure Bonnies,Q. Adams,4585591,,False,25.0,1,3,1,3,0,0,1,3,0,2,2,1,1,0,0,1,3
401365208,St. Bonaventure Bonnies,TEAM,TOTAL,TOTAL,False,,29,58,25,44,4,14,13,21,11,26,37,10,7,8,6,13,75
401365208,Siena Saints,J. Stormo,4397697,,True,32.0,3,10,3,9,0,1,0,0,2,4,6,1,0,2,0,3,6
401365208,Siena Saints,M. Baer,4397031,,True,26.0,0,3,0,1,0,2,0,0,1,5,6,2,3,0,3,3,0
401365208,Siena Saints,A. Carpenter,4703516,,True,30.0,4,9,4,6,0,3,2,2,0,3,3,0,1,0,5,3,10
401365208,Siena Saints,C. Rogers,4592921,,True,35.0,3,5,0,0,3,5,0,0,1,1,2,3,0,0,0,3,9
401365208,Siena Saints,A. Gaines,4277972,,True,25.0,2,6,1,5,1,1,1,2,2,3,5,2,1,0,3,2,6
401365208,Siena Saints,M. Tertsea,4607618,,False,6.0,0,1,0,1,0,0,0,0,0,1,1,0,0,0,0,3,0
401365208,Siena Saints,R. Mahala,4398389,,False,4.0,0,1,0,1,0,0,0,0,0,0,0,0,0,0,0,0,0
401365208,Siena Saints,J. Johnson,4397552,,False,25.0,3,8,2,2,1,6,3,6,0,5,5,1,0,1,3,0,10
401365208,Siena Saints,N. Hopkins,4067151,,False,17.0,2,7,0,2,2,5,0,0,1,1,2,2,0,0,0,0,6
401365208,Siena Saints,TEAM,TOTAL,TOTAL,False,,17,50,10,27,7,23,6,10,9,23,32,11,5,3,15,17,47
401365202,Rider Broncs,M. James,4592283,,True,34.0,4,8,4,7,0,1,2,4,3,2,5,1,1,1,1,2,10
401365202,Rider Broncs,A. Ogemuno-Johnson,4406151,,True,25.0,1,4,1,4,0,0,0,0,2,10,12,0,1,0,0,0,2
401365202,Rider Broncs,D. Vaughn,4067347,,True,32.0,6,12,6,8,0,4,1,1,2,5,7,1,0,1,4,3,13
401365202,Rider Broncs,A. Powell,4593364,,True,16.0,2,5,1,2,1,3,0,0,0,0,0,0,0,0,1,3,5
401365202,Rider Broncs,D. Murray Jr.,4398029,,True,39.0,7,14,6,10,1,4,2,2,1,4,5,4,0,0,4,0,17
401365202,Rider Broncs,N. Benson,4705270,,False,5.0,1,1,1,1,0,0,0,0,0,0,0,0,0,1,0,0,2
401365202,Rider Broncs,T. Bladen,4398396,,False,0.0,0,0,0,0,0,0,0,0,0,0,0,0,0,0,0,0,0
401365202,Rider Broncs,J. McGlone,4705265,,False,1.0,0,0,0,0,0,0,0,0,0,0,0,0,0,0,0,0,0
401365202,Rider Broncs,J. Smalls,4705264,,False,1.0,0,0,0,0,0,0,0,0,0,0,0,0,0,0,0,0,0
401365202,Rider Broncs,C. McKeithan,4433243,,False,23.0,4,9,4,7,0,2,2,2,1,1,2,1,2,0,1,1,10
401365202,Rider Broncs,S. Altman,4432935,,False,15.0,1,3,1,2,0,1,0,0,0,1,1,2,0,0,0,3,2
401365202,Rider Broncs,J. Pope,4288898,,False,9.0,0,1,0,0,0,1,0,0,0,0,0,0,0,0,1,0,0
401365202,Rider Broncs,TEAM,TOTAL,TOTAL,False,,26,57,24,41,2,16,7,9,9,26,35,9,4,3,13,12,61
401365202,Duquesne Dukes,T. Williams,4432147,,True,38.0,6,9,4,6,2,3,0,0,1,5,6,4,1,3,0,3,14
401365202,Duquesne Dukes,K. Easley,4398159,,True,27.0,5,10,1,2,4,8,2,2,2,0,2,0,0,0,0,1,16
401365202,Duquesne Dukes,A. Spears,4897090,,True,27.0,5,12,3,6,2,6,2,2,0,3,3,7,2,0,3,2,14
401365202,Duquesne Dukes,L. Ayers III,4703813,,True,28.0,3,7,2,3,1,4,5,5,1,5,6,3,3,1,0,2,12
401365202,Duquesne Dukes,T. Okani,4700873,,True,33.0,1,7,0,5,1,2,4,4,2,3,5,1,0,0,1,2,7
401365202,Duquesne Dukes,M. Hima,4700878,,False,2.0,0,0,0,0,0,0,0,0,0,1,1,0,0,0,0,0,0
401365202,Duquesne Dukes,D. Larson,4897091,,False,15.0,1,3,1,2,0,1,0,0,2,1,3,0,0,0,0,0,2
401365202,Duquesne Dukes,J. Johnson III,4897088,,False,8.0,1,5,1,3,0,2,0,0,0,1,1,0,0,0,2,1,2
401365202,Duquesne Dukes,M. Bekelja,4700874,,False,7.0,0,1,0,0,0,1,0,0,0,0,0,0,0,0,0,0,0
401365202,Duquesne Dukes,T. Acuff,4606831,,False,15.0,2,7,0,4,2,3,0,0,0,3,3,0,0,0,0,2,6
401365202,Duquesne Dukes,TEAM,TOTAL,TOTAL,False,,24,61,12,31,12,30,13,13,11,23,34,15,6,4,7,13,73
401365199,VCU Rams,H. Ward,4592495,,True,29.0,6,8,6,7,0,1,2,4,3,6,9,1,1,4,2,1,14
401365199,VCU Rams,V. Williams Jr.,4397227,,True,25.0,2,8,1,4,1,4,4,6,1,4,5,4,2,1,3,4,9
401365199,VCU Rams,L. Stockard III,4277897,,True,28.0,1,2,1,2,0,0,1,2,0,7,7,1,0,2,0,1,3
401365199,VCU Rams,J. Nunn,4896614,,True,24.0,2,4,2,3,0,1,5,6,0,0,0,1,4,0,6,3,9
401365199,VCU Rams,K. Curry,4397228,,True,33.0,3,9,3,7,0,2,6,8,0,3,3,3,3,1,4,2,12
401365199,VCU Rams,M. Brown-Jones,4433224,,False,8.0,1,2,1,2,0,0,0,0,0,1,1,0,0,1,0,2,2
401365199,VCU Rams,J. DeLoach,4432483,,False,8.0,0,1,0,1,0,0,0,0,0,0,0,0,0,2,0,0,0
401365199,VCU Rams,J. Nichols Jr.,4397108,,False,7.0,1,1,0,0,1,1,0,0,0,0,0,0,0,0,1,0,3
401365199,VCU Rams,N. Kern,4684145,,False,5.0,1,3,1,2,0,1,1,1,0,2,2,0,0,1,0,1,3
401365199,VCU Rams,M. Tsohonis,4592438,,False,16.0,0,3,0,0,0,3,0,0,0,3,3,1,0,0,1,1,0
401365199,VCU Rams,J. Banks,4432402,,False,17.0,1,2,1,1,0,1,0,0,0,0,0,1,0,0,2,0,2
401365199,VCU Rams,TEAM,TOTAL,TOTAL,False,,18,43,16,29,2,14,19,27,4,27,31,12,10,12,19,15,57
401365199,Saint Peter's Peacocks,F. Drame,4432970,,True,31.0,2,5,1,4,1,1,1,2,3,5,8,2,1,1,2,4,6
401365199,Saint Peter's Peacocks,K. Ndefo,4398386,,True,16.0,4,10,4,9,0,1,2,3,0,4,4,1,1,1,2,4,10
401365199,Saint Peter's Peacocks,M. Lee,4593388,,True,33.0,2,11,2,7,0,4,4,4,0,2,2,3,1,0,3,3,8
401365199,Saint Peter's Peacocks,D. Banks III,4593386,,True,31.0,1,5,0,1,1,4,4,5,1,3,4,2,3,0,5,2,7
401365199,Saint Peter's Peacocks,D. Edert,4432977,,True,33.0,6,11,1,4,5,7,0,0,2,2,4,0,2,0,0,2,17
401365199,Saint Peter's Peacocks,C. Rupert,4898258,,False,7.0,0,2,0,2,0,0,0,0,1,1,2,0,0,0,0,3,0
401365199,Saint Peter's Peacocks,H. Drame,4593387,,False,26.0,1,5,1,3,0,2,0,0,1,5,6,1,3,0,4,2,2
401365199,Saint Peter's Peacocks,M. Silvera,4703527,,False,6.0,1,5,1,4,0,1,0,0,2,0,2,0,0,0,1,1,2
401365199,Saint Peter's Peacocks,I. Dasher,4701199,,False,10.0,0,2,0,1,0,1,0,0,0,2,2,1,0,0,1,1,0
401365199,Saint Peter's Peacocks,J. Murray,4683865,,False,7.0,1,2,1,2,0,0,0,0,0,1,1,1,0,0,1,2,2
401365199,Saint Peter's Peacocks,TEAM,TOTAL,TOTAL,False,,18,58,11,37,7,21,11,14,13,25,38,11,11,2,21,24,54
401365060,Toledo Rockets,J. Shumate,4703541,,True,33.0,7,12,3,5,4,7,0,0,2,5,7,0,1,0,2,3,18
401365060,Toledo Rockets,S. Millner Jr.,4703540,,True,35.0,10,16,6,11,4,5,1,1,2,6,8,1,0,1,2,1,25
401365060,Toledo Rockets,R. Moss,4703538,,True,27.0,2,5,2,3,0,2,0,0,1,6,7,1,0,0,1,4,4
401365060,Toledo Rockets,R. Rollins,4591725,,True,35.0,2,12,1,8,1,4,0,0,0,5,5,6,2,1,5,3,5
401365060,Toledo Rockets,R. Dennis,4431941,,True,36.0,5,7,4,5,1,2,2,6,0,6,6,5,1,0,1,3,13
401365060,Toledo Rockets,K. Jacobi,4898343,,False,12.0,1,3,1,3,0,0,0,0,1,2,3,1,0,0,0,2,2
401365060,Toledo Rockets,E. Wilson,4898341,,False,11.0,0,0,0,0,0,0,0,0,0,2,2,1,0,0,0,0,0
401365060,Toledo Rockets,K. Saunders,4397880,,False,11.0,1,4,1,3,0,1,0,0,0,2,2,0,0,0,1,1,2
401365060,Toledo Rockets,TEAM,TOTAL,TOTAL,False,,28,59,18,38,10,21,3,7,6,35,41,15,4,2,14,17,69
401365060,Richmond Spiders,T. Burton,4431914,,True,29.0,4,10,1,3,3,7,6,8,1,8,9,0,0,1,1,0,17
401365060,Richmond Spiders,N. Cayo,4278380,,True,28.0,3,5,3,5,0,0,0,1,1,1,2,0,0,0,0,2,6
401365060,Richmond Spiders,G. Golden,4066836,,True,25.0,3,10,3,8,0,2,1,2,2,5,7,3,0,0,4,2,7
401365060,Richmond Spiders,I. Wilson,4700973,,True,24.0,0,6,0,4,0,2,3,4,2,2,4,2,1,0,1,2,3
401365060,Richmond Spiders,J. Gilyard,4278378,,True,36.0,4,12,0,3,4,9,1,2,0,3,3,7,5,0,0,3,13
401365060,Richmond Spiders,M. Grace,4397192,,False,15.0,1,3,0,1,1,2,1,2,0,0,0,2,1,0,1,0,4
401365060,Richmond Spiders,S. Koureissi,4397190,,False,4.0,0,0,0,0,0,0,0,0,0,0,0,0,0,0,0,0,0
401365060,Richmond Spiders,A. Gustavson,4397193,,False,2.0,0,0,0,0,0,0,0,0,0,0,0,0,0,0,0,0,0
401365060,Richmond Spiders,C. Crabtree,4396658,,False,18.0,3,6,2,4,1,2,1,2,2,3,5,3,1,0,0,1,8
401365060,Richmond Spiders,N. Sherod,4066832,,False,19.0,4,10,0,2,4,8,2,2,1,4,5,0,0,0,0,1,14
401365060,Richmond Spiders,TEAM,TOTAL,TOTAL,False,,22,62,9,30,13,32,15,23,9,27,36,17,8,1,7,11,72
401365049,Northern Illinois Huskies,Z. Kueth,4703524,,True,21.0,0,3,0,0,0,3,0,0,0,0,0,0,1,1,1,1,0
401365049,Northern Illinois Huskies,A. Makuoi,4703525,,True,6.0,0,3,0,3,0,0,0,0,2,1,3,0,1,0,0,1,0
401365049,Northern Illinois Huskies,K. Thornton,4703521,,True,21.0,0,2,0,1,0,1,0,0,0,1,1,2,1,1,3,3,0
401365049,Northern Illinois Huskies,K. Williams,4602029,,True,27.0,3,13,3,11,0,2,1,1,0,0,0,3,0,0,2,0,7
401365049,Northern Illinois Huskies,T. Hankerson,4397854,,True,26.0,2,5,1,1,1,4,2,2,0,2,2,0,1,0,3,1,7
401365049,Northern Illinois Huskies,M. Myrick,4898333,,False,3.0,0,1,0,1,0,0,1,2,1,0,1,0,0,0,0,0,1
401365049,Northern Illinois Huskies,C. Kingsley Okanu,4703523,,False,13.0,2,5,2,5,0,0,0,0,0,2,2,0,0,1,0,2,4
401365049,Northern Illinois Huskies,C. Osten,4702376,,False,8.0,1,1,1,1,0,0,0,2,1,1,2,0,0,0,0,0,2
401365049,Northern Illinois Huskies,A. Crump,4397550,,False,26.0,3,10,2,8,1,2,0,2,1,2,3,2,4,0,0,1,7
401365049,Northern Illinois Huskies,E. Manuel,4898336,,False,2.0,0,0,0,0,0,0,0,0,0,0,0,0,0,0,0,0,0
401365049,Northern Illinois Huskies,Z. Russell,4898334,,False,16.0,2,3,1,2,1,1,1,1,0,1,1,0,1,0,1,0,6
401365049,Northern Illinois Huskies,N. Kon,4898332,,False,6.0,0,0,0,0,0,0,1,2,0,0,0,0,0,0,0,2,1
401365049,Northern Illinois Huskies,D. Hunter,4596869,,False,25.0,3,9,3,6,0,3,0,0,1,3,4,0,0,0,2,2,6
401365049,Northern Illinois Huskies,TEAM,TOTAL,TOTAL,False,,16,55,13,39,3,16,6,12,9,16,25,7,9,3,13,13,41
401365049,Dayton Flyers,R.J. Blakney,4700864,,True,16.0,2,5,2,2,0,3,1,1,1,1,2,1,0,1,2,2,5
401365049,Dayton Flyers,T. Camara,4431736,,True,11.0,2,4,1,2,1,2,0,0,1,1,2,1,0,2,4,3,5
401365049,Dayton Flyers,D. Holmes II,4433607,,True,23.0,6,7,6,7,0,0,2,3,1,4,5,0,1,1,0,0,14
401365049,Dayton Flyers,M. Smith,4683861,,True,23.0,4,5,3,3,1,2,2,2,0,5,5,4,4,0,1,1,11
401365049,Dayton Flyers,K. Elvis,4683135,,True,15.0,0,1,0,1,0,0,0,0,0,1,1,4,0,0,2,0,0
401365049,Dayton Flyers,M. Sissoko,4431824,,False,17.0,1,2,1,2,0,0,0,0,5,3,8,0,0,0,0,3,2
401365049,Dayton Flyers,M. Amzil,4711607,,False,24.0,2,8,2,3,0,5,0,0,0,4,4,1,0,0,2,2,4
401365049,Dayton Flyers,K. Washington,4684293,,False,6.0,1,3,1,1,0,2,0,0,0,0,0,1,0,0,1,0,2
401365049,Dayton Flyers,Z. Nwokeji,4618121,,False,9.0,1,2,1,1,0,1,2,2,0,1,1,0,0,0,0,1,4
401365049,Dayton Flyers,C. Wilson,4403456,,False,2.0,0,1,0,1,0,0,0,0,0,0,0,0,0,0,0,0,0
401365049,Dayton Flyers,K. Brea,4591259,,False,18.0,4,6,0,1,4,5,0,0,0,4,4,0,0,1,1,1,12
401365049,Dayton Flyers,L. Greer III,4433175,,False,17.0,2,5,2,4,0,1,0,0,1,5,6,4,0,0,3,2,4
401365049,Dayton Flyers,E. Weaver,4397139,,False,19.0,6,7,4,4,2,3,2,2,0,0,0,2,0,0,0,1,16
401365049,Dayton Flyers,TEAM,TOTAL,TOTAL,False,,31,56,23,32,8,24,9,10,10,33,43,18,5,5,17,16,79
401365043,Duquesne Dukes,T. Williams,4432147,,True,35.0,4,9,3,6,1,3,3,8,4,4,8,4,1,1,0,3,12
401365043,Duquesne Dukes,K. Easley,4398159,,True,31.0,5,10,3,5,2,5,6,9,3,5,8,0,0,1,0,3,18
401365043,Duquesne Dukes,A. Spears,4897090,,True,35.0,2,12,2,11,0,1,1,1,0,1,1,2,3,0,3,1,5
401365043,Duquesne Dukes,L. Ayers III,4703813,,True,35.0,6,17,3,6,3,11,5,6,1,3,4,2,1,0,3,2,20
401365043,Duquesne Dukes,T. Acuff,4606831,,True,34.0,2,5,1,1,1,4,0,0,0,7,7,2,0,1,0,4,5
401365043,Duquesne Dukes,A. Rotroff,4396806,,False,7.0,1,1,1,1,0,0,0,0,1,2,3,1,0,1,0,1,2
401365043,Duquesne Dukes,J. Johnson III,4897088,,False,7.0,1,3,0,2,1,1,0,0,0,1,1,1,0,0,1,0,3
401365043,Duquesne Dukes,M. Bekelja,4700874,,False,2.0,0,0,0,0,0,0,0,0,0,0,0,0,0,0,0,0,0
401365043,Duquesne Dukes,T. Okani,4700873,,False,14.0,2,5,1,4,1,1,0,0,1,3,4,0,0,0,0,1,5
401365043,Duquesne Dukes,TEAM,TOTAL,TOTAL,False,,23,62,14,36,9,26,15,24,11,28,39,12,5,4,8,15,70
401365043,Bowling Green Falcons,J. Reece,4703098,,True,26.0,5,13,5,12,0,1,5,7,3,9,12,0,0,0,0,2,15
401365043,Bowling Green Falcons,T. Diggs,4593401,,True,21.0,0,4,0,2,0,2,2,2,2,4,6,0,2,0,3,0,2
401365043,Bowling Green Falcons,D. Plowden,4279318,,True,29.0,5,13,4,10,1,3,2,4,4,5,9,0,0,1,0,3,13
401365043,Bowling Green Falcons,K. Metheny,4703572,,True,28.0,6,14,3,9,3,5,0,0,0,1,1,3,0,0,2,0,15
401365043,Bowling Green Falcons,S. Curtis,4431792,,True,27.0,5,7,3,4,2,3,2,2,1,4,5,7,0,0,1,3,14
401365043,Bowling Green Falcons,G. O'Neal,4703555,,False,9.0,0,3,0,3,0,0,0,0,0,1,1,0,0,0,0,2,0
401365043,Bowling Green Falcons,M. Kulackovskis,4279319,,False,12.0,2,4,0,2,2,2,0,0,1,0,1,0,1,0,1,4,6
401365043,Bowling Green Falcons,C. Turner,4432130,,False,13.0,2,4,2,4,0,0,2,2,1,2,3,1,0,0,0,3,6
401365043,Bowling Green Falcons,C. Young,4703573,,False,5.0,0,0,0,0,0,0,0,0,1,0,1,1,0,0,0,0,0
401365043,Bowling Green Falcons,J. Fulcher,4703571,,False,19.0,3,6,2,5,1,1,0,1,2,5,7,0,0,0,1,3,7
401365043,Bowling Green Falcons,B. Mills,4592891,,False,11.0,0,1,0,1,0,0,0,0,0,0,0,0,0,0,0,1,0
401365043,Bowling Green Falcons,TEAM,TOTAL,TOTAL,False,,28,69,19,52,9,17,13,18,16,33,49,12,3,1,9,21,78
401365025,Fordham Rams,C. Ohams,4066856,,True,23.0,2,6,1,5,1,1,0,0,1,5,6,0,0,1,1,2,5
401365025,Fordham Rams,A. Charlton,4897085,,True,35.0,3,8,2,7,1,1,0,0,2,5,7,1,2,0,0,4,7
401365025,Fordham Rams,J. Navarro,4592316,,True,9.0,0,2,0,1,0,1,0,0,0,1,1,0,0,0,0,2,0
401365025,Fordham Rams,K. Rose,4592315,,True,33.0,3,6,1,1,2,5,0,0,4,3,7,2,0,1,0,2,8
401365025,Fordham Rams,A. Daye Jr.,4397500,,True,28.0,5,8,4,6,1,2,8,10,0,4,4,0,0,0,2,2,19
401365025,Fordham Rams,A. Tsimbila,4702329,,False,12.0,1,2,1,2,0,0,0,2,0,4,4,0,0,1,0,3,2
401365025,Fordham Rams,R. Novitskyi,4897084,,False,14.0,0,0,0,0,0,0,1,2,0,2,2,1,0,0,1,2,1
401365025,Fordham Rams,A. Harrison,4897086,,False,12.0,1,4,1,3,0,1,2,3,0,0,0,0,2,0,0,1,4
401365025,Fordham Rams,K. Cunningham,4705891,,False,3.0,0,0,0,0,0,0,0,0,0,0,0,0,0,0,0,1,0
401365025,Fordham Rams,A. Evans,4700881,,False,1.0,0,0,0,0,0,0,0,0,0,0,0,0,0,0,0,0,0
401365025,Fordham Rams,D. Quisenberry,4397790,,False,30.0,6,15,5,9,1,6,4,4,1,4,5,3,0,0,3,1,17
401365025,Fordham Rams,TEAM,TOTAL,TOTAL,False,,21,51,15,34,6,17,15,21,8,29,37,7,4,3,8,20,63
401365025,Akron Zips,E. Freeman,4592699,,True,25.0,4,9,4,8,0,1,1,2,3,8,11,0,0,1,1,4,9
401365025,Akron Zips,A. Ali,4592700,,True,29.0,2,8,2,5,0,3,2,4,0,5,5,1,0,0,1,0,6
401365025,Akron Zips,X. Castaneda,4396641,,True,32.0,2,6,1,2,1,4,3,3,0,1,1,0,1,0,2,2,8
401365025,Akron Zips,B. Trimble Jr.,4278583,,True,25.0,1,8,1,3,0,5,0,0,0,1,1,0,0,0,0,1,2
401365025,Akron Zips,K.J. Walton,3917384,,True,19.0,2,5,2,5,0,0,2,3,0,2,2,0,0,0,1,2,6
401365025,Akron Zips,A. Bandaogo,4703576,,False,17.0,1,3,1,3,0,0,1,2,1,3,4,0,0,0,1,2,3
401365025,Akron Zips,S. Kalle,4898277,,False,1.0,1,1,1,1,0,0,0,2,0,0,0,0,0,0,0,0,2
401365025,Akron Zips,M. Wynn,4395689,,False,7.0,1,2,1,1,0,1,1,2,1,0,1,0,0,0,0,1,3
401365025,Akron Zips,M. Dawson,4609661,,False,17.0,0,1,0,1,0,0,0,0,1,1,2,2,2,0,0,2,0
401365025,Akron Zips,E. Wilson,4898276,,False,1.0,0,0,0,0,0,0,0,0,0,0,0,0,0,0,0,0,0
401365025,Akron Zips,G. Tribble,4592697,,False,12.0,2,5,2,3,0,2,0,1,0,2,2,0,0,1,1,4,4
401365025,Akron Zips,G. Clarke,4433221,,False,15.0,0,3,0,1,0,2,0,0,0,2,2,1,0,0,1,3,0
401365025,Akron Zips,TEAM,TOTAL,TOTAL,False,,16,51,15,33,1,18,10,19,6,25,31,4,3,2,8,21,43
401123954,Quinnipiac Bobcats,J. Rigoni,4279743,,True,16.0,2,6,1,2,1,4,0,0,0,1,1,0,0,0,0,0,5
401123954,Quinnipiac Bobcats,A. Bundu,3947028,,True,18.0,2,2,2,2,0,0,5,7,3,2,5,0,1,0,1,2,9
401123954,Quinnipiac Bobcats,T. Williams,4398399,,True,30.0,2,6,1,2,1,4,0,0,1,2,3,0,0,0,0,4,5
401123954,Quinnipiac Bobcats,R. Kelly,4279741,,True,36.0,4,11,3,8,1,3,2,2,1,1,2,6,0,1,3,2,11
401123954,Quinnipiac Bobcats,C. Young,4070684,,True,35.0,11,19,8,12,3,7,4,5,2,6,8,0,2,0,2,5,29
401123954,Quinnipiac Bobcats,K. Marfo,4066877,,False,18.0,3,6,3,6,0,0,0,1,2,9,11,2,0,1,0,3,6
401123954,Quinnipiac Bobcats,T. Pickron,4398400,,False,10.0,0,1,0,0,0,1,0,0,0,0,0,0,0,0,0,0,0
401123954,Quinnipiac Bobcats,T. Atson,4066478,,False,20.0,2,4,1,2,1,2,0,0,0,1,1,0,0,0,1,2,5
401123954,Quinnipiac Bobcats,Aa. Robinson,3947024,,False,17.0,4,6,1,2,3,4,0,0,0,0,0,1,0,0,0,4,11
401123954,Quinnipiac Bobcats,TEAM,TOTAL,TOTAL,False,,30,61,20,36,10,25,11,15,10,24,34,9,3,2,7,22,81
401123954,NJIT Highlanders,K. de Graaf,4396755,,True,26.0,2,5,0,1,2,4,2,2,2,1,3,1,0,1,0,0,8
401123954,NJIT Highlanders,M. Bendary,3947203,,True,17.0,3,5,3,5,0,0,1,2,2,3,5,3,0,0,0,4,7
401123954,NJIT Highlanders,D. Wilson,4278451,,True,29.0,2,9,0,4,2,5,9,11,0,1,1,1,0,0,0,2,15
401123954,NJIT Highlanders,Z. Cooks,4278449,,True,36.0,12,20,8,13,4,7,6,8,0,6,6,1,1,0,0,1,34
401123954,NJIT Highlanders,S. Gibbs,4067192,,True,35.0,6,10,5,6,1,4,2,2,0,1,1,7,1,0,0,2,15
401123954,NJIT Highlanders,S. Diakite,4396754,,False,22.0,1,3,1,3,0,0,0,1,4,5,9,0,1,0,1,4,2
401123954,NJIT Highlanders,S. Brinson,4278448,,False,14.0,1,2,1,1,0,1,0,0,1,2,3,0,0,0,1,1,2
401123954,NJIT Highlanders,S. Jones,4278452,,False,13.0,0,1,0,0,0,1,0,0,0,3,3,0,0,0,2,1,0
401123954,NJIT Highlanders,D. Greer,4067195,,False,8.0,3,4,0,0,3,4,0,0,0,1,1,0,0,0,0,0,9
401123954,NJIT Highlanders,TEAM,TOTAL,TOTAL,False,,30,59,18,33,12,26,20,26,9,24,33,13,3,1,5,15,92
401123416,North Carolina Tar Heels,G. Brooks,4277908,,True,27.0,4,8,4,8,0,0,2,2,3,5,8,0,1,0,0,4,10
401123416,North Carolina Tar Heels,L. Maye,3911620,,True,29.0,6,16,6,13,0,3,4,4,4,5,9,2,0,0,2,4,16
401123416,North Carolina Tar Heels,C. White,4395651,,True,31.0,4,14,2,6,2,8,0,2,0,6,6,4,2,0,1,2,10
401123416,North Carolina Tar Heels,K. Williams,3911619,,True,34.0,3,8,2,5,1,3,1,2,4,4,8,3,0,0,1,2,8
401123416,North Carolina Tar Heels,C. Johnson,3138196,,True,32.0,7,13,3,5,4,8,3,3,1,6,7,4,0,0,1,0,21
401123416,North Carolina Tar Heels,N. Little,4395652,,False,17.0,9,13,9,13,0,0,1,1,3,1,4,0,0,0,2,2,19
401123416,North Carolina Tar Heels,W. Miller,4277910,,False,0.0,0,0,0,0,0,0,0,0,0,0,0,0,0,0,0,0,0
401123416,North Carolina Tar Heels,S. Manley,4277909,,False,2.0,1,1,1,1,0,0,0,0,0,0,0,0,0,0,0,0,2
401123416,North Carolina Tar Heels,S. Rush,4065674,,False,0.0,0,0,0,0,0,0,0,1,0,0,0,0,0,0,0,0,0
401123416,North Carolina Tar Heels,L. Black,4395650,,False,6.0,0,0,0,0,0,0,0,0,1,2,3,0,0,0,1,1,0
401123416,North Carolina Tar Heels,B. Huffman,4277912,,False,0.0,1,1,1,1,0,0,0,0,1,1,2,0,0,0,0,0,2
401123416,North Carolina Tar Heels,K.J. Smith,4277911,,False,1.0,0,0,0,0,0,0,0,0,0,0,0,0,0,0,0,1,0
401123416,North Carolina Tar Heels,A. Platek,4277906,,False,2.0,0,0,0,0,0,0,0,0,0,0,0,1,0,0,0,0,0
401123416,North Carolina Tar Heels,S. Woods,4065676,,False,8.0,0,1,0,1,0,0,0,0,0,0,0,2,0,0,2,0,0
401123416,North Carolina Tar Heels,B. Robinson,4065675,,False,11.0,0,0,0,0,0,0,0,0,0,1,1,0,0,0,1,0,0
401123416,North Carolina Tar Heels,TEAM,TOTAL,TOTAL,False,,35,75,28,53,7,22,11,15,20,32,52,16,3,0,12,16,88
401123416,Iona Gaels,T. Agee,4398087,,True,17.0,3,7,2,4,1,3,2,2,0,5,5,0,1,0,2,5,9
401123416,Iona Gaels,E.J. Crawford,4067295,,True,37.0,3,10,2,3,1,7,3,4,0,4,4,2,0,0,4,1,10
401123416,Iona Gaels,A. Gist,4067164,,True,40.0,4,12,1,2,3,10,6,6,0,3,3,5,0,0,3,2,17
401123416,Iona Gaels,B. Perez,3948791,,True,31.0,0,3,0,0,0,3,0,0,0,3,3,2,1,0,0,2,0
401123416,Iona Gaels,R. McGill,3948698,,True,38.0,8,12,1,3,7,9,3,3,0,2,2,1,4,1,3,3,26
401123416,Iona Gaels,J. Maxwell,4398088,,False,8.0,0,0,0,0,0,0,0,0,0,0,0,0,0,0,0,0,0
401123416,Iona Gaels,A. Ristanovic,4279492,,False,27.0,4,11,1,2,3,9,0,0,1,5,6,1,0,0,0,1,11
401123416,Iona Gaels,M. Rhem,4404249,,False,1.0,0,0,0,0,0,0,0,0,0,0,0,0,0,0,0,0,0
401123416,Iona Gaels,P. Hudson,4398089,,False,1.0,0,0,0,0,0,0,0,0,0,0,0,0,0,0,0,0,0
401123416,Iona Gaels,TEAM,TOTAL,TOTAL,False,,22,55,7,14,15,41,14,15,2,24,26,11,6,1,12,14,73
401121808,Niagara Purple Eagles,M. Prochet,3907184,,True,35.0,2,7,1,2,1,5,6,6,2,10,12,1,0,3,1,2,11
401121808,Niagara Purple Eagles,G. King,3906490,,True,22.0,2,4,2,4,0,0,1,2,0,3,3,0,3,1,3,3,5
401121808,Niagara Purple Eagles,M. Hammond,4398404,,True,37.0,4,12,2,5,2,7,5,5,1,2,3,3,1,0,1,3,15
401121808,Niagara Purple Eagles,R. Solomon,4398403,,True,33.0,6,12,1,4,5,8,7,8,2,3,5,0,0,0,1,5,24
401121808,Niagara Purple Eagles,C. Barton,3907182,,True,25.0,2,5,1,2,1,3,2,4,0,2,2,1,1,0,2,4,7
401121808,Niagara Purple Eagles,G. Kuakumensah,4279739,,False,4.0,0,1,0,1,0,0,0,0,0,0,0,0,0,0,0,0,0
401121808,Niagara Purple Eagles,D. Robb,3907186,,False,19.0,3,5,3,5,0,0,1,2,0,3,3,0,0,4,1,3,7
401121808,Niagara Purple Eagles,K. Tate,4279738,,False,4.0,0,2,0,0,0,2,0,0,0,0,0,0,0,0,1,0,0
401121808,Niagara Purple Eagles,D. Fragala,4279737,,False,4.0,0,1,0,0,0,1,0,0,0,0,0,0,0,0,0,1,0
401121808,Niagara Purple Eagles,J. Towns,4067341,,False,17.0,1,2,0,0,1,2,0,0,0,1,1,0,0,0,3,1,3
401121808,Niagara Purple Eagles,TEAM,TOTAL,TOTAL,False,,20,51,10,23,10,28,22,27,5,28,33,5,5,8,13,22,72
401121808,Niagara Purple Eagles,M. Prochet,3907184,,True,35.0,2,7,1,2,1,5,6,6,2,10,12,1,0,3,1,2,11
401121808,Niagara Purple Eagles,G. King,3906490,,True,22.0,2,4,2,4,0,0,1,2,0,3,3,0,3,1,3,3,5
401121808,Niagara Purple Eagles,M. Hammond,4398404,,True,37.0,4,12,2,5,2,7,5,5,1,2,3,3,1,0,1,3,15
401121808,Niagara Purple Eagles,R. Solomon,4398403,,True,33.0,6,12,1,4,5,8,7,8,2,3,5,0,0,0,1,5,24
401121808,Niagara Purple Eagles,C. Barton,3907182,,True,25.0,2,5,1,2,1,3,2,4,0,2,2,1,1,0,2,4,7
401121808,Niagara Purple Eagles,G. Kuakumensah,4279739,,False,4.0,0,1,0,1,0,0,0,0,0,0,0,0,0,0,0,0,0
401121808,Niagara Purple Eagles,D. Robb,3907186,,False,19.0,3,5,3,5,0,0,1,2,0,3,3,0,0,4,1,3,7
401121808,Niagara Purple Eagles,K. Tate,4279738,,False,4.0,0,2,0,0,0,2,0,0,0,0,0,0,0,0,1,0,0
401121808,Niagara Purple Eagles,D. Fragala,4279737,,False,4.0,0,1,0,0,0,1,0,0,0,0,0,0,0,0,0,1,0
401121808,Niagara Purple Eagles,J. Towns,4067341,,False,17.0,1,2,0,0,1,2,0,0,0,1,1,0,0,0,3,1,3
401121808,Niagara Purple Eagles,TEAM,TOTAL,TOTAL,False,,20,51,10,23,10,28,22,27,5,28,33,5,5,8,13,22,72
401121808,Monmouth Hawks,M. Traore,3975762,,True,18.0,3,5,3,5,0,0,0,0,1,3,4,1,0,0,0,4,6
401121808,Monmouth Hawks,D. Quinn,3948714,,True,32.0,5,12,5,12,0,0,4,7,3,6,9,0,0,3,2,2,14
401121808,Monmouth Hawks,M. McClary,4279736,,True,21.0,1,5,1,5,0,0,1,2,1,3,4,0,1,0,0,0,3
401121808,Monmouth Hawks,D. Hammond,4279734,,True,26.0,2,11,1,7,1,4,0,0,0,1,1,0,0,0,1,3,5
401121808,Monmouth Hawks,R. Salnave,4067329,,True,32.0,7,10,6,8,1,2,5,6,0,1,1,2,0,0,4,4,20
401121808,Monmouth Hawks,M. Martin,4279733,,False,21.0,1,2,1,2,0,0,0,0,1,5,6,0,1,0,0,3,2
401121808,Monmouth Hawks,S. Chaput,4398409,,False,10.0,1,1,1,1,0,0,0,1,0,0,0,1,0,0,0,0,2
401121808,Monmouth Hawks,L. Pillari,3948713,,False,18.0,6,12,6,10,0,2,3,5,0,2,2,0,0,0,1,3,15
401121808,Monmouth Hawks,N. Rutherford,3946977,,False,22.0,2,3,1,2,1,1,4,5,0,4,4,2,4,0,1,3,9
401121808,Monmouth Hawks,TEAM,TOTAL,TOTAL,False,,28,61,25,52,3,9,17,26,9,27,36,6,6,3,9,22,76
401121808,Monmouth Hawks,M. Traore,3975762,,True,18.0,3,5,3,5,0,0,0,0,1,3,4,1,0,0,0,4,6
401121808,Monmouth Hawks,D. Quinn,3948714,,True,32.0,5,12,5,12,0,0,4,7,3,6,9,0,0,3,2,2,14
401121808,Monmouth Hawks,M. McClary,4279736,,True,21.0,1,5,1,5,0,0,1,2,1,3,4,0,1,0,0,0,3
401121808,Monmouth Hawks,D. Hammond,4279734,,True,26.0,2,11,1,7,1,4,0,0,0,1,1,0,0,0,1,3,5
401121808,Monmouth Hawks,R. Salnave,4067329,,True,32.0,7,10,6,8,1,2,5,6,0,1,1,2,0,0,4,4,20
401121808,Monmouth Hawks,M. Martin,4279733,,False,21.0,1,2,1,2,0,0,0,0,1,5,6,0,1,0,0,3,2
401121808,Monmouth Hawks,S. Chaput,4398409,,False,10.0,1,1,1,1,0,0,0,1,0,0,0,1,0,0,0,0,2
401121808,Monmouth Hawks,L. Pillari,3948713,,False,18.0,6,12,6,10,0,2,3,5,0,2,2,0,0,0,1,3,15
401121808,Monmouth Hawks,N. Rutherford,3946977,,False,22.0,2,3,1,2,1,1,4,5,0,4,4,2,4,0,1,3,9
401121808,Monmouth Hawks,TEAM,TOTAL,TOTAL,False,,28,61,25,52,3,9,17,26,9,27,36,6,6,3,9,22,76
401121807,Manhattan Jaspers,T. Reynolds,4398107,,True,19.0,1,3,0,0,1,3,0,0,0,1,1,0,1,1,0,2,3
401121807,Manhattan Jaspers,W. Williams,4279701,,True,14.0,2,4,2,4,0,0,6,8,1,3,4,1,1,0,3,4,10
401121807,Manhattan Jaspers,C. Hinckson,4398106,,True,26.0,5,8,4,5,1,3,5,5,0,2,2,0,0,0,0,1,16
401121807,Manhattan Jaspers,S. Stewart,4398104,,True,32.0,2,9,0,2,2,7,2,2,0,2,2,1,2,0,0,1,8
401121807,Manhattan Jaspers,N. Mack,4279703,,True,23.0,1,3,1,1,0,2,0,0,0,3,3,2,1,0,2,1,2
401121807,Manhattan Jaspers,E. Ebube,4279705,,False,26.0,2,5,2,2,0,3,3,4,2,4,6,2,0,1,0,3,7
401121807,Manhattan Jaspers,T. Greene,4398108,,False,22.0,0,3,0,1,0,2,3,4,2,0,2,0,0,0,2,4,3
401121807,Manhattan Jaspers,E. Buchanan,4398103,,False,9.0,1,3,1,3,0,0,0,0,0,1,1,1,0,0,0,0,2
401121807,Manhattan Jaspers,T. Capuano,3948706,,False,14.0,2,3,2,2,0,1,0,0,0,1,1,0,0,0,0,1,4
401121807,Manhattan Jaspers,S. Usilo,3138468,,False,15.0,1,3,1,3,0,0,0,1,1,2,3,1,2,0,2,1,2
401121807,Manhattan Jaspers,TEAM,TOTAL,TOTAL,False,,17,44,13,23,4,21,19,24,7,20,27,8,7,2,9,18,57
401121807,Manhattan Jaspers,T. Reynolds,4398107,,True,19.0,1,3,0,0,1,3,0,0,0,1,1,0,1,1,0,2,3
401121807,Manhattan Jaspers,W. Williams,4279701,,True,14.0,2,4,2,4,0,0,6,8,1,3,4,1,1,0,3,4,10
401121807,Manhattan Jaspers,C. Hinckson,4398106,,True,26.0,5,8,4,5,1,3,5,5,0,2,2,0,0,0,0,1,16
401121807,Manhattan Jaspers,S. Stewart,4398104,,True,32.0,2,9,0,2,2,7,2,2,0,2,2,1,2,0,0,1,8
401121807,Manhattan Jaspers,N. Mack,4279703,,True,23.0,1,3,1,1,0,2,0,0,0,3,3,2,1,0,2,1,2
401121807,Manhattan Jaspers,E. Ebube,4279705,,False,26.0,2,5,2,2,0,3,3,4,2,4,6,2,0,1,0,3,7
401121807,Manhattan Jaspers,T. Greene,4398108,,False,22.0,0,3,0,1,0,2,3,4,2,0,2,0,0,0,2,4,3
401121807,Manhattan Jaspers,E. Buchanan,4398103,,False,9.0,1,3,1,3,0,0,0,0,0,1,1,1,0,0,0,0,2
401121807,Manhattan Jaspers,T. Capuano,3948706,,False,14.0,2,3,2,2,0,1,0,0,0,1,1,0,0,0,0,1,4
401121807,Manhattan Jaspers,S. Usilo,3138468,,False,15.0,1,3,1,3,0,0,0,1,1,2,3,1,2,0,2,1,2
401121807,Manhattan Jaspers,TEAM,TOTAL,TOTAL,False,,17,44,13,23,4,21,19,24,7,20,27,8,7,2,9,18,57
401121807,Fairfield Stags,J. Kasibabu,3947016,,True,29.0,3,6,3,6,0,0,2,2,5,1,6,1,0,1,2,4,8
401121807,Fairfield Stags,M. Milin,3947018,,True,19.0,2,6,1,4,1,2,2,4,2,3,5,0,0,0,1,3,7
401121807,Fairfield Stags,L. Taliaferro,4398078,,True,40.0,3,6,1,1,2,5,4,6,1,1,2,2,1,2,2,1,12
401121807,Fairfield Stags,N. Alvarez,4398075,,True,40.0,7,14,4,8,3,6,1,2,0,5,5,1,0,0,5,1,18
401121807,Fairfield Stags,T. Benning,4279483,,True,40.0,1,6,1,5,0,1,1,2,0,4,4,3,0,0,1,4,3
401121807,Fairfield Stags,W. Methnani,4279486,,False,20.0,2,3,1,2,1,1,0,0,0,3,3,0,2,1,0,3,5
401121807,Fairfield Stags,J. Cruz,4279488,,False,12.0,0,3,0,3,0,0,0,0,1,1,2,0,0,0,2,2,0
401121807,Fairfield Stags,TEAM,TOTAL,TOTAL,False,,18,44,11,29,7,15,10,16,10,20,30,7,3,4,14,18,53
401121807,Fairfield Stags,J. Kasibabu,3947016,,True,29.0,3,6,3,6,0,0,2,2,5,1,6,1,0,1,2,4,8
401121807,Fairfield Stags,M. Milin,3947018,,True,19.0,2,6,1,4,1,2,2,4,2,3,5,0,0,0,1,3,7
401121807,Fairfield Stags,L. Taliaferro,4398078,,True,40.0,3,6,1,1,2,5,4,6,1,1,2,2,1,2,2,1,12
401121807,Fairfield Stags,N. Alvarez,4398075,,True,40.0,7,14,4,8,3,6,1,2,0,5,5,1,0,0,5,1,18
401121807,Fairfield Stags,T. Benning,4279483,,True,40.0,1,6,1,5,0,1,1,2,0,4,4,3,0,0,1,4,3
401121807,Fairfield Stags,W. Methnani,4279486,,False,20.0,2,3,1,2,1,1,0,0,0,3,3,0,2,1,0,3,5
401121807,Fairfield Stags,J. Cruz,4279488,,False,12.0,0,3,0,3,0,0,0,0,1,1,2,0,0,0,2,2,0
401121807,Fairfield Stags,TEAM,TOTAL,TOTAL,False,,18,44,11,29,7,15,10,16,10,20,30,7,3,4,14,18,53
401121806,Saint Peter's Peacocks,KC Ndefo,4398386,,True,27.0,4,6,4,4,0,2,1,2,0,5,5,1,0,4,2,5,9
401121806,Saint Peter's Peacocks,S. Idowu,3922042,,True,34.0,3,9,3,7,0,2,2,2,1,7,8,2,1,2,3,4,8
401121806,Saint Peter's Peacocks,D. Watson,4398384,,True,44.0,5,6,2,2,3,4,4,4,0,4,4,3,0,0,2,1,17
401121806,Saint Peter's Peacocks,Q. Taylor,4067357,,True,42.0,4,11,4,8,0,3,3,6,1,4,5,0,2,2,2,2,11
401121806,Saint Peter's Peacocks,D. Turner,4067356,,True,44.0,5,9,3,5,2,4,6,6,1,2,3,3,1,0,1,2,18
401121806,Saint Peter's Peacocks,D. Woods,3919424,,False,11.0,0,0,0,0,0,0,1,2,0,2,2,0,0,0,1,0,1
401121806,Saint Peter's Peacocks,K. Brown,4398385,,False,2.0,0,1,0,0,0,1,0,0,0,0,0,0,0,0,0,2,0
401121806,Saint Peter's Peacocks,M. Dixon,4279758,,False,21.0,3,5,2,2,1,3,0,0,0,1,1,0,0,0,1,0,7
401121806,Saint Peter's Peacocks,TEAM,TOTAL,TOTAL,False,,24,47,18,28,6,19,17,22,4,26,30,9,4,8,14,16,71
401121806,Saint Peter's Peacocks,KC Ndefo,4398386,,True,27.0,4,6,4,4,0,2,1,2,0,5,5,1,0,4,2,5,9
401121806,Saint Peter's Peacocks,S. Idowu,3922042,,True,34.0,3,9,3,7,0,2,2,2,1,7,8,2,1,2,3,4,8
401121806,Saint Peter's Peacocks,D. Watson,4398384,,True,44.0,5,6,2,2,3,4,4,4,0,4,4,3,0,0,2,1,17
401121806,Saint Peter's Peacocks,Q. Taylor,4067357,,True,42.0,4,11,4,8,0,3,3,6,1,4,5,0,2,2,2,2,11
401121806,Saint Peter's Peacocks,D. Turner,4067356,,True,44.0,5,9,3,5,2,4,6,6,1,2,3,3,1,0,1,2,18
401121806,Saint Peter's Peacocks,D. Woods,3919424,,False,11.0,0,0,0,0,0,0,1,2,0,2,2,0,0,0,1,0,1
401121806,Saint Peter's Peacocks,K. Brown,4398385,,False,2.0,0,1,0,0,0,1,0,0,0,0,0,0,0,0,0,2,0
401121806,Saint Peter's Peacocks,M. Dixon,4279758,,False,21.0,3,5,2,2,1,3,0,0,0,1,1,0,0,0,1,0,7
401121806,Saint Peter's Peacocks,TEAM,TOTAL,TOTAL,False,,24,47,18,28,6,19,17,22,4,26,30,9,4,8,14,16,71
401121806,Marist Red Foxes,I. Lamb,3936028,,True,28.0,1,5,1,3,0,2,2,2,2,4,6,0,1,0,0,5,4
401121806,Marist Red Foxes,R. Funk,3936026,,True,41.0,5,11,2,3,3,8,5,5,0,1,1,0,0,0,1,3,18
401121806,Marist Red Foxes,T. Sjoberg,4067328,,True,7.0,0,1,0,1,0,0,0,0,1,0,1,0,0,0,0,3,0
401121806,Marist Red Foxes,B. Parker,3936030,,True,35.0,9,15,9,15,0,0,4,6,2,3,5,4,1,0,4,5,22
401121806,Marist Red Foxes,D. Knudsen,3936027,,True,14.0,2,5,1,3,1,2,0,0,0,1,1,0,0,0,0,0,5
401121806,Marist Red Foxes,L. Nedrow,4398414,,False,5.0,1,2,0,0,1,2,0,0,0,1,1,0,0,0,2,1,3
401121806,Marist Red Foxes,A. Dozic,3923222,,False,32.0,4,9,2,5,2,4,1,1,0,4,4,3,2,0,0,0,11
401121806,Marist Red Foxes,M. Herasme,4398413,,False,21.0,0,0,0,0,0,0,0,0,1,1,2,1,0,1,0,1,0
401121806,Marist Red Foxes,D. Hines,4398410,,False,31.0,2,7,1,6,1,1,0,0,0,2,2,1,1,0,2,0,5
401121806,Marist Red Foxes,A. Williams,4279709,,False,11.0,0,1,0,1,0,0,0,0,0,2,2,0,0,0,1,1,0
401121806,Marist Red Foxes,TEAM,TOTAL,TOTAL,False,,24,56,16,37,8,19,12,14,7,20,27,9,5,1,10,19,68
401121806,Marist Red Foxes,I. Lamb,3936028,,True,28.0,1,5,1,3,0,2,2,2,2,4,6,0,1,0,0,5,4
401121806,Marist Red Foxes,R. Funk,3936026,,True,41.0,5,11,2,3,3,8,5,5,0,1,1,0,0,0,1,3,18
401121806,Marist Red Foxes,T. Sjoberg,4067328,,True,7.0,0,1,0,1,0,0,0,0,1,0,1,0,0,0,0,3,0
401121806,Marist Red Foxes,B. Parker,3936030,,True,35.0,9,15,9,15,0,0,4,6,2,3,5,4,1,0,4,5,22
401121806,Marist Red Foxes,D. Knudsen,3936027,,True,14.0,2,5,1,3,1,2,0,0,0,1,1,0,0,0,0,0,5
401121806,Marist Red Foxes,L. Nedrow,4398414,,False,5.0,1,2,0,0,1,2,0,0,0,1,1,0,0,0,2,1,3
401121806,Marist Red Foxes,A. Dozic,3923222,,False,32.0,4,9,2,5,2,4,1,1,0,4,4,3,2,0,0,0,11
401121806,Marist Red Foxes,M. Herasme,4398413,,False,21.0,0,0,0,0,0,0,0,0,1,1,2,1,0,1,0,1,0
401121806,Marist Red Foxes,D. Hines,4398410,,False,31.0,2,7,1,6,1,1,0,0,0,2,2,1,1,0,2,0,5
401121806,Marist Red Foxes,A. Williams,4279709,,False,11.0,0,1,0,1,0,0,0,0,0,2,2,0,0,0,1,1,0
401121806,Marist Red Foxes,TEAM,TOTAL,TOTAL,False,,24,56,16,37,8,19,12,14,7,20,27,9,5,1,10,19,68
401121805,Manhattan Jaspers,T. Reynolds,4398107,,True,16.0,1,4,0,0,1,4,0,0,0,0,0,2,0,0,0,2,3
401121805,Manhattan Jaspers,W. Williams,4279701,,True,29.0,11,15,11,15,0,0,5,7,4,1,5,0,1,1,1,4,27
401121805,Manhattan Jaspers,C. Hinckson,4398106,,True,23.0,0,6,0,6,0,0,1,2,3,2,5,3,5,0,2,4,1
401121805,Manhattan Jaspers,S. Stewart,4398104,,True,35.0,2,6,0,0,2,6,2,2,0,0,0,1,0,0,3,3,8
401121805,Manhattan Jaspers,N. Mack,4279703,,True,35.0,3,5,0,1,3,4,4,4,1,1,2,3,0,0,1,0,13
401121805,Manhattan Jaspers,E. Ebube,4279705,,False,16.0,0,3,0,2,0,1,0,0,3,2,5,0,0,0,2,5,0
401121805,Manhattan Jaspers,T. Greene,4398108,,False,32.0,2,8,2,4,0,4,2,6,2,5,7,0,0,0,4,1,6
401121805,Manhattan Jaspers,E. Buchanan,4398103,,False,9.0,0,3,0,3,0,0,0,0,1,0,1,1,0,0,0,1,0
401121805,Manhattan Jaspers,T. Capuano,3948706,,False,11.0,2,4,1,1,1,3,0,0,0,0,0,1,0,0,0,0,5
401121805,Manhattan Jaspers,S. Usilo,3138468,,False,19.0,1,2,1,1,0,1,0,0,0,5,5,1,1,0,1,2,2
401121805,Manhattan Jaspers,TEAM,TOTAL,TOTAL,False,,22,56,15,33,7,23,14,21,14,20,34,12,7,1,14,22,65
401121805,Manhattan Jaspers,T. Reynolds,4398107,,True,16.0,1,4,0,0,1,4,0,0,0,0,0,2,0,0,0,2,3
401121805,Manhattan Jaspers,W. Williams,4279701,,True,29.0,11,15,11,15,0,0,5,7,4,1,5,0,1,1,1,4,27
401121805,Manhattan Jaspers,C. Hinckson,4398106,,True,23.0,0,6,0,6,0,0,1,2,3,2,5,3,5,0,2,4,1
401121805,Manhattan Jaspers,S. Stewart,4398104,,True,35.0,2,6,0,0,2,6,2,2,0,0,0,1,0,0,3,3,8
401121805,Manhattan Jaspers,N. Mack,4279703,,True,35.0,3,5,0,1,3,4,4,4,1,1,2,3,0,0,1,0,13
401121805,Manhattan Jaspers,E. Ebube,4279705,,False,16.0,0,3,0,2,0,1,0,0,3,2,5,0,0,0,2,5,0
401121805,Manhattan Jaspers,T. Greene,4398108,,False,32.0,2,8,2,4,0,4,2,6,2,5,7,0,0,0,4,1,6
401121805,Manhattan Jaspers,E. Buchanan,4398103,,False,9.0,0,3,0,3,0,0,0,0,1,0,1,1,0,0,0,1,0
401121805,Manhattan Jaspers,T. Capuano,3948706,,False,11.0,2,4,1,1,1,3,0,0,0,0,0,1,0,0,0,0,5
401121805,Manhattan Jaspers,S. Usilo,3138468,,False,19.0,1,2,1,1,0,1,0,0,0,5,5,1,1,0,1,2,2
401121805,Manhattan Jaspers,TEAM,TOTAL,TOTAL,False,,22,56,15,33,7,23,14,21,14,20,34,12,7,1,14,22,65
401121805,Canisius Golden Griffins,S. Hitchon,4279482,,True,11.0,0,2,0,2,0,0,2,4,0,1,1,1,0,0,4,2,2
401121805,Canisius Golden Griffins,J. White,4279478,,True,33.0,7,7,7,7,0,0,2,3,1,3,4,0,1,1,3,2,16
401121805,Canisius Golden Griffins,T. Molson,4279481,,True,35.0,3,9,1,3,2,6,7,10,0,3,3,1,2,0,2,5,15
401121805,Canisius Golden Griffins,M. Johnson,4067275,,True,43.0,3,9,2,4,1,5,4,4,1,5,6,6,0,0,3,3,11
401121805,Canisius Golden Griffins,J. Sanks,3141259,,True,40.0,1,8,0,3,1,5,0,0,1,1,2,1,0,0,1,4,3
401121805,Canisius Golden Griffins,M. Lotts,4279480,,False,4.0,0,0,0,0,0,0,0,0,0,1,1,1,0,1,0,0,0
401121805,Canisius Golden Griffins,D. St. Louis,4067280,,False,4.0,0,0,0,0,0,0,0,0,0,0,0,0,0,1,0,1,0
401121805,Canisius Golden Griffins,J. Faulkner,3137250,,False,33.0,8,10,6,7,2,3,2,2,3,5,8,3,0,1,0,1,20
401121805,Canisius Golden Griffins,J. Henderson,4398046,,False,22.0,1,5,1,4,0,1,0,0,1,0,1,0,0,0,0,1,2
401121805,Canisius Golden Griffins,TEAM,TOTAL,TOTAL,False,,23,50,17,30,6,20,17,23,8,21,29,13,3,4,14,19,69
401121805,Canisius Golden Griffins,S. Hitchon,4279482,,True,11.0,0,2,0,2,0,0,2,4,0,1,1,1,0,0,4,2,2
401121805,Canisius Golden Griffins,J. White,4279478,,True,33.0,7,7,7,7,0,0,2,3,1,3,4,0,1,1,3,2,16
401121805,Canisius Golden Griffins,T. Molson,4279481,,True,35.0,3,9,1,3,2,6,7,10,0,3,3,1,2,0,2,5,15
401121805,Canisius Golden Griffins,M. Johnson,4067275,,True,43.0,3,9,2,4,1,5,4,4,1,5,6,6,0,0,3,3,11
401121805,Canisius Golden Griffins,J. Sanks,3141259,,True,40.0,1,8,0,3,1,5,0,0,1,1,2,1,0,0,1,4,3
401121805,Canisius Golden Griffins,M. Lotts,4279480,,False,4.0,0,0,0,0,0,0,0,0,0,1,1,1,0,1,0,0,0
401121805,Canisius Golden Griffins,D. St. Louis,4067280,,False,4.0,0,0,0,0,0,0,0,0,0,0,0,0,0,1,0,1,0
401121805,Canisius Golden Griffins,J. Faulkner,3137250,,False,33.0,8,10,6,7,2,3,2,2,3,5,8,3,0,1,0,1,20
401121805,Canisius Golden Griffins,J. Henderson,4398046,,False,22.0,1,5,1,4,0,1,0,0,1,0,1,0,0,0,0,1,2
401121805,Canisius Golden Griffins,TEAM,TOTAL,TOTAL,False,,23,50,17,30,6,20,17,23,8,21,29,13,3,4,14,19,69
401121804,Saint Peter's Peacocks,KC Ndefo,4398386,,True,33.0,3,4,2,3,1,1,5,5,0,4,4,1,1,4,4,5,12
401121804,Saint Peter's Peacocks,S. Idowu,3922042,,True,30.0,4,8,4,7,0,1,2,2,1,8,9,0,1,3,0,4,10
401121804,Saint Peter's Peacocks,D. Watson,4398384,,True,37.0,3,7,2,3,1,4,2,2,0,2,2,5,1,0,6,1,9
401121804,Saint Peter's Peacocks,Q. Taylor,4067357,,True,22.0,2,4,2,4,0,0,1,2,3,5,8,1,0,0,2,3,5
401121804,Saint Peter's Peacocks,D. Turner,4067356,,True,39.0,9,16,5,8,4,8,1,2,1,3,4,1,1,1,1,2,23
401121804,Saint Peter's Peacocks,D. Woods,3919424,,False,9.0,1,1,1,1,0,0,1,2,1,1,2,0,0,0,1,3,3
401121804,Saint Peter's Peacocks,K. Brown,4398385,,False,8.0,0,1,0,0,0,1,0,0,0,1,1,0,0,0,0,1,0
401121804,Saint Peter's Peacocks,M. Dixon,4279758,,False,22.0,4,5,3,4,1,1,0,0,1,1,2,1,0,0,1,2,9
401121804,Saint Peter's Peacocks,TEAM,TOTAL,TOTAL,False,,26,46,19,30,7,16,12,15,7,25,32,9,4,8,17,21,71
401121804,Saint Peter's Peacocks,KC Ndefo,4398386,,True,33.0,3,4,2,3,1,1,5,5,0,4,4,1,1,4,4,5,12
401121804,Saint Peter's Peacocks,S. Idowu,3922042,,True,30.0,4,8,4,7,0,1,2,2,1,8,9,0,1,3,0,4,10
401121804,Saint Peter's Peacocks,D. Watson,4398384,,True,37.0,3,7,2,3,1,4,2,2,0,2,2,5,1,0,6,1,9
401121804,Saint Peter's Peacocks,Q. Taylor,4067357,,True,22.0,2,4,2,4,0,0,1,2,3,5,8,1,0,0,2,3,5
401121804,Saint Peter's Peacocks,D. Turner,4067356,,True,39.0,9,16,5,8,4,8,1,2,1,3,4,1,1,1,1,2,23
401121804,Saint Peter's Peacocks,D. Woods,3919424,,False,9.0,1,1,1,1,0,0,1,2,1,1,2,0,0,0,1,3,3
401121804,Saint Peter's Peacocks,K. Brown,4398385,,False,8.0,0,1,0,0,0,1,0,0,0,1,1,0,0,0,0,1,0
401121804,Saint Peter's Peacocks,M. Dixon,4279758,,False,22.0,4,5,3,4,1,1,0,0,1,1,2,1,0,0,1,2,9
401121804,Saint Peter's Peacocks,TEAM,TOTAL,TOTAL,False,,26,46,19,30,7,16,12,15,7,25,32,9,4,8,17,21,71
401121804,Iona Gaels,T. Agee,4398087,,True,35.0,9,17,8,14,1,3,7,8,3,3,6,0,2,1,2,5,26
401121804,Iona Gaels,E.J. Crawford,4067295,,True,40.0,8,15,5,10,3,5,7,8,1,3,4,1,1,0,0,1,26
401121804,Iona Gaels,A. Gist,4067164,,True,30.0,0,4,0,2,0,2,2,3,0,1,1,4,0,0,0,3,2
401121804,Iona Gaels,B. Perez,3948791,,True,24.0,0,2,0,1,0,1,1,2,0,0,0,1,2,0,1,2,1
401121804,Iona Gaels,R. McGill,3948698,,True,40.0,7,12,5,8,2,4,2,3,1,1,2,2,2,0,2,2,18
401121804,Iona Gaels,J. Maxwell,4398088,,False,9.0,0,2,0,1,0,1,0,0,0,0,0,0,0,0,0,2,0
401121804,Iona Gaels,A. Ristanovic,4279492,,False,20.0,0,2,0,0,0,2,0,0,1,1,2,0,0,0,0,2,0
401121804,Iona Gaels,P. Hudson,4398089,,False,2.0,0,0,0,0,0,0,0,0,0,0,0,0,1,0,0,0,0
401121804,Iona Gaels,TEAM,TOTAL,TOTAL,False,,24,54,18,36,6,18,19,24,6,13,19,8,8,1,5,17,73
401121804,Iona Gaels,T. Agee,4398087,,True,35.0,9,17,8,14,1,3,7,8,3,3,6,0,2,1,2,5,26
401121804,Iona Gaels,E.J. Crawford,4067295,,True,40.0,8,15,5,10,3,5,7,8,1,3,4,1,1,0,0,1,26
401121804,Iona Gaels,A. Gist,4067164,,True,30.0,0,4,0,2,0,2,2,3,0,1,1,4,0,0,0,3,2
401121804,Iona Gaels,B. Perez,3948791,,True,24.0,0,2,0,1,0,1,1,2,0,0,0,1,2,0,1,2,1
401121804,Iona Gaels,R. McGill,3948698,,True,40.0,7,12,5,8,2,4,2,3,1,1,2,2,2,0,2,2,18
401121804,Iona Gaels,J. Maxwell,4398088,,False,9.0,0,2,0,1,0,1,0,0,0,0,0,0,0,0,0,2,0
401121804,Iona Gaels,A. Ristanovic,4279492,,False,20.0,0,2,0,0,0,2,0,0,1,1,2,0,0,0,0,2,0
401121804,Iona Gaels,P. Hudson,4398089,,False,2.0,0,0,0,0,0,0,0,0,0,0,0,0,1,0,0,0,0
401121804,Iona Gaels,TEAM,TOTAL,TOTAL,False,,24,54,18,36,6,18,19,24,6,13,19,8,8,1,5,17,73
401121803,Siena Saints,S. Seymour,4398391,,True,23.0,6,8,0,0,6,8,0,0,0,0,0,0,0,0,0,0,18
401121803,Siena Saints,E. Fisher,3913235,,True,38.0,7,11,6,9,1,2,7,8,0,6,6,1,0,0,3,0,22
401121803,Siena Saints,K. Degnan,3138282,,True,33.0,5,9,3,4,2,5,1,2,1,6,7,2,0,0,1,4,13
401121803,Siena Saints,J. Pickett,4398390,,True,38.0,6,9,5,6,1,3,7,8,0,1,1,6,2,4,0,2,20
401121803,Siena Saints,M. Camper,4279751,,True,31.0,1,2,0,1,1,1,0,0,0,3,3,5,1,0,5,5,3
401121803,Siena Saints,T. Huerter Jr.,4067350,,False,2.0,0,0,0,0,0,0,0,0,0,1,1,0,0,0,0,0,0
401121803,Siena Saints,J. Ratliff,4398392,,False,4.0,0,0,0,0,0,0,0,0,1,0,1,0,0,0,1,0,0
401121803,Siena Saints,K. Smithen,3133848,,False,31.0,3,4,2,2,1,2,4,5,0,4,4,3,2,0,3,2,11
401121803,Siena Saints,TEAM,TOTAL,TOTAL,False,,28,43,16,22,12,21,19,23,2,22,24,17,5,4,13,13,87
401121803,Siena Saints,S. Seymour,4398391,,True,23.0,6,8,0,0,6,8,0,0,0,0,0,0,0,0,0,0,18
401121803,Siena Saints,E. Fisher,3913235,,True,38.0,7,11,6,9,1,2,7,8,0,6,6,1,0,0,3,0,22
401121803,Siena Saints,K. Degnan,3138282,,True,33.0,5,9,3,4,2,5,1,2,1,6,7,2,0,0,1,4,13
401121803,Siena Saints,J. Pickett,4398390,,True,38.0,6,9,5,6,1,3,7,8,0,1,1,6,2,4,0,2,20
401121803,Siena Saints,M. Camper,4279751,,True,31.0,1,2,0,1,1,1,0,0,0,3,3,5,1,0,5,5,3
401121803,Siena Saints,T. Huerter Jr.,4067350,,False,2.0,0,0,0,0,0,0,0,0,0,1,1,0,0,0,0,0,0
401121803,Siena Saints,J. Ratliff,4398392,,False,4.0,0,0,0,0,0,0,0,0,1,0,1,0,0,0,1,0,0
401121803,Siena Saints,K. Smithen,3133848,,False,31.0,3,4,2,2,1,2,4,5,0,4,4,3,2,0,3,2,11
401121803,Siena Saints,TEAM,TOTAL,TOTAL,False,,28,43,16,22,12,21,19,23,2,22,24,17,5,4,13,13,87
401121803,Rider Broncs,F. Scott,3922033,,True,29.0,3,8,2,5,1,3,2,4,0,3,3,1,2,0,1,0,9
401121803,Rider Broncs,T. Marshall,4067348,,True,29.0,10,15,10,15,0,0,2,3,7,1,8,1,1,2,2,3,22
401121803,Rider Broncs,S. Jordan,4067349,,True,37.0,6,15,5,11,1,4,1,2,1,0,1,3,1,0,2,4,14
401121803,Rider Broncs,K. Williams,3946983,,True,15.0,0,1,0,1,0,0,0,0,0,1,1,1,0,0,1,3,0
401121803,Rider Broncs,A. Durham,3138490,,True,35.0,5,11,3,6,2,5,0,0,2,3,5,4,0,0,1,3,12
401121803,Rider Broncs,K. Cisse,4279746,,False,2.0,0,0,0,0,0,0,0,0,0,0,0,0,0,0,0,0,0
401121803,Rider Broncs,D. Eke,3941312,,False,7.0,0,0,0,0,0,0,0,0,1,2,3,1,0,0,0,2,0
401121803,Rider Broncs,D. Vaughn,4067347,,False,19.0,4,7,4,5,0,2,4,5,3,2,5,0,1,0,3,2,12
401121803,Rider Broncs,J. Allen,4067345,,False,27.0,3,10,0,1,3,9,3,3,0,3,3,0,0,0,0,4,12
401121803,Rider Broncs,TEAM,TOTAL,TOTAL,False,,31,67,24,44,7,23,12,17,17,15,32,11,5,2,10,21,81
401121803,Rider Broncs,F. Scott,3922033,,True,29.0,3,8,2,5,1,3,2,4,0,3,3,1,2,0,1,0,9
401121803,Rider Broncs,T. Marshall,4067348,,True,29.0,10,15,10,15,0,0,2,3,7,1,8,1,1,2,2,3,22
401121803,Rider Broncs,S. Jordan,4067349,,True,37.0,6,15,5,11,1,4,1,2,1,0,1,3,1,0,2,4,14
401121803,Rider Broncs,K. Williams,3946983,,True,15.0,0,1,0,1,0,0,0,0,0,1,1,1,0,0,1,3,0
401121803,Rider Broncs,A. Durham,3138490,,True,35.0,5,11,3,6,2,5,0,0,2,3,5,4,0,0,1,3,12
401121803,Rider Broncs,K. Cisse,4279746,,False,2.0,0,0,0,0,0,0,0,0,0,0,0,0,0,0,0,0,0
401121803,Rider Broncs,D. Eke,3941312,,False,7.0,0,0,0,0,0,0,0,0,1,2,3,1,0,0,0,2,0
401121803,Rider Broncs,D. Vaughn,4067347,,False,19.0,4,7,4,5,0,2,4,5,3,2,5,0,1,0,3,2,12
401121803,Rider Broncs,J. Allen,4067345,,False,27.0,3,10,0,1,3,9,3,3,0,3,3,0,0,0,0,4,12
401121803,Rider Broncs,TEAM,TOTAL,TOTAL,False,,31,67,24,44,7,23,12,17,17,15,32,11,5,2,10,21,81
401121802,Quinnipiac Bobcats,J. Rigoni,4279743,,True,34.0,7,11,0,0,7,11,9,9,0,3,3,0,0,0,0,1,30
401121802,Quinnipiac Bobcats,A. Bundu,3947028,,True,18.0,1,3,1,3,0,0,0,0,3,2,5,0,0,1,2,3,2
401121802,Quinnipiac Bobcats,T. Williams,4398399,,True,24.0,1,4,0,1,1,3,2,2,0,1,1,2,0,0,2,4,5
401121802,Quinnipiac Bobcats,R. Kelly,4279741,,True,34.0,3,5,3,3,0,2,4,5,0,0,0,11,2,0,4,4,10
401121802,Quinnipiac Bobcats,C. Young,4070684,,True,40.0,10,18,2,2,8,16,5,6,2,5,7,0,1,0,4,0,33
401121802,Quinnipiac Bobcats,K. Marfo,4066877,,False,19.0,2,2,2,2,0,0,2,2,1,6,7,2,0,1,0,4,6
401121802,Quinnipiac Bobcats,T. Pickron,4398400,,False,21.0,2,8,0,4,2,4,0,0,1,2,3,0,0,0,0,3,6
401121802,Quinnipiac Bobcats,T. Atson,4066478,,False,6.0,0,1,0,0,0,1,0,0,0,1,1,0,0,0,1,1,0
401121802,Quinnipiac Bobcats,Aa. Robinson,3947024,,False,4.0,0,1,0,0,0,1,0,0,0,0,0,0,0,0,0,1,0
401121802,Quinnipiac Bobcats,TEAM,TOTAL,TOTAL,False,,26,53,8,15,18,38,22,24,8,22,30,15,3,2,14,21,92
401121802,Quinnipiac Bobcats,J. Rigoni,4279743,,True,34.0,7,11,0,0,7,11,9,9,0,3,3,0,0,0,0,1,30
401121802,Quinnipiac Bobcats,A. Bundu,3947028,,True,18.0,1,3,1,3,0,0,0,0,3,2,5,0,0,1,2,3,2
401121802,Quinnipiac Bobcats,T. Williams,4398399,,True,24.0,1,4,0,1,1,3,2,2,0,1,1,2,0,0,2,4,5
401121802,Quinnipiac Bobcats,R. Kelly,4279741,,True,34.0,3,5,3,3,0,2,4,5,0,0,0,11,2,0,4,4,10
401121802,Quinnipiac Bobcats,C. Young,4070684,,True,40.0,10,18,2,2,8,16,5,6,2,5,7,0,1,0,4,0,33
401121802,Quinnipiac Bobcats,K. Marfo,4066877,,False,19.0,2,2,2,2,0,0,2,2,1,6,7,2,0,1,0,4,6
401121802,Quinnipiac Bobcats,T. Pickron,4398400,,False,21.0,2,8,0,4,2,4,0,0,1,2,3,0,0,0,0,3,6
401121802,Quinnipiac Bobcats,T. Atson,4066478,,False,6.0,0,1,0,0,0,1,0,0,0,1,1,0,0,0,1,1,0
401121802,Quinnipiac Bobcats,Aa. Robinson,3947024,,False,4.0,0,1,0,0,0,1,0,0,0,0,0,0,0,0,0,1,0
401121802,Quinnipiac Bobcats,TEAM,TOTAL,TOTAL,False,,26,53,8,15,18,38,22,24,8,22,30,15,3,2,14,21,92
401121802,Monmouth Hawks,M. Traore,3975762,,True,25.0,8,11,8,11,0,0,3,3,2,3,5,0,1,0,2,2,19
401121802,Monmouth Hawks,D. Quinn,3948714,,True,27.0,4,6,4,6,0,0,4,7,5,2,7,0,1,0,0,2,12
401121802,Monmouth Hawks,M. McClary,4279736,,True,26.0,5,8,5,6,0,2,4,6,1,3,4,3,1,0,0,2,14
401121802,Monmouth Hawks,L. Pillari,3948713,,True,21.0,4,5,3,3,1,2,1,1,0,1,1,2,1,0,1,1,10
401121802,Monmouth Hawks,N. Rutherford,3946977,,True,27.0,4,6,3,4,1,2,2,2,0,2,2,3,0,1,0,3,11
401121802,Monmouth Hawks,M. Martin,4279733,,False,10.0,1,2,0,1,1,1,0,0,0,2,2,0,1,1,0,1,3
401121802,Monmouth Hawks,S. Chaput,4398409,,False,5.0,0,1,0,0,0,1,0,0,0,0,0,0,0,0,0,2,0
401121802,Monmouth Hawks,D. Hammond,4279734,,False,29.0,3,10,1,4,2,6,2,3,0,2,2,2,1,0,0,1,10
401121802,Monmouth Hawks,R. Salnave,4067329,,False,30.0,6,14,5,13,1,1,6,6,1,5,6,4,1,0,2,2,19
401121802,Monmouth Hawks,TEAM,TOTAL,TOTAL,False,,35,63,29,48,6,15,22,28,10,21,31,14,7,2,5,16,98
401121802,Monmouth Hawks,M. Traore,3975762,,True,25.0,8,11,8,11,0,0,3,3,2,3,5,0,1,0,2,2,19
401121802,Monmouth Hawks,D. Quinn,3948714,,True,27.0,4,6,4,6,0,0,4,7,5,2,7,0,1,0,0,2,12
401121802,Monmouth Hawks,M. McClary,4279736,,True,26.0,5,8,5,6,0,2,4,6,1,3,4,3,1,0,0,2,14
401121802,Monmouth Hawks,L. Pillari,3948713,,True,21.0,4,5,3,3,1,2,1,1,0,1,1,2,1,0,1,1,10
401121802,Monmouth Hawks,N. Rutherford,3946977,,True,27.0,4,6,3,4,1,2,2,2,0,2,2,3,0,1,0,3,11
401121802,Monmouth Hawks,M. Martin,4279733,,False,10.0,1,2,0,1,1,1,0,0,0,2,2,0,1,1,0,1,3
401121802,Monmouth Hawks,S. Chaput,4398409,,False,5.0,0,1,0,0,0,1,0,0,0,0,0,0,0,0,0,2,0
401121802,Monmouth Hawks,D. Hammond,4279734,,False,29.0,3,10,1,4,2,6,2,3,0,2,2,2,1,0,0,1,10
401121802,Monmouth Hawks,R. Salnave,4067329,,False,30.0,6,14,5,13,1,1,6,6,1,5,6,4,1,0,2,2,19
401121802,Monmouth Hawks,TEAM,TOTAL,TOTAL,False,,35,63,29,48,6,15,22,28,10,21,31,14,7,2,5,16,98
401121801,Siena Saints,S. Seymour,4398391,,True,32.0,3,9,0,0,3,9,0,0,0,0,0,0,0,0,0,1,9
401121801,Siena Saints,E. Fisher,3913235,,True,35.0,6,18,6,15,0,3,3,4,1,4,5,0,0,2,1,4,15
401121801,Siena Saints,K. Degnan,3138282,,True,34.0,3,5,2,2,1,3,0,0,1,7,8,2,0,0,1,2,7
401121801,Siena Saints,J. Pickett,4398390,,True,38.0,6,14,4,7,2,7,1,1,1,6,7,8,0,0,2,4,15
401121801,Siena Saints,M. Camper,4279751,,True,21.0,1,5,1,4,0,1,1,2,0,4,4,0,0,0,1,3,3
401121801,Siena Saints,T. Huerter Jr.,4067350,,False,2.0,0,0,0,0,0,0,0,0,1,0,1,0,0,0,0,0,0
401121801,Siena Saints,J. Ratliff,4398392,,False,1.0,0,0,0,0,0,0,0,0,0,0,0,0,0,0,0,0,0
401121801,Siena Saints,P. Morastoni,4293127,,False,1.0,0,0,0,0,0,0,0,0,0,0,0,0,0,0,0,0,0
401121801,Siena Saints,B. Bayer,4065720,,False,1.0,0,0,0,0,0,0,0,0,0,0,0,0,0,0,0,0,0
401121801,Siena Saints,K. Smithen,3133848,,False,35.0,3,8,1,3,2,5,0,0,1,1,2,3,3,0,0,1,8
401121801,Siena Saints,TEAM,TOTAL,TOTAL,False,,22,59,14,31,8,28,5,7,7,23,30,13,3,2,6,15,57
401121801,Siena Saints,S. Seymour,4398391,,True,32.0,3,9,0,0,3,9,0,0,0,0,0,0,0,0,0,1,9
401121801,Siena Saints,E. Fisher,3913235,,True,35.0,6,18,6,15,0,3,3,4,1,4,5,0,0,2,1,4,15
401121801,Siena Saints,K. Degnan,3138282,,True,34.0,3,5,2,2,1,3,0,0,1,7,8,2,0,0,1,2,7
401121801,Siena Saints,J. Pickett,4398390,,True,38.0,6,14,4,7,2,7,1,1,1,6,7,8,0,0,2,4,15
401121801,Siena Saints,M. Camper,4279751,,True,21.0,1,5,1,4,0,1,1,2,0,4,4,0,0,0,1,3,3
401121801,Siena Saints,T. Huerter Jr.,4067350,,False,2.0,0,0,0,0,0,0,0,0,1,0,1,0,0,0,0,0,0
401121801,Siena Saints,J. Ratliff,4398392,,False,1.0,0,0,0,0,0,0,0,0,0,0,0,0,0,0,0,0,0
401121801,Siena Saints,P. Morastoni,4293127,,False,1.0,0,0,0,0,0,0,0,0,0,0,0,0,0,0,0,0,0
401121801,Siena Saints,B. Bayer,4065720,,False,1.0,0,0,0,0,0,0,0,0,0,0,0,0,0,0,0,0,0
401121801,Siena Saints,K. Smithen,3133848,,False,35.0,3,8,1,3,2,5,0,0,1,1,2,3,3,0,0,1,8
401121801,Siena Saints,TEAM,TOTAL,TOTAL,False,,22,59,14,31,8,28,5,7,7,23,30,13,3,2,6,15,57
401121801,Iona Gaels,T. Agee,4398087,,True,31.0,3,9,3,8,0,1,0,0,1,12,13,2,0,0,2,1,6
401121801,Iona Gaels,E.J. Crawford,4067295,,True,36.0,6,12,4,9,2,3,2,4,2,6,8,2,0,1,1,2,16
401121801,Iona Gaels,A. Gist,4067164,,True,36.0,7,13,4,8,3,5,5,6,0,1,1,3,0,0,1,1,22
401121801,Iona Gaels,B. Perez,3948791,,True,32.0,4,6,4,5,0,1,0,0,1,4,5,0,1,0,1,1,8
401121801,Iona Gaels,R. McGill,3948698,,True,39.0,5,10,2,2,3,8,5,6,2,4,6,3,2,0,2,1,18
401121801,Iona Gaels,J. Maxwell,4398088,,False,3.0,0,0,0,0,0,0,0,0,0,0,0,0,0,0,0,1,0
401121801,Iona Gaels,A. Ristanovic,4279492,,False,21.0,1,3,0,1,1,2,0,0,1,1,2,1,0,1,1,1,3
401121801,Iona Gaels,M. Rhem,4404249,,False,1.0,0,0,0,0,0,0,0,2,0,0,0,0,0,0,0,0,0
401121801,Iona Gaels,P. Hudson,4398089,,False,1.0,0,0,0,0,0,0,0,0,0,0,0,0,0,0,0,0,0
401121801,Iona Gaels,TEAM,TOTAL,TOTAL,False,,26,53,17,33,9,20,12,18,7,30,37,11,3,2,8,8,73
401121801,Iona Gaels,T. Agee,4398087,,True,31.0,3,9,3,8,0,1,0,0,1,12,13,2,0,0,2,1,6
401121801,Iona Gaels,E.J. Crawford,4067295,,True,36.0,6,12,4,9,2,3,2,4,2,6,8,2,0,1,1,2,16
401121801,Iona Gaels,A. Gist,4067164,,True,36.0,7,13,4,8,3,5,5,6,0,1,1,3,0,0,1,1,22
401121801,Iona Gaels,B. Perez,3948791,,True,32.0,4,6,4,5,0,1,0,0,1,4,5,0,1,0,1,1,8
401121801,Iona Gaels,R. McGill,3948698,,True,39.0,5,10,2,2,3,8,5,6,2,4,6,3,2,0,2,1,18
401121801,Iona Gaels,J. Maxwell,4398088,,False,3.0,0,0,0,0,0,0,0,0,0,0,0,0,0,0,0,1,0
401121801,Iona Gaels,A. Ristanovic,4279492,,False,21.0,1,3,0,1,1,2,0,0,1,1,2,1,0,1,1,1,3
401121801,Iona Gaels,M. Rhem,4404249,,False,1.0,0,0,0,0,0,0,0,2,0,0,0,0,0,0,0,0,0
401121801,Iona Gaels,P. Hudson,4398089,,False,1.0,0,0,0,0,0,0,0,0,0,0,0,0,0,0,0,0,0
401121801,Iona Gaels,TEAM,TOTAL,TOTAL,False,,26,53,17,33,9,20,12,18,7,30,37,11,3,2,8,8,73
401121800,Monmouth Hawks,M. Traore,3975762,,True,30.0,2,6,2,6,0,0,4,4,2,6,8,0,1,0,1,0,8
401121800,Monmouth Hawks,D. Quinn,3948714,,True,21.0,5,7,5,7,0,0,4,5,3,7,10,0,0,2,1,3,14
401121800,Monmouth Hawks,M. McClary,4279736,,True,26.0,3,7,2,6,1,1,3,7,2,0,2,2,0,0,2,2,10
401121800,Monmouth Hawks,D. Hammond,4279734,,True,31.0,8,11,7,9,1,2,2,3,0,3,3,1,1,0,1,2,19
401121800,Monmouth Hawks,R. Salnave,4067329,,True,30.0,1,8,1,7,0,1,3,4,0,7,7,2,1,0,0,2,5
401121800,Monmouth Hawks,S. Ibiezugbe,4067330,,False,4.0,0,0,0,0,0,0,0,0,0,0,0,0,0,1,1,1,0
401121800,Monmouth Hawks,M. Martin,4279733,,False,24.0,1,2,1,1,0,1,1,2,1,2,3,0,0,0,1,0,3
401121800,Monmouth Hawks,M. James Jr.,4404878,,False,0.0,0,0,0,0,0,0,0,0,0,0,0,0,0,0,0,0,0
401121800,Monmouth Hawks,S. Chaput,4398409,,False,11.0,2,2,2,2,0,0,2,2,0,3,3,1,1,0,2,1,6
401121800,Monmouth Hawks,D. Calloway Jr.,4398407,,False,0.0,0,0,0,0,0,0,0,0,0,0,0,0,0,0,0,0,0
401121800,Monmouth Hawks,L. Pillari,3948713,,False,17.0,2,7,0,3,2,4,0,0,0,1,1,1,0,0,1,2,6
401121800,Monmouth Hawks,N. Rutherford,3946977,,False,6.0,0,1,0,1,0,0,2,2,0,0,0,1,1,1,2,3,2
401121800,Monmouth Hawks,TEAM,TOTAL,TOTAL,False,,24,51,20,42,4,9,21,29,10,29,39,8,5,4,14,16,73
401121800,Monmouth Hawks,M. Traore,3975762,,True,30.0,2,6,2,6,0,0,4,4,2,6,8,0,1,0,1,0,8
401121800,Monmouth Hawks,D. Quinn,3948714,,True,21.0,5,7,5,7,0,0,4,5,3,7,10,0,0,2,1,3,14
401121800,Monmouth Hawks,M. McClary,4279736,,True,26.0,3,7,2,6,1,1,3,7,2,0,2,2,0,0,2,2,10
401121800,Monmouth Hawks,D. Hammond,4279734,,True,31.0,8,11,7,9,1,2,2,3,0,3,3,1,1,0,1,2,19
401121800,Monmouth Hawks,R. Salnave,4067329,,True,30.0,1,8,1,7,0,1,3,4,0,7,7,2,1,0,0,2,5
401121800,Monmouth Hawks,S. Ibiezugbe,4067330,,False,4.0,0,0,0,0,0,0,0,0,0,0,0,0,0,1,1,1,0
401121800,Monmouth Hawks,M. Martin,4279733,,False,24.0,1,2,1,1,0,1,1,2,1,2,3,0,0,0,1,0,3
401121800,Monmouth Hawks,M. James Jr.,4404878,,False,0.0,0,0,0,0,0,0,0,0,0,0,0,0,0,0,0,0,0
401121800,Monmouth Hawks,S. Chaput,4398409,,False,11.0,2,2,2,2,0,0,2,2,0,3,3,1,1,0,2,1,6
401121800,Monmouth Hawks,D. Calloway Jr.,4398407,,False,0.0,0,0,0,0,0,0,0,0,0,0,0,0,0,0,0,0,0
401121800,Monmouth Hawks,L. Pillari,3948713,,False,17.0,2,7,0,3,2,4,0,0,0,1,1,1,0,0,1,2,6
401121800,Monmouth Hawks,N. Rutherford,3946977,,False,6.0,0,1,0,1,0,0,2,2,0,0,0,1,1,1,2,3,2
401121800,Monmouth Hawks,TEAM,TOTAL,TOTAL,False,,24,51,20,42,4,9,21,29,10,29,39,8,5,4,14,16,73
401121800,Canisius Golden Griffins,S. Hitchon,4279482,,True,19.0,4,9,4,7,0,2,0,0,0,2,2,0,0,2,2,2,8
401121800,Canisius Golden Griffins,J. White,4279478,,True,35.0,4,5,3,4,1,1,2,4,2,4,6,1,1,0,0,4,11
401121800,Canisius Golden Griffins,T. Molson,4279481,,True,35.0,6,18,6,14,0,4,5,6,1,6,7,1,3,0,2,3,17
401121800,Canisius Golden Griffins,M. Johnson,4067275,,True,39.0,4,10,4,8,0,2,2,3,1,3,4,5,3,0,4,3,10
401121800,Canisius Golden Griffins,J. Sanks,3141259,,True,28.0,1,7,0,0,1,7,3,4,0,1,1,1,1,0,1,4,6
401121800,Canisius Golden Griffins,M. Lotts,4279480,,False,3.0,0,1,0,1,0,0,0,0,1,0,1,0,0,0,1,0,0
401121800,Canisius Golden Griffins,D. St. Louis,4067280,,False,5.0,0,0,0,0,0,0,0,0,0,0,0,0,0,1,1,1,0
401121800,Canisius Golden Griffins,J. Faulkner,3137250,,False,15.0,2,6,1,3,1,3,0,0,0,1,1,1,0,0,0,2,5
401121800,Canisius Golden Griffins,J. Henderson,4398046,,False,21.0,1,2,1,1,0,1,0,0,0,3,3,1,0,2,0,2,2
401121800,Canisius Golden Griffins,TEAM,TOTAL,TOTAL,False,,22,58,19,38,3,20,12,17,8,20,28,10,8,5,11,21,59
401121800,Canisius Golden Griffins,S. Hitchon,4279482,,True,19.0,4,9,4,7,0,2,0,0,0,2,2,0,0,2,2,2,8
401121800,Canisius Golden Griffins,J. White,4279478,,True,35.0,4,5,3,4,1,1,2,4,2,4,6,1,1,0,0,4,11
401121800,Canisius Golden Griffins,T. Molson,4279481,,True,35.0,6,18,6,14,0,4,5,6,1,6,7,1,3,0,2,3,17
401121800,Canisius Golden Griffins,M. Johnson,4067275,,True,39.0,4,10,4,8,0,2,2,3,1,3,4,5,3,0,4,3,10
401121800,Canisius Golden Griffins,J. Sanks,3141259,,True,28.0,1,7,0,0,1,7,3,4,0,1,1,1,1,0,1,4,6
401121800,Canisius Golden Griffins,M. Lotts,4279480,,False,3.0,0,1,0,1,0,0,0,0,1,0,1,0,0,0,1,0,0
401121800,Canisius Golden Griffins,D. St. Louis,4067280,,False,5.0,0,0,0,0,0,0,0,0,0,0,0,0,0,1,1,1,0
401121800,Canisius Golden Griffins,J. Faulkner,3137250,,False,15.0,2,6,1,3,1,3,0,0,0,1,1,1,0,0,0,2,5
401121800,Canisius Golden Griffins,J. Henderson,4398046,,False,21.0,1,2,1,1,0,1,0,0,0,3,3,1,0,2,0,2,2
401121800,Canisius Golden Griffins,TEAM,TOTAL,TOTAL,False,,22,58,19,38,3,20,12,17,8,20,28,10,8,5,11,21,59
401121799,Monmouth Hawks,M. Traore,3975762,,True,16.0,3,6,3,6,0,0,0,1,3,3,6,1,0,0,2,3,6
401121799,Monmouth Hawks,D. Quinn,3948714,,True,24.0,5,5,5,5,0,0,3,4,2,1,3,0,0,1,1,3,13
401121799,Monmouth Hawks,M. McClary,4279736,,True,21.0,3,5,2,4,1,1,0,0,0,2,2,0,0,0,1,5,7
401121799,Monmouth Hawks,D. Hammond,4279734,,True,31.0,4,11,4,4,0,7,0,0,0,3,3,1,0,0,1,1,8
401121799,Monmouth Hawks,R. Salnave,4067329,,True,22.0,1,4,1,4,0,0,0,1,1,2,3,3,2,0,4,3,2
401121799,Monmouth Hawks,N. Rutty,4398408,,False,2.0,0,0,0,0,0,0,0,0,0,0,0,0,0,0,0,0,0
401121799,Monmouth Hawks,S. Ibiezugbe,4067330,,False,10.0,1,4,1,4,0,0,1,2,2,4,6,0,0,0,0,0,3
401121799,Monmouth Hawks,M. Martin,4279733,,False,19.0,2,3,1,1,1,2,1,4,0,2,2,0,1,0,2,1,6
401121799,Monmouth Hawks,M. James Jr.,4404878,,False,2.0,0,1,0,0,0,1,0,0,0,1,1,0,0,0,0,0,0
401121799,Monmouth Hawks,S. Chaput,4398409,,False,7.0,0,0,0,0,0,0,0,0,0,0,0,2,0,0,1,0,0
401121799,Monmouth Hawks,D. Calloway Jr.,4398407,,False,2.0,0,3,0,0,0,3,0,0,1,0,1,0,1,0,0,0,0
401121799,Monmouth Hawks,G. Papas,4279735,,False,6.0,2,3,0,0,2,3,0,0,1,0,1,1,0,0,0,1,6
401121799,Monmouth Hawks,T. Gross Jr.,4065729,,False,2.0,0,1,0,0,0,1,0,0,0,0,0,0,0,0,0,1,0
401121799,Monmouth Hawks,L. Pillari,3948713,,False,19.0,1,7,1,3,0,4,0,0,1,0,1,0,0,0,1,1,2
401121799,Monmouth Hawks,N. Rutherford,3946977,,False,16.0,3,5,2,3,1,2,0,0,0,2,2,0,2,0,2,1,7
401121799,Monmouth Hawks,TEAM,TOTAL,TOTAL,False,,25,58,20,34,5,24,5,12,12,22,34,8,6,1,15,20,60
401121799,Monmouth Hawks,M. Traore,3975762,,True,16.0,3,6,3,6,0,0,0,1,3,3,6,1,0,0,2,3,6
401121799,Monmouth Hawks,D. Quinn,3948714,,True,24.0,5,5,5,5,0,0,3,4,2,1,3,0,0,1,1,3,13
401121799,Monmouth Hawks,M. McClary,4279736,,True,21.0,3,5,2,4,1,1,0,0,0,2,2,0,0,0,1,5,7
401121799,Monmouth Hawks,D. Hammond,4279734,,True,31.0,4,11,4,4,0,7,0,0,0,3,3,1,0,0,1,1,8
401121799,Monmouth Hawks,R. Salnave,4067329,,True,22.0,1,4,1,4,0,0,0,1,1,2,3,3,2,0,4,3,2
401121799,Monmouth Hawks,N. Rutty,4398408,,False,2.0,0,0,0,0,0,0,0,0,0,0,0,0,0,0,0,0,0
401121799,Monmouth Hawks,S. Ibiezugbe,4067330,,False,10.0,1,4,1,4,0,0,1,2,2,4,6,0,0,0,0,0,3
401121799,Monmouth Hawks,M. Martin,4279733,,False,19.0,2,3,1,1,1,2,1,4,0,2,2,0,1,0,2,1,6
401121799,Monmouth Hawks,M. James Jr.,4404878,,False,2.0,0,1,0,0,0,1,0,0,0,1,1,0,0,0,0,0,0
401121799,Monmouth Hawks,S. Chaput,4398409,,False,7.0,0,0,0,0,0,0,0,0,0,0,0,2,0,0,1,0,0
401121799,Monmouth Hawks,D. Calloway Jr.,4398407,,False,2.0,0,3,0,0,0,3,0,0,1,0,1,0,1,0,0,0,0
401121799,Monmouth Hawks,G. Papas,4279735,,False,6.0,2,3,0,0,2,3,0,0,1,0,1,1,0,0,0,1,6
401121799,Monmouth Hawks,T. Gross Jr.,4065729,,False,2.0,0,1,0,0,0,1,0,0,0,0,0,0,0,0,0,1,0
401121799,Monmouth Hawks,L. Pillari,3948713,,False,19.0,1,7,1,3,0,4,0,0,1,0,1,0,0,0,1,1,2
401121799,Monmouth Hawks,N. Rutherford,3946977,,False,16.0,3,5,2,3,1,2,0,0,0,2,2,0,2,0,2,1,7
401121799,Monmouth Hawks,TEAM,TOTAL,TOTAL,False,,25,58,20,34,5,24,5,12,12,22,34,8,6,1,15,20,60
401121799,Iona Gaels,T. Agee,4398087,,True,30.0,6,9,3,5,3,4,3,3,1,6,7,2,3,0,2,4,18
401121799,Iona Gaels,E.J. Crawford,4067295,,True,35.0,3,6,3,5,0,1,9,11,1,5,6,3,0,0,3,2,15
401121799,Iona Gaels,A. Gist,4067164,,True,40.0,6,12,1,3,5,9,5,5,0,1,1,4,0,0,2,1,22
401121799,Iona Gaels,B. Perez,3948791,,True,35.0,4,9,1,1,3,8,3,4,1,4,5,1,5,0,2,2,14
401121799,Iona Gaels,R. McGill,3948698,,True,28.0,4,9,3,6,1,3,1,2,2,2,4,3,3,1,0,4,10
401121799,Iona Gaels,J. Maxwell,4398088,,False,9.0,0,2,0,0,0,2,0,0,0,2,2,0,0,0,0,2,0
401121799,Iona Gaels,A. Ristanovic,4279492,,False,20.0,1,5,1,3,0,2,0,0,2,4,6,0,0,2,2,1,2
401121799,Iona Gaels,M. Rhem,4404249,,False,1.0,0,0,0,0,0,0,0,0,0,0,0,0,0,0,0,0,0
401121799,Iona Gaels,P. Hudson,4398089,,False,2.0,0,0,0,0,0,0,0,0,0,1,1,0,0,0,0,0,0
401121799,Iona Gaels,TEAM,TOTAL,TOTAL,False,,24,52,12,23,12,29,21,25,8,26,34,13,11,3,11,16,81
401121799,Iona Gaels,T. Agee,4398087,,True,30.0,6,9,3,5,3,4,3,3,1,6,7,2,3,0,2,4,18
401121799,Iona Gaels,E.J. Crawford,4067295,,True,35.0,3,6,3,5,0,1,9,11,1,5,6,3,0,0,3,2,15
401121799,Iona Gaels,A. Gist,4067164,,True,40.0,6,12,1,3,5,9,5,5,0,1,1,4,0,0,2,1,22
401121799,Iona Gaels,B. Perez,3948791,,True,35.0,4,9,1,1,3,8,3,4,1,4,5,1,5,0,2,2,14
401121799,Iona Gaels,R. McGill,3948698,,True,28.0,4,9,3,6,1,3,1,2,2,2,4,3,3,1,0,4,10
401121799,Iona Gaels,J. Maxwell,4398088,,False,9.0,0,2,0,0,0,2,0,0,0,2,2,0,0,0,0,2,0
401121799,Iona Gaels,A. Ristanovic,4279492,,False,20.0,1,5,1,3,0,2,0,0,2,4,6,0,0,2,2,1,2
401121799,Iona Gaels,M. Rhem,4404249,,False,1.0,0,0,0,0,0,0,0,0,0,0,0,0,0,0,0,0,0
401121799,Iona Gaels,P. Hudson,4398089,,False,2.0,0,0,0,0,0,0,0,0,0,1,1,0,0,0,0,0,0
401121799,Iona Gaels,TEAM,TOTAL,TOTAL,False,,24,52,12,23,12,29,21,25,8,26,34,13,11,3,11,16,81
401107075,Rider Broncs,F. Scott,3922033,,True,35.0,4,9,2,6,2,3,11,12,1,6,7,2,1,1,1,2,21
401107075,Rider Broncs,T. Marshall,4067348,,True,21.0,6,8,6,8,0,0,1,2,2,5,7,1,0,0,1,4,13
401107075,Rider Broncs,J. Allen,4067345,,True,34.0,6,15,4,7,2,8,3,3,0,3,3,1,3,0,1,1,17
401107075,Rider Broncs,K. Williams,3946983,,True,37.0,3,6,3,5,0,1,3,5,0,1,1,2,1,0,1,2,9
401107075,Rider Broncs,A. Durham,3138490,,True,37.0,2,7,2,4,0,3,2,2,1,0,1,4,0,0,1,0,6
401107075,Rider Broncs,A. Ogemuno-Johnson,4406151,,False,5.0,0,0,0,0,0,0,0,0,2,1,3,0,0,0,1,0,0
401107075,Rider Broncs,D. Eke,3941312,,False,19.0,3,3,3,3,0,0,2,4,3,1,4,1,0,0,0,3,8
401107075,Rider Broncs,A. Gilbert,3911886,,False,12.0,2,7,0,3,2,4,0,0,0,0,0,0,0,0,0,2,6
401107075,Rider Broncs,TEAM,TOTAL,TOTAL,False,,26,55,20,36,6,19,22,28,9,20,29,11,5,1,6,14,80
401107075,Cal State Northridge Matadors,L. Diane,4278738,,True,36.0,11,21,11,21,0,0,2,5,4,5,9,2,1,0,1,5,24
401107075,Cal State Northridge Matadors,M. Ou,4397453,,True,18.0,1,2,1,2,0,0,0,0,0,3,3,2,0,0,0,5,2
401107075,Cal State Northridge Matadors,D. Brown II,4397450,,True,30.0,2,4,1,1,1,3,3,5,1,1,2,4,0,0,2,2,8
401107075,Cal State Northridge Matadors,T. Gomez,4278736,,True,39.0,8,14,3,4,5,10,0,0,0,0,0,4,0,0,1,0,21
401107075,Cal State Northridge Matadors,C. Gottfried,3138494,,True,32.0,4,7,3,4,1,3,1,2,1,8,9,2,1,1,2,1,10
401107075,Cal State Northridge Matadors,J. Pearre,4278743,,False,7.0,0,0,0,0,0,0,0,0,0,1,1,1,0,1,0,3,0
401107075,Cal State Northridge Matadors,M. Kaba-Camara,4066894,,False,14.0,0,0,0,0,0,0,0,0,0,2,2,0,0,0,0,5,0
401107075,Cal State Northridge Matadors,B. Orr,3946047,,False,0.0,0,0,0,0,0,0,0,0,0,0,0,0,0,0,0,0,0
401107075,Cal State Northridge Matadors,R. Henderson Jr.,4397448,,False,24.0,7,11,5,7,2,4,0,0,3,1,4,1,0,0,2,1,16
401107075,Cal State Northridge Matadors,TEAM,TOTAL,TOTAL,False,,33,59,24,39,9,20,6,12,9,22,31,16,2,2,9,22,81
401101474,Marist Red Foxes,I. Lamb,3936028,,True,25.0,5,8,4,4,1,4,1,2,2,6,8,1,3,0,0,3,12
401101474,Marist Red Foxes,T. Sjoberg,4067328,,True,18.0,5,6,5,6,0,0,2,3,4,2,6,2,1,0,2,4,12
401101474,Marist Red Foxes,D. Hines,4398410,,True,25.0,3,6,2,4,1,2,3,3,0,1,1,2,2,1,0,2,10
401101474,Marist Red Foxes,B. Parker,3936030,,True,25.0,6,11,4,8,2,3,1,2,0,6,6,5,0,0,2,1,15
401101474,Marist Red Foxes,D. Knudsen,3936027,,True,21.0,1,2,1,1,0,1,0,0,0,0,0,0,2,0,1,2,2
401101474,Marist Red Foxes,L. Nedrow,4398414,,False,7.0,1,1,0,0,1,1,0,0,0,0,0,1,0,0,0,1,3
401101474,Marist Red Foxes,R. Funk,3936026,,False,29.0,1,11,0,1,1,10,0,0,0,2,2,1,0,0,1,1,3
401101474,Marist Red Foxes,A. Dozic,3923222,,False,15.0,2,5,2,4,0,1,0,0,1,3,4,2,0,1,1,1,4
401101474,Marist Red Foxes,M. Herasme,4398413,,False,15.0,2,3,2,2,0,1,2,3,0,2,2,0,2,0,4,0,6
401101474,Marist Red Foxes,A. Williams,4279709,,False,19.0,1,4,1,4,0,0,1,4,2,4,6,2,0,1,2,4,3
401101474,Marist Red Foxes,R. Carmello,4279708,,False,1.0,0,0,0,0,0,0,0,0,0,0,0,0,0,0,0,0,0
401101474,Marist Red Foxes,TEAM,TOTAL,TOTAL,False,,27,57,21,34,6,23,10,17,10,28,38,16,10,3,14,19,70
401100834,St. Francis Brooklyn Terriers,Y. Evans,4279650,,True,18.0,1,5,0,2,1,3,1,4,0,3,3,0,0,1,1,1,4
401100834,St. Francis Brooklyn Terriers,D. Celen,4067291,,True,5.0,1,2,1,2,0,0,0,0,1,2,3,0,0,0,3,3,2
401100834,St. Francis Brooklyn Terriers,J. Jordan,4279651,,True,35.0,5,12,1,5,4,7,0,0,1,3,4,0,1,1,2,0,14
401100834,St. Francis Brooklyn Terriers,R. Hurley,3913229,,True,14.0,1,2,1,2,0,0,0,0,0,2,2,0,1,0,1,1,2
401100834,St. Francis Brooklyn Terriers,G. Sanabria,3133979,,True,38.0,7,19,3,9,4,10,0,0,0,4,4,6,0,1,0,3,18
401100834,St. Francis Brooklyn Terriers,K. Williams,3155881,,False,32.0,3,5,2,3,1,2,0,0,2,7,9,2,2,0,1,2,7
401100834,St. Francis Brooklyn Terriers,C. Rohlehr,4398010,,False,24.0,1,4,1,4,0,0,2,5,4,5,9,0,0,3,0,3,4
401100834,St. Francis Brooklyn Terriers,C. Johnson,4067953,,False,10.0,1,5,1,5,0,0,0,0,2,2,4,1,0,1,1,3,2
401100834,St. Francis Brooklyn Terriers,C. Hawkins,4279649,,False,24.0,6,11,3,5,3,6,7,8,0,1,1,1,0,0,1,3,22
401100834,St. Francis Brooklyn Terriers,TEAM,TOTAL,TOTAL,False,,26,65,13,37,13,28,10,17,13,33,46,10,4,7,10,19,75
401100834,Niagara Purple Eagles,D. Robb,3907186,,True,31.0,6,12,5,11,1,1,4,6,1,3,4,0,1,4,2,3,17
401100834,Niagara Purple Eagles,R. Solomon,4398403,,True,20.0,4,8,2,4,2,4,2,4,3,3,6,0,1,0,3,4,12
401100834,Niagara Purple Eagles,K. Tate,4279738,,True,36.0,3,9,2,6,1,3,0,0,2,3,5,0,0,0,2,0,7
401100834,Niagara Purple Eagles,J. Towns,4067341,,True,27.0,0,7,0,7,0,0,2,2,0,3,3,2,0,0,3,0,2
401100834,Niagara Purple Eagles,C. Barton,3907182,,True,29.0,1,7,1,3,0,4,3,5,0,3,3,1,0,0,2,4,5
401100834,Niagara Purple Eagles,G. Kuakumensah,4279739,,False,25.0,2,5,2,2,0,3,6,6,1,9,10,0,0,1,0,3,10
401100834,Niagara Purple Eagles,G. King,3906490,,False,11.0,3,3,3,3,0,0,1,1,0,4,4,1,0,1,0,1,7
401100834,Niagara Purple Eagles,M. Hammond,4398404,,False,17.0,1,5,1,4,0,1,1,2,0,0,0,2,0,0,0,3,3
401100834,Niagara Purple Eagles,D. Fragala,4279737,,False,4.0,0,0,0,0,0,0,0,0,0,0,0,0,0,0,0,0,0
401100834,Niagara Purple Eagles,TEAM,TOTAL,TOTAL,False,,20,56,16,40,4,16,19,26,8,30,38,6,2,6,12,18,63
401100194,Iona Gaels,N. Nikolic,4398090,,True,10.0,2,3,2,3,0,0,1,2,1,0,1,0,0,0,1,1,5
401100194,Iona Gaels,E.J. Crawford,4067295,,True,36.0,8,12,8,10,0,2,3,3,0,3,3,5,1,1,2,4,19
401100194,Iona Gaels,A. Gist,4067164,,True,28.0,3,7,1,3,2,4,1,2,0,3,3,2,0,0,1,2,9
401100194,Iona Gaels,R. McGill,3948698,,True,37.0,4,7,4,6,0,1,4,5,0,3,3,5,3,0,3,4,12
401100194,Iona Gaels,I. Still,3938908,,True,25.0,2,3,0,0,2,3,2,4,1,0,1,2,1,0,4,3,8
401100194,Iona Gaels,J. Maxwell,4398088,,False,11.0,1,2,0,0,1,2,0,0,0,2,2,1,0,0,1,2,3
401100194,Iona Gaels,T. Agee,4398087,,False,20.0,4,7,4,6,0,1,4,8,0,9,9,0,0,0,0,3,12
401100194,Iona Gaels,A. Ristanovic,4279492,,False,14.0,3,5,0,1,3,4,0,0,0,2,2,1,1,0,2,0,9
401100194,Iona Gaels,B. Perez,3948791,,False,19.0,1,3,0,0,1,3,0,0,1,0,1,0,0,0,0,1,3
401100194,Iona Gaels,TEAM,TOTAL,TOTAL,False,,28,49,19,29,9,20,15,24,4,22,26,16,6,1,14,20,80
401100194,Hartford Hawks,G. Blagojevic,3917980,,True,39.0,8,15,8,13,0,2,3,5,4,5,9,0,0,0,3,4,19
401100194,Hartford Hawks,J. Carroll,3130746,,True,39.0,8,18,6,13,2,5,8,10,1,5,6,1,1,0,1,4,26
401100194,Hartford Hawks,T. Weatherington,4278214,,True,22.0,1,3,0,0,1,3,0,0,0,2,2,1,1,0,0,1,3
401100194,Hartford Hawks,J.R. Lynch,3917979,,True,40.0,7,13,7,9,0,4,1,2,2,3,5,3,2,0,3,1,15
401100194,Hartford Hawks,J. Dunne,3917978,,True,35.0,2,6,0,2,2,4,4,4,0,2,2,5,2,0,5,5,10
401100194,Hartford Hawks,D.J. Mitchell,4395893,,False,0.0,0,0,0,0,0,0,0,0,0,0,0,0,0,0,0,0,0
401100194,Hartford Hawks,R. Boxus,4395888,,False,5.0,0,0,0,0,0,0,0,0,0,0,0,0,0,0,0,2,0
401100194,Hartford Hawks,M. Twyman,3130743,,False,20.0,1,2,1,1,0,1,0,0,1,1,2,2,0,0,0,2,2
401100194,Hartford Hawks,TEAM,TOTAL,TOTAL,False,,27,57,22,38,5,19,16,21,9,21,30,12,6,0,13,19,75
401096968,Siena Saints,S. Seymour,4398391,,True,23.0,3,11,1,1,2,10,0,0,0,0,0,0,0,0,0,0,8
401096968,Siena Saints,E. Fisher,3913235,,True,32.0,7,14,7,13,0,1,0,0,1,6,7,3,0,1,1,3,14
401096968,Siena Saints,K. Degnan,3138282,,True,30.0,3,7,3,4,0,3,0,2,3,2,5,0,1,0,0,0,6
401096968,Siena Saints,J. Pickett,4398390,,True,37.0,3,8,1,4,2,4,0,0,1,2,3,1,1,2,2,2,8
401096968,Siena Saints,M. Camper,4279751,,True,21.0,2,2,2,2,0,0,0,0,1,3,4,0,0,0,1,0,4
401096968,Siena Saints,S. Friday IV,4067353,,False,8.0,1,2,1,2,0,0,0,0,0,2,2,0,0,0,1,1,2
401096968,Siena Saints,T. Huerter Jr.,4067350,,False,17.0,0,2,0,0,0,2,0,0,0,2,2,1,1,0,0,1,0
401096968,Siena Saints,J. Ratliff,4398392,,False,12.0,0,1,0,0,0,1,0,0,1,1,2,1,0,0,1,2,0
401096968,Siena Saints,B. Bayer,4065720,,False,7.0,1,3,0,0,1,3,0,0,0,0,0,0,0,0,1,0,3
401096968,Siena Saints,K. Smithen,3133848,,False,13.0,0,0,0,0,0,0,0,0,1,1,2,0,1,0,0,0,0
401096968,Siena Saints,TEAM,TOTAL,TOTAL,False,,20,50,15,26,5,24,0,2,8,20,28,6,4,3,9,9,45
401096968,Holy Cross Crusaders,M. Faw,4280072,,True,18.0,2,5,1,2,1,3,0,0,0,1,1,0,1,1,0,0,5
401096968,Holy Cross Crusaders,J. Floyd,3907455,,True,35.0,3,5,3,5,0,0,0,0,0,3,3,2,3,5,0,0,6
401096968,Holy Cross Crusaders,J. Grandison,4280073,,True,40.0,9,16,3,6,6,10,0,1,0,3,3,4,0,0,1,1,24
401096968,Holy Cross Crusaders,A. Butler,4280070,,True,35.0,5,11,3,7,2,4,0,0,5,6,11,5,0,0,0,4,12
401096968,Holy Cross Crusaders,C. Green,4280068,,True,39.0,3,8,3,4,0,4,0,0,0,4,4,1,2,0,3,1,6
401096968,Holy Cross Crusaders,C. Niego,4280071,,False,5.0,0,1,0,0,0,1,0,0,0,0,0,0,0,0,0,1,0
401096968,Holy Cross Crusaders,P. Benzan,3907453,,False,28.0,2,7,2,4,0,3,0,0,1,2,3,5,0,0,1,2,4
401096968,Holy Cross Crusaders,TEAM,TOTAL,TOTAL,False,,24,53,15,28,9,25,0,1,8,21,29,17,6,6,5,9,57
401096915,UAB Blazers,W. Butler,4397728,,True,26.0,3,4,3,4,0,0,0,0,1,6,7,0,1,0,1,4,6
401096915,UAB Blazers,L. Sullivan,3132486,,True,22.0,1,7,1,5,0,2,0,0,6,3,9,0,0,3,3,5,2
401096915,UAB Blazers,T. Lovan,4397726,,True,20.0,1,3,1,3,0,0,2,2,0,1,1,0,0,0,3,0,4
401096915,UAB Blazers,J. Bell,4067436,,True,35.0,6,9,4,5,2,4,1,2,0,2,2,2,0,0,2,2,15
401096915,UAB Blazers,J. Perry,3913199,,True,25.0,4,10,3,5,1,5,2,4,0,3,3,1,0,0,2,3,11
401096915,UAB Blazers,T. Pearson,4397727,,False,2.0,0,0,0,0,0,0,0,0,0,0,0,0,0,0,0,1,0
401096915,UAB Blazers,M. Gueye,4279106,,False,18.0,2,3,2,3,0,0,0,0,1,1,2,1,1,0,2,4,4
401096915,UAB Blazers,T. Scott-Grayson,4397725,,False,15.0,0,4,0,2,0,2,0,0,3,0,3,1,0,0,2,0,0
401096915,UAB Blazers,A. McCoy,4279104,,False,0.0,0,0,0,0,0,0,0,0,0,0,0,0,0,0,0,0,0
401096915,UAB Blazers,Z. Bryant,4279103,,False,37.0,9,14,7,10,2,4,6,7,0,5,5,4,7,0,7,3,26
401096915,UAB Blazers,TEAM,TOTAL,TOTAL,False,,26,54,21,37,5,17,11,15,13,24,37,9,9,3,22,22,68
401096915,Canisius Golden Griffins,S. Hitchon,4279482,,True,29.0,4,11,4,11,0,0,5,7,2,3,5,2,0,1,5,3,13
401096915,Canisius Golden Griffins,J. White,4279478,,True,18.0,0,1,0,1,0,0,0,0,0,1,1,0,2,0,1,0,0
401096915,Canisius Golden Griffins,T. Molson,4279481,,True,34.0,5,10,4,4,1,6,4,4,2,3,5,2,3,0,4,3,15
401096915,Canisius Golden Griffins,I. Reese,4067278,,True,33.0,3,12,3,9,0,3,0,0,1,5,6,3,1,0,3,1,6
401096915,Canisius Golden Griffins,M. Johnson,4067275,,True,30.0,2,8,2,4,0,4,2,3,0,2,2,3,2,0,3,3,6
401096915,Canisius Golden Griffins,K. Johnson-Alls,4398049,,False,18.0,1,3,0,1,1,2,2,2,1,2,3,0,1,1,0,2,5
401096915,Canisius Golden Griffins,D. St. Louis,4067280,,False,13.0,1,1,1,1,0,0,0,0,1,0,1,0,0,1,1,2,2
401096915,Canisius Golden Griffins,J. Faulkner,3137250,,False,10.0,0,3,0,1,0,2,2,2,0,0,0,0,0,0,1,1,2
401096915,Canisius Golden Griffins,J. Sanks,3141259,,False,15.0,3,4,1,1,2,3,1,2,0,0,0,1,0,0,2,3,9
401096915,Canisius Golden Griffins,TEAM,TOTAL,TOTAL,False,,19,53,15,33,4,20,16,20,12,16,28,11,9,3,20,18,58
401096908,Memphis Tigers,M. Parks Jr.,4278284,,True,17.0,7,8,7,8,0,0,0,0,3,2,5,0,1,1,2,3,14
401096908,Memphis Tigers,A. Lomax,4396633,,True,25.0,1,3,1,3,0,0,0,1,3,5,8,5,0,0,0,0,2
401096908,Memphis Tigers,T. Harris,4396632,,True,20.0,1,5,1,3,0,2,0,0,0,0,0,1,0,0,1,3,2
401096908,Memphis Tigers,R. Thornton,4278282,,True,23.0,2,3,2,3,0,0,1,2,1,2,3,0,0,2,4,2,5
401096908,Memphis Tigers,J. Martin,3907788,,True,35.0,4,11,3,7,1,4,1,2,1,5,6,2,0,1,4,2,10
401096908,Memphis Tigers,K. Davenport,4278280,,False,21.0,5,9,5,7,0,2,6,8,4,6,10,2,1,1,3,3,16
401096908,Memphis Tigers,I. Maurice,3912845,,False,8.0,1,2,1,2,0,0,0,0,0,1,1,0,0,0,3,4,2
401096908,Memphis Tigers,D. Wingett,4396637,,False,1.0,0,1,0,0,0,1,0,0,0,0,0,0,0,0,0,0,0
401096908,Memphis Tigers,V. Enoh,4278286,,False,11.0,1,2,1,2,0,0,0,0,4,0,4,0,0,0,1,1,2
401096908,Memphis Tigers,A. Jones,4396634,,False,18.0,6,14,6,11,0,3,2,3,2,4,6,1,0,2,1,1,14
401096908,Memphis Tigers,K. Brewton Jr.,4278283,,False,21.0,2,5,2,3,0,2,0,0,1,4,5,3,0,0,1,1,4
401096908,Memphis Tigers,TEAM,TOTAL,TOTAL,False,,30,63,29,49,1,14,10,16,20,31,51,14,2,7,20,20,71
401096908,Canisius Golden Griffins,S. Hitchon,4279482,,True,18.0,0,2,0,0,0,2,2,4,1,0,1,3,1,0,1,2,2
401096908,Canisius Golden Griffins,J. White,4279478,,True,16.0,2,4,2,4,0,0,1,4,1,1,2,0,2,0,1,2,5
401096908,Canisius Golden Griffins,T. Molson,4279481,,True,34.0,6,13,4,6,2,7,4,4,3,0,3,2,1,0,1,4,18
401096908,Canisius Golden Griffins,I. Reese,4067278,,True,35.0,6,15,4,8,2,7,0,2,0,3,3,3,1,0,2,3,14
401096908,Canisius Golden Griffins,M. Johnson,4067275,,True,35.0,5,10,4,8,1,2,0,0,0,6,6,3,3,0,1,2,11
401096908,Canisius Golden Griffins,K. Johnson-Alls,4398049,,False,23.0,0,5,0,4,0,1,0,0,0,6,6,0,1,1,1,3,0
401096908,Canisius Golden Griffins,D. St. Louis,4067280,,False,23.0,5,8,5,8,0,0,0,0,2,0,2,0,0,1,1,2,10
401096908,Canisius Golden Griffins,J. Faulkner,3137250,,False,7.0,0,1,0,1,0,0,1,2,0,0,0,0,0,0,0,1,1
401096908,Canisius Golden Griffins,J. Henderson,4398046,,False,4.0,0,0,0,0,0,0,2,2,0,1,1,0,0,0,1,0,2
401096908,Canisius Golden Griffins,J. Sanks,3141259,,False,5.0,0,2,0,0,0,2,0,0,0,1,1,0,0,0,1,1,0
401096908,Canisius Golden Griffins,TEAM,TOTAL,TOTAL,False,,24,60,19,39,5,21,10,18,9,19,28,11,9,2,10,20,63
401096899,Monmouth Hawks,M. Traore,3975762,,True,18.0,0,3,0,3,0,0,0,0,2,7,9,1,0,0,4,4,0
401096899,Monmouth Hawks,M. McClary,4279736,,True,9.0,0,1,0,1,0,0,1,2,0,1,1,0,1,0,1,3,1
401096899,Monmouth Hawks,D. Hammond,4279734,,True,28.0,4,15,2,5,2,10,5,5,0,4,4,2,3,0,1,1,15
401096899,Monmouth Hawks,R. Salnave,4067329,,True,25.0,2,7,2,5,0,2,0,0,0,3,3,1,1,0,1,4,4
401096899,Monmouth Hawks,N. Rutherford,3946977,,True,25.0,2,5,1,3,1,2,0,0,0,2,2,2,0,0,3,3,5
401096899,Monmouth Hawks,N. Rutty,4398408,,False,9.0,0,1,0,1,0,0,6,8,0,1,1,0,0,0,0,0,6
401096899,Monmouth Hawks,S. Ibiezugbe,4067330,,False,14.0,4,7,4,7,0,0,3,4,0,1,1,1,3,0,2,5,11
401096899,Monmouth Hawks,D. Quinn,3948714,,False,13.0,2,6,2,6,0,0,2,2,1,1,2,0,0,0,2,3,6
401096899,Monmouth Hawks,M. Martin,4279733,,False,16.0,3,4,3,3,0,1,4,4,2,1,3,0,0,0,1,3,10
401096899,Monmouth Hawks,S. Chaput,4398409,,False,19.0,1,2,1,2,0,0,0,0,0,0,0,0,1,0,1,0,2
401096899,Monmouth Hawks,G. Papas,4279735,,False,7.0,0,3,0,0,0,3,0,0,0,1,1,0,1,0,0,0,0
401096899,Monmouth Hawks,T. Gross Jr.,4065729,,False,6.0,0,0,0,0,0,0,0,0,0,0,0,0,0,0,1,0,0
401096899,Monmouth Hawks,L. Pillari,3948713,,False,11.0,0,3,0,0,0,3,3,4,1,2,3,3,0,1,2,1,3
401096899,Monmouth Hawks,TEAM,TOTAL,TOTAL,False,,18,57,15,36,3,21,24,29,10,27,37,10,10,1,19,27,63
401096899,Cal State Fullerton Titans,J. Rowe,4066889,,True,21.0,1,3,1,2,0,1,2,2,2,8,10,1,1,4,2,4,4
401096899,Cal State Fullerton Titans,D. Clare,4066882,,True,20.0,1,2,1,1,0,1,1,2,3,3,6,2,0,0,1,2,3
401096899,Cal State Fullerton Titans,A. Awosika,4066883,,True,28.0,2,5,2,4,0,1,4,7,0,4,4,7,2,0,1,0,8
401096899,Cal State Fullerton Titans,K. Allman Jr.,3946040,,True,30.0,4,13,2,8,2,5,3,5,0,2,2,3,1,0,4,2,13
401096899,Cal State Fullerton Titans,K. Ahmad,3946039,,True,29.0,13,22,5,9,8,13,6,8,1,4,5,0,4,0,1,1,40
401096899,Cal State Fullerton Titans,A. Kuljuhovic,4397406,,False,11.0,2,3,1,2,1,1,0,2,0,4,4,1,0,0,1,2,5
401096899,Cal State Fullerton Titans,J. Wang,4278728,,False,11.0,2,4,2,4,0,0,1,2,1,1,2,0,0,0,2,2,5
401096899,Cal State Fullerton Titans,J. Pitts,4278727,,False,8.0,0,0,0,0,0,0,0,0,0,1,1,0,0,0,2,3,0
401096899,Cal State Fullerton Titans,G. Ozegovic,4278726,,False,5.0,1,1,0,0,1,1,0,0,0,1,1,0,0,0,1,1,3
401096899,Cal State Fullerton Titans,D. Heinzl,4278725,,False,4.0,0,0,0,0,0,0,1,2,0,0,0,0,1,0,0,1,1
401096899,Cal State Fullerton Titans,W. Arnold,4397405,,False,19.0,1,4,0,0,1,4,0,0,0,1,1,0,1,0,0,1,3
401096899,Cal State Fullerton Titans,J. Smith,3946038,,False,14.0,0,0,0,0,0,0,2,2,0,0,0,1,0,1,0,3,2
401096899,Cal State Fullerton Titans,TEAM,TOTAL,TOTAL,False,,27,57,14,30,13,27,20,32,7,30,37,15,10,5,15,22,87
401096894,Valparaiso Beacons,R. Fazekas,3913218,,True,30.0,5,12,2,4,3,8,0,0,1,3,4,0,0,0,1,1,13
401096894,Valparaiso Beacons,D. Smits,3921419,,True,28.0,3,5,3,5,0,0,1,2,2,5,7,1,1,1,5,3,7
401096894,Valparaiso Beacons,J. Freeman-Liberty,4397511,,True,28.0,4,6,3,3,1,3,3,6,2,2,4,3,2,0,1,1,12
401096894,Valparaiso Beacons,B. Evelyn,3911894,,True,33.0,2,8,1,3,1,5,0,1,0,1,1,3,2,0,1,1,5
401096894,Valparaiso Beacons,D. Lavender,3148995,,True,31.0,7,8,7,7,0,1,1,2,1,7,8,5,1,0,4,3,15
401096894,Valparaiso Beacons,M. McMillan,4279176,,False,2.0,0,0,0,0,0,0,0,0,0,1,1,0,0,0,2,4,0
401096894,Valparaiso Beacons,M. Golder,4279173,,False,22.0,2,8,0,3,2,5,2,2,1,1,2,1,0,0,2,2,8
401096894,Valparaiso Beacons,J. Kiser,4067455,,False,15.0,2,2,2,2,0,0,0,0,0,3,3,1,0,0,0,0,4
401096894,Valparaiso Beacons,L. Stalling,4397513,,False,1.0,0,0,0,0,0,0,0,0,0,0,0,0,0,0,0,0,0
401096894,Valparaiso Beacons,D. Sackey,4397512,,False,7.0,0,1,0,1,0,0,0,0,0,0,0,0,0,0,1,0,0
401096894,Valparaiso Beacons,M. Bradford,4067452,,False,3.0,0,0,0,0,0,0,0,0,0,0,0,0,0,0,1,0,0
401096894,Valparaiso Beacons,TEAM,TOTAL,TOTAL,False,,25,50,18,28,7,22,7,13,8,25,33,14,6,1,18,15,64
401096894,Monmouth Hawks,M. Traore,3975762,,True,21.0,7,7,7,7,0,0,0,0,2,1,3,1,1,0,2,3,14
401096894,Monmouth Hawks,D. Hammond,4279734,,True,29.0,2,8,1,3,1,5,3,5,0,2,2,1,0,0,2,3,8
401096894,Monmouth Hawks,R. Salnave,4067329,,True,19.0,2,7,1,4,1,3,2,2,1,1,2,0,1,0,2,0,7
401096894,Monmouth Hawks,L. Pillari,3948713,,True,19.0,2,5,1,1,1,4,0,0,0,3,3,0,0,0,1,2,5
401096894,Monmouth Hawks,N. Rutherford,3946977,,True,29.0,2,8,2,7,0,1,0,0,0,3,3,1,1,0,1,1,4
401096894,Monmouth Hawks,N. Rutty,4398408,,False,15.0,0,1,0,1,0,0,2,2,2,1,3,0,0,0,1,0,2
401096894,Monmouth Hawks,D. Quinn,3948714,,False,9.0,2,4,2,4,0,0,0,0,1,6,7,0,1,0,1,2,4
401096894,Monmouth Hawks,M. Martin,4279733,,False,13.0,1,1,1,1,0,0,0,0,1,0,1,0,0,0,0,1,2
401096894,Monmouth Hawks,M. James Jr.,4404878,,False,2.0,0,1,0,1,0,0,0,0,0,0,0,0,0,0,0,0,0
401096894,Monmouth Hawks,S. Chaput,4398409,,False,9.0,0,2,0,2,0,0,0,0,0,1,1,0,0,0,1,0,0
401096894,Monmouth Hawks,D. Calloway Jr.,4398407,,False,2.0,0,0,0,0,0,0,0,0,0,0,0,0,0,0,0,0,0
401096894,Monmouth Hawks,M. McClary,4279736,,False,13.0,0,0,0,0,0,0,0,0,0,2,2,0,1,0,0,2,0
401096894,Monmouth Hawks,G. Papas,4279735,,False,16.0,2,6,1,3,1,3,0,0,0,0,0,3,2,1,0,0,5
401096894,Monmouth Hawks,T. Gross Jr.,4065729,,False,4.0,1,3,1,1,0,2,0,0,0,0,0,0,0,0,0,1,2
401096894,Monmouth Hawks,TEAM,TOTAL,TOTAL,False,,21,53,17,35,4,18,7,9,7,23,30,6,7,1,12,15,53
401089014,Fairfield Stags,M. Milin,3947018,,True,14.0,2,2,1,1,1,1,0,0,0,2,2,1,0,0,0,1,5
401089014,Fairfield Stags,L. Taliaferro,4398078,,True,33.0,7,11,3,5,4,6,3,3,0,3,3,0,2,0,0,2,21
401089014,Fairfield Stags,N. Alvarez,4398075,,True,35.0,6,15,5,11,1,4,0,0,3,2,5,7,2,0,4,3,13
401089014,Fairfield Stags,J. Cruz,4279488,,True,23.0,2,6,1,3,1,3,0,0,0,1,1,0,0,0,2,2,5
401089014,Fairfield Stags,T. Benning,4279483,,True,30.0,2,3,2,3,0,0,0,0,1,0,1,5,0,0,0,3,4
401089014,Fairfield Stags,W. Methnani,4279486,,False,13.0,5,11,3,7,2,4,0,1,1,2,3,1,0,0,1,3,12
401089014,Fairfield Stags,K. Senghore-Peterson,4279485,,False,3.0,0,0,0,0,0,0,0,0,0,0,0,0,0,0,0,0,0
401089014,Fairfield Stags,J. Kasibabu,3947016,,False,17.0,4,4,4,4,0,0,2,5,1,4,5,1,1,0,0,4,10
401089014,Fairfield Stags,C. Whipple,4398077,,False,6.0,1,1,1,1,0,0,0,0,0,0,0,0,0,0,0,2,2
401089014,Fairfield Stags,F. Lemetti,4398076,,False,23.0,4,7,0,1,4,6,0,0,0,0,0,1,1,0,1,2,12
401089014,Fairfield Stags,A. Kavaliauskas,4080375,,False,3.0,1,1,1,1,0,0,0,0,0,0,0,0,0,0,2,1,2
401089014,Fairfield Stags,TEAM,TOTAL,TOTAL,False,,34,61,21,37,13,24,5,9,6,14,20,16,6,0,10,23,86
401089014,Denver Pioneers,D. Carlisle,4279501,,True,22.0,3,6,3,5,0,1,0,0,2,4,6,0,0,1,2,1,6
401089014,Denver Pioneers,A. Akintola,3915207,,True,21.0,3,4,3,4,0,0,0,0,2,1,3,0,1,1,0,0,6
401089014,Denver Pioneers,R. Harrell Jr.,3155484,,True,34.0,5,10,4,8,1,2,10,10,0,1,1,2,0,0,2,4,21
401089014,Denver Pioneers,T. Gatlin,4398061,,True,11.0,0,0,0,0,0,0,0,0,0,0,0,1,1,0,2,2,0
401089014,Denver Pioneers,A. Murkey,4067603,,True,20.0,3,5,3,4,0,1,7,9,1,7,8,3,3,0,1,2,13
401089014,Denver Pioneers,A. Kurnaz,4398063,,False,5.0,0,1,0,0,0,1,0,0,0,2,2,1,0,0,1,0,0
401089014,Denver Pioneers,D. Nzekwesi,4398059,,False,19.0,6,6,6,6,0,0,5,6,2,3,5,0,1,1,0,1,17
401089014,Denver Pioneers,J. Lanzi,4398062,,False,23.0,1,2,1,2,0,0,0,0,0,2,2,2,0,2,2,0,2
401089014,Denver Pioneers,J. Townsend,4398060,,False,20.0,2,6,2,4,0,2,0,0,1,1,2,0,0,0,0,1,4
401089014,Denver Pioneers,E. Rodriguez,4279503,,False,25.0,6,8,6,6,0,2,4,6,0,3,3,1,0,0,2,1,16
401089014,Denver Pioneers,TEAM,TOTAL,TOTAL,False,,29,48,28,39,1,9,26,31,8,24,32,10,6,5,13,12,85
401088229,Longwood Lancers,J. Cintron,4278891,,True,25.0,1,3,0,0,1,3,2,2,2,5,7,1,0,1,4,1,5
401088229,Longwood Lancers,J. Smith,4067595,,True,32.0,6,11,5,6,1,5,0,0,2,0,2,1,0,1,0,1,13
401088229,Longwood Lancers,P. Adgei,3907586,,True,14.0,0,2,0,2,0,0,1,2,1,1,2,0,0,0,0,2,1
401088229,Longwood Lancers,S. Flood,4397638,,True,31.0,6,7,2,2,4,5,3,4,0,5,5,3,2,0,5,2,19
401088229,Longwood Lancers,S. Phillips,4397635,,True,34.0,3,7,2,3,1,4,4,4,0,7,7,4,0,0,2,1,11
401088229,Longwood Lancers,G. Okafor,4397641,,False,3.0,0,0,0,0,0,0,0,0,0,0,0,0,0,0,1,0,0
401088229,Longwood Lancers,S. Franklin,4278890,,False,16.0,2,2,2,2,0,0,2,2,0,2,2,0,1,0,1,3,6
401088229,Longwood Lancers,D. Geter,66583,,False,22.0,3,5,3,4,0,1,0,0,2,4,6,0,0,1,3,3,6
401088229,Longwood Lancers,K. Chapman,4278888,,False,7.0,0,3,0,0,0,3,0,0,0,0,0,0,0,0,1,0,0
401088229,Longwood Lancers,J. Munoz,4067594,,False,16.0,2,6,1,3,1,3,1,1,0,2,2,1,0,0,2,2,6
401088229,Longwood Lancers,TEAM,TOTAL,TOTAL,False,,23,46,15,22,8,24,13,15,7,26,33,10,3,3,19,15,67
401088229,Fairfield Stags,J. Kasibabu,3947016,,True,33.0,4,10,4,8,0,2,4,4,4,2,6,1,1,1,2,3,12
401088229,Fairfield Stags,L. Taliaferro,4398078,,True,38.0,6,16,1,5,5,11,2,2,1,1,2,1,0,0,0,1,19
401088229,Fairfield Stags,N. Alvarez,4398075,,True,39.0,7,13,6,8,1,5,1,3,1,2,3,6,2,0,2,4,16
401088229,Fairfield Stags,J. Cruz,4279488,,True,31.0,5,12,4,8,1,4,0,0,0,2,2,1,3,0,1,1,11
401088229,Fairfield Stags,T. Benning,4279483,,True,16.0,0,0,0,0,0,0,0,0,0,1,1,0,0,0,2,0,0
401088229,Fairfield Stags,W. Methnani,4279486,,False,12.0,2,3,2,3,0,0,0,0,0,3,3,0,0,0,0,2,4
401088229,Fairfield Stags,K. Senghore-Peterson,4279485,,False,1.0,0,0,0,0,0,0,0,0,0,0,0,0,0,0,0,2,0
401088229,Fairfield Stags,M. Milin,3947018,,False,4.0,0,0,0,0,0,0,0,0,1,0,1,0,0,0,1,0,0
401088229,Fairfield Stags,F. Lemetti,4398076,,False,4.0,0,1,0,0,0,1,0,0,0,0,0,0,0,0,0,1,0
401088229,Fairfield Stags,A. Kavaliauskas,4080375,,False,22.0,0,3,0,1,0,2,3,5,0,1,1,3,2,0,0,2,3
401088229,Fairfield Stags,TEAM,TOTAL,TOTAL,False,,24,58,17,33,7,25,10,14,7,12,19,12,8,1,8,16,65
401087882,Canisius Golden Griffins,S. Hitchon,4279482,,True,32.0,4,8,3,6,1,2,6,6,0,3,3,2,0,2,4,2,15
401087882,Canisius Golden Griffins,J. White,4279478,,True,13.0,1,2,1,1,0,1,1,2,1,0,1,1,0,1,0,5,3
401087882,Canisius Golden Griffins,T. Molson,4279481,,True,38.0,5,11,2,4,3,7,5,9,1,5,6,2,1,3,4,2,18
401087882,Canisius Golden Griffins,I. Reese,4067278,,True,38.0,6,14,3,6,3,8,0,0,0,4,4,5,3,0,6,5,15
401087882,Canisius Golden Griffins,M. Johnson,4067275,,True,42.0,8,12,5,6,3,6,0,2,0,2,2,2,2,0,1,4,19
401087882,Canisius Golden Griffins,M. Lotts,4279480,,False,11.0,1,1,1,1,0,0,1,3,2,0,2,1,0,1,2,1,3
401087882,Canisius Golden Griffins,J. Faulkner,3137250,,False,20.0,3,6,2,4,1,2,0,0,3,5,8,0,0,1,1,2,7
401087882,Canisius Golden Griffins,J. Henderson,4398046,,False,14.0,2,4,2,4,0,0,0,0,1,2,3,1,0,0,2,2,4
401087882,Canisius Golden Griffins,J. Sanks,3141259,,False,17.0,2,7,0,0,2,7,0,0,0,2,2,1,0,0,2,3,6
401087882,Canisius Golden Griffins,TEAM,TOTAL,TOTAL,False,,32,65,19,32,13,33,13,22,9,26,35,15,6,8,22,26,90
401087882,Brown Bears,M. DeWolf,4279464,,True,11.0,1,4,1,4,0,0,0,0,2,3,5,3,0,0,2,3,2
401087882,Brown Bears,T. Choh,4279463,,True,35.0,7,13,7,13,0,0,4,6,6,5,11,3,3,0,4,3,18
401087882,Brown Bears,D. Cambridge Jr.,4279462,,True,39.0,11,19,4,6,7,13,2,2,0,2,2,1,2,2,1,5,31
401087882,Brown Bears,Z. Hunsaker,4279461,,True,25.0,1,3,0,0,1,3,6,8,0,2,2,5,2,0,1,4,9
401087882,Brown Bears,O. Okolie,3906824,,True,39.0,6,10,5,7,1,3,2,6,0,4,4,1,2,0,2,2,15
401087882,Brown Bears,J. Howard,4066802,,False,19.0,3,6,2,4,1,2,0,2,0,1,1,1,0,0,2,2,7
401087882,Brown Bears,D. Mitchell,4397914,,False,22.0,3,5,3,5,0,0,0,0,3,5,8,0,1,0,2,2,6
401087882,Brown Bears,B. Anderson,4066800,,False,25.0,3,9,3,6,0,3,3,4,1,2,3,3,2,0,4,1,9
401087882,Brown Bears,C. Sullivan,3906825,,False,10.0,0,1,0,0,0,1,0,0,0,2,2,0,0,0,0,1,0
401087882,Brown Bears,TEAM,TOTAL,TOTAL,False,,35,70,25,45,10,25,17,28,13,28,41,17,12,2,18,23,97
401086097,Seattle U Redhawks,M. Carter,3906549,,True,25.0,4,5,4,5,0,0,4,7,0,5,5,0,0,4,4,5,12
401086097,Seattle U Redhawks,T. Brown Jr.,4395997,,True,33.0,2,6,2,6,0,0,4,8,1,4,5,5,1,0,0,2,8
401086097,Seattle U Redhawks,M. Means,4067559,,True,35.0,1,7,0,5,1,2,13,16,2,7,9,2,0,0,6,3,16
401086097,Seattle U Redhawks,M. Kavas,3947715,,True,39.0,6,11,3,8,3,3,5,6,1,8,9,2,0,0,0,1,20
401086097,Seattle U Redhawks,D. Jones,3907473,,True,30.0,7,9,6,7,1,2,2,3,0,3,3,3,0,0,4,2,17
401086097,Seattle U Redhawks,A. Hundal,4396003,,False,2.0,0,0,0,0,0,0,0,0,0,1,1,0,0,0,0,3,0
401086097,Seattle U Redhawks,T. Hopkins,4396002,,False,5.0,0,1,0,0,0,1,0,0,0,1,1,0,0,0,1,0,0
401086097,Seattle U Redhawks,R. Grigsby,4396001,,False,13.0,3,4,3,4,0,0,1,3,2,4,6,0,0,0,0,3,7
401086097,Seattle U Redhawks,A. Nettles,4280184,,False,16.0,1,2,0,0,1,2,0,0,0,2,2,1,0,0,0,2,3
401086097,Seattle U Redhawks,M. Da Campo,4067561,,False,2.0,0,0,0,0,0,0,0,0,1,0,1,0,0,0,0,0,0
401086097,Seattle U Redhawks,TEAM,TOTAL,TOTAL,False,,24,45,18,35,6,10,29,43,7,35,42,13,1,4,16,21,83
401086097,Fairfield Stags,J. Kasibabu,3947016,,True,11.0,2,4,2,2,0,2,3,6,1,1,2,3,1,0,1,5,7
401086097,Fairfield Stags,L. Taliaferro,4398078,,True,25.0,4,10,0,6,4,4,0,0,0,0,0,1,0,0,1,4,12
401086097,Fairfield Stags,N. Alvarez,4398075,,True,25.0,7,15,5,11,2,4,0,1,1,3,4,3,0,0,3,3,16
401086097,Fairfield Stags,J. Cruz,4279488,,True,29.0,6,11,5,8,1,3,0,0,2,4,6,0,1,0,0,5,13
401086097,Fairfield Stags,T. Benning,4279483,,True,28.0,1,6,1,5,0,1,3,3,0,3,3,2,1,0,1,4,5
401086097,Fairfield Stags,W. Methnani,4279486,,False,18.0,2,7,2,5,0,2,5,5,0,3,3,0,1,1,0,3,9
401086097,Fairfield Stags,M. Milin,3947018,,False,11.0,1,4,1,3,0,1,2,2,1,1,2,0,0,0,0,2,4
401086097,Fairfield Stags,C. Whipple,4398077,,False,11.0,0,3,0,0,0,3,0,0,1,1,2,0,0,1,0,1,0
401086097,Fairfield Stags,F. Lemetti,4398076,,False,26.0,3,6,0,1,3,5,0,1,0,1,1,1,1,0,0,4,9
401086097,Fairfield Stags,A. Kavaliauskas,4080375,,False,16.0,1,1,0,0,1,1,2,2,0,0,0,1,1,0,0,2,5
401086097,Fairfield Stags,TEAM,TOTAL,TOTAL,False,,27,67,16,41,11,26,15,20,6,17,23,11,6,2,7,33,80
401086065,Saint Peter's Peacocks,S. Idowu,3922042,,True,29.0,8,11,6,8,2,3,2,4,1,6,7,1,0,2,3,5,20
401086065,Saint Peter's Peacocks,C. Underwood,4398388,,True,6.0,0,0,0,0,0,0,0,0,0,0,0,0,0,0,0,1,0
401086065,Saint Peter's Peacocks,Q. Taylor,4067357,,True,39.0,5,7,3,5,2,2,6,6,4,2,6,1,1,0,0,1,18
401086065,Saint Peter's Peacocks,M. Dixon,4279758,,True,25.0,2,4,2,2,0,2,0,1,1,3,4,1,0,0,0,3,4
401086065,Saint Peter's Peacocks,D. Turner,4067356,,True,43.0,8,16,6,12,2,4,5,7,1,4,5,6,1,1,2,4,23
401086065,Saint Peter's Peacocks,K. Ndefo,4398386,,False,30.0,2,6,2,6,0,0,1,4,3,2,5,3,1,4,2,2,5
401086065,Saint Peter's Peacocks,D. Woods,3919424,,False,14.0,3,7,3,6,0,1,0,0,0,0,0,0,0,1,2,2,6
401086065,Saint Peter's Peacocks,M. Majak,4398387,,False,2.0,0,0,0,0,0,0,0,0,0,0,0,0,0,0,1,1,0
401086065,Saint Peter's Peacocks,D. Watson,4398384,,False,37.0,2,10,1,6,1,4,2,2,1,6,7,2,0,0,1,3,7
401086065,Saint Peter's Peacocks,TEAM,TOTAL,TOTAL,False,,30,61,23,45,7,16,16,24,12,26,38,14,3,8,11,22,83
401086065,Hampton Pirates,T. Barnes,3951877,,True,26.0,5,9,4,6,1,3,5,5,4,4,8,0,0,0,2,4,16
401086065,Hampton Pirates,G. Heckstall,4279786,,True,40.0,8,14,3,7,5,7,1,1,0,6,6,3,1,1,2,2,22
401086065,Hampton Pirates,J. Marrow,4070762,,True,28.0,2,10,2,6,0,4,3,4,0,1,1,3,1,0,4,5,7
401086065,Hampton Pirates,K. Fisher,3951879,,True,45.0,5,11,1,4,4,7,8,9,0,3,3,5,0,0,0,4,22
401086065,Hampton Pirates,A. Mitchell,3951878,,True,41.0,1,6,1,6,0,0,2,4,2,4,6,2,1,0,0,3,4
401086065,Hampton Pirates,R. Smoot,4397621,,False,13.0,1,1,1,1,0,0,0,0,3,2,5,0,0,1,2,2,2
401086065,Hampton Pirates,B. Stanley,4279788,,False,6.0,1,1,1,1,0,0,0,0,0,2,2,0,0,0,0,1,2
401086065,Hampton Pirates,L. Bracey,4072301,,False,11.0,0,5,0,2,0,3,0,0,1,0,1,1,0,0,0,1,0
401086065,Hampton Pirates,D. Griffin,4067187,,False,15.0,1,4,1,2,0,2,3,4,0,1,1,0,0,0,1,2,5
401086065,Hampton Pirates,TEAM,TOTAL,TOTAL,False,,24,61,14,35,10,26,22,27,13,24,37,14,3,2,11,24,80
401086064,Saint Peter's Peacocks,K. Ndefo,4398386,,True,11.0,0,4,0,3,0,1,0,0,1,2,3,0,1,0,2,1,0
401086064,Saint Peter's Peacocks,S. Idowu,3922042,,True,18.0,1,1,0,0,1,1,0,0,1,2,3,0,0,0,4,2,3
401086064,Saint Peter's Peacocks,K. Brown,4398385,,True,22.0,2,4,1,1,1,3,0,0,0,0,0,0,1,0,1,5,5
401086064,Saint Peter's Peacocks,Q. Taylor,4067357,,True,28.0,5,8,5,7,0,1,5,5,2,4,6,2,1,0,1,5,15
401086064,Saint Peter's Peacocks,D. Turner,4067356,,True,36.0,11,21,9,15,2,6,4,5,1,3,4,4,2,0,2,2,28
401086064,Saint Peter's Peacocks,D. Woods,3919424,,False,17.0,1,1,1,1,0,0,4,4,1,1,2,0,0,1,2,4,6
401086064,Saint Peter's Peacocks,M. Majak,4398387,,False,6.0,4,5,4,5,0,0,0,0,2,1,3,0,0,1,1,4,8
401086064,Saint Peter's Peacocks,C. Underwood,4398388,,False,6.0,1,1,1,1,0,0,1,2,0,1,1,0,0,0,0,1,3
401086064,Saint Peter's Peacocks,D. Watson,4398384,,False,27.0,0,3,0,1,0,2,1,2,0,0,0,2,0,0,6,3,1
401086064,Saint Peter's Peacocks,M. Dixon,4279758,,False,29.0,1,3,0,1,1,2,2,2,0,0,0,0,0,0,1,3,5
401086064,Saint Peter's Peacocks,TEAM,TOTAL,TOTAL,False,,26,51,21,35,5,16,17,20,9,18,27,8,5,2,22,30,74
401086064,Fairleigh Dickinson Knights,E. Williams,4279627,,True,24.0,2,4,2,4,0,0,2,3,1,4,5,2,1,0,4,2,6
401086064,Fairleigh Dickinson Knights,M. Holloway Jr.,3917366,,True,30.0,4,7,4,7,0,0,5,8,2,2,4,0,1,3,3,4,13
401086064,Fairleigh Dickinson Knights,J. Jenkins,4279625,,True,37.0,4,10,3,6,1,4,3,4,1,3,4,6,4,0,1,3,12
401086064,Fairleigh Dickinson Knights,X. Malone-Key,4067346,,True,35.0,5,8,3,5,2,3,6,6,0,2,2,1,4,1,3,2,18
401086064,Fairleigh Dickinson Knights,D. Edge,3948797,,True,35.0,5,11,4,4,1,7,10,10,1,0,1,3,2,0,1,3,21
401086064,Fairleigh Dickinson Knights,K. Bishop,4067893,,False,25.0,3,6,2,3,1,3,3,3,1,3,4,1,1,0,1,2,10
401086064,Fairleigh Dickinson Knights,O. Okeke,4397965,,False,1.0,0,0,0,0,0,0,0,0,0,0,0,0,0,0,0,0,0
401086064,Fairleigh Dickinson Knights,B. Powell,4397964,,False,11.0,1,2,0,0,1,2,0,0,0,1,1,1,0,0,1,1,3
401086064,Fairleigh Dickinson Knights,T. Jones,4279624,,False,2.0,0,0,0,0,0,0,0,0,0,0,0,0,0,0,0,0,0
401086064,Fairleigh Dickinson Knights,TEAM,TOTAL,TOTAL,False,,24,48,18,29,6,19,29,34,7,17,24,14,13,4,14,17,83
401086063,St. Francis Brooklyn Terriers,Y. Evans,4279650,,True,33.0,2,5,0,1,2,4,0,1,5,13,18,2,0,2,2,3,6
401086063,St. Francis Brooklyn Terriers,D. Celen,4067291,,True,16.0,1,3,1,1,0,2,0,0,0,3,3,4,1,1,1,1,2
401086063,St. Francis Brooklyn Terriers,J. Jordan,4279651,,True,34.0,5,11,0,3,5,8,6,8,1,3,4,0,1,0,2,1,21
401086063,St. Francis Brooklyn Terriers,R. Hurley,3913229,,True,13.0,0,2,0,2,0,0,0,0,1,0,1,0,0,0,2,2,0
401086063,St. Francis Brooklyn Terriers,G. Sanabria,3133979,,True,36.0,6,14,2,4,4,10,1,2,2,2,4,2,2,0,2,1,17
401086063,St. Francis Brooklyn Terriers,K. Williams,3155881,,False,15.0,0,3,0,0,0,3,0,0,0,2,2,1,0,0,0,1,0
401086063,St. Francis Brooklyn Terriers,C. Rohlehr,4398010,,False,17.0,1,3,1,3,0,0,0,0,0,1,1,0,0,0,1,2,2
401086063,St. Francis Brooklyn Terriers,C. Johnson,4067953,,False,6.0,0,2,0,1,0,1,0,0,0,0,0,0,0,0,1,2,0
401086063,St. Francis Brooklyn Terriers,C. Hawkins,4279649,,False,30.0,2,10,2,10,0,0,4,7,0,0,0,2,2,0,2,3,8
401086063,St. Francis Brooklyn Terriers,TEAM,TOTAL,TOTAL,False,,17,53,6,25,11,28,11,18,12,25,37,11,6,3,13,16,56
401086063,Saint Peter's Peacocks,K. Ndefo,4398386,,True,30.0,0,3,0,3,0,0,0,0,0,2,2,0,1,1,1,4,0
401086063,Saint Peter's Peacocks,S. Idowu,3922042,,True,33.0,4,12,4,10,0,2,3,4,2,3,5,1,1,4,3,3,11
401086063,Saint Peter's Peacocks,K. Brown,4398385,,True,20.0,0,1,0,0,0,1,0,0,0,3,3,1,0,0,3,2,0
401086063,Saint Peter's Peacocks,Q. Taylor,4067357,,True,31.0,4,7,3,5,1,2,3,6,1,5,6,2,0,0,0,3,12
401086063,Saint Peter's Peacocks,D. Turner,4067356,,True,38.0,8,17,8,15,0,2,3,4,1,3,4,2,0,0,5,1,19
401086063,Saint Peter's Peacocks,M. Majak,4398387,,False,5.0,0,0,0,0,0,0,0,0,0,1,1,0,0,0,0,0,0
401086063,Saint Peter's Peacocks,D. Watson,4398384,,False,30.0,3,6,0,1,3,5,2,4,0,4,4,3,1,0,3,1,11
401086063,Saint Peter's Peacocks,M. Dixon,4279758,,False,13.0,0,0,0,0,0,0,0,0,0,3,3,0,0,2,1,5,0
401086063,Saint Peter's Peacocks,TEAM,TOTAL,TOTAL,False,,19,46,15,34,4,12,11,18,6,27,33,9,3,7,16,19,53
401086062,Saint Peter's Peacocks,K. Ndefo,4398386,,True,34.0,6,13,6,11,0,2,3,4,1,4,5,0,1,2,4,4,15
401086062,Saint Peter's Peacocks,S. Idowu,3922042,,True,28.0,3,8,3,8,0,0,0,1,2,4,6,0,0,3,1,3,6
401086062,Saint Peter's Peacocks,Q. Taylor,4067357,,True,29.0,5,9,5,8,0,1,0,1,2,4,6,1,1,0,3,4,10
401086062,Saint Peter's Peacocks,D. Turner,4067356,,True,37.0,3,12,2,9,1,3,2,2,0,1,1,3,2,1,2,0,9
401086062,Saint Peter's Peacocks,C. Jones,3922043,,True,18.0,1,1,1,1,0,0,0,0,0,2,2,5,3,0,3,2,2
401086062,Saint Peter's Peacocks,C. Underwood,4398388,,False,1.0,0,0,0,0,0,0,0,0,0,0,0,0,0,0,0,0,0
401086062,Saint Peter's Peacocks,K. Brown,4398385,,False,12.0,0,3,0,1,0,2,2,2,1,4,5,0,0,0,0,3,2
401086062,Saint Peter's Peacocks,D. Watson,4398384,,False,26.0,4,8,2,5,2,3,1,2,0,3,3,2,1,0,1,1,11
401086062,Saint Peter's Peacocks,A. Hicks,4284295,,False,1.0,0,0,0,0,0,0,0,0,0,0,0,0,0,0,0,0,0
401086062,Saint Peter's Peacocks,M. Dixon,4279758,,False,14.0,1,1,0,0,1,1,0,0,1,0,1,0,0,0,0,2,3
401086062,Saint Peter's Peacocks,TEAM,TOTAL,TOTAL,False,,23,55,19,43,4,12,8,12,7,23,30,11,8,6,14,19,58
401086062,Long Island University Sharks,T. Flowers,4066795,,True,36.0,4,12,2,2,2,10,5,5,1,6,7,2,0,0,4,2,15
401086062,Long Island University Sharks,J. van Sauers,3936114,,True,34.0,3,5,1,2,2,3,5,6,2,4,6,1,2,0,0,3,13
401086062,Long Island University Sharks,J. Batts,4067901,,True,14.0,2,3,0,0,2,3,0,2,0,0,0,2,3,0,0,1,6
401086062,Long Island University Sharks,J. Agosto,4067900,,True,33.0,1,7,1,4,0,3,1,2,2,4,6,6,2,1,2,3,3
401086062,Long Island University Sharks,R. Clark,3948799,,True,40.0,6,11,5,7,1,4,3,5,3,12,15,2,2,2,6,3,16
401086062,Long Island University Sharks,G. Cisse,3936113,,False,6.0,0,1,0,1,0,0,0,0,0,0,0,0,0,0,0,0,0
401086062,Long Island University Sharks,S. Hicks,4279630,,False,7.0,0,1,0,0,0,1,0,0,0,0,0,0,0,0,0,1,0
401086062,Long Island University Sharks,C. Owens Jr.,4279629,,False,2.0,0,2,0,0,0,2,0,0,0,0,0,0,0,0,0,0,0
401086062,Long Island University Sharks,R. Frias,3936112,,False,28.0,7,10,0,1,7,9,0,0,2,1,3,0,0,0,2,1,21
401086062,Long Island University Sharks,TEAM,TOTAL,TOTAL,False,,23,52,9,17,14,35,14,20,10,27,37,13,9,3,17,14,74
401086061,Saint Peter's Peacocks,S. Idowu,3922042,,True,34.0,7,17,6,14,1,3,6,8,3,3,6,3,2,1,3,2,21
401086061,Saint Peter's Peacocks,Q. Taylor,4067357,,True,41.0,2,5,2,4,0,1,3,6,2,4,6,2,1,1,2,4,7
401086061,Saint Peter's Peacocks,K. Brown,4398385,,True,35.0,3,8,2,4,1,4,2,2,1,3,4,2,2,3,1,4,9
401086061,Saint Peter's Peacocks,D. Turner,4067356,,True,42.0,1,6,0,2,1,4,0,1,2,2,4,1,0,0,0,3,3
401086061,Saint Peter's Peacocks,C. Jones,3922043,,True,41.0,5,10,3,6,2,4,5,6,2,4,6,2,1,0,1,3,17
401086061,Saint Peter's Peacocks,K. Ndefo,4398386,,False,7.0,0,3,0,3,0,0,0,2,1,2,3,0,0,0,1,1,0
401086061,Saint Peter's Peacocks,M. Majak,4398387,,False,6.0,0,0,0,0,0,0,0,0,0,1,1,0,1,0,0,3,0
401086061,Saint Peter's Peacocks,D. Watson,4398384,,False,19.0,2,3,0,1,2,2,0,0,0,3,3,0,0,0,7,2,6
401086061,Saint Peter's Peacocks,TEAM,TOTAL,TOTAL,False,,20,52,13,34,7,18,16,25,12,23,35,10,7,5,17,22,63
401086061,Maine Black Bears,V. Larsson,4395896,,True,45.0,5,6,2,3,3,3,0,2,0,3,3,4,1,2,2,4,13
401086061,Maine Black Bears,A. Fleming,4066695,,True,44.0,5,17,5,15,0,2,4,4,2,6,8,3,1,1,2,1,14
401086061,Maine Black Bears,I. Stojiljkovic,3941316,,True,18.0,5,6,3,4,2,2,0,1,1,3,4,0,2,0,1,2,12
401086061,Maine Black Bears,S. El Darwich,4067724,,True,32.0,1,5,1,2,0,3,5,5,0,4,4,2,1,0,3,1,7
401086061,Maine Black Bears,I. White,3913240,,True,26.0,2,8,1,4,1,4,0,1,0,1,1,0,2,0,3,5,5
401086061,Maine Black Bears,M. Antoms,4278224,,False,4.0,0,1,0,1,0,0,0,0,1,3,4,0,0,0,1,2,0
401086061,Maine Black Bears,V. Eze,3941313,,False,17.0,2,4,2,4,0,0,1,2,2,1,3,2,1,1,3,3,5
401086061,Maine Black Bears,T. Moss,4395897,,False,39.0,1,4,1,1,0,3,1,1,1,1,2,2,1,0,2,1,3
401086061,Maine Black Bears,TEAM,TOTAL,TOTAL,False,,21,51,15,34,6,17,11,16,7,25,32,13,9,4,17,19,59
401086060,Saint Peter's Peacocks,K. Ndefo,4398386,,True,31.0,4,9,4,7,0,2,5,6,2,7,9,1,2,0,4,3,13
401086060,Saint Peter's Peacocks,S. Idowu,3922042,,True,27.0,4,7,4,5,0,2,0,0,1,3,4,1,1,3,2,4,8
401086060,Saint Peter's Peacocks,D. Watson,4398384,,True,23.0,2,2,1,1,1,1,0,0,0,0,0,2,0,0,2,0,5
401086060,Saint Peter's Peacocks,Q. Taylor,4067357,,True,30.0,3,7,3,5,0,2,0,0,0,4,4,0,0,0,1,4,6
401086060,Saint Peter's Peacocks,D. Turner,4067356,,True,34.0,6,12,4,5,2,7,5,6,0,0,0,3,1,0,4,3,19
401086060,Saint Peter's Peacocks,M. Ndiaye,3922044,,False,7.0,1,2,1,2,0,0,1,2,0,0,0,0,1,0,1,2,3
401086060,Saint Peter's Peacocks,M. Majak,4398387,,False,2.0,0,0,0,0,0,0,0,0,0,0,0,0,0,0,0,0,0
401086060,Saint Peter's Peacocks,K. Brown,4398385,,False,19.0,3,7,2,4,1,3,2,3,2,1,3,1,2,1,1,3,9
401086060,Saint Peter's Peacocks,C. Jones,3922043,,False,27.0,1,4,0,2,1,2,0,0,1,3,4,2,2,1,0,1,3
401086060,Saint Peter's Peacocks,TEAM,TOTAL,TOTAL,False,,24,50,19,31,5,19,13,17,7,19,26,10,9,5,15,20,66
401086060,North Texas Mean Green,Z. Simmons,4279089,,True,0.0,6,8,6,8,0,0,3,5,3,2,5,0,2,3,1,0,15
401086060,North Texas Mean Green,J. Simmons,4067774,,True,0.0,0,2,0,2,0,0,4,4,0,3,3,1,1,0,2,1,4
401086060,North Texas Mean Green,U. Gibson,4279087,,True,0.0,4,9,1,3,3,6,5,5,0,1,1,0,1,0,1,2,16
401086060,North Texas Mean Green,J. Duffy,4279086,,True,32.0,3,7,3,5,0,2,1,2,2,4,6,3,1,0,0,1,7
401086060,North Texas Mean Green,R. Woolridge,3906547,,True,0.0,4,10,4,10,0,0,6,10,1,2,3,5,3,1,5,1,14
401086060,North Texas Mean Green,T. Arikawe,4279085,,False,1.0,0,1,0,1,0,0,0,0,0,0,0,0,0,0,0,0,0
401086060,North Texas Mean Green,S. Alcindor,4397562,,False,2.0,0,0,0,0,0,0,0,0,0,0,0,0,0,0,0,1,0
401086060,North Texas Mean Green,R. Smart,4279090,,False,25.0,5,12,2,4,3,8,0,0,1,3,4,3,0,0,3,3,13
401086060,North Texas Mean Green,M. Miller,4279088,,False,21.0,3,4,3,4,0,0,0,1,4,2,6,0,0,0,2,3,6
401086060,North Texas Mean Green,D. Draper,3920183,,False,5.0,0,0,0,0,0,0,0,0,0,0,0,0,0,0,0,2,0
401086060,North Texas Mean Green,TEAM,TOTAL,TOTAL,False,,25,53,19,37,6,16,19,27,14,20,34,12,8,4,14,14,75
401086059,Saint Peter's Peacocks,K. Ndefo,4398386,,True,22.0,0,5,0,4,0,1,3,8,1,3,4,1,0,2,3,2,3
401086059,Saint Peter's Peacocks,S. Idowu,3922042,,True,33.0,11,15,10,13,1,2,2,3,3,6,9,1,0,0,2,3,25
401086059,Saint Peter's Peacocks,Q. Taylor,4067357,,True,30.0,3,5,3,4,0,1,3,4,0,6,6,3,0,0,1,4,9
401086059,Saint Peter's Peacocks,D. Turner,4067356,,True,25.0,3,6,1,2,2,4,2,2,1,1,2,1,0,0,3,1,10
401086059,Saint Peter's Peacocks,C. Jones,3922043,,True,32.0,2,9,0,4,2,5,0,0,0,4,4,1,1,0,3,2,6
401086059,Saint Peter's Peacocks,M. Ndiaye,3922044,,False,2.0,0,1,0,1,0,0,0,0,0,0,0,0,0,1,0,1,0
401086059,Saint Peter's Peacocks,C. Underwood,4398388,,False,1.0,0,1,0,1,0,0,0,0,0,0,0,0,0,0,0,0,0
401086059,Saint Peter's Peacocks,K. Brown,4398385,,False,3.0,0,0,0,0,0,0,0,0,0,0,0,0,0,0,0,1,0
401086059,Saint Peter's Peacocks,D. Watson,4398384,,False,25.0,2,5,1,3,1,2,0,0,0,1,1,6,1,0,0,2,5
401086059,Saint Peter's Peacocks,M. Dixon,4279758,,False,27.0,2,3,1,1,1,2,0,0,0,1,1,2,1,0,1,1,5
401086059,Saint Peter's Peacocks,TEAM,TOTAL,TOTAL,False,,23,50,16,33,7,17,10,17,5,27,32,15,3,3,13,17,63
401086059,Bryant Bulldogs,P. Harding,4397946,,True,24.0,1,2,1,2,0,0,1,5,2,7,9,4,0,0,0,4,3
401086059,Bryant Bulldogs,J. Cardenas,4397942,,True,10.0,0,1,0,1,0,0,2,2,1,1,2,1,0,0,1,1,2
401086059,Bryant Bulldogs,B. Carroll,4067526,,True,21.0,5,8,2,4,3,4,0,0,0,2,2,1,2,0,0,4,13
401086059,Bryant Bulldogs,J. Kasperzyk,4397945,,True,13.0,1,3,1,2,0,1,0,0,1,0,1,2,1,0,0,0,2
401086059,Bryant Bulldogs,K. Cardaci,4397944,,True,6.0,0,3,0,0,0,3,0,0,0,0,0,1,0,0,0,1,0
401086059,Bryant Bulldogs,S. Townes,4067527,,False,29.0,7,11,5,7,2,4,2,2,1,9,10,3,1,0,1,1,18
401086059,Bryant Bulldogs,M. Urmilevicius,4067523,,False,2.0,0,0,0,0,0,0,0,0,1,1,2,0,0,0,0,0,0
401086059,Bryant Bulldogs,N. Hernandez,4397943,,False,2.0,0,0,0,0,0,0,0,0,0,0,0,0,0,0,0,0,0
401086059,Bryant Bulldogs,T. Johnson,4067525,,False,13.0,1,3,0,0,1,3,0,0,0,1,1,0,0,0,1,2,3
401086059,Bryant Bulldogs,A. Grant,4067524,,False,35.0,6,13,2,4,4,9,2,2,0,3,3,5,0,0,0,1,18
401086059,Bryant Bulldogs,T. McHugh,3947121,,False,17.0,0,3,0,1,0,2,1,2,0,0,0,2,0,0,2,0,1
401086059,Bryant Bulldogs,B. Hawkins,3147463,,False,28.0,4,10,1,4,3,6,0,2,0,0,0,2,0,0,3,1,11
401086059,Bryant Bulldogs,TEAM,TOTAL,TOTAL,False,,25,57,12,25,13,32,8,15,8,26,34,21,4,0,9,15,71
401086058,Saint Peter's Peacocks,S. Idowu,3922042,,True,17.0,5,6,2,3,3,3,2,2,3,0,3,0,0,1,2,4,15
401086058,Saint Peter's Peacocks,M. Dixon,4279758,,True,32.0,2,4,1,1,1,3,2,2,1,3,4,0,0,0,0,3,7
401086058,Saint Peter's Peacocks,Q. Taylor,4067357,,True,32.0,1,6,1,5,0,1,3,4,3,4,7,0,0,0,1,2,5
401086058,Saint Peter's Peacocks,D. Turner,4067356,,True,40.0,10,24,7,11,3,13,2,2,3,3,6,8,0,0,0,2,25
401086058,Saint Peter's Peacocks,C. Jones,3922043,,True,37.0,4,11,1,4,3,7,4,4,2,8,10,3,1,0,2,3,15
401086058,Saint Peter's Peacocks,K. Ndefo,4398386,,False,31.0,7,12,7,11,0,1,2,3,2,8,10,0,1,2,2,4,16
401086058,Saint Peter's Peacocks,M. Ndiaye,3922044,,False,11.0,0,1,0,1,0,0,2,5,0,0,0,0,1,0,1,0,2
401086058,Saint Peter's Peacocks,M. Majak,4398387,,False,3.0,0,0,0,0,0,0,0,0,0,0,0,0,0,1,1,0,0
401086058,Saint Peter's Peacocks,K. Brown,4398385,,False,3.0,0,0,0,0,0,0,0,0,0,0,0,0,0,0,0,0,0
401086058,Saint Peter's Peacocks,D. Watson,4398384,,False,19.0,3,7,1,2,2,5,0,0,0,1,1,2,0,0,1,2,8
401086058,Saint Peter's Peacocks,TEAM,TOTAL,TOTAL,False,,32,71,20,38,12,33,17,22,15,29,44,13,3,4,11,20,93
401086058,Lafayette Leopards,M. Cherry,4067119,,True,31.0,3,6,3,6,0,0,0,0,6,5,11,1,0,0,3,3,6
401086058,Lafayette Leopards,P. Zalys,3907433,,True,24.0,3,7,3,5,0,2,1,2,0,4,4,2,0,0,4,4,7
401086058,Lafayette Leopards,A. Petrie,4280076,,True,30.0,7,22,5,16,2,6,2,4,0,3,3,1,0,0,1,1,18
401086058,Lafayette Leopards,J. Jaworski,4280075,,True,38.0,7,12,1,1,6,11,8,8,0,5,5,1,1,0,3,2,28
401086058,Lafayette Leopards,K. Stout,4067118,,True,38.0,6,12,1,2,5,10,0,0,1,2,3,4,0,0,0,3,17
401086058,Lafayette Leopards,S. Good,4398073,,False,1.0,0,0,0,0,0,0,0,0,0,1,1,0,0,0,0,0,0
401086058,Lafayette Leopards,D. Hastings,4280077,,False,17.0,0,1,0,0,0,1,0,0,1,2,3,0,0,0,0,4,0
401086058,Lafayette Leopards,L. Jarrett,4067117,,False,17.0,0,1,0,0,0,1,0,0,0,0,0,0,0,0,1,3,0
401086058,Lafayette Leopards,I. Suffren,4398072,,False,12.0,1,2,1,2,0,0,3,3,1,1,2,2,0,0,1,2,5
401086058,Lafayette Leopards,T. Perry,4398070,,False,17.0,1,3,0,0,1,3,2,2,1,1,2,1,1,0,2,3,5
401086058,Lafayette Leopards,A. Evans,3907431,,False,0.0,0,0,0,0,0,0,0,0,0,0,0,0,0,0,0,0,0
401086058,Lafayette Leopards,TEAM,TOTAL,TOTAL,False,,28,66,14,32,14,34,16,19,11,27,38,12,2,0,15,25,86
401086057,Siena Saints,S. Seymour,4398391,,True,27.0,4,7,0,0,4,7,0,0,0,0,0,0,0,0,0,0,12
401086057,Siena Saints,E. Fisher,3913235,,True,31.0,7,13,6,11,1,2,6,6,0,2,2,0,0,0,0,2,21
401086057,Siena Saints,K. Degnan,3138282,,True,35.0,3,8,2,4,1,4,0,0,1,5,6,1,1,0,1,2,7
401086057,Siena Saints,J. Pickett,4398390,,True,39.0,5,13,2,7,3,6,5,5,1,3,4,9,2,0,2,3,18
401086057,Siena Saints,M. Camper,4279751,,True,34.0,2,4,2,4,0,0,3,6,4,3,7,2,3,1,1,1,7
401086057,Siena Saints,D. Tchougang,4398394,,False,5.0,0,1,0,1,0,0,0,1,0,0,0,0,0,0,0,4,0
401086057,Siena Saints,T. Huerter Jr.,4067350,,False,0.0,0,0,0,0,0,0,0,0,0,0,0,0,0,0,0,0,0
401086057,Siena Saints,J. Ratliff,4398392,,False,8.0,0,1,0,0,0,1,0,0,0,0,0,0,0,0,0,1,0
401086057,Siena Saints,K. Smithen,3133848,,False,21.0,1,2,0,0,1,2,4,4,0,1,1,1,1,1,0,4,7
401086057,Siena Saints,TEAM,TOTAL,TOTAL,False,,22,49,12,27,10,22,18,22,7,16,23,13,7,2,4,17,72
401086057,Siena Saints,S. Seymour,4398391,,True,27.0,4,7,0,0,4,7,0,0,0,0,0,0,0,0,0,0,12
401086057,Siena Saints,E. Fisher,3913235,,True,31.0,7,13,6,11,1,2,6,6,0,2,2,0,0,0,0,2,21
401086057,Siena Saints,K. Degnan,3138282,,True,35.0,3,8,2,4,1,4,0,0,1,5,6,1,1,0,1,2,7
401086057,Siena Saints,J. Pickett,4398390,,True,39.0,5,13,2,7,3,6,5,5,1,3,4,9,2,0,2,3,18
401086057,Siena Saints,M. Camper,4279751,,True,34.0,2,4,2,4,0,0,3,6,4,3,7,2,3,1,1,1,7
401086057,Siena Saints,D. Tchougang,4398394,,False,5.0,0,1,0,1,0,0,0,1,0,0,0,0,0,0,0,4,0
401086057,Siena Saints,T. Huerter Jr.,4067350,,False,0.0,0,0,0,0,0,0,0,0,0,0,0,0,0,0,0,0,0
401086057,Siena Saints,J. Ratliff,4398392,,False,8.0,0,1,0,0,0,1,0,0,0,0,0,0,0,0,0,1,0
401086057,Siena Saints,K. Smithen,3133848,,False,21.0,1,2,0,0,1,2,4,4,0,1,1,1,1,1,0,4,7
401086057,Siena Saints,TEAM,TOTAL,TOTAL,False,,22,49,12,27,10,22,18,22,7,16,23,13,7,2,4,17,72
401086057,Saint Peter's Peacocks,S. Idowu,3922042,,True,15.0,2,3,2,3,0,0,0,0,1,4,5,1,0,1,1,1,4
401086057,Saint Peter's Peacocks,C. Underwood,4398388,,True,4.0,0,0,0,0,0,0,0,0,1,0,1,0,0,0,0,2,0
401086057,Saint Peter's Peacocks,D. Watson,4398384,,True,32.0,3,8,2,7,1,1,1,1,1,2,3,1,0,1,4,3,8
401086057,Saint Peter's Peacocks,Q. Taylor,4067357,,True,33.0,6,9,6,6,0,3,0,2,2,4,6,0,1,0,1,4,12
401086057,Saint Peter's Peacocks,D. Turner,4067356,,True,34.0,6,12,4,8,2,4,2,4,0,2,2,1,1,0,3,1,16
401086057,Saint Peter's Peacocks,KC Ndefo,4398386,,False,33.0,5,6,5,6,0,0,2,2,1,3,4,1,0,3,1,5,12
401086057,Saint Peter's Peacocks,D. Woods,3919424,,False,21.0,2,4,2,4,0,0,4,8,1,3,4,0,0,1,1,1,8
401086057,Saint Peter's Peacocks,M. Majak,4398387,,False,2.0,0,1,0,1,0,0,0,0,0,0,0,0,0,1,1,1,0
401086057,Saint Peter's Peacocks,A. Hicks,4284295,,False,1.0,0,0,0,0,0,0,0,0,0,0,0,0,0,0,1,0,0
401086057,Saint Peter's Peacocks,M. Dixon,4279758,,False,25.0,0,3,0,2,0,1,2,2,1,1,2,0,0,0,0,2,2
401086057,Saint Peter's Peacocks,TEAM,TOTAL,TOTAL,False,,24,46,21,37,3,9,11,19,8,23,31,4,2,7,15,20,62
401086057,Saint Peter's Peacocks,S. Idowu,3922042,,True,15.0,2,3,2,3,0,0,0,0,1,4,5,1,0,1,1,1,4
401086057,Saint Peter's Peacocks,C. Underwood,4398388,,True,4.0,0,0,0,0,0,0,0,0,1,0,1,0,0,0,0,2,0
401086057,Saint Peter's Peacocks,D. Watson,4398384,,True,32.0,3,8,2,7,1,1,1,1,1,2,3,1,0,1,4,3,8
401086057,Saint Peter's Peacocks,Q. Taylor,4067357,,True,33.0,6,9,6,6,0,3,0,2,2,4,6,0,1,0,1,4,12
401086057,Saint Peter's Peacocks,D. Turner,4067356,,True,34.0,6,12,4,8,2,4,2,4,0,2,2,1,1,0,3,1,16
401086057,Saint Peter's Peacocks,KC Ndefo,4398386,,False,33.0,5,6,5,6,0,0,2,2,1,3,4,1,0,3,1,5,12
401086057,Saint Peter's Peacocks,D. Woods,3919424,,False,21.0,2,4,2,4,0,0,4,8,1,3,4,0,0,1,1,1,8
401086057,Saint Peter's Peacocks,M. Majak,4398387,,False,2.0,0,1,0,1,0,0,0,0,0,0,0,0,0,1,1,1,0
401086057,Saint Peter's Peacocks,A. Hicks,4284295,,False,1.0,0,0,0,0,0,0,0,0,0,0,0,0,0,0,1,0,0
401086057,Saint Peter's Peacocks,M. Dixon,4279758,,False,25.0,0,3,0,2,0,1,2,2,1,1,2,0,0,0,0,2,2
401086057,Saint Peter's Peacocks,TEAM,TOTAL,TOTAL,False,,24,46,21,37,3,9,11,19,8,23,31,4,2,7,15,20,62
401086056,Siena Saints,S. Seymour,4398391,,True,32.0,4,6,0,0,4,6,0,0,0,0,0,0,0,0,0,0,12
401086056,Siena Saints,E. Fisher,3913235,,True,36.0,11,18,11,17,0,1,1,2,2,4,6,0,1,0,0,2,23
401086056,Siena Saints,K. Degnan,3138282,,True,33.0,2,6,1,2,1,4,0,2,1,8,9,0,1,1,1,1,5
401086056,Siena Saints,G. Darwiche,4398393,,True,25.0,1,3,1,2,0,1,0,0,0,1,1,1,0,0,0,3,2
401086056,Siena Saints,J. Pickett,4398390,,True,38.0,7,13,5,6,2,7,0,0,0,4,4,8,2,2,5,2,16
401086056,Siena Saints,D. Tchougang,4398394,,False,4.0,0,1,0,1,0,0,0,0,0,0,0,0,0,0,0,0,0
401086056,Siena Saints,T. Huerter Jr.,4067350,,False,0.0,0,0,0,0,0,0,0,0,0,0,0,0,0,0,0,1,0
401086056,Siena Saints,J. Ratliff,4398392,,False,17.0,0,0,0,0,0,0,0,0,1,0,1,1,0,0,1,2,0
401086056,Siena Saints,B. Bayer,4065720,,False,0.0,0,0,0,0,0,0,0,0,0,0,0,0,0,0,0,0,0
401086056,Siena Saints,K. Smithen,3133848,,False,15.0,0,2,0,1,0,1,2,2,0,2,2,0,1,0,0,1,2
401086056,Siena Saints,TEAM,TOTAL,TOTAL,False,,25,49,18,29,7,20,3,6,5,20,25,10,5,3,8,12,60
401086056,Siena Saints,S. Seymour,4398391,,True,32.0,4,6,0,0,4,6,0,0,0,0,0,0,0,0,0,0,12
401086056,Siena Saints,E. Fisher,3913235,,True,36.0,11,18,11,17,0,1,1,2,2,4,6,0,1,0,0,2,23
401086056,Siena Saints,K. Degnan,3138282,,True,33.0,2,6,1,2,1,4,0,2,1,8,9,0,1,1,1,1,5
401086056,Siena Saints,G. Darwiche,4398393,,True,25.0,1,3,1,2,0,1,0,0,0,1,1,1,0,0,0,3,2
401086056,Siena Saints,J. Pickett,4398390,,True,38.0,7,13,5,6,2,7,0,0,0,4,4,8,2,2,5,2,16
401086056,Siena Saints,D. Tchougang,4398394,,False,4.0,0,1,0,1,0,0,0,0,0,0,0,0,0,0,0,0,0
401086056,Siena Saints,T. Huerter Jr.,4067350,,False,0.0,0,0,0,0,0,0,0,0,0,0,0,0,0,0,0,1,0
401086056,Siena Saints,J. Ratliff,4398392,,False,17.0,0,0,0,0,0,0,0,0,1,0,1,1,0,0,1,2,0
401086056,Siena Saints,B. Bayer,4065720,,False,0.0,0,0,0,0,0,0,0,0,0,0,0,0,0,0,0,0,0
401086056,Siena Saints,K. Smithen,3133848,,False,15.0,0,2,0,1,0,1,2,2,0,2,2,0,1,0,0,1,2
401086056,Siena Saints,TEAM,TOTAL,TOTAL,False,,25,49,18,29,7,20,3,6,5,20,25,10,5,3,8,12,60
401086056,Saint Peter's Peacocks,K. Ndefo,4398386,,True,33.0,4,7,4,7,0,0,0,0,2,4,6,1,0,0,0,2,8
401086056,Saint Peter's Peacocks,S. Idowu,3922042,,True,29.0,5,10,4,6,1,4,4,4,1,6,7,0,1,1,0,1,15
401086056,Saint Peter's Peacocks,Q. Taylor,4067357,,True,35.0,4,7,3,6,1,1,1,2,2,3,5,1,0,0,1,1,10
401086056,Saint Peter's Peacocks,D. Watson,4398384,,True,29.0,1,4,1,2,0,2,0,1,0,3,3,5,0,0,3,0,2
401086056,Saint Peter's Peacocks,D. Turner,4067356,,True,37.0,8,17,5,12,3,5,2,3,1,1,2,2,0,0,2,0,21
401086056,Saint Peter's Peacocks,D. Woods,3919424,,False,10.0,1,2,1,1,0,1,0,0,0,1,1,0,1,0,1,1,2
401086056,Saint Peter's Peacocks,M. Dixon,4279758,,False,27.0,3,3,2,2,1,1,0,0,1,1,2,1,1,0,0,1,7
401086056,Saint Peter's Peacocks,TEAM,TOTAL,TOTAL,False,,26,50,20,36,6,14,7,10,7,20,27,10,3,1,7,6,65
401086056,Saint Peter's Peacocks,K. Ndefo,4398386,,True,33.0,4,7,4,7,0,0,0,0,2,4,6,1,0,0,0,2,8
401086056,Saint Peter's Peacocks,S. Idowu,3922042,,True,29.0,5,10,4,6,1,4,4,4,1,6,7,0,1,1,0,1,15
401086056,Saint Peter's Peacocks,Q. Taylor,4067357,,True,35.0,4,7,3,6,1,1,1,2,2,3,5,1,0,0,1,1,10
401086056,Saint Peter's Peacocks,D. Watson,4398384,,True,29.0,1,4,1,2,0,2,0,1,0,3,3,5,0,0,3,0,2
401086056,Saint Peter's Peacocks,D. Turner,4067356,,True,37.0,8,17,5,12,3,5,2,3,1,1,2,2,0,0,2,0,21
401086056,Saint Peter's Peacocks,D. Woods,3919424,,False,10.0,1,2,1,1,0,1,0,0,0,1,1,0,1,0,1,1,2
401086056,Saint Peter's Peacocks,M. Dixon,4279758,,False,27.0,3,3,2,2,1,1,0,0,1,1,2,1,1,0,0,1,7
401086056,Saint Peter's Peacocks,TEAM,TOTAL,TOTAL,False,,26,50,20,36,6,14,7,10,7,20,27,10,3,1,7,6,65
401086055,Siena Saints,E. Fisher,3913235,,True,35.0,8,14,8,12,0,2,1,1,2,7,9,2,0,0,2,2,17
401086055,Siena Saints,S. Seymour,4398391,,True,25.0,2,10,0,1,2,9,0,0,0,0,0,0,0,1,0,0,6
401086055,Siena Saints,K. Degnan,3138282,,True,23.0,1,3,0,0,1,3,0,0,2,7,9,1,1,1,1,1,3
401086055,Siena Saints,G. Darwiche,4398393,,True,29.0,2,5,0,0,2,5,0,0,1,0,1,0,1,0,1,3,6
401086055,Siena Saints,J. Pickett,4398390,,True,39.0,6,13,5,6,1,7,1,2,4,0,4,8,1,0,1,2,14
401086055,Siena Saints,D. Tchougang,4398394,,False,5.0,0,0,0,0,0,0,0,0,0,0,0,0,0,0,1,2,0
401086055,Siena Saints,J. Ratliff,4398392,,False,32.0,4,9,1,2,3,7,0,0,1,1,2,1,0,0,1,0,11
401086055,Siena Saints,K. Smithen,3133848,,False,12.0,0,0,0,0,0,0,0,0,0,1,1,3,0,0,2,2,0
401086055,Siena Saints,TEAM,TOTAL,TOTAL,False,,23,54,14,21,9,33,2,3,11,18,29,15,3,2,10,12,57
401086055,Holy Cross Crusaders,J. Floyd,3907455,,True,38.0,7,11,7,11,0,0,0,2,4,4,8,5,0,1,0,1,14
401086055,Holy Cross Crusaders,M. Faw,4280072,,True,18.0,1,3,1,1,0,2,0,0,0,1,1,0,1,1,1,0,2
401086055,Holy Cross Crusaders,J. Grandison,4280073,,True,37.0,5,11,3,9,2,2,2,2,1,6,7,3,0,0,1,1,14
401086055,Holy Cross Crusaders,A. Butler,4280070,,True,37.0,7,14,3,6,4,8,0,0,0,5,5,0,0,0,0,3,18
401086055,Holy Cross Crusaders,C. Green,4280068,,True,39.0,5,5,4,4,1,1,1,2,0,1,1,5,1,0,4,4,12
401086055,Holy Cross Crusaders,C. Le Sann,4067110,,False,3.0,0,0,0,0,0,0,0,0,0,1,1,0,0,0,1,0,0
401086055,Holy Cross Crusaders,P. Benzan,3907453,,False,28.0,0,2,0,2,0,0,0,1,1,3,4,1,1,0,0,0,0
401086055,Holy Cross Crusaders,TEAM,TOTAL,TOTAL,False,,25,46,18,33,7,13,3,7,6,21,27,14,3,2,8,9,60
401086054,Siena Saints,S. Seymour,4398391,,True,21.0,3,7,0,1,3,6,0,0,1,1,2,0,0,0,0,1,9
401086054,Siena Saints,K. Degnan,3138282,,True,38.0,7,13,2,5,5,8,0,0,1,6,7,2,1,0,2,3,19
401086054,Siena Saints,J. Ratliff,4398392,,True,40.0,4,8,2,3,2,5,0,0,1,3,4,2,1,1,0,3,10
401086054,Siena Saints,J. Pickett,4398390,,True,40.0,7,17,6,11,1,6,5,6,1,6,7,7,1,0,2,2,20
401086054,Siena Saints,M. Camper,4279751,,True,37.0,6,6,6,6,0,0,2,3,2,2,4,1,0,0,3,3,14
401086054,Siena Saints,D. Tchougang,4398394,,False,5.0,0,2,0,2,0,0,0,0,0,0,0,0,0,0,0,1,0
401086054,Siena Saints,T. Huerter Jr.,4067350,,False,0.0,0,0,0,0,0,0,0,0,0,0,0,0,0,0,0,0,0
401086054,Siena Saints,K. Smithen,3133848,,False,19.0,0,0,0,0,0,0,2,4,0,1,1,1,1,0,2,3,2
401086054,Siena Saints,TEAM,TOTAL,TOTAL,False,,27,53,16,28,11,25,9,13,6,20,26,13,4,1,9,16,74
401086054,Robert Morris Colonials,Y. Mendy,4397993,,True,8.0,0,0,0,0,0,0,0,0,0,1,1,0,0,0,0,0,0
401086054,Robert Morris Colonials,C. Bain,4279641,,True,23.0,4,7,3,5,1,2,0,2,2,1,3,0,1,0,0,1,9
401086054,Robert Morris Colonials,J. Williams,4279635,,True,31.0,1,1,1,1,0,0,0,0,0,2,2,4,0,0,2,3,2
401086054,Robert Morris Colonials,M. McConnell,3938915,,True,31.0,5,8,3,5,2,3,4,5,0,2,2,0,2,0,1,1,16
401086054,Robert Morris Colonials,J. Williams,3907021,,True,36.0,6,13,3,8,3,5,4,7,0,3,3,2,0,0,2,1,19
401086054,Robert Morris Colonials,M. Petteway,4279638,,False,23.0,4,7,4,7,0,0,1,1,0,4,4,0,0,1,0,4,9
401086054,Robert Morris Colonials,K. Thomas,4279639,,False,18.0,2,6,2,6,0,0,1,1,2,7,9,1,0,0,1,2,5
401086054,Robert Morris Colonials,S. McEwen,4397992,,False,13.0,4,5,4,5,0,0,0,0,0,0,0,0,0,0,0,0,8
401086054,Robert Morris Colonials,D. Treacy,4397989,,False,17.0,1,1,1,1,0,0,1,2,0,0,0,2,0,0,2,3,3
401086054,Robert Morris Colonials,TEAM,TOTAL,TOTAL,False,,27,48,21,38,6,10,11,18,5,23,28,9,3,1,9,15,71
401086053,Siena Saints,S. Seymour,4398391,,True,33.0,3,9,0,2,3,7,0,0,1,1,2,0,1,1,0,0,9
401086053,Siena Saints,E. Fisher,3913235,,True,21.0,3,8,3,8,0,0,0,0,2,4,6,0,0,0,1,2,6
401086053,Siena Saints,K. Degnan,3138282,,True,37.0,6,12,3,4,3,8,1,2,1,3,4,2,2,3,1,2,16
401086053,Siena Saints,J. Pickett,4398390,,True,39.0,6,14,4,8,2,6,0,0,1,3,4,8,2,0,5,3,14
401086053,Siena Saints,M. Camper,4279751,,True,33.0,3,5,3,5,0,0,1,4,3,2,5,3,1,0,0,4,7
401086053,Siena Saints,S. Friday IV,4067353,,False,21.0,4,6,4,6,0,0,2,3,2,1,3,1,0,0,0,3,10
401086053,Siena Saints,T. Huerter Jr.,4067350,,False,4.0,0,0,0,0,0,0,2,2,0,0,0,0,0,0,2,1,2
401086053,Siena Saints,G. Darwiche,4398393,,False,1.0,0,1,0,0,0,1,0,0,0,0,0,0,0,0,0,0,0
401086053,Siena Saints,J. Ratliff,4398392,,False,6.0,0,1,0,0,0,1,0,0,0,2,2,0,0,0,0,0,0
401086053,Siena Saints,K. Smithen,3133848,,False,5.0,0,0,0,0,0,0,3,6,0,1,1,1,1,0,0,2,3
401086053,Siena Saints,TEAM,TOTAL,TOTAL,False,,25,56,17,33,8,23,9,17,11,22,33,15,7,4,9,17,67
401086053,Harvard Crimson,D. Djuricic,4279557,,True,25.0,2,6,2,4,0,2,1,2,3,4,7,1,0,0,0,1,5
401086053,Harvard Crimson,H. Welsh,4066831,,True,24.0,3,6,3,5,0,1,0,1,1,7,8,0,0,0,2,2,6
401086053,Harvard Crimson,C. Juzang,4066828,,True,27.0,3,4,1,1,2,3,2,3,0,2,2,3,1,0,0,1,10
401086053,Harvard Crimson,J. Bassey,4066827,,True,32.0,6,12,6,10,0,2,3,6,2,5,7,3,1,0,4,2,15
401086053,Harvard Crimson,C. Johnson,3920225,,True,13.0,2,3,0,0,2,3,0,0,0,0,0,0,0,0,0,1,6
401086053,Harvard Crimson,M. Forbes,4397970,,False,9.0,1,1,1,1,0,0,0,0,0,0,0,0,1,0,0,1,2
401086053,Harvard Crimson,R. Baker II,4066830,,False,19.0,3,6,3,5,0,1,0,0,1,1,2,1,0,2,3,1,6
401086053,Harvard Crimson,S. Freedman,4397969,,False,10.0,0,1,0,0,0,1,0,0,0,0,0,0,0,0,1,0,0
401086053,Harvard Crimson,N. Kirkwood,4397968,,False,26.0,2,8,1,5,1,3,1,2,1,4,5,0,1,0,4,2,6
401086053,Harvard Crimson,R. Haskett,4279556,,False,15.0,3,3,1,1,2,2,0,0,1,1,2,1,0,0,1,3,8
401086053,Harvard Crimson,TEAM,TOTAL,TOTAL,False,,25,50,18,32,7,18,7,14,9,24,33,9,4,2,15,14,64
401086052,Siena Saints,S. Seymour,4398391,,True,26.0,2,6,0,0,2,6,0,0,0,1,1,1,0,0,1,2,6
401086052,Siena Saints,E. Fisher,3913235,,True,30.0,9,12,9,11,0,1,4,4,1,5,6,1,0,0,1,2,22
401086052,Siena Saints,K. Degnan,3138282,,True,31.0,3,8,1,1,2,7,0,1,0,4,4,0,0,0,1,4,8
401086052,Siena Saints,J. Pickett,4398390,,True,36.0,9,16,8,11,1,5,2,3,1,4,5,9,7,2,3,1,21
401086052,Siena Saints,M. Camper,4279751,,True,32.0,4,9,4,6,0,3,2,7,5,2,7,2,0,0,1,3,10
401086052,Siena Saints,S. Friday IV,4067353,,False,19.0,4,6,4,6,0,0,2,3,2,0,2,0,0,0,0,3,10
401086052,Siena Saints,T. Huerter Jr.,4067350,,False,5.0,0,1,0,1,0,0,0,0,0,1,1,1,0,0,0,1,0
401086052,Siena Saints,J. Ratliff,4398392,,False,10.0,0,1,0,0,0,1,0,0,0,1,1,0,0,0,0,1,0
401086052,Siena Saints,B. Bayer,4065720,,False,4.0,0,0,0,0,0,0,0,0,0,0,0,0,0,0,0,1,0
401086052,Siena Saints,K. Smithen,3133848,,False,7.0,1,1,1,1,0,0,0,0,0,0,0,1,0,0,0,1,2
401086052,Siena Saints,TEAM,TOTAL,TOTAL,False,,32,60,27,37,5,23,10,18,10,18,28,15,7,2,8,19,79
401086052,Colgate Raiders,W. Rayman,4067106,,True,35.0,4,9,2,4,2,5,0,0,1,5,6,3,0,1,0,2,10
401086052,Colgate Raiders,R. Ivanauskas,4066395,,True,32.0,6,12,6,10,0,2,4,4,3,8,11,1,0,0,1,3,16
401086052,Colgate Raiders,D. Batt,3921438,,True,18.0,3,4,3,4,0,0,0,0,0,2,2,1,0,0,1,4,6
401086052,Colgate Raiders,T. Richardson,4398040,,True,32.0,1,3,0,1,1,2,0,1,0,3,3,4,0,0,1,1,3
401086052,Colgate Raiders,J. Burns,4280047,,True,31.0,9,14,4,5,5,9,2,4,0,1,1,4,2,0,3,1,25
401086052,Colgate Raiders,M. Regisford,3921437,,False,14.0,1,2,1,2,0,0,0,0,0,0,0,0,0,0,0,2,2
401086052,Colgate Raiders,J. Ferguson,4280048,,False,22.0,5,7,2,4,3,3,9,10,0,1,1,1,1,0,0,3,22
401086052,Colgate Raiders,F. Amiel,3921440,,False,16.0,0,2,0,0,0,2,0,0,2,0,2,1,0,0,3,1,0
401086052,Colgate Raiders,TEAM,TOTAL,TOTAL,False,,29,53,18,30,11,23,15,19,7,22,29,15,3,1,9,17,84
401086051,Siena Saints,S. Seymour,4398391,,True,27.0,3,9,0,0,3,9,0,0,0,1,1,0,0,0,0,2,9
401086051,Siena Saints,E. Fisher,3913235,,True,29.0,5,13,5,11,0,2,3,3,3,4,7,1,0,0,3,1,13
401086051,Siena Saints,K. Degnan,3138282,,True,32.0,3,6,2,2,1,4,0,0,3,2,5,0,1,1,0,2,7
401086051,Siena Saints,J. Pickett,4398390,,True,38.0,10,19,6,11,4,8,1,2,4,2,6,7,3,1,1,2,25
401086051,Siena Saints,M. Camper,4279751,,True,26.0,2,5,2,4,0,1,4,4,3,3,6,1,2,0,2,3,8
401086051,Siena Saints,S. Friday IV,4067353,,False,12.0,3,6,3,6,0,0,0,0,1,1,2,0,0,0,1,2,6
401086051,Siena Saints,T. Huerter Jr.,4067350,,False,13.0,0,2,0,0,0,2,0,0,0,2,2,1,1,0,0,0,0
401086051,Siena Saints,J. Ratliff,4398392,,False,8.0,0,3,0,0,0,3,0,0,0,0,0,0,0,0,0,0,0
401086051,Siena Saints,B. Bayer,4065720,,False,3.0,0,0,0,0,0,0,0,0,0,0,0,0,0,0,0,0,0
401086051,Siena Saints,K. Smithen,3133848,,False,12.0,0,1,0,0,0,1,1,2,0,2,2,0,0,0,0,0,1
401086051,Siena Saints,TEAM,TOTAL,TOTAL,False,,26,64,18,34,8,30,9,11,14,17,31,10,7,2,7,12,69
401086051,Lehigh Mountain Hawks,P. Andree,4067122,,True,21.0,3,6,1,1,2,5,0,0,0,4,4,1,0,0,0,3,8
401086051,Lehigh Mountain Hawks,J. Karnik,4280080,,True,20.0,2,4,2,4,0,0,2,5,1,7,8,1,0,0,0,2,6
401086051,Lehigh Mountain Hawks,J. Cohen,4067120,,True,31.0,5,8,3,4,2,4,3,4,1,3,4,4,1,0,2,1,15
401086051,Lehigh Mountain Hawks,K. Leufroy,3908514,,True,30.0,8,11,4,6,4,5,5,6,1,4,5,3,1,0,2,1,25
401086051,Lehigh Mountain Hawks,L. Tejada,3147354,,True,25.0,1,5,1,4,0,1,0,0,0,1,1,3,2,0,4,3,2
401086051,Lehigh Mountain Hawks,J. Wilson,4398116,,False,25.0,4,6,2,4,2,2,0,0,2,1,3,2,0,0,1,0,10
401086051,Lehigh Mountain Hawks,N. Lynch,4398119,,False,19.0,0,1,0,1,0,0,0,0,0,2,2,0,1,0,0,1,0
401086051,Lehigh Mountain Hawks,M. Wilson,4280081,,False,20.0,5,6,3,4,2,2,0,0,0,2,2,2,0,0,0,1,12
401086051,Lehigh Mountain Hawks,C. Bennett,4280078,,False,9.0,1,3,1,3,0,0,0,0,0,0,0,1,0,0,2,1,2
401086051,Lehigh Mountain Hawks,TEAM,TOTAL,TOTAL,False,,29,50,17,31,12,19,10,15,7,25,32,17,5,0,12,13,80
401086050,Siena Saints,S. Seymour,4398391,,True,26.0,5,10,1,1,4,9,0,0,0,1,1,1,0,0,0,0,14
401086050,Siena Saints,E. Fisher,3913235,,True,29.0,4,7,4,6,0,1,5,8,0,2,2,2,0,0,1,1,13
401086050,Siena Saints,K. Degnan,3138282,,True,24.0,1,3,0,0,1,3,4,4,0,3,3,3,1,0,0,1,7
401086050,Siena Saints,J. Pickett,4398390,,True,37.0,4,6,0,0,4,6,0,1,1,3,4,4,3,1,3,0,12
401086050,Siena Saints,M. Camper,4279751,,True,13.0,0,2,0,0,0,2,0,0,1,8,9,1,0,0,1,3,0
401086050,Siena Saints,S. Friday IV,4067353,,False,11.0,1,3,1,3,0,0,2,4,0,1,1,1,0,0,1,2,4
401086050,Siena Saints,T. Huerter Jr.,4067350,,False,14.0,0,3,0,1,0,2,0,0,0,1,1,0,0,0,1,2,0
401086050,Siena Saints,G. Darwiche,4398393,,False,1.0,0,0,0,0,0,0,0,0,0,0,0,1,0,0,1,1,0
401086050,Siena Saints,J. Ratliff,4398392,,False,16.0,1,4,0,0,1,4,0,0,0,1,1,0,1,0,1,1,3
401086050,Siena Saints,B. Bayer,4065720,,False,6.0,0,0,0,0,0,0,0,0,0,0,0,0,0,0,0,0,0
401086050,Siena Saints,K. Smithen,3133848,,False,23.0,2,5,1,2,1,3,3,4,0,2,2,0,1,0,0,1,8
401086050,Siena Saints,TEAM,TOTAL,TOTAL,False,,18,43,7,13,11,30,14,21,3,23,26,13,6,1,10,12,61
401086050,Norfolk State Spartans,A. Long,3947058,,True,18.0,3,6,3,6,0,0,1,1,1,2,3,0,0,0,1,2,7
401086050,Norfolk State Spartans,J. Butler,3156043,,True,30.0,5,7,5,7,0,0,3,5,4,5,9,1,0,1,0,1,13
401086050,Norfolk State Spartans,C.J. Kelly,4398208,,True,17.0,0,2,0,2,0,0,0,0,1,1,2,0,1,0,1,3,0
401086050,Norfolk State Spartans,N. Thomas,3948866,,True,18.0,2,7,1,2,1,5,0,0,0,2,2,1,0,0,1,3,5
401086050,Norfolk State Spartans,S. Whitley,3938909,,True,17.0,3,9,3,6,0,3,4,4,0,2,2,2,1,0,1,3,10
401086050,Norfolk State Spartans,C. Ford,4398209,,False,9.0,0,0,0,0,0,0,0,0,0,0,0,0,0,0,0,1,0
401086050,Norfolk State Spartans,A. Branch,3155936,,False,12.0,1,3,1,1,0,2,0,0,0,2,2,0,0,0,1,1,2
401086050,Norfolk State Spartans,K. Chavis,4398210,,False,17.0,1,2,1,2,0,0,0,0,0,1,1,2,1,0,1,0,2
401086050,Norfolk State Spartans,J. Bryant Jr.,4398206,,False,8.0,0,3,0,2,0,1,0,0,0,1,1,1,1,0,0,1,0
401086050,Norfolk State Spartans,B. Fitzgerald,4398205,,False,3.0,0,0,0,0,0,0,2,2,0,1,1,0,0,0,0,1,2
401086050,Norfolk State Spartans,D. Jamerson Jr.,4279809,,False,29.0,6,14,3,3,3,11,0,0,3,4,7,0,0,0,0,4,15
401086050,Norfolk State Spartans,M. Pitt,4279808,,False,22.0,1,3,1,1,0,2,0,0,0,2,2,4,0,0,2,1,2
401086050,Norfolk State Spartans,TEAM,TOTAL,TOTAL,False,,22,56,18,32,4,24,10,12,11,24,35,11,4,1,9,21,58
401086049,Siena Saints,S. Seymour,4398391,,True,20.0,2,7,0,1,2,6,0,0,0,0,0,0,0,0,2,1,6
401086049,Siena Saints,E. Fisher,3913235,,True,25.0,4,10,4,7,0,3,0,0,0,6,6,1,0,0,1,0,8
401086049,Siena Saints,K. Degnan,3138282,,True,23.0,5,7,0,1,5,6,0,0,1,7,8,0,1,0,0,1,15
401086049,Siena Saints,J. Pickett,4398390,,True,35.0,5,12,1,3,4,9,5,6,3,2,5,6,0,1,1,2,19
401086049,Siena Saints,M. Camper,4279751,,True,28.0,4,10,4,8,0,2,1,5,1,2,3,2,2,0,1,2,9
401086049,Siena Saints,S. Friday IV,4067353,,False,15.0,1,6,1,6,0,0,0,0,3,6,9,1,0,1,0,2,2
401086049,Siena Saints,T. Huerter Jr.,4067350,,False,20.0,0,0,0,0,0,0,0,0,1,1,2,1,0,2,0,3,0
401086049,Siena Saints,G. Darwiche,4398393,,False,8.0,0,1,0,1,0,0,0,0,2,0,2,3,0,0,0,0,0
401086049,Siena Saints,J. Ratliff,4398392,,False,17.0,2,7,1,1,1,6,0,0,2,1,3,1,3,0,1,1,5
401086049,Siena Saints,K. Smithen,3133848,,False,9.0,2,3,1,1,1,2,0,0,0,0,0,0,1,0,0,0,5
401086049,Siena Saints,TEAM,TOTAL,TOTAL,False,,25,63,12,29,13,34,6,11,16,26,42,15,7,4,7,12,69
401086049,George Washington Revolutionaries,A. Toro,4066875,,True,34.0,4,6,4,6,0,0,1,2,4,5,9,1,1,0,1,3,9
401086049,George Washington Revolutionaries,T. Nolan Jr.,4278494,,True,35.0,6,13,2,6,4,7,1,3,1,8,9,2,0,0,2,2,17
401086049,George Washington Revolutionaries,J. Mazzulla,4278493,,True,32.0,8,14,6,11,2,3,0,1,2,6,8,1,0,0,1,1,18
401086049,George Washington Revolutionaries,A. Potter,3913163,,True,28.0,2,8,2,8,0,0,0,1,0,1,1,3,0,0,0,3,4
401086049,George Washington Revolutionaries,D.J. Williams,3911841,,True,36.0,2,8,1,4,1,4,3,4,0,3,3,2,2,2,2,0,8
401086049,George Washington Revolutionaries,M. Offurum,4396837,,False,7.0,0,1,0,1,0,0,0,0,0,0,0,0,0,1,0,0,0
401086049,George Washington Revolutionaries,J. Langarica,4278497,,False,6.0,0,0,0,0,0,0,2,2,0,0,0,0,0,0,0,0,2
401086049,George Washington Revolutionaries,S. Brown,4396836,,False,10.0,0,1,0,0,0,1,0,0,0,0,0,1,0,0,0,1,0
401086049,George Washington Revolutionaries,M. Jack,4278495,,False,8.0,1,3,0,0,1,3,0,0,0,0,0,0,0,0,0,0,3
401086049,George Washington Revolutionaries,A. Mitola,4066874,,False,2.0,0,0,0,0,0,0,0,0,1,0,1,0,0,0,1,0,0
401086049,George Washington Revolutionaries,J. Williams,4066873,,False,2.0,0,0,0,0,0,0,0,0,0,1,1,0,0,0,0,1,0
401086049,George Washington Revolutionaries,TEAM,TOTAL,TOTAL,False,,23,54,15,36,8,18,7,13,8,24,32,10,3,3,8,11,61
401086048,Saint Peter's Peacocks,KC Ndefo,4398386,,True,37.0,5,8,5,7,0,1,5,6,1,8,9,1,1,6,2,2,15
401086048,Saint Peter's Peacocks,S. Idowu,3922042,,True,33.0,9,12,9,11,0,1,3,3,5,7,12,0,1,2,4,3,21
401086048,Saint Peter's Peacocks,D. Watson,4398384,,True,38.0,0,2,0,2,0,0,5,7,1,4,5,2,0,1,6,4,5
401086048,Saint Peter's Peacocks,Q. Taylor,4067357,,True,36.0,3,6,2,5,1,1,2,2,2,4,6,3,1,0,3,2,9
401086048,Saint Peter's Peacocks,D. Turner,4067356,,True,39.0,3,14,2,9,1,5,0,0,0,1,1,4,4,0,1,0,7
401086048,Saint Peter's Peacocks,D. Woods,3919424,,False,7.0,1,2,1,2,0,0,0,0,1,0,1,0,0,0,3,3,2
401086048,Saint Peter's Peacocks,C. Underwood,4398388,,False,1.0,0,0,0,0,0,0,0,0,0,0,0,0,0,0,0,0,0
401086048,Saint Peter's Peacocks,K. Brown,4398385,,False,9.0,1,1,0,0,1,1,0,0,0,0,0,0,1,0,0,0,3
401086048,Saint Peter's Peacocks,TEAM,TOTAL,TOTAL,False,,22,45,19,36,3,9,15,18,10,27,37,10,8,9,19,14,62
401086048,Saint Peter's Peacocks,KC Ndefo,4398386,,True,37.0,5,8,5,7,0,1,5,6,1,8,9,1,1,6,2,2,15
401086048,Saint Peter's Peacocks,S. Idowu,3922042,,True,33.0,9,12,9,11,0,1,3,3,5,7,12,0,1,2,4,3,21
401086048,Saint Peter's Peacocks,D. Watson,4398384,,True,38.0,0,2,0,2,0,0,5,7,1,4,5,2,0,1,6,4,5
401086048,Saint Peter's Peacocks,Q. Taylor,4067357,,True,36.0,3,6,2,5,1,1,2,2,2,4,6,3,1,0,3,2,9
401086048,Saint Peter's Peacocks,D. Turner,4067356,,True,39.0,3,14,2,9,1,5,0,0,0,1,1,4,4,0,1,0,7
401086048,Saint Peter's Peacocks,D. Woods,3919424,,False,7.0,1,2,1,2,0,0,0,0,1,0,1,0,0,0,3,3,2
401086048,Saint Peter's Peacocks,C. Underwood,4398388,,False,1.0,0,0,0,0,0,0,0,0,0,0,0,0,0,0,0,0,0
401086048,Saint Peter's Peacocks,K. Brown,4398385,,False,9.0,1,1,0,0,1,1,0,0,0,0,0,0,1,0,0,0,3
401086048,Saint Peter's Peacocks,TEAM,TOTAL,TOTAL,False,,22,45,19,36,3,9,15,18,10,27,37,10,8,9,19,14,62
401086048,Fairfield Stags,M. Milin,3947018,,True,24.0,3,5,2,3,1,2,0,0,2,2,4,1,0,0,2,4,7
401086048,Fairfield Stags,J. Kasibabu,3947016,,True,38.0,1,6,1,5,0,1,6,6,2,4,6,0,2,1,1,3,8
401086048,Fairfield Stags,L. Taliaferro,4398078,,True,32.0,3,12,1,5,2,7,0,0,0,0,0,1,2,0,0,0,8
401086048,Fairfield Stags,N. Alvarez,4398075,,True,39.0,6,13,5,9,1,4,3,4,0,3,3,4,3,0,2,3,16
401086048,Fairfield Stags,T. Benning,4279483,,True,32.0,3,6,1,4,2,2,0,0,0,1,1,0,1,0,4,3,8
401086048,Fairfield Stags,W. Methnani,4279486,,False,4.0,0,2,0,1,0,1,0,0,0,1,1,0,0,0,2,0,0
401086048,Fairfield Stags,C. Whipple,4398077,,False,6.0,1,1,0,0,1,1,0,0,0,0,0,0,0,0,0,0,3
401086048,Fairfield Stags,J. Cruz,4279488,,False,15.0,1,5,1,5,0,0,0,0,1,0,1,1,2,0,1,3,2
401086048,Fairfield Stags,A. Kavaliauskas,4080375,,False,10.0,0,2,0,1,0,1,0,0,1,1,2,1,0,0,1,3,0
401086048,Fairfield Stags,TEAM,TOTAL,TOTAL,False,,18,52,11,33,7,19,9,10,7,15,22,8,10,1,13,19,52
401086048,Fairfield Stags,M. Milin,3947018,,True,24.0,3,5,2,3,1,2,0,0,2,2,4,1,0,0,2,4,7
401086048,Fairfield Stags,J. Kasibabu,3947016,,True,38.0,1,6,1,5,0,1,6,6,2,4,6,0,2,1,1,3,8
401086048,Fairfield Stags,L. Taliaferro,4398078,,True,32.0,3,12,1,5,2,7,0,0,0,0,0,1,2,0,0,0,8
401086048,Fairfield Stags,N. Alvarez,4398075,,True,39.0,6,13,5,9,1,4,3,4,0,3,3,4,3,0,2,3,16
401086048,Fairfield Stags,T. Benning,4279483,,True,32.0,3,6,1,4,2,2,0,0,0,1,1,0,1,0,4,3,8
401086048,Fairfield Stags,W. Methnani,4279486,,False,4.0,0,2,0,1,0,1,0,0,0,1,1,0,0,0,2,0,0
401086048,Fairfield Stags,C. Whipple,4398077,,False,6.0,1,1,0,0,1,1,0,0,0,0,0,0,0,0,0,0,3
401086048,Fairfield Stags,J. Cruz,4279488,,False,15.0,1,5,1,5,0,0,0,0,1,0,1,1,2,0,1,3,2
401086048,Fairfield Stags,A. Kavaliauskas,4080375,,False,10.0,0,2,0,1,0,1,0,0,1,1,2,1,0,0,1,3,0
401086048,Fairfield Stags,TEAM,TOTAL,TOTAL,False,,18,52,11,33,7,19,9,10,7,15,22,8,10,1,13,19,52
401086047,Siena Saints,S. Seymour,4398391,,True,22.0,3,4,0,0,3,4,0,0,0,1,1,0,0,0,0,1,9
401086047,Siena Saints,E. Fisher,3913235,,True,33.0,8,16,6,13,2,3,0,0,0,4,4,0,0,0,1,1,18
401086047,Siena Saints,K. Degnan,3138282,,True,34.0,4,6,2,3,2,3,0,1,0,5,5,0,3,0,2,1,10
401086047,Siena Saints,J. Pickett,4398390,,True,35.0,5,15,3,9,2,6,1,1,1,4,5,3,1,1,2,2,13
401086047,Siena Saints,M. Camper,4279751,,True,30.0,1,3,1,3,0,0,3,6,4,2,6,5,1,0,2,1,5
401086047,Siena Saints,D. Tchougang,4398394,,False,7.0,1,1,1,1,0,0,0,0,0,0,0,0,0,1,0,0,2
401086047,Siena Saints,T. Huerter Jr.,4067350,,False,13.0,0,1,0,1,0,0,0,0,1,0,1,1,0,0,1,0,0
401086047,Siena Saints,B. Bayer,4065720,,False,5.0,0,0,0,0,0,0,0,0,0,1,1,0,0,0,0,3,0
401086047,Siena Saints,K. Smithen,3133848,,False,21.0,1,2,1,2,0,0,2,2,0,0,0,4,1,1,0,1,4
401086047,Siena Saints,TEAM,TOTAL,TOTAL,False,,23,48,14,32,9,16,6,10,7,19,26,13,6,3,10,10,61
401086047,Siena Saints,S. Seymour,4398391,,True,22.0,3,4,0,0,3,4,0,0,0,1,1,0,0,0,0,1,9
401086047,Siena Saints,E. Fisher,3913235,,True,33.0,8,16,6,13,2,3,0,0,0,4,4,0,0,0,1,1,18
401086047,Siena Saints,K. Degnan,3138282,,True,34.0,4,6,2,3,2,3,0,1,0,5,5,0,3,0,2,1,10
401086047,Siena Saints,J. Pickett,4398390,,True,35.0,5,15,3,9,2,6,1,1,1,4,5,3,1,1,2,2,13
401086047,Siena Saints,M. Camper,4279751,,True,30.0,1,3,1,3,0,0,3,6,4,2,6,5,1,0,2,1,5
401086047,Siena Saints,D. Tchougang,4398394,,False,7.0,1,1,1,1,0,0,0,0,0,0,0,0,0,1,0,0,2
401086047,Siena Saints,T. Huerter Jr.,4067350,,False,13.0,0,1,0,1,0,0,0,0,1,0,1,1,0,0,1,0,0
401086047,Siena Saints,B. Bayer,4065720,,False,5.0,0,0,0,0,0,0,0,0,0,1,1,0,0,0,0,3,0
401086047,Siena Saints,K. Smithen,3133848,,False,21.0,1,2,1,2,0,0,2,2,0,0,0,4,1,1,0,1,4
401086047,Siena Saints,TEAM,TOTAL,TOTAL,False,,23,48,14,32,9,16,6,10,7,19,26,13,6,3,10,10,61
401086047,Fairfield Stags,J. Kasibabu,3947016,,True,22.0,3,5,2,3,1,2,0,0,1,2,3,0,1,0,2,1,7
401086047,Fairfield Stags,L. Taliaferro,4398078,,True,31.0,5,12,1,4,4,8,0,0,0,2,2,0,0,0,2,3,14
401086047,Fairfield Stags,N. Alvarez,4398075,,True,26.0,2,5,2,4,0,1,0,0,1,2,3,2,1,0,5,1,4
401086047,Fairfield Stags,J. Cruz,4279488,,True,31.0,2,9,2,6,0,3,1,1,3,2,5,3,0,0,2,3,5
401086047,Fairfield Stags,T. Benning,4279483,,True,37.0,2,5,1,3,1,2,0,0,2,2,4,3,1,0,1,2,5
401086047,Fairfield Stags,W. Methnani,4279486,,False,27.0,5,10,3,4,2,6,0,0,0,7,7,1,1,1,3,1,12
401086047,Fairfield Stags,C. Whipple,4398077,,False,9.0,1,2,0,1,1,1,0,0,0,1,1,0,0,0,0,1,3
401086047,Fairfield Stags,A. Kavaliauskas,4080375,,False,17.0,0,1,0,0,0,1,0,0,0,3,3,2,1,0,1,0,0
401086047,Fairfield Stags,TEAM,TOTAL,TOTAL,False,,20,49,11,25,9,24,1,1,10,21,31,11,5,1,17,12,50
401086047,Fairfield Stags,J. Kasibabu,3947016,,True,22.0,3,5,2,3,1,2,0,0,1,2,3,0,1,0,2,1,7
401086047,Fairfield Stags,L. Taliaferro,4398078,,True,31.0,5,12,1,4,4,8,0,0,0,2,2,0,0,0,2,3,14
401086047,Fairfield Stags,N. Alvarez,4398075,,True,26.0,2,5,2,4,0,1,0,0,1,2,3,2,1,0,5,1,4
401086047,Fairfield Stags,J. Cruz,4279488,,True,31.0,2,9,2,6,0,3,1,1,3,2,5,3,0,0,2,3,5
401086047,Fairfield Stags,T. Benning,4279483,,True,37.0,2,5,1,3,1,2,0,0,2,2,4,3,1,0,1,2,5
401086047,Fairfield Stags,W. Methnani,4279486,,False,27.0,5,10,3,4,2,6,0,0,0,7,7,1,1,1,3,1,12
401086047,Fairfield Stags,C. Whipple,4398077,,False,9.0,1,2,0,1,1,1,0,0,0,1,1,0,0,0,0,1,3
401086047,Fairfield Stags,A. Kavaliauskas,4080375,,False,17.0,0,1,0,0,0,1,0,0,0,3,3,2,1,0,1,0,0
401086047,Fairfield Stags,TEAM,TOTAL,TOTAL,False,,20,49,11,25,9,24,1,1,10,21,31,11,5,1,17,12,50
401086046,Siena Saints,S. Seymour,4398391,,True,29.0,3,8,0,0,3,8,0,0,0,1,1,0,1,0,0,0,9
401086046,Siena Saints,E. Fisher,3913235,,True,31.0,3,13,2,10,1,3,4,5,2,4,6,2,1,1,5,1,11
401086046,Siena Saints,K. Degnan,3138282,,True,34.0,3,5,2,3,1,2,0,0,0,9,9,1,2,1,0,0,7
401086046,Siena Saints,G. Darwiche,4398393,,True,13.0,0,2,0,0,0,2,0,0,0,1,1,1,0,0,1,1,0
401086046,Siena Saints,J. Pickett,4398390,,True,36.0,8,12,8,10,0,2,4,7,2,2,4,3,4,0,4,2,20
401086046,Siena Saints,D. Tchougang,4398394,,False,6.0,0,2,0,2,0,0,0,0,0,0,0,0,0,0,1,1,0
401086046,Siena Saints,M. Camper,4279751,,False,23.0,2,3,2,3,0,0,2,3,1,6,7,1,0,2,3,4,6
401086046,Siena Saints,B. Bayer,4065720,,False,1.0,0,0,0,0,0,0,0,0,0,0,0,0,0,0,0,1,0
401086046,Siena Saints,K. Smithen,3133848,,False,27.0,1,2,1,2,0,0,2,4,1,2,3,1,0,0,0,3,4
401086046,Siena Saints,TEAM,TOTAL,TOTAL,False,,20,47,15,30,5,17,12,19,6,26,32,9,8,4,15,13,57
401086046,Siena Saints,S. Seymour,4398391,,True,29.0,3,8,0,0,3,8,0,0,0,1,1,0,1,0,0,0,9
401086046,Siena Saints,E. Fisher,3913235,,True,31.0,3,13,2,10,1,3,4,5,2,4,6,2,1,1,5,1,11
401086046,Siena Saints,K. Degnan,3138282,,True,34.0,3,5,2,3,1,2,0,0,0,9,9,1,2,1,0,0,7
401086046,Siena Saints,G. Darwiche,4398393,,True,13.0,0,2,0,0,0,2,0,0,0,1,1,1,0,0,1,1,0
401086046,Siena Saints,J. Pickett,4398390,,True,36.0,8,12,8,10,0,2,4,7,2,2,4,3,4,0,4,2,20
401086046,Siena Saints,D. Tchougang,4398394,,False,6.0,0,2,0,2,0,0,0,0,0,0,0,0,0,0,1,1,0
401086046,Siena Saints,M. Camper,4279751,,False,23.0,2,3,2,3,0,0,2,3,1,6,7,1,0,2,3,4,6
401086046,Siena Saints,B. Bayer,4065720,,False,1.0,0,0,0,0,0,0,0,0,0,0,0,0,0,0,0,1,0
401086046,Siena Saints,K. Smithen,3133848,,False,27.0,1,2,1,2,0,0,2,4,1,2,3,1,0,0,0,3,4
401086046,Siena Saints,TEAM,TOTAL,TOTAL,False,,20,47,15,30,5,17,12,19,6,26,32,9,8,4,15,13,57
401086046,Fairfield Stags,J. Kasibabu,3947016,,True,23.0,3,5,3,4,0,1,0,0,3,4,7,1,2,0,2,5,6
401086046,Fairfield Stags,J. Cruz,4279488,,True,30.0,3,10,3,7,0,3,0,0,2,3,5,2,0,0,3,4,6
401086046,Fairfield Stags,L. Taliaferro,4398078,,True,18.0,0,4,0,1,0,3,2,2,0,0,0,0,1,0,1,1,2
401086046,Fairfield Stags,F. Lemetti,4398076,,True,7.0,0,3,0,0,0,3,0,0,0,0,0,0,0,0,0,0,0
401086046,Fairfield Stags,N. Alvarez,4398075,,True,30.0,4,12,4,10,0,2,2,4,2,5,7,2,2,0,3,2,10
401086046,Fairfield Stags,O. El-Sheikh,4279489,,False,5.0,0,0,0,0,0,0,0,0,0,1,1,0,1,0,1,0,0
401086046,Fairfield Stags,W. Methnani,4279486,,False,36.0,6,10,3,5,3,5,0,1,1,4,5,0,2,2,3,1,15
401086046,Fairfield Stags,M. Milin,3947018,,False,7.0,1,2,1,1,0,1,0,0,1,4,5,0,0,0,1,1,2
401086046,Fairfield Stags,C. Whipple,4398077,,False,24.0,2,6,1,2,1,4,0,0,1,2,3,1,2,0,1,1,5
401086046,Fairfield Stags,T. Benning,4279483,,False,11.0,0,2,0,1,0,1,0,0,0,0,0,0,1,1,2,2,0
401086046,Fairfield Stags,A. Kavaliauskas,4080375,,False,9.0,1,2,1,2,0,0,0,0,0,0,0,2,0,0,1,0,2
401086046,Fairfield Stags,TEAM,TOTAL,TOTAL,False,,20,56,16,33,4,23,4,7,11,24,35,8,11,3,18,17,48
401086046,Fairfield Stags,J. Kasibabu,3947016,,True,23.0,3,5,3,4,0,1,0,0,3,4,7,1,2,0,2,5,6
401086046,Fairfield Stags,J. Cruz,4279488,,True,30.0,3,10,3,7,0,3,0,0,2,3,5,2,0,0,3,4,6
401086046,Fairfield Stags,L. Taliaferro,4398078,,True,18.0,0,4,0,1,0,3,2,2,0,0,0,0,1,0,1,1,2
401086046,Fairfield Stags,F. Lemetti,4398076,,True,7.0,0,3,0,0,0,3,0,0,0,0,0,0,0,0,0,0,0
401086046,Fairfield Stags,N. Alvarez,4398075,,True,30.0,4,12,4,10,0,2,2,4,2,5,7,2,2,0,3,2,10
401086046,Fairfield Stags,O. El-Sheikh,4279489,,False,5.0,0,0,0,0,0,0,0,0,0,1,1,0,1,0,1,0,0
401086046,Fairfield Stags,W. Methnani,4279486,,False,36.0,6,10,3,5,3,5,0,1,1,4,5,0,2,2,3,1,15
401086046,Fairfield Stags,M. Milin,3947018,,False,7.0,1,2,1,1,0,1,0,0,1,4,5,0,0,0,1,1,2
401086046,Fairfield Stags,C. Whipple,4398077,,False,24.0,2,6,1,2,1,4,0,0,1,2,3,1,2,0,1,1,5
401086046,Fairfield Stags,T. Benning,4279483,,False,11.0,0,2,0,1,0,1,0,0,0,0,0,0,1,1,2,2,0
401086046,Fairfield Stags,A. Kavaliauskas,4080375,,False,9.0,1,2,1,2,0,0,0,0,0,0,0,2,0,0,1,0,2
401086046,Fairfield Stags,TEAM,TOTAL,TOTAL,False,,20,56,16,33,4,23,4,7,11,24,35,8,11,3,18,17,48
401086045,Saint Peter's Peacocks,S. Idowu,3922042,,True,25.0,3,5,3,4,0,1,0,1,3,4,7,0,0,1,3,3,6
401086045,Saint Peter's Peacocks,Q. Taylor,4067357,,True,37.0,2,9,2,7,0,2,5,7,2,2,4,3,3,0,0,3,9
401086045,Saint Peter's Peacocks,D. Watson,4398384,,True,37.0,3,9,1,4,2,5,0,0,1,1,2,4,1,0,2,1,8
401086045,Saint Peter's Peacocks,M. Dixon,4279758,,True,29.0,3,10,0,4,3,6,1,2,2,2,4,0,3,0,2,2,10
401086045,Saint Peter's Peacocks,D. Turner,4067356,,True,37.0,7,13,3,5,4,8,2,3,2,4,6,4,0,0,4,3,20
401086045,Saint Peter's Peacocks,D. Woods,3919424,,False,12.0,2,3,2,3,0,0,0,0,1,3,4,0,1,1,3,2,4
401086045,Saint Peter's Peacocks,M. Majak,4398387,,False,3.0,0,0,0,0,0,0,0,0,0,0,0,1,0,0,1,0,0
401086045,Saint Peter's Peacocks,C. Underwood,4398388,,False,2.0,0,0,0,0,0,0,0,0,0,0,0,0,0,0,0,0,0
401086045,Saint Peter's Peacocks,K. Brown,4398385,,False,16.0,0,4,0,0,0,4,0,0,0,1,1,1,2,0,0,0,0
401086045,Saint Peter's Peacocks,A. Hicks,4284295,,False,2.0,0,0,0,0,0,0,0,0,0,0,0,0,0,0,0,0,0
401086045,Saint Peter's Peacocks,TEAM,TOTAL,TOTAL,False,,20,53,11,27,9,26,8,13,12,18,30,13,10,2,15,14,57
401086045,Saint Peter's Peacocks,S. Idowu,3922042,,True,25.0,3,5,3,4,0,1,0,1,3,4,7,0,0,1,3,3,6
401086045,Saint Peter's Peacocks,Q. Taylor,4067357,,True,37.0,2,9,2,7,0,2,5,7,2,2,4,3,3,0,0,3,9
401086045,Saint Peter's Peacocks,D. Watson,4398384,,True,37.0,3,9,1,4,2,5,0,0,1,1,2,4,1,0,2,1,8
401086045,Saint Peter's Peacocks,M. Dixon,4279758,,True,29.0,3,10,0,4,3,6,1,2,2,2,4,0,3,0,2,2,10
401086045,Saint Peter's Peacocks,D. Turner,4067356,,True,37.0,7,13,3,5,4,8,2,3,2,4,6,4,0,0,4,3,20
401086045,Saint Peter's Peacocks,D. Woods,3919424,,False,12.0,2,3,2,3,0,0,0,0,1,3,4,0,1,1,3,2,4
401086045,Saint Peter's Peacocks,M. Majak,4398387,,False,3.0,0,0,0,0,0,0,0,0,0,0,0,1,0,0,1,0,0
401086045,Saint Peter's Peacocks,C. Underwood,4398388,,False,2.0,0,0,0,0,0,0,0,0,0,0,0,0,0,0,0,0,0
401086045,Saint Peter's Peacocks,K. Brown,4398385,,False,16.0,0,4,0,0,0,4,0,0,0,1,1,1,2,0,0,0,0
401086045,Saint Peter's Peacocks,A. Hicks,4284295,,False,2.0,0,0,0,0,0,0,0,0,0,0,0,0,0,0,0,0,0
401086045,Saint Peter's Peacocks,TEAM,TOTAL,TOTAL,False,,20,53,11,27,9,26,8,13,12,18,30,13,10,2,15,14,57
401086045,Fairfield Stags,J. Kasibabu,3947016,,True,31.0,7,12,7,12,0,0,3,4,5,4,9,4,0,1,1,4,17
401086045,Fairfield Stags,J. Cruz,4279488,,True,25.0,5,9,5,8,0,1,0,0,0,5,5,1,1,0,2,2,10
401086045,Fairfield Stags,L. Taliaferro,4398078,,True,20.0,3,4,2,2,1,2,0,0,0,4,4,1,0,0,1,2,7
401086045,Fairfield Stags,F. Lemetti,4398076,,True,23.0,2,4,1,3,1,1,0,0,0,1,1,0,0,0,1,1,5
401086045,Fairfield Stags,N. Alvarez,4398075,,True,28.0,1,4,1,1,0,3,0,0,1,4,5,2,2,0,4,0,2
401086045,Fairfield Stags,O. El-Sheikh,4279489,,False,4.0,0,0,0,0,0,0,0,2,0,0,0,0,1,1,2,0,0
401086045,Fairfield Stags,W. Methnani,4279486,,False,8.0,1,4,1,3,0,1,0,0,0,2,2,0,1,0,1,0,2
401086045,Fairfield Stags,M. Milin,3947018,,False,13.0,1,3,0,1,1,2,0,0,0,0,0,1,0,0,0,2,3
401086045,Fairfield Stags,C. Whipple,4398077,,False,27.0,3,4,2,2,1,2,0,0,0,2,2,1,1,0,1,1,7
401086045,Fairfield Stags,A. Kavaliauskas,4080375,,False,21.0,2,4,1,3,1,1,2,3,0,1,1,6,1,0,2,3,7
401086045,Fairfield Stags,TEAM,TOTAL,TOTAL,False,,25,48,20,35,5,13,5,9,6,24,30,16,7,2,16,15,60
401086045,Fairfield Stags,J. Kasibabu,3947016,,True,31.0,7,12,7,12,0,0,3,4,5,4,9,4,0,1,1,4,17
401086045,Fairfield Stags,J. Cruz,4279488,,True,25.0,5,9,5,8,0,1,0,0,0,5,5,1,1,0,2,2,10
401086045,Fairfield Stags,L. Taliaferro,4398078,,True,20.0,3,4,2,2,1,2,0,0,0,4,4,1,0,0,1,2,7
401086045,Fairfield Stags,F. Lemetti,4398076,,True,23.0,2,4,1,3,1,1,0,0,0,1,1,0,0,0,1,1,5
401086045,Fairfield Stags,N. Alvarez,4398075,,True,28.0,1,4,1,1,0,3,0,0,1,4,5,2,2,0,4,0,2
401086045,Fairfield Stags,O. El-Sheikh,4279489,,False,4.0,0,0,0,0,0,0,0,2,0,0,0,0,1,1,2,0,0
401086045,Fairfield Stags,W. Methnani,4279486,,False,8.0,1,4,1,3,0,1,0,0,0,2,2,0,1,0,1,0,2
401086045,Fairfield Stags,M. Milin,3947018,,False,13.0,1,3,0,1,1,2,0,0,0,0,0,1,0,0,0,2,3
401086045,Fairfield Stags,C. Whipple,4398077,,False,27.0,3,4,2,2,1,2,0,0,0,2,2,1,1,0,1,1,7
401086045,Fairfield Stags,A. Kavaliauskas,4080375,,False,21.0,2,4,1,3,1,1,2,3,0,1,1,6,1,0,2,3,7
401086045,Fairfield Stags,TEAM,TOTAL,TOTAL,False,,25,48,20,35,5,13,5,9,6,24,30,16,7,2,16,15,60
401086044,New Hampshire Wildcats,J. Martinez,4396579,,True,21.0,2,6,2,4,0,2,0,0,0,4,4,1,0,0,1,1,4
401086044,New Hampshire Wildcats,N. Guadarrama,4396578,,True,22.0,5,7,4,4,1,3,0,1,1,5,6,1,1,0,2,4,11
401086044,New Hampshire Wildcats,M. Maultsby,4396576,,True,11.0,1,2,1,1,0,1,0,0,0,0,0,0,0,0,1,3,2
401086044,New Hampshire Wildcats,E. Jordan,4278237,,True,39.0,2,7,0,4,2,3,3,4,0,3,3,3,0,1,5,4,9
401086044,New Hampshire Wildcats,J. Reed,3132469,,True,38.0,3,9,1,2,2,7,1,2,0,2,2,1,4,1,3,2,9
401086044,New Hampshire Wildcats,L. Rosinski,4066730,,False,2.0,0,0,0,0,0,0,0,0,0,0,0,0,0,0,1,0,0
401086044,New Hampshire Wildcats,C. Lester,4066728,,False,9.0,0,1,0,1,0,0,0,0,0,0,0,0,0,0,0,0,0
401086044,New Hampshire Wildcats,D. Watkins,3922029,,False,26.0,6,8,4,4,2,4,2,2,0,7,7,0,0,0,0,2,16
401086044,New Hampshire Wildcats,M. Carbone,4066743,,False,23.0,1,7,0,1,1,6,3,4,0,2,2,1,0,0,0,5,6
401086044,New Hampshire Wildcats,J. Ogwuche,4066726,,False,9.0,0,1,0,1,0,0,0,0,1,1,2,0,0,0,0,0,0
401086044,New Hampshire Wildcats,TEAM,TOTAL,TOTAL,False,,20,48,12,22,8,26,9,13,3,24,27,7,5,2,13,21,57
401086044,Fairfield Stags,J. Kasibabu,3947016,,True,26.0,1,2,1,2,0,0,3,4,2,7,9,0,1,0,4,2,5
401086044,Fairfield Stags,L. Taliaferro,4398078,,True,19.0,1,2,1,1,0,1,0,0,0,1,1,0,0,0,3,2,2
401086044,Fairfield Stags,F. Lemetti,4398076,,True,25.0,1,6,0,3,1,3,2,3,1,3,4,0,0,0,0,5,5
401086044,Fairfield Stags,N. Alvarez,4398075,,True,30.0,9,17,7,10,2,7,3,3,2,3,5,2,2,0,5,3,23
401086044,Fairfield Stags,J. Cruz,4279488,,True,34.0,3,10,3,8,0,2,4,4,1,5,6,0,0,0,1,4,10
401086044,Fairfield Stags,O. El-Sheikh,4279489,,False,5.0,1,3,0,2,1,1,2,4,1,0,1,0,0,0,0,1,5
401086044,Fairfield Stags,W. Methnani,4279486,,False,14.0,2,4,2,2,0,2,1,1,0,2,2,0,1,1,0,0,5
401086044,Fairfield Stags,C. Whipple,4398077,,False,26.0,0,1,0,0,0,1,2,2,0,4,4,0,0,0,2,2,2
401086044,Fairfield Stags,T. Benning,4279483,,False,2.0,0,1,0,0,0,1,1,2,0,1,1,0,0,0,0,0,1
401086044,Fairfield Stags,A. Kavaliauskas,4080375,,False,16.0,2,3,2,3,0,0,1,2,0,1,1,0,0,0,1,1,5
401086044,Fairfield Stags,T. Nolan,3947015,,False,3.0,0,0,0,0,0,0,0,0,0,0,0,0,0,0,0,0,0
401086044,Fairfield Stags,TEAM,TOTAL,TOTAL,False,,20,49,16,31,4,18,19,25,9,27,36,2,4,1,16,20,63
401086043,Old Dominion Monarchs,A. Carver,3913676,,True,17.0,0,1,0,1,0,0,0,0,0,3,3,0,1,0,1,0,0
401086043,Old Dominion Monarchs,E. Robinson III,3136215,,True,7.0,0,1,0,1,0,0,0,1,1,0,1,0,0,0,2,2,0
401086043,Old Dominion Monarchs,X. Green,4067031,,True,30.0,5,10,3,6,2,4,0,0,1,3,4,1,1,0,1,2,12
401086043,Old Dominion Monarchs,A. Caver,3948144,,True,40.0,3,13,3,9,0,4,6,11,0,6,6,12,0,0,0,1,12
401086043,Old Dominion Monarchs,B.J. Stith,3138202,,True,37.0,10,16,9,14,1,2,7,9,2,12,14,1,0,2,1,0,28
401086043,Old Dominion Monarchs,K. Ezikpe,4397564,,False,12.0,1,1,1,1,0,0,5,5,0,2,2,0,0,0,1,4,7
401086043,Old Dominion Monarchs,D. Dickens,4278576,,False,9.0,0,0,0,0,0,0,0,0,1,0,1,0,0,0,1,2,0
401086043,Old Dominion Monarchs,J. Wade,4397567,,False,24.0,2,7,2,7,0,0,2,2,2,2,4,3,1,0,0,3,6
401086043,Old Dominion Monarchs,M. Godwin,4279093,,False,24.0,5,7,2,2,3,5,1,2,0,1,1,0,0,1,0,1,14
401086043,Old Dominion Monarchs,TEAM,TOTAL,TOTAL,False,,26,56,20,41,6,15,21,30,10,29,39,17,3,3,7,15,79
401086043,Fairfield Stags,J. Kasibabu,3947016,,True,28.0,3,8,3,8,0,0,7,8,5,10,15,2,0,3,1,4,13
401086043,Fairfield Stags,L. Taliaferro,4398078,,True,36.0,6,16,0,1,6,15,0,0,0,2,2,2,0,0,1,1,18
401086043,Fairfield Stags,N. Alvarez,4398075,,True,26.0,2,6,2,3,0,3,0,0,0,1,1,4,1,0,1,0,4
401086043,Fairfield Stags,J. Cruz,4279488,,True,21.0,2,6,2,4,0,2,1,2,3,3,6,1,1,0,0,1,5
401086043,Fairfield Stags,T. Benning,4279483,,True,31.0,2,8,0,1,2,7,0,0,1,1,2,3,1,0,1,5,6
401086043,Fairfield Stags,W. Methnani,4279486,,False,17.0,2,9,2,7,0,2,2,2,0,2,2,1,0,1,1,5,6
401086043,Fairfield Stags,M. Milin,3947018,,False,11.0,1,2,1,2,0,0,3,3,1,3,4,0,1,0,2,1,5
401086043,Fairfield Stags,C. Whipple,4398077,,False,3.0,1,1,0,0,1,1,0,0,0,0,0,0,0,0,0,2,3
401086043,Fairfield Stags,F. Lemetti,4398076,,False,18.0,3,5,0,1,3,4,0,0,0,1,1,2,0,0,1,2,9
401086043,Fairfield Stags,A. Kavaliauskas,4080375,,False,9.0,0,0,0,0,0,0,0,0,0,1,1,0,0,0,1,3,0
401086043,Fairfield Stags,TEAM,TOTAL,TOTAL,False,,22,61,10,27,12,34,13,15,11,27,38,15,4,4,9,24,69
401086042,Oakland Golden Grizzlies,J. Beck,4279495,,True,18.0,3,4,3,4,0,0,1,1,1,3,4,1,1,0,3,5,7
401086042,Oakland Golden Grizzlies,X. Hill-Mais,3913700,,True,31.0,9,12,8,9,1,3,2,3,1,5,6,3,1,0,8,5,21
401086042,Oakland Golden Grizzlies,B. Norris,4397778,,True,40.0,1,2,0,0,1,2,6,8,0,0,0,9,0,0,4,2,9
401086042,Oakland Golden Grizzlies,K. Newman,4066864,,True,36.0,6,9,3,5,3,4,4,4,1,4,5,2,1,0,2,0,19
401086042,Oakland Golden Grizzlies,J. Cumberland,3913701,,True,40.0,4,10,0,2,4,8,5,5,1,1,2,5,1,0,2,1,17
401086042,Oakland Golden Grizzlies,J. Nobles,3148984,,False,19.0,2,5,1,1,1,4,1,1,0,3,3,2,0,1,0,1,6
401086042,Oakland Golden Grizzlies,B. Brechting,3913699,,False,11.0,2,2,2,2,0,0,2,2,1,2,3,0,0,1,0,4,6
401086042,Oakland Golden Grizzlies,S. Scott,4279494,,False,5.0,1,3,1,3,0,0,0,0,1,0,1,0,0,1,0,0,2
401086042,Oakland Golden Grizzlies,TEAM,TOTAL,TOTAL,False,,28,47,18,26,10,21,21,24,6,21,27,22,4,3,20,18,87
401086042,Fairfield Stags,J. Kasibabu,3947016,,True,23.0,6,10,5,8,1,2,4,5,8,4,12,2,2,0,3,5,17
401086042,Fairfield Stags,J. Cruz,4279488,,True,28.0,4,6,4,6,0,0,4,4,1,4,5,2,2,0,1,3,12
401086042,Fairfield Stags,L. Taliaferro,4398078,,True,23.0,1,6,1,2,0,4,0,0,0,1,1,1,1,0,1,1,2
401086042,Fairfield Stags,N. Alvarez,4398075,,True,36.0,8,16,6,12,2,4,3,7,1,3,4,1,3,0,4,3,21
401086042,Fairfield Stags,T. Benning,4279483,,True,30.0,5,11,4,7,1,4,0,0,0,1,1,2,2,0,0,0,11
401086042,Fairfield Stags,W. Methnani,4279486,,False,16.0,2,4,1,2,1,2,0,0,1,1,2,2,2,0,1,5,5
401086042,Fairfield Stags,M. Milin,3947018,,False,13.0,2,3,1,2,1,1,2,2,1,1,2,1,0,0,1,2,7
401086042,Fairfield Stags,F. Lemetti,4398076,,False,21.0,2,5,0,1,2,4,0,0,0,0,0,1,0,0,0,3,6
401086042,Fairfield Stags,A. Kavaliauskas,4080375,,False,10.0,2,3,1,2,1,1,0,0,0,0,0,5,0,0,1,1,5
401086042,Fairfield Stags,TEAM,TOTAL,TOTAL,False,,32,64,23,42,9,22,13,18,12,15,27,17,12,0,12,23,86
401086041,Fairfield Stags,J. Kasibabu,3947016,,True,16.0,1,4,1,3,0,1,5,6,1,2,3,2,1,0,2,3,7
401086041,Fairfield Stags,L. Taliaferro,4398078,,True,37.0,2,8,0,4,2,4,0,0,1,3,4,0,0,0,1,2,6
401086041,Fairfield Stags,N. Alvarez,4398075,,True,31.0,5,15,4,9,1,6,3,4,0,2,2,3,4,0,4,4,14
401086041,Fairfield Stags,J. Cruz,4279488,,True,12.0,2,5,1,3,1,2,2,2,1,1,2,1,0,0,4,0,7
401086041,Fairfield Stags,T. Benning,4279483,,True,37.0,3,6,2,3,1,3,0,0,0,7,7,4,2,0,3,2,7
401086041,Fairfield Stags,W. Methnani,4279486,,False,17.0,4,9,2,6,2,3,2,3,4,6,10,0,0,2,2,5,12
401086041,Fairfield Stags,K. Senghore-Peterson,4279485,,False,3.0,0,0,0,0,0,0,0,0,0,1,1,0,0,0,1,0,0
401086041,Fairfield Stags,M. Milin,3947018,,False,4.0,0,0,0,0,0,0,0,0,0,0,0,0,0,0,0,0,0
401086041,Fairfield Stags,C. Whipple,4398077,,False,23.0,2,4,2,2,0,2,0,0,1,7,8,0,0,0,1,1,4
401086041,Fairfield Stags,F. Lemetti,4398076,,False,18.0,1,6,0,0,1,6,0,0,0,0,0,0,0,0,1,2,3
401086041,Fairfield Stags,A. Kavaliauskas,4080375,,False,2.0,0,0,0,0,0,0,0,0,0,0,0,0,0,0,0,0,0
401086041,Fairfield Stags,T. Nolan,3947015,,False,0.0,0,0,0,0,0,0,0,0,0,0,0,0,0,0,1,1,0
401086041,Fairfield Stags,TEAM,TOTAL,TOTAL,False,,20,57,12,30,8,27,12,15,10,31,41,10,7,2,21,20,60
401086041,Army Black Knights,A. King,4284080,,True,17.0,3,6,2,2,1,4,2,2,0,2,2,0,0,0,5,2,9
401086041,Army Black Knights,M. Wilson,4067091,,True,29.0,8,14,8,14,0,0,3,5,4,5,9,0,0,0,1,3,19
401086041,Army Black Knights,T. Funk,4067089,,True,31.0,1,10,1,6,0,4,4,6,1,3,4,4,0,0,0,2,6
401086041,Army Black Knights,J. Fox,3948826,,True,35.0,2,8,0,3,2,5,2,4,0,3,3,3,2,0,3,0,8
401086041,Army Black Knights,J. Kessler,3155887,,True,15.0,0,0,0,0,0,0,0,0,3,1,4,0,1,1,0,1,0
401086041,Army Black Knights,B. Kinker,4397611,,False,1.0,0,0,0,0,0,0,0,0,0,1,1,0,0,0,0,0,0
401086041,Army Black Knights,A. Duhart,4397609,,False,9.0,0,1,0,1,0,0,2,2,0,0,0,2,2,0,2,1,2
401086041,Army Black Knights,J. Caldwell,4397607,,False,22.0,1,5,1,4,0,1,1,4,0,5,5,3,1,0,2,3,3
401086041,Army Black Knights,T. Blackwell,4284076,,False,7.0,0,1,0,0,0,1,0,0,0,0,0,0,0,0,0,1,0
401086041,Army Black Knights,J. Emezie,3948830,,False,24.0,5,9,2,3,3,6,3,4,1,4,5,0,4,1,0,1,16
401086041,Army Black Knights,C. Edwards,3948821,,False,10.0,0,2,0,2,0,0,0,0,1,0,1,0,0,0,1,3,0
401086041,Army Black Knights,TEAM,TOTAL,TOTAL,False,,20,56,14,35,6,21,17,27,11,28,39,12,10,2,15,17,63
401086040,Wagner Seahawks,A. Sumbry,68109,,True,32.0,6,10,6,10,0,0,3,6,5,9,14,0,0,3,4,4,15
401086040,Wagner Seahawks,T. Nesby IV,4398027,,True,4.0,0,1,0,0,0,1,0,0,0,0,0,0,0,1,1,0,0
401086040,Wagner Seahawks,T. Plummer,4279883,,True,11.0,0,0,0,0,0,0,0,0,0,0,0,0,0,2,1,2,0
401086040,Wagner Seahawks,D. Liggeons,3908813,,True,32.0,3,7,1,3,2,4,3,6,2,2,4,0,0,0,4,2,11
401086040,Wagner Seahawks,R. Saunders,3136086,,True,33.0,4,14,3,7,1,7,7,7,4,8,12,3,0,0,1,2,16
401086040,Wagner Seahawks,C. Anderson,4066750,,False,8.0,3,4,3,4,0,0,0,0,2,3,5,0,0,2,1,0,6
401086040,Wagner Seahawks,J. Coulanges,4398028,,False,27.0,4,5,4,4,0,1,0,0,1,3,4,2,1,0,2,4,8
401086040,Wagner Seahawks,J. Norfleet,4398026,,False,27.0,2,4,2,2,0,2,2,2,0,2,2,2,2,0,1,3,6
401086040,Wagner Seahawks,E. Davis,4067972,,False,26.0,8,17,7,12,1,5,0,1,2,2,4,1,1,0,1,1,17
401086040,Wagner Seahawks,TEAM,TOTAL,TOTAL,False,,30,62,26,42,4,20,15,22,17,30,47,8,4,8,16,18,79
401086040,Fairfield Stags,J. Kasibabu,3947016,,True,30.0,4,8,3,5,1,3,5,6,3,5,8,1,1,0,1,4,14
401086040,Fairfield Stags,L. Taliaferro,4398078,,True,37.0,9,15,3,4,6,11,3,3,1,2,3,1,1,0,1,3,27
401086040,Fairfield Stags,N. Alvarez,4398075,,True,34.0,7,17,7,15,0,2,1,3,0,8,8,7,4,0,2,1,15
401086040,Fairfield Stags,J. Cruz,4279488,,True,21.0,2,7,2,6,0,1,0,0,0,0,0,0,0,0,3,2,4
401086040,Fairfield Stags,T. Benning,4279483,,True,29.0,1,3,0,2,1,1,1,2,0,2,2,1,0,0,2,2,4
401086040,Fairfield Stags,W. Methnani,4279486,,False,14.0,1,2,0,1,1,1,0,0,0,1,1,2,0,1,2,5,3
401086040,Fairfield Stags,K. Senghore-Peterson,4279485,,False,1.0,0,0,0,0,0,0,0,0,0,0,0,0,0,0,0,0,0
401086040,Fairfield Stags,C. Whipple,4398077,,False,9.0,0,1,0,0,0,1,0,0,0,0,0,0,0,0,0,1,0
401086040,Fairfield Stags,F. Lemetti,4398076,,False,25.0,2,6,0,0,2,6,0,0,0,2,2,1,0,0,1,2,6
401086040,Fairfield Stags,TEAM,TOTAL,TOTAL,False,,26,59,15,33,11,26,10,14,6,20,26,13,6,1,12,20,73
401086039,Long Island University Sharks,T. Flowers,4066795,,True,36.0,8,11,2,4,6,7,1,1,2,2,4,1,2,1,3,2,23
401086039,Long Island University Sharks,J. van Sauers,3936114,,True,19.0,0,3,0,1,0,2,1,2,2,1,3,1,0,0,0,5,1
401086039,Long Island University Sharks,J. Batts,4067901,,True,35.0,0,5,0,4,0,1,5,6,0,9,9,4,5,0,2,1,5
401086039,Long Island University Sharks,J. Agosto,4067900,,True,38.0,4,7,3,6,1,1,3,5,1,1,2,9,0,0,3,2,12
401086039,Long Island University Sharks,R. Clark,3948799,,True,30.0,14,22,11,16,3,6,2,3,0,0,0,1,1,2,1,3,33
401086039,Long Island University Sharks,E. Penn,4279628,,False,8.0,0,2,0,2,0,0,0,0,0,0,0,0,0,0,0,1,0
401086039,Long Island University Sharks,G. Cisse,3936113,,False,5.0,1,1,1,1,0,0,0,0,1,0,1,0,0,0,0,0,2
401086039,Long Island University Sharks,O. Ndim,4397967,,False,4.0,0,0,0,0,0,0,0,0,0,1,1,0,0,0,0,0,0
401086039,Long Island University Sharks,R. Frias,3936112,,False,25.0,4,9,1,1,3,8,2,3,0,4,4,1,0,1,0,0,13
401086039,Long Island University Sharks,TEAM,TOTAL,TOTAL,False,,31,60,18,35,13,25,14,20,7,21,28,17,8,4,10,14,89
401086039,Fairfield Stags,W. Methnani,4279486,,True,7.0,0,3,0,2,0,1,0,0,0,0,0,0,0,0,1,0,0
401086039,Fairfield Stags,J. Kasibabu,3947016,,True,29.0,4,8,4,7,0,1,1,3,7,3,10,1,1,2,1,4,9
401086039,Fairfield Stags,L. Taliaferro,4398078,,True,27.0,5,10,0,3,5,7,0,0,0,1,1,1,1,0,0,3,15
401086039,Fairfield Stags,N. Alvarez,4398075,,True,40.0,3,7,3,4,0,3,6,9,0,2,2,4,0,0,3,3,12
401086039,Fairfield Stags,T. Benning,4279483,,True,33.0,5,9,3,7,2,2,0,0,0,5,5,4,0,1,1,3,12
401086039,Fairfield Stags,M. Milin,3947018,,False,23.0,6,8,5,6,1,2,3,3,4,4,8,1,1,0,2,2,16
401086039,Fairfield Stags,F. Lemetti,4398076,,False,13.0,2,6,0,1,2,5,0,1,0,2,2,1,1,0,0,1,6
401086039,Fairfield Stags,J. Cruz,4279488,,False,28.0,6,10,6,8,0,2,5,5,1,8,9,7,2,0,4,3,17
401086039,Fairfield Stags,TEAM,TOTAL,TOTAL,False,,31,61,21,38,10,23,15,21,12,25,37,19,6,3,14,19,87
401086038,Fairfield Stags,J. Kasibabu,3947016,,True,14.0,0,1,0,1,0,0,2,2,1,2,3,0,2,2,3,5,2
401086038,Fairfield Stags,W. Methnani,4279486,,True,18.0,2,4,2,3,0,1,0,0,0,1,1,1,0,1,2,5,4
401086038,Fairfield Stags,L. Taliaferro,4398078,,True,40.0,5,15,3,9,2,6,0,2,1,5,6,1,1,0,0,0,12
401086038,Fairfield Stags,N. Alvarez,4398075,,True,31.0,6,12,3,7,3,5,1,2,1,6,7,1,2,0,4,3,16
401086038,Fairfield Stags,T. Benning,4279483,,True,37.0,1,4,1,3,0,1,7,7,0,2,2,0,0,0,1,2,9
401086038,Fairfield Stags,K. Senghore-Peterson,4279485,,False,6.0,0,1,0,1,0,0,0,0,0,0,0,0,0,0,0,4,0
401086038,Fairfield Stags,M. Milin,3947018,,False,16.0,1,2,1,2,0,0,0,0,1,1,2,0,0,0,0,0,2
401086038,Fairfield Stags,F. Lemetti,4398076,,False,5.0,1,2,1,1,0,1,0,0,0,0,0,0,0,0,0,0,2
401086038,Fairfield Stags,J. Cruz,4279488,,False,26.0,3,7,3,6,0,1,4,4,2,2,4,0,0,0,0,3,10
401086038,Fairfield Stags,A. Kavaliauskas,4080375,,False,7.0,1,1,0,0,1,1,0,0,0,0,0,1,0,0,2,1,3
401086038,Fairfield Stags,TEAM,TOTAL,TOTAL,False,,20,49,14,33,6,16,14,17,7,20,27,4,5,3,13,23,60
401086038,Bucknell Bison,B. Moore,4067103,,True,23.0,1,6,1,4,0,2,2,2,1,2,3,1,0,1,2,4,4
401086038,Bucknell Bison,P. Newman,4280043,,True,35.0,4,11,4,11,0,0,4,6,4,3,7,0,1,4,2,2,12
401086038,Bucknell Bison,J. Sotos,4280044,,True,29.0,2,4,2,3,0,1,2,2,1,3,4,4,0,2,5,2,6
401086038,Bucknell Bison,A. Toomer,4067102,,True,28.0,4,9,2,3,2,6,0,4,6,2,8,2,1,1,0,3,10
401086038,Bucknell Bison,K. Mackenzie,3914278,,True,37.0,5,17,3,11,2,6,3,4,3,3,6,5,0,0,3,3,15
401086038,Bucknell Bison,K. Spear,4397651,,False,2.0,0,1,0,0,0,1,0,0,0,1,1,0,0,1,0,0,0
401086038,Bucknell Bison,W. Ellis,4397649,,False,12.0,1,2,0,0,1,2,0,0,0,1,1,1,0,0,0,2,3
401086038,Bucknell Bison,A. Funk,4397650,,False,12.0,0,1,0,0,0,1,0,0,0,2,2,1,0,0,0,2,0
401086038,Bucknell Bison,B. Robertson,4067104,,False,20.0,3,6,3,5,0,1,2,4,1,6,7,0,1,0,2,2,8
401086038,Bucknell Bison,M. O'Reilly,3914281,,False,2.0,0,1,0,0,0,1,0,0,0,0,0,0,0,0,0,0,0
401086038,Bucknell Bison,TEAM,TOTAL,TOTAL,False,,20,58,15,37,5,21,13,22,17,24,41,14,3,9,14,20,58
401086037,Saint Peter's Peacocks,KC Ndefo,4398386,,True,33.0,4,9,4,8,0,1,1,2,0,4,4,1,2,2,2,3,9
401086037,Saint Peter's Peacocks,S. Idowu,3922042,,True,19.0,2,6,2,6,0,0,2,2,0,5,5,0,0,0,0,0,6
401086037,Saint Peter's Peacocks,Q. Taylor,4067357,,True,24.0,6,7,6,6,0,1,0,0,2,3,5,1,0,1,3,5,12
401086037,Saint Peter's Peacocks,D. Watson,4398384,,True,39.0,2,8,2,6,0,2,4,4,0,1,1,5,2,0,6,2,8
401086037,Saint Peter's Peacocks,D. Turner,4067356,,True,34.0,4,11,4,7,0,4,7,8,1,1,2,0,2,0,2,2,15
401086037,Saint Peter's Peacocks,D. Woods,3919424,,False,6.0,1,1,1,1,0,0,0,0,1,1,2,0,0,0,1,3,2
401086037,Saint Peter's Peacocks,M. Majak,4398387,,False,14.0,1,1,1,1,0,0,1,2,0,5,5,0,0,3,0,5,3
401086037,Saint Peter's Peacocks,C. Underwood,4398388,,False,1.0,0,0,0,0,0,0,0,0,0,0,0,0,0,0,0,0,0
401086037,Saint Peter's Peacocks,A. Hicks,4284295,,False,1.0,0,1,0,1,0,0,0,0,0,0,0,0,0,0,0,2,0
401086037,Saint Peter's Peacocks,M. Dixon,4279758,,False,29.0,3,7,2,4,1,3,3,4,2,1,3,0,0,0,0,3,10
401086037,Saint Peter's Peacocks,TEAM,TOTAL,TOTAL,False,,23,51,22,40,1,11,18,22,9,24,33,7,6,6,15,25,65
401086037,Saint Peter's Peacocks,KC Ndefo,4398386,,True,33.0,4,9,4,8,0,1,1,2,0,4,4,1,2,2,2,3,9
401086037,Saint Peter's Peacocks,S. Idowu,3922042,,True,19.0,2,6,2,6,0,0,2,2,0,5,5,0,0,0,0,0,6
401086037,Saint Peter's Peacocks,Q. Taylor,4067357,,True,24.0,6,7,6,6,0,1,0,0,2,3,5,1,0,1,3,5,12
401086037,Saint Peter's Peacocks,D. Watson,4398384,,True,39.0,2,8,2,6,0,2,4,4,0,1,1,5,2,0,6,2,8
401086037,Saint Peter's Peacocks,D. Turner,4067356,,True,34.0,4,11,4,7,0,4,7,8,1,1,2,0,2,0,2,2,15
401086037,Saint Peter's Peacocks,D. Woods,3919424,,False,6.0,1,1,1,1,0,0,0,0,1,1,2,0,0,0,1,3,2
401086037,Saint Peter's Peacocks,M. Majak,4398387,,False,14.0,1,1,1,1,0,0,1,2,0,5,5,0,0,3,0,5,3
401086037,Saint Peter's Peacocks,C. Underwood,4398388,,False,1.0,0,0,0,0,0,0,0,0,0,0,0,0,0,0,0,0,0
401086037,Saint Peter's Peacocks,A. Hicks,4284295,,False,1.0,0,1,0,1,0,0,0,0,0,0,0,0,0,0,0,2,0
401086037,Saint Peter's Peacocks,M. Dixon,4279758,,False,29.0,3,7,2,4,1,3,3,4,2,1,3,0,0,0,0,3,10
401086037,Saint Peter's Peacocks,TEAM,TOTAL,TOTAL,False,,23,51,22,40,1,11,18,22,9,24,33,7,6,6,15,25,65
401086037,Rider Broncs,F. Scott,3922033,,True,27.0,1,3,0,1,1,2,9,12,1,0,1,1,0,1,1,2,12
401086037,Rider Broncs,T. Marshall,4067348,,True,37.0,11,19,11,19,0,0,3,5,7,7,14,3,0,2,1,2,25
401086037,Rider Broncs,S. Jordan,4067349,,True,37.0,3,11,0,5,3,6,3,4,1,4,5,2,1,3,2,5,12
401086037,Rider Broncs,K. Williams,3946983,,True,23.0,0,2,0,2,0,0,0,3,0,0,0,2,1,0,0,4,0
401086037,Rider Broncs,A. Durham,3138490,,True,31.0,4,9,2,4,2,5,4,4,0,1,1,2,2,0,2,2,14
401086037,Rider Broncs,A. Ogemuno-Johnson,4406151,,False,2.0,0,1,0,1,0,0,0,0,1,0,1,0,0,0,0,0,0
401086037,Rider Broncs,K. Cisse,4279746,,False,1.0,0,0,0,0,0,0,0,0,0,0,0,0,0,1,0,0,0
401086037,Rider Broncs,D. Eke,3941312,,False,2.0,0,0,0,0,0,0,0,0,0,0,0,0,0,0,1,1,0
401086037,Rider Broncs,D. Vaughn,4067347,,False,20.0,1,4,1,3,0,1,0,2,1,4,5,1,1,1,2,1,2
401086037,Rider Broncs,J. Allen,4067345,,False,5.0,0,0,0,0,0,0,0,0,0,0,0,0,0,0,0,1,0
401086037,Rider Broncs,A. Gilbert,3911886,,False,15.0,2,5,0,1,2,4,0,0,0,1,1,1,1,0,1,5,6
401086037,Rider Broncs,TEAM,TOTAL,TOTAL,False,,22,54,14,36,8,18,19,30,12,20,32,12,6,8,10,23,71
401086037,Rider Broncs,F. Scott,3922033,,True,27.0,1,3,0,1,1,2,9,12,1,0,1,1,0,1,1,2,12
401086037,Rider Broncs,T. Marshall,4067348,,True,37.0,11,19,11,19,0,0,3,5,7,7,14,3,0,2,1,2,25
401086037,Rider Broncs,S. Jordan,4067349,,True,37.0,3,11,0,5,3,6,3,4,1,4,5,2,1,3,2,5,12
401086037,Rider Broncs,K. Williams,3946983,,True,23.0,0,2,0,2,0,0,0,3,0,0,0,2,1,0,0,4,0
401086037,Rider Broncs,A. Durham,3138490,,True,31.0,4,9,2,4,2,5,4,4,0,1,1,2,2,0,2,2,14
401086037,Rider Broncs,A. Ogemuno-Johnson,4406151,,False,2.0,0,1,0,1,0,0,0,0,1,0,1,0,0,0,0,0,0
401086037,Rider Broncs,K. Cisse,4279746,,False,1.0,0,0,0,0,0,0,0,0,0,0,0,0,0,1,0,0,0
401086037,Rider Broncs,D. Eke,3941312,,False,2.0,0,0,0,0,0,0,0,0,0,0,0,0,0,0,1,1,0
401086037,Rider Broncs,D. Vaughn,4067347,,False,20.0,1,4,1,3,0,1,0,2,1,4,5,1,1,1,2,1,2
401086037,Rider Broncs,J. Allen,4067345,,False,5.0,0,0,0,0,0,0,0,0,0,0,0,0,0,0,0,1,0
401086037,Rider Broncs,A. Gilbert,3911886,,False,15.0,2,5,0,1,2,4,0,0,0,1,1,1,1,0,1,5,6
401086037,Rider Broncs,TEAM,TOTAL,TOTAL,False,,22,54,14,36,8,18,19,30,12,20,32,12,6,8,10,23,71
401086036,Siena Saints,S. Seymour,4398391,,True,28.0,2,6,0,1,2,5,0,0,0,0,0,0,0,0,1,2,6
401086036,Siena Saints,E. Fisher,3913235,,True,37.0,8,19,7,15,1,4,4,6,1,7,8,1,0,2,2,2,21
401086036,Siena Saints,K. Degnan,3138282,,True,35.0,1,5,1,3,0,2,0,0,1,5,6,1,3,0,0,2,2
401086036,Siena Saints,J. Pickett,4398390,,True,38.0,3,7,1,3,2,4,0,0,1,3,4,6,2,1,1,3,8
401086036,Siena Saints,M. Camper,4279751,,True,21.0,1,3,1,1,0,2,4,10,2,7,9,1,1,0,1,4,6
401086036,Siena Saints,D. Tchougang,4398394,,False,2.0,0,1,0,1,0,0,0,0,0,0,0,0,0,0,1,2,0
401086036,Siena Saints,T. Huerter Jr.,4067350,,False,6.0,0,0,0,0,0,0,0,0,0,0,0,0,0,0,1,0,0
401086036,Siena Saints,G. Darwiche,4398393,,False,0.0,0,0,0,0,0,0,0,0,0,0,0,0,0,0,0,0,0
401086036,Siena Saints,B. Bayer,4065720,,False,0.0,0,0,0,0,0,0,0,0,0,0,0,0,0,0,0,0,0
401086036,Siena Saints,K. Smithen,3133848,,False,33.0,3,9,2,6,1,3,9,10,0,6,6,1,4,0,3,3,16
401086036,Siena Saints,TEAM,TOTAL,TOTAL,False,,18,50,12,30,6,20,17,26,7,29,36,10,10,3,11,18,59
401086036,Siena Saints,S. Seymour,4398391,,True,28.0,2,6,0,1,2,5,0,0,0,0,0,0,0,0,1,2,6
401086036,Siena Saints,E. Fisher,3913235,,True,37.0,8,19,7,15,1,4,4,6,1,7,8,1,0,2,2,2,21
401086036,Siena Saints,K. Degnan,3138282,,True,35.0,1,5,1,3,0,2,0,0,1,5,6,1,3,0,0,2,2
401086036,Siena Saints,J. Pickett,4398390,,True,38.0,3,7,1,3,2,4,0,0,1,3,4,6,2,1,1,3,8
401086036,Siena Saints,M. Camper,4279751,,True,21.0,1,3,1,1,0,2,4,10,2,7,9,1,1,0,1,4,6
401086036,Siena Saints,D. Tchougang,4398394,,False,2.0,0,1,0,1,0,0,0,0,0,0,0,0,0,0,1,2,0
401086036,Siena Saints,T. Huerter Jr.,4067350,,False,6.0,0,0,0,0,0,0,0,0,0,0,0,0,0,0,1,0,0
401086036,Siena Saints,G. Darwiche,4398393,,False,0.0,0,0,0,0,0,0,0,0,0,0,0,0,0,0,0,0,0
401086036,Siena Saints,B. Bayer,4065720,,False,0.0,0,0,0,0,0,0,0,0,0,0,0,0,0,0,0,0,0
401086036,Siena Saints,K. Smithen,3133848,,False,33.0,3,9,2,6,1,3,9,10,0,6,6,1,4,0,3,3,16
401086036,Siena Saints,TEAM,TOTAL,TOTAL,False,,18,50,12,30,6,20,17,26,7,29,36,10,10,3,11,18,59
401086036,Rider Broncs,D. Vaughn,4067347,,True,27.0,3,8,3,7,0,1,0,0,1,5,6,1,0,1,1,3,6
401086036,Rider Broncs,F. Scott,3922033,,True,34.0,2,5,2,4,0,1,5,7,1,9,10,0,0,0,1,2,9
401086036,Rider Broncs,T. Marshall,4067348,,True,36.0,8,14,8,14,0,0,3,6,2,3,5,0,0,1,0,4,19
401086036,Rider Broncs,S. Jordan,4067349,,True,32.0,2,11,2,8,0,3,4,4,3,1,4,3,1,1,7,3,8
401086036,Rider Broncs,A. Durham,3138490,,True,24.0,1,5,1,2,0,3,0,0,2,3,5,2,0,0,1,4,2
401086036,Rider Broncs,A. Ogemuno-Johnson,4406151,,False,1.0,0,0,0,0,0,0,0,0,0,0,0,0,0,0,0,2,0
401086036,Rider Broncs,D. Eke,3941312,,False,8.0,1,2,1,2,0,0,0,2,1,4,5,1,0,0,0,1,2
401086036,Rider Broncs,J. Allen,4067345,,False,21.0,1,8,0,2,1,6,2,3,0,2,2,0,0,0,2,2,5
401086036,Rider Broncs,A. Gilbert,3911886,,False,17.0,2,6,2,4,0,2,2,2,2,1,3,0,3,0,1,0,6
401086036,Rider Broncs,TEAM,TOTAL,TOTAL,False,,20,59,19,43,1,16,16,24,15,29,44,7,4,3,13,21,57
401086036,Rider Broncs,D. Vaughn,4067347,,True,27.0,3,8,3,7,0,1,0,0,1,5,6,1,0,1,1,3,6
401086036,Rider Broncs,F. Scott,3922033,,True,34.0,2,5,2,4,0,1,5,7,1,9,10,0,0,0,1,2,9
401086036,Rider Broncs,T. Marshall,4067348,,True,36.0,8,14,8,14,0,0,3,6,2,3,5,0,0,1,0,4,19
401086036,Rider Broncs,S. Jordan,4067349,,True,32.0,2,11,2,8,0,3,4,4,3,1,4,3,1,1,7,3,8
401086036,Rider Broncs,A. Durham,3138490,,True,24.0,1,5,1,2,0,3,0,0,2,3,5,2,0,0,1,4,2
401086036,Rider Broncs,A. Ogemuno-Johnson,4406151,,False,1.0,0,0,0,0,0,0,0,0,0,0,0,0,0,0,0,2,0
401086036,Rider Broncs,D. Eke,3941312,,False,8.0,1,2,1,2,0,0,0,2,1,4,5,1,0,0,0,1,2
401086036,Rider Broncs,J. Allen,4067345,,False,21.0,1,8,0,2,1,6,2,3,0,2,2,0,0,0,2,2,5
401086036,Rider Broncs,A. Gilbert,3911886,,False,17.0,2,6,2,4,0,2,2,2,2,1,3,0,3,0,1,0,6
401086036,Rider Broncs,TEAM,TOTAL,TOTAL,False,,20,59,19,43,1,16,16,24,15,29,44,7,4,3,13,21,57
401086035,Saint Peter's Peacocks,KC Ndefo,4398386,,True,28.0,4,8,4,8,0,0,0,1,3,4,7,1,1,0,2,4,8
401086035,Saint Peter's Peacocks,S. Idowu,3922042,,True,28.0,4,7,4,7,0,0,2,3,0,6,6,0,0,6,1,2,10
401086035,Saint Peter's Peacocks,K. Brown,4398385,,True,13.0,0,1,0,0,0,1,0,0,0,3,3,0,2,1,4,3,0
401086035,Saint Peter's Peacocks,Q. Taylor,4067357,,True,29.0,1,3,0,1,1,2,0,0,0,3,3,1,1,0,3,5,3
401086035,Saint Peter's Peacocks,D. Turner,4067356,,True,34.0,4,13,2,5,2,8,2,5,0,5,5,2,3,0,6,2,12
401086035,Saint Peter's Peacocks,D. Woods,3919424,,False,12.0,2,7,2,6,0,1,1,2,1,0,1,0,0,1,1,2,5
401086035,Saint Peter's Peacocks,D. Watson,4398384,,False,27.0,2,9,2,6,0,3,0,0,0,2,2,2,0,0,4,1,4
401086035,Saint Peter's Peacocks,M. Dixon,4279758,,False,29.0,3,4,2,2,1,2,2,2,1,2,3,3,1,0,1,4,9
401086035,Saint Peter's Peacocks,TEAM,TOTAL,TOTAL,False,,20,52,16,35,4,17,7,13,10,26,36,9,8,8,25,23,51
401086035,Saint Peter's Peacocks,KC Ndefo,4398386,,True,28.0,4,8,4,8,0,0,0,1,3,4,7,1,1,0,2,4,8
401086035,Saint Peter's Peacocks,S. Idowu,3922042,,True,28.0,4,7,4,7,0,0,2,3,0,6,6,0,0,6,1,2,10
401086035,Saint Peter's Peacocks,K. Brown,4398385,,True,13.0,0,1,0,0,0,1,0,0,0,3,3,0,2,1,4,3,0
401086035,Saint Peter's Peacocks,Q. Taylor,4067357,,True,29.0,1,3,0,1,1,2,0,0,0,3,3,1,1,0,3,5,3
401086035,Saint Peter's Peacocks,D. Turner,4067356,,True,34.0,4,13,2,5,2,8,2,5,0,5,5,2,3,0,6,2,12
401086035,Saint Peter's Peacocks,D. Woods,3919424,,False,12.0,2,7,2,6,0,1,1,2,1,0,1,0,0,1,1,2,5
401086035,Saint Peter's Peacocks,D. Watson,4398384,,False,27.0,2,9,2,6,0,3,0,0,0,2,2,2,0,0,4,1,4
401086035,Saint Peter's Peacocks,M. Dixon,4279758,,False,29.0,3,4,2,2,1,2,2,2,1,2,3,3,1,0,1,4,9
401086035,Saint Peter's Peacocks,TEAM,TOTAL,TOTAL,False,,20,52,16,35,4,17,7,13,10,26,36,9,8,8,25,23,51
401086035,Rider Broncs,D. Vaughn,4067347,,True,22.0,0,4,0,2,0,2,2,2,0,3,3,0,0,1,2,3,2
401086035,Rider Broncs,F. Scott,3922033,,True,25.0,2,9,2,8,0,1,4,6,4,2,6,1,1,0,1,0,8
401086035,Rider Broncs,T. Marshall,4067348,,True,26.0,7,12,7,12,0,0,0,0,4,5,9,1,0,2,1,2,14
401086035,Rider Broncs,S. Jordan,4067349,,True,35.0,5,14,5,11,0,3,0,1,2,1,3,4,2,0,4,3,10
401086035,Rider Broncs,A. Durham,3138490,,True,28.0,2,5,2,4,0,1,8,8,2,2,4,0,1,0,1,3,12
401086035,Rider Broncs,A. Ogemuno-Johnson,4406151,,False,3.0,0,0,0,0,0,0,0,0,0,1,1,0,0,0,0,0,0
401086035,Rider Broncs,K. Cisse,4279746,,False,3.0,0,1,0,1,0,0,0,0,0,0,0,0,0,0,1,0,0
401086035,Rider Broncs,D. Eke,3941312,,False,21.0,5,5,5,5,0,0,2,6,2,3,5,1,5,2,2,1,12
401086035,Rider Broncs,J. Allen,4067345,,False,23.0,0,9,0,2,0,7,1,2,0,5,5,1,0,1,0,1,1
401086035,Rider Broncs,K. Williams,3946983,,False,14.0,0,2,0,2,0,0,0,0,1,1,2,2,1,0,2,1,0
401086035,Rider Broncs,TEAM,TOTAL,TOTAL,False,,21,61,21,47,0,14,17,25,17,24,41,10,10,6,15,15,59
401086035,Rider Broncs,D. Vaughn,4067347,,True,22.0,0,4,0,2,0,2,2,2,0,3,3,0,0,1,2,3,2
401086035,Rider Broncs,F. Scott,3922033,,True,25.0,2,9,2,8,0,1,4,6,4,2,6,1,1,0,1,0,8
401086035,Rider Broncs,T. Marshall,4067348,,True,26.0,7,12,7,12,0,0,0,0,4,5,9,1,0,2,1,2,14
401086035,Rider Broncs,S. Jordan,4067349,,True,35.0,5,14,5,11,0,3,0,1,2,1,3,4,2,0,4,3,10
401086035,Rider Broncs,A. Durham,3138490,,True,28.0,2,5,2,4,0,1,8,8,2,2,4,0,1,0,1,3,12
401086035,Rider Broncs,A. Ogemuno-Johnson,4406151,,False,3.0,0,0,0,0,0,0,0,0,0,1,1,0,0,0,0,0,0
401086035,Rider Broncs,K. Cisse,4279746,,False,3.0,0,1,0,1,0,0,0,0,0,0,0,0,0,0,1,0,0
401086035,Rider Broncs,D. Eke,3941312,,False,21.0,5,5,5,5,0,0,2,6,2,3,5,1,5,2,2,1,12
401086035,Rider Broncs,J. Allen,4067345,,False,23.0,0,9,0,2,0,7,1,2,0,5,5,1,0,1,0,1,1
401086035,Rider Broncs,K. Williams,3946983,,False,14.0,0,2,0,2,0,0,0,0,1,1,2,2,1,0,2,1,0
401086035,Rider Broncs,TEAM,TOTAL,TOTAL,False,,21,61,21,47,0,14,17,25,17,24,41,10,10,6,15,15,59
401086034,Rider Broncs,F. Scott,3922033,,True,29.0,5,14,4,12,1,2,0,3,4,9,13,1,0,0,1,2,11
401086034,Rider Broncs,T. Marshall,4067348,,True,20.0,5,11,5,11,0,0,2,2,3,5,8,0,3,2,2,1,12
401086034,Rider Broncs,S. Jordan,4067349,,True,37.0,7,11,7,8,0,3,5,6,1,3,4,5,4,1,2,2,19
401086034,Rider Broncs,K. Williams,3946983,,True,38.0,6,11,6,11,0,0,4,9,1,1,2,3,1,0,1,2,16
401086034,Rider Broncs,A. Durham,3138490,,True,34.0,2,5,2,5,0,0,0,0,3,1,4,4,2,0,2,1,4
401086034,Rider Broncs,A. Ogemuno-Johnson,4406151,,False,16.0,5,7,5,7,0,0,2,3,1,3,4,0,1,0,1,2,12
401086034,Rider Broncs,K. Cisse,4279746,,False,0.0,0,0,0,0,0,0,0,0,0,0,0,0,0,0,0,0,0
401086034,Rider Broncs,D. Eke,3941312,,False,11.0,2,6,2,6,0,0,2,2,0,1,1,0,0,0,1,3,6
401086034,Rider Broncs,J. Allen,4067345,,False,13.0,1,2,0,0,1,2,0,0,0,0,0,0,0,0,0,0,3
401086034,Rider Broncs,A. Gilbert,3911886,,False,2.0,0,1,0,1,0,0,0,0,0,0,0,1,0,0,0,0,0
401086034,Rider Broncs,TEAM,TOTAL,TOTAL,False,,33,68,31,61,2,7,15,25,14,23,37,14,11,3,10,13,83
401086034,Rider Broncs,F. Scott,3922033,,True,29.0,5,14,4,12,1,2,0,3,4,9,13,1,0,0,1,2,11
401086034,Rider Broncs,T. Marshall,4067348,,True,20.0,5,11,5,11,0,0,2,2,3,5,8,0,3,2,2,1,12
401086034,Rider Broncs,S. Jordan,4067349,,True,37.0,7,11,7,8,0,3,5,6,1,3,4,5,4,1,2,2,19
401086034,Rider Broncs,K. Williams,3946983,,True,38.0,6,11,6,11,0,0,4,9,1,1,2,3,1,0,1,2,16
401086034,Rider Broncs,A. Durham,3138490,,True,34.0,2,5,2,5,0,0,0,0,3,1,4,4,2,0,2,1,4
401086034,Rider Broncs,A. Ogemuno-Johnson,4406151,,False,16.0,5,7,5,7,0,0,2,3,1,3,4,0,1,0,1,2,12
401086034,Rider Broncs,K. Cisse,4279746,,False,0.0,0,0,0,0,0,0,0,0,0,0,0,0,0,0,0,0,0
401086034,Rider Broncs,D. Eke,3941312,,False,11.0,2,6,2,6,0,0,2,2,0,1,1,0,0,0,1,3,6
401086034,Rider Broncs,J. Allen,4067345,,False,13.0,1,2,0,0,1,2,0,0,0,0,0,0,0,0,0,0,3
401086034,Rider Broncs,A. Gilbert,3911886,,False,2.0,0,1,0,1,0,0,0,0,0,0,0,1,0,0,0,0,0
401086034,Rider Broncs,TEAM,TOTAL,TOTAL,False,,33,68,31,61,2,7,15,25,14,23,37,14,11,3,10,13,83
401086034,Fairfield Stags,J. Kasibabu,3947016,,True,26.0,8,13,8,11,0,2,2,3,1,9,10,2,0,0,2,4,18
401086034,Fairfield Stags,L. Taliaferro,4398078,,True,37.0,10,17,2,3,8,14,1,2,0,3,3,4,1,0,2,1,29
401086034,Fairfield Stags,F. Lemetti,4398076,,True,11.0,0,0,0,0,0,0,0,0,1,1,2,2,0,0,0,2,0
401086034,Fairfield Stags,N. Alvarez,4398075,,True,27.0,2,5,1,2,1,3,0,0,1,1,2,5,0,0,7,0,5
401086034,Fairfield Stags,J. Cruz,4279488,,True,19.0,3,5,3,5,0,0,1,1,0,1,1,1,0,0,0,4,7
401086034,Fairfield Stags,O. El-Sheikh,4279489,,False,17.0,3,6,2,4,1,2,0,2,0,5,5,2,0,1,3,3,7
401086034,Fairfield Stags,W. Methnani,4279486,,False,15.0,3,4,2,2,1,2,0,0,0,5,5,1,0,0,2,3,7
401086034,Fairfield Stags,M. Milin,3947018,,False,3.0,0,0,0,0,0,0,0,0,1,1,2,2,0,0,0,0,0
401086034,Fairfield Stags,C. Whipple,4398077,,False,15.0,0,1,0,0,0,1,0,0,0,0,0,1,0,0,0,1,0
401086034,Fairfield Stags,T. Benning,4279483,,False,8.0,2,3,1,1,1,2,0,0,0,0,0,1,0,0,0,0,5
401086034,Fairfield Stags,A. Kavaliauskas,4080375,,False,22.0,1,2,0,0,1,2,1,2,0,1,1,4,1,0,4,3,4
401086034,Fairfield Stags,TEAM,TOTAL,TOTAL,False,,32,56,19,28,13,28,5,10,5,28,33,25,2,1,20,21,82
401086034,Fairfield Stags,J. Kasibabu,3947016,,True,26.0,8,13,8,11,0,2,2,3,1,9,10,2,0,0,2,4,18
401086034,Fairfield Stags,L. Taliaferro,4398078,,True,37.0,10,17,2,3,8,14,1,2,0,3,3,4,1,0,2,1,29
401086034,Fairfield Stags,F. Lemetti,4398076,,True,11.0,0,0,0,0,0,0,0,0,1,1,2,2,0,0,0,2,0
401086034,Fairfield Stags,N. Alvarez,4398075,,True,27.0,2,5,1,2,1,3,0,0,1,1,2,5,0,0,7,0,5
401086034,Fairfield Stags,J. Cruz,4279488,,True,19.0,3,5,3,5,0,0,1,1,0,1,1,1,0,0,0,4,7
401086034,Fairfield Stags,O. El-Sheikh,4279489,,False,17.0,3,6,2,4,1,2,0,2,0,5,5,2,0,1,3,3,7
401086034,Fairfield Stags,W. Methnani,4279486,,False,15.0,3,4,2,2,1,2,0,0,0,5,5,1,0,0,2,3,7
401086034,Fairfield Stags,M. Milin,3947018,,False,3.0,0,0,0,0,0,0,0,0,1,1,2,2,0,0,0,0,0
401086034,Fairfield Stags,C. Whipple,4398077,,False,15.0,0,1,0,0,0,1,0,0,0,0,0,1,0,0,0,1,0
401086034,Fairfield Stags,T. Benning,4279483,,False,8.0,2,3,1,1,1,2,0,0,0,0,0,1,0,0,0,0,5
401086034,Fairfield Stags,A. Kavaliauskas,4080375,,False,22.0,1,2,0,0,1,2,1,2,0,1,1,4,1,0,4,3,4
401086034,Fairfield Stags,TEAM,TOTAL,TOTAL,False,,32,56,19,28,13,28,5,10,5,28,33,25,2,1,20,21,82
401086033,Rider Broncs,D. Vaughn,4067347,,True,27.0,5,9,2,4,3,5,0,0,1,2,3,1,5,1,2,2,13
401086033,Rider Broncs,T. Marshall,4067348,,True,17.0,2,8,2,7,0,1,1,4,1,3,4,1,1,1,3,1,5
401086033,Rider Broncs,S. Jordan,4067349,,True,17.0,1,4,1,1,0,3,0,0,0,2,2,3,1,1,3,0,2
401086033,Rider Broncs,J. Allen,4067345,,True,33.0,5,10,3,4,2,6,0,0,1,2,3,1,2,0,3,0,12
401086033,Rider Broncs,A. Durham,3138490,,True,34.0,3,3,1,1,2,2,6,7,0,2,2,0,0,1,1,3,14
401086033,Rider Broncs,A. Ogemuno-Johnson,4406151,,False,15.0,2,2,2,2,0,0,0,0,3,0,3,0,0,1,1,1,4
401086033,Rider Broncs,D. Eke,3941312,,False,14.0,1,2,1,2,0,0,1,3,0,0,0,1,2,1,0,3,3
401086033,Rider Broncs,F. Scott,3922033,,False,24.0,6,11,5,7,1,4,4,8,1,7,8,0,2,0,1,1,17
401086033,Rider Broncs,K. Williams,3946983,,False,11.0,0,3,0,3,0,0,0,0,1,0,1,2,0,0,0,2,0
401086033,Rider Broncs,A. Gilbert,3911886,,False,8.0,1,3,1,3,0,0,2,2,0,3,3,1,3,0,0,0,4
401086033,Rider Broncs,TEAM,TOTAL,TOTAL,False,,26,55,18,34,8,21,14,24,9,22,31,10,16,6,14,13,74
401086033,Northern Colorado Bears,K. Edwards,4066929,,True,24.0,1,3,1,3,0,0,1,2,5,5,10,1,0,0,2,4,3
401086033,Northern Colorado Bears,B. Hume,4397311,,True,29.0,5,11,1,2,4,9,1,2,1,3,4,3,1,0,1,4,15
401086033,Northern Colorado Bears,S. Masten,4397310,,True,23.0,3,6,3,4,0,2,0,0,0,2,2,1,0,0,3,1,6
401086033,Northern Colorado Bears,J. Radebaugh,3912836,,True,40.0,3,6,2,2,1,4,2,2,2,8,10,2,0,0,4,2,9
401086033,Northern Colorado Bears,J. Davis,3912832,,True,37.0,9,17,7,13,2,4,1,1,0,3,3,7,2,0,3,4,21
401086033,Northern Colorado Bears,K. Jockuch,4397312,,False,3.0,1,1,1,1,0,0,0,0,1,0,1,0,0,0,0,0,2
401086033,Northern Colorado Bears,C. Bergan,4397309,,False,16.0,1,4,1,4,0,0,0,0,1,4,5,1,2,1,5,1,2
401086033,Northern Colorado Bears,T. Harris,4397307,,False,28.0,3,11,0,2,3,9,0,0,1,1,2,0,0,0,4,1,9
401086033,Northern Colorado Bears,TEAM,TOTAL,TOTAL,False,,26,59,16,31,10,28,5,7,12,27,39,15,5,1,22,17,67
401086032,Rider Broncs,D. Vaughn,4067347,,True,26.0,2,10,2,7,0,3,3,5,1,1,2,1,3,0,2,3,7
401086032,Rider Broncs,T. Marshall,4067348,,True,29.0,10,17,10,17,0,0,1,1,3,5,8,1,1,0,0,3,21
401086032,Rider Broncs,S. Jordan,4067349,,True,36.0,1,8,1,4,0,4,2,2,0,2,2,2,1,0,3,1,4
401086032,Rider Broncs,J. Allen,4067345,,True,22.0,3,6,1,1,2,5,0,0,0,1,1,0,0,0,0,2,8
401086032,Rider Broncs,A. Durham,3138490,,True,35.0,4,6,3,4,1,2,1,1,0,4,4,1,2,0,3,2,10
401086032,Rider Broncs,A. Ogemuno-Johnson,4406151,,False,11.0,1,4,1,3,0,1,4,4,2,1,3,0,0,0,2,0,6
401086032,Rider Broncs,D. Eke,3941312,,False,1.0,0,0,0,0,0,0,0,0,0,0,0,0,0,0,0,0,0
401086032,Rider Broncs,F. Scott,3922033,,False,22.0,0,6,0,5,0,1,0,0,1,5,6,0,0,0,1,2,0
401086032,Rider Broncs,K. Williams,3946983,,False,15.0,1,2,1,1,0,1,0,0,0,0,0,1,3,0,0,0,2
401086032,Rider Broncs,A. Gilbert,3911886,,False,3.0,0,1,0,0,0,1,0,0,0,0,0,0,0,0,0,1,0
401086032,Rider Broncs,TEAM,TOTAL,TOTAL,False,,22,60,19,42,3,18,11,13,9,23,32,6,10,0,11,14,58
401086032,Drake Bulldogs,T. Murphy,4397346,,True,17.0,1,4,0,2,1,2,0,0,0,5,5,2,1,0,2,4,3
401086032,Drake Bulldogs,N. McGlynn,3948774,,True,32.0,7,10,6,8,1,2,2,3,1,10,11,1,0,1,1,1,17
401086032,Drake Bulldogs,D.J. Wilkins,4397350,,True,39.0,5,10,0,3,5,7,2,2,1,2,3,3,1,0,3,2,17
401086032,Drake Bulldogs,B. Ellingson,3136488,,True,24.0,2,8,0,1,2,7,0,0,0,1,1,1,1,0,0,0,6
401086032,Drake Bulldogs,N. Norton,3132482,,True,33.0,6,11,5,6,1,5,0,0,0,1,1,7,1,0,1,1,13
401086032,Drake Bulldogs,A. Pilipovic,4278994,,False,5.0,1,2,0,0,1,2,0,0,0,0,0,1,0,0,0,0,3
401086032,Drake Bulldogs,L. Robbins,4397347,,False,9.0,0,2,0,2,0,0,0,0,1,0,1,0,0,0,3,1,0
401086032,Drake Bulldogs,G. Sturtz,4397348,,False,16.0,3,4,2,3,1,1,2,2,2,4,6,2,0,0,2,0,9
401086032,Drake Bulldogs,A. Murphy,4397345,,False,14.0,2,4,1,2,1,2,3,4,1,2,3,0,0,1,1,3,8
401086032,Drake Bulldogs,N. Thomas,4278995,,False,11.0,0,1,0,0,0,1,0,0,1,1,2,1,0,0,1,2,0
401086032,Drake Bulldogs,TEAM,TOTAL,TOTAL,False,,27,56,14,27,13,29,9,11,7,31,38,18,4,2,14,14,76
401086031,Washington State Cougars,R. Franks,3922235,,True,38.0,7,12,4,6,3,6,8,10,2,10,12,5,0,0,1,1,25
401086031,Washington State Cougars,C. Elleby,4397166,,True,36.0,6,11,5,8,1,3,5,9,1,6,7,1,3,0,2,3,18
401086031,Washington State Cougars,M. Cannon,4397168,,True,32.0,4,5,4,4,0,1,15,16,0,2,2,2,0,2,3,2,23
401086031,Washington State Cougars,J. Robinson,4397165,,True,21.0,1,3,1,3,0,0,0,1,0,2,2,1,0,0,6,2,2
401086031,Washington State Cougars,C. Skaggs,4278548,,True,27.0,2,5,0,0,2,5,6,6,0,5,5,0,1,0,0,1,12
401086031,Washington State Cougars,A. Kunc,4397167,,False,4.0,0,1,0,0,0,1,0,0,0,1,1,0,0,0,0,1,0
401086031,Washington State Cougars,I. Wade,4397164,,False,4.0,1,1,1,1,0,0,0,2,0,2,2,0,0,0,0,1,2
401086031,Washington State Cougars,J. Pollard,4066667,,False,12.0,1,2,1,1,0,1,5,6,0,4,4,3,1,0,0,3,7
401086031,Washington State Cougars,D. Cooper,3907105,,False,6.0,1,2,1,2,0,0,0,0,0,1,1,2,0,0,0,4,2
401086031,Washington State Cougars,A. Ali,4397170,,False,20.0,1,4,0,1,1,3,0,1,1,1,2,1,1,0,6,4,3
401086031,Washington State Cougars,TEAM,TOTAL,TOTAL,False,,24,46,17,26,7,20,39,51,4,35,39,15,6,2,18,22,94
401086031,Rider Broncs,A. Ogemuno-Johnson,4406151,,True,13.0,0,2,0,2,0,0,0,2,1,1,2,0,1,0,0,3,0
401086031,Rider Broncs,D. Vaughn,4067347,,True,19.0,5,9,4,6,1,3,0,0,2,2,4,2,1,0,1,5,11
401086031,Rider Broncs,S. Jordan,4067349,,True,34.0,4,12,2,6,2,6,1,2,2,3,5,2,1,0,4,1,11
401086031,Rider Broncs,K. Williams,3946983,,True,17.0,4,7,4,7,0,0,0,2,0,2,2,1,2,0,2,5,8
401086031,Rider Broncs,A. Durham,3138490,,True,26.0,0,6,0,0,0,6,0,0,1,2,3,0,0,0,0,3,0
401086031,Rider Broncs,D. Eke,3941312,,False,3.0,0,1,0,1,0,0,0,0,0,0,0,0,0,0,1,2,0
401086031,Rider Broncs,F. Scott,3922033,,False,26.0,3,10,1,6,2,4,4,8,2,5,7,4,1,0,2,5,12
401086031,Rider Broncs,T. Marshall,4067348,,False,23.0,4,5,4,5,0,0,4,4,1,6,7,1,1,0,2,2,12
401086031,Rider Broncs,R. O'Leary,4279747,,False,0.0,0,0,0,0,0,0,0,0,0,0,0,0,0,0,0,0,0
401086031,Rider Broncs,J. Allen,4067345,,False,31.0,7,18,0,4,7,14,3,4,0,1,1,0,1,0,2,2,24
401086031,Rider Broncs,A. Gilbert,3911886,,False,8.0,0,2,0,0,0,2,2,2,1,1,2,1,1,0,1,5,2
401086031,Rider Broncs,TEAM,TOTAL,TOTAL,False,,27,72,15,37,12,35,14,24,14,25,39,11,9,0,17,33,80
401086030,Robert Morris Colonials,Y. Mendy,4397993,,True,10.0,0,1,0,1,0,0,0,0,0,3,3,1,0,0,3,4,0
401086030,Robert Morris Colonials,C. Bain,4279641,,True,21.0,4,10,3,5,1,5,0,1,2,4,6,0,0,0,4,1,9
401086030,Robert Morris Colonials,J. Williams,4279635,,True,38.0,2,8,0,0,2,8,0,0,0,4,4,4,2,0,3,2,6
401086030,Robert Morris Colonials,M. McConnell,3938915,,True,15.0,1,2,1,1,0,1,1,3,0,2,2,1,2,1,2,2,3
401086030,Robert Morris Colonials,J. Williams,3907021,,True,38.0,6,14,0,0,6,14,2,2,2,2,4,1,0,1,3,1,20
401086030,Robert Morris Colonials,C. Coalmon,4279643,,False,13.0,0,0,0,0,0,0,1,2,1,2,3,1,0,0,2,2,1
401086030,Robert Morris Colonials,M. Petteway,4279638,,False,20.0,1,4,1,4,0,0,3,6,2,3,5,0,2,1,1,2,5
401086030,Robert Morris Colonials,K. Thomas,4279639,,False,16.0,3,7,3,6,0,1,0,1,0,1,1,1,1,0,4,1,6
401086030,Robert Morris Colonials,C. Wilbon,4397994,,False,11.0,0,1,0,1,0,0,0,1,0,1,1,0,0,1,3,0,0
401086030,Robert Morris Colonials,S. McEwen,4397992,,False,2.0,0,2,0,0,0,2,0,0,0,0,0,0,0,0,0,0,0
401086030,Robert Morris Colonials,D. Treacy,4397989,,False,16.0,0,1,0,1,0,0,0,0,1,2,3,2,1,0,4,2,0
401086030,Robert Morris Colonials,TEAM,TOTAL,TOTAL,False,,17,50,8,19,9,31,7,16,10,25,35,11,8,4,29,17,50
401086030,Rider Broncs,A. Ogemuno-Johnson,4406151,,True,10.0,2,3,2,3,0,0,0,0,0,1,1,0,0,0,2,2,4
401086030,Rider Broncs,D. Vaughn,4067347,,True,21.0,2,5,2,4,0,1,0,0,1,2,3,1,3,0,5,2,4
401086030,Rider Broncs,S. Jordan,4067349,,True,27.0,5,6,3,4,2,2,5,6,1,4,5,6,5,0,4,3,17
401086030,Rider Broncs,K. Williams,3946983,,True,24.0,1,5,1,5,0,0,0,0,0,5,5,4,1,0,1,1,2
401086030,Rider Broncs,A. Durham,3138490,,True,28.0,3,6,2,3,1,3,1,3,1,2,3,1,2,0,1,3,8
401086030,Rider Broncs,K. Cisse,4279746,,False,7.0,0,0,0,0,0,0,2,2,0,1,1,0,0,0,2,2,2
401086030,Rider Broncs,D. Eke,3941312,,False,13.0,2,2,2,2,0,0,1,2,0,3,3,1,3,1,0,0,5
401086030,Rider Broncs,F. Scott,3922033,,False,20.0,4,6,3,3,1,3,0,0,0,3,3,0,1,0,2,1,9
401086030,Rider Broncs,T. Marshall,4067348,,False,14.0,1,5,1,5,0,0,1,3,0,5,5,0,1,1,2,3,3
401086030,Rider Broncs,J. Allen,4067345,,False,27.0,4,12,2,6,2,6,1,2,3,1,4,2,0,0,1,1,11
401086030,Rider Broncs,A. Gilbert,3911886,,False,9.0,2,4,2,2,0,2,0,0,0,1,1,0,0,0,0,1,4
401086030,Rider Broncs,TEAM,TOTAL,TOTAL,False,,26,54,20,37,6,17,11,18,7,29,36,15,16,2,21,19,69
401086029,Rider Broncs,A. Ogemuno-Johnson,4406151,,True,20.0,3,5,3,5,0,0,4,6,4,3,7,1,0,4,3,2,10
401086029,Rider Broncs,D. Vaughn,4067347,,True,35.0,5,13,4,8,1,5,2,2,1,5,6,2,5,0,3,3,13
401086029,Rider Broncs,S. Jordan,4067349,,True,29.0,7,10,4,5,3,5,1,2,1,0,1,3,2,0,0,4,18
401086029,Rider Broncs,K. Williams,3946983,,True,31.0,1,7,1,7,0,0,0,0,0,2,2,2,2,0,2,0,2
401086029,Rider Broncs,A. Durham,3138490,,True,26.0,3,8,2,5,1,3,4,7,3,1,4,3,0,1,2,1,11
401086029,Rider Broncs,K. Cisse,4279746,,False,6.0,0,1,0,1,0,0,1,2,1,1,2,0,1,0,0,2,1
401086029,Rider Broncs,D. Eke,3941312,,False,11.0,3,5,3,5,0,0,0,5,4,1,5,1,0,0,0,1,6
401086029,Rider Broncs,J. Allen,4067345,,False,28.0,7,12,3,3,4,9,2,2,0,5,5,1,0,2,0,0,20
401086029,Rider Broncs,A. Gilbert,3911886,,False,14.0,0,6,0,3,0,3,0,2,2,1,3,3,0,1,1,1,0
401086029,Rider Broncs,TEAM,TOTAL,TOTAL,False,,29,67,20,42,9,25,14,28,16,21,37,16,10,8,11,14,81
401086029,Norfolk State Spartans,A. Long,3947058,,True,24.0,6,7,6,7,0,0,1,1,2,2,4,2,0,1,2,4,13
401086029,Norfolk State Spartans,J. Butler,3156043,,True,23.0,4,9,4,9,0,0,0,0,1,9,10,1,0,3,2,3,8
401086029,Norfolk State Spartans,D. Jamerson Jr.,4279809,,True,30.0,5,10,1,1,4,9,0,0,1,2,3,0,0,1,2,4,14
401086029,Norfolk State Spartans,N. Thomas,3948866,,True,31.0,3,11,1,6,2,5,8,9,1,3,4,5,0,0,4,3,16
401086029,Norfolk State Spartans,S. Whitley,3938909,,True,28.0,1,3,1,3,0,0,1,2,0,6,6,2,3,0,3,5,3
401086029,Norfolk State Spartans,C. Ford,4398209,,False,8.0,1,3,1,3,0,0,0,0,1,1,2,0,0,0,0,1,2
401086029,Norfolk State Spartans,A. Branch,3155936,,False,23.0,2,4,2,3,0,1,4,4,1,1,2,0,0,0,1,1,8
401086029,Norfolk State Spartans,K. Chavis,4398210,,False,12.0,1,3,1,2,0,1,2,3,0,0,0,1,0,0,1,2,4
401086029,Norfolk State Spartans,J. Bryant Jr.,4398206,,False,3.0,0,0,0,0,0,0,0,0,0,0,0,0,0,0,2,0,0
401086029,Norfolk State Spartans,B. Fitzgerald,4398205,,False,2.0,0,0,0,0,0,0,0,0,0,3,3,0,0,0,0,1,0
401086029,Norfolk State Spartans,M. Pitt,4279808,,False,16.0,1,3,0,1,1,2,0,0,0,2,2,3,0,0,3,1,3
401086029,Norfolk State Spartans,TEAM,TOTAL,TOTAL,False,,24,53,17,35,7,18,16,19,10,29,39,14,3,5,23,25,71
401086028,Wagner Seahawks,N. Jackson,4279882,,True,26.0,5,11,1,2,4,9,0,0,0,3,3,1,0,1,2,3,14
401086028,Wagner Seahawks,A. Sumbry,68109,,True,29.0,3,5,3,5,0,0,2,4,2,4,6,0,1,0,2,2,8
401086028,Wagner Seahawks,J. Coulanges,4398028,,True,17.0,3,5,1,2,2,3,0,0,0,1,1,0,1,0,2,4,8
401086028,Wagner Seahawks,J. Norfleet,4398026,,True,23.0,3,7,2,4,1,3,3,3,0,1,1,4,1,0,2,2,10
401086028,Wagner Seahawks,R. Saunders,3136086,,True,34.0,2,10,0,1,2,9,4,5,0,4,4,4,1,0,4,3,10
401086028,Wagner Seahawks,C. Anderson,4066750,,False,6.0,0,0,0,0,0,0,0,0,0,3,3,0,0,1,0,1,0
401086028,Wagner Seahawks,T. Nesby IV,4398027,,False,6.0,0,1,0,0,0,1,0,2,0,1,1,1,1,1,0,0,0
401086028,Wagner Seahawks,T. Graham,4279885,,False,17.0,4,9,2,3,2,6,0,0,1,2,3,0,1,2,0,3,10
401086028,Wagner Seahawks,T. Plummer,4279883,,False,17.0,0,0,0,0,0,0,0,2,0,1,1,3,0,1,4,3,0
401086028,Wagner Seahawks,E. Davis,4067972,,False,18.0,2,4,1,2,1,2,0,0,1,1,2,2,1,0,0,2,5
401086028,Wagner Seahawks,D. Liggeons,3908813,,False,7.0,0,0,0,0,0,0,0,0,0,0,0,1,0,0,3,2,0
401086028,Wagner Seahawks,TEAM,TOTAL,TOTAL,False,,22,52,10,19,12,33,9,16,5,22,27,16,7,6,20,25,65
401086028,Rider Broncs,D. Vaughn,4067347,,True,27.0,6,9,3,5,3,4,4,5,3,4,7,2,3,0,2,0,19
401086028,Rider Broncs,T. Marshall,4067348,,True,19.0,4,11,4,11,0,0,2,2,4,2,6,1,1,1,0,3,10
401086028,Rider Broncs,S. Jordan,4067349,,True,31.0,3,5,3,4,0,1,0,0,0,4,4,10,0,0,1,2,6
401086028,Rider Broncs,J. Allen,4067345,,True,28.0,8,14,2,3,6,11,2,3,0,0,0,2,1,0,0,2,24
401086028,Rider Broncs,A. Durham,3138490,,True,25.0,1,4,1,1,0,3,0,0,0,5,5,1,0,0,1,0,2
401086028,Rider Broncs,A. Ogemuno-Johnson,4406151,,False,9.0,1,1,1,1,0,0,2,2,1,2,3,1,0,0,1,2,4
401086028,Rider Broncs,K. Cisse,4279746,,False,3.0,0,1,0,1,0,0,0,0,0,0,0,0,0,0,2,3,0
401086028,Rider Broncs,D. Eke,3941312,,False,11.0,0,1,0,1,0,0,1,2,0,4,4,1,1,0,1,1,1
401086028,Rider Broncs,F. Scott,3922033,,False,17.0,3,7,3,5,0,2,4,5,0,3,3,2,0,0,2,1,10
401086028,Rider Broncs,R. O'Leary,4279747,,False,2.0,0,1,0,1,0,0,0,3,0,0,0,0,0,0,0,0,0
401086028,Rider Broncs,N. Buono,4279744,,False,2.0,1,1,1,1,0,0,0,0,1,0,1,0,0,0,0,0,2
401086028,Rider Broncs,K. Williams,3946983,,False,18.0,1,1,1,1,0,0,3,7,0,2,2,1,2,0,4,3,5
401086028,Rider Broncs,A. Gilbert,3911886,,False,8.0,2,3,0,0,2,3,0,0,0,3,3,0,0,1,1,1,6
401086028,Rider Broncs,TEAM,TOTAL,TOTAL,False,,30,59,19,35,11,24,18,29,13,30,43,21,8,2,15,18,89
401086027,Rider Broncs,D. Vaughn,4067347,,True,23.0,6,12,5,9,1,3,6,8,1,5,6,0,2,1,0,4,19
401086027,Rider Broncs,T. Marshall,4067348,,True,16.0,1,7,1,7,0,0,0,0,2,2,4,1,0,0,3,3,2
401086027,Rider Broncs,S. Jordan,4067349,,True,26.0,3,6,1,4,2,2,0,0,0,3,3,7,3,0,1,4,8
401086027,Rider Broncs,J. Allen,4067345,,True,28.0,6,12,2,3,4,9,2,3,2,2,4,0,0,1,0,0,18
401086027,Rider Broncs,A. Durham,3138490,,True,25.0,4,8,3,5,1,3,2,5,1,4,5,3,0,0,2,0,11
401086027,Rider Broncs,A. Ogemuno-Johnson,4406151,,False,4.0,0,0,0,0,0,0,1,2,0,1,1,0,0,0,0,1,1
401086027,Rider Broncs,K. Cisse,4279746,,False,13.0,2,3,2,3,0,0,5,7,0,1,1,0,0,0,0,3,9
401086027,Rider Broncs,D. Eke,3941312,,False,12.0,1,3,1,2,0,1,0,0,3,4,7,1,0,1,0,0,2
401086027,Rider Broncs,F. Scott,3922033,,False,16.0,4,9,3,7,1,2,0,0,2,5,7,1,1,0,1,1,9
401086027,Rider Broncs,R. O'Leary,4279747,,False,2.0,0,1,0,0,0,1,0,0,0,0,0,0,0,0,0,1,0
401086027,Rider Broncs,N. Buono,4279744,,False,1.0,0,0,0,0,0,0,0,0,0,0,0,0,0,0,0,0,0
401086027,Rider Broncs,K. Williams,3946983,,False,26.0,2,4,2,4,0,0,2,3,1,2,3,6,2,0,3,2,6
401086027,Rider Broncs,A. Gilbert,3911886,,False,8.0,1,3,1,2,0,1,0,0,0,1,1,0,1,0,1,0,2
401086027,Rider Broncs,TEAM,TOTAL,TOTAL,False,,30,68,21,46,9,22,18,28,14,31,45,19,9,3,12,19,87
401086027,Coppin State Eagles,C. Council,4279768,,True,20.0,1,4,1,1,0,3,2,2,1,5,6,0,0,1,2,2,4
401086027,Coppin State Eagles,C. Andrews-Fulton,4279766,,True,12.0,2,3,1,2,1,1,0,0,2,2,4,0,0,0,3,5,5
401086027,Coppin State Eagles,L. Morgan,4279771,,True,30.0,3,13,0,3,3,10,1,2,2,6,8,2,1,0,1,1,10
401086027,Coppin State Eagles,D. Clayton,4067878,,True,36.0,1,5,1,3,0,2,3,4,0,3,3,7,2,0,1,3,5
401086027,Coppin State Eagles,K. Auslander,3947465,,True,19.0,3,5,1,1,2,4,0,0,0,1,1,0,0,0,3,0,8
401086027,Coppin State Eagles,G. Ring,4398110,,False,4.0,1,1,0,0,1,1,0,0,0,0,0,0,0,0,0,3,3
401086027,Coppin State Eagles,J. Hardwick,4279770,,False,2.0,0,0,0,0,0,0,1,2,0,0,0,0,0,0,1,0,1
401086027,Coppin State Eagles,B. Medley-Bacon,4398113,,False,14.0,1,1,1,1,0,0,0,2,1,3,4,0,0,0,0,4,2
401086027,Coppin State Eagles,J. Steers,4398112,,False,24.0,7,13,6,8,1,5,1,2,2,2,4,0,0,2,1,2,16
401086027,Coppin State Eagles,N. Marshall,4398111,,False,14.0,3,8,3,5,0,3,1,2,0,3,3,1,2,0,1,1,7
401086027,Coppin State Eagles,I. Williams,4398109,,False,19.0,0,4,0,2,0,2,3,4,0,1,1,3,1,0,5,0,3
401086027,Coppin State Eagles,L. Brownlee,3947036,,False,6.0,1,2,0,0,1,2,0,0,0,0,0,0,0,0,0,2,3
401086027,Coppin State Eagles,TEAM,TOTAL,TOTAL,False,,23,59,14,26,9,33,12,20,9,28,37,13,6,3,20,23,67
401086026,Rider Broncs,F. Scott,3922033,,True,31.0,7,13,4,7,3,6,4,5,1,5,6,1,1,1,1,4,21
401086026,Rider Broncs,T. Marshall,4067348,,True,26.0,5,8,5,8,0,0,7,12,2,8,10,2,2,0,3,4,17
401086026,Rider Broncs,S. Jordan,4067349,,True,37.0,4,11,4,8,0,3,7,12,0,1,1,6,4,0,3,2,15
401086026,Rider Broncs,K. Williams,3946983,,True,14.0,0,0,0,0,0,0,0,3,0,1,1,2,2,0,3,1,0
401086026,Rider Broncs,A. Durham,3138490,,True,32.0,3,9,2,5,1,4,4,4,5,4,9,4,2,0,1,2,11
401086026,Rider Broncs,K. Cisse,4279746,,False,2.0,0,0,0,0,0,0,0,0,0,0,0,0,0,0,0,2,0
401086026,Rider Broncs,D. Eke,3941312,,False,9.0,1,2,1,2,0,0,1,2,0,3,3,0,0,0,0,1,3
401086026,Rider Broncs,D. Vaughn,4067347,,False,30.0,2,9,2,5,0,4,7,9,1,2,3,3,4,0,2,2,11
401086026,Rider Broncs,J. Allen,4067345,,False,6.0,0,1,0,0,0,1,0,0,0,0,0,0,0,0,0,2,0
401086026,Rider Broncs,A. Gilbert,3911886,,False,13.0,1,2,0,0,1,2,0,0,0,1,1,0,0,0,1,1,3
401086026,Rider Broncs,TEAM,TOTAL,TOTAL,False,,23,55,18,35,5,20,30,47,10,27,37,18,15,1,15,21,81
401086026,Rider Broncs,F. Scott,3922033,,True,31.0,7,13,4,7,3,6,4,5,1,5,6,1,1,1,1,4,21
401086026,Rider Broncs,T. Marshall,4067348,,True,26.0,5,8,5,8,0,0,7,12,2,8,10,2,2,0,3,4,17
401086026,Rider Broncs,S. Jordan,4067349,,True,37.0,4,11,4,8,0,3,7,12,0,1,1,6,4,0,3,2,15
401086026,Rider Broncs,K. Williams,3946983,,True,14.0,0,0,0,0,0,0,0,3,0,1,1,2,2,0,3,1,0
401086026,Rider Broncs,A. Durham,3138490,,True,32.0,3,9,2,5,1,4,4,4,5,4,9,4,2,0,1,2,11
401086026,Rider Broncs,K. Cisse,4279746,,False,2.0,0,0,0,0,0,0,0,0,0,0,0,0,0,0,0,2,0
401086026,Rider Broncs,D. Eke,3941312,,False,9.0,1,2,1,2,0,0,1,2,0,3,3,0,0,0,0,1,3
401086026,Rider Broncs,D. Vaughn,4067347,,False,30.0,2,9,2,5,0,4,7,9,1,2,3,3,4,0,2,2,11
401086026,Rider Broncs,J. Allen,4067345,,False,6.0,0,1,0,0,0,1,0,0,0,0,0,0,0,0,0,2,0
401086026,Rider Broncs,A. Gilbert,3911886,,False,13.0,1,2,0,0,1,2,0,0,0,1,1,0,0,0,1,1,3
401086026,Rider Broncs,TEAM,TOTAL,TOTAL,False,,23,55,18,35,5,20,30,47,10,27,37,18,15,1,15,21,81
401086026,Monmouth Hawks,M. Traore,3975762,,True,25.0,2,3,2,3,0,0,3,4,1,4,5,0,1,1,2,4,7
401086026,Monmouth Hawks,D. Quinn,3948714,,True,31.0,4,4,4,4,0,0,3,5,3,9,12,1,0,1,0,4,11
401086026,Monmouth Hawks,M. McClary,4279736,,True,22.0,3,8,3,8,0,0,0,2,1,2,3,2,1,0,2,4,6
401086026,Monmouth Hawks,D. Hammond,4279734,,True,27.0,4,13,1,3,3,10,0,0,1,1,2,1,1,0,2,5,11
401086026,Monmouth Hawks,N. Rutherford,3946977,,True,28.0,4,9,4,8,0,1,2,2,1,4,5,5,2,0,4,3,10
401086026,Monmouth Hawks,M. Martin,4279733,,False,7.0,0,0,0,0,0,0,0,0,0,0,0,0,0,0,1,1,0
401086026,Monmouth Hawks,S. Chaput,4398409,,False,13.0,0,0,0,0,0,0,0,2,0,1,1,1,1,0,1,4,0
401086026,Monmouth Hawks,G. Papas,4279735,,False,4.0,1,3,0,0,1,3,0,0,0,0,0,0,0,0,1,0,3
401086026,Monmouth Hawks,R. Salnave,4067329,,False,23.0,5,11,5,9,0,2,7,9,0,6,6,1,2,0,7,4,17
401086026,Monmouth Hawks,T. Gross Jr.,4065729,,False,0.0,0,0,0,0,0,0,0,0,0,0,0,0,0,0,0,0,0
401086026,Monmouth Hawks,L. Pillari,3948713,,False,20.0,2,7,2,3,0,4,3,4,2,0,2,0,0,0,2,1,7
401086026,Monmouth Hawks,TEAM,TOTAL,TOTAL,False,,25,58,21,38,4,20,18,28,12,30,42,11,8,2,23,30,72
401086026,Monmouth Hawks,M. Traore,3975762,,True,25.0,2,3,2,3,0,0,3,4,1,4,5,0,1,1,2,4,7
401086026,Monmouth Hawks,D. Quinn,3948714,,True,31.0,4,4,4,4,0,0,3,5,3,9,12,1,0,1,0,4,11
401086026,Monmouth Hawks,M. McClary,4279736,,True,22.0,3,8,3,8,0,0,0,2,1,2,3,2,1,0,2,4,6
401086026,Monmouth Hawks,D. Hammond,4279734,,True,27.0,4,13,1,3,3,10,0,0,1,1,2,1,1,0,2,5,11
401086026,Monmouth Hawks,N. Rutherford,3946977,,True,28.0,4,9,4,8,0,1,2,2,1,4,5,5,2,0,4,3,10
401086026,Monmouth Hawks,M. Martin,4279733,,False,7.0,0,0,0,0,0,0,0,0,0,0,0,0,0,0,1,1,0
401086026,Monmouth Hawks,S. Chaput,4398409,,False,13.0,0,0,0,0,0,0,0,2,0,1,1,1,1,0,1,4,0
401086026,Monmouth Hawks,G. Papas,4279735,,False,4.0,1,3,0,0,1,3,0,0,0,0,0,0,0,0,1,0,3
401086026,Monmouth Hawks,R. Salnave,4067329,,False,23.0,5,11,5,9,0,2,7,9,0,6,6,1,2,0,7,4,17
401086026,Monmouth Hawks,T. Gross Jr.,4065729,,False,0.0,0,0,0,0,0,0,0,0,0,0,0,0,0,0,0,0,0
401086026,Monmouth Hawks,L. Pillari,3948713,,False,20.0,2,7,2,3,0,4,3,4,2,0,2,0,0,0,2,1,7
401086026,Monmouth Hawks,TEAM,TOTAL,TOTAL,False,,25,58,21,38,4,20,18,28,12,30,42,11,8,2,23,30,72
401086025,Monmouth Hawks,M. Traore,3975762,,True,25.0,7,12,7,12,0,0,2,3,2,7,9,1,1,0,3,3,16
401086025,Monmouth Hawks,D. Quinn,3948714,,True,23.0,2,10,2,10,0,0,0,2,2,7,9,0,0,0,0,3,4
401086025,Monmouth Hawks,M. McClary,4279736,,True,23.0,1,2,1,2,0,0,2,4,1,1,2,2,1,0,1,4,4
401086025,Monmouth Hawks,D. Hammond,4279734,,True,29.0,2,5,2,3,0,2,0,0,0,0,0,1,0,0,2,0,4
401086025,Monmouth Hawks,N. Rutherford,3946977,,True,32.0,0,1,0,0,0,1,0,0,2,6,8,5,2,2,2,0,0
401086025,Monmouth Hawks,M. Martin,4279733,,False,14.0,2,6,1,3,1,3,0,0,0,1,1,0,1,1,1,2,5
401086025,Monmouth Hawks,S. Chaput,4398409,,False,9.0,0,1,0,1,0,0,2,2,0,0,0,0,0,0,1,1,2
401086025,Monmouth Hawks,R. Salnave,4067329,,False,29.0,7,15,5,12,2,3,1,3,0,7,7,1,0,1,1,0,17
401086025,Monmouth Hawks,L. Pillari,3948713,,False,16.0,3,4,2,3,1,1,2,3,0,2,2,2,0,0,2,1,9
401086025,Monmouth Hawks,TEAM,TOTAL,TOTAL,False,,24,56,20,46,4,10,9,17,11,32,43,12,5,4,13,14,61
401086025,Monmouth Hawks,M. Traore,3975762,,True,25.0,7,12,7,12,0,0,2,3,2,7,9,1,1,0,3,3,16
401086025,Monmouth Hawks,D. Quinn,3948714,,True,23.0,2,10,2,10,0,0,0,2,2,7,9,0,0,0,0,3,4
401086025,Monmouth Hawks,M. McClary,4279736,,True,23.0,1,2,1,2,0,0,2,4,1,1,2,2,1,0,1,4,4
401086025,Monmouth Hawks,D. Hammond,4279734,,True,29.0,2,5,2,3,0,2,0,0,0,0,0,1,0,0,2,0,4
401086025,Monmouth Hawks,N. Rutherford,3946977,,True,32.0,0,1,0,0,0,1,0,0,2,6,8,5,2,2,2,0,0
401086025,Monmouth Hawks,M. Martin,4279733,,False,14.0,2,6,1,3,1,3,0,0,0,1,1,0,1,1,1,2,5
401086025,Monmouth Hawks,S. Chaput,4398409,,False,9.0,0,1,0,1,0,0,2,2,0,0,0,0,0,0,1,1,2
401086025,Monmouth Hawks,R. Salnave,4067329,,False,29.0,7,15,5,12,2,3,1,3,0,7,7,1,0,1,1,0,17
401086025,Monmouth Hawks,L. Pillari,3948713,,False,16.0,3,4,2,3,1,1,2,3,0,2,2,2,0,0,2,1,9
401086025,Monmouth Hawks,TEAM,TOTAL,TOTAL,False,,24,56,20,46,4,10,9,17,11,32,43,12,5,4,13,14,61
401086025,Fairfield Stags,J. Kasibabu,3947016,,True,35.0,2,8,2,6,0,2,0,1,1,6,7,1,1,3,4,2,4
401086025,Fairfield Stags,L. Taliaferro,4398078,,True,15.0,1,7,0,0,1,7,0,0,0,3,3,0,0,0,0,1,3
401086025,Fairfield Stags,F. Lemetti,4398076,,True,28.0,3,9,1,1,2,8,0,0,0,0,0,0,0,0,0,4,8
401086025,Fairfield Stags,J. Cruz,4279488,,True,31.0,3,10,2,6,1,4,2,2,3,0,3,0,3,0,3,4,9
401086025,Fairfield Stags,T. Benning,4279483,,True,36.0,3,6,3,4,0,2,6,8,1,6,7,4,1,0,2,2,12
401086025,Fairfield Stags,O. El-Sheikh,4279489,,False,4.0,0,0,0,0,0,0,0,0,0,0,0,0,0,0,2,1,0
401086025,Fairfield Stags,W. Methnani,4279486,,False,15.0,1,8,0,4,1,4,2,2,3,2,5,0,0,1,2,0,5
401086025,Fairfield Stags,M. Milin,3947018,,False,18.0,2,5,2,2,0,3,2,2,2,5,7,4,0,0,0,2,6
401086025,Fairfield Stags,C. Whipple,4398077,,False,9.0,0,4,0,1,0,3,0,0,1,1,2,0,0,1,0,0,0
401086025,Fairfield Stags,A. Kavaliauskas,4080375,,False,9.0,1,2,1,2,0,0,0,0,0,0,0,0,1,0,2,2,2
401086025,Fairfield Stags,TEAM,TOTAL,TOTAL,False,,16,59,11,26,5,33,12,15,14,25,39,9,6,5,15,18,49
401086025,Fairfield Stags,J. Kasibabu,3947016,,True,35.0,2,8,2,6,0,2,0,1,1,6,7,1,1,3,4,2,4
401086025,Fairfield Stags,L. Taliaferro,4398078,,True,15.0,1,7,0,0,1,7,0,0,0,3,3,0,0,0,0,1,3
401086025,Fairfield Stags,F. Lemetti,4398076,,True,28.0,3,9,1,1,2,8,0,0,0,0,0,0,0,0,0,4,8
401086025,Fairfield Stags,J. Cruz,4279488,,True,31.0,3,10,2,6,1,4,2,2,3,0,3,0,3,0,3,4,9
401086025,Fairfield Stags,T. Benning,4279483,,True,36.0,3,6,3,4,0,2,6,8,1,6,7,4,1,0,2,2,12
401086025,Fairfield Stags,O. El-Sheikh,4279489,,False,4.0,0,0,0,0,0,0,0,0,0,0,0,0,0,0,2,1,0
401086025,Fairfield Stags,W. Methnani,4279486,,False,15.0,1,8,0,4,1,4,2,2,3,2,5,0,0,1,2,0,5
401086025,Fairfield Stags,M. Milin,3947018,,False,18.0,2,5,2,2,0,3,2,2,2,5,7,4,0,0,0,2,6
401086025,Fairfield Stags,C. Whipple,4398077,,False,9.0,0,4,0,1,0,3,0,0,1,1,2,0,0,1,0,0,0
401086025,Fairfield Stags,A. Kavaliauskas,4080375,,False,9.0,1,2,1,2,0,0,0,0,0,0,0,0,1,0,2,2,2
401086025,Fairfield Stags,TEAM,TOTAL,TOTAL,False,,16,59,11,26,5,33,12,15,14,25,39,9,6,5,15,18,49
401086024,Saint Peter's Peacocks,KC Ndefo,4398386,,True,26.0,0,1,0,1,0,0,3,4,0,2,2,1,1,5,1,3,3
401086024,Saint Peter's Peacocks,S. Idowu,3922042,,True,29.0,6,11,5,5,1,6,3,4,1,7,8,0,0,2,2,4,16
401086024,Saint Peter's Peacocks,M. Dixon,4279758,,True,28.0,1,5,0,3,1,2,2,2,1,2,3,0,3,1,4,3,5
401086024,Saint Peter's Peacocks,A. Hicks,4284295,,True,8.0,0,0,0,0,0,0,0,0,0,0,0,0,0,0,1,0,0
401086024,Saint Peter's Peacocks,D. Turner,4067356,,True,35.0,7,15,2,5,5,10,1,1,0,1,1,2,0,0,2,1,20
401086024,Saint Peter's Peacocks,D. Woods,3919424,,False,8.0,1,1,0,0,1,1,0,0,0,1,1,1,0,1,1,4,3
401086024,Saint Peter's Peacocks,M. Majak,4398387,,False,3.0,0,0,0,0,0,0,0,0,0,1,1,0,0,1,0,1,0
401086024,Saint Peter's Peacocks,K. Brown,4398385,,False,18.0,0,3,0,0,0,3,0,0,0,2,2,1,1,1,1,0,0
401086024,Saint Peter's Peacocks,D. Watson,4398384,,False,29.0,1,5,0,0,1,5,1,2,0,2,2,5,0,0,5,2,4
401086024,Saint Peter's Peacocks,Q. Taylor,4067357,,False,16.0,0,1,0,1,0,0,0,0,1,4,5,0,0,0,0,3,0
401086024,Saint Peter's Peacocks,TEAM,TOTAL,TOTAL,False,,16,42,7,15,9,27,10,13,5,24,29,10,5,11,17,21,51
401086024,Saint Peter's Peacocks,KC Ndefo,4398386,,True,26.0,0,1,0,1,0,0,3,4,0,2,2,1,1,5,1,3,3
401086024,Saint Peter's Peacocks,S. Idowu,3922042,,True,29.0,6,11,5,5,1,6,3,4,1,7,8,0,0,2,2,4,16
401086024,Saint Peter's Peacocks,M. Dixon,4279758,,True,28.0,1,5,0,3,1,2,2,2,1,2,3,0,3,1,4,3,5
401086024,Saint Peter's Peacocks,A. Hicks,4284295,,True,8.0,0,0,0,0,0,0,0,0,0,0,0,0,0,0,1,0,0
401086024,Saint Peter's Peacocks,D. Turner,4067356,,True,35.0,7,15,2,5,5,10,1,1,0,1,1,2,0,0,2,1,20
401086024,Saint Peter's Peacocks,D. Woods,3919424,,False,8.0,1,1,0,0,1,1,0,0,0,1,1,1,0,1,1,4,3
401086024,Saint Peter's Peacocks,M. Majak,4398387,,False,3.0,0,0,0,0,0,0,0,0,0,1,1,0,0,1,0,1,0
401086024,Saint Peter's Peacocks,K. Brown,4398385,,False,18.0,0,3,0,0,0,3,0,0,0,2,2,1,1,1,1,0,0
401086024,Saint Peter's Peacocks,D. Watson,4398384,,False,29.0,1,5,0,0,1,5,1,2,0,2,2,5,0,0,5,2,4
401086024,Saint Peter's Peacocks,Q. Taylor,4067357,,False,16.0,0,1,0,1,0,0,0,0,1,4,5,0,0,0,0,3,0
401086024,Saint Peter's Peacocks,TEAM,TOTAL,TOTAL,False,,16,42,7,15,9,27,10,13,5,24,29,10,5,11,17,21,51
401086024,Monmouth Hawks,M. Traore,3975762,,True,23.0,1,3,1,3,0,0,7,8,1,3,4,0,1,0,1,3,9
401086024,Monmouth Hawks,D. Quinn,3948714,,True,26.0,3,10,3,10,0,0,4,6,2,1,3,0,0,1,3,2,10
401086024,Monmouth Hawks,M. McClary,4279736,,True,33.0,5,6,4,5,1,1,2,2,0,4,4,1,2,0,2,1,13
401086024,Monmouth Hawks,D. Hammond,4279734,,True,9.0,2,5,0,2,2,3,0,0,0,0,0,0,1,0,0,0,6
401086024,Monmouth Hawks,N. Rutherford,3946977,,True,31.0,2,6,2,6,0,0,5,5,1,7,8,1,2,0,1,0,9
401086024,Monmouth Hawks,N. Rutty,4398408,,False,14.0,0,2,0,2,0,0,0,0,2,0,2,0,0,0,0,1,0
401086024,Monmouth Hawks,S. Chaput,4398409,,False,17.0,0,2,0,1,0,1,0,0,0,0,0,0,0,0,0,2,0
401086024,Monmouth Hawks,M. Martin,4279733,,False,6.0,0,0,0,0,0,0,0,0,0,2,2,0,0,0,2,1,0
401086024,Monmouth Hawks,G. Papas,4279735,,False,10.0,1,5,1,2,0,3,0,0,0,0,0,1,0,0,0,0,2
401086024,Monmouth Hawks,R. Salnave,4067329,,False,27.0,0,7,0,5,0,2,2,2,0,4,4,1,0,0,3,3,2
401086024,Monmouth Hawks,L. Pillari,3948713,,False,4.0,0,1,0,0,0,1,2,2,0,0,0,0,0,0,0,1,2
401086024,Monmouth Hawks,TEAM,TOTAL,TOTAL,False,,14,47,11,36,3,11,22,25,10,22,32,4,6,1,12,14,53
401086024,Monmouth Hawks,M. Traore,3975762,,True,23.0,1,3,1,3,0,0,7,8,1,3,4,0,1,0,1,3,9
401086024,Monmouth Hawks,D. Quinn,3948714,,True,26.0,3,10,3,10,0,0,4,6,2,1,3,0,0,1,3,2,10
401086024,Monmouth Hawks,M. McClary,4279736,,True,33.0,5,6,4,5,1,1,2,2,0,4,4,1,2,0,2,1,13
401086024,Monmouth Hawks,D. Hammond,4279734,,True,9.0,2,5,0,2,2,3,0,0,0,0,0,0,1,0,0,0,6
401086024,Monmouth Hawks,N. Rutherford,3946977,,True,31.0,2,6,2,6,0,0,5,5,1,7,8,1,2,0,1,0,9
401086024,Monmouth Hawks,N. Rutty,4398408,,False,14.0,0,2,0,2,0,0,0,0,2,0,2,0,0,0,0,1,0
401086024,Monmouth Hawks,S. Chaput,4398409,,False,17.0,0,2,0,1,0,1,0,0,0,0,0,0,0,0,0,2,0
401086024,Monmouth Hawks,M. Martin,4279733,,False,6.0,0,0,0,0,0,0,0,0,0,2,2,0,0,0,2,1,0
401086024,Monmouth Hawks,G. Papas,4279735,,False,10.0,1,5,1,2,0,3,0,0,0,0,0,1,0,0,0,0,2
401086024,Monmouth Hawks,R. Salnave,4067329,,False,27.0,0,7,0,5,0,2,2,2,0,4,4,1,0,0,3,3,2
401086024,Monmouth Hawks,L. Pillari,3948713,,False,4.0,0,1,0,0,0,1,2,2,0,0,0,0,0,0,0,1,2
401086024,Monmouth Hawks,TEAM,TOTAL,TOTAL,False,,14,47,11,36,3,11,22,25,10,22,32,4,6,1,12,14,53
401086023,Rider Broncs,D. Vaughn,4067347,,True,38.0,4,15,4,9,0,6,7,9,4,5,9,2,5,0,2,4,15
401086023,Rider Broncs,T. Marshall,4067348,,True,17.0,3,6,3,6,0,0,2,2,1,3,4,1,1,1,0,4,8
401086023,Rider Broncs,S. Jordan,4067349,,True,30.0,4,6,3,3,1,3,1,1,0,2,2,5,0,0,3,5,10
401086023,Rider Broncs,J. Allen,4067345,,True,15.0,2,5,1,1,1,4,0,0,0,1,1,0,0,0,0,0,5
401086023,Rider Broncs,A. Durham,3138490,,True,35.0,4,9,2,4,2,5,2,2,3,0,3,1,2,0,1,5,12
401086023,Rider Broncs,A. Ogemuno-Johnson,4406151,,False,5.0,0,1,0,1,0,0,0,0,0,0,0,0,0,0,1,1,0
401086023,Rider Broncs,K. Cisse,4279746,,False,4.0,0,0,0,0,0,0,0,0,0,0,0,0,0,0,0,0,0
401086023,Rider Broncs,D. Eke,3941312,,False,22.0,4,5,4,5,0,0,3,5,2,4,6,0,1,1,4,3,11
401086023,Rider Broncs,F. Scott,3922033,,False,22.0,0,4,0,1,0,3,8,8,2,1,3,2,0,0,3,3,8
401086023,Rider Broncs,K. Williams,3946983,,False,12.0,1,2,1,2,0,0,0,0,0,0,0,0,2,1,4,1,2
401086023,Rider Broncs,TEAM,TOTAL,TOTAL,False,,22,53,18,32,4,21,23,27,12,17,29,11,11,3,18,26,71
401086023,Rider Broncs,D. Vaughn,4067347,,True,38.0,4,15,4,9,0,6,7,9,4,5,9,2,5,0,2,4,15
401086023,Rider Broncs,T. Marshall,4067348,,True,17.0,3,6,3,6,0,0,2,2,1,3,4,1,1,1,0,4,8
401086023,Rider Broncs,S. Jordan,4067349,,True,30.0,4,6,3,3,1,3,1,1,0,2,2,5,0,0,3,5,10
401086023,Rider Broncs,J. Allen,4067345,,True,15.0,2,5,1,1,1,4,0,0,0,1,1,0,0,0,0,0,5
401086023,Rider Broncs,A. Durham,3138490,,True,35.0,4,9,2,4,2,5,2,2,3,0,3,1,2,0,1,5,12
401086023,Rider Broncs,A. Ogemuno-Johnson,4406151,,False,5.0,0,1,0,1,0,0,0,0,0,0,0,0,0,0,1,1,0
401086023,Rider Broncs,K. Cisse,4279746,,False,4.0,0,0,0,0,0,0,0,0,0,0,0,0,0,0,0,0,0
401086023,Rider Broncs,D. Eke,3941312,,False,22.0,4,5,4,5,0,0,3,5,2,4,6,0,1,1,4,3,11
401086023,Rider Broncs,F. Scott,3922033,,False,22.0,0,4,0,1,0,3,8,8,2,1,3,2,0,0,3,3,8
401086023,Rider Broncs,K. Williams,3946983,,False,12.0,1,2,1,2,0,0,0,0,0,0,0,0,2,1,4,1,2
401086023,Rider Broncs,TEAM,TOTAL,TOTAL,False,,22,53,18,32,4,21,23,27,12,17,29,11,11,3,18,26,71
401086023,Monmouth Hawks,M. Traore,3975762,,True,28.0,4,8,4,8,0,0,0,3,2,5,7,0,0,2,3,2,8
401086023,Monmouth Hawks,D. Quinn,3948714,,True,22.0,4,6,4,6,0,0,9,10,4,3,7,1,0,1,1,4,17
401086023,Monmouth Hawks,M. McClary,4279736,,True,25.0,2,2,1,1,1,1,0,0,0,1,1,0,0,0,1,2,5
401086023,Monmouth Hawks,D. Hammond,4279734,,True,21.0,4,7,1,2,3,5,0,0,0,0,0,2,0,1,2,3,11
401086023,Monmouth Hawks,N. Rutherford,3946977,,True,32.0,2,7,2,7,0,0,5,5,0,4,4,5,2,0,6,2,9
401086023,Monmouth Hawks,N. Rutty,4398408,,False,15.0,1,2,1,2,0,0,0,0,1,1,2,1,0,0,1,4,2
401086023,Monmouth Hawks,S. Ibiezugbe,4067330,,False,5.0,1,2,1,2,0,0,0,0,0,2,2,0,1,1,0,2,2
401086023,Monmouth Hawks,M. Martin,4279733,,False,9.0,2,2,2,2,0,0,0,0,0,1,1,0,0,0,1,3,4
401086023,Monmouth Hawks,S. Chaput,4398409,,False,14.0,2,5,2,5,0,0,1,4,0,0,0,2,1,0,3,1,5
401086023,Monmouth Hawks,G. Papas,4279735,,False,2.0,0,0,0,0,0,0,0,0,0,0,0,0,1,0,1,0,0
401086023,Monmouth Hawks,R. Salnave,4067329,,False,10.0,1,4,1,4,0,0,4,4,0,0,0,0,1,0,0,1,6
401086023,Monmouth Hawks,L. Pillari,3948713,,False,17.0,1,5,1,1,0,4,4,4,0,0,0,2,2,0,1,0,6
401086023,Monmouth Hawks,TEAM,TOTAL,TOTAL,False,,24,50,20,40,4,10,23,30,10,19,29,13,8,5,20,24,75
401086023,Monmouth Hawks,M. Traore,3975762,,True,28.0,4,8,4,8,0,0,0,3,2,5,7,0,0,2,3,2,8
401086023,Monmouth Hawks,D. Quinn,3948714,,True,22.0,4,6,4,6,0,0,9,10,4,3,7,1,0,1,1,4,17
401086023,Monmouth Hawks,M. McClary,4279736,,True,25.0,2,2,1,1,1,1,0,0,0,1,1,0,0,0,1,2,5
401086023,Monmouth Hawks,D. Hammond,4279734,,True,21.0,4,7,1,2,3,5,0,0,0,0,0,2,0,1,2,3,11
401086023,Monmouth Hawks,N. Rutherford,3946977,,True,32.0,2,7,2,7,0,0,5,5,0,4,4,5,2,0,6,2,9
401086023,Monmouth Hawks,N. Rutty,4398408,,False,15.0,1,2,1,2,0,0,0,0,1,1,2,1,0,0,1,4,2
401086023,Monmouth Hawks,S. Ibiezugbe,4067330,,False,5.0,1,2,1,2,0,0,0,0,0,2,2,0,1,1,0,2,2
401086023,Monmouth Hawks,M. Martin,4279733,,False,9.0,2,2,2,2,0,0,0,0,0,1,1,0,0,0,1,3,4
401086023,Monmouth Hawks,S. Chaput,4398409,,False,14.0,2,5,2,5,0,0,1,4,0,0,0,2,1,0,3,1,5
401086023,Monmouth Hawks,G. Papas,4279735,,False,2.0,0,0,0,0,0,0,0,0,0,0,0,0,1,0,1,0,0
401086023,Monmouth Hawks,R. Salnave,4067329,,False,10.0,1,4,1,4,0,0,4,4,0,0,0,0,1,0,0,1,6
401086023,Monmouth Hawks,L. Pillari,3948713,,False,17.0,1,5,1,1,0,4,4,4,0,0,0,2,2,0,1,0,6
401086023,Monmouth Hawks,TEAM,TOTAL,TOTAL,False,,24,50,20,40,4,10,23,30,10,19,29,13,8,5,20,24,75
401086022,Siena Saints,S. Seymour,4398391,,True,34.0,5,12,0,0,5,12,0,0,0,0,0,1,0,0,0,1,15
401086022,Siena Saints,E. Fisher,3913235,,True,35.0,6,11,6,10,0,1,2,2,0,3,3,2,1,0,3,3,14
401086022,Siena Saints,K. Degnan,3138282,,True,25.0,1,5,0,1,1,4,0,0,1,5,6,2,4,1,0,3,3
401086022,Siena Saints,G. Darwiche,4398393,,True,28.0,1,6,0,1,1,5,0,0,0,1,1,1,0,0,3,4,3
401086022,Siena Saints,J. Pickett,4398390,,True,31.0,4,10,2,6,2,4,1,3,0,4,4,5,2,1,5,5,11
401086022,Siena Saints,D. Tchougang,4398394,,False,2.0,0,0,0,0,0,0,0,0,0,0,0,0,0,0,0,0,0
401086022,Siena Saints,M. Camper,4279751,,False,26.0,1,7,1,5,0,2,3,3,5,5,10,2,1,1,3,2,5
401086022,Siena Saints,B. Bayer,4065720,,False,1.0,0,0,0,0,0,0,0,0,0,0,0,0,0,0,0,0,0
401086022,Siena Saints,K. Smithen,3133848,,False,18.0,2,4,2,2,0,2,0,0,1,3,4,0,0,0,0,5,4
401086022,Siena Saints,TEAM,TOTAL,TOTAL,False,,20,55,11,25,9,30,6,8,7,21,28,13,8,3,14,23,55
401086022,Siena Saints,S. Seymour,4398391,,True,34.0,5,12,0,0,5,12,0,0,0,0,0,1,0,0,0,1,15
401086022,Siena Saints,E. Fisher,3913235,,True,35.0,6,11,6,10,0,1,2,2,0,3,3,2,1,0,3,3,14
401086022,Siena Saints,K. Degnan,3138282,,True,25.0,1,5,0,1,1,4,0,0,1,5,6,2,4,1,0,3,3
401086022,Siena Saints,G. Darwiche,4398393,,True,28.0,1,6,0,1,1,5,0,0,0,1,1,1,0,0,3,4,3
401086022,Siena Saints,J. Pickett,4398390,,True,31.0,4,10,2,6,2,4,1,3,0,4,4,5,2,1,5,5,11
401086022,Siena Saints,D. Tchougang,4398394,,False,2.0,0,0,0,0,0,0,0,0,0,0,0,0,0,0,0,0,0
401086022,Siena Saints,M. Camper,4279751,,False,26.0,1,7,1,5,0,2,3,3,5,5,10,2,1,1,3,2,5
401086022,Siena Saints,B. Bayer,4065720,,False,1.0,0,0,0,0,0,0,0,0,0,0,0,0,0,0,0,0,0
401086022,Siena Saints,K. Smithen,3133848,,False,18.0,2,4,2,2,0,2,0,0,1,3,4,0,0,0,0,5,4
401086022,Siena Saints,TEAM,TOTAL,TOTAL,False,,20,55,11,25,9,30,6,8,7,21,28,13,8,3,14,23,55
401086022,Monmouth Hawks,M. Traore,3975762,,True,30.0,3,8,3,8,0,0,1,2,2,2,4,4,1,0,1,0,7
401086022,Monmouth Hawks,D. Quinn,3948714,,True,31.0,4,4,4,4,0,0,2,2,0,5,5,0,0,0,3,4,10
401086022,Monmouth Hawks,M. McClary,4279736,,True,20.0,1,4,0,3,1,1,2,2,0,2,2,0,1,0,1,2,5
401086022,Monmouth Hawks,D. Hammond,4279734,,True,35.0,4,7,0,1,4,6,4,7,1,3,4,0,2,0,1,1,16
401086022,Monmouth Hawks,N. Rutherford,3946977,,True,23.0,2,4,2,3,0,1,4,6,2,6,8,3,1,0,3,4,8
401086022,Monmouth Hawks,N. Rutty,4398408,,False,11.0,0,0,0,0,0,0,1,5,0,1,1,0,0,0,0,0,1
401086022,Monmouth Hawks,S. Ibiezugbe,4067330,,False,3.0,0,0,0,0,0,0,0,0,0,0,0,0,0,0,0,0,0
401086022,Monmouth Hawks,S. Chaput,4398409,,False,21.0,1,5,1,5,0,0,4,7,0,2,2,4,2,0,1,0,6
401086022,Monmouth Hawks,G. Papas,4279735,,False,6.0,1,1,0,0,1,1,0,0,0,1,1,1,0,0,0,0,3
401086022,Monmouth Hawks,L. Pillari,3948713,,False,20.0,4,9,3,7,1,2,1,1,1,4,5,0,0,0,3,1,10
401086022,Monmouth Hawks,TEAM,TOTAL,TOTAL,False,,20,42,13,31,7,11,19,32,6,28,34,12,7,0,13,12,66
401086022,Monmouth Hawks,M. Traore,3975762,,True,30.0,3,8,3,8,0,0,1,2,2,2,4,4,1,0,1,0,7
401086022,Monmouth Hawks,D. Quinn,3948714,,True,31.0,4,4,4,4,0,0,2,2,0,5,5,0,0,0,3,4,10
401086022,Monmouth Hawks,M. McClary,4279736,,True,20.0,1,4,0,3,1,1,2,2,0,2,2,0,1,0,1,2,5
401086022,Monmouth Hawks,D. Hammond,4279734,,True,35.0,4,7,0,1,4,6,4,7,1,3,4,0,2,0,1,1,16
401086022,Monmouth Hawks,N. Rutherford,3946977,,True,23.0,2,4,2,3,0,1,4,6,2,6,8,3,1,0,3,4,8
401086022,Monmouth Hawks,N. Rutty,4398408,,False,11.0,0,0,0,0,0,0,1,5,0,1,1,0,0,0,0,0,1
401086022,Monmouth Hawks,S. Ibiezugbe,4067330,,False,3.0,0,0,0,0,0,0,0,0,0,0,0,0,0,0,0,0,0
401086022,Monmouth Hawks,S. Chaput,4398409,,False,21.0,1,5,1,5,0,0,4,7,0,2,2,4,2,0,1,0,6
401086022,Monmouth Hawks,G. Papas,4279735,,False,6.0,1,1,0,0,1,1,0,0,0,1,1,1,0,0,0,0,3
401086022,Monmouth Hawks,L. Pillari,3948713,,False,20.0,4,9,3,7,1,2,1,1,1,4,5,0,0,0,3,1,10
401086022,Monmouth Hawks,TEAM,TOTAL,TOTAL,False,,20,42,13,31,7,11,19,32,6,28,34,12,7,0,13,12,66
401086021,Monmouth Hawks,M. Traore,3975762,,True,24.0,1,5,1,5,0,0,1,2,1,7,8,2,0,1,0,1,3
401086021,Monmouth Hawks,D. Quinn,3948714,,True,25.0,5,8,5,8,0,0,5,5,4,4,8,2,0,2,2,4,15
401086021,Monmouth Hawks,M. McClary,4279736,,True,21.0,0,2,0,2,0,0,4,4,1,2,3,2,0,0,2,1,4
401086021,Monmouth Hawks,D. Hammond,4279734,,True,24.0,6,16,2,6,4,10,0,0,0,0,0,0,1,0,2,3,16
401086021,Monmouth Hawks,R. Salnave,4067329,,True,25.0,5,12,2,6,3,6,4,5,0,3,3,2,3,0,5,3,17
401086021,Monmouth Hawks,N. Rutty,4398408,,False,13.0,1,1,1,1,0,0,3,5,0,2,2,0,0,2,1,1,5
401086021,Monmouth Hawks,S. Ibiezugbe,4067330,,False,2.0,0,0,0,0,0,0,0,0,0,0,0,0,0,0,0,0,0
401086021,Monmouth Hawks,M. Martin,4279733,,False,15.0,1,1,1,1,0,0,0,0,0,2,2,1,0,0,0,1,2
401086021,Monmouth Hawks,M. James Jr.,4404878,,False,1.0,0,0,0,0,0,0,0,0,0,1,1,0,0,0,0,0,0
401086021,Monmouth Hawks,S. Chaput,4398409,,False,19.0,2,2,1,1,1,1,2,2,0,0,0,0,2,0,2,1,7
401086021,Monmouth Hawks,D. Calloway Jr.,4398407,,False,2.0,0,1,0,0,0,1,0,0,0,1,1,0,0,0,0,0,0
401086021,Monmouth Hawks,G. Papas,4279735,,False,2.0,0,1,0,0,0,1,0,0,0,1,1,0,0,0,0,0,0
401086021,Monmouth Hawks,T. Gross Jr.,4065729,,False,2.0,0,1,0,1,0,0,0,0,0,0,0,0,0,0,0,0,0
401086021,Monmouth Hawks,N. Rutherford,3946977,,False,25.0,2,3,1,2,1,1,0,0,1,7,8,6,4,1,2,2,5
401086021,Monmouth Hawks,TEAM,TOTAL,TOTAL,False,,23,53,14,33,9,20,19,23,9,32,41,15,10,6,16,17,74
401086021,Monmouth Hawks,M. Traore,3975762,,True,24.0,1,5,1,5,0,0,1,2,1,7,8,2,0,1,0,1,3
401086021,Monmouth Hawks,D. Quinn,3948714,,True,25.0,5,8,5,8,0,0,5,5,4,4,8,2,0,2,2,4,15
401086021,Monmouth Hawks,M. McClary,4279736,,True,21.0,0,2,0,2,0,0,4,4,1,2,3,2,0,0,2,1,4
401086021,Monmouth Hawks,D. Hammond,4279734,,True,24.0,6,16,2,6,4,10,0,0,0,0,0,0,1,0,2,3,16
401086021,Monmouth Hawks,R. Salnave,4067329,,True,25.0,5,12,2,6,3,6,4,5,0,3,3,2,3,0,5,3,17
401086021,Monmouth Hawks,N. Rutty,4398408,,False,13.0,1,1,1,1,0,0,3,5,0,2,2,0,0,2,1,1,5
401086021,Monmouth Hawks,S. Ibiezugbe,4067330,,False,2.0,0,0,0,0,0,0,0,0,0,0,0,0,0,0,0,0,0
401086021,Monmouth Hawks,M. Martin,4279733,,False,15.0,1,1,1,1,0,0,0,0,0,2,2,1,0,0,0,1,2
401086021,Monmouth Hawks,M. James Jr.,4404878,,False,1.0,0,0,0,0,0,0,0,0,0,1,1,0,0,0,0,0,0
401086021,Monmouth Hawks,S. Chaput,4398409,,False,19.0,2,2,1,1,1,1,2,2,0,0,0,0,2,0,2,1,7
401086021,Monmouth Hawks,D. Calloway Jr.,4398407,,False,2.0,0,1,0,0,0,1,0,0,0,1,1,0,0,0,0,0,0
401086021,Monmouth Hawks,G. Papas,4279735,,False,2.0,0,1,0,0,0,1,0,0,0,1,1,0,0,0,0,0,0
401086021,Monmouth Hawks,T. Gross Jr.,4065729,,False,2.0,0,1,0,1,0,0,0,0,0,0,0,0,0,0,0,0,0
401086021,Monmouth Hawks,N. Rutherford,3946977,,False,25.0,2,3,1,2,1,1,0,0,1,7,8,6,4,1,2,2,5
401086021,Monmouth Hawks,TEAM,TOTAL,TOTAL,False,,23,53,14,33,9,20,19,23,9,32,41,15,10,6,16,17,74
401086021,Fairfield Stags,J. Kasibabu,3947016,,True,24.0,5,6,5,6,0,0,2,6,4,5,9,2,1,2,3,3,12
401086021,Fairfield Stags,L. Taliaferro,4398078,,True,23.0,3,9,1,4,2,5,0,0,0,1,1,0,1,0,0,1,8
401086021,Fairfield Stags,F. Lemetti,4398076,,True,29.0,3,6,0,1,3,5,0,0,1,1,2,0,0,0,1,2,9
401086021,Fairfield Stags,N. Alvarez,4398075,,True,31.0,3,12,2,7,1,5,4,7,0,2,2,3,1,0,5,3,11
401086021,Fairfield Stags,J. Cruz,4279488,,True,23.0,1,7,1,4,0,3,2,4,2,5,7,0,0,0,1,1,4
401086021,Fairfield Stags,O. El-Sheikh,4279489,,False,8.0,1,2,1,1,0,1,0,0,0,0,0,0,0,0,2,0,2
401086021,Fairfield Stags,W. Methnani,4279486,,False,12.0,1,3,1,3,0,0,0,0,1,3,4,1,0,0,0,5,2
401086021,Fairfield Stags,K. Senghore-Peterson,4279485,,False,11.0,1,2,1,1,0,1,1,4,1,2,3,0,0,0,1,1,3
401086021,Fairfield Stags,C. Whipple,4398077,,False,13.0,1,3,0,0,1,3,0,0,1,1,2,2,0,0,0,0,3
401086021,Fairfield Stags,T. Benning,4279483,,False,4.0,1,3,0,1,1,2,0,0,0,1,1,0,0,0,2,1,3
401086021,Fairfield Stags,A. Kavaliauskas,4080375,,False,22.0,0,3,0,1,0,2,0,1,0,2,2,5,4,0,1,2,0
401086021,Fairfield Stags,TEAM,TOTAL,TOTAL,False,,20,56,12,29,8,27,9,22,12,24,36,13,7,2,16,19,57
401086021,Fairfield Stags,J. Kasibabu,3947016,,True,24.0,5,6,5,6,0,0,2,6,4,5,9,2,1,2,3,3,12
401086021,Fairfield Stags,L. Taliaferro,4398078,,True,23.0,3,9,1,4,2,5,0,0,0,1,1,0,1,0,0,1,8
401086021,Fairfield Stags,F. Lemetti,4398076,,True,29.0,3,6,0,1,3,5,0,0,1,1,2,0,0,0,1,2,9
401086021,Fairfield Stags,N. Alvarez,4398075,,True,31.0,3,12,2,7,1,5,4,7,0,2,2,3,1,0,5,3,11
401086021,Fairfield Stags,J. Cruz,4279488,,True,23.0,1,7,1,4,0,3,2,4,2,5,7,0,0,0,1,1,4
401086021,Fairfield Stags,O. El-Sheikh,4279489,,False,8.0,1,2,1,1,0,1,0,0,0,0,0,0,0,0,2,0,2
401086021,Fairfield Stags,W. Methnani,4279486,,False,12.0,1,3,1,3,0,0,0,0,1,3,4,1,0,0,0,5,2
401086021,Fairfield Stags,K. Senghore-Peterson,4279485,,False,11.0,1,2,1,1,0,1,1,4,1,2,3,0,0,0,1,1,3
401086021,Fairfield Stags,C. Whipple,4398077,,False,13.0,1,3,0,0,1,3,0,0,1,1,2,2,0,0,0,0,3
401086021,Fairfield Stags,T. Benning,4279483,,False,4.0,1,3,0,1,1,2,0,0,0,1,1,0,0,0,2,1,3
401086021,Fairfield Stags,A. Kavaliauskas,4080375,,False,22.0,0,3,0,1,0,2,0,1,0,2,2,5,4,0,1,2,0
401086021,Fairfield Stags,TEAM,TOTAL,TOTAL,False,,20,56,12,29,8,27,9,22,12,24,36,13,7,2,16,19,57
401086020,Siena Saints,E. Fisher,3913235,,True,36.0,5,15,4,10,1,5,1,4,1,3,4,2,0,1,3,2,12
401086020,Siena Saints,K. Degnan,3138282,,True,41.0,5,7,0,0,5,7,2,2,1,6,7,1,2,1,0,0,17
401086020,Siena Saints,S. Seymour,4398391,,True,34.0,2,5,0,0,2,5,0,0,0,1,1,0,2,1,2,1,6
401086020,Siena Saints,G. Darwiche,4398393,,True,19.0,1,3,0,0,1,3,0,0,0,0,0,2,0,0,1,3,3
401086020,Siena Saints,J. Pickett,4398390,,True,44.0,5,15,0,5,5,10,0,0,1,6,7,6,3,2,6,2,15
401086020,Siena Saints,D. Tchougang,4398394,,False,8.0,0,1,0,1,0,0,0,0,0,1,1,0,0,1,0,3,0
401086020,Siena Saints,M. Camper,4279751,,False,29.0,2,2,2,2,0,0,1,8,2,3,5,1,0,0,0,2,5
401086020,Siena Saints,B. Bayer,4065720,,False,5.0,0,0,0,0,0,0,0,0,0,0,0,0,0,0,0,1,0
401086020,Siena Saints,K. Smithen,3133848,,False,9.0,1,3,1,2,0,1,0,0,0,0,0,1,1,0,0,1,2
401086020,Siena Saints,TEAM,TOTAL,TOTAL,False,,21,51,7,20,14,31,4,14,6,24,30,13,8,6,14,16,60
401086020,Siena Saints,E. Fisher,3913235,,True,36.0,5,15,4,10,1,5,1,4,1,3,4,2,0,1,3,2,12
401086020,Siena Saints,K. Degnan,3138282,,True,41.0,5,7,0,0,5,7,2,2,1,6,7,1,2,1,0,0,17
401086020,Siena Saints,S. Seymour,4398391,,True,34.0,2,5,0,0,2,5,0,0,0,1,1,0,2,1,2,1,6
401086020,Siena Saints,G. Darwiche,4398393,,True,19.0,1,3,0,0,1,3,0,0,0,0,0,2,0,0,1,3,3
401086020,Siena Saints,J. Pickett,4398390,,True,44.0,5,15,0,5,5,10,0,0,1,6,7,6,3,2,6,2,15
401086020,Siena Saints,D. Tchougang,4398394,,False,8.0,0,1,0,1,0,0,0,0,0,1,1,0,0,1,0,3,0
401086020,Siena Saints,M. Camper,4279751,,False,29.0,2,2,2,2,0,0,1,8,2,3,5,1,0,0,0,2,5
401086020,Siena Saints,B. Bayer,4065720,,False,5.0,0,0,0,0,0,0,0,0,0,0,0,0,0,0,0,1,0
401086020,Siena Saints,K. Smithen,3133848,,False,9.0,1,3,1,2,0,1,0,0,0,0,0,1,1,0,0,1,2
401086020,Siena Saints,TEAM,TOTAL,TOTAL,False,,21,51,7,20,14,31,4,14,6,24,30,13,8,6,14,16,60
401086020,Monmouth Hawks,M. Traore,3975762,,True,37.0,3,4,3,4,0,0,0,0,2,7,9,2,3,0,2,3,6
401086020,Monmouth Hawks,D. Quinn,3948714,,True,36.0,6,11,6,11,0,0,2,4,4,5,9,0,0,1,0,4,14
401086020,Monmouth Hawks,M. McClary,4279736,,True,12.0,0,1,0,1,0,0,0,0,1,0,1,0,0,0,0,0,0
401086020,Monmouth Hawks,D. Hammond,4279734,,True,30.0,6,12,2,5,4,7,0,1,0,3,3,0,0,0,3,2,16
401086020,Monmouth Hawks,R. Salnave,4067329,,True,35.0,3,14,3,11,0,3,8,8,1,2,3,3,1,0,3,2,14
401086020,Monmouth Hawks,N. Rutty,4398408,,False,3.0,0,0,0,0,0,0,0,0,0,0,0,0,0,0,0,0,0
401086020,Monmouth Hawks,S. Ibiezugbe,4067330,,False,5.0,0,2,0,2,0,0,0,0,0,0,0,0,1,0,0,0,0
401086020,Monmouth Hawks,M. Martin,4279733,,False,9.0,0,0,0,0,0,0,0,0,0,1,1,0,0,1,0,1,0
401086020,Monmouth Hawks,S. Chaput,4398409,,False,25.0,2,7,1,4,1,3,2,2,1,1,2,3,0,0,1,1,7
401086020,Monmouth Hawks,N. Rutherford,3946977,,False,33.0,2,4,2,3,0,1,2,2,1,7,8,2,4,0,2,1,6
401086020,Monmouth Hawks,TEAM,TOTAL,TOTAL,False,,22,55,17,41,5,14,14,17,10,26,36,10,9,2,13,14,63
401086020,Monmouth Hawks,M. Traore,3975762,,True,37.0,3,4,3,4,0,0,0,0,2,7,9,2,3,0,2,3,6
401086020,Monmouth Hawks,D. Quinn,3948714,,True,36.0,6,11,6,11,0,0,2,4,4,5,9,0,0,1,0,4,14
401086020,Monmouth Hawks,M. McClary,4279736,,True,12.0,0,1,0,1,0,0,0,0,1,0,1,0,0,0,0,0,0
401086020,Monmouth Hawks,D. Hammond,4279734,,True,30.0,6,12,2,5,4,7,0,1,0,3,3,0,0,0,3,2,16
401086020,Monmouth Hawks,R. Salnave,4067329,,True,35.0,3,14,3,11,0,3,8,8,1,2,3,3,1,0,3,2,14
401086020,Monmouth Hawks,N. Rutty,4398408,,False,3.0,0,0,0,0,0,0,0,0,0,0,0,0,0,0,0,0,0
401086020,Monmouth Hawks,S. Ibiezugbe,4067330,,False,5.0,0,2,0,2,0,0,0,0,0,0,0,0,1,0,0,0,0
401086020,Monmouth Hawks,M. Martin,4279733,,False,9.0,0,0,0,0,0,0,0,0,0,1,1,0,0,1,0,1,0
401086020,Monmouth Hawks,S. Chaput,4398409,,False,25.0,2,7,1,4,1,3,2,2,1,1,2,3,0,0,1,1,7
401086020,Monmouth Hawks,N. Rutherford,3946977,,False,33.0,2,4,2,3,0,1,2,2,1,7,8,2,4,0,2,1,6
401086020,Monmouth Hawks,TEAM,TOTAL,TOTAL,False,,22,55,17,41,5,14,14,17,10,26,36,10,9,2,13,14,63
401086019,Saint Peter's Peacocks,K. Ndefo,4398386,,True,31.0,0,3,0,3,0,0,3,4,3,4,7,0,1,2,1,4,3
401086019,Saint Peter's Peacocks,S. Idowu,3922042,,True,17.0,3,7,2,5,1,2,0,0,1,2,3,0,1,1,4,4,7
401086019,Saint Peter's Peacocks,D. Watson,4398384,,True,30.0,4,8,2,3,2,5,3,4,0,3,3,2,1,0,6,2,13
401086019,Saint Peter's Peacocks,Q. Taylor,4067357,,True,33.0,2,7,2,5,0,2,0,0,1,4,5,1,3,0,3,1,4
401086019,Saint Peter's Peacocks,D. Turner,4067356,,True,37.0,5,15,4,8,1,7,1,2,1,1,2,3,0,1,2,2,12
401086019,Saint Peter's Peacocks,D. Woods,3919424,,False,16.0,0,0,0,0,0,0,1,2,0,1,1,0,0,1,2,4,1
401086019,Saint Peter's Peacocks,M. Majak,4398387,,False,5.0,0,0,0,0,0,0,0,0,1,0,1,0,0,0,2,1,0
401086019,Saint Peter's Peacocks,C. Underwood,4398388,,False,1.0,0,0,0,0,0,0,0,0,0,1,1,0,0,0,0,0,0
401086019,Saint Peter's Peacocks,K. Brown,4398385,,False,6.0,1,1,0,0,1,1,0,0,0,1,1,0,0,0,2,2,3
401086019,Saint Peter's Peacocks,A. Hicks,4284295,,False,1.0,0,0,0,0,0,0,0,0,0,0,0,0,0,0,0,0,0
401086019,Saint Peter's Peacocks,M. Dixon,4279758,,False,23.0,0,4,0,1,0,3,1,2,1,0,1,1,1,0,0,4,1
401086019,Saint Peter's Peacocks,TEAM,TOTAL,TOTAL,False,,15,45,10,25,5,20,9,14,8,18,26,7,7,5,22,24,44
401086019,Saint Peter's Peacocks,K. Ndefo,4398386,,True,31.0,0,3,0,3,0,0,3,4,3,4,7,0,1,2,1,4,3
401086019,Saint Peter's Peacocks,S. Idowu,3922042,,True,17.0,3,7,2,5,1,2,0,0,1,2,3,0,1,1,4,4,7
401086019,Saint Peter's Peacocks,D. Watson,4398384,,True,30.0,4,8,2,3,2,5,3,4,0,3,3,2,1,0,6,2,13
401086019,Saint Peter's Peacocks,Q. Taylor,4067357,,True,33.0,2,7,2,5,0,2,0,0,1,4,5,1,3,0,3,1,4
401086019,Saint Peter's Peacocks,D. Turner,4067356,,True,37.0,5,15,4,8,1,7,1,2,1,1,2,3,0,1,2,2,12
401086019,Saint Peter's Peacocks,D. Woods,3919424,,False,16.0,0,0,0,0,0,0,1,2,0,1,1,0,0,1,2,4,1
401086019,Saint Peter's Peacocks,M. Majak,4398387,,False,5.0,0,0,0,0,0,0,0,0,1,0,1,0,0,0,2,1,0
401086019,Saint Peter's Peacocks,C. Underwood,4398388,,False,1.0,0,0,0,0,0,0,0,0,0,1,1,0,0,0,0,0,0
401086019,Saint Peter's Peacocks,K. Brown,4398385,,False,6.0,1,1,0,0,1,1,0,0,0,1,1,0,0,0,2,2,3
401086019,Saint Peter's Peacocks,A. Hicks,4284295,,False,1.0,0,0,0,0,0,0,0,0,0,0,0,0,0,0,0,0,0
401086019,Saint Peter's Peacocks,M. Dixon,4279758,,False,23.0,0,4,0,1,0,3,1,2,1,0,1,1,1,0,0,4,1
401086019,Saint Peter's Peacocks,TEAM,TOTAL,TOTAL,False,,15,45,10,25,5,20,9,14,8,18,26,7,7,5,22,24,44
401086019,Monmouth Hawks,M. Traore,3975762,,True,19.0,0,2,0,2,0,0,0,0,1,3,4,0,0,0,1,0,0
401086019,Monmouth Hawks,D. Quinn,3948714,,True,30.0,5,8,5,8,0,0,9,12,3,5,8,0,1,0,1,2,19
401086019,Monmouth Hawks,M. McClary,4279736,,True,11.0,0,0,0,0,0,0,0,0,0,1,1,0,0,0,3,1,0
401086019,Monmouth Hawks,D. Hammond,4279734,,True,25.0,3,7,1,4,2,3,0,0,0,1,1,0,1,0,1,1,8
401086019,Monmouth Hawks,R. Salnave,4067329,,True,20.0,2,4,1,2,1,2,4,5,0,1,1,6,1,0,4,2,9
401086019,Monmouth Hawks,N. Rutty,4398408,,False,8.0,1,1,1,1,0,0,0,0,0,3,3,0,0,0,3,3,2
401086019,Monmouth Hawks,S. Ibiezugbe,4067330,,False,2.0,0,2,0,2,0,0,0,0,1,1,2,0,0,0,0,1,0
401086019,Monmouth Hawks,M. Martin,4279733,,False,19.0,1,3,0,2,1,1,0,0,0,4,4,1,0,0,3,0,3
401086019,Monmouth Hawks,M. James Jr.,4404878,,False,2.0,0,0,0,0,0,0,0,0,0,0,0,0,0,0,0,0,0
401086019,Monmouth Hawks,S. Chaput,4398409,,False,19.0,3,4,2,3,1,1,3,4,0,2,2,1,0,0,1,1,10
401086019,Monmouth Hawks,D. Calloway Jr.,4398407,,False,2.0,0,1,0,0,0,1,0,0,0,0,0,0,0,0,0,0,0
401086019,Monmouth Hawks,G. Papas,4279735,,False,3.0,0,0,0,0,0,0,0,0,0,0,0,0,0,0,0,0,0
401086019,Monmouth Hawks,T. Gross Jr.,4065729,,False,1.0,0,0,0,0,0,0,0,2,1,0,1,0,0,0,0,1,0
401086019,Monmouth Hawks,L. Pillari,3948713,,False,14.0,0,2,0,0,0,2,2,3,1,1,2,0,0,0,2,0,2
401086019,Monmouth Hawks,N. Rutherford,3946977,,False,25.0,2,4,2,4,0,0,4,4,0,4,4,1,3,1,1,4,8
401086019,Monmouth Hawks,TEAM,TOTAL,TOTAL,False,,17,38,12,28,5,10,22,30,8,27,35,9,6,1,22,16,61
401086019,Monmouth Hawks,M. Traore,3975762,,True,19.0,0,2,0,2,0,0,0,0,1,3,4,0,0,0,1,0,0
401086019,Monmouth Hawks,D. Quinn,3948714,,True,30.0,5,8,5,8,0,0,9,12,3,5,8,0,1,0,1,2,19
401086019,Monmouth Hawks,M. McClary,4279736,,True,11.0,0,0,0,0,0,0,0,0,0,1,1,0,0,0,3,1,0
401086019,Monmouth Hawks,D. Hammond,4279734,,True,25.0,3,7,1,4,2,3,0,0,0,1,1,0,1,0,1,1,8
401086019,Monmouth Hawks,R. Salnave,4067329,,True,20.0,2,4,1,2,1,2,4,5,0,1,1,6,1,0,4,2,9
401086019,Monmouth Hawks,N. Rutty,4398408,,False,8.0,1,1,1,1,0,0,0,0,0,3,3,0,0,0,3,3,2
401086019,Monmouth Hawks,S. Ibiezugbe,4067330,,False,2.0,0,2,0,2,0,0,0,0,1,1,2,0,0,0,0,1,0
401086019,Monmouth Hawks,M. Martin,4279733,,False,19.0,1,3,0,2,1,1,0,0,0,4,4,1,0,0,3,0,3
401086019,Monmouth Hawks,M. James Jr.,4404878,,False,2.0,0,0,0,0,0,0,0,0,0,0,0,0,0,0,0,0,0
401086019,Monmouth Hawks,S. Chaput,4398409,,False,19.0,3,4,2,3,1,1,3,4,0,2,2,1,0,0,1,1,10
401086019,Monmouth Hawks,D. Calloway Jr.,4398407,,False,2.0,0,1,0,0,0,1,0,0,0,0,0,0,0,0,0,0,0
401086019,Monmouth Hawks,G. Papas,4279735,,False,3.0,0,0,0,0,0,0,0,0,0,0,0,0,0,0,0,0,0
401086019,Monmouth Hawks,T. Gross Jr.,4065729,,False,1.0,0,0,0,0,0,0,0,2,1,0,1,0,0,0,0,1,0
401086019,Monmouth Hawks,L. Pillari,3948713,,False,14.0,0,2,0,0,0,2,2,3,1,1,2,0,0,0,2,0,2
401086019,Monmouth Hawks,N. Rutherford,3946977,,False,25.0,2,4,2,4,0,0,4,4,0,4,4,1,3,1,1,4,8
401086019,Monmouth Hawks,TEAM,TOTAL,TOTAL,False,,17,38,12,28,5,10,22,30,8,27,35,9,6,1,22,16,61
401086018,Pennsylvania Quakers,A. Brodeur,4066838,,True,40.0,7,14,7,14,0,0,6,13,3,6,9,4,2,1,3,3,20
401086018,Pennsylvania Quakers,J. Silpe,3906967,,True,19.0,1,2,1,2,0,0,1,2,0,1,1,1,2,0,2,3,3
401086018,Pennsylvania Quakers,A. Woods,3155740,,True,43.0,5,18,2,8,3,10,6,6,3,9,12,2,2,0,3,1,19
401086018,Pennsylvania Quakers,B. Washington,4397982,,True,39.0,5,12,0,2,5,10,2,2,4,1,5,1,3,0,1,3,17
401086018,Pennsylvania Quakers,D. Goodman,4066839,,True,39.0,1,8,0,2,1,6,3,6,0,0,0,1,3,1,1,3,6
401086018,Pennsylvania Quakers,J. Simmons,4279562,,False,18.0,0,0,0,0,0,0,0,1,3,2,5,0,0,0,0,4,0
401086018,Pennsylvania Quakers,K. Mijakowski,4066842,,False,16.0,2,7,1,1,1,6,0,0,2,2,4,3,0,0,1,2,5
401086018,Pennsylvania Quakers,J. Donahue,3906968,,False,5.0,1,2,0,0,1,2,1,1,0,0,0,1,0,0,2,0,4
401086018,Pennsylvania Quakers,E. Scott,4279560,,False,6.0,0,0,0,0,0,0,0,0,0,0,0,1,0,0,1,0,0
401086018,Pennsylvania Quakers,TEAM,TOTAL,TOTAL,False,,22,63,11,29,11,34,19,31,19,23,42,14,12,2,14,19,74
401086018,Monmouth Hawks,N. Rutty,4398408,,True,17.0,1,2,1,2,0,0,0,0,1,1,2,0,1,0,0,3,2
401086018,Monmouth Hawks,M. Traore,3975762,,True,27.0,4,9,4,9,0,0,1,1,5,0,5,0,1,0,2,5,9
401086018,Monmouth Hawks,M. McClary,4279736,,True,21.0,0,2,0,2,0,0,2,2,0,3,3,2,0,0,3,2,2
401086018,Monmouth Hawks,D. Hammond,4279734,,True,17.0,1,4,1,1,0,3,0,0,1,1,2,1,2,0,1,2,2
401086018,Monmouth Hawks,R. Salnave,4067329,,True,27.0,5,8,2,4,3,4,4,6,2,2,4,2,2,0,4,2,17
401086018,Monmouth Hawks,S. Ibiezugbe,4067330,,False,1.0,0,0,0,0,0,0,0,0,0,0,0,0,0,0,0,0,0
401086018,Monmouth Hawks,D. Quinn,3948714,,False,31.0,6,14,6,14,0,0,7,9,7,7,14,0,0,2,1,3,19
401086018,Monmouth Hawks,M. Martin,4279733,,False,21.0,2,4,1,2,1,2,1,2,0,1,1,1,0,0,0,4,6
401086018,Monmouth Hawks,S. Chaput,4398409,,False,9.0,1,1,1,1,0,0,2,3,0,4,4,0,0,0,2,1,4
401086018,Monmouth Hawks,G. Papas,4279735,,False,10.0,0,3,0,1,0,2,0,0,0,2,2,0,0,0,0,0,0
401086018,Monmouth Hawks,L. Pillari,3948713,,False,22.0,6,11,5,9,1,2,0,0,0,3,3,2,0,0,1,1,13
401086018,Monmouth Hawks,N. Rutherford,3946977,,False,22.0,1,4,1,4,0,0,0,0,0,2,2,2,0,0,1,2,2
401086018,Monmouth Hawks,TEAM,TOTAL,TOTAL,False,,27,62,22,49,5,13,17,23,18,29,47,10,6,2,15,25,76
401086017,Yale Bulldogs,J. Bruner,4066850,,True,32.0,4,9,3,6,1,3,0,0,2,7,9,4,1,4,3,2,9
401086017,Yale Bulldogs,B. Reynolds,3906996,,True,27.0,4,6,4,5,0,1,2,4,3,5,8,3,1,1,3,0,10
401086017,Yale Bulldogs,M. Oni,4066851,,True,30.0,7,14,3,8,4,6,2,4,0,7,7,3,1,1,1,4,20
401086017,Yale Bulldogs,T. Phills,3906995,,True,22.0,1,7,1,4,0,3,0,0,1,2,3,3,0,0,3,2,2
401086017,Yale Bulldogs,A. Copeland,3906992,,True,23.0,1,5,1,3,0,2,2,2,0,0,0,3,0,0,2,1,4
401086017,Yale Bulldogs,P. Atkinson Jr.,4279699,,False,22.0,1,1,1,1,0,0,2,4,4,2,6,0,1,1,2,2,4
401086017,Yale Bulldogs,A. Swain,4279697,,False,24.0,4,8,0,2,4,6,2,4,0,3,3,1,0,0,1,3,14
401086017,Yale Bulldogs,J. Gabbidon,4279696,,False,7.0,0,2,0,0,0,2,0,0,0,0,0,0,0,0,0,0,0
401086017,Yale Bulldogs,E. Monroe,4066848,,False,13.0,1,3,0,2,1,1,0,0,2,0,2,0,0,0,1,2,3
401086017,Yale Bulldogs,TEAM,TOTAL,TOTAL,False,,23,55,13,31,10,24,10,18,12,27,39,17,4,7,16,16,66
401086017,Monmouth Hawks,N. Rutty,4398408,,True,20.0,1,4,1,4,0,0,3,6,3,2,5,1,0,0,1,3,5
401086017,Monmouth Hawks,M. Traore,3975762,,True,29.0,3,7,3,7,0,0,0,1,4,8,12,0,1,0,1,2,6
401086017,Monmouth Hawks,M. McClary,4279736,,True,18.0,2,2,2,2,0,0,3,4,0,0,0,0,0,0,2,1,7
401086017,Monmouth Hawks,R. Salnave,4067329,,True,29.0,5,14,5,12,0,2,5,6,3,4,7,1,2,0,3,4,15
401086017,Monmouth Hawks,L. Pillari,3948713,,True,22.0,1,10,1,7,0,3,0,0,0,2,2,2,1,0,0,1,2
401086017,Monmouth Hawks,S. Ibiezugbe,4067330,,False,7.0,0,0,0,0,0,0,0,0,0,1,1,0,0,0,0,0,0
401086017,Monmouth Hawks,D. Quinn,3948714,,False,22.0,2,4,2,4,0,0,0,0,1,1,2,0,0,0,3,2,4
401086017,Monmouth Hawks,M. Martin,4279733,,False,16.0,3,3,2,2,1,1,2,2,0,0,0,0,2,1,0,3,9
401086017,Monmouth Hawks,G. Papas,4279735,,False,16.0,3,8,3,4,0,4,1,1,0,3,3,0,1,1,1,0,7
401086017,Monmouth Hawks,N. Rutherford,3946977,,False,21.0,1,4,1,3,0,1,1,2,0,5,5,4,0,0,1,2,3
401086017,Monmouth Hawks,TEAM,TOTAL,TOTAL,False,,21,56,20,45,1,11,15,22,12,26,38,8,7,2,14,18,58
401086016,UAlbany Great Danes,A. Lulka,4278204,,True,25.0,1,1,0,0,1,1,4,5,1,2,3,1,0,0,0,4,7
401086016,UAlbany Great Danes,D. Campbell,4066683,,True,32.0,3,8,0,3,3,5,2,2,1,4,5,1,1,0,3,2,11
401086016,UAlbany Great Danes,B. Hank,4278202,,True,24.0,2,2,2,2,0,0,3,3,2,1,3,1,1,2,2,5,7
401086016,UAlbany Great Danes,C. Healy,4278203,,True,33.0,3,11,0,2,3,9,2,3,0,1,1,4,0,0,2,2,11
401086016,UAlbany Great Danes,A. Clark,4278199,,True,36.0,7,12,3,6,4,6,11,12,1,5,6,3,3,1,2,1,29
401086016,UAlbany Great Danes,K. Lauderdale,4395878,,False,1.0,0,0,0,0,0,0,0,0,0,0,0,0,0,0,0,0,0
401086016,UAlbany Great Danes,M. De Sousa,4395874,,False,9.0,0,2,0,1,0,1,0,0,0,0,0,0,0,0,1,0,0
401086016,UAlbany Great Danes,S. French,4066754,,False,9.0,1,2,1,2,0,0,0,0,1,1,2,1,0,1,2,1,2
401086016,UAlbany Great Danes,R. Brooks,4395875,,False,1.0,0,0,0,0,0,0,0,0,0,1,1,0,0,0,0,0,0
401086016,UAlbany Great Danes,A. Rizzuto,4395873,,False,22.0,3,6,0,0,3,6,4,5,1,1,2,3,2,0,2,3,13
401086016,UAlbany Great Danes,N. Fruscio,4066685,,False,1.0,1,1,1,1,0,0,0,0,0,0,0,0,0,0,0,0,2
401086016,UAlbany Great Danes,R. Miller,3961485,,False,7.0,0,1,0,0,0,1,0,0,0,0,0,1,0,0,0,1,0
401086016,UAlbany Great Danes,TEAM,TOTAL,TOTAL,False,,21,46,7,17,14,29,26,30,8,19,27,15,7,4,16,19,82
401086016,Monmouth Hawks,N. Rutty,4398408,,True,25.0,1,4,1,4,0,0,0,4,1,1,2,1,0,0,1,4,2
401086016,Monmouth Hawks,M. Traore,3975762,,True,28.0,5,7,5,7,0,0,0,0,5,2,7,0,0,0,2,4,10
401086016,Monmouth Hawks,M. McClary,4279736,,True,20.0,0,1,0,1,0,0,0,0,1,2,3,1,1,0,2,2,0
401086016,Monmouth Hawks,D. Hammond,4279734,,True,26.0,3,11,2,5,1,6,0,0,1,3,4,1,1,1,4,3,7
401086016,Monmouth Hawks,R. Salnave,4067329,,True,39.0,9,23,7,14,2,9,5,7,3,4,7,4,1,0,5,3,25
401086016,Monmouth Hawks,D. Quinn,3948714,,False,25.0,1,4,1,4,0,0,2,4,4,1,5,0,1,0,0,3,4
401086016,Monmouth Hawks,L. Pillari,3948713,,False,13.0,2,4,1,1,1,3,2,2,0,0,0,1,1,0,0,2,7
401086016,Monmouth Hawks,N. Rutherford,3946977,,False,24.0,3,6,2,4,1,2,1,2,1,5,6,2,2,0,2,3,8
401086016,Monmouth Hawks,TEAM,TOTAL,TOTAL,False,,24,60,19,40,5,20,10,19,19,21,40,10,7,1,18,24,63
401086015,Monmouth Hawks,M. Traore,3975762,,True,28.0,4,8,4,8,0,0,0,2,3,7,10,2,0,1,2,3,8
401086015,Monmouth Hawks,D. Quinn,3948714,,True,25.0,2,6,2,6,0,0,2,2,0,5,5,0,0,2,4,3,6
401086015,Monmouth Hawks,M. McClary,4279736,,True,18.0,1,3,1,3,0,0,0,1,1,0,1,1,0,0,2,2,2
401086015,Monmouth Hawks,D. Hammond,4279734,,True,24.0,3,12,1,7,2,5,0,0,0,2,2,2,0,0,2,0,8
401086015,Monmouth Hawks,R. Salnave,4067329,,True,22.0,3,5,2,3,1,2,1,1,0,2,2,0,1,0,1,5,8
401086015,Monmouth Hawks,N. Rutty,4398408,,False,12.0,0,0,0,0,0,0,2,6,1,0,1,0,0,0,1,1,2
401086015,Monmouth Hawks,S. Ibiezugbe,4067330,,False,16.0,3,5,3,5,0,0,0,1,2,0,2,0,1,0,0,1,6
401086015,Monmouth Hawks,M. Martin,4279733,,False,10.0,0,1,0,1,0,0,0,0,0,0,0,4,0,0,0,0,0
401086015,Monmouth Hawks,S. Chaput,4398409,,False,2.0,0,0,0,0,0,0,0,0,0,1,1,0,0,0,0,0,0
401086015,Monmouth Hawks,G. Papas,4279735,,False,13.0,0,6,0,0,0,6,1,2,0,1,1,0,2,0,0,0,1
401086015,Monmouth Hawks,L. Pillari,3948713,,False,15.0,0,3,0,2,0,1,0,0,1,5,6,2,0,1,3,2,0
401086015,Monmouth Hawks,N. Rutherford,3946977,,False,15.0,1,3,1,2,0,1,0,0,0,5,5,1,0,0,2,1,2
401086015,Monmouth Hawks,TEAM,TOTAL,TOTAL,False,,17,52,14,37,3,15,6,15,8,29,37,12,4,4,18,18,43
401086015,Bucknell Bison,N. Sestina,3914279,,True,33.0,6,9,4,5,2,4,2,4,0,10,10,0,0,3,2,2,16
401086015,Bucknell Bison,B. Moore,4067103,,True,20.0,2,4,1,2,1,2,0,0,0,3,3,1,0,0,0,3,5
401086015,Bucknell Bison,J. Sotos,4280044,,True,28.0,3,9,1,2,2,7,2,2,0,4,4,7,3,0,3,2,10
401086015,Bucknell Bison,A. Toomer,4067102,,True,26.0,6,12,3,5,3,7,2,3,0,2,2,1,4,0,3,2,17
401086015,Bucknell Bison,K. Mackenzie,3914278,,True,34.0,1,8,0,2,1,6,6,7,1,4,5,4,1,0,1,0,9
401086015,Bucknell Bison,K. Spear,4397651,,False,3.0,0,1,0,1,0,0,0,0,0,1,1,0,0,0,0,1,0
401086015,Bucknell Bison,P. Newman,4280043,,False,9.0,1,1,1,1,0,0,0,0,1,1,2,0,0,1,0,4,2
401086015,Bucknell Bison,W. Ellis,4397649,,False,12.0,0,2,0,1,0,1,0,0,1,0,1,0,0,0,0,1,0
401086015,Bucknell Bison,A. Funk,4397650,,False,14.0,2,4,0,0,2,4,0,0,1,0,1,0,1,0,2,0,6
401086015,Bucknell Bison,J. Sechan,4280045,,False,3.0,0,0,0,0,0,0,0,0,0,0,0,0,0,0,0,0,0
401086015,Bucknell Bison,B. Robertson,4067104,,False,15.0,0,0,0,0,0,0,0,2,0,3,3,1,1,0,0,0,0
401086015,Bucknell Bison,N. Jones,3914280,,False,3.0,0,3,0,0,0,3,0,0,0,0,0,0,0,0,0,0,0
401086015,Bucknell Bison,TEAM,TOTAL,TOTAL,False,,21,53,10,19,11,34,12,18,5,31,36,14,10,4,11,15,65
401086014,Princeton Tigers,R. Schwieger,4279565,,True,0.0,0,3,0,1,0,2,0,0,0,0,0,0,0,0,0,2,0
401086014,Princeton Tigers,R. Aririguzoh,4066847,,True,0.0,1,2,1,2,0,0,2,5,1,4,5,0,0,1,2,3,4
401086014,Princeton Tigers,E. Wright,4398005,,True,0.0,2,4,2,4,0,0,1,1,2,0,2,0,0,0,0,3,5
401086014,Princeton Tigers,M. Stephens,3906978,,True,0.0,4,11,3,7,1,4,4,4,3,6,9,1,0,2,3,1,13
401086014,Princeton Tigers,D. Cannady,3906977,,True,0.0,7,14,2,3,5,11,2,2,0,3,3,1,1,0,1,1,21
401086014,Princeton Tigers,D. Friberg,4398004,,False,0.0,0,1,0,0,0,1,0,0,0,0,0,1,0,0,0,1,0
401086014,Princeton Tigers,S. Much,4279568,,False,0.0,0,2,0,0,0,2,0,0,0,1,1,1,0,0,1,3,0
401086014,Princeton Tigers,J. Desrosiers,4279566,,False,0.0,0,0,0,0,0,0,0,0,0,1,1,0,0,0,0,1,0
401086014,Princeton Tigers,W. Gladson,4066846,,False,0.0,1,1,1,1,0,0,0,0,0,0,0,0,0,0,0,0,2
401086014,Princeton Tigers,M. Johns,4398003,,False,0.0,2,7,1,2,1,5,0,0,0,1,1,0,1,0,1,5,5
401086014,Princeton Tigers,J. Morales,4066845,,False,0.0,4,9,3,5,1,4,1,1,1,1,2,6,4,0,2,1,10
401086014,Princeton Tigers,TEAM,TOTAL,TOTAL,False,,21,54,13,25,8,29,10,13,9,18,27,10,6,3,11,21,60
401086014,Monmouth Hawks,M. Traore,3975762,,True,0.0,3,7,3,7,0,0,4,4,3,3,6,0,1,0,3,1,10
401086014,Monmouth Hawks,D. Hammond,4279734,,True,0.0,3,7,1,4,2,3,2,3,0,0,0,1,0,0,5,4,10
401086014,Monmouth Hawks,R. Salnave,4067329,,True,0.0,4,7,3,4,1,3,3,4,2,7,9,3,1,1,1,4,12
401086014,Monmouth Hawks,L. Pillari,3948713,,True,0.0,3,9,1,2,2,7,5,5,0,4,4,0,1,0,1,2,13
401086014,Monmouth Hawks,N. Rutherford,3946977,,True,0.0,3,5,3,3,0,2,3,4,0,8,8,2,1,0,3,1,9
401086014,Monmouth Hawks,D. Quinn,3948714,,False,0.0,0,2,0,2,0,0,3,4,1,2,3,0,0,0,0,4,3
401086014,Monmouth Hawks,M. Martin,4279733,,False,0.0,0,3,0,2,0,1,0,1,1,0,1,0,0,0,2,1,0
401086014,Monmouth Hawks,S. Chaput,4398409,,False,0.0,0,1,0,1,0,0,0,0,0,0,0,1,0,0,0,0,0
401086014,Monmouth Hawks,M. McClary,4279736,,False,0.0,0,0,0,0,0,0,0,0,1,0,1,0,0,0,0,0,0
401086014,Monmouth Hawks,G. Papas,4279735,,False,0.0,0,1,0,0,0,1,0,0,0,0,0,0,0,0,0,0,0
401086014,Monmouth Hawks,T. Gross Jr.,4065729,,False,0.0,0,0,0,0,0,0,0,0,0,0,0,0,0,0,0,0,0
401086014,Monmouth Hawks,TEAM,TOTAL,TOTAL,False,,16,42,11,25,5,17,20,25,9,26,35,7,4,1,17,17,57
401086013,Monmouth Hawks,M. Traore,3975762,,True,26.0,1,6,1,6,0,0,1,4,3,1,4,0,2,0,3,3,3
401086013,Monmouth Hawks,M. McClary,4279736,,True,30.0,3,5,3,5,0,0,2,3,3,2,5,3,1,1,4,1,8
401086013,Monmouth Hawks,D. Hammond,4279734,,True,31.0,4,13,0,5,4,8,2,2,0,4,4,2,0,1,2,3,14
401086013,Monmouth Hawks,R. Salnave,4067329,,True,26.0,6,12,5,8,1,4,3,3,1,3,4,3,2,0,2,3,16
401086013,Monmouth Hawks,N. Rutherford,3946977,,True,19.0,2,3,2,3,0,0,4,4,1,5,6,3,0,0,1,4,8
401086013,Monmouth Hawks,N. Rutty,4398408,,False,7.0,0,1,0,1,0,0,0,0,1,1,2,0,0,0,0,1,0
401086013,Monmouth Hawks,S. Ibiezugbe,4067330,,False,3.0,1,2,1,2,0,0,2,2,0,1,1,0,0,0,0,1,4
401086013,Monmouth Hawks,D. Quinn,3948714,,False,5.0,1,2,1,2,0,0,2,2,1,0,1,0,0,0,3,1,4
401086013,Monmouth Hawks,M. Martin,4279733,,False,9.0,0,0,0,0,0,0,0,0,1,0,1,0,0,0,1,2,0
401086013,Monmouth Hawks,S. Chaput,4398409,,False,14.0,0,1,0,1,0,0,4,4,0,0,0,1,1,0,0,0,4
401086013,Monmouth Hawks,G. Papas,4279735,,False,13.0,1,4,0,0,1,4,0,0,0,0,0,0,2,1,0,3,3
401086013,Monmouth Hawks,L. Pillari,3948713,,False,17.0,3,8,3,6,0,2,4,4,0,1,1,1,0,1,2,2,10
401086013,Monmouth Hawks,TEAM,TOTAL,TOTAL,False,,22,57,16,39,6,18,24,28,12,20,32,13,8,4,18,24,74
401086013,Colgate Raiders,W. Rayman,4067106,,True,31.0,5,9,2,6,3,3,2,2,2,2,4,3,0,0,3,4,15
401086013,Colgate Raiders,R. Ivanauskas,4066395,,True,36.0,8,12,6,6,2,6,4,4,5,5,10,2,1,0,5,4,22
401086013,Colgate Raiders,D. Batt,3921438,,True,15.0,2,4,2,4,0,0,5,5,0,0,0,1,0,0,1,0,9
401086013,Colgate Raiders,J. Burns,4280047,,True,37.0,8,19,3,9,5,10,9,12,0,5,5,6,1,0,3,3,30
401086013,Colgate Raiders,F. Amiel,3921440,,True,25.0,1,4,0,0,1,4,0,0,0,3,3,3,0,0,1,2,3
401086013,Colgate Raiders,M. Regisford,3921437,,False,13.0,0,1,0,1,0,0,2,4,2,2,4,0,0,1,1,4,2
401086013,Colgate Raiders,T. Richardson,4398040,,False,26.0,2,6,0,1,2,5,0,1,1,5,6,1,0,0,1,4,6
401086013,Colgate Raiders,Z. Light,4398038,,False,3.0,0,0,0,0,0,0,0,0,0,2,2,0,0,0,1,0,0
401086013,Colgate Raiders,J. Ferguson,4280048,,False,14.0,0,1,0,0,0,1,0,0,0,1,1,1,0,0,2,3,0
401086013,Colgate Raiders,TEAM,TOTAL,TOTAL,False,,26,56,13,27,13,29,22,28,13,26,39,17,2,1,19,24,87
401086012,Monmouth Hawks,M. Traore,3975762,,True,20.0,1,4,1,4,0,0,3,4,1,4,5,1,1,1,3,1,5
401086012,Monmouth Hawks,M. McClary,4279736,,True,18.0,2,5,2,5,0,0,0,0,1,2,3,0,1,0,2,5,4
401086012,Monmouth Hawks,D. Hammond,4279734,,True,25.0,7,16,3,5,4,11,3,3,0,1,1,0,0,1,3,0,21
401086012,Monmouth Hawks,R. Salnave,4067329,,True,20.0,1,5,1,2,0,3,0,0,0,0,0,6,4,1,1,4,2
401086012,Monmouth Hawks,N. Rutherford,3946977,,True,19.0,0,2,0,2,0,0,4,4,0,4,4,0,0,1,0,0,4
401086012,Monmouth Hawks,N. Rutty,4398408,,False,17.0,2,3,2,3,0,0,0,1,0,3,3,1,0,0,1,2,4
401086012,Monmouth Hawks,D. Quinn,3948714,,False,7.0,0,2,0,2,0,0,0,0,0,0,0,0,0,0,1,1,0
401086012,Monmouth Hawks,M. Martin,4279733,,False,19.0,2,4,2,4,0,0,0,1,1,2,3,1,0,1,0,4,4
401086012,Monmouth Hawks,S. Chaput,4398409,,False,12.0,1,2,1,2,0,0,4,4,0,1,1,0,0,0,0,3,6
401086012,Monmouth Hawks,G. Papas,4279735,,False,18.0,1,6,1,1,0,5,4,5,0,3,3,2,1,0,2,1,6
401086012,Monmouth Hawks,T. Gross Jr.,4065729,,False,10.0,0,1,0,1,0,0,0,0,0,1,1,0,2,0,1,1,0
401086012,Monmouth Hawks,L. Pillari,3948713,,False,15.0,2,6,2,4,0,2,1,2,0,1,1,0,0,0,2,1,5
401086012,Monmouth Hawks,TEAM,TOTAL,TOTAL,False,,19,56,15,35,4,21,19,24,5,23,28,11,9,5,16,23,61
401086012,Lehigh Mountain Hawks,P. Andree,4067122,,True,30.0,9,15,3,5,6,10,7,10,2,6,8,2,2,0,1,1,31
401086012,Lehigh Mountain Hawks,J. Karnik,4280080,,True,23.0,1,2,1,2,0,0,2,3,1,5,6,0,0,0,1,3,4
401086012,Lehigh Mountain Hawks,J. Cohen,4067120,,True,28.0,5,9,3,4,2,5,3,5,2,3,5,4,1,2,1,4,15
401086012,Lehigh Mountain Hawks,K. Leufroy,3908514,,True,27.0,4,6,1,1,3,5,0,0,0,9,9,4,1,0,1,1,11
401086012,Lehigh Mountain Hawks,L. Tejada,3147354,,True,31.0,2,14,2,8,0,6,0,0,0,4,4,4,1,0,4,3,4
401086012,Lehigh Mountain Hawks,J. Wilson,4398116,,False,16.0,0,1,0,1,0,0,3,4,1,4,5,0,0,0,2,1,3
401086012,Lehigh Mountain Hawks,S. Acoveno,4280082,,False,2.0,0,0,0,0,0,0,0,0,0,0,0,0,0,1,0,1,0
401086012,Lehigh Mountain Hawks,N. Lynch,4398119,,False,9.0,5,7,5,7,0,0,0,2,2,1,3,0,0,0,2,4,10
401086012,Lehigh Mountain Hawks,D. Roelke,4403408,,False,2.0,1,1,1,1,0,0,0,0,0,0,0,0,0,0,0,0,2
401086012,Lehigh Mountain Hawks,Z. Farrell,4398118,,False,2.0,0,0,0,0,0,0,0,0,0,0,0,1,0,0,0,0,0
401086012,Lehigh Mountain Hawks,J. Foley,4398117,,False,6.0,1,2,1,2,0,0,0,0,0,2,2,0,0,0,2,1,2
401086012,Lehigh Mountain Hawks,M. Wilson,4280081,,False,9.0,0,0,0,0,0,0,0,0,0,0,0,0,0,0,0,0,0
401086012,Lehigh Mountain Hawks,C. Bennett,4280078,,False,15.0,1,2,1,1,0,1,1,1,0,0,0,0,2,0,3,4,3
401086012,Lehigh Mountain Hawks,TEAM,TOTAL,TOTAL,False,,29,59,18,32,11,27,16,25,11,36,47,15,7,3,18,23,85
401086011,Siena Saints,S. Seymour,4398391,,True,25.0,2,7,0,0,2,7,0,0,0,0,0,0,0,0,0,0,6
401086011,Siena Saints,E. Fisher,3913235,,True,43.0,6,13,6,11,0,2,3,4,1,9,10,0,0,0,0,1,15
401086011,Siena Saints,K. Degnan,3138282,,True,44.0,3,8,0,0,3,8,3,6,1,7,8,1,1,0,1,3,12
401086011,Siena Saints,J. Pickett,4398390,,True,44.0,8,20,5,9,3,11,8,8,2,4,6,8,3,2,1,4,27
401086011,Siena Saints,M. Camper,4279751,,True,33.0,1,7,1,5,0,2,2,2,0,1,1,0,2,1,0,3,4
401086011,Siena Saints,T. Huerter Jr.,4067350,,False,1.0,0,0,0,0,0,0,0,0,0,0,0,0,0,0,0,0,0
401086011,Siena Saints,K. Smithen,3133848,,False,35.0,2,6,2,4,0,2,4,4,3,5,8,0,1,3,1,2,8
401086011,Siena Saints,TEAM,TOTAL,TOTAL,False,,22,61,14,29,8,32,20,24,7,27,34,9,7,6,6,13,72
401086011,Siena Saints,S. Seymour,4398391,,True,25.0,2,7,0,0,2,7,0,0,0,0,0,0,0,0,0,0,6
401086011,Siena Saints,E. Fisher,3913235,,True,43.0,6,13,6,11,0,2,3,4,1,9,10,0,0,0,0,1,15
401086011,Siena Saints,K. Degnan,3138282,,True,44.0,3,8,0,0,3,8,3,6,1,7,8,1,1,0,1,3,12
401086011,Siena Saints,J. Pickett,4398390,,True,44.0,8,20,5,9,3,11,8,8,2,4,6,8,3,2,1,4,27
401086011,Siena Saints,M. Camper,4279751,,True,33.0,1,7,1,5,0,2,2,2,0,1,1,0,2,1,0,3,4
401086011,Siena Saints,T. Huerter Jr.,4067350,,False,1.0,0,0,0,0,0,0,0,0,0,0,0,0,0,0,0,0,0
401086011,Siena Saints,K. Smithen,3133848,,False,35.0,2,6,2,4,0,2,4,4,3,5,8,0,1,3,1,2,8
401086011,Siena Saints,TEAM,TOTAL,TOTAL,False,,22,61,14,29,8,32,20,24,7,27,34,9,7,6,6,13,72
401086011,Niagara Purple Eagles,D. Robb,3907186,,True,21.0,1,5,1,4,0,1,0,0,0,0,0,0,0,0,2,1,2
401086011,Niagara Purple Eagles,M. Prochet,3907184,,True,44.0,8,19,5,10,3,9,2,4,2,8,10,2,0,0,1,4,21
401086011,Niagara Purple Eagles,G. King,3906490,,True,32.0,5,7,5,7,0,0,0,0,0,11,11,0,0,3,1,2,10
401086011,Niagara Purple Eagles,M. Hammond,4398404,,True,37.0,1,7,0,3,1,4,0,0,0,4,4,0,0,0,3,4,3
401086011,Niagara Purple Eagles,C. Barton,3907182,,True,30.0,4,7,3,4,1,3,7,9,2,3,5,0,0,0,2,3,16
401086011,Niagara Purple Eagles,G. Kuakumensah,4279739,,False,1.0,0,0,0,0,0,0,0,0,0,0,0,0,0,0,0,0,0
401086011,Niagara Purple Eagles,R. Solomon,4398403,,False,34.0,3,8,1,2,2,6,0,0,1,1,2,1,0,0,4,3,8
401086011,Niagara Purple Eagles,K. Tate,4279738,,False,5.0,1,2,1,1,0,1,0,0,0,0,0,0,0,0,0,0,2
401086011,Niagara Purple Eagles,D. Fragala,4279737,,False,8.0,1,1,0,0,1,1,0,0,0,0,0,0,0,0,0,0,3
401086011,Niagara Purple Eagles,J. Towns,4067341,,False,13.0,0,2,0,2,0,0,0,0,0,2,2,1,0,0,1,1,0
401086011,Niagara Purple Eagles,TEAM,TOTAL,TOTAL,False,,24,58,16,33,8,25,9,13,9,32,41,4,0,3,14,18,65
401086011,Niagara Purple Eagles,D. Robb,3907186,,True,21.0,1,5,1,4,0,1,0,0,0,0,0,0,0,0,2,1,2
401086011,Niagara Purple Eagles,M. Prochet,3907184,,True,44.0,8,19,5,10,3,9,2,4,2,8,10,2,0,0,1,4,21
401086011,Niagara Purple Eagles,G. King,3906490,,True,32.0,5,7,5,7,0,0,0,0,0,11,11,0,0,3,1,2,10
401086011,Niagara Purple Eagles,M. Hammond,4398404,,True,37.0,1,7,0,3,1,4,0,0,0,4,4,0,0,0,3,4,3
401086011,Niagara Purple Eagles,C. Barton,3907182,,True,30.0,4,7,3,4,1,3,7,9,2,3,5,0,0,0,2,3,16
401086011,Niagara Purple Eagles,G. Kuakumensah,4279739,,False,1.0,0,0,0,0,0,0,0,0,0,0,0,0,0,0,0,0,0
401086011,Niagara Purple Eagles,R. Solomon,4398403,,False,34.0,3,8,1,2,2,6,0,0,1,1,2,1,0,0,4,3,8
401086011,Niagara Purple Eagles,K. Tate,4279738,,False,5.0,1,2,1,1,0,1,0,0,0,0,0,0,0,0,0,0,2
401086011,Niagara Purple Eagles,D. Fragala,4279737,,False,8.0,1,1,0,0,1,1,0,0,0,0,0,0,0,0,0,0,3
401086011,Niagara Purple Eagles,J. Towns,4067341,,False,13.0,0,2,0,2,0,0,0,0,0,2,2,1,0,0,1,1,0
401086011,Niagara Purple Eagles,TEAM,TOTAL,TOTAL,False,,24,58,16,33,8,25,9,13,9,32,41,4,0,3,14,18,65
401086010,Saint Peter's Peacocks,KC Ndefo,4398386,,True,34.0,3,6,3,5,0,1,4,5,2,8,10,1,0,2,2,3,10
401086010,Saint Peter's Peacocks,S. Idowu,3922042,,True,27.0,7,12,6,11,1,1,0,0,1,8,9,1,0,2,1,4,15
401086010,Saint Peter's Peacocks,Q. Taylor,4067357,,True,24.0,2,3,2,3,0,0,2,2,2,2,4,2,0,2,0,2,6
401086010,Saint Peter's Peacocks,D. Watson,4398384,,True,36.0,2,8,2,4,0,4,5,7,0,1,1,4,0,0,0,2,9
401086010,Saint Peter's Peacocks,D. Turner,4067356,,True,34.0,10,19,4,7,6,12,2,2,1,1,2,2,2,0,0,2,28
401086010,Saint Peter's Peacocks,D. Woods,3919424,,False,9.0,2,4,2,4,0,0,2,2,2,5,7,0,0,0,2,4,6
401086010,Saint Peter's Peacocks,M. Majak,4398387,,False,2.0,0,0,0,0,0,0,0,0,0,0,0,0,0,1,0,2,0
401086010,Saint Peter's Peacocks,C. Underwood,4398388,,False,1.0,0,0,0,0,0,0,0,0,0,0,0,0,0,0,0,0,0
401086010,Saint Peter's Peacocks,A. Hicks,4284295,,False,4.0,0,0,0,0,0,0,0,0,0,0,0,1,0,1,0,0,0
401086010,Saint Peter's Peacocks,M. Johnson,4279759,,False,1.0,0,0,0,0,0,0,0,0,0,0,0,0,0,0,0,0,0
401086010,Saint Peter's Peacocks,M. Dixon,4279758,,False,28.0,2,4,2,4,0,0,0,0,2,3,5,0,0,0,1,0,4
401086010,Saint Peter's Peacocks,TEAM,TOTAL,TOTAL,False,,28,56,21,38,7,18,15,18,11,28,39,11,2,8,7,19,78
401086010,Saint Peter's Peacocks,KC Ndefo,4398386,,True,34.0,3,6,3,5,0,1,4,5,2,8,10,1,0,2,2,3,10
401086010,Saint Peter's Peacocks,S. Idowu,3922042,,True,27.0,7,12,6,11,1,1,0,0,1,8,9,1,0,2,1,4,15
401086010,Saint Peter's Peacocks,Q. Taylor,4067357,,True,24.0,2,3,2,3,0,0,2,2,2,2,4,2,0,2,0,2,6
401086010,Saint Peter's Peacocks,D. Watson,4398384,,True,36.0,2,8,2,4,0,4,5,7,0,1,1,4,0,0,0,2,9
401086010,Saint Peter's Peacocks,D. Turner,4067356,,True,34.0,10,19,4,7,6,12,2,2,1,1,2,2,2,0,0,2,28
401086010,Saint Peter's Peacocks,D. Woods,3919424,,False,9.0,2,4,2,4,0,0,2,2,2,5,7,0,0,0,2,4,6
401086010,Saint Peter's Peacocks,M. Majak,4398387,,False,2.0,0,0,0,0,0,0,0,0,0,0,0,0,0,1,0,2,0
401086010,Saint Peter's Peacocks,C. Underwood,4398388,,False,1.0,0,0,0,0,0,0,0,0,0,0,0,0,0,0,0,0,0
401086010,Saint Peter's Peacocks,A. Hicks,4284295,,False,4.0,0,0,0,0,0,0,0,0,0,0,0,1,0,1,0,0,0
401086010,Saint Peter's Peacocks,M. Johnson,4279759,,False,1.0,0,0,0,0,0,0,0,0,0,0,0,0,0,0,0,0,0
401086010,Saint Peter's Peacocks,M. Dixon,4279758,,False,28.0,2,4,2,4,0,0,0,0,2,3,5,0,0,0,1,0,4
401086010,Saint Peter's Peacocks,TEAM,TOTAL,TOTAL,False,,28,56,21,38,7,18,15,18,11,28,39,11,2,8,7,19,78
401086010,Niagara Purple Eagles,M. Prochet,3907184,,True,35.0,3,9,1,4,2,5,3,4,0,1,1,1,1,0,1,3,11
401086010,Niagara Purple Eagles,G. King,3906490,,True,15.0,0,2,0,2,0,0,1,4,1,2,3,0,0,1,0,1,1
401086010,Niagara Purple Eagles,M. Hammond,4398404,,True,32.0,4,8,3,4,1,4,0,0,2,1,3,2,1,0,1,5,9
401086010,Niagara Purple Eagles,R. Solomon,4398403,,True,23.0,2,6,0,3,2,3,0,0,1,1,2,0,0,0,0,1,6
401086010,Niagara Purple Eagles,C. Barton,3907182,,True,19.0,0,4,0,4,0,0,0,0,0,1,1,0,0,0,2,2,0
401086010,Niagara Purple Eagles,K. Green,4067342,,False,6.0,0,0,0,0,0,0,0,0,0,2,2,0,0,0,0,1,0
401086010,Niagara Purple Eagles,D. Robb,3907186,,False,25.0,6,12,5,10,1,2,4,6,3,5,8,0,0,3,0,3,17
401086010,Niagara Purple Eagles,K. Tate,4279738,,False,6.0,0,1,0,1,0,0,0,0,0,1,1,0,0,1,1,0,0
401086010,Niagara Purple Eagles,D. Fragala,4279737,,False,9.0,0,2,0,0,0,2,2,2,0,0,0,0,0,0,0,1,2
401086010,Niagara Purple Eagles,J. Towns,4067341,,False,30.0,5,11,4,6,1,5,3,5,2,2,4,1,0,0,1,1,14
401086010,Niagara Purple Eagles,TEAM,TOTAL,TOTAL,False,,20,55,13,34,7,21,13,21,12,19,31,4,2,5,7,18,60
401086010,Niagara Purple Eagles,M. Prochet,3907184,,True,35.0,3,9,1,4,2,5,3,4,0,1,1,1,1,0,1,3,11
401086010,Niagara Purple Eagles,G. King,3906490,,True,15.0,0,2,0,2,0,0,1,4,1,2,3,0,0,1,0,1,1
401086010,Niagara Purple Eagles,M. Hammond,4398404,,True,32.0,4,8,3,4,1,4,0,0,2,1,3,2,1,0,1,5,9
401086010,Niagara Purple Eagles,R. Solomon,4398403,,True,23.0,2,6,0,3,2,3,0,0,1,1,2,0,0,0,0,1,6
401086010,Niagara Purple Eagles,C. Barton,3907182,,True,19.0,0,4,0,4,0,0,0,0,0,1,1,0,0,0,2,2,0
401086010,Niagara Purple Eagles,K. Green,4067342,,False,6.0,0,0,0,0,0,0,0,0,0,2,2,0,0,0,0,1,0
401086010,Niagara Purple Eagles,D. Robb,3907186,,False,25.0,6,12,5,10,1,2,4,6,3,5,8,0,0,3,0,3,17
401086010,Niagara Purple Eagles,K. Tate,4279738,,False,6.0,0,1,0,1,0,0,0,0,0,1,1,0,0,1,1,0,0
401086010,Niagara Purple Eagles,D. Fragala,4279737,,False,9.0,0,2,0,0,0,2,2,2,0,0,0,0,0,0,0,1,2
401086010,Niagara Purple Eagles,J. Towns,4067341,,False,30.0,5,11,4,6,1,5,3,5,2,2,4,1,0,0,1,1,14
401086010,Niagara Purple Eagles,TEAM,TOTAL,TOTAL,False,,20,55,13,34,7,21,13,21,12,19,31,4,2,5,7,18,60
401086009,Rider Broncs,F. Scott,3922033,,True,22.0,3,6,1,3,2,3,0,0,1,7,8,2,3,0,1,1,8
401086009,Rider Broncs,T. Marshall,4067348,,True,19.0,6,11,6,11,0,0,2,4,2,2,4,3,1,0,1,1,14
401086009,Rider Broncs,S. Jordan,4067349,,True,25.0,9,13,6,9,3,4,0,2,2,0,2,6,2,0,0,2,21
401086009,Rider Broncs,K. Williams,3946983,,True,28.0,2,5,2,5,0,0,3,8,1,2,3,6,4,1,3,3,7
401086009,Rider Broncs,A. Durham,3138490,,True,16.0,4,5,2,2,2,3,3,4,0,3,3,0,0,0,0,1,13
401086009,Rider Broncs,A. Ogemuno-Johnson,4406151,,False,14.0,1,2,1,2,0,0,0,0,5,0,5,0,0,0,2,2,2
401086009,Rider Broncs,K. Cisse,4279746,,False,6.0,1,2,1,2,0,0,2,2,0,2,2,0,0,1,0,1,4
401086009,Rider Broncs,D. Eke,3941312,,False,11.0,2,4,2,3,0,1,0,0,1,3,4,0,1,0,0,2,4
401086009,Rider Broncs,D. Vaughn,4067347,,False,16.0,4,10,2,2,2,8,1,2,1,7,8,2,2,1,1,2,11
401086009,Rider Broncs,R. O'Leary,4279747,,False,5.0,0,1,0,0,0,1,1,2,0,0,0,0,0,0,0,0,1
401086009,Rider Broncs,N. Buono,4279744,,False,4.0,0,1,0,0,0,1,0,0,0,0,0,0,0,0,1,0,0
401086009,Rider Broncs,J. Allen,4067345,,False,22.0,2,11,0,1,2,10,0,0,0,1,1,2,1,2,3,3,6
401086009,Rider Broncs,A. Gilbert,3911886,,False,12.0,2,4,0,1,2,3,0,0,0,1,1,4,2,0,1,1,6
401086009,Rider Broncs,TEAM,TOTAL,TOTAL,False,,36,75,23,41,13,34,12,24,15,33,48,25,16,5,13,19,97
401086009,Rider Broncs,F. Scott,3922033,,True,22.0,3,6,1,3,2,3,0,0,1,7,8,2,3,0,1,1,8
401086009,Rider Broncs,T. Marshall,4067348,,True,19.0,6,11,6,11,0,0,2,4,2,2,4,3,1,0,1,1,14
401086009,Rider Broncs,S. Jordan,4067349,,True,25.0,9,13,6,9,3,4,0,2,2,0,2,6,2,0,0,2,21
401086009,Rider Broncs,K. Williams,3946983,,True,28.0,2,5,2,5,0,0,3,8,1,2,3,6,4,1,3,3,7
401086009,Rider Broncs,A. Durham,3138490,,True,16.0,4,5,2,2,2,3,3,4,0,3,3,0,0,0,0,1,13
401086009,Rider Broncs,A. Ogemuno-Johnson,4406151,,False,14.0,1,2,1,2,0,0,0,0,5,0,5,0,0,0,2,2,2
401086009,Rider Broncs,K. Cisse,4279746,,False,6.0,1,2,1,2,0,0,2,2,0,2,2,0,0,1,0,1,4
401086009,Rider Broncs,D. Eke,3941312,,False,11.0,2,4,2,3,0,1,0,0,1,3,4,0,1,0,0,2,4
401086009,Rider Broncs,D. Vaughn,4067347,,False,16.0,4,10,2,2,2,8,1,2,1,7,8,2,2,1,1,2,11
401086009,Rider Broncs,R. O'Leary,4279747,,False,5.0,0,1,0,0,0,1,1,2,0,0,0,0,0,0,0,0,1
401086009,Rider Broncs,N. Buono,4279744,,False,4.0,0,1,0,0,0,1,0,0,0,0,0,0,0,0,1,0,0
401086009,Rider Broncs,J. Allen,4067345,,False,22.0,2,11,0,1,2,10,0,0,0,1,1,2,1,2,3,3,6
401086009,Rider Broncs,A. Gilbert,3911886,,False,12.0,2,4,0,1,2,3,0,0,0,1,1,4,2,0,1,1,6
401086009,Rider Broncs,TEAM,TOTAL,TOTAL,False,,36,75,23,41,13,34,12,24,15,33,48,25,16,5,13,19,97
401086009,Niagara Purple Eagles,D. Robb,3907186,,True,15.0,2,4,2,4,0,0,3,4,0,0,0,0,0,0,1,2,7
401086009,Niagara Purple Eagles,M. Prochet,3907184,,True,25.0,3,12,3,8,0,4,2,3,4,5,9,3,1,0,2,1,8
401086009,Niagara Purple Eagles,K. Tate,4279738,,True,6.0,1,4,1,1,0,3,0,0,0,2,2,0,0,0,1,1,2
401086009,Niagara Purple Eagles,J. Towns,4067341,,True,16.0,2,5,2,5,0,0,0,0,1,0,1,0,0,0,3,0,4
401086009,Niagara Purple Eagles,C. Barton,3907182,,True,22.0,2,5,1,3,1,2,3,5,3,1,4,0,0,0,2,4,8
401086009,Niagara Purple Eagles,G. Kuakumensah,4279739,,False,18.0,3,5,3,4,0,1,0,0,0,4,4,2,1,0,1,0,6
401086009,Niagara Purple Eagles,K. Green,4067342,,False,4.0,3,4,2,2,1,2,0,0,0,1,1,0,0,0,0,1,7
401086009,Niagara Purple Eagles,G. King,3906490,,False,19.0,3,5,3,5,0,0,0,0,1,7,8,0,0,2,1,3,6
401086009,Niagara Purple Eagles,M. Hammond,4398404,,False,24.0,5,11,2,5,3,6,2,2,1,5,6,8,3,0,2,3,15
401086009,Niagara Purple Eagles,R. Solomon,4398403,,False,27.0,3,11,0,4,3,7,1,2,2,4,6,1,0,0,2,1,10
401086009,Niagara Purple Eagles,D. Fragala,4279737,,False,24.0,3,11,2,5,1,6,1,3,2,2,4,1,1,1,3,2,8
401086009,Niagara Purple Eagles,TEAM,TOTAL,TOTAL,False,,30,77,21,46,9,31,12,19,18,32,50,15,6,3,18,18,81
401086009,Niagara Purple Eagles,D. Robb,3907186,,True,15.0,2,4,2,4,0,0,3,4,0,0,0,0,0,0,1,2,7
401086009,Niagara Purple Eagles,M. Prochet,3907184,,True,25.0,3,12,3,8,0,4,2,3,4,5,9,3,1,0,2,1,8
401086009,Niagara Purple Eagles,K. Tate,4279738,,True,6.0,1,4,1,1,0,3,0,0,0,2,2,0,0,0,1,1,2
401086009,Niagara Purple Eagles,J. Towns,4067341,,True,16.0,2,5,2,5,0,0,0,0,1,0,1,0,0,0,3,0,4
401086009,Niagara Purple Eagles,C. Barton,3907182,,True,22.0,2,5,1,3,1,2,3,5,3,1,4,0,0,0,2,4,8
401086009,Niagara Purple Eagles,G. Kuakumensah,4279739,,False,18.0,3,5,3,4,0,1,0,0,0,4,4,2,1,0,1,0,6
401086009,Niagara Purple Eagles,K. Green,4067342,,False,4.0,3,4,2,2,1,2,0,0,0,1,1,0,0,0,0,1,7
401086009,Niagara Purple Eagles,G. King,3906490,,False,19.0,3,5,3,5,0,0,0,0,1,7,8,0,0,2,1,3,6
401086009,Niagara Purple Eagles,M. Hammond,4398404,,False,24.0,5,11,2,5,3,6,2,2,1,5,6,8,3,0,2,3,15
401086009,Niagara Purple Eagles,R. Solomon,4398403,,False,27.0,3,11,0,4,3,7,1,2,2,4,6,1,0,0,2,1,10
401086009,Niagara Purple Eagles,D. Fragala,4279737,,False,24.0,3,11,2,5,1,6,1,3,2,2,4,1,1,1,3,2,8
401086009,Niagara Purple Eagles,TEAM,TOTAL,TOTAL,False,,30,77,21,46,9,31,12,19,18,32,50,15,6,3,18,18,81
401086008,Niagara Purple Eagles,D. Robb,3907186,,True,33.0,9,13,8,12,1,1,4,6,0,5,5,0,0,2,0,1,23
401086008,Niagara Purple Eagles,M. Prochet,3907184,,True,37.0,2,10,1,5,1,5,0,2,2,7,9,5,0,2,3,0,5
401086008,Niagara Purple Eagles,K. Tate,4279738,,True,19.0,1,4,0,1,1,3,1,4,1,6,7,0,0,0,1,1,4
401086008,Niagara Purple Eagles,J. Towns,4067341,,True,24.0,1,4,1,4,0,0,4,4,0,1,1,3,2,0,1,0,6
401086008,Niagara Purple Eagles,C. Barton,3907182,,True,27.0,5,7,4,6,1,1,3,5,1,5,6,1,2,0,5,2,14
401086008,Niagara Purple Eagles,G. Kuakumensah,4279739,,False,3.0,0,1,0,1,0,0,0,0,0,0,0,0,0,0,1,1,0
401086008,Niagara Purple Eagles,G. King,3906490,,False,7.0,0,1,0,1,0,0,0,0,0,1,1,0,0,0,2,1,0
401086008,Niagara Purple Eagles,M. Hammond,4398404,,False,21.0,1,1,1,1,0,0,1,2,0,4,4,2,0,1,1,1,3
401086008,Niagara Purple Eagles,R. Solomon,4398403,,False,18.0,3,6,1,2,2,4,0,0,1,1,2,0,0,0,2,2,8
401086008,Niagara Purple Eagles,D. Fragala,4279737,,False,11.0,3,5,0,0,3,5,6,6,0,0,0,0,0,0,0,1,15
401086008,Niagara Purple Eagles,TEAM,TOTAL,TOTAL,False,,25,52,16,33,9,19,19,29,7,30,37,11,4,5,16,10,78
401086008,Niagara Purple Eagles,D. Robb,3907186,,True,33.0,9,13,8,12,1,1,4,6,0,5,5,0,0,2,0,1,23
401086008,Niagara Purple Eagles,M. Prochet,3907184,,True,37.0,2,10,1,5,1,5,0,2,2,7,9,5,0,2,3,0,5
401086008,Niagara Purple Eagles,K. Tate,4279738,,True,19.0,1,4,0,1,1,3,1,4,1,6,7,0,0,0,1,1,4
401086008,Niagara Purple Eagles,J. Towns,4067341,,True,24.0,1,4,1,4,0,0,4,4,0,1,1,3,2,0,1,0,6
401086008,Niagara Purple Eagles,C. Barton,3907182,,True,27.0,5,7,4,6,1,1,3,5,1,5,6,1,2,0,5,2,14
401086008,Niagara Purple Eagles,G. Kuakumensah,4279739,,False,3.0,0,1,0,1,0,0,0,0,0,0,0,0,0,0,1,1,0
401086008,Niagara Purple Eagles,G. King,3906490,,False,7.0,0,1,0,1,0,0,0,0,0,1,1,0,0,0,2,1,0
401086008,Niagara Purple Eagles,M. Hammond,4398404,,False,21.0,1,1,1,1,0,0,1,2,0,4,4,2,0,1,1,1,3
401086008,Niagara Purple Eagles,R. Solomon,4398403,,False,18.0,3,6,1,2,2,4,0,0,1,1,2,0,0,0,2,2,8
401086008,Niagara Purple Eagles,D. Fragala,4279737,,False,11.0,3,5,0,0,3,5,6,6,0,0,0,0,0,0,0,1,15
401086008,Niagara Purple Eagles,TEAM,TOTAL,TOTAL,False,,25,52,16,33,9,19,19,29,7,30,37,11,4,5,16,10,78
401086008,Fairfield Stags,M. Milin,3947018,,True,18.0,3,4,2,3,1,1,0,0,1,2,3,0,0,0,1,3,7
401086008,Fairfield Stags,J. Kasibabu,3947016,,True,28.0,1,6,1,6,0,0,0,0,2,5,7,3,0,0,2,4,2
401086008,Fairfield Stags,N. Alvarez,4398075,,True,35.0,7,17,5,12,2,5,0,0,1,2,3,2,2,1,2,4,16
401086008,Fairfield Stags,J. Cruz,4279488,,True,18.0,2,7,1,4,1,3,0,0,0,2,2,1,2,0,0,3,5
401086008,Fairfield Stags,T. Benning,4279483,,True,24.0,4,9,4,8,0,1,0,0,1,2,3,1,2,0,0,1,8
401086008,Fairfield Stags,W. Methnani,4279486,,False,17.0,2,5,2,3,0,2,2,2,0,3,3,1,0,0,2,5,6
401086008,Fairfield Stags,L. Taliaferro,4398078,,False,24.0,7,11,3,3,4,8,0,0,0,3,3,0,1,0,1,3,18
401086008,Fairfield Stags,C. Whipple,4398077,,False,3.0,0,0,0,0,0,0,0,0,0,1,1,0,0,0,0,2,0
401086008,Fairfield Stags,A. Kavaliauskas,4080375,,False,33.0,4,8,3,5,1,3,2,2,0,5,5,6,3,0,4,2,11
401086008,Fairfield Stags,TEAM,TOTAL,TOTAL,False,,30,67,21,44,9,23,4,4,6,25,31,14,10,1,12,27,73
401086008,Fairfield Stags,M. Milin,3947018,,True,18.0,3,4,2,3,1,1,0,0,1,2,3,0,0,0,1,3,7
401086008,Fairfield Stags,J. Kasibabu,3947016,,True,28.0,1,6,1,6,0,0,0,0,2,5,7,3,0,0,2,4,2
401086008,Fairfield Stags,N. Alvarez,4398075,,True,35.0,7,17,5,12,2,5,0,0,1,2,3,2,2,1,2,4,16
401086008,Fairfield Stags,J. Cruz,4279488,,True,18.0,2,7,1,4,1,3,0,0,0,2,2,1,2,0,0,3,5
401086008,Fairfield Stags,T. Benning,4279483,,True,24.0,4,9,4,8,0,1,0,0,1,2,3,1,2,0,0,1,8
401086008,Fairfield Stags,W. Methnani,4279486,,False,17.0,2,5,2,3,0,2,2,2,0,3,3,1,0,0,2,5,6
401086008,Fairfield Stags,L. Taliaferro,4398078,,False,24.0,7,11,3,3,4,8,0,0,0,3,3,0,1,0,1,3,18
401086008,Fairfield Stags,C. Whipple,4398077,,False,3.0,0,0,0,0,0,0,0,0,0,1,1,0,0,0,0,2,0
401086008,Fairfield Stags,A. Kavaliauskas,4080375,,False,33.0,4,8,3,5,1,3,2,2,0,5,5,6,3,0,4,2,11
401086008,Fairfield Stags,TEAM,TOTAL,TOTAL,False,,30,67,21,44,9,23,4,4,6,25,31,14,10,1,12,27,73
401086007,Niagara Purple Eagles,D. Robb,3907186,,True,16.0,0,4,0,4,0,0,0,0,1,4,5,0,1,0,2,4,0
401086007,Niagara Purple Eagles,M. Prochet,3907184,,True,33.0,7,13,1,3,6,10,1,2,1,8,9,0,0,1,1,2,21
401086007,Niagara Purple Eagles,K. Tate,4279738,,True,16.0,1,4,1,2,0,2,0,0,1,2,3,2,0,0,0,0,2
401086007,Niagara Purple Eagles,J. Towns,4067341,,True,37.0,5,12,4,10,1,2,4,4,1,2,3,4,1,0,0,0,15
401086007,Niagara Purple Eagles,C. Barton,3907182,,True,34.0,6,8,4,5,2,3,8,9,2,5,7,3,0,0,2,0,22
401086007,Niagara Purple Eagles,G. Kuakumensah,4279739,,False,7.0,0,1,0,0,0,1,0,0,0,1,1,0,0,0,0,2,0
401086007,Niagara Purple Eagles,K. Green,4067342,,False,1.0,0,0,0,0,0,0,0,0,0,0,0,0,0,0,0,0,0
401086007,Niagara Purple Eagles,G. King,3906490,,False,23.0,1,2,1,2,0,0,3,4,1,5,6,1,1,0,1,2,5
401086007,Niagara Purple Eagles,M. Hammond,4398404,,False,6.0,0,0,0,0,0,0,0,0,0,0,0,0,0,0,0,1,0
401086007,Niagara Purple Eagles,R. Solomon,4398403,,False,26.0,2,7,0,0,2,7,4,4,0,2,2,1,1,0,4,2,10
401086007,Niagara Purple Eagles,D. Fragala,4279737,,False,1.0,0,0,0,0,0,0,0,0,0,0,0,0,0,0,0,0,0
401086007,Niagara Purple Eagles,TEAM,TOTAL,TOTAL,False,,22,51,11,26,11,25,20,23,9,29,38,11,4,1,12,13,75
401086007,Niagara Purple Eagles,D. Robb,3907186,,True,16.0,0,4,0,4,0,0,0,0,1,4,5,0,1,0,2,4,0
401086007,Niagara Purple Eagles,M. Prochet,3907184,,True,33.0,7,13,1,3,6,10,1,2,1,8,9,0,0,1,1,2,21
401086007,Niagara Purple Eagles,K. Tate,4279738,,True,16.0,1,4,1,2,0,2,0,0,1,2,3,2,0,0,0,0,2
401086007,Niagara Purple Eagles,J. Towns,4067341,,True,37.0,5,12,4,10,1,2,4,4,1,2,3,4,1,0,0,0,15
401086007,Niagara Purple Eagles,C. Barton,3907182,,True,34.0,6,8,4,5,2,3,8,9,2,5,7,3,0,0,2,0,22
401086007,Niagara Purple Eagles,G. Kuakumensah,4279739,,False,7.0,0,1,0,0,0,1,0,0,0,1,1,0,0,0,0,2,0
401086007,Niagara Purple Eagles,K. Green,4067342,,False,1.0,0,0,0,0,0,0,0,0,0,0,0,0,0,0,0,0,0
401086007,Niagara Purple Eagles,G. King,3906490,,False,23.0,1,2,1,2,0,0,3,4,1,5,6,1,1,0,1,2,5
401086007,Niagara Purple Eagles,M. Hammond,4398404,,False,6.0,0,0,0,0,0,0,0,0,0,0,0,0,0,0,0,1,0
401086007,Niagara Purple Eagles,R. Solomon,4398403,,False,26.0,2,7,0,0,2,7,4,4,0,2,2,1,1,0,4,2,10
401086007,Niagara Purple Eagles,D. Fragala,4279737,,False,1.0,0,0,0,0,0,0,0,0,0,0,0,0,0,0,0,0,0
401086007,Niagara Purple Eagles,TEAM,TOTAL,TOTAL,False,,22,51,11,26,11,25,20,23,9,29,38,11,4,1,12,13,75
401086007,Monmouth Hawks,M. Traore,3975762,,True,21.0,4,7,4,7,0,0,1,3,1,3,4,1,0,2,2,0,9
401086007,Monmouth Hawks,D. Quinn,3948714,,True,28.0,3,9,3,9,0,0,2,4,2,5,7,0,0,0,2,2,8
401086007,Monmouth Hawks,M. McClary,4279736,,True,17.0,2,3,2,3,0,0,0,0,1,1,2,2,0,0,0,2,4
401086007,Monmouth Hawks,D. Hammond,4279734,,True,24.0,5,8,3,4,2,4,0,0,1,2,3,1,0,0,2,4,12
401086007,Monmouth Hawks,R. Salnave,4067329,,True,15.0,1,5,0,3,1,2,0,0,0,3,3,0,2,0,4,1,3
401086007,Monmouth Hawks,N. Rutty,4398408,,False,4.0,0,1,0,1,0,0,1,2,2,0,2,0,0,0,0,1,1
401086007,Monmouth Hawks,S. Ibiezugbe,4067330,,False,6.0,0,1,0,1,0,0,0,0,0,0,0,0,0,0,0,0,0
401086007,Monmouth Hawks,M. Martin,4279733,,False,17.0,3,5,2,4,1,1,0,0,1,2,3,1,1,0,2,4,7
401086007,Monmouth Hawks,M. James Jr.,4404878,,False,2.0,0,2,0,1,0,1,0,0,0,0,0,0,0,0,0,0,0
401086007,Monmouth Hawks,S. Chaput,4398409,,False,9.0,1,2,1,2,0,0,0,0,0,0,0,1,0,0,0,3,2
401086007,Monmouth Hawks,D. Calloway Jr.,4398407,,False,2.0,0,0,0,0,0,0,0,0,0,0,0,0,0,0,0,1,0
401086007,Monmouth Hawks,G. Papas,4279735,,False,7.0,0,2,0,0,0,2,0,0,0,0,0,0,0,0,0,0,0
401086007,Monmouth Hawks,T. Gross Jr.,4065729,,False,6.0,0,2,0,2,0,0,0,0,1,2,3,1,0,0,0,0,0
401086007,Monmouth Hawks,L. Pillari,3948713,,False,11.0,0,2,0,2,0,0,2,2,0,0,0,1,0,0,0,0,2
401086007,Monmouth Hawks,N. Rutherford,3946977,,False,31.0,0,6,0,4,0,2,0,2,2,1,3,3,2,1,0,0,0
401086007,Monmouth Hawks,TEAM,TOTAL,TOTAL,False,,19,55,15,43,4,12,6,13,12,21,33,11,5,3,12,18,48
401086007,Monmouth Hawks,M. Traore,3975762,,True,21.0,4,7,4,7,0,0,1,3,1,3,4,1,0,2,2,0,9
401086007,Monmouth Hawks,D. Quinn,3948714,,True,28.0,3,9,3,9,0,0,2,4,2,5,7,0,0,0,2,2,8
401086007,Monmouth Hawks,M. McClary,4279736,,True,17.0,2,3,2,3,0,0,0,0,1,1,2,2,0,0,0,2,4
401086007,Monmouth Hawks,D. Hammond,4279734,,True,24.0,5,8,3,4,2,4,0,0,1,2,3,1,0,0,2,4,12
401086007,Monmouth Hawks,R. Salnave,4067329,,True,15.0,1,5,0,3,1,2,0,0,0,3,3,0,2,0,4,1,3
401086007,Monmouth Hawks,N. Rutty,4398408,,False,4.0,0,1,0,1,0,0,1,2,2,0,2,0,0,0,0,1,1
401086007,Monmouth Hawks,S. Ibiezugbe,4067330,,False,6.0,0,1,0,1,0,0,0,0,0,0,0,0,0,0,0,0,0
401086007,Monmouth Hawks,M. Martin,4279733,,False,17.0,3,5,2,4,1,1,0,0,1,2,3,1,1,0,2,4,7
401086007,Monmouth Hawks,M. James Jr.,4404878,,False,2.0,0,2,0,1,0,1,0,0,0,0,0,0,0,0,0,0,0
401086007,Monmouth Hawks,S. Chaput,4398409,,False,9.0,1,2,1,2,0,0,0,0,0,0,0,1,0,0,0,3,2
401086007,Monmouth Hawks,D. Calloway Jr.,4398407,,False,2.0,0,0,0,0,0,0,0,0,0,0,0,0,0,0,0,1,0
401086007,Monmouth Hawks,G. Papas,4279735,,False,7.0,0,2,0,0,0,2,0,0,0,0,0,0,0,0,0,0,0
401086007,Monmouth Hawks,T. Gross Jr.,4065729,,False,6.0,0,2,0,2,0,0,0,0,1,2,3,1,0,0,0,0,0
401086007,Monmouth Hawks,L. Pillari,3948713,,False,11.0,0,2,0,2,0,0,2,2,0,0,0,1,0,0,0,0,2
401086007,Monmouth Hawks,N. Rutherford,3946977,,False,31.0,0,6,0,4,0,2,0,2,2,1,3,3,2,1,0,0,0
401086007,Monmouth Hawks,TEAM,TOTAL,TOTAL,False,,19,55,15,43,4,12,6,13,12,21,33,11,5,3,12,18,48
401086006,Saint Peter's Peacocks,S. Idowu,3922042,,True,26.0,7,12,6,11,1,1,0,0,2,2,4,0,0,2,1,2,15
401086006,Saint Peter's Peacocks,K. Brown,4398385,,True,20.0,1,2,0,1,1,1,1,3,0,5,5,1,1,1,0,4,4
401086006,Saint Peter's Peacocks,M. Dixon,4279758,,True,32.0,2,2,0,0,2,2,0,0,0,5,5,1,1,0,4,1,6
401086006,Saint Peter's Peacocks,Q. Taylor,4067357,,True,29.0,1,3,1,3,0,0,4,4,1,1,2,1,0,0,0,3,6
401086006,Saint Peter's Peacocks,D. Turner,4067356,,True,37.0,10,23,7,14,3,9,8,8,2,4,6,3,1,0,4,0,31
401086006,Saint Peter's Peacocks,KC Ndefo,4398386,,False,27.0,3,5,3,5,0,0,0,1,1,3,4,3,1,1,2,4,6
401086006,Saint Peter's Peacocks,D. Woods,3919424,,False,9.0,3,4,3,4,0,0,0,1,2,3,5,0,0,0,2,2,6
401086006,Saint Peter's Peacocks,M. Majak,4398387,,False,5.0,0,0,0,0,0,0,0,0,0,0,0,0,1,0,0,0,0
401086006,Saint Peter's Peacocks,C. Underwood,4398388,,False,4.0,0,0,0,0,0,0,0,0,0,0,0,0,0,0,0,0,0
401086006,Saint Peter's Peacocks,A. Hicks,4284295,,False,11.0,0,0,0,0,0,0,0,0,1,0,1,1,0,1,0,1,0
401086006,Saint Peter's Peacocks,TEAM,TOTAL,TOTAL,False,,27,51,20,38,7,13,13,17,9,25,34,10,5,5,13,17,74
401086006,Saint Peter's Peacocks,S. Idowu,3922042,,True,26.0,7,12,6,11,1,1,0,0,2,2,4,0,0,2,1,2,15
401086006,Saint Peter's Peacocks,K. Brown,4398385,,True,20.0,1,2,0,1,1,1,1,3,0,5,5,1,1,1,0,4,4
401086006,Saint Peter's Peacocks,M. Dixon,4279758,,True,32.0,2,2,0,0,2,2,0,0,0,5,5,1,1,0,4,1,6
401086006,Saint Peter's Peacocks,Q. Taylor,4067357,,True,29.0,1,3,1,3,0,0,4,4,1,1,2,1,0,0,0,3,6
401086006,Saint Peter's Peacocks,D. Turner,4067356,,True,37.0,10,23,7,14,3,9,8,8,2,4,6,3,1,0,4,0,31
401086006,Saint Peter's Peacocks,KC Ndefo,4398386,,False,27.0,3,5,3,5,0,0,0,1,1,3,4,3,1,1,2,4,6
401086006,Saint Peter's Peacocks,D. Woods,3919424,,False,9.0,3,4,3,4,0,0,0,1,2,3,5,0,0,0,2,2,6
401086006,Saint Peter's Peacocks,M. Majak,4398387,,False,5.0,0,0,0,0,0,0,0,0,0,0,0,0,1,0,0,0,0
401086006,Saint Peter's Peacocks,C. Underwood,4398388,,False,4.0,0,0,0,0,0,0,0,0,0,0,0,0,0,0,0,0,0
401086006,Saint Peter's Peacocks,A. Hicks,4284295,,False,11.0,0,0,0,0,0,0,0,0,1,0,1,1,0,1,0,1,0
401086006,Saint Peter's Peacocks,TEAM,TOTAL,TOTAL,False,,27,51,20,38,7,13,13,17,9,25,34,10,5,5,13,17,74
401086006,Niagara Purple Eagles,D. Robb,3907186,,True,26.0,3,5,3,5,0,0,3,3,0,3,3,0,0,2,1,1,9
401086006,Niagara Purple Eagles,M. Prochet,3907184,,True,37.0,7,14,1,6,6,8,4,5,1,7,8,3,0,0,3,3,24
401086006,Niagara Purple Eagles,K. Tate,4279738,,True,29.0,1,4,1,2,0,2,2,2,0,1,1,2,1,0,1,0,4
401086006,Niagara Purple Eagles,J. Towns,4067341,,True,21.0,1,6,0,3,1,3,3,4,0,1,1,3,1,0,1,1,6
401086006,Niagara Purple Eagles,C. Barton,3907182,,True,26.0,4,5,4,5,0,0,3,4,0,0,0,2,0,1,0,3,11
401086006,Niagara Purple Eagles,G. Kuakumensah,4279739,,False,6.0,0,0,0,0,0,0,0,0,0,2,2,0,0,0,0,0,0
401086006,Niagara Purple Eagles,G. King,3906490,,False,11.0,0,3,0,3,0,0,2,2,1,1,2,1,1,0,2,2,2
401086006,Niagara Purple Eagles,M. Hammond,4398404,,False,19.0,0,1,0,1,0,0,1,2,0,0,0,2,2,0,1,0,1
401086006,Niagara Purple Eagles,R. Solomon,4398403,,False,23.0,5,7,0,0,5,7,0,1,0,1,1,0,1,0,3,2,15
401086006,Niagara Purple Eagles,D. Fragala,4279737,,False,2.0,0,1,0,0,0,1,0,0,0,0,0,0,0,0,0,1,0
401086006,Niagara Purple Eagles,TEAM,TOTAL,TOTAL,False,,21,46,9,25,12,21,18,23,3,18,21,13,6,3,12,13,72
401086006,Niagara Purple Eagles,D. Robb,3907186,,True,26.0,3,5,3,5,0,0,3,3,0,3,3,0,0,2,1,1,9
401086006,Niagara Purple Eagles,M. Prochet,3907184,,True,37.0,7,14,1,6,6,8,4,5,1,7,8,3,0,0,3,3,24
401086006,Niagara Purple Eagles,K. Tate,4279738,,True,29.0,1,4,1,2,0,2,2,2,0,1,1,2,1,0,1,0,4
401086006,Niagara Purple Eagles,J. Towns,4067341,,True,21.0,1,6,0,3,1,3,3,4,0,1,1,3,1,0,1,1,6
401086006,Niagara Purple Eagles,C. Barton,3907182,,True,26.0,4,5,4,5,0,0,3,4,0,0,0,2,0,1,0,3,11
401086006,Niagara Purple Eagles,G. Kuakumensah,4279739,,False,6.0,0,0,0,0,0,0,0,0,0,2,2,0,0,0,0,0,0
401086006,Niagara Purple Eagles,G. King,3906490,,False,11.0,0,3,0,3,0,0,2,2,1,1,2,1,1,0,2,2,2
401086006,Niagara Purple Eagles,M. Hammond,4398404,,False,19.0,0,1,0,1,0,0,1,2,0,0,0,2,2,0,1,0,1
401086006,Niagara Purple Eagles,R. Solomon,4398403,,False,23.0,5,7,0,0,5,7,0,1,0,1,1,0,1,0,3,2,15
401086006,Niagara Purple Eagles,D. Fragala,4279737,,False,2.0,0,1,0,0,0,1,0,0,0,0,0,0,0,0,0,1,0
401086006,Niagara Purple Eagles,TEAM,TOTAL,TOTAL,False,,21,46,9,25,12,21,18,23,3,18,21,13,6,3,12,13,72
401086005,Siena Saints,E. Fisher,3913235,,True,33.0,6,12,5,11,1,1,0,0,0,6,6,3,0,1,1,0,13
401086005,Siena Saints,K. Degnan,3138282,,True,35.0,4,10,3,5,1,5,0,0,0,7,7,1,0,0,1,3,9
401086005,Siena Saints,S. Seymour,4398391,,True,27.0,2,5,0,1,2,4,0,0,0,2,2,0,0,0,0,0,6
401086005,Siena Saints,G. Darwiche,4398393,,True,20.0,0,2,0,0,0,2,0,0,0,0,0,2,0,0,2,2,0
401086005,Siena Saints,J. Pickett,4398390,,True,28.0,5,11,4,9,1,2,6,6,2,2,4,7,1,0,2,2,17
401086005,Siena Saints,D. Tchougang,4398394,,False,7.0,1,2,1,2,0,0,0,0,0,0,0,0,0,0,0,1,2
401086005,Siena Saints,M. Camper,4279751,,False,25.0,0,3,0,3,0,0,6,9,4,7,11,0,1,0,1,4,6
401086005,Siena Saints,K. Smithen,3133848,,False,25.0,5,9,3,6,2,3,1,2,0,1,1,0,2,0,1,2,13
401086005,Siena Saints,TEAM,TOTAL,TOTAL,False,,23,54,16,37,7,17,13,17,7,27,34,13,4,1,8,14,66
401086005,Siena Saints,E. Fisher,3913235,,True,33.0,6,12,5,11,1,1,0,0,0,6,6,3,0,1,1,0,13
401086005,Siena Saints,K. Degnan,3138282,,True,35.0,4,10,3,5,1,5,0,0,0,7,7,1,0,0,1,3,9
401086005,Siena Saints,S. Seymour,4398391,,True,27.0,2,5,0,1,2,4,0,0,0,2,2,0,0,0,0,0,6
401086005,Siena Saints,G. Darwiche,4398393,,True,20.0,0,2,0,0,0,2,0,0,0,0,0,2,0,0,2,2,0
401086005,Siena Saints,J. Pickett,4398390,,True,28.0,5,11,4,9,1,2,6,6,2,2,4,7,1,0,2,2,17
401086005,Siena Saints,D. Tchougang,4398394,,False,7.0,1,2,1,2,0,0,0,0,0,0,0,0,0,0,0,1,2
401086005,Siena Saints,M. Camper,4279751,,False,25.0,0,3,0,3,0,0,6,9,4,7,11,0,1,0,1,4,6
401086005,Siena Saints,K. Smithen,3133848,,False,25.0,5,9,3,6,2,3,1,2,0,1,1,0,2,0,1,2,13
401086005,Siena Saints,TEAM,TOTAL,TOTAL,False,,23,54,16,37,7,17,13,17,7,27,34,13,4,1,8,14,66
401086005,Niagara Purple Eagles,D. Robb,3907186,,True,25.0,4,8,3,6,1,2,3,4,2,3,5,1,0,1,0,0,12
401086005,Niagara Purple Eagles,M. Prochet,3907184,,True,36.0,6,15,5,9,1,6,2,2,1,6,7,1,2,1,0,2,15
401086005,Niagara Purple Eagles,K. Tate,4279738,,True,34.0,3,7,3,5,0,2,1,2,3,3,6,1,0,0,2,4,7
401086005,Niagara Purple Eagles,J. Towns,4067341,,True,34.0,8,13,6,9,2,4,3,4,0,4,4,1,1,0,1,0,21
401086005,Niagara Purple Eagles,C. Barton,3907182,,True,16.0,0,3,0,0,0,3,0,0,0,1,1,0,0,0,3,1,0
401086005,Niagara Purple Eagles,G. Kuakumensah,4279739,,False,6.0,0,2,0,2,0,0,0,0,0,2,2,0,1,0,0,0,0
401086005,Niagara Purple Eagles,G. King,3906490,,False,15.0,0,1,0,1,0,0,0,0,0,2,2,1,1,1,3,4,0
401086005,Niagara Purple Eagles,M. Hammond,4398404,,False,14.0,0,2,0,0,0,2,0,0,0,1,1,0,0,0,1,2,0
401086005,Niagara Purple Eagles,R. Solomon,4398403,,False,17.0,1,4,1,2,0,2,0,0,0,1,1,1,0,1,1,3,2
401086005,Niagara Purple Eagles,D. Fragala,4279737,,False,3.0,0,1,0,0,0,1,0,0,1,0,1,0,0,0,0,0,0
401086005,Niagara Purple Eagles,TEAM,TOTAL,TOTAL,False,,22,56,18,34,4,22,9,12,8,24,32,6,5,4,11,16,57
401086005,Niagara Purple Eagles,D. Robb,3907186,,True,25.0,4,8,3,6,1,2,3,4,2,3,5,1,0,1,0,0,12
401086005,Niagara Purple Eagles,M. Prochet,3907184,,True,36.0,6,15,5,9,1,6,2,2,1,6,7,1,2,1,0,2,15
401086005,Niagara Purple Eagles,K. Tate,4279738,,True,34.0,3,7,3,5,0,2,1,2,3,3,6,1,0,0,2,4,7
401086005,Niagara Purple Eagles,J. Towns,4067341,,True,34.0,8,13,6,9,2,4,3,4,0,4,4,1,1,0,1,0,21
401086005,Niagara Purple Eagles,C. Barton,3907182,,True,16.0,0,3,0,0,0,3,0,0,0,1,1,0,0,0,3,1,0
401086005,Niagara Purple Eagles,G. Kuakumensah,4279739,,False,6.0,0,2,0,2,0,0,0,0,0,2,2,0,1,0,0,0,0
401086005,Niagara Purple Eagles,G. King,3906490,,False,15.0,0,1,0,1,0,0,0,0,0,2,2,1,1,1,3,4,0
401086005,Niagara Purple Eagles,M. Hammond,4398404,,False,14.0,0,2,0,0,0,2,0,0,0,1,1,0,0,0,1,2,0
401086005,Niagara Purple Eagles,R. Solomon,4398403,,False,17.0,1,4,1,2,0,2,0,0,0,1,1,1,0,1,1,3,2
401086005,Niagara Purple Eagles,D. Fragala,4279737,,False,3.0,0,1,0,0,0,1,0,0,1,0,1,0,0,0,0,0,0
401086005,Niagara Purple Eagles,TEAM,TOTAL,TOTAL,False,,22,56,18,34,4,22,9,12,8,24,32,6,5,4,11,16,57
401086004,Rider Broncs,F. Scott,3922033,,True,27.0,6,9,5,7,1,2,1,2,0,3,3,1,0,0,2,2,14
401086004,Rider Broncs,T. Marshall,4067348,,True,26.0,7,11,7,11,0,0,8,10,3,11,14,2,0,0,1,1,22
401086004,Rider Broncs,S. Jordan,4067349,,True,29.0,5,9,5,7,0,2,4,4,0,3,3,8,2,1,1,2,14
401086004,Rider Broncs,K. Williams,3946983,,True,24.0,7,8,7,8,0,0,0,1,0,4,4,4,0,0,1,4,14
401086004,Rider Broncs,A. Durham,3138490,,True,31.0,5,7,3,3,2,4,0,0,2,3,5,4,0,0,1,2,12
401086004,Rider Broncs,A. Ogemuno-Johnson,4406151,,False,7.0,2,2,2,2,0,0,0,0,0,0,0,0,0,0,0,0,4
401086004,Rider Broncs,K. Cisse,4279746,,False,2.0,0,0,0,0,0,0,0,0,0,0,0,0,0,0,0,0,0
401086004,Rider Broncs,D. Eke,3941312,,False,8.0,0,0,0,0,0,0,0,0,0,1,1,0,1,1,1,2,0
401086004,Rider Broncs,D. Vaughn,4067347,,False,15.0,2,6,1,2,1,4,0,0,1,1,2,1,1,0,2,2,5
401086004,Rider Broncs,R. O'Leary,4279747,,False,1.0,1,1,0,0,1,1,0,0,0,0,0,0,0,0,0,0,3
401086004,Rider Broncs,N. Buono,4279744,,False,1.0,0,0,0,0,0,0,0,0,0,0,0,0,0,0,0,0,0
401086004,Rider Broncs,J. Allen,4067345,,False,22.0,6,11,2,2,4,9,0,0,1,3,4,0,0,0,1,0,16
401086004,Rider Broncs,A. Gilbert,3911886,,False,7.0,0,3,0,1,0,2,0,0,1,1,2,0,0,0,1,0,0
401086004,Rider Broncs,TEAM,TOTAL,TOTAL,False,,41,67,32,43,9,24,13,17,8,31,39,20,4,2,11,15,104
401086004,Rider Broncs,F. Scott,3922033,,True,27.0,6,9,5,7,1,2,1,2,0,3,3,1,0,0,2,2,14
401086004,Rider Broncs,T. Marshall,4067348,,True,26.0,7,11,7,11,0,0,8,10,3,11,14,2,0,0,1,1,22
401086004,Rider Broncs,S. Jordan,4067349,,True,29.0,5,9,5,7,0,2,4,4,0,3,3,8,2,1,1,2,14
401086004,Rider Broncs,K. Williams,3946983,,True,24.0,7,8,7,8,0,0,0,1,0,4,4,4,0,0,1,4,14
401086004,Rider Broncs,A. Durham,3138490,,True,31.0,5,7,3,3,2,4,0,0,2,3,5,4,0,0,1,2,12
401086004,Rider Broncs,A. Ogemuno-Johnson,4406151,,False,7.0,2,2,2,2,0,0,0,0,0,0,0,0,0,0,0,0,4
401086004,Rider Broncs,K. Cisse,4279746,,False,2.0,0,0,0,0,0,0,0,0,0,0,0,0,0,0,0,0,0
401086004,Rider Broncs,D. Eke,3941312,,False,8.0,0,0,0,0,0,0,0,0,0,1,1,0,1,1,1,2,0
401086004,Rider Broncs,D. Vaughn,4067347,,False,15.0,2,6,1,2,1,4,0,0,1,1,2,1,1,0,2,2,5
401086004,Rider Broncs,R. O'Leary,4279747,,False,1.0,1,1,0,0,1,1,0,0,0,0,0,0,0,0,0,0,3
401086004,Rider Broncs,N. Buono,4279744,,False,1.0,0,0,0,0,0,0,0,0,0,0,0,0,0,0,0,0,0
401086004,Rider Broncs,J. Allen,4067345,,False,22.0,6,11,2,2,4,9,0,0,1,3,4,0,0,0,1,0,16
401086004,Rider Broncs,A. Gilbert,3911886,,False,7.0,0,3,0,1,0,2,0,0,1,1,2,0,0,0,1,0,0
401086004,Rider Broncs,TEAM,TOTAL,TOTAL,False,,41,67,32,43,9,24,13,17,8,31,39,20,4,2,11,15,104
401086004,Niagara Purple Eagles,D. Robb,3907186,,True,16.0,4,9,4,9,0,0,0,0,1,2,3,0,1,0,0,3,8
401086004,Niagara Purple Eagles,M. Prochet,3907184,,True,28.0,3,6,2,3,1,3,3,3,0,3,3,0,2,0,3,0,10
401086004,Niagara Purple Eagles,K. Tate,4279738,,True,25.0,7,13,2,4,5,9,0,0,0,4,4,0,0,0,1,1,19
401086004,Niagara Purple Eagles,J. Towns,4067341,,True,30.0,5,10,4,8,1,2,4,4,2,3,5,6,0,0,1,0,15
401086004,Niagara Purple Eagles,C. Barton,3907182,,True,21.0,2,6,1,2,1,4,0,0,0,1,1,3,0,0,1,2,5
401086004,Niagara Purple Eagles,G. Kuakumensah,4279739,,False,17.0,1,1,1,1,0,0,2,2,2,3,5,0,1,0,2,1,4
401086004,Niagara Purple Eagles,K. Green,4067342,,False,9.0,2,4,2,4,0,0,0,0,1,1,2,1,1,0,1,3,4
401086004,Niagara Purple Eagles,G. King,3906490,,False,11.0,3,5,3,5,0,0,0,5,2,2,4,0,0,1,0,4,6
401086004,Niagara Purple Eagles,M. Hammond,4398404,,False,19.0,2,4,2,4,0,0,2,2,0,0,0,1,0,0,1,0,6
401086004,Niagara Purple Eagles,R. Solomon,4398403,,False,17.0,2,8,2,4,0,4,0,0,1,0,1,2,0,0,0,1,4
401086004,Niagara Purple Eagles,D. Fragala,4279737,,False,7.0,1,3,0,0,1,3,0,0,0,0,0,0,0,0,0,1,3
401086004,Niagara Purple Eagles,TEAM,TOTAL,TOTAL,False,,32,69,23,44,9,25,11,16,9,21,30,13,5,1,10,16,84
401086004,Niagara Purple Eagles,D. Robb,3907186,,True,16.0,4,9,4,9,0,0,0,0,1,2,3,0,1,0,0,3,8
401086004,Niagara Purple Eagles,M. Prochet,3907184,,True,28.0,3,6,2,3,1,3,3,3,0,3,3,0,2,0,3,0,10
401086004,Niagara Purple Eagles,K. Tate,4279738,,True,25.0,7,13,2,4,5,9,0,0,0,4,4,0,0,0,1,1,19
401086004,Niagara Purple Eagles,J. Towns,4067341,,True,30.0,5,10,4,8,1,2,4,4,2,3,5,6,0,0,1,0,15
401086004,Niagara Purple Eagles,C. Barton,3907182,,True,21.0,2,6,1,2,1,4,0,0,0,1,1,3,0,0,1,2,5
401086004,Niagara Purple Eagles,G. Kuakumensah,4279739,,False,17.0,1,1,1,1,0,0,2,2,2,3,5,0,1,0,2,1,4
401086004,Niagara Purple Eagles,K. Green,4067342,,False,9.0,2,4,2,4,0,0,0,0,1,1,2,1,1,0,1,3,4
401086004,Niagara Purple Eagles,G. King,3906490,,False,11.0,3,5,3,5,0,0,0,5,2,2,4,0,0,1,0,4,6
401086004,Niagara Purple Eagles,M. Hammond,4398404,,False,19.0,2,4,2,4,0,0,2,2,0,0,0,1,0,0,1,0,6
401086004,Niagara Purple Eagles,R. Solomon,4398403,,False,17.0,2,8,2,4,0,4,0,0,1,0,1,2,0,0,0,1,4
401086004,Niagara Purple Eagles,D. Fragala,4279737,,False,7.0,1,3,0,0,1,3,0,0,0,0,0,0,0,0,0,1,3
401086004,Niagara Purple Eagles,TEAM,TOTAL,TOTAL,False,,32,69,23,44,9,25,11,16,9,21,30,13,5,1,10,16,84
401086003,Niagara Purple Eagles,D. Robb,3907186,,True,23.0,1,3,1,3,0,0,0,0,1,1,2,1,0,0,2,0,2
401086003,Niagara Purple Eagles,M. Prochet,3907184,,True,27.0,3,12,2,7,1,5,2,3,2,2,4,1,2,0,1,2,9
401086003,Niagara Purple Eagles,K. Tate,4279738,,True,26.0,2,10,1,4,1,6,2,2,0,4,4,0,1,0,1,0,7
401086003,Niagara Purple Eagles,J. Towns,4067341,,True,28.0,2,4,2,3,0,1,0,0,1,1,2,3,2,0,6,2,4
401086003,Niagara Purple Eagles,C. Barton,3907182,,True,7.0,0,2,0,1,0,1,0,0,0,0,0,0,0,0,1,3,0
401086003,Niagara Purple Eagles,G. Kuakumensah,4279739,,False,5.0,0,0,0,0,0,0,0,0,0,1,1,0,0,0,0,1,0
401086003,Niagara Purple Eagles,K. Green,4067342,,False,9.0,1,2,1,2,0,0,0,0,1,1,2,0,0,0,2,0,2
401086003,Niagara Purple Eagles,G. King,3906490,,False,16.0,3,6,3,6,0,0,1,3,1,6,7,0,0,0,0,1,7
401086003,Niagara Purple Eagles,M. Hammond,4398404,,False,24.0,1,2,1,1,0,1,0,0,0,1,1,3,0,1,2,4,2
401086003,Niagara Purple Eagles,R. Solomon,4398403,,False,18.0,2,5,0,2,2,3,0,0,0,0,0,1,0,0,2,2,6
401086003,Niagara Purple Eagles,D. Fragala,4279737,,False,17.0,7,9,5,5,2,4,4,5,0,1,1,1,1,0,0,0,20
401086003,Niagara Purple Eagles,TEAM,TOTAL,TOTAL,False,,22,55,16,34,6,21,9,13,6,21,27,10,6,1,18,15,59
401086003,Niagara Purple Eagles,D. Robb,3907186,,True,23.0,1,3,1,3,0,0,0,0,1,1,2,1,0,0,2,0,2
401086003,Niagara Purple Eagles,M. Prochet,3907184,,True,27.0,3,12,2,7,1,5,2,3,2,2,4,1,2,0,1,2,9
401086003,Niagara Purple Eagles,K. Tate,4279738,,True,26.0,2,10,1,4,1,6,2,2,0,4,4,0,1,0,1,0,7
401086003,Niagara Purple Eagles,J. Towns,4067341,,True,28.0,2,4,2,3,0,1,0,0,1,1,2,3,2,0,6,2,4
401086003,Niagara Purple Eagles,C. Barton,3907182,,True,7.0,0,2,0,1,0,1,0,0,0,0,0,0,0,0,1,3,0
401086003,Niagara Purple Eagles,G. Kuakumensah,4279739,,False,5.0,0,0,0,0,0,0,0,0,0,1,1,0,0,0,0,1,0
401086003,Niagara Purple Eagles,K. Green,4067342,,False,9.0,1,2,1,2,0,0,0,0,1,1,2,0,0,0,2,0,2
401086003,Niagara Purple Eagles,G. King,3906490,,False,16.0,3,6,3,6,0,0,1,3,1,6,7,0,0,0,0,1,7
401086003,Niagara Purple Eagles,M. Hammond,4398404,,False,24.0,1,2,1,1,0,1,0,0,0,1,1,3,0,1,2,4,2
401086003,Niagara Purple Eagles,R. Solomon,4398403,,False,18.0,2,5,0,2,2,3,0,0,0,0,0,1,0,0,2,2,6
401086003,Niagara Purple Eagles,D. Fragala,4279737,,False,17.0,7,9,5,5,2,4,4,5,0,1,1,1,1,0,0,0,20
401086003,Niagara Purple Eagles,TEAM,TOTAL,TOTAL,False,,22,55,16,34,6,21,9,13,6,21,27,10,6,1,18,15,59
401086003,Fairfield Stags,J. Kasibabu,3947016,,True,30.0,10,14,10,13,0,1,0,0,4,10,14,1,1,0,2,3,20
401086003,Fairfield Stags,L. Taliaferro,4398078,,True,20.0,3,9,1,5,2,4,0,0,1,1,2,0,1,0,2,3,8
401086003,Fairfield Stags,F. Lemetti,4398076,,True,30.0,0,5,0,0,0,5,0,0,0,1,1,2,1,0,1,1,0
401086003,Fairfield Stags,N. Alvarez,4398075,,True,26.0,5,8,5,7,0,1,5,6,0,6,6,2,2,0,4,2,15
401086003,Fairfield Stags,J. Cruz,4279488,,True,33.0,5,7,4,6,1,1,2,3,3,6,9,3,1,1,2,0,13
401086003,Fairfield Stags,O. El-Sheikh,4279489,,False,6.0,1,2,1,2,0,0,0,0,0,1,1,0,0,0,0,1,2
401086003,Fairfield Stags,W. Methnani,4279486,,False,8.0,2,5,1,2,1,3,0,0,0,1,1,1,0,1,2,2,5
401086003,Fairfield Stags,K. Senghore-Peterson,4279485,,False,1.0,0,0,0,0,0,0,0,0,0,0,0,0,0,0,0,0,0
401086003,Fairfield Stags,M. Milin,3947018,,False,1.0,0,0,0,0,0,0,0,0,1,0,1,0,0,0,0,0,0
401086003,Fairfield Stags,C. Whipple,4398077,,False,19.0,3,5,1,1,2,4,0,0,1,3,4,0,0,0,0,3,8
401086003,Fairfield Stags,T. Benning,4279483,,False,1.0,0,0,0,0,0,0,0,0,0,0,0,0,0,0,1,2,0
401086003,Fairfield Stags,A. Kavaliauskas,4080375,,False,24.0,2,5,2,3,0,2,2,2,0,1,1,10,2,0,3,1,6
401086003,Fairfield Stags,T. Nolan,3947015,,False,1.0,0,1,0,0,0,1,0,0,0,0,0,0,1,0,0,0,0
401086003,Fairfield Stags,TEAM,TOTAL,TOTAL,False,,31,61,25,39,6,22,9,11,10,30,40,19,9,2,17,18,77
401086003,Fairfield Stags,J. Kasibabu,3947016,,True,30.0,10,14,10,13,0,1,0,0,4,10,14,1,1,0,2,3,20
401086003,Fairfield Stags,L. Taliaferro,4398078,,True,20.0,3,9,1,5,2,4,0,0,1,1,2,0,1,0,2,3,8
401086003,Fairfield Stags,F. Lemetti,4398076,,True,30.0,0,5,0,0,0,5,0,0,0,1,1,2,1,0,1,1,0
401086003,Fairfield Stags,N. Alvarez,4398075,,True,26.0,5,8,5,7,0,1,5,6,0,6,6,2,2,0,4,2,15
401086003,Fairfield Stags,J. Cruz,4279488,,True,33.0,5,7,4,6,1,1,2,3,3,6,9,3,1,1,2,0,13
401086003,Fairfield Stags,O. El-Sheikh,4279489,,False,6.0,1,2,1,2,0,0,0,0,0,1,1,0,0,0,0,1,2
401086003,Fairfield Stags,W. Methnani,4279486,,False,8.0,2,5,1,2,1,3,0,0,0,1,1,1,0,1,2,2,5
401086003,Fairfield Stags,K. Senghore-Peterson,4279485,,False,1.0,0,0,0,0,0,0,0,0,0,0,0,0,0,0,0,0,0
401086003,Fairfield Stags,M. Milin,3947018,,False,1.0,0,0,0,0,0,0,0,0,1,0,1,0,0,0,0,0,0
401086003,Fairfield Stags,C. Whipple,4398077,,False,19.0,3,5,1,1,2,4,0,0,1,3,4,0,0,0,0,3,8
401086003,Fairfield Stags,T. Benning,4279483,,False,1.0,0,0,0,0,0,0,0,0,0,0,0,0,0,0,1,2,0
401086003,Fairfield Stags,A. Kavaliauskas,4080375,,False,24.0,2,5,2,3,0,2,2,2,0,1,1,10,2,0,3,1,6
401086003,Fairfield Stags,T. Nolan,3947015,,False,1.0,0,1,0,0,0,1,0,0,0,0,0,0,1,0,0,0,0
401086003,Fairfield Stags,TEAM,TOTAL,TOTAL,False,,31,61,25,39,6,22,9,11,10,30,40,19,9,2,17,18,77
401086002,UAlbany Great Danes,A. Lulka,4278204,,True,26.0,5,9,5,7,0,2,3,4,1,5,6,0,1,0,1,4,13
401086002,UAlbany Great Danes,B. Hank,4278202,,True,23.0,2,3,2,3,0,0,2,2,5,9,14,0,0,0,2,3,6
401086002,UAlbany Great Danes,A. Rizzuto,4395873,,True,32.0,2,10,1,5,1,5,1,1,1,2,3,0,2,0,0,2,6
401086002,UAlbany Great Danes,C. Healy,4278203,,True,30.0,7,14,1,4,6,10,0,0,0,2,2,2,1,0,2,3,20
401086002,UAlbany Great Danes,A. Clark,4278199,,True,34.0,8,18,7,12,1,6,0,0,0,5,5,10,2,0,2,3,17
401086002,UAlbany Great Danes,K. Lauderdale,4395878,,False,4.0,0,0,0,0,0,0,0,0,0,0,0,0,0,0,2,1,0
401086002,UAlbany Great Danes,M. De Sousa,4395874,,False,4.0,0,0,0,0,0,0,0,0,0,1,1,0,0,0,1,0,0
401086002,UAlbany Great Danes,S. French,4066754,,False,0.0,0,0,0,0,0,0,0,0,0,0,0,0,0,0,0,0,0
401086002,UAlbany Great Danes,D. Campbell,4066683,,False,30.0,4,7,3,5,1,2,3,4,2,2,4,1,0,0,0,2,12
401086002,UAlbany Great Danes,R. Brooks,4395875,,False,1.0,0,1,0,0,0,1,0,0,0,0,0,0,0,0,1,0,0
401086002,UAlbany Great Danes,P. Flory,4278581,,False,13.0,1,2,0,0,1,2,2,2,0,3,3,0,0,0,1,3,5
401086002,UAlbany Great Danes,R. Miller,3961485,,False,3.0,0,0,0,0,0,0,0,0,0,0,0,0,0,0,0,1,0
401086002,UAlbany Great Danes,TEAM,TOTAL,TOTAL,False,,29,64,19,36,10,28,11,13,10,30,40,13,6,0,12,22,79
401086002,Niagara Purple Eagles,D. Robb,3907186,,True,18.0,2,7,2,7,0,0,1,2,1,3,4,0,0,3,1,1,5
401086002,Niagara Purple Eagles,M. Prochet,3907184,,True,23.0,4,9,1,4,3,5,2,5,1,8,9,2,0,2,2,3,13
401086002,Niagara Purple Eagles,K. Tate,4279738,,True,16.0,0,5,0,3,0,2,0,0,2,1,3,1,0,0,1,2,0
401086002,Niagara Purple Eagles,J. Towns,4067341,,True,34.0,3,10,3,9,0,1,8,9,0,3,3,5,1,0,3,2,14
401086002,Niagara Purple Eagles,C. Barton,3907182,,True,10.0,1,4,1,2,0,2,0,0,1,0,1,0,0,0,1,3,2
401086002,Niagara Purple Eagles,G. Kuakumensah,4279739,,False,15.0,0,0,0,0,0,0,2,2,1,2,3,0,0,0,0,2,2
401086002,Niagara Purple Eagles,K. Green,4067342,,False,3.0,0,1,0,0,0,1,0,0,0,0,0,0,0,0,0,2,0
401086002,Niagara Purple Eagles,G. King,3906490,,False,22.0,2,2,2,2,0,0,3,5,2,7,9,0,0,1,0,0,7
401086002,Niagara Purple Eagles,M. Hammond,4398404,,False,29.0,5,8,2,3,3,5,3,4,0,0,0,0,2,0,0,0,16
401086002,Niagara Purple Eagles,R. Solomon,4398403,,False,24.0,5,13,3,8,2,5,3,3,2,0,2,0,1,0,0,2,15
401086002,Niagara Purple Eagles,D. Fragala,4279737,,False,6.0,0,1,0,0,0,1,0,0,0,0,0,0,0,0,0,0,0
401086002,Niagara Purple Eagles,TEAM,TOTAL,TOTAL,False,,22,60,14,38,8,22,22,30,11,26,37,8,4,6,8,17,74
401086001,Norfolk State Spartans,C. Ford,4398209,,True,8.0,1,1,1,1,0,0,0,1,1,0,1,0,0,0,1,3,2
401086001,Norfolk State Spartans,A. Long,3947058,,True,19.0,3,8,3,8,0,0,0,0,0,2,2,0,0,1,0,1,6
401086001,Norfolk State Spartans,D. Jamerson Jr.,4279809,,True,26.0,0,4,0,1,0,3,2,2,0,2,2,0,0,1,0,2,2
401086001,Norfolk State Spartans,M. Pitt,4279808,,True,33.0,7,10,4,6,3,4,1,1,0,4,4,2,0,0,5,4,18
401086001,Norfolk State Spartans,N. Thomas,3948866,,True,31.0,4,13,1,5,3,8,2,2,0,4,4,4,0,0,3,2,13
401086001,Norfolk State Spartans,J. Butler,3156043,,False,35.0,6,12,6,12,0,0,0,0,3,6,9,0,0,2,2,3,12
401086001,Norfolk State Spartans,A. Branch,3155936,,False,7.0,1,1,0,0,1,1,0,0,0,3,3,0,0,0,0,1,3
401086001,Norfolk State Spartans,K. Chavis,4398210,,False,13.0,0,3,0,2,0,1,0,0,2,0,2,1,0,0,0,1,0
401086001,Norfolk State Spartans,C.J. Kelly,4398208,,False,13.0,2,6,2,6,0,0,0,0,0,5,5,1,1,1,2,1,4
401086001,Norfolk State Spartans,B. Fitzgerald,4398205,,False,2.0,1,2,1,2,0,0,0,0,1,1,2,1,1,0,0,1,2
401086001,Norfolk State Spartans,S. Whitley,3938909,,False,13.0,6,7,5,5,1,2,0,0,0,5,5,2,0,0,2,4,13
401086001,Norfolk State Spartans,TEAM,TOTAL,TOTAL,False,,31,67,23,48,8,19,5,6,9,33,42,11,2,5,15,23,75
401086001,Niagara Purple Eagles,D. Robb,3907186,,True,29.0,5,7,5,7,0,0,1,2,1,4,5,1,0,3,3,1,11
401086001,Niagara Purple Eagles,M. Prochet,3907184,,True,32.0,8,14,4,5,4,9,3,4,0,8,8,3,0,1,0,1,23
401086001,Niagara Purple Eagles,K. Tate,4279738,,True,25.0,4,12,1,5,3,7,3,5,1,2,3,0,1,0,0,1,14
401086001,Niagara Purple Eagles,J. Towns,4067341,,True,38.0,2,8,2,7,0,1,11,13,1,6,7,10,1,0,2,0,15
401086001,Niagara Purple Eagles,C. Barton,3907182,,True,14.0,0,2,0,1,0,1,0,0,3,1,4,2,1,0,1,0,0
401086001,Niagara Purple Eagles,G. Kuakumensah,4279739,,False,8.0,0,1,0,1,0,0,0,0,0,1,1,0,0,0,0,1,0
401086001,Niagara Purple Eagles,K. Green,4067342,,False,3.0,1,1,1,1,0,0,0,0,1,0,1,0,0,1,0,0,2
401086001,Niagara Purple Eagles,G. King,3906490,,False,9.0,1,2,1,2,0,0,0,2,0,2,2,0,0,0,2,5,2
401086001,Niagara Purple Eagles,M. Hammond,4398404,,False,21.0,2,5,1,2,1,3,0,0,0,2,2,0,0,0,0,1,5
401086001,Niagara Purple Eagles,R. Solomon,4398403,,False,20.0,4,9,2,5,2,4,1,2,0,1,1,4,1,0,0,2,11
401086001,Niagara Purple Eagles,D. Fragala,4279737,,False,1.0,0,0,0,0,0,0,0,1,0,1,1,1,0,0,0,2,0
401086001,Niagara Purple Eagles,TEAM,TOTAL,TOTAL,False,,27,61,17,36,10,25,19,29,9,28,37,21,4,5,8,14,83
401086000,Niagara Purple Eagles,D. Robb,3907186,,True,27.0,6,7,6,7,0,0,1,2,0,4,4,1,0,3,1,2,13
401086000,Niagara Purple Eagles,M. Prochet,3907184,,True,26.0,5,13,3,9,2,4,3,4,3,6,9,1,2,3,3,3,15
401086000,Niagara Purple Eagles,K. Tate,4279738,,True,30.0,4,10,4,6,0,4,1,1,0,5,5,2,3,0,2,1,9
401086000,Niagara Purple Eagles,J. Towns,4067341,,True,32.0,6,13,5,11,1,2,6,8,1,5,6,5,0,0,5,0,19
401086000,Niagara Purple Eagles,C. Barton,3907182,,True,17.0,2,7,1,3,1,4,0,0,0,1,1,0,0,0,1,1,5
401086000,Niagara Purple Eagles,G. Kuakumensah,4279739,,False,14.0,1,1,1,1,0,0,0,0,0,2,2,0,1,0,1,2,2
401086000,Niagara Purple Eagles,G. King,3906490,,False,13.0,1,3,1,3,0,0,0,0,1,10,11,0,0,0,3,2,2
401086000,Niagara Purple Eagles,M. Hammond,4398404,,False,23.0,3,4,1,1,2,3,0,0,0,2,2,1,1,0,1,0,8
401086000,Niagara Purple Eagles,R. Solomon,4398403,,False,18.0,2,5,1,1,1,4,0,0,0,1,1,1,0,0,1,2,5
401086000,Niagara Purple Eagles,TEAM,TOTAL,TOTAL,False,,30,63,23,42,7,21,11,15,7,38,45,11,7,6,18,13,78
401086000,Army Black Knights,M. Wilson,4067091,,True,25.0,2,10,2,10,0,0,1,2,0,4,4,0,1,0,3,1,5
401086000,Army Black Knights,A. King,4284080,,True,30.0,4,14,2,8,2,6,2,3,1,3,4,3,0,0,1,4,12
401086000,Army Black Knights,T. Funk,4067089,,True,35.0,3,6,1,3,2,3,2,2,0,3,3,5,0,0,4,3,10
401086000,Army Black Knights,J. Fox,3948826,,True,35.0,4,12,0,5,4,7,0,0,0,4,4,6,1,0,2,2,12
401086000,Army Black Knights,J. Kessler,3155887,,True,8.0,1,2,0,0,1,2,0,0,0,0,0,0,1,0,0,0,3
401086000,Army Black Knights,A. Duhart,4397609,,False,5.0,2,3,2,3,0,0,0,0,0,2,2,0,0,0,2,1,4
401086000,Army Black Knights,J. Caldwell,4397607,,False,20.0,0,6,0,4,0,2,0,0,3,4,7,1,1,0,1,1,0
401086000,Army Black Knights,T. Blackwell,4284076,,False,5.0,0,0,0,0,0,0,0,2,0,0,0,1,0,0,0,0,0
401086000,Army Black Knights,L. Grayson,4284075,,False,12.0,3,6,0,1,3,5,1,2,0,3,3,1,2,0,0,1,10
401086000,Army Black Knights,J. Emezie,3948830,,False,14.0,2,3,0,0,2,3,0,0,0,0,0,0,0,0,1,0,6
401086000,Army Black Knights,C. Edwards,3948821,,False,11.0,2,6,2,6,0,0,0,0,2,4,6,0,0,0,1,3,4
401086000,Army Black Knights,TEAM,TOTAL,TOTAL,False,,23,68,9,40,14,28,6,11,8,28,36,17,6,0,15,16,66
401085999,Niagara Purple Eagles,D. Robb,3907186,,True,19.0,4,9,4,7,0,2,0,0,2,8,10,3,0,3,1,1,8
401085999,Niagara Purple Eagles,M. Prochet,3907184,,True,34.0,4,17,3,8,1,9,3,4,4,6,10,0,1,1,2,3,12
401085999,Niagara Purple Eagles,K. Tate,4279738,,True,25.0,1,7,1,3,0,4,0,0,1,2,3,2,1,0,4,3,2
401085999,Niagara Purple Eagles,J. Towns,4067341,,True,28.0,6,16,5,14,1,2,5,5,2,2,4,4,1,0,3,3,18
401085999,Niagara Purple Eagles,C. Barton,3907182,,True,26.0,1,4,1,2,0,2,0,0,0,1,1,2,1,0,1,3,2
401085999,Niagara Purple Eagles,G. Kuakumensah,4279739,,False,4.0,0,1,0,0,0,1,0,0,0,0,0,0,0,0,0,0,0
401085999,Niagara Purple Eagles,K. Green,4067342,,False,7.0,1,3,1,1,0,2,0,0,1,1,2,0,0,0,1,3,2
401085999,Niagara Purple Eagles,G. King,3906490,,False,17.0,1,3,1,3,0,0,3,6,3,5,8,0,0,0,2,2,5
401085999,Niagara Purple Eagles,M. Hammond,4398404,,False,22.0,3,5,0,1,3,4,0,0,0,1,1,0,0,0,1,2,9
401085999,Niagara Purple Eagles,R. Solomon,4398403,,False,17.0,1,3,1,2,0,1,0,0,1,0,1,0,0,0,0,0,2
401085999,Niagara Purple Eagles,D. Fragala,4279737,,False,1.0,0,0,0,0,0,0,0,0,0,0,0,0,0,0,0,0,0
401085999,Niagara Purple Eagles,TEAM,TOTAL,TOTAL,False,,22,68,17,41,5,27,11,15,18,27,45,11,4,4,15,20,60
401085999,Cleveland State Vikings,J. Hill,4399105,,True,28.0,5,10,5,10,0,0,1,3,5,3,8,2,1,1,2,2,11
401085999,Cleveland State Vikings,S. Kenic,4280301,,True,23.0,5,11,5,7,0,4,4,5,2,2,4,1,1,0,1,3,14
401085999,Cleveland State Vikings,S. Millner Jr.,4399107,,True,17.0,1,2,1,1,0,1,0,0,0,0,0,1,0,0,0,1,2
401085999,Cleveland State Vikings,T. Appleby,4280299,,True,30.0,4,9,1,5,3,4,5,9,0,8,8,4,1,1,2,3,16
401085999,Cleveland State Vikings,K. Thomas,4067414,,True,27.0,6,9,5,5,1,4,0,1,0,4,4,1,0,0,3,4,13
401085999,Cleveland State Vikings,D. Johnson,4399102,,False,13.0,1,4,1,4,0,0,2,2,1,4,5,2,1,0,0,1,4
401085999,Cleveland State Vikings,A. Eichelberger,4065777,,False,17.0,3,7,3,7,0,0,0,0,2,1,3,1,0,1,2,0,6
401085999,Cleveland State Vikings,R. Williams,4399106,,False,27.0,4,11,0,0,4,11,2,2,0,3,3,1,0,0,0,1,14
401085999,Cleveland State Vikings,D. Highsmith,67060,,False,18.0,0,1,0,1,0,0,2,2,0,2,2,0,2,1,0,2,2
401085999,Cleveland State Vikings,TEAM,TOTAL,TOTAL,False,,29,64,21,40,8,24,16,24,12,30,42,13,6,4,10,17,82
401085998,Niagara Purple Eagles,D. Robb,3907186,,True,28.0,4,8,4,8,0,0,4,4,5,4,9,2,1,1,0,1,12
401085998,Niagara Purple Eagles,M. Prochet,3907184,,True,38.0,7,15,2,7,5,8,5,11,1,9,10,2,1,0,1,1,24
401085998,Niagara Purple Eagles,K. Tate,4279738,,True,33.0,9,18,4,7,5,11,0,0,1,4,5,2,0,0,2,3,23
401085998,Niagara Purple Eagles,J. Towns,4067341,,True,36.0,3,10,3,10,0,0,2,2,0,3,3,5,0,0,0,1,8
401085998,Niagara Purple Eagles,C. Barton,3907182,,True,34.0,2,7,2,6,0,1,2,2,2,0,2,2,0,0,1,4,6
401085998,Niagara Purple Eagles,G. Kuakumensah,4279739,,False,2.0,0,1,0,0,0,1,0,0,0,0,0,0,0,0,0,0,0
401085998,Niagara Purple Eagles,G. King,3906490,,False,12.0,0,1,0,1,0,0,0,0,1,4,5,0,1,0,0,3,0
401085998,Niagara Purple Eagles,M. Hammond,4398404,,False,4.0,0,0,0,0,0,0,0,0,0,0,0,0,0,0,0,0,0
401085998,Niagara Purple Eagles,R. Solomon,4398403,,False,9.0,0,2,0,1,0,1,2,2,0,0,0,0,0,0,0,4,2
401085998,Niagara Purple Eagles,D. Fragala,4279737,,False,4.0,1,3,1,1,0,2,0,0,0,0,0,0,0,0,0,0,2
401085998,Niagara Purple Eagles,TEAM,TOTAL,TOTAL,False,,26,65,16,41,10,24,15,21,14,24,38,13,3,1,4,17,77
401085998,Cornell Big Red,S. Julian,4279477,,True,35.0,4,7,4,7,0,0,0,0,4,6,10,0,0,5,1,3,8
401085998,Cornell Big Red,J. Warren,4066813,,True,31.0,8,14,7,11,1,3,3,4,1,3,4,5,0,0,2,2,20
401085998,Cornell Big Red,T. Whiteside,3906954,,True,20.0,1,3,0,1,1,2,0,0,0,2,2,0,0,0,1,3,3
401085998,Cornell Big Red,T. McBride,4279474,,True,31.0,0,3,0,2,0,1,2,2,0,3,3,5,0,0,1,2,2
401085998,Cornell Big Red,M. Morgan,3906955,,True,30.0,6,15,2,7,4,8,6,6,0,1,1,5,1,1,1,2,22
401085998,Cornell Big Red,J. Boeheim,4279472,,False,22.0,4,9,2,5,2,4,2,4,0,4,4,2,1,1,0,1,12
401085998,Cornell Big Red,J. Kuhn,4279476,,False,13.0,0,1,0,1,0,0,0,0,0,1,1,0,0,0,1,0,0
401085998,Cornell Big Red,B. Knapp,4279473,,False,6.0,1,1,1,1,0,0,0,0,0,1,1,0,0,0,0,1,2
401085998,Cornell Big Red,J. Davis,3906957,,False,12.0,0,2,0,2,0,0,5,5,2,2,4,0,0,0,3,2,5
401085998,Cornell Big Red,TEAM,TOTAL,TOTAL,False,,24,55,16,37,8,18,18,21,10,29,39,17,2,7,10,16,74
401085997,Niagara Purple Eagles,D. Robb,3907186,,True,30.0,4,6,4,6,0,0,0,0,1,5,6,2,0,2,2,3,8
401085997,Niagara Purple Eagles,M. Prochet,3907184,,True,32.0,6,15,4,8,2,7,1,1,1,3,4,1,0,1,0,1,15
401085997,Niagara Purple Eagles,K. Tate,4279738,,True,22.0,1,7,1,5,0,2,2,2,0,3,3,0,1,0,1,0,4
401085997,Niagara Purple Eagles,J. Towns,4067341,,True,36.0,9,13,8,9,1,4,4,6,0,6,6,6,0,0,1,1,23
401085997,Niagara Purple Eagles,C. Barton,3907182,,True,28.0,1,5,1,2,0,3,1,2,1,9,10,1,0,0,1,1,3
401085997,Niagara Purple Eagles,K. Green,4067342,,False,8.0,1,2,1,2,0,0,0,0,0,3,3,2,0,0,0,0,2
401085997,Niagara Purple Eagles,G. King,3906490,,False,10.0,1,2,1,2,0,0,0,0,0,1,1,0,0,0,1,3,2
401085997,Niagara Purple Eagles,M. Hammond,4398404,,False,4.0,0,0,0,0,0,0,0,0,0,0,0,0,0,0,0,1,0
401085997,Niagara Purple Eagles,R. Solomon,4398403,,False,18.0,4,6,0,0,4,6,2,2,1,2,3,0,2,0,1,1,14
401085997,Niagara Purple Eagles,D. Fragala,4279737,,False,12.0,0,4,0,0,0,4,0,0,1,0,1,0,0,0,0,1,0
401085997,Niagara Purple Eagles,TEAM,TOTAL,TOTAL,False,,27,60,20,34,7,26,10,13,5,33,38,12,3,3,7,12,71
401085997,New Hampshire Wildcats,C. Lester,4066728,,True,11.0,1,3,1,2,0,1,0,0,1,3,4,0,0,0,1,2,2
401085997,New Hampshire Wildcats,D. Watkins,3922029,,True,11.0,2,6,1,2,1,4,0,0,0,1,1,0,0,0,1,1,5
401085997,New Hampshire Wildcats,M. Maultsby,4396576,,True,25.0,4,12,3,10,1,2,3,3,1,2,3,1,1,0,1,4,12
401085997,New Hampshire Wildcats,E. Jordan,4278237,,True,35.0,2,5,2,4,0,1,2,2,1,1,2,4,0,1,0,1,6
401085997,New Hampshire Wildcats,J. Reed,3132469,,True,37.0,4,14,1,3,3,11,1,1,0,4,4,3,2,0,1,4,12
401085997,New Hampshire Wildcats,J. Martinez,4396579,,False,33.0,8,14,6,8,2,6,2,3,2,11,13,3,0,2,1,0,20
401085997,New Hampshire Wildcats,N. Guadarrama,4396578,,False,25.0,3,8,1,3,2,5,0,0,2,4,6,1,1,0,0,0,8
401085997,New Hampshire Wildcats,D. Hall,4396577,,False,5.0,0,0,0,0,0,0,0,0,0,2,2,0,0,0,1,0,0
401085997,New Hampshire Wildcats,M. Carbone,4066743,,False,9.0,0,1,0,0,0,1,0,0,0,2,2,1,0,0,0,2,0
401085997,New Hampshire Wildcats,K. Love,4066727,,False,9.0,1,4,1,1,0,3,0,0,1,0,1,0,0,0,0,1,2
401085997,New Hampshire Wildcats,TEAM,TOTAL,TOTAL,False,,25,67,16,33,9,34,8,9,9,30,39,13,4,3,7,15,67
401085996,St. Francis (PA) Red Flash,M. Thompson,4398017,,True,13.0,2,4,2,2,0,2,0,1,1,4,5,0,0,0,0,1,4
401085996,St. Francis (PA) Red Flash,L. Laporal,4280255,,True,21.0,5,12,5,12,0,0,1,1,4,3,7,0,0,0,1,3,11
401085996,St. Francis (PA) Red Flash,K. Braxton,4067957,,True,37.0,9,13,8,10,1,3,6,6,1,11,12,7,3,0,2,2,25
401085996,St. Francis (PA) Red Flash,J. King,3957062,,True,31.0,3,10,2,7,1,3,2,3,0,2,2,5,1,0,4,3,9
401085996,St. Francis (PA) Red Flash,A. Wolford,3924892,,True,31.0,2,9,0,1,2,8,1,2,0,1,1,0,2,0,0,0,7
401085996,St. Francis (PA) Red Flash,D. Kuzavas,4067960,,False,8.0,2,3,2,3,0,0,0,0,2,0,2,0,0,0,1,2,4
401085996,St. Francis (PA) Red Flash,M. Flagg,4280256,,False,16.0,4,6,4,6,0,0,0,1,2,2,4,0,0,1,1,3,8
401085996,St. Francis (PA) Red Flash,R. Dixon-Conover,4398016,,False,3.0,1,2,1,2,0,0,0,0,0,1,1,1,0,0,2,0,2
401085996,St. Francis (PA) Red Flash,R. Gaskins Jr.,4067956,,False,17.0,0,2,0,1,0,1,0,0,2,1,3,0,0,1,2,2,0
401085996,St. Francis (PA) Red Flash,I. Blackmon,3924894,,False,23.0,3,11,2,5,1,6,2,2,2,2,4,0,0,0,0,3,9
401085996,St. Francis (PA) Red Flash,TEAM,TOTAL,TOTAL,False,,31,72,26,49,5,23,12,16,15,27,42,13,6,2,13,19,79
401085996,Niagara Purple Eagles,G. Kuakumensah,4279739,,True,8.0,0,1,0,0,0,1,0,0,0,2,2,0,0,0,0,4,0
401085996,Niagara Purple Eagles,D. Robb,3907186,,True,35.0,9,14,9,12,0,2,4,6,1,7,8,2,0,3,0,2,22
401085996,Niagara Purple Eagles,K. Tate,4279738,,True,25.0,4,12,1,4,3,8,4,4,1,3,4,2,0,0,1,2,15
401085996,Niagara Purple Eagles,J. Towns,4067341,,True,31.0,5,11,2,6,3,5,3,3,0,4,4,3,1,0,4,0,16
401085996,Niagara Purple Eagles,C. Barton,3907182,,True,31.0,1,6,0,4,1,2,0,0,3,2,5,2,0,0,2,3,3
401085996,Niagara Purple Eagles,K. Green,4067342,,False,21.0,1,4,1,3,0,1,0,0,0,6,6,1,2,0,2,4,2
401085996,Niagara Purple Eagles,G. King,3906490,,False,14.0,1,4,1,4,0,0,0,0,2,2,4,0,0,0,3,2,2
401085996,Niagara Purple Eagles,M. Hammond,4398404,,False,9.0,0,0,0,0,0,0,2,2,0,0,0,0,0,0,0,0,2
401085996,Niagara Purple Eagles,R. Solomon,4398403,,False,17.0,4,9,3,4,1,5,4,5,1,3,4,0,0,0,2,3,13
401085996,Niagara Purple Eagles,D. Fragala,4279737,,False,9.0,0,2,0,1,0,1,0,0,0,0,0,0,0,0,0,0,0
401085996,Niagara Purple Eagles,TEAM,TOTAL,TOTAL,False,,25,63,17,38,8,25,17,20,11,29,40,10,3,3,15,20,75
401085995,Niagara Purple Eagles,D. Robb,3907186,,True,29.0,6,12,6,12,0,0,3,6,4,6,10,0,3,2,1,2,15
401085995,Niagara Purple Eagles,M. Prochet,3907184,,True,36.0,7,15,4,9,3,6,6,8,2,10,12,0,0,1,1,3,23
401085995,Niagara Purple Eagles,K. Tate,4279738,,True,31.0,3,9,3,6,0,3,0,0,1,2,3,0,0,0,2,3,6
401085995,Niagara Purple Eagles,J. Towns,4067341,,True,27.0,1,12,1,7,0,5,4,4,1,2,3,6,0,0,2,3,6
401085995,Niagara Purple Eagles,C. Barton,3907182,,True,29.0,3,7,3,5,0,2,3,4,2,1,3,4,0,0,0,1,9
401085995,Niagara Purple Eagles,G. Kuakumensah,4279739,,False,2.0,0,0,0,0,0,0,0,0,0,0,0,0,0,0,0,1,0
401085995,Niagara Purple Eagles,K. Green,4067342,,False,1.0,0,1,0,0,0,1,0,0,0,0,0,0,0,0,0,2,0
401085995,Niagara Purple Eagles,G. King,3906490,,False,11.0,2,4,2,4,0,0,0,0,0,2,2,0,0,1,2,3,4
401085995,Niagara Purple Eagles,M. Hammond,4398404,,False,13.0,0,0,0,0,0,0,2,2,0,1,1,0,1,0,0,0,2
401085995,Niagara Purple Eagles,R. Solomon,4398403,,False,18.0,0,5,0,1,0,4,3,4,1,1,2,0,0,0,1,1,3
401085995,Niagara Purple Eagles,D. Fragala,4279737,,False,3.0,0,1,0,0,0,1,0,0,0,0,0,0,0,0,0,0,0
401085995,Niagara Purple Eagles,TEAM,TOTAL,TOTAL,False,,22,66,19,44,3,22,21,28,13,27,40,10,4,4,9,19,68
401085995,Grambling Tigers,D. Jackson,4280111,,True,27.0,5,11,4,10,1,1,5,6,0,3,3,1,0,2,1,2,16
401085995,Grambling Tigers,T. Bunch,4280113,,True,19.0,2,3,2,3,0,0,0,1,0,4,4,0,0,1,3,4,4
401085995,Grambling Tigers,L. Johnson,4280112,,True,37.0,6,12,3,5,3,7,0,0,0,6,6,1,0,0,0,2,15
401085995,Grambling Tigers,I. Smith Jr.,4072626,,True,28.0,3,8,2,7,1,1,5,9,0,6,6,9,2,0,2,4,12
401085995,Grambling Tigers,A. Mpoyo,4280107,,False,8.0,1,3,1,1,0,2,0,0,0,1,1,0,0,0,2,4,2
401085995,Grambling Tigers,Z. Peart,4067311,,False,21.0,5,7,5,7,0,0,1,2,1,3,4,1,0,1,0,1,11
401085995,Grambling Tigers,D. Polk-Hilliard,4279529,,False,38.0,3,5,2,3,1,2,3,4,2,8,10,0,0,0,1,3,10
401085995,Grambling Tigers,P. Moss,4280109,,False,7.0,1,1,1,1,0,0,0,0,0,1,1,0,0,0,2,0,2
401085995,Grambling Tigers,S. Athie,4280105,,False,2.0,0,1,0,1,0,0,0,0,0,0,0,1,0,0,0,0,0
401085995,Grambling Tigers,N. Ribeiro,3947705,,False,13.0,1,4,1,3,0,1,0,0,0,1,1,2,0,0,1,1,2
401085995,Grambling Tigers,TEAM,TOTAL,TOTAL,False,,27,55,21,41,6,14,14,22,5,34,39,15,2,4,15,21,74
401085994,Wyoming Cowboys,A. Mueller,4066794,,True,29.0,2,3,2,3,0,0,1,2,0,5,5,1,2,1,3,3,5
401085994,Wyoming Cowboys,J. Hendricks,4397443,,True,38.0,6,12,3,6,3,6,0,0,0,3,3,1,1,0,3,2,15
401085994,Wyoming Cowboys,H. Maldonado,4280267,,True,40.0,6,18,6,12,0,6,1,2,3,12,15,2,0,1,4,4,13
401085994,Wyoming Cowboys,J. James,3914058,,True,37.0,7,15,5,12,2,3,7,8,1,7,8,1,2,0,1,2,23
401085994,Wyoming Cowboys,N. Redding,3134927,,True,32.0,2,4,2,3,0,1,0,0,0,1,1,3,1,0,1,2,4
401085994,Wyoming Cowboys,B. Porter,4397445,,False,5.0,2,3,0,1,2,2,0,0,0,1,1,0,0,1,0,0,6
401085994,Wyoming Cowboys,T. Taylor,4397446,,False,9.0,0,2,0,2,0,0,1,2,3,0,3,0,0,0,1,0,1
401085994,Wyoming Cowboys,T. Johnson,4397444,,False,2.0,0,3,0,2,0,1,0,0,1,0,1,0,0,0,1,1,0
401085994,Wyoming Cowboys,A.J. Banks,4397440,,False,8.0,0,2,0,1,0,1,0,0,0,1,1,0,0,0,1,1,0
401085994,Wyoming Cowboys,TEAM,TOTAL,TOTAL,False,,25,62,18,42,7,20,10,14,9,33,42,8,6,3,15,15,67
401085994,Niagara Purple Eagles,D. Robb,3907186,,True,29.0,4,9,3,8,1,1,4,4,2,4,6,1,0,3,1,3,13
401085994,Niagara Purple Eagles,M. Prochet,3907184,,True,35.0,8,17,3,6,5,11,2,4,3,9,12,0,1,0,1,1,23
401085994,Niagara Purple Eagles,K. Tate,4279738,,True,33.0,0,6,0,3,0,3,0,0,0,3,3,2,1,0,0,1,0
401085994,Niagara Purple Eagles,J. Towns,4067341,,True,36.0,2,9,2,6,0,3,4,5,0,3,3,3,0,0,2,2,8
401085994,Niagara Purple Eagles,C. Barton,3907182,,True,34.0,4,12,2,6,2,6,2,2,0,5,5,2,0,0,3,1,12
401085994,Niagara Purple Eagles,G. Kuakumensah,4279739,,False,7.0,0,1,0,1,0,0,0,0,1,0,1,0,0,0,0,2,0
401085994,Niagara Purple Eagles,K. Green,4067342,,False,4.0,0,1,0,1,0,0,0,0,1,0,1,0,0,0,1,1,0
401085994,Niagara Purple Eagles,G. King,3906490,,False,4.0,2,2,2,2,0,0,0,0,1,1,2,0,0,0,1,3,4
401085994,Niagara Purple Eagles,M. Hammond,4398404,,False,4.0,0,0,0,0,0,0,0,0,0,0,0,1,0,0,0,0,0
401085994,Niagara Purple Eagles,R. Solomon,4398403,,False,14.0,5,9,3,3,2,6,0,0,1,1,2,1,1,0,1,1,12
401085994,Niagara Purple Eagles,TEAM,TOTAL,TOTAL,False,,25,66,15,36,10,30,12,15,10,29,39,10,3,3,11,16,72
401085993,Niagara Purple Eagles,D. Robb,3907186,,True,20.0,3,7,2,4,1,3,3,3,0,3,3,0,0,4,1,3,10
401085993,Niagara Purple Eagles,M. Prochet,3907184,,True,33.0,4,16,1,9,3,7,3,3,6,5,11,2,0,0,1,4,14
401085993,Niagara Purple Eagles,K. Tate,4279738,,True,29.0,2,11,0,5,2,6,0,0,2,3,5,1,0,0,3,1,6
401085993,Niagara Purple Eagles,J. Towns,4067341,,True,37.0,7,15,6,13,1,2,4,5,3,4,7,1,1,0,2,1,19
401085993,Niagara Purple Eagles,C. Barton,3907182,,True,28.0,3,6,3,4,0,2,7,8,0,2,2,3,2,0,1,1,13
401085993,Niagara Purple Eagles,G. Kuakumensah,4279739,,False,4.0,0,1,0,0,0,1,0,0,0,0,0,0,0,0,0,1,0
401085993,Niagara Purple Eagles,K. Green,4067342,,False,3.0,0,0,0,0,0,0,0,0,0,0,0,0,0,0,0,0,0
401085993,Niagara Purple Eagles,G. King,3906490,,False,20.0,0,5,0,5,0,0,0,0,1,5,6,0,0,0,1,2,0
401085993,Niagara Purple Eagles,M. Hammond,4398404,,False,13.0,0,0,0,0,0,0,0,0,2,0,2,0,0,0,0,1,0
401085993,Niagara Purple Eagles,R. Solomon,4398403,,False,3.0,0,1,0,0,0,1,0,0,0,1,1,1,0,0,0,1,0
401085993,Niagara Purple Eagles,D. Fragala,4279737,,False,10.0,0,3,0,2,0,1,0,0,0,0,0,1,0,0,0,1,0
401085993,Niagara Purple Eagles,TEAM,TOTAL,TOTAL,False,,19,65,12,42,7,23,17,19,14,23,37,9,3,4,9,16,62
401085993,Loyola Chicago Ramblers,A. Uguak,4066717,,True,32.0,6,9,6,7,0,2,3,4,2,2,4,3,0,0,2,1,15
401085993,Loyola Chicago Ramblers,C. Krutwig,4279150,,True,30.0,7,7,7,7,0,0,4,7,2,9,11,3,0,4,3,3,18
401085993,Loyola Chicago Ramblers,L. Williamson,4279147,,True,25.0,2,6,0,1,2,5,0,0,0,5,5,0,1,0,0,5,6
401085993,Loyola Chicago Ramblers,M. Townes,3133963,,True,35.0,6,14,5,10,1,4,2,3,1,8,9,4,2,2,1,0,15
401085993,Loyola Chicago Ramblers,C. Custer,3133597,,True,24.0,6,9,5,6,1,3,1,3,0,1,1,2,1,0,1,4,14
401085993,Loyola Chicago Ramblers,F. Agunanne,4397431,,False,9.0,1,4,1,4,0,0,0,0,1,1,2,0,0,0,1,2,2
401085993,Loyola Chicago Ramblers,C. Negron,4279149,,False,2.0,0,1,0,1,0,0,0,0,0,1,1,0,0,0,0,0,0
401085993,Loyola Chicago Ramblers,C. Kaifes,4397430,,False,9.0,0,1,0,1,0,0,0,0,0,1,1,1,0,0,1,0,0
401085993,Loyola Chicago Ramblers,I. Bujdoso,4397429,,False,15.0,1,2,1,2,0,0,0,0,0,2,2,2,1,0,0,0,2
401085993,Loyola Chicago Ramblers,B. Skokna,4067020,,False,19.0,1,5,0,0,1,5,0,0,0,3,3,1,1,0,1,2,3
401085993,Loyola Chicago Ramblers,TEAM,TOTAL,TOTAL,False,,30,58,25,39,5,19,10,17,8,34,42,16,6,6,10,17,75
401085992,Rider Broncs,F. Scott,3922033,,True,13.0,2,4,1,3,1,1,1,2,2,0,2,0,1,0,1,2,6
401085992,Rider Broncs,T. Marshall,4067348,,True,21.0,2,6,2,6,0,0,2,2,2,2,4,1,1,1,0,1,6
401085992,Rider Broncs,S. Jordan,4067349,,True,37.0,4,10,2,5,2,5,3,8,1,6,7,4,3,0,2,2,13
401085992,Rider Broncs,K. Williams,3946983,,True,19.0,1,4,1,2,0,2,1,3,1,1,2,4,1,0,1,1,3
401085992,Rider Broncs,A. Durham,3138490,,True,35.0,3,8,1,2,2,6,5,6,0,2,2,1,0,0,1,1,13
401085992,Rider Broncs,K. Cisse,4279746,,False,5.0,1,1,1,1,0,0,2,2,0,1,1,0,0,0,0,1,4
401085992,Rider Broncs,D. Eke,3941312,,False,18.0,1,1,1,1,0,0,1,2,1,2,3,1,3,1,2,3,3
401085992,Rider Broncs,D. Vaughn,4067347,,False,17.0,1,4,0,2,1,2,0,0,0,4,4,1,0,1,3,3,3
401085992,Rider Broncs,J. Allen,4067345,,False,25.0,7,11,1,2,6,9,3,4,0,2,2,0,0,0,0,1,23
401085992,Rider Broncs,A. Gilbert,3911886,,False,10.0,0,2,0,1,0,1,1,2,0,3,3,1,0,0,3,1,1
401085992,Rider Broncs,TEAM,TOTAL,TOTAL,False,,22,51,10,25,12,26,19,31,8,27,35,13,9,3,13,16,75
401085992,Rider Broncs,F. Scott,3922033,,True,13.0,2,4,1,3,1,1,1,2,2,0,2,0,1,0,1,2,6
401085992,Rider Broncs,T. Marshall,4067348,,True,21.0,2,6,2,6,0,0,2,2,2,2,4,1,1,1,0,1,6
401085992,Rider Broncs,S. Jordan,4067349,,True,37.0,4,10,2,5,2,5,3,8,1,6,7,4,3,0,2,2,13
401085992,Rider Broncs,K. Williams,3946983,,True,19.0,1,4,1,2,0,2,1,3,1,1,2,4,1,0,1,1,3
401085992,Rider Broncs,A. Durham,3138490,,True,35.0,3,8,1,2,2,6,5,6,0,2,2,1,0,0,1,1,13
401085992,Rider Broncs,K. Cisse,4279746,,False,5.0,1,1,1,1,0,0,2,2,0,1,1,0,0,0,0,1,4
401085992,Rider Broncs,D. Eke,3941312,,False,18.0,1,1,1,1,0,0,1,2,1,2,3,1,3,1,2,3,3
401085992,Rider Broncs,D. Vaughn,4067347,,False,17.0,1,4,0,2,1,2,0,0,0,4,4,1,0,1,3,3,3
401085992,Rider Broncs,J. Allen,4067345,,False,25.0,7,11,1,2,6,9,3,4,0,2,2,0,0,0,0,1,23
401085992,Rider Broncs,A. Gilbert,3911886,,False,10.0,0,2,0,1,0,1,1,2,0,3,3,1,0,0,3,1,1
401085992,Rider Broncs,TEAM,TOTAL,TOTAL,False,,22,51,10,25,12,26,19,31,8,27,35,13,9,3,13,16,75
401085992,Marist Red Foxes,I. Lamb,3936028,,True,23.0,1,9,1,4,0,5,1,3,1,3,4,4,2,1,0,3,3
401085992,Marist Red Foxes,R. Funk,3936026,,True,33.0,5,10,1,1,4,9,2,2,0,2,2,0,1,0,2,1,16
401085992,Marist Red Foxes,T. Sjoberg,4067328,,True,24.0,2,3,2,3,0,0,1,2,4,3,7,3,1,0,2,4,5
401085992,Marist Red Foxes,B. Parker,3936030,,True,31.0,8,14,8,14,0,0,3,3,0,4,4,2,0,0,5,3,19
401085992,Marist Red Foxes,D. Knudsen,3936027,,True,18.0,0,5,0,4,0,1,0,0,2,2,4,1,0,0,0,1,0
401085992,Marist Red Foxes,L. Nedrow,4398414,,False,3.0,0,1,0,1,0,0,0,0,0,1,1,0,0,0,0,2,0
401085992,Marist Red Foxes,A. Dozic,3923222,,False,13.0,1,2,1,2,0,0,3,3,2,1,3,2,0,1,1,6,5
401085992,Marist Red Foxes,M. Herasme,4398413,,False,17.0,2,3,1,1,1,2,0,0,1,3,4,0,0,0,0,2,5
401085992,Marist Red Foxes,D. Hines,4398410,,False,14.0,0,5,0,2,0,3,0,0,0,0,0,0,0,0,3,0,0
401085992,Marist Red Foxes,A. Williams,4279709,,False,24.0,4,5,4,5,0,0,3,4,1,5,6,1,3,0,5,3,11
401085992,Marist Red Foxes,TEAM,TOTAL,TOTAL,False,,23,57,18,37,5,20,13,17,11,27,38,13,7,2,18,25,64
401085992,Marist Red Foxes,I. Lamb,3936028,,True,23.0,1,9,1,4,0,5,1,3,1,3,4,4,2,1,0,3,3
401085992,Marist Red Foxes,R. Funk,3936026,,True,33.0,5,10,1,1,4,9,2,2,0,2,2,0,1,0,2,1,16
401085992,Marist Red Foxes,T. Sjoberg,4067328,,True,24.0,2,3,2,3,0,0,1,2,4,3,7,3,1,0,2,4,5
401085992,Marist Red Foxes,B. Parker,3936030,,True,31.0,8,14,8,14,0,0,3,3,0,4,4,2,0,0,5,3,19
401085992,Marist Red Foxes,D. Knudsen,3936027,,True,18.0,0,5,0,4,0,1,0,0,2,2,4,1,0,0,0,1,0
401085992,Marist Red Foxes,L. Nedrow,4398414,,False,3.0,0,1,0,1,0,0,0,0,0,1,1,0,0,0,0,2,0
401085992,Marist Red Foxes,A. Dozic,3923222,,False,13.0,1,2,1,2,0,0,3,3,2,1,3,2,0,1,1,6,5
401085992,Marist Red Foxes,M. Herasme,4398413,,False,17.0,2,3,1,1,1,2,0,0,1,3,4,0,0,0,0,2,5
401085992,Marist Red Foxes,D. Hines,4398410,,False,14.0,0,5,0,2,0,3,0,0,0,0,0,0,0,0,3,0,0
401085992,Marist Red Foxes,A. Williams,4279709,,False,24.0,4,5,4,5,0,0,3,4,1,5,6,1,3,0,5,3,11
401085992,Marist Red Foxes,TEAM,TOTAL,TOTAL,False,,23,57,18,37,5,20,13,17,11,27,38,13,7,2,18,25,64
401085991,Marist Red Foxes,I. Lamb,3936028,,True,32.0,1,7,1,5,0,2,0,0,4,6,10,0,0,0,0,0,2
401085991,Marist Red Foxes,T. Sjoberg,4067328,,True,15.0,1,4,1,4,0,0,0,0,1,3,4,0,0,0,1,3,2
401085991,Marist Red Foxes,D. Hines,4398410,,True,17.0,0,2,0,1,0,1,0,0,0,0,0,1,0,0,1,0,0
401085991,Marist Red Foxes,B. Parker,3936030,,True,29.0,5,12,5,12,0,0,6,8,0,3,3,2,1,0,5,2,16
401085991,Marist Red Foxes,D. Knudsen,3936027,,True,13.0,1,3,1,2,0,1,0,0,0,2,2,0,0,0,1,1,2
401085991,Marist Red Foxes,L. Nedrow,4398414,,False,13.0,3,3,2,2,1,1,0,0,0,2,2,0,0,0,1,3,7
401085991,Marist Red Foxes,R. Funk,3936026,,False,19.0,0,2,0,1,0,1,0,0,0,1,1,1,1,0,1,2,0
401085991,Marist Red Foxes,A. Dozic,3923222,,False,12.0,2,5,2,5,0,0,0,0,2,2,4,0,0,0,1,0,4
401085991,Marist Red Foxes,M. Herasme,4398413,,False,24.0,2,6,2,3,0,3,1,1,1,2,3,0,1,0,1,2,5
401085991,Marist Red Foxes,M. Servetas,4279711,,False,1.0,0,0,0,0,0,0,0,0,0,0,0,0,0,0,0,0,0
401085991,Marist Red Foxes,T. Lee,4279710,,False,1.0,0,0,0,0,0,0,0,0,0,0,0,0,0,0,0,0,0
401085991,Marist Red Foxes,A. Williams,4279709,,False,23.0,2,5,2,5,0,0,2,4,1,0,1,2,2,0,4,1,6
401085991,Marist Red Foxes,R. Carmello,4279708,,False,1.0,0,0,0,0,0,0,0,0,0,0,0,0,0,0,1,0,0
401085991,Marist Red Foxes,TEAM,TOTAL,TOTAL,False,,17,49,16,40,1,9,9,13,10,23,33,6,5,0,17,14,44
401085991,Marist Red Foxes,I. Lamb,3936028,,True,32.0,1,7,1,5,0,2,0,0,4,6,10,0,0,0,0,0,2
401085991,Marist Red Foxes,T. Sjoberg,4067328,,True,15.0,1,4,1,4,0,0,0,0,1,3,4,0,0,0,1,3,2
401085991,Marist Red Foxes,D. Hines,4398410,,True,17.0,0,2,0,1,0,1,0,0,0,0,0,1,0,0,1,0,0
401085991,Marist Red Foxes,B. Parker,3936030,,True,29.0,5,12,5,12,0,0,6,8,0,3,3,2,1,0,5,2,16
401085991,Marist Red Foxes,D. Knudsen,3936027,,True,13.0,1,3,1,2,0,1,0,0,0,2,2,0,0,0,1,1,2
401085991,Marist Red Foxes,L. Nedrow,4398414,,False,13.0,3,3,2,2,1,1,0,0,0,2,2,0,0,0,1,3,7
401085991,Marist Red Foxes,R. Funk,3936026,,False,19.0,0,2,0,1,0,1,0,0,0,1,1,1,1,0,1,2,0
401085991,Marist Red Foxes,A. Dozic,3923222,,False,12.0,2,5,2,5,0,0,0,0,2,2,4,0,0,0,1,0,4
401085991,Marist Red Foxes,M. Herasme,4398413,,False,24.0,2,6,2,3,0,3,1,1,1,2,3,0,1,0,1,2,5
401085991,Marist Red Foxes,M. Servetas,4279711,,False,1.0,0,0,0,0,0,0,0,0,0,0,0,0,0,0,0,0,0
401085991,Marist Red Foxes,T. Lee,4279710,,False,1.0,0,0,0,0,0,0,0,0,0,0,0,0,0,0,0,0,0
401085991,Marist Red Foxes,A. Williams,4279709,,False,23.0,2,5,2,5,0,0,2,4,1,0,1,2,2,0,4,1,6
401085991,Marist Red Foxes,R. Carmello,4279708,,False,1.0,0,0,0,0,0,0,0,0,0,0,0,0,0,0,1,0,0
401085991,Marist Red Foxes,TEAM,TOTAL,TOTAL,False,,17,49,16,40,1,9,9,13,10,23,33,6,5,0,17,14,44
401085991,Fairfield Stags,J. Kasibabu,3947016,,True,31.0,10,17,9,14,1,3,1,1,3,8,11,1,1,0,5,3,22
401085991,Fairfield Stags,M. Milin,3947018,,True,31.0,5,8,3,5,2,3,0,0,0,4,4,3,1,1,2,4,12
401085991,Fairfield Stags,N. Alvarez,4398075,,True,34.0,2,5,2,3,0,2,0,0,0,4,4,4,3,1,1,2,4
401085991,Fairfield Stags,T. Benning,4279483,,True,40.0,2,7,2,5,0,2,1,2,2,6,8,7,0,0,1,1,5
401085991,Fairfield Stags,T. Nolan,3947015,,True,9.0,0,2,0,0,0,2,0,0,0,0,0,0,1,0,1,2,0
401085991,Fairfield Stags,W. Methnani,4279486,,False,8.0,1,4,1,2,0,2,0,0,0,0,0,0,0,1,1,0,2
401085991,Fairfield Stags,L. Taliaferro,4398078,,False,28.0,4,6,0,1,4,5,0,2,0,2,2,2,2,0,0,0,12
401085991,Fairfield Stags,J. Cruz,4279488,,False,9.0,1,1,1,1,0,0,0,0,0,0,0,0,0,1,1,0,2
401085991,Fairfield Stags,A. Kavaliauskas,4080375,,False,10.0,0,1,0,1,0,0,0,0,0,1,1,0,2,0,2,2,0
401085991,Fairfield Stags,TEAM,TOTAL,TOTAL,False,,25,51,18,32,7,19,2,5,6,25,31,17,10,4,14,14,59
401085991,Fairfield Stags,J. Kasibabu,3947016,,True,31.0,10,17,9,14,1,3,1,1,3,8,11,1,1,0,5,3,22
401085991,Fairfield Stags,M. Milin,3947018,,True,31.0,5,8,3,5,2,3,0,0,0,4,4,3,1,1,2,4,12
401085991,Fairfield Stags,N. Alvarez,4398075,,True,34.0,2,5,2,3,0,2,0,0,0,4,4,4,3,1,1,2,4
401085991,Fairfield Stags,T. Benning,4279483,,True,40.0,2,7,2,5,0,2,1,2,2,6,8,7,0,0,1,1,5
401085991,Fairfield Stags,T. Nolan,3947015,,True,9.0,0,2,0,0,0,2,0,0,0,0,0,0,1,0,1,2,0
401085991,Fairfield Stags,W. Methnani,4279486,,False,8.0,1,4,1,2,0,2,0,0,0,0,0,0,0,1,1,0,2
401085991,Fairfield Stags,L. Taliaferro,4398078,,False,28.0,4,6,0,1,4,5,0,2,0,2,2,2,2,0,0,0,12
401085991,Fairfield Stags,J. Cruz,4279488,,False,9.0,1,1,1,1,0,0,0,0,0,0,0,0,0,1,1,0,2
401085991,Fairfield Stags,A. Kavaliauskas,4080375,,False,10.0,0,1,0,1,0,0,0,0,0,1,1,0,2,0,2,2,0
401085991,Fairfield Stags,TEAM,TOTAL,TOTAL,False,,25,51,18,32,7,19,2,5,6,25,31,17,10,4,14,14,59
401085990,Siena Saints,E. Fisher,3913235,,True,36.0,7,12,6,8,1,4,1,1,0,2,2,4,0,2,3,1,16
401085990,Siena Saints,K. Degnan,3138282,,True,38.0,8,12,2,3,6,9,3,4,1,5,6,0,0,2,1,2,25
401085990,Siena Saints,P. Morastoni,4293127,,True,4.0,0,1,0,0,0,1,0,0,0,3,3,0,0,0,1,0,0
401085990,Siena Saints,B. Bayer,4065720,,True,4.0,0,1,0,0,0,1,0,0,0,0,0,0,0,0,0,0,0
401085990,Siena Saints,K. Smithen,3133848,,True,31.0,3,5,1,2,2,3,1,1,0,0,0,2,1,1,2,2,9
401085990,Siena Saints,S. Seymour,4398391,,False,21.0,0,5,0,0,0,5,0,0,0,0,0,0,0,0,1,1,0
401085990,Siena Saints,T. Huerter Jr.,4067350,,False,3.0,0,0,0,0,0,0,0,0,0,1,1,0,0,0,0,0,0
401085990,Siena Saints,J. Ratliff,4398392,,False,5.0,0,0,0,0,0,0,0,0,0,0,0,0,0,0,0,1,0
401085990,Siena Saints,J. Pickett,4398390,,False,34.0,4,10,4,6,0,4,3,4,0,8,8,10,1,2,2,2,11
401085990,Siena Saints,M. Camper,4279751,,False,24.0,3,4,3,3,0,1,0,0,1,4,5,1,0,0,0,3,6
401085990,Siena Saints,TEAM,TOTAL,TOTAL,False,,25,50,16,22,9,28,8,10,6,26,32,17,2,7,13,12,67
401085990,Siena Saints,E. Fisher,3913235,,True,36.0,7,12,6,8,1,4,1,1,0,2,2,4,0,2,3,1,16
401085990,Siena Saints,K. Degnan,3138282,,True,38.0,8,12,2,3,6,9,3,4,1,5,6,0,0,2,1,2,25
401085990,Siena Saints,P. Morastoni,4293127,,True,4.0,0,1,0,0,0,1,0,0,0,3,3,0,0,0,1,0,0
401085990,Siena Saints,B. Bayer,4065720,,True,4.0,0,1,0,0,0,1,0,0,0,0,0,0,0,0,0,0,0
401085990,Siena Saints,K. Smithen,3133848,,True,31.0,3,5,1,2,2,3,1,1,0,0,0,2,1,1,2,2,9
401085990,Siena Saints,S. Seymour,4398391,,False,21.0,0,5,0,0,0,5,0,0,0,0,0,0,0,0,1,1,0
401085990,Siena Saints,T. Huerter Jr.,4067350,,False,3.0,0,0,0,0,0,0,0,0,0,1,1,0,0,0,0,0,0
401085990,Siena Saints,J. Ratliff,4398392,,False,5.0,0,0,0,0,0,0,0,0,0,0,0,0,0,0,0,1,0
401085990,Siena Saints,J. Pickett,4398390,,False,34.0,4,10,4,6,0,4,3,4,0,8,8,10,1,2,2,2,11
401085990,Siena Saints,M. Camper,4279751,,False,24.0,3,4,3,3,0,1,0,0,1,4,5,1,0,0,0,3,6
401085990,Siena Saints,TEAM,TOTAL,TOTAL,False,,25,50,16,22,9,28,8,10,6,26,32,17,2,7,13,12,67
401085990,Marist Red Foxes,I. Lamb,3936028,,True,28.0,2,7,2,4,0,3,0,0,3,4,7,0,1,0,1,2,4
401085990,Marist Red Foxes,T. Sjoberg,4067328,,True,17.0,1,6,1,6,0,0,1,4,2,0,2,1,0,0,1,1,3
401085990,Marist Red Foxes,D. Hines,4398410,,True,26.0,1,4,1,2,0,2,0,0,0,2,2,1,2,0,1,1,2
401085990,Marist Red Foxes,B. Parker,3936030,,True,30.0,5,13,5,13,0,0,5,6,1,3,4,6,4,0,2,0,15
401085990,Marist Red Foxes,D. Knudsen,3936027,,True,18.0,4,6,4,4,0,2,0,0,0,4,4,1,0,0,0,2,8
401085990,Marist Red Foxes,L. Nedrow,4398414,,False,16.0,2,6,2,3,0,3,1,1,2,1,3,0,0,0,1,3,5
401085990,Marist Red Foxes,R. Funk,3936026,,False,31.0,3,7,1,1,2,6,3,3,0,3,3,0,0,0,0,2,11
401085990,Marist Red Foxes,A. Dozic,3923222,,False,6.0,2,3,2,3,0,0,0,0,0,0,0,1,0,0,0,0,4
401085990,Marist Red Foxes,M. Herasme,4398413,,False,17.0,1,3,1,2,0,1,1,2,2,1,3,0,1,0,0,0,3
401085990,Marist Red Foxes,T. Lee,4279710,,False,1.0,0,0,0,0,0,0,0,0,0,0,0,0,0,0,0,0,0
401085990,Marist Red Foxes,A. Williams,4279709,,False,9.0,0,3,0,3,0,0,0,0,0,1,1,0,0,0,3,1,0
401085990,Marist Red Foxes,R. Carmello,4279708,,False,1.0,0,0,0,0,0,0,0,0,0,0,0,0,0,0,0,0,0
401085990,Marist Red Foxes,TEAM,TOTAL,TOTAL,False,,21,58,19,41,2,17,11,16,11,21,32,10,8,0,9,12,55
401085990,Marist Red Foxes,I. Lamb,3936028,,True,28.0,2,7,2,4,0,3,0,0,3,4,7,0,1,0,1,2,4
401085990,Marist Red Foxes,T. Sjoberg,4067328,,True,17.0,1,6,1,6,0,0,1,4,2,0,2,1,0,0,1,1,3
401085990,Marist Red Foxes,D. Hines,4398410,,True,26.0,1,4,1,2,0,2,0,0,0,2,2,1,2,0,1,1,2
401085990,Marist Red Foxes,B. Parker,3936030,,True,30.0,5,13,5,13,0,0,5,6,1,3,4,6,4,0,2,0,15
401085990,Marist Red Foxes,D. Knudsen,3936027,,True,18.0,4,6,4,4,0,2,0,0,0,4,4,1,0,0,0,2,8
401085990,Marist Red Foxes,L. Nedrow,4398414,,False,16.0,2,6,2,3,0,3,1,1,2,1,3,0,0,0,1,3,5
401085990,Marist Red Foxes,R. Funk,3936026,,False,31.0,3,7,1,1,2,6,3,3,0,3,3,0,0,0,0,2,11
401085990,Marist Red Foxes,A. Dozic,3923222,,False,6.0,2,3,2,3,0,0,0,0,0,0,0,1,0,0,0,0,4
401085990,Marist Red Foxes,M. Herasme,4398413,,False,17.0,1,3,1,2,0,1,1,2,2,1,3,0,1,0,0,0,3
401085990,Marist Red Foxes,T. Lee,4279710,,False,1.0,0,0,0,0,0,0,0,0,0,0,0,0,0,0,0,0,0
401085990,Marist Red Foxes,A. Williams,4279709,,False,9.0,0,3,0,3,0,0,0,0,0,1,1,0,0,0,3,1,0
401085990,Marist Red Foxes,R. Carmello,4279708,,False,1.0,0,0,0,0,0,0,0,0,0,0,0,0,0,0,0,0,0
401085990,Marist Red Foxes,TEAM,TOTAL,TOTAL,False,,21,58,19,41,2,17,11,16,11,21,32,10,8,0,9,12,55
401085989,Saint Peter's Peacocks,KC Ndefo,4398386,,True,32.0,5,10,4,8,1,2,2,2,1,3,4,1,1,2,1,4,13
401085989,Saint Peter's Peacocks,S. Idowu,3922042,,True,24.0,4,8,4,6,0,2,0,0,3,2,5,0,0,3,2,2,8
401085989,Saint Peter's Peacocks,D. Watson,4398384,,True,38.0,4,9,3,5,1,4,0,2,0,4,4,3,0,0,2,1,9
401085989,Saint Peter's Peacocks,Q. Taylor,4067357,,True,29.0,3,6,2,2,1,4,3,5,0,5,5,3,1,0,1,4,10
401085989,Saint Peter's Peacocks,D. Turner,4067356,,True,35.0,3,5,0,0,3,5,7,7,2,3,5,1,0,0,1,1,16
401085989,Saint Peter's Peacocks,D. Woods,3919424,,False,12.0,2,2,2,2,0,0,1,2,0,0,0,0,0,1,2,4,5
401085989,Saint Peter's Peacocks,M. Majak,4398387,,False,3.0,0,0,0,0,0,0,0,0,0,0,0,0,0,0,0,0,0
401085989,Saint Peter's Peacocks,A. Hicks,4284295,,False,2.0,0,1,0,0,0,1,0,0,0,0,0,0,0,0,0,0,0
401085989,Saint Peter's Peacocks,M. Dixon,4279758,,False,25.0,2,3,2,2,0,1,0,0,0,0,0,0,2,1,3,2,4
401085989,Saint Peter's Peacocks,TEAM,TOTAL,TOTAL,False,,23,44,17,25,6,19,13,18,8,20,28,8,4,7,13,18,65
401085989,Saint Peter's Peacocks,KC Ndefo,4398386,,True,32.0,5,10,4,8,1,2,2,2,1,3,4,1,1,2,1,4,13
401085989,Saint Peter's Peacocks,S. Idowu,3922042,,True,24.0,4,8,4,6,0,2,0,0,3,2,5,0,0,3,2,2,8
401085989,Saint Peter's Peacocks,D. Watson,4398384,,True,38.0,4,9,3,5,1,4,0,2,0,4,4,3,0,0,2,1,9
401085989,Saint Peter's Peacocks,Q. Taylor,4067357,,True,29.0,3,6,2,2,1,4,3,5,0,5,5,3,1,0,1,4,10
401085989,Saint Peter's Peacocks,D. Turner,4067356,,True,35.0,3,5,0,0,3,5,7,7,2,3,5,1,0,0,1,1,16
401085989,Saint Peter's Peacocks,D. Woods,3919424,,False,12.0,2,2,2,2,0,0,1,2,0,0,0,0,0,1,2,4,5
401085989,Saint Peter's Peacocks,M. Majak,4398387,,False,3.0,0,0,0,0,0,0,0,0,0,0,0,0,0,0,0,0,0
401085989,Saint Peter's Peacocks,A. Hicks,4284295,,False,2.0,0,1,0,0,0,1,0,0,0,0,0,0,0,0,0,0,0
401085989,Saint Peter's Peacocks,M. Dixon,4279758,,False,25.0,2,3,2,2,0,1,0,0,0,0,0,0,2,1,3,2,4
401085989,Saint Peter's Peacocks,TEAM,TOTAL,TOTAL,False,,23,44,17,25,6,19,13,18,8,20,28,8,4,7,13,18,65
401085989,Marist Red Foxes,I. Lamb,3936028,,True,10.0,0,3,0,1,0,2,0,0,0,0,0,0,0,0,0,0,0
401085989,Marist Red Foxes,T. Sjoberg,4067328,,True,9.0,0,1,0,1,0,0,0,0,1,0,1,0,0,0,1,1,0
401085989,Marist Red Foxes,D. Hines,4398410,,True,25.0,1,3,1,3,0,0,0,0,1,2,3,1,1,0,1,0,2
401085989,Marist Red Foxes,B. Parker,3936030,,True,29.0,7,11,7,11,0,0,5,10,1,2,3,2,0,0,1,3,19
401085989,Marist Red Foxes,D. Knudsen,3936027,,True,20.0,3,6,2,2,1,4,2,2,3,4,7,0,1,0,1,2,9
401085989,Marist Red Foxes,L. Nedrow,4398414,,False,10.0,1,3,0,1,1,2,0,0,0,0,0,1,0,0,1,2,3
401085989,Marist Red Foxes,R. Funk,3936026,,False,27.0,4,8,0,1,4,7,0,0,0,2,2,0,1,0,2,0,12
401085989,Marist Red Foxes,A. Dozic,3923222,,False,21.0,2,8,2,3,0,5,2,2,0,2,2,1,1,0,1,3,6
401085989,Marist Red Foxes,M. Herasme,4398413,,False,28.0,1,4,1,3,0,1,4,4,3,1,4,1,0,0,0,4,6
401085989,Marist Red Foxes,A. Williams,4279709,,False,21.0,1,4,1,4,0,0,0,0,1,0,1,1,0,0,0,2,2
401085989,Marist Red Foxes,TEAM,TOTAL,TOTAL,False,,20,51,14,30,6,21,13,18,13,14,27,7,4,0,10,17,59
401085989,Marist Red Foxes,I. Lamb,3936028,,True,10.0,0,3,0,1,0,2,0,0,0,0,0,0,0,0,0,0,0
401085989,Marist Red Foxes,T. Sjoberg,4067328,,True,9.0,0,1,0,1,0,0,0,0,1,0,1,0,0,0,1,1,0
401085989,Marist Red Foxes,D. Hines,4398410,,True,25.0,1,3,1,3,0,0,0,0,1,2,3,1,1,0,1,0,2
401085989,Marist Red Foxes,B. Parker,3936030,,True,29.0,7,11,7,11,0,0,5,10,1,2,3,2,0,0,1,3,19
401085989,Marist Red Foxes,D. Knudsen,3936027,,True,20.0,3,6,2,2,1,4,2,2,3,4,7,0,1,0,1,2,9
401085989,Marist Red Foxes,L. Nedrow,4398414,,False,10.0,1,3,0,1,1,2,0,0,0,0,0,1,0,0,1,2,3
401085989,Marist Red Foxes,R. Funk,3936026,,False,27.0,4,8,0,1,4,7,0,0,0,2,2,0,1,0,2,0,12
401085989,Marist Red Foxes,A. Dozic,3923222,,False,21.0,2,8,2,3,0,5,2,2,0,2,2,1,1,0,1,3,6
401085989,Marist Red Foxes,M. Herasme,4398413,,False,28.0,1,4,1,3,0,1,4,4,3,1,4,1,0,0,0,4,6
401085989,Marist Red Foxes,A. Williams,4279709,,False,21.0,1,4,1,4,0,0,0,0,1,0,1,1,0,0,0,2,2
401085989,Marist Red Foxes,TEAM,TOTAL,TOTAL,False,,20,51,14,30,6,21,13,18,13,14,27,7,4,0,10,17,59
401085988,Monmouth Hawks,M. Traore,3975762,,True,18.0,3,4,3,4,0,0,1,2,1,1,2,1,1,0,0,1,7
401085988,Monmouth Hawks,D. Quinn,3948714,,True,30.0,6,14,6,14,0,0,4,6,5,5,10,0,1,1,0,2,16
401085988,Monmouth Hawks,D. Hammond,4279734,,True,25.0,4,15,3,5,1,10,2,4,0,1,1,1,1,0,3,2,11
401085988,Monmouth Hawks,R. Salnave,4067329,,True,23.0,2,6,1,3,1,3,0,0,1,2,3,7,1,0,0,1,5
401085988,Monmouth Hawks,N. Rutherford,3946977,,True,28.0,3,9,2,6,1,3,0,0,1,4,5,1,2,0,0,3,7
401085988,Monmouth Hawks,S. Chaput,4398409,,False,19.0,0,3,0,3,0,0,0,0,0,1,1,2,2,0,0,2,0
401085988,Monmouth Hawks,M. McClary,4279736,,False,22.0,3,9,2,5,1,4,2,2,2,1,3,4,1,0,0,2,9
401085988,Monmouth Hawks,G. Papas,4279735,,False,15.0,4,6,0,0,4,6,0,1,3,2,5,0,1,1,0,3,12
401085988,Monmouth Hawks,T. Gross Jr.,4065729,,False,17.0,0,2,0,1,0,1,0,0,2,3,5,0,0,0,1,3,0
401085988,Monmouth Hawks,L. Pillari,3948713,,False,3.0,0,0,0,0,0,0,0,0,0,0,0,0,0,0,0,0,0
401085988,Monmouth Hawks,TEAM,TOTAL,TOTAL,False,,25,68,17,41,8,27,9,15,16,22,38,16,10,2,4,19,67
401085988,Monmouth Hawks,M. Traore,3975762,,True,18.0,3,4,3,4,0,0,1,2,1,1,2,1,1,0,0,1,7
401085988,Monmouth Hawks,D. Quinn,3948714,,True,30.0,6,14,6,14,0,0,4,6,5,5,10,0,1,1,0,2,16
401085988,Monmouth Hawks,D. Hammond,4279734,,True,25.0,4,15,3,5,1,10,2,4,0,1,1,1,1,0,3,2,11
401085988,Monmouth Hawks,R. Salnave,4067329,,True,23.0,2,6,1,3,1,3,0,0,1,2,3,7,1,0,0,1,5
401085988,Monmouth Hawks,N. Rutherford,3946977,,True,28.0,3,9,2,6,1,3,0,0,1,4,5,1,2,0,0,3,7
401085988,Monmouth Hawks,S. Chaput,4398409,,False,19.0,0,3,0,3,0,0,0,0,0,1,1,2,2,0,0,2,0
401085988,Monmouth Hawks,M. McClary,4279736,,False,22.0,3,9,2,5,1,4,2,2,2,1,3,4,1,0,0,2,9
401085988,Monmouth Hawks,G. Papas,4279735,,False,15.0,4,6,0,0,4,6,0,1,3,2,5,0,1,1,0,3,12
401085988,Monmouth Hawks,T. Gross Jr.,4065729,,False,17.0,0,2,0,1,0,1,0,0,2,3,5,0,0,0,1,3,0
401085988,Monmouth Hawks,L. Pillari,3948713,,False,3.0,0,0,0,0,0,0,0,0,0,0,0,0,0,0,0,0,0
401085988,Monmouth Hawks,TEAM,TOTAL,TOTAL,False,,25,68,17,41,8,27,9,15,16,22,38,16,10,2,4,19,67
401085988,Marist Red Foxes,I. Lamb,3936028,,True,28.0,4,8,2,4,2,4,2,3,1,5,6,0,1,0,1,0,12
401085988,Marist Red Foxes,T. Sjoberg,4067328,,True,17.0,1,3,1,3,0,0,0,0,2,2,4,0,0,0,0,3,2
401085988,Marist Red Foxes,D. Hines,4398410,,True,33.0,5,7,4,4,1,3,3,4,0,4,4,5,0,0,1,0,14
401085988,Marist Red Foxes,B. Parker,3936030,,True,28.0,5,10,5,9,0,1,5,6,1,5,6,4,0,0,4,1,15
401085988,Marist Red Foxes,D. Knudsen,3936027,,True,24.0,3,5,1,2,2,3,0,0,0,4,4,2,0,0,1,3,8
401085988,Marist Red Foxes,L. Nedrow,4398414,,False,2.0,0,0,0,0,0,0,0,0,0,0,0,0,0,0,0,1,0
401085988,Marist Red Foxes,R. Funk,3936026,,False,25.0,4,8,1,1,3,7,0,0,0,2,2,0,1,1,0,2,11
401085988,Marist Red Foxes,A. Dozic,3923222,,False,21.0,2,5,1,2,1,3,3,3,0,4,4,1,0,1,2,3,8
401085988,Marist Red Foxes,M. Herasme,4398413,,False,14.0,1,4,0,2,1,2,0,3,2,2,4,0,0,0,0,1,3
401085988,Marist Red Foxes,A. Williams,4279709,,False,8.0,1,1,1,1,0,0,0,0,0,0,0,0,0,0,3,2,2
401085988,Marist Red Foxes,TEAM,TOTAL,TOTAL,False,,26,51,16,28,10,23,13,19,7,30,37,12,2,2,12,16,75
401085988,Marist Red Foxes,I. Lamb,3936028,,True,28.0,4,8,2,4,2,4,2,3,1,5,6,0,1,0,1,0,12
401085988,Marist Red Foxes,T. Sjoberg,4067328,,True,17.0,1,3,1,3,0,0,0,0,2,2,4,0,0,0,0,3,2
401085988,Marist Red Foxes,D. Hines,4398410,,True,33.0,5,7,4,4,1,3,3,4,0,4,4,5,0,0,1,0,14
401085988,Marist Red Foxes,B. Parker,3936030,,True,28.0,5,10,5,9,0,1,5,6,1,5,6,4,0,0,4,1,15
401085988,Marist Red Foxes,D. Knudsen,3936027,,True,24.0,3,5,1,2,2,3,0,0,0,4,4,2,0,0,1,3,8
401085988,Marist Red Foxes,L. Nedrow,4398414,,False,2.0,0,0,0,0,0,0,0,0,0,0,0,0,0,0,0,1,0
401085988,Marist Red Foxes,R. Funk,3936026,,False,25.0,4,8,1,1,3,7,0,0,0,2,2,0,1,1,0,2,11
401085988,Marist Red Foxes,A. Dozic,3923222,,False,21.0,2,5,1,2,1,3,3,3,0,4,4,1,0,1,2,3,8
401085988,Marist Red Foxes,M. Herasme,4398413,,False,14.0,1,4,0,2,1,2,0,3,2,2,4,0,0,0,0,1,3
401085988,Marist Red Foxes,A. Williams,4279709,,False,8.0,1,1,1,1,0,0,0,0,0,0,0,0,0,0,3,2,2
401085988,Marist Red Foxes,TEAM,TOTAL,TOTAL,False,,26,51,16,28,10,23,13,19,7,30,37,12,2,2,12,16,75
401085987,Niagara Purple Eagles,D. Robb,3907186,,True,21.0,2,5,2,5,0,0,1,2,0,1,1,0,1,1,2,1,5
401085987,Niagara Purple Eagles,M. Prochet,3907184,,True,29.0,5,12,5,9,0,3,1,1,2,3,5,1,0,0,1,2,11
401085987,Niagara Purple Eagles,K. Tate,4279738,,True,24.0,2,6,1,4,1,2,0,0,2,0,2,1,1,0,3,2,5
401085987,Niagara Purple Eagles,J. Towns,4067341,,True,30.0,5,9,5,7,0,2,1,2,0,1,1,3,0,0,2,1,11
401085987,Niagara Purple Eagles,C. Barton,3907182,,True,22.0,2,5,1,4,1,1,0,1,0,2,2,0,0,0,2,0,5
401085987,Niagara Purple Eagles,G. Kuakumensah,4279739,,False,11.0,1,2,0,0,1,2,0,0,0,0,0,1,0,0,0,0,3
401085987,Niagara Purple Eagles,G. King,3906490,,False,19.0,1,1,1,1,0,0,0,0,1,5,6,0,0,0,0,1,2
401085987,Niagara Purple Eagles,M. Hammond,4398404,,False,16.0,0,0,0,0,0,0,0,0,0,1,1,1,0,0,1,0,0
401085987,Niagara Purple Eagles,R. Solomon,4398403,,False,25.0,4,9,0,1,4,8,4,4,0,4,4,0,0,1,0,2,16
401085987,Niagara Purple Eagles,D. Fragala,4279737,,False,3.0,0,1,0,1,0,0,0,0,0,0,0,0,0,0,0,0,0
401085987,Niagara Purple Eagles,TEAM,TOTAL,TOTAL,False,,22,50,15,32,7,18,7,10,6,19,25,7,2,2,11,9,58
401085987,Niagara Purple Eagles,D. Robb,3907186,,True,21.0,2,5,2,5,0,0,1,2,0,1,1,0,1,1,2,1,5
401085987,Niagara Purple Eagles,M. Prochet,3907184,,True,29.0,5,12,5,9,0,3,1,1,2,3,5,1,0,0,1,2,11
401085987,Niagara Purple Eagles,K. Tate,4279738,,True,24.0,2,6,1,4,1,2,0,0,2,0,2,1,1,0,3,2,5
401085987,Niagara Purple Eagles,J. Towns,4067341,,True,30.0,5,9,5,7,0,2,1,2,0,1,1,3,0,0,2,1,11
401085987,Niagara Purple Eagles,C. Barton,3907182,,True,22.0,2,5,1,4,1,1,0,1,0,2,2,0,0,0,2,0,5
401085987,Niagara Purple Eagles,G. Kuakumensah,4279739,,False,11.0,1,2,0,0,1,2,0,0,0,0,0,1,0,0,0,0,3
401085987,Niagara Purple Eagles,G. King,3906490,,False,19.0,1,1,1,1,0,0,0,0,1,5,6,0,0,0,0,1,2
401085987,Niagara Purple Eagles,M. Hammond,4398404,,False,16.0,0,0,0,0,0,0,0,0,0,1,1,1,0,0,1,0,0
401085987,Niagara Purple Eagles,R. Solomon,4398403,,False,25.0,4,9,0,1,4,8,4,4,0,4,4,0,0,1,0,2,16
401085987,Niagara Purple Eagles,D. Fragala,4279737,,False,3.0,0,1,0,1,0,0,0,0,0,0,0,0,0,0,0,0,0
401085987,Niagara Purple Eagles,TEAM,TOTAL,TOTAL,False,,22,50,15,32,7,18,7,10,6,19,25,7,2,2,11,9,58
401085987,Marist Red Foxes,I. Lamb,3936028,,True,21.0,2,4,1,2,1,2,2,2,1,0,1,0,1,1,0,1,7
401085987,Marist Red Foxes,T. Sjoberg,4067328,,True,16.0,1,2,1,2,0,0,0,0,0,1,1,1,0,0,0,0,2
401085987,Marist Red Foxes,D. Hines,4398410,,True,30.0,5,10,3,6,2,4,0,0,0,1,1,6,1,0,1,1,12
401085987,Marist Red Foxes,B. Parker,3936030,,True,21.0,4,8,4,8,0,0,0,0,1,4,5,3,0,0,3,1,8
401085987,Marist Red Foxes,D. Knudsen,3936027,,True,21.0,3,8,2,2,1,6,0,0,0,1,1,2,1,0,0,0,7
401085987,Marist Red Foxes,R. Funk,3936026,,False,36.0,9,12,2,3,7,9,0,0,0,6,6,0,0,0,0,1,25
401085987,Marist Red Foxes,A. Dozic,3923222,,False,23.0,4,7,1,2,3,5,0,0,1,6,7,7,0,1,1,2,11
401085987,Marist Red Foxes,M. Herasme,4398413,,False,22.0,2,2,2,2,0,0,1,2,1,2,3,0,0,0,0,2,5
401085987,Marist Red Foxes,A. Williams,4279709,,False,10.0,1,1,1,1,0,0,0,0,0,1,1,2,0,0,1,2,2
401085987,Marist Red Foxes,TEAM,TOTAL,TOTAL,False,,31,54,17,28,14,26,3,4,4,24,28,21,3,2,7,10,79
401085987,Marist Red Foxes,I. Lamb,3936028,,True,21.0,2,4,1,2,1,2,2,2,1,0,1,0,1,1,0,1,7
401085987,Marist Red Foxes,T. Sjoberg,4067328,,True,16.0,1,2,1,2,0,0,0,0,0,1,1,1,0,0,0,0,2
401085987,Marist Red Foxes,D. Hines,4398410,,True,30.0,5,10,3,6,2,4,0,0,0,1,1,6,1,0,1,1,12
401085987,Marist Red Foxes,B. Parker,3936030,,True,21.0,4,8,4,8,0,0,0,0,1,4,5,3,0,0,3,1,8
401085987,Marist Red Foxes,D. Knudsen,3936027,,True,21.0,3,8,2,2,1,6,0,0,0,1,1,2,1,0,0,0,7
401085987,Marist Red Foxes,R. Funk,3936026,,False,36.0,9,12,2,3,7,9,0,0,0,6,6,0,0,0,0,1,25
401085987,Marist Red Foxes,A. Dozic,3923222,,False,23.0,4,7,1,2,3,5,0,0,1,6,7,7,0,1,1,2,11
401085987,Marist Red Foxes,M. Herasme,4398413,,False,22.0,2,2,2,2,0,0,1,2,1,2,3,0,0,0,0,2,5
401085987,Marist Red Foxes,A. Williams,4279709,,False,10.0,1,1,1,1,0,0,0,0,0,1,1,2,0,0,1,2,2
401085987,Marist Red Foxes,TEAM,TOTAL,TOTAL,False,,31,54,17,28,14,26,3,4,4,24,28,21,3,2,7,10,79
401085986,Marist Red Foxes,I. Lamb,3936028,,True,19.0,2,6,2,4,0,2,0,0,2,5,7,1,2,0,2,4,4
401085986,Marist Red Foxes,T. Sjoberg,4067328,,True,26.0,1,3,1,3,0,0,1,2,1,1,2,0,0,1,1,2,3
401085986,Marist Red Foxes,D. Hines,4398410,,True,34.0,1,5,1,3,0,2,0,0,0,1,1,2,3,0,1,3,2
401085986,Marist Red Foxes,B. Parker,3936030,,True,28.0,7,12,7,12,0,0,3,7,0,1,1,2,2,0,4,1,17
401085986,Marist Red Foxes,D. Knudsen,3936027,,True,16.0,1,4,0,1,1,3,0,0,0,1,1,1,0,0,1,3,3
401085986,Marist Red Foxes,L. Nedrow,4398414,,False,5.0,1,2,1,1,0,1,0,0,0,0,0,1,0,0,0,1,2
401085986,Marist Red Foxes,R. Funk,3936026,,False,23.0,5,10,4,4,1,6,2,2,0,4,4,0,0,0,1,3,13
401085986,Marist Red Foxes,A. Dozic,3923222,,False,9.0,1,4,1,3,0,1,0,0,0,2,2,0,2,0,1,2,2
401085986,Marist Red Foxes,M. Herasme,4398413,,False,26.0,1,2,0,0,1,2,0,0,1,4,5,0,1,0,1,1,3
401085986,Marist Red Foxes,A. Williams,4279709,,False,14.0,1,3,0,2,1,1,0,0,0,2,2,0,0,0,2,1,3
401085986,Marist Red Foxes,TEAM,TOTAL,TOTAL,False,,21,51,17,33,4,18,6,11,6,24,30,7,10,1,15,21,52
401085986,Marist Red Foxes,I. Lamb,3936028,,True,19.0,2,6,2,4,0,2,0,0,2,5,7,1,2,0,2,4,4
401085986,Marist Red Foxes,T. Sjoberg,4067328,,True,26.0,1,3,1,3,0,0,1,2,1,1,2,0,0,1,1,2,3
401085986,Marist Red Foxes,D. Hines,4398410,,True,34.0,1,5,1,3,0,2,0,0,0,1,1,2,3,0,1,3,2
401085986,Marist Red Foxes,B. Parker,3936030,,True,28.0,7,12,7,12,0,0,3,7,0,1,1,2,2,0,4,1,17
401085986,Marist Red Foxes,D. Knudsen,3936027,,True,16.0,1,4,0,1,1,3,0,0,0,1,1,1,0,0,1,3,3
401085986,Marist Red Foxes,L. Nedrow,4398414,,False,5.0,1,2,1,1,0,1,0,0,0,0,0,1,0,0,0,1,2
401085986,Marist Red Foxes,R. Funk,3936026,,False,23.0,5,10,4,4,1,6,2,2,0,4,4,0,0,0,1,3,13
401085986,Marist Red Foxes,A. Dozic,3923222,,False,9.0,1,4,1,3,0,1,0,0,0,2,2,0,2,0,1,2,2
401085986,Marist Red Foxes,M. Herasme,4398413,,False,26.0,1,2,0,0,1,2,0,0,1,4,5,0,1,0,1,1,3
401085986,Marist Red Foxes,A. Williams,4279709,,False,14.0,1,3,0,2,1,1,0,0,0,2,2,0,0,0,2,1,3
401085986,Marist Red Foxes,TEAM,TOTAL,TOTAL,False,,21,51,17,33,4,18,6,11,6,24,30,7,10,1,15,21,52
401085986,Fairfield Stags,J. Kasibabu,3947016,,True,27.0,3,6,2,5,1,1,0,0,1,5,6,0,1,1,7,4,7
401085986,Fairfield Stags,L. Taliaferro,4398078,,True,22.0,4,8,3,5,1,3,1,2,1,1,2,1,0,0,2,2,10
401085986,Fairfield Stags,N. Alvarez,4398075,,True,35.0,4,11,4,6,0,5,3,4,0,3,3,3,0,0,1,0,11
401085986,Fairfield Stags,J. Cruz,4279488,,True,32.0,3,5,3,5,0,0,4,8,1,5,6,0,2,1,2,1,10
401085986,Fairfield Stags,T. Benning,4279483,,True,20.0,3,4,2,2,1,2,1,1,0,2,2,0,1,0,0,3,8
401085986,Fairfield Stags,W. Methnani,4279486,,False,22.0,1,4,0,2,1,2,0,1,0,6,6,1,0,2,3,4,3
401085986,Fairfield Stags,M. Milin,3947018,,False,1.0,0,0,0,0,0,0,0,0,0,0,0,0,0,0,0,0,0
401085986,Fairfield Stags,C. Whipple,4398077,,False,16.0,0,3,0,0,0,3,0,0,0,0,0,1,0,0,0,0,0
401085986,Fairfield Stags,A. Kavaliauskas,4080375,,False,25.0,2,3,1,1,1,2,3,4,1,4,5,3,2,0,4,0,8
401085986,Fairfield Stags,TEAM,TOTAL,TOTAL,False,,20,44,15,26,5,18,12,20,5,26,31,9,6,4,19,14,57
401085986,Fairfield Stags,J. Kasibabu,3947016,,True,27.0,3,6,2,5,1,1,0,0,1,5,6,0,1,1,7,4,7
401085986,Fairfield Stags,L. Taliaferro,4398078,,True,22.0,4,8,3,5,1,3,1,2,1,1,2,1,0,0,2,2,10
401085986,Fairfield Stags,N. Alvarez,4398075,,True,35.0,4,11,4,6,0,5,3,4,0,3,3,3,0,0,1,0,11
401085986,Fairfield Stags,J. Cruz,4279488,,True,32.0,3,5,3,5,0,0,4,8,1,5,6,0,2,1,2,1,10
401085986,Fairfield Stags,T. Benning,4279483,,True,20.0,3,4,2,2,1,2,1,1,0,2,2,0,1,0,0,3,8
401085986,Fairfield Stags,W. Methnani,4279486,,False,22.0,1,4,0,2,1,2,0,1,0,6,6,1,0,2,3,4,3
401085986,Fairfield Stags,M. Milin,3947018,,False,1.0,0,0,0,0,0,0,0,0,0,0,0,0,0,0,0,0,0
401085986,Fairfield Stags,C. Whipple,4398077,,False,16.0,0,3,0,0,0,3,0,0,0,0,0,1,0,0,0,0,0
401085986,Fairfield Stags,A. Kavaliauskas,4080375,,False,25.0,2,3,1,1,1,2,3,4,1,4,5,3,2,0,4,0,8
401085986,Fairfield Stags,TEAM,TOTAL,TOTAL,False,,20,44,15,26,5,18,12,20,5,26,31,9,6,4,19,14,57
401085985,Rider Broncs,D. Vaughn,4067347,,True,20.0,3,6,1,1,2,5,4,4,1,4,5,1,0,1,2,4,12
401085985,Rider Broncs,F. Scott,3922033,,True,24.0,4,10,3,4,1,6,6,8,1,8,9,2,1,0,1,1,15
401085985,Rider Broncs,T. Marshall,4067348,,True,19.0,4,7,4,7,0,0,2,3,3,2,5,1,0,0,1,0,10
401085985,Rider Broncs,S. Jordan,4067349,,True,34.0,7,11,3,6,4,5,0,2,1,4,5,3,4,1,3,4,18
401085985,Rider Broncs,A. Durham,3138490,,True,32.0,3,4,3,4,0,0,4,4,1,0,1,3,3,1,1,4,10
401085985,Rider Broncs,A. Ogemuno-Johnson,4406151,,False,4.0,0,0,0,0,0,0,0,0,0,0,0,0,0,0,0,2,0
401085985,Rider Broncs,D. Eke,3941312,,False,22.0,2,4,2,3,0,1,1,7,0,2,2,3,1,3,0,2,5
401085985,Rider Broncs,J. Allen,4067345,,False,27.0,5,12,1,4,4,8,0,0,0,0,0,2,0,0,1,0,14
401085985,Rider Broncs,K. Williams,3946983,,False,17.0,1,2,1,2,0,0,0,3,1,3,4,3,2,1,0,0,2
401085985,Rider Broncs,A. Gilbert,3911886,,False,1.0,0,0,0,0,0,0,0,0,0,0,0,0,0,0,0,0,0
401085985,Rider Broncs,TEAM,TOTAL,TOTAL,False,,29,56,18,31,11,25,17,31,10,24,34,18,11,7,9,17,86
401085985,Rider Broncs,D. Vaughn,4067347,,True,20.0,3,6,1,1,2,5,4,4,1,4,5,1,0,1,2,4,12
401085985,Rider Broncs,F. Scott,3922033,,True,24.0,4,10,3,4,1,6,6,8,1,8,9,2,1,0,1,1,15
401085985,Rider Broncs,T. Marshall,4067348,,True,19.0,4,7,4,7,0,0,2,3,3,2,5,1,0,0,1,0,10
401085985,Rider Broncs,S. Jordan,4067349,,True,34.0,7,11,3,6,4,5,0,2,1,4,5,3,4,1,3,4,18
401085985,Rider Broncs,A. Durham,3138490,,True,32.0,3,4,3,4,0,0,4,4,1,0,1,3,3,1,1,4,10
401085985,Rider Broncs,A. Ogemuno-Johnson,4406151,,False,4.0,0,0,0,0,0,0,0,0,0,0,0,0,0,0,0,2,0
401085985,Rider Broncs,D. Eke,3941312,,False,22.0,2,4,2,3,0,1,1,7,0,2,2,3,1,3,0,2,5
401085985,Rider Broncs,J. Allen,4067345,,False,27.0,5,12,1,4,4,8,0,0,0,0,0,2,0,0,1,0,14
401085985,Rider Broncs,K. Williams,3946983,,False,17.0,1,2,1,2,0,0,0,3,1,3,4,3,2,1,0,0,2
401085985,Rider Broncs,A. Gilbert,3911886,,False,1.0,0,0,0,0,0,0,0,0,0,0,0,0,0,0,0,0,0
401085985,Rider Broncs,TEAM,TOTAL,TOTAL,False,,29,56,18,31,11,25,17,31,10,24,34,18,11,7,9,17,86
401085985,Marist Red Foxes,I. Lamb,3936028,,True,23.0,4,9,2,4,2,5,0,0,1,6,7,0,0,0,0,4,10
401085985,Marist Red Foxes,T. Sjoberg,4067328,,True,13.0,0,1,0,1,0,0,0,0,1,1,2,0,2,0,1,3,0
401085985,Marist Red Foxes,D. Hines,4398410,,True,31.0,2,6,1,4,1,2,4,4,0,1,1,3,0,1,4,4,9
401085985,Marist Red Foxes,B. Parker,3936030,,True,33.0,7,14,4,10,3,4,2,5,1,4,5,4,0,1,5,3,19
401085985,Marist Red Foxes,D. Knudsen,3936027,,True,15.0,2,2,2,2,0,0,0,0,1,3,4,1,0,0,2,2,4
401085985,Marist Red Foxes,R. Funk,3936026,,False,32.0,10,15,3,4,7,11,5,5,1,4,5,1,0,0,0,2,32
401085985,Marist Red Foxes,A. Dozic,3923222,,False,27.0,3,7,1,2,2,5,0,0,0,4,4,6,2,1,1,4,8
401085985,Marist Red Foxes,M. Herasme,4398413,,False,17.0,0,3,0,3,0,0,1,2,1,2,3,0,1,0,1,0,1
401085985,Marist Red Foxes,A. Williams,4279709,,False,9.0,1,1,1,1,0,0,0,0,0,0,0,0,0,1,0,2,2
401085985,Marist Red Foxes,TEAM,TOTAL,TOTAL,False,,29,58,14,31,15,27,12,16,7,26,33,15,5,4,14,24,85
401085985,Marist Red Foxes,I. Lamb,3936028,,True,23.0,4,9,2,4,2,5,0,0,1,6,7,0,0,0,0,4,10
401085985,Marist Red Foxes,T. Sjoberg,4067328,,True,13.0,0,1,0,1,0,0,0,0,1,1,2,0,2,0,1,3,0
401085985,Marist Red Foxes,D. Hines,4398410,,True,31.0,2,6,1,4,1,2,4,4,0,1,1,3,0,1,4,4,9
401085985,Marist Red Foxes,B. Parker,3936030,,True,33.0,7,14,4,10,3,4,2,5,1,4,5,4,0,1,5,3,19
401085985,Marist Red Foxes,D. Knudsen,3936027,,True,15.0,2,2,2,2,0,0,0,0,1,3,4,1,0,0,2,2,4
401085985,Marist Red Foxes,R. Funk,3936026,,False,32.0,10,15,3,4,7,11,5,5,1,4,5,1,0,0,0,2,32
401085985,Marist Red Foxes,A. Dozic,3923222,,False,27.0,3,7,1,2,2,5,0,0,0,4,4,6,2,1,1,4,8
401085985,Marist Red Foxes,M. Herasme,4398413,,False,17.0,0,3,0,3,0,0,1,2,1,2,3,0,1,0,1,0,1
401085985,Marist Red Foxes,A. Williams,4279709,,False,9.0,1,1,1,1,0,0,0,0,0,0,0,0,0,1,0,2,2
401085985,Marist Red Foxes,TEAM,TOTAL,TOTAL,False,,29,58,14,31,15,27,12,16,7,26,33,15,5,4,14,24,85
401085984,Saint Peter's Peacocks,S. Idowu,3922042,,True,28.0,3,6,3,6,0,0,8,10,3,6,9,0,0,3,0,2,14
401085984,Saint Peter's Peacocks,Q. Taylor,4067357,,True,32.0,2,8,2,4,0,4,5,6,3,1,4,1,1,0,3,4,9
401085984,Saint Peter's Peacocks,D. Watson,4398384,,True,33.0,3,8,1,1,2,7,0,0,0,1,1,3,1,0,2,0,8
401085984,Saint Peter's Peacocks,M. Dixon,4279758,,True,25.0,0,4,0,1,0,3,7,7,0,1,1,0,0,0,1,4,7
401085984,Saint Peter's Peacocks,D. Turner,4067356,,True,38.0,6,14,2,6,4,8,6,10,1,2,3,2,0,0,2,0,22
401085984,Saint Peter's Peacocks,KC Ndefo,4398386,,False,17.0,1,2,1,2,0,0,1,2,2,2,4,0,0,0,4,3,3
401085984,Saint Peter's Peacocks,D. Woods,3919424,,False,11.0,2,2,2,2,0,0,2,2,1,7,8,0,0,0,1,4,6
401085984,Saint Peter's Peacocks,C. Underwood,4398388,,False,0.0,0,0,0,0,0,0,0,0,0,0,0,0,0,0,0,0,0
401085984,Saint Peter's Peacocks,K. Brown,4398385,,False,16.0,1,1,1,1,0,0,1,2,1,3,4,2,1,0,1,2,3
401085984,Saint Peter's Peacocks,A. Hicks,4284295,,False,0.0,0,0,0,0,0,0,0,0,0,0,0,0,0,0,0,0,0
401085984,Saint Peter's Peacocks,TEAM,TOTAL,TOTAL,False,,18,45,12,23,6,22,30,39,12,28,40,8,3,3,15,19,72
401085984,Saint Peter's Peacocks,S. Idowu,3922042,,True,28.0,3,6,3,6,0,0,8,10,3,6,9,0,0,3,0,2,14
401085984,Saint Peter's Peacocks,Q. Taylor,4067357,,True,32.0,2,8,2,4,0,4,5,6,3,1,4,1,1,0,3,4,9
401085984,Saint Peter's Peacocks,D. Watson,4398384,,True,33.0,3,8,1,1,2,7,0,0,0,1,1,3,1,0,2,0,8
401085984,Saint Peter's Peacocks,M. Dixon,4279758,,True,25.0,0,4,0,1,0,3,7,7,0,1,1,0,0,0,1,4,7
401085984,Saint Peter's Peacocks,D. Turner,4067356,,True,38.0,6,14,2,6,4,8,6,10,1,2,3,2,0,0,2,0,22
401085984,Saint Peter's Peacocks,KC Ndefo,4398386,,False,17.0,1,2,1,2,0,0,1,2,2,2,4,0,0,0,4,3,3
401085984,Saint Peter's Peacocks,D. Woods,3919424,,False,11.0,2,2,2,2,0,0,2,2,1,7,8,0,0,0,1,4,6
401085984,Saint Peter's Peacocks,C. Underwood,4398388,,False,0.0,0,0,0,0,0,0,0,0,0,0,0,0,0,0,0,0,0
401085984,Saint Peter's Peacocks,K. Brown,4398385,,False,16.0,1,1,1,1,0,0,1,2,1,3,4,2,1,0,1,2,3
401085984,Saint Peter's Peacocks,A. Hicks,4284295,,False,0.0,0,0,0,0,0,0,0,0,0,0,0,0,0,0,0,0,0
401085984,Saint Peter's Peacocks,TEAM,TOTAL,TOTAL,False,,18,45,12,23,6,22,30,39,12,28,40,8,3,3,15,19,72
401085984,Marist Red Foxes,I. Lamb,3936028,,True,22.0,1,5,0,1,1,4,1,2,0,1,1,2,1,0,1,4,4
401085984,Marist Red Foxes,T. Sjoberg,4067328,,True,21.0,3,4,3,4,0,0,3,4,1,3,4,0,1,0,1,4,9
401085984,Marist Red Foxes,D. Hines,4398410,,True,19.0,3,6,3,5,0,1,0,0,1,1,2,0,1,0,0,2,6
401085984,Marist Red Foxes,B. Parker,3936030,,True,33.0,5,9,5,8,0,1,7,10,1,2,3,3,0,0,2,4,17
401085984,Marist Red Foxes,D. Knudsen,3936027,,True,16.0,1,4,0,1,1,3,0,0,0,0,0,2,2,0,0,0,3
401085984,Marist Red Foxes,L. Nedrow,4398414,,False,3.0,0,0,0,0,0,0,0,0,0,0,0,0,0,0,0,2,0
401085984,Marist Red Foxes,R. Funk,3936026,,False,34.0,2,8,1,2,1,6,2,4,0,3,3,1,3,0,0,1,7
401085984,Marist Red Foxes,A. Dozic,3923222,,False,15.0,3,7,2,2,1,5,0,1,0,1,1,2,2,1,2,1,7
401085984,Marist Red Foxes,M. Herasme,4398413,,False,17.0,1,1,1,1,0,0,0,0,0,1,1,1,0,0,0,2,2
401085984,Marist Red Foxes,A. Williams,4279709,,False,20.0,3,5,2,4,1,1,1,2,1,3,4,0,0,0,2,5,8
401085984,Marist Red Foxes,TEAM,TOTAL,TOTAL,False,,22,49,17,28,5,21,14,23,4,16,20,11,10,1,9,25,63
401085984,Marist Red Foxes,I. Lamb,3936028,,True,22.0,1,5,0,1,1,4,1,2,0,1,1,2,1,0,1,4,4
401085984,Marist Red Foxes,T. Sjoberg,4067328,,True,21.0,3,4,3,4,0,0,3,4,1,3,4,0,1,0,1,4,9
401085984,Marist Red Foxes,D. Hines,4398410,,True,19.0,3,6,3,5,0,1,0,0,1,1,2,0,1,0,0,2,6
401085984,Marist Red Foxes,B. Parker,3936030,,True,33.0,5,9,5,8,0,1,7,10,1,2,3,3,0,0,2,4,17
401085984,Marist Red Foxes,D. Knudsen,3936027,,True,16.0,1,4,0,1,1,3,0,0,0,0,0,2,2,0,0,0,3
401085984,Marist Red Foxes,L. Nedrow,4398414,,False,3.0,0,0,0,0,0,0,0,0,0,0,0,0,0,0,0,2,0
401085984,Marist Red Foxes,R. Funk,3936026,,False,34.0,2,8,1,2,1,6,2,4,0,3,3,1,3,0,0,1,7
401085984,Marist Red Foxes,A. Dozic,3923222,,False,15.0,3,7,2,2,1,5,0,1,0,1,1,2,2,1,2,1,7
401085984,Marist Red Foxes,M. Herasme,4398413,,False,17.0,1,1,1,1,0,0,0,0,0,1,1,1,0,0,0,2,2
401085984,Marist Red Foxes,A. Williams,4279709,,False,20.0,3,5,2,4,1,1,1,2,1,3,4,0,0,0,2,5,8
401085984,Marist Red Foxes,TEAM,TOTAL,TOTAL,False,,22,49,17,28,5,21,14,23,4,16,20,11,10,1,9,25,63
401085983,Siena Saints,S. Seymour,4398391,,True,31.0,4,11,0,1,4,10,0,0,0,0,0,0,0,0,1,1,12
401085983,Siena Saints,E. Fisher,3913235,,True,32.0,8,10,6,8,2,2,5,5,1,3,4,2,0,0,4,3,23
401085983,Siena Saints,K. Degnan,3138282,,True,34.0,3,8,0,4,3,4,0,0,0,4,4,0,0,1,0,2,9
401085983,Siena Saints,G. Darwiche,4398393,,True,27.0,3,7,2,4,1,3,2,2,0,1,1,2,1,0,2,3,9
401085983,Siena Saints,J. Pickett,4398390,,True,37.0,2,6,2,5,0,1,5,7,1,5,6,8,2,0,2,3,9
401085983,Siena Saints,D. Tchougang,4398394,,False,8.0,0,1,0,1,0,0,0,0,0,3,3,1,0,0,0,0,0
401085983,Siena Saints,M. Camper,4279751,,False,18.0,3,4,3,3,0,1,3,3,0,4,4,1,1,0,0,2,9
401085983,Siena Saints,B. Bayer,4065720,,False,3.0,0,1,0,0,0,1,0,0,0,0,0,1,0,0,0,1,0
401085983,Siena Saints,K. Smithen,3133848,,False,10.0,0,0,0,0,0,0,0,0,0,2,2,0,0,0,0,1,0
401085983,Siena Saints,TEAM,TOTAL,TOTAL,False,,23,48,13,26,10,22,15,17,2,26,28,15,4,1,11,16,71
401085983,Siena Saints,S. Seymour,4398391,,True,31.0,4,11,0,1,4,10,0,0,0,0,0,0,0,0,1,1,12
401085983,Siena Saints,E. Fisher,3913235,,True,32.0,8,10,6,8,2,2,5,5,1,3,4,2,0,0,4,3,23
401085983,Siena Saints,K. Degnan,3138282,,True,34.0,3,8,0,4,3,4,0,0,0,4,4,0,0,1,0,2,9
401085983,Siena Saints,G. Darwiche,4398393,,True,27.0,3,7,2,4,1,3,2,2,0,1,1,2,1,0,2,3,9
401085983,Siena Saints,J. Pickett,4398390,,True,37.0,2,6,2,5,0,1,5,7,1,5,6,8,2,0,2,3,9
401085983,Siena Saints,D. Tchougang,4398394,,False,8.0,0,1,0,1,0,0,0,0,0,3,3,1,0,0,0,0,0
401085983,Siena Saints,M. Camper,4279751,,False,18.0,3,4,3,3,0,1,3,3,0,4,4,1,1,0,0,2,9
401085983,Siena Saints,B. Bayer,4065720,,False,3.0,0,1,0,0,0,1,0,0,0,0,0,1,0,0,0,1,0
401085983,Siena Saints,K. Smithen,3133848,,False,10.0,0,0,0,0,0,0,0,0,0,2,2,0,0,0,0,1,0
401085983,Siena Saints,TEAM,TOTAL,TOTAL,False,,23,48,13,26,10,22,15,17,2,26,28,15,4,1,11,16,71
401085983,Marist Red Foxes,I. Lamb,3936028,,True,31.0,5,8,5,5,0,3,3,7,3,5,8,0,0,0,0,2,13
401085983,Marist Red Foxes,T. Sjoberg,4067328,,True,16.0,3,3,3,3,0,0,1,1,3,3,6,0,0,0,0,1,7
401085983,Marist Red Foxes,D. Knudsen,3936027,,True,19.0,3,7,1,2,2,5,2,2,0,1,1,2,2,0,1,0,10
401085983,Marist Red Foxes,D. Hines,4398410,,True,26.0,1,2,1,2,0,0,2,2,0,2,2,1,0,0,2,4,4
401085983,Marist Red Foxes,B. Parker,3936030,,True,34.0,6,14,6,14,0,0,0,1,1,4,5,6,1,0,4,1,12
401085983,Marist Red Foxes,L. Nedrow,4398414,,False,1.0,0,0,0,0,0,0,0,0,0,0,0,0,0,0,0,0,0
401085983,Marist Red Foxes,R. Funk,3936026,,False,23.0,4,8,1,1,3,7,0,0,0,2,2,0,0,0,1,1,11
401085983,Marist Red Foxes,A. Dozic,3923222,,False,23.0,3,14,3,8,0,6,0,0,1,4,5,1,0,0,0,2,6
401085983,Marist Red Foxes,M. Herasme,4398413,,False,11.0,0,1,0,0,0,1,0,0,0,2,2,0,0,0,0,2,0
401085983,Marist Red Foxes,A. Williams,4279709,,False,16.0,0,0,0,0,0,0,3,4,1,0,1,1,0,0,0,4,3
401085983,Marist Red Foxes,TEAM,TOTAL,TOTAL,False,,25,57,20,35,5,22,11,17,9,24,33,11,3,0,9,17,66
401085983,Marist Red Foxes,I. Lamb,3936028,,True,31.0,5,8,5,5,0,3,3,7,3,5,8,0,0,0,0,2,13
401085983,Marist Red Foxes,T. Sjoberg,4067328,,True,16.0,3,3,3,3,0,0,1,1,3,3,6,0,0,0,0,1,7
401085983,Marist Red Foxes,D. Knudsen,3936027,,True,19.0,3,7,1,2,2,5,2,2,0,1,1,2,2,0,1,0,10
401085983,Marist Red Foxes,D. Hines,4398410,,True,26.0,1,2,1,2,0,0,2,2,0,2,2,1,0,0,2,4,4
401085983,Marist Red Foxes,B. Parker,3936030,,True,34.0,6,14,6,14,0,0,0,1,1,4,5,6,1,0,4,1,12
401085983,Marist Red Foxes,L. Nedrow,4398414,,False,1.0,0,0,0,0,0,0,0,0,0,0,0,0,0,0,0,0,0
401085983,Marist Red Foxes,R. Funk,3936026,,False,23.0,4,8,1,1,3,7,0,0,0,2,2,0,0,0,1,1,11
401085983,Marist Red Foxes,A. Dozic,3923222,,False,23.0,3,14,3,8,0,6,0,0,1,4,5,1,0,0,0,2,6
401085983,Marist Red Foxes,M. Herasme,4398413,,False,11.0,0,1,0,0,0,1,0,0,0,2,2,0,0,0,0,2,0
401085983,Marist Red Foxes,A. Williams,4279709,,False,16.0,0,0,0,0,0,0,3,4,1,0,1,1,0,0,0,4,3
401085983,Marist Red Foxes,TEAM,TOTAL,TOTAL,False,,25,57,20,35,5,22,11,17,9,24,33,11,3,0,9,17,66
401085982,Marist Red Foxes,I. Lamb,3936028,,True,31.0,2,8,1,6,1,2,2,2,3,3,6,0,2,1,0,1,7
401085982,Marist Red Foxes,T. Sjoberg,4067328,,True,11.0,0,0,0,0,0,0,0,0,0,3,3,2,0,0,1,2,0
401085982,Marist Red Foxes,D. Hines,4398410,,True,24.0,1,6,0,4,1,2,0,0,0,2,2,1,2,0,3,2,3
401085982,Marist Red Foxes,B. Parker,3936030,,True,30.0,8,11,8,10,0,1,0,0,0,3,3,3,1,0,3,0,16
401085982,Marist Red Foxes,D. Knudsen,3936027,,True,24.0,3,6,0,1,3,5,0,0,0,3,3,0,1,0,1,0,9
401085982,Marist Red Foxes,L. Nedrow,4398414,,False,10.0,0,1,0,0,0,1,0,0,0,0,0,0,0,2,1,1,0
401085982,Marist Red Foxes,R. Funk,3936026,,False,25.0,2,11,0,1,2,10,1,2,1,1,2,1,2,0,2,1,7
401085982,Marist Red Foxes,A. Dozic,3923222,,False,17.0,3,5,1,2,2,3,0,0,1,2,3,1,0,2,2,4,8
401085982,Marist Red Foxes,M. Herasme,4398413,,False,10.0,0,1,0,1,0,0,0,0,0,2,2,0,0,0,0,0,0
401085982,Marist Red Foxes,A. Williams,4279709,,False,18.0,3,5,3,5,0,0,0,0,0,2,2,1,2,1,2,3,6
401085982,Marist Red Foxes,TEAM,TOTAL,TOTAL,False,,22,54,13,30,9,24,3,4,6,23,29,9,10,6,16,14,56
401085982,Hartford Hawks,G. Blagojevic,3917980,,True,35.0,3,9,3,9,0,0,8,12,2,8,10,3,2,1,2,0,14
401085982,Hartford Hawks,J. Carroll,3130746,,True,31.0,5,12,4,9,1,3,0,0,2,1,3,1,1,1,2,1,11
401085982,Hartford Hawks,T. Weatherington,4278214,,True,29.0,1,4,0,1,1,3,0,0,0,2,2,1,3,1,3,1,3
401085982,Hartford Hawks,J.R. Lynch,3917979,,True,38.0,7,12,4,6,3,6,0,0,2,9,11,1,3,1,3,2,17
401085982,Hartford Hawks,J. Dunne,3917978,,True,39.0,4,9,0,1,4,8,0,0,0,2,2,3,0,1,3,1,12
401085982,Hartford Hawks,R. Boxus,4395888,,False,16.0,1,3,0,0,1,3,0,0,0,1,1,0,1,1,1,2,3
401085982,Hartford Hawks,M. Twyman,3130743,,False,12.0,2,3,1,1,1,2,0,0,1,1,2,0,1,1,0,0,5
401085982,Hartford Hawks,TEAM,TOTAL,TOTAL,False,,23,52,12,27,11,25,8,12,8,25,33,9,11,7,14,7,65
401085981,Marist Red Foxes,I. Lamb,3936028,,True,28.0,3,7,2,3,1,4,0,0,1,2,3,1,0,0,0,2,7
401085981,Marist Red Foxes,T. Sjoberg,4067328,,True,5.0,0,2,0,2,0,0,0,0,1,0,1,0,0,0,0,2,0
401085981,Marist Red Foxes,D. Knudsen,3936027,,True,22.0,1,4,0,1,1,3,0,0,0,4,4,0,0,1,1,1,3
401085981,Marist Red Foxes,D. Hines,4398410,,True,30.0,3,8,3,7,0,1,1,2,0,1,1,2,0,0,1,2,7
401085981,Marist Red Foxes,B. Parker,3936030,,True,24.0,2,9,2,8,0,1,2,3,0,1,1,6,0,0,4,0,6
401085981,Marist Red Foxes,L. Nedrow,4398414,,False,10.0,0,1,0,1,0,0,0,0,0,2,2,1,0,0,1,1,0
401085981,Marist Red Foxes,R. Funk,3936026,,False,14.0,0,3,0,2,0,1,2,2,0,2,2,0,0,0,0,3,2
401085981,Marist Red Foxes,A. Dozic,3923222,,False,23.0,5,10,4,6,1,4,5,6,4,3,7,1,1,0,4,2,16
401085981,Marist Red Foxes,M. Herasme,4398413,,False,22.0,0,3,0,0,0,3,2,2,1,4,5,0,1,0,1,1,2
401085981,Marist Red Foxes,T. Lee,4279710,,False,2.0,0,2,0,0,0,2,0,0,0,0,0,0,0,0,0,0,0
401085981,Marist Red Foxes,A. Williams,4279709,,False,15.0,3,6,3,6,0,0,1,3,2,2,4,0,1,1,3,1,7
401085981,Marist Red Foxes,R. Carmello,4279708,,False,5.0,1,1,1,1,0,0,1,2,0,0,0,0,0,0,0,0,3
401085981,Marist Red Foxes,TEAM,TOTAL,TOTAL,False,,18,56,15,37,3,19,14,20,11,21,32,11,3,2,16,15,53
401085981,Brown Bears,M. DeWolf,4279464,,True,11.0,1,2,1,2,0,0,0,0,1,2,3,0,0,0,0,0,2
401085981,Brown Bears,T. Choh,4279463,,True,19.0,0,2,0,2,0,0,3,4,0,4,4,2,2,1,4,5,3
401085981,Brown Bears,D. Cambridge Jr.,4279462,,True,24.0,12,18,6,7,6,11,0,1,0,3,3,0,0,1,1,2,30
401085981,Brown Bears,Z. Hunsaker,4279461,,True,23.0,2,5,1,3,1,2,2,2,0,3,3,2,1,0,1,1,7
401085981,Brown Bears,O. Okolie,3906824,,True,26.0,4,4,3,3,1,1,1,2,0,3,3,1,0,0,1,0,10
401085981,Brown Bears,J. Gainey,4397913,,False,3.0,1,2,1,2,0,0,0,0,2,0,2,0,0,1,0,0,2
401085981,Brown Bears,D. Franks,4397912,,False,2.0,0,0,0,0,0,0,0,0,0,0,0,0,0,0,0,0,0
401085981,Brown Bears,J. Howard,4066802,,False,25.0,5,6,5,5,0,1,3,3,1,2,3,3,2,1,2,4,13
401085981,Brown Bears,T. Fuller,3906822,,False,3.0,1,1,1,1,0,0,0,0,0,3,3,0,0,0,1,0,2
401085981,Brown Bears,T. Shaughnessy,4397915,,False,3.0,0,2,0,0,0,2,0,0,0,0,0,0,0,0,0,0,0
401085981,Brown Bears,D. Mitchell,4397914,,False,19.0,2,4,2,2,0,2,0,0,0,5,5,2,0,0,1,4,4
401085981,Brown Bears,J. Shaper,4279460,,False,2.0,0,1,0,0,0,1,0,0,0,1,1,0,0,0,0,0,0
401085981,Brown Bears,G. Mawanda-Kalema,4279459,,False,9.0,0,4,0,2,0,2,0,0,1,0,1,0,0,0,1,1,0
401085981,Brown Bears,B. Anderson,4066800,,False,18.0,2,3,1,2,1,1,0,0,0,1,1,5,3,0,2,2,5
401085981,Brown Bears,C. Sullivan,3906825,,False,13.0,0,3,0,0,0,3,0,0,0,3,3,0,1,0,0,2,0
401085981,Brown Bears,TEAM,TOTAL,TOTAL,False,,30,57,21,31,9,26,9,12,6,32,38,15,9,4,14,21,78
401085980,New Hampshire Wildcats,J. Martinez,4396579,,True,24.0,3,12,1,4,2,8,1,1,2,6,8,1,0,0,2,5,9
401085980,New Hampshire Wildcats,N. Guadarrama,4396578,,True,29.0,4,9,4,6,0,3,0,2,2,5,7,1,1,0,1,4,8
401085980,New Hampshire Wildcats,M. Maultsby,4396576,,True,19.0,1,5,0,2,1,3,0,0,1,3,4,0,0,0,1,3,3
401085980,New Hampshire Wildcats,E. Jordan,4278237,,True,38.0,3,7,3,5,0,2,0,0,0,4,4,8,1,0,1,1,6
401085980,New Hampshire Wildcats,J. Reed,3132469,,True,38.0,4,8,0,1,4,7,0,0,0,8,8,1,0,0,1,0,12
401085980,New Hampshire Wildcats,L. Rosinski,4066730,,False,2.0,0,0,0,0,0,0,0,2,0,0,0,0,0,0,0,0,0
401085980,New Hampshire Wildcats,C. Lester,4066728,,False,13.0,0,1,0,0,0,1,0,0,0,0,0,0,0,0,0,1,0
401085980,New Hampshire Wildcats,D. Watkins,3922029,,False,13.0,0,4,0,2,0,2,0,0,0,1,1,1,0,0,1,0,0
401085980,New Hampshire Wildcats,D. Hall,4396577,,False,6.0,0,1,0,0,0,1,0,0,0,0,0,0,0,0,1,0,0
401085980,New Hampshire Wildcats,M. Carbone,4066743,,False,18.0,4,7,1,1,3,6,0,0,0,0,0,0,1,0,1,3,11
401085980,New Hampshire Wildcats,TEAM,TOTAL,TOTAL,False,,19,54,9,21,10,33,1,5,5,28,33,12,3,0,9,17,49
401085980,Marist Red Foxes,I. Lamb,3936028,,True,27.0,2,4,1,2,1,2,3,6,2,4,6,1,1,0,1,3,8
401085980,Marist Red Foxes,T. Sjoberg,4067328,,True,7.0,1,2,1,2,0,0,0,1,0,1,1,0,0,0,2,1,2
401085980,Marist Red Foxes,D. Knudsen,3936027,,True,18.0,3,8,2,5,1,3,0,1,0,2,2,0,0,0,0,0,7
401085980,Marist Red Foxes,D. Hines,4398410,,True,30.0,5,7,4,5,1,2,0,0,0,3,3,0,1,0,0,0,11
401085980,Marist Red Foxes,B. Parker,3936030,,True,28.0,6,11,6,11,0,0,1,6,1,4,5,3,1,0,4,2,13
401085980,Marist Red Foxes,L. Nedrow,4398414,,False,18.0,0,2,0,1,0,1,0,2,1,6,7,1,0,0,1,1,0
401085980,Marist Red Foxes,R. Funk,3936026,,False,30.0,4,9,1,2,3,7,0,0,0,4,4,0,0,1,0,1,11
401085980,Marist Red Foxes,A. Dozic,3923222,,False,15.0,1,2,1,2,0,0,0,0,0,3,3,4,0,0,1,1,2
401085980,Marist Red Foxes,M. Herasme,4398413,,False,15.0,1,2,1,1,0,1,1,2,1,2,3,0,0,0,0,0,3
401085980,Marist Red Foxes,A. Williams,4279709,,False,12.0,0,1,0,1,0,0,1,2,0,2,2,1,0,0,1,1,1
401085980,Marist Red Foxes,TEAM,TOTAL,TOTAL,False,,23,48,17,32,6,16,6,20,5,32,37,10,3,1,10,10,58
401085979,Marist Red Foxes,I. Lamb,3936028,,True,29.0,2,7,1,4,1,3,2,3,1,3,4,1,2,0,0,2,7
401085979,Marist Red Foxes,T. Sjoberg,4067328,,True,8.0,1,3,1,3,0,0,0,0,0,2,2,0,0,0,0,2,2
401085979,Marist Red Foxes,D. Hines,4398410,,True,19.0,3,8,2,6,1,2,0,0,0,1,1,0,1,0,1,2,7
401085979,Marist Red Foxes,B. Parker,3936030,,True,29.0,6,10,6,8,0,2,6,12,1,1,2,3,0,0,4,2,18
401085979,Marist Red Foxes,D. Knudsen,3936027,,True,25.0,3,8,0,1,3,7,0,0,0,2,2,1,0,0,1,4,9
401085979,Marist Red Foxes,L. Nedrow,4398414,,False,17.0,2,3,1,1,1,2,0,0,1,1,2,0,0,0,2,1,5
401085979,Marist Red Foxes,R. Funk,3936026,,False,19.0,0,7,0,2,0,5,3,3,0,1,1,1,0,0,0,2,3
401085979,Marist Red Foxes,A. Dozic,3923222,,False,12.0,2,5,1,2,1,3,0,0,1,2,3,0,2,0,3,3,5
401085979,Marist Red Foxes,M. Herasme,4398413,,False,20.0,1,4,1,1,0,3,2,2,0,3,3,1,1,0,0,4,4
401085979,Marist Red Foxes,M. Servetas,4279711,,False,1.0,0,0,0,0,0,0,0,0,0,1,1,0,0,0,0,0,0
401085979,Marist Red Foxes,T. Lee,4279710,,False,1.0,0,0,0,0,0,0,0,0,0,0,0,0,0,0,0,0,0
401085979,Marist Red Foxes,A. Williams,4279709,,False,18.0,2,4,2,3,0,1,0,2,0,0,0,5,3,0,0,5,4
401085979,Marist Red Foxes,R. Carmello,4279708,,False,2.0,1,1,1,1,0,0,0,0,0,1,1,0,0,0,0,0,2
401085979,Marist Red Foxes,TEAM,TOTAL,TOTAL,False,,23,60,16,32,7,28,13,22,9,19,28,12,9,0,11,27,66
401085979,Colgate Raiders,W. Rayman,4067106,,True,31.0,7,11,6,8,1,3,6,9,1,6,7,2,2,0,3,3,21
401085979,Colgate Raiders,R. Ivanauskas,4066395,,True,33.0,4,8,3,5,1,3,0,0,3,9,12,2,0,2,6,4,9
401085979,Colgate Raiders,D. Batt,3921438,,True,17.0,3,4,3,4,0,0,4,4,3,3,6,0,0,1,1,1,10
401085979,Colgate Raiders,T. Richardson,4398040,,True,31.0,2,5,1,1,1,4,1,2,2,2,4,0,2,0,1,4,6
401085979,Colgate Raiders,J. Burns,4280047,,True,32.0,7,16,5,9,2,7,8,10,0,2,2,6,0,0,2,4,24
401085979,Colgate Raiders,H. Baxter,4280050,,False,1.0,0,1,0,0,0,1,0,0,0,0,0,0,0,0,0,0,0
401085979,Colgate Raiders,M. Regisford,3921437,,False,13.0,2,2,2,2,0,0,3,3,1,6,7,0,0,0,1,1,7
401085979,Colgate Raiders,Z. Light,4398038,,False,1.0,0,0,0,0,0,0,0,0,0,0,0,0,0,0,0,0,0
401085979,Colgate Raiders,J. Ferguson,4280048,,False,23.0,1,5,0,2,1,3,0,0,1,3,4,2,0,0,1,2,3
401085979,Colgate Raiders,F. Amiel,3921440,,False,18.0,0,0,0,0,0,0,2,2,0,1,1,1,0,0,1,0,2
401085979,Colgate Raiders,TEAM,TOTAL,TOTAL,False,,26,52,20,31,6,21,24,30,12,34,46,13,4,3,16,19,82
401085978,Stetson Hatters,A. Iyiola,4278475,,True,20.0,2,4,2,4,0,0,2,2,1,3,4,1,0,0,2,2,6
401085978,Stetson Hatters,L. Goodman,3904635,,True,25.0,2,6,1,3,1,3,2,2,1,1,2,3,0,0,0,2,7
401085978,Stetson Hatters,M. Sumner,4396780,,True,24.0,1,8,0,2,1,6,2,2,1,6,7,4,0,0,3,3,5
401085978,Stetson Hatters,K. Aninye,4278473,,True,35.0,5,8,3,4,2,4,3,4,1,2,3,6,2,0,4,2,15
401085978,Stetson Hatters,C. Jones,4278470,,True,37.0,8,14,3,5,5,9,2,4,1,8,9,1,3,0,1,1,23
401085978,Stetson Hatters,R. Lynch,4396783,,False,11.0,0,2,0,0,0,2,2,2,0,0,0,0,0,0,1,1,2
401085978,Stetson Hatters,R. Gouety,4278474,,False,2.0,0,1,0,1,0,0,0,0,0,1,1,0,0,0,1,1,0
401085978,Stetson Hatters,C. Verk,4067215,,False,16.0,5,6,4,4,1,2,0,0,0,0,0,0,0,1,1,1,11
401085978,Stetson Hatters,A. Webb,4278476,,False,2.0,0,0,0,0,0,0,0,0,0,0,0,0,0,0,0,0,0
401085978,Stetson Hatters,J. Crutchfield,4396782,,False,7.0,1,2,0,0,1,2,1,2,0,1,1,0,0,0,0,3,4
401085978,Stetson Hatters,R. McKeython,4278472,,False,17.0,1,1,1,1,0,0,0,0,0,1,1,1,1,1,1,3,2
401085978,Stetson Hatters,K. Matthews,4278471,,False,4.0,0,1,0,0,0,1,0,0,0,0,0,2,0,0,1,1,0
401085978,Stetson Hatters,TEAM,TOTAL,TOTAL,False,,25,53,14,24,11,29,14,18,6,25,31,18,6,2,15,20,75
401085978,Marist Red Foxes,I. Lamb,3936028,,True,28.0,7,11,5,6,2,5,2,4,2,5,7,1,0,1,1,3,18
401085978,Marist Red Foxes,T. Sjoberg,4067328,,True,18.0,1,2,1,2,0,0,0,0,2,1,3,1,1,0,0,1,2
401085978,Marist Red Foxes,D. Knudsen,3936027,,True,20.0,4,8,1,2,3,6,0,0,0,0,0,2,1,0,0,0,11
401085978,Marist Red Foxes,D. Hines,4398410,,True,31.0,2,7,1,5,1,2,0,0,0,0,0,3,2,0,0,3,5
401085978,Marist Red Foxes,B. Parker,3936030,,True,30.0,5,13,5,12,0,1,6,8,0,4,4,4,2,0,3,2,16
401085978,Marist Red Foxes,L. Nedrow,4398414,,False,1.0,0,0,0,0,0,0,0,0,1,0,1,0,0,0,0,0,0
401085978,Marist Red Foxes,R. Funk,3936026,,False,20.0,2,4,2,2,0,2,6,6,2,2,4,0,0,0,1,4,10
401085978,Marist Red Foxes,A. Dozic,3923222,,False,21.0,4,6,2,3,2,3,0,0,0,5,5,4,1,1,4,2,10
401085978,Marist Red Foxes,M. Herasme,4398413,,False,17.0,1,2,0,1,1,1,0,1,0,1,1,0,0,0,0,1,3
401085978,Marist Red Foxes,A. Williams,4279709,,False,14.0,2,2,2,2,0,0,0,1,0,5,5,2,2,0,1,1,4
401085978,Marist Red Foxes,TEAM,TOTAL,TOTAL,False,,28,55,19,35,9,20,14,20,7,25,32,17,9,2,11,17,79
401085977,Marist Red Foxes,I. Lamb,3936028,,True,18.0,1,5,0,2,1,3,0,0,0,3,3,0,0,0,0,0,3
401085977,Marist Red Foxes,T. Sjoberg,4067328,,True,16.0,3,4,3,4,0,0,2,2,0,2,2,2,0,1,1,3,8
401085977,Marist Red Foxes,D. Knudsen,3936027,,True,21.0,2,5,0,1,2,4,0,0,1,1,2,0,1,0,1,3,6
401085977,Marist Red Foxes,D. Hines,4398410,,True,29.0,4,7,4,6,0,1,2,2,0,3,3,2,0,0,0,2,10
401085977,Marist Red Foxes,B. Parker,3936030,,True,24.0,7,9,7,9,0,0,4,5,0,4,4,6,1,0,3,2,18
401085977,Marist Red Foxes,L. Nedrow,4398414,,False,5.0,0,0,0,0,0,0,0,0,0,0,0,0,0,0,0,1,0
401085977,Marist Red Foxes,R. Funk,3936026,,False,30.0,4,8,0,2,4,6,2,2,0,1,1,1,0,0,0,0,14
401085977,Marist Red Foxes,A. Dozic,3923222,,False,19.0,3,7,2,4,1,3,2,2,2,6,8,1,0,3,2,1,9
401085977,Marist Red Foxes,M. Herasme,4398413,,False,20.0,1,2,1,1,0,1,0,0,0,6,6,1,0,0,0,0,2
401085977,Marist Red Foxes,M. Servetas,4279711,,False,1.0,0,0,0,0,0,0,0,0,0,0,0,0,0,0,0,0,0
401085977,Marist Red Foxes,T. Lee,4279710,,False,1.0,0,0,0,0,0,0,0,0,0,0,0,0,0,0,0,0,0
401085977,Marist Red Foxes,A. Williams,4279709,,False,15.0,2,4,2,4,0,0,2,2,1,1,2,2,1,0,3,1,6
401085977,Marist Red Foxes,R. Carmello,4279708,,False,1.0,0,0,0,0,0,0,0,0,0,0,0,0,0,0,0,0,0
401085977,Marist Red Foxes,TEAM,TOTAL,TOTAL,False,,27,51,19,33,8,18,14,15,4,28,32,15,3,4,11,13,76
401085977,Dartmouth Big Green,A. Jackson,4279555,,True,23.0,1,5,0,2,1,3,0,0,0,3,3,0,1,0,1,2,3
401085977,Dartmouth Big Green,C. Knight,4279553,,True,27.0,7,13,7,13,0,0,2,2,2,5,7,1,0,1,3,3,16
401085977,Dartmouth Big Green,B. Barry,4066823,,True,32.0,3,9,1,2,2,7,3,3,0,2,2,3,0,0,2,1,11
401085977,Dartmouth Big Green,J. Foye,4066822,,True,27.0,2,5,1,3,1,2,0,0,0,3,3,3,0,0,0,3,5
401085977,Dartmouth Big Green,I. Sistare,4066821,,True,31.0,3,7,1,2,2,5,0,0,0,0,0,2,0,0,0,0,8
401085977,Dartmouth Big Green,W. Emery,4066819,,False,7.0,1,2,1,2,0,0,0,0,0,0,0,0,0,0,2,0,2
401085977,Dartmouth Big Green,A. Rai,4279554,,False,16.0,0,2,0,1,0,1,2,3,2,3,5,0,1,0,2,2,2
401085977,Dartmouth Big Green,W. Slajchert,4397961,,False,5.0,0,1,0,1,0,0,0,0,0,0,0,0,0,0,0,1,0
401085977,Dartmouth Big Green,T. Samuels,4397960,,False,27.0,3,8,0,3,3,5,2,4,0,1,1,2,0,0,1,2,11
401085977,Dartmouth Big Green,G. Smith,3906965,,False,5.0,0,1,0,0,0,1,0,0,0,1,1,0,0,0,1,2,0
401085977,Dartmouth Big Green,TEAM,TOTAL,TOTAL,False,,20,53,11,29,9,24,9,12,5,20,25,11,2,1,12,16,58
401085976,Marist Red Foxes,I. Lamb,3936028,,True,21.0,1,4,1,4,0,0,0,0,1,3,4,2,1,0,2,2,2
401085976,Marist Red Foxes,A. Dozic,3923222,,True,13.0,3,5,1,3,2,2,0,0,1,1,2,1,0,0,2,1,8
401085976,Marist Red Foxes,D. Hines,4398410,,True,25.0,0,4,0,3,0,1,0,0,0,2,2,0,0,0,1,2,0
401085976,Marist Red Foxes,B. Parker,3936030,,True,11.0,0,5,0,4,0,1,3,4,0,2,2,3,0,0,2,2,3
401085976,Marist Red Foxes,D. Knudsen,3936027,,True,19.0,1,6,1,3,0,3,0,0,1,2,3,0,1,0,1,0,2
401085976,Marist Red Foxes,L. Nedrow,4398414,,False,10.0,2,3,2,2,0,1,0,0,0,3,3,2,0,0,1,1,4
401085976,Marist Red Foxes,R. Funk,3936026,,False,27.0,3,10,1,3,2,7,2,2,0,0,0,0,0,1,0,1,10
401085976,Marist Red Foxes,T. Sjoberg,4067328,,False,17.0,2,3,2,3,0,0,0,0,3,1,4,1,0,0,0,2,4
401085976,Marist Red Foxes,M. Herasme,4398413,,False,25.0,2,6,2,4,0,2,2,2,2,5,7,2,2,0,4,2,6
401085976,Marist Red Foxes,T. Lee,4279710,,False,2.0,0,0,0,0,0,0,0,0,0,0,0,0,1,0,1,0,0
401085976,Marist Red Foxes,A. Williams,4279709,,False,26.0,5,9,5,8,0,1,0,0,2,2,4,0,1,0,2,3,10
401085976,Marist Red Foxes,R. Carmello,4279708,,False,4.0,0,0,0,0,0,0,0,0,0,0,0,0,0,0,0,0,0
401085976,Marist Red Foxes,TEAM,TOTAL,TOTAL,False,,19,55,15,37,4,18,7,8,10,22,32,11,6,1,16,16,49
401085976,Buffalo Bulls,M. McRae,4279323,,True,14.0,3,3,1,1,2,2,0,0,2,1,3,1,0,0,2,3,8
401085976,Buffalo Bulls,J. Graves,4279325,,True,25.0,6,9,2,3,4,6,0,0,0,3,3,0,0,3,1,0,16
401085976,Buffalo Bulls,J. Harris,4279324,,True,28.0,2,10,0,3,2,7,0,1,0,4,4,8,1,0,0,0,6
401085976,Buffalo Bulls,D. Caruthers,4067372,,True,22.0,1,2,1,1,0,1,0,0,0,4,4,5,0,0,2,1,2
401085976,Buffalo Bulls,D. Jordan,4067370,,True,20.0,3,4,2,2,1,2,1,2,1,1,2,1,1,0,4,3,8
401085976,Buffalo Bulls,T. Fagan,4397823,,False,14.0,2,3,2,2,0,1,0,0,0,1,1,0,3,1,1,2,4
401085976,Buffalo Bulls,N. Williams,4397821,,False,13.0,0,3,0,0,0,3,2,3,0,0,0,0,0,0,1,0,2
401085976,Buffalo Bulls,N. Perkins,3907031,,False,20.0,1,6,1,4,0,2,2,3,0,7,7,1,1,3,1,1,4
401085976,Buffalo Bulls,B. Bertram,4067374,,False,4.0,0,1,0,1,0,0,0,0,1,1,2,0,0,0,0,1,0
401085976,Buffalo Bulls,R. Segu,4397820,,False,15.0,2,2,1,1,1,1,0,0,0,2,2,3,0,0,2,0,5
401085976,Buffalo Bulls,C. Massinburg,3907030,,False,25.0,7,10,1,3,6,7,1,1,1,2,3,1,0,0,0,2,21
401085976,Buffalo Bulls,TEAM,TOTAL,TOTAL,False,,27,53,11,21,16,32,6,10,7,26,33,20,6,7,14,13,76
401085975,Stephen F. Austin Lumberjacks,D. Fitzgerald,66627,,True,30.0,8,13,6,10,2,3,0,1,1,1,2,0,1,0,2,5,18
401085975,Stephen F. Austin Lumberjacks,J. Grujic,3907343,,True,17.0,2,4,2,4,0,0,0,0,2,3,5,0,0,1,2,2,4
401085975,Stephen F. Austin Lumberjacks,S. Bogues,4278337,,True,38.0,5,12,4,7,1,5,5,6,0,4,4,4,4,1,2,0,16
401085975,Stephen F. Austin Lumberjacks,K. Harris,4067858,,True,39.0,2,10,2,8,0,2,2,5,3,5,8,1,0,1,3,4,6
401085975,Stephen F. Austin Lumberjacks,A. Augustin,4067857,,True,32.0,0,2,0,0,0,2,0,0,1,2,3,6,0,0,2,3,0
401085975,Stephen F. Austin Lumberjacks,N. Bain,3907340,,False,24.0,3,4,3,4,0,0,3,6,4,4,8,1,1,0,1,5,9
401085975,Stephen F. Austin Lumberjacks,A. Walton,4398294,,False,2.0,0,1,0,1,0,0,0,0,0,0,0,0,0,0,0,0,0
401085975,Stephen F. Austin Lumberjacks,O. Walker,4398293,,False,8.0,0,2,0,0,0,2,0,0,0,1,1,2,0,0,1,0,0
401085975,Stephen F. Austin Lumberjacks,J. Hughes,4398291,,False,10.0,3,6,0,1,3,5,2,2,0,1,1,0,0,0,1,1,11
401085975,Stephen F. Austin Lumberjacks,TEAM,TOTAL,TOTAL,False,,23,54,17,35,6,19,12,20,11,21,32,14,6,3,16,20,64
401085975,Marist Red Foxes,I. Lamb,3936028,,True,29.0,5,8,1,2,4,6,1,2,0,5,5,1,1,0,4,4,15
401085975,Marist Red Foxes,T. Sjoberg,4067328,,True,10.0,0,0,0,0,0,0,0,0,0,2,2,0,0,0,1,1,0
401085975,Marist Red Foxes,D. Hines,4398410,,True,36.0,2,3,1,1,1,2,2,2,0,0,0,5,1,0,2,2,7
401085975,Marist Red Foxes,B. Parker,3936030,,True,31.0,1,7,1,6,0,1,6,9,1,2,3,3,2,0,2,3,8
401085975,Marist Red Foxes,D. Knudsen,3936027,,True,20.0,4,6,2,3,2,3,0,0,0,1,1,3,0,0,0,1,10
401085975,Marist Red Foxes,L. Nedrow,4398414,,False,13.0,1,2,0,0,1,2,0,0,0,1,1,0,0,0,4,4,3
401085975,Marist Red Foxes,R. Funk,3936026,,False,26.0,3,7,0,1,3,6,0,0,0,6,6,0,0,0,2,1,9
401085975,Marist Red Foxes,A. Dozic,3923222,,False,17.0,2,5,1,2,1,3,0,0,1,3,4,0,1,0,2,5,5
401085975,Marist Red Foxes,M. Herasme,4398413,,False,5.0,0,0,0,0,0,0,0,0,0,0,0,0,0,0,0,1,0
401085975,Marist Red Foxes,A. Williams,4279709,,False,13.0,1,2,1,2,0,0,1,1,0,0,0,3,1,0,0,1,3
401085975,Marist Red Foxes,TEAM,TOTAL,TOTAL,False,,19,40,7,17,12,23,10,14,2,20,22,15,6,0,17,24,60
401085974,Marist Red Foxes,I. Lamb,3936028,,True,29.0,2,6,0,2,2,4,1,2,1,8,9,1,1,0,1,4,7
401085974,Marist Red Foxes,T. Sjoberg,4067328,,True,8.0,0,0,0,0,0,0,0,0,0,0,0,1,0,0,0,0,0
401085974,Marist Red Foxes,D. Knudsen,3936027,,True,18.0,4,8,0,1,4,7,2,2,0,2,2,2,1,0,2,4,14
401085974,Marist Red Foxes,D. Hines,4398410,,True,30.0,3,6,2,4,1,2,0,0,0,3,3,5,1,0,1,0,7
401085974,Marist Red Foxes,B. Parker,3936030,,True,33.0,5,15,4,11,1,4,6,6,0,4,4,5,1,0,3,1,17
401085974,Marist Red Foxes,L. Nedrow,4398414,,False,14.0,2,3,0,1,2,2,0,0,0,2,2,0,0,0,0,0,6
401085974,Marist Red Foxes,R. Funk,3936026,,False,31.0,5,13,1,4,4,9,2,2,0,3,3,1,3,0,1,2,16
401085974,Marist Red Foxes,A. Dozic,3923222,,False,11.0,1,1,0,0,1,1,0,0,1,1,2,2,0,0,1,1,3
401085974,Marist Red Foxes,M. Herasme,4398413,,False,15.0,0,0,0,0,0,0,0,0,0,1,1,2,0,0,2,0,0
401085974,Marist Red Foxes,A. Williams,4279709,,False,11.0,1,3,1,3,0,0,0,2,0,1,1,0,0,0,1,2,2
401085974,Marist Red Foxes,TEAM,TOTAL,TOTAL,False,,23,55,8,26,15,29,11,14,4,26,30,19,7,0,12,14,72
401085974,Lehigh Mountain Hawks,P. Andree,4067122,,True,33.0,6,9,3,5,3,4,1,1,2,8,10,1,0,0,0,3,16
401085974,Lehigh Mountain Hawks,J. Karnik,4280080,,True,21.0,0,3,0,3,0,0,0,0,2,5,7,3,0,0,2,1,0
401085974,Lehigh Mountain Hawks,J. Cohen,4067120,,True,25.0,5,9,4,7,1,2,0,1,0,7,7,2,0,0,2,3,11
401085974,Lehigh Mountain Hawks,K. Leufroy,3908514,,True,30.0,8,13,4,6,4,7,3,4,1,4,5,2,1,0,2,0,23
401085974,Lehigh Mountain Hawks,L. Tejada,3147354,,True,34.0,6,12,2,3,4,9,0,0,1,0,1,7,1,0,3,3,16
401085974,Lehigh Mountain Hawks,J. Wilson,4398116,,False,8.0,0,0,0,0,0,0,0,0,0,0,0,0,1,0,1,1,0
401085974,Lehigh Mountain Hawks,N. Lynch,4398119,,False,7.0,1,3,1,3,0,0,0,0,0,1,1,0,0,0,0,0,2
401085974,Lehigh Mountain Hawks,J. Foley,4398117,,False,2.0,0,0,0,0,0,0,0,0,0,0,0,0,0,0,0,0,0
401085974,Lehigh Mountain Hawks,M. Wilson,4280081,,False,20.0,1,6,0,1,1,5,0,0,0,0,0,0,0,0,2,1,3
401085974,Lehigh Mountain Hawks,C. Bennett,4280078,,False,20.0,2,5,2,5,0,0,3,4,1,3,4,1,1,0,0,2,7
401085974,Lehigh Mountain Hawks,TEAM,TOTAL,TOTAL,False,,29,60,16,33,13,27,7,10,8,28,36,16,4,0,13,14,78
401085973,Marist Red Foxes,I. Lamb,3936028,,True,27.0,4,8,3,5,1,3,0,1,2,3,5,3,2,0,3,1,9
401085973,Marist Red Foxes,T. Sjoberg,4067328,,True,13.0,0,1,0,1,0,0,0,0,3,1,4,1,1,0,0,4,0
401085973,Marist Red Foxes,D. Knudsen,3936027,,True,25.0,5,11,0,2,5,9,0,1,1,4,5,0,0,0,0,0,15
401085973,Marist Red Foxes,D. Hines,4398410,,True,32.0,4,5,4,4,0,1,3,4,0,2,2,2,0,0,4,1,11
401085973,Marist Red Foxes,B. Parker,3936030,,True,29.0,6,13,4,10,2,3,7,13,0,6,6,1,0,0,7,3,21
401085973,Marist Red Foxes,L. Nedrow,4398414,,False,21.0,2,2,1,1,1,1,0,1,4,1,5,3,0,1,0,3,5
401085973,Marist Red Foxes,R. Funk,3936026,,False,29.0,5,11,2,3,3,8,0,0,0,6,6,1,0,1,0,1,13
401085973,Marist Red Foxes,A. Dozic,3923222,,False,7.0,0,1,0,0,0,1,0,0,0,2,2,1,0,0,1,3,0
401085973,Marist Red Foxes,M. Herasme,4398413,,False,9.0,2,4,2,2,0,2,2,2,0,1,1,0,0,0,0,4,6
401085973,Marist Red Foxes,A. Williams,4279709,,False,8.0,1,1,1,1,0,0,0,0,0,0,0,1,1,0,1,4,2
401085973,Marist Red Foxes,TEAM,TOTAL,TOTAL,False,,29,57,17,29,12,28,12,22,13,26,39,13,4,2,16,24,82
401085973,Columbia Lions,I. Nweke,4397926,,True,27.0,5,7,5,7,0,0,7,10,4,3,7,1,0,0,2,3,17
401085973,Columbia Lions,R. Hunter,3948604,,True,13.0,0,1,0,0,0,1,0,2,0,2,2,0,0,2,1,2,0
401085973,Columbia Lions,T. Bibbs,4279470,,True,12.0,0,2,0,0,0,2,0,0,0,0,0,1,1,0,1,2,0
401085973,Columbia Lions,G. Stefanini,4279467,,True,31.0,5,9,3,5,2,4,1,1,0,2,2,2,1,0,2,0,13
401085973,Columbia Lions,M. Smith,4066806,,True,36.0,7,14,5,9,2,5,7,8,0,4,4,8,3,0,3,4,23
401085973,Columbia Lions,R. Brumant,4279466,,False,21.0,5,10,4,9,1,1,0,1,2,4,6,1,2,1,0,3,11
401085973,Columbia Lions,M. Ellis,4397927,,False,10.0,0,2,0,1,0,1,0,0,1,0,1,1,0,0,1,3,0
401085973,Columbia Lions,J. Killingsworth,4066807,,False,15.0,0,1,0,0,0,1,0,0,0,3,3,0,0,0,1,2,0
401085973,Columbia Lions,P. Barba,3948608,,False,6.0,0,1,0,0,0,1,2,2,1,0,1,0,1,0,0,0,2
401085973,Columbia Lions,Q. Adlesh,3948606,,False,29.0,4,9,2,2,2,7,0,0,0,3,3,2,1,0,3,4,10
401085973,Columbia Lions,TEAM,TOTAL,TOTAL,False,,26,56,19,33,7,23,17,24,10,22,32,16,9,3,14,23,76
401085972,Marist Red Foxes,I. Lamb,3936028,,True,16.0,2,3,2,3,0,0,1,1,1,1,2,1,0,0,0,0,5
401085972,Marist Red Foxes,T. Sjoberg,4067328,,True,20.0,2,2,2,2,0,0,0,0,1,3,4,0,1,0,3,4,4
401085972,Marist Red Foxes,D. Hines,4398410,,True,19.0,2,3,2,2,0,1,0,0,0,1,1,1,0,0,1,4,4
401085972,Marist Red Foxes,B. Parker,3936030,,True,28.0,9,16,9,16,0,0,7,14,3,7,10,3,0,0,4,3,25
401085972,Marist Red Foxes,D. Knudsen,3936027,,True,24.0,1,7,1,2,0,5,0,0,0,2,2,1,2,0,2,3,2
401085972,Marist Red Foxes,L. Nedrow,4398414,,False,9.0,2,3,2,2,0,1,0,0,0,1,1,1,0,0,0,4,4
401085972,Marist Red Foxes,R. Funk,3936026,,False,32.0,3,8,1,2,2,6,2,2,0,4,4,0,0,0,0,1,10
401085972,Marist Red Foxes,A. Dozic,3923222,,False,10.0,2,4,2,3,0,1,0,0,1,2,3,0,0,0,0,0,4
401085972,Marist Red Foxes,M. Herasme,4398413,,False,18.0,1,1,0,0,1,1,0,0,0,3,3,1,0,0,1,2,3
401085972,Marist Red Foxes,A. Williams,4279709,,False,24.0,3,5,3,5,0,0,2,7,2,2,4,0,1,0,1,2,8
401085972,Marist Red Foxes,TEAM,TOTAL,TOTAL,False,,27,52,24,37,3,15,12,24,9,27,36,8,4,0,12,23,69
401085972,Army Black Knights,M. Wilson,4067091,,True,23.0,8,8,8,8,0,0,8,12,1,5,6,1,0,0,1,4,24
401085972,Army Black Knights,J. Caldwell,4397607,,True,30.0,2,8,1,4,1,4,0,0,2,4,6,4,0,0,0,4,5
401085972,Army Black Knights,T. Funk,4067089,,True,27.0,4,6,2,3,2,3,5,7,0,2,2,6,1,0,1,4,15
401085972,Army Black Knights,J. Fox,3948826,,True,28.0,5,8,1,1,4,7,0,0,0,3,3,0,0,0,1,3,14
401085972,Army Black Knights,J. Kessler,3155887,,True,20.0,0,0,0,0,0,0,1,3,2,1,3,0,3,0,0,3,1
401085972,Army Black Knights,B. Kinker,4397611,,False,11.0,0,3,0,0,0,3,1,2,0,3,3,0,0,0,1,0,1
401085972,Army Black Knights,A. King,4284080,,False,17.0,0,4,0,1,0,3,2,2,0,2,2,0,0,1,0,1,2
401085972,Army Black Knights,A. Duhart,4397609,,False,14.0,2,6,0,3,2,3,0,0,0,1,1,1,0,0,1,2,6
401085972,Army Black Knights,J. Miller,3948827,,False,7.0,0,0,0,0,0,0,0,0,1,0,1,0,0,0,0,0,0
401085972,Army Black Knights,T. Blackwell,4284076,,False,12.0,0,4,0,0,0,4,2,2,0,1,1,2,1,0,0,0,2
401085972,Army Black Knights,L. Grayson,4284075,,False,8.0,1,3,1,1,0,2,1,1,0,0,0,0,0,0,1,1,3
401085972,Army Black Knights,J. Emezie,3948830,,False,3.0,0,1,0,0,0,1,0,0,0,0,0,0,0,0,0,0,0
401085972,Army Black Knights,TEAM,TOTAL,TOTAL,False,,22,51,13,21,9,30,20,29,6,22,28,14,5,1,6,22,73
401085971,Monmouth Hawks,M. Traore,3975762,,True,28.0,3,8,3,8,0,0,1,2,2,7,9,2,1,4,1,1,7
401085971,Monmouth Hawks,D. Quinn,3948714,,True,24.0,2,3,2,3,0,0,3,4,2,2,4,0,0,2,1,3,7
401085971,Monmouth Hawks,M. McClary,4279736,,True,34.0,3,3,3,3,0,0,0,0,1,1,2,1,1,0,1,2,6
401085971,Monmouth Hawks,D. Hammond,4279734,,True,33.0,6,13,2,5,4,8,1,3,0,2,2,0,0,0,1,1,17
401085971,Monmouth Hawks,R. Salnave,4067329,,True,32.0,5,9,3,5,2,4,5,6,1,8,9,9,0,0,3,2,17
401085971,Monmouth Hawks,S. Ibiezugbe,4067330,,False,2.0,0,0,0,0,0,0,0,0,0,0,0,0,0,0,0,0,0
401085971,Monmouth Hawks,M. Martin,4279733,,False,18.0,1,1,1,1,0,0,0,1,0,2,2,0,0,1,3,3,2
401085971,Monmouth Hawks,S. Chaput,4398409,,False,0.0,0,0,0,0,0,0,0,0,0,0,0,0,0,0,0,0,0
401085971,Monmouth Hawks,G. Papas,4279735,,False,7.0,0,0,0,0,0,0,1,2,0,0,0,0,0,0,1,1,1
401085971,Monmouth Hawks,L. Pillari,3948713,,False,8.0,2,5,2,3,0,2,0,0,0,0,0,0,0,0,1,0,4
401085971,Monmouth Hawks,N. Rutherford,3946977,,False,12.0,0,3,0,2,0,1,0,0,0,3,3,2,1,0,2,1,0
401085971,Monmouth Hawks,TEAM,TOTAL,TOTAL,False,,22,45,16,30,6,15,12,19,9,30,39,14,3,7,15,14,62
401085971,Monmouth Hawks,M. Traore,3975762,,True,28.0,3,8,3,8,0,0,1,2,2,7,9,2,1,4,1,1,7
401085971,Monmouth Hawks,D. Quinn,3948714,,True,24.0,2,3,2,3,0,0,3,4,2,2,4,0,0,2,1,3,7
401085971,Monmouth Hawks,M. McClary,4279736,,True,34.0,3,3,3,3,0,0,0,0,1,1,2,1,1,0,1,2,6
401085971,Monmouth Hawks,D. Hammond,4279734,,True,33.0,6,13,2,5,4,8,1,3,0,2,2,0,0,0,1,1,17
401085971,Monmouth Hawks,R. Salnave,4067329,,True,32.0,5,9,3,5,2,4,5,6,1,8,9,9,0,0,3,2,17
401085971,Monmouth Hawks,S. Ibiezugbe,4067330,,False,2.0,0,0,0,0,0,0,0,0,0,0,0,0,0,0,0,0,0
401085971,Monmouth Hawks,M. Martin,4279733,,False,18.0,1,1,1,1,0,0,0,1,0,2,2,0,0,1,3,3,2
401085971,Monmouth Hawks,S. Chaput,4398409,,False,0.0,0,0,0,0,0,0,0,0,0,0,0,0,0,0,0,0,0
401085971,Monmouth Hawks,G. Papas,4279735,,False,7.0,0,0,0,0,0,0,1,2,0,0,0,0,0,0,1,1,1
401085971,Monmouth Hawks,L. Pillari,3948713,,False,8.0,2,5,2,3,0,2,0,0,0,0,0,0,0,0,1,0,4
401085971,Monmouth Hawks,N. Rutherford,3946977,,False,12.0,0,3,0,2,0,1,0,0,0,3,3,2,1,0,2,1,0
401085971,Monmouth Hawks,TEAM,TOTAL,TOTAL,False,,22,45,16,30,6,15,12,19,9,30,39,14,3,7,15,14,62
401085971,Manhattan Jaspers,T. Reynolds,4398107,,True,25.0,4,12,4,6,0,6,1,1,2,2,4,1,2,0,0,1,9
401085971,Manhattan Jaspers,W. Williams,4279701,,True,35.0,5,10,5,10,0,0,5,10,5,3,8,1,1,2,3,3,15
401085971,Manhattan Jaspers,C. Hinckson,4398106,,True,15.0,2,3,2,3,0,0,0,1,1,0,1,1,0,1,2,1,4
401085971,Manhattan Jaspers,S. Stewart,4398104,,True,32.0,2,10,1,3,1,7,2,2,3,1,4,0,0,0,0,1,7
401085971,Manhattan Jaspers,N. Mack,4279703,,True,23.0,1,3,0,0,1,3,0,0,0,3,3,4,1,0,0,1,3
401085971,Manhattan Jaspers,E. Ebube,4279705,,False,8.0,0,0,0,0,0,0,0,0,0,0,0,0,1,0,0,5,0
401085971,Manhattan Jaspers,I. Diallo,3149898,,False,0.0,0,0,0,0,0,0,0,0,0,0,0,0,0,0,0,0,0
401085971,Manhattan Jaspers,T. Greene,4398108,,False,19.0,3,10,0,2,3,8,0,0,0,5,5,1,0,0,1,0,9
401085971,Manhattan Jaspers,E. Buchanan,4398103,,False,13.0,3,8,3,6,0,2,1,2,0,4,4,3,3,0,0,3,7
401085971,Manhattan Jaspers,E. Lasko,4277944,,False,4.0,0,0,0,0,0,0,0,0,0,0,0,0,0,0,0,0,0
401085971,Manhattan Jaspers,T. Capuano,3948706,,False,7.0,0,2,0,1,0,1,0,0,0,0,0,1,0,0,2,0,0
401085971,Manhattan Jaspers,S. Usilo,3138468,,False,18.0,0,2,0,1,0,1,0,0,0,1,1,0,1,0,0,0,0
401085971,Manhattan Jaspers,TEAM,TOTAL,TOTAL,False,,20,61,15,32,5,29,9,16,15,19,34,12,9,3,8,15,54
401085971,Manhattan Jaspers,T. Reynolds,4398107,,True,25.0,4,12,4,6,0,6,1,1,2,2,4,1,2,0,0,1,9
401085971,Manhattan Jaspers,W. Williams,4279701,,True,35.0,5,10,5,10,0,0,5,10,5,3,8,1,1,2,3,3,15
401085971,Manhattan Jaspers,C. Hinckson,4398106,,True,15.0,2,3,2,3,0,0,0,1,1,0,1,1,0,1,2,1,4
401085971,Manhattan Jaspers,S. Stewart,4398104,,True,32.0,2,10,1,3,1,7,2,2,3,1,4,0,0,0,0,1,7
401085971,Manhattan Jaspers,N. Mack,4279703,,True,23.0,1,3,0,0,1,3,0,0,0,3,3,4,1,0,0,1,3
401085971,Manhattan Jaspers,E. Ebube,4279705,,False,8.0,0,0,0,0,0,0,0,0,0,0,0,0,1,0,0,5,0
401085971,Manhattan Jaspers,I. Diallo,3149898,,False,0.0,0,0,0,0,0,0,0,0,0,0,0,0,0,0,0,0,0
401085971,Manhattan Jaspers,T. Greene,4398108,,False,19.0,3,10,0,2,3,8,0,0,0,5,5,1,0,0,1,0,9
401085971,Manhattan Jaspers,E. Buchanan,4398103,,False,13.0,3,8,3,6,0,2,1,2,0,4,4,3,3,0,0,3,7
401085971,Manhattan Jaspers,E. Lasko,4277944,,False,4.0,0,0,0,0,0,0,0,0,0,0,0,0,0,0,0,0,0
401085971,Manhattan Jaspers,T. Capuano,3948706,,False,7.0,0,2,0,1,0,1,0,0,0,0,0,1,0,0,2,0,0
401085971,Manhattan Jaspers,S. Usilo,3138468,,False,18.0,0,2,0,1,0,1,0,0,0,1,1,0,1,0,0,0,0
401085971,Manhattan Jaspers,TEAM,TOTAL,TOTAL,False,,20,61,15,32,5,29,9,16,15,19,34,12,9,3,8,15,54
401085970,Manhattan Jaspers,W. Williams,4279701,,True,23.0,5,7,5,7,0,0,3,6,2,4,6,0,1,0,3,2,13
401085970,Manhattan Jaspers,T. Greene,4398108,,True,32.0,1,5,0,2,1,3,2,2,0,2,2,2,0,0,3,2,5
401085970,Manhattan Jaspers,C. Hinckson,4398106,,True,17.0,3,6,2,4,1,2,2,2,3,1,4,0,0,1,1,2,9
401085970,Manhattan Jaspers,S. Stewart,4398104,,True,28.0,1,4,0,0,1,4,2,3,0,3,3,3,0,0,0,3,5
401085970,Manhattan Jaspers,N. Mack,4279703,,True,30.0,1,5,1,3,0,2,0,0,0,1,1,4,0,0,2,1,2
401085970,Manhattan Jaspers,T. Reynolds,4398107,,False,8.0,1,4,0,0,1,4,0,0,0,0,0,0,0,0,0,0,3
401085970,Manhattan Jaspers,D. Schreier,4398105,,False,3.0,0,0,0,0,0,0,0,0,0,0,0,0,0,0,0,0,0
401085970,Manhattan Jaspers,E. Ebube,4279705,,False,29.0,8,14,5,8,3,6,1,3,4,1,5,0,2,0,1,0,20
401085970,Manhattan Jaspers,E. Buchanan,4398103,,False,13.0,1,1,1,1,0,0,0,0,1,0,1,1,0,0,1,2,2
401085970,Manhattan Jaspers,E. Lasko,4277944,,False,3.0,0,0,0,0,0,0,0,0,0,0,0,0,0,0,0,1,0
401085970,Manhattan Jaspers,T. Capuano,3948706,,False,8.0,0,2,0,1,0,1,0,0,0,0,0,0,0,0,0,0,0
401085970,Manhattan Jaspers,S. Usilo,3138468,,False,6.0,0,0,0,0,0,0,0,0,0,2,2,0,0,0,1,3,0
401085970,Manhattan Jaspers,TEAM,TOTAL,TOTAL,False,,21,48,14,26,7,22,10,16,11,15,26,10,3,1,12,16,59
401085970,Manhattan Jaspers,W. Williams,4279701,,True,23.0,5,7,5,7,0,0,3,6,2,4,6,0,1,0,3,2,13
401085970,Manhattan Jaspers,T. Greene,4398108,,True,32.0,1,5,0,2,1,3,2,2,0,2,2,2,0,0,3,2,5
401085970,Manhattan Jaspers,C. Hinckson,4398106,,True,17.0,3,6,2,4,1,2,2,2,3,1,4,0,0,1,1,2,9
401085970,Manhattan Jaspers,S. Stewart,4398104,,True,28.0,1,4,0,0,1,4,2,3,0,3,3,3,0,0,0,3,5
401085970,Manhattan Jaspers,N. Mack,4279703,,True,30.0,1,5,1,3,0,2,0,0,0,1,1,4,0,0,2,1,2
401085970,Manhattan Jaspers,T. Reynolds,4398107,,False,8.0,1,4,0,0,1,4,0,0,0,0,0,0,0,0,0,0,3
401085970,Manhattan Jaspers,D. Schreier,4398105,,False,3.0,0,0,0,0,0,0,0,0,0,0,0,0,0,0,0,0,0
401085970,Manhattan Jaspers,E. Ebube,4279705,,False,29.0,8,14,5,8,3,6,1,3,4,1,5,0,2,0,1,0,20
401085970,Manhattan Jaspers,E. Buchanan,4398103,,False,13.0,1,1,1,1,0,0,0,0,1,0,1,1,0,0,1,2,2
401085970,Manhattan Jaspers,E. Lasko,4277944,,False,3.0,0,0,0,0,0,0,0,0,0,0,0,0,0,0,0,1,0
401085970,Manhattan Jaspers,T. Capuano,3948706,,False,8.0,0,2,0,1,0,1,0,0,0,0,0,0,0,0,0,0,0
401085970,Manhattan Jaspers,S. Usilo,3138468,,False,6.0,0,0,0,0,0,0,0,0,0,2,2,0,0,0,1,3,0
401085970,Manhattan Jaspers,TEAM,TOTAL,TOTAL,False,,21,48,14,26,7,22,10,16,11,15,26,10,3,1,12,16,59
401085970,Fairfield Stags,J. Kasibabu,3947016,,True,18.0,3,5,3,5,0,0,0,0,1,3,4,4,0,0,1,4,6
401085970,Fairfield Stags,M. Milin,3947018,,True,31.0,5,8,4,6,1,2,3,6,3,1,4,1,0,0,2,3,14
401085970,Fairfield Stags,L. Taliaferro,4398078,,True,39.0,8,19,0,1,8,18,2,2,1,2,3,2,0,0,1,2,26
401085970,Fairfield Stags,N. Alvarez,4398075,,True,39.0,2,5,1,3,1,2,2,2,0,3,3,4,0,0,2,0,7
401085970,Fairfield Stags,T. Benning,4279483,,True,32.0,1,3,0,2,1,1,0,0,0,4,4,5,3,0,1,2,3
401085970,Fairfield Stags,W. Methnani,4279486,,False,6.0,2,3,2,2,0,1,0,0,0,0,0,0,1,0,0,1,4
401085970,Fairfield Stags,C. Whipple,4398077,,False,1.0,0,0,0,0,0,0,0,0,0,0,0,0,0,0,0,0,0
401085970,Fairfield Stags,F. Lemetti,4398076,,False,1.0,1,1,0,0,1,1,0,0,0,1,1,0,0,0,0,0,3
401085970,Fairfield Stags,J. Cruz,4279488,,False,24.0,3,5,2,4,1,1,2,3,1,2,3,1,0,0,1,2,9
401085970,Fairfield Stags,A. Kavaliauskas,4080375,,False,8.0,0,1,0,0,0,1,0,0,0,1,1,3,0,0,1,0,0
401085970,Fairfield Stags,T. Nolan,3947015,,False,1.0,0,0,0,0,0,0,0,0,0,0,0,0,0,0,0,1,0
401085970,Fairfield Stags,TEAM,TOTAL,TOTAL,False,,25,50,12,23,13,27,9,13,12,19,31,20,4,0,11,15,72
401085970,Fairfield Stags,J. Kasibabu,3947016,,True,18.0,3,5,3,5,0,0,0,0,1,3,4,4,0,0,1,4,6
401085970,Fairfield Stags,M. Milin,3947018,,True,31.0,5,8,4,6,1,2,3,6,3,1,4,1,0,0,2,3,14
401085970,Fairfield Stags,L. Taliaferro,4398078,,True,39.0,8,19,0,1,8,18,2,2,1,2,3,2,0,0,1,2,26
401085970,Fairfield Stags,N. Alvarez,4398075,,True,39.0,2,5,1,3,1,2,2,2,0,3,3,4,0,0,2,0,7
401085970,Fairfield Stags,T. Benning,4279483,,True,32.0,1,3,0,2,1,1,0,0,0,4,4,5,3,0,1,2,3
401085970,Fairfield Stags,W. Methnani,4279486,,False,6.0,2,3,2,2,0,1,0,0,0,0,0,0,1,0,0,1,4
401085970,Fairfield Stags,C. Whipple,4398077,,False,1.0,0,0,0,0,0,0,0,0,0,0,0,0,0,0,0,0,0
401085970,Fairfield Stags,F. Lemetti,4398076,,False,1.0,1,1,0,0,1,1,0,0,0,1,1,0,0,0,0,0,3
401085970,Fairfield Stags,J. Cruz,4279488,,False,24.0,3,5,2,4,1,1,2,3,1,2,3,1,0,0,1,2,9
401085970,Fairfield Stags,A. Kavaliauskas,4080375,,False,8.0,0,1,0,0,0,1,0,0,0,1,1,3,0,0,1,0,0
401085970,Fairfield Stags,T. Nolan,3947015,,False,1.0,0,0,0,0,0,0,0,0,0,0,0,0,0,0,0,1,0
401085970,Fairfield Stags,TEAM,TOTAL,TOTAL,False,,25,50,12,23,13,27,9,13,12,19,31,20,4,0,11,15,72
401085969,Niagara Purple Eagles,D. Robb,3907186,,True,27.0,7,10,7,10,0,0,3,5,0,5,5,0,0,2,0,2,17
401085969,Niagara Purple Eagles,M. Prochet,3907184,,True,31.0,2,7,0,2,2,5,0,0,1,4,5,1,1,2,1,4,6
401085969,Niagara Purple Eagles,K. Tate,4279738,,True,23.0,2,8,2,4,0,4,0,0,0,2,2,1,0,0,1,1,4
401085969,Niagara Purple Eagles,J. Towns,4067341,,True,34.0,3,6,2,4,1,2,4,6,0,4,4,4,0,0,2,2,11
401085969,Niagara Purple Eagles,C. Barton,3907182,,True,24.0,1,3,1,2,0,1,0,2,1,0,1,3,0,0,1,5,2
401085969,Niagara Purple Eagles,G. Kuakumensah,4279739,,False,8.0,0,1,0,1,0,0,2,2,1,1,2,0,1,2,2,1,2
401085969,Niagara Purple Eagles,G. King,3906490,,False,14.0,4,5,4,5,0,0,1,1,2,1,3,0,0,0,1,1,9
401085969,Niagara Purple Eagles,M. Hammond,4398404,,False,23.0,3,5,0,2,3,3,0,0,0,1,1,1,0,0,1,0,9
401085969,Niagara Purple Eagles,R. Solomon,4398403,,False,15.0,0,2,0,1,0,1,0,0,0,2,2,1,0,0,0,1,0
401085969,Niagara Purple Eagles,D. Fragala,4279737,,False,1.0,0,0,0,0,0,0,0,0,0,0,0,1,0,0,1,0,0
401085969,Niagara Purple Eagles,TEAM,TOTAL,TOTAL,False,,22,47,16,31,6,16,10,16,5,21,26,12,2,6,10,17,60
401085969,Niagara Purple Eagles,D. Robb,3907186,,True,27.0,7,10,7,10,0,0,3,5,0,5,5,0,0,2,0,2,17
401085969,Niagara Purple Eagles,M. Prochet,3907184,,True,31.0,2,7,0,2,2,5,0,0,1,4,5,1,1,2,1,4,6
401085969,Niagara Purple Eagles,K. Tate,4279738,,True,23.0,2,8,2,4,0,4,0,0,0,2,2,1,0,0,1,1,4
401085969,Niagara Purple Eagles,J. Towns,4067341,,True,34.0,3,6,2,4,1,2,4,6,0,4,4,4,0,0,2,2,11
401085969,Niagara Purple Eagles,C. Barton,3907182,,True,24.0,1,3,1,2,0,1,0,2,1,0,1,3,0,0,1,5,2
401085969,Niagara Purple Eagles,G. Kuakumensah,4279739,,False,8.0,0,1,0,1,0,0,2,2,1,1,2,0,1,2,2,1,2
401085969,Niagara Purple Eagles,G. King,3906490,,False,14.0,4,5,4,5,0,0,1,1,2,1,3,0,0,0,1,1,9
401085969,Niagara Purple Eagles,M. Hammond,4398404,,False,23.0,3,5,0,2,3,3,0,0,0,1,1,1,0,0,1,0,9
401085969,Niagara Purple Eagles,R. Solomon,4398403,,False,15.0,0,2,0,1,0,1,0,0,0,2,2,1,0,0,0,1,0
401085969,Niagara Purple Eagles,D. Fragala,4279737,,False,1.0,0,0,0,0,0,0,0,0,0,0,0,1,0,0,1,0,0
401085969,Niagara Purple Eagles,TEAM,TOTAL,TOTAL,False,,22,47,16,31,6,16,10,16,5,21,26,12,2,6,10,17,60
401085969,Manhattan Jaspers,T. Reynolds,4398107,,True,22.0,1,11,0,4,1,7,2,2,0,7,7,0,0,0,0,0,5
401085969,Manhattan Jaspers,W. Williams,4279701,,True,31.0,4,6,4,6,0,0,1,2,1,4,5,2,2,0,1,2,9
401085969,Manhattan Jaspers,C. Hinckson,4398106,,True,27.0,2,8,2,6,0,2,2,2,2,0,2,4,0,0,2,1,6
401085969,Manhattan Jaspers,S. Stewart,4398104,,True,33.0,5,7,1,2,4,5,0,0,0,1,1,1,0,0,2,3,14
401085969,Manhattan Jaspers,N. Mack,4279703,,True,20.0,1,1,1,1,0,0,0,0,1,3,4,2,0,0,1,4,2
401085969,Manhattan Jaspers,D. Schreier,4398105,,False,3.0,0,0,0,0,0,0,0,0,0,1,1,0,0,0,0,0,0
401085969,Manhattan Jaspers,E. Ebube,4279705,,False,15.0,4,5,3,4,1,1,2,2,2,2,4,0,1,1,1,5,11
401085969,Manhattan Jaspers,T. Greene,4398108,,False,20.0,3,5,0,2,3,3,5,6,0,5,5,2,0,0,1,0,14
401085969,Manhattan Jaspers,E. Buchanan,4398103,,False,3.0,0,0,0,0,0,0,0,0,0,0,0,1,0,0,1,3,0
401085969,Manhattan Jaspers,E. Lasko,4277944,,False,3.0,0,1,0,0,0,1,0,0,0,0,0,0,0,0,0,0,0
401085969,Manhattan Jaspers,T. Capuano,3948706,,False,21.0,1,3,0,1,1,2,0,0,0,0,0,3,1,0,0,0,3
401085969,Manhattan Jaspers,S. Usilo,3138468,,False,2.0,0,0,0,0,0,0,0,0,0,0,0,0,0,0,1,0,0
401085969,Manhattan Jaspers,TEAM,TOTAL,TOTAL,False,,21,47,11,26,10,21,12,14,7,24,31,15,4,1,11,18,64
401085969,Manhattan Jaspers,T. Reynolds,4398107,,True,22.0,1,11,0,4,1,7,2,2,0,7,7,0,0,0,0,0,5
401085969,Manhattan Jaspers,W. Williams,4279701,,True,31.0,4,6,4,6,0,0,1,2,1,4,5,2,2,0,1,2,9
401085969,Manhattan Jaspers,C. Hinckson,4398106,,True,27.0,2,8,2,6,0,2,2,2,2,0,2,4,0,0,2,1,6
401085969,Manhattan Jaspers,S. Stewart,4398104,,True,33.0,5,7,1,2,4,5,0,0,0,1,1,1,0,0,2,3,14
401085969,Manhattan Jaspers,N. Mack,4279703,,True,20.0,1,1,1,1,0,0,0,0,1,3,4,2,0,0,1,4,2
401085969,Manhattan Jaspers,D. Schreier,4398105,,False,3.0,0,0,0,0,0,0,0,0,0,1,1,0,0,0,0,0,0
401085969,Manhattan Jaspers,E. Ebube,4279705,,False,15.0,4,5,3,4,1,1,2,2,2,2,4,0,1,1,1,5,11
401085969,Manhattan Jaspers,T. Greene,4398108,,False,20.0,3,5,0,2,3,3,5,6,0,5,5,2,0,0,1,0,14
401085969,Manhattan Jaspers,E. Buchanan,4398103,,False,3.0,0,0,0,0,0,0,0,0,0,0,0,1,0,0,1,3,0
401085969,Manhattan Jaspers,E. Lasko,4277944,,False,3.0,0,1,0,0,0,1,0,0,0,0,0,0,0,0,0,0,0
401085969,Manhattan Jaspers,T. Capuano,3948706,,False,21.0,1,3,0,1,1,2,0,0,0,0,0,3,1,0,0,0,3
401085969,Manhattan Jaspers,S. Usilo,3138468,,False,2.0,0,0,0,0,0,0,0,0,0,0,0,0,0,0,1,0,0
401085969,Manhattan Jaspers,TEAM,TOTAL,TOTAL,False,,21,47,11,26,10,21,12,14,7,24,31,15,4,1,11,18,64
401085968,Siena Saints,S. Seymour,4398391,,True,24.0,3,10,1,2,2,8,0,0,1,0,1,0,0,0,0,0,8
401085968,Siena Saints,E. Fisher,3913235,,True,35.0,8,15,8,15,0,0,2,2,1,5,6,1,0,0,1,2,18
401085968,Siena Saints,K. Degnan,3138282,,True,36.0,1,9,1,5,0,4,0,0,2,3,5,3,2,0,1,2,2
401085968,Siena Saints,J. Pickett,4398390,,True,34.0,2,8,2,5,0,3,5,7,0,2,2,3,1,1,4,1,9
401085968,Siena Saints,M. Camper,4279751,,True,29.0,2,3,2,3,0,0,1,4,2,1,3,3,1,0,1,3,5
401085968,Siena Saints,D. Tchougang,4398394,,False,5.0,0,0,0,0,0,0,0,0,0,0,0,0,0,0,0,1,0
401085968,Siena Saints,T. Huerter Jr.,4067350,,False,4.0,0,0,0,0,0,0,0,0,0,0,0,0,0,0,0,0,0
401085968,Siena Saints,B. Bayer,4065720,,False,2.0,0,1,0,0,0,1,0,0,0,0,0,0,0,0,0,0,0
401085968,Siena Saints,K. Smithen,3133848,,False,31.0,3,5,2,2,1,3,2,2,0,8,8,2,3,0,1,1,9
401085968,Siena Saints,TEAM,TOTAL,TOTAL,False,,19,51,16,32,3,19,10,15,8,21,29,12,7,1,8,10,51
401085968,Siena Saints,S. Seymour,4398391,,True,24.0,3,10,1,2,2,8,0,0,1,0,1,0,0,0,0,0,8
401085968,Siena Saints,E. Fisher,3913235,,True,35.0,8,15,8,15,0,0,2,2,1,5,6,1,0,0,1,2,18
401085968,Siena Saints,K. Degnan,3138282,,True,36.0,1,9,1,5,0,4,0,0,2,3,5,3,2,0,1,2,2
401085968,Siena Saints,J. Pickett,4398390,,True,34.0,2,8,2,5,0,3,5,7,0,2,2,3,1,1,4,1,9
401085968,Siena Saints,M. Camper,4279751,,True,29.0,2,3,2,3,0,0,1,4,2,1,3,3,1,0,1,3,5
401085968,Siena Saints,D. Tchougang,4398394,,False,5.0,0,0,0,0,0,0,0,0,0,0,0,0,0,0,0,1,0
401085968,Siena Saints,T. Huerter Jr.,4067350,,False,4.0,0,0,0,0,0,0,0,0,0,0,0,0,0,0,0,0,0
401085968,Siena Saints,B. Bayer,4065720,,False,2.0,0,1,0,0,0,1,0,0,0,0,0,0,0,0,0,0,0
401085968,Siena Saints,K. Smithen,3133848,,False,31.0,3,5,2,2,1,3,2,2,0,8,8,2,3,0,1,1,9
401085968,Siena Saints,TEAM,TOTAL,TOTAL,False,,19,51,16,32,3,19,10,15,8,21,29,12,7,1,8,10,51
401085968,Manhattan Jaspers,T. Reynolds,4398107,,True,36.0,6,10,2,4,4,6,2,2,0,9,9,2,0,0,3,1,18
401085968,Manhattan Jaspers,W. Williams,4279701,,True,24.0,4,8,4,7,0,1,1,2,0,1,1,0,1,1,3,1,9
401085968,Manhattan Jaspers,C. Hinckson,4398106,,True,19.0,1,2,1,2,0,0,1,2,1,2,3,0,1,0,0,0,3
401085968,Manhattan Jaspers,S. Stewart,4398104,,True,22.0,1,3,0,0,1,3,0,0,0,3,3,3,1,0,3,4,3
401085968,Manhattan Jaspers,N. Mack,4279703,,True,24.0,2,7,2,3,0,4,0,0,0,1,1,2,1,0,2,1,4
401085968,Manhattan Jaspers,D. Schreier,4398105,,False,2.0,1,2,1,1,0,1,0,0,1,0,1,0,0,0,0,0,2
401085968,Manhattan Jaspers,E. Ebube,4279705,,False,26.0,3,5,2,2,1,3,0,0,2,6,8,0,0,2,0,2,7
401085968,Manhattan Jaspers,T. Greene,4398108,,False,12.0,0,3,0,1,0,2,3,4,0,3,3,0,1,0,1,0,3
401085968,Manhattan Jaspers,E. Buchanan,4398103,,False,15.0,0,3,0,2,0,1,0,2,1,2,3,0,0,0,2,3,0
401085968,Manhattan Jaspers,E. Lasko,4277944,,False,1.0,0,0,0,0,0,0,0,0,0,0,0,0,0,0,0,0,0
401085968,Manhattan Jaspers,T. Capuano,3948706,,False,19.0,0,2,0,0,0,2,0,0,0,1,1,2,0,0,2,3,0
401085968,Manhattan Jaspers,TEAM,TOTAL,TOTAL,False,,18,45,12,22,6,23,7,12,7,28,35,9,5,3,16,15,49
401085968,Manhattan Jaspers,T. Reynolds,4398107,,True,36.0,6,10,2,4,4,6,2,2,0,9,9,2,0,0,3,1,18
401085968,Manhattan Jaspers,W. Williams,4279701,,True,24.0,4,8,4,7,0,1,1,2,0,1,1,0,1,1,3,1,9
401085968,Manhattan Jaspers,C. Hinckson,4398106,,True,19.0,1,2,1,2,0,0,1,2,1,2,3,0,1,0,0,0,3
401085968,Manhattan Jaspers,S. Stewart,4398104,,True,22.0,1,3,0,0,1,3,0,0,0,3,3,3,1,0,3,4,3
401085968,Manhattan Jaspers,N. Mack,4279703,,True,24.0,2,7,2,3,0,4,0,0,0,1,1,2,1,0,2,1,4
401085968,Manhattan Jaspers,D. Schreier,4398105,,False,2.0,1,2,1,1,0,1,0,0,1,0,1,0,0,0,0,0,2
401085968,Manhattan Jaspers,E. Ebube,4279705,,False,26.0,3,5,2,2,1,3,0,0,2,6,8,0,0,2,0,2,7
401085968,Manhattan Jaspers,T. Greene,4398108,,False,12.0,0,3,0,1,0,2,3,4,0,3,3,0,1,0,1,0,3
401085968,Manhattan Jaspers,E. Buchanan,4398103,,False,15.0,0,3,0,2,0,1,0,2,1,2,3,0,0,0,2,3,0
401085968,Manhattan Jaspers,E. Lasko,4277944,,False,1.0,0,0,0,0,0,0,0,0,0,0,0,0,0,0,0,0,0
401085968,Manhattan Jaspers,T. Capuano,3948706,,False,19.0,0,2,0,0,0,2,0,0,0,1,1,2,0,0,2,3,0
401085968,Manhattan Jaspers,TEAM,TOTAL,TOTAL,False,,18,45,12,22,6,23,7,12,7,28,35,9,5,3,16,15,49
401085967,Rider Broncs,D. Vaughn,4067347,,True,34.0,7,12,3,6,4,6,4,6,1,7,8,0,1,2,2,0,22
401085967,Rider Broncs,T. Marshall,4067348,,True,19.0,1,4,1,4,0,0,2,4,2,7,9,3,0,0,1,2,4
401085967,Rider Broncs,S. Jordan,4067349,,True,32.0,2,4,1,2,1,2,3,4,0,1,1,2,3,1,4,2,8
401085967,Rider Broncs,J. Allen,4067345,,True,31.0,3,12,1,1,2,11,0,0,0,1,1,0,1,0,0,0,8
401085967,Rider Broncs,A. Durham,3138490,,True,27.0,2,4,2,3,0,1,2,3,2,1,3,2,2,0,1,5,6
401085967,Rider Broncs,D. Eke,3941312,,False,20.0,3,6,3,6,0,0,1,2,2,2,4,1,1,0,2,3,7
401085967,Rider Broncs,F. Scott,3922033,,False,20.0,3,4,3,3,0,1,5,7,0,3,3,0,1,2,4,2,11
401085967,Rider Broncs,K. Williams,3946983,,False,17.0,0,0,0,0,0,0,0,0,0,1,1,3,0,0,3,4,0
401085967,Rider Broncs,TEAM,TOTAL,TOTAL,False,,21,46,14,25,7,21,17,26,8,23,31,11,9,5,17,18,66
401085967,Rider Broncs,D. Vaughn,4067347,,True,34.0,7,12,3,6,4,6,4,6,1,7,8,0,1,2,2,0,22
401085967,Rider Broncs,T. Marshall,4067348,,True,19.0,1,4,1,4,0,0,2,4,2,7,9,3,0,0,1,2,4
401085967,Rider Broncs,S. Jordan,4067349,,True,32.0,2,4,1,2,1,2,3,4,0,1,1,2,3,1,4,2,8
401085967,Rider Broncs,J. Allen,4067345,,True,31.0,3,12,1,1,2,11,0,0,0,1,1,0,1,0,0,0,8
401085967,Rider Broncs,A. Durham,3138490,,True,27.0,2,4,2,3,0,1,2,3,2,1,3,2,2,0,1,5,6
401085967,Rider Broncs,D. Eke,3941312,,False,20.0,3,6,3,6,0,0,1,2,2,2,4,1,1,0,2,3,7
401085967,Rider Broncs,F. Scott,3922033,,False,20.0,3,4,3,3,0,1,5,7,0,3,3,0,1,2,4,2,11
401085967,Rider Broncs,K. Williams,3946983,,False,17.0,0,0,0,0,0,0,0,0,0,1,1,3,0,0,3,4,0
401085967,Rider Broncs,TEAM,TOTAL,TOTAL,False,,21,46,14,25,7,21,17,26,8,23,31,11,9,5,17,18,66
401085967,Manhattan Jaspers,T. Reynolds,4398107,,True,34.0,8,14,2,3,6,11,1,2,1,6,7,1,0,0,1,1,23
401085967,Manhattan Jaspers,W. Williams,4279701,,True,4.0,1,1,1,1,0,0,0,0,0,0,0,0,0,0,1,4,2
401085967,Manhattan Jaspers,C. Hinckson,4398106,,True,26.0,1,6,1,5,0,1,2,6,1,4,5,3,1,2,3,3,4
401085967,Manhattan Jaspers,S. Stewart,4398104,,True,29.0,4,6,0,1,4,5,7,8,1,0,1,5,2,0,5,3,19
401085967,Manhattan Jaspers,N. Mack,4279703,,True,25.0,2,2,1,1,1,1,0,1,0,0,0,2,1,0,1,2,5
401085967,Manhattan Jaspers,D. Schreier,4398105,,False,7.0,0,1,0,0,0,1,0,0,1,2,3,0,0,1,0,1,0
401085967,Manhattan Jaspers,E. Ebube,4279705,,False,26.0,5,7,5,6,0,1,0,0,2,3,5,2,0,2,0,4,10
401085967,Manhattan Jaspers,I. Diallo,3149898,,False,2.0,0,0,0,0,0,0,0,0,0,0,0,0,0,0,0,0,0
401085967,Manhattan Jaspers,T. Greene,4398108,,False,21.0,3,8,3,6,0,2,0,0,0,2,2,1,0,0,1,1,6
401085967,Manhattan Jaspers,E. Buchanan,4398103,,False,11.0,0,3,0,2,0,1,1,2,0,1,1,0,0,0,2,3,1
401085967,Manhattan Jaspers,E. Lasko,4277944,,False,1.0,0,0,0,0,0,0,0,0,0,0,0,0,0,0,0,0,0
401085967,Manhattan Jaspers,T. Capuano,3948706,,False,14.0,1,3,0,2,1,1,0,0,1,1,2,2,1,0,0,1,3
401085967,Manhattan Jaspers,TEAM,TOTAL,TOTAL,False,,25,51,13,27,12,24,11,19,8,21,29,16,5,5,16,23,73
401085967,Manhattan Jaspers,T. Reynolds,4398107,,True,34.0,8,14,2,3,6,11,1,2,1,6,7,1,0,0,1,1,23
401085967,Manhattan Jaspers,W. Williams,4279701,,True,4.0,1,1,1,1,0,0,0,0,0,0,0,0,0,0,1,4,2
401085967,Manhattan Jaspers,C. Hinckson,4398106,,True,26.0,1,6,1,5,0,1,2,6,1,4,5,3,1,2,3,3,4
401085967,Manhattan Jaspers,S. Stewart,4398104,,True,29.0,4,6,0,1,4,5,7,8,1,0,1,5,2,0,5,3,19
401085967,Manhattan Jaspers,N. Mack,4279703,,True,25.0,2,2,1,1,1,1,0,1,0,0,0,2,1,0,1,2,5
401085967,Manhattan Jaspers,D. Schreier,4398105,,False,7.0,0,1,0,0,0,1,0,0,1,2,3,0,0,1,0,1,0
401085967,Manhattan Jaspers,E. Ebube,4279705,,False,26.0,5,7,5,6,0,1,0,0,2,3,5,2,0,2,0,4,10
401085967,Manhattan Jaspers,I. Diallo,3149898,,False,2.0,0,0,0,0,0,0,0,0,0,0,0,0,0,0,0,0,0
401085967,Manhattan Jaspers,T. Greene,4398108,,False,21.0,3,8,3,6,0,2,0,0,0,2,2,1,0,0,1,1,6
401085967,Manhattan Jaspers,E. Buchanan,4398103,,False,11.0,0,3,0,2,0,1,1,2,0,1,1,0,0,0,2,3,1
401085967,Manhattan Jaspers,E. Lasko,4277944,,False,1.0,0,0,0,0,0,0,0,0,0,0,0,0,0,0,0,0,0
401085967,Manhattan Jaspers,T. Capuano,3948706,,False,14.0,1,3,0,2,1,1,0,0,1,1,2,2,1,0,0,1,3
401085967,Manhattan Jaspers,TEAM,TOTAL,TOTAL,False,,25,51,13,27,12,24,11,19,8,21,29,16,5,5,16,23,73
401085966,Saint Peter's Peacocks,S. Idowu,3922042,,True,24.0,2,7,2,6,0,1,0,0,2,7,9,1,0,3,1,3,4
401085966,Saint Peter's Peacocks,M. Dixon,4279758,,True,30.0,7,11,6,8,1,3,3,3,2,1,3,0,2,0,3,5,18
401085966,Saint Peter's Peacocks,K. Brown,4398385,,True,23.0,2,5,2,3,0,2,1,4,1,5,6,1,1,1,3,1,5
401085966,Saint Peter's Peacocks,Q. Taylor,4067357,,True,31.0,2,7,2,7,0,0,0,0,2,5,7,0,1,0,3,2,4
401085966,Saint Peter's Peacocks,D. Turner,4067356,,True,27.0,0,2,0,1,0,1,4,5,0,1,1,1,0,0,4,4,4
401085966,Saint Peter's Peacocks,KC Ndefo,4398386,,False,13.0,1,3,1,3,0,0,3,4,3,2,5,1,1,1,2,2,5
401085966,Saint Peter's Peacocks,D. Woods,3919424,,False,9.0,0,1,0,1,0,0,3,4,0,2,2,1,0,1,0,3,3
401085966,Saint Peter's Peacocks,M. Majak,4398387,,False,7.0,0,0,0,0,0,0,2,2,0,0,0,0,0,0,0,0,2
401085966,Saint Peter's Peacocks,C. Underwood,4398388,,False,2.0,0,0,0,0,0,0,0,0,0,0,0,0,0,0,0,0,0
401085966,Saint Peter's Peacocks,D. Watson,4398384,,False,33.0,1,4,0,1,1,3,2,4,1,1,2,0,0,0,5,3,5
401085966,Saint Peter's Peacocks,A. Hicks,4284295,,False,1.0,0,0,0,0,0,0,0,0,0,0,0,0,0,0,0,0,0
401085966,Saint Peter's Peacocks,M. Johnson,4279759,,False,0.0,0,0,0,0,0,0,0,0,0,0,0,0,0,0,0,0,0
401085966,Saint Peter's Peacocks,TEAM,TOTAL,TOTAL,False,,15,40,13,30,2,10,18,26,12,25,37,5,5,6,21,23,50
401085966,Saint Peter's Peacocks,S. Idowu,3922042,,True,24.0,2,7,2,6,0,1,0,0,2,7,9,1,0,3,1,3,4
401085966,Saint Peter's Peacocks,M. Dixon,4279758,,True,30.0,7,11,6,8,1,3,3,3,2,1,3,0,2,0,3,5,18
401085966,Saint Peter's Peacocks,K. Brown,4398385,,True,23.0,2,5,2,3,0,2,1,4,1,5,6,1,1,1,3,1,5
401085966,Saint Peter's Peacocks,Q. Taylor,4067357,,True,31.0,2,7,2,7,0,0,0,0,2,5,7,0,1,0,3,2,4
401085966,Saint Peter's Peacocks,D. Turner,4067356,,True,27.0,0,2,0,1,0,1,4,5,0,1,1,1,0,0,4,4,4
401085966,Saint Peter's Peacocks,KC Ndefo,4398386,,False,13.0,1,3,1,3,0,0,3,4,3,2,5,1,1,1,2,2,5
401085966,Saint Peter's Peacocks,D. Woods,3919424,,False,9.0,0,1,0,1,0,0,3,4,0,2,2,1,0,1,0,3,3
401085966,Saint Peter's Peacocks,M. Majak,4398387,,False,7.0,0,0,0,0,0,0,2,2,0,0,0,0,0,0,0,0,2
401085966,Saint Peter's Peacocks,C. Underwood,4398388,,False,2.0,0,0,0,0,0,0,0,0,0,0,0,0,0,0,0,0,0
401085966,Saint Peter's Peacocks,D. Watson,4398384,,False,33.0,1,4,0,1,1,3,2,4,1,1,2,0,0,0,5,3,5
401085966,Saint Peter's Peacocks,A. Hicks,4284295,,False,1.0,0,0,0,0,0,0,0,0,0,0,0,0,0,0,0,0,0
401085966,Saint Peter's Peacocks,M. Johnson,4279759,,False,0.0,0,0,0,0,0,0,0,0,0,0,0,0,0,0,0,0,0
401085966,Saint Peter's Peacocks,TEAM,TOTAL,TOTAL,False,,15,40,13,30,2,10,18,26,12,25,37,5,5,6,21,23,50
401085966,Manhattan Jaspers,T. Reynolds,4398107,,True,22.0,4,9,3,6,1,3,0,0,0,2,2,1,2,1,0,1,9
401085966,Manhattan Jaspers,W. Williams,4279701,,True,12.0,2,2,2,2,0,0,3,4,1,2,3,0,0,0,0,4,7
401085966,Manhattan Jaspers,C. Hinckson,4398106,,True,23.0,1,4,0,3,1,1,4,4,1,1,2,1,1,0,2,1,7
401085966,Manhattan Jaspers,S. Stewart,4398104,,True,26.0,5,6,1,1,4,5,5,7,0,0,0,1,5,0,1,1,19
401085966,Manhattan Jaspers,N. Mack,4279703,,True,14.0,1,2,1,2,0,0,0,0,0,0,0,1,2,0,1,5,2
401085966,Manhattan Jaspers,D. Schreier,4398105,,False,13.0,0,1,0,0,0,1,0,0,0,2,2,1,0,1,1,3,0
401085966,Manhattan Jaspers,K. Salis,4293482,,False,2.0,0,0,0,0,0,0,0,0,0,0,0,0,0,0,0,1,0
401085966,Manhattan Jaspers,E. Ebube,4279705,,False,22.0,1,5,1,2,0,3,2,4,2,0,2,1,0,1,2,4,4
401085966,Manhattan Jaspers,I. Diallo,3149898,,False,10.0,0,3,0,3,0,0,0,0,0,2,2,0,1,0,1,4,0
401085966,Manhattan Jaspers,T. Greene,4398108,,False,16.0,1,3,1,2,0,1,1,2,0,5,5,0,0,0,1,0,3
401085966,Manhattan Jaspers,E. Buchanan,4398103,,False,20.0,3,7,2,4,1,3,3,4,1,3,4,3,2,1,1,2,10
401085966,Manhattan Jaspers,J. Boyce,4286223,,False,1.0,0,1,0,1,0,0,0,0,0,0,0,0,0,0,0,0,0
401085966,Manhattan Jaspers,E. Lasko,4277944,,False,4.0,0,2,0,1,0,1,0,0,0,0,0,0,0,0,0,0,0
401085966,Manhattan Jaspers,T. Capuano,3948706,,False,13.0,0,1,0,0,0,1,0,0,0,0,0,1,0,0,2,1,0
401085966,Manhattan Jaspers,M. Maloney,3948705,,False,2.0,1,2,0,0,1,2,0,0,0,0,0,0,0,0,0,0,3
401085966,Manhattan Jaspers,TEAM,TOTAL,TOTAL,False,,19,48,11,27,8,21,18,25,7,17,24,10,13,4,12,27,64
401085966,Manhattan Jaspers,T. Reynolds,4398107,,True,22.0,4,9,3,6,1,3,0,0,0,2,2,1,2,1,0,1,9
401085966,Manhattan Jaspers,W. Williams,4279701,,True,12.0,2,2,2,2,0,0,3,4,1,2,3,0,0,0,0,4,7
401085966,Manhattan Jaspers,C. Hinckson,4398106,,True,23.0,1,4,0,3,1,1,4,4,1,1,2,1,1,0,2,1,7
401085966,Manhattan Jaspers,S. Stewart,4398104,,True,26.0,5,6,1,1,4,5,5,7,0,0,0,1,5,0,1,1,19
401085966,Manhattan Jaspers,N. Mack,4279703,,True,14.0,1,2,1,2,0,0,0,0,0,0,0,1,2,0,1,5,2
401085966,Manhattan Jaspers,D. Schreier,4398105,,False,13.0,0,1,0,0,0,1,0,0,0,2,2,1,0,1,1,3,0
401085966,Manhattan Jaspers,K. Salis,4293482,,False,2.0,0,0,0,0,0,0,0,0,0,0,0,0,0,0,0,1,0
401085966,Manhattan Jaspers,E. Ebube,4279705,,False,22.0,1,5,1,2,0,3,2,4,2,0,2,1,0,1,2,4,4
401085966,Manhattan Jaspers,I. Diallo,3149898,,False,10.0,0,3,0,3,0,0,0,0,0,2,2,0,1,0,1,4,0
401085966,Manhattan Jaspers,T. Greene,4398108,,False,16.0,1,3,1,2,0,1,1,2,0,5,5,0,0,0,1,0,3
401085966,Manhattan Jaspers,E. Buchanan,4398103,,False,20.0,3,7,2,4,1,3,3,4,1,3,4,3,2,1,1,2,10
401085966,Manhattan Jaspers,J. Boyce,4286223,,False,1.0,0,1,0,1,0,0,0,0,0,0,0,0,0,0,0,0,0
401085966,Manhattan Jaspers,E. Lasko,4277944,,False,4.0,0,2,0,1,0,1,0,0,0,0,0,0,0,0,0,0,0
401085966,Manhattan Jaspers,T. Capuano,3948706,,False,13.0,0,1,0,0,0,1,0,0,0,0,0,1,0,0,2,1,0
401085966,Manhattan Jaspers,M. Maloney,3948705,,False,2.0,1,2,0,0,1,2,0,0,0,0,0,0,0,0,0,0,3
401085966,Manhattan Jaspers,TEAM,TOTAL,TOTAL,False,,19,48,11,27,8,21,18,25,7,17,24,10,13,4,12,27,64
401085965,Manhattan Jaspers,T. Reynolds,4398107,,True,27.0,5,8,2,2,3,6,4,4,0,6,6,1,1,0,1,1,17
401085965,Manhattan Jaspers,W. Williams,4279701,,True,12.0,3,7,3,7,0,0,0,0,3,1,4,0,1,1,4,4,6
401085965,Manhattan Jaspers,C. Hinckson,4398106,,True,22.0,1,6,1,4,0,2,0,0,0,5,5,2,1,0,2,3,2
401085965,Manhattan Jaspers,S. Stewart,4398104,,True,29.0,4,5,2,3,2,2,1,2,0,2,2,2,2,0,3,1,11
401085965,Manhattan Jaspers,N. Mack,4279703,,True,21.0,0,1,0,1,0,0,2,3,0,1,1,2,2,0,1,3,2
401085965,Manhattan Jaspers,D. Schreier,4398105,,False,14.0,1,1,0,0,1,1,0,0,1,1,2,1,0,0,3,1,3
401085965,Manhattan Jaspers,E. Ebube,4279705,,False,29.0,7,12,6,10,1,2,0,1,3,5,8,2,1,0,0,3,15
401085965,Manhattan Jaspers,T. Greene,4398108,,False,15.0,1,1,0,0,1,1,0,0,0,0,0,1,0,0,3,1,3
401085965,Manhattan Jaspers,E. Buchanan,4398103,,False,11.0,0,1,0,1,0,0,0,0,0,2,2,1,0,0,1,0,0
401085965,Manhattan Jaspers,E. Lasko,4277944,,False,6.0,0,0,0,0,0,0,1,2,0,1,1,0,0,0,1,0,1
401085965,Manhattan Jaspers,T. Capuano,3948706,,False,14.0,1,3,1,2,0,1,0,0,1,2,3,2,0,0,0,2,2
401085965,Manhattan Jaspers,TEAM,TOTAL,TOTAL,False,,23,45,15,30,8,15,8,12,11,26,37,14,8,1,21,19,62
401085965,Manhattan Jaspers,T. Reynolds,4398107,,True,27.0,5,8,2,2,3,6,4,4,0,6,6,1,1,0,1,1,17
401085965,Manhattan Jaspers,W. Williams,4279701,,True,12.0,3,7,3,7,0,0,0,0,3,1,4,0,1,1,4,4,6
401085965,Manhattan Jaspers,C. Hinckson,4398106,,True,22.0,1,6,1,4,0,2,0,0,0,5,5,2,1,0,2,3,2
401085965,Manhattan Jaspers,S. Stewart,4398104,,True,29.0,4,5,2,3,2,2,1,2,0,2,2,2,2,0,3,1,11
401085965,Manhattan Jaspers,N. Mack,4279703,,True,21.0,0,1,0,1,0,0,2,3,0,1,1,2,2,0,1,3,2
401085965,Manhattan Jaspers,D. Schreier,4398105,,False,14.0,1,1,0,0,1,1,0,0,1,1,2,1,0,0,3,1,3
401085965,Manhattan Jaspers,E. Ebube,4279705,,False,29.0,7,12,6,10,1,2,0,1,3,5,8,2,1,0,0,3,15
401085965,Manhattan Jaspers,T. Greene,4398108,,False,15.0,1,1,0,0,1,1,0,0,0,0,0,1,0,0,3,1,3
401085965,Manhattan Jaspers,E. Buchanan,4398103,,False,11.0,0,1,0,1,0,0,0,0,0,2,2,1,0,0,1,0,0
401085965,Manhattan Jaspers,E. Lasko,4277944,,False,6.0,0,0,0,0,0,0,1,2,0,1,1,0,0,0,1,0,1
401085965,Manhattan Jaspers,T. Capuano,3948706,,False,14.0,1,3,1,2,0,1,0,0,1,2,3,2,0,0,0,2,2
401085965,Manhattan Jaspers,TEAM,TOTAL,TOTAL,False,,23,45,15,30,8,15,8,12,11,26,37,14,8,1,21,19,62
401085965,Fairfield Stags,J. Kasibabu,3947016,,True,28.0,3,5,3,5,0,0,3,5,4,3,7,1,1,4,6,3,9
401085965,Fairfield Stags,L. Taliaferro,4398078,,True,19.0,3,8,1,1,2,7,0,2,0,0,0,1,0,0,0,3,8
401085965,Fairfield Stags,F. Lemetti,4398076,,True,23.0,2,6,1,2,1,4,1,3,1,1,2,1,1,0,2,2,6
401085965,Fairfield Stags,N. Alvarez,4398075,,True,34.0,2,7,2,5,0,2,0,0,0,2,2,5,2,0,2,1,4
401085965,Fairfield Stags,J. Cruz,4279488,,True,20.0,3,7,3,5,0,2,1,2,1,2,3,0,0,0,2,2,7
401085965,Fairfield Stags,W. Methnani,4279486,,False,20.0,1,5,0,2,1,3,0,0,0,2,2,1,0,0,4,5,3
401085965,Fairfield Stags,M. Milin,3947018,,False,11.0,1,1,1,1,0,0,2,5,0,2,2,0,0,1,0,0,4
401085965,Fairfield Stags,C. Whipple,4398077,,False,18.0,2,7,0,0,2,7,0,0,3,0,3,1,1,0,0,2,6
401085965,Fairfield Stags,T. Benning,4279483,,False,6.0,0,1,0,0,0,1,0,0,1,1,2,1,0,0,0,1,0
401085965,Fairfield Stags,A. Kavaliauskas,4080375,,False,21.0,0,2,0,0,0,2,2,2,0,1,1,2,2,0,1,0,2
401085965,Fairfield Stags,TEAM,TOTAL,TOTAL,False,,17,49,11,21,6,28,9,19,11,14,25,13,7,5,17,19,49
401085965,Fairfield Stags,J. Kasibabu,3947016,,True,28.0,3,5,3,5,0,0,3,5,4,3,7,1,1,4,6,3,9
401085965,Fairfield Stags,L. Taliaferro,4398078,,True,19.0,3,8,1,1,2,7,0,2,0,0,0,1,0,0,0,3,8
401085965,Fairfield Stags,F. Lemetti,4398076,,True,23.0,2,6,1,2,1,4,1,3,1,1,2,1,1,0,2,2,6
401085965,Fairfield Stags,N. Alvarez,4398075,,True,34.0,2,7,2,5,0,2,0,0,0,2,2,5,2,0,2,1,4
401085965,Fairfield Stags,J. Cruz,4279488,,True,20.0,3,7,3,5,0,2,1,2,1,2,3,0,0,0,2,2,7
401085965,Fairfield Stags,W. Methnani,4279486,,False,20.0,1,5,0,2,1,3,0,0,0,2,2,1,0,0,4,5,3
401085965,Fairfield Stags,M. Milin,3947018,,False,11.0,1,1,1,1,0,0,2,5,0,2,2,0,0,1,0,0,4
401085965,Fairfield Stags,C. Whipple,4398077,,False,18.0,2,7,0,0,2,7,0,0,3,0,3,1,1,0,0,2,6
401085965,Fairfield Stags,T. Benning,4279483,,False,6.0,0,1,0,0,0,1,0,0,1,1,2,1,0,0,0,1,0
401085965,Fairfield Stags,A. Kavaliauskas,4080375,,False,21.0,0,2,0,0,0,2,2,2,0,1,1,2,2,0,1,0,2
401085965,Fairfield Stags,TEAM,TOTAL,TOTAL,False,,17,49,11,21,6,28,9,19,11,14,25,13,7,5,17,19,49
401085964,Siena Saints,S. Seymour,4398391,,True,27.0,3,10,1,2,2,8,0,0,0,1,1,1,0,0,0,1,8
401085964,Siena Saints,E. Fisher,3913235,,True,32.0,3,8,3,7,0,1,0,0,0,3,3,3,0,0,2,0,6
401085964,Siena Saints,K. Degnan,3138282,,True,35.0,2,4,1,2,1,2,0,0,0,3,3,3,0,0,1,1,5
401085964,Siena Saints,G. Darwiche,4398393,,True,10.0,0,1,0,0,0,1,0,0,0,0,0,0,0,0,0,0,0
401085964,Siena Saints,J. Pickett,4398390,,True,38.0,8,14,6,9,2,5,0,0,0,5,5,2,4,0,0,0,18
401085964,Siena Saints,D. Tchougang,4398394,,False,8.0,1,1,1,1,0,0,0,0,1,0,1,0,0,0,1,1,2
401085964,Siena Saints,M. Camper,4279751,,False,22.0,3,6,3,5,0,1,1,2,2,5,7,0,3,0,1,3,7
401085964,Siena Saints,B. Bayer,4065720,,False,2.0,0,1,0,0,0,1,0,0,0,0,0,0,0,0,0,0,0
401085964,Siena Saints,K. Smithen,3133848,,False,26.0,3,4,2,2,1,2,0,0,0,3,3,1,0,0,0,2,7
401085964,Siena Saints,TEAM,TOTAL,TOTAL,False,,23,49,17,28,6,21,1,2,4,20,24,10,7,0,6,8,53
401085964,Siena Saints,S. Seymour,4398391,,True,27.0,3,10,1,2,2,8,0,0,0,1,1,1,0,0,0,1,8
401085964,Siena Saints,E. Fisher,3913235,,True,32.0,3,8,3,7,0,1,0,0,0,3,3,3,0,0,2,0,6
401085964,Siena Saints,K. Degnan,3138282,,True,35.0,2,4,1,2,1,2,0,0,0,3,3,3,0,0,1,1,5
401085964,Siena Saints,G. Darwiche,4398393,,True,10.0,0,1,0,0,0,1,0,0,0,0,0,0,0,0,0,0,0
401085964,Siena Saints,J. Pickett,4398390,,True,38.0,8,14,6,9,2,5,0,0,0,5,5,2,4,0,0,0,18
401085964,Siena Saints,D. Tchougang,4398394,,False,8.0,1,1,1,1,0,0,0,0,1,0,1,0,0,0,1,1,2
401085964,Siena Saints,M. Camper,4279751,,False,22.0,3,6,3,5,0,1,1,2,2,5,7,0,3,0,1,3,7
401085964,Siena Saints,B. Bayer,4065720,,False,2.0,0,1,0,0,0,1,0,0,0,0,0,0,0,0,0,0,0
401085964,Siena Saints,K. Smithen,3133848,,False,26.0,3,4,2,2,1,2,0,0,0,3,3,1,0,0,0,2,7
401085964,Siena Saints,TEAM,TOTAL,TOTAL,False,,23,49,17,28,6,21,1,2,4,20,24,10,7,0,6,8,53
401085964,Manhattan Jaspers,T. Reynolds,4398107,,True,25.0,4,8,2,4,2,4,2,2,0,4,4,0,0,1,1,0,12
401085964,Manhattan Jaspers,W. Williams,4279701,,True,24.0,2,4,2,4,0,0,1,2,1,2,3,0,0,0,0,2,5
401085964,Manhattan Jaspers,C. Hinckson,4398106,,True,20.0,0,2,0,2,0,0,1,2,1,3,4,1,0,0,1,1,1
401085964,Manhattan Jaspers,E. Buchanan,4398103,,True,5.0,0,2,0,1,0,1,0,0,0,0,0,0,0,0,0,0,0
401085964,Manhattan Jaspers,N. Mack,4279703,,True,24.0,1,4,1,3,0,1,0,0,0,2,2,4,0,0,3,0,2
401085964,Manhattan Jaspers,D. Schreier,4398105,,False,10.0,0,0,0,0,0,0,0,0,0,0,0,0,0,0,0,0,0
401085964,Manhattan Jaspers,E. Ebube,4279705,,False,13.0,1,2,0,1,1,1,0,0,1,2,3,1,0,0,1,1,3
401085964,Manhattan Jaspers,I. Diallo,3149898,,False,7.0,0,1,0,1,0,0,0,0,0,0,0,0,1,0,0,0,0
401085964,Manhattan Jaspers,T. Greene,4398108,,False,15.0,3,7,3,5,0,2,0,0,2,1,3,0,0,0,2,1,6
401085964,Manhattan Jaspers,S. Stewart,4398104,,False,27.0,3,7,0,1,3,6,0,0,1,2,3,1,1,0,2,3,9
401085964,Manhattan Jaspers,T. Capuano,3948706,,False,24.0,1,4,1,2,0,2,0,0,0,5,5,1,1,0,1,0,2
401085964,Manhattan Jaspers,S. Usilo,3138468,,False,6.0,0,0,0,0,0,0,0,0,0,2,2,0,0,0,3,1,0
401085964,Manhattan Jaspers,TEAM,TOTAL,TOTAL,False,,15,41,9,24,6,17,4,6,6,23,29,8,3,1,15,9,40
401085964,Manhattan Jaspers,T. Reynolds,4398107,,True,25.0,4,8,2,4,2,4,2,2,0,4,4,0,0,1,1,0,12
401085964,Manhattan Jaspers,W. Williams,4279701,,True,24.0,2,4,2,4,0,0,1,2,1,2,3,0,0,0,0,2,5
401085964,Manhattan Jaspers,C. Hinckson,4398106,,True,20.0,0,2,0,2,0,0,1,2,1,3,4,1,0,0,1,1,1
401085964,Manhattan Jaspers,E. Buchanan,4398103,,True,5.0,0,2,0,1,0,1,0,0,0,0,0,0,0,0,0,0,0
401085964,Manhattan Jaspers,N. Mack,4279703,,True,24.0,1,4,1,3,0,1,0,0,0,2,2,4,0,0,3,0,2
401085964,Manhattan Jaspers,D. Schreier,4398105,,False,10.0,0,0,0,0,0,0,0,0,0,0,0,0,0,0,0,0,0
401085964,Manhattan Jaspers,E. Ebube,4279705,,False,13.0,1,2,0,1,1,1,0,0,1,2,3,1,0,0,1,1,3
401085964,Manhattan Jaspers,I. Diallo,3149898,,False,7.0,0,1,0,1,0,0,0,0,0,0,0,0,1,0,0,0,0
401085964,Manhattan Jaspers,T. Greene,4398108,,False,15.0,3,7,3,5,0,2,0,0,2,1,3,0,0,0,2,1,6
401085964,Manhattan Jaspers,S. Stewart,4398104,,False,27.0,3,7,0,1,3,6,0,0,1,2,3,1,1,0,2,3,9
401085964,Manhattan Jaspers,T. Capuano,3948706,,False,24.0,1,4,1,2,0,2,0,0,0,5,5,1,1,0,1,0,2
401085964,Manhattan Jaspers,S. Usilo,3138468,,False,6.0,0,0,0,0,0,0,0,0,0,2,2,0,0,0,3,1,0
401085964,Manhattan Jaspers,TEAM,TOTAL,TOTAL,False,,15,41,9,24,6,17,4,6,6,23,29,8,3,1,15,9,40
401085963,Marist Red Foxes,I. Lamb,3936028,,True,24.0,2,4,1,1,1,3,1,1,0,3,3,0,0,0,2,2,6
401085963,Marist Red Foxes,T. Sjoberg,4067328,,True,20.0,1,1,1,1,0,0,0,0,2,4,6,2,1,3,0,5,2
401085963,Marist Red Foxes,D. Knudsen,3936027,,True,32.0,7,12,2,5,5,7,2,2,1,5,6,0,0,0,1,1,21
401085963,Marist Red Foxes,D. Hines,4398410,,True,29.0,2,9,2,5,0,4,7,9,0,3,3,3,0,0,3,2,11
401085963,Marist Red Foxes,B. Parker,3936030,,True,30.0,3,9,3,8,0,1,4,7,0,3,3,1,0,0,1,0,10
401085963,Marist Red Foxes,L. Nedrow,4398414,,False,15.0,0,2,0,1,0,1,0,1,3,2,5,1,1,2,1,3,0
401085963,Marist Red Foxes,A. Dozic,3923222,,False,5.0,0,1,0,1,0,0,0,0,0,0,0,0,0,0,0,2,0
401085963,Marist Red Foxes,M. Herasme,4398413,,False,18.0,1,2,1,1,0,1,0,0,0,2,2,0,2,0,0,1,2
401085963,Marist Red Foxes,A. Williams,4279709,,False,26.0,2,2,2,2,0,0,6,8,1,2,3,3,1,0,1,3,10
401085963,Marist Red Foxes,R. Carmello,4279708,,False,1.0,0,0,0,0,0,0,0,0,0,0,0,0,0,0,1,1,0
401085963,Marist Red Foxes,TEAM,TOTAL,TOTAL,False,,18,42,12,25,6,17,20,28,7,27,34,10,5,5,13,20,62
401085963,Marist Red Foxes,I. Lamb,3936028,,True,24.0,2,4,1,1,1,3,1,1,0,3,3,0,0,0,2,2,6
401085963,Marist Red Foxes,T. Sjoberg,4067328,,True,20.0,1,1,1,1,0,0,0,0,2,4,6,2,1,3,0,5,2
401085963,Marist Red Foxes,D. Knudsen,3936027,,True,32.0,7,12,2,5,5,7,2,2,1,5,6,0,0,0,1,1,21
401085963,Marist Red Foxes,D. Hines,4398410,,True,29.0,2,9,2,5,0,4,7,9,0,3,3,3,0,0,3,2,11
401085963,Marist Red Foxes,B. Parker,3936030,,True,30.0,3,9,3,8,0,1,4,7,0,3,3,1,0,0,1,0,10
401085963,Marist Red Foxes,L. Nedrow,4398414,,False,15.0,0,2,0,1,0,1,0,1,3,2,5,1,1,2,1,3,0
401085963,Marist Red Foxes,A. Dozic,3923222,,False,5.0,0,1,0,1,0,0,0,0,0,0,0,0,0,0,0,2,0
401085963,Marist Red Foxes,M. Herasme,4398413,,False,18.0,1,2,1,1,0,1,0,0,0,2,2,0,2,0,0,1,2
401085963,Marist Red Foxes,A. Williams,4279709,,False,26.0,2,2,2,2,0,0,6,8,1,2,3,3,1,0,1,3,10
401085963,Marist Red Foxes,R. Carmello,4279708,,False,1.0,0,0,0,0,0,0,0,0,0,0,0,0,0,0,1,1,0
401085963,Marist Red Foxes,TEAM,TOTAL,TOTAL,False,,18,42,12,25,6,17,20,28,7,27,34,10,5,5,13,20,62
401085963,Manhattan Jaspers,T. Reynolds,4398107,,True,16.0,1,3,1,1,0,2,0,0,0,2,2,0,0,0,0,0,2
401085963,Manhattan Jaspers,W. Williams,4279701,,True,26.0,4,8,4,8,0,0,4,8,1,3,4,0,1,1,5,3,12
401085963,Manhattan Jaspers,C. Hinckson,4398106,,True,16.0,0,5,0,4,0,1,1,4,0,1,1,0,0,0,1,2,1
401085963,Manhattan Jaspers,E. Buchanan,4398103,,True,12.0,2,4,1,2,1,2,3,4,0,2,2,1,1,0,1,5,8
401085963,Manhattan Jaspers,N. Mack,4279703,,True,28.0,1,1,1,1,0,0,1,1,0,2,2,3,1,0,1,3,3
401085963,Manhattan Jaspers,E. Ebube,4279705,,False,15.0,0,2,0,2,0,0,0,0,0,1,1,0,0,1,1,1,0
401085963,Manhattan Jaspers,T. Greene,4398108,,False,24.0,2,9,1,5,1,4,3,4,2,1,3,0,1,0,1,2,8
401085963,Manhattan Jaspers,S. Stewart,4398104,,False,17.0,1,2,0,0,1,2,0,0,1,2,3,1,0,0,3,5,3
401085963,Manhattan Jaspers,E. Lasko,4277944,,False,0.0,0,0,0,0,0,0,0,0,0,0,0,0,0,0,0,0,0
401085963,Manhattan Jaspers,T. Capuano,3948706,,False,22.0,0,1,0,1,0,0,0,0,0,1,1,2,1,0,0,1,0
401085963,Manhattan Jaspers,S. Usilo,3138468,,False,24.0,4,9,4,8,0,1,1,1,2,4,6,1,0,0,2,4,9
401085963,Manhattan Jaspers,TEAM,TOTAL,TOTAL,False,,15,44,12,32,3,12,13,22,7,20,27,8,5,2,15,26,46
401085963,Manhattan Jaspers,T. Reynolds,4398107,,True,16.0,1,3,1,1,0,2,0,0,0,2,2,0,0,0,0,0,2
401085963,Manhattan Jaspers,W. Williams,4279701,,True,26.0,4,8,4,8,0,0,4,8,1,3,4,0,1,1,5,3,12
401085963,Manhattan Jaspers,C. Hinckson,4398106,,True,16.0,0,5,0,4,0,1,1,4,0,1,1,0,0,0,1,2,1
401085963,Manhattan Jaspers,E. Buchanan,4398103,,True,12.0,2,4,1,2,1,2,3,4,0,2,2,1,1,0,1,5,8
401085963,Manhattan Jaspers,N. Mack,4279703,,True,28.0,1,1,1,1,0,0,1,1,0,2,2,3,1,0,1,3,3
401085963,Manhattan Jaspers,E. Ebube,4279705,,False,15.0,0,2,0,2,0,0,0,0,0,1,1,0,0,1,1,1,0
401085963,Manhattan Jaspers,T. Greene,4398108,,False,24.0,2,9,1,5,1,4,3,4,2,1,3,0,1,0,1,2,8
401085963,Manhattan Jaspers,S. Stewart,4398104,,False,17.0,1,2,0,0,1,2,0,0,1,2,3,1,0,0,3,5,3
401085963,Manhattan Jaspers,E. Lasko,4277944,,False,0.0,0,0,0,0,0,0,0,0,0,0,0,0,0,0,0,0,0
401085963,Manhattan Jaspers,T. Capuano,3948706,,False,22.0,0,1,0,1,0,0,0,0,0,1,1,2,1,0,0,1,0
401085963,Manhattan Jaspers,S. Usilo,3138468,,False,24.0,4,9,4,8,0,1,1,1,2,4,6,1,0,0,2,4,9
401085963,Manhattan Jaspers,TEAM,TOTAL,TOTAL,False,,15,44,12,32,3,12,13,22,7,20,27,8,5,2,15,26,46
401085962,Rider Broncs,F. Scott,3922033,,True,25.0,4,8,2,6,2,2,1,3,2,3,5,3,1,1,4,4,11
401085962,Rider Broncs,T. Marshall,4067348,,True,28.0,4,10,4,10,0,0,1,2,2,4,6,0,1,1,1,2,9
401085962,Rider Broncs,S. Jordan,4067349,,True,29.0,2,7,1,5,1,2,2,3,0,1,1,5,2,0,2,4,7
401085962,Rider Broncs,K. Williams,3946983,,True,18.0,0,2,0,2,0,0,0,0,0,2,2,3,0,0,3,0,0
401085962,Rider Broncs,A. Durham,3138490,,True,32.0,6,7,5,5,1,2,0,0,2,3,5,2,1,0,0,1,13
401085962,Rider Broncs,A. Ogemuno-Johnson,4406151,,False,5.0,0,1,0,1,0,0,1,2,1,1,2,0,0,0,1,2,1
401085962,Rider Broncs,D. Eke,3941312,,False,9.0,0,0,0,0,0,0,0,0,0,1,1,0,1,0,0,3,0
401085962,Rider Broncs,D. Vaughn,4067347,,False,33.0,5,10,1,3,4,7,2,2,0,9,9,1,1,0,4,2,16
401085962,Rider Broncs,J. Allen,4067345,,False,19.0,1,6,0,0,1,6,0,0,0,2,2,0,0,0,0,0,3
401085962,Rider Broncs,A. Gilbert,3911886,,False,2.0,0,1,0,0,0,1,0,0,0,1,1,0,0,0,1,2,0
401085962,Rider Broncs,TEAM,TOTAL,TOTAL,False,,22,52,13,32,9,20,7,12,10,27,37,14,7,2,17,20,60
401085962,Rider Broncs,F. Scott,3922033,,True,25.0,4,8,2,6,2,2,1,3,2,3,5,3,1,1,4,4,11
401085962,Rider Broncs,T. Marshall,4067348,,True,28.0,4,10,4,10,0,0,1,2,2,4,6,0,1,1,1,2,9
401085962,Rider Broncs,S. Jordan,4067349,,True,29.0,2,7,1,5,1,2,2,3,0,1,1,5,2,0,2,4,7
401085962,Rider Broncs,K. Williams,3946983,,True,18.0,0,2,0,2,0,0,0,0,0,2,2,3,0,0,3,0,0
401085962,Rider Broncs,A. Durham,3138490,,True,32.0,6,7,5,5,1,2,0,0,2,3,5,2,1,0,0,1,13
401085962,Rider Broncs,A. Ogemuno-Johnson,4406151,,False,5.0,0,1,0,1,0,0,1,2,1,1,2,0,0,0,1,2,1
401085962,Rider Broncs,D. Eke,3941312,,False,9.0,0,0,0,0,0,0,0,0,0,1,1,0,1,0,0,3,0
401085962,Rider Broncs,D. Vaughn,4067347,,False,33.0,5,10,1,3,4,7,2,2,0,9,9,1,1,0,4,2,16
401085962,Rider Broncs,J. Allen,4067345,,False,19.0,1,6,0,0,1,6,0,0,0,2,2,0,0,0,0,0,3
401085962,Rider Broncs,A. Gilbert,3911886,,False,2.0,0,1,0,0,0,1,0,0,0,1,1,0,0,0,1,2,0
401085962,Rider Broncs,TEAM,TOTAL,TOTAL,False,,22,52,13,32,9,20,7,12,10,27,37,14,7,2,17,20,60
401085962,Manhattan Jaspers,T. Reynolds,4398107,,True,23.0,4,9,1,1,3,8,0,0,0,2,2,1,0,0,1,2,11
401085962,Manhattan Jaspers,W. Williams,4279701,,True,15.0,3,5,3,5,0,0,1,4,1,2,3,0,0,3,2,4,7
401085962,Manhattan Jaspers,C. Hinckson,4398106,,True,21.0,4,8,3,7,1,1,2,3,1,3,4,1,1,1,2,2,11
401085962,Manhattan Jaspers,E. Buchanan,4398103,,True,14.0,0,4,0,2,0,2,0,1,1,4,5,1,0,1,0,1,0
401085962,Manhattan Jaspers,N. Mack,4279703,,True,22.0,1,1,1,1,0,0,1,2,0,2,2,0,3,1,2,3,3
401085962,Manhattan Jaspers,D. Schreier,4398105,,False,2.0,0,0,0,0,0,0,0,0,0,0,0,0,0,0,0,0,0
401085962,Manhattan Jaspers,E. Ebube,4279705,,False,15.0,1,2,1,1,0,1,0,2,1,0,1,1,1,0,3,3,2
401085962,Manhattan Jaspers,I. Diallo,3149898,,False,9.0,1,1,1,1,0,0,0,0,0,1,1,0,1,0,1,5,2
401085962,Manhattan Jaspers,T. Greene,4398108,,False,11.0,0,2,0,1,0,1,0,0,2,1,3,1,0,0,2,0,0
401085962,Manhattan Jaspers,S. Stewart,4398104,,False,27.0,0,7,0,2,0,5,2,3,1,1,2,3,2,0,2,1,2
401085962,Manhattan Jaspers,T. Capuano,3948706,,False,23.0,3,8,2,4,1,4,0,0,0,5,5,1,1,0,3,0,7
401085962,Manhattan Jaspers,S. Usilo,3138468,,False,18.0,1,3,1,3,0,0,0,2,0,3,3,1,0,1,1,0,2
401085962,Manhattan Jaspers,TEAM,TOTAL,TOTAL,False,,18,50,13,28,5,22,6,17,10,24,34,10,9,7,19,21,47
401085962,Manhattan Jaspers,T. Reynolds,4398107,,True,23.0,4,9,1,1,3,8,0,0,0,2,2,1,0,0,1,2,11
401085962,Manhattan Jaspers,W. Williams,4279701,,True,15.0,3,5,3,5,0,0,1,4,1,2,3,0,0,3,2,4,7
401085962,Manhattan Jaspers,C. Hinckson,4398106,,True,21.0,4,8,3,7,1,1,2,3,1,3,4,1,1,1,2,2,11
401085962,Manhattan Jaspers,E. Buchanan,4398103,,True,14.0,0,4,0,2,0,2,0,1,1,4,5,1,0,1,0,1,0
401085962,Manhattan Jaspers,N. Mack,4279703,,True,22.0,1,1,1,1,0,0,1,2,0,2,2,0,3,1,2,3,3
401085962,Manhattan Jaspers,D. Schreier,4398105,,False,2.0,0,0,0,0,0,0,0,0,0,0,0,0,0,0,0,0,0
401085962,Manhattan Jaspers,E. Ebube,4279705,,False,15.0,1,2,1,1,0,1,0,2,1,0,1,1,1,0,3,3,2
401085962,Manhattan Jaspers,I. Diallo,3149898,,False,9.0,1,1,1,1,0,0,0,0,0,1,1,0,1,0,1,5,2
401085962,Manhattan Jaspers,T. Greene,4398108,,False,11.0,0,2,0,1,0,1,0,0,2,1,3,1,0,0,2,0,0
401085962,Manhattan Jaspers,S. Stewart,4398104,,False,27.0,0,7,0,2,0,5,2,3,1,1,2,3,2,0,2,1,2
401085962,Manhattan Jaspers,T. Capuano,3948706,,False,23.0,3,8,2,4,1,4,0,0,0,5,5,1,1,0,3,0,7
401085962,Manhattan Jaspers,S. Usilo,3138468,,False,18.0,1,3,1,3,0,0,0,2,0,3,3,1,0,1,1,0,2
401085962,Manhattan Jaspers,TEAM,TOTAL,TOTAL,False,,18,50,13,28,5,22,6,17,10,24,34,10,9,7,19,21,47
401085961,Saint Peter's Peacocks,S. Idowu,3922042,,True,12.0,2,3,2,3,0,0,0,0,1,2,3,0,0,0,1,5,4
401085961,Saint Peter's Peacocks,Q. Taylor,4067357,,True,32.0,1,4,1,3,0,1,6,6,4,3,7,3,1,0,0,2,8
401085961,Saint Peter's Peacocks,D. Watson,4398384,,True,21.0,2,2,1,1,1,1,0,1,0,1,1,1,0,0,5,0,5
401085961,Saint Peter's Peacocks,M. Dixon,4279758,,True,33.0,2,7,1,4,1,3,0,0,0,2,2,0,0,0,0,2,5
401085961,Saint Peter's Peacocks,D. Turner,4067356,,True,40.0,2,14,2,7,0,7,10,11,2,2,4,0,2,1,2,0,14
401085961,Saint Peter's Peacocks,KC Ndefo,4398386,,False,23.0,2,6,2,6,0,0,4,4,0,4,4,1,2,0,4,1,8
401085961,Saint Peter's Peacocks,D. Woods,3919424,,False,28.0,3,4,3,4,0,0,6,6,1,4,5,0,1,1,0,4,12
401085961,Saint Peter's Peacocks,K. Brown,4398385,,False,11.0,0,2,0,0,0,2,0,0,0,2,2,1,0,0,0,0,0
401085961,Saint Peter's Peacocks,TEAM,TOTAL,TOTAL,False,,14,42,12,28,2,14,26,28,10,22,32,6,6,2,16,14,56
401085961,Saint Peter's Peacocks,S. Idowu,3922042,,True,12.0,2,3,2,3,0,0,0,0,1,2,3,0,0,0,1,5,4
401085961,Saint Peter's Peacocks,Q. Taylor,4067357,,True,32.0,1,4,1,3,0,1,6,6,4,3,7,3,1,0,0,2,8
401085961,Saint Peter's Peacocks,D. Watson,4398384,,True,21.0,2,2,1,1,1,1,0,1,0,1,1,1,0,0,5,0,5
401085961,Saint Peter's Peacocks,M. Dixon,4279758,,True,33.0,2,7,1,4,1,3,0,0,0,2,2,0,0,0,0,2,5
401085961,Saint Peter's Peacocks,D. Turner,4067356,,True,40.0,2,14,2,7,0,7,10,11,2,2,4,0,2,1,2,0,14
401085961,Saint Peter's Peacocks,KC Ndefo,4398386,,False,23.0,2,6,2,6,0,0,4,4,0,4,4,1,2,0,4,1,8
401085961,Saint Peter's Peacocks,D. Woods,3919424,,False,28.0,3,4,3,4,0,0,6,6,1,4,5,0,1,1,0,4,12
401085961,Saint Peter's Peacocks,K. Brown,4398385,,False,11.0,0,2,0,0,0,2,0,0,0,2,2,1,0,0,0,0,0
401085961,Saint Peter's Peacocks,TEAM,TOTAL,TOTAL,False,,14,42,12,28,2,14,26,28,10,22,32,6,6,2,16,14,56
401085961,Manhattan Jaspers,T. Reynolds,4398107,,True,31.0,3,9,2,2,1,7,2,2,1,3,4,0,1,0,2,1,9
401085961,Manhattan Jaspers,W. Williams,4279701,,True,17.0,7,9,7,9,0,0,1,4,2,4,6,2,1,2,1,4,15
401085961,Manhattan Jaspers,C. Hinckson,4398106,,True,10.0,2,2,2,2,0,0,0,0,1,0,1,0,0,0,1,3,4
401085961,Manhattan Jaspers,E. Buchanan,4398103,,True,15.0,0,4,0,3,0,1,0,0,0,0,0,2,0,0,1,2,0
401085961,Manhattan Jaspers,N. Mack,4279703,,True,27.0,3,6,1,3,2,3,0,0,0,1,1,4,5,0,1,0,8
401085961,Manhattan Jaspers,D. Schreier,4398105,,False,6.0,0,0,0,0,0,0,0,0,0,1,1,0,0,0,0,0,0
401085961,Manhattan Jaspers,I. Diallo,3149898,,False,17.0,2,5,2,5,0,0,0,0,1,1,2,1,2,0,1,2,4
401085961,Manhattan Jaspers,T. Greene,4398108,,False,9.0,0,2,0,1,0,1,0,0,0,2,2,0,0,0,3,2,0
401085961,Manhattan Jaspers,S. Stewart,4398104,,False,16.0,1,2,0,0,1,2,0,0,0,1,1,0,0,0,1,4,3
401085961,Manhattan Jaspers,E. Lasko,4277944,,False,0.0,0,0,0,0,0,0,0,0,0,0,0,0,0,0,0,0,0
401085961,Manhattan Jaspers,T. Capuano,3948706,,False,22.0,4,6,3,3,1,3,0,0,0,0,0,4,2,0,0,2,9
401085961,Manhattan Jaspers,S. Usilo,3138468,,False,30.0,2,5,1,4,1,1,1,3,2,3,5,1,0,0,1,1,6
401085961,Manhattan Jaspers,TEAM,TOTAL,TOTAL,False,,24,50,18,32,6,18,4,9,8,20,28,14,11,2,14,21,58
401085961,Manhattan Jaspers,T. Reynolds,4398107,,True,31.0,3,9,2,2,1,7,2,2,1,3,4,0,1,0,2,1,9
401085961,Manhattan Jaspers,W. Williams,4279701,,True,17.0,7,9,7,9,0,0,1,4,2,4,6,2,1,2,1,4,15
401085961,Manhattan Jaspers,C. Hinckson,4398106,,True,10.0,2,2,2,2,0,0,0,0,1,0,1,0,0,0,1,3,4
401085961,Manhattan Jaspers,E. Buchanan,4398103,,True,15.0,0,4,0,3,0,1,0,0,0,0,0,2,0,0,1,2,0
401085961,Manhattan Jaspers,N. Mack,4279703,,True,27.0,3,6,1,3,2,3,0,0,0,1,1,4,5,0,1,0,8
401085961,Manhattan Jaspers,D. Schreier,4398105,,False,6.0,0,0,0,0,0,0,0,0,0,1,1,0,0,0,0,0,0
401085961,Manhattan Jaspers,I. Diallo,3149898,,False,17.0,2,5,2,5,0,0,0,0,1,1,2,1,2,0,1,2,4
401085961,Manhattan Jaspers,T. Greene,4398108,,False,9.0,0,2,0,1,0,1,0,0,0,2,2,0,0,0,3,2,0
401085961,Manhattan Jaspers,S. Stewart,4398104,,False,16.0,1,2,0,0,1,2,0,0,0,1,1,0,0,0,1,4,3
401085961,Manhattan Jaspers,E. Lasko,4277944,,False,0.0,0,0,0,0,0,0,0,0,0,0,0,0,0,0,0,0,0
401085961,Manhattan Jaspers,T. Capuano,3948706,,False,22.0,4,6,3,3,1,3,0,0,0,0,0,4,2,0,0,2,9
401085961,Manhattan Jaspers,S. Usilo,3138468,,False,30.0,2,5,1,4,1,1,1,3,2,3,5,1,0,0,1,1,6
401085961,Manhattan Jaspers,TEAM,TOTAL,TOTAL,False,,24,50,18,32,6,18,4,9,8,20,28,14,11,2,14,21,58
401085960,Monmouth Hawks,M. Traore,3975762,,True,25.0,4,7,4,7,0,0,2,2,3,5,8,1,0,1,2,0,10
401085960,Monmouth Hawks,D. Quinn,3948714,,True,20.0,4,5,4,5,0,0,0,1,0,3,3,0,1,0,1,5,8
401085960,Monmouth Hawks,M. McClary,4279736,,True,23.0,0,2,0,1,0,1,0,0,0,3,3,0,0,0,0,2,0
401085960,Monmouth Hawks,D. Hammond,4279734,,True,24.0,3,6,3,5,0,1,3,4,0,2,2,0,0,1,1,4,9
401085960,Monmouth Hawks,R. Salnave,4067329,,True,33.0,6,10,5,6,1,4,4,6,1,4,5,6,1,2,2,1,17
401085960,Monmouth Hawks,N. Rutty,4398408,,False,11.0,0,0,0,0,0,0,0,2,0,2,2,0,0,0,1,2,0
401085960,Monmouth Hawks,S. Ibiezugbe,4067330,,False,2.0,0,0,0,0,0,0,0,0,0,1,1,0,0,0,0,0,0
401085960,Monmouth Hawks,M. Martin,4279733,,False,26.0,2,5,2,3,0,2,3,3,0,1,1,1,0,1,6,3,7
401085960,Monmouth Hawks,M. James Jr.,4404878,,False,1.0,1,1,1,1,0,0,0,0,0,0,0,0,0,0,0,0,2
401085960,Monmouth Hawks,S. Chaput,4398409,,False,7.0,0,2,0,2,0,0,0,0,0,1,1,1,0,0,0,0,0
401085960,Monmouth Hawks,D. Calloway Jr.,4398407,,False,2.0,0,0,0,0,0,0,0,0,0,0,0,0,0,0,0,0,0
401085960,Monmouth Hawks,G. Papas,4279735,,False,10.0,2,3,0,0,2,3,2,2,0,1,1,1,1,0,1,1,8
401085960,Monmouth Hawks,N. Rutherford,3946977,,False,16.0,1,2,1,2,0,0,2,3,1,3,4,1,2,0,1,1,4
401085960,Monmouth Hawks,TEAM,TOTAL,TOTAL,False,,23,43,20,32,3,11,16,23,5,27,32,11,5,5,15,19,65
401085960,Monmouth Hawks,M. Traore,3975762,,True,25.0,4,7,4,7,0,0,2,2,3,5,8,1,0,1,2,0,10
401085960,Monmouth Hawks,D. Quinn,3948714,,True,20.0,4,5,4,5,0,0,0,1,0,3,3,0,1,0,1,5,8
401085960,Monmouth Hawks,M. McClary,4279736,,True,23.0,0,2,0,1,0,1,0,0,0,3,3,0,0,0,0,2,0
401085960,Monmouth Hawks,D. Hammond,4279734,,True,24.0,3,6,3,5,0,1,3,4,0,2,2,0,0,1,1,4,9
401085960,Monmouth Hawks,R. Salnave,4067329,,True,33.0,6,10,5,6,1,4,4,6,1,4,5,6,1,2,2,1,17
401085960,Monmouth Hawks,N. Rutty,4398408,,False,11.0,0,0,0,0,0,0,0,2,0,2,2,0,0,0,1,2,0
401085960,Monmouth Hawks,S. Ibiezugbe,4067330,,False,2.0,0,0,0,0,0,0,0,0,0,1,1,0,0,0,0,0,0
401085960,Monmouth Hawks,M. Martin,4279733,,False,26.0,2,5,2,3,0,2,3,3,0,1,1,1,0,1,6,3,7
401085960,Monmouth Hawks,M. James Jr.,4404878,,False,1.0,1,1,1,1,0,0,0,0,0,0,0,0,0,0,0,0,2
401085960,Monmouth Hawks,S. Chaput,4398409,,False,7.0,0,2,0,2,0,0,0,0,0,1,1,1,0,0,0,0,0
401085960,Monmouth Hawks,D. Calloway Jr.,4398407,,False,2.0,0,0,0,0,0,0,0,0,0,0,0,0,0,0,0,0,0
401085960,Monmouth Hawks,G. Papas,4279735,,False,10.0,2,3,0,0,2,3,2,2,0,1,1,1,1,0,1,1,8
401085960,Monmouth Hawks,N. Rutherford,3946977,,False,16.0,1,2,1,2,0,0,2,3,1,3,4,1,2,0,1,1,4
401085960,Monmouth Hawks,TEAM,TOTAL,TOTAL,False,,23,43,20,32,3,11,16,23,5,27,32,11,5,5,15,19,65
401085960,Manhattan Jaspers,T. Reynolds,4398107,,True,15.0,3,4,0,1,3,3,0,0,0,1,1,0,0,0,1,2,9
401085960,Manhattan Jaspers,E. Ebube,4279705,,True,22.0,3,4,3,3,0,1,0,0,2,5,7,0,0,1,2,5,6
401085960,Manhattan Jaspers,W. Williams,4279701,,True,20.0,1,4,1,4,0,0,2,2,1,4,5,1,0,2,2,2,4
401085960,Manhattan Jaspers,N. Mack,4279703,,True,29.0,0,5,0,1,0,4,0,0,0,0,0,5,0,0,0,4,0
401085960,Manhattan Jaspers,T. Capuano,3948706,,True,20.0,4,11,1,5,3,6,0,1,2,0,2,0,1,0,2,0,11
401085960,Manhattan Jaspers,I. Diallo,3149898,,False,6.0,1,2,1,2,0,0,0,1,1,0,1,0,0,0,0,2,2
401085960,Manhattan Jaspers,T. Greene,4398108,,False,25.0,0,9,0,5,0,4,5,8,4,4,8,1,1,0,3,1,5
401085960,Manhattan Jaspers,C. Hinckson,4398106,,False,10.0,0,0,0,0,0,0,0,0,0,2,2,2,0,0,0,0,0
401085960,Manhattan Jaspers,S. Stewart,4398104,,False,18.0,2,4,0,1,2,3,0,0,0,0,0,2,0,0,3,0,6
401085960,Manhattan Jaspers,E. Buchanan,4398103,,False,12.0,1,7,0,3,1,4,1,2,1,0,1,0,0,0,0,2,4
401085960,Manhattan Jaspers,S. Usilo,3138468,,False,23.0,1,4,1,4,0,0,0,3,2,2,4,0,2,0,1,5,2
401085960,Manhattan Jaspers,TEAM,TOTAL,TOTAL,False,,16,54,7,29,9,25,8,17,14,19,33,11,4,3,16,23,49
401085960,Manhattan Jaspers,T. Reynolds,4398107,,True,15.0,3,4,0,1,3,3,0,0,0,1,1,0,0,0,1,2,9
401085960,Manhattan Jaspers,E. Ebube,4279705,,True,22.0,3,4,3,3,0,1,0,0,2,5,7,0,0,1,2,5,6
401085960,Manhattan Jaspers,W. Williams,4279701,,True,20.0,1,4,1,4,0,0,2,2,1,4,5,1,0,2,2,2,4
401085960,Manhattan Jaspers,N. Mack,4279703,,True,29.0,0,5,0,1,0,4,0,0,0,0,0,5,0,0,0,4,0
401085960,Manhattan Jaspers,T. Capuano,3948706,,True,20.0,4,11,1,5,3,6,0,1,2,0,2,0,1,0,2,0,11
401085960,Manhattan Jaspers,I. Diallo,3149898,,False,6.0,1,2,1,2,0,0,0,1,1,0,1,0,0,0,0,2,2
401085960,Manhattan Jaspers,T. Greene,4398108,,False,25.0,0,9,0,5,0,4,5,8,4,4,8,1,1,0,3,1,5
401085960,Manhattan Jaspers,C. Hinckson,4398106,,False,10.0,0,0,0,0,0,0,0,0,0,2,2,2,0,0,0,0,0
401085960,Manhattan Jaspers,S. Stewart,4398104,,False,18.0,2,4,0,1,2,3,0,0,0,0,0,2,0,0,3,0,6
401085960,Manhattan Jaspers,E. Buchanan,4398103,,False,12.0,1,7,0,3,1,4,1,2,1,0,1,0,0,0,0,2,4
401085960,Manhattan Jaspers,S. Usilo,3138468,,False,23.0,1,4,1,4,0,0,0,3,2,2,4,0,2,0,1,5,2
401085960,Manhattan Jaspers,TEAM,TOTAL,TOTAL,False,,16,54,7,29,9,25,8,17,14,19,33,11,4,3,16,23,49
401085959,Marist Red Foxes,I. Lamb,3936028,,True,10.0,0,1,0,0,0,1,0,0,0,1,1,0,0,0,0,3,0
401085959,Marist Red Foxes,T. Sjoberg,4067328,,True,17.0,0,0,0,0,0,0,1,2,3,0,3,0,0,1,1,4,1
401085959,Marist Red Foxes,D. Knudsen,3936027,,True,16.0,2,2,2,2,0,0,7,7,0,2,2,1,0,0,1,0,11
401085959,Marist Red Foxes,D. Hines,4398410,,True,29.0,4,7,2,5,2,2,5,6,0,2,2,2,2,0,2,2,15
401085959,Marist Red Foxes,B. Parker,3936030,,True,34.0,6,10,6,9,0,1,5,9,0,6,6,4,0,0,2,4,17
401085959,Marist Red Foxes,L. Nedrow,4398414,,False,10.0,0,1,0,1,0,0,0,1,2,2,4,0,1,0,2,4,0
401085959,Marist Red Foxes,R. Funk,3936026,,False,29.0,5,9,0,1,5,8,2,2,0,3,3,0,1,0,1,1,17
401085959,Marist Red Foxes,A. Dozic,3923222,,False,21.0,4,8,3,5,1,3,2,2,0,4,4,2,1,0,4,4,11
401085959,Marist Red Foxes,M. Herasme,4398413,,False,24.0,1,2,1,2,0,0,2,2,0,1,1,0,3,0,0,1,4
401085959,Marist Red Foxes,A. Williams,4279709,,False,10.0,1,1,1,1,0,0,0,0,1,0,1,2,0,0,0,3,2
401085959,Marist Red Foxes,TEAM,TOTAL,TOTAL,False,,23,41,15,26,8,15,24,31,6,22,28,11,8,1,14,26,78
401085959,Marist Red Foxes,I. Lamb,3936028,,True,10.0,0,1,0,0,0,1,0,0,0,1,1,0,0,0,0,3,0
401085959,Marist Red Foxes,T. Sjoberg,4067328,,True,17.0,0,0,0,0,0,0,1,2,3,0,3,0,0,1,1,4,1
401085959,Marist Red Foxes,D. Knudsen,3936027,,True,16.0,2,2,2,2,0,0,7,7,0,2,2,1,0,0,1,0,11
401085959,Marist Red Foxes,D. Hines,4398410,,True,29.0,4,7,2,5,2,2,5,6,0,2,2,2,2,0,2,2,15
401085959,Marist Red Foxes,B. Parker,3936030,,True,34.0,6,10,6,9,0,1,5,9,0,6,6,4,0,0,2,4,17
401085959,Marist Red Foxes,L. Nedrow,4398414,,False,10.0,0,1,0,1,0,0,0,1,2,2,4,0,1,0,2,4,0
401085959,Marist Red Foxes,R. Funk,3936026,,False,29.0,5,9,0,1,5,8,2,2,0,3,3,0,1,0,1,1,17
401085959,Marist Red Foxes,A. Dozic,3923222,,False,21.0,4,8,3,5,1,3,2,2,0,4,4,2,1,0,4,4,11
401085959,Marist Red Foxes,M. Herasme,4398413,,False,24.0,1,2,1,2,0,0,2,2,0,1,1,0,3,0,0,1,4
401085959,Marist Red Foxes,A. Williams,4279709,,False,10.0,1,1,1,1,0,0,0,0,1,0,1,2,0,0,0,3,2
401085959,Marist Red Foxes,TEAM,TOTAL,TOTAL,False,,23,41,15,26,8,15,24,31,6,22,28,11,8,1,14,26,78
401085959,Manhattan Jaspers,T. Reynolds,4398107,,True,17.0,2,7,0,0,2,7,0,0,1,5,6,1,1,0,2,3,6
401085959,Manhattan Jaspers,P. Paulicap,4279706,,True,18.0,2,8,2,8,0,0,2,2,4,2,6,0,0,0,1,4,6
401085959,Manhattan Jaspers,W. Williams,4279701,,True,16.0,2,4,2,4,0,0,1,3,0,2,2,0,0,0,3,3,5
401085959,Manhattan Jaspers,N. Mack,4279703,,True,22.0,4,6,1,1,3,5,6,6,2,1,3,0,0,0,1,3,17
401085959,Manhattan Jaspers,T. Capuano,3948706,,True,29.0,3,8,1,2,2,6,0,0,0,1,1,4,2,0,1,2,8
401085959,Manhattan Jaspers,D. Schreier,4398105,,False,3.0,0,0,0,0,0,0,0,0,0,0,0,0,0,0,0,0,0
401085959,Manhattan Jaspers,E. Ebube,4279705,,False,17.0,1,1,1,1,0,0,0,1,0,1,1,0,1,0,1,4,2
401085959,Manhattan Jaspers,T. Greene,4398108,,False,22.0,1,3,1,1,0,2,2,3,1,4,5,0,1,0,4,4,4
401085959,Manhattan Jaspers,C. Hinckson,4398106,,False,21.0,1,5,1,3,0,2,4,8,2,1,3,1,0,0,1,0,6
401085959,Manhattan Jaspers,S. Stewart,4398104,,False,18.0,1,2,0,0,1,2,0,0,0,0,0,1,1,0,3,3,3
401085959,Manhattan Jaspers,E. Buchanan,4398103,,False,11.0,1,3,1,2,0,1,1,2,1,0,1,2,0,0,1,2,3
401085959,Manhattan Jaspers,S. Usilo,3138468,,False,6.0,1,1,1,1,0,0,1,3,0,0,0,0,0,0,0,0,3
401085959,Manhattan Jaspers,TEAM,TOTAL,TOTAL,False,,19,48,11,23,8,25,17,28,12,17,29,9,6,0,18,28,63
401085959,Manhattan Jaspers,T. Reynolds,4398107,,True,17.0,2,7,0,0,2,7,0,0,1,5,6,1,1,0,2,3,6
401085959,Manhattan Jaspers,P. Paulicap,4279706,,True,18.0,2,8,2,8,0,0,2,2,4,2,6,0,0,0,1,4,6
401085959,Manhattan Jaspers,W. Williams,4279701,,True,16.0,2,4,2,4,0,0,1,3,0,2,2,0,0,0,3,3,5
401085959,Manhattan Jaspers,N. Mack,4279703,,True,22.0,4,6,1,1,3,5,6,6,2,1,3,0,0,0,1,3,17
401085959,Manhattan Jaspers,T. Capuano,3948706,,True,29.0,3,8,1,2,2,6,0,0,0,1,1,4,2,0,1,2,8
401085959,Manhattan Jaspers,D. Schreier,4398105,,False,3.0,0,0,0,0,0,0,0,0,0,0,0,0,0,0,0,0,0
401085959,Manhattan Jaspers,E. Ebube,4279705,,False,17.0,1,1,1,1,0,0,0,1,0,1,1,0,1,0,1,4,2
401085959,Manhattan Jaspers,T. Greene,4398108,,False,22.0,1,3,1,1,0,2,2,3,1,4,5,0,1,0,4,4,4
401085959,Manhattan Jaspers,C. Hinckson,4398106,,False,21.0,1,5,1,3,0,2,4,8,2,1,3,1,0,0,1,0,6
401085959,Manhattan Jaspers,S. Stewart,4398104,,False,18.0,1,2,0,0,1,2,0,0,0,0,0,1,1,0,3,3,3
401085959,Manhattan Jaspers,E. Buchanan,4398103,,False,11.0,1,3,1,2,0,1,1,2,1,0,1,2,0,0,1,2,3
401085959,Manhattan Jaspers,S. Usilo,3138468,,False,6.0,1,1,1,1,0,0,1,3,0,0,0,0,0,0,0,0,3
401085959,Manhattan Jaspers,TEAM,TOTAL,TOTAL,False,,19,48,11,23,8,25,17,28,12,17,29,9,6,0,18,28,63
401085958,Niagara Purple Eagles,D. Robb,3907186,,True,30.0,7,11,7,10,0,1,3,4,7,3,10,1,0,4,0,3,17
401085958,Niagara Purple Eagles,M. Prochet,3907184,,True,27.0,5,10,3,4,2,6,3,4,0,3,3,3,3,0,5,2,15
401085958,Niagara Purple Eagles,K. Tate,4279738,,True,23.0,4,9,1,2,3,7,2,2,0,1,1,1,0,0,2,3,13
401085958,Niagara Purple Eagles,J. Towns,4067341,,True,38.0,3,11,3,9,0,2,7,8,1,2,3,6,1,0,3,2,13
401085958,Niagara Purple Eagles,C. Barton,3907182,,True,28.0,1,3,1,3,0,0,0,0,0,2,2,2,0,0,0,0,2
401085958,Niagara Purple Eagles,G. Kuakumensah,4279739,,False,3.0,0,0,0,0,0,0,0,1,0,0,0,0,1,0,1,2,0
401085958,Niagara Purple Eagles,K. Green,4067342,,False,11.0,2,4,2,4,0,0,2,2,0,1,1,0,0,0,0,1,6
401085958,Niagara Purple Eagles,G. King,3906490,,False,10.0,1,3,1,3,0,0,2,2,0,0,0,0,0,0,0,3,4
401085958,Niagara Purple Eagles,M. Hammond,4398404,,False,25.0,3,4,1,2,2,2,2,2,1,0,1,0,0,0,0,2,10
401085958,Niagara Purple Eagles,R. Solomon,4398403,,False,3.0,0,0,0,0,0,0,0,0,0,0,0,0,0,0,1,1,0
401085958,Niagara Purple Eagles,D. Fragala,4279737,,False,2.0,0,0,0,0,0,0,0,0,0,0,0,0,0,0,0,0,0
401085958,Niagara Purple Eagles,TEAM,TOTAL,TOTAL,False,,26,55,19,37,7,18,21,25,13,15,28,13,5,4,12,19,80
401085958,Niagara Purple Eagles,D. Robb,3907186,,True,30.0,7,11,7,10,0,1,3,4,7,3,10,1,0,4,0,3,17
401085958,Niagara Purple Eagles,M. Prochet,3907184,,True,27.0,5,10,3,4,2,6,3,4,0,3,3,3,3,0,5,2,15
401085958,Niagara Purple Eagles,K. Tate,4279738,,True,23.0,4,9,1,2,3,7,2,2,0,1,1,1,0,0,2,3,13
401085958,Niagara Purple Eagles,J. Towns,4067341,,True,38.0,3,11,3,9,0,2,7,8,1,2,3,6,1,0,3,2,13
401085958,Niagara Purple Eagles,C. Barton,3907182,,True,28.0,1,3,1,3,0,0,0,0,0,2,2,2,0,0,0,0,2
401085958,Niagara Purple Eagles,G. Kuakumensah,4279739,,False,3.0,0,0,0,0,0,0,0,1,0,0,0,0,1,0,1,2,0
401085958,Niagara Purple Eagles,K. Green,4067342,,False,11.0,2,4,2,4,0,0,2,2,0,1,1,0,0,0,0,1,6
401085958,Niagara Purple Eagles,G. King,3906490,,False,10.0,1,3,1,3,0,0,2,2,0,0,0,0,0,0,0,3,4
401085958,Niagara Purple Eagles,M. Hammond,4398404,,False,25.0,3,4,1,2,2,2,2,2,1,0,1,0,0,0,0,2,10
401085958,Niagara Purple Eagles,R. Solomon,4398403,,False,3.0,0,0,0,0,0,0,0,0,0,0,0,0,0,0,1,1,0
401085958,Niagara Purple Eagles,D. Fragala,4279737,,False,2.0,0,0,0,0,0,0,0,0,0,0,0,0,0,0,0,0,0
401085958,Niagara Purple Eagles,TEAM,TOTAL,TOTAL,False,,26,55,19,37,7,18,21,25,13,15,28,13,5,4,12,19,80
401085958,Manhattan Jaspers,T. Reynolds,4398107,,True,26.0,3,6,0,0,3,6,1,2,0,0,0,1,0,0,0,2,10
401085958,Manhattan Jaspers,P. Paulicap,4279706,,True,22.0,5,7,5,7,0,0,0,1,0,4,4,1,1,2,1,4,10
401085958,Manhattan Jaspers,W. Williams,4279701,,True,20.0,3,5,3,5,0,0,2,4,1,1,2,2,0,0,6,2,8
401085958,Manhattan Jaspers,N. Mack,4279703,,True,28.0,2,2,1,1,1,1,0,0,0,0,0,5,0,0,1,2,5
401085958,Manhattan Jaspers,T. Capuano,3948706,,True,19.0,4,8,2,2,2,6,0,0,2,3,5,1,0,0,0,3,10
401085958,Manhattan Jaspers,D. Schreier,4398105,,False,5.0,1,1,1,1,0,0,0,0,0,0,0,0,0,0,0,0,2
401085958,Manhattan Jaspers,E. Ebube,4279705,,False,20.0,4,5,3,4,1,1,0,0,1,0,1,3,0,0,0,2,9
401085958,Manhattan Jaspers,I. Diallo,3149898,,False,4.0,0,2,0,2,0,0,0,0,1,0,1,0,0,0,0,0,0
401085958,Manhattan Jaspers,T. Greene,4398108,,False,14.0,2,6,1,3,1,3,1,2,1,2,3,1,1,0,1,4,6
401085958,Manhattan Jaspers,C. Hinckson,4398106,,False,9.0,3,3,3,3,0,0,0,0,1,2,3,1,0,0,1,0,6
401085958,Manhattan Jaspers,S. Stewart,4398104,,False,20.0,6,6,1,1,5,5,5,5,0,0,0,4,3,0,1,3,22
401085958,Manhattan Jaspers,E. Buchanan,4398103,,False,9.0,1,3,1,3,0,0,0,0,0,2,2,0,1,0,3,1,2
401085958,Manhattan Jaspers,E. Lasko,4277944,,False,4.0,0,0,0,0,0,0,0,0,0,1,1,0,0,0,0,0,0
401085958,Manhattan Jaspers,TEAM,TOTAL,TOTAL,False,,34,54,21,32,13,22,9,14,8,17,25,19,6,2,15,23,90
401085958,Manhattan Jaspers,T. Reynolds,4398107,,True,26.0,3,6,0,0,3,6,1,2,0,0,0,1,0,0,0,2,10
401085958,Manhattan Jaspers,P. Paulicap,4279706,,True,22.0,5,7,5,7,0,0,0,1,0,4,4,1,1,2,1,4,10
401085958,Manhattan Jaspers,W. Williams,4279701,,True,20.0,3,5,3,5,0,0,2,4,1,1,2,2,0,0,6,2,8
401085958,Manhattan Jaspers,N. Mack,4279703,,True,28.0,2,2,1,1,1,1,0,0,0,0,0,5,0,0,1,2,5
401085958,Manhattan Jaspers,T. Capuano,3948706,,True,19.0,4,8,2,2,2,6,0,0,2,3,5,1,0,0,0,3,10
401085958,Manhattan Jaspers,D. Schreier,4398105,,False,5.0,1,1,1,1,0,0,0,0,0,0,0,0,0,0,0,0,2
401085958,Manhattan Jaspers,E. Ebube,4279705,,False,20.0,4,5,3,4,1,1,0,0,1,0,1,3,0,0,0,2,9
401085958,Manhattan Jaspers,I. Diallo,3149898,,False,4.0,0,2,0,2,0,0,0,0,1,0,1,0,0,0,0,0,0
401085958,Manhattan Jaspers,T. Greene,4398108,,False,14.0,2,6,1,3,1,3,1,2,1,2,3,1,1,0,1,4,6
401085958,Manhattan Jaspers,C. Hinckson,4398106,,False,9.0,3,3,3,3,0,0,0,0,1,2,3,1,0,0,1,0,6
401085958,Manhattan Jaspers,S. Stewart,4398104,,False,20.0,6,6,1,1,5,5,5,5,0,0,0,4,3,0,1,3,22
401085958,Manhattan Jaspers,E. Buchanan,4398103,,False,9.0,1,3,1,3,0,0,0,0,0,2,2,0,1,0,3,1,2
401085958,Manhattan Jaspers,E. Lasko,4277944,,False,4.0,0,0,0,0,0,0,0,0,0,1,1,0,0,0,0,0,0
401085958,Manhattan Jaspers,TEAM,TOTAL,TOTAL,False,,34,54,21,32,13,22,9,14,8,17,25,19,6,2,15,23,90
401085957,St. Francis Brooklyn Terriers,Y. Evans,4279650,,True,19.0,3,7,2,3,1,4,0,0,0,2,2,0,0,0,1,4,7
401085957,St. Francis Brooklyn Terriers,D. Celen,4067291,,True,26.0,5,7,3,5,2,2,0,0,0,3,3,3,1,1,1,3,12
401085957,St. Francis Brooklyn Terriers,J. Jordan,4279651,,True,34.0,2,10,0,4,2,6,3,5,0,5,5,3,1,0,1,1,9
401085957,St. Francis Brooklyn Terriers,R. Hurley,3913229,,True,25.0,4,8,4,8,0,0,3,4,5,3,8,5,1,0,1,2,11
401085957,St. Francis Brooklyn Terriers,G. Sanabria,3133979,,True,36.0,4,11,3,6,1,5,7,9,2,1,3,4,2,0,3,2,16
401085957,St. Francis Brooklyn Terriers,K. Williams,3155881,,False,13.0,1,2,1,2,0,0,0,0,0,1,1,1,1,0,1,3,2
401085957,St. Francis Brooklyn Terriers,C. Rohlehr,4398010,,False,4.0,1,1,1,1,0,0,0,0,0,0,0,0,1,1,0,3,2
401085957,St. Francis Brooklyn Terriers,C. Johnson,4067953,,False,10.0,4,5,4,5,0,0,3,4,2,2,4,0,0,0,2,3,11
401085957,St. Francis Brooklyn Terriers,S. Krtinic,4398008,,False,7.0,0,0,0,0,0,0,0,0,0,1,1,1,0,0,1,1,0
401085957,St. Francis Brooklyn Terriers,C. Hawkins,4279649,,False,26.0,0,4,0,4,0,0,2,2,0,5,5,1,1,0,5,3,2
401085957,St. Francis Brooklyn Terriers,TEAM,TOTAL,TOTAL,False,,24,55,18,38,6,17,18,24,10,24,34,18,8,2,16,25,72
401085957,Manhattan Jaspers,P. Paulicap,4279706,,True,23.0,6,11,6,11,0,0,5,7,1,3,4,0,0,4,2,2,17
401085957,Manhattan Jaspers,T. Greene,4398108,,True,15.0,2,7,2,3,0,4,3,6,2,1,3,0,1,0,0,1,7
401085957,Manhattan Jaspers,N. Mack,4279703,,True,31.0,1,4,1,3,0,1,1,2,1,2,3,1,2,0,5,3,3
401085957,Manhattan Jaspers,T. Capuano,3948706,,True,37.0,3,7,1,4,2,3,0,0,0,2,2,2,2,0,1,4,8
401085957,Manhattan Jaspers,S. Usilo,3138468,,True,13.0,1,1,1,1,0,0,0,0,0,2,2,1,2,0,3,4,2
401085957,Manhattan Jaspers,T. Reynolds,4398107,,False,4.0,1,1,1,1,0,0,0,0,0,0,0,0,1,0,0,0,2
401085957,Manhattan Jaspers,E. Ebube,4279705,,False,9.0,0,1,0,1,0,0,0,0,2,2,4,0,0,0,2,2,0
401085957,Manhattan Jaspers,W. Williams,4279701,,False,10.0,2,5,2,5,0,0,3,5,3,0,3,0,0,1,1,4,7
401085957,Manhattan Jaspers,I. Diallo,3149898,,False,7.0,1,1,1,1,0,0,0,0,0,1,1,0,0,0,0,0,2
401085957,Manhattan Jaspers,C. Hinckson,4398106,,False,17.0,1,1,1,1,0,0,0,0,0,5,5,0,0,0,2,1,2
401085957,Manhattan Jaspers,S. Stewart,4398104,,False,12.0,0,3,0,2,0,1,0,0,1,1,2,2,1,0,2,0,0
401085957,Manhattan Jaspers,E. Buchanan,4398103,,False,22.0,0,3,0,2,0,1,6,9,0,4,4,2,0,0,3,2,6
401085957,Manhattan Jaspers,TEAM,TOTAL,TOTAL,False,,18,45,16,35,2,10,18,29,10,25,35,8,9,5,21,23,56
401085956,UAlbany Great Danes,A. Lulka,4278204,,True,38.0,5,6,5,6,0,0,0,0,4,6,10,3,1,2,2,4,10
401085956,UAlbany Great Danes,B. Hank,4278202,,True,9.0,0,0,0,0,0,0,1,2,0,1,1,1,1,0,1,4,1
401085956,UAlbany Great Danes,A. Rizzuto,4395873,,True,32.0,3,8,0,2,3,6,5,6,0,5,5,1,0,1,0,2,14
401085956,UAlbany Great Danes,C. Healy,4278203,,True,33.0,4,9,0,2,4,7,4,4,0,5,5,2,1,0,4,0,16
401085956,UAlbany Great Danes,A. Clark,4278199,,True,35.0,4,9,2,3,2,6,13,15,1,3,4,6,1,0,6,4,23
401085956,UAlbany Great Danes,K. Lauderdale,4395878,,False,16.0,3,4,3,4,0,0,0,0,2,0,2,1,0,0,0,4,6
401085956,UAlbany Great Danes,M. De Sousa,4395874,,False,8.0,1,1,1,1,0,0,1,2,0,0,0,1,1,0,0,0,3
401085956,UAlbany Great Danes,S. French,4066754,,False,1.0,0,1,0,1,0,0,0,0,0,0,0,0,0,0,1,0,0
401085956,UAlbany Great Danes,D. Campbell,4066683,,False,28.0,0,2,0,1,0,1,4,6,0,3,3,1,2,1,2,0,4
401085956,UAlbany Great Danes,N. Fruscio,4066685,,False,0.0,0,0,0,0,0,0,0,0,0,0,0,0,0,0,0,0,0
401085956,UAlbany Great Danes,TEAM,TOTAL,TOTAL,False,,20,40,11,20,9,20,28,35,8,25,33,16,7,4,19,18,77
401085956,Manhattan Jaspers,P. Paulicap,4279706,,True,9.0,2,3,2,3,0,0,0,0,1,0,1,0,0,0,1,5,4
401085956,Manhattan Jaspers,S. Usilo,3138468,,True,15.0,0,0,0,0,0,0,0,0,0,4,4,1,2,0,2,1,0
401085956,Manhattan Jaspers,T. Greene,4398108,,True,18.0,3,10,2,6,1,4,0,0,0,1,1,1,1,0,1,1,7
401085956,Manhattan Jaspers,N. Mack,4279703,,True,29.0,6,9,3,5,3,4,6,6,0,2,2,3,1,0,2,1,21
401085956,Manhattan Jaspers,T. Capuano,3948706,,True,30.0,3,5,1,2,2,3,0,0,0,1,1,4,2,0,1,4,8
401085956,Manhattan Jaspers,T. Reynolds,4398107,,False,17.0,1,5,1,1,0,4,0,0,0,2,2,0,1,0,1,1,2
401085956,Manhattan Jaspers,E. Ebube,4279705,,False,7.0,1,1,1,1,0,0,0,0,0,0,0,1,0,0,0,2,2
401085956,Manhattan Jaspers,W. Williams,4279701,,False,21.0,6,12,6,12,0,0,0,5,3,1,4,1,1,0,0,2,12
401085956,Manhattan Jaspers,I. Diallo,3149898,,False,9.0,3,4,3,4,0,0,0,0,1,1,2,0,0,1,1,1,6
401085956,Manhattan Jaspers,C. Hinckson,4398106,,False,18.0,1,6,1,4,0,2,1,2,1,1,2,1,2,1,1,2,3
401085956,Manhattan Jaspers,S. Stewart,4398104,,False,15.0,1,2,1,2,0,0,0,0,0,0,0,5,1,0,0,2,2
401085956,Manhattan Jaspers,E. Buchanan,4398103,,False,11.0,0,1,0,0,0,1,0,0,0,1,1,1,0,0,1,5,0
401085956,Manhattan Jaspers,E. Lasko,4277944,,False,1.0,0,0,0,0,0,0,0,0,1,0,1,0,0,0,2,0,0
401085956,Manhattan Jaspers,TEAM,TOTAL,TOTAL,False,,27,58,21,40,6,18,7,13,9,15,24,18,11,2,13,27,67
401085955,Stony Brook Seawolves,J. Otchere,4396585,,True,17.0,1,1,1,1,0,0,2,2,0,6,6,1,0,2,1,3,4
401085955,Stony Brook Seawolves,A. Yeboah,3913169,,True,35.0,4,10,3,6,1,4,16,20,2,5,7,2,0,0,1,2,25
401085955,Stony Brook Seawolves,M. Latimer,4396584,,True,32.0,3,5,0,0,3,5,4,5,1,2,3,1,0,0,2,0,13
401085955,Stony Brook Seawolves,E. Olaniyi,4278240,,True,23.0,1,6,0,5,1,1,0,0,2,4,6,2,1,2,1,2,3
401085955,Stony Brook Seawolves,J. Cornish,4278239,,True,39.0,3,8,3,6,0,2,4,6,0,2,2,1,0,0,5,3,10
401085955,Stony Brook Seawolves,A. Ochefu,4278243,,False,10.0,0,1,0,1,0,0,0,0,0,1,1,0,0,1,1,2,0
401085955,Stony Brook Seawolves,A. Christie,4396587,,False,2.0,0,1,0,1,0,0,0,0,1,0,1,0,0,0,0,0,0
401085955,Stony Brook Seawolves,J. Moor,4396583,,False,18.0,3,3,3,3,0,0,4,4,2,3,5,0,2,2,1,2,10
401085955,Stony Brook Seawolves,J. McKenzie,4278242,,False,7.0,0,3,0,2,0,1,0,0,0,0,0,0,0,0,1,3,0
401085955,Stony Brook Seawolves,C. Long,4278241,,False,2.0,0,0,0,0,0,0,0,0,0,0,0,0,0,0,1,0,0
401085955,Stony Brook Seawolves,A. Garcia,4066768,,False,15.0,0,4,0,2,0,2,4,4,3,0,3,0,0,0,0,4,4
401085955,Stony Brook Seawolves,TEAM,TOTAL,TOTAL,False,,15,42,10,27,5,15,34,41,12,26,38,7,3,7,14,21,69
401085955,Manhattan Jaspers,P. Paulicap,4279706,,True,27.0,7,14,7,14,0,0,10,11,4,6,10,0,1,5,1,4,24
401085955,Manhattan Jaspers,E. Ebube,4279705,,True,25.0,1,4,1,2,0,2,0,0,1,2,3,0,1,2,2,3,2
401085955,Manhattan Jaspers,T. Greene,4398108,,True,9.0,0,3,0,1,0,2,0,2,0,2,2,0,1,0,1,3,0
401085955,Manhattan Jaspers,N. Mack,4279703,,True,22.0,1,8,1,5,0,3,4,4,1,1,2,2,2,0,0,4,6
401085955,Manhattan Jaspers,T. Capuano,3948706,,True,24.0,2,5,2,2,0,3,0,0,1,1,2,1,0,0,0,1,4
401085955,Manhattan Jaspers,T. Reynolds,4398107,,False,31.0,2,6,0,1,2,5,0,0,0,2,2,0,1,0,1,2,6
401085955,Manhattan Jaspers,W. Williams,4279701,,False,13.0,4,6,4,6,0,0,2,3,1,0,1,1,0,0,1,1,10
401085955,Manhattan Jaspers,C. Hinckson,4398106,,False,14.0,1,4,1,4,0,0,1,2,2,1,3,1,1,0,0,5,3
401085955,Manhattan Jaspers,S. Stewart,4398104,,False,13.0,2,5,1,1,1,4,0,0,1,0,1,2,0,0,1,4,5
401085955,Manhattan Jaspers,E. Buchanan,4398103,,False,19.0,1,5,1,4,0,1,0,1,0,2,2,3,0,1,2,5,2
401085955,Manhattan Jaspers,S. Usilo,3138468,,False,3.0,0,0,0,0,0,0,0,0,0,1,1,0,0,0,0,0,0
401085955,Manhattan Jaspers,TEAM,TOTAL,TOTAL,False,,21,60,18,40,3,20,17,23,15,18,33,10,7,8,10,32,62
401085954,Manhattan Jaspers,P. Paulicap,4279706,,True,22.0,4,7,4,7,0,0,7,13,5,1,6,0,1,0,2,2,15
401085954,Manhattan Jaspers,E. Ebube,4279705,,True,28.0,3,9,3,6,0,3,1,2,5,5,10,0,1,0,2,1,7
401085954,Manhattan Jaspers,T. Greene,4398108,,True,18.0,0,4,0,3,0,1,0,0,0,2,2,0,0,0,3,3,0
401085954,Manhattan Jaspers,N. Mack,4279703,,True,31.0,3,4,1,1,2,3,0,0,0,1,1,4,0,0,1,2,8
401085954,Manhattan Jaspers,T. Capuano,3948706,,True,31.0,0,3,0,2,0,1,2,2,0,2,2,4,1,0,0,2,2
401085954,Manhattan Jaspers,T. Reynolds,4398107,,False,22.0,2,5,0,1,2,4,0,0,0,3,3,0,0,0,0,1,6
401085954,Manhattan Jaspers,D. Schreier,4398105,,False,1.0,0,0,0,0,0,0,0,0,0,0,0,0,0,0,0,0,0
401085954,Manhattan Jaspers,W. Williams,4279701,,False,18.0,5,7,5,7,0,0,0,4,1,0,1,0,1,0,2,2,10
401085954,Manhattan Jaspers,C. Hinckson,4398106,,False,11.0,0,2,0,2,0,0,0,0,0,5,5,0,1,0,2,2,0
401085954,Manhattan Jaspers,S. Stewart,4398104,,False,13.0,1,3,1,2,0,1,5,5,1,0,1,0,0,0,1,0,7
401085954,Manhattan Jaspers,E. Buchanan,4398103,,False,5.0,0,2,0,2,0,0,1,2,1,0,1,0,0,0,1,0,1
401085954,Manhattan Jaspers,TEAM,TOTAL,TOTAL,False,,18,46,14,33,4,13,16,28,15,21,36,8,5,0,15,15,56
401085954,Fordham Rams,I. Raut,4278492,,True,21.0,3,7,3,3,0,4,0,1,1,2,3,0,0,0,0,1,6
401085954,Fordham Rams,C. Ohams,4066856,,True,22.0,3,4,3,4,0,0,0,0,0,6,6,0,1,1,2,5,6
401085954,Fordham Rams,J. Bunting,3906466,,True,29.0,1,3,1,3,0,0,0,0,0,3,3,0,2,2,3,5,2
401085954,Fordham Rams,N. Honor,4396810,,True,38.0,4,10,3,6,1,4,4,4,0,2,2,1,2,0,2,2,13
401085954,Fordham Rams,A. Portley,3922045,,True,32.0,4,8,0,2,4,6,2,4,0,3,3,7,0,0,2,1,14
401085954,Fordham Rams,O. Eyisi,4396816,,False,6.0,0,0,0,0,0,0,0,0,0,0,0,0,0,0,0,5,0
401085954,Fordham Rams,D. Pekarek,3906467,,False,17.0,2,4,1,3,1,1,0,0,2,1,3,1,0,0,0,1,5
401085954,Fordham Rams,T. Perry,4396812,,False,3.0,0,2,0,2,0,0,0,0,1,1,2,0,0,0,0,0,0
401085954,Fordham Rams,C. Austin,4396811,,False,0.0,0,0,0,0,0,0,0,0,0,0,0,0,0,0,0,1,0
401085954,Fordham Rams,J. Cobb,4396809,,False,32.0,5,10,4,5,1,5,0,1,0,2,2,2,0,1,2,0,11
401085954,Fordham Rams,TEAM,TOTAL,TOTAL,False,,22,48,15,28,7,20,6,10,7,20,27,11,5,4,13,21,57
401085953,Manhattan Jaspers,E. Ebube,4279705,,True,0.0,3,4,2,3,1,1,2,4,5,5,10,0,1,0,3,0,9
401085953,Manhattan Jaspers,W. Williams,4279701,,True,0.0,1,5,1,5,0,0,2,2,0,3,3,1,0,0,2,3,4
401085953,Manhattan Jaspers,T. Greene,4398108,,True,0.0,2,8,2,6,0,2,0,0,2,0,2,1,0,0,2,3,4
401085953,Manhattan Jaspers,E. Buchanan,4398103,,True,0.0,3,10,3,8,0,2,0,3,2,3,5,2,5,0,4,4,6
401085953,Manhattan Jaspers,N. Mack,4279703,,True,0.0,0,3,0,0,0,3,0,0,0,1,1,1,1,0,0,2,0
401085953,Manhattan Jaspers,T. Reynolds,4398107,,False,0.0,0,2,0,0,0,2,0,0,0,0,0,0,1,0,1,1,0
401085953,Manhattan Jaspers,P. Paulicap,4279706,,False,0.0,0,2,0,2,0,0,0,0,0,0,0,0,1,0,2,2,0
401085953,Manhattan Jaspers,I. Diallo,3149898,,False,0.0,4,7,4,7,0,0,1,4,2,1,3,0,0,0,0,1,9
401085953,Manhattan Jaspers,S. Stewart,4398104,,False,0.0,1,6,0,2,1,4,2,2,0,0,0,3,1,0,1,3,5
401085953,Manhattan Jaspers,C. Hinckson,4398106,,False,0.0,3,5,3,4,0,1,0,0,4,0,4,1,1,1,2,2,6
401085953,Manhattan Jaspers,E. Lasko,4277944,,False,0.0,0,0,0,0,0,0,0,0,0,1,1,0,0,0,0,0,0
401085953,Manhattan Jaspers,T. Capuano,3948706,,False,0.0,0,3,0,0,0,3,0,0,0,0,0,1,2,0,2,0,0
401085953,Manhattan Jaspers,TEAM,TOTAL,TOTAL,False,,17,55,15,37,2,18,7,15,16,15,31,10,13,1,21,21,43
401085953,George Washington Revolutionaries,A. Toro,4066875,,True,0.0,4,5,4,4,0,1,3,5,2,11,13,1,1,2,1,2,11
401085953,George Washington Revolutionaries,T. Nolan Jr.,4278494,,True,0.0,4,6,1,1,3,5,0,0,0,3,3,4,1,1,4,3,11
401085953,George Washington Revolutionaries,J. Mazzulla,4278493,,True,0.0,3,5,3,4,0,1,2,3,1,2,3,4,2,0,2,3,8
401085953,George Washington Revolutionaries,A. Potter,3913163,,True,0.0,2,6,1,2,1,4,2,2,0,4,4,6,0,1,3,3,7
401085953,George Washington Revolutionaries,D.J. Williams,3911841,,True,0.0,6,10,6,10,0,0,4,6,1,2,3,1,1,1,1,2,16
401085953,George Washington Revolutionaries,M. Littles,4396838,,False,0.0,0,0,0,0,0,0,0,0,0,1,1,0,0,0,0,1,0
401085953,George Washington Revolutionaries,M. Offurum,4396837,,False,0.0,0,1,0,1,0,0,0,0,0,0,0,0,0,1,1,0,0
401085953,George Washington Revolutionaries,J. Langarica,4278497,,False,0.0,1,1,1,1,0,0,0,0,0,0,0,0,0,0,0,1,2
401085953,George Washington Revolutionaries,L. Sasser,4066970,,False,0.0,1,1,1,1,0,0,0,0,0,0,0,0,0,0,0,1,2
401085953,George Washington Revolutionaries,M. Elashari-Rashed,4396840,,False,0.0,0,0,0,0,0,0,2,2,0,0,0,1,1,0,1,0,2
401085953,George Washington Revolutionaries,S. Brown,4396836,,False,0.0,0,1,0,1,0,0,0,2,0,1,1,0,1,0,4,2,0
401085953,George Washington Revolutionaries,M. Jack,4278495,,False,0.0,1,5,0,1,1,4,0,0,1,1,2,0,1,1,3,1,3
401085953,George Washington Revolutionaries,A. Mitola,4066874,,False,0.0,0,1,0,0,0,1,0,0,0,0,0,0,0,0,1,0,0
401085953,George Washington Revolutionaries,J. Williams,4066873,,False,0.0,3,3,2,2,1,1,1,2,2,2,4,0,0,0,0,0,8
401085953,George Washington Revolutionaries,TEAM,TOTAL,TOTAL,False,,25,45,19,28,6,17,14,22,9,28,37,17,8,7,21,19,70
401085952,UNC Asheville Bulldogs,C. Jude,4397803,,True,29.0,1,6,0,2,1,4,2,3,4,3,7,1,2,0,3,5,5
401085952,UNC Asheville Bulldogs,J. Peck,4067230,,True,36.0,2,6,2,6,0,0,1,1,5,4,9,1,1,1,1,2,5
401085952,UNC Asheville Bulldogs,D. Baker,4397802,,True,31.0,6,17,6,13,0,4,6,6,2,0,2,0,2,0,3,3,18
401085952,UNC Asheville Bulldogs,C. Worthy,4397799,,True,36.0,0,2,0,1,0,1,0,0,2,2,4,1,1,0,3,4,0
401085952,UNC Asheville Bulldogs,T. Jones,4279052,,True,33.0,0,6,0,2,0,4,1,2,0,1,1,0,3,0,3,0,1
401085952,UNC Asheville Bulldogs,L. Lawson,4397801,,False,5.0,0,1,0,0,0,1,0,0,0,1,1,0,0,0,0,1,0
401085952,UNC Asheville Bulldogs,S. Edoka,4397800,,False,6.0,0,1,0,1,0,0,0,0,0,2,2,0,1,0,0,0,0
401085952,UNC Asheville Bulldogs,D. Gilmore,3129935,,False,4.0,0,2,0,2,0,0,0,0,0,1,1,0,0,0,0,0,0
401085952,UNC Asheville Bulldogs,J. Seegars,4279051,,False,20.0,2,3,1,2,1,1,4,6,1,1,2,0,2,1,1,3,9
401085952,UNC Asheville Bulldogs,TEAM,TOTAL,TOTAL,False,,11,44,9,29,2,15,14,18,17,16,33,3,12,2,20,18,38
401085952,Manhattan Jaspers,E. Ebube,4279705,,True,31.0,1,3,1,3,0,0,0,3,2,6,8,1,2,0,2,3,2
401085952,Manhattan Jaspers,W. Williams,4279701,,True,29.0,4,8,4,8,0,0,5,9,1,3,4,0,0,2,1,3,13
401085952,Manhattan Jaspers,T. Greene,4398108,,True,14.0,2,3,2,3,0,0,1,1,1,2,3,0,1,0,2,1,5
401085952,Manhattan Jaspers,E. Buchanan,4398103,,True,23.0,3,5,3,3,0,2,0,0,0,1,1,2,0,0,1,2,6
401085952,Manhattan Jaspers,N. Mack,4279703,,True,29.0,1,4,1,1,0,3,5,5,2,0,2,4,2,0,2,2,7
401085952,Manhattan Jaspers,T. Reynolds,4398107,,False,29.0,5,12,0,2,5,10,0,0,0,4,4,2,1,0,2,2,15
401085952,Manhattan Jaspers,I. Diallo,3149898,,False,4.0,0,0,0,0,0,0,0,0,0,0,0,0,0,0,1,1,0
401085952,Manhattan Jaspers,C. Hinckson,4398106,,False,10.0,0,0,0,0,0,0,0,0,0,0,0,1,0,0,1,2,0
401085952,Manhattan Jaspers,S. Stewart,4398104,,False,7.0,0,2,0,0,0,2,0,0,0,0,0,0,1,0,2,2,0
401085952,Manhattan Jaspers,E. Lasko,4277944,,False,2.0,0,0,0,0,0,0,0,0,0,0,0,0,0,0,1,0,0
401085952,Manhattan Jaspers,T. Capuano,3948706,,False,22.0,2,3,0,1,2,2,0,0,1,0,1,0,1,0,1,1,6
401085952,Manhattan Jaspers,TEAM,TOTAL,TOTAL,False,,18,40,11,21,7,19,11,18,9,17,26,10,8,2,17,19,54
401085951,Northern Kentucky Norse,D. Walton,4067446,,True,38.0,4,5,0,0,4,5,3,4,1,6,7,2,1,2,2,4,15
401085951,Northern Kentucky Norse,D. McDonald,3907639,,True,32.0,5,12,2,6,3,6,6,8,0,8,8,2,0,2,4,4,19
401085951,Northern Kentucky Norse,J. Tate,4067442,,True,35.0,0,4,0,4,0,0,2,5,0,6,6,4,1,0,4,3,2
401085951,Northern Kentucky Norse,B. Mocaby,4397776,,True,8.0,0,2,0,0,0,2,1,2,0,0,0,0,0,0,0,2,1
401085951,Northern Kentucky Norse,Z. Robinson,3154149,,True,25.0,1,2,1,2,0,0,2,2,0,1,1,4,0,0,2,2,4
401085951,Northern Kentucky Norse,C. Vogt,4279252,,False,17.0,2,4,2,4,0,0,3,9,5,3,8,0,1,4,1,1,7
401085951,Northern Kentucky Norse,T. Faulkner,4397774,,False,11.0,1,2,1,1,0,1,0,2,0,0,0,0,0,0,3,1,2
401085951,Northern Kentucky Norse,P. Djoko,4279251,,False,12.0,0,0,0,0,0,0,0,0,0,0,0,1,0,0,1,0,0
401085951,Northern Kentucky Norse,T. Sharpe,4065667,,False,22.0,3,6,0,1,3,5,0,0,0,2,2,1,2,0,1,4,9
401085951,Northern Kentucky Norse,TEAM,TOTAL,TOTAL,False,,16,37,6,18,10,19,17,32,6,26,32,14,5,8,18,21,59
401085951,Manhattan Jaspers,E. Ebube,4279705,,True,29.0,3,9,1,5,2,4,0,0,4,1,5,2,0,1,1,3,8
401085951,Manhattan Jaspers,W. Williams,4279701,,True,20.0,5,9,5,9,0,0,2,6,2,5,7,0,0,0,1,4,12
401085951,Manhattan Jaspers,T. Greene,4398108,,True,21.0,3,6,3,6,0,0,1,2,1,2,3,0,1,0,1,4,7
401085951,Manhattan Jaspers,E. Buchanan,4398103,,True,22.0,1,6,1,3,0,3,1,3,0,4,4,2,2,0,3,2,3
401085951,Manhattan Jaspers,N. Mack,4279703,,True,28.0,0,4,0,3,0,1,0,0,0,2,2,1,1,0,1,1,0
401085951,Manhattan Jaspers,T. Reynolds,4398107,,False,8.0,1,2,0,0,1,2,0,0,0,0,0,1,1,0,0,2,3
401085951,Manhattan Jaspers,D. Schreier,4398105,,False,2.0,0,0,0,0,0,0,0,0,0,0,0,0,0,0,1,1,0
401085951,Manhattan Jaspers,I. Diallo,3149898,,False,8.0,1,1,1,1,0,0,0,0,1,1,2,1,0,0,0,2,2
401085951,Manhattan Jaspers,C. Hinckson,4398106,,False,15.0,0,2,0,2,0,0,0,1,0,2,2,0,1,1,1,1,0
401085951,Manhattan Jaspers,S. Stewart,4398104,,False,15.0,1,3,0,0,1,3,4,4,0,0,0,1,0,0,1,1,7
401085951,Manhattan Jaspers,T. Capuano,3948706,,False,26.0,2,7,0,3,2,4,3,4,0,4,4,2,0,0,3,2,9
401085951,Manhattan Jaspers,S. Usilo,3138468,,False,6.0,1,3,1,2,0,1,0,0,0,1,1,0,0,0,0,1,2
401085951,Manhattan Jaspers,TEAM,TOTAL,TOTAL,False,,18,52,12,34,6,18,11,20,12,23,35,10,6,2,15,24,53
401085950,Manhattan Jaspers,W. Williams,4279701,,True,15.0,1,3,1,3,0,0,1,3,1,1,2,0,1,0,4,4,3
401085950,Manhattan Jaspers,T. Greene,4398108,,True,13.0,0,7,0,6,0,1,2,2,1,0,1,0,1,0,0,2,2
401085950,Manhattan Jaspers,E. Buchanan,4398103,,True,26.0,2,5,1,2,1,3,0,2,0,1,1,3,0,0,2,4,5
401085950,Manhattan Jaspers,N. Mack,4279703,,True,22.0,2,4,0,1,2,3,5,6,0,3,3,3,3,0,2,3,11
401085950,Manhattan Jaspers,S. Usilo,3138468,,True,13.0,0,2,0,2,0,0,1,2,0,2,2,0,0,1,1,2,1
401085950,Manhattan Jaspers,T. Reynolds,4398107,,False,21.0,4,8,0,1,4,7,0,0,0,3,3,0,0,0,1,2,12
401085950,Manhattan Jaspers,E. Ebube,4279705,,False,33.0,4,6,3,3,1,3,0,2,6,6,12,3,1,0,2,3,9
401085950,Manhattan Jaspers,I. Diallo,3149898,,False,4.0,0,0,0,0,0,0,0,0,0,0,0,0,0,0,1,0,0
401085950,Manhattan Jaspers,C. Hinckson,4398106,,False,8.0,1,1,1,1,0,0,0,3,0,2,2,0,0,0,2,5,2
401085950,Manhattan Jaspers,S. Stewart,4398104,,False,18.0,1,3,0,0,1,3,0,0,0,2,2,2,0,0,2,1,3
401085950,Manhattan Jaspers,E. Lasko,4277944,,False,1.0,0,0,0,0,0,0,0,0,0,0,0,0,0,0,0,0,0
401085950,Manhattan Jaspers,T. Capuano,3948706,,False,26.0,1,2,0,1,1,1,4,8,0,3,3,1,2,0,1,2,7
401085950,Manhattan Jaspers,TEAM,TOTAL,TOTAL,False,,16,41,6,20,10,21,13,28,10,26,36,12,8,1,19,28,55
401085950,Coastal Carolina Chanticleers,Z. Cuthbertson,4280149,,True,30.0,1,6,1,5,0,1,10,13,1,8,9,3,2,1,4,3,12
401085950,Coastal Carolina Chanticleers,A. Bamba,4067318,,True,26.0,1,5,1,5,0,0,1,3,5,5,10,0,1,0,1,4,3
401085950,Coastal Carolina Chanticleers,D. Pierce,4397505,,True,24.0,1,6,0,2,1,4,4,9,0,1,1,1,1,0,0,3,7
401085950,Coastal Carolina Chanticleers,E. Dibba,4397504,,True,37.0,3,5,2,3,1,2,1,2,0,5,5,3,1,0,5,1,8
401085950,Coastal Carolina Chanticleers,A. Sanders,4280146,,True,14.0,0,3,0,2,0,1,1,2,0,1,1,1,0,0,0,1,1
401085950,Coastal Carolina Chanticleers,T. Burton,4397510,,False,14.0,2,3,2,3,0,0,1,3,1,4,5,0,1,0,1,3,5
401085950,Coastal Carolina Chanticleers,I. Hippolyte,4397509,,False,2.0,0,1,0,1,0,0,0,0,0,0,0,0,0,0,0,0,0
401085950,Coastal Carolina Chanticleers,D. Kralj,4397508,,False,19.0,2,4,1,3,1,1,0,0,1,2,3,2,0,0,2,2,5
401085950,Coastal Carolina Chanticleers,T. Gumbs-Frater,4284123,,False,11.0,1,3,1,1,0,2,0,0,0,0,0,0,0,0,1,4,2
401085950,Coastal Carolina Chanticleers,T. Brown,4280145,,False,23.0,3,6,0,1,3,5,1,2,0,0,0,0,2,0,1,3,10
401085950,Coastal Carolina Chanticleers,TEAM,TOTAL,TOTAL,False,,14,42,8,26,6,16,19,34,9,26,35,10,8,1,16,24,53
401085949,UMBC Retrievers,M. Curran,4066773,,True,28.0,3,6,3,4,0,2,1,2,1,3,4,2,2,0,4,4,7
401085949,UMBC Retrievers,A. Lamar,4066775,,True,28.0,5,7,2,3,3,4,2,2,1,2,3,1,5,0,0,1,15
401085949,UMBC Retrievers,J. Sherburne,3904749,,True,32.0,5,11,3,6,2,5,1,2,2,3,5,4,1,0,2,0,13
401085949,UMBC Retrievers,K.J. Jackson,4396589,,True,36.0,7,10,3,3,4,7,2,2,0,7,7,7,0,0,5,2,20
401085949,UMBC Retrievers,R. Council II,3913216,,True,15.0,3,8,0,1,3,7,0,0,2,1,3,0,0,0,0,0,9
401085949,UMBC Retrievers,B. Horvath,4279162,,False,26.0,3,8,2,6,1,2,4,5,1,5,6,2,2,0,2,3,11
401085949,UMBC Retrievers,S. Schwietz,3904748,,False,10.0,0,0,0,0,0,0,0,0,2,1,3,1,0,0,0,2,0
401085949,UMBC Retrievers,J. Placer,4396592,,False,10.0,0,1,0,0,0,1,0,0,0,0,0,2,0,0,2,0,0
401085949,UMBC Retrievers,R. Eytle-Rock,4396591,,False,15.0,0,2,0,1,0,1,0,0,0,0,0,0,0,1,1,1,0
401085949,UMBC Retrievers,J. Schwietz,4396590,,False,0.0,0,0,0,0,0,0,0,0,0,0,0,0,0,0,0,0,0
401085949,UMBC Retrievers,I. Rogers,4284136,,False,0.0,0,0,0,0,0,0,0,0,0,0,0,0,0,0,0,0,0
401085949,UMBC Retrievers,J. Rosario,4279161,,False,0.0,0,0,0,0,0,0,0,0,0,0,0,0,0,0,0,0,0
401085949,UMBC Retrievers,TEAM,TOTAL,TOTAL,False,,26,53,13,24,13,29,10,13,10,25,35,19,10,1,18,13,75
401085949,Manhattan Jaspers,T. Reynolds,4398107,,True,16.0,2,5,0,0,2,5,0,0,0,1,1,0,0,0,2,0,6
401085949,Manhattan Jaspers,D. Schreier,4398105,,True,13.0,0,2,0,0,0,2,0,0,0,0,0,1,0,0,1,2,0
401085949,Manhattan Jaspers,T. Greene,4398108,,True,23.0,2,4,1,2,1,2,0,0,0,2,2,0,2,0,3,2,5
401085949,Manhattan Jaspers,N. Mack,4279703,,True,16.0,0,3,0,1,0,2,1,2,0,2,2,2,1,0,2,3,1
401085949,Manhattan Jaspers,S. Usilo,3138468,,True,23.0,3,4,3,3,0,1,1,4,1,6,7,0,1,0,0,2,7
401085949,Manhattan Jaspers,E. Ebube,4279705,,False,13.0,1,3,1,2,0,1,0,0,1,0,1,1,0,0,0,1,2
401085949,Manhattan Jaspers,W. Williams,4279701,,False,24.0,3,5,3,5,0,0,0,1,1,2,3,2,0,1,3,2,6
401085949,Manhattan Jaspers,I. Diallo,3149898,,False,7.0,0,0,0,0,0,0,1,2,2,0,2,0,0,0,1,1,1
401085949,Manhattan Jaspers,C. Hinckson,4398106,,False,2.0,0,1,0,0,0,1,0,0,0,0,0,0,0,0,0,0,0
401085949,Manhattan Jaspers,S. Stewart,4398104,,False,19.0,2,5,1,3,1,2,0,0,0,0,0,1,1,0,4,4,5
401085949,Manhattan Jaspers,E. Buchanan,4398103,,False,22.0,4,10,2,5,2,5,0,0,1,3,4,3,1,1,2,2,10
401085949,Manhattan Jaspers,E. Lasko,4277944,,False,2.0,0,0,0,0,0,0,0,0,0,1,1,0,0,0,0,0,0
401085949,Manhattan Jaspers,T. Capuano,3948706,,False,20.0,3,7,0,1,3,6,0,0,0,2,2,0,1,0,3,2,9
401085949,Manhattan Jaspers,TEAM,TOTAL,TOTAL,False,,20,49,11,22,9,27,3,9,8,19,27,10,7,2,22,21,52
401085948,New Mexico Lobos,K. Ezzeddine,4397359,,True,16.0,2,5,2,4,0,1,2,2,2,1,3,1,0,0,3,4,6
401085948,New Mexico Lobos,V. Jackson,4066442,,True,28.0,5,10,2,2,3,8,5,8,2,10,12,3,1,0,3,2,18
401085948,New Mexico Lobos,V. Pinchuk,4278701,,True,30.0,4,4,4,4,0,0,2,7,2,5,7,3,1,2,4,2,10
401085948,New Mexico Lobos,K. McGee,4397356,,True,23.0,3,5,0,0,3,5,4,4,0,0,0,2,1,0,2,3,13
401085948,New Mexico Lobos,A. Mathis,3906578,,True,24.0,5,10,1,2,4,8,0,0,0,1,1,1,0,0,5,4,14
401085948,New Mexico Lobos,J. Arroyo,4397360,,False,4.0,0,0,0,0,0,0,0,0,0,0,0,0,0,0,0,0,0
401085948,New Mexico Lobos,C. Manigault,4065714,,False,25.0,5,8,5,8,0,0,8,11,2,7,9,3,2,1,1,2,18
401085948,New Mexico Lobos,D. Kuiper,3906577,,False,27.0,2,6,1,2,1,4,0,0,0,2,2,3,1,1,0,3,5
401085948,New Mexico Lobos,M. Maluach,4278699,,False,21.0,1,5,0,1,1,4,3,6,0,3,3,2,1,1,0,2,6
401085948,New Mexico Lobos,D. Drinnon,4397358,,False,1.0,0,0,0,0,0,0,0,0,0,0,0,1,0,0,1,0,0
401085948,New Mexico Lobos,T. Percy,4397357,,False,1.0,0,0,0,0,0,0,0,0,0,0,0,0,0,0,0,0,0
401085948,New Mexico Lobos,TEAM,TOTAL,TOTAL,False,,27,53,15,23,12,30,24,38,9,32,41,19,7,5,20,22,90
401085948,Iona Gaels,T. Agee,4398087,,True,13.0,0,1,0,0,0,1,2,2,2,2,4,0,1,1,1,5,2
401085948,Iona Gaels,E.J. Crawford,4067295,,True,30.0,3,7,3,7,0,0,10,14,1,2,3,1,0,0,2,3,16
401085948,Iona Gaels,A. Gist,4067164,,True,30.0,6,13,3,5,3,8,4,6,0,3,3,3,1,0,2,4,19
401085948,Iona Gaels,R. McGill,3948698,,True,36.0,2,7,2,5,0,2,7,8,0,4,4,8,1,0,4,4,11
401085948,Iona Gaels,I. Still,3938908,,True,30.0,5,15,3,8,2,7,3,6,3,5,8,1,5,1,3,4,15
401085948,Iona Gaels,N. Nikolic,4398090,,False,11.0,1,3,1,3,0,0,0,0,3,0,3,0,1,1,0,1,2
401085948,Iona Gaels,J. Maxwell,4398088,,False,15.0,3,5,3,3,0,2,0,0,0,1,1,1,3,0,0,3,6
401085948,Iona Gaels,A. Ristanovic,4279492,,False,9.0,0,0,0,0,0,0,0,0,0,2,2,0,0,0,0,2,0
401085948,Iona Gaels,P. Hudson,4398089,,False,2.0,0,0,0,0,0,0,0,0,0,0,0,0,0,0,1,0,0
401085948,Iona Gaels,B. Perez,3948791,,False,24.0,4,9,0,3,4,6,0,0,0,0,0,1,0,0,1,3,12
401085948,Iona Gaels,TEAM,TOTAL,TOTAL,False,,24,60,15,34,9,26,26,36,11,23,34,15,12,3,15,29,83
401085947,UAlbany Great Danes,A. Lulka,4278204,,True,27.0,3,4,3,3,0,1,2,2,1,5,6,2,0,0,3,4,8
401085947,UAlbany Great Danes,D. Campbell,4066683,,True,38.0,4,13,3,10,1,3,8,9,4,6,10,2,0,0,0,3,17
401085947,UAlbany Great Danes,B. Hank,4278202,,True,15.0,0,1,0,1,0,0,0,0,1,1,2,1,0,0,3,2,0
401085947,UAlbany Great Danes,C. Healy,4278203,,True,33.0,4,11,0,4,4,7,2,2,1,3,4,1,0,0,5,2,14
401085947,UAlbany Great Danes,A. Clark,4278199,,True,27.0,8,14,3,7,5,7,0,0,2,3,5,1,0,0,3,5,21
401085947,UAlbany Great Danes,K. Lauderdale,4395878,,False,8.0,0,0,0,0,0,0,0,0,0,0,0,0,0,0,2,1,0
401085947,UAlbany Great Danes,M. De Sousa,4395874,,False,4.0,0,2,0,1,0,1,0,0,0,2,2,1,0,0,0,0,0
401085947,UAlbany Great Danes,S. French,4066754,,False,12.0,1,4,1,4,0,0,0,0,2,1,3,0,0,0,2,1,2
401085947,UAlbany Great Danes,R. Brooks,4395875,,False,16.0,0,6,0,2,0,4,3,3,1,0,1,1,0,0,2,1,3
401085947,UAlbany Great Danes,R. Miller,3961485,,False,20.0,1,3,0,2,1,1,0,0,0,4,4,1,0,0,2,1,3
401085947,UAlbany Great Danes,TEAM,TOTAL,TOTAL,False,,21,58,10,34,11,24,15,16,13,26,39,10,0,0,22,20,68
401085947,Iona Gaels,T. Agee,4398087,,True,21.0,3,7,3,6,0,1,4,5,2,4,6,1,3,0,2,3,10
401085947,Iona Gaels,E.J. Crawford,4067295,,True,32.0,5,11,5,9,0,2,4,5,2,3,5,0,1,0,3,2,14
401085947,Iona Gaels,A. Gist,4067164,,True,19.0,1,6,1,3,0,3,1,1,0,1,1,2,1,0,1,1,3
401085947,Iona Gaels,R. McGill,3948698,,True,37.0,3,6,1,2,2,4,4,6,1,1,2,9,2,0,2,1,12
401085947,Iona Gaels,I. Still,3938908,,True,31.0,3,8,3,4,0,4,3,8,1,7,8,2,2,1,2,2,9
401085947,Iona Gaels,N. Nikolic,4398090,,False,15.0,4,4,4,4,0,0,0,0,0,0,0,1,0,0,1,3,8
401085947,Iona Gaels,J. Maxwell,4398088,,False,4.0,0,2,0,1,0,1,0,0,1,0,1,0,1,0,0,0,0
401085947,Iona Gaels,A. Ristanovic,4279492,,False,17.0,2,4,0,0,2,4,0,0,1,2,3,1,2,1,2,3,6
401085947,Iona Gaels,B. Perez,3948791,,False,24.0,4,9,2,3,2,6,0,0,0,3,3,0,0,0,0,1,10
401085947,Iona Gaels,TEAM,TOTAL,TOTAL,False,,25,57,19,32,6,25,16,25,10,24,34,16,12,2,13,16,72
401085946,Rider Broncs,K. Cisse,4279746,,True,8.0,1,1,1,1,0,0,1,3,0,2,2,0,0,1,1,1,3
401085946,Rider Broncs,F. Scott,3922033,,True,31.0,7,14,6,11,1,3,2,3,2,10,12,4,1,1,3,3,17
401085946,Rider Broncs,S. Jordan,4067349,,True,36.0,7,13,5,9,2,4,0,0,3,3,6,10,3,0,3,4,16
401085946,Rider Broncs,K. Williams,3946983,,True,11.0,1,4,1,3,0,1,0,0,3,2,5,0,0,0,2,2,2
401085946,Rider Broncs,A. Durham,3138490,,True,33.0,5,9,3,6,2,3,0,0,0,2,2,4,0,0,1,1,12
401085946,Rider Broncs,D. Eke,3941312,,False,13.0,5,6,4,5,1,1,0,2,2,1,3,0,1,0,1,3,11
401085946,Rider Broncs,D. Vaughn,4067347,,False,25.0,2,7,1,4,1,3,1,2,0,6,6,4,1,0,2,2,6
401085946,Rider Broncs,T. Marshall,4067348,,False,21.0,1,6,1,6,0,0,1,2,1,2,3,2,0,0,1,4,3
401085946,Rider Broncs,J. Allen,4067345,,False,19.0,3,12,0,4,3,8,0,0,2,0,2,0,1,1,1,2,9
401085946,Rider Broncs,A. Gilbert,3911886,,False,3.0,0,1,0,0,0,1,0,0,0,0,0,0,0,0,1,0,0
401085946,Rider Broncs,TEAM,TOTAL,TOTAL,False,,32,73,22,49,10,24,5,12,14,28,42,24,7,3,16,22,79
401085946,Rider Broncs,K. Cisse,4279746,,True,8.0,1,1,1,1,0,0,1,3,0,2,2,0,0,1,1,1,3
401085946,Rider Broncs,F. Scott,3922033,,True,31.0,7,14,6,11,1,3,2,3,2,10,12,4,1,1,3,3,17
401085946,Rider Broncs,S. Jordan,4067349,,True,36.0,7,13,5,9,2,4,0,0,3,3,6,10,3,0,3,4,16
401085946,Rider Broncs,K. Williams,3946983,,True,11.0,1,4,1,3,0,1,0,0,3,2,5,0,0,0,2,2,2
401085946,Rider Broncs,A. Durham,3138490,,True,33.0,5,9,3,6,2,3,0,0,0,2,2,4,0,0,1,1,12
401085946,Rider Broncs,D. Eke,3941312,,False,13.0,5,6,4,5,1,1,0,2,2,1,3,0,1,0,1,3,11
401085946,Rider Broncs,D. Vaughn,4067347,,False,25.0,2,7,1,4,1,3,1,2,0,6,6,4,1,0,2,2,6
401085946,Rider Broncs,T. Marshall,4067348,,False,21.0,1,6,1,6,0,0,1,2,1,2,3,2,0,0,1,4,3
401085946,Rider Broncs,J. Allen,4067345,,False,19.0,3,12,0,4,3,8,0,0,2,0,2,0,1,1,1,2,9
401085946,Rider Broncs,A. Gilbert,3911886,,False,3.0,0,1,0,0,0,1,0,0,0,0,0,0,0,0,1,0,0
401085946,Rider Broncs,TEAM,TOTAL,TOTAL,False,,32,73,22,49,10,24,5,12,14,28,42,24,7,3,16,22,79
401085946,Iona Gaels,T. Agee,4398087,,True,35.0,6,10,5,7,1,3,0,1,2,6,8,2,0,2,3,3,13
401085946,Iona Gaels,E.J. Crawford,4067295,,True,38.0,8,16,6,11,2,5,3,6,2,6,8,1,1,1,1,2,21
401085946,Iona Gaels,A. Gist,4067164,,True,32.0,5,9,1,3,4,6,8,9,1,2,3,4,1,0,4,3,22
401085946,Iona Gaels,B. Perez,3948791,,True,38.0,3,6,0,0,3,6,0,2,1,5,6,2,0,1,1,2,9
401085946,Iona Gaels,R. McGill,3948698,,True,38.0,4,13,3,6,1,7,5,7,1,6,7,6,2,0,3,1,14
401085946,Iona Gaels,J. Maxwell,4398088,,False,16.0,3,6,2,3,1,3,0,1,0,4,4,2,0,0,2,3,7
401085946,Iona Gaels,A. Ristanovic,4279492,,False,3.0,0,0,0,0,0,0,0,0,0,0,0,0,0,0,0,2,0
401085946,Iona Gaels,TEAM,TOTAL,TOTAL,False,,29,60,17,30,12,30,16,26,8,32,40,17,4,4,14,16,86
401085946,Iona Gaels,T. Agee,4398087,,True,35.0,6,10,5,7,1,3,0,1,2,6,8,2,0,2,3,3,13
401085946,Iona Gaels,E.J. Crawford,4067295,,True,38.0,8,16,6,11,2,5,3,6,2,6,8,1,1,1,1,2,21
401085946,Iona Gaels,A. Gist,4067164,,True,32.0,5,9,1,3,4,6,8,9,1,2,3,4,1,0,4,3,22
401085946,Iona Gaels,B. Perez,3948791,,True,38.0,3,6,0,0,3,6,0,2,1,5,6,2,0,1,1,2,9
401085946,Iona Gaels,R. McGill,3948698,,True,38.0,4,13,3,6,1,7,5,7,1,6,7,6,2,0,3,1,14
401085946,Iona Gaels,J. Maxwell,4398088,,False,16.0,3,6,2,3,1,3,0,1,0,4,4,2,0,0,2,3,7
401085946,Iona Gaels,A. Ristanovic,4279492,,False,3.0,0,0,0,0,0,0,0,0,0,0,0,0,0,0,0,2,0
401085946,Iona Gaels,TEAM,TOTAL,TOTAL,False,,29,60,17,30,12,30,16,26,8,32,40,17,4,4,14,16,86
401085945,Manhattan Jaspers,W. Williams,4279701,,True,22.0,5,7,5,7,0,0,0,1,2,5,7,2,0,4,3,3,10
401085945,Manhattan Jaspers,T. Greene,4398108,,True,32.0,6,12,2,3,4,9,0,0,0,2,2,1,2,1,3,0,16
401085945,Manhattan Jaspers,C. Hinckson,4398106,,True,17.0,1,5,1,3,0,2,0,0,2,3,5,1,1,0,1,2,2
401085945,Manhattan Jaspers,S. Stewart,4398104,,True,26.0,1,9,0,0,1,9,0,0,0,0,0,6,1,0,2,1,3
401085945,Manhattan Jaspers,N. Mack,4279703,,True,30.0,3,5,1,3,2,2,0,0,0,0,0,1,0,0,3,5,8
401085945,Manhattan Jaspers,D. Schreier,4398105,,False,4.0,0,0,0,0,0,0,0,0,0,0,0,0,0,0,0,1,0
401085945,Manhattan Jaspers,E. Ebube,4279705,,False,28.0,4,8,2,4,2,4,2,2,6,4,10,0,3,0,0,2,12
401085945,Manhattan Jaspers,E. Buchanan,4398103,,False,14.0,0,4,0,2,0,2,1,2,0,4,4,0,0,1,1,2,1
401085945,Manhattan Jaspers,E. Lasko,4277944,,False,1.0,0,0,0,0,0,0,0,0,0,0,0,0,0,0,0,0,0
401085945,Manhattan Jaspers,T. Capuano,3948706,,False,16.0,0,4,0,0,0,4,0,0,0,1,1,1,0,0,0,1,0
401085945,Manhattan Jaspers,S. Usilo,3138468,,False,10.0,0,2,0,2,0,0,0,4,1,3,4,0,0,0,0,1,0
401085945,Manhattan Jaspers,TEAM,TOTAL,TOTAL,False,,20,56,11,24,9,32,3,9,12,23,35,12,7,6,14,18,52
401085945,Manhattan Jaspers,W. Williams,4279701,,True,22.0,5,7,5,7,0,0,0,1,2,5,7,2,0,4,3,3,10
401085945,Manhattan Jaspers,T. Greene,4398108,,True,32.0,6,12,2,3,4,9,0,0,0,2,2,1,2,1,3,0,16
401085945,Manhattan Jaspers,C. Hinckson,4398106,,True,17.0,1,5,1,3,0,2,0,0,2,3,5,1,1,0,1,2,2
401085945,Manhattan Jaspers,S. Stewart,4398104,,True,26.0,1,9,0,0,1,9,0,0,0,0,0,6,1,0,2,1,3
401085945,Manhattan Jaspers,N. Mack,4279703,,True,30.0,3,5,1,3,2,2,0,0,0,0,0,1,0,0,3,5,8
401085945,Manhattan Jaspers,D. Schreier,4398105,,False,4.0,0,0,0,0,0,0,0,0,0,0,0,0,0,0,0,1,0
401085945,Manhattan Jaspers,E. Ebube,4279705,,False,28.0,4,8,2,4,2,4,2,2,6,4,10,0,3,0,0,2,12
401085945,Manhattan Jaspers,E. Buchanan,4398103,,False,14.0,0,4,0,2,0,2,1,2,0,4,4,0,0,1,1,2,1
401085945,Manhattan Jaspers,E. Lasko,4277944,,False,1.0,0,0,0,0,0,0,0,0,0,0,0,0,0,0,0,0,0
401085945,Manhattan Jaspers,T. Capuano,3948706,,False,16.0,0,4,0,0,0,4,0,0,0,1,1,1,0,0,0,1,0
401085945,Manhattan Jaspers,S. Usilo,3138468,,False,10.0,0,2,0,2,0,0,0,4,1,3,4,0,0,0,0,1,0
401085945,Manhattan Jaspers,TEAM,TOTAL,TOTAL,False,,20,56,11,24,9,32,3,9,12,23,35,12,7,6,14,18,52
401085945,Iona Gaels,T. Agee,4398087,,True,32.0,2,8,1,7,1,1,4,4,5,3,8,1,2,0,6,4,9
401085945,Iona Gaels,E.J. Crawford,4067295,,True,40.0,4,8,2,3,2,5,6,6,0,3,3,0,2,0,2,1,16
401085945,Iona Gaels,A. Gist,4067164,,True,28.0,2,11,0,3,2,8,0,2,0,5,5,3,1,0,0,0,6
401085945,Iona Gaels,B. Perez,3948791,,True,37.0,4,9,0,0,4,9,1,3,2,6,8,1,1,0,0,1,13
401085945,Iona Gaels,R. McGill,3948698,,True,39.0,5,13,2,6,3,7,0,0,2,0,2,4,2,0,2,2,13
401085945,Iona Gaels,J. Maxwell,4398088,,False,8.0,0,1,0,0,0,1,0,0,0,1,1,1,0,0,0,1,0
401085945,Iona Gaels,A. Ristanovic,4279492,,False,16.0,4,4,3,3,1,1,0,1,1,5,6,0,0,1,1,3,9
401085945,Iona Gaels,TEAM,TOTAL,TOTAL,False,,21,54,8,22,13,32,11,16,12,28,40,10,8,1,13,12,66
401085945,Iona Gaels,T. Agee,4398087,,True,32.0,2,8,1,7,1,1,4,4,5,3,8,1,2,0,6,4,9
401085945,Iona Gaels,E.J. Crawford,4067295,,True,40.0,4,8,2,3,2,5,6,6,0,3,3,0,2,0,2,1,16
401085945,Iona Gaels,A. Gist,4067164,,True,28.0,2,11,0,3,2,8,0,2,0,5,5,3,1,0,0,0,6
401085945,Iona Gaels,B. Perez,3948791,,True,37.0,4,9,0,0,4,9,1,3,2,6,8,1,1,0,0,1,13
401085945,Iona Gaels,R. McGill,3948698,,True,39.0,5,13,2,6,3,7,0,0,2,0,2,4,2,0,2,2,13
401085945,Iona Gaels,J. Maxwell,4398088,,False,8.0,0,1,0,0,0,1,0,0,0,1,1,1,0,0,0,1,0
401085945,Iona Gaels,A. Ristanovic,4279492,,False,16.0,4,4,3,3,1,1,0,1,1,5,6,0,0,1,1,3,9
401085945,Iona Gaels,TEAM,TOTAL,TOTAL,False,,21,54,8,22,13,32,11,16,12,28,40,10,8,1,13,12,66
401085944,Saint Peter's Peacocks,S. Idowu,3922042,,True,26.0,5,10,4,9,1,1,1,3,3,2,5,1,1,5,1,2,12
401085944,Saint Peter's Peacocks,Q. Taylor,4067357,,True,32.0,2,6,0,3,2,3,0,0,1,8,9,0,0,0,0,1,6
401085944,Saint Peter's Peacocks,D. Watson,4398384,,True,32.0,1,7,1,5,0,2,0,0,0,3,3,5,0,0,4,1,2
401085944,Saint Peter's Peacocks,M. Dixon,4279758,,True,30.0,3,7,2,4,1,3,0,0,0,2,2,0,0,0,1,1,7
401085944,Saint Peter's Peacocks,D. Turner,4067356,,True,34.0,4,15,1,6,3,9,0,0,2,4,6,3,0,1,4,1,11
401085944,Saint Peter's Peacocks,KC Ndefo,4398386,,False,21.0,1,5,1,5,0,0,1,2,0,2,2,0,0,3,1,4,3
401085944,Saint Peter's Peacocks,D. Woods,3919424,,False,6.0,1,1,1,1,0,0,0,2,0,2,2,0,0,0,2,0,2
401085944,Saint Peter's Peacocks,M. Majak,4398387,,False,8.0,0,0,0,0,0,0,0,0,0,0,0,0,1,1,0,0,0
401085944,Saint Peter's Peacocks,C. Underwood,4398388,,False,1.0,0,0,0,0,0,0,0,0,0,0,0,0,0,0,0,0,0
401085944,Saint Peter's Peacocks,A. Hicks,4284295,,False,10.0,1,2,0,0,1,2,0,0,0,1,1,0,0,0,0,0,3
401085944,Saint Peter's Peacocks,TEAM,TOTAL,TOTAL,False,,18,53,10,33,8,20,2,7,9,25,34,9,2,10,13,10,46
401085944,Saint Peter's Peacocks,S. Idowu,3922042,,True,26.0,5,10,4,9,1,1,1,3,3,2,5,1,1,5,1,2,12
401085944,Saint Peter's Peacocks,Q. Taylor,4067357,,True,32.0,2,6,0,3,2,3,0,0,1,8,9,0,0,0,0,1,6
401085944,Saint Peter's Peacocks,D. Watson,4398384,,True,32.0,1,7,1,5,0,2,0,0,0,3,3,5,0,0,4,1,2
401085944,Saint Peter's Peacocks,M. Dixon,4279758,,True,30.0,3,7,2,4,1,3,0,0,0,2,2,0,0,0,1,1,7
401085944,Saint Peter's Peacocks,D. Turner,4067356,,True,34.0,4,15,1,6,3,9,0,0,2,4,6,3,0,1,4,1,11
401085944,Saint Peter's Peacocks,KC Ndefo,4398386,,False,21.0,1,5,1,5,0,0,1,2,0,2,2,0,0,3,1,4,3
401085944,Saint Peter's Peacocks,D. Woods,3919424,,False,6.0,1,1,1,1,0,0,0,2,0,2,2,0,0,0,2,0,2
401085944,Saint Peter's Peacocks,M. Majak,4398387,,False,8.0,0,0,0,0,0,0,0,0,0,0,0,0,1,1,0,0,0
401085944,Saint Peter's Peacocks,C. Underwood,4398388,,False,1.0,0,0,0,0,0,0,0,0,0,0,0,0,0,0,0,0,0
401085944,Saint Peter's Peacocks,A. Hicks,4284295,,False,10.0,1,2,0,0,1,2,0,0,0,1,1,0,0,0,0,0,3
401085944,Saint Peter's Peacocks,TEAM,TOTAL,TOTAL,False,,18,53,10,33,8,20,2,7,9,25,34,9,2,10,13,10,46
401085944,Iona Gaels,T. Agee,4398087,,True,29.0,2,13,2,10,0,3,2,2,4,9,13,3,1,0,3,4,6
401085944,Iona Gaels,E.J. Crawford,4067295,,True,37.0,5,11,0,6,5,5,2,2,1,0,1,1,0,0,2,2,17
401085944,Iona Gaels,A. Gist,4067164,,True,38.0,7,15,4,7,3,8,0,0,3,1,4,3,1,0,1,0,17
401085944,Iona Gaels,B. Perez,3948791,,True,22.0,1,2,0,0,1,2,0,0,0,6,6,1,0,1,0,0,3
401085944,Iona Gaels,R. McGill,3948698,,True,39.0,5,13,5,9,0,4,3,4,0,5,5,7,3,2,1,2,13
401085944,Iona Gaels,N. Nikolic,4398090,,False,19.0,3,4,3,4,0,0,0,0,2,1,3,0,2,2,1,1,6
401085944,Iona Gaels,J. Maxwell,4398088,,False,4.0,0,1,0,0,0,1,0,0,0,3,3,0,0,1,1,0,0
401085944,Iona Gaels,A. Ristanovic,4279492,,False,4.0,0,1,0,0,0,1,0,0,0,1,1,0,0,0,0,1,0
401085944,Iona Gaels,M. Rhem,4404249,,False,1.0,0,0,0,0,0,0,0,0,0,0,0,0,0,0,0,0,0
401085944,Iona Gaels,P. Hudson,4398089,,False,7.0,0,0,0,0,0,0,0,0,0,0,0,1,1,0,0,1,0
401085944,Iona Gaels,TEAM,TOTAL,TOTAL,False,,23,60,14,36,9,24,7,8,13,28,41,16,8,6,9,11,62
401085944,Iona Gaels,T. Agee,4398087,,True,29.0,2,13,2,10,0,3,2,2,4,9,13,3,1,0,3,4,6
401085944,Iona Gaels,E.J. Crawford,4067295,,True,37.0,5,11,0,6,5,5,2,2,1,0,1,1,0,0,2,2,17
401085944,Iona Gaels,A. Gist,4067164,,True,38.0,7,15,4,7,3,8,0,0,3,1,4,3,1,0,1,0,17
401085944,Iona Gaels,B. Perez,3948791,,True,22.0,1,2,0,0,1,2,0,0,0,6,6,1,0,1,0,0,3
401085944,Iona Gaels,R. McGill,3948698,,True,39.0,5,13,5,9,0,4,3,4,0,5,5,7,3,2,1,2,13
401085944,Iona Gaels,N. Nikolic,4398090,,False,19.0,3,4,3,4,0,0,0,0,2,1,3,0,2,2,1,1,6
401085944,Iona Gaels,J. Maxwell,4398088,,False,4.0,0,1,0,0,0,1,0,0,0,3,3,0,0,1,1,0,0
401085944,Iona Gaels,A. Ristanovic,4279492,,False,4.0,0,1,0,0,0,1,0,0,0,1,1,0,0,0,0,1,0
401085944,Iona Gaels,M. Rhem,4404249,,False,1.0,0,0,0,0,0,0,0,0,0,0,0,0,0,0,0,0,0
401085944,Iona Gaels,P. Hudson,4398089,,False,7.0,0,0,0,0,0,0,0,0,0,0,0,1,1,0,0,1,0
401085944,Iona Gaels,TEAM,TOTAL,TOTAL,False,,23,60,14,36,9,24,7,8,13,28,41,16,8,6,9,11,62
401085943,Siena Saints,S. Seymour,4398391,,True,28.0,4,10,0,0,4,10,0,0,0,0,0,0,0,0,0,0,12
401085943,Siena Saints,E. Fisher,3913235,,True,34.0,7,18,7,16,0,2,3,4,1,3,4,1,1,1,2,2,17
401085943,Siena Saints,K. Degnan,3138282,,True,36.0,2,8,1,5,1,3,0,0,2,6,8,1,3,0,1,3,5
401085943,Siena Saints,J. Pickett,4398390,,True,38.0,4,10,2,3,2,7,0,0,0,5,5,4,4,3,3,1,10
401085943,Siena Saints,M. Camper,4279751,,True,25.0,2,3,2,2,0,1,0,0,3,2,5,2,2,2,3,2,4
401085943,Siena Saints,D. Tchougang,4398394,,False,4.0,0,0,0,0,0,0,0,0,0,2,2,0,0,0,0,1,0
401085943,Siena Saints,T. Huerter Jr.,4067350,,False,4.0,0,0,0,0,0,0,0,0,0,0,0,0,0,0,0,0,0
401085943,Siena Saints,G. Darwiche,4398393,,False,0.0,0,0,0,0,0,0,0,0,0,0,0,0,0,0,0,1,0
401085943,Siena Saints,K. Smithen,3133848,,False,31.0,2,7,2,4,0,3,0,1,1,4,5,3,1,0,2,0,4
401085943,Siena Saints,TEAM,TOTAL,TOTAL,False,,21,56,14,30,7,26,3,5,8,23,31,11,11,6,11,10,52
401085943,Siena Saints,S. Seymour,4398391,,True,28.0,4,10,0,0,4,10,0,0,0,0,0,0,0,0,0,0,12
401085943,Siena Saints,E. Fisher,3913235,,True,34.0,7,18,7,16,0,2,3,4,1,3,4,1,1,1,2,2,17
401085943,Siena Saints,K. Degnan,3138282,,True,36.0,2,8,1,5,1,3,0,0,2,6,8,1,3,0,1,3,5
401085943,Siena Saints,J. Pickett,4398390,,True,38.0,4,10,2,3,2,7,0,0,0,5,5,4,4,3,3,1,10
401085943,Siena Saints,M. Camper,4279751,,True,25.0,2,3,2,2,0,1,0,0,3,2,5,2,2,2,3,2,4
401085943,Siena Saints,D. Tchougang,4398394,,False,4.0,0,0,0,0,0,0,0,0,0,2,2,0,0,0,0,1,0
401085943,Siena Saints,T. Huerter Jr.,4067350,,False,4.0,0,0,0,0,0,0,0,0,0,0,0,0,0,0,0,0,0
401085943,Siena Saints,G. Darwiche,4398393,,False,0.0,0,0,0,0,0,0,0,0,0,0,0,0,0,0,0,1,0
401085943,Siena Saints,K. Smithen,3133848,,False,31.0,2,7,2,4,0,3,0,1,1,4,5,3,1,0,2,0,4
401085943,Siena Saints,TEAM,TOTAL,TOTAL,False,,21,56,14,30,7,26,3,5,8,23,31,11,11,6,11,10,52
401085943,Iona Gaels,T. Agee,4398087,,True,32.0,9,17,4,11,5,6,2,3,5,8,13,1,2,1,3,2,25
401085943,Iona Gaels,E.J. Crawford,4067295,,True,40.0,4,12,4,8,0,4,1,1,0,6,6,2,2,0,2,3,9
401085943,Iona Gaels,A. Gist,4067164,,True,34.0,2,10,1,5,1,5,2,3,0,1,1,1,0,0,1,0,7
401085943,Iona Gaels,B. Perez,3948791,,True,33.0,3,4,2,2,1,2,2,2,1,6,7,1,0,0,2,1,9
401085943,Iona Gaels,R. McGill,3948698,,True,38.0,3,9,3,7,0,2,1,2,1,5,6,3,3,0,6,1,7
401085943,Iona Gaels,N. Nikolic,4398090,,False,5.0,0,0,0,0,0,0,0,0,0,0,0,0,0,0,1,0,0
401085943,Iona Gaels,J. Maxwell,4398088,,False,3.0,0,0,0,0,0,0,0,0,0,1,1,0,1,0,0,1,0
401085943,Iona Gaels,P. Hudson,4398089,,False,15.0,0,0,0,0,0,0,0,0,0,0,0,1,0,0,0,1,0
401085943,Iona Gaels,TEAM,TOTAL,TOTAL,False,,21,52,14,33,7,19,8,11,10,28,38,9,8,1,15,9,57
401085943,Iona Gaels,T. Agee,4398087,,True,32.0,9,17,4,11,5,6,2,3,5,8,13,1,2,1,3,2,25
401085943,Iona Gaels,E.J. Crawford,4067295,,True,40.0,4,12,4,8,0,4,1,1,0,6,6,2,2,0,2,3,9
401085943,Iona Gaels,A. Gist,4067164,,True,34.0,2,10,1,5,1,5,2,3,0,1,1,1,0,0,1,0,7
401085943,Iona Gaels,B. Perez,3948791,,True,33.0,3,4,2,2,1,2,2,2,1,6,7,1,0,0,2,1,9
401085943,Iona Gaels,R. McGill,3948698,,True,38.0,3,9,3,7,0,2,1,2,1,5,6,3,3,0,6,1,7
401085943,Iona Gaels,N. Nikolic,4398090,,False,5.0,0,0,0,0,0,0,0,0,0,0,0,0,0,0,1,0,0
401085943,Iona Gaels,J. Maxwell,4398088,,False,3.0,0,0,0,0,0,0,0,0,0,1,1,0,1,0,0,1,0
401085943,Iona Gaels,P. Hudson,4398089,,False,15.0,0,0,0,0,0,0,0,0,0,0,0,1,0,0,0,1,0
401085943,Iona Gaels,TEAM,TOTAL,TOTAL,False,,21,52,14,33,7,19,8,11,10,28,38,9,8,1,15,9,57
401085942,Niagara Purple Eagles,D. Robb,3907186,,True,24.0,2,5,2,5,0,0,1,2,1,2,3,1,2,0,2,2,5
401085942,Niagara Purple Eagles,M. Prochet,3907184,,True,37.0,5,13,0,5,5,8,2,2,1,7,8,4,0,1,3,2,17
401085942,Niagara Purple Eagles,K. Tate,4279738,,True,8.0,0,2,0,0,0,2,0,0,0,0,0,0,1,0,2,4,0
401085942,Niagara Purple Eagles,J. Towns,4067341,,True,26.0,2,8,1,5,1,3,0,0,0,3,3,3,0,0,2,1,5
401085942,Niagara Purple Eagles,C. Barton,3907182,,True,18.0,2,5,1,2,1,3,2,2,0,1,1,1,0,0,0,1,7
401085942,Niagara Purple Eagles,G. Kuakumensah,4279739,,False,3.0,0,0,0,0,0,0,0,0,0,1,1,0,0,0,2,1,0
401085942,Niagara Purple Eagles,G. King,3906490,,False,16.0,2,5,2,5,0,0,0,0,1,0,1,0,0,1,1,1,4
401085942,Niagara Purple Eagles,M. Hammond,4398404,,False,29.0,7,9,3,4,4,5,0,0,0,6,6,0,0,0,3,3,18
401085942,Niagara Purple Eagles,R. Solomon,4398403,,False,22.0,3,6,2,3,1,3,3,4,1,3,4,2,1,1,1,3,10
401085942,Niagara Purple Eagles,D. Fragala,4279737,,False,17.0,3,5,0,1,3,4,1,2,1,1,2,1,1,0,0,1,10
401085942,Niagara Purple Eagles,TEAM,TOTAL,TOTAL,False,,26,58,11,30,15,28,9,12,7,26,33,12,5,3,17,19,76
401085942,Niagara Purple Eagles,D. Robb,3907186,,True,24.0,2,5,2,5,0,0,1,2,1,2,3,1,2,0,2,2,5
401085942,Niagara Purple Eagles,M. Prochet,3907184,,True,37.0,5,13,0,5,5,8,2,2,1,7,8,4,0,1,3,2,17
401085942,Niagara Purple Eagles,K. Tate,4279738,,True,8.0,0,2,0,0,0,2,0,0,0,0,0,0,1,0,2,4,0
401085942,Niagara Purple Eagles,J. Towns,4067341,,True,26.0,2,8,1,5,1,3,0,0,0,3,3,3,0,0,2,1,5
401085942,Niagara Purple Eagles,C. Barton,3907182,,True,18.0,2,5,1,2,1,3,2,2,0,1,1,1,0,0,0,1,7
401085942,Niagara Purple Eagles,G. Kuakumensah,4279739,,False,3.0,0,0,0,0,0,0,0,0,0,1,1,0,0,0,2,1,0
401085942,Niagara Purple Eagles,G. King,3906490,,False,16.0,2,5,2,5,0,0,0,0,1,0,1,0,0,1,1,1,4
401085942,Niagara Purple Eagles,M. Hammond,4398404,,False,29.0,7,9,3,4,4,5,0,0,0,6,6,0,0,0,3,3,18
401085942,Niagara Purple Eagles,R. Solomon,4398403,,False,22.0,3,6,2,3,1,3,3,4,1,3,4,2,1,1,1,3,10
401085942,Niagara Purple Eagles,D. Fragala,4279737,,False,17.0,3,5,0,1,3,4,1,2,1,1,2,1,1,0,0,1,10
401085942,Niagara Purple Eagles,TEAM,TOTAL,TOTAL,False,,26,58,11,30,15,28,9,12,7,26,33,12,5,3,17,19,76
401085942,Iona Gaels,T. Agee,4398087,,True,30.0,4,8,4,7,0,1,2,4,3,7,10,1,0,1,2,3,10
401085942,Iona Gaels,E.J. Crawford,4067295,,True,38.0,8,15,5,9,3,6,2,3,1,3,4,3,0,0,0,3,21
401085942,Iona Gaels,A. Gist,4067164,,True,37.0,7,15,4,8,3,7,2,2,0,2,2,2,2,0,3,3,19
401085942,Iona Gaels,B. Perez,3948791,,True,30.0,3,9,1,1,2,8,3,4,1,6,7,0,1,0,2,2,11
401085942,Iona Gaels,R. McGill,3948698,,True,40.0,6,11,6,10,0,1,6,7,0,3,3,8,3,0,2,1,18
401085942,Iona Gaels,N. Nikolic,4398090,,False,10.0,0,0,0,0,0,0,0,0,2,0,2,0,0,3,0,1,0
401085942,Iona Gaels,J. Maxwell,4398088,,False,2.0,0,1,0,0,0,1,0,0,0,1,1,0,0,0,0,0,0
401085942,Iona Gaels,P. Hudson,4398089,,False,13.0,0,1,0,0,0,1,0,0,1,2,3,0,0,0,1,1,0
401085942,Iona Gaels,TEAM,TOTAL,TOTAL,False,,28,60,20,35,8,25,15,20,8,26,34,14,6,4,10,14,79
401085942,Iona Gaels,T. Agee,4398087,,True,30.0,4,8,4,7,0,1,2,4,3,7,10,1,0,1,2,3,10
401085942,Iona Gaels,E.J. Crawford,4067295,,True,38.0,8,15,5,9,3,6,2,3,1,3,4,3,0,0,0,3,21
401085942,Iona Gaels,A. Gist,4067164,,True,37.0,7,15,4,8,3,7,2,2,0,2,2,2,2,0,3,3,19
401085942,Iona Gaels,B. Perez,3948791,,True,30.0,3,9,1,1,2,8,3,4,1,6,7,0,1,0,2,2,11
401085942,Iona Gaels,R. McGill,3948698,,True,40.0,6,11,6,10,0,1,6,7,0,3,3,8,3,0,2,1,18
401085942,Iona Gaels,N. Nikolic,4398090,,False,10.0,0,0,0,0,0,0,0,0,2,0,2,0,0,3,0,1,0
401085942,Iona Gaels,J. Maxwell,4398088,,False,2.0,0,1,0,0,0,1,0,0,0,1,1,0,0,0,0,0,0
401085942,Iona Gaels,P. Hudson,4398089,,False,13.0,0,1,0,0,0,1,0,0,1,2,3,0,0,0,1,1,0
401085942,Iona Gaels,TEAM,TOTAL,TOTAL,False,,28,60,20,35,8,25,15,20,8,26,34,14,6,4,10,14,79
401085941,Siena Saints,K. Degnan,3138282,,True,37.0,3,8,3,3,0,5,2,2,3,4,7,1,2,0,2,3,8
401085941,Siena Saints,S. Seymour,4398391,,True,21.0,1,5,1,2,0,3,0,0,0,1,1,1,0,0,0,1,2
401085941,Siena Saints,E. Fisher,3913235,,True,31.0,5,11,4,8,1,3,1,4,0,5,5,1,0,1,1,0,12
401085941,Siena Saints,J. Pickett,4398390,,True,37.0,6,16,3,9,3,7,2,2,0,2,2,2,0,0,3,4,17
401085941,Siena Saints,M. Camper,4279751,,True,25.0,2,7,2,6,0,1,2,2,1,6,7,1,0,0,2,4,6
401085941,Siena Saints,D. Tchougang,4398394,,False,9.0,0,0,0,0,0,0,0,0,0,3,3,0,0,0,1,0,0
401085941,Siena Saints,T. Huerter Jr.,4067350,,False,19.0,2,2,1,1,1,1,0,0,1,2,3,0,1,0,0,0,5
401085941,Siena Saints,B. Bayer,4065720,,False,2.0,0,0,0,0,0,0,0,0,0,0,0,0,0,0,0,0,0
401085941,Siena Saints,K. Smithen,3133848,,False,19.0,2,2,0,0,2,2,0,0,0,2,2,1,1,0,1,3,6
401085941,Siena Saints,TEAM,TOTAL,TOTAL,False,,21,51,14,29,7,22,7,10,8,26,34,7,4,1,10,15,56
401085941,Siena Saints,K. Degnan,3138282,,True,37.0,3,8,3,3,0,5,2,2,3,4,7,1,2,0,2,3,8
401085941,Siena Saints,S. Seymour,4398391,,True,21.0,1,5,1,2,0,3,0,0,0,1,1,1,0,0,0,1,2
401085941,Siena Saints,E. Fisher,3913235,,True,31.0,5,11,4,8,1,3,1,4,0,5,5,1,0,1,1,0,12
401085941,Siena Saints,J. Pickett,4398390,,True,37.0,6,16,3,9,3,7,2,2,0,2,2,2,0,0,3,4,17
401085941,Siena Saints,M. Camper,4279751,,True,25.0,2,7,2,6,0,1,2,2,1,6,7,1,0,0,2,4,6
401085941,Siena Saints,D. Tchougang,4398394,,False,9.0,0,0,0,0,0,0,0,0,0,3,3,0,0,0,1,0,0
401085941,Siena Saints,T. Huerter Jr.,4067350,,False,19.0,2,2,1,1,1,1,0,0,1,2,3,0,1,0,0,0,5
401085941,Siena Saints,B. Bayer,4065720,,False,2.0,0,0,0,0,0,0,0,0,0,0,0,0,0,0,0,0,0
401085941,Siena Saints,K. Smithen,3133848,,False,19.0,2,2,0,0,2,2,0,0,0,2,2,1,1,0,1,3,6
401085941,Siena Saints,TEAM,TOTAL,TOTAL,False,,21,51,14,29,7,22,7,10,8,26,34,7,4,1,10,15,56
401085941,Iona Gaels,N. Nikolic,4398090,,True,18.0,2,2,2,2,0,0,0,0,0,1,1,0,0,2,1,2,4
401085941,Iona Gaels,T. Agee,4398087,,True,27.0,1,9,1,6,0,3,1,3,3,5,8,1,1,1,1,1,3
401085941,Iona Gaels,E.J. Crawford,4067295,,True,33.0,6,11,6,7,0,4,7,8,1,3,4,1,0,0,0,0,19
401085941,Iona Gaels,B. Perez,3948791,,True,33.0,6,9,1,2,5,7,0,0,1,3,4,0,0,0,1,0,17
401085941,Iona Gaels,R. McGill,3948698,,True,37.0,1,5,1,2,0,3,4,8,3,2,5,6,1,0,3,3,6
401085941,Iona Gaels,A. Ristanovic,4279492,,False,27.0,0,9,0,2,0,7,0,0,1,7,8,2,1,0,1,2,0
401085941,Iona Gaels,P. Hudson,4398089,,False,17.0,2,3,1,1,1,2,0,0,1,0,1,0,0,0,0,1,5
401085941,Iona Gaels,A. Gist,4067164,,False,8.0,0,2,0,1,0,1,0,0,0,0,0,0,0,0,1,0,0
401085941,Iona Gaels,TEAM,TOTAL,TOTAL,False,,18,50,12,23,6,27,12,19,10,22,32,10,3,3,8,9,54
401085941,Iona Gaels,N. Nikolic,4398090,,True,18.0,2,2,2,2,0,0,0,0,0,1,1,0,0,2,1,2,4
401085941,Iona Gaels,T. Agee,4398087,,True,27.0,1,9,1,6,0,3,1,3,3,5,8,1,1,1,1,1,3
401085941,Iona Gaels,E.J. Crawford,4067295,,True,33.0,6,11,6,7,0,4,7,8,1,3,4,1,0,0,0,0,19
401085941,Iona Gaels,B. Perez,3948791,,True,33.0,6,9,1,2,5,7,0,0,1,3,4,0,0,0,1,0,17
401085941,Iona Gaels,R. McGill,3948698,,True,37.0,1,5,1,2,0,3,4,8,3,2,5,6,1,0,3,3,6
401085941,Iona Gaels,A. Ristanovic,4279492,,False,27.0,0,9,0,2,0,7,0,0,1,7,8,2,1,0,1,2,0
401085941,Iona Gaels,P. Hudson,4398089,,False,17.0,2,3,1,1,1,2,0,0,1,0,1,0,0,0,0,1,5
401085941,Iona Gaels,A. Gist,4067164,,False,8.0,0,2,0,1,0,1,0,0,0,0,0,0,0,0,1,0,0
401085941,Iona Gaels,TEAM,TOTAL,TOTAL,False,,18,50,12,23,6,27,12,19,10,22,32,10,3,3,8,9,54
401085940,Marist Red Foxes,I. Lamb,3936028,,True,23.0,4,7,1,1,3,6,4,4,0,2,2,0,0,1,1,2,15
401085940,Marist Red Foxes,T. Sjoberg,4067328,,True,9.0,0,0,0,0,0,0,0,0,0,2,2,1,0,0,2,3,0
401085940,Marist Red Foxes,D. Knudsen,3936027,,True,22.0,2,5,0,1,2,4,0,0,1,3,4,4,1,0,1,0,6
401085940,Marist Red Foxes,D. Hines,4398410,,True,25.0,4,7,1,2,3,5,3,4,1,0,1,1,1,0,2,4,14
401085940,Marist Red Foxes,B. Parker,3936030,,True,31.0,5,15,4,11,1,4,0,2,0,1,1,3,0,0,3,1,11
401085940,Marist Red Foxes,L. Nedrow,4398414,,False,6.0,0,2,0,1,0,1,1,2,0,1,1,1,0,0,0,3,1
401085940,Marist Red Foxes,R. Funk,3936026,,False,22.0,2,3,1,2,1,1,6,6,1,1,2,0,1,1,1,2,11
401085940,Marist Red Foxes,A. Dozic,3923222,,False,25.0,6,12,5,10,1,2,1,1,3,6,9,3,1,3,3,1,14
401085940,Marist Red Foxes,M. Herasme,4398413,,False,18.0,1,2,1,2,0,0,2,3,2,1,3,0,2,0,1,3,4
401085940,Marist Red Foxes,A. Williams,4279709,,False,19.0,1,5,1,4,0,1,0,0,2,5,7,1,0,0,1,1,2
401085940,Marist Red Foxes,TEAM,TOTAL,TOTAL,False,,25,58,14,34,11,24,17,22,12,23,35,14,6,5,16,20,78
401085940,Marist Red Foxes,I. Lamb,3936028,,True,23.0,4,7,1,1,3,6,4,4,0,2,2,0,0,1,1,2,15
401085940,Marist Red Foxes,T. Sjoberg,4067328,,True,9.0,0,0,0,0,0,0,0,0,0,2,2,1,0,0,2,3,0
401085940,Marist Red Foxes,D. Knudsen,3936027,,True,22.0,2,5,0,1,2,4,0,0,1,3,4,4,1,0,1,0,6
401085940,Marist Red Foxes,D. Hines,4398410,,True,25.0,4,7,1,2,3,5,3,4,1,0,1,1,1,0,2,4,14
401085940,Marist Red Foxes,B. Parker,3936030,,True,31.0,5,15,4,11,1,4,0,2,0,1,1,3,0,0,3,1,11
401085940,Marist Red Foxes,L. Nedrow,4398414,,False,6.0,0,2,0,1,0,1,1,2,0,1,1,1,0,0,0,3,1
401085940,Marist Red Foxes,R. Funk,3936026,,False,22.0,2,3,1,2,1,1,6,6,1,1,2,0,1,1,1,2,11
401085940,Marist Red Foxes,A. Dozic,3923222,,False,25.0,6,12,5,10,1,2,1,1,3,6,9,3,1,3,3,1,14
401085940,Marist Red Foxes,M. Herasme,4398413,,False,18.0,1,2,1,2,0,0,2,3,2,1,3,0,2,0,1,3,4
401085940,Marist Red Foxes,A. Williams,4279709,,False,19.0,1,5,1,4,0,1,0,0,2,5,7,1,0,0,1,1,2
401085940,Marist Red Foxes,TEAM,TOTAL,TOTAL,False,,25,58,14,34,11,24,17,22,12,23,35,14,6,5,16,20,78
401085940,Iona Gaels,J. Maxwell,4398088,,True,10.0,0,3,0,0,0,3,0,0,1,1,2,0,0,0,0,0,0
401085940,Iona Gaels,A. Ristanovic,4279492,,True,18.0,2,3,1,1,1,2,0,0,1,2,3,0,0,3,0,1,5
401085940,Iona Gaels,E.J. Crawford,4067295,,True,39.0,9,13,8,11,1,2,3,3,3,5,8,2,0,1,2,2,22
401085940,Iona Gaels,B. Perez,3948791,,True,33.0,3,6,0,0,3,6,0,0,3,1,4,1,3,0,0,2,9
401085940,Iona Gaels,R. McGill,3948698,,True,40.0,3,11,2,8,1,3,7,9,2,6,8,7,2,1,9,2,14
401085940,Iona Gaels,T. Agee,4398087,,False,20.0,2,9,1,7,1,2,5,6,1,4,5,0,0,1,0,4,10
401085940,Iona Gaels,P. Hudson,4398089,,False,9.0,0,1,0,0,0,1,0,0,0,1,1,1,0,0,0,1,0
401085940,Iona Gaels,A. Gist,4067164,,False,31.0,5,13,1,3,4,10,0,0,0,2,2,1,0,0,3,4,14
401085940,Iona Gaels,TEAM,TOTAL,TOTAL,False,,24,59,13,30,11,29,15,18,12,23,35,12,5,6,14,16,74
401085940,Iona Gaels,J. Maxwell,4398088,,True,10.0,0,3,0,0,0,3,0,0,1,1,2,0,0,0,0,0,0
401085940,Iona Gaels,A. Ristanovic,4279492,,True,18.0,2,3,1,1,1,2,0,0,1,2,3,0,0,3,0,1,5
401085940,Iona Gaels,E.J. Crawford,4067295,,True,39.0,9,13,8,11,1,2,3,3,3,5,8,2,0,1,2,2,22
401085940,Iona Gaels,B. Perez,3948791,,True,33.0,3,6,0,0,3,6,0,0,3,1,4,1,3,0,0,2,9
401085940,Iona Gaels,R. McGill,3948698,,True,40.0,3,11,2,8,1,3,7,9,2,6,8,7,2,1,9,2,14
401085940,Iona Gaels,T. Agee,4398087,,False,20.0,2,9,1,7,1,2,5,6,1,4,5,0,0,1,0,4,10
401085940,Iona Gaels,P. Hudson,4398089,,False,9.0,0,1,0,0,0,1,0,0,0,1,1,1,0,0,0,1,0
401085940,Iona Gaels,A. Gist,4067164,,False,31.0,5,13,1,3,4,10,0,0,0,2,2,1,0,0,3,4,14
401085940,Iona Gaels,TEAM,TOTAL,TOTAL,False,,24,59,13,30,11,29,15,18,12,23,35,12,5,6,14,16,74
401085939,Iona Gaels,N. Nikolic,4398090,,True,9.0,1,1,1,1,0,0,0,0,1,0,1,0,1,0,0,1,2
401085939,Iona Gaels,T. Agee,4398087,,True,20.0,1,6,1,2,0,4,1,5,1,3,4,0,1,2,3,5,3
401085939,Iona Gaels,A. Ristanovic,4279492,,True,20.0,0,0,0,0,0,0,0,0,1,3,4,0,0,0,4,3,0
401085939,Iona Gaels,E.J. Crawford,4067295,,True,37.0,11,15,10,13,1,2,5,7,0,5,5,3,1,0,3,2,28
401085939,Iona Gaels,R. McGill,3948698,,True,36.0,5,12,4,9,1,3,7,10,1,3,4,2,0,1,5,5,18
401085939,Iona Gaels,J. Maxwell,4398088,,False,17.0,2,4,2,3,0,1,0,0,2,3,5,0,0,0,1,4,4
401085939,Iona Gaels,P. Hudson,4398089,,False,24.0,0,0,0,0,0,0,0,0,0,0,0,1,1,0,0,1,0
401085939,Iona Gaels,A. Gist,4067164,,False,37.0,4,11,3,7,1,4,4,5,0,4,4,0,0,0,3,2,13
401085939,Iona Gaels,TEAM,TOTAL,TOTAL,False,,24,49,21,35,3,14,17,27,7,24,31,6,4,3,19,23,68
401085939,Iona Gaels,N. Nikolic,4398090,,True,9.0,1,1,1,1,0,0,0,0,1,0,1,0,1,0,0,1,2
401085939,Iona Gaels,T. Agee,4398087,,True,20.0,1,6,1,2,0,4,1,5,1,3,4,0,1,2,3,5,3
401085939,Iona Gaels,A. Ristanovic,4279492,,True,20.0,0,0,0,0,0,0,0,0,1,3,4,0,0,0,4,3,0
401085939,Iona Gaels,E.J. Crawford,4067295,,True,37.0,11,15,10,13,1,2,5,7,0,5,5,3,1,0,3,2,28
401085939,Iona Gaels,R. McGill,3948698,,True,36.0,5,12,4,9,1,3,7,10,1,3,4,2,0,1,5,5,18
401085939,Iona Gaels,J. Maxwell,4398088,,False,17.0,2,4,2,3,0,1,0,0,2,3,5,0,0,0,1,4,4
401085939,Iona Gaels,P. Hudson,4398089,,False,24.0,0,0,0,0,0,0,0,0,0,0,0,1,1,0,0,1,0
401085939,Iona Gaels,A. Gist,4067164,,False,37.0,4,11,3,7,1,4,4,5,0,4,4,0,0,0,3,2,13
401085939,Iona Gaels,TEAM,TOTAL,TOTAL,False,,24,49,21,35,3,14,17,27,7,24,31,6,4,3,19,23,68
401085939,Fairfield Stags,J. Kasibabu,3947016,,True,25.0,4,5,4,5,0,0,2,2,1,4,5,1,2,1,4,4,10
401085939,Fairfield Stags,L. Taliaferro,4398078,,True,34.0,3,11,1,4,2,7,11,12,0,1,1,2,3,0,0,2,19
401085939,Fairfield Stags,F. Lemetti,4398076,,True,17.0,0,2,0,0,0,2,0,0,0,1,1,1,0,0,0,1,0
401085939,Fairfield Stags,N. Alvarez,4398075,,True,40.0,5,14,5,11,0,3,1,4,2,5,7,3,0,0,1,0,11
401085939,Fairfield Stags,J. Cruz,4279488,,True,34.0,9,17,6,12,3,5,3,3,3,2,5,1,1,0,2,4,24
401085939,Fairfield Stags,W. Methnani,4279486,,False,6.0,4,4,3,3,1,1,2,2,0,0,0,0,0,1,1,5,11
401085939,Fairfield Stags,M. Milin,3947018,,False,9.0,1,3,1,3,0,0,1,2,1,3,4,1,0,0,1,1,3
401085939,Fairfield Stags,C. Whipple,4398077,,False,7.0,0,1,0,0,0,1,0,0,0,1,1,0,0,0,0,2,0
401085939,Fairfield Stags,T. Benning,4279483,,False,5.0,0,0,0,0,0,0,0,0,0,0,0,0,0,0,0,0,0
401085939,Fairfield Stags,A. Kavaliauskas,4080375,,False,23.0,1,2,1,2,0,0,0,0,1,4,5,3,2,0,2,4,2
401085939,Fairfield Stags,T. Nolan,3947015,,False,0.0,0,0,0,0,0,0,0,0,0,0,0,0,0,0,0,0,0
401085939,Fairfield Stags,TEAM,TOTAL,TOTAL,False,,27,59,21,40,6,19,20,25,10,23,33,12,8,2,11,23,80
401085939,Fairfield Stags,J. Kasibabu,3947016,,True,25.0,4,5,4,5,0,0,2,2,1,4,5,1,2,1,4,4,10
401085939,Fairfield Stags,L. Taliaferro,4398078,,True,34.0,3,11,1,4,2,7,11,12,0,1,1,2,3,0,0,2,19
401085939,Fairfield Stags,F. Lemetti,4398076,,True,17.0,0,2,0,0,0,2,0,0,0,1,1,1,0,0,0,1,0
401085939,Fairfield Stags,N. Alvarez,4398075,,True,40.0,5,14,5,11,0,3,1,4,2,5,7,3,0,0,1,0,11
401085939,Fairfield Stags,J. Cruz,4279488,,True,34.0,9,17,6,12,3,5,3,3,3,2,5,1,1,0,2,4,24
401085939,Fairfield Stags,W. Methnani,4279486,,False,6.0,4,4,3,3,1,1,2,2,0,0,0,0,0,1,1,5,11
401085939,Fairfield Stags,M. Milin,3947018,,False,9.0,1,3,1,3,0,0,1,2,1,3,4,1,0,0,1,1,3
401085939,Fairfield Stags,C. Whipple,4398077,,False,7.0,0,1,0,0,0,1,0,0,0,1,1,0,0,0,0,2,0
401085939,Fairfield Stags,T. Benning,4279483,,False,5.0,0,0,0,0,0,0,0,0,0,0,0,0,0,0,0,0,0
401085939,Fairfield Stags,A. Kavaliauskas,4080375,,False,23.0,1,2,1,2,0,0,0,0,1,4,5,3,2,0,2,4,2
401085939,Fairfield Stags,T. Nolan,3947015,,False,0.0,0,0,0,0,0,0,0,0,0,0,0,0,0,0,0,0,0
401085939,Fairfield Stags,TEAM,TOTAL,TOTAL,False,,27,59,21,40,6,19,20,25,10,23,33,12,8,2,11,23,80
401085938,Rider Broncs,F. Scott,3922033,,True,30.0,5,13,4,9,1,4,3,6,4,1,5,1,1,2,3,0,14
401085938,Rider Broncs,T. Marshall,4067348,,True,32.0,2,9,2,9,0,0,1,4,2,7,9,3,2,2,2,3,5
401085938,Rider Broncs,S. Jordan,4067349,,True,37.0,5,14,3,7,2,7,2,3,2,3,5,5,1,0,3,4,14
401085938,Rider Broncs,K. Williams,3946983,,True,14.0,0,2,0,2,0,0,0,0,0,1,1,2,1,0,0,0,0
401085938,Rider Broncs,A. Durham,3138490,,True,22.0,3,4,2,3,1,1,1,2,2,2,4,0,1,1,1,4,8
401085938,Rider Broncs,A. Ogemuno-Johnson,4406151,,False,5.0,1,3,1,3,0,0,0,0,0,0,0,0,0,0,0,0,2
401085938,Rider Broncs,D. Eke,3941312,,False,4.0,1,1,1,1,0,0,0,0,1,0,1,0,0,0,0,0,2
401085938,Rider Broncs,D. Vaughn,4067347,,False,29.0,3,6,1,3,2,3,3,4,0,6,6,3,1,2,1,1,11
401085938,Rider Broncs,J. Allen,4067345,,False,27.0,5,15,2,3,3,12,2,2,2,6,8,1,1,0,1,3,15
401085938,Rider Broncs,TEAM,TOTAL,TOTAL,False,,25,67,16,40,9,27,12,21,14,27,41,15,8,7,11,15,71
401085938,Rider Broncs,F. Scott,3922033,,True,30.0,5,13,4,9,1,4,3,6,4,1,5,1,1,2,3,0,14
401085938,Rider Broncs,T. Marshall,4067348,,True,32.0,2,9,2,9,0,0,1,4,2,7,9,3,2,2,2,3,5
401085938,Rider Broncs,S. Jordan,4067349,,True,37.0,5,14,3,7,2,7,2,3,2,3,5,5,1,0,3,4,14
401085938,Rider Broncs,K. Williams,3946983,,True,14.0,0,2,0,2,0,0,0,0,0,1,1,2,1,0,0,0,0
401085938,Rider Broncs,A. Durham,3138490,,True,22.0,3,4,2,3,1,1,1,2,2,2,4,0,1,1,1,4,8
401085938,Rider Broncs,A. Ogemuno-Johnson,4406151,,False,5.0,1,3,1,3,0,0,0,0,0,0,0,0,0,0,0,0,2
401085938,Rider Broncs,D. Eke,3941312,,False,4.0,1,1,1,1,0,0,0,0,1,0,1,0,0,0,0,0,2
401085938,Rider Broncs,D. Vaughn,4067347,,False,29.0,3,6,1,3,2,3,3,4,0,6,6,3,1,2,1,1,11
401085938,Rider Broncs,J. Allen,4067345,,False,27.0,5,15,2,3,3,12,2,2,2,6,8,1,1,0,1,3,15
401085938,Rider Broncs,TEAM,TOTAL,TOTAL,False,,25,67,16,40,9,27,12,21,14,27,41,15,8,7,11,15,71
401085938,Iona Gaels,N. Nikolic,4398090,,True,28.0,0,1,0,1,0,0,0,0,0,4,4,0,0,6,2,4,0
401085938,Iona Gaels,T. Agee,4398087,,True,24.0,7,13,5,9,2,4,0,1,2,6,8,0,1,0,3,4,16
401085938,Iona Gaels,A. Ristanovic,4279492,,True,27.0,1,3,1,1,0,2,0,0,0,8,8,1,0,0,0,3,2
401085938,Iona Gaels,E.J. Crawford,4067295,,True,39.0,9,19,9,13,0,6,2,2,0,2,2,2,1,0,3,1,20
401085938,Iona Gaels,R. McGill,3948698,,True,40.0,6,11,5,8,1,3,6,8,2,7,9,7,3,0,5,2,19
401085938,Iona Gaels,J. Maxwell,4398088,,False,9.0,0,2,0,1,0,1,0,0,1,0,1,1,0,0,0,1,0
401085938,Iona Gaels,A. Gist,4067164,,False,33.0,8,15,7,10,1,5,3,6,0,2,2,3,0,0,0,2,20
401085938,Iona Gaels,TEAM,TOTAL,TOTAL,False,,31,64,27,43,4,21,11,17,9,33,42,14,5,6,15,17,77
401085938,Iona Gaels,N. Nikolic,4398090,,True,28.0,0,1,0,1,0,0,0,0,0,4,4,0,0,6,2,4,0
401085938,Iona Gaels,T. Agee,4398087,,True,24.0,7,13,5,9,2,4,0,1,2,6,8,0,1,0,3,4,16
401085938,Iona Gaels,A. Ristanovic,4279492,,True,27.0,1,3,1,1,0,2,0,0,0,8,8,1,0,0,0,3,2
401085938,Iona Gaels,E.J. Crawford,4067295,,True,39.0,9,19,9,13,0,6,2,2,0,2,2,2,1,0,3,1,20
401085938,Iona Gaels,R. McGill,3948698,,True,40.0,6,11,5,8,1,3,6,8,2,7,9,7,3,0,5,2,19
401085938,Iona Gaels,J. Maxwell,4398088,,False,9.0,0,2,0,1,0,1,0,0,1,0,1,1,0,0,0,1,0
401085938,Iona Gaels,A. Gist,4067164,,False,33.0,8,15,7,10,1,5,3,6,0,2,2,3,0,0,0,2,20
401085938,Iona Gaels,TEAM,TOTAL,TOTAL,False,,31,64,27,43,4,21,11,17,9,33,42,14,5,6,15,17,77
401085937,Monmouth Hawks,M. Traore,3975762,,True,18.0,2,5,2,5,0,0,3,4,3,0,3,1,1,0,1,2,7
401085937,Monmouth Hawks,D. Quinn,3948714,,True,17.0,2,4,2,4,0,0,1,3,2,3,5,0,0,1,2,5,5
401085937,Monmouth Hawks,M. McClary,4279736,,True,17.0,3,5,1,3,2,2,0,0,1,2,3,1,0,0,0,1,8
401085937,Monmouth Hawks,D. Hammond,4279734,,True,26.0,2,11,0,3,2,8,9,9,1,4,5,2,0,1,0,1,15
401085937,Monmouth Hawks,R. Salnave,4067329,,True,25.0,7,13,6,9,1,4,4,7,0,2,2,3,0,0,2,3,19
401085937,Monmouth Hawks,N. Rutty,4398408,,False,5.0,1,2,1,2,0,0,0,2,1,0,1,0,0,0,1,0,2
401085937,Monmouth Hawks,S. Ibiezugbe,4067330,,False,17.0,4,4,4,4,0,0,4,7,3,1,4,0,0,0,0,3,12
401085937,Monmouth Hawks,M. Martin,4279733,,False,22.0,2,5,2,5,0,0,3,5,2,3,5,4,1,2,2,4,7
401085937,Monmouth Hawks,S. Chaput,4398409,,False,21.0,0,3,0,3,0,0,2,2,1,1,2,3,0,0,1,1,2
401085937,Monmouth Hawks,G. Papas,4279735,,False,8.0,1,3,1,1,0,2,0,0,0,1,1,0,0,0,0,1,2
401085937,Monmouth Hawks,L. Pillari,3948713,,False,0.0,0,1,0,0,0,1,0,0,0,0,0,0,0,0,0,0,0
401085937,Monmouth Hawks,N. Rutherford,3946977,,False,24.0,2,4,2,3,0,1,0,0,0,6,6,3,3,0,2,3,4
401085937,Monmouth Hawks,TEAM,TOTAL,TOTAL,False,,26,60,21,42,5,18,26,39,15,24,39,17,5,4,11,24,83
401085937,Monmouth Hawks,M. Traore,3975762,,True,18.0,2,5,2,5,0,0,3,4,3,0,3,1,1,0,1,2,7
401085937,Monmouth Hawks,D. Quinn,3948714,,True,17.0,2,4,2,4,0,0,1,3,2,3,5,0,0,1,2,5,5
401085937,Monmouth Hawks,M. McClary,4279736,,True,17.0,3,5,1,3,2,2,0,0,1,2,3,1,0,0,0,1,8
401085937,Monmouth Hawks,D. Hammond,4279734,,True,26.0,2,11,0,3,2,8,9,9,1,4,5,2,0,1,0,1,15
401085937,Monmouth Hawks,R. Salnave,4067329,,True,25.0,7,13,6,9,1,4,4,7,0,2,2,3,0,0,2,3,19
401085937,Monmouth Hawks,N. Rutty,4398408,,False,5.0,1,2,1,2,0,0,0,2,1,0,1,0,0,0,1,0,2
401085937,Monmouth Hawks,S. Ibiezugbe,4067330,,False,17.0,4,4,4,4,0,0,4,7,3,1,4,0,0,0,0,3,12
401085937,Monmouth Hawks,M. Martin,4279733,,False,22.0,2,5,2,5,0,0,3,5,2,3,5,4,1,2,2,4,7
401085937,Monmouth Hawks,S. Chaput,4398409,,False,21.0,0,3,0,3,0,0,2,2,1,1,2,3,0,0,1,1,2
401085937,Monmouth Hawks,G. Papas,4279735,,False,8.0,1,3,1,1,0,2,0,0,0,1,1,0,0,0,0,1,2
401085937,Monmouth Hawks,L. Pillari,3948713,,False,0.0,0,1,0,0,0,1,0,0,0,0,0,0,0,0,0,0,0
401085937,Monmouth Hawks,N. Rutherford,3946977,,False,24.0,2,4,2,3,0,1,0,0,0,6,6,3,3,0,2,3,4
401085937,Monmouth Hawks,TEAM,TOTAL,TOTAL,False,,26,60,21,42,5,18,26,39,15,24,39,17,5,4,11,24,83
401085937,Iona Gaels,N. Nikolic,4398090,,True,15.0,0,0,0,0,0,0,2,4,0,1,1,0,1,0,2,4,2
401085937,Iona Gaels,T. Agee,4398087,,True,35.0,5,10,4,5,1,5,9,9,1,9,10,3,0,0,2,4,20
401085937,Iona Gaels,E.J. Crawford,4067295,,True,34.0,3,11,2,5,1,6,0,0,2,3,5,1,1,0,3,3,7
401085937,Iona Gaels,B. Perez,3948791,,True,25.0,4,6,0,0,4,6,1,1,0,4,4,2,1,0,0,5,13
401085937,Iona Gaels,R. McGill,3948698,,True,40.0,5,11,3,7,2,4,6,8,0,3,3,5,3,1,3,4,18
401085937,Iona Gaels,J. Maxwell,4398088,,False,9.0,0,4,0,2,0,2,0,0,2,1,3,1,0,0,0,3,0
401085937,Iona Gaels,A. Ristanovic,4279492,,False,10.0,0,1,0,0,0,1,0,0,1,0,1,0,0,0,1,2,0
401085937,Iona Gaels,A. Gist,4067164,,False,32.0,6,13,3,4,3,9,6,7,1,1,2,4,1,0,2,2,21
401085937,Iona Gaels,TEAM,TOTAL,TOTAL,False,,23,56,12,23,11,33,24,29,7,23,30,16,7,1,13,27,81
401085937,Iona Gaels,N. Nikolic,4398090,,True,15.0,0,0,0,0,0,0,2,4,0,1,1,0,1,0,2,4,2
401085937,Iona Gaels,T. Agee,4398087,,True,35.0,5,10,4,5,1,5,9,9,1,9,10,3,0,0,2,4,20
401085937,Iona Gaels,E.J. Crawford,4067295,,True,34.0,3,11,2,5,1,6,0,0,2,3,5,1,1,0,3,3,7
401085937,Iona Gaels,B. Perez,3948791,,True,25.0,4,6,0,0,4,6,1,1,0,4,4,2,1,0,0,5,13
401085937,Iona Gaels,R. McGill,3948698,,True,40.0,5,11,3,7,2,4,6,8,0,3,3,5,3,1,3,4,18
401085937,Iona Gaels,J. Maxwell,4398088,,False,9.0,0,4,0,2,0,2,0,0,2,1,3,1,0,0,0,3,0
401085937,Iona Gaels,A. Ristanovic,4279492,,False,10.0,0,1,0,0,0,1,0,0,1,0,1,0,0,0,1,2,0
401085937,Iona Gaels,A. Gist,4067164,,False,32.0,6,13,3,4,3,9,6,7,1,1,2,4,1,0,2,2,21
401085937,Iona Gaels,TEAM,TOTAL,TOTAL,False,,23,56,12,23,11,33,24,29,7,23,30,16,7,1,13,27,81
401085936,Marist Red Foxes,T. Sjoberg,4067328,,True,10.0,0,0,0,0,0,0,0,0,0,1,1,0,0,2,1,0,0
401085936,Marist Red Foxes,D. Hines,4398410,,True,25.0,2,7,1,3,1,4,4,5,1,2,3,1,0,0,4,4,9
401085936,Marist Red Foxes,A. Williams,4279709,,True,19.0,1,4,1,4,0,0,0,0,1,3,4,3,0,0,2,3,2
401085936,Marist Red Foxes,B. Parker,3936030,,True,31.0,6,14,5,10,1,4,0,0,1,1,2,3,0,0,4,3,13
401085936,Marist Red Foxes,D. Knudsen,3936027,,True,21.0,1,3,0,1,1,2,0,0,1,2,3,2,1,0,0,1,3
401085936,Marist Red Foxes,L. Nedrow,4398414,,False,15.0,1,3,0,0,1,3,4,4,0,1,1,1,0,0,2,4,7
401085936,Marist Red Foxes,I. Lamb,3936028,,False,25.0,2,6,0,3,2,3,2,4,3,3,6,1,0,0,0,3,8
401085936,Marist Red Foxes,R. Funk,3936026,,False,32.0,7,14,0,1,7,13,0,0,1,5,6,1,1,0,1,3,21
401085936,Marist Red Foxes,A. Dozic,3923222,,False,15.0,4,5,3,3,1,2,2,2,0,0,0,2,0,0,0,2,11
401085936,Marist Red Foxes,M. Herasme,4398413,,False,5.0,0,1,0,0,0,1,0,0,0,2,2,1,0,0,0,1,0
401085936,Marist Red Foxes,T. Lee,4279710,,False,1.0,0,0,0,0,0,0,0,0,0,0,0,0,0,0,0,0,0
401085936,Marist Red Foxes,R. Carmello,4279708,,False,1.0,1,1,1,1,0,0,1,1,0,0,0,0,0,0,0,0,3
401085936,Marist Red Foxes,TEAM,TOTAL,TOTAL,False,,25,58,11,26,14,32,13,16,10,20,30,15,2,2,14,24,77
401085936,Marist Red Foxes,T. Sjoberg,4067328,,True,10.0,0,0,0,0,0,0,0,0,0,1,1,0,0,2,1,0,0
401085936,Marist Red Foxes,D. Hines,4398410,,True,25.0,2,7,1,3,1,4,4,5,1,2,3,1,0,0,4,4,9
401085936,Marist Red Foxes,A. Williams,4279709,,True,19.0,1,4,1,4,0,0,0,0,1,3,4,3,0,0,2,3,2
401085936,Marist Red Foxes,B. Parker,3936030,,True,31.0,6,14,5,10,1,4,0,0,1,1,2,3,0,0,4,3,13
401085936,Marist Red Foxes,D. Knudsen,3936027,,True,21.0,1,3,0,1,1,2,0,0,1,2,3,2,1,0,0,1,3
401085936,Marist Red Foxes,L. Nedrow,4398414,,False,15.0,1,3,0,0,1,3,4,4,0,1,1,1,0,0,2,4,7
401085936,Marist Red Foxes,I. Lamb,3936028,,False,25.0,2,6,0,3,2,3,2,4,3,3,6,1,0,0,0,3,8
401085936,Marist Red Foxes,R. Funk,3936026,,False,32.0,7,14,0,1,7,13,0,0,1,5,6,1,1,0,1,3,21
401085936,Marist Red Foxes,A. Dozic,3923222,,False,15.0,4,5,3,3,1,2,2,2,0,0,0,2,0,0,0,2,11
401085936,Marist Red Foxes,M. Herasme,4398413,,False,5.0,0,1,0,0,0,1,0,0,0,2,2,1,0,0,0,1,0
401085936,Marist Red Foxes,T. Lee,4279710,,False,1.0,0,0,0,0,0,0,0,0,0,0,0,0,0,0,0,0,0
401085936,Marist Red Foxes,R. Carmello,4279708,,False,1.0,1,1,1,1,0,0,1,1,0,0,0,0,0,0,0,0,3
401085936,Marist Red Foxes,TEAM,TOTAL,TOTAL,False,,25,58,11,26,14,32,13,16,10,20,30,15,2,2,14,24,77
401085936,Iona Gaels,N. Nikolic,4398090,,True,12.0,2,3,2,3,0,0,0,0,3,1,4,0,0,1,1,2,4
401085936,Iona Gaels,T. Agee,4398087,,True,26.0,4,9,4,7,0,2,2,2,3,4,7,0,0,1,2,3,10
401085936,Iona Gaels,E.J. Crawford,4067295,,True,35.0,4,9,2,3,2,6,4,4,1,6,7,5,0,1,2,4,14
401085936,Iona Gaels,B. Perez,3948791,,True,34.0,2,7,1,1,1,6,7,7,0,2,2,1,1,0,1,1,12
401085936,Iona Gaels,R. McGill,3948698,,True,39.0,5,11,3,7,2,4,4,4,1,4,5,7,1,0,2,2,16
401085936,Iona Gaels,J. Maxwell,4398088,,False,17.0,4,7,1,1,3,6,2,2,0,2,2,0,2,0,0,2,13
401085936,Iona Gaels,A. Ristanovic,4279492,,False,3.0,0,0,0,0,0,0,0,0,0,1,1,0,0,0,0,1,0
401085936,Iona Gaels,M. Rhem,4404249,,False,1.0,0,1,0,1,0,0,0,0,0,0,0,0,0,0,0,0,0
401085936,Iona Gaels,P. Hudson,4398089,,False,1.0,0,0,0,0,0,0,0,0,0,0,0,0,0,0,0,1,0
401085936,Iona Gaels,A. Gist,4067164,,False,32.0,6,9,2,2,4,7,5,7,0,3,3,1,0,0,1,2,21
401085936,Iona Gaels,TEAM,TOTAL,TOTAL,False,,27,56,15,25,12,31,24,26,10,24,34,14,4,3,9,18,90
401085936,Iona Gaels,N. Nikolic,4398090,,True,12.0,2,3,2,3,0,0,0,0,3,1,4,0,0,1,1,2,4
401085936,Iona Gaels,T. Agee,4398087,,True,26.0,4,9,4,7,0,2,2,2,3,4,7,0,0,1,2,3,10
401085936,Iona Gaels,E.J. Crawford,4067295,,True,35.0,4,9,2,3,2,6,4,4,1,6,7,5,0,1,2,4,14
401085936,Iona Gaels,B. Perez,3948791,,True,34.0,2,7,1,1,1,6,7,7,0,2,2,1,1,0,1,1,12
401085936,Iona Gaels,R. McGill,3948698,,True,39.0,5,11,3,7,2,4,4,4,1,4,5,7,1,0,2,2,16
401085936,Iona Gaels,J. Maxwell,4398088,,False,17.0,4,7,1,1,3,6,2,2,0,2,2,0,2,0,0,2,13
401085936,Iona Gaels,A. Ristanovic,4279492,,False,3.0,0,0,0,0,0,0,0,0,0,1,1,0,0,0,0,1,0
401085936,Iona Gaels,M. Rhem,4404249,,False,1.0,0,1,0,1,0,0,0,0,0,0,0,0,0,0,0,0,0
401085936,Iona Gaels,P. Hudson,4398089,,False,1.0,0,0,0,0,0,0,0,0,0,0,0,0,0,0,0,1,0
401085936,Iona Gaels,A. Gist,4067164,,False,32.0,6,9,2,2,4,7,5,7,0,3,3,1,0,0,1,2,21
401085936,Iona Gaels,TEAM,TOTAL,TOTAL,False,,27,56,15,25,12,31,24,26,10,24,34,14,4,3,9,18,90
401085935,Niagara Purple Eagles,G. Kuakumensah,4279739,,False,9.0,2,3,1,2,1,1,0,0,1,2,3,0,0,0,1,4,5
401085935,Niagara Purple Eagles,D. Robb,3907186,,False,24.0,6,11,6,11,0,0,1,1,5,5,10,2,1,1,1,4,13
401085935,Niagara Purple Eagles,M. Prochet,3907184,,False,31.0,7,13,2,6,5,7,1,2,3,7,10,2,2,1,2,1,20
401085935,Niagara Purple Eagles,G. King,3906490,,False,16.0,5,6,5,6,0,0,0,0,2,6,8,1,0,1,2,1,10
401085935,Niagara Purple Eagles,M. Hammond,4398404,,False,20.0,1,3,1,2,0,1,4,4,1,3,4,7,0,0,1,2,6
401085935,Niagara Purple Eagles,R. Solomon,4398403,,False,26.0,6,12,3,5,3,7,3,3,2,2,4,1,0,0,1,2,18
401085935,Niagara Purple Eagles,K. Tate,4279738,,False,23.0,3,11,1,5,2,6,0,0,1,1,2,4,0,0,3,0,8
401085935,Niagara Purple Eagles,D. Fragala,4279737,,False,10.0,3,4,2,2,1,2,1,1,0,1,1,0,0,0,0,1,8
401085935,Niagara Purple Eagles,J. Towns,4067341,,False,23.0,1,9,1,4,0,5,0,1,1,3,4,0,0,0,3,0,2
401085935,Niagara Purple Eagles,C. Barton,3907182,,False,18.0,2,5,1,2,1,3,0,1,0,0,0,1,0,0,0,2,5
401085935,Niagara Purple Eagles,TEAM,TOTAL,TOTAL,False,,36,77,23,45,13,32,10,13,18,33,51,18,3,3,14,17,95
401085935,Niagara Purple Eagles,G. Kuakumensah,4279739,,False,9.0,2,3,1,2,1,1,0,0,1,2,3,0,0,0,1,4,5
401085935,Niagara Purple Eagles,D. Robb,3907186,,False,24.0,6,11,6,11,0,0,1,1,5,5,10,2,1,1,1,4,13
401085935,Niagara Purple Eagles,M. Prochet,3907184,,False,31.0,7,13,2,6,5,7,1,2,3,7,10,2,2,1,2,1,20
401085935,Niagara Purple Eagles,G. King,3906490,,False,16.0,5,6,5,6,0,0,0,0,2,6,8,1,0,1,2,1,10
401085935,Niagara Purple Eagles,M. Hammond,4398404,,False,20.0,1,3,1,2,0,1,4,4,1,3,4,7,0,0,1,2,6
401085935,Niagara Purple Eagles,R. Solomon,4398403,,False,26.0,6,12,3,5,3,7,3,3,2,2,4,1,0,0,1,2,18
401085935,Niagara Purple Eagles,K. Tate,4279738,,False,23.0,3,11,1,5,2,6,0,0,1,1,2,4,0,0,3,0,8
401085935,Niagara Purple Eagles,D. Fragala,4279737,,False,10.0,3,4,2,2,1,2,1,1,0,1,1,0,0,0,0,1,8
401085935,Niagara Purple Eagles,J. Towns,4067341,,False,23.0,1,9,1,4,0,5,0,1,1,3,4,0,0,0,3,0,2
401085935,Niagara Purple Eagles,C. Barton,3907182,,False,18.0,2,5,1,2,1,3,0,1,0,0,0,1,0,0,0,2,5
401085935,Niagara Purple Eagles,TEAM,TOTAL,TOTAL,False,,36,77,23,45,13,32,10,13,18,33,51,18,3,3,14,17,95
401085935,Iona Gaels,N. Nikolic,4398090,,False,7.0,1,2,1,2,0,0,0,0,0,1,1,0,0,0,1,0,2
401085935,Iona Gaels,J. Maxwell,4398088,,False,6.0,0,1,0,0,0,1,0,0,0,2,2,0,0,0,0,1,0
401085935,Iona Gaels,T. Agee,4398087,,False,36.0,8,14,6,10,2,4,4,4,0,11,11,1,1,2,2,2,22
401085935,Iona Gaels,E.J. Crawford,4067295,,False,37.0,10,15,8,12,2,3,1,2,2,4,6,2,1,0,0,4,23
401085935,Iona Gaels,A. Gist,4067164,,False,33.0,3,11,1,4,2,7,1,2,0,2,2,6,1,0,0,2,9
401085935,Iona Gaels,B. Perez,3948791,,False,30.0,3,7,1,3,2,4,0,0,0,2,2,1,2,0,2,2,8
401085935,Iona Gaels,R. McGill,3948698,,False,36.0,9,14,8,12,1,2,3,3,1,3,4,3,5,0,2,5,22
401085935,Iona Gaels,I. Still,3938908,,False,15.0,1,3,1,2,0,1,2,6,0,1,1,1,2,0,1,2,4
401085935,Iona Gaels,TEAM,TOTAL,TOTAL,False,,35,67,26,45,9,22,11,17,3,26,29,14,12,2,8,18,90
401085935,Iona Gaels,N. Nikolic,4398090,,False,7.0,1,2,1,2,0,0,0,0,0,1,1,0,0,0,1,0,2
401085935,Iona Gaels,J. Maxwell,4398088,,False,6.0,0,1,0,0,0,1,0,0,0,2,2,0,0,0,0,1,0
401085935,Iona Gaels,T. Agee,4398087,,False,36.0,8,14,6,10,2,4,4,4,0,11,11,1,1,2,2,2,22
401085935,Iona Gaels,E.J. Crawford,4067295,,False,37.0,10,15,8,12,2,3,1,2,2,4,6,2,1,0,0,4,23
401085935,Iona Gaels,A. Gist,4067164,,False,33.0,3,11,1,4,2,7,1,2,0,2,2,6,1,0,0,2,9
401085935,Iona Gaels,B. Perez,3948791,,False,30.0,3,7,1,3,2,4,0,0,0,2,2,1,2,0,2,2,8
401085935,Iona Gaels,R. McGill,3948698,,False,36.0,9,14,8,12,1,2,3,3,1,3,4,3,5,0,2,5,22
401085935,Iona Gaels,I. Still,3938908,,False,15.0,1,3,1,2,0,1,2,6,0,1,1,1,2,0,1,2,4
401085935,Iona Gaels,TEAM,TOTAL,TOTAL,False,,35,67,26,45,9,22,11,17,3,26,29,14,12,2,8,18,90
401085934,Iona Gaels,T. Agee,4398087,,True,34.0,6,15,5,9,1,6,10,14,1,9,10,2,2,0,1,5,23
401085934,Iona Gaels,A. Ristanovic,4279492,,True,15.0,1,3,0,1,1,2,2,2,1,2,3,0,0,0,0,3,5
401085934,Iona Gaels,E.J. Crawford,4067295,,True,35.0,9,14,7,11,2,3,2,3,3,3,6,1,2,0,3,3,22
401085934,Iona Gaels,B. Perez,3948791,,True,36.0,4,9,4,5,0,4,0,1,2,3,5,2,3,0,0,2,8
401085934,Iona Gaels,R. McGill,3948698,,True,36.0,5,13,4,11,1,2,4,5,2,4,6,9,4,0,4,2,15
401085934,Iona Gaels,J. Maxwell,4398088,,False,12.0,0,1,0,0,0,1,0,0,0,2,2,0,0,0,1,0,0
401085934,Iona Gaels,A. Gist,4067164,,False,32.0,6,9,1,3,5,6,4,4,0,2,2,3,0,0,2,1,21
401085934,Iona Gaels,TEAM,TOTAL,TOTAL,False,,31,64,21,40,10,24,22,29,11,26,37,17,11,0,11,16,94
401085934,Iona Gaels,T. Agee,4398087,,True,34.0,6,15,5,9,1,6,10,14,1,9,10,2,2,0,1,5,23
401085934,Iona Gaels,A. Ristanovic,4279492,,True,15.0,1,3,0,1,1,2,2,2,1,2,3,0,0,0,0,3,5
401085934,Iona Gaels,E.J. Crawford,4067295,,True,35.0,9,14,7,11,2,3,2,3,3,3,6,1,2,0,3,3,22
401085934,Iona Gaels,B. Perez,3948791,,True,36.0,4,9,4,5,0,4,0,1,2,3,5,2,3,0,0,2,8
401085934,Iona Gaels,R. McGill,3948698,,True,36.0,5,13,4,11,1,2,4,5,2,4,6,9,4,0,4,2,15
401085934,Iona Gaels,J. Maxwell,4398088,,False,12.0,0,1,0,0,0,1,0,0,0,2,2,0,0,0,1,0,0
401085934,Iona Gaels,A. Gist,4067164,,False,32.0,6,9,1,3,5,6,4,4,0,2,2,3,0,0,2,1,21
401085934,Iona Gaels,TEAM,TOTAL,TOTAL,False,,31,64,21,40,10,24,22,29,11,26,37,17,11,0,11,16,94
401085934,Fairfield Stags,J. Kasibabu,3947016,,True,22.0,5,6,4,5,1,1,3,5,3,2,5,2,1,0,1,5,14
401085934,Fairfield Stags,J. Cruz,4279488,,True,31.0,5,8,4,7,1,1,2,2,4,6,10,4,0,0,4,4,13
401085934,Fairfield Stags,L. Taliaferro,4398078,,True,36.0,5,14,0,2,5,12,2,2,0,2,2,1,1,1,4,2,17
401085934,Fairfield Stags,F. Lemetti,4398076,,True,32.0,6,12,0,0,6,12,0,0,0,2,2,5,2,0,1,5,18
401085934,Fairfield Stags,N. Alvarez,4398075,,True,33.0,4,11,2,6,2,5,2,2,0,6,6,7,1,0,4,2,12
401085934,Fairfield Stags,O. El-Sheikh,4279489,,False,8.0,1,2,0,1,1,1,0,0,0,2,2,1,0,0,0,1,3
401085934,Fairfield Stags,W. Methnani,4279486,,False,15.0,3,6,3,6,0,0,0,0,0,4,4,0,1,1,2,3,6
401085934,Fairfield Stags,M. Milin,3947018,,False,5.0,1,1,1,1,0,0,0,0,1,1,2,0,0,0,0,0,2
401085934,Fairfield Stags,T. Benning,4279483,,False,11.0,1,4,1,3,0,1,0,0,1,1,2,0,0,1,2,2,2
401085934,Fairfield Stags,A. Kavaliauskas,4080375,,False,7.0,0,0,0,0,0,0,0,0,0,0,0,1,0,0,0,1,0
401085934,Fairfield Stags,TEAM,TOTAL,TOTAL,False,,31,64,15,31,16,33,9,11,9,27,36,21,6,3,18,25,87
401085934,Fairfield Stags,J. Kasibabu,3947016,,True,22.0,5,6,4,5,1,1,3,5,3,2,5,2,1,0,1,5,14
401085934,Fairfield Stags,J. Cruz,4279488,,True,31.0,5,8,4,7,1,1,2,2,4,6,10,4,0,0,4,4,13
401085934,Fairfield Stags,L. Taliaferro,4398078,,True,36.0,5,14,0,2,5,12,2,2,0,2,2,1,1,1,4,2,17
401085934,Fairfield Stags,F. Lemetti,4398076,,True,32.0,6,12,0,0,6,12,0,0,0,2,2,5,2,0,1,5,18
401085934,Fairfield Stags,N. Alvarez,4398075,,True,33.0,4,11,2,6,2,5,2,2,0,6,6,7,1,0,4,2,12
401085934,Fairfield Stags,O. El-Sheikh,4279489,,False,8.0,1,2,0,1,1,1,0,0,0,2,2,1,0,0,0,1,3
401085934,Fairfield Stags,W. Methnani,4279486,,False,15.0,3,6,3,6,0,0,0,0,0,4,4,0,1,1,2,3,6
401085934,Fairfield Stags,M. Milin,3947018,,False,5.0,1,1,1,1,0,0,0,0,1,1,2,0,0,0,0,0,2
401085934,Fairfield Stags,T. Benning,4279483,,False,11.0,1,4,1,3,0,1,0,0,1,1,2,0,0,1,2,2,2
401085934,Fairfield Stags,A. Kavaliauskas,4080375,,False,7.0,0,0,0,0,0,0,0,0,0,0,0,1,0,0,0,1,0
401085934,Fairfield Stags,TEAM,TOTAL,TOTAL,False,,31,64,15,31,16,33,9,11,9,27,36,21,6,3,18,25,87
401085933,Monmouth Hawks,N. Rutty,4398408,,True,17.0,1,2,1,2,0,0,0,2,1,1,2,0,0,2,0,2,2
401085933,Monmouth Hawks,M. Traore,3975762,,True,14.0,0,1,0,1,0,0,1,2,0,2,2,3,0,0,0,1,1
401085933,Monmouth Hawks,M. McClary,4279736,,True,6.0,0,0,0,0,0,0,0,0,1,0,1,0,0,0,2,4,0
401085933,Monmouth Hawks,D. Hammond,4279734,,True,25.0,8,14,3,5,5,9,1,2,1,1,2,1,0,0,2,2,22
401085933,Monmouth Hawks,R. Salnave,4067329,,True,16.0,1,7,0,3,1,4,2,4,0,4,4,2,1,0,1,1,5
401085933,Monmouth Hawks,S. Ibiezugbe,4067330,,False,6.0,0,3,0,3,0,0,0,0,0,2,2,0,0,0,0,3,0
401085933,Monmouth Hawks,D. Quinn,3948714,,False,22.0,7,9,7,9,0,0,6,7,4,3,7,0,0,2,1,1,20
401085933,Monmouth Hawks,M. Martin,4279733,,False,13.0,0,4,0,3,0,1,2,3,0,1,1,1,0,0,0,1,2
401085933,Monmouth Hawks,M. James Jr.,4404878,,False,1.0,0,0,0,0,0,0,0,0,0,0,0,1,0,0,0,0,0
401085933,Monmouth Hawks,S. Chaput,4398409,,False,23.0,4,5,4,4,0,1,1,3,0,0,0,2,1,0,2,2,9
401085933,Monmouth Hawks,D. Calloway Jr.,4398407,,False,1.0,0,0,0,0,0,0,1,2,0,0,0,0,0,0,0,1,1
401085933,Monmouth Hawks,G. Papas,4279735,,False,13.0,3,5,1,1,2,4,0,1,0,0,0,0,1,0,0,3,8
401085933,Monmouth Hawks,T. Gross Jr.,4065729,,False,6.0,1,1,0,0,1,1,0,0,0,0,0,0,0,0,0,1,3
401085933,Monmouth Hawks,L. Pillari,3948713,,False,12.0,1,2,1,2,0,0,3,3,0,0,0,1,0,0,0,0,5
401085933,Monmouth Hawks,N. Rutherford,3946977,,False,25.0,2,6,1,4,1,2,1,3,0,5,5,1,1,1,2,3,6
401085933,Monmouth Hawks,TEAM,TOTAL,TOTAL,False,,28,59,18,37,10,22,18,32,8,22,30,12,4,5,10,25,84
401085933,Monmouth Hawks,N. Rutty,4398408,,True,17.0,1,2,1,2,0,0,0,2,1,1,2,0,0,2,0,2,2
401085933,Monmouth Hawks,M. Traore,3975762,,True,14.0,0,1,0,1,0,0,1,2,0,2,2,3,0,0,0,1,1
401085933,Monmouth Hawks,M. McClary,4279736,,True,6.0,0,0,0,0,0,0,0,0,1,0,1,0,0,0,2,4,0
401085933,Monmouth Hawks,D. Hammond,4279734,,True,25.0,8,14,3,5,5,9,1,2,1,1,2,1,0,0,2,2,22
401085933,Monmouth Hawks,R. Salnave,4067329,,True,16.0,1,7,0,3,1,4,2,4,0,4,4,2,1,0,1,1,5
401085933,Monmouth Hawks,S. Ibiezugbe,4067330,,False,6.0,0,3,0,3,0,0,0,0,0,2,2,0,0,0,0,3,0
401085933,Monmouth Hawks,D. Quinn,3948714,,False,22.0,7,9,7,9,0,0,6,7,4,3,7,0,0,2,1,1,20
401085933,Monmouth Hawks,M. Martin,4279733,,False,13.0,0,4,0,3,0,1,2,3,0,1,1,1,0,0,0,1,2
401085933,Monmouth Hawks,M. James Jr.,4404878,,False,1.0,0,0,0,0,0,0,0,0,0,0,0,1,0,0,0,0,0
401085933,Monmouth Hawks,S. Chaput,4398409,,False,23.0,4,5,4,4,0,1,1,3,0,0,0,2,1,0,2,2,9
401085933,Monmouth Hawks,D. Calloway Jr.,4398407,,False,1.0,0,0,0,0,0,0,1,2,0,0,0,0,0,0,0,1,1
401085933,Monmouth Hawks,G. Papas,4279735,,False,13.0,3,5,1,1,2,4,0,1,0,0,0,0,1,0,0,3,8
401085933,Monmouth Hawks,T. Gross Jr.,4065729,,False,6.0,1,1,0,0,1,1,0,0,0,0,0,0,0,0,0,1,3
401085933,Monmouth Hawks,L. Pillari,3948713,,False,12.0,1,2,1,2,0,0,3,3,0,0,0,1,0,0,0,0,5
401085933,Monmouth Hawks,N. Rutherford,3946977,,False,25.0,2,6,1,4,1,2,1,3,0,5,5,1,1,1,2,3,6
401085933,Monmouth Hawks,TEAM,TOTAL,TOTAL,False,,28,59,18,37,10,22,18,32,8,22,30,12,4,5,10,25,84
401085933,Iona Gaels,T. Agee,4398087,,True,31.0,2,12,2,8,0,4,0,1,2,8,10,2,1,2,3,5,4
401085933,Iona Gaels,A. Ristanovic,4279492,,True,31.0,2,2,0,0,2,2,6,8,0,6,6,2,0,0,1,4,12
401085933,Iona Gaels,E.J. Crawford,4067295,,True,30.0,6,8,3,3,3,5,5,6,0,5,5,5,1,1,1,3,20
401085933,Iona Gaels,B. Perez,3948791,,True,32.0,6,8,2,2,4,6,3,3,1,2,3,2,2,0,0,2,19
401085933,Iona Gaels,R. McGill,3948698,,True,38.0,9,11,6,6,3,5,8,11,0,2,2,3,4,0,3,1,29
401085933,Iona Gaels,N. Nikolic,4398090,,False,0.0,0,0,0,0,0,0,0,0,0,0,0,0,0,0,0,1,0
401085933,Iona Gaels,J. Maxwell,4398088,,False,25.0,5,9,1,2,4,7,2,4,1,6,7,3,0,0,1,3,16
401085933,Iona Gaels,M. Rhem,4404249,,False,1.0,0,1,0,1,0,0,0,0,0,0,0,0,0,0,0,0,0
401085933,Iona Gaels,P. Hudson,4398089,,False,4.0,0,0,0,0,0,0,0,0,1,0,1,0,0,0,0,1,0
401085933,Iona Gaels,A. Gist,4067164,,False,8.0,1,2,0,0,1,2,0,1,0,0,0,1,0,0,3,4,3
401085933,Iona Gaels,TEAM,TOTAL,TOTAL,False,,31,53,14,22,17,31,24,34,9,32,41,18,8,3,13,24,103
401085933,Iona Gaels,T. Agee,4398087,,True,31.0,2,12,2,8,0,4,0,1,2,8,10,2,1,2,3,5,4
401085933,Iona Gaels,A. Ristanovic,4279492,,True,31.0,2,2,0,0,2,2,6,8,0,6,6,2,0,0,1,4,12
401085933,Iona Gaels,E.J. Crawford,4067295,,True,30.0,6,8,3,3,3,5,5,6,0,5,5,5,1,1,1,3,20
401085933,Iona Gaels,B. Perez,3948791,,True,32.0,6,8,2,2,4,6,3,3,1,2,3,2,2,0,0,2,19
401085933,Iona Gaels,R. McGill,3948698,,True,38.0,9,11,6,6,3,5,8,11,0,2,2,3,4,0,3,1,29
401085933,Iona Gaels,N. Nikolic,4398090,,False,0.0,0,0,0,0,0,0,0,0,0,0,0,0,0,0,0,1,0
401085933,Iona Gaels,J. Maxwell,4398088,,False,25.0,5,9,1,2,4,7,2,4,1,6,7,3,0,0,1,3,16
401085933,Iona Gaels,M. Rhem,4404249,,False,1.0,0,1,0,1,0,0,0,0,0,0,0,0,0,0,0,0,0
401085933,Iona Gaels,P. Hudson,4398089,,False,4.0,0,0,0,0,0,0,0,0,1,0,1,0,0,0,0,1,0
401085933,Iona Gaels,A. Gist,4067164,,False,8.0,1,2,0,0,1,2,0,1,0,0,0,1,0,0,3,4,3
401085933,Iona Gaels,TEAM,TOTAL,TOTAL,False,,31,53,14,22,17,31,24,34,9,32,41,18,8,3,13,24,103
401085932,Iona Gaels,T. Agee,4398087,,True,36.0,7,13,6,11,1,2,3,4,3,9,12,0,1,0,1,3,18
401085932,Iona Gaels,A. Ristanovic,4279492,,True,10.0,1,2,0,0,1,2,0,0,0,1,1,0,0,2,1,0,3
401085932,Iona Gaels,E.J. Crawford,4067295,,True,31.0,5,10,5,9,0,1,1,2,2,2,4,1,2,0,3,2,11
401085932,Iona Gaels,B. Perez,3948791,,True,24.0,1,5,0,1,1,4,0,0,0,0,0,0,0,0,0,2,3
401085932,Iona Gaels,R. McGill,3948698,,True,35.0,6,10,6,8,0,2,4,5,0,4,4,5,1,0,1,2,16
401085932,Iona Gaels,J. Maxwell,4398088,,False,2.0,0,0,0,0,0,0,0,0,0,0,0,0,0,0,1,1,0
401085932,Iona Gaels,A. Gist,4067164,,False,33.0,5,12,3,6,2,6,0,0,3,1,4,1,0,0,1,3,12
401085932,Iona Gaels,I. Still,3938908,,False,29.0,3,5,3,4,0,1,2,6,1,1,2,1,0,1,1,2,8
401085932,Iona Gaels,TEAM,TOTAL,TOTAL,False,,28,57,23,39,5,18,10,17,10,18,28,8,4,3,10,15,71
401085932,Holy Cross Crusaders,M. Faw,4280072,,True,17.0,3,8,2,3,1,5,0,0,1,2,3,1,0,1,1,4,7
401085932,Holy Cross Crusaders,J. Floyd,3907455,,True,28.0,3,5,3,5,0,0,0,0,1,4,5,1,1,4,5,4,6
401085932,Holy Cross Crusaders,J. Grandison,4280073,,True,40.0,8,12,4,7,4,5,5,5,3,6,9,8,0,1,4,3,25
401085932,Holy Cross Crusaders,A. Butler,4280070,,True,35.0,7,11,5,6,2,5,1,2,0,5,5,1,0,0,1,3,17
401085932,Holy Cross Crusaders,C. Green,4280068,,True,40.0,5,9,3,4,2,5,4,6,0,3,3,5,2,0,1,3,16
401085932,Holy Cross Crusaders,C. Le Sann,4067110,,False,5.0,1,3,0,0,1,3,0,0,0,0,0,0,0,0,1,0,3
401085932,Holy Cross Crusaders,P. Benzan,3907453,,False,35.0,2,6,2,5,0,1,0,0,2,3,5,2,2,0,0,0,4
401085932,Holy Cross Crusaders,TEAM,TOTAL,TOTAL,False,,29,54,19,30,10,24,10,13,10,23,33,18,5,6,14,17,78
401085931,Yale Bulldogs,J. Bruner,4066850,,True,25.0,2,6,1,4,1,2,5,7,4,6,10,6,0,3,0,0,10
401085931,Yale Bulldogs,B. Reynolds,3906996,,True,25.0,8,10,5,7,3,3,0,1,0,4,4,3,0,0,1,1,19
401085931,Yale Bulldogs,M. Oni,4066851,,True,20.0,4,9,2,5,2,4,0,0,2,8,10,4,0,1,2,2,10
401085931,Yale Bulldogs,T. Phills,3906995,,True,25.0,2,6,2,3,0,3,3,5,1,6,7,1,0,0,2,0,7
401085931,Yale Bulldogs,A. Copeland,3906992,,True,24.0,3,10,3,7,0,3,2,2,0,2,2,6,0,0,0,1,8
401085931,Yale Bulldogs,I. Kelly,4398015,,False,2.0,0,0,0,0,0,0,0,0,0,0,0,0,0,0,0,1,0
401085931,Yale Bulldogs,J. Lanford,4398014,,False,1.0,0,0,0,0,0,0,0,2,1,0,1,0,0,0,0,0,0
401085931,Yale Bulldogs,W. Yess,4279700,,False,2.0,2,2,2,2,0,0,0,0,1,0,1,0,0,0,0,0,4
401085931,Yale Bulldogs,P. Atkinson Jr.,4279699,,False,20.0,10,10,10,10,0,0,3,5,5,1,6,1,1,0,4,3,23
401085931,Yale Bulldogs,J. Alausa,4279698,,False,3.0,2,4,2,4,0,0,0,0,2,1,3,0,0,0,0,0,4
401085931,Yale Bulldogs,A. Williams,4066849,,False,0.0,0,0,0,0,0,0,0,0,0,0,0,0,0,0,0,0,0
401085931,Yale Bulldogs,T. Ryan,3948616,,False,4.0,0,2,0,0,0,2,0,1,0,0,0,0,0,0,1,1,0
401085931,Yale Bulldogs,M. Feinberg,4398013,,False,2.0,0,0,0,0,0,0,0,0,0,0,0,1,0,0,0,0,0
401085931,Yale Bulldogs,M. Cotton,4398012,,False,8.0,0,1,0,0,0,1,0,0,0,0,0,2,0,0,0,1,0
401085931,Yale Bulldogs,E. Dike,4398011,,False,1.0,0,0,0,0,0,0,0,0,0,0,0,0,0,0,0,2,0
401085931,Yale Bulldogs,A. Swain,4279697,,False,19.0,3,8,1,2,2,6,0,0,1,4,5,1,0,0,3,1,8
401085931,Yale Bulldogs,J. Gabbidon,4279696,,False,9.0,1,2,0,0,1,2,0,0,0,3,3,1,1,0,0,0,3
401085931,Yale Bulldogs,E. Monroe,4066848,,False,10.0,1,2,0,0,1,2,0,0,0,1,1,4,0,0,0,3,3
401085931,Yale Bulldogs,TEAM,TOTAL,TOTAL,False,,38,72,28,44,10,28,13,23,17,36,53,30,2,4,13,16,99
401085931,Iona Gaels,A. Ristanovic,4279492,,True,26.0,2,6,0,1,2,5,0,0,1,7,8,2,0,0,0,1,6
401085931,Iona Gaels,E.J. Crawford,4067295,,True,33.0,9,14,7,8,2,6,3,4,0,3,3,1,1,0,0,1,23
401085931,Iona Gaels,B. Perez,3948791,,True,26.0,3,9,2,2,1,7,0,0,0,1,1,1,0,0,0,1,7
401085931,Iona Gaels,R. McGill,3948698,,True,30.0,5,13,5,10,0,3,3,3,1,3,4,3,3,0,0,5,13
401085931,Iona Gaels,I. Still,3938908,,True,10.0,0,2,0,1,0,1,0,0,0,0,0,0,0,0,1,2,0
401085931,Iona Gaels,N. Nikolic,4398090,,False,9.0,0,2,0,2,0,0,1,2,3,1,4,0,0,2,1,2,1
401085931,Iona Gaels,J. Maxwell,4398088,,False,9.0,0,1,0,0,0,1,1,2,0,1,1,0,0,0,1,2,1
401085931,Iona Gaels,T. Agee,4398087,,False,21.0,4,11,2,6,2,5,3,5,0,5,5,1,4,1,4,5,13
401085931,Iona Gaels,P. Hudson,4398089,,False,5.0,0,0,0,0,0,0,0,0,0,0,0,3,0,0,0,0,0
401085931,Iona Gaels,A. Gist,4067164,,False,31.0,6,12,3,5,3,7,5,6,1,2,3,4,1,0,0,2,20
401085931,Iona Gaels,TEAM,TOTAL,TOTAL,False,,29,70,19,35,10,35,16,22,7,23,30,15,9,3,7,21,84
401085930,Princeton Tigers,R. Aririguzoh,4066847,,True,26.0,4,6,4,6,0,0,2,2,3,2,5,1,1,1,2,4,10
401085930,Princeton Tigers,J. Llewellyn,4398002,,True,38.0,10,15,8,11,2,4,0,0,0,3,3,8,1,1,2,0,22
401085930,Princeton Tigers,J. Morales,4066845,,True,36.0,3,9,1,3,2,6,4,4,0,1,1,5,1,0,1,2,12
401085930,Princeton Tigers,M. Stephens,3906978,,True,23.0,4,9,4,7,0,2,2,4,0,3,3,0,1,0,2,1,10
401085930,Princeton Tigers,D. Cannady,3906977,,True,37.0,6,16,0,1,6,15,4,4,0,4,4,1,4,0,1,1,22
401085930,Princeton Tigers,D. Friberg,4398004,,False,9.0,3,4,0,0,3,4,0,0,1,0,1,1,0,0,1,2,9
401085930,Princeton Tigers,J. Desrosiers,4279566,,False,11.0,0,1,0,0,0,1,0,0,0,3,3,2,0,0,0,2,0
401085930,Princeton Tigers,W. Gladson,4066846,,False,8.0,0,3,0,2,0,1,0,0,1,1,2,1,0,0,0,0,0
401085930,Princeton Tigers,R. Schwieger,4279565,,False,8.0,0,1,0,0,0,1,0,0,0,2,2,0,0,0,1,2,0
401085930,Princeton Tigers,M. Johns,4398003,,False,4.0,0,0,0,0,0,0,0,0,1,0,1,0,0,0,0,0,0
401085930,Princeton Tigers,TEAM,TOTAL,TOTAL,False,,30,64,17,30,13,34,12,14,10,26,36,19,8,2,11,15,85
401085930,Iona Gaels,T. Agee,4398087,,True,26.0,6,9,5,6,1,3,2,2,0,2,2,2,0,1,3,4,15
401085930,Iona Gaels,I. Still,3938908,,True,24.0,3,7,2,5,1,2,2,2,0,2,2,3,0,0,1,4,9
401085930,Iona Gaels,E.J. Crawford,4067295,,True,34.0,7,14,2,8,5,6,2,4,1,2,3,1,0,0,2,2,21
401085930,Iona Gaels,A. Gist,4067164,,True,12.0,0,3,0,0,0,3,0,0,1,2,3,0,1,0,0,0,0
401085930,Iona Gaels,R. McGill,3948698,,True,40.0,5,11,5,9,0,2,2,2,0,6,6,6,1,0,2,2,12
401085930,Iona Gaels,N. Nikolic,4398090,,False,3.0,0,0,0,0,0,0,0,0,1,0,1,0,0,0,1,0,0
401085930,Iona Gaels,J. Maxwell,4398088,,False,11.0,0,1,0,1,0,0,0,0,1,2,3,1,0,2,0,1,0
401085930,Iona Gaels,A. Ristanovic,4279492,,False,17.0,4,6,1,1,3,5,0,0,0,2,2,1,1,1,2,1,11
401085930,Iona Gaels,P. Hudson,4398089,,False,0.0,0,0,0,0,0,0,0,0,0,0,0,0,0,0,0,1,0
401085930,Iona Gaels,B. Perez,3948791,,False,33.0,5,12,2,4,3,8,0,0,4,3,7,0,0,0,2,1,13
401085930,Iona Gaels,TEAM,TOTAL,TOTAL,False,,30,63,17,34,13,29,8,10,8,25,33,14,3,4,13,16,81
401085929,Iona Gaels,N. Nikolic,4398090,,True,5.0,0,1,0,1,0,0,0,0,0,0,0,0,0,0,1,1,0
401085929,Iona Gaels,E.J. Crawford,4067295,,True,35.0,4,11,2,7,2,4,7,8,3,4,7,3,0,0,0,3,17
401085929,Iona Gaels,I. Still,3938908,,True,37.0,5,10,4,7,1,3,3,3,1,5,6,3,1,0,2,1,14
401085929,Iona Gaels,A. Gist,4067164,,True,31.0,4,11,4,7,0,4,3,4,0,5,5,1,2,0,4,3,11
401085929,Iona Gaels,R. McGill,3948698,,True,40.0,4,9,4,7,0,2,1,3,2,3,5,5,4,2,4,2,9
401085929,Iona Gaels,J. Maxwell,4398088,,False,16.0,2,4,2,2,0,2,0,0,0,1,1,2,0,0,2,1,4
401085929,Iona Gaels,T. Agee,4398087,,False,30.0,6,7,4,5,2,2,2,2,2,9,11,0,1,0,5,5,16
401085929,Iona Gaels,A. Ristanovic,4279492,,False,4.0,0,2,0,1,0,1,0,0,0,0,0,0,0,0,0,0,0
401085929,Iona Gaels,P. Hudson,4398089,,False,2.0,0,0,0,0,0,0,0,0,0,0,0,0,0,0,0,0,0
401085929,Iona Gaels,TEAM,TOTAL,TOTAL,False,,25,55,20,37,5,18,16,20,9,28,37,14,8,2,18,16,71
401085929,Columbia Lions,P. Tape,4066805,,True,23.0,5,10,5,10,0,0,3,4,3,5,8,0,2,1,2,3,13
401085929,Columbia Lions,R. Brumant,4279466,,True,21.0,3,9,3,7,0,2,0,0,0,1,1,2,0,2,0,2,6
401085929,Columbia Lions,J. Killingsworth,4066807,,True,32.0,5,11,1,3,4,8,0,0,2,5,7,1,1,0,0,3,14
401085929,Columbia Lions,T. Bibbs,4279470,,True,9.0,0,2,0,2,0,0,0,0,0,1,1,1,0,0,0,1,0
401085929,Columbia Lions,G. Stefanini,4279467,,True,25.0,3,7,2,4,1,3,4,4,0,4,4,5,0,0,3,4,11
401085929,Columbia Lions,I. Nweke,4397926,,False,10.0,2,2,2,2,0,0,1,1,0,1,1,0,0,0,0,1,5
401085929,Columbia Lions,M. Ellis,4397927,,False,25.0,4,8,1,2,3,6,2,2,0,2,2,2,4,0,1,1,13
401085929,Columbia Lions,B. Milstein,4397925,,False,0.0,0,0,0,0,0,0,0,0,0,1,1,0,0,0,0,0,0
401085929,Columbia Lions,P. Barba,3948608,,False,5.0,0,1,0,0,0,1,0,0,0,0,0,1,0,0,0,0,0
401085929,Columbia Lions,Q. Adlesh,3948606,,False,36.0,4,11,2,3,2,8,0,0,0,2,2,5,0,0,3,0,10
401085929,Columbia Lions,C. Davis,3948605,,False,10.0,0,2,0,1,0,1,2,2,0,2,2,1,0,0,2,1,2
401085929,Columbia Lions,R. Hunter,3948604,,False,4.0,0,0,0,0,0,0,0,0,1,0,1,1,0,0,0,0,0
401085929,Columbia Lions,TEAM,TOTAL,TOTAL,False,,26,63,16,34,10,29,12,13,9,23,32,19,7,3,12,16,74
401085928,Ohio Bobcats,J. Carter,4067398,,True,26.0,8,15,7,12,1,3,3,4,1,5,6,2,1,0,2,3,20
401085928,Ohio Bobcats,D. Taylor,3907085,,True,27.0,6,9,6,9,0,0,0,0,5,6,11,0,0,2,1,4,12
401085928,Ohio Bobcats,A. Cowart Jr.,4397922,,True,26.0,1,6,1,4,0,2,1,2,2,6,8,3,0,0,1,1,3
401085928,Ohio Bobcats,J. Preston,4397916,,True,24.0,0,4,0,1,0,3,0,0,1,1,2,5,0,0,2,0,0
401085928,Ohio Bobcats,T. Kirk,4279447,,True,32.0,8,18,8,16,0,2,2,2,2,5,7,5,2,0,3,4,18
401085928,Ohio Bobcats,M. McMurray,4397923,,False,7.0,1,2,1,1,0,1,0,0,0,1,1,0,1,0,1,2,2
401085928,Ohio Bobcats,B. Vander Plas,4279448,,False,25.0,7,12,4,5,3,7,1,2,4,7,11,2,0,1,3,1,18
401085928,Ohio Bobcats,J. Reeves,4077675,,False,1.0,0,0,0,0,0,0,0,2,0,1,1,0,0,0,0,1,0
401085928,Ohio Bobcats,G. Block,3907082,,False,26.0,4,6,1,2,3,4,2,2,0,3,3,5,2,1,0,2,13
401085928,Ohio Bobcats,C. McGraw,4397921,,False,1.0,0,0,0,0,0,0,0,0,0,0,0,0,0,0,1,0,0
401085928,Ohio Bobcats,J. Tenerowicz,4397920,,False,1.0,0,0,0,0,0,0,0,0,0,1,1,1,0,0,0,0,0
401085928,Ohio Bobcats,T. James,4397919,,False,2.0,0,1,0,1,0,0,0,0,0,0,0,0,0,0,0,1,0
401085928,Ohio Bobcats,C. Murrell,4397918,,False,2.0,0,0,0,0,0,0,3,4,0,0,0,0,0,0,1,1,3
401085928,Ohio Bobcats,TEAM,TOTAL,TOTAL,False,,35,73,28,51,7,22,12,18,16,37,53,23,6,4,15,20,89
401085928,Iona Gaels,N. Nikolic,4398090,,True,16.0,1,4,1,4,0,0,0,3,0,1,1,0,1,0,2,4,2
401085928,Iona Gaels,T. Agee,4398087,,True,29.0,8,14,5,9,3,5,4,7,2,6,8,1,0,1,2,1,23
401085928,Iona Gaels,E.J. Crawford,4067295,,True,29.0,1,8,1,3,0,5,2,3,3,6,9,2,0,0,4,1,4
401085928,Iona Gaels,A. Gist,4067164,,True,31.0,2,12,1,5,1,7,0,0,2,1,3,4,1,0,1,2,5
401085928,Iona Gaels,R. McGill,3948698,,True,34.0,4,10,1,5,3,5,5,7,1,5,6,5,4,0,3,3,16
401085928,Iona Gaels,J. Maxwell,4398088,,False,17.0,2,5,2,2,0,3,1,1,2,2,4,2,2,0,2,6,5
401085928,Iona Gaels,A. Ristanovic,4279492,,False,12.0,2,5,1,2,1,3,1,1,0,1,1,0,0,1,1,0,6
401085928,Iona Gaels,P. Hudson,4398089,,False,13.0,0,2,0,1,0,1,0,0,0,1,1,1,1,0,0,0,0
401085928,Iona Gaels,I. Still,3938908,,False,19.0,1,5,0,1,1,4,1,2,0,2,2,1,0,0,2,4,4
401085928,Iona Gaels,TEAM,TOTAL,TOTAL,False,,21,65,12,32,9,33,14,24,13,26,39,16,9,2,17,21,65
401085927,Long Beach State Beach,K. Byers,4278752,,True,31.0,4,6,2,3,2,3,4,5,0,10,10,1,3,1,3,3,14
401085927,Long Beach State Beach,M. Riggins,3946948,,True,9.0,0,0,0,0,0,0,0,0,0,1,1,0,0,0,0,1,0
401085927,Long Beach State Beach,R. Freeman,4397495,,True,28.0,6,10,4,7,2,3,0,0,2,4,6,0,0,0,1,3,14
401085927,Long Beach State Beach,E. Maxhuni,4278756,,True,17.0,3,6,1,2,2,4,0,0,0,0,0,1,0,0,3,2,8
401085927,Long Beach State Beach,D. Booker,4278753,,True,34.0,4,8,4,7,0,1,6,6,1,3,4,7,0,0,7,3,14
401085927,Long Beach State Beach,B. Jackson,4397497,,False,10.0,0,1,0,1,0,0,1,2,3,3,6,0,1,0,1,1,1
401085927,Long Beach State Beach,J. Roberts,4278751,,False,13.0,1,3,1,3,0,0,1,2,0,3,3,1,1,0,2,2,3
401085927,Long Beach State Beach,T. Yussuf,3137252,,False,26.0,7,12,7,12,0,0,4,5,1,2,3,2,0,1,4,3,18
401085927,Long Beach State Beach,D. Mims,4397498,,False,0.0,0,0,0,0,0,0,0,0,0,0,0,0,0,0,0,1,0
401085927,Long Beach State Beach,D. Cobb,4397496,,False,1.0,0,0,0,0,0,0,0,0,0,0,0,0,0,0,0,0,0
401085927,Long Beach State Beach,B. Richard,4278754,,False,4.0,0,0,0,0,0,0,0,0,0,0,0,0,0,0,1,1,0
401085927,Long Beach State Beach,J. Griffin,4066920,,False,7.0,2,2,1,1,1,1,0,0,0,0,0,1,0,0,0,0,5
401085927,Long Beach State Beach,B. Alberts,3155939,,False,20.0,3,6,0,1,3,5,0,0,0,0,0,0,1,0,2,5,9
401085927,Long Beach State Beach,TEAM,TOTAL,TOTAL,False,,30,54,20,37,10,17,16,20,9,27,36,13,6,2,25,25,86
401085927,Iona Gaels,T. Agee,4398087,,True,11.0,2,5,1,3,1,2,0,0,1,1,2,0,0,0,3,5,5
401085927,Iona Gaels,E.J. Crawford,4067295,,True,32.0,5,11,3,6,2,5,3,3,0,4,4,0,2,0,4,3,15
401085927,Iona Gaels,A. Gist,4067164,,True,30.0,5,10,2,3,3,7,4,6,0,0,0,0,4,0,3,2,17
401085927,Iona Gaels,R. McGill,3948698,,True,37.0,5,11,4,7,1,4,4,5,1,3,4,4,3,0,2,3,15
401085927,Iona Gaels,I. Still,3938908,,True,32.0,3,8,1,2,2,6,8,8,1,2,3,3,1,0,5,1,16
401085927,Iona Gaels,N. Nikolic,4398090,,False,14.0,1,3,1,3,0,0,1,2,2,1,3,0,0,1,0,0,3
401085927,Iona Gaels,J. Maxwell,4398088,,False,15.0,4,5,3,3,1,2,0,0,2,2,4,0,1,0,0,2,9
401085927,Iona Gaels,A. Ristanovic,4279492,,False,10.0,1,3,1,1,0,2,2,2,1,3,4,1,1,1,0,2,4
401085927,Iona Gaels,P. Hudson,4398089,,False,1.0,0,0,0,0,0,0,0,0,0,0,0,0,1,0,0,1,0
401085927,Iona Gaels,B. Perez,3948791,,False,18.0,0,4,0,1,0,3,1,2,0,1,1,3,1,0,0,2,1
401085927,Iona Gaels,TEAM,TOTAL,TOTAL,False,,26,60,16,29,10,31,23,28,10,17,27,11,14,2,17,21,85
401085926,Siena Saints,S. Seymour,4398391,,True,31.0,4,8,1,1,3,7,1,1,0,2,2,0,0,0,0,1,12
401085926,Siena Saints,E. Fisher,3913235,,True,34.0,8,16,8,15,0,1,1,1,2,5,7,2,1,0,0,1,17
401085926,Siena Saints,K. Degnan,3138282,,True,36.0,5,12,3,4,2,8,0,0,2,5,7,0,0,0,0,1,12
401085926,Siena Saints,J. Pickett,4398390,,True,38.0,5,20,4,15,1,5,0,0,3,7,10,8,1,1,3,3,11
401085926,Siena Saints,M. Camper,4279751,,True,35.0,3,7,3,6,0,1,0,1,1,7,8,1,0,0,1,3,6
401085926,Siena Saints,T. Huerter Jr.,4067350,,False,4.0,0,0,0,0,0,0,0,0,0,1,1,0,0,0,1,0,0
401085926,Siena Saints,J. Ratliff,4398392,,False,6.0,0,0,0,0,0,0,0,0,1,0,1,0,0,0,1,0,0
401085926,Siena Saints,K. Smithen,3133848,,False,16.0,1,1,1,1,0,0,2,2,1,0,1,0,0,0,1,4,4
401085926,Siena Saints,TEAM,TOTAL,TOTAL,False,,26,64,20,42,6,22,4,5,10,29,39,11,2,1,8,13,62
401085926,Siena Saints,S. Seymour,4398391,,True,31.0,4,8,1,1,3,7,1,1,0,2,2,0,0,0,0,1,12
401085926,Siena Saints,E. Fisher,3913235,,True,34.0,8,16,8,15,0,1,1,1,2,5,7,2,1,0,0,1,17
401085926,Siena Saints,K. Degnan,3138282,,True,36.0,5,12,3,4,2,8,0,0,2,5,7,0,0,0,0,1,12
401085926,Siena Saints,J. Pickett,4398390,,True,38.0,5,20,4,15,1,5,0,0,3,7,10,8,1,1,3,3,11
401085926,Siena Saints,M. Camper,4279751,,True,35.0,3,7,3,6,0,1,0,1,1,7,8,1,0,0,1,3,6
401085926,Siena Saints,T. Huerter Jr.,4067350,,False,4.0,0,0,0,0,0,0,0,0,0,1,1,0,0,0,1,0,0
401085926,Siena Saints,J. Ratliff,4398392,,False,6.0,0,0,0,0,0,0,0,0,1,0,1,0,0,0,1,0,0
401085926,Siena Saints,K. Smithen,3133848,,False,16.0,1,1,1,1,0,0,2,2,1,0,1,0,0,0,1,4,4
401085926,Siena Saints,TEAM,TOTAL,TOTAL,False,,26,64,20,42,6,22,4,5,10,29,39,11,2,1,8,13,62
401085926,Canisius Golden Griffins,S. Hitchon,4279482,,True,34.0,4,8,1,4,3,4,0,0,0,3,3,1,0,2,1,0,11
401085926,Canisius Golden Griffins,J. White,4279478,,True,25.0,6,10,6,9,0,1,1,4,0,2,2,0,0,0,0,0,13
401085926,Canisius Golden Griffins,T. Molson,4279481,,True,39.0,7,19,5,12,2,7,0,0,3,6,9,2,0,2,1,2,16
401085926,Canisius Golden Griffins,M. Johnson,4067275,,True,36.0,4,5,4,4,0,1,2,3,1,8,9,12,0,0,1,1,10
401085926,Canisius Golden Griffins,J. Sanks,3141259,,True,21.0,3,8,3,6,0,2,4,5,1,4,5,1,0,0,0,3,10
401085926,Canisius Golden Griffins,D. St. Louis,4067280,,False,3.0,0,0,0,0,0,0,0,0,0,1,1,0,0,0,0,0,0
401085926,Canisius Golden Griffins,J. Faulkner,3137250,,False,17.0,1,5,1,1,0,4,0,0,0,2,2,0,1,1,0,1,2
401085926,Canisius Golden Griffins,J. Henderson,4398046,,False,25.0,2,3,1,1,1,2,1,2,0,3,3,2,1,0,0,3,6
401085926,Canisius Golden Griffins,TEAM,TOTAL,TOTAL,False,,27,58,21,37,6,21,8,14,5,29,34,18,2,5,3,10,68
401085926,Canisius Golden Griffins,S. Hitchon,4279482,,True,34.0,4,8,1,4,3,4,0,0,0,3,3,1,0,2,1,0,11
401085926,Canisius Golden Griffins,J. White,4279478,,True,25.0,6,10,6,9,0,1,1,4,0,2,2,0,0,0,0,0,13
401085926,Canisius Golden Griffins,T. Molson,4279481,,True,39.0,7,19,5,12,2,7,0,0,3,6,9,2,0,2,1,2,16
401085926,Canisius Golden Griffins,M. Johnson,4067275,,True,36.0,4,5,4,4,0,1,2,3,1,8,9,12,0,0,1,1,10
401085926,Canisius Golden Griffins,J. Sanks,3141259,,True,21.0,3,8,3,6,0,2,4,5,1,4,5,1,0,0,0,3,10
401085926,Canisius Golden Griffins,D. St. Louis,4067280,,False,3.0,0,0,0,0,0,0,0,0,0,1,1,0,0,0,0,0,0
401085926,Canisius Golden Griffins,J. Faulkner,3137250,,False,17.0,1,5,1,1,0,4,0,0,0,2,2,0,1,1,0,1,2
401085926,Canisius Golden Griffins,J. Henderson,4398046,,False,25.0,2,3,1,1,1,2,1,2,0,3,3,2,1,0,0,3,6
401085926,Canisius Golden Griffins,TEAM,TOTAL,TOTAL,False,,27,58,21,37,6,21,8,14,5,29,34,18,2,5,3,10,68
401085925,Niagara Purple Eagles,M. Prochet,3907184,,True,31.0,3,6,3,4,0,2,3,4,2,3,5,4,0,2,0,0,9
401085925,Niagara Purple Eagles,G. King,3906490,,True,15.0,2,3,2,3,0,0,0,0,1,1,2,0,0,0,0,1,4
401085925,Niagara Purple Eagles,M. Hammond,4398404,,True,35.0,6,10,1,4,5,6,1,2,1,6,7,2,0,1,0,1,18
401085925,Niagara Purple Eagles,R. Solomon,4398403,,True,15.0,0,5,0,2,0,3,0,0,0,3,3,1,2,1,3,2,0
401085925,Niagara Purple Eagles,C. Barton,3907182,,True,21.0,3,8,2,6,1,2,3,7,2,0,2,1,1,0,0,4,10
401085925,Niagara Purple Eagles,G. Kuakumensah,4279739,,False,9.0,1,1,0,0,1,1,0,0,0,2,2,0,0,0,1,1,3
401085925,Niagara Purple Eagles,D. Robb,3907186,,False,25.0,6,7,6,6,0,1,8,8,0,0,0,2,0,1,3,1,20
401085925,Niagara Purple Eagles,K. Tate,4279738,,False,16.0,1,2,0,0,1,2,2,2,0,0,0,0,1,0,0,0,5
401085925,Niagara Purple Eagles,D. Fragala,4279737,,False,8.0,2,3,0,0,2,3,0,0,0,0,0,0,0,0,0,0,6
401085925,Niagara Purple Eagles,J. Towns,4067341,,False,25.0,3,7,2,5,1,2,4,4,0,5,5,4,0,0,2,2,11
401085925,Niagara Purple Eagles,TEAM,TOTAL,TOTAL,False,,27,52,16,30,11,22,21,27,8,20,28,14,4,5,9,12,86
401085925,Niagara Purple Eagles,M. Prochet,3907184,,True,31.0,3,6,3,4,0,2,3,4,2,3,5,4,0,2,0,0,9
401085925,Niagara Purple Eagles,G. King,3906490,,True,15.0,2,3,2,3,0,0,0,0,1,1,2,0,0,0,0,1,4
401085925,Niagara Purple Eagles,M. Hammond,4398404,,True,35.0,6,10,1,4,5,6,1,2,1,6,7,2,0,1,0,1,18
401085925,Niagara Purple Eagles,R. Solomon,4398403,,True,15.0,0,5,0,2,0,3,0,0,0,3,3,1,2,1,3,2,0
401085925,Niagara Purple Eagles,C. Barton,3907182,,True,21.0,3,8,2,6,1,2,3,7,2,0,2,1,1,0,0,4,10
401085925,Niagara Purple Eagles,G. Kuakumensah,4279739,,False,9.0,1,1,0,0,1,1,0,0,0,2,2,0,0,0,1,1,3
401085925,Niagara Purple Eagles,D. Robb,3907186,,False,25.0,6,7,6,6,0,1,8,8,0,0,0,2,0,1,3,1,20
401085925,Niagara Purple Eagles,K. Tate,4279738,,False,16.0,1,2,0,0,1,2,2,2,0,0,0,0,1,0,0,0,5
401085925,Niagara Purple Eagles,D. Fragala,4279737,,False,8.0,2,3,0,0,2,3,0,0,0,0,0,0,0,0,0,0,6
401085925,Niagara Purple Eagles,J. Towns,4067341,,False,25.0,3,7,2,5,1,2,4,4,0,5,5,4,0,0,2,2,11
401085925,Niagara Purple Eagles,TEAM,TOTAL,TOTAL,False,,27,52,16,30,11,22,21,27,8,20,28,14,4,5,9,12,86
401085925,Canisius Golden Griffins,S. Hitchon,4279482,,True,25.0,3,6,2,3,1,3,0,0,0,3,3,4,0,0,4,2,7
401085925,Canisius Golden Griffins,J. White,4279478,,True,19.0,3,4,2,3,1,1,3,4,1,1,2,0,1,0,2,2,10
401085925,Canisius Golden Griffins,T. Molson,4279481,,True,38.0,11,19,8,9,3,10,3,4,3,6,9,0,0,0,1,0,28
401085925,Canisius Golden Griffins,M. Johnson,4067275,,True,29.0,6,12,4,6,2,6,1,2,1,2,3,5,0,0,0,4,15
401085925,Canisius Golden Griffins,J. Sanks,3141259,,True,36.0,4,7,1,4,3,3,2,3,0,3,3,3,1,0,0,4,13
401085925,Canisius Golden Griffins,D. St. Louis,4067280,,False,10.0,0,0,0,0,0,0,0,0,0,0,0,0,0,0,0,1,0
401085925,Canisius Golden Griffins,J. Faulkner,3137250,,False,24.0,4,7,4,4,0,3,0,0,3,0,3,2,0,0,2,3,8
401085925,Canisius Golden Griffins,J. Henderson,4398046,,False,19.0,1,6,0,1,1,5,0,0,0,2,2,1,0,0,0,5,3
401085925,Canisius Golden Griffins,TEAM,TOTAL,TOTAL,False,,32,61,21,30,11,31,9,13,11,18,29,15,2,0,10,21,84
401085925,Canisius Golden Griffins,S. Hitchon,4279482,,True,25.0,3,6,2,3,1,3,0,0,0,3,3,4,0,0,4,2,7
401085925,Canisius Golden Griffins,J. White,4279478,,True,19.0,3,4,2,3,1,1,3,4,1,1,2,0,1,0,2,2,10
401085925,Canisius Golden Griffins,T. Molson,4279481,,True,38.0,11,19,8,9,3,10,3,4,3,6,9,0,0,0,1,0,28
401085925,Canisius Golden Griffins,M. Johnson,4067275,,True,29.0,6,12,4,6,2,6,1,2,1,2,3,5,0,0,0,4,15
401085925,Canisius Golden Griffins,J. Sanks,3141259,,True,36.0,4,7,1,4,3,3,2,3,0,3,3,3,1,0,0,4,13
401085925,Canisius Golden Griffins,D. St. Louis,4067280,,False,10.0,0,0,0,0,0,0,0,0,0,0,0,0,0,0,0,1,0
401085925,Canisius Golden Griffins,J. Faulkner,3137250,,False,24.0,4,7,4,4,0,3,0,0,3,0,3,2,0,0,2,3,8
401085925,Canisius Golden Griffins,J. Henderson,4398046,,False,19.0,1,6,0,1,1,5,0,0,0,2,2,1,0,0,0,5,3
401085925,Canisius Golden Griffins,TEAM,TOTAL,TOTAL,False,,32,61,21,30,11,31,9,13,11,18,29,15,2,0,10,21,84
401085924,Iona Gaels,T. Agee,4398087,,True,27.0,8,12,6,10,2,2,1,1,4,5,9,2,0,1,3,2,19
401085924,Iona Gaels,E.J. Crawford,4067295,,True,40.0,6,13,6,8,0,5,6,6,0,2,2,3,0,0,1,0,18
401085924,Iona Gaels,A. Gist,4067164,,True,30.0,3,7,2,5,1,2,2,2,1,1,2,1,0,0,1,3,9
401085924,Iona Gaels,B. Perez,3948791,,True,29.0,0,0,0,0,0,0,2,2,0,3,3,1,0,1,3,1,2
401085924,Iona Gaels,R. McGill,3948698,,True,40.0,8,16,3,6,5,10,9,9,1,6,7,4,4,0,0,1,30
401085924,Iona Gaels,J. Maxwell,4398088,,False,7.0,0,0,0,0,0,0,1,2,1,0,1,0,0,0,0,0,1
401085924,Iona Gaels,A. Ristanovic,4279492,,False,26.0,2,4,0,1,2,3,2,2,1,4,5,0,0,3,1,3,8
401085924,Iona Gaels,P. Hudson,4398089,,False,1.0,0,0,0,0,0,0,0,0,0,0,0,0,0,0,0,0,0
401085924,Iona Gaels,TEAM,TOTAL,TOTAL,False,,27,52,17,30,10,22,23,24,11,21,32,11,4,5,9,10,87
401085924,Iona Gaels,T. Agee,4398087,,True,27.0,8,12,6,10,2,2,1,1,4,5,9,2,0,1,3,2,19
401085924,Iona Gaels,E.J. Crawford,4067295,,True,40.0,6,13,6,8,0,5,6,6,0,2,2,3,0,0,1,0,18
401085924,Iona Gaels,A. Gist,4067164,,True,30.0,3,7,2,5,1,2,2,2,1,1,2,1,0,0,1,3,9
401085924,Iona Gaels,B. Perez,3948791,,True,29.0,0,0,0,0,0,0,2,2,0,3,3,1,0,1,3,1,2
401085924,Iona Gaels,R. McGill,3948698,,True,40.0,8,16,3,6,5,10,9,9,1,6,7,4,4,0,0,1,30
401085924,Iona Gaels,J. Maxwell,4398088,,False,7.0,0,0,0,0,0,0,1,2,1,0,1,0,0,0,0,0,1
401085924,Iona Gaels,A. Ristanovic,4279492,,False,26.0,2,4,0,1,2,3,2,2,1,4,5,0,0,3,1,3,8
401085924,Iona Gaels,P. Hudson,4398089,,False,1.0,0,0,0,0,0,0,0,0,0,0,0,0,0,0,0,0,0
401085924,Iona Gaels,TEAM,TOTAL,TOTAL,False,,27,52,17,30,10,22,23,24,11,21,32,11,4,5,9,10,87
401085924,Canisius Golden Griffins,S. Hitchon,4279482,,True,11.0,3,5,2,3,1,2,0,0,0,0,0,2,0,0,1,4,7
401085924,Canisius Golden Griffins,J. White,4279478,,True,22.0,3,5,2,4,1,1,0,0,0,1,1,1,1,2,1,4,7
401085924,Canisius Golden Griffins,T. Molson,4279481,,True,38.0,9,16,7,10,2,6,1,2,4,6,10,6,0,0,4,3,21
401085924,Canisius Golden Griffins,M. Johnson,4067275,,True,34.0,4,8,2,5,2,3,2,2,0,1,1,4,0,0,1,4,12
401085924,Canisius Golden Griffins,J. Sanks,3141259,,True,35.0,5,14,2,5,3,9,3,4,1,0,1,4,1,1,1,2,16
401085924,Canisius Golden Griffins,M. Lotts,4279480,,False,8.0,2,2,2,2,0,0,0,0,0,0,0,0,0,0,0,1,4
401085924,Canisius Golden Griffins,D. St. Louis,4067280,,False,9.0,0,1,0,1,0,0,0,0,1,0,1,0,0,0,0,2,0
401085924,Canisius Golden Griffins,J. Faulkner,3137250,,False,29.0,5,7,4,4,1,3,2,4,1,2,3,1,2,1,0,0,13
401085924,Canisius Golden Griffins,J. Henderson,4398046,,False,14.0,0,2,0,0,0,2,0,0,0,1,1,0,0,0,0,0,0
401085924,Canisius Golden Griffins,TEAM,TOTAL,TOTAL,False,,31,60,21,34,10,26,8,12,10,14,24,18,4,4,8,20,80
401085924,Canisius Golden Griffins,S. Hitchon,4279482,,True,11.0,3,5,2,3,1,2,0,0,0,0,0,2,0,0,1,4,7
401085924,Canisius Golden Griffins,J. White,4279478,,True,22.0,3,5,2,4,1,1,0,0,0,1,1,1,1,2,1,4,7
401085924,Canisius Golden Griffins,T. Molson,4279481,,True,38.0,9,16,7,10,2,6,1,2,4,6,10,6,0,0,4,3,21
401085924,Canisius Golden Griffins,M. Johnson,4067275,,True,34.0,4,8,2,5,2,3,2,2,0,1,1,4,0,0,1,4,12
401085924,Canisius Golden Griffins,J. Sanks,3141259,,True,35.0,5,14,2,5,3,9,3,4,1,0,1,4,1,1,1,2,16
401085924,Canisius Golden Griffins,M. Lotts,4279480,,False,8.0,2,2,2,2,0,0,0,0,0,0,0,0,0,0,0,1,4
401085924,Canisius Golden Griffins,D. St. Louis,4067280,,False,9.0,0,1,0,1,0,0,0,0,1,0,1,0,0,0,0,2,0
401085924,Canisius Golden Griffins,J. Faulkner,3137250,,False,29.0,5,7,4,4,1,3,2,4,1,2,3,1,2,1,0,0,13
401085924,Canisius Golden Griffins,J. Henderson,4398046,,False,14.0,0,2,0,0,0,2,0,0,0,1,1,0,0,0,0,0,0
401085924,Canisius Golden Griffins,TEAM,TOTAL,TOTAL,False,,31,60,21,34,10,26,8,12,10,14,24,18,4,4,8,20,80
401085923,Monmouth Hawks,M. Traore,3975762,,True,26.0,4,9,4,9,0,0,2,4,2,6,8,0,0,0,0,1,10
401085923,Monmouth Hawks,D. Quinn,3948714,,True,21.0,5,10,5,10,0,0,3,4,1,7,8,0,1,1,1,2,13
401085923,Monmouth Hawks,M. McClary,4279736,,True,27.0,2,4,2,4,0,0,0,1,1,1,2,2,2,1,0,4,4
401085923,Monmouth Hawks,D. Hammond,4279734,,True,24.0,5,10,2,3,3,7,1,2,1,3,4,2,0,0,4,4,14
401085923,Monmouth Hawks,R. Salnave,4067329,,True,28.0,2,4,2,3,0,1,3,4,1,4,5,5,2,0,5,4,7
401085923,Monmouth Hawks,S. Ibiezugbe,4067330,,False,15.0,0,5,0,5,0,0,0,0,1,3,4,0,0,0,1,1,0
401085923,Monmouth Hawks,M. Martin,4279733,,False,14.0,2,2,1,1,1,1,0,0,0,1,1,0,0,0,0,0,5
401085923,Monmouth Hawks,S. Chaput,4398409,,False,8.0,0,2,0,1,0,1,0,0,0,0,0,0,0,0,1,1,0
401085923,Monmouth Hawks,G. Papas,4279735,,False,1.0,0,0,0,0,0,0,0,0,0,0,0,0,0,0,0,0,0
401085923,Monmouth Hawks,T. Gross Jr.,4065729,,False,2.0,0,0,0,0,0,0,0,0,0,0,0,0,0,0,0,0,0
401085923,Monmouth Hawks,L. Pillari,3948713,,False,9.0,1,3,1,2,0,1,0,0,0,0,0,1,0,0,2,2,2
401085923,Monmouth Hawks,N. Rutherford,3946977,,False,25.0,1,2,1,2,0,0,2,2,1,3,4,1,2,0,3,1,4
401085923,Monmouth Hawks,TEAM,TOTAL,TOTAL,False,,22,51,18,40,4,11,11,17,9,29,38,11,7,2,17,20,59
401085923,Monmouth Hawks,M. Traore,3975762,,True,26.0,4,9,4,9,0,0,2,4,2,6,8,0,0,0,0,1,10
401085923,Monmouth Hawks,D. Quinn,3948714,,True,21.0,5,10,5,10,0,0,3,4,1,7,8,0,1,1,1,2,13
401085923,Monmouth Hawks,M. McClary,4279736,,True,27.0,2,4,2,4,0,0,0,1,1,1,2,2,2,1,0,4,4
401085923,Monmouth Hawks,D. Hammond,4279734,,True,24.0,5,10,2,3,3,7,1,2,1,3,4,2,0,0,4,4,14
401085923,Monmouth Hawks,R. Salnave,4067329,,True,28.0,2,4,2,3,0,1,3,4,1,4,5,5,2,0,5,4,7
401085923,Monmouth Hawks,S. Ibiezugbe,4067330,,False,15.0,0,5,0,5,0,0,0,0,1,3,4,0,0,0,1,1,0
401085923,Monmouth Hawks,M. Martin,4279733,,False,14.0,2,2,1,1,1,1,0,0,0,1,1,0,0,0,0,0,5
401085923,Monmouth Hawks,S. Chaput,4398409,,False,8.0,0,2,0,1,0,1,0,0,0,0,0,0,0,0,1,1,0
401085923,Monmouth Hawks,G. Papas,4279735,,False,1.0,0,0,0,0,0,0,0,0,0,0,0,0,0,0,0,0,0
401085923,Monmouth Hawks,T. Gross Jr.,4065729,,False,2.0,0,0,0,0,0,0,0,0,0,0,0,0,0,0,0,0,0
401085923,Monmouth Hawks,L. Pillari,3948713,,False,9.0,1,3,1,2,0,1,0,0,0,0,0,1,0,0,2,2,2
401085923,Monmouth Hawks,N. Rutherford,3946977,,False,25.0,1,2,1,2,0,0,2,2,1,3,4,1,2,0,3,1,4
401085923,Monmouth Hawks,TEAM,TOTAL,TOTAL,False,,22,51,18,40,4,11,11,17,9,29,38,11,7,2,17,20,59
401085923,Canisius Golden Griffins,S. Hitchon,4279482,,True,31.0,5,9,4,6,1,3,3,4,3,3,6,2,2,2,1,3,14
401085923,Canisius Golden Griffins,J. White,4279478,,True,20.0,0,2,0,2,0,0,4,4,1,2,3,1,0,2,0,1,4
401085923,Canisius Golden Griffins,T. Molson,4279481,,True,34.0,5,16,2,5,3,11,2,4,2,4,6,2,1,1,1,2,15
401085923,Canisius Golden Griffins,M. Johnson,4067275,,True,36.0,1,9,1,4,0,5,1,2,0,3,3,3,2,0,3,1,3
401085923,Canisius Golden Griffins,J. Sanks,3141259,,True,32.0,2,11,0,2,2,9,6,8,1,3,4,3,0,0,3,3,12
401085923,Canisius Golden Griffins,M. Lotts,4279480,,False,8.0,0,1,0,1,0,0,0,0,2,2,4,0,0,1,2,1,0
401085923,Canisius Golden Griffins,D. St. Louis,4067280,,False,1.0,0,0,0,0,0,0,0,0,0,0,0,0,0,0,1,2,0
401085923,Canisius Golden Griffins,J. Faulkner,3137250,,False,19.0,3,8,0,3,3,5,0,0,2,4,6,1,0,0,1,1,9
401085923,Canisius Golden Griffins,S. Rautins,4398047,,False,0.0,0,0,0,0,0,0,0,0,0,0,0,0,0,0,0,0,0
401085923,Canisius Golden Griffins,J. Henderson,4398046,,False,19.0,1,1,0,0,1,1,0,0,0,0,0,0,0,0,2,4,3
401085923,Canisius Golden Griffins,TEAM,TOTAL,TOTAL,False,,17,57,7,23,10,34,16,22,12,23,35,12,5,6,15,18,60
401085923,Canisius Golden Griffins,S. Hitchon,4279482,,True,31.0,5,9,4,6,1,3,3,4,3,3,6,2,2,2,1,3,14
401085923,Canisius Golden Griffins,J. White,4279478,,True,20.0,0,2,0,2,0,0,4,4,1,2,3,1,0,2,0,1,4
401085923,Canisius Golden Griffins,T. Molson,4279481,,True,34.0,5,16,2,5,3,11,2,4,2,4,6,2,1,1,1,2,15
401085923,Canisius Golden Griffins,M. Johnson,4067275,,True,36.0,1,9,1,4,0,5,1,2,0,3,3,3,2,0,3,1,3
401085923,Canisius Golden Griffins,J. Sanks,3141259,,True,32.0,2,11,0,2,2,9,6,8,1,3,4,3,0,0,3,3,12
401085923,Canisius Golden Griffins,M. Lotts,4279480,,False,8.0,0,1,0,1,0,0,0,0,2,2,4,0,0,1,2,1,0
401085923,Canisius Golden Griffins,D. St. Louis,4067280,,False,1.0,0,0,0,0,0,0,0,0,0,0,0,0,0,0,1,2,0
401085923,Canisius Golden Griffins,J. Faulkner,3137250,,False,19.0,3,8,0,3,3,5,0,0,2,4,6,1,0,0,1,1,9
401085923,Canisius Golden Griffins,S. Rautins,4398047,,False,0.0,0,0,0,0,0,0,0,0,0,0,0,0,0,0,0,0,0
401085923,Canisius Golden Griffins,J. Henderson,4398046,,False,19.0,1,1,0,0,1,1,0,0,0,0,0,0,0,0,2,4,3
401085923,Canisius Golden Griffins,TEAM,TOTAL,TOTAL,False,,17,57,7,23,10,34,16,22,12,23,35,12,5,6,15,18,60
401085922,Manhattan Jaspers,T. Reynolds,4398107,,True,21.0,4,6,2,2,2,4,0,0,0,3,3,3,2,0,0,0,10
401085922,Manhattan Jaspers,W. Williams,4279701,,True,11.0,5,5,5,5,0,0,2,2,0,3,3,0,0,0,0,4,12
401085922,Manhattan Jaspers,C. Hinckson,4398106,,True,23.0,3,3,3,3,0,0,0,0,0,1,1,3,0,1,1,3,6
401085922,Manhattan Jaspers,S. Stewart,4398104,,True,32.0,5,7,2,2,3,5,0,0,0,1,1,1,1,0,3,2,13
401085922,Manhattan Jaspers,N. Mack,4279703,,True,20.0,1,1,1,1,0,0,2,3,0,1,1,4,0,0,2,2,4
401085922,Manhattan Jaspers,D. Schreier,4398105,,False,5.0,1,1,0,0,1,1,0,0,0,0,0,0,0,0,0,0,3
401085922,Manhattan Jaspers,E. Ebube,4279705,,False,29.0,0,6,0,6,0,0,0,0,0,2,2,0,1,1,2,4,0
401085922,Manhattan Jaspers,T. Greene,4398108,,False,20.0,4,5,3,4,1,1,2,3,2,2,4,2,0,0,1,3,11
401085922,Manhattan Jaspers,E. Buchanan,4398103,,False,19.0,1,5,1,4,0,1,0,2,1,0,1,1,0,0,2,2,2
401085922,Manhattan Jaspers,T. Capuano,3948706,,False,9.0,1,1,0,0,1,1,0,0,0,0,0,0,0,0,2,1,3
401085922,Manhattan Jaspers,S. Usilo,3138468,,False,11.0,3,3,3,3,0,0,0,1,0,1,1,0,1,0,0,1,6
401085922,Manhattan Jaspers,TEAM,TOTAL,TOTAL,False,,28,43,20,30,8,13,6,11,4,16,20,14,5,2,14,22,70
401085922,Manhattan Jaspers,T. Reynolds,4398107,,True,21.0,4,6,2,2,2,4,0,0,0,3,3,3,2,0,0,0,10
401085922,Manhattan Jaspers,W. Williams,4279701,,True,11.0,5,5,5,5,0,0,2,2,0,3,3,0,0,0,0,4,12
401085922,Manhattan Jaspers,C. Hinckson,4398106,,True,23.0,3,3,3,3,0,0,0,0,0,1,1,3,0,1,1,3,6
401085922,Manhattan Jaspers,S. Stewart,4398104,,True,32.0,5,7,2,2,3,5,0,0,0,1,1,1,1,0,3,2,13
401085922,Manhattan Jaspers,N. Mack,4279703,,True,20.0,1,1,1,1,0,0,2,3,0,1,1,4,0,0,2,2,4
401085922,Manhattan Jaspers,D. Schreier,4398105,,False,5.0,1,1,0,0,1,1,0,0,0,0,0,0,0,0,0,0,3
401085922,Manhattan Jaspers,E. Ebube,4279705,,False,29.0,0,6,0,6,0,0,0,0,0,2,2,0,1,1,2,4,0
401085922,Manhattan Jaspers,T. Greene,4398108,,False,20.0,4,5,3,4,1,1,2,3,2,2,4,2,0,0,1,3,11
401085922,Manhattan Jaspers,E. Buchanan,4398103,,False,19.0,1,5,1,4,0,1,0,2,1,0,1,1,0,0,2,2,2
401085922,Manhattan Jaspers,T. Capuano,3948706,,False,9.0,1,1,0,0,1,1,0,0,0,0,0,0,0,0,2,1,3
401085922,Manhattan Jaspers,S. Usilo,3138468,,False,11.0,3,3,3,3,0,0,0,1,0,1,1,0,1,0,0,1,6
401085922,Manhattan Jaspers,TEAM,TOTAL,TOTAL,False,,28,43,20,30,8,13,6,11,4,16,20,14,5,2,14,22,70
401085922,Canisius Golden Griffins,S. Hitchon,4279482,,True,33.0,4,6,3,5,1,1,1,1,0,2,2,1,0,1,1,2,10
401085922,Canisius Golden Griffins,J. White,4279478,,True,11.0,0,1,0,1,0,0,0,0,1,0,1,0,0,1,2,0,0
401085922,Canisius Golden Griffins,T. Molson,4279481,,True,36.0,3,11,1,5,2,6,7,8,3,2,5,3,2,0,3,2,15
401085922,Canisius Golden Griffins,M. Johnson,4067275,,True,40.0,3,9,1,5,2,4,0,0,1,1,2,9,3,0,4,1,8
401085922,Canisius Golden Griffins,J. Sanks,3141259,,True,34.0,3,6,0,1,3,5,1,2,1,3,4,2,0,0,1,5,10
401085922,Canisius Golden Griffins,D. St. Louis,4067280,,False,7.0,0,1,0,1,0,0,0,0,0,1,1,0,0,0,1,0,0
401085922,Canisius Golden Griffins,J. Faulkner,3137250,,False,25.0,7,10,6,9,1,1,5,8,1,6,7,0,1,0,1,0,20
401085922,Canisius Golden Griffins,S. Rautins,4398047,,False,0.0,0,0,0,0,0,0,0,0,0,0,0,0,0,0,0,0,0
401085922,Canisius Golden Griffins,J. Henderson,4398046,,False,14.0,0,1,0,0,0,1,2,2,1,0,1,0,1,0,0,5,2
401085922,Canisius Golden Griffins,TEAM,TOTAL,TOTAL,False,,20,45,11,27,9,18,16,21,9,15,24,15,7,2,15,15,65
401085922,Canisius Golden Griffins,S. Hitchon,4279482,,True,33.0,4,6,3,5,1,1,1,1,0,2,2,1,0,1,1,2,10
401085922,Canisius Golden Griffins,J. White,4279478,,True,11.0,0,1,0,1,0,0,0,0,1,0,1,0,0,1,2,0,0
401085922,Canisius Golden Griffins,T. Molson,4279481,,True,36.0,3,11,1,5,2,6,7,8,3,2,5,3,2,0,3,2,15
401085922,Canisius Golden Griffins,M. Johnson,4067275,,True,40.0,3,9,1,5,2,4,0,0,1,1,2,9,3,0,4,1,8
401085922,Canisius Golden Griffins,J. Sanks,3141259,,True,34.0,3,6,0,1,3,5,1,2,1,3,4,2,0,0,1,5,10
401085922,Canisius Golden Griffins,D. St. Louis,4067280,,False,7.0,0,1,0,1,0,0,0,0,0,1,1,0,0,0,1,0,0
401085922,Canisius Golden Griffins,J. Faulkner,3137250,,False,25.0,7,10,6,9,1,1,5,8,1,6,7,0,1,0,1,0,20
401085922,Canisius Golden Griffins,S. Rautins,4398047,,False,0.0,0,0,0,0,0,0,0,0,0,0,0,0,0,0,0,0,0
401085922,Canisius Golden Griffins,J. Henderson,4398046,,False,14.0,0,1,0,0,0,1,2,2,1,0,1,0,1,0,0,5,2
401085922,Canisius Golden Griffins,TEAM,TOTAL,TOTAL,False,,20,45,11,27,9,18,16,21,9,15,24,15,7,2,15,15,65
401085921,Fairfield Stags,J. Kasibabu,3947016,,True,32.0,7,12,7,11,0,1,2,2,3,2,5,0,2,0,2,4,16
401085921,Fairfield Stags,M. Milin,3947018,,True,28.0,2,6,2,3,0,3,1,2,3,6,9,0,1,1,1,3,5
401085921,Fairfield Stags,N. Alvarez,4398075,,True,38.0,5,15,3,11,2,4,2,2,0,2,2,4,0,0,2,2,14
401085921,Fairfield Stags,J. Cruz,4279488,,True,39.0,7,14,7,12,0,2,4,4,0,3,3,3,0,0,3,1,18
401085921,Fairfield Stags,T. Benning,4279483,,True,24.0,3,6,2,3,1,3,0,0,0,2,2,1,2,0,5,3,7
401085921,Fairfield Stags,C. Whipple,4398077,,False,14.0,1,2,0,1,1,1,0,0,0,2,2,1,0,0,0,0,3
401085921,Fairfield Stags,F. Lemetti,4398076,,False,1.0,0,0,0,0,0,0,0,0,0,1,1,0,0,0,0,0,0
401085921,Fairfield Stags,A. Kavaliauskas,4080375,,False,24.0,1,2,0,0,1,2,2,3,0,2,2,1,1,0,3,4,5
401085921,Fairfield Stags,TEAM,TOTAL,TOTAL,False,,26,57,21,41,5,16,11,13,12,24,36,10,6,1,17,17,68
401085921,Fairfield Stags,J. Kasibabu,3947016,,True,32.0,7,12,7,11,0,1,2,2,3,2,5,0,2,0,2,4,16
401085921,Fairfield Stags,M. Milin,3947018,,True,28.0,2,6,2,3,0,3,1,2,3,6,9,0,1,1,1,3,5
401085921,Fairfield Stags,N. Alvarez,4398075,,True,38.0,5,15,3,11,2,4,2,2,0,2,2,4,0,0,2,2,14
401085921,Fairfield Stags,J. Cruz,4279488,,True,39.0,7,14,7,12,0,2,4,4,0,3,3,3,0,0,3,1,18
401085921,Fairfield Stags,T. Benning,4279483,,True,24.0,3,6,2,3,1,3,0,0,0,2,2,1,2,0,5,3,7
401085921,Fairfield Stags,C. Whipple,4398077,,False,14.0,1,2,0,1,1,1,0,0,0,2,2,1,0,0,0,0,3
401085921,Fairfield Stags,F. Lemetti,4398076,,False,1.0,0,0,0,0,0,0,0,0,0,1,1,0,0,0,0,0,0
401085921,Fairfield Stags,A. Kavaliauskas,4080375,,False,24.0,1,2,0,0,1,2,2,3,0,2,2,1,1,0,3,4,5
401085921,Fairfield Stags,TEAM,TOTAL,TOTAL,False,,26,57,21,41,5,16,11,13,12,24,36,10,6,1,17,17,68
401085921,Canisius Golden Griffins,S. Hitchon,4279482,,True,28.0,7,11,2,4,5,7,2,2,0,0,0,3,0,3,1,2,21
401085921,Canisius Golden Griffins,J. White,4279478,,True,26.0,7,14,7,10,0,4,2,4,2,5,7,1,0,3,2,1,16
401085921,Canisius Golden Griffins,T. Molson,4279481,,True,21.0,3,5,1,2,2,3,1,2,3,2,5,1,1,0,3,5,9
401085921,Canisius Golden Griffins,M. Johnson,4067275,,True,40.0,2,9,2,6,0,3,5,7,0,5,5,7,2,0,3,1,9
401085921,Canisius Golden Griffins,J. Sanks,3141259,,True,19.0,0,3,0,2,0,1,0,0,0,2,2,0,3,0,0,2,0
401085921,Canisius Golden Griffins,M. Lotts,4279480,,False,5.0,0,0,0,0,0,0,0,0,0,0,0,0,0,0,1,1,0
401085921,Canisius Golden Griffins,D. St. Louis,4067280,,False,8.0,0,0,0,0,0,0,0,0,0,1,1,0,0,1,1,2,0
401085921,Canisius Golden Griffins,J. Faulkner,3137250,,False,12.0,3,6,1,2,2,4,0,0,0,0,0,1,1,0,1,0,8
401085921,Canisius Golden Griffins,S. Rautins,4398047,,False,12.0,0,0,0,0,0,0,0,0,0,2,2,0,0,0,0,1,0
401085921,Canisius Golden Griffins,J. Henderson,4398046,,False,29.0,3,6,2,3,1,3,2,3,0,1,1,5,3,1,1,1,9
401085921,Canisius Golden Griffins,TEAM,TOTAL,TOTAL,False,,25,54,15,29,10,25,12,18,8,19,27,18,10,8,14,16,72
401085921,Canisius Golden Griffins,S. Hitchon,4279482,,True,28.0,7,11,2,4,5,7,2,2,0,0,0,3,0,3,1,2,21
401085921,Canisius Golden Griffins,J. White,4279478,,True,26.0,7,14,7,10,0,4,2,4,2,5,7,1,0,3,2,1,16
401085921,Canisius Golden Griffins,T. Molson,4279481,,True,21.0,3,5,1,2,2,3,1,2,3,2,5,1,1,0,3,5,9
401085921,Canisius Golden Griffins,M. Johnson,4067275,,True,40.0,2,9,2,6,0,3,5,7,0,5,5,7,2,0,3,1,9
401085921,Canisius Golden Griffins,J. Sanks,3141259,,True,19.0,0,3,0,2,0,1,0,0,0,2,2,0,3,0,0,2,0
401085921,Canisius Golden Griffins,M. Lotts,4279480,,False,5.0,0,0,0,0,0,0,0,0,0,0,0,0,0,0,1,1,0
401085921,Canisius Golden Griffins,D. St. Louis,4067280,,False,8.0,0,0,0,0,0,0,0,0,0,1,1,0,0,1,1,2,0
401085921,Canisius Golden Griffins,J. Faulkner,3137250,,False,12.0,3,6,1,2,2,4,0,0,0,0,0,1,1,0,1,0,8
401085921,Canisius Golden Griffins,S. Rautins,4398047,,False,12.0,0,0,0,0,0,0,0,0,0,2,2,0,0,0,0,1,0
401085921,Canisius Golden Griffins,J. Henderson,4398046,,False,29.0,3,6,2,3,1,3,2,3,0,1,1,5,3,1,1,1,9
401085921,Canisius Golden Griffins,TEAM,TOTAL,TOTAL,False,,25,54,15,29,10,25,12,18,8,19,27,18,10,8,14,16,72
401085920,Saint Peter's Peacocks,KC Ndefo,4398386,,True,23.0,2,4,2,4,0,0,2,2,0,1,1,2,2,2,4,0,6
401085920,Saint Peter's Peacocks,S. Idowu,3922042,,True,22.0,4,6,3,4,1,2,2,2,1,5,6,1,0,1,2,1,11
401085920,Saint Peter's Peacocks,Q. Taylor,4067357,,True,30.0,3,5,3,4,0,1,0,1,3,0,3,1,1,0,2,0,6
401085920,Saint Peter's Peacocks,D. Watson,4398384,,True,29.0,2,7,0,2,2,5,2,2,0,1,1,1,1,0,2,2,8
401085920,Saint Peter's Peacocks,D. Turner,4067356,,True,30.0,2,8,1,4,1,4,3,5,1,3,4,1,0,0,4,3,8
401085920,Saint Peter's Peacocks,D. Woods,3919424,,False,18.0,5,10,5,8,0,2,4,4,1,5,6,0,1,1,1,1,14
401085920,Saint Peter's Peacocks,K. Brown,4398385,,False,20.0,1,2,0,0,1,2,0,0,2,2,4,3,0,1,1,0,3
401085920,Saint Peter's Peacocks,M. Dixon,4279758,,False,28.0,2,6,2,5,0,1,0,0,1,3,4,0,1,0,0,4,4
401085920,Saint Peter's Peacocks,TEAM,TOTAL,TOTAL,False,,21,48,16,31,5,17,13,16,10,22,32,9,6,5,16,11,60
401085920,Saint Peter's Peacocks,KC Ndefo,4398386,,True,23.0,2,4,2,4,0,0,2,2,0,1,1,2,2,2,4,0,6
401085920,Saint Peter's Peacocks,S. Idowu,3922042,,True,22.0,4,6,3,4,1,2,2,2,1,5,6,1,0,1,2,1,11
401085920,Saint Peter's Peacocks,Q. Taylor,4067357,,True,30.0,3,5,3,4,0,1,0,1,3,0,3,1,1,0,2,0,6
401085920,Saint Peter's Peacocks,D. Watson,4398384,,True,29.0,2,7,0,2,2,5,2,2,0,1,1,1,1,0,2,2,8
401085920,Saint Peter's Peacocks,D. Turner,4067356,,True,30.0,2,8,1,4,1,4,3,5,1,3,4,1,0,0,4,3,8
401085920,Saint Peter's Peacocks,D. Woods,3919424,,False,18.0,5,10,5,8,0,2,4,4,1,5,6,0,1,1,1,1,14
401085920,Saint Peter's Peacocks,K. Brown,4398385,,False,20.0,1,2,0,0,1,2,0,0,2,2,4,3,0,1,1,0,3
401085920,Saint Peter's Peacocks,M. Dixon,4279758,,False,28.0,2,6,2,5,0,1,0,0,1,3,4,0,1,0,0,4,4
401085920,Saint Peter's Peacocks,TEAM,TOTAL,TOTAL,False,,21,48,16,31,5,17,13,16,10,22,32,9,6,5,16,11,60
401085920,Canisius Golden Griffins,S. Hitchon,4279482,,True,22.0,4,7,2,4,2,3,1,2,1,0,1,2,0,1,0,2,11
401085920,Canisius Golden Griffins,J. White,4279478,,True,12.0,2,3,2,3,0,0,0,0,0,1,1,0,0,1,0,0,4
401085920,Canisius Golden Griffins,T. Molson,4279481,,True,35.0,8,11,5,5,3,6,2,2,1,4,5,2,1,0,3,2,21
401085920,Canisius Golden Griffins,M. Johnson,4067275,,True,40.0,4,11,3,8,1,3,2,2,0,4,4,8,4,0,2,2,11
401085920,Canisius Golden Griffins,J. Sanks,3141259,,True,35.0,2,10,2,4,0,6,0,0,0,2,2,2,1,0,1,4,4
401085920,Canisius Golden Griffins,M. Lotts,4279480,,False,7.0,1,1,1,1,0,0,0,0,0,0,0,0,0,0,0,0,2
401085920,Canisius Golden Griffins,D. St. Louis,4067280,,False,11.0,1,2,1,2,0,0,0,0,0,0,0,0,0,0,0,1,2
401085920,Canisius Golden Griffins,J. Faulkner,3137250,,False,11.0,2,2,0,0,2,2,0,0,0,1,1,0,0,0,2,2,6
401085920,Canisius Golden Griffins,J. Henderson,4398046,,False,27.0,1,5,0,1,1,4,0,0,0,2,2,0,2,1,1,2,3
401085920,Canisius Golden Griffins,TEAM,TOTAL,TOTAL,False,,25,52,16,28,9,24,5,6,3,17,20,14,8,3,9,15,64
401085920,Canisius Golden Griffins,S. Hitchon,4279482,,True,22.0,4,7,2,4,2,3,1,2,1,0,1,2,0,1,0,2,11
401085920,Canisius Golden Griffins,J. White,4279478,,True,12.0,2,3,2,3,0,0,0,0,0,1,1,0,0,1,0,0,4
401085920,Canisius Golden Griffins,T. Molson,4279481,,True,35.0,8,11,5,5,3,6,2,2,1,4,5,2,1,0,3,2,21
401085920,Canisius Golden Griffins,M. Johnson,4067275,,True,40.0,4,11,3,8,1,3,2,2,0,4,4,8,4,0,2,2,11
401085920,Canisius Golden Griffins,J. Sanks,3141259,,True,35.0,2,10,2,4,0,6,0,0,0,2,2,2,1,0,1,4,4
401085920,Canisius Golden Griffins,M. Lotts,4279480,,False,7.0,1,1,1,1,0,0,0,0,0,0,0,0,0,0,0,0,2
401085920,Canisius Golden Griffins,D. St. Louis,4067280,,False,11.0,1,2,1,2,0,0,0,0,0,0,0,0,0,0,0,1,2
401085920,Canisius Golden Griffins,J. Faulkner,3137250,,False,11.0,2,2,0,0,2,2,0,0,0,1,1,0,0,0,2,2,6
401085920,Canisius Golden Griffins,J. Henderson,4398046,,False,27.0,1,5,0,1,1,4,0,0,0,2,2,0,2,1,1,2,3
401085920,Canisius Golden Griffins,TEAM,TOTAL,TOTAL,False,,25,52,16,28,9,24,5,6,3,17,20,14,8,3,9,15,64
401085919,Rider Broncs,D. Vaughn,4067347,,True,35.0,4,6,4,6,0,0,5,9,0,3,3,3,1,3,0,2,13
401085919,Rider Broncs,D. Eke,3941312,,True,14.0,2,3,2,3,0,0,1,6,0,3,3,0,0,0,0,2,5
401085919,Rider Broncs,T. Marshall,4067348,,True,21.0,5,10,5,10,0,0,0,1,2,3,5,2,1,0,1,2,10
401085919,Rider Broncs,S. Jordan,4067349,,True,37.0,8,13,7,11,1,2,5,7,3,2,5,4,2,0,5,0,22
401085919,Rider Broncs,A. Durham,3138490,,True,30.0,2,5,1,3,1,2,2,2,1,4,5,1,0,0,2,2,7
401085919,Rider Broncs,A. Ogemuno-Johnson,4406151,,False,1.0,0,0,0,0,0,0,0,0,0,0,0,0,0,0,0,0,0
401085919,Rider Broncs,F. Scott,3922033,,False,26.0,5,10,5,8,0,2,4,4,1,2,3,1,0,0,0,4,14
401085919,Rider Broncs,J. Allen,4067345,,False,23.0,1,4,0,0,1,4,0,0,0,4,4,0,1,0,3,0,3
401085919,Rider Broncs,K. Williams,3946983,,False,7.0,2,3,2,3,0,0,0,0,0,0,0,3,2,0,0,0,4
401085919,Rider Broncs,A. Gilbert,3911886,,False,6.0,1,3,1,1,0,2,0,0,0,0,0,0,1,0,0,1,2
401085919,Rider Broncs,TEAM,TOTAL,TOTAL,False,,30,57,27,45,3,12,17,29,7,24,31,14,8,3,11,13,80
401085919,Rider Broncs,D. Vaughn,4067347,,True,35.0,4,6,4,6,0,0,5,9,0,3,3,3,1,3,0,2,13
401085919,Rider Broncs,D. Eke,3941312,,True,14.0,2,3,2,3,0,0,1,6,0,3,3,0,0,0,0,2,5
401085919,Rider Broncs,T. Marshall,4067348,,True,21.0,5,10,5,10,0,0,0,1,2,3,5,2,1,0,1,2,10
401085919,Rider Broncs,S. Jordan,4067349,,True,37.0,8,13,7,11,1,2,5,7,3,2,5,4,2,0,5,0,22
401085919,Rider Broncs,A. Durham,3138490,,True,30.0,2,5,1,3,1,2,2,2,1,4,5,1,0,0,2,2,7
401085919,Rider Broncs,A. Ogemuno-Johnson,4406151,,False,1.0,0,0,0,0,0,0,0,0,0,0,0,0,0,0,0,0,0
401085919,Rider Broncs,F. Scott,3922033,,False,26.0,5,10,5,8,0,2,4,4,1,2,3,1,0,0,0,4,14
401085919,Rider Broncs,J. Allen,4067345,,False,23.0,1,4,0,0,1,4,0,0,0,4,4,0,1,0,3,0,3
401085919,Rider Broncs,K. Williams,3946983,,False,7.0,2,3,2,3,0,0,0,0,0,0,0,3,2,0,0,0,4
401085919,Rider Broncs,A. Gilbert,3911886,,False,6.0,1,3,1,1,0,2,0,0,0,0,0,0,1,0,0,1,2
401085919,Rider Broncs,TEAM,TOTAL,TOTAL,False,,30,57,27,45,3,12,17,29,7,24,31,14,8,3,11,13,80
401085919,Canisius Golden Griffins,S. Hitchon,4279482,,True,23.0,5,8,4,7,1,1,4,4,1,3,4,2,1,0,2,3,15
401085919,Canisius Golden Griffins,J. White,4279478,,True,20.0,1,3,1,3,0,0,0,0,0,2,2,2,0,1,1,5,2
401085919,Canisius Golden Griffins,T. Molson,4279481,,True,39.0,6,13,5,6,1,7,4,4,1,7,8,1,1,1,2,4,17
401085919,Canisius Golden Griffins,M. Johnson,4067275,,True,40.0,4,10,3,7,1,3,4,4,0,4,4,8,3,0,4,4,13
401085919,Canisius Golden Griffins,J. Sanks,3141259,,True,34.0,6,9,1,1,5,8,0,0,1,1,2,3,1,0,2,4,17
401085919,Canisius Golden Griffins,D. St. Louis,4067280,,False,9.0,3,4,3,4,0,0,2,3,1,2,3,0,0,0,0,1,8
401085919,Canisius Golden Griffins,J. Faulkner,3137250,,False,14.0,1,6,0,1,1,5,1,2,0,2,2,0,0,0,0,1,4
401085919,Canisius Golden Griffins,J. Henderson,4398046,,False,21.0,2,3,1,1,1,2,0,0,0,2,2,1,1,0,1,3,5
401085919,Canisius Golden Griffins,TEAM,TOTAL,TOTAL,False,,28,56,18,30,10,26,15,17,5,26,31,17,7,2,14,25,81
401085919,Canisius Golden Griffins,S. Hitchon,4279482,,True,23.0,5,8,4,7,1,1,4,4,1,3,4,2,1,0,2,3,15
401085919,Canisius Golden Griffins,J. White,4279478,,True,20.0,1,3,1,3,0,0,0,0,0,2,2,2,0,1,1,5,2
401085919,Canisius Golden Griffins,T. Molson,4279481,,True,39.0,6,13,5,6,1,7,4,4,1,7,8,1,1,1,2,4,17
401085919,Canisius Golden Griffins,M. Johnson,4067275,,True,40.0,4,10,3,7,1,3,4,4,0,4,4,8,3,0,4,4,13
401085919,Canisius Golden Griffins,J. Sanks,3141259,,True,34.0,6,9,1,1,5,8,0,0,1,1,2,3,1,0,2,4,17
401085919,Canisius Golden Griffins,D. St. Louis,4067280,,False,9.0,3,4,3,4,0,0,2,3,1,2,3,0,0,0,0,1,8
401085919,Canisius Golden Griffins,J. Faulkner,3137250,,False,14.0,1,6,0,1,1,5,1,2,0,2,2,0,0,0,0,1,4
401085919,Canisius Golden Griffins,J. Henderson,4398046,,False,21.0,2,3,1,1,1,2,0,0,0,2,2,1,1,0,1,3,5
401085919,Canisius Golden Griffins,TEAM,TOTAL,TOTAL,False,,28,56,18,30,10,26,15,17,5,26,31,17,7,2,14,25,81
401085918,Marist Red Foxes,I. Lamb,3936028,,True,24.0,1,4,0,2,1,2,0,0,0,1,1,1,0,1,1,1,3
401085918,Marist Red Foxes,T. Sjoberg,4067328,,True,10.0,2,2,2,2,0,0,4,4,2,2,4,0,0,0,0,1,8
401085918,Marist Red Foxes,D. Hines,4398410,,True,35.0,2,4,0,2,2,2,2,2,0,2,2,2,1,0,2,2,8
401085918,Marist Red Foxes,B. Parker,3936030,,True,21.0,4,9,4,8,0,1,1,2,0,3,3,2,0,0,1,1,9
401085918,Marist Red Foxes,D. Knudsen,3936027,,True,20.0,6,11,3,3,3,8,0,0,0,1,1,2,0,1,0,2,15
401085918,Marist Red Foxes,L. Nedrow,4398414,,False,7.0,0,1,0,0,0,1,0,0,0,0,0,0,1,0,1,1,0
401085918,Marist Red Foxes,R. Funk,3936026,,False,30.0,1,6,1,1,0,5,2,2,0,4,4,2,0,0,1,1,4
401085918,Marist Red Foxes,A. Dozic,3923222,,False,27.0,7,10,6,9,1,1,2,2,2,3,5,6,0,0,2,3,17
401085918,Marist Red Foxes,M. Herasme,4398413,,False,29.0,1,4,0,0,1,4,5,6,1,2,3,2,0,0,1,1,8
401085918,Marist Red Foxes,A. Williams,4279709,,False,22.0,3,5,3,5,0,0,0,0,2,3,5,0,2,0,2,3,6
401085918,Marist Red Foxes,TEAM,TOTAL,TOTAL,False,,27,56,19,32,8,24,16,18,8,23,31,17,4,2,11,16,78
401085918,Marist Red Foxes,I. Lamb,3936028,,True,24.0,1,4,0,2,1,2,0,0,0,1,1,1,0,1,1,1,3
401085918,Marist Red Foxes,T. Sjoberg,4067328,,True,10.0,2,2,2,2,0,0,4,4,2,2,4,0,0,0,0,1,8
401085918,Marist Red Foxes,D. Hines,4398410,,True,35.0,2,4,0,2,2,2,2,2,0,2,2,2,1,0,2,2,8
401085918,Marist Red Foxes,B. Parker,3936030,,True,21.0,4,9,4,8,0,1,1,2,0,3,3,2,0,0,1,1,9
401085918,Marist Red Foxes,D. Knudsen,3936027,,True,20.0,6,11,3,3,3,8,0,0,0,1,1,2,0,1,0,2,15
401085918,Marist Red Foxes,L. Nedrow,4398414,,False,7.0,0,1,0,0,0,1,0,0,0,0,0,0,1,0,1,1,0
401085918,Marist Red Foxes,R. Funk,3936026,,False,30.0,1,6,1,1,0,5,2,2,0,4,4,2,0,0,1,1,4
401085918,Marist Red Foxes,A. Dozic,3923222,,False,27.0,7,10,6,9,1,1,2,2,2,3,5,6,0,0,2,3,17
401085918,Marist Red Foxes,M. Herasme,4398413,,False,29.0,1,4,0,0,1,4,5,6,1,2,3,2,0,0,1,1,8
401085918,Marist Red Foxes,A. Williams,4279709,,False,22.0,3,5,3,5,0,0,0,0,2,3,5,0,2,0,2,3,6
401085918,Marist Red Foxes,TEAM,TOTAL,TOTAL,False,,27,56,19,32,8,24,16,18,8,23,31,17,4,2,11,16,78
401085918,Canisius Golden Griffins,S. Hitchon,4279482,,True,28.0,3,9,3,8,0,1,0,0,0,1,1,1,0,0,1,1,6
401085918,Canisius Golden Griffins,J. White,4279478,,True,26.0,3,5,3,5,0,0,0,0,2,0,2,2,1,1,3,4,6
401085918,Canisius Golden Griffins,T. Molson,4279481,,True,38.0,5,13,3,6,2,7,7,7,0,5,5,2,2,0,2,2,19
401085918,Canisius Golden Griffins,M. Johnson,4067275,,True,43.0,6,12,4,5,2,7,5,5,1,8,9,7,2,0,4,4,19
401085918,Canisius Golden Griffins,J. Sanks,3141259,,True,30.0,2,8,1,3,1,5,2,2,1,2,3,0,1,0,0,2,7
401085918,Canisius Golden Griffins,D. St. Louis,4067280,,False,6.0,0,0,0,0,0,0,0,0,0,1,1,0,0,0,0,1,0
401085918,Canisius Golden Griffins,J. Faulkner,3137250,,False,27.0,4,7,4,5,0,2,0,0,3,3,6,2,0,0,0,1,8
401085918,Canisius Golden Griffins,J. Henderson,4398046,,False,27.0,2,5,1,1,1,4,1,2,1,0,1,0,0,0,2,2,6
401085918,Canisius Golden Griffins,TEAM,TOTAL,TOTAL,False,,25,59,19,33,6,26,15,16,11,21,32,14,6,1,13,17,71
401085918,Canisius Golden Griffins,S. Hitchon,4279482,,True,28.0,3,9,3,8,0,1,0,0,0,1,1,1,0,0,1,1,6
401085918,Canisius Golden Griffins,J. White,4279478,,True,26.0,3,5,3,5,0,0,0,0,2,0,2,2,1,1,3,4,6
401085918,Canisius Golden Griffins,T. Molson,4279481,,True,38.0,5,13,3,6,2,7,7,7,0,5,5,2,2,0,2,2,19
401085918,Canisius Golden Griffins,M. Johnson,4067275,,True,43.0,6,12,4,5,2,7,5,5,1,8,9,7,2,0,4,4,19
401085918,Canisius Golden Griffins,J. Sanks,3141259,,True,30.0,2,8,1,3,1,5,2,2,1,2,3,0,1,0,0,2,7
401085918,Canisius Golden Griffins,D. St. Louis,4067280,,False,6.0,0,0,0,0,0,0,0,0,0,1,1,0,0,0,0,1,0
401085918,Canisius Golden Griffins,J. Faulkner,3137250,,False,27.0,4,7,4,5,0,2,0,0,3,3,6,2,0,0,0,1,8
401085918,Canisius Golden Griffins,J. Henderson,4398046,,False,27.0,2,5,1,1,1,4,1,2,1,0,1,0,0,0,2,2,6
401085918,Canisius Golden Griffins,TEAM,TOTAL,TOTAL,False,,25,59,19,33,6,26,15,16,11,21,32,14,6,1,13,17,71
401085917,Niagara Purple Eagles,D. Robb,3907186,,True,23.0,6,10,6,8,0,2,2,2,3,3,6,0,0,3,3,1,14
401085917,Niagara Purple Eagles,M. Prochet,3907184,,True,31.0,6,11,3,7,3,4,8,8,1,3,4,1,0,1,3,0,23
401085917,Niagara Purple Eagles,K. Tate,4279738,,True,30.0,1,5,1,2,0,3,1,3,1,3,4,1,1,0,1,3,3
401085917,Niagara Purple Eagles,J. Towns,4067341,,True,35.0,4,8,4,6,0,2,3,4,1,5,6,5,1,0,1,1,11
401085917,Niagara Purple Eagles,C. Barton,3907182,,True,31.0,2,4,2,3,0,1,1,2,2,2,4,0,0,0,1,1,5
401085917,Niagara Purple Eagles,G. Kuakumensah,4279739,,False,9.0,1,2,0,1,1,1,1,2,0,2,2,0,1,0,0,0,4
401085917,Niagara Purple Eagles,G. King,3906490,,False,17.0,3,6,3,6,0,0,4,4,2,1,3,0,0,1,2,1,10
401085917,Niagara Purple Eagles,M. Hammond,4398404,,False,10.0,2,2,0,0,2,2,2,2,0,0,0,0,0,1,0,0,8
401085917,Niagara Purple Eagles,R. Solomon,4398403,,False,14.0,0,3,0,1,0,2,0,0,0,2,2,0,0,0,2,2,0
401085917,Niagara Purple Eagles,TEAM,TOTAL,TOTAL,False,,25,51,19,34,6,17,22,27,11,23,34,7,3,6,14,9,78
401085917,Niagara Purple Eagles,D. Robb,3907186,,True,23.0,6,10,6,8,0,2,2,2,3,3,6,0,0,3,3,1,14
401085917,Niagara Purple Eagles,M. Prochet,3907184,,True,31.0,6,11,3,7,3,4,8,8,1,3,4,1,0,1,3,0,23
401085917,Niagara Purple Eagles,K. Tate,4279738,,True,30.0,1,5,1,2,0,3,1,3,1,3,4,1,1,0,1,3,3
401085917,Niagara Purple Eagles,J. Towns,4067341,,True,35.0,4,8,4,6,0,2,3,4,1,5,6,5,1,0,1,1,11
401085917,Niagara Purple Eagles,C. Barton,3907182,,True,31.0,2,4,2,3,0,1,1,2,2,2,4,0,0,0,1,1,5
401085917,Niagara Purple Eagles,G. Kuakumensah,4279739,,False,9.0,1,2,0,1,1,1,1,2,0,2,2,0,1,0,0,0,4
401085917,Niagara Purple Eagles,G. King,3906490,,False,17.0,3,6,3,6,0,0,4,4,2,1,3,0,0,1,2,1,10
401085917,Niagara Purple Eagles,M. Hammond,4398404,,False,10.0,2,2,0,0,2,2,2,2,0,0,0,0,0,1,0,0,8
401085917,Niagara Purple Eagles,R. Solomon,4398403,,False,14.0,0,3,0,1,0,2,0,0,0,2,2,0,0,0,2,2,0
401085917,Niagara Purple Eagles,TEAM,TOTAL,TOTAL,False,,25,51,19,34,6,17,22,27,11,23,34,7,3,6,14,9,78
401085917,Canisius Golden Griffins,S. Hitchon,4279482,,True,18.0,2,5,2,4,0,1,0,0,0,1,1,5,0,0,2,1,4
401085917,Canisius Golden Griffins,J. White,4279478,,True,20.0,4,10,4,10,0,0,1,2,1,0,1,0,1,1,4,3,9
401085917,Canisius Golden Griffins,T. Molson,4279481,,True,34.0,3,9,0,1,3,8,0,0,2,5,7,2,1,0,1,4,9
401085917,Canisius Golden Griffins,I. Reese,4067278,,True,8.0,0,3,0,2,0,1,0,0,1,2,3,1,0,1,0,0,0
401085917,Canisius Golden Griffins,M. Johnson,4067275,,True,39.0,5,9,4,7,1,2,1,2,0,3,3,9,4,0,1,5,12
401085917,Canisius Golden Griffins,M. Lotts,4279480,,False,2.0,0,0,0,0,0,0,0,0,0,0,0,0,0,0,0,1,0
401085917,Canisius Golden Griffins,D. St. Louis,4067280,,False,10.0,1,1,1,1,0,0,0,0,0,2,2,0,0,0,0,1,2
401085917,Canisius Golden Griffins,J. Faulkner,3137250,,False,30.0,6,9,6,8,0,1,1,1,0,1,1,1,1,1,2,2,13
401085917,Canisius Golden Griffins,J. Henderson,4398046,,False,10.0,2,4,1,2,1,2,0,0,0,1,1,0,0,0,0,3,5
401085917,Canisius Golden Griffins,J. Sanks,3141259,,False,29.0,6,11,4,4,2,7,2,2,2,2,4,1,0,0,2,2,16
401085917,Canisius Golden Griffins,TEAM,TOTAL,TOTAL,False,,29,61,22,39,7,22,5,7,10,17,27,19,7,3,13,22,70
401085917,Canisius Golden Griffins,S. Hitchon,4279482,,True,18.0,2,5,2,4,0,1,0,0,0,1,1,5,0,0,2,1,4
401085917,Canisius Golden Griffins,J. White,4279478,,True,20.0,4,10,4,10,0,0,1,2,1,0,1,0,1,1,4,3,9
401085917,Canisius Golden Griffins,T. Molson,4279481,,True,34.0,3,9,0,1,3,8,0,0,2,5,7,2,1,0,1,4,9
401085917,Canisius Golden Griffins,I. Reese,4067278,,True,8.0,0,3,0,2,0,1,0,0,1,2,3,1,0,1,0,0,0
401085917,Canisius Golden Griffins,M. Johnson,4067275,,True,39.0,5,9,4,7,1,2,1,2,0,3,3,9,4,0,1,5,12
401085917,Canisius Golden Griffins,M. Lotts,4279480,,False,2.0,0,0,0,0,0,0,0,0,0,0,0,0,0,0,0,1,0
401085917,Canisius Golden Griffins,D. St. Louis,4067280,,False,10.0,1,1,1,1,0,0,0,0,0,2,2,0,0,0,0,1,2
401085917,Canisius Golden Griffins,J. Faulkner,3137250,,False,30.0,6,9,6,8,0,1,1,1,0,1,1,1,1,1,2,2,13
401085917,Canisius Golden Griffins,J. Henderson,4398046,,False,10.0,2,4,1,2,1,2,0,0,0,1,1,0,0,0,0,3,5
401085917,Canisius Golden Griffins,J. Sanks,3141259,,False,29.0,6,11,4,4,2,7,2,2,2,2,4,1,0,0,2,2,16
401085917,Canisius Golden Griffins,TEAM,TOTAL,TOTAL,False,,29,61,22,39,7,22,5,7,10,17,27,19,7,3,13,22,70
401085916,Monmouth Hawks,M. Traore,3975762,,True,25.0,2,3,2,3,0,0,0,0,0,2,2,1,1,0,2,3,4
401085916,Monmouth Hawks,D. Quinn,3948714,,True,22.0,1,8,1,8,0,0,3,6,5,3,8,1,1,0,0,1,5
401085916,Monmouth Hawks,M. McClary,4279736,,True,5.0,1,1,1,1,0,0,0,0,0,0,0,0,1,0,3,4,2
401085916,Monmouth Hawks,D. Hammond,4279734,,True,28.0,2,7,0,1,2,6,8,8,1,3,4,0,1,0,2,1,14
401085916,Monmouth Hawks,R. Salnave,4067329,,True,23.0,5,11,4,8,1,3,3,3,0,2,2,1,0,0,1,4,14
401085916,Monmouth Hawks,N. Rutty,4398408,,False,9.0,0,0,0,0,0,0,0,0,0,1,1,0,0,0,0,2,0
401085916,Monmouth Hawks,S. Ibiezugbe,4067330,,False,6.0,1,2,1,2,0,0,0,0,1,2,3,0,0,1,0,0,2
401085916,Monmouth Hawks,M. Martin,4279733,,False,17.0,2,4,2,3,0,1,0,0,0,2,2,0,1,0,3,2,4
401085916,Monmouth Hawks,S. Chaput,4398409,,False,15.0,1,4,1,4,0,0,0,1,0,3,3,2,0,0,0,2,2
401085916,Monmouth Hawks,G. Papas,4279735,,False,6.0,0,1,0,0,0,1,0,0,0,0,0,1,0,0,0,0,0
401085916,Monmouth Hawks,T. Gross Jr.,4065729,,False,1.0,0,0,0,0,0,0,0,0,0,0,0,0,0,0,0,0,0
401085916,Monmouth Hawks,L. Pillari,3948713,,False,10.0,3,7,2,3,1,4,3,3,1,0,1,0,0,0,1,1,10
401085916,Monmouth Hawks,N. Rutherford,3946977,,False,33.0,3,8,3,5,0,3,3,4,0,2,2,2,5,2,1,2,9
401085916,Monmouth Hawks,TEAM,TOTAL,TOTAL,False,,21,56,17,38,4,18,20,25,10,21,31,8,10,3,13,22,66
401085916,Monmouth Hawks,M. Traore,3975762,,True,25.0,2,3,2,3,0,0,0,0,0,2,2,1,1,0,2,3,4
401085916,Monmouth Hawks,D. Quinn,3948714,,True,22.0,1,8,1,8,0,0,3,6,5,3,8,1,1,0,0,1,5
401085916,Monmouth Hawks,M. McClary,4279736,,True,5.0,1,1,1,1,0,0,0,0,0,0,0,0,1,0,3,4,2
401085916,Monmouth Hawks,D. Hammond,4279734,,True,28.0,2,7,0,1,2,6,8,8,1,3,4,0,1,0,2,1,14
401085916,Monmouth Hawks,R. Salnave,4067329,,True,23.0,5,11,4,8,1,3,3,3,0,2,2,1,0,0,1,4,14
401085916,Monmouth Hawks,N. Rutty,4398408,,False,9.0,0,0,0,0,0,0,0,0,0,1,1,0,0,0,0,2,0
401085916,Monmouth Hawks,S. Ibiezugbe,4067330,,False,6.0,1,2,1,2,0,0,0,0,1,2,3,0,0,1,0,0,2
401085916,Monmouth Hawks,M. Martin,4279733,,False,17.0,2,4,2,3,0,1,0,0,0,2,2,0,1,0,3,2,4
401085916,Monmouth Hawks,S. Chaput,4398409,,False,15.0,1,4,1,4,0,0,0,1,0,3,3,2,0,0,0,2,2
401085916,Monmouth Hawks,G. Papas,4279735,,False,6.0,0,1,0,0,0,1,0,0,0,0,0,1,0,0,0,0,0
401085916,Monmouth Hawks,T. Gross Jr.,4065729,,False,1.0,0,0,0,0,0,0,0,0,0,0,0,0,0,0,0,0,0
401085916,Monmouth Hawks,L. Pillari,3948713,,False,10.0,3,7,2,3,1,4,3,3,1,0,1,0,0,0,1,1,10
401085916,Monmouth Hawks,N. Rutherford,3946977,,False,33.0,3,8,3,5,0,3,3,4,0,2,2,2,5,2,1,2,9
401085916,Monmouth Hawks,TEAM,TOTAL,TOTAL,False,,21,56,17,38,4,18,20,25,10,21,31,8,10,3,13,22,66
401085916,Canisius Golden Griffins,S. Hitchon,4279482,,True,19.0,4,5,2,3,2,2,1,2,1,3,4,2,0,2,1,3,11
401085916,Canisius Golden Griffins,J. White,4279478,,True,7.0,2,2,2,2,0,0,0,0,0,0,0,0,0,0,0,4,4
401085916,Canisius Golden Griffins,T. Molson,4279481,,True,33.0,7,11,4,7,3,4,1,5,1,4,5,4,1,0,3,0,18
401085916,Canisius Golden Griffins,I. Reese,4067278,,True,35.0,5,10,4,7,1,3,0,1,0,5,5,7,0,1,5,3,11
401085916,Canisius Golden Griffins,M. Johnson,4067275,,True,28.0,1,4,1,2,0,2,5,7,0,2,2,6,1,0,3,3,7
401085916,Canisius Golden Griffins,M. Lotts,4279480,,False,4.0,0,0,0,0,0,0,0,0,0,0,0,0,0,0,0,1,0
401085916,Canisius Golden Griffins,D. St. Louis,4067280,,False,17.0,1,1,1,1,0,0,4,8,1,3,4,0,1,1,0,3,6
401085916,Canisius Golden Griffins,J. Faulkner,3137250,,False,27.0,4,7,3,4,1,3,0,0,0,2,2,1,0,0,1,1,9
401085916,Canisius Golden Griffins,J. Henderson,4398046,,False,7.0,0,1,0,0,0,1,0,0,0,2,2,0,0,0,1,0,0
401085916,Canisius Golden Griffins,J. Sanks,3141259,,False,23.0,5,8,1,2,4,6,0,0,0,5,5,1,0,0,2,3,14
401085916,Canisius Golden Griffins,TEAM,TOTAL,TOTAL,False,,29,49,18,28,11,21,11,23,6,28,34,21,3,4,17,21,80
401085916,Canisius Golden Griffins,S. Hitchon,4279482,,True,19.0,4,5,2,3,2,2,1,2,1,3,4,2,0,2,1,3,11
401085916,Canisius Golden Griffins,J. White,4279478,,True,7.0,2,2,2,2,0,0,0,0,0,0,0,0,0,0,0,4,4
401085916,Canisius Golden Griffins,T. Molson,4279481,,True,33.0,7,11,4,7,3,4,1,5,1,4,5,4,1,0,3,0,18
401085916,Canisius Golden Griffins,I. Reese,4067278,,True,35.0,5,10,4,7,1,3,0,1,0,5,5,7,0,1,5,3,11
401085916,Canisius Golden Griffins,M. Johnson,4067275,,True,28.0,1,4,1,2,0,2,5,7,0,2,2,6,1,0,3,3,7
401085916,Canisius Golden Griffins,M. Lotts,4279480,,False,4.0,0,0,0,0,0,0,0,0,0,0,0,0,0,0,0,1,0
401085916,Canisius Golden Griffins,D. St. Louis,4067280,,False,17.0,1,1,1,1,0,0,4,8,1,3,4,0,1,1,0,3,6
401085916,Canisius Golden Griffins,J. Faulkner,3137250,,False,27.0,4,7,3,4,1,3,0,0,0,2,2,1,0,0,1,1,9
401085916,Canisius Golden Griffins,J. Henderson,4398046,,False,7.0,0,1,0,0,0,1,0,0,0,2,2,0,0,0,1,0,0
401085916,Canisius Golden Griffins,J. Sanks,3141259,,False,23.0,5,8,1,2,4,6,0,0,0,5,5,1,0,0,2,3,14
401085916,Canisius Golden Griffins,TEAM,TOTAL,TOTAL,False,,29,49,18,28,11,21,11,23,6,28,34,21,3,4,17,21,80
401085915,Fairfield Stags,J. Kasibabu,3947016,,True,28.0,5,6,5,6,0,0,6,9,3,10,13,2,1,0,5,5,16
401085915,Fairfield Stags,L. Taliaferro,4398078,,True,29.0,2,13,1,5,1,8,0,0,1,2,3,2,0,0,1,1,5
401085915,Fairfield Stags,F. Lemetti,4398076,,True,6.0,0,2,0,1,0,1,0,0,0,0,0,0,0,0,0,2,0
401085915,Fairfield Stags,N. Alvarez,4398075,,True,31.0,4,9,3,6,1,3,2,4,0,1,1,3,0,0,2,5,11
401085915,Fairfield Stags,J. Cruz,4279488,,True,35.0,9,14,8,13,1,1,2,3,2,4,6,0,1,0,1,1,21
401085915,Fairfield Stags,O. El-Sheikh,4279489,,False,4.0,2,3,2,3,0,0,0,0,0,3,3,0,0,0,0,1,4
401085915,Fairfield Stags,M. Milin,3947018,,False,14.0,1,3,1,3,0,0,3,5,1,1,2,0,1,0,1,2,5
401085915,Fairfield Stags,C. Whipple,4398077,,False,25.0,1,5,0,1,1,4,0,0,1,2,3,0,1,0,0,2,3
401085915,Fairfield Stags,T. Benning,4279483,,False,14.0,0,2,0,1,0,1,0,0,1,1,2,0,0,0,1,2,0
401085915,Fairfield Stags,A. Kavaliauskas,4080375,,False,14.0,1,2,1,1,0,1,1,1,0,2,2,2,0,0,3,1,3
401085915,Fairfield Stags,TEAM,TOTAL,TOTAL,False,,25,59,21,40,4,19,14,22,12,27,39,9,4,0,14,22,68
401085915,Fairfield Stags,J. Kasibabu,3947016,,True,28.0,5,6,5,6,0,0,6,9,3,10,13,2,1,0,5,5,16
401085915,Fairfield Stags,L. Taliaferro,4398078,,True,29.0,2,13,1,5,1,8,0,0,1,2,3,2,0,0,1,1,5
401085915,Fairfield Stags,F. Lemetti,4398076,,True,6.0,0,2,0,1,0,1,0,0,0,0,0,0,0,0,0,2,0
401085915,Fairfield Stags,N. Alvarez,4398075,,True,31.0,4,9,3,6,1,3,2,4,0,1,1,3,0,0,2,5,11
401085915,Fairfield Stags,J. Cruz,4279488,,True,35.0,9,14,8,13,1,1,2,3,2,4,6,0,1,0,1,1,21
401085915,Fairfield Stags,O. El-Sheikh,4279489,,False,4.0,2,3,2,3,0,0,0,0,0,3,3,0,0,0,0,1,4
401085915,Fairfield Stags,M. Milin,3947018,,False,14.0,1,3,1,3,0,0,3,5,1,1,2,0,1,0,1,2,5
401085915,Fairfield Stags,C. Whipple,4398077,,False,25.0,1,5,0,1,1,4,0,0,1,2,3,0,1,0,0,2,3
401085915,Fairfield Stags,T. Benning,4279483,,False,14.0,0,2,0,1,0,1,0,0,1,1,2,0,0,0,1,2,0
401085915,Fairfield Stags,A. Kavaliauskas,4080375,,False,14.0,1,2,1,1,0,1,1,1,0,2,2,2,0,0,3,1,3
401085915,Fairfield Stags,TEAM,TOTAL,TOTAL,False,,25,59,21,40,4,19,14,22,12,27,39,9,4,0,14,22,68
401085915,Canisius Golden Griffins,S. Hitchon,4279482,,True,13.0,1,2,1,2,0,0,1,2,0,2,2,0,0,0,2,3,3
401085915,Canisius Golden Griffins,J. White,4279478,,True,16.0,2,4,2,4,0,0,0,1,1,0,1,0,0,1,1,2,4
401085915,Canisius Golden Griffins,T. Molson,4279481,,True,31.0,4,10,4,5,0,5,2,3,1,2,3,2,1,0,1,0,10
401085915,Canisius Golden Griffins,I. Reese,4067278,,True,34.0,5,11,3,5,2,6,3,4,0,9,9,7,2,1,5,2,15
401085915,Canisius Golden Griffins,M. Johnson,4067275,,True,34.0,2,8,1,5,1,3,6,8,0,6,6,5,3,0,0,2,11
401085915,Canisius Golden Griffins,M. Lotts,4279480,,False,13.0,3,4,3,4,0,0,0,0,0,1,1,0,1,0,1,4,6
401085915,Canisius Golden Griffins,D. St. Louis,4067280,,False,11.0,0,2,0,2,0,0,0,0,1,0,1,0,0,1,0,5,0
401085915,Canisius Golden Griffins,J. Faulkner,3137250,,False,26.0,6,6,4,4,2,2,2,2,1,3,4,2,1,0,2,2,16
401085915,Canisius Golden Griffins,J. Henderson,4398046,,False,6.0,0,0,0,0,0,0,0,0,1,0,1,1,0,0,0,0,0
401085915,Canisius Golden Griffins,J. Sanks,3141259,,False,16.0,3,5,1,2,2,3,0,0,0,3,3,0,0,0,2,1,8
401085915,Canisius Golden Griffins,TEAM,TOTAL,TOTAL,False,,26,52,19,33,7,19,14,20,5,27,32,17,8,3,14,21,73
401085915,Canisius Golden Griffins,S. Hitchon,4279482,,True,13.0,1,2,1,2,0,0,1,2,0,2,2,0,0,0,2,3,3
401085915,Canisius Golden Griffins,J. White,4279478,,True,16.0,2,4,2,4,0,0,0,1,1,0,1,0,0,1,1,2,4
401085915,Canisius Golden Griffins,T. Molson,4279481,,True,31.0,4,10,4,5,0,5,2,3,1,2,3,2,1,0,1,0,10
401085915,Canisius Golden Griffins,I. Reese,4067278,,True,34.0,5,11,3,5,2,6,3,4,0,9,9,7,2,1,5,2,15
401085915,Canisius Golden Griffins,M. Johnson,4067275,,True,34.0,2,8,1,5,1,3,6,8,0,6,6,5,3,0,0,2,11
401085915,Canisius Golden Griffins,M. Lotts,4279480,,False,13.0,3,4,3,4,0,0,0,0,0,1,1,0,1,0,1,4,6
401085915,Canisius Golden Griffins,D. St. Louis,4067280,,False,11.0,0,2,0,2,0,0,0,0,1,0,1,0,0,1,0,5,0
401085915,Canisius Golden Griffins,J. Faulkner,3137250,,False,26.0,6,6,4,4,2,2,2,2,1,3,4,2,1,0,2,2,16
401085915,Canisius Golden Griffins,J. Henderson,4398046,,False,6.0,0,0,0,0,0,0,0,0,1,0,1,1,0,0,0,0,0
401085915,Canisius Golden Griffins,J. Sanks,3141259,,False,16.0,3,5,1,2,2,3,0,0,0,3,3,0,0,0,2,1,8
401085915,Canisius Golden Griffins,TEAM,TOTAL,TOTAL,False,,26,52,19,33,7,19,14,20,5,27,32,17,8,3,14,21,73
401085914,Iona Gaels,N. Nikolic,4398090,,True,23.0,0,1,0,1,0,0,0,0,2,4,6,4,0,1,1,5,0
401085914,Iona Gaels,T. Agee,4398087,,True,23.0,2,5,2,3,0,2,4,4,1,5,6,2,0,0,2,5,8
401085914,Iona Gaels,E.J. Crawford,4067295,,True,35.0,6,16,3,10,3,6,5,5,0,4,4,2,1,0,3,5,20
401085914,Iona Gaels,B. Perez,3948791,,True,40.0,5,9,0,2,5,7,2,2,2,9,11,4,1,0,2,0,17
401085914,Iona Gaels,R. McGill,3948698,,True,30.0,9,13,8,11,1,2,1,2,1,2,3,2,0,0,2,3,20
401085914,Iona Gaels,J. Maxwell,4398088,,False,21.0,2,4,1,1,1,3,0,0,0,3,3,1,0,1,4,4,5
401085914,Iona Gaels,P. Hudson,4398089,,False,2.0,0,0,0,0,0,0,0,0,0,1,1,0,0,0,0,0,0
401085914,Iona Gaels,A. Gist,4067164,,False,26.0,6,8,2,2,4,6,2,2,0,1,1,2,0,0,2,1,18
401085914,Iona Gaels,TEAM,TOTAL,TOTAL,False,,30,56,16,30,14,26,14,15,6,34,40,17,2,2,17,23,88
401085914,Iona Gaels,N. Nikolic,4398090,,True,23.0,0,1,0,1,0,0,0,0,2,4,6,4,0,1,1,5,0
401085914,Iona Gaels,T. Agee,4398087,,True,23.0,2,5,2,3,0,2,4,4,1,5,6,2,0,0,2,5,8
401085914,Iona Gaels,E.J. Crawford,4067295,,True,35.0,6,16,3,10,3,6,5,5,0,4,4,2,1,0,3,5,20
401085914,Iona Gaels,B. Perez,3948791,,True,40.0,5,9,0,2,5,7,2,2,2,9,11,4,1,0,2,0,17
401085914,Iona Gaels,R. McGill,3948698,,True,30.0,9,13,8,11,1,2,1,2,1,2,3,2,0,0,2,3,20
401085914,Iona Gaels,J. Maxwell,4398088,,False,21.0,2,4,1,1,1,3,0,0,0,3,3,1,0,1,4,4,5
401085914,Iona Gaels,P. Hudson,4398089,,False,2.0,0,0,0,0,0,0,0,0,0,1,1,0,0,0,0,0,0
401085914,Iona Gaels,A. Gist,4067164,,False,26.0,6,8,2,2,4,6,2,2,0,1,1,2,0,0,2,1,18
401085914,Iona Gaels,TEAM,TOTAL,TOTAL,False,,30,56,16,30,14,26,14,15,6,34,40,17,2,2,17,23,88
401085914,Canisius Golden Griffins,S. Hitchon,4279482,,True,26.0,4,7,4,6,0,1,0,1,0,1,1,0,2,0,1,3,8
401085914,Canisius Golden Griffins,J. White,4279478,,True,19.0,4,9,4,9,0,0,1,2,2,2,4,2,0,1,0,3,9
401085914,Canisius Golden Griffins,T. Molson,4279481,,True,31.0,4,13,3,6,1,7,4,4,1,4,5,0,0,0,4,4,13
401085914,Canisius Golden Griffins,I. Reese,4067278,,True,37.0,2,11,2,2,0,9,6,7,1,4,5,8,2,0,3,1,10
401085914,Canisius Golden Griffins,M. Johnson,4067275,,True,37.0,5,9,2,4,3,5,1,2,0,2,2,4,2,0,0,1,14
401085914,Canisius Golden Griffins,M. Lotts,4279480,,False,5.0,0,0,0,0,0,0,0,0,0,2,2,0,0,0,0,1,0
401085914,Canisius Golden Griffins,D. St. Louis,4067280,,False,4.0,1,1,1,1,0,0,0,2,0,1,1,0,0,0,0,1,2
401085914,Canisius Golden Griffins,J. Faulkner,3137250,,False,10.0,1,5,1,3,0,2,2,2,1,0,1,0,0,0,1,1,4
401085914,Canisius Golden Griffins,J. Henderson,4398046,,False,18.0,2,4,0,0,2,4,2,2,0,1,1,0,1,0,0,1,8
401085914,Canisius Golden Griffins,J. Sanks,3141259,,False,13.0,1,4,1,1,0,3,0,0,0,3,3,1,0,0,1,2,2
401085914,Canisius Golden Griffins,TEAM,TOTAL,TOTAL,False,,24,63,18,32,6,31,16,22,9,20,29,15,7,1,10,18,70
401085914,Canisius Golden Griffins,S. Hitchon,4279482,,True,26.0,4,7,4,6,0,1,0,1,0,1,1,0,2,0,1,3,8
401085914,Canisius Golden Griffins,J. White,4279478,,True,19.0,4,9,4,9,0,0,1,2,2,2,4,2,0,1,0,3,9
401085914,Canisius Golden Griffins,T. Molson,4279481,,True,31.0,4,13,3,6,1,7,4,4,1,4,5,0,0,0,4,4,13
401085914,Canisius Golden Griffins,I. Reese,4067278,,True,37.0,2,11,2,2,0,9,6,7,1,4,5,8,2,0,3,1,10
401085914,Canisius Golden Griffins,M. Johnson,4067275,,True,37.0,5,9,2,4,3,5,1,2,0,2,2,4,2,0,0,1,14
401085914,Canisius Golden Griffins,M. Lotts,4279480,,False,5.0,0,0,0,0,0,0,0,0,0,2,2,0,0,0,0,1,0
401085914,Canisius Golden Griffins,D. St. Louis,4067280,,False,4.0,1,1,1,1,0,0,0,2,0,1,1,0,0,0,0,1,2
401085914,Canisius Golden Griffins,J. Faulkner,3137250,,False,10.0,1,5,1,3,0,2,2,2,1,0,1,0,0,0,1,1,4
401085914,Canisius Golden Griffins,J. Henderson,4398046,,False,18.0,2,4,0,0,2,4,2,2,0,1,1,0,1,0,0,1,8
401085914,Canisius Golden Griffins,J. Sanks,3141259,,False,13.0,1,4,1,1,0,3,0,0,0,3,3,1,0,0,1,2,2
401085914,Canisius Golden Griffins,TEAM,TOTAL,TOTAL,False,,24,63,18,32,6,31,16,22,9,20,29,15,7,1,10,18,70
401085913,Rider Broncs,F. Scott,3922033,,True,22.0,7,9,7,9,0,0,8,11,2,3,5,2,1,0,2,2,22
401085913,Rider Broncs,T. Marshall,4067348,,True,24.0,5,8,5,8,0,0,1,2,2,6,8,0,0,0,1,1,11
401085913,Rider Broncs,S. Jordan,4067349,,True,39.0,6,10,6,7,0,3,2,3,0,2,2,3,0,1,1,5,14
401085913,Rider Broncs,K. Williams,3946983,,True,25.0,1,4,1,4,0,0,0,1,1,5,6,5,1,0,1,1,2
401085913,Rider Broncs,A. Durham,3138490,,True,25.0,4,6,3,4,1,2,5,8,3,2,5,3,2,0,1,1,14
401085913,Rider Broncs,A. Ogemuno-Johnson,4406151,,False,5.0,1,1,1,1,0,0,0,0,0,0,0,1,0,0,2,0,2
401085913,Rider Broncs,D. Eke,3941312,,False,18.0,3,5,3,4,0,1,0,2,1,1,2,0,1,0,1,2,6
401085913,Rider Broncs,D. Vaughn,4067347,,False,14.0,1,4,1,2,0,2,2,2,0,3,3,0,2,0,0,2,4
401085913,Rider Broncs,J. Allen,4067345,,False,22.0,2,10,2,3,0,7,3,4,0,4,4,2,0,1,3,2,7
401085913,Rider Broncs,A. Gilbert,3911886,,False,6.0,0,1,0,1,0,0,0,0,0,0,0,0,0,0,0,0,0
401085913,Rider Broncs,TEAM,TOTAL,TOTAL,False,,30,58,29,43,1,15,21,33,9,29,38,16,7,2,12,16,82
401085913,Rider Broncs,F. Scott,3922033,,True,22.0,7,9,7,9,0,0,8,11,2,3,5,2,1,0,2,2,22
401085913,Rider Broncs,T. Marshall,4067348,,True,24.0,5,8,5,8,0,0,1,2,2,6,8,0,0,0,1,1,11
401085913,Rider Broncs,S. Jordan,4067349,,True,39.0,6,10,6,7,0,3,2,3,0,2,2,3,0,1,1,5,14
401085913,Rider Broncs,K. Williams,3946983,,True,25.0,1,4,1,4,0,0,0,1,1,5,6,5,1,0,1,1,2
401085913,Rider Broncs,A. Durham,3138490,,True,25.0,4,6,3,4,1,2,5,8,3,2,5,3,2,0,1,1,14
401085913,Rider Broncs,A. Ogemuno-Johnson,4406151,,False,5.0,1,1,1,1,0,0,0,0,0,0,0,1,0,0,2,0,2
401085913,Rider Broncs,D. Eke,3941312,,False,18.0,3,5,3,4,0,1,0,2,1,1,2,0,1,0,1,2,6
401085913,Rider Broncs,D. Vaughn,4067347,,False,14.0,1,4,1,2,0,2,2,2,0,3,3,0,2,0,0,2,4
401085913,Rider Broncs,J. Allen,4067345,,False,22.0,2,10,2,3,0,7,3,4,0,4,4,2,0,1,3,2,7
401085913,Rider Broncs,A. Gilbert,3911886,,False,6.0,0,1,0,1,0,0,0,0,0,0,0,0,0,0,0,0,0
401085913,Rider Broncs,TEAM,TOTAL,TOTAL,False,,30,58,29,43,1,15,21,33,9,29,38,16,7,2,12,16,82
401085913,Canisius Golden Griffins,S. Hitchon,4279482,,True,18.0,2,5,2,4,0,1,0,0,2,3,5,2,0,0,1,3,4
401085913,Canisius Golden Griffins,J. White,4279478,,True,14.0,2,4,2,4,0,0,0,1,2,2,4,0,0,2,0,1,4
401085913,Canisius Golden Griffins,T. Molson,4279481,,True,31.0,6,16,2,6,4,10,3,5,1,4,5,2,2,0,7,4,19
401085913,Canisius Golden Griffins,I. Reese,4067278,,True,37.0,8,18,4,10,4,8,1,1,1,7,8,4,4,0,4,3,21
401085913,Canisius Golden Griffins,M. Johnson,4067275,,True,32.0,1,6,1,4,0,2,2,2,2,6,8,5,1,0,2,3,4
401085913,Canisius Golden Griffins,M. Lotts,4279480,,False,14.0,3,6,3,6,0,0,0,0,3,1,4,0,0,0,3,3,6
401085913,Canisius Golden Griffins,D. St. Louis,4067280,,False,8.0,1,2,1,2,0,0,0,2,0,0,0,0,0,0,0,3,2
401085913,Canisius Golden Griffins,J. Faulkner,3137250,,False,14.0,2,3,1,1,1,2,0,0,0,0,0,1,0,0,0,0,5
401085913,Canisius Golden Griffins,J. Henderson,4398046,,False,20.0,2,2,1,1,1,1,0,0,0,1,1,3,1,0,1,4,5
401085913,Canisius Golden Griffins,J. Sanks,3141259,,False,12.0,1,5,0,0,1,5,0,0,0,1,1,1,0,0,0,2,3
401085913,Canisius Golden Griffins,TEAM,TOTAL,TOTAL,False,,28,67,17,38,11,29,6,11,14,26,40,18,8,2,19,26,73
401085913,Canisius Golden Griffins,S. Hitchon,4279482,,True,18.0,2,5,2,4,0,1,0,0,2,3,5,2,0,0,1,3,4
401085913,Canisius Golden Griffins,J. White,4279478,,True,14.0,2,4,2,4,0,0,0,1,2,2,4,0,0,2,0,1,4
401085913,Canisius Golden Griffins,T. Molson,4279481,,True,31.0,6,16,2,6,4,10,3,5,1,4,5,2,2,0,7,4,19
401085913,Canisius Golden Griffins,I. Reese,4067278,,True,37.0,8,18,4,10,4,8,1,1,1,7,8,4,4,0,4,3,21
401085913,Canisius Golden Griffins,M. Johnson,4067275,,True,32.0,1,6,1,4,0,2,2,2,2,6,8,5,1,0,2,3,4
401085913,Canisius Golden Griffins,M. Lotts,4279480,,False,14.0,3,6,3,6,0,0,0,0,3,1,4,0,0,0,3,3,6
401085913,Canisius Golden Griffins,D. St. Louis,4067280,,False,8.0,1,2,1,2,0,0,0,2,0,0,0,0,0,0,0,3,2
401085913,Canisius Golden Griffins,J. Faulkner,3137250,,False,14.0,2,3,1,1,1,2,0,0,0,0,0,1,0,0,0,0,5
401085913,Canisius Golden Griffins,J. Henderson,4398046,,False,20.0,2,2,1,1,1,1,0,0,0,1,1,3,1,0,1,4,5
401085913,Canisius Golden Griffins,J. Sanks,3141259,,False,12.0,1,5,0,0,1,5,0,0,0,1,1,1,0,0,0,2,3
401085913,Canisius Golden Griffins,TEAM,TOTAL,TOTAL,False,,28,67,17,38,11,29,6,11,14,26,40,18,8,2,19,26,73
401085911,Siena Saints,E. Fisher,3913235,,True,37.0,9,19,7,15,2,4,1,3,4,13,17,2,0,1,3,2,21
401085911,Siena Saints,K. Degnan,3138282,,True,39.0,3,8,1,2,2,6,0,0,1,3,4,1,0,1,2,5,8
401085911,Siena Saints,S. Seymour,4398391,,True,35.0,5,12,0,0,5,12,0,0,0,1,1,0,3,0,2,3,15
401085911,Siena Saints,G. Darwiche,4398393,,True,30.0,1,5,0,0,1,5,2,2,0,0,0,0,1,0,3,2,5
401085911,Siena Saints,J. Pickett,4398390,,True,40.0,5,17,3,10,2,7,2,4,5,2,7,11,1,1,2,0,14
401085911,Siena Saints,D. Tchougang,4398394,,False,3.0,0,0,0,0,0,0,0,0,0,1,1,0,0,0,0,0,0
401085911,Siena Saints,T. Huerter Jr.,4067350,,False,5.0,0,0,0,0,0,0,0,0,0,0,0,0,0,0,0,1,0
401085911,Siena Saints,B. Bayer,4065720,,False,0.0,0,0,0,0,0,0,0,0,0,0,0,0,0,0,0,1,0
401085911,Siena Saints,K. Smithen,3133848,,False,11.0,1,2,0,1,1,1,0,0,1,1,2,0,0,1,0,0,3
401085911,Siena Saints,TEAM,TOTAL,TOTAL,False,,24,63,11,28,13,35,5,9,12,21,33,14,5,4,13,14,66
401085911,Siena Saints,E. Fisher,3913235,,True,37.0,9,19,7,15,2,4,1,3,4,13,17,2,0,1,3,2,21
401085911,Siena Saints,K. Degnan,3138282,,True,39.0,3,8,1,2,2,6,0,0,1,3,4,1,0,1,2,5,8
401085911,Siena Saints,S. Seymour,4398391,,True,35.0,5,12,0,0,5,12,0,0,0,1,1,0,3,0,2,3,15
401085911,Siena Saints,G. Darwiche,4398393,,True,30.0,1,5,0,0,1,5,2,2,0,0,0,0,1,0,3,2,5
401085911,Siena Saints,J. Pickett,4398390,,True,40.0,5,17,3,10,2,7,2,4,5,2,7,11,1,1,2,0,14
401085911,Siena Saints,D. Tchougang,4398394,,False,3.0,0,0,0,0,0,0,0,0,0,1,1,0,0,0,0,0,0
401085911,Siena Saints,T. Huerter Jr.,4067350,,False,5.0,0,0,0,0,0,0,0,0,0,0,0,0,0,0,0,1,0
401085911,Siena Saints,B. Bayer,4065720,,False,0.0,0,0,0,0,0,0,0,0,0,0,0,0,0,0,0,1,0
401085911,Siena Saints,K. Smithen,3133848,,False,11.0,1,2,0,1,1,1,0,0,1,1,2,0,0,1,0,0,3
401085911,Siena Saints,TEAM,TOTAL,TOTAL,False,,24,63,11,28,13,35,5,9,12,21,33,14,5,4,13,14,66
401085911,Canisius Golden Griffins,S. Hitchon,4279482,,True,28.0,4,9,4,8,0,1,3,4,0,4,4,0,1,2,3,3,11
401085911,Canisius Golden Griffins,J. White,4279478,,True,29.0,4,5,4,5,0,0,0,0,1,7,8,2,1,2,1,2,8
401085911,Canisius Golden Griffins,T. Molson,4279481,,True,35.0,8,16,7,11,1,5,6,9,3,5,8,0,1,0,2,3,23
401085911,Canisius Golden Griffins,I. Reese,4067278,,True,37.0,6,11,4,8,2,3,6,6,2,6,8,3,5,0,2,0,20
401085911,Canisius Golden Griffins,M. Johnson,4067275,,True,32.0,1,5,1,3,0,2,0,0,0,4,4,3,1,0,2,2,2
401085911,Canisius Golden Griffins,M. Lotts,4279480,,False,7.0,0,1,0,1,0,0,1,2,1,1,2,0,0,0,0,1,1
401085911,Canisius Golden Griffins,D. St. Louis,4067280,,False,5.0,1,1,1,1,0,0,0,0,0,1,1,0,0,0,0,1,2
401085911,Canisius Golden Griffins,J. Faulkner,3137250,,False,11.0,0,3,0,2,0,1,0,0,0,0,0,1,0,0,0,0,0
401085911,Canisius Golden Griffins,J. Henderson,4398046,,False,8.0,1,2,1,1,0,1,1,1,0,0,0,0,0,1,1,0,3
401085911,Canisius Golden Griffins,J. Sanks,3141259,,False,8.0,0,2,0,0,0,2,0,0,0,3,3,0,0,0,0,2,0
401085911,Canisius Golden Griffins,TEAM,TOTAL,TOTAL,False,,25,55,22,40,3,15,17,22,8,31,39,9,9,5,11,14,70
401085911,Canisius Golden Griffins,S. Hitchon,4279482,,True,28.0,4,9,4,8,0,1,3,4,0,4,4,0,1,2,3,3,11
401085911,Canisius Golden Griffins,J. White,4279478,,True,29.0,4,5,4,5,0,0,0,0,1,7,8,2,1,2,1,2,8
401085911,Canisius Golden Griffins,T. Molson,4279481,,True,35.0,8,16,7,11,1,5,6,9,3,5,8,0,1,0,2,3,23
401085911,Canisius Golden Griffins,I. Reese,4067278,,True,37.0,6,11,4,8,2,3,6,6,2,6,8,3,5,0,2,0,20
401085911,Canisius Golden Griffins,M. Johnson,4067275,,True,32.0,1,5,1,3,0,2,0,0,0,4,4,3,1,0,2,2,2
401085911,Canisius Golden Griffins,M. Lotts,4279480,,False,7.0,0,1,0,1,0,0,1,2,1,1,2,0,0,0,0,1,1
401085911,Canisius Golden Griffins,D. St. Louis,4067280,,False,5.0,1,1,1,1,0,0,0,0,0,1,1,0,0,0,0,1,2
401085911,Canisius Golden Griffins,J. Faulkner,3137250,,False,11.0,0,3,0,2,0,1,0,0,0,0,0,1,0,0,0,0,0
401085911,Canisius Golden Griffins,J. Henderson,4398046,,False,8.0,1,2,1,1,0,1,1,1,0,0,0,0,0,1,1,0,3
401085911,Canisius Golden Griffins,J. Sanks,3141259,,False,8.0,0,2,0,0,0,2,0,0,0,3,3,0,0,0,0,2,0
401085911,Canisius Golden Griffins,TEAM,TOTAL,TOTAL,False,,25,55,22,40,3,15,17,22,8,31,39,9,9,5,11,14,70
401085910,Marist Red Foxes,I. Lamb,3936028,,True,32.0,7,11,4,6,3,5,4,6,4,5,9,0,2,0,3,2,21
401085910,Marist Red Foxes,T. Sjoberg,4067328,,True,18.0,0,1,0,1,0,0,0,0,2,4,6,4,0,0,1,0,0
401085910,Marist Red Foxes,D. Knudsen,3936027,,True,14.0,0,3,0,0,0,3,2,2,0,2,2,0,0,1,1,1,2
401085910,Marist Red Foxes,D. Hines,4398410,,True,31.0,3,5,2,2,1,3,0,0,0,1,1,0,0,1,0,3,7
401085910,Marist Red Foxes,B. Parker,3936030,,True,33.0,6,12,3,7,3,5,4,6,0,2,2,3,1,0,4,1,19
401085910,Marist Red Foxes,L. Nedrow,4398414,,False,6.0,1,3,0,0,1,3,0,0,0,0,0,0,0,0,0,4,3
401085910,Marist Red Foxes,R. Funk,3936026,,False,28.0,3,9,1,4,2,5,2,2,0,3,3,0,0,0,0,2,10
401085910,Marist Red Foxes,A. Dozic,3923222,,False,15.0,1,3,0,0,1,3,3,5,0,3,3,2,0,0,2,4,6
401085910,Marist Red Foxes,M. Herasme,4398413,,False,7.0,0,0,0,0,0,0,0,0,0,1,1,0,0,0,0,4,0
401085910,Marist Red Foxes,A. Williams,4279709,,False,16.0,2,3,2,3,0,0,0,1,0,1,1,0,0,0,2,1,4
401085910,Marist Red Foxes,TEAM,TOTAL,TOTAL,False,,23,50,12,23,11,27,15,22,7,22,29,9,3,2,13,22,72
401085910,Marist Red Foxes,I. Lamb,3936028,,True,32.0,7,11,4,6,3,5,4,6,4,5,9,0,2,0,3,2,21
401085910,Marist Red Foxes,T. Sjoberg,4067328,,True,18.0,0,1,0,1,0,0,0,0,2,4,6,4,0,0,1,0,0
401085910,Marist Red Foxes,D. Knudsen,3936027,,True,14.0,0,3,0,0,0,3,2,2,0,2,2,0,0,1,1,1,2
401085910,Marist Red Foxes,D. Hines,4398410,,True,31.0,3,5,2,2,1,3,0,0,0,1,1,0,0,1,0,3,7
401085910,Marist Red Foxes,B. Parker,3936030,,True,33.0,6,12,3,7,3,5,4,6,0,2,2,3,1,0,4,1,19
401085910,Marist Red Foxes,L. Nedrow,4398414,,False,6.0,1,3,0,0,1,3,0,0,0,0,0,0,0,0,0,4,3
401085910,Marist Red Foxes,R. Funk,3936026,,False,28.0,3,9,1,4,2,5,2,2,0,3,3,0,0,0,0,2,10
401085910,Marist Red Foxes,A. Dozic,3923222,,False,15.0,1,3,0,0,1,3,3,5,0,3,3,2,0,0,2,4,6
401085910,Marist Red Foxes,M. Herasme,4398413,,False,7.0,0,0,0,0,0,0,0,0,0,1,1,0,0,0,0,4,0
401085910,Marist Red Foxes,A. Williams,4279709,,False,16.0,2,3,2,3,0,0,0,1,0,1,1,0,0,0,2,1,4
401085910,Marist Red Foxes,TEAM,TOTAL,TOTAL,False,,23,50,12,23,11,27,15,22,7,22,29,9,3,2,13,22,72
401085910,Canisius Golden Griffins,S. Hitchon,4279482,,True,27.0,2,4,1,2,1,2,0,0,1,2,3,1,1,0,0,2,5
401085910,Canisius Golden Griffins,J. White,4279478,,True,12.0,3,4,3,4,0,0,0,0,1,2,3,0,0,0,2,4,6
401085910,Canisius Golden Griffins,T. Molson,4279481,,True,24.0,5,16,4,8,1,8,8,12,1,3,4,0,0,1,1,4,19
401085910,Canisius Golden Griffins,I. Reese,4067278,,True,35.0,3,7,1,1,2,6,1,3,2,5,7,8,2,0,1,2,9
401085910,Canisius Golden Griffins,M. Johnson,4067275,,True,26.0,1,6,1,1,0,5,2,5,1,4,5,4,2,0,3,0,4
401085910,Canisius Golden Griffins,M. Lotts,4279480,,False,11.0,1,2,1,2,0,0,0,1,5,1,6,0,0,0,1,1,2
401085910,Canisius Golden Griffins,D. St. Louis,4067280,,False,2.0,0,0,0,0,0,0,0,0,0,0,0,0,0,0,0,1,0
401085910,Canisius Golden Griffins,J. Faulkner,3137250,,False,24.0,7,13,3,7,4,6,0,0,2,0,2,2,0,0,1,3,18
401085910,Canisius Golden Griffins,J. Henderson,4398046,,False,17.0,0,2,0,2,0,0,2,2,2,1,3,2,1,1,1,3,2
401085910,Canisius Golden Griffins,J. Sanks,3141259,,False,22.0,3,7,1,2,2,5,2,2,1,2,3,1,0,0,2,3,10
401085910,Canisius Golden Griffins,TEAM,TOTAL,TOTAL,False,,25,61,15,29,10,32,15,25,16,23,39,18,6,2,12,23,75
401085910,Canisius Golden Griffins,S. Hitchon,4279482,,True,27.0,2,4,1,2,1,2,0,0,1,2,3,1,1,0,0,2,5
401085910,Canisius Golden Griffins,J. White,4279478,,True,12.0,3,4,3,4,0,0,0,0,1,2,3,0,0,0,2,4,6
401085910,Canisius Golden Griffins,T. Molson,4279481,,True,24.0,5,16,4,8,1,8,8,12,1,3,4,0,0,1,1,4,19
401085910,Canisius Golden Griffins,I. Reese,4067278,,True,35.0,3,7,1,1,2,6,1,3,2,5,7,8,2,0,1,2,9
401085910,Canisius Golden Griffins,M. Johnson,4067275,,True,26.0,1,6,1,1,0,5,2,5,1,4,5,4,2,0,3,0,4
401085910,Canisius Golden Griffins,M. Lotts,4279480,,False,11.0,1,2,1,2,0,0,0,1,5,1,6,0,0,0,1,1,2
401085910,Canisius Golden Griffins,D. St. Louis,4067280,,False,2.0,0,0,0,0,0,0,0,0,0,0,0,0,0,0,0,1,0
401085910,Canisius Golden Griffins,J. Faulkner,3137250,,False,24.0,7,13,3,7,4,6,0,0,2,0,2,2,0,0,1,3,18
401085910,Canisius Golden Griffins,J. Henderson,4398046,,False,17.0,0,2,0,2,0,0,2,2,2,1,3,2,1,1,1,3,2
401085910,Canisius Golden Griffins,J. Sanks,3141259,,False,22.0,3,7,1,2,2,5,2,2,1,2,3,1,0,0,2,3,10
401085910,Canisius Golden Griffins,TEAM,TOTAL,TOTAL,False,,25,61,15,29,10,32,15,25,16,23,39,18,6,2,12,23,75
401085909,Canisius Golden Griffins,S. Hitchon,4279482,,True,17.0,1,4,1,4,0,0,0,0,1,1,2,1,0,0,1,1,2
401085909,Canisius Golden Griffins,J. White,4279478,,True,13.0,2,4,2,4,0,0,2,2,1,1,2,0,0,1,0,4,6
401085909,Canisius Golden Griffins,T. Molson,4279481,,True,33.0,4,14,4,7,0,7,7,10,5,1,6,4,2,0,5,3,15
401085909,Canisius Golden Griffins,I. Reese,4067278,,True,33.0,5,14,3,6,2,8,1,2,3,5,8,2,0,0,2,1,13
401085909,Canisius Golden Griffins,M. Johnson,4067275,,True,38.0,5,16,4,8,1,8,2,2,1,4,5,5,1,1,1,3,13
401085909,Canisius Golden Griffins,D. St. Louis,4067280,,False,18.0,1,2,1,2,0,0,2,2,2,3,5,1,0,0,0,1,4
401085909,Canisius Golden Griffins,J. Faulkner,3137250,,False,19.0,3,6,0,1,3,5,0,0,1,3,4,0,0,0,2,1,9
401085909,Canisius Golden Griffins,J. Henderson,4398046,,False,11.0,0,1,0,0,0,1,0,0,1,0,1,0,0,0,0,2,0
401085909,Canisius Golden Griffins,J. Sanks,3141259,,False,18.0,4,8,2,2,2,6,0,2,0,2,2,0,0,1,2,2,10
401085909,Canisius Golden Griffins,TEAM,TOTAL,TOTAL,False,,25,69,17,34,8,35,14,20,17,24,41,13,3,3,13,18,72
401085909,Buffalo Bulls,M. McRae,4279323,,True,15.0,1,3,1,2,0,1,0,0,3,2,5,0,0,0,2,3,2
401085909,Buffalo Bulls,J. Graves,4279325,,True,17.0,3,6,1,1,2,5,2,2,0,2,2,0,0,1,0,4,10
401085909,Buffalo Bulls,J. Harris,4279324,,True,34.0,7,13,4,8,3,5,0,0,0,9,9,3,1,2,0,2,17
401085909,Buffalo Bulls,D. Jordan,4067370,,True,28.0,3,3,1,1,2,2,0,3,0,4,4,2,0,0,4,3,8
401085909,Buffalo Bulls,C. Massinburg,3907030,,True,30.0,7,13,3,6,4,7,4,6,3,4,7,3,0,0,1,1,22
401085909,Buffalo Bulls,T. Fagan,4397823,,False,3.0,0,0,0,0,0,0,0,0,0,0,0,0,0,0,0,0,0
401085909,Buffalo Bulls,N. Williams,4397821,,False,9.0,1,5,1,4,0,1,0,1,1,1,2,0,0,0,1,0,2
401085909,Buffalo Bulls,N. Perkins,3907031,,False,27.0,7,14,7,12,0,2,4,5,3,6,9,1,0,1,2,0,18
401085909,Buffalo Bulls,R. Segu,4397820,,False,7.0,0,2,0,1,0,1,0,0,0,0,0,0,0,0,2,1,0
401085909,Buffalo Bulls,D. Caruthers,4067372,,False,30.0,4,7,4,6,0,1,0,0,1,1,2,6,2,0,1,3,8
401085909,Buffalo Bulls,TEAM,TOTAL,TOTAL,False,,33,66,22,41,11,25,10,17,14,31,45,15,3,4,13,17,87
401085908,Holy Cross Crusaders,J. Floyd,3907455,,True,31.0,7,11,7,11,0,0,1,3,4,3,7,3,2,5,3,4,15
401085908,Holy Cross Crusaders,M. Faw,4280072,,True,21.0,4,9,4,8,0,1,3,3,2,4,6,0,1,0,2,5,11
401085908,Holy Cross Crusaders,J. Grandison,4280073,,True,37.0,6,15,5,7,1,8,2,4,0,7,7,6,0,1,0,1,15
401085908,Holy Cross Crusaders,A. Butler,4280070,,True,37.0,2,9,0,1,2,8,1,2,0,4,4,0,2,0,2,2,7
401085908,Holy Cross Crusaders,C. Green,4280068,,True,38.0,4,9,3,5,1,4,0,0,0,2,2,3,1,0,3,0,9
401085908,Holy Cross Crusaders,M. Hargis,4398054,,False,3.0,1,2,1,2,0,0,0,0,0,0,0,0,0,0,0,0,2
401085908,Holy Cross Crusaders,C. Le Sann,4067110,,False,4.0,0,0,0,0,0,0,0,0,0,0,0,0,1,0,0,0,0
401085908,Holy Cross Crusaders,M. Zignorski,3907457,,False,4.0,0,0,0,0,0,0,0,0,0,0,0,0,0,0,0,0,0
401085908,Holy Cross Crusaders,P. Benzan,3907453,,False,25.0,2,3,2,3,0,0,2,4,2,2,4,4,0,0,2,1,6
401085908,Holy Cross Crusaders,TEAM,TOTAL,TOTAL,False,,26,58,22,37,4,21,9,16,9,24,33,16,7,6,13,13,65
401085908,Canisius Golden Griffins,S. Hitchon,4279482,,True,22.0,5,11,5,10,0,1,1,2,4,4,8,0,1,0,1,2,11
401085908,Canisius Golden Griffins,J. White,4279478,,True,15.0,1,3,1,3,0,0,2,4,1,3,4,0,0,0,1,1,4
401085908,Canisius Golden Griffins,T. Molson,4279481,,True,34.0,4,14,3,7,1,7,5,5,2,6,8,2,0,0,2,2,14
401085908,Canisius Golden Griffins,I. Reese,4067278,,True,36.0,6,10,2,3,4,7,0,0,0,3,3,4,1,0,5,4,16
401085908,Canisius Golden Griffins,M. Johnson,4067275,,True,34.0,1,4,1,3,0,1,0,0,1,2,3,5,2,0,5,1,2
401085908,Canisius Golden Griffins,M. Lotts,4279480,,False,11.0,0,0,0,0,0,0,0,0,0,1,1,0,0,0,1,2,0
401085908,Canisius Golden Griffins,D. St. Louis,4067280,,False,7.0,0,1,0,1,0,0,2,2,0,1,1,0,0,0,0,2,2
401085908,Canisius Golden Griffins,J. Faulkner,3137250,,False,25.0,4,8,3,5,1,3,0,0,3,4,7,1,2,0,0,2,9
401085908,Canisius Golden Griffins,J. Henderson,4398046,,False,6.0,1,1,0,0,1,1,0,0,0,1,1,0,0,0,1,0,3
401085908,Canisius Golden Griffins,J. Sanks,3141259,,False,10.0,1,4,1,1,0,3,0,0,0,2,2,0,0,0,0,1,2
401085908,Canisius Golden Griffins,TEAM,TOTAL,TOTAL,False,,23,56,16,33,7,23,10,13,11,27,38,12,6,0,16,17,63
401085907,Robert Morris Colonials,Y. Mendy,4397993,,True,14.0,4,5,4,5,0,0,1,1,1,2,3,1,0,0,0,5,9
401085907,Robert Morris Colonials,C. Bain,4279641,,True,19.0,2,9,0,4,2,5,6,6,1,1,2,0,0,1,2,2,12
401085907,Robert Morris Colonials,J. Williams,4279635,,True,32.0,1,4,0,0,1,4,0,0,0,1,1,3,1,0,3,1,3
401085907,Robert Morris Colonials,M. McConnell,3938915,,True,28.0,2,4,2,3,0,1,1,3,0,3,3,3,4,1,1,5,5
401085907,Robert Morris Colonials,J. Williams,3907021,,True,37.0,3,12,0,4,3,8,8,8,3,2,5,0,0,0,3,5,17
401085907,Robert Morris Colonials,M. Petteway,4279638,,False,22.0,0,5,0,5,0,0,5,10,4,4,8,0,1,1,2,2,5
401085907,Robert Morris Colonials,K. Thomas,4279639,,False,24.0,4,10,4,9,0,1,0,0,0,5,5,0,1,0,0,1,8
401085907,Robert Morris Colonials,C. Wilbon,4397994,,False,10.0,1,1,1,1,0,0,0,1,0,1,1,1,0,0,0,1,2
401085907,Robert Morris Colonials,S. McEwen,4397992,,False,6.0,0,1,0,0,0,1,1,2,0,1,1,0,1,0,0,0,1
401085907,Robert Morris Colonials,D. Treacy,4397989,,False,8.0,0,0,0,0,0,0,0,0,0,0,0,0,0,0,3,1,0
401085907,Robert Morris Colonials,TEAM,TOTAL,TOTAL,False,,17,51,11,31,6,20,22,31,10,21,31,8,8,3,15,23,62
401085907,Canisius Golden Griffins,S. Hitchon,4279482,,True,30.0,3,5,3,4,0,1,7,8,1,1,2,1,0,1,3,3,13
401085907,Canisius Golden Griffins,J. White,4279478,,True,26.0,4,10,4,9,0,1,0,0,2,1,3,1,0,1,1,3,8
401085907,Canisius Golden Griffins,T. Molson,4279481,,True,29.0,4,10,3,6,1,4,5,7,1,2,3,1,1,0,4,2,14
401085907,Canisius Golden Griffins,I. Reese,4067278,,True,32.0,5,8,5,6,0,2,0,2,0,12,12,7,3,0,4,4,10
401085907,Canisius Golden Griffins,M. Johnson,4067275,,True,32.0,1,3,0,1,1,2,3,4,0,6,6,0,0,0,4,3,6
401085907,Canisius Golden Griffins,D. St. Louis,4067280,,False,7.0,0,0,0,0,0,0,2,2,1,2,3,0,0,0,3,3,2
401085907,Canisius Golden Griffins,J. Faulkner,3137250,,False,15.0,2,6,2,5,0,1,0,0,2,0,2,0,1,0,0,1,4
401085907,Canisius Golden Griffins,J. Henderson,4398046,,False,14.0,2,2,1,1,1,1,0,0,0,0,0,1,1,0,0,2,5
401085907,Canisius Golden Griffins,J. Sanks,3141259,,False,15.0,2,3,1,1,1,2,1,2,0,3,3,0,1,0,0,2,6
401085907,Canisius Golden Griffins,TEAM,TOTAL,TOTAL,False,,23,47,19,33,4,14,18,25,7,30,37,11,7,2,19,23,68
401085906,UAlbany Great Danes,A. Lulka,4278204,,True,35.0,2,7,2,6,0,1,1,3,2,8,10,3,0,0,2,0,5
401085906,UAlbany Great Danes,D. Campbell,4066683,,True,31.0,5,6,3,4,2,2,3,6,1,4,5,1,2,0,0,3,15
401085906,UAlbany Great Danes,B. Hank,4278202,,True,10.0,1,1,1,1,0,0,0,0,1,1,2,0,0,0,1,3,2
401085906,UAlbany Great Danes,C. Healy,4278203,,True,34.0,6,12,4,5,2,7,0,1,1,5,6,4,0,0,6,3,14
401085906,UAlbany Great Danes,A. Clark,4278199,,True,37.0,8,16,4,8,4,8,10,11,0,5,5,7,3,0,4,4,30
401085906,UAlbany Great Danes,K. Lauderdale,4395878,,False,18.0,3,4,3,4,0,0,2,2,0,3,3,0,0,0,1,1,8
401085906,UAlbany Great Danes,M. De Sousa,4395874,,False,7.0,0,0,0,0,0,0,0,0,0,0,0,0,0,1,2,1,0
401085906,UAlbany Great Danes,S. French,4066754,,False,4.0,0,0,0,0,0,0,0,0,0,0,0,0,0,0,0,0,0
401085906,UAlbany Great Danes,R. Brooks,4395875,,False,4.0,0,0,0,0,0,0,0,0,0,0,0,0,0,0,0,1,0
401085906,UAlbany Great Danes,R. Miller,3961485,,False,20.0,0,1,0,1,0,0,1,2,1,1,2,2,0,0,1,3,1
401085906,UAlbany Great Danes,TEAM,TOTAL,TOTAL,False,,25,47,17,29,8,18,17,25,6,31,37,17,5,1,18,19,75
401085906,Canisius Golden Griffins,S. Hitchon,4279482,,True,26.0,4,6,3,5,1,1,1,3,1,3,4,0,0,0,1,2,10
401085906,Canisius Golden Griffins,J. White,4279478,,True,14.0,1,3,1,2,0,1,4,6,2,2,4,0,1,1,0,0,6
401085906,Canisius Golden Griffins,T. Molson,4279481,,True,33.0,8,20,6,10,2,10,6,9,3,0,3,2,0,1,1,2,24
401085906,Canisius Golden Griffins,I. Reese,4067278,,True,36.0,3,13,3,6,0,7,0,0,1,7,8,4,4,0,2,4,6
401085906,Canisius Golden Griffins,M. Johnson,4067275,,True,24.0,0,2,0,0,0,2,0,0,0,0,0,3,2,0,1,4,0
401085906,Canisius Golden Griffins,K. Johnson-Alls,4398049,,False,7.0,1,2,0,0,1,2,1,3,0,2,2,0,1,0,2,2,4
401085906,Canisius Golden Griffins,D. St. Louis,4067280,,False,10.0,1,1,1,1,0,0,0,0,0,2,2,0,0,0,0,3,2
401085906,Canisius Golden Griffins,J. Faulkner,3137250,,False,19.0,3,7,2,4,1,3,0,0,1,0,1,1,0,0,0,2,7
401085906,Canisius Golden Griffins,J. Henderson,4398046,,False,4.0,0,0,0,0,0,0,0,0,0,0,0,0,0,0,1,1,0
401085906,Canisius Golden Griffins,J. Sanks,3141259,,False,27.0,2,6,1,2,1,4,2,4,0,5,5,2,3,0,0,4,7
401085906,Canisius Golden Griffins,TEAM,TOTAL,TOTAL,False,,23,60,17,30,6,30,14,25,11,21,32,12,11,2,8,24,66
401085905,Canisius Golden Griffins,S. Hitchon,4279482,,True,20.0,3,3,3,3,0,0,2,2,2,2,4,2,1,1,3,4,8
401085905,Canisius Golden Griffins,J. White,4279478,,True,14.0,3,7,3,7,0,0,0,0,2,1,3,1,1,0,1,4,6
401085905,Canisius Golden Griffins,T. Molson,4279481,,True,33.0,7,14,4,7,3,7,8,8,1,6,7,3,3,0,3,2,25
401085905,Canisius Golden Griffins,I. Reese,4067278,,True,30.0,6,14,3,7,3,7,0,0,0,6,6,2,0,0,2,1,15
401085905,Canisius Golden Griffins,M. Johnson,4067275,,True,40.0,2,6,2,5,0,1,7,8,0,4,4,3,2,0,1,0,11
401085905,Canisius Golden Griffins,K. Johnson-Alls,4398049,,False,12.0,0,0,0,0,0,0,1,3,0,1,1,0,0,0,0,1,1
401085905,Canisius Golden Griffins,D. St. Louis,4067280,,False,11.0,0,2,0,2,0,0,0,0,1,1,2,0,0,1,1,4,0
401085905,Canisius Golden Griffins,J. Faulkner,3137250,,False,19.0,2,5,0,1,2,4,1,2,0,2,2,0,1,1,0,1,7
401085905,Canisius Golden Griffins,S. Rautins,4398047,,False,0.0,0,0,0,0,0,0,0,0,0,0,0,0,0,0,0,0,0
401085905,Canisius Golden Griffins,J. Henderson,4398046,,False,5.0,0,1,0,1,0,0,0,0,0,0,0,1,0,1,1,1,0
401085905,Canisius Golden Griffins,J. Sanks,3141259,,False,16.0,3,5,1,2,2,3,1,2,0,2,2,1,0,0,0,3,9
401085905,Canisius Golden Griffins,TEAM,TOTAL,TOTAL,False,,26,57,16,35,10,22,20,25,9,27,36,13,8,4,12,21,82
401085905,Bucknell Bison,B. Moore,4067103,,True,23.0,0,4,0,3,0,1,4,4,0,1,1,3,0,0,3,2,4
401085905,Bucknell Bison,P. Newman,4280043,,True,27.0,5,7,5,7,0,0,3,5,1,6,7,1,0,4,3,4,13
401085905,Bucknell Bison,J. Sotos,4280044,,True,36.0,9,12,4,5,5,7,0,0,0,6,6,2,1,0,5,2,23
401085905,Bucknell Bison,A. Toomer,4067102,,True,20.0,1,2,1,1,0,1,0,1,0,2,2,1,1,0,1,5,2
401085905,Bucknell Bison,K. Mackenzie,3914278,,True,31.0,4,12,0,3,4,9,4,5,2,1,3,2,1,0,1,3,16
401085905,Bucknell Bison,K. Spear,4397651,,False,2.0,0,0,0,0,0,0,0,3,0,0,0,0,0,0,0,0,0
401085905,Bucknell Bison,W. Ellis,4397649,,False,12.0,1,3,0,0,1,3,0,0,1,3,4,0,0,1,1,1,3
401085905,Bucknell Bison,A. Funk,4397650,,False,21.0,1,5,1,1,0,4,0,1,0,1,1,0,1,0,1,1,2
401085905,Bucknell Bison,B. Robertson,4067104,,False,22.0,5,6,5,6,0,0,0,1,0,3,3,4,0,1,0,4,10
401085905,Bucknell Bison,N. Jones,3914280,,False,6.0,0,2,0,1,0,1,0,0,0,0,0,1,0,0,0,0,0
401085905,Bucknell Bison,TEAM,TOTAL,TOTAL,False,,26,53,16,27,10,26,11,20,5,23,28,14,4,6,15,22,73
401085902,Elon Phoenix,C. Hannah,4397456,,True,25.0,3,9,2,7,1,2,3,4,3,1,4,3,1,0,1,2,10
401085902,Elon Phoenix,T. Seibring,3948129,,True,32.0,8,13,3,4,5,9,3,4,2,1,3,1,0,1,0,3,24
401085902,Elon Phoenix,N. Priddy,4279201,,True,33.0,5,7,2,3,3,4,2,4,1,2,3,2,0,0,3,3,15
401085902,Elon Phoenix,S. Santa Ana,4067232,,True,32.0,8,13,5,7,3,6,6,11,0,7,7,2,2,0,1,5,25
401085902,Elon Phoenix,S. Eberhardt,3948127,,True,30.0,5,7,3,4,2,3,0,0,0,3,3,2,0,0,3,1,12
401085902,Elon Phoenix,S. Wright,4279202,,False,17.0,0,3,0,0,0,3,0,0,0,4,4,2,0,0,1,5,0
401085902,Elon Phoenix,K. Kundrotas,3948125,,False,6.0,0,1,0,1,0,0,2,2,0,1,1,0,0,0,0,0,2
401085902,Elon Phoenix,A. Pack,4397458,,False,3.0,0,0,0,0,0,0,0,0,1,0,1,0,1,0,2,2,0
401085902,Elon Phoenix,K. Wooten,4397455,,False,6.0,0,0,0,0,0,0,0,0,0,1,1,1,0,0,0,0,0
401085902,Elon Phoenix,S. Fuller,4067231,,False,16.0,1,4,0,1,1,3,0,0,1,2,3,1,0,0,0,1,3
401085902,Elon Phoenix,TEAM,TOTAL,TOTAL,False,,30,57,15,27,15,30,16,25,10,23,33,14,4,1,12,22,91
401085902,Canisius Golden Griffins,S. Hitchon,4279482,,True,19.0,5,7,3,3,2,4,4,5,1,1,2,2,0,0,0,4,16
401085902,Canisius Golden Griffins,J. White,4279478,,True,9.0,1,3,1,3,0,0,0,1,1,0,1,0,0,0,0,2,2
401085902,Canisius Golden Griffins,J. Henderson,4398046,,True,23.0,4,5,2,2,2,3,0,2,1,1,2,2,0,0,1,2,10
401085902,Canisius Golden Griffins,T. Molson,4279481,,True,26.0,4,9,2,3,2,6,10,14,0,6,6,3,2,0,2,1,20
401085902,Canisius Golden Griffins,M. Johnson,4067275,,True,35.0,3,9,1,4,2,5,4,6,1,1,2,5,1,1,3,2,12
401085902,Canisius Golden Griffins,M. Lotts,4279480,,False,5.0,0,1,0,1,0,0,0,0,0,1,1,1,0,0,0,1,0
401085902,Canisius Golden Griffins,D. St. Louis,4067280,,False,12.0,0,1,0,1,0,0,0,0,1,3,4,0,1,1,1,2,0
401085902,Canisius Golden Griffins,J. Faulkner,3137250,,False,32.0,7,13,5,8,2,5,0,0,3,5,8,2,2,0,0,1,16
401085902,Canisius Golden Griffins,I. Reese,4067278,,False,22.0,3,7,2,3,1,4,0,0,0,1,1,1,1,0,0,2,7
401085902,Canisius Golden Griffins,J. Sanks,3141259,,False,17.0,4,6,3,3,1,3,0,0,0,2,2,2,0,2,1,2,9
401085902,Canisius Golden Griffins,TEAM,TOTAL,TOTAL,False,,31,61,19,31,12,30,18,28,11,22,33,18,7,4,9,19,92
401085894,Manhattan Jaspers,E. Ebube,4279705,,True,29.0,2,9,0,4,2,5,0,0,3,0,3,1,1,0,1,3,6
401085894,Manhattan Jaspers,I. Diallo,3149898,,True,7.0,0,0,0,0,0,0,0,0,0,0,0,0,0,0,0,0,0
401085894,Manhattan Jaspers,E. Buchanan,4398103,,True,4.0,0,2,0,1,0,1,0,0,0,0,0,0,0,0,0,1,0
401085894,Manhattan Jaspers,N. Mack,4279703,,True,22.0,3,9,1,4,2,5,2,2,0,2,2,1,2,0,2,4,10
401085894,Manhattan Jaspers,T. Capuano,3948706,,True,31.0,4,12,2,8,2,4,0,0,0,8,8,4,1,0,0,3,10
401085894,Manhattan Jaspers,T. Reynolds,4398107,,False,2.0,0,0,0,0,0,0,0,0,0,0,0,0,0,0,0,0,0
401085894,Manhattan Jaspers,D. Schreier,4398105,,False,6.0,1,1,0,0,1,1,0,0,0,0,0,0,0,0,0,0,3
401085894,Manhattan Jaspers,W. Williams,4279701,,False,14.0,1,3,1,3,0,0,2,4,4,2,6,1,0,0,1,5,4
401085894,Manhattan Jaspers,T. Greene,4398108,,False,21.0,2,9,2,6,0,3,0,1,2,1,3,0,0,0,2,2,4
401085894,Manhattan Jaspers,C. Hinckson,4398106,,False,18.0,2,4,2,4,0,0,0,0,1,3,4,1,2,0,1,1,4
401085894,Manhattan Jaspers,S. Stewart,4398104,,False,26.0,2,9,0,1,2,8,1,2,1,0,1,2,2,0,2,2,7
401085894,Manhattan Jaspers,S. Usilo,3138468,,False,20.0,4,7,4,5,0,2,0,0,0,1,1,0,1,0,2,2,8
401085894,Manhattan Jaspers,TEAM,TOTAL,TOTAL,False,,21,65,12,36,9,29,5,9,14,22,36,10,9,0,12,23,56
401085894,Elon Phoenix,T. Seibring,3948129,,True,33.0,6,12,3,6,3,6,2,2,0,8,8,1,0,1,1,1,17
401085894,Elon Phoenix,K. Kundrotas,3948125,,True,20.0,3,5,3,4,0,1,0,3,1,4,5,1,0,0,3,4,6
401085894,Elon Phoenix,S. Santa Ana,4067232,,True,36.0,3,6,2,3,1,3,5,7,0,4,4,4,0,0,4,1,12
401085894,Elon Phoenix,S. Eberhardt,3948127,,True,31.0,2,7,1,4,1,3,2,2,1,2,3,5,1,0,3,2,7
401085894,Elon Phoenix,D. Swoope,3948126,,True,32.0,4,9,1,2,3,7,3,4,1,1,2,1,0,0,0,1,14
401085894,Elon Phoenix,F. Poser,4397457,,False,14.0,2,2,2,2,0,0,0,0,2,0,2,0,0,0,1,3,4
401085894,Elon Phoenix,C. Hannah,4397456,,False,14.0,0,0,0,0,0,0,0,0,1,1,2,0,1,1,2,2,0
401085894,Elon Phoenix,A. Pack,4397458,,False,3.0,0,1,0,1,0,0,0,0,0,0,0,0,0,0,0,0,0
401085894,Elon Phoenix,K. Wooten,4397455,,False,8.0,1,3,1,1,0,2,0,0,0,0,0,0,0,0,1,0,2
401085894,Elon Phoenix,S. Fuller,4067231,,False,9.0,0,0,0,0,0,0,0,0,0,2,2,1,0,0,1,0,0
401085894,Elon Phoenix,TEAM,TOTAL,TOTAL,False,,21,45,13,23,8,22,12,18,7,28,35,13,2,2,18,14,62
401085779,Quinnipiac Bobcats,J. Rigoni,4279743,,True,24.0,0,6,0,3,0,3,0,0,1,1,2,0,1,0,1,1,0
401085779,Quinnipiac Bobcats,A. Bundu,3947028,,True,26.0,2,4,2,4,0,0,1,2,2,5,7,0,2,2,1,2,5
401085779,Quinnipiac Bobcats,R. Kelly,4279741,,True,35.0,6,15,2,6,4,9,1,2,0,4,4,2,1,0,1,4,17
401085779,Quinnipiac Bobcats,C. Young,4070684,,True,38.0,3,12,1,4,2,8,8,9,0,6,6,3,0,0,4,2,16
401085779,Quinnipiac Bobcats,Aa. Robinson,3947024,,True,3.0,0,0,0,0,0,0,0,0,0,0,0,0,0,0,0,0,0
401085779,Quinnipiac Bobcats,K. Marfo,4066877,,False,12.0,1,1,1,1,0,0,4,4,2,3,5,0,0,1,0,2,6
401085779,Quinnipiac Bobcats,T. Pickron,4398400,,False,18.0,2,8,0,2,2,6,0,0,2,1,3,1,1,0,0,0,6
401085779,Quinnipiac Bobcats,T. Williams,4398399,,False,26.0,1,4,0,1,1,3,2,2,0,3,3,2,1,0,3,3,5
401085779,Quinnipiac Bobcats,T. Atson,4066478,,False,18.0,1,2,0,0,1,2,0,0,1,1,2,2,0,0,0,1,3
401085779,Quinnipiac Bobcats,TEAM,TOTAL,TOTAL,False,,16,52,6,21,10,31,16,19,10,27,37,10,6,3,11,15,58
401085779,Quinnipiac Bobcats,J. Rigoni,4279743,,True,24.0,0,6,0,3,0,3,0,0,1,1,2,0,1,0,1,1,0
401085779,Quinnipiac Bobcats,A. Bundu,3947028,,True,26.0,2,4,2,4,0,0,1,2,2,5,7,0,2,2,1,2,5
401085779,Quinnipiac Bobcats,R. Kelly,4279741,,True,35.0,6,15,2,6,4,9,1,2,0,4,4,2,1,0,1,4,17
401085779,Quinnipiac Bobcats,C. Young,4070684,,True,38.0,3,12,1,4,2,8,8,9,0,6,6,3,0,0,4,2,16
401085779,Quinnipiac Bobcats,Aa. Robinson,3947024,,True,3.0,0,0,0,0,0,0,0,0,0,0,0,0,0,0,0,0,0
401085779,Quinnipiac Bobcats,K. Marfo,4066877,,False,12.0,1,1,1,1,0,0,4,4,2,3,5,0,0,1,0,2,6
401085779,Quinnipiac Bobcats,T. Pickron,4398400,,False,18.0,2,8,0,2,2,6,0,0,2,1,3,1,1,0,0,0,6
401085779,Quinnipiac Bobcats,T. Williams,4398399,,False,26.0,1,4,0,1,1,3,2,2,0,3,3,2,1,0,3,3,5
401085779,Quinnipiac Bobcats,T. Atson,4066478,,False,18.0,1,2,0,0,1,2,0,0,1,1,2,2,0,0,0,1,3
401085779,Quinnipiac Bobcats,TEAM,TOTAL,TOTAL,False,,16,52,6,21,10,31,16,19,10,27,37,10,6,3,11,15,58
401085779,Manhattan Jaspers,T. Reynolds,4398107,,True,19.0,4,9,0,0,4,9,0,0,0,2,2,2,0,0,1,0,12
401085779,Manhattan Jaspers,W. Williams,4279701,,True,18.0,4,8,4,8,0,0,3,5,2,2,4,0,1,1,0,5,11
401085779,Manhattan Jaspers,C. Hinckson,4398106,,True,18.0,0,2,0,2,0,0,0,0,0,1,1,0,1,0,0,1,0
401085779,Manhattan Jaspers,S. Stewart,4398104,,True,33.0,2,7,0,2,2,5,0,0,0,1,1,3,0,1,2,2,6
401085779,Manhattan Jaspers,N. Mack,4279703,,True,30.0,3,7,1,2,2,5,2,2,2,5,7,4,0,0,2,0,10
401085779,Manhattan Jaspers,E. Ebube,4279705,,False,22.0,2,3,2,2,0,1,0,0,3,4,7,0,0,0,2,3,4
401085779,Manhattan Jaspers,T. Greene,4398108,,False,23.0,3,7,2,4,1,3,1,4,0,7,7,0,0,0,0,1,8
401085779,Manhattan Jaspers,E. Buchanan,4398103,,False,11.0,2,4,2,2,0,2,0,0,0,1,1,0,0,0,1,4,4
401085779,Manhattan Jaspers,T. Capuano,3948706,,False,6.0,0,1,0,0,0,1,0,0,0,0,0,0,0,0,2,1,0
401085779,Manhattan Jaspers,S. Usilo,3138468,,False,20.0,3,7,3,6,0,1,1,3,2,3,5,0,1,1,0,0,7
401085779,Manhattan Jaspers,TEAM,TOTAL,TOTAL,False,,23,55,14,28,9,27,7,14,10,28,38,9,3,3,11,17,62
401085779,Manhattan Jaspers,T. Reynolds,4398107,,True,19.0,4,9,0,0,4,9,0,0,0,2,2,2,0,0,1,0,12
401085779,Manhattan Jaspers,W. Williams,4279701,,True,18.0,4,8,4,8,0,0,3,5,2,2,4,0,1,1,0,5,11
401085779,Manhattan Jaspers,C. Hinckson,4398106,,True,18.0,0,2,0,2,0,0,0,0,0,1,1,0,1,0,0,1,0
401085779,Manhattan Jaspers,S. Stewart,4398104,,True,33.0,2,7,0,2,2,5,0,0,0,1,1,3,0,1,2,2,6
401085779,Manhattan Jaspers,N. Mack,4279703,,True,30.0,3,7,1,2,2,5,2,2,2,5,7,4,0,0,2,0,10
401085779,Manhattan Jaspers,E. Ebube,4279705,,False,22.0,2,3,2,2,0,1,0,0,3,4,7,0,0,0,2,3,4
401085779,Manhattan Jaspers,T. Greene,4398108,,False,23.0,3,7,2,4,1,3,1,4,0,7,7,0,0,0,0,1,8
401085779,Manhattan Jaspers,E. Buchanan,4398103,,False,11.0,2,4,2,2,0,2,0,0,0,1,1,0,0,0,1,4,4
401085779,Manhattan Jaspers,T. Capuano,3948706,,False,6.0,0,1,0,0,0,1,0,0,0,0,0,0,0,0,2,1,0
401085779,Manhattan Jaspers,S. Usilo,3138468,,False,20.0,3,7,3,6,0,1,1,3,2,3,5,0,1,1,0,0,7
401085779,Manhattan Jaspers,TEAM,TOTAL,TOTAL,False,,23,55,14,28,9,27,7,14,10,28,38,9,3,3,11,17,62
401085778,Saint Peter's Peacocks,KC Ndefo,4398386,,True,33.0,6,14,5,11,1,3,2,2,2,1,3,1,3,2,2,3,15
401085778,Saint Peter's Peacocks,S. Idowu,3922042,,True,19.0,3,4,3,4,0,0,0,0,0,3,3,0,1,0,2,4,6
401085778,Saint Peter's Peacocks,D. Watson,4398384,,True,34.0,1,12,1,8,0,4,2,2,0,2,2,4,0,0,3,1,4
401085778,Saint Peter's Peacocks,Q. Taylor,4067357,,True,35.0,6,11,5,8,1,3,2,2,2,4,6,4,2,0,1,4,15
401085778,Saint Peter's Peacocks,D. Turner,4067356,,True,37.0,6,14,3,6,3,8,0,0,0,3,3,1,1,0,1,2,15
401085778,Saint Peter's Peacocks,D. Woods,3919424,,False,19.0,2,6,2,6,0,0,1,2,1,3,4,0,0,0,1,4,5
401085778,Saint Peter's Peacocks,M. Majak,4398387,,False,2.0,0,0,0,0,0,0,0,0,0,0,0,0,0,0,0,0,0
401085778,Saint Peter's Peacocks,C. Underwood,4398388,,False,5.0,0,0,0,0,0,0,0,0,0,0,0,0,0,0,0,0,0
401085778,Saint Peter's Peacocks,K. Brown,4398385,,False,14.0,0,0,0,0,0,0,0,0,0,0,0,0,1,0,0,0,0
401085778,Saint Peter's Peacocks,A. Hicks,4284295,,False,2.0,0,1,0,0,0,1,0,0,0,0,0,1,0,0,0,0,0
401085778,Saint Peter's Peacocks,TEAM,TOTAL,TOTAL,False,,24,62,19,43,5,19,7,8,8,18,26,11,8,2,10,18,60
401085778,Saint Peter's Peacocks,KC Ndefo,4398386,,True,33.0,6,14,5,11,1,3,2,2,2,1,3,1,3,2,2,3,15
401085778,Saint Peter's Peacocks,S. Idowu,3922042,,True,19.0,3,4,3,4,0,0,0,0,0,3,3,0,1,0,2,4,6
401085778,Saint Peter's Peacocks,D. Watson,4398384,,True,34.0,1,12,1,8,0,4,2,2,0,2,2,4,0,0,3,1,4
401085778,Saint Peter's Peacocks,Q. Taylor,4067357,,True,35.0,6,11,5,8,1,3,2,2,2,4,6,4,2,0,1,4,15
401085778,Saint Peter's Peacocks,D. Turner,4067356,,True,37.0,6,14,3,6,3,8,0,0,0,3,3,1,1,0,1,2,15
401085778,Saint Peter's Peacocks,D. Woods,3919424,,False,19.0,2,6,2,6,0,0,1,2,1,3,4,0,0,0,1,4,5
401085778,Saint Peter's Peacocks,M. Majak,4398387,,False,2.0,0,0,0,0,0,0,0,0,0,0,0,0,0,0,0,0,0
401085778,Saint Peter's Peacocks,C. Underwood,4398388,,False,5.0,0,0,0,0,0,0,0,0,0,0,0,0,0,0,0,0,0
401085778,Saint Peter's Peacocks,K. Brown,4398385,,False,14.0,0,0,0,0,0,0,0,0,0,0,0,0,1,0,0,0,0
401085778,Saint Peter's Peacocks,A. Hicks,4284295,,False,2.0,0,1,0,0,0,1,0,0,0,0,0,1,0,0,0,0,0
401085778,Saint Peter's Peacocks,TEAM,TOTAL,TOTAL,False,,24,62,19,43,5,19,7,8,8,18,26,11,8,2,10,18,60
401085778,Quinnipiac Bobcats,J. Rigoni,4279743,,True,27.0,6,9,1,1,5,8,0,0,1,3,4,1,1,0,1,0,17
401085778,Quinnipiac Bobcats,A. Bundu,3947028,,True,18.0,3,3,3,3,0,0,0,0,0,5,5,1,0,0,2,2,6
401085778,Quinnipiac Bobcats,T. Williams,4398399,,True,31.0,2,5,0,1,2,4,0,0,0,2,2,5,0,1,3,3,6
401085778,Quinnipiac Bobcats,R. Kelly,4279741,,True,34.0,2,5,1,2,1,3,2,2,0,3,3,4,1,0,1,0,7
401085778,Quinnipiac Bobcats,C. Young,4070684,,True,37.0,8,12,2,4,6,8,4,5,0,0,0,3,1,0,8,4,26
401085778,Quinnipiac Bobcats,K. Marfo,4066877,,False,20.0,1,1,1,1,0,0,6,6,0,9,9,2,0,3,1,1,8
401085778,Quinnipiac Bobcats,T. Pickron,4398400,,False,18.0,2,5,0,1,2,4,1,2,0,1,1,2,1,0,0,1,7
401085778,Quinnipiac Bobcats,T. Atson,4066478,,False,15.0,0,2,0,1,0,1,0,0,0,3,3,0,0,0,1,0,0
401085778,Quinnipiac Bobcats,TEAM,TOTAL,TOTAL,False,,24,42,8,14,16,28,13,15,1,29,30,18,4,4,18,11,77
401085778,Quinnipiac Bobcats,J. Rigoni,4279743,,True,27.0,6,9,1,1,5,8,0,0,1,3,4,1,1,0,1,0,17
401085778,Quinnipiac Bobcats,A. Bundu,3947028,,True,18.0,3,3,3,3,0,0,0,0,0,5,5,1,0,0,2,2,6
401085778,Quinnipiac Bobcats,T. Williams,4398399,,True,31.0,2,5,0,1,2,4,0,0,0,2,2,5,0,1,3,3,6
401085778,Quinnipiac Bobcats,R. Kelly,4279741,,True,34.0,2,5,1,2,1,3,2,2,0,3,3,4,1,0,1,0,7
401085778,Quinnipiac Bobcats,C. Young,4070684,,True,37.0,8,12,2,4,6,8,4,5,0,0,0,3,1,0,8,4,26
401085778,Quinnipiac Bobcats,K. Marfo,4066877,,False,20.0,1,1,1,1,0,0,6,6,0,9,9,2,0,3,1,1,8
401085778,Quinnipiac Bobcats,T. Pickron,4398400,,False,18.0,2,5,0,1,2,4,1,2,0,1,1,2,1,0,0,1,7
401085778,Quinnipiac Bobcats,T. Atson,4066478,,False,15.0,0,2,0,1,0,1,0,0,0,3,3,0,0,0,1,0,0
401085778,Quinnipiac Bobcats,TEAM,TOTAL,TOTAL,False,,24,42,8,14,16,28,13,15,1,29,30,18,4,4,18,11,77
401085777,Quinnipiac Bobcats,J. Rigoni,4279743,,True,31.0,0,4,0,2,0,2,3,3,1,4,5,4,1,0,2,4,3
401085777,Quinnipiac Bobcats,A. Bundu,3947028,,True,9.0,0,2,0,2,0,0,0,0,1,3,4,0,0,0,0,2,0
401085777,Quinnipiac Bobcats,T. Williams,4398399,,True,35.0,3,10,1,5,2,5,2,4,3,6,9,2,2,0,3,1,10
401085777,Quinnipiac Bobcats,R. Kelly,4279741,,True,31.0,7,12,1,2,6,10,2,2,0,3,3,0,0,0,3,4,22
401085777,Quinnipiac Bobcats,C. Young,4070684,,True,39.0,5,15,2,6,3,9,12,13,3,3,6,2,0,0,5,1,25
401085777,Quinnipiac Bobcats,K. Marfo,4066877,,False,21.0,0,1,0,1,0,0,2,2,2,5,7,0,1,1,1,2,2
401085777,Quinnipiac Bobcats,T. Pickron,4398400,,False,4.0,0,1,0,0,0,1,0,0,0,0,0,0,0,0,0,0,0
401085777,Quinnipiac Bobcats,T. Atson,4066478,,False,18.0,2,3,0,0,2,3,0,0,1,4,5,1,1,0,1,4,6
401085777,Quinnipiac Bobcats,Aa. Robinson,3947024,,False,12.0,0,1,0,0,0,1,0,1,0,1,1,0,1,0,0,1,0
401085777,Quinnipiac Bobcats,TEAM,TOTAL,TOTAL,False,,17,49,4,18,13,31,21,25,12,30,42,9,6,1,17,19,68
401085777,Quinnipiac Bobcats,J. Rigoni,4279743,,True,31.0,0,4,0,2,0,2,3,3,1,4,5,4,1,0,2,4,3
401085777,Quinnipiac Bobcats,A. Bundu,3947028,,True,9.0,0,2,0,2,0,0,0,0,1,3,4,0,0,0,0,2,0
401085777,Quinnipiac Bobcats,T. Williams,4398399,,True,35.0,3,10,1,5,2,5,2,4,3,6,9,2,2,0,3,1,10
401085777,Quinnipiac Bobcats,R. Kelly,4279741,,True,31.0,7,12,1,2,6,10,2,2,0,3,3,0,0,0,3,4,22
401085777,Quinnipiac Bobcats,C. Young,4070684,,True,39.0,5,15,2,6,3,9,12,13,3,3,6,2,0,0,5,1,25
401085777,Quinnipiac Bobcats,K. Marfo,4066877,,False,21.0,0,1,0,1,0,0,2,2,2,5,7,0,1,1,1,2,2
401085777,Quinnipiac Bobcats,T. Pickron,4398400,,False,4.0,0,1,0,0,0,1,0,0,0,0,0,0,0,0,0,0,0
401085777,Quinnipiac Bobcats,T. Atson,4066478,,False,18.0,2,3,0,0,2,3,0,0,1,4,5,1,1,0,1,4,6
401085777,Quinnipiac Bobcats,Aa. Robinson,3947024,,False,12.0,0,1,0,0,0,1,0,1,0,1,1,0,1,0,0,1,0
401085777,Quinnipiac Bobcats,TEAM,TOTAL,TOTAL,False,,17,49,4,18,13,31,21,25,12,30,42,9,6,1,17,19,68
401085777,Monmouth Hawks,M. Traore,3975762,,True,26.0,4,8,4,8,0,0,2,4,2,0,2,2,1,0,0,1,10
401085777,Monmouth Hawks,D. Quinn,3948714,,True,26.0,1,5,1,5,0,0,3,4,1,4,5,0,0,3,3,3,5
401085777,Monmouth Hawks,D. Hammond,4279734,,True,27.0,2,10,0,3,2,7,2,4,0,1,1,0,1,1,1,1,8
401085777,Monmouth Hawks,R. Salnave,4067329,,True,22.0,3,8,2,5,1,3,2,2,1,0,1,2,1,0,1,4,9
401085777,Monmouth Hawks,T. Gross Jr.,4065729,,True,9.0,0,1,0,0,0,1,0,0,0,2,2,1,1,0,0,1,0
401085777,Monmouth Hawks,S. Ibiezugbe,4067330,,False,5.0,0,0,0,0,0,0,0,0,0,1,1,0,1,0,1,0,0
401085777,Monmouth Hawks,M. Martin,4279733,,False,16.0,1,3,1,2,0,1,0,0,1,3,4,1,0,0,1,1,2
401085777,Monmouth Hawks,S. Chaput,4398409,,False,6.0,1,1,1,1,0,0,0,0,0,0,0,0,0,0,1,0,2
401085777,Monmouth Hawks,M. McClary,4279736,,False,20.0,5,9,5,9,0,0,2,4,4,1,5,0,1,0,0,2,12
401085777,Monmouth Hawks,G. Papas,4279735,,False,2.0,0,1,0,0,0,1,0,0,0,1,1,0,0,0,0,0,0
401085777,Monmouth Hawks,L. Pillari,3948713,,False,24.0,3,9,2,4,1,5,1,2,0,5,5,2,0,0,0,3,8
401085777,Monmouth Hawks,N. Rutherford,3946977,,False,17.0,0,2,0,1,0,1,0,0,0,2,2,3,1,0,1,3,0
401085777,Monmouth Hawks,TEAM,TOTAL,TOTAL,False,,20,57,16,38,4,19,12,20,9,21,30,11,7,4,9,19,56
401085777,Monmouth Hawks,M. Traore,3975762,,True,26.0,4,8,4,8,0,0,2,4,2,0,2,2,1,0,0,1,10
401085777,Monmouth Hawks,D. Quinn,3948714,,True,26.0,1,5,1,5,0,0,3,4,1,4,5,0,0,3,3,3,5
401085777,Monmouth Hawks,D. Hammond,4279734,,True,27.0,2,10,0,3,2,7,2,4,0,1,1,0,1,1,1,1,8
401085777,Monmouth Hawks,R. Salnave,4067329,,True,22.0,3,8,2,5,1,3,2,2,1,0,1,2,1,0,1,4,9
401085777,Monmouth Hawks,T. Gross Jr.,4065729,,True,9.0,0,1,0,0,0,1,0,0,0,2,2,1,1,0,0,1,0
401085777,Monmouth Hawks,S. Ibiezugbe,4067330,,False,5.0,0,0,0,0,0,0,0,0,0,1,1,0,1,0,1,0,0
401085777,Monmouth Hawks,M. Martin,4279733,,False,16.0,1,3,1,2,0,1,0,0,1,3,4,1,0,0,1,1,2
401085777,Monmouth Hawks,S. Chaput,4398409,,False,6.0,1,1,1,1,0,0,0,0,0,0,0,0,0,0,1,0,2
401085777,Monmouth Hawks,M. McClary,4279736,,False,20.0,5,9,5,9,0,0,2,4,4,1,5,0,1,0,0,2,12
401085777,Monmouth Hawks,G. Papas,4279735,,False,2.0,0,1,0,0,0,1,0,0,0,1,1,0,0,0,0,0,0
401085777,Monmouth Hawks,L. Pillari,3948713,,False,24.0,3,9,2,4,1,5,1,2,0,5,5,2,0,0,0,3,8
401085777,Monmouth Hawks,N. Rutherford,3946977,,False,17.0,0,2,0,1,0,1,0,0,0,2,2,3,1,0,1,3,0
401085777,Monmouth Hawks,TEAM,TOTAL,TOTAL,False,,20,57,16,38,4,19,12,20,9,21,30,11,7,4,9,19,56
401085776,Quinnipiac Bobcats,J. Rigoni,4279743,,True,21.0,2,9,0,0,2,9,2,2,1,5,6,2,0,0,1,0,8
401085776,Quinnipiac Bobcats,A. Bundu,3947028,,True,16.0,0,1,0,1,0,0,1,2,1,2,3,0,0,1,0,5,1
401085776,Quinnipiac Bobcats,T. Williams,4398399,,True,34.0,4,10,3,5,1,5,0,0,0,8,8,1,3,0,0,3,9
401085776,Quinnipiac Bobcats,R. Kelly,4279741,,True,37.0,6,14,0,4,6,10,0,0,1,1,2,4,1,0,3,3,18
401085776,Quinnipiac Bobcats,C. Young,4070684,,True,36.0,10,21,3,5,7,16,3,8,0,4,4,3,0,0,2,5,30
401085776,Quinnipiac Bobcats,K. Marfo,4066877,,False,22.0,3,4,3,4,0,0,2,4,5,5,10,0,0,0,0,3,8
401085776,Quinnipiac Bobcats,T. Atson,4066478,,False,21.0,1,8,0,3,1,5,0,1,2,2,4,1,0,0,0,2,3
401085776,Quinnipiac Bobcats,Aa. Robinson,3947024,,False,13.0,0,4,0,0,0,4,0,0,0,1,1,2,0,0,0,0,0
401085776,Quinnipiac Bobcats,TEAM,TOTAL,TOTAL,False,,26,71,9,22,17,49,8,17,11,28,39,13,4,1,6,21,77
401085776,Quinnipiac Bobcats,J. Rigoni,4279743,,True,21.0,2,9,0,0,2,9,2,2,1,5,6,2,0,0,1,0,8
401085776,Quinnipiac Bobcats,A. Bundu,3947028,,True,16.0,0,1,0,1,0,0,1,2,1,2,3,0,0,1,0,5,1
401085776,Quinnipiac Bobcats,T. Williams,4398399,,True,34.0,4,10,3,5,1,5,0,0,0,8,8,1,3,0,0,3,9
401085776,Quinnipiac Bobcats,R. Kelly,4279741,,True,37.0,6,14,0,4,6,10,0,0,1,1,2,4,1,0,3,3,18
401085776,Quinnipiac Bobcats,C. Young,4070684,,True,36.0,10,21,3,5,7,16,3,8,0,4,4,3,0,0,2,5,30
401085776,Quinnipiac Bobcats,K. Marfo,4066877,,False,22.0,3,4,3,4,0,0,2,4,5,5,10,0,0,0,0,3,8
401085776,Quinnipiac Bobcats,T. Atson,4066478,,False,21.0,1,8,0,3,1,5,0,1,2,2,4,1,0,0,0,2,3
401085776,Quinnipiac Bobcats,Aa. Robinson,3947024,,False,13.0,0,4,0,0,0,4,0,0,0,1,1,2,0,0,0,0,0
401085776,Quinnipiac Bobcats,TEAM,TOTAL,TOTAL,False,,26,71,9,22,17,49,8,17,11,28,39,13,4,1,6,21,77
401085776,Iona Gaels,T. Agee,4398087,,True,38.0,7,13,5,9,2,4,11,16,2,10,12,3,1,1,2,3,27
401085776,Iona Gaels,E.J. Crawford,4067295,,True,38.0,9,13,7,8,2,5,0,0,1,9,10,2,0,1,3,2,20
401085776,Iona Gaels,A. Gist,4067164,,True,34.0,0,8,0,3,0,5,5,6,0,4,4,4,0,0,1,2,5
401085776,Iona Gaels,B. Perez,3948791,,True,29.0,2,6,2,3,0,3,2,2,0,4,4,1,1,0,0,4,6
401085776,Iona Gaels,R. McGill,3948698,,True,36.0,8,15,4,8,4,7,1,2,0,3,3,3,1,0,2,2,21
401085776,Iona Gaels,N. Nikolic,4398090,,False,10.0,1,1,1,1,0,0,0,0,3,1,4,1,0,0,1,3,2
401085776,Iona Gaels,J. Maxwell,4398088,,False,4.0,0,1,0,0,0,1,0,0,0,0,0,0,0,0,0,0,0
401085776,Iona Gaels,A. Ristanovic,4279492,,False,8.0,0,3,0,0,0,3,0,0,0,4,4,0,0,0,0,2,0
401085776,Iona Gaels,P. Hudson,4398089,,False,3.0,0,0,0,0,0,0,0,0,0,0,0,1,0,0,0,0,0
401085776,Iona Gaels,TEAM,TOTAL,TOTAL,False,,27,60,19,32,8,28,19,26,8,37,45,15,3,2,9,18,81
401085776,Iona Gaels,T. Agee,4398087,,True,38.0,7,13,5,9,2,4,11,16,2,10,12,3,1,1,2,3,27
401085776,Iona Gaels,E.J. Crawford,4067295,,True,38.0,9,13,7,8,2,5,0,0,1,9,10,2,0,1,3,2,20
401085776,Iona Gaels,A. Gist,4067164,,True,34.0,0,8,0,3,0,5,5,6,0,4,4,4,0,0,1,2,5
401085776,Iona Gaels,B. Perez,3948791,,True,29.0,2,6,2,3,0,3,2,2,0,4,4,1,1,0,0,4,6
401085776,Iona Gaels,R. McGill,3948698,,True,36.0,8,15,4,8,4,7,1,2,0,3,3,3,1,0,2,2,21
401085776,Iona Gaels,N. Nikolic,4398090,,False,10.0,1,1,1,1,0,0,0,0,3,1,4,1,0,0,1,3,2
401085776,Iona Gaels,J. Maxwell,4398088,,False,4.0,0,1,0,0,0,1,0,0,0,0,0,0,0,0,0,0,0
401085776,Iona Gaels,A. Ristanovic,4279492,,False,8.0,0,3,0,0,0,3,0,0,0,4,4,0,0,0,0,2,0
401085776,Iona Gaels,P. Hudson,4398089,,False,3.0,0,0,0,0,0,0,0,0,0,0,0,1,0,0,0,0,0
401085776,Iona Gaels,TEAM,TOTAL,TOTAL,False,,27,60,19,32,8,28,19,26,8,37,45,15,3,2,9,18,81
401085775,Siena Saints,S. Seymour,4398391,,True,29.0,3,7,0,0,3,7,0,0,0,1,1,0,0,0,1,0,9
401085775,Siena Saints,E. Fisher,3913235,,True,38.0,2,14,2,10,0,4,0,0,3,3,6,1,1,0,1,3,4
401085775,Siena Saints,K. Degnan,3138282,,True,52.0,4,9,1,2,3,7,4,4,3,5,8,0,1,0,0,4,15
401085775,Siena Saints,J. Pickett,4398390,,True,53.0,14,26,10,18,4,8,14,17,0,4,4,13,4,1,1,3,46
401085775,Siena Saints,M. Camper,4279751,,True,42.0,8,14,8,12,0,2,5,6,2,3,5,0,1,0,1,5,21
401085775,Siena Saints,D. Tchougang,4398394,,False,3.0,0,0,0,0,0,0,0,0,0,0,0,0,1,1,0,0,0
401085775,Siena Saints,J. Ratliff,4398392,,False,20.0,0,2,0,0,0,2,0,0,2,0,2,1,1,1,0,1,0
401085775,Siena Saints,P. Morastoni,4293127,,False,0.0,0,0,0,0,0,0,0,0,0,0,0,0,0,0,0,0,0
401085775,Siena Saints,K. Smithen,3133848,,False,38.0,2,5,1,2,1,3,0,0,0,4,4,2,2,0,0,5,5
401085775,Siena Saints,TEAM,TOTAL,TOTAL,False,,33,77,22,44,11,33,23,27,11,20,31,17,11,3,4,21,100
401085775,Siena Saints,S. Seymour,4398391,,True,29.0,3,7,0,0,3,7,0,0,0,1,1,0,0,0,1,0,9
401085775,Siena Saints,E. Fisher,3913235,,True,38.0,2,14,2,10,0,4,0,0,3,3,6,1,1,0,1,3,4
401085775,Siena Saints,K. Degnan,3138282,,True,52.0,4,9,1,2,3,7,4,4,3,5,8,0,1,0,0,4,15
401085775,Siena Saints,J. Pickett,4398390,,True,53.0,14,26,10,18,4,8,14,17,0,4,4,13,4,1,1,3,46
401085775,Siena Saints,M. Camper,4279751,,True,42.0,8,14,8,12,0,2,5,6,2,3,5,0,1,0,1,5,21
401085775,Siena Saints,D. Tchougang,4398394,,False,3.0,0,0,0,0,0,0,0,0,0,0,0,0,1,1,0,0,0
401085775,Siena Saints,J. Ratliff,4398392,,False,20.0,0,2,0,0,0,2,0,0,2,0,2,1,1,1,0,1,0
401085775,Siena Saints,P. Morastoni,4293127,,False,0.0,0,0,0,0,0,0,0,0,0,0,0,0,0,0,0,0,0
401085775,Siena Saints,K. Smithen,3133848,,False,38.0,2,5,1,2,1,3,0,0,0,4,4,2,2,0,0,5,5
401085775,Siena Saints,TEAM,TOTAL,TOTAL,False,,33,77,22,44,11,33,23,27,11,20,31,17,11,3,4,21,100
401085775,Quinnipiac Bobcats,J. Rigoni,4279743,,True,48.0,2,8,1,4,1,4,0,0,0,6,6,2,0,0,3,3,5
401085775,Quinnipiac Bobcats,A. Bundu,3947028,,True,28.0,3,4,3,4,0,0,0,0,2,5,7,3,0,0,2,5,6
401085775,Quinnipiac Bobcats,T. Williams,4398399,,True,29.0,5,12,4,9,1,3,3,3,0,5,5,0,0,0,2,5,14
401085775,Quinnipiac Bobcats,R. Kelly,4279741,,True,52.0,9,15,5,8,4,7,2,2,1,2,3,2,1,0,3,0,24
401085775,Quinnipiac Bobcats,C. Young,4070684,,True,54.0,15,24,6,11,9,13,16,20,5,5,10,2,0,0,2,3,55
401085775,Quinnipiac Bobcats,K. Marfo,4066877,,False,20.0,0,0,0,0,0,0,2,2,2,2,4,0,0,1,0,4,2
401085775,Quinnipiac Bobcats,T. Pickron,4398400,,False,9.0,0,0,0,0,0,0,0,0,0,1,1,0,0,0,0,1,0
401085775,Quinnipiac Bobcats,T. Atson,4066478,,False,12.0,0,2,0,0,0,2,1,2,1,3,4,0,0,0,3,0,1
401085775,Quinnipiac Bobcats,Aa. Robinson,3947024,,False,23.0,0,2,0,1,0,1,0,0,0,3,3,1,1,0,0,3,0
401085775,Quinnipiac Bobcats,TEAM,TOTAL,TOTAL,False,,34,67,19,37,15,30,24,29,14,36,50,10,2,1,18,24,107
401085775,Quinnipiac Bobcats,J. Rigoni,4279743,,True,48.0,2,8,1,4,1,4,0,0,0,6,6,2,0,0,3,3,5
401085775,Quinnipiac Bobcats,A. Bundu,3947028,,True,28.0,3,4,3,4,0,0,0,0,2,5,7,3,0,0,2,5,6
401085775,Quinnipiac Bobcats,T. Williams,4398399,,True,29.0,5,12,4,9,1,3,3,3,0,5,5,0,0,0,2,5,14
401085775,Quinnipiac Bobcats,R. Kelly,4279741,,True,52.0,9,15,5,8,4,7,2,2,1,2,3,2,1,0,3,0,24
401085775,Quinnipiac Bobcats,C. Young,4070684,,True,54.0,15,24,6,11,9,13,16,20,5,5,10,2,0,0,2,3,55
401085775,Quinnipiac Bobcats,K. Marfo,4066877,,False,20.0,0,0,0,0,0,0,2,2,2,2,4,0,0,1,0,4,2
401085775,Quinnipiac Bobcats,T. Pickron,4398400,,False,9.0,0,0,0,0,0,0,0,0,0,1,1,0,0,0,0,1,0
401085775,Quinnipiac Bobcats,T. Atson,4066478,,False,12.0,0,2,0,0,0,2,1,2,1,3,4,0,0,0,3,0,1
401085775,Quinnipiac Bobcats,Aa. Robinson,3947024,,False,23.0,0,2,0,1,0,1,0,0,0,3,3,1,1,0,0,3,0
401085775,Quinnipiac Bobcats,TEAM,TOTAL,TOTAL,False,,34,67,19,37,15,30,24,29,14,36,50,10,2,1,18,24,107
401085774,Quinnipiac Bobcats,J. Rigoni,4279743,,True,30.0,4,14,1,5,3,9,2,2,0,2,2,0,0,0,1,2,13
401085774,Quinnipiac Bobcats,A. Bundu,3947028,,True,23.0,1,3,1,3,0,0,3,3,4,3,7,2,0,1,0,0,5
401085774,Quinnipiac Bobcats,T. Williams,4398399,,True,34.0,2,7,0,1,2,6,0,0,0,7,7,5,2,0,5,4,6
401085774,Quinnipiac Bobcats,R. Kelly,4279741,,True,27.0,2,7,0,2,2,5,0,0,2,0,2,5,0,0,1,3,6
401085774,Quinnipiac Bobcats,C. Young,4070684,,True,38.0,8,13,5,6,3,7,5,6,1,3,4,1,0,2,2,1,24
401085774,Quinnipiac Bobcats,K. Marfo,4066877,,False,11.0,0,0,0,0,0,0,0,0,2,3,5,1,0,0,0,2,0
401085774,Quinnipiac Bobcats,T. Pickron,4398400,,False,3.0,0,0,0,0,0,0,0,0,0,0,0,0,0,0,0,1,0
401085774,Quinnipiac Bobcats,T. Atson,4066478,,False,15.0,2,5,2,3,0,2,0,0,0,4,4,0,0,0,0,2,4
401085774,Quinnipiac Bobcats,Aa. Robinson,3947024,,False,19.0,1,4,0,0,1,4,0,0,0,1,1,1,0,0,0,0,3
401085774,Quinnipiac Bobcats,TEAM,TOTAL,TOTAL,False,,20,53,9,20,11,33,10,11,9,24,33,15,2,3,10,15,61
401085774,Quinnipiac Bobcats,J. Rigoni,4279743,,True,30.0,4,14,1,5,3,9,2,2,0,2,2,0,0,0,1,2,13
401085774,Quinnipiac Bobcats,A. Bundu,3947028,,True,23.0,1,3,1,3,0,0,3,3,4,3,7,2,0,1,0,0,5
401085774,Quinnipiac Bobcats,T. Williams,4398399,,True,34.0,2,7,0,1,2,6,0,0,0,7,7,5,2,0,5,4,6
401085774,Quinnipiac Bobcats,R. Kelly,4279741,,True,27.0,2,7,0,2,2,5,0,0,2,0,2,5,0,0,1,3,6
401085774,Quinnipiac Bobcats,C. Young,4070684,,True,38.0,8,13,5,6,3,7,5,6,1,3,4,1,0,2,2,1,24
401085774,Quinnipiac Bobcats,K. Marfo,4066877,,False,11.0,0,0,0,0,0,0,0,0,2,3,5,1,0,0,0,2,0
401085774,Quinnipiac Bobcats,T. Pickron,4398400,,False,3.0,0,0,0,0,0,0,0,0,0,0,0,0,0,0,0,1,0
401085774,Quinnipiac Bobcats,T. Atson,4066478,,False,15.0,2,5,2,3,0,2,0,0,0,4,4,0,0,0,0,2,4
401085774,Quinnipiac Bobcats,Aa. Robinson,3947024,,False,19.0,1,4,0,0,1,4,0,0,0,1,1,1,0,0,0,0,3
401085774,Quinnipiac Bobcats,TEAM,TOTAL,TOTAL,False,,20,53,9,20,11,33,10,11,9,24,33,15,2,3,10,15,61
401085774,Marist Red Foxes,I. Lamb,3936028,,True,23.0,2,3,1,1,1,2,3,4,0,1,1,1,1,0,0,1,8
401085774,Marist Red Foxes,T. Sjoberg,4067328,,True,13.0,0,1,0,1,0,0,0,0,2,1,3,1,1,0,0,2,0
401085774,Marist Red Foxes,D. Hines,4398410,,True,18.0,0,3,0,2,0,1,0,0,0,0,0,1,1,0,3,3,0
401085774,Marist Red Foxes,B. Parker,3936030,,True,22.0,6,8,6,8,0,0,0,0,1,3,4,6,0,1,1,2,12
401085774,Marist Red Foxes,D. Knudsen,3936027,,True,20.0,1,5,0,0,1,5,0,0,1,1,2,0,0,0,0,0,3
401085774,Marist Red Foxes,L. Nedrow,4398414,,False,11.0,2,3,1,2,1,1,0,0,0,0,0,0,0,0,0,3,5
401085774,Marist Red Foxes,R. Funk,3936026,,False,32.0,3,10,0,2,3,8,1,2,0,1,1,0,0,0,0,0,10
401085774,Marist Red Foxes,A. Dozic,3923222,,False,15.0,4,10,3,5,1,5,0,1,1,3,4,2,0,0,1,3,9
401085774,Marist Red Foxes,M. Herasme,4398413,,False,20.0,0,4,0,0,0,4,2,2,1,3,4,0,1,0,0,1,2
401085774,Marist Red Foxes,A. Williams,4279709,,False,26.0,6,8,6,8,0,0,2,2,0,4,4,2,1,0,1,1,14
401085774,Marist Red Foxes,TEAM,TOTAL,TOTAL,False,,24,55,17,29,7,26,8,11,7,20,27,13,5,1,6,16,63
401085774,Marist Red Foxes,I. Lamb,3936028,,True,23.0,2,3,1,1,1,2,3,4,0,1,1,1,1,0,0,1,8
401085774,Marist Red Foxes,T. Sjoberg,4067328,,True,13.0,0,1,0,1,0,0,0,0,2,1,3,1,1,0,0,2,0
401085774,Marist Red Foxes,D. Hines,4398410,,True,18.0,0,3,0,2,0,1,0,0,0,0,0,1,1,0,3,3,0
401085774,Marist Red Foxes,B. Parker,3936030,,True,22.0,6,8,6,8,0,0,0,0,1,3,4,6,0,1,1,2,12
401085774,Marist Red Foxes,D. Knudsen,3936027,,True,20.0,1,5,0,0,1,5,0,0,1,1,2,0,0,0,0,0,3
401085774,Marist Red Foxes,L. Nedrow,4398414,,False,11.0,2,3,1,2,1,1,0,0,0,0,0,0,0,0,0,3,5
401085774,Marist Red Foxes,R. Funk,3936026,,False,32.0,3,10,0,2,3,8,1,2,0,1,1,0,0,0,0,0,10
401085774,Marist Red Foxes,A. Dozic,3923222,,False,15.0,4,10,3,5,1,5,0,1,1,3,4,2,0,0,1,3,9
401085774,Marist Red Foxes,M. Herasme,4398413,,False,20.0,0,4,0,0,0,4,2,2,1,3,4,0,1,0,0,1,2
401085774,Marist Red Foxes,A. Williams,4279709,,False,26.0,6,8,6,8,0,0,2,2,0,4,4,2,1,0,1,1,14
401085774,Marist Red Foxes,TEAM,TOTAL,TOTAL,False,,24,55,17,29,7,26,8,11,7,20,27,13,5,1,6,16,63
401085773,Rider Broncs,D. Vaughn,4067347,,True,28.0,2,10,2,7,0,3,3,5,2,4,6,0,1,0,3,3,7
401085773,Rider Broncs,F. Scott,3922033,,True,36.0,3,10,2,7,1,3,8,14,2,5,7,3,3,0,2,4,15
401085773,Rider Broncs,T. Marshall,4067348,,True,30.0,5,12,5,12,0,0,2,3,4,5,9,3,0,2,1,3,12
401085773,Rider Broncs,S. Jordan,4067349,,True,41.0,7,14,4,8,3,6,0,1,2,7,9,4,1,0,2,4,17
401085773,Rider Broncs,A. Durham,3138490,,True,31.0,5,11,3,6,2,5,4,6,1,3,4,1,2,0,0,4,16
401085773,Rider Broncs,A. Ogemuno-Johnson,4406151,,False,4.0,0,0,0,0,0,0,0,0,0,0,0,0,0,0,1,0,0
401085773,Rider Broncs,D. Eke,3941312,,False,12.0,2,3,2,3,0,0,1,3,3,1,4,0,2,0,2,1,5
401085773,Rider Broncs,J. Allen,4067345,,False,18.0,3,9,2,2,1,7,0,0,0,2,2,0,0,0,1,3,7
401085773,Rider Broncs,K. Williams,3946983,,False,16.0,0,3,0,2,0,1,0,0,0,0,0,2,2,0,0,0,0
401085773,Rider Broncs,A. Gilbert,3911886,,False,9.0,4,5,3,3,1,2,0,0,0,0,0,0,0,1,1,2,9
401085773,Rider Broncs,TEAM,TOTAL,TOTAL,False,,31,77,23,50,8,27,18,32,19,27,46,13,11,3,13,24,88
401085773,Rider Broncs,D. Vaughn,4067347,,True,28.0,2,10,2,7,0,3,3,5,2,4,6,0,1,0,3,3,7
401085773,Rider Broncs,F. Scott,3922033,,True,36.0,3,10,2,7,1,3,8,14,2,5,7,3,3,0,2,4,15
401085773,Rider Broncs,T. Marshall,4067348,,True,30.0,5,12,5,12,0,0,2,3,4,5,9,3,0,2,1,3,12
401085773,Rider Broncs,S. Jordan,4067349,,True,41.0,7,14,4,8,3,6,0,1,2,7,9,4,1,0,2,4,17
401085773,Rider Broncs,A. Durham,3138490,,True,31.0,5,11,3,6,2,5,4,6,1,3,4,1,2,0,0,4,16
401085773,Rider Broncs,A. Ogemuno-Johnson,4406151,,False,4.0,0,0,0,0,0,0,0,0,0,0,0,0,0,0,1,0,0
401085773,Rider Broncs,D. Eke,3941312,,False,12.0,2,3,2,3,0,0,1,3,3,1,4,0,2,0,2,1,5
401085773,Rider Broncs,J. Allen,4067345,,False,18.0,3,9,2,2,1,7,0,0,0,2,2,0,0,0,1,3,7
401085773,Rider Broncs,K. Williams,3946983,,False,16.0,0,3,0,2,0,1,0,0,0,0,0,2,2,0,0,0,0
401085773,Rider Broncs,A. Gilbert,3911886,,False,9.0,4,5,3,3,1,2,0,0,0,0,0,0,0,1,1,2,9
401085773,Rider Broncs,TEAM,TOTAL,TOTAL,False,,31,77,23,50,8,27,18,32,19,27,46,13,11,3,13,24,88
401085773,Quinnipiac Bobcats,J. Rigoni,4279743,,True,33.0,4,11,3,5,1,6,5,7,3,9,12,5,1,0,0,4,14
401085773,Quinnipiac Bobcats,A. Bundu,3947028,,True,24.0,4,4,4,4,0,0,3,4,1,4,5,0,0,1,1,3,11
401085773,Quinnipiac Bobcats,T. Williams,4398399,,True,31.0,7,12,1,2,6,10,3,4,0,3,3,2,0,0,4,5,23
401085773,Quinnipiac Bobcats,R. Kelly,4279741,,True,39.0,5,10,2,3,3,7,3,3,0,2,2,4,0,0,8,3,16
401085773,Quinnipiac Bobcats,C. Young,4070684,,True,43.0,9,18,7,12,2,6,5,8,1,7,8,5,1,0,4,3,25
401085773,Quinnipiac Bobcats,K. Marfo,4066877,,False,20.0,1,1,1,1,0,0,1,2,2,7,9,1,2,0,0,2,3
401085773,Quinnipiac Bobcats,T. Pickron,4398400,,False,3.0,0,3,0,0,0,3,0,0,0,0,0,0,0,0,0,1,0
401085773,Quinnipiac Bobcats,T. Atson,4066478,,False,12.0,2,4,1,2,1,2,1,2,0,3,3,1,0,0,0,0,6
401085773,Quinnipiac Bobcats,Aa. Robinson,3947024,,False,20.0,0,2,0,0,0,2,0,0,0,1,1,2,1,0,1,3,0
401085773,Quinnipiac Bobcats,TEAM,TOTAL,TOTAL,False,,32,65,19,29,13,36,21,30,9,37,46,20,5,1,18,24,98
401085773,Quinnipiac Bobcats,J. Rigoni,4279743,,True,33.0,4,11,3,5,1,6,5,7,3,9,12,5,1,0,0,4,14
401085773,Quinnipiac Bobcats,A. Bundu,3947028,,True,24.0,4,4,4,4,0,0,3,4,1,4,5,0,0,1,1,3,11
401085773,Quinnipiac Bobcats,T. Williams,4398399,,True,31.0,7,12,1,2,6,10,3,4,0,3,3,2,0,0,4,5,23
401085773,Quinnipiac Bobcats,R. Kelly,4279741,,True,39.0,5,10,2,3,3,7,3,3,0,2,2,4,0,0,8,3,16
401085773,Quinnipiac Bobcats,C. Young,4070684,,True,43.0,9,18,7,12,2,6,5,8,1,7,8,5,1,0,4,3,25
401085773,Quinnipiac Bobcats,K. Marfo,4066877,,False,20.0,1,1,1,1,0,0,1,2,2,7,9,1,2,0,0,2,3
401085773,Quinnipiac Bobcats,T. Pickron,4398400,,False,3.0,0,3,0,0,0,3,0,0,0,0,0,0,0,0,0,1,0
401085773,Quinnipiac Bobcats,T. Atson,4066478,,False,12.0,2,4,1,2,1,2,1,2,0,3,3,1,0,0,0,0,6
401085773,Quinnipiac Bobcats,Aa. Robinson,3947024,,False,20.0,0,2,0,0,0,2,0,0,0,1,1,2,1,0,1,3,0
401085773,Quinnipiac Bobcats,TEAM,TOTAL,TOTAL,False,,32,65,19,29,13,36,21,30,9,37,46,20,5,1,18,24,98
401085772,Quinnipiac Bobcats,J. Rigoni,4279743,,True,27.0,7,11,5,7,2,4,0,0,1,6,7,2,1,0,3,2,16
401085772,Quinnipiac Bobcats,A. Bundu,3947028,,True,26.0,4,6,4,6,0,0,2,2,4,4,8,0,0,1,2,2,10
401085772,Quinnipiac Bobcats,T. Williams,4398399,,True,34.0,3,10,2,4,1,6,0,0,1,5,6,6,0,0,2,3,7
401085772,Quinnipiac Bobcats,R. Kelly,4279741,,True,32.0,3,8,2,5,1,3,2,2,0,3,3,3,1,0,2,1,9
401085772,Quinnipiac Bobcats,C. Young,4070684,,True,38.0,6,17,4,9,2,8,4,6,2,3,5,1,0,0,1,0,18
401085772,Quinnipiac Bobcats,K. Marfo,4066877,,False,14.0,2,3,2,3,0,0,0,0,1,2,3,0,0,1,0,1,4
401085772,Quinnipiac Bobcats,T. Pickron,4398400,,False,5.0,0,1,0,1,0,0,0,0,0,0,0,0,0,0,0,0,0
401085772,Quinnipiac Bobcats,T. Atson,4066478,,False,12.0,1,3,1,1,0,2,0,0,0,4,4,0,0,1,2,0,2
401085772,Quinnipiac Bobcats,Aa. Robinson,3947024,,False,12.0,0,0,0,0,0,0,0,0,0,5,5,0,0,0,0,1,0
401085772,Quinnipiac Bobcats,TEAM,TOTAL,TOTAL,False,,26,59,20,36,6,23,8,10,10,33,43,12,2,3,12,10,66
401085772,Quinnipiac Bobcats,J. Rigoni,4279743,,True,27.0,7,11,5,7,2,4,0,0,1,6,7,2,1,0,3,2,16
401085772,Quinnipiac Bobcats,A. Bundu,3947028,,True,26.0,4,6,4,6,0,0,2,2,4,4,8,0,0,1,2,2,10
401085772,Quinnipiac Bobcats,T. Williams,4398399,,True,34.0,3,10,2,4,1,6,0,0,1,5,6,6,0,0,2,3,7
401085772,Quinnipiac Bobcats,R. Kelly,4279741,,True,32.0,3,8,2,5,1,3,2,2,0,3,3,3,1,0,2,1,9
401085772,Quinnipiac Bobcats,C. Young,4070684,,True,38.0,6,17,4,9,2,8,4,6,2,3,5,1,0,0,1,0,18
401085772,Quinnipiac Bobcats,K. Marfo,4066877,,False,14.0,2,3,2,3,0,0,0,0,1,2,3,0,0,1,0,1,4
401085772,Quinnipiac Bobcats,T. Pickron,4398400,,False,5.0,0,1,0,1,0,0,0,0,0,0,0,0,0,0,0,0,0
401085772,Quinnipiac Bobcats,T. Atson,4066478,,False,12.0,1,3,1,1,0,2,0,0,0,4,4,0,0,1,2,0,2
401085772,Quinnipiac Bobcats,Aa. Robinson,3947024,,False,12.0,0,0,0,0,0,0,0,0,0,5,5,0,0,0,0,1,0
401085772,Quinnipiac Bobcats,TEAM,TOTAL,TOTAL,False,,26,59,20,36,6,23,8,10,10,33,43,12,2,3,12,10,66
401085772,Iona Gaels,T. Agee,4398087,,True,38.0,8,14,8,11,0,3,1,2,2,10,12,2,2,3,3,2,17
401085772,Iona Gaels,A. Ristanovic,4279492,,True,15.0,0,3,0,1,0,2,0,0,1,0,1,0,0,1,0,0,0
401085772,Iona Gaels,E.J. Crawford,4067295,,True,38.0,8,17,5,12,3,5,3,3,1,4,5,2,1,0,0,2,22
401085772,Iona Gaels,B. Perez,3948791,,True,26.0,0,1,0,0,0,1,2,2,0,0,0,2,2,1,1,3,2
401085772,Iona Gaels,R. McGill,3948698,,True,39.0,6,15,6,9,0,6,0,1,2,3,5,4,2,0,0,2,12
401085772,Iona Gaels,N. Nikolic,4398090,,False,5.0,0,1,0,1,0,0,0,0,1,1,2,0,0,1,0,0,0
401085772,Iona Gaels,P. Hudson,4398089,,False,3.0,0,1,0,0,0,1,0,0,0,0,0,0,0,0,0,0,0
401085772,Iona Gaels,A. Gist,4067164,,False,26.0,4,11,2,4,2,7,0,0,0,3,3,2,0,0,0,1,10
401085772,Iona Gaels,I. Still,3938908,,False,10.0,1,4,1,4,0,0,0,0,0,0,0,0,0,0,0,1,2
401085772,Iona Gaels,TEAM,TOTAL,TOTAL,False,,27,67,22,42,5,25,6,8,9,23,32,12,7,6,4,11,65
401085772,Iona Gaels,T. Agee,4398087,,True,38.0,8,14,8,11,0,3,1,2,2,10,12,2,2,3,3,2,17
401085772,Iona Gaels,A. Ristanovic,4279492,,True,15.0,0,3,0,1,0,2,0,0,1,0,1,0,0,1,0,0,0
401085772,Iona Gaels,E.J. Crawford,4067295,,True,38.0,8,17,5,12,3,5,3,3,1,4,5,2,1,0,0,2,22
401085772,Iona Gaels,B. Perez,3948791,,True,26.0,0,1,0,0,0,1,2,2,0,0,0,2,2,1,1,3,2
401085772,Iona Gaels,R. McGill,3948698,,True,39.0,6,15,6,9,0,6,0,1,2,3,5,4,2,0,0,2,12
401085772,Iona Gaels,N. Nikolic,4398090,,False,5.0,0,1,0,1,0,0,0,0,1,1,2,0,0,1,0,0,0
401085772,Iona Gaels,P. Hudson,4398089,,False,3.0,0,1,0,0,0,1,0,0,0,0,0,0,0,0,0,0,0
401085772,Iona Gaels,A. Gist,4067164,,False,26.0,4,11,2,4,2,7,0,0,0,3,3,2,0,0,0,1,10
401085772,Iona Gaels,I. Still,3938908,,False,10.0,1,4,1,4,0,0,0,0,0,0,0,0,0,0,0,1,2
401085772,Iona Gaels,TEAM,TOTAL,TOTAL,False,,27,67,22,42,5,25,6,8,9,23,32,12,7,6,4,11,65
401085771,Quinnipiac Bobcats,J. Rigoni,4279743,,True,32.0,6,8,2,2,4,6,4,6,1,0,1,1,2,0,0,0,20
401085771,Quinnipiac Bobcats,A. Bundu,3947028,,True,26.0,2,3,2,3,0,0,2,4,3,8,11,1,0,1,1,2,6
401085771,Quinnipiac Bobcats,T. Williams,4398399,,True,31.0,4,11,2,5,2,6,3,3,1,1,2,2,0,0,1,2,13
401085771,Quinnipiac Bobcats,R. Kelly,4279741,,True,38.0,5,9,0,2,5,7,6,6,1,2,3,3,1,0,2,2,21
401085771,Quinnipiac Bobcats,C. Young,4070684,,True,32.0,7,11,6,7,1,4,7,11,0,6,6,2,0,0,2,1,22
401085771,Quinnipiac Bobcats,K. Marfo,4066877,,False,14.0,0,3,0,3,0,0,0,0,3,3,6,1,0,0,0,2,0
401085771,Quinnipiac Bobcats,T. Pickron,4398400,,False,10.0,1,3,1,1,0,2,0,0,0,0,0,0,2,0,1,0,2
401085771,Quinnipiac Bobcats,T. Atson,4066478,,False,9.0,0,1,0,0,0,1,0,0,0,2,2,1,0,0,0,1,0
401085771,Quinnipiac Bobcats,Aa. Robinson,3947024,,False,8.0,0,2,0,0,0,2,0,0,0,0,0,0,0,0,0,1,0
401085771,Quinnipiac Bobcats,TEAM,TOTAL,TOTAL,False,,25,51,13,23,12,28,22,30,9,23,32,11,5,1,8,11,84
401085771,Quinnipiac Bobcats,J. Rigoni,4279743,,True,32.0,6,8,2,2,4,6,4,6,1,0,1,1,2,0,0,0,20
401085771,Quinnipiac Bobcats,A. Bundu,3947028,,True,26.0,2,3,2,3,0,0,2,4,3,8,11,1,0,1,1,2,6
401085771,Quinnipiac Bobcats,T. Williams,4398399,,True,31.0,4,11,2,5,2,6,3,3,1,1,2,2,0,0,1,2,13
401085771,Quinnipiac Bobcats,R. Kelly,4279741,,True,38.0,5,9,0,2,5,7,6,6,1,2,3,3,1,0,2,2,21
401085771,Quinnipiac Bobcats,C. Young,4070684,,True,32.0,7,11,6,7,1,4,7,11,0,6,6,2,0,0,2,1,22
401085771,Quinnipiac Bobcats,K. Marfo,4066877,,False,14.0,0,3,0,3,0,0,0,0,3,3,6,1,0,0,0,2,0
401085771,Quinnipiac Bobcats,T. Pickron,4398400,,False,10.0,1,3,1,1,0,2,0,0,0,0,0,0,2,0,1,0,2
401085771,Quinnipiac Bobcats,T. Atson,4066478,,False,9.0,0,1,0,0,0,1,0,0,0,2,2,1,0,0,0,1,0
401085771,Quinnipiac Bobcats,Aa. Robinson,3947024,,False,8.0,0,2,0,0,0,2,0,0,0,0,0,0,0,0,0,1,0
401085771,Quinnipiac Bobcats,TEAM,TOTAL,TOTAL,False,,25,51,13,23,12,28,22,30,9,23,32,11,5,1,8,11,84
401085771,Niagara Purple Eagles,D. Robb,3907186,,True,16.0,2,4,2,4,0,0,0,0,0,1,1,0,0,0,0,1,4
401085771,Niagara Purple Eagles,M. Prochet,3907184,,True,29.0,5,16,4,9,1,7,2,5,0,3,3,0,1,0,1,0,13
401085771,Niagara Purple Eagles,K. Tate,4279738,,True,39.0,4,12,2,8,2,4,3,3,2,4,6,0,2,0,0,3,13
401085771,Niagara Purple Eagles,J. Towns,4067341,,True,14.0,0,2,0,1,0,1,0,0,0,0,0,1,0,0,0,3,0
401085771,Niagara Purple Eagles,C. Barton,3907182,,True,21.0,3,5,2,3,1,2,0,0,1,1,2,0,0,0,3,4,7
401085771,Niagara Purple Eagles,G. Kuakumensah,4279739,,False,14.0,1,3,1,2,0,1,0,0,2,3,5,0,1,0,1,3,2
401085771,Niagara Purple Eagles,G. King,3906490,,False,24.0,5,7,5,7,0,0,0,1,6,2,8,3,0,1,2,4,10
401085771,Niagara Purple Eagles,M. Hammond,4398404,,False,28.0,3,7,0,1,3,6,2,3,4,4,8,6,0,0,2,1,11
401085771,Niagara Purple Eagles,R. Solomon,4398403,,False,15.0,4,8,1,1,3,7,2,3,0,2,2,0,0,0,1,4,13
401085771,Niagara Purple Eagles,TEAM,TOTAL,TOTAL,False,,27,64,17,36,10,28,9,15,17,20,37,10,4,1,11,23,73
401085771,Niagara Purple Eagles,D. Robb,3907186,,True,16.0,2,4,2,4,0,0,0,0,0,1,1,0,0,0,0,1,4
401085771,Niagara Purple Eagles,M. Prochet,3907184,,True,29.0,5,16,4,9,1,7,2,5,0,3,3,0,1,0,1,0,13
401085771,Niagara Purple Eagles,K. Tate,4279738,,True,39.0,4,12,2,8,2,4,3,3,2,4,6,0,2,0,0,3,13
401085771,Niagara Purple Eagles,J. Towns,4067341,,True,14.0,0,2,0,1,0,1,0,0,0,0,0,1,0,0,0,3,0
401085771,Niagara Purple Eagles,C. Barton,3907182,,True,21.0,3,5,2,3,1,2,0,0,1,1,2,0,0,0,3,4,7
401085771,Niagara Purple Eagles,G. Kuakumensah,4279739,,False,14.0,1,3,1,2,0,1,0,0,2,3,5,0,1,0,1,3,2
401085771,Niagara Purple Eagles,G. King,3906490,,False,24.0,5,7,5,7,0,0,0,1,6,2,8,3,0,1,2,4,10
401085771,Niagara Purple Eagles,M. Hammond,4398404,,False,28.0,3,7,0,1,3,6,2,3,4,4,8,6,0,0,2,1,11
401085771,Niagara Purple Eagles,R. Solomon,4398403,,False,15.0,4,8,1,1,3,7,2,3,0,2,2,0,0,0,1,4,13
401085771,Niagara Purple Eagles,TEAM,TOTAL,TOTAL,False,,27,64,17,36,10,28,9,15,17,20,37,10,4,1,11,23,73
401085770,Quinnipiac Bobcats,J. Rigoni,4279743,,True,31.0,5,7,2,2,3,5,5,5,0,2,2,3,2,0,2,1,18
401085770,Quinnipiac Bobcats,A. Bundu,3947028,,True,28.0,2,3,2,3,0,0,0,0,3,6,9,1,0,0,2,4,4
401085770,Quinnipiac Bobcats,T. Williams,4398399,,True,36.0,3,9,3,8,0,1,1,5,0,3,3,2,0,0,1,3,7
401085770,Quinnipiac Bobcats,R. Kelly,4279741,,True,29.0,1,7,0,2,1,5,2,3,0,1,1,4,0,0,5,4,5
401085770,Quinnipiac Bobcats,C. Young,4070684,,True,38.0,8,14,5,8,3,6,11,13,2,6,8,1,1,1,3,4,30
401085770,Quinnipiac Bobcats,K. Marfo,4066877,,False,12.0,0,2,0,2,0,0,0,0,1,3,4,1,0,0,0,1,0
401085770,Quinnipiac Bobcats,T. Pickron,4398400,,False,11.0,2,5,0,0,2,5,0,0,0,2,2,0,0,0,0,1,6
401085770,Quinnipiac Bobcats,T. Atson,4066478,,False,9.0,0,3,0,0,0,3,0,0,0,0,0,0,0,0,0,1,0
401085770,Quinnipiac Bobcats,Aa. Robinson,3947024,,False,6.0,0,0,0,0,0,0,0,0,0,1,1,0,0,0,0,1,0
401085770,Quinnipiac Bobcats,TEAM,TOTAL,TOTAL,False,,21,50,12,25,9,25,19,26,7,26,33,12,3,1,13,20,70
401085770,Quinnipiac Bobcats,J. Rigoni,4279743,,True,31.0,5,7,2,2,3,5,5,5,0,2,2,3,2,0,2,1,18
401085770,Quinnipiac Bobcats,A. Bundu,3947028,,True,28.0,2,3,2,3,0,0,0,0,3,6,9,1,0,0,2,4,4
401085770,Quinnipiac Bobcats,T. Williams,4398399,,True,36.0,3,9,3,8,0,1,1,5,0,3,3,2,0,0,1,3,7
401085770,Quinnipiac Bobcats,R. Kelly,4279741,,True,29.0,1,7,0,2,1,5,2,3,0,1,1,4,0,0,5,4,5
401085770,Quinnipiac Bobcats,C. Young,4070684,,True,38.0,8,14,5,8,3,6,11,13,2,6,8,1,1,1,3,4,30
401085770,Quinnipiac Bobcats,K. Marfo,4066877,,False,12.0,0,2,0,2,0,0,0,0,1,3,4,1,0,0,0,1,0
401085770,Quinnipiac Bobcats,T. Pickron,4398400,,False,11.0,2,5,0,0,2,5,0,0,0,2,2,0,0,0,0,1,6
401085770,Quinnipiac Bobcats,T. Atson,4066478,,False,9.0,0,3,0,0,0,3,0,0,0,0,0,0,0,0,0,1,0
401085770,Quinnipiac Bobcats,Aa. Robinson,3947024,,False,6.0,0,0,0,0,0,0,0,0,0,1,1,0,0,0,0,1,0
401085770,Quinnipiac Bobcats,TEAM,TOTAL,TOTAL,False,,21,50,12,25,9,25,19,26,7,26,33,12,3,1,13,20,70
401085770,Canisius Golden Griffins,S. Hitchon,4279482,,True,29.0,4,9,3,6,1,3,0,0,2,4,6,0,0,0,3,4,9
401085770,Canisius Golden Griffins,J. White,4279478,,True,24.0,2,5,1,4,1,1,1,1,1,3,4,2,0,1,2,3,6
401085770,Canisius Golden Griffins,T. Molson,4279481,,True,22.0,5,11,4,6,1,5,11,13,2,3,5,1,3,0,2,3,22
401085770,Canisius Golden Griffins,M. Johnson,4067275,,True,40.0,4,12,1,8,3,4,1,2,1,6,7,9,0,0,2,0,12
401085770,Canisius Golden Griffins,J. Sanks,3141259,,True,25.0,2,6,0,1,2,5,1,2,0,2,2,2,0,0,0,2,7
401085770,Canisius Golden Griffins,D. St. Louis,4067280,,False,11.0,1,1,1,1,0,0,0,0,1,0,1,0,0,1,0,4,2
401085770,Canisius Golden Griffins,J. Faulkner,3137250,,False,24.0,1,8,0,4,1,4,0,0,0,4,4,0,2,1,0,1,3
401085770,Canisius Golden Griffins,J. Henderson,4398046,,False,25.0,5,8,3,5,2,3,2,2,2,2,4,3,0,1,0,4,14
401085770,Canisius Golden Griffins,TEAM,TOTAL,TOTAL,False,,24,60,13,35,11,25,16,20,13,27,40,17,5,4,9,21,75
401085770,Canisius Golden Griffins,S. Hitchon,4279482,,True,29.0,4,9,3,6,1,3,0,0,2,4,6,0,0,0,3,4,9
401085770,Canisius Golden Griffins,J. White,4279478,,True,24.0,2,5,1,4,1,1,1,1,1,3,4,2,0,1,2,3,6
401085770,Canisius Golden Griffins,T. Molson,4279481,,True,22.0,5,11,4,6,1,5,11,13,2,3,5,1,3,0,2,3,22
401085770,Canisius Golden Griffins,M. Johnson,4067275,,True,40.0,4,12,1,8,3,4,1,2,1,6,7,9,0,0,2,0,12
401085770,Canisius Golden Griffins,J. Sanks,3141259,,True,25.0,2,6,0,1,2,5,1,2,0,2,2,2,0,0,0,2,7
401085770,Canisius Golden Griffins,D. St. Louis,4067280,,False,11.0,1,1,1,1,0,0,0,0,1,0,1,0,0,1,0,4,2
401085770,Canisius Golden Griffins,J. Faulkner,3137250,,False,24.0,1,8,0,4,1,4,0,0,0,4,4,0,2,1,0,1,3
401085770,Canisius Golden Griffins,J. Henderson,4398046,,False,25.0,5,8,3,5,2,3,2,2,2,2,4,3,0,1,0,4,14
401085770,Canisius Golden Griffins,TEAM,TOTAL,TOTAL,False,,24,60,13,35,11,25,16,20,13,27,40,17,5,4,9,21,75
401085769,Saint Peter's Peacocks,S. Idowu,3922042,,True,19.0,6,10,6,8,0,2,2,2,2,0,2,0,0,1,2,3,14
401085769,Saint Peter's Peacocks,K. Brown,4398385,,True,15.0,1,4,0,3,1,1,0,0,0,0,0,1,0,0,1,1,3
401085769,Saint Peter's Peacocks,M. Dixon,4279758,,True,28.0,1,5,1,4,0,1,0,0,1,1,2,1,0,0,0,3,2
401085769,Saint Peter's Peacocks,Q. Taylor,4067357,,True,33.0,1,5,1,3,0,2,4,4,2,7,9,2,1,0,3,2,6
401085769,Saint Peter's Peacocks,D. Turner,4067356,,True,32.0,7,18,6,13,1,5,0,0,0,1,1,3,0,1,1,2,15
401085769,Saint Peter's Peacocks,KC Ndefo,4398386,,False,25.0,2,2,1,1,1,1,0,2,0,5,5,1,1,0,0,2,5
401085769,Saint Peter's Peacocks,D. Woods,3919424,,False,7.0,1,1,1,1,0,0,0,0,0,2,2,0,0,1,0,4,2
401085769,Saint Peter's Peacocks,M. Majak,4398387,,False,10.0,1,1,1,1,0,0,1,2,1,1,2,0,0,0,1,2,3
401085769,Saint Peter's Peacocks,C. Underwood,4398388,,False,3.0,0,0,0,0,0,0,0,0,0,0,0,1,0,0,0,2,0
401085769,Saint Peter's Peacocks,D. Watson,4398384,,False,24.0,3,7,1,4,2,3,0,0,0,1,1,2,0,0,1,2,8
401085769,Saint Peter's Peacocks,A. Hicks,4284295,,False,4.0,0,1,0,0,0,1,0,0,0,0,0,0,0,0,1,0,0
401085769,Saint Peter's Peacocks,TEAM,TOTAL,TOTAL,False,,23,54,18,38,5,16,7,10,6,18,24,11,2,3,11,23,58
401085769,Saint Peter's Peacocks,S. Idowu,3922042,,True,19.0,6,10,6,8,0,2,2,2,2,0,2,0,0,1,2,3,14
401085769,Saint Peter's Peacocks,K. Brown,4398385,,True,15.0,1,4,0,3,1,1,0,0,0,0,0,1,0,0,1,1,3
401085769,Saint Peter's Peacocks,M. Dixon,4279758,,True,28.0,1,5,1,4,0,1,0,0,1,1,2,1,0,0,0,3,2
401085769,Saint Peter's Peacocks,Q. Taylor,4067357,,True,33.0,1,5,1,3,0,2,4,4,2,7,9,2,1,0,3,2,6
401085769,Saint Peter's Peacocks,D. Turner,4067356,,True,32.0,7,18,6,13,1,5,0,0,0,1,1,3,0,1,1,2,15
401085769,Saint Peter's Peacocks,KC Ndefo,4398386,,False,25.0,2,2,1,1,1,1,0,2,0,5,5,1,1,0,0,2,5
401085769,Saint Peter's Peacocks,D. Woods,3919424,,False,7.0,1,1,1,1,0,0,0,0,0,2,2,0,0,1,0,4,2
401085769,Saint Peter's Peacocks,M. Majak,4398387,,False,10.0,1,1,1,1,0,0,1,2,1,1,2,0,0,0,1,2,3
401085769,Saint Peter's Peacocks,C. Underwood,4398388,,False,3.0,0,0,0,0,0,0,0,0,0,0,0,1,0,0,0,2,0
401085769,Saint Peter's Peacocks,D. Watson,4398384,,False,24.0,3,7,1,4,2,3,0,0,0,1,1,2,0,0,1,2,8
401085769,Saint Peter's Peacocks,A. Hicks,4284295,,False,4.0,0,1,0,0,0,1,0,0,0,0,0,0,0,0,1,0,0
401085769,Saint Peter's Peacocks,TEAM,TOTAL,TOTAL,False,,23,54,18,38,5,16,7,10,6,18,24,11,2,3,11,23,58
401085769,Quinnipiac Bobcats,J. Rigoni,4279743,,True,21.0,4,6,1,1,3,5,5,5,1,0,1,0,0,1,0,0,16
401085769,Quinnipiac Bobcats,A. Bundu,3947028,,True,19.0,3,4,3,4,0,0,1,2,1,2,3,0,0,0,2,4,7
401085769,Quinnipiac Bobcats,T. Williams,4398399,,True,28.0,3,8,2,4,1,4,1,1,0,3,3,1,1,0,1,0,8
401085769,Quinnipiac Bobcats,R. Kelly,4279741,,True,36.0,3,7,2,4,1,3,0,0,0,2,2,6,2,0,2,0,7
401085769,Quinnipiac Bobcats,C. Young,4070684,,True,35.0,7,12,3,4,4,8,10,12,0,3,3,3,2,0,2,2,28
401085769,Quinnipiac Bobcats,K. Marfo,4066877,,False,13.0,2,3,2,3,0,0,5,5,2,3,5,0,0,0,0,2,9
401085769,Quinnipiac Bobcats,J. Higgins,4398402,,False,1.0,0,0,0,0,0,0,0,0,0,0,0,0,0,0,0,0,0
401085769,Quinnipiac Bobcats,K. Atkins,4398401,,False,1.0,0,0,0,0,0,0,0,0,0,0,0,0,0,0,0,0,0
401085769,Quinnipiac Bobcats,T. Pickron,4398400,,False,18.0,0,2,0,0,0,2,0,0,0,3,3,0,1,1,1,0,0
401085769,Quinnipiac Bobcats,T. Atson,4066478,,False,17.0,1,4,1,2,0,2,0,0,1,3,4,1,0,0,2,2,2
401085769,Quinnipiac Bobcats,Aa. Robinson,3947024,,False,11.0,0,0,0,0,0,0,0,0,0,1,1,0,0,0,0,1,0
401085769,Quinnipiac Bobcats,TEAM,TOTAL,TOTAL,False,,23,46,14,22,9,24,22,25,5,20,25,11,6,2,11,11,77
401085769,Quinnipiac Bobcats,J. Rigoni,4279743,,True,21.0,4,6,1,1,3,5,5,5,1,0,1,0,0,1,0,0,16
401085769,Quinnipiac Bobcats,A. Bundu,3947028,,True,19.0,3,4,3,4,0,0,1,2,1,2,3,0,0,0,2,4,7
401085769,Quinnipiac Bobcats,T. Williams,4398399,,True,28.0,3,8,2,4,1,4,1,1,0,3,3,1,1,0,1,0,8
401085769,Quinnipiac Bobcats,R. Kelly,4279741,,True,36.0,3,7,2,4,1,3,0,0,0,2,2,6,2,0,2,0,7
401085769,Quinnipiac Bobcats,C. Young,4070684,,True,35.0,7,12,3,4,4,8,10,12,0,3,3,3,2,0,2,2,28
401085769,Quinnipiac Bobcats,K. Marfo,4066877,,False,13.0,2,3,2,3,0,0,5,5,2,3,5,0,0,0,0,2,9
401085769,Quinnipiac Bobcats,J. Higgins,4398402,,False,1.0,0,0,0,0,0,0,0,0,0,0,0,0,0,0,0,0,0
401085769,Quinnipiac Bobcats,K. Atkins,4398401,,False,1.0,0,0,0,0,0,0,0,0,0,0,0,0,0,0,0,0,0
401085769,Quinnipiac Bobcats,T. Pickron,4398400,,False,18.0,0,2,0,0,0,2,0,0,0,3,3,0,1,1,1,0,0
401085769,Quinnipiac Bobcats,T. Atson,4066478,,False,17.0,1,4,1,2,0,2,0,0,1,3,4,1,0,0,2,2,2
401085769,Quinnipiac Bobcats,Aa. Robinson,3947024,,False,11.0,0,0,0,0,0,0,0,0,0,1,1,0,0,0,0,1,0
401085769,Quinnipiac Bobcats,TEAM,TOTAL,TOTAL,False,,23,46,14,22,9,24,22,25,5,20,25,11,6,2,11,11,77
401085768,Quinnipiac Bobcats,J. Rigoni,4279743,,True,27.0,1,5,0,1,1,4,0,0,1,3,4,1,1,0,0,0,3
401085768,Quinnipiac Bobcats,A. Bundu,3947028,,True,23.0,6,7,6,6,0,1,2,4,3,4,7,0,0,0,2,2,14
401085768,Quinnipiac Bobcats,T. Williams,4398399,,True,30.0,5,9,2,4,3,5,0,0,0,5,5,6,0,0,0,5,13
401085768,Quinnipiac Bobcats,R. Kelly,4279741,,True,36.0,6,10,2,2,4,8,6,6,1,2,3,4,1,0,0,2,22
401085768,Quinnipiac Bobcats,C. Young,4070684,,True,37.0,9,13,3,4,6,9,5,8,0,6,6,3,0,0,4,2,29
401085768,Quinnipiac Bobcats,K. Marfo,4066877,,False,8.0,0,2,0,2,0,0,0,0,0,0,0,0,0,0,1,3,0
401085768,Quinnipiac Bobcats,T. Pickron,4398400,,False,8.0,1,2,0,0,1,2,0,0,0,0,0,0,0,0,0,1,3
401085768,Quinnipiac Bobcats,T. Atson,4066478,,False,18.0,2,6,2,3,0,3,4,5,0,2,2,2,1,0,0,1,8
401085768,Quinnipiac Bobcats,Aa. Robinson,3947024,,False,13.0,0,1,0,1,0,0,0,3,1,0,1,1,0,0,0,1,0
401085768,Quinnipiac Bobcats,TEAM,TOTAL,TOTAL,False,,30,55,15,23,15,32,17,26,7,24,31,17,3,0,8,17,92
401085768,Quinnipiac Bobcats,J. Rigoni,4279743,,True,27.0,1,5,0,1,1,4,0,0,1,3,4,1,1,0,0,0,3
401085768,Quinnipiac Bobcats,A. Bundu,3947028,,True,23.0,6,7,6,6,0,1,2,4,3,4,7,0,0,0,2,2,14
401085768,Quinnipiac Bobcats,T. Williams,4398399,,True,30.0,5,9,2,4,3,5,0,0,0,5,5,6,0,0,0,5,13
401085768,Quinnipiac Bobcats,R. Kelly,4279741,,True,36.0,6,10,2,2,4,8,6,6,1,2,3,4,1,0,0,2,22
401085768,Quinnipiac Bobcats,C. Young,4070684,,True,37.0,9,13,3,4,6,9,5,8,0,6,6,3,0,0,4,2,29
401085768,Quinnipiac Bobcats,K. Marfo,4066877,,False,8.0,0,2,0,2,0,0,0,0,0,0,0,0,0,0,1,3,0
401085768,Quinnipiac Bobcats,T. Pickron,4398400,,False,8.0,1,2,0,0,1,2,0,0,0,0,0,0,0,0,0,1,3
401085768,Quinnipiac Bobcats,T. Atson,4066478,,False,18.0,2,6,2,3,0,3,4,5,0,2,2,2,1,0,0,1,8
401085768,Quinnipiac Bobcats,Aa. Robinson,3947024,,False,13.0,0,1,0,1,0,0,0,3,1,0,1,1,0,0,0,1,0
401085768,Quinnipiac Bobcats,TEAM,TOTAL,TOTAL,False,,30,55,15,23,15,32,17,26,7,24,31,17,3,0,8,17,92
401085768,Marist Red Foxes,I. Lamb,3936028,,True,24.0,3,4,0,0,3,4,0,0,0,3,3,1,0,0,3,2,9
401085768,Marist Red Foxes,T. Sjoberg,4067328,,True,19.0,0,0,0,0,0,0,0,0,1,0,1,3,0,0,1,4,0
401085768,Marist Red Foxes,D. Knudsen,3936027,,True,33.0,7,12,4,5,3,7,0,0,1,3,4,0,2,0,0,4,17
401085768,Marist Red Foxes,D. Hines,4398410,,True,26.0,2,7,1,3,1,4,1,2,0,2,2,1,1,0,0,0,6
401085768,Marist Red Foxes,B. Parker,3936030,,True,28.0,7,13,7,12,0,1,2,4,1,3,4,3,0,0,3,2,16
401085768,Marist Red Foxes,L. Nedrow,4398414,,False,3.0,2,3,1,2,1,1,0,0,0,0,0,0,0,1,0,2,5
401085768,Marist Red Foxes,R. Funk,3936026,,False,23.0,4,9,2,3,2,6,3,4,1,2,3,0,0,0,0,5,13
401085768,Marist Red Foxes,A. Dozic,3923222,,False,13.0,1,2,1,1,0,1,0,0,1,1,2,1,0,0,1,0,2
401085768,Marist Red Foxes,M. Herasme,4398413,,False,17.0,3,4,2,2,1,2,0,0,1,5,6,1,0,0,0,3,7
401085768,Marist Red Foxes,A. Williams,4279709,,False,13.0,1,2,1,2,0,0,1,4,0,1,1,0,0,0,0,2,3
401085768,Marist Red Foxes,R. Carmello,4279708,,False,1.0,0,0,0,0,0,0,0,0,0,0,0,0,0,0,0,0,0
401085768,Marist Red Foxes,TEAM,TOTAL,TOTAL,False,,30,56,19,30,11,26,7,14,6,22,28,10,3,1,8,24,78
401085768,Marist Red Foxes,I. Lamb,3936028,,True,24.0,3,4,0,0,3,4,0,0,0,3,3,1,0,0,3,2,9
401085768,Marist Red Foxes,T. Sjoberg,4067328,,True,19.0,0,0,0,0,0,0,0,0,1,0,1,3,0,0,1,4,0
401085768,Marist Red Foxes,D. Knudsen,3936027,,True,33.0,7,12,4,5,3,7,0,0,1,3,4,0,2,0,0,4,17
401085768,Marist Red Foxes,D. Hines,4398410,,True,26.0,2,7,1,3,1,4,1,2,0,2,2,1,1,0,0,0,6
401085768,Marist Red Foxes,B. Parker,3936030,,True,28.0,7,13,7,12,0,1,2,4,1,3,4,3,0,0,3,2,16
401085768,Marist Red Foxes,L. Nedrow,4398414,,False,3.0,2,3,1,2,1,1,0,0,0,0,0,0,0,1,0,2,5
401085768,Marist Red Foxes,R. Funk,3936026,,False,23.0,4,9,2,3,2,6,3,4,1,2,3,0,0,0,0,5,13
401085768,Marist Red Foxes,A. Dozic,3923222,,False,13.0,1,2,1,1,0,1,0,0,1,1,2,1,0,0,1,0,2
401085768,Marist Red Foxes,M. Herasme,4398413,,False,17.0,3,4,2,2,1,2,0,0,1,5,6,1,0,0,0,3,7
401085768,Marist Red Foxes,A. Williams,4279709,,False,13.0,1,2,1,2,0,0,1,4,0,1,1,0,0,0,0,2,3
401085768,Marist Red Foxes,R. Carmello,4279708,,False,1.0,0,0,0,0,0,0,0,0,0,0,0,0,0,0,0,0,0
401085768,Marist Red Foxes,TEAM,TOTAL,TOTAL,False,,30,56,19,30,11,26,7,14,6,22,28,10,3,1,8,24,78
401085767,Quinnipiac Bobcats,J. Rigoni,4279743,,True,26.0,2,5,1,3,1,2,2,2,1,3,4,1,1,0,1,5,7
401085767,Quinnipiac Bobcats,A. Bundu,3947028,,True,28.0,4,5,4,5,0,0,2,2,5,3,8,1,1,0,1,3,10
401085767,Quinnipiac Bobcats,T. Williams,4398399,,True,34.0,4,10,4,6,0,4,3,3,0,5,5,3,0,0,4,1,11
401085767,Quinnipiac Bobcats,R. Kelly,4279741,,True,33.0,7,11,1,2,6,9,0,0,0,2,2,8,0,0,1,0,20
401085767,Quinnipiac Bobcats,C. Young,4070684,,True,38.0,9,18,6,11,3,7,3,4,3,4,7,3,1,1,1,3,24
401085767,Quinnipiac Bobcats,T. Pickron,4398400,,False,4.0,0,1,0,0,0,1,0,0,0,0,0,0,0,0,0,1,0
401085767,Quinnipiac Bobcats,T. Atson,4066478,,False,14.0,0,6,0,4,0,2,0,0,1,2,3,0,1,0,2,0,0
401085767,Quinnipiac Bobcats,Aa. Robinson,3947024,,False,23.0,0,5,0,0,0,5,0,0,1,3,4,0,0,0,0,4,0
401085767,Quinnipiac Bobcats,TEAM,TOTAL,TOTAL,False,,26,61,16,31,10,30,10,11,12,22,34,16,4,1,10,17,72
401085767,Quinnipiac Bobcats,J. Rigoni,4279743,,True,26.0,2,5,1,3,1,2,2,2,1,3,4,1,1,0,1,5,7
401085767,Quinnipiac Bobcats,A. Bundu,3947028,,True,28.0,4,5,4,5,0,0,2,2,5,3,8,1,1,0,1,3,10
401085767,Quinnipiac Bobcats,T. Williams,4398399,,True,34.0,4,10,4,6,0,4,3,3,0,5,5,3,0,0,4,1,11
401085767,Quinnipiac Bobcats,R. Kelly,4279741,,True,33.0,7,11,1,2,6,9,0,0,0,2,2,8,0,0,1,0,20
401085767,Quinnipiac Bobcats,C. Young,4070684,,True,38.0,9,18,6,11,3,7,3,4,3,4,7,3,1,1,1,3,24
401085767,Quinnipiac Bobcats,T. Pickron,4398400,,False,4.0,0,1,0,0,0,1,0,0,0,0,0,0,0,0,0,1,0
401085767,Quinnipiac Bobcats,T. Atson,4066478,,False,14.0,0,6,0,4,0,2,0,0,1,2,3,0,1,0,2,0,0
401085767,Quinnipiac Bobcats,Aa. Robinson,3947024,,False,23.0,0,5,0,0,0,5,0,0,1,3,4,0,0,0,0,4,0
401085767,Quinnipiac Bobcats,TEAM,TOTAL,TOTAL,False,,26,61,16,31,10,30,10,11,12,22,34,16,4,1,10,17,72
401085767,Niagara Purple Eagles,D. Robb,3907186,,True,24.0,3,6,3,6,0,0,0,2,2,2,4,0,0,2,1,1,6
401085767,Niagara Purple Eagles,M. Prochet,3907184,,True,27.0,9,11,5,6,4,5,2,4,1,2,3,2,1,0,2,2,24
401085767,Niagara Purple Eagles,K. Tate,4279738,,True,22.0,1,4,1,2,0,2,2,2,1,0,1,3,0,0,0,0,4
401085767,Niagara Purple Eagles,J. Towns,4067341,,True,24.0,2,6,0,4,2,2,0,1,0,4,4,1,1,0,1,2,6
401085767,Niagara Purple Eagles,C. Barton,3907182,,True,24.0,5,6,3,3,2,3,2,4,0,3,3,1,0,0,2,4,14
401085767,Niagara Purple Eagles,G. Kuakumensah,4279739,,False,9.0,0,1,0,1,0,0,0,0,0,2,2,0,0,0,1,1,0
401085767,Niagara Purple Eagles,K. Green,4067342,,False,3.0,0,1,0,0,0,1,0,0,0,1,1,0,0,0,0,0,0
401085767,Niagara Purple Eagles,G. King,3906490,,False,16.0,2,2,2,2,0,0,0,0,0,3,3,0,0,0,1,1,4
401085767,Niagara Purple Eagles,M. Hammond,4398404,,False,24.0,1,4,0,2,1,2,2,2,1,1,2,0,2,0,0,2,5
401085767,Niagara Purple Eagles,R. Solomon,4398403,,False,27.0,4,11,2,7,2,4,2,2,1,2,3,1,1,1,1,1,12
401085767,Niagara Purple Eagles,D. Fragala,4279737,,False,0.0,0,0,0,0,0,0,0,0,0,0,0,0,0,0,0,0,0
401085767,Niagara Purple Eagles,TEAM,TOTAL,TOTAL,False,,27,52,16,33,11,19,10,17,7,23,30,8,5,3,9,14,75
401085767,Niagara Purple Eagles,D. Robb,3907186,,True,24.0,3,6,3,6,0,0,0,2,2,2,4,0,0,2,1,1,6
401085767,Niagara Purple Eagles,M. Prochet,3907184,,True,27.0,9,11,5,6,4,5,2,4,1,2,3,2,1,0,2,2,24
401085767,Niagara Purple Eagles,K. Tate,4279738,,True,22.0,1,4,1,2,0,2,2,2,1,0,1,3,0,0,0,0,4
401085767,Niagara Purple Eagles,J. Towns,4067341,,True,24.0,2,6,0,4,2,2,0,1,0,4,4,1,1,0,1,2,6
401085767,Niagara Purple Eagles,C. Barton,3907182,,True,24.0,5,6,3,3,2,3,2,4,0,3,3,1,0,0,2,4,14
401085767,Niagara Purple Eagles,G. Kuakumensah,4279739,,False,9.0,0,1,0,1,0,0,0,0,0,2,2,0,0,0,1,1,0
401085767,Niagara Purple Eagles,K. Green,4067342,,False,3.0,0,1,0,0,0,1,0,0,0,1,1,0,0,0,0,0,0
401085767,Niagara Purple Eagles,G. King,3906490,,False,16.0,2,2,2,2,0,0,0,0,0,3,3,0,0,0,1,1,4
401085767,Niagara Purple Eagles,M. Hammond,4398404,,False,24.0,1,4,0,2,1,2,2,2,1,1,2,0,2,0,0,2,5
401085767,Niagara Purple Eagles,R. Solomon,4398403,,False,27.0,4,11,2,7,2,4,2,2,1,2,3,1,1,1,1,1,12
401085767,Niagara Purple Eagles,D. Fragala,4279737,,False,0.0,0,0,0,0,0,0,0,0,0,0,0,0,0,0,0,0,0
401085767,Niagara Purple Eagles,TEAM,TOTAL,TOTAL,False,,27,52,16,33,11,19,10,17,7,23,30,8,5,3,9,14,75
401085766,Quinnipiac Bobcats,J. Rigoni,4279743,,True,22.0,1,5,1,1,0,4,0,0,1,3,4,2,0,0,1,1,2
401085766,Quinnipiac Bobcats,A. Bundu,3947028,,True,28.0,1,2,1,2,0,0,1,1,8,5,13,0,0,3,1,2,3
401085766,Quinnipiac Bobcats,T. Williams,4398399,,True,30.0,4,13,3,9,1,4,0,0,1,3,4,3,2,0,3,1,9
401085766,Quinnipiac Bobcats,R. Kelly,4279741,,True,35.0,3,10,0,2,3,8,8,8,0,1,1,4,0,0,2,0,17
401085766,Quinnipiac Bobcats,C. Young,4070684,,True,36.0,9,17,7,11,2,6,0,1,1,3,4,0,0,0,2,1,20
401085766,Quinnipiac Bobcats,T. Atson,4066478,,False,22.0,2,7,0,4,2,3,0,0,0,6,6,3,1,0,0,3,6
401085766,Quinnipiac Bobcats,Aa. Robinson,3947024,,False,27.0,2,4,0,2,2,2,0,2,0,1,1,0,1,0,4,2,6
401085766,Quinnipiac Bobcats,TEAM,TOTAL,TOTAL,False,,22,58,12,31,10,27,9,12,17,25,42,12,4,3,15,10,63
401085766,Quinnipiac Bobcats,J. Rigoni,4279743,,True,22.0,1,5,1,1,0,4,0,0,1,3,4,2,0,0,1,1,2
401085766,Quinnipiac Bobcats,A. Bundu,3947028,,True,28.0,1,2,1,2,0,0,1,1,8,5,13,0,0,3,1,2,3
401085766,Quinnipiac Bobcats,T. Williams,4398399,,True,30.0,4,13,3,9,1,4,0,0,1,3,4,3,2,0,3,1,9
401085766,Quinnipiac Bobcats,R. Kelly,4279741,,True,35.0,3,10,0,2,3,8,8,8,0,1,1,4,0,0,2,0,17
401085766,Quinnipiac Bobcats,C. Young,4070684,,True,36.0,9,17,7,11,2,6,0,1,1,3,4,0,0,0,2,1,20
401085766,Quinnipiac Bobcats,T. Atson,4066478,,False,22.0,2,7,0,4,2,3,0,0,0,6,6,3,1,0,0,3,6
401085766,Quinnipiac Bobcats,Aa. Robinson,3947024,,False,27.0,2,4,0,2,2,2,0,2,0,1,1,0,1,0,4,2,6
401085766,Quinnipiac Bobcats,TEAM,TOTAL,TOTAL,False,,22,58,12,31,10,27,9,12,17,25,42,12,4,3,15,10,63
401085766,Canisius Golden Griffins,S. Hitchon,4279482,,True,25.0,6,12,3,7,3,5,0,2,1,1,2,2,0,0,2,4,15
401085766,Canisius Golden Griffins,J. White,4279478,,True,19.0,2,7,2,6,0,1,0,0,2,5,7,2,0,1,0,2,4
401085766,Canisius Golden Griffins,T. Molson,4279481,,True,27.0,8,10,6,7,2,3,0,0,3,0,3,1,2,0,1,2,18
401085766,Canisius Golden Griffins,I. Reese,4067278,,True,34.0,4,11,2,6,2,5,1,1,1,3,4,9,0,4,2,0,11
401085766,Canisius Golden Griffins,M. Johnson,4067275,,True,35.0,1,5,0,1,1,4,1,2,0,3,3,3,2,0,1,3,4
401085766,Canisius Golden Griffins,M. Lotts,4279480,,False,2.0,0,0,0,0,0,0,0,0,0,1,1,0,0,0,0,2,0
401085766,Canisius Golden Griffins,D. St. Louis,4067280,,False,12.0,1,4,1,4,0,0,1,2,2,1,3,0,0,0,0,0,3
401085766,Canisius Golden Griffins,J. Faulkner,3137250,,False,19.0,1,3,0,1,1,2,0,0,1,0,1,1,0,0,2,1,3
401085766,Canisius Golden Griffins,J. Henderson,4398046,,False,7.0,1,2,1,2,0,0,0,0,0,1,1,0,0,0,0,0,2
401085766,Canisius Golden Griffins,J. Sanks,3141259,,False,20.0,2,7,1,3,1,4,0,0,0,2,2,0,0,0,0,1,5
401085766,Canisius Golden Griffins,TEAM,TOTAL,TOTAL,False,,26,61,16,37,10,24,3,7,11,21,32,18,4,5,9,15,65
401085766,Canisius Golden Griffins,S. Hitchon,4279482,,True,25.0,6,12,3,7,3,5,0,2,1,1,2,2,0,0,2,4,15
401085766,Canisius Golden Griffins,J. White,4279478,,True,19.0,2,7,2,6,0,1,0,0,2,5,7,2,0,1,0,2,4
401085766,Canisius Golden Griffins,T. Molson,4279481,,True,27.0,8,10,6,7,2,3,0,0,3,0,3,1,2,0,1,2,18
401085766,Canisius Golden Griffins,I. Reese,4067278,,True,34.0,4,11,2,6,2,5,1,1,1,3,4,9,0,4,2,0,11
401085766,Canisius Golden Griffins,M. Johnson,4067275,,True,35.0,1,5,0,1,1,4,1,2,0,3,3,3,2,0,1,3,4
401085766,Canisius Golden Griffins,M. Lotts,4279480,,False,2.0,0,0,0,0,0,0,0,0,0,1,1,0,0,0,0,2,0
401085766,Canisius Golden Griffins,D. St. Louis,4067280,,False,12.0,1,4,1,4,0,0,1,2,2,1,3,0,0,0,0,0,3
401085766,Canisius Golden Griffins,J. Faulkner,3137250,,False,19.0,1,3,0,1,1,2,0,0,1,0,1,1,0,0,2,1,3
401085766,Canisius Golden Griffins,J. Henderson,4398046,,False,7.0,1,2,1,2,0,0,0,0,0,1,1,0,0,0,0,0,2
401085766,Canisius Golden Griffins,J. Sanks,3141259,,False,20.0,2,7,1,3,1,4,0,0,0,2,2,0,0,0,0,1,5
401085766,Canisius Golden Griffins,TEAM,TOTAL,TOTAL,False,,26,61,16,37,10,24,3,7,11,21,32,18,4,5,9,15,65
401085765,Quinnipiac Bobcats,J. Rigoni,4279743,,True,23.0,2,6,0,1,2,5,1,2,1,7,8,3,0,0,2,1,7
401085765,Quinnipiac Bobcats,A. Bundu,3947028,,True,34.0,4,10,4,10,0,0,4,6,5,4,9,0,2,1,0,3,12
401085765,Quinnipiac Bobcats,T. Williams,4398399,,True,24.0,2,5,1,3,1,2,2,2,0,3,3,1,1,0,2,3,7
401085765,Quinnipiac Bobcats,R. Kelly,4279741,,True,33.0,1,3,0,0,1,3,6,8,0,1,1,7,0,0,4,3,9
401085765,Quinnipiac Bobcats,C. Young,4070684,,True,34.0,6,12,4,8,2,4,6,6,1,5,6,5,2,0,7,3,20
401085765,Quinnipiac Bobcats,T. Pickron,4398400,,False,5.0,1,2,0,0,1,2,0,0,0,0,0,0,1,0,0,0,3
401085765,Quinnipiac Bobcats,T. Atson,4066478,,False,19.0,4,6,2,3,2,3,0,0,2,2,4,1,0,0,1,0,10
401085765,Quinnipiac Bobcats,Aa. Robinson,3947024,,False,28.0,4,5,0,0,4,5,0,0,0,2,2,1,0,0,1,1,12
401085765,Quinnipiac Bobcats,TEAM,TOTAL,TOTAL,False,,24,49,11,25,13,24,19,24,11,26,37,18,6,1,18,14,80
401085765,Quinnipiac Bobcats,J. Rigoni,4279743,,True,23.0,2,6,0,1,2,5,1,2,1,7,8,3,0,0,2,1,7
401085765,Quinnipiac Bobcats,A. Bundu,3947028,,True,34.0,4,10,4,10,0,0,4,6,5,4,9,0,2,1,0,3,12
401085765,Quinnipiac Bobcats,T. Williams,4398399,,True,24.0,2,5,1,3,1,2,2,2,0,3,3,1,1,0,2,3,7
401085765,Quinnipiac Bobcats,R. Kelly,4279741,,True,33.0,1,3,0,0,1,3,6,8,0,1,1,7,0,0,4,3,9
401085765,Quinnipiac Bobcats,C. Young,4070684,,True,34.0,6,12,4,8,2,4,6,6,1,5,6,5,2,0,7,3,20
401085765,Quinnipiac Bobcats,T. Pickron,4398400,,False,5.0,1,2,0,0,1,2,0,0,0,0,0,0,1,0,0,0,3
401085765,Quinnipiac Bobcats,T. Atson,4066478,,False,19.0,4,6,2,3,2,3,0,0,2,2,4,1,0,0,1,0,10
401085765,Quinnipiac Bobcats,Aa. Robinson,3947024,,False,28.0,4,5,0,0,4,5,0,0,0,2,2,1,0,0,1,1,12
401085765,Quinnipiac Bobcats,TEAM,TOTAL,TOTAL,False,,24,49,11,25,13,24,19,24,11,26,37,18,6,1,18,14,80
401085765,Fairfield Stags,J. Kasibabu,3947016,,True,27.0,3,5,3,4,0,1,1,2,4,5,9,1,0,2,2,4,7
401085765,Fairfield Stags,L. Taliaferro,4398078,,True,32.0,4,13,1,5,3,8,0,0,0,2,2,0,1,0,2,1,11
401085765,Fairfield Stags,F. Lemetti,4398076,,True,35.0,5,9,3,4,2,5,2,2,0,1,1,0,1,1,1,4,14
401085765,Fairfield Stags,N. Alvarez,4398075,,True,17.0,3,9,1,3,2,6,0,0,0,0,0,1,1,0,1,2,8
401085765,Fairfield Stags,J. Cruz,4279488,,True,35.0,8,11,6,9,2,2,2,4,4,3,7,4,1,1,2,2,20
401085765,Fairfield Stags,W. Methnani,4279486,,False,4.0,1,2,1,1,0,1,0,0,0,0,0,0,0,0,0,2,2
401085765,Fairfield Stags,M. Milin,3947018,,False,9.0,2,3,2,3,0,0,0,0,0,0,0,0,0,0,0,2,4
401085765,Fairfield Stags,C. Whipple,4398077,,False,13.0,2,4,0,0,2,4,0,0,0,1,1,1,0,0,0,2,6
401085765,Fairfield Stags,A. Kavaliauskas,4080375,,False,28.0,3,8,3,4,0,4,0,0,0,1,1,6,5,0,0,4,6
401085765,Fairfield Stags,TEAM,TOTAL,TOTAL,False,,31,64,20,33,11,31,5,8,9,16,25,13,9,4,8,23,78
401085765,Fairfield Stags,J. Kasibabu,3947016,,True,27.0,3,5,3,4,0,1,1,2,4,5,9,1,0,2,2,4,7
401085765,Fairfield Stags,L. Taliaferro,4398078,,True,32.0,4,13,1,5,3,8,0,0,0,2,2,0,1,0,2,1,11
401085765,Fairfield Stags,F. Lemetti,4398076,,True,35.0,5,9,3,4,2,5,2,2,0,1,1,0,1,1,1,4,14
401085765,Fairfield Stags,N. Alvarez,4398075,,True,17.0,3,9,1,3,2,6,0,0,0,0,0,1,1,0,1,2,8
401085765,Fairfield Stags,J. Cruz,4279488,,True,35.0,8,11,6,9,2,2,2,4,4,3,7,4,1,1,2,2,20
401085765,Fairfield Stags,W. Methnani,4279486,,False,4.0,1,2,1,1,0,1,0,0,0,0,0,0,0,0,0,2,2
401085765,Fairfield Stags,M. Milin,3947018,,False,9.0,2,3,2,3,0,0,0,0,0,0,0,0,0,0,0,2,4
401085765,Fairfield Stags,C. Whipple,4398077,,False,13.0,2,4,0,0,2,4,0,0,0,1,1,1,0,0,0,2,6
401085765,Fairfield Stags,A. Kavaliauskas,4080375,,False,28.0,3,8,3,4,0,4,0,0,0,1,1,6,5,0,0,4,6
401085765,Fairfield Stags,TEAM,TOTAL,TOTAL,False,,31,64,20,33,11,31,5,8,9,16,25,13,9,4,8,23,78
401085764,Quinnipiac Bobcats,J. Rigoni,4279743,,True,42.0,4,11,1,1,3,10,1,2,0,4,4,3,2,0,4,3,12
401085764,Quinnipiac Bobcats,A. Bundu,3947028,,True,35.0,3,3,3,3,0,0,1,6,6,6,12,2,1,3,1,4,7
401085764,Quinnipiac Bobcats,T. Williams,4398399,,True,28.0,4,4,0,0,4,4,0,0,1,1,2,2,3,0,5,5,12
401085764,Quinnipiac Bobcats,R. Kelly,4279741,,True,46.0,7,14,4,8,3,6,8,9,3,1,4,4,1,0,3,2,25
401085764,Quinnipiac Bobcats,C. Young,4070684,,True,46.0,8,18,4,8,4,10,13,16,1,5,6,2,2,0,4,2,33
401085764,Quinnipiac Bobcats,T. Pickron,4398400,,False,10.0,0,4,0,2,0,2,0,0,0,5,5,1,0,0,1,2,0
401085764,Quinnipiac Bobcats,T. Atson,4066478,,False,16.0,0,4,0,1,0,3,0,0,0,3,3,0,1,0,1,2,0
401085764,Quinnipiac Bobcats,Aa. Robinson,3947024,,False,27.0,0,1,0,0,0,1,0,2,0,3,3,0,0,0,2,2,0
401085764,Quinnipiac Bobcats,TEAM,TOTAL,TOTAL,False,,26,59,12,23,14,36,23,35,13,30,43,14,10,3,22,22,89
401085764,Quinnipiac Bobcats,J. Rigoni,4279743,,True,42.0,4,11,1,1,3,10,1,2,0,4,4,3,2,0,4,3,12
401085764,Quinnipiac Bobcats,A. Bundu,3947028,,True,35.0,3,3,3,3,0,0,1,6,6,6,12,2,1,3,1,4,7
401085764,Quinnipiac Bobcats,T. Williams,4398399,,True,28.0,4,4,0,0,4,4,0,0,1,1,2,2,3,0,5,5,12
401085764,Quinnipiac Bobcats,R. Kelly,4279741,,True,46.0,7,14,4,8,3,6,8,9,3,1,4,4,1,0,3,2,25
401085764,Quinnipiac Bobcats,C. Young,4070684,,True,46.0,8,18,4,8,4,10,13,16,1,5,6,2,2,0,4,2,33
401085764,Quinnipiac Bobcats,T. Pickron,4398400,,False,10.0,0,4,0,2,0,2,0,0,0,5,5,1,0,0,1,2,0
401085764,Quinnipiac Bobcats,T. Atson,4066478,,False,16.0,0,4,0,1,0,3,0,0,0,3,3,0,1,0,1,2,0
401085764,Quinnipiac Bobcats,Aa. Robinson,3947024,,False,27.0,0,1,0,0,0,1,0,2,0,3,3,0,0,0,2,2,0
401085764,Quinnipiac Bobcats,TEAM,TOTAL,TOTAL,False,,26,59,12,23,14,36,23,35,13,30,43,14,10,3,22,22,89
401085764,Monmouth Hawks,M. Traore,3975762,,True,18.0,1,1,1,1,0,0,0,0,1,1,2,0,1,0,1,1,2
401085764,Monmouth Hawks,D. Quinn,3948714,,True,26.0,4,9,4,9,0,0,2,4,4,2,6,0,1,0,1,4,10
401085764,Monmouth Hawks,M. McClary,4279736,,True,27.0,2,6,2,5,0,1,1,2,4,1,5,2,1,0,0,1,5
401085764,Monmouth Hawks,D. Hammond,4279734,,True,42.0,10,22,6,8,4,14,3,4,1,1,2,0,0,1,2,1,27
401085764,Monmouth Hawks,R. Salnave,4067329,,True,38.0,8,20,8,16,0,4,5,8,0,7,7,4,1,1,3,5,21
401085764,Monmouth Hawks,N. Rutty,4398408,,False,6.0,1,1,1,1,0,0,0,0,0,0,0,0,0,0,0,1,2
401085764,Monmouth Hawks,S. Ibiezugbe,4067330,,False,8.0,1,1,1,1,0,0,0,0,2,4,6,0,0,0,0,1,2
401085764,Monmouth Hawks,M. Martin,4279733,,False,20.0,0,1,0,0,0,1,0,0,0,2,2,3,1,0,1,5,0
401085764,Monmouth Hawks,S. Chaput,4398409,,False,22.0,2,8,2,4,0,4,0,0,0,0,0,2,2,0,0,3,4
401085764,Monmouth Hawks,G. Papas,4279735,,False,8.0,0,1,0,0,0,1,0,0,0,1,1,0,0,0,0,1,0
401085764,Monmouth Hawks,T. Gross Jr.,4065729,,False,0.0,0,0,0,0,0,0,0,0,0,0,0,0,0,0,0,0,0
401085764,Monmouth Hawks,N. Rutherford,3946977,,False,35.0,5,7,5,7,0,0,0,1,0,6,6,1,2,1,4,4,10
401085764,Monmouth Hawks,TEAM,TOTAL,TOTAL,False,,34,77,30,52,4,25,11,19,17,26,43,12,9,3,14,27,83
401085764,Monmouth Hawks,M. Traore,3975762,,True,18.0,1,1,1,1,0,0,0,0,1,1,2,0,1,0,1,1,2
401085764,Monmouth Hawks,D. Quinn,3948714,,True,26.0,4,9,4,9,0,0,2,4,4,2,6,0,1,0,1,4,10
401085764,Monmouth Hawks,M. McClary,4279736,,True,27.0,2,6,2,5,0,1,1,2,4,1,5,2,1,0,0,1,5
401085764,Monmouth Hawks,D. Hammond,4279734,,True,42.0,10,22,6,8,4,14,3,4,1,1,2,0,0,1,2,1,27
401085764,Monmouth Hawks,R. Salnave,4067329,,True,38.0,8,20,8,16,0,4,5,8,0,7,7,4,1,1,3,5,21
401085764,Monmouth Hawks,N. Rutty,4398408,,False,6.0,1,1,1,1,0,0,0,0,0,0,0,0,0,0,0,1,2
401085764,Monmouth Hawks,S. Ibiezugbe,4067330,,False,8.0,1,1,1,1,0,0,0,0,2,4,6,0,0,0,0,1,2
401085764,Monmouth Hawks,M. Martin,4279733,,False,20.0,0,1,0,0,0,1,0,0,0,2,2,3,1,0,1,5,0
401085764,Monmouth Hawks,S. Chaput,4398409,,False,22.0,2,8,2,4,0,4,0,0,0,0,0,2,2,0,0,3,4
401085764,Monmouth Hawks,G. Papas,4279735,,False,8.0,0,1,0,0,0,1,0,0,0,1,1,0,0,0,0,1,0
401085764,Monmouth Hawks,T. Gross Jr.,4065729,,False,0.0,0,0,0,0,0,0,0,0,0,0,0,0,0,0,0,0,0
401085764,Monmouth Hawks,N. Rutherford,3946977,,False,35.0,5,7,5,7,0,0,0,1,0,6,6,1,2,1,4,4,10
401085764,Monmouth Hawks,TEAM,TOTAL,TOTAL,False,,34,77,30,52,4,25,11,19,17,26,43,12,9,3,14,27,83
401085763,Rider Broncs,F. Scott,3922033,,True,28.0,6,8,5,6,1,2,0,0,2,8,10,3,0,0,1,2,13
401085763,Rider Broncs,T. Marshall,4067348,,True,16.0,3,3,3,3,0,0,2,2,1,3,4,1,0,0,1,4,8
401085763,Rider Broncs,S. Jordan,4067349,,True,34.0,3,8,3,6,0,2,4,4,1,5,6,1,2,2,6,2,10
401085763,Rider Broncs,K. Williams,3946983,,True,29.0,3,9,3,8,0,1,4,6,1,6,7,2,5,0,3,2,10
401085763,Rider Broncs,A. Durham,3138490,,True,27.0,4,10,3,7,1,3,2,2,1,1,2,1,2,0,2,1,11
401085763,Rider Broncs,A. Ogemuno-Johnson,4406151,,False,15.0,3,5,3,5,0,0,1,2,1,1,2,0,0,1,0,1,7
401085763,Rider Broncs,D. Eke,3941312,,False,13.0,1,2,1,2,0,0,2,5,1,0,1,1,0,1,1,4,4
401085763,Rider Broncs,J. Allen,4067345,,False,28.0,1,8,0,3,1,5,1,2,1,3,4,0,0,0,1,1,4
401085763,Rider Broncs,A. Gilbert,3911886,,False,10.0,2,8,1,3,1,5,0,0,0,1,1,2,1,0,0,1,5
401085763,Rider Broncs,TEAM,TOTAL,TOTAL,False,,26,61,22,43,4,18,16,23,13,29,42,11,10,4,15,18,72
401085763,Rider Broncs,F. Scott,3922033,,True,28.0,6,8,5,6,1,2,0,0,2,8,10,3,0,0,1,2,13
401085763,Rider Broncs,T. Marshall,4067348,,True,16.0,3,3,3,3,0,0,2,2,1,3,4,1,0,0,1,4,8
401085763,Rider Broncs,S. Jordan,4067349,,True,34.0,3,8,3,6,0,2,4,4,1,5,6,1,2,2,6,2,10
401085763,Rider Broncs,K. Williams,3946983,,True,29.0,3,9,3,8,0,1,4,6,1,6,7,2,5,0,3,2,10
401085763,Rider Broncs,A. Durham,3138490,,True,27.0,4,10,3,7,1,3,2,2,1,1,2,1,2,0,2,1,11
401085763,Rider Broncs,A. Ogemuno-Johnson,4406151,,False,15.0,3,5,3,5,0,0,1,2,1,1,2,0,0,1,0,1,7
401085763,Rider Broncs,D. Eke,3941312,,False,13.0,1,2,1,2,0,0,2,5,1,0,1,1,0,1,1,4,4
401085763,Rider Broncs,J. Allen,4067345,,False,28.0,1,8,0,3,1,5,1,2,1,3,4,0,0,0,1,1,4
401085763,Rider Broncs,A. Gilbert,3911886,,False,10.0,2,8,1,3,1,5,0,0,0,1,1,2,1,0,0,1,5
401085763,Rider Broncs,TEAM,TOTAL,TOTAL,False,,26,61,22,43,4,18,16,23,13,29,42,11,10,4,15,18,72
401085763,Quinnipiac Bobcats,J. Rigoni,4279743,,True,32.0,4,13,1,2,3,11,3,4,0,3,3,1,1,2,0,2,14
401085763,Quinnipiac Bobcats,A. Bundu,3947028,,True,22.0,2,3,2,3,0,0,0,0,2,2,4,1,0,3,1,4,4
401085763,Quinnipiac Bobcats,T. Williams,4398399,,True,17.0,2,5,1,3,1,2,0,0,0,3,3,0,0,0,1,4,5
401085763,Quinnipiac Bobcats,R. Kelly,4279741,,True,34.0,3,8,1,2,2,6,4,5,0,3,3,5,2,0,6,1,12
401085763,Quinnipiac Bobcats,C. Young,4070684,,True,39.0,8,14,3,5,5,9,3,4,1,8,9,1,2,1,4,3,24
401085763,Quinnipiac Bobcats,T. Pickron,4398400,,False,4.0,0,0,0,0,0,0,1,2,0,1,1,0,0,0,1,1,1
401085763,Quinnipiac Bobcats,T. Atson,4066478,,False,24.0,2,10,2,9,0,1,0,1,2,3,5,1,1,0,4,1,4
401085763,Quinnipiac Bobcats,A. Robinson,3947024,,False,28.0,1,4,0,0,1,4,0,0,1,1,2,2,1,0,1,4,3
401085763,Quinnipiac Bobcats,TEAM,TOTAL,TOTAL,False,,22,57,10,24,12,33,11,16,8,25,33,11,7,6,19,20,67
401085763,Quinnipiac Bobcats,J. Rigoni,4279743,,True,32.0,4,13,1,2,3,11,3,4,0,3,3,1,1,2,0,2,14
401085763,Quinnipiac Bobcats,A. Bundu,3947028,,True,22.0,2,3,2,3,0,0,0,0,2,2,4,1,0,3,1,4,4
401085763,Quinnipiac Bobcats,T. Williams,4398399,,True,17.0,2,5,1,3,1,2,0,0,0,3,3,0,0,0,1,4,5
401085763,Quinnipiac Bobcats,R. Kelly,4279741,,True,34.0,3,8,1,2,2,6,4,5,0,3,3,5,2,0,6,1,12
401085763,Quinnipiac Bobcats,C. Young,4070684,,True,39.0,8,14,3,5,5,9,3,4,1,8,9,1,2,1,4,3,24
401085763,Quinnipiac Bobcats,T. Pickron,4398400,,False,4.0,0,0,0,0,0,0,1,2,0,1,1,0,0,0,1,1,1
401085763,Quinnipiac Bobcats,T. Atson,4066478,,False,24.0,2,10,2,9,0,1,0,1,2,3,5,1,1,0,4,1,4
401085763,Quinnipiac Bobcats,A. Robinson,3947024,,False,28.0,1,4,0,0,1,4,0,0,1,1,2,2,1,0,1,4,3
401085763,Quinnipiac Bobcats,TEAM,TOTAL,TOTAL,False,,22,57,10,24,12,33,11,16,8,25,33,11,7,6,19,20,67
401085762,Quinnipiac Bobcats,J. Rigoni,4279743,,True,33.0,4,7,1,1,3,6,0,0,0,3,3,2,1,1,0,1,11
401085762,Quinnipiac Bobcats,A. Bundu,3947028,,True,14.0,1,2,1,2,0,0,0,1,1,2,3,0,0,0,1,2,2
401085762,Quinnipiac Bobcats,T. Williams,4398399,,True,33.0,2,6,0,2,2,4,1,2,2,2,4,3,2,0,3,3,7
401085762,Quinnipiac Bobcats,R. Kelly,4279741,,True,37.0,4,6,3,3,1,3,1,3,0,5,5,4,2,0,3,1,10
401085762,Quinnipiac Bobcats,C. Young,4070684,,True,37.0,4,10,1,2,3,8,4,4,0,3,3,1,1,0,4,2,15
401085762,Quinnipiac Bobcats,T. Pickron,4398400,,False,4.0,0,4,0,1,0,3,0,0,0,0,0,0,0,0,0,0,0
401085762,Quinnipiac Bobcats,T. Atson,4066478,,False,25.0,3,7,1,4,2,3,5,6,2,1,3,3,3,1,3,4,13
401085762,Quinnipiac Bobcats,A. Robinson,3947024,,False,17.0,2,4,1,2,1,2,0,0,0,2,2,1,0,0,0,0,5
401085762,Quinnipiac Bobcats,TEAM,TOTAL,TOTAL,False,,20,46,8,17,12,29,11,16,7,19,26,14,9,2,14,13,63
401085762,Quinnipiac Bobcats,J. Rigoni,4279743,,True,33.0,4,7,1,1,3,6,0,0,0,3,3,2,1,1,0,1,11
401085762,Quinnipiac Bobcats,A. Bundu,3947028,,True,14.0,1,2,1,2,0,0,0,1,1,2,3,0,0,0,1,2,2
401085762,Quinnipiac Bobcats,T. Williams,4398399,,True,33.0,2,6,0,2,2,4,1,2,2,2,4,3,2,0,3,3,7
401085762,Quinnipiac Bobcats,R. Kelly,4279741,,True,37.0,4,6,3,3,1,3,1,3,0,5,5,4,2,0,3,1,10
401085762,Quinnipiac Bobcats,C. Young,4070684,,True,37.0,4,10,1,2,3,8,4,4,0,3,3,1,1,0,4,2,15
401085762,Quinnipiac Bobcats,T. Pickron,4398400,,False,4.0,0,4,0,1,0,3,0,0,0,0,0,0,0,0,0,0,0
401085762,Quinnipiac Bobcats,T. Atson,4066478,,False,25.0,3,7,1,4,2,3,5,6,2,1,3,3,3,1,3,4,13
401085762,Quinnipiac Bobcats,A. Robinson,3947024,,False,17.0,2,4,1,2,1,2,0,0,0,2,2,1,0,0,0,0,5
401085762,Quinnipiac Bobcats,TEAM,TOTAL,TOTAL,False,,20,46,8,17,12,29,11,16,7,19,26,14,9,2,14,13,63
401085762,Manhattan Jaspers,T. Reynolds,4398107,,True,10.0,2,5,1,1,1,4,0,0,0,0,0,0,0,0,2,2,5
401085762,Manhattan Jaspers,P. Paulicap,4279706,,True,11.0,1,5,1,5,0,0,1,1,1,4,5,0,1,0,0,4,3
401085762,Manhattan Jaspers,W. Williams,4279701,,True,14.0,2,4,2,4,0,0,1,2,1,2,3,0,0,1,2,3,5
401085762,Manhattan Jaspers,N. Mack,4279703,,True,33.0,3,8,2,5,1,3,0,0,0,0,0,5,1,0,0,1,7
401085762,Manhattan Jaspers,T. Capuano,3948706,,True,35.0,5,8,3,3,2,5,1,1,1,0,1,0,2,0,4,3,13
401085762,Manhattan Jaspers,E. Ebube,4279705,,False,26.0,2,7,1,5,1,2,0,0,5,4,9,1,1,0,1,3,5
401085762,Manhattan Jaspers,I. Diallo,3149898,,False,11.0,1,1,1,1,0,0,0,0,1,2,3,0,1,0,2,0,2
401085762,Manhattan Jaspers,T. Greene,4398108,,False,30.0,5,10,4,7,1,3,2,3,1,6,7,0,0,0,2,0,13
401085762,Manhattan Jaspers,C. Hinckson,4398106,,False,15.0,2,2,2,2,0,0,0,0,0,1,1,1,0,1,1,1,4
401085762,Manhattan Jaspers,S. Stewart,4398104,,False,9.0,0,3,0,3,0,0,0,0,0,1,1,3,0,0,1,0,0
401085762,Manhattan Jaspers,E. Buchanan,4398103,,False,3.0,1,1,1,1,0,0,0,0,0,0,0,0,0,0,1,0,2
401085762,Manhattan Jaspers,S. Usilo,3138468,,False,3.0,0,0,0,0,0,0,0,0,0,0,0,0,1,0,0,0,0
401085762,Manhattan Jaspers,TEAM,TOTAL,TOTAL,False,,24,54,18,37,6,17,5,7,12,23,35,10,7,2,17,17,59
401085762,Manhattan Jaspers,T. Reynolds,4398107,,True,10.0,2,5,1,1,1,4,0,0,0,0,0,0,0,0,2,2,5
401085762,Manhattan Jaspers,P. Paulicap,4279706,,True,11.0,1,5,1,5,0,0,1,1,1,4,5,0,1,0,0,4,3
401085762,Manhattan Jaspers,W. Williams,4279701,,True,14.0,2,4,2,4,0,0,1,2,1,2,3,0,0,1,2,3,5
401085762,Manhattan Jaspers,N. Mack,4279703,,True,33.0,3,8,2,5,1,3,0,0,0,0,0,5,1,0,0,1,7
401085762,Manhattan Jaspers,T. Capuano,3948706,,True,35.0,5,8,3,3,2,5,1,1,1,0,1,0,2,0,4,3,13
401085762,Manhattan Jaspers,E. Ebube,4279705,,False,26.0,2,7,1,5,1,2,0,0,5,4,9,1,1,0,1,3,5
401085762,Manhattan Jaspers,I. Diallo,3149898,,False,11.0,1,1,1,1,0,0,0,0,1,2,3,0,1,0,2,0,2
401085762,Manhattan Jaspers,T. Greene,4398108,,False,30.0,5,10,4,7,1,3,2,3,1,6,7,0,0,0,2,0,13
401085762,Manhattan Jaspers,C. Hinckson,4398106,,False,15.0,2,2,2,2,0,0,0,0,0,1,1,1,0,1,1,1,4
401085762,Manhattan Jaspers,S. Stewart,4398104,,False,9.0,0,3,0,3,0,0,0,0,0,1,1,3,0,0,1,0,0
401085762,Manhattan Jaspers,E. Buchanan,4398103,,False,3.0,1,1,1,1,0,0,0,0,0,0,0,0,0,0,1,0,2
401085762,Manhattan Jaspers,S. Usilo,3138468,,False,3.0,0,0,0,0,0,0,0,0,0,0,0,0,1,0,0,0,0
401085762,Manhattan Jaspers,TEAM,TOTAL,TOTAL,False,,24,54,18,37,6,17,5,7,12,23,35,10,7,2,17,17,59
401085761,Stony Brook Seawolves,J. Otchere,4396585,,True,28.0,3,3,3,3,0,0,0,0,4,3,7,0,0,2,1,5,6
401085761,Stony Brook Seawolves,A. Yeboah,3913169,,True,3.0,0,2,0,0,0,2,0,0,0,1,1,0,0,0,0,0,0
401085761,Stony Brook Seawolves,M. Latimer,4396584,,True,28.0,1,6,1,4,0,2,8,9,0,3,3,2,0,0,0,2,10
401085761,Stony Brook Seawolves,E. Olaniyi,4278240,,True,20.0,3,6,2,3,1,3,2,2,2,1,3,0,0,0,4,3,9
401085761,Stony Brook Seawolves,J. Cornish,4278239,,True,32.0,4,12,3,10,1,2,6,8,1,5,6,4,3,0,1,3,15
401085761,Stony Brook Seawolves,A. Ochefu,4278243,,False,12.0,2,3,2,3,0,0,0,1,1,0,1,0,1,0,1,3,4
401085761,Stony Brook Seawolves,A. Christie,4396587,,False,0.0,0,0,0,0,0,0,0,0,0,0,0,0,0,0,0,0,0
401085761,Stony Brook Seawolves,J. Moor,4396583,,False,7.0,1,2,1,2,0,0,0,0,1,0,1,0,0,0,0,2,2
401085761,Stony Brook Seawolves,J. McKenzie,4278242,,False,19.0,2,5,2,3,0,2,0,0,0,3,3,3,1,0,1,1,4
401085761,Stony Brook Seawolves,C. Long,4278241,,False,14.0,3,6,2,5,1,1,0,1,4,2,6,0,1,0,2,0,7
401085761,Stony Brook Seawolves,A. Garcia,4066768,,False,37.0,7,15,5,11,2,4,3,7,1,5,6,0,0,0,3,2,19
401085761,Stony Brook Seawolves,TEAM,TOTAL,TOTAL,False,,26,60,21,44,5,16,19,28,16,24,40,9,6,2,13,21,76
401085761,Quinnipiac Bobcats,J. Rigoni,4279743,,True,25.0,4,7,0,3,4,4,4,4,1,4,5,0,0,0,2,3,16
401085761,Quinnipiac Bobcats,K. Marfo,4066877,,True,23.0,3,9,3,9,0,0,4,8,8,5,13,0,1,0,1,3,10
401085761,Quinnipiac Bobcats,T. Williams,4398399,,True,21.0,0,6,0,3,0,3,1,2,0,0,0,1,1,0,1,5,1
401085761,Quinnipiac Bobcats,R. Kelly,4279741,,True,33.0,2,5,0,3,2,2,3,4,1,1,2,3,0,0,5,3,9
401085761,Quinnipiac Bobcats,A. Robinson,3947024,,True,29.0,0,6,0,1,0,5,0,1,1,2,3,2,0,0,1,4,0
401085761,Quinnipiac Bobcats,A. Bundu,3947028,,False,17.0,2,2,2,2,0,0,2,2,1,1,2,0,0,1,0,0,6
401085761,Quinnipiac Bobcats,T. Pickron,4398400,,False,14.0,4,4,2,2,2,2,0,0,0,1,1,3,1,0,1,2,10
401085761,Quinnipiac Bobcats,C. Young,4070684,,False,30.0,8,18,4,6,4,12,1,2,0,5,5,3,1,1,2,1,21
401085761,Quinnipiac Bobcats,T. Atson,4066478,,False,8.0,0,2,0,1,0,1,0,0,1,3,4,0,1,0,1,2,0
401085761,Quinnipiac Bobcats,TEAM,TOTAL,TOTAL,False,,23,59,11,30,12,29,15,23,15,23,38,12,5,2,14,23,73
401085760,Quinnipiac Bobcats,J. Rigoni,4279743,,True,20.0,4,6,0,0,4,6,0,0,1,1,2,0,0,0,0,0,12
401085760,Quinnipiac Bobcats,K. Marfo,4066877,,True,26.0,5,9,5,9,0,0,5,8,6,7,13,5,0,1,1,4,15
401085760,Quinnipiac Bobcats,T. Williams,4398399,,True,30.0,4,9,4,5,0,4,2,2,2,4,6,6,1,0,2,1,10
401085760,Quinnipiac Bobcats,R. Kelly,4279741,,True,28.0,5,10,3,5,2,5,0,0,3,1,4,4,2,0,1,1,12
401085760,Quinnipiac Bobcats,C. Young,4070684,,True,30.0,5,10,2,5,3,5,5,6,1,4,5,1,3,0,1,0,18
401085760,Quinnipiac Bobcats,A. Bundu,3947028,,False,14.0,1,5,1,5,0,0,1,2,1,0,1,0,2,0,0,3,3
401085760,Quinnipiac Bobcats,J. Higgins,4398402,,False,1.0,0,0,0,0,0,0,0,0,0,0,0,0,0,0,0,0,0
401085760,Quinnipiac Bobcats,K. Atkins,4398401,,False,1.0,0,0,0,0,0,0,0,0,0,0,0,0,0,0,0,0,0
401085760,Quinnipiac Bobcats,T. Pickron,4398400,,False,11.0,0,3,0,1,0,2,0,0,0,0,0,1,0,0,0,0,0
401085760,Quinnipiac Bobcats,T. Atson,4066478,,False,19.0,4,6,2,2,2,4,3,4,0,5,5,2,0,0,0,1,13
401085760,Quinnipiac Bobcats,A. Robinson,3947024,,False,20.0,2,6,2,2,0,4,0,0,0,2,2,1,0,0,3,0,4
401085760,Quinnipiac Bobcats,TEAM,TOTAL,TOTAL,False,,30,64,19,34,11,30,16,22,15,25,40,20,8,1,8,10,87
401085760,Bethune-Cookman Wildcats,C. Pope,4398098,,True,32.0,5,8,5,8,0,0,0,2,4,8,12,1,1,2,3,4,10
401085760,Bethune-Cookman Wildcats,W. Parks,4398096,,True,12.0,1,2,1,2,0,0,0,2,0,0,0,0,0,0,1,1,2
401085760,Bethune-Cookman Wildcats,H. Smith,4067873,,True,23.0,3,9,3,7,0,2,0,0,1,3,4,1,0,0,1,1,6
401085760,Bethune-Cookman Wildcats,D. Duffus,4067196,,True,32.0,3,9,1,4,2,5,0,0,0,2,2,4,0,0,2,2,8
401085760,Bethune-Cookman Wildcats,M. Maitland,3914072,,True,31.0,3,10,1,4,2,6,0,0,0,2,2,4,2,0,1,2,8
401085760,Bethune-Cookman Wildcats,D. Francis,4279764,,False,7.0,0,0,0,0,0,0,0,0,0,0,0,2,0,0,1,1,0
401085760,Bethune-Cookman Wildcats,S. Davis,4279762,,False,26.0,5,11,5,9,0,2,0,2,3,3,6,3,1,0,1,2,10
401085760,Bethune-Cookman Wildcats,M. Gordon,4398099,,False,29.0,8,12,5,7,3,5,0,0,0,5,5,0,0,0,4,2,19
401085760,Bethune-Cookman Wildcats,A. Collins,3906565,,False,8.0,0,1,0,0,0,1,0,0,1,1,2,0,0,0,0,1,0
401085760,Bethune-Cookman Wildcats,TEAM,TOTAL,TOTAL,False,,28,62,21,41,7,21,0,6,12,24,36,15,4,2,14,16,63
401085759,Quinnipiac Bobcats,J. Rigoni,4279743,,True,14.0,0,2,0,0,0,2,0,0,0,0,0,1,0,0,2,3,0
401085759,Quinnipiac Bobcats,K. Marfo,4066877,,True,25.0,2,2,2,2,0,0,6,10,2,6,8,0,0,1,2,3,10
401085759,Quinnipiac Bobcats,T. Williams,4398399,,True,32.0,5,8,1,2,4,6,2,2,2,2,4,7,2,0,2,4,16
401085759,Quinnipiac Bobcats,R. Kelly,4279741,,True,29.0,3,6,2,3,1,3,4,5,2,1,3,2,2,0,1,2,11
401085759,Quinnipiac Bobcats,C. Young,4070684,,True,30.0,9,17,5,9,4,8,6,7,0,4,4,0,3,0,0,0,28
401085759,Quinnipiac Bobcats,A. Bundu,3947028,,False,15.0,0,0,0,0,0,0,0,0,1,1,2,0,0,0,0,1,0
401085759,Quinnipiac Bobcats,T. Pickron,4398400,,False,10.0,1,2,1,1,0,1,1,2,1,0,1,0,0,0,1,0,3
401085759,Quinnipiac Bobcats,T. Atson,4066478,,False,24.0,3,8,1,2,2,6,2,4,1,2,3,2,2,0,0,2,10
401085759,Quinnipiac Bobcats,A. Robinson,3947024,,False,21.0,4,5,2,2,2,3,0,0,0,1,1,1,0,0,1,3,10
401085759,Quinnipiac Bobcats,TEAM,TOTAL,TOTAL,False,,27,50,14,21,13,29,21,30,9,17,26,13,9,1,11,18,88
401085759,Lafayette Leopards,M. Cherry,4067119,,True,25.0,3,8,3,6,0,2,3,7,2,1,3,1,1,0,2,1,9
401085759,Lafayette Leopards,L. Jarrett,4067117,,True,15.0,1,2,1,1,0,1,0,0,0,1,1,0,0,1,1,3,2
401085759,Lafayette Leopards,I. Suffren,4398072,,True,25.0,3,6,3,6,0,0,1,2,2,3,5,1,0,0,3,3,7
401085759,Lafayette Leopards,J. Jaworski,4280075,,True,32.0,7,11,3,5,4,6,1,1,0,3,3,2,2,0,4,3,19
401085759,Lafayette Leopards,E.J. Stephens,4280074,,True,22.0,4,9,3,6,1,3,2,2,2,1,3,1,0,0,0,2,11
401085759,Lafayette Leopards,S. Good,4398073,,False,4.0,0,0,0,0,0,0,0,0,0,0,0,1,0,0,0,2,0
401085759,Lafayette Leopards,D. Hastings,4280077,,False,14.0,0,0,0,0,0,0,0,0,2,1,3,2,0,0,1,1,0
401085759,Lafayette Leopards,P. Zalys,3907433,,False,20.0,3,8,3,8,0,0,1,5,2,3,5,2,0,0,1,3,7
401085759,Lafayette Leopards,J. Vaughan,4398071,,False,1.0,0,0,0,0,0,0,0,0,0,0,0,0,0,0,0,0,0
401085759,Lafayette Leopards,T. Perry,4398070,,False,7.0,0,0,0,0,0,0,0,0,0,0,0,0,0,0,0,0,0
401085759,Lafayette Leopards,A. Petrie,4280076,,False,21.0,6,15,3,11,3,4,0,0,0,2,2,1,0,0,1,0,15
401085759,Lafayette Leopards,K. Stout,4067118,,False,14.0,3,4,2,2,1,2,0,0,1,2,3,1,0,0,2,3,7
401085759,Lafayette Leopards,TEAM,TOTAL,TOTAL,False,,30,63,21,45,9,18,8,17,11,17,28,12,3,1,15,21,77
401085758,Quinnipiac Bobcats,J. Rigoni,4279743,,True,13.0,1,3,1,1,0,2,0,0,1,3,4,0,0,1,1,1,2
401085758,Quinnipiac Bobcats,K. Marfo,4066877,,True,26.0,3,6,3,6,0,0,6,8,4,9,13,0,1,0,0,3,12
401085758,Quinnipiac Bobcats,T. Williams,4398399,,True,28.0,4,10,2,4,2,6,0,0,0,5,5,1,2,0,1,1,10
401085758,Quinnipiac Bobcats,R. Kelly,4279741,,True,34.0,2,13,2,7,0,6,0,0,0,4,4,7,0,0,1,2,4
401085758,Quinnipiac Bobcats,C. Young,4070684,,True,34.0,7,15,5,11,2,4,5,8,0,4,4,0,1,0,2,2,21
401085758,Quinnipiac Bobcats,A. Bundu,3947028,,False,14.0,1,2,1,2,0,0,0,0,2,2,4,0,0,0,2,2,2
401085758,Quinnipiac Bobcats,T. Pickron,4398400,,False,4.0,0,1,0,0,0,1,0,0,0,0,0,0,0,0,1,0,0
401085758,Quinnipiac Bobcats,T. Atson,4066478,,False,22.0,3,5,1,1,2,4,2,3,2,1,3,1,1,1,3,2,10
401085758,Quinnipiac Bobcats,A. Robinson,3947024,,False,25.0,1,5,0,0,1,5,0,0,0,4,4,1,0,1,0,1,3
401085758,Quinnipiac Bobcats,TEAM,TOTAL,TOTAL,False,,22,60,15,32,7,28,13,19,12,32,44,10,5,3,11,14,64
401085758,Dartmouth Big Green,A. Jackson,4279555,,True,24.0,1,8,0,6,1,2,1,3,4,6,10,1,1,2,1,2,4
401085758,Dartmouth Big Green,C. Knight,4279553,,True,32.0,10,17,9,16,1,1,2,3,1,2,3,2,1,1,3,3,23
401085758,Dartmouth Big Green,B. Barry,4066823,,True,33.0,2,7,2,5,0,2,0,0,1,7,8,3,0,1,1,1,4
401085758,Dartmouth Big Green,J. Foye,4066822,,True,21.0,2,5,1,3,1,2,0,0,0,1,1,2,0,1,0,4,5
401085758,Dartmouth Big Green,I. Sistare,4066821,,True,32.0,3,13,2,7,1,6,2,2,2,4,6,0,0,0,1,3,9
401085758,Dartmouth Big Green,W. Emery,4066819,,False,9.0,0,1,0,0,0,1,0,2,0,1,1,0,0,0,0,0,0
401085758,Dartmouth Big Green,A. Rai,4279554,,False,3.0,0,1,0,1,0,0,0,0,0,0,0,0,0,0,0,0,0
401085758,Dartmouth Big Green,W. Slajchert,4397961,,False,12.0,0,1,0,1,0,0,0,0,0,3,3,0,1,0,1,1,0
401085758,Dartmouth Big Green,T. Samuels,4397960,,False,30.0,5,11,4,7,1,4,1,2,0,1,1,2,1,0,3,2,12
401085758,Dartmouth Big Green,I. Letoa,4279552,,False,4.0,1,1,1,1,0,0,0,0,0,1,1,0,0,0,0,0,2
401085758,Dartmouth Big Green,TEAM,TOTAL,TOTAL,False,,24,65,19,47,5,18,6,12,9,27,36,10,4,5,10,16,59
401085757,Stony Brook Seawolves,J. Otchere,4396585,,True,15.0,1,3,1,3,0,0,2,4,2,8,10,2,0,0,0,5,4
401085757,Stony Brook Seawolves,A. Yeboah,3913169,,True,37.0,6,11,3,5,3,6,4,7,2,6,8,2,1,2,3,3,19
401085757,Stony Brook Seawolves,M. Latimer,4396584,,True,34.0,4,9,2,6,2,3,4,5,0,4,4,2,1,1,1,1,14
401085757,Stony Brook Seawolves,J. Moor,4396583,,True,15.0,4,4,3,3,1,1,0,0,0,3,3,0,2,0,1,2,9
401085757,Stony Brook Seawolves,J. Cornish,4278239,,True,30.0,3,11,1,6,2,5,0,0,0,3,3,4,2,1,2,2,8
401085757,Stony Brook Seawolves,A. Ochefu,4278243,,False,10.0,0,2,0,2,0,0,0,0,2,3,5,0,0,0,2,4,0
401085757,Stony Brook Seawolves,J. McKenzie,4278242,,False,11.0,0,0,0,0,0,0,0,0,0,0,0,0,0,0,3,2,0
401085757,Stony Brook Seawolves,E. Olaniyi,4278240,,False,28.0,5,10,4,8,1,2,2,2,1,3,4,2,1,0,1,2,13
401085757,Stony Brook Seawolves,A. Garcia,4066768,,False,20.0,1,4,1,3,0,1,2,2,1,1,2,0,0,1,2,1,4
401085757,Stony Brook Seawolves,TEAM,TOTAL,TOTAL,False,,24,54,15,36,9,18,14,20,9,32,41,12,7,5,15,22,71
401085757,Quinnipiac Bobcats,J. Rigoni,4279743,,True,14.0,0,3,0,0,0,3,0,0,0,1,1,0,1,0,0,2,0
401085757,Quinnipiac Bobcats,K. Marfo,4066877,,True,16.0,3,4,3,4,0,0,2,5,0,6,6,0,0,1,0,2,8
401085757,Quinnipiac Bobcats,T. Williams,4398399,,True,32.0,2,6,1,3,1,3,4,4,2,3,5,0,0,1,4,4,9
401085757,Quinnipiac Bobcats,C. Young,4070684,,True,35.0,7,18,7,15,0,3,15,18,0,4,4,2,3,0,0,5,29
401085757,Quinnipiac Bobcats,T. Atson,4066478,,True,18.0,1,8,1,5,0,3,0,0,1,1,2,0,1,0,2,1,2
401085757,Quinnipiac Bobcats,A. Bundu,3947028,,False,23.0,3,6,3,6,0,0,0,0,4,6,10,0,0,0,1,1,6
401085757,Quinnipiac Bobcats,T. Pickron,4398400,,False,5.0,0,1,0,0,0,1,0,0,0,0,0,0,0,0,0,0,0
401085757,Quinnipiac Bobcats,R. Kelly,4279741,,False,24.0,3,6,2,4,1,2,0,1,0,1,1,6,0,0,3,1,7
401085757,Quinnipiac Bobcats,A. Robinson,3947024,,False,33.0,0,3,0,0,0,3,0,0,1,1,2,0,1,0,1,3,0
401085757,Quinnipiac Bobcats,TEAM,TOTAL,TOTAL,False,,19,55,17,37,2,18,21,28,9,25,34,8,6,2,12,19,61
401085756,Quinnipiac Bobcats,J. Rigoni,4279743,,True,30.0,3,11,1,1,2,10,2,2,1,3,4,2,1,0,2,0,10
401085756,Quinnipiac Bobcats,K. Marfo,4066877,,True,25.0,1,5,1,5,0,0,1,5,4,4,8,2,0,1,2,2,3
401085756,Quinnipiac Bobcats,T. Williams,4398399,,True,33.0,2,9,2,5,0,4,0,1,1,3,4,0,0,0,4,4,4
401085756,Quinnipiac Bobcats,C. Young,4070684,,True,26.0,0,8,0,3,0,5,7,8,0,4,4,3,3,0,3,4,7
401085756,Quinnipiac Bobcats,T. Atson,4066478,,True,35.0,5,13,3,7,2,6,4,6,4,4,8,2,2,0,3,3,16
401085756,Quinnipiac Bobcats,A. Bundu,3947028,,False,8.0,1,2,1,2,0,0,2,2,0,0,0,0,0,0,0,2,4
401085756,Quinnipiac Bobcats,T. Pickron,4398400,,False,12.0,1,3,0,0,1,3,0,0,0,0,0,1,1,0,0,0,3
401085756,Quinnipiac Bobcats,A. Robinson,3947024,,False,31.0,5,9,0,0,5,9,0,0,2,3,5,3,0,0,1,1,15
401085756,Quinnipiac Bobcats,TEAM,TOTAL,TOTAL,False,,18,60,8,23,10,37,16,24,13,25,38,13,7,1,15,16,62
401085756,Massachusetts Minutemen,R. Holloway,3149936,,True,21.0,2,3,2,3,0,0,0,0,4,9,13,1,0,3,1,4,4
401085756,Massachusetts Minutemen,J. Laurent,3946036,,True,34.0,3,5,2,3,1,2,0,0,1,8,9,1,0,0,1,2,7
401085756,Massachusetts Minutemen,C. Pierre,4278368,,True,26.0,5,10,3,5,2,5,0,1,0,3,3,0,1,0,2,4,12
401085756,Massachusetts Minutemen,L. Pipkins,3947221,,True,36.0,7,15,4,8,3,7,3,4,0,2,2,7,2,0,5,2,20
401085756,Massachusetts Minutemen,C. Cobb III,3947017,,True,30.0,4,15,2,7,2,8,3,4,0,8,8,2,3,0,2,0,13
401085756,Massachusetts Minutemen,S. Chatman,4397162,,False,10.0,0,1,0,1,0,0,0,0,0,0,0,0,0,0,1,2,0
401085756,Massachusetts Minutemen,S. Diallo,4397161,,False,6.0,0,1,0,0,0,1,0,0,0,1,1,0,0,0,0,2,0
401085756,Massachusetts Minutemen,K. Turner-Morris,4278370,,False,6.0,0,1,0,1,0,0,0,0,1,0,1,0,0,0,0,1,0
401085756,Massachusetts Minutemen,T. Wood,4397160,,False,15.0,3,3,2,2,1,1,0,0,0,0,0,0,0,0,4,4,7
401085756,Massachusetts Minutemen,K. Clergeot,4066460,,False,16.0,1,2,1,1,0,1,4,5,0,1,1,2,0,0,3,0,6
401085756,Massachusetts Minutemen,TEAM,TOTAL,TOTAL,False,,25,56,16,31,9,25,10,14,7,32,39,13,6,3,19,21,69
401085755,Quinnipiac Bobcats,J. Rigoni,4279743,,True,34.0,4,9,1,2,3,7,0,0,1,0,1,1,0,0,3,0,11
401085755,Quinnipiac Bobcats,K. Marfo,4066877,,True,17.0,2,5,2,5,0,0,0,2,1,5,6,1,1,0,0,3,4
401085755,Quinnipiac Bobcats,T. Williams,4398399,,True,37.0,6,12,2,3,4,9,3,5,0,7,7,3,2,0,1,0,19
401085755,Quinnipiac Bobcats,C. Young,4070684,,True,27.0,3,8,2,5,1,3,5,10,3,3,6,1,1,2,2,2,12
401085755,Quinnipiac Bobcats,T. Atson,4066478,,True,13.0,0,4,0,1,0,3,0,0,0,1,1,2,1,1,2,2,0
401085755,Quinnipiac Bobcats,A. Bundu,3947028,,False,23.0,0,1,0,1,0,0,1,3,0,5,5,0,1,0,0,3,1
401085755,Quinnipiac Bobcats,T. Pickron,4398400,,False,16.0,0,4,0,0,0,4,0,0,0,0,0,1,0,0,1,1,0
401085755,Quinnipiac Bobcats,A. Robinson,3947024,,False,33.0,4,6,1,1,3,5,0,0,1,2,3,3,1,0,1,2,11
401085755,Quinnipiac Bobcats,TEAM,TOTAL,TOTAL,False,,19,49,8,18,11,31,9,20,7,25,32,12,7,3,11,13,58
401085755,Maine Black Bears,V. Larsson,4395896,,True,40.0,3,5,2,4,1,1,0,0,5,4,9,2,1,2,2,2,7
401085755,Maine Black Bears,A. Fleming,4066695,,True,40.0,2,9,2,7,0,2,1,4,1,6,7,4,0,3,1,2,5
401085755,Maine Black Bears,I. Stojiljkovic,3941316,,True,4.0,0,1,0,1,0,0,0,0,0,0,0,0,0,0,0,2,0
401085755,Maine Black Bears,S. El Darwich,4067724,,True,29.0,3,7,3,3,0,4,1,2,0,4,4,2,2,0,4,4,7
401085755,Maine Black Bears,I. White,3913240,,True,36.0,8,19,5,9,3,10,0,0,0,3,3,0,1,0,3,4,19
401085755,Maine Black Bears,M. Antoms,4278224,,False,4.0,0,1,0,1,0,0,0,0,0,1,1,0,0,0,1,1,0
401085755,Maine Black Bears,V. Eze,3941313,,False,19.0,5,7,5,7,0,0,0,0,0,3,3,0,0,1,3,1,10
401085755,Maine Black Bears,T. Moss,4395897,,False,13.0,1,3,1,2,0,1,0,0,0,1,1,2,1,0,0,2,2
401085755,Maine Black Bears,C. Araujo,4278222,,False,10.0,0,0,0,0,0,0,0,0,0,1,1,1,0,0,1,0,0
401085755,Maine Black Bears,D. Ashley,3941310,,False,5.0,0,2,0,1,0,1,0,0,1,0,1,0,0,0,0,0,0
401085755,Maine Black Bears,TEAM,TOTAL,TOTAL,False,,22,54,18,35,4,19,2,6,9,29,38,11,5,6,15,18,50
401085754,Quinnipiac Bobcats,J. Rigoni,4279743,,True,32.0,8,17,4,10,4,7,3,3,2,7,9,0,0,0,4,1,23
401085754,Quinnipiac Bobcats,K. Marfo,4066877,,True,26.0,2,3,2,3,0,0,0,0,5,9,14,4,0,0,4,5,4
401085754,Quinnipiac Bobcats,T. Williams,4398399,,True,26.0,0,3,0,1,0,2,2,5,0,3,3,1,1,0,2,4,2
401085754,Quinnipiac Bobcats,C. Young,4070684,,True,35.0,5,13,1,4,4,9,3,4,1,2,3,1,1,0,4,1,17
401085754,Quinnipiac Bobcats,T. Atson,4066478,,True,27.0,2,8,1,3,1,5,2,3,0,5,5,0,1,0,3,1,7
401085754,Quinnipiac Bobcats,A. Bundu,3947028,,False,10.0,1,1,1,1,0,0,0,0,3,0,3,0,0,1,1,4,2
401085754,Quinnipiac Bobcats,T. Pickron,4398400,,False,13.0,3,7,2,4,1,3,0,2,2,3,5,0,0,0,1,1,7
401085754,Quinnipiac Bobcats,A. Robinson,3947024,,False,31.0,2,5,0,1,2,4,1,4,1,4,5,3,1,0,1,1,7
401085754,Quinnipiac Bobcats,TEAM,TOTAL,TOTAL,False,,23,57,11,27,12,30,11,21,15,35,50,9,4,1,20,18,69
401085754,New Hampshire Wildcats,J. Martinez,4396579,,True,9.0,0,1,0,1,0,0,0,0,0,4,4,0,1,0,0,0,0
401085754,New Hampshire Wildcats,L. Rosinski,4066730,,True,18.0,0,0,0,0,0,0,1,2,0,0,0,0,1,0,2,4,1
401085754,New Hampshire Wildcats,J. Hopkins,4278238,,True,37.0,4,14,2,7,2,7,4,5,0,3,3,0,0,0,1,3,14
401085754,New Hampshire Wildcats,E. Jordan,4278237,,True,34.0,7,16,3,10,4,6,1,2,2,0,2,1,0,0,3,2,19
401085754,New Hampshire Wildcats,J. Reed,3132469,,True,20.0,6,10,4,6,2,4,3,3,0,0,0,0,1,0,0,4,17
401085754,New Hampshire Wildcats,N. Guadarrama,4396578,,False,26.0,2,7,2,5,0,2,0,1,1,3,4,0,1,1,2,1,4
401085754,New Hampshire Wildcats,C. Lester,4066728,,False,19.0,2,3,1,2,1,1,0,1,2,4,6,0,2,0,2,2,5
401085754,New Hampshire Wildcats,D. Watkins,3922029,,False,2.0,0,1,0,0,0,1,0,0,0,0,0,0,0,0,0,1,0
401085754,New Hampshire Wildcats,M. Maultsby,4396576,,False,8.0,0,1,0,1,0,0,0,0,0,2,2,3,2,0,0,4,0
401085754,New Hampshire Wildcats,M. Carbone,4066743,,False,4.0,0,2,0,1,0,1,0,0,0,0,0,0,0,0,1,0,0
401085754,New Hampshire Wildcats,K. Love,4066727,,False,5.0,0,3,0,2,0,1,0,0,1,1,2,1,0,0,0,1,0
401085754,New Hampshire Wildcats,J. Ogwuche,4066726,,False,18.0,1,5,1,4,0,1,1,2,1,4,5,0,0,1,0,1,3
401085754,New Hampshire Wildcats,TEAM,TOTAL,TOTAL,False,,22,63,13,39,9,24,10,16,11,22,33,5,8,2,11,23,63
401085753,Quinnipiac Bobcats,J. Rigoni,4279743,,True,16.0,1,3,1,1,0,2,2,2,1,1,2,1,2,1,4,4,4
401085753,Quinnipiac Bobcats,K. Marfo,4066877,,True,23.0,2,4,2,4,0,0,0,3,5,5,10,1,0,0,1,3,4
401085753,Quinnipiac Bobcats,T. Williams,4398399,,True,35.0,3,12,2,7,1,5,0,0,0,4,4,2,0,0,1,2,7
401085753,Quinnipiac Bobcats,C. Young,4070684,,True,36.0,6,18,2,9,4,9,1,2,1,5,6,2,0,0,4,2,17
401085753,Quinnipiac Bobcats,T. Atson,4066478,,True,35.0,4,7,3,4,1,3,2,2,2,1,3,0,1,0,1,2,11
401085753,Quinnipiac Bobcats,A. Bundu,3947028,,False,17.0,1,2,1,2,0,0,1,1,0,3,3,0,1,0,3,3,3
401085753,Quinnipiac Bobcats,T. Pickron,4398400,,False,9.0,0,4,0,1,0,3,0,0,0,0,0,0,0,0,1,1,0
401085753,Quinnipiac Bobcats,A. Robinson,3947024,,False,29.0,3,8,1,1,2,7,0,0,1,2,3,1,0,0,0,4,8
401085753,Quinnipiac Bobcats,TEAM,TOTAL,TOTAL,False,,20,58,12,29,8,29,6,10,11,21,32,7,4,1,15,21,54
401085753,Hartford Hawks,G. Blagojevic,3917980,,True,38.0,4,8,4,6,0,2,3,9,6,7,13,0,1,0,2,2,11
401085753,Hartford Hawks,J. Carroll,3130746,,True,34.0,8,13,6,10,2,3,4,8,1,7,8,3,0,0,6,0,22
401085753,Hartford Hawks,T. Weatherington,4278214,,True,22.0,3,5,0,1,3,4,0,0,1,3,4,0,0,1,1,4,9
401085753,Hartford Hawks,J.R. Lynch,3917979,,True,36.0,3,10,2,6,1,4,4,4,0,4,4,8,2,0,1,3,11
401085753,Hartford Hawks,J. Dunne,3917978,,True,37.0,2,9,1,3,1,6,2,2,1,2,3,3,0,1,5,2,7
401085753,Hartford Hawks,H. Marks,4395886,,False,1.0,0,0,0,0,0,0,0,0,0,0,0,0,0,0,0,0,0
401085753,Hartford Hawks,E. Davis III,3152336,,False,9.0,1,2,0,0,1,2,0,0,0,1,1,0,0,0,0,0,3
401085753,Hartford Hawks,D.J. Mitchell,4395893,,False,7.0,0,0,0,0,0,0,0,0,0,1,1,0,0,0,0,0,0
401085753,Hartford Hawks,M. Twyman,3130743,,False,16.0,2,3,1,2,1,1,0,0,0,0,0,0,1,0,0,1,5
401085753,Hartford Hawks,TEAM,TOTAL,TOTAL,False,,23,50,14,28,9,22,13,23,9,26,35,14,4,2,15,12,68
401085740,VCU Rams,C. Douglas,4397226,,True,17.0,4,5,4,5,0,0,0,1,4,2,6,0,1,1,0,1,8
401085740,VCU Rams,M. Santos-Silva,4278420,,True,20.0,3,6,3,6,0,0,0,0,1,5,6,1,1,0,0,4,6
401085740,VCU Rams,I. Vann,3941317,,True,23.0,5,9,4,6,1,3,0,1,1,3,4,1,1,0,1,2,11
401085740,VCU Rams,D. Jenkins,4066500,,True,28.0,4,11,2,5,2,6,3,3,0,2,2,6,2,0,1,1,13
401085740,VCU Rams,M. Evans,3920203,,True,29.0,4,9,1,3,3,6,3,4,0,5,5,5,2,0,4,1,14
401085740,VCU Rams,S. Mobley,4278418,,False,15.0,1,2,0,1,1,1,0,0,0,1,1,3,0,0,1,2,3
401085740,VCU Rams,M. Gilmore,3138208,,False,9.0,0,0,0,0,0,0,2,3,1,4,5,1,0,0,0,4,2
401085740,VCU Rams,V. Williams Jr.,4397227,,False,14.0,1,3,1,2,0,1,0,0,2,2,4,6,1,0,2,2,2
401085740,VCU Rams,P.J. Byrd,4397229,,False,4.0,0,0,0,0,0,0,0,0,0,0,0,0,0,0,1,0,0
401085740,VCU Rams,K. Curry,4397228,,False,8.0,2,3,2,2,0,1,0,0,0,0,0,0,0,0,1,0,4
401085740,VCU Rams,X. Jackson,4278421,,False,1.0,0,0,0,0,0,0,0,0,0,0,0,0,0,0,0,0,0
401085740,VCU Rams,M. Simms,4278417,,False,19.0,5,7,2,2,3,5,2,2,0,1,1,1,0,0,1,1,15
401085740,VCU Rams,M. Crowfield,4066501,,False,13.0,4,7,0,1,4,6,0,0,0,0,0,0,0,0,0,0,12
401085740,VCU Rams,TEAM,TOTAL,TOTAL,False,,33,62,19,33,14,29,10,14,9,25,34,24,8,1,13,18,90
401085740,Rider Broncs,F. Scott,3922033,,True,30.0,5,9,5,6,0,3,1,1,0,3,3,2,0,0,2,2,11
401085740,Rider Broncs,T. Marshall,4067348,,True,19.0,3,7,3,7,0,0,0,2,3,4,7,0,0,0,2,4,6
401085740,Rider Broncs,J. Allen,4067345,,True,26.0,3,12,0,3,3,9,3,4,1,2,3,2,1,0,0,1,12
401085740,Rider Broncs,K. Williams,3946983,,True,34.0,6,9,6,9,0,0,0,0,0,3,3,4,5,0,1,2,12
401085740,Rider Broncs,A. Durham,3138490,,True,22.0,2,5,1,2,1,3,0,0,0,6,6,5,1,0,4,2,5
401085740,Rider Broncs,A. Ogemuno-Johnson,4406151,,False,13.0,3,4,3,4,0,0,1,3,1,0,1,0,2,1,0,1,7
401085740,Rider Broncs,K. Cisse,4279746,,False,2.0,0,0,0,0,0,0,0,0,0,0,0,0,0,0,0,0,0
401085740,Rider Broncs,D. Eke,3941312,,False,11.0,1,4,1,4,0,0,0,0,2,0,2,0,0,0,0,3,2
401085740,Rider Broncs,S. Jordan,4067349,,False,32.0,3,7,1,3,2,4,4,7,3,3,6,7,0,0,5,2,12
401085740,Rider Broncs,A. Gilbert,3911886,,False,11.0,4,6,0,1,4,5,0,0,0,1,1,0,1,0,0,0,12
401085740,Rider Broncs,TEAM,TOTAL,TOTAL,False,,30,63,20,39,10,24,9,17,12,24,36,20,10,1,14,17,79
401085739,VCU Rams,C. Douglas,4397226,,True,22.0,4,8,3,7,1,1,2,2,2,3,5,0,0,4,0,4,11
401085739,VCU Rams,M. Santos-Silva,4278420,,True,23.0,5,6,5,6,0,0,2,8,5,4,9,2,1,1,2,3,12
401085739,VCU Rams,I. Vann,3941317,,True,19.0,3,9,3,5,0,4,1,2,0,1,1,3,3,0,1,3,7
401085739,VCU Rams,D. Jenkins,4066500,,True,25.0,2,7,0,1,2,6,0,0,0,2,2,3,1,1,0,2,6
401085739,VCU Rams,M. Evans,3920203,,True,23.0,4,10,1,5,3,5,8,10,1,5,6,1,3,0,1,2,19
401085739,VCU Rams,M. Gilmore,3138208,,False,13.0,2,9,2,5,0,4,0,0,1,2,3,1,0,1,0,1,4
401085739,VCU Rams,V. Williams Jr.,4397227,,False,22.0,1,5,1,3,0,2,2,4,1,1,2,3,2,0,1,4,4
401085739,VCU Rams,P.J. Byrd,4397229,,False,13.0,0,1,0,0,0,1,3,4,0,0,0,1,0,0,1,2,3
401085739,VCU Rams,K. Curry,4397228,,False,10.0,3,3,2,2,1,1,1,2,1,2,3,1,1,0,1,1,8
401085739,VCU Rams,D. Sheehy-Guiseppi,4278419,,False,2.0,0,1,0,1,0,0,0,0,1,0,1,0,0,0,1,1,0
401085739,VCU Rams,M. Simms,4278417,,False,21.0,3,6,0,1,3,5,2,4,2,4,6,0,1,0,0,0,11
401085739,VCU Rams,M. Crowfield,4066501,,False,7.0,1,1,0,0,1,1,0,0,1,2,3,1,2,0,0,0,3
401085739,VCU Rams,TEAM,TOTAL,TOTAL,False,,28,66,17,36,11,30,21,36,17,27,44,16,14,7,8,23,88
401085739,Iona Gaels,T. Agee,4398087,,True,28.0,3,9,1,5,2,4,1,2,1,4,5,0,0,0,3,5,9
401085739,Iona Gaels,E.J. Crawford,4067295,,True,35.0,5,12,4,9,1,3,5,5,1,7,8,0,0,0,1,1,16
401085739,Iona Gaels,A. Gist,4067164,,True,18.0,0,1,0,0,0,1,0,0,0,0,0,2,0,0,4,5,0
401085739,Iona Gaels,R. McGill,3948698,,True,38.0,4,11,4,7,0,4,8,11,0,5,5,3,1,0,5,3,16
401085739,Iona Gaels,I. Still,3938908,,True,39.0,3,10,3,6,0,4,1,1,0,8,8,1,1,2,3,3,7
401085739,Iona Gaels,N. Nikolic,4398090,,False,17.0,3,5,3,5,0,0,2,3,4,2,6,1,0,0,4,5,8
401085739,Iona Gaels,J. Maxwell,4398088,,False,15.0,1,2,0,0,1,2,0,1,0,0,0,0,0,0,1,4,3
401085739,Iona Gaels,A. Ristanovic,4279492,,False,1.0,0,0,0,0,0,0,0,0,0,0,0,0,0,1,0,0,0
401085739,Iona Gaels,P. Hudson,4398089,,False,9.0,0,1,0,0,0,1,0,0,0,0,0,0,1,0,0,1,0
401085739,Iona Gaels,TEAM,TOTAL,TOTAL,False,,19,51,15,32,4,19,17,23,9,31,40,7,3,3,23,27,59
401085723,St. Bonaventure Bonnies,T. Ngalakulondi,4278410,,True,28.0,3,9,3,5,0,4,0,1,1,5,6,1,1,1,1,2,6
401085723,St. Bonaventure Bonnies,C. Stockard,3919422,,True,29.0,6,11,6,9,0,2,5,5,0,9,9,4,1,1,1,1,17
401085723,St. Bonaventure Bonnies,A. Ikpeze,4066517,,True,20.0,2,3,2,3,0,0,0,0,2,3,5,0,0,1,0,3,4
401085723,St. Bonaventure Bonnies,K. Lofton,4397220,,True,36.0,2,6,2,5,0,1,2,3,1,0,1,4,0,0,0,1,6
401085723,St. Bonaventure Bonnies,J. Poyser,3936100,,True,29.0,6,11,5,7,1,4,0,0,1,4,5,2,2,0,2,2,13
401085723,St. Bonaventure Bonnies,O. Osunniyi,4397224,,False,20.0,5,7,5,7,0,0,3,4,4,3,7,1,0,2,0,2,13
401085723,St. Bonaventure Bonnies,A. Okoli,4397222,,False,6.0,1,1,1,1,0,0,0,0,0,1,1,0,0,0,0,0,2
401085723,St. Bonaventure Bonnies,J. Lee,4283452,,False,5.0,0,0,0,0,0,0,0,0,0,1,1,1,0,0,1,0,0
401085723,St. Bonaventure Bonnies,J. Galatio,4072631,,False,2.0,0,0,0,0,0,0,0,0,0,0,0,0,0,0,0,1,0
401085723,St. Bonaventure Bonnies,N. Kaputo,3919421,,False,25.0,8,11,3,5,5,6,0,0,0,3,3,0,2,0,1,1,21
401085723,St. Bonaventure Bonnies,TEAM,TOTAL,TOTAL,False,,33,59,27,42,6,17,10,13,9,29,38,13,6,5,8,13,82
401085723,Siena Saints,S. Seymour,4398391,,True,17.0,1,7,0,0,1,7,0,0,0,2,2,0,0,0,0,1,3
401085723,Siena Saints,S. Friday IV,4067353,,True,24.0,3,3,3,3,0,0,1,5,2,1,3,0,0,0,0,0,7
401085723,Siena Saints,K. Degnan,3138282,,True,19.0,1,6,0,2,1,4,0,0,0,1,1,0,0,1,2,2,3
401085723,Siena Saints,J. Pickett,4398390,,True,30.0,2,7,2,4,0,3,0,2,1,0,1,4,1,0,5,3,4
401085723,Siena Saints,M. Camper,4279751,,True,24.0,3,5,2,3,1,2,0,0,0,3,3,0,0,1,1,1,7
401085723,Siena Saints,D. Tchougang,4398394,,False,16.0,0,2,0,2,0,0,0,0,3,1,4,0,0,0,2,2,0
401085723,Siena Saints,T. Huerter Jr.,4067350,,False,21.0,0,3,0,2,0,1,0,0,0,4,4,1,2,0,2,2,0
401085723,Siena Saints,G. Darwiche,4398393,,False,7.0,0,3,0,2,0,1,0,0,0,0,0,1,0,0,0,1,0
401085723,Siena Saints,J. Ratliff,4398392,,False,30.0,5,7,1,1,4,6,2,3,1,4,5,0,0,1,1,2,16
401085723,Siena Saints,P. Morastoni,4293127,,False,1.0,0,0,0,0,0,0,0,0,0,0,0,0,0,0,0,0,0
401085723,Siena Saints,B. Diamond,4279752,,False,1.0,0,1,0,1,0,0,0,0,0,0,0,0,0,0,0,0,0
401085723,Siena Saints,B. Bayer,4065720,,False,7.0,0,2,0,0,0,2,0,0,0,1,1,0,0,0,1,0,0
401085723,Siena Saints,K. Smithen,3133848,,False,3.0,0,0,0,0,0,0,0,0,0,0,0,0,0,0,1,1,0
401085723,Siena Saints,TEAM,TOTAL,TOTAL,False,,15,46,8,20,7,26,3,10,7,19,26,6,3,3,15,15,40
401085721,St. Bonaventure Bonnies,T. Ngalakulondi,4278410,,True,26.0,3,5,3,5,0,0,0,0,0,5,5,1,0,0,0,2,6
401085721,St. Bonaventure Bonnies,A. Ikpeze,4066517,,True,12.0,1,4,1,4,0,0,0,0,2,2,4,0,0,0,2,1,2
401085721,St. Bonaventure Bonnies,A. Okoli,4397222,,True,8.0,0,0,0,0,0,0,0,0,0,1,1,0,0,0,2,2,0
401085721,St. Bonaventure Bonnies,K. Lofton,4397220,,True,40.0,5,12,2,6,3,6,0,0,0,3,3,9,0,0,0,1,13
401085721,St. Bonaventure Bonnies,J. Poyser,3936100,,True,36.0,2,10,0,1,2,9,0,0,0,4,4,2,1,0,2,2,6
401085721,St. Bonaventure Bonnies,C. Stockard,3919422,,False,20.0,5,7,4,4,1,3,8,8,0,7,7,3,1,0,2,3,19
401085721,St. Bonaventure Bonnies,O. Osunniyi,4397224,,False,29.0,6,9,6,9,0,0,0,2,4,7,11,0,0,4,1,2,12
401085721,St. Bonaventure Bonnies,N. Kaputo,3919421,,False,29.0,4,9,1,4,3,5,1,3,0,5,5,1,0,0,2,2,12
401085721,St. Bonaventure Bonnies,TEAM,TOTAL,TOTAL,False,,26,56,17,33,9,23,9,13,8,34,42,16,2,4,13,15,70
401085721,Canisius Golden Griffins,S. Hitchon,4279482,,True,16.0,1,5,1,3,0,2,0,0,0,1,1,2,0,0,0,1,2
401085721,Canisius Golden Griffins,J. White,4279478,,True,13.0,1,3,1,2,0,1,1,1,0,0,0,0,0,0,0,3,3
401085721,Canisius Golden Griffins,T. Molson,4279481,,True,25.0,4,9,3,4,1,5,1,2,0,1,1,0,1,0,3,2,10
401085721,Canisius Golden Griffins,I. Reese,4067278,,True,26.0,1,10,1,5,0,5,1,2,1,5,6,7,3,1,0,1,3
401085721,Canisius Golden Griffins,M. Johnson,4067275,,True,36.0,3,6,2,4,1,2,2,4,2,6,8,1,1,0,3,4,9
401085721,Canisius Golden Griffins,K. Johnson-Alls,4398049,,False,4.0,0,0,0,0,0,0,0,0,0,2,2,0,0,0,2,1,0
401085721,Canisius Golden Griffins,D. St. Louis,4067280,,False,17.0,2,6,2,6,0,0,0,0,2,5,7,0,0,0,1,3,4
401085721,Canisius Golden Griffins,J. Faulkner,3137250,,False,20.0,3,8,3,4,0,4,1,2,2,0,2,0,0,0,1,2,7
401085721,Canisius Golden Griffins,I. Hadzic,4398048,,False,7.0,0,1,0,0,0,1,0,0,0,0,0,0,0,0,0,0,0
401085721,Canisius Golden Griffins,J. Henderson,4398046,,False,16.0,2,4,1,2,1,2,0,0,1,2,3,2,1,0,0,2,5
401085721,Canisius Golden Griffins,J. Sanks,3141259,,False,20.0,4,8,0,0,4,8,0,0,0,2,2,1,0,0,0,3,12
401085721,Canisius Golden Griffins,TEAM,TOTAL,TOTAL,False,,21,60,14,30,7,30,6,11,8,24,32,13,6,1,10,22,55
401085719,St. Bonaventure Bonnies,T. Ngalakulondi,4278410,,True,33.0,6,12,4,9,2,3,0,1,4,9,13,1,2,1,3,4,14
401085719,St. Bonaventure Bonnies,A. Ikpeze,4066517,,True,18.0,2,8,2,8,0,0,0,0,1,3,4,0,0,1,1,2,4
401085719,St. Bonaventure Bonnies,D. Welch,4397221,,True,33.0,4,10,2,6,2,4,0,0,0,6,6,3,0,0,2,2,10
401085719,St. Bonaventure Bonnies,K. Lofton,4397220,,True,28.0,3,6,2,4,1,2,0,0,2,2,4,4,1,0,1,5,7
401085719,St. Bonaventure Bonnies,J. Poyser,3936100,,True,40.0,9,18,8,14,1,4,2,2,0,1,1,2,0,0,0,1,21
401085719,St. Bonaventure Bonnies,O. Osunniyi,4397224,,False,22.0,7,8,7,8,0,0,0,0,2,0,2,0,0,2,3,4,14
401085719,St. Bonaventure Bonnies,A. Okoli,4397222,,False,3.0,0,1,0,1,0,0,0,0,0,0,0,0,0,0,0,2,0
401085719,St. Bonaventure Bonnies,N. Kaputo,3919421,,False,23.0,1,5,1,3,0,2,0,0,0,3,3,3,2,0,4,2,2
401085719,St. Bonaventure Bonnies,TEAM,TOTAL,TOTAL,False,,32,68,26,53,6,15,2,3,11,26,37,13,5,4,15,22,72
401085719,Niagara Purple Eagles,D. Robb,3907186,,True,27.0,2,5,2,4,0,1,2,2,1,4,5,0,0,8,2,2,6
401085719,Niagara Purple Eagles,M. Prochet,3907184,,True,34.0,6,9,3,4,3,5,5,7,3,7,10,3,0,0,3,1,20
401085719,Niagara Purple Eagles,K. Tate,4279738,,True,31.0,7,16,5,11,2,5,1,2,1,2,3,3,3,0,0,1,17
401085719,Niagara Purple Eagles,J. Towns,4067341,,True,27.0,4,10,3,6,1,4,9,12,2,1,3,2,1,0,2,3,18
401085719,Niagara Purple Eagles,C. Barton,3907182,,True,26.0,2,5,2,4,0,1,2,2,1,3,4,2,0,0,2,1,6
401085719,Niagara Purple Eagles,G. Kuakumensah,4279739,,False,3.0,0,1,0,1,0,0,0,0,0,0,0,0,1,0,1,1,0
401085719,Niagara Purple Eagles,K. Green,4067342,,False,6.0,2,2,2,2,0,0,0,0,1,0,1,0,0,0,0,0,4
401085719,Niagara Purple Eagles,G. King,3906490,,False,13.0,2,3,2,3,0,0,0,0,2,0,2,0,1,1,0,1,4
401085719,Niagara Purple Eagles,M. Hammond,4398404,,False,16.0,0,3,0,1,0,2,0,0,0,4,4,1,0,0,0,0,0
401085719,Niagara Purple Eagles,R. Solomon,4398403,,False,8.0,0,3,0,1,0,2,0,0,2,1,3,1,0,0,2,1,0
401085719,Niagara Purple Eagles,D. Fragala,4279737,,False,9.0,2,5,1,3,1,2,0,0,1,1,2,1,0,0,0,0,5
401085719,Niagara Purple Eagles,TEAM,TOTAL,TOTAL,False,,27,62,20,40,7,22,19,25,14,25,39,13,6,9,12,11,80
401085678,Saint Joseph's Hawks,C. Brown Jr.,4066508,,True,23.0,7,12,6,8,1,4,6,7,3,2,5,0,0,0,1,3,21
401085678,Saint Joseph's Hawks,T. Funk,4278395,,True,26.0,3,9,1,3,2,6,0,0,3,4,7,1,0,0,0,1,8
401085678,Saint Joseph's Hawks,J. Bynum,4397194,,True,36.0,3,11,2,7,1,4,0,0,1,0,1,5,2,1,1,2,7
401085678,Saint Joseph's Hawks,A. Longpre,4278393,,True,19.0,3,4,2,3,1,1,1,2,1,6,7,1,0,0,0,2,8
401085678,Saint Joseph's Hawks,L. Kimble,3911628,,True,39.0,5,14,4,6,1,8,8,10,0,6,6,4,0,0,2,1,19
401085678,Saint Joseph's Hawks,L. Edwards,4066512,,False,15.0,5,7,4,4,1,3,0,1,1,2,3,0,0,0,0,1,11
401085678,Saint Joseph's Hawks,P. Oliva,3911632,,False,25.0,2,6,2,5,0,1,0,2,4,6,10,5,1,0,2,4,4
401085678,Saint Joseph's Hawks,M. Lodge,3133856,,False,0.0,0,0,0,0,0,0,0,0,0,0,0,0,0,0,0,0,0
401085678,Saint Joseph's Hawks,C. Clover,3911629,,False,17.0,0,5,0,3,0,2,0,0,1,1,2,1,1,0,0,2,0
401085678,Saint Joseph's Hawks,TEAM,TOTAL,TOTAL,False,,28,68,21,39,7,29,15,22,15,28,43,17,4,1,6,16,78
401085678,Monmouth Hawks,M. Traore,3975762,,True,24.0,5,10,5,10,0,0,2,6,0,4,4,1,0,2,1,3,12
401085678,Monmouth Hawks,D. Hammond,4279734,,True,30.0,5,13,4,5,1,8,1,1,1,4,5,1,0,0,0,2,12
401085678,Monmouth Hawks,R. Salnave,4067329,,True,30.0,5,9,4,6,1,3,3,5,0,4,4,2,0,0,2,4,14
401085678,Monmouth Hawks,L. Pillari,3948713,,True,23.0,2,4,2,2,0,2,1,2,0,2,2,1,1,0,1,1,5
401085678,Monmouth Hawks,N. Rutherford,3946977,,True,34.0,2,6,2,4,0,2,0,0,1,6,7,2,1,1,4,1,4
401085678,Monmouth Hawks,N. Rutty,4398408,,False,3.0,0,0,0,0,0,0,0,0,0,0,0,0,1,0,0,0,0
401085678,Monmouth Hawks,S. Ibiezugbe,4067330,,False,4.0,0,0,0,0,0,0,0,0,0,2,2,1,0,0,0,0,0
401085678,Monmouth Hawks,D. Quinn,3948714,,False,9.0,1,4,1,4,0,0,0,0,0,2,2,0,0,1,1,1,2
401085678,Monmouth Hawks,M. Martin,4279733,,False,22.0,3,4,2,3,1,1,0,0,0,1,1,0,0,1,0,3,7
401085678,Monmouth Hawks,S. Chaput,4398409,,False,6.0,0,0,0,0,0,0,0,0,0,0,0,0,0,0,0,0,0
401085678,Monmouth Hawks,M. McClary,4279736,,False,3.0,1,1,1,1,0,0,0,0,0,0,0,1,0,0,0,1,2
401085678,Monmouth Hawks,G. Papas,4279735,,False,9.0,1,2,1,1,0,1,0,0,0,0,0,4,1,0,0,2,2
401085678,Monmouth Hawks,T. Gross Jr.,4065729,,False,3.0,1,1,0,0,1,1,0,0,0,0,0,0,0,0,0,0,3
401085678,Monmouth Hawks,TEAM,TOTAL,TOTAL,False,,26,54,22,36,4,18,7,14,2,27,29,13,4,5,10,18,63
401085304,Siena Saints,E. Fisher,3913235,,True,36.0,11,19,10,16,1,3,3,6,0,8,8,2,0,0,3,1,26
401085304,Siena Saints,K. Degnan,3138282,,True,31.0,2,4,0,0,2,4,0,0,2,7,9,1,0,1,1,0,6
401085304,Siena Saints,S. Seymour,4398391,,True,24.0,4,9,0,0,4,9,0,0,0,0,0,0,0,0,1,1,12
401085304,Siena Saints,G. Darwiche,4398393,,True,21.0,1,1,0,0,1,1,0,0,0,2,2,2,1,0,2,2,3
401085304,Siena Saints,J. Pickett,4398390,,True,31.0,6,12,2,5,4,7,0,2,3,2,5,11,2,0,1,3,16
401085304,Siena Saints,D. Tchougang,4398394,,False,4.0,0,0,0,0,0,0,4,4,0,0,0,0,0,0,1,1,4
401085304,Siena Saints,J. Ratliff,4398392,,False,25.0,1,4,0,1,1,3,0,0,0,1,1,0,0,0,0,0,3
401085304,Siena Saints,P. Morastoni,4293127,,False,0.0,0,0,0,0,0,0,0,0,0,0,0,0,0,0,0,0,0
401085304,Siena Saints,B. Diamond,4279752,,False,0.0,0,0,0,0,0,0,0,0,0,0,0,0,0,0,0,0,0
401085304,Siena Saints,B. Bayer,4065720,,False,0.0,0,0,0,0,0,0,0,0,0,0,0,0,0,0,0,0,0
401085304,Siena Saints,K. Smithen,3133848,,False,28.0,1,2,0,0,1,2,2,2,0,4,4,1,1,1,0,2,5
401085304,Siena Saints,TEAM,TOTAL,TOTAL,False,,26,51,12,22,14,29,9,14,5,25,30,17,4,2,9,10,75
401085304,Cal Poly Mustangs,D. Carr,4397362,,True,23.0,0,1,0,1,0,0,0,0,1,5,6,0,0,0,0,4,0
401085304,Cal Poly Mustangs,H. Hollingsworth,3948022,,True,29.0,6,7,6,7,0,0,0,1,2,3,5,1,0,0,3,1,12
401085304,Cal Poly Mustangs,M. Crowe,4066868,,True,33.0,5,5,2,2,3,3,0,0,0,3,3,2,0,0,0,2,13
401085304,Cal Poly Mustangs,M. Garrick,4278710,,True,28.0,4,10,1,6,3,4,0,0,0,3,3,0,1,0,0,1,11
401085304,Cal Poly Mustangs,D. Fields,4066867,,True,31.0,5,15,4,11,1,4,0,0,0,2,2,7,0,0,4,4,11
401085304,Cal Poly Mustangs,K. Niziol,4397367,,False,21.0,2,7,2,6,0,1,1,1,1,2,3,2,0,0,0,1,5
401085304,Cal Poly Mustangs,T. Jaakkola,4397363,,False,8.0,1,1,1,1,0,0,0,0,0,0,0,0,0,0,1,1,2
401085304,Cal Poly Mustangs,K. Garoza,4278711,,False,3.0,0,0,0,0,0,0,0,0,0,1,1,0,1,0,0,1,0
401085304,Cal Poly Mustangs,J. Ballard,4397365,,False,12.0,0,4,0,3,0,1,0,0,0,2,2,0,1,0,2,2,0
401085304,Cal Poly Mustangs,J. Alexander,4397361,,False,12.0,0,2,0,1,0,1,0,0,0,0,0,1,1,0,3,1,0
401085304,Cal Poly Mustangs,J. Rice,4278709,,False,0.0,0,0,0,0,0,0,0,0,0,0,0,0,0,0,0,0,0
401085304,Cal Poly Mustangs,TEAM,TOTAL,TOTAL,False,,23,52,16,38,7,14,1,2,4,23,27,13,4,0,14,18,54
401084639,UCF Knights,C. Smith,4278481,,True,29.0,4,10,4,9,0,1,6,15,6,7,13,3,0,1,1,3,14
401084639,UCF Knights,T. Fall,3904625,,True,17.0,2,2,2,2,0,0,0,2,0,6,6,0,0,5,1,4,4
401084639,UCF Knights,T. Allen,3912281,,True,30.0,4,6,3,4,1,2,4,5,1,4,5,4,0,0,1,2,13
401084639,UCF Knights,A. Dawkins,3136493,,True,31.0,5,14,4,6,1,8,5,7,1,9,10,0,2,2,3,2,16
401084639,UCF Knights,B.J. Taylor,3132062,,True,33.0,5,13,3,9,2,4,10,14,1,1,2,4,1,0,2,1,22
401084639,UCF Knights,C. Brown,3904623,,False,14.0,1,1,1,1,0,0,0,0,0,2,2,0,0,2,0,5,2
401084639,UCF Knights,F. Bertz,4396673,,False,2.0,0,1,0,0,0,1,0,0,0,0,0,1,0,0,0,2,0
401084639,UCF Knights,C. DeJesus,4066487,,False,15.0,3,5,3,4,0,1,0,1,1,1,2,1,1,0,1,1,6
401084639,UCF Knights,C. McSpadden,3904624,,False,9.0,1,3,1,1,0,2,0,1,0,2,2,0,0,0,1,0,2
401084639,UCF Knights,D. Griffin,3132374,,False,20.0,2,4,1,1,1,3,0,0,1,1,2,1,1,0,1,2,5
401084639,UCF Knights,TEAM,TOTAL,TOTAL,False,,27,59,22,37,5,22,25,45,12,35,47,14,5,10,11,22,84
401084639,Rider Broncs,D. Vaughn,4067347,,True,18.0,6,9,5,7,1,2,1,4,2,3,5,0,0,0,1,5,14
401084639,Rider Broncs,T. Marshall,4067348,,True,21.0,4,11,4,11,0,0,3,5,3,2,5,2,1,0,3,3,11
401084639,Rider Broncs,S. Jordan,4067349,,True,32.0,3,8,2,6,1,2,1,2,0,3,3,4,1,0,6,2,8
401084639,Rider Broncs,J. Allen,4067345,,True,27.0,2,6,1,1,1,5,0,0,0,4,4,1,0,0,2,2,5
401084639,Rider Broncs,A. Durham,3138490,,True,24.0,2,5,2,5,0,0,1,1,0,2,2,2,0,0,0,4,5
401084639,Rider Broncs,A. Ogemuno-Johnson,4406151,,False,7.0,0,2,0,2,0,0,1,2,1,0,1,0,0,0,0,0,1
401084639,Rider Broncs,K. Cisse,4279746,,False,3.0,0,1,0,1,0,0,0,0,1,1,2,1,0,0,0,4,0
401084639,Rider Broncs,D. Eke,3941312,,False,8.0,1,1,1,1,0,0,0,2,1,0,1,1,1,0,0,5,2
401084639,Rider Broncs,F. Scott,3922033,,False,20.0,4,9,2,7,2,2,1,5,1,5,6,0,1,0,2,2,11
401084639,Rider Broncs,K. Williams,3946983,,False,23.0,2,8,2,8,0,0,0,0,0,3,3,4,2,0,0,4,4
401084639,Rider Broncs,A. Gilbert,3911886,,False,17.0,3,9,1,3,2,6,1,3,1,2,3,0,0,1,3,1,9
401084639,Rider Broncs,TEAM,TOTAL,TOTAL,False,,27,69,20,52,7,17,9,24,16,31,47,15,6,1,17,32,70
401084620,UConn Huskies,T. Polley,4278230,,True,27.0,1,4,0,0,1,4,5,6,1,2,3,2,1,1,1,0,8
401084620,UConn Huskies,J. Carlton,4278229,,True,20.0,5,6,5,6,0,0,1,2,5,0,5,0,1,4,0,2,11
401084620,UConn Huskies,C. Vital,4066443,,True,32.0,4,10,3,5,1,5,4,5,1,7,8,2,7,0,3,2,13
401084620,UConn Huskies,A. Gilbert,4066441,,True,26.0,3,9,1,3,2,6,4,5,0,3,3,4,0,0,5,3,12
401084620,UConn Huskies,J. Adams,3934622,,True,22.0,1,4,1,2,0,2,0,0,0,2,2,2,1,0,4,3,2
401084620,UConn Huskies,K. Williams,4278232,,False,2.0,0,1,0,1,0,0,0,0,1,0,1,0,0,0,0,0,0
401084620,UConn Huskies,I. Whaley,4278231,,False,2.0,0,0,0,0,0,0,0,0,0,1,1,0,0,0,0,2,0
401084620,UConn Huskies,K. Yakwe,3938920,,False,13.0,0,1,0,1,0,0,0,2,0,3,3,0,0,2,0,2,0
401084620,UConn Huskies,E. Cobb,3923248,,False,5.0,0,2,0,2,0,0,0,0,0,2,2,0,0,0,0,1,0
401084620,UConn Huskies,S. Wilson,4278233,,False,14.0,3,7,3,5,0,2,0,0,1,0,1,0,1,1,1,1,6
401084620,UConn Huskies,B. Adams,4396612,,False,10.0,0,3,0,1,0,2,0,2,1,1,2,2,0,0,1,1,0
401084620,UConn Huskies,T. Aiyegbusi,4076548,,False,0.0,0,0,0,0,0,0,0,0,0,0,0,0,0,0,0,1,0
401084620,UConn Huskies,T. Smith,3136501,,False,27.0,4,9,4,7,0,2,1,2,0,5,5,2,1,1,2,0,9
401084620,UConn Huskies,TEAM,TOTAL,TOTAL,False,,21,56,17,33,4,23,15,24,14,26,40,14,12,9,17,18,61
401084620,Manhattan Jaspers,P. Paulicap,4279706,,True,19.0,2,5,2,5,0,0,0,2,1,1,2,0,1,0,1,4,4
401084620,Manhattan Jaspers,E. Ebube,4279705,,True,17.0,0,3,0,1,0,2,0,0,0,3,3,0,0,1,1,0,0
401084620,Manhattan Jaspers,T. Greene,4398108,,True,25.0,4,8,3,6,1,2,0,1,1,3,4,0,1,1,3,2,9
401084620,Manhattan Jaspers,N. Mack,4279703,,True,22.0,3,5,1,3,2,2,0,0,0,0,0,3,2,0,3,4,8
401084620,Manhattan Jaspers,T. Capuano,3948706,,True,29.0,0,4,0,1,0,3,2,3,0,4,4,3,2,0,2,1,2
401084620,Manhattan Jaspers,T. Reynolds,4398107,,False,9.0,1,2,0,0,1,2,0,0,2,2,4,0,0,0,2,0,3
401084620,Manhattan Jaspers,W. Williams,4279701,,False,19.0,4,7,4,7,0,0,2,2,1,5,6,0,0,0,4,3,10
401084620,Manhattan Jaspers,I. Diallo,3149898,,False,1.0,0,0,0,0,0,0,0,0,0,0,0,0,0,0,0,0,0
401084620,Manhattan Jaspers,C. Hinckson,4398106,,False,8.0,0,1,0,1,0,0,1,2,1,1,2,0,1,0,1,0,1
401084620,Manhattan Jaspers,S. Stewart,4398104,,False,17.0,0,6,0,2,0,4,0,0,0,1,1,2,1,0,1,1,0
401084620,Manhattan Jaspers,E. Buchanan,4398103,,False,10.0,1,2,1,2,0,0,0,0,0,0,0,0,1,0,0,5,2
401084620,Manhattan Jaspers,E. Lasko,4277944,,False,3.0,0,1,0,0,0,1,2,2,0,0,0,0,0,0,0,1,2
401084620,Manhattan Jaspers,S. Usilo,3138468,,False,21.0,2,5,1,3,1,2,0,0,1,5,6,2,1,0,4,2,5
401084620,Manhattan Jaspers,TEAM,TOTAL,TOTAL,False,,17,49,12,31,5,18,7,12,10,27,37,10,10,2,24,23,46
401083943,Quinnipiac Bobcats,J. Rigoni,4279743,,True,29.0,5,12,1,2,4,10,1,2,1,3,4,0,0,2,2,4,15
401083943,Quinnipiac Bobcats,K. Marfo,4066877,,True,10.0,1,2,1,2,0,0,4,6,2,1,3,0,0,0,0,2,6
401083943,Quinnipiac Bobcats,T. Williams,4398399,,True,37.0,5,10,3,7,2,3,0,0,1,5,6,4,1,0,2,3,12
401083943,Quinnipiac Bobcats,R. Kelly,4279741,,True,32.0,4,9,2,6,2,3,2,2,3,1,4,6,0,0,6,0,12
401083943,Quinnipiac Bobcats,C. Young,4070684,,True,25.0,5,10,3,4,2,6,2,2,0,1,1,1,1,0,2,5,14
401083943,Quinnipiac Bobcats,A. Bundu,3947028,,False,27.0,5,6,5,6,0,0,2,3,2,3,5,1,3,0,0,0,12
401083943,Quinnipiac Bobcats,T. Atson,4066478,,False,15.0,3,4,1,1,2,3,2,2,1,3,4,0,0,0,0,2,10
401083943,Quinnipiac Bobcats,A. Robinson,3947024,,False,25.0,1,5,1,1,0,4,0,0,0,1,1,3,0,0,0,2,2
401083943,Quinnipiac Bobcats,TEAM,TOTAL,TOTAL,False,,29,58,17,29,12,29,13,17,10,18,28,15,5,2,16,18,83
401083943,Drexel Dragons,T. Perry Jr.,4279196,,True,15.0,1,1,1,1,0,0,0,0,1,2,3,0,0,0,3,5,2
401083943,Drexel Dragons,J. Butler,4067138,,True,28.0,6,9,6,8,0,1,0,0,2,3,5,1,1,0,0,4,12
401083943,Drexel Dragons,C. Wynter,4397427,,True,38.0,8,14,8,13,0,1,2,4,1,6,7,6,4,0,3,3,18
401083943,Drexel Dragons,T. John,3137243,,True,36.0,3,6,1,2,2,4,0,0,0,1,1,1,2,0,0,2,8
401083943,Drexel Dragons,T. Harper,3129896,,True,34.0,7,14,7,13,0,1,5,5,0,3,3,2,2,0,2,2,19
401083943,Drexel Dragons,A. Demir,4279197,,False,28.0,11,15,10,13,1,2,3,3,0,4,4,1,0,0,2,3,26
401083943,Drexel Dragons,J. Doles,4279195,,False,9.0,2,4,0,2,2,2,0,0,1,0,1,1,0,0,0,0,6
401083943,Drexel Dragons,M. Juric,4397428,,False,9.0,0,0,0,0,0,0,1,2,0,0,0,0,0,0,0,1,1
401083943,Drexel Dragons,C. Washington,4397425,,False,3.0,0,0,0,0,0,0,0,0,0,0,0,0,0,0,0,0,0
401083943,Drexel Dragons,TEAM,TOTAL,TOTAL,False,,38,63,33,52,5,11,11,14,5,19,24,12,9,0,10,20,92
401083908,Saint Peter's Peacocks,S. Idowu,3922042,,True,24.0,5,11,4,8,1,3,4,4,0,0,0,0,1,3,2,4,15
401083908,Saint Peter's Peacocks,M. Dixon,4279758,,True,32.0,1,8,1,5,0,3,4,4,1,3,4,2,4,1,1,2,6
401083908,Saint Peter's Peacocks,Q. Taylor,4067357,,True,31.0,1,5,1,4,0,1,0,0,3,3,6,0,1,0,0,3,2
401083908,Saint Peter's Peacocks,D. Turner,4067356,,True,32.0,9,18,7,14,2,4,3,4,3,4,7,2,4,1,3,5,23
401083908,Saint Peter's Peacocks,C. Jones,3922043,,True,36.0,5,11,2,3,3,8,0,0,0,2,2,2,1,0,2,2,13
401083908,Saint Peter's Peacocks,K. Ndefo,4398386,,False,28.0,5,10,5,9,0,1,1,4,2,4,6,0,1,3,4,4,11
401083908,Saint Peter's Peacocks,M. Ndiaye,3922044,,False,8.0,0,1,0,0,0,1,0,0,1,2,3,0,0,0,2,2,0
401083908,Saint Peter's Peacocks,M. Majak,4398387,,False,7.0,0,0,0,0,0,0,0,0,1,0,1,0,0,0,1,2,0
401083908,Saint Peter's Peacocks,K. Brown,4398385,,False,5.0,0,0,0,0,0,0,0,0,0,0,0,0,0,0,1,0,0
401083908,Saint Peter's Peacocks,D. Watson,4398384,,False,22.0,2,5,1,2,1,3,0,0,0,1,1,5,0,0,0,1,5
401083908,Saint Peter's Peacocks,TEAM,TOTAL,TOTAL,False,,28,69,21,45,7,24,12,16,15,21,36,11,12,8,16,25,75
401083908,Delaware Blue Hens,C. Goss,3913552,,True,14.0,3,4,0,0,3,4,0,0,0,0,0,0,1,2,3,3,9
401083908,Delaware Blue Hens,E. Carter,3129938,,True,38.0,4,9,4,9,0,0,10,14,1,7,8,5,0,2,5,5,18
401083908,Delaware Blue Hens,K. Anderson,4279189,,True,40.0,7,14,5,10,2,4,9,11,2,6,8,2,1,0,6,2,25
401083908,Delaware Blue Hens,R. Johnson,3149901,,True,27.0,0,3,0,1,0,2,0,0,0,4,4,1,1,1,1,2,0
401083908,Delaware Blue Hens,D. Bryant,3133839,,True,42.0,3,7,3,5,0,2,0,0,1,4,5,1,1,0,1,3,6
401083908,Delaware Blue Hens,M. Veretto,4397404,,False,34.0,6,10,4,6,2,4,0,0,6,2,8,0,1,1,4,2,14
401083908,Delaware Blue Hens,J. Cushing,4067223,,False,14.0,2,2,0,0,2,2,0,0,0,0,0,1,0,0,2,0,6
401083908,Delaware Blue Hens,I. Horton,4397401,,False,16.0,0,5,0,3,0,2,0,0,0,1,1,1,0,0,1,2,0
401083908,Delaware Blue Hens,TEAM,TOTAL,TOTAL,False,,25,54,16,34,9,20,19,25,11,26,37,11,5,6,23,19,78
401083890,Siena Saints,S. Seymour,4398391,,True,20.0,1,7,0,0,1,7,0,0,0,0,0,0,0,0,0,1,3
401083890,Siena Saints,E. Fisher,3913235,,True,32.0,7,14,7,11,0,3,4,5,2,5,7,1,0,1,1,3,18
401083890,Siena Saints,K. Degnan,3138282,,True,34.0,2,7,0,0,2,7,0,0,1,3,4,0,1,1,1,0,6
401083890,Siena Saints,J. Pickett,4398390,,True,35.0,3,9,1,2,2,7,1,3,0,3,3,4,2,0,3,2,9
401083890,Siena Saints,M. Camper,4279751,,True,14.0,2,3,2,2,0,1,0,0,2,3,5,1,1,0,3,3,4
401083890,Siena Saints,D. Tchougang,4398394,,False,3.0,1,1,1,1,0,0,0,0,0,0,0,0,0,0,0,0,2
401083890,Siena Saints,G. Darwiche,4398393,,False,18.0,2,4,1,1,1,3,0,0,2,0,2,1,0,0,2,4,5
401083890,Siena Saints,J. Ratliff,4398392,,False,29.0,2,7,0,0,2,7,0,0,1,0,1,0,0,1,1,0,6
401083890,Siena Saints,P. Morastoni,4293127,,False,4.0,0,0,0,0,0,0,0,0,0,0,0,1,0,0,0,0,0
401083890,Siena Saints,K. Smithen,3133848,,False,11.0,1,2,0,1,1,1,2,2,0,1,1,1,1,1,0,1,5
401083890,Siena Saints,TEAM,TOTAL,TOTAL,False,,21,54,12,18,9,36,7,10,8,16,24,9,5,4,11,14,58
401083890,Charleston Cougars,J. Brantley,3912292,,True,20.0,8,8,3,3,5,5,2,2,0,5,5,3,1,1,1,2,23
401083890,Charleston Cougars,N. Harris,3129936,,True,22.0,2,5,2,5,0,0,2,2,2,2,4,0,2,0,0,0,6
401083890,Charleston Cougars,Z. Jasper,4311618,,True,29.0,3,5,2,3,1,2,1,1,0,3,3,1,1,0,0,1,8
401083890,Charleston Cougars,B. Galloway,4067219,,True,23.0,6,8,4,4,2,4,0,1,2,2,4,0,2,0,1,2,14
401083890,Charleston Cougars,G. Riller,3912295,,True,28.0,8,14,7,11,1,3,2,3,0,1,1,0,0,0,3,0,19
401083890,Charleston Cougars,I. Moore,4397384,,False,7.0,0,0,0,0,0,0,0,0,0,0,0,0,1,0,1,0,0
401083890,Charleston Cougars,S. Miller,4397383,,False,9.0,1,1,0,0,1,1,0,2,0,1,1,0,0,0,0,0,3
401083890,Charleston Cougars,J. McManus,4067220,,False,22.0,2,5,2,4,0,1,0,0,1,7,8,0,0,0,1,1,4
401083890,Charleston Cougars,O. Smart,4067221,,False,3.0,0,0,0,0,0,0,0,0,0,0,0,0,0,0,0,0,0
401083890,Charleston Cougars,J. Richard,4397382,,False,14.0,2,2,2,2,0,0,2,2,0,3,3,1,0,1,0,1,6
401083890,Charleston Cougars,M. Pointer,3912294,,False,23.0,0,4,0,3,0,1,0,0,1,1,2,4,0,0,2,3,0
401083890,Charleston Cougars,TEAM,TOTAL,TOTAL,False,,32,52,22,35,10,17,9,13,7,26,33,9,7,2,9,10,83
401083862,Manhattan Jaspers,T. Reynolds,4398107,,True,19.0,3,7,0,0,3,7,0,0,0,4,4,3,0,1,1,0,9
401083862,Manhattan Jaspers,P. Paulicap,4279706,,True,11.0,1,4,1,4,0,0,0,0,1,0,1,0,0,0,0,2,2
401083862,Manhattan Jaspers,T. Greene,4398108,,True,19.0,1,6,0,2,1,4,0,2,0,1,1,1,0,0,1,0,3
401083862,Manhattan Jaspers,C. Hinckson,4398106,,True,14.0,1,4,1,4,0,0,0,0,1,2,3,2,0,0,0,1,2
401083862,Manhattan Jaspers,N. Mack,4279703,,True,31.0,0,2,0,0,0,2,2,2,1,0,1,3,0,0,2,1,2
401083862,Manhattan Jaspers,E. Ebube,4279705,,False,25.0,4,11,4,10,0,1,2,4,1,3,4,2,1,0,2,3,10
401083862,Manhattan Jaspers,W. Williams,4279701,,False,29.0,5,10,5,10,0,0,0,3,5,2,7,0,0,0,2,2,10
401083862,Manhattan Jaspers,S. Stewart,4398104,,False,14.0,2,4,0,1,2,3,0,0,0,0,0,1,0,0,0,5,6
401083862,Manhattan Jaspers,E. Buchanan,4398103,,False,2.0,0,0,0,0,0,0,1,2,0,0,0,0,0,0,1,1,1
401083862,Manhattan Jaspers,E. Lasko,4277944,,False,11.0,0,0,0,0,0,0,0,0,0,2,2,1,0,0,1,1,0
401083862,Manhattan Jaspers,T. Capuano,3948706,,False,18.0,1,6,0,2,1,4,0,0,0,3,3,0,0,0,0,0,3
401083862,Manhattan Jaspers,S. Usilo,3138468,,False,7.0,0,0,0,0,0,0,2,4,0,0,0,1,0,1,0,2,2
401083862,Manhattan Jaspers,TEAM,TOTAL,TOTAL,False,,18,54,11,33,7,21,7,17,11,18,29,14,1,2,11,18,50
401083862,Hofstra Pride,J. Taylor,3136992,,True,27.0,2,2,2,2,0,0,0,0,0,5,5,0,1,1,2,3,4
401083862,Hofstra Pride,E. Pemberton,4067241,,True,31.0,2,5,1,4,1,1,0,0,0,3,3,5,0,0,3,3,5
401083862,Hofstra Pride,T. Coburn,4066515,,True,30.0,7,10,4,5,3,5,5,6,2,8,10,1,1,0,2,3,22
401083862,Hofstra Pride,D. Buie,3911567,,True,35.0,6,13,5,10,1,3,5,5,1,4,5,6,3,0,1,3,18
401083862,Hofstra Pride,J. Wright-Foreman,3911566,,True,35.0,4,8,2,4,2,4,4,5,0,5,5,2,0,0,1,0,14
401083862,Hofstra Pride,M. Radovic,4279204,,False,2.0,0,0,0,0,0,0,0,0,0,0,0,0,0,0,1,0,0
401083862,Hofstra Pride,K. Schutte,4279205,,False,2.0,0,0,0,0,0,0,0,0,0,1,1,0,0,0,0,1,0
401083862,Hofstra Pride,D. Dwyer,3155745,,False,11.0,1,2,1,2,0,0,2,2,0,2,2,0,0,1,0,2,4
401083862,Hofstra Pride,J. Ray,4279206,,False,25.0,5,8,2,4,3,4,0,0,0,1,1,1,0,0,1,2,13
401083862,Hofstra Pride,C. Klementowicz,4067240,,False,2.0,0,0,0,0,0,0,0,0,0,0,0,0,0,0,0,0,0
401083862,Hofstra Pride,TEAM,TOTAL,TOTAL,False,,27,48,17,31,10,17,16,18,4,31,35,15,5,2,11,17,80
401083861,Rider Broncs,D. Vaughn,4067347,,True,36.0,6,11,5,8,1,3,3,6,2,3,5,4,1,1,0,1,16
401083861,Rider Broncs,T. Marshall,4067348,,True,23.0,3,5,3,5,0,0,1,2,1,2,3,1,1,0,3,3,7
401083861,Rider Broncs,S. Jordan,4067349,,True,30.0,7,10,5,6,2,4,1,2,0,2,2,2,2,0,4,4,17
401083861,Rider Broncs,J. Allen,4067345,,True,32.0,3,7,0,0,3,7,0,0,0,1,1,1,1,0,1,3,9
401083861,Rider Broncs,A. Durham,3138490,,True,32.0,2,6,0,2,2,4,2,4,1,3,4,2,0,0,1,4,8
401083861,Rider Broncs,D. Eke,3941312,,False,6.0,0,0,0,0,0,0,0,1,0,0,0,0,0,1,1,2,0
401083861,Rider Broncs,F. Scott,3922033,,False,18.0,3,4,2,3,1,1,2,5,1,1,2,2,0,1,0,1,9
401083861,Rider Broncs,K. Williams,3946983,,False,14.0,2,2,2,2,0,0,0,0,0,0,0,3,0,0,3,3,4
401083861,Rider Broncs,A. Gilbert,3911886,,False,9.0,1,2,0,0,1,2,0,0,0,0,0,3,0,0,0,3,3
401083861,Rider Broncs,TEAM,TOTAL,TOTAL,False,,27,47,17,26,10,21,9,20,5,12,17,18,5,3,13,24,73
401083861,Hofstra Pride,J. Taylor,3136992,,True,20.0,4,6,4,6,0,0,0,1,2,4,6,1,1,1,1,3,8
401083861,Hofstra Pride,E. Pemberton,4067241,,True,37.0,3,8,3,5,0,3,6,7,5,2,7,5,1,0,2,2,12
401083861,Hofstra Pride,T. Coburn,4066515,,True,34.0,6,10,4,6,2,4,5,6,4,4,8,2,0,0,0,2,19
401083861,Hofstra Pride,D. Buie,3911567,,True,32.0,4,8,2,3,2,5,4,4,1,1,2,6,2,0,1,1,14
401083861,Hofstra Pride,J. Wright-Foreman,3911566,,True,40.0,10,19,7,9,3,10,1,1,0,2,2,6,0,0,3,1,24
401083861,Hofstra Pride,S. Trueheart,4067243,,False,6.0,0,1,0,0,0,1,0,0,0,1,1,0,0,0,0,1,0
401083861,Hofstra Pride,D. Dwyer,3155745,,False,20.0,2,2,2,2,0,0,2,2,2,5,7,1,0,0,1,5,6
401083861,Hofstra Pride,J. Ray,4279206,,False,11.0,2,4,0,1,2,3,0,0,1,1,2,1,1,0,2,0,6
401083861,Hofstra Pride,TEAM,TOTAL,TOTAL,False,,31,58,22,32,9,26,18,21,15,20,35,22,5,1,11,15,89
401083860,Monmouth Hawks,N. Rutty,4398408,,True,22.0,1,3,1,3,0,0,0,0,2,2,4,0,1,0,2,3,2
401083860,Monmouth Hawks,M. Traore,3975762,,True,32.0,3,5,3,5,0,0,3,3,2,3,5,2,1,0,2,0,9
401083860,Monmouth Hawks,M. McClary,4279736,,True,21.0,1,1,1,1,0,0,0,0,1,0,1,2,0,0,1,3,2
401083860,Monmouth Hawks,D. Hammond,4279734,,True,19.0,5,11,1,3,4,8,0,0,0,2,2,2,1,0,2,4,14
401083860,Monmouth Hawks,R. Salnave,4067329,,True,40.0,8,15,5,7,3,8,3,5,0,5,5,7,3,0,4,2,22
401083860,Monmouth Hawks,S. Ibiezugbe,4067330,,False,6.0,1,1,1,1,0,0,0,0,1,1,2,0,0,0,0,1,2
401083860,Monmouth Hawks,D. Quinn,3948714,,False,20.0,5,8,5,8,0,0,3,4,3,3,6,0,0,2,1,1,13
401083860,Monmouth Hawks,M. Martin,4279733,,False,2.0,0,0,0,0,0,0,0,0,0,0,0,0,0,0,0,0,0
401083860,Monmouth Hawks,L. Pillari,3948713,,False,21.0,4,7,3,5,1,2,0,0,0,1,1,2,0,0,1,2,9
401083860,Monmouth Hawks,N. Rutherford,3946977,,False,17.0,0,4,0,3,0,1,0,0,0,2,2,2,1,0,1,1,0
401083860,Monmouth Hawks,TEAM,TOTAL,TOTAL,False,,28,55,20,36,8,19,9,12,10,19,29,17,7,2,15,17,73
401083860,Hofstra Pride,S. Trueheart,4067243,,True,12.0,3,5,1,2,2,3,0,0,2,2,4,0,2,0,0,1,8
401083860,Hofstra Pride,J. Taylor,3136992,,True,26.0,1,2,1,2,0,0,1,1,3,6,9,0,1,3,4,2,3
401083860,Hofstra Pride,E. Pemberton,4067241,,True,38.0,3,10,2,6,1,4,7,8,3,1,4,3,0,0,1,1,14
401083860,Hofstra Pride,D. Buie,3911567,,True,32.0,3,4,0,0,3,4,0,0,0,0,0,6,1,0,3,1,9
401083860,Hofstra Pride,J. Wright-Foreman,3911566,,True,40.0,10,23,6,15,4,8,6,10,1,6,7,4,0,2,3,2,30
401083860,Hofstra Pride,D. Dwyer,3155745,,False,14.0,0,1,0,1,0,0,0,0,0,1,1,0,1,1,0,2,0
401083860,Hofstra Pride,J. Ray,4279206,,False,11.0,1,1,0,0,1,1,2,2,0,0,0,0,0,0,2,0,5
401083860,Hofstra Pride,T. Coburn,4066515,,False,27.0,1,3,0,0,1,3,3,5,0,2,2,1,2,0,1,3,6
401083860,Hofstra Pride,TEAM,TOTAL,TOTAL,False,,22,49,10,26,12,23,19,26,9,18,27,14,7,6,14,12,75
401083858,Siena Saints,S. Seymour,4398391,,True,27.0,4,14,1,1,3,13,2,2,0,1,1,1,0,0,0,0,13
401083858,Siena Saints,E. Fisher,3913235,,True,33.0,12,17,12,17,0,0,1,3,2,5,7,2,0,1,0,1,25
401083858,Siena Saints,K. Degnan,3138282,,True,32.0,3,6,0,0,3,6,1,2,3,5,8,1,0,2,1,5,10
401083858,Siena Saints,J. Pickett,4398390,,True,38.0,9,12,7,9,2,3,7,9,3,2,5,13,2,0,1,4,27
401083858,Siena Saints,M. Camper,4279751,,True,21.0,1,3,0,1,1,2,0,0,0,2,2,1,0,0,4,1,3
401083858,Siena Saints,S. Friday IV,4067353,,False,12.0,3,5,3,5,0,0,2,5,0,0,0,0,0,0,3,4,8
401083858,Siena Saints,T. Huerter Jr.,4067350,,False,7.0,0,0,0,0,0,0,0,0,0,0,0,0,0,0,1,0,0
401083858,Siena Saints,G. Darwiche,4398393,,False,4.0,0,0,0,0,0,0,0,0,0,0,0,0,0,0,1,2,0
401083858,Siena Saints,J. Ratliff,4398392,,False,24.0,0,1,0,0,0,1,0,0,0,1,1,0,0,0,0,3,0
401083858,Siena Saints,B. Bayer,4065720,,False,2.0,0,1,0,0,0,1,0,0,0,0,0,0,1,1,0,0,0
401083858,Siena Saints,K. Smithen,3133848,,False,0.0,0,0,0,0,0,0,0,0,0,0,0,0,0,0,0,0,0
401083858,Siena Saints,TEAM,TOTAL,TOTAL,False,,32,59,23,33,9,26,13,21,8,16,24,18,3,4,12,20,86
401083858,Hofstra Pride,S. Trueheart,4067243,,True,11.0,1,3,0,1,1,2,0,0,1,0,1,1,0,0,0,2,3
401083858,Hofstra Pride,J. Taylor,3136992,,True,11.0,1,1,1,1,0,0,0,0,0,5,5,0,0,1,0,1,2
401083858,Hofstra Pride,E. Pemberton,4067241,,True,37.0,6,11,4,7,2,4,5,8,0,2,2,1,3,0,2,3,19
401083858,Hofstra Pride,D. Buie,3911567,,True,33.0,3,6,2,5,1,1,6,6,0,0,0,4,2,0,3,2,13
401083858,Hofstra Pride,J. Wright-Foreman,3911566,,True,38.0,12,19,10,14,2,5,2,2,0,0,0,4,1,0,2,2,28
401083858,Hofstra Pride,D. Dwyer,3155745,,False,28.0,2,3,2,3,0,0,5,6,1,6,7,1,0,3,1,3,9
401083858,Hofstra Pride,J. Ray,4279206,,False,22.0,2,4,2,3,0,1,4,4,0,2,2,1,1,0,0,3,8
401083858,Hofstra Pride,T. Coburn,4066515,,False,20.0,4,10,3,8,1,2,3,3,6,8,14,0,0,0,0,2,12
401083858,Hofstra Pride,TEAM,TOTAL,TOTAL,False,,31,57,24,42,7,15,25,29,8,23,31,12,7,4,8,18,94
401083457,West Virginia Mountaineers,E. Ahmad,3947257,,True,27.0,6,14,5,12,1,2,3,7,5,2,7,2,3,1,3,3,16
401083457,West Virginia Mountaineers,L. Routt,3947256,,True,14.0,2,3,2,3,0,0,3,4,5,3,8,1,2,1,0,1,7
401083457,West Virginia Mountaineers,W. Harris,4277933,,True,29.0,3,12,3,8,0,4,3,4,3,5,8,1,0,1,0,4,9
401083457,West Virginia Mountaineers,C. Harler,4066331,,True,30.0,4,7,2,2,2,5,1,2,0,0,0,2,0,0,0,0,11
401083457,West Virginia Mountaineers,J. Bolden,3913554,,True,13.0,4,7,1,2,3,5,1,2,1,0,1,2,1,0,4,1,12
401083457,West Virginia Mountaineers,E. Matthews Jr.,4397099,,False,19.0,3,5,3,5,0,0,5,7,0,3,3,2,0,0,0,2,11
401083457,West Virginia Mountaineers,A. Gordon,4397096,,False,6.0,0,1,0,1,0,0,0,0,0,1,1,0,0,0,0,1,0
401083457,West Virginia Mountaineers,L. West,3913555,,False,24.0,6,13,2,3,4,10,4,5,2,5,7,1,1,1,0,1,20
401083457,West Virginia Mountaineers,J. McCabe,4397100,,False,18.0,0,4,0,2,0,2,1,2,1,1,2,8,1,0,3,1,1
401083457,West Virginia Mountaineers,J. Haley,4397097,,False,10.0,1,2,1,1,0,1,0,0,0,1,1,0,0,0,1,0,2
401083457,West Virginia Mountaineers,B. Knapper,4277935,,False,10.0,1,2,0,1,1,1,0,0,0,2,2,2,1,0,3,1,3
401083457,West Virginia Mountaineers,TEAM,TOTAL,TOTAL,False,,30,70,19,40,11,30,21,33,20,26,46,21,9,4,14,15,92
401083457,Rider Broncs,D. Vaughn,4067347,,True,35.0,4,11,3,8,1,3,2,3,0,8,8,3,4,1,2,1,11
401083457,Rider Broncs,T. Marshall,4067348,,True,21.0,1,5,1,5,0,0,2,2,2,1,3,0,0,0,3,4,4
401083457,Rider Broncs,S. Jordan,4067349,,True,29.0,6,8,5,6,1,2,0,0,0,1,1,3,2,0,0,3,13
401083457,Rider Broncs,J. Allen,4067345,,True,30.0,4,11,1,5,3,6,0,0,1,1,2,1,2,0,3,0,11
401083457,Rider Broncs,A. Durham,3138490,,True,24.0,3,8,1,6,2,2,2,2,1,2,3,1,0,0,2,5,10
401083457,Rider Broncs,A. Ogemuno-Johnson,4406151,,False,1.0,1,1,1,1,0,0,0,1,0,0,0,0,0,0,0,0,2
401083457,Rider Broncs,K. Cisse,4279746,,False,3.0,0,1,0,1,0,0,0,0,2,0,2,1,1,0,0,1,0
401083457,Rider Broncs,D. Eke,3941312,,False,9.0,1,1,1,1,0,0,0,2,1,2,3,0,0,1,0,2,2
401083457,Rider Broncs,F. Scott,3922033,,False,26.0,7,12,6,9,1,3,2,4,4,2,6,0,0,0,2,1,17
401083457,Rider Broncs,K. Williams,3946983,,False,21.0,3,8,3,8,0,0,2,2,1,3,4,2,0,0,3,4,8
401083457,Rider Broncs,A. Gilbert,3911886,,False,1.0,0,0,0,0,0,0,0,0,0,0,0,0,0,0,0,1,0
401083457,Rider Broncs,TEAM,TOTAL,TOTAL,False,,30,66,22,50,8,16,10,16,12,24,36,11,9,2,15,23,78
401083455,West Virginia Mountaineers,S. Konate,4066333,,True,26.0,4,11,3,6,1,5,5,7,1,7,8,3,1,4,3,2,14
401083455,West Virginia Mountaineers,E. Ahmad,3947257,,True,22.0,5,9,4,6,1,3,5,7,2,1,3,2,1,1,5,4,16
401083455,West Virginia Mountaineers,L. West,3913555,,True,23.0,0,2,0,1,0,1,0,0,0,1,1,1,1,0,2,0,0
401083455,West Virginia Mountaineers,C. Harler,4066331,,True,33.0,2,5,1,2,1,3,0,0,1,1,2,1,0,3,0,1,5
401083455,West Virginia Mountaineers,J. Bolden,3913554,,True,27.0,3,8,3,3,0,5,3,5,0,3,3,3,2,0,2,3,9
401083455,West Virginia Mountaineers,E. Matthews Jr.,4397099,,False,4.0,0,1,0,0,0,1,0,0,0,2,2,1,0,0,0,0,0
401083455,West Virginia Mountaineers,A. Gordon,4397096,,False,6.0,1,2,1,2,0,0,1,2,0,0,0,0,0,0,0,2,3
401083455,West Virginia Mountaineers,L. Routt,3947256,,False,8.0,2,2,2,2,0,0,1,4,1,0,1,0,0,0,0,2,5
401083455,West Virginia Mountaineers,W. Harris,4277933,,False,20.0,1,2,0,0,1,2,2,2,1,3,4,1,3,0,2,3,5
401083455,West Virginia Mountaineers,J. McCabe,4397100,,False,16.0,2,3,0,0,2,3,3,4,0,3,3,0,0,0,1,1,9
401083455,West Virginia Mountaineers,T. Horton,4397098,,False,2.0,0,0,0,0,0,0,1,2,0,0,0,0,0,0,0,0,1
401083455,West Virginia Mountaineers,J. Haley,4397097,,False,12.0,1,1,1,1,0,0,2,4,1,1,2,0,0,0,1,1,4
401083455,West Virginia Mountaineers,B. Knapper,4277935,,False,1.0,0,0,0,0,0,0,0,0,0,0,0,1,0,0,2,0,0
401083455,West Virginia Mountaineers,TEAM,TOTAL,TOTAL,False,,21,46,15,23,6,23,23,37,12,27,39,13,8,8,18,19,71
401083455,Monmouth Hawks,M. Traore,3975762,,True,14.0,3,4,3,4,0,0,0,0,1,0,1,0,1,0,0,2,6
401083455,Monmouth Hawks,D. Hammond,4279734,,True,24.0,3,8,1,3,2,5,2,4,0,0,0,1,0,0,1,3,10
401083455,Monmouth Hawks,R. Salnave,4067329,,True,10.0,1,2,1,2,0,0,0,0,1,2,3,0,0,0,4,5,2
401083455,Monmouth Hawks,L. Pillari,3948713,,True,31.0,3,9,1,3,2,6,0,1,1,4,5,3,1,1,4,3,8
401083455,Monmouth Hawks,N. Rutherford,3946977,,True,36.0,3,8,2,6,1,2,2,4,0,4,4,7,5,0,6,2,9
401083455,Monmouth Hawks,N. Rutty,4398408,,False,11.0,1,1,1,1,0,0,2,2,2,2,4,0,0,1,1,2,4
401083455,Monmouth Hawks,S. Ibiezugbe,4067330,,False,7.0,0,3,0,3,0,0,1,2,1,1,2,0,0,0,0,1,1
401083455,Monmouth Hawks,D. Quinn,3948714,,False,8.0,1,2,1,2,0,0,0,0,1,2,3,0,0,0,1,2,2
401083455,Monmouth Hawks,M. Martin,4279733,,False,18.0,1,3,1,3,0,0,0,0,1,2,3,0,1,0,0,3,2
401083455,Monmouth Hawks,S. Chaput,4398409,,False,6.0,0,1,0,1,0,0,0,0,0,0,0,0,0,0,1,1,0
401083455,Monmouth Hawks,D. Calloway Jr.,4398407,,False,2.0,1,2,0,0,1,2,0,0,0,0,0,0,0,0,0,1,3
401083455,Monmouth Hawks,M. McClary,4279736,,False,8.0,0,3,0,3,0,0,0,0,2,0,2,1,0,0,0,3,0
401083455,Monmouth Hawks,G. Papas,4279735,,False,24.0,1,5,0,2,1,3,3,5,0,2,2,1,2,0,0,1,6
401083455,Monmouth Hawks,T. Gross Jr.,4065729,,False,1.0,0,0,0,0,0,0,0,0,0,0,0,0,0,0,0,0,0
401083455,Monmouth Hawks,TEAM,TOTAL,TOTAL,False,,18,51,11,33,7,18,10,18,11,21,32,13,10,2,18,29,53
401083353,Villanova Wildcats,S. Bey,4397136,,True,31.0,5,11,4,6,1,5,0,0,2,6,8,0,1,1,1,1,11
401083353,Villanova Wildcats,D. Cosby-Roundtree,4278586,,True,29.0,6,7,6,7,0,0,3,4,8,5,13,1,3,1,1,4,15
401083353,Villanova Wildcats,E. Paschall,3133817,,True,27.0,3,8,2,2,1,6,0,0,3,3,6,2,1,0,1,3,7
401083353,Villanova Wildcats,C. Gillespie,4278585,,True,21.0,2,4,1,2,1,2,2,3,0,1,1,1,1,0,0,4,7
401083353,Villanova Wildcats,P. Booth,3147656,,True,21.0,5,8,4,6,1,2,4,7,1,3,4,1,0,0,3,2,15
401083353,Villanova Wildcats,C. Swider,4397134,,False,18.0,3,7,0,0,3,7,2,2,0,2,2,1,0,0,1,2,11
401083353,Villanova Wildcats,B. Slater,4397133,,False,5.0,0,1,0,0,0,1,0,0,0,0,0,0,1,0,0,2,0
401083353,Villanova Wildcats,J. Samuels Jr.,4278588,,False,8.0,0,2,0,0,0,2,0,0,1,4,5,2,0,1,2,1,0
401083353,Villanova Wildcats,T. Delaney,3934674,,False,1.0,0,0,0,0,0,0,0,0,0,1,1,0,0,0,0,0,0
401083353,Villanova Wildcats,J. Quinerly,4397132,,False,15.0,3,5,2,3,1,2,2,2,1,2,3,2,0,0,4,0,9
401083353,Villanova Wildcats,J. Cremo,3918721,,False,24.0,2,7,0,3,2,4,2,2,1,4,5,2,1,0,1,1,8
401083353,Villanova Wildcats,TEAM,TOTAL,TOTAL,False,,29,60,19,29,10,31,15,20,18,33,51,12,8,3,17,20,83
401083353,Canisius Golden Griffins,S. Hitchon,4279482,,True,22.0,0,1,0,1,0,0,1,2,0,1,1,1,0,1,1,0,1
401083353,Canisius Golden Griffins,J. White,4279478,,True,14.0,2,3,2,3,0,0,0,1,0,1,1,0,0,1,0,2,4
401083353,Canisius Golden Griffins,T. Molson,4279481,,True,36.0,3,15,2,10,1,5,3,3,2,1,3,4,3,0,3,0,10
401083353,Canisius Golden Griffins,I. Reese,4067278,,True,28.0,6,17,2,8,4,9,3,3,1,6,7,3,1,0,3,5,19
401083353,Canisius Golden Griffins,M. Johnson,4067275,,True,29.0,3,9,3,6,0,3,2,2,1,1,2,1,4,1,3,4,8
401083353,Canisius Golden Griffins,K. Johnson-Alls,4398049,,False,15.0,0,1,0,0,0,1,0,0,1,1,2,0,0,1,0,1,0
401083353,Canisius Golden Griffins,M. Lotts,4279480,,False,8.0,0,0,0,0,0,0,0,0,0,0,0,0,0,0,0,0,0
401083353,Canisius Golden Griffins,D. St. Louis,4067280,,False,12.0,1,2,1,2,0,0,4,4,1,1,2,0,0,0,2,1,6
401083353,Canisius Golden Griffins,J. Faulkner,3137250,,False,15.0,2,3,2,2,0,1,1,1,0,0,0,1,1,0,1,1,5
401083353,Canisius Golden Griffins,S. Rautins,4398047,,False,1.0,0,0,0,0,0,0,0,0,0,0,0,0,0,0,0,0,0
401083353,Canisius Golden Griffins,J. Henderson,4398046,,False,1.0,0,0,0,0,0,0,0,1,0,0,0,0,0,0,0,0,0
401083353,Canisius Golden Griffins,J. Sanks,3141259,,False,19.0,1,4,0,0,1,4,0,0,0,0,0,1,0,0,1,4,3
401083353,Canisius Golden Griffins,TEAM,TOTAL,TOTAL,False,,18,55,12,32,6,23,14,17,7,17,24,11,9,4,14,18,56
401083351,Villanova Wildcats,D. Cosby-Roundtree,4278586,,True,16.0,3,4,3,4,0,0,0,0,2,3,5,0,0,3,1,1,6
401083351,Villanova Wildcats,E. Paschall,3133817,,True,20.0,4,6,4,4,0,2,3,5,3,5,8,3,0,0,3,3,11
401083351,Villanova Wildcats,C. Gillespie,4278585,,True,22.0,6,9,2,3,4,6,0,0,0,2,2,1,2,0,0,2,16
401083351,Villanova Wildcats,J. Cremo,3918721,,True,25.0,3,6,1,1,2,5,0,0,1,3,4,4,0,0,1,2,8
401083351,Villanova Wildcats,P. Booth,3147656,,True,30.0,7,16,4,10,3,6,6,6,1,2,3,5,2,1,0,0,23
401083351,Villanova Wildcats,S. Bey,4397136,,False,22.0,3,4,2,3,1,1,1,2,3,3,6,2,0,2,1,0,8
401083351,Villanova Wildcats,C. Swider,4397134,,False,11.0,0,5,0,3,0,2,0,0,0,2,2,2,1,0,0,5,0
401083351,Villanova Wildcats,B. Slater,4397133,,False,7.0,1,2,1,1,0,1,0,0,4,0,4,0,0,0,0,2,2
401083351,Villanova Wildcats,J. Samuels Jr.,4278588,,False,26.0,3,8,2,4,1,4,0,1,3,4,7,2,0,1,1,3,7
401083351,Villanova Wildcats,D. Painter,4065840,,False,5.0,1,2,1,2,0,0,0,2,2,1,3,0,0,1,0,0,2
401083351,Villanova Wildcats,J. Quinerly,4397132,,False,16.0,1,6,0,1,1,5,0,0,0,1,1,1,0,0,3,0,3
401083351,Villanova Wildcats,TEAM,TOTAL,TOTAL,False,,32,68,20,36,12,32,10,16,20,30,50,20,5,8,11,18,86
401083351,Quinnipiac Bobcats,J. Rigoni,4279743,,True,30.0,1,4,1,2,0,2,2,2,1,1,2,2,0,1,0,1,4
401083351,Quinnipiac Bobcats,K. Marfo,4066877,,True,21.0,1,4,1,4,0,0,3,4,2,6,8,0,0,0,2,3,5
401083351,Quinnipiac Bobcats,T. Williams,4398399,,True,23.0,2,7,1,4,1,3,0,2,1,5,6,1,1,1,4,4,5
401083351,Quinnipiac Bobcats,C. Young,4070684,,True,35.0,7,18,5,13,2,5,2,3,0,1,1,3,2,1,2,0,18
401083351,Quinnipiac Bobcats,T. Atson,4066478,,True,29.0,4,6,3,4,1,2,2,2,0,3,3,1,0,0,2,2,11
401083351,Quinnipiac Bobcats,A. Bundu,3947028,,False,19.0,3,6,3,6,0,0,0,1,2,1,3,0,1,1,1,2,6
401083351,Quinnipiac Bobcats,T. Pickron,4398400,,False,22.0,0,3,0,0,0,3,1,2,0,0,0,0,0,0,1,1,1
401083351,Quinnipiac Bobcats,A. Robinson,3947024,,False,21.0,1,8,0,2,1,6,0,0,0,1,1,0,1,0,1,4,3
401083351,Quinnipiac Bobcats,TEAM,TOTAL,TOTAL,False,,19,56,14,35,5,21,10,16,10,19,29,7,5,4,13,17,53
401083311,Providence Friars,J. Nichols,4397108,,True,10.0,3,5,3,4,0,1,0,0,2,1,3,1,0,0,1,0,6
401083311,Providence Friars,K. Young,4065814,,True,20.0,2,4,2,4,0,0,0,0,1,6,7,1,0,2,2,3,4
401083311,Providence Friars,A.J. Reeves,4397109,,True,31.0,8,12,4,5,4,7,0,1,2,1,3,1,0,0,1,3,20
401083311,Providence Friars,D. Duke Jr.,4397107,,True,22.0,1,8,1,5,0,3,0,0,1,0,1,5,2,1,3,5,2
401083311,Providence Friars,A. Diallo,4065813,,True,39.0,8,16,7,13,1,3,6,6,4,5,9,2,2,0,3,1,23
401083311,Providence Friars,E. Holt,3147674,,False,6.0,1,2,1,2,0,0,2,3,0,0,0,0,0,0,0,1,4
401083311,Providence Friars,N. Watson,4278573,,False,20.0,4,5,4,5,0,0,5,6,0,2,2,0,0,0,2,2,13
401083311,Providence Friars,M. White,4065812,,False,22.0,2,7,0,3,2,4,0,0,0,1,1,6,0,1,0,0,6
401083311,Providence Friars,I. Jackson,3133821,,False,30.0,4,8,2,4,2,4,3,4,3,3,6,1,2,1,0,2,13
401083311,Providence Friars,TEAM,TOTAL,TOTAL,False,,33,67,24,45,9,22,16,20,14,21,35,17,6,5,12,17,91
401083311,Iona Gaels,N. Nikolic,4398090,,True,31.0,7,7,7,7,0,0,0,0,4,4,8,2,1,0,3,1,14
401083311,Iona Gaels,I. Still,3938908,,True,18.0,0,0,0,0,0,0,1,2,0,1,1,0,0,0,0,0,1
401083311,Iona Gaels,E.J. Crawford,4067295,,True,38.0,8,18,5,11,3,7,2,2,2,3,5,1,1,0,1,2,21
401083311,Iona Gaels,A. Gist,4067164,,True,38.0,6,12,5,7,1,5,7,8,1,4,5,1,1,0,3,3,20
401083311,Iona Gaels,R. McGill,3948698,,True,38.0,5,11,3,5,2,6,2,2,0,4,4,8,1,0,5,4,14
401083311,Iona Gaels,J. Maxwell,4398088,,False,4.0,0,1,0,1,0,0,0,0,0,0,0,0,0,0,0,1,0
401083311,Iona Gaels,T. Agee,4398087,,False,23.0,3,8,3,6,0,2,3,4,0,6,6,3,2,0,3,4,9
401083311,Iona Gaels,A. Ristanovic,4279492,,False,7.0,0,0,0,0,0,0,0,0,0,1,1,0,0,0,0,1,0
401083311,Iona Gaels,B. Perez,3948791,,False,3.0,0,0,0,0,0,0,0,0,0,0,0,0,0,0,0,0,0
401083311,Iona Gaels,TEAM,TOTAL,TOTAL,False,,29,57,23,37,6,20,15,18,7,23,30,15,6,0,15,16,79
401083308,Siena Saints,S. Seymour,4398391,,True,27.0,5,9,0,0,5,9,0,0,1,0,1,0,0,0,2,1,15
401083308,Siena Saints,E. Fisher,3913235,,True,31.0,5,10,5,9,0,1,1,2,1,5,6,3,0,0,2,1,11
401083308,Siena Saints,K. Degnan,3138282,,True,26.0,3,7,0,1,3,6,0,0,2,2,4,0,2,0,0,0,9
401083308,Siena Saints,J. Pickett,4398390,,True,32.0,2,11,1,4,1,7,2,2,0,1,1,9,1,0,2,3,7
401083308,Siena Saints,M. Camper,4279751,,True,18.0,3,3,2,2,1,1,0,0,1,1,2,0,0,0,0,0,7
401083308,Siena Saints,S. Friday IV,4067353,,False,9.0,3,4,3,4,0,0,3,5,0,0,0,0,0,0,2,1,9
401083308,Siena Saints,T. Huerter Jr.,4067350,,False,13.0,0,0,0,0,0,0,0,0,1,1,2,2,0,0,0,1,0
401083308,Siena Saints,G. Darwiche,4398393,,False,9.0,0,2,0,2,0,0,1,2,1,1,2,0,0,0,1,1,1
401083308,Siena Saints,J. Ratliff,4398392,,False,21.0,2,4,0,0,2,4,0,0,1,2,3,1,1,0,1,3,6
401083308,Siena Saints,K. Smithen,3133848,,False,14.0,0,1,0,1,0,0,2,2,0,1,1,1,2,0,2,1,2
401083308,Siena Saints,TEAM,TOTAL,TOTAL,False,,23,51,11,23,12,28,9,13,9,14,23,16,6,0,13,12,67
401083308,Providence Friars,K. Young,4065814,,True,16.0,0,1,0,1,0,0,0,0,0,4,4,2,0,0,0,0,0
401083308,Providence Friars,I. Jackson,3133821,,True,29.0,6,9,3,4,3,5,1,1,2,1,3,4,0,0,1,1,16
401083308,Providence Friars,A.J. Reeves,4397109,,True,30.0,10,13,3,4,7,9,2,2,1,1,2,1,1,1,1,1,29
401083308,Providence Friars,D. Duke Jr.,4397107,,True,20.0,0,5,0,4,0,1,0,0,1,1,2,1,1,0,3,2,0
401083308,Providence Friars,A. Diallo,4065813,,True,32.0,6,11,3,6,3,5,1,2,4,7,11,5,0,0,2,1,16
401083308,Providence Friars,J. Nichols,4397108,,False,5.0,0,0,0,0,0,0,0,0,0,0,0,0,1,0,0,1,0
401083308,Providence Friars,E. Holt,3147674,,False,6.0,0,1,0,1,0,0,0,0,0,0,0,0,0,0,1,0,0
401083308,Providence Friars,N. Watson,4278573,,False,24.0,5,5,5,5,0,0,0,0,2,4,6,2,0,0,1,2,10
401083308,Providence Friars,M. Ashton-Langford,4278574,,False,12.0,2,4,2,2,0,2,0,0,0,0,0,0,0,0,2,3,4
401083308,Providence Friars,M. White,4065812,,False,23.0,0,3,0,0,0,3,2,2,0,1,1,1,1,1,2,1,2
401083308,Providence Friars,D. Edwards,3913217,,False,3.0,0,1,0,1,0,0,0,0,0,0,0,0,0,0,0,1,0
401083308,Providence Friars,TEAM,TOTAL,TOTAL,False,,29,53,16,28,13,25,6,7,11,20,31,16,4,2,15,13,77
401083167,Saint Peter's Peacocks,K. Ndefo,4398386,,True,34.0,3,8,2,6,1,2,5,8,0,5,5,0,0,1,2,3,12
401083167,Saint Peter's Peacocks,S. Idowu,3922042,,True,25.0,2,5,1,3,1,2,0,0,2,3,5,0,0,3,3,3,5
401083167,Saint Peter's Peacocks,D. Watson,4398384,,True,34.0,3,14,2,7,1,7,2,3,2,1,3,6,2,0,5,1,9
401083167,Saint Peter's Peacocks,Q. Taylor,4067357,,True,31.0,1,3,1,3,0,0,2,2,1,3,4,1,0,0,4,4,4
401083167,Saint Peter's Peacocks,D. Turner,4067356,,True,33.0,3,14,1,5,2,9,4,4,0,4,4,0,3,0,6,1,12
401083167,Saint Peter's Peacocks,M. Majak,4398387,,False,15.0,0,2,0,2,0,0,0,0,1,4,5,0,0,0,1,1,0
401083167,Saint Peter's Peacocks,C. Underwood,4398388,,False,4.0,0,0,0,0,0,0,1,2,1,1,2,0,0,1,1,1,1
401083167,Saint Peter's Peacocks,K. Brown,4398385,,False,20.0,2,5,1,3,1,2,1,2,3,3,6,0,3,1,4,4,6
401083167,Saint Peter's Peacocks,A. Hicks,4284295,,False,4.0,0,1,0,1,0,0,0,0,0,0,0,1,1,0,0,1,0
401083167,Saint Peter's Peacocks,TEAM,TOTAL,TOTAL,False,,14,52,8,30,6,22,15,21,14,24,38,8,9,6,26,19,49
401083167,Auburn Tigers,C. Okeke,4278052,,True,22.0,5,5,3,3,2,2,0,0,4,2,6,3,1,2,1,0,12
401083167,Auburn Tigers,A. McLemore,4066253,,True,18.0,8,13,5,8,3,5,0,0,2,3,5,0,3,2,1,3,19
401083167,Auburn Tigers,J. Harper,4066248,,True,27.0,2,8,0,2,2,6,0,0,0,1,1,8,3,0,3,1,6
401083167,Auburn Tigers,S. Doughty,3913188,,True,26.0,1,2,1,1,0,1,0,0,2,4,6,5,1,0,1,2,2
401083167,Auburn Tigers,B. Brown,3908521,,True,25.0,7,11,4,5,3,6,2,4,0,4,4,5,1,0,1,0,19
401083167,Auburn Tigers,M. Parker,4395710,,False,3.0,0,2,0,1,0,1,0,0,0,0,0,0,1,0,0,0,0
401083167,Auburn Tigers,T. Collier,4284066,,False,2.0,0,0,0,0,0,0,0,0,0,0,0,0,0,0,1,1,0
401083167,Auburn Tigers,C. Blackstock,3947519,,False,4.0,0,1,0,1,0,0,1,2,1,1,2,0,0,0,0,0,1
401083167,Auburn Tigers,H. Spencer,3908520,,False,14.0,0,6,0,6,0,0,2,3,2,2,4,1,2,1,2,4,2
401083167,Auburn Tigers,A. Wiley,4078506,,False,18.0,7,13,7,12,0,1,2,4,4,5,9,0,1,3,1,3,16
401083167,Auburn Tigers,C. Maasdorp,4403231,,False,4.0,1,2,0,0,1,2,1,2,0,0,0,0,0,0,0,0,4
401083167,Auburn Tigers,P. Cook,4403230,,False,2.0,1,1,1,1,0,0,0,0,0,1,1,1,1,0,0,0,2
401083167,Auburn Tigers,J. McCormick,4395709,,False,10.0,0,0,0,0,0,0,0,0,0,0,0,1,0,0,0,1,0
401083167,Auburn Tigers,D. Williams,4278054,,False,3.0,0,0,0,0,0,0,0,0,0,0,0,0,0,0,1,1,0
401083167,Auburn Tigers,W. Macoy,4066252,,False,4.0,0,2,0,1,0,1,2,3,0,0,0,0,0,0,0,0,2
401083167,Auburn Tigers,M. Dunbar,60231,,False,18.0,4,9,0,3,4,6,2,2,0,3,3,1,2,0,1,1,14
401083167,Auburn Tigers,TEAM,TOTAL,TOTAL,False,,36,75,21,44,15,31,12,20,19,28,47,25,16,8,13,17,99
401083128,Monmouth Hawks,M. Traore,3975762,,True,9.0,2,4,2,4,0,0,0,0,1,0,1,0,0,0,1,5,4
401083128,Monmouth Hawks,M. McClary,4279736,,True,12.0,2,4,2,4,0,0,0,2,2,1,3,0,1,0,1,2,4
401083128,Monmouth Hawks,D. Hammond,4279734,,True,18.0,0,5,0,1,0,4,0,0,1,0,1,1,0,0,1,2,0
401083128,Monmouth Hawks,R. Salnave,4067329,,True,38.0,5,17,5,15,0,2,4,5,2,2,4,2,1,0,3,3,14
401083128,Monmouth Hawks,N. Rutherford,3946977,,True,26.0,0,4,0,3,0,1,0,0,1,5,6,0,2,1,4,1,0
401083128,Monmouth Hawks,S. Ibiezugbe,4067330,,False,12.0,0,2,0,2,0,0,0,0,1,0,1,0,0,0,1,2,0
401083128,Monmouth Hawks,D. Quinn,3948714,,False,24.0,1,3,1,3,0,0,6,8,3,2,5,0,0,1,2,2,8
401083128,Monmouth Hawks,M. Martin,4279733,,False,21.0,3,6,2,3,1,3,0,0,2,2,4,0,0,0,1,1,7
401083128,Monmouth Hawks,S. Chaput,4398409,,False,14.0,0,3,0,3,0,0,0,1,0,0,0,1,1,0,2,1,0
401083128,Monmouth Hawks,D. Calloway Jr.,4398407,,False,2.0,1,1,0,0,1,1,0,0,0,0,0,0,0,0,0,0,3
401083128,Monmouth Hawks,G. Papas,4279735,,False,12.0,1,4,1,1,0,3,0,0,0,0,0,0,1,0,0,2,2
401083128,Monmouth Hawks,T. Gross Jr.,4065729,,False,1.0,0,0,0,0,0,0,0,0,0,0,0,0,0,0,0,0,0
401083128,Monmouth Hawks,L. Pillari,3948713,,False,11.0,1,5,1,3,0,2,0,0,0,0,0,0,0,0,0,0,2
401083128,Monmouth Hawks,TEAM,TOTAL,TOTAL,False,,16,58,14,42,2,16,10,16,13,12,25,4,6,2,16,21,44
401083128,Kentucky Wildcats,P.J. Washington,4278078,,True,19.0,3,6,2,4,1,2,1,1,2,6,8,1,0,0,1,5,8
401083128,Kentucky Wildcats,R. Travis,3134914,,True,27.0,4,6,3,4,1,2,4,5,0,6,6,1,0,1,1,1,13
401083128,Kentucky Wildcats,T. Herro,4395725,,True,28.0,6,10,4,5,2,5,2,2,1,7,8,1,5,0,0,1,16
401083128,Kentucky Wildcats,I. Quickley,4395724,,True,20.0,1,3,1,1,0,2,2,2,0,2,2,2,0,0,2,0,4
401083128,Kentucky Wildcats,K. Johnson,4395723,,True,31.0,5,9,4,6,1,3,4,5,0,3,3,2,0,0,4,1,15
401083128,Kentucky Wildcats,E. Montgomery,4395727,,False,26.0,3,6,3,5,0,1,1,2,1,3,4,2,2,1,1,4,7
401083128,Kentucky Wildcats,N. Richards,4278076,,False,9.0,2,3,2,3,0,0,2,2,2,0,2,0,0,3,0,3,6
401083128,Kentucky Wildcats,A. Hagans,4395722,,False,20.0,2,3,1,1,1,2,2,2,0,2,2,3,1,0,2,1,7
401083128,Kentucky Wildcats,Q. Green,4278074,,False,18.0,4,7,0,0,4,7,2,2,0,2,2,3,0,0,3,0,14
401083128,Kentucky Wildcats,J. David,3936295,,False,2.0,0,0,0,0,0,0,0,0,0,0,0,0,0,0,0,0,0
401083128,Kentucky Wildcats,TEAM,TOTAL,TOTAL,False,,30,53,20,29,10,24,20,23,9,31,40,15,8,5,14,16,90
401082841,Saint Peter's Peacocks,S. Idowu,3922042,,True,19.0,4,10,4,9,0,1,1,2,3,1,4,0,0,0,0,2,9
401082841,Saint Peter's Peacocks,M. Dixon,4279758,,True,12.0,1,2,1,1,0,1,2,2,0,2,2,0,0,0,1,5,4
401082841,Saint Peter's Peacocks,Q. Taylor,4067357,,True,31.0,3,7,3,7,0,0,2,2,1,2,3,0,1,0,2,2,8
401082841,Saint Peter's Peacocks,D. Turner,4067356,,True,37.0,6,15,3,6,3,9,5,6,1,3,4,6,1,0,3,2,20
401082841,Saint Peter's Peacocks,C. Jones,3922043,,True,14.0,1,2,0,0,1,2,1,2,0,0,0,0,0,0,2,2,4
401082841,Saint Peter's Peacocks,K. Ndefo,4398386,,False,26.0,1,4,1,4,0,0,4,6,3,3,6,0,0,1,2,3,6
401082841,Saint Peter's Peacocks,M. Ndiaye,3922044,,False,5.0,0,2,0,1,0,1,0,0,0,0,0,0,1,0,0,0,0
401082841,Saint Peter's Peacocks,M. Majak,4398387,,False,7.0,1,2,1,2,0,0,0,0,1,4,5,0,0,0,0,1,2
401082841,Saint Peter's Peacocks,C. Underwood,4398388,,False,1.0,0,0,0,0,0,0,0,0,0,0,0,0,0,0,0,0,0
401082841,Saint Peter's Peacocks,K. Brown,4398385,,False,16.0,0,3,0,1,0,2,0,0,0,1,1,0,1,0,0,4,0
401082841,Saint Peter's Peacocks,D. Watson,4398384,,False,31.0,1,7,1,2,0,5,2,6,0,3,3,2,1,0,4,2,4
401082841,Saint Peter's Peacocks,A. Hicks,4284295,,False,1.0,0,0,0,0,0,0,0,0,0,0,0,0,0,0,0,0,0
401082841,Saint Peter's Peacocks,TEAM,TOTAL,TOTAL,False,,18,54,14,33,4,21,17,26,12,20,32,8,5,1,15,23,57
401082841,NC State Wolfpack,W. Walker,3906811,,True,21.0,3,3,3,3,0,0,2,2,1,1,2,0,1,3,1,3,8
401082841,NC State Wolfpack,D. Daniels,4066428,,True,15.0,1,2,0,1,1,1,2,3,0,2,2,2,0,0,2,4,5
401082841,NC State Wolfpack,M. Johnson,4065699,,True,25.0,3,7,2,4,1,3,2,2,0,1,1,1,1,0,1,1,9
401082841,NC State Wolfpack,C.J. Bryce,3946973,,True,28.0,2,5,1,3,1,2,4,5,1,3,4,3,0,2,0,2,9
401082841,NC State Wolfpack,T. Dorn,3132359,,True,23.0,3,6,2,5,1,1,5,7,0,2,2,3,1,0,2,0,12
401082841,NC State Wolfpack,J. Hellems,4395661,,False,17.0,4,7,2,4,2,3,0,0,0,2,2,0,0,1,1,2,10
401082841,NC State Wolfpack,D.J. Funderburk,4066401,,False,13.0,3,5,3,4,0,1,1,1,2,4,6,1,0,0,1,3,7
401082841,NC State Wolfpack,B. Harris,4278106,,False,16.0,2,2,2,2,0,0,0,0,1,2,3,4,2,0,2,2,4
401082841,NC State Wolfpack,B. Beverly,4278007,,False,22.0,2,9,0,4,2,5,4,4,1,1,2,3,1,0,1,2,10
401082841,NC State Wolfpack,E. Lockett,3133822,,False,20.0,4,6,2,2,2,4,1,3,0,6,6,3,0,0,1,2,11
401082841,NC State Wolfpack,TEAM,TOTAL,TOTAL,False,,27,52,17,32,10,20,21,27,9,27,36,20,6,6,12,21,85
401082807,Pittsburgh Panthers,K. Chukwuka,4278017,,True,23.0,0,2,0,0,0,2,3,4,2,0,2,2,0,0,0,2,3
401082807,Pittsburgh Panthers,A. Toney,4395671,,True,24.0,3,3,1,1,2,2,4,5,0,9,9,0,1,0,4,4,12
401082807,Pittsburgh Panthers,T. McGowens,4395670,,True,25.0,4,8,2,3,2,5,2,2,1,1,2,0,4,0,5,2,12
401082807,Pittsburgh Panthers,X. Johnson,4395669,,True,32.0,7,16,4,11,3,5,2,5,0,1,1,3,3,0,4,2,19
401082807,Pittsburgh Panthers,M. Ellison,3938916,,True,17.0,3,5,3,5,0,0,1,2,1,1,2,2,0,0,3,3,7
401082807,Pittsburgh Panthers,T. Brown-Soares,4278018,,False,12.0,3,6,3,6,0,0,0,0,0,3,3,0,0,1,1,0,6
401082807,Pittsburgh Panthers,P. Ilegomah,4278022,,False,2.0,0,0,0,0,0,0,0,0,0,0,0,0,0,0,0,2,0
401082807,Pittsburgh Panthers,K. Davis,4278016,,False,12.0,0,0,0,0,0,0,0,0,0,2,2,1,0,0,0,0,0
401082807,Pittsburgh Panthers,J. Wilson-Frame,4278012,,False,32.0,3,11,1,3,2,8,0,0,0,3,3,6,0,1,1,2,8
401082807,Pittsburgh Panthers,S. N'Dir,4067470,,False,21.0,1,6,0,3,1,3,0,0,0,2,2,3,1,0,0,1,3
401082807,Pittsburgh Panthers,TEAM,TOTAL,TOTAL,False,,24,57,14,32,10,25,12,18,7,24,31,17,9,2,18,18,70
401082807,Niagara Purple Eagles,K. Green,4067342,,True,15.0,1,3,1,2,0,1,0,2,1,4,5,0,1,0,0,4,2
401082807,Niagara Purple Eagles,D. Robb,3907186,,True,26.0,5,9,5,9,0,0,2,2,1,4,5,3,1,4,1,5,12
401082807,Niagara Purple Eagles,K. Tate,4279738,,True,35.0,6,15,2,6,4,9,1,2,2,5,7,1,2,0,5,2,17
401082807,Niagara Purple Eagles,J. Towns,4067341,,True,36.0,4,8,3,7,1,1,3,4,1,5,6,9,1,0,6,2,12
401082807,Niagara Purple Eagles,C. Barton,3907182,,True,32.0,2,6,1,3,1,3,1,3,0,4,4,3,0,0,6,2,6
401082807,Niagara Purple Eagles,G. Kuakumensah,4279739,,False,25.0,4,5,2,3,2,2,2,2,1,6,7,0,1,2,1,3,12
401082807,Niagara Purple Eagles,G. King,3906490,,False,14.0,4,5,4,5,0,0,0,0,0,1,1,0,0,0,1,1,8
401082807,Niagara Purple Eagles,M. Hammond,4398404,,False,4.0,1,1,1,1,0,0,0,0,1,0,1,0,0,0,2,0,2
401082807,Niagara Purple Eagles,R. Solomon,4398403,,False,10.0,0,3,0,1,0,2,0,0,0,0,0,0,0,0,2,2,0
401082807,Niagara Purple Eagles,D. Fragala,4279737,,False,3.0,0,1,0,0,0,1,0,0,0,0,0,0,0,0,0,0,0
401082807,Niagara Purple Eagles,TEAM,TOTAL,TOTAL,False,,27,56,19,37,8,19,9,15,9,29,38,16,6,6,24,21,71
401082697,Florida State Seminoles,C. Koumadje,3907824,,True,17.0,4,6,4,6,0,0,0,0,2,7,9,0,0,1,1,3,8
401082697,Florida State Seminoles,M. Walker,4277854,,True,24.0,4,7,1,3,3,4,1,3,3,1,4,2,2,0,4,3,12
401082697,Florida State Seminoles,P. Savoy,4065657,,True,22.0,0,2,0,0,0,2,2,2,0,1,1,0,1,0,2,0,2
401082697,Florida State Seminoles,T. Forrest,4065656,,True,29.0,3,7,3,7,0,0,2,2,0,5,5,6,2,0,1,1,8
401082697,Florida State Seminoles,T. Mann,3907823,,True,28.0,4,9,3,8,1,1,3,3,3,2,5,4,0,0,2,0,12
401082697,Florida State Seminoles,R. Gray,4277850,,False,12.0,0,0,0,0,0,0,4,4,1,2,3,2,0,0,1,0,4
401082697,Florida State Seminoles,M. Kabengele,4065660,,False,19.0,6,12,6,11,0,1,6,10,3,3,6,1,0,0,1,2,18
401082697,Florida State Seminoles,D. Vassell,4395630,,False,14.0,4,7,4,6,0,1,2,2,1,0,1,0,3,1,1,1,10
401082697,Florida State Seminoles,W. Wilkes,4277855,,False,5.0,2,2,0,0,2,2,0,0,0,1,1,0,0,0,1,1,6
401082697,Florida State Seminoles,A. Polite,4277852,,False,13.0,2,3,1,1,1,2,4,4,0,2,2,2,1,0,0,2,9
401082697,Florida State Seminoles,D. Nichols,3918723,,False,17.0,2,4,2,3,0,1,0,0,0,0,0,2,0,1,1,2,4
401082697,Florida State Seminoles,TEAM,TOTAL,TOTAL,False,,31,59,24,45,7,14,24,30,14,26,40,19,9,3,15,15,93
401082697,Canisius Golden Griffins,S. Hitchon,4279482,,True,7.0,0,1,0,1,0,0,0,0,0,0,0,0,1,2,1,4,0
401082697,Canisius Golden Griffins,J. White,4279478,,True,20.0,0,1,0,1,0,0,0,0,0,2,2,1,1,1,0,1,0
401082697,Canisius Golden Griffins,T. Molson,4279481,,True,34.0,6,16,6,10,0,6,3,4,1,5,6,5,0,0,3,3,15
401082697,Canisius Golden Griffins,I. Reese,4067278,,True,35.0,6,16,3,9,3,7,0,0,0,4,4,0,0,0,2,3,15
401082697,Canisius Golden Griffins,M. Johnson,4067275,,True,38.0,6,9,1,3,5,6,3,4,2,2,4,2,0,0,6,2,20
401082697,Canisius Golden Griffins,K. Johnson-Alls,4398049,,False,16.0,1,2,1,1,0,1,0,0,0,1,1,0,0,1,2,4,2
401082697,Canisius Golden Griffins,D. St. Louis,4067280,,False,27.0,3,4,3,4,0,0,3,6,1,2,3,0,2,1,2,3,9
401082697,Canisius Golden Griffins,J. Faulkner,3137250,,False,5.0,0,0,0,0,0,0,0,0,0,0,0,1,0,1,1,3,0
401082697,Canisius Golden Griffins,S. Rautins,4398047,,False,0.0,0,0,0,0,0,0,0,0,0,0,0,0,0,0,0,0,0
401082697,Canisius Golden Griffins,J. Henderson,4398046,,False,2.0,0,0,0,0,0,0,0,0,1,0,1,0,0,0,0,0,0
401082697,Canisius Golden Griffins,J. Sanks,3141259,,False,16.0,0,3,0,2,0,1,0,1,0,0,0,1,0,0,1,0,0
401082697,Canisius Golden Griffins,TEAM,TOTAL,TOTAL,False,,22,52,14,31,8,21,9,15,8,17,25,10,4,6,19,23,61
401082646,Saint Peter's Peacocks,K. Ndefo,4398386,,True,34.0,3,11,2,6,1,5,2,2,2,4,6,3,2,1,2,5,9
401082646,Saint Peter's Peacocks,S. Idowu,3922042,,True,15.0,2,4,2,4,0,0,0,0,0,2,2,0,0,0,0,5,4
401082646,Saint Peter's Peacocks,Q. Taylor,4067357,,True,35.0,1,7,1,6,0,1,1,3,3,7,10,1,1,0,0,4,3
401082646,Saint Peter's Peacocks,D. Turner,4067356,,True,37.0,7,17,4,11,3,6,1,1,2,0,2,2,1,1,3,0,18
401082646,Saint Peter's Peacocks,C. Jones,3922043,,True,36.0,5,10,2,5,3,5,0,0,0,4,4,2,1,0,3,2,13
401082646,Saint Peter's Peacocks,M. Majak,4398387,,False,19.0,1,2,1,2,0,0,0,0,0,1,1,0,0,4,1,4,2
401082646,Saint Peter's Peacocks,K. Brown,4398385,,False,4.0,0,0,0,0,0,0,0,0,0,0,0,0,0,0,0,1,0
401082646,Saint Peter's Peacocks,D. Watson,4398384,,False,20.0,4,5,1,1,3,4,0,0,0,1,1,0,0,0,2,1,11
401082646,Saint Peter's Peacocks,TEAM,TOTAL,TOTAL,False,,23,56,13,35,10,21,4,6,8,21,29,8,5,6,11,22,60
401082646,Clemson Tigers,A. Simms,4277835,,True,24.0,1,5,1,2,0,3,0,0,0,4,4,0,0,2,1,1,2
401082646,Clemson Tigers,J. White,3913224,,True,10.0,1,3,1,3,0,0,0,0,1,0,1,0,0,0,0,0,2
401082646,Clemson Tigers,D. Skara,3133922,,True,30.0,1,3,1,1,0,2,2,4,1,3,4,0,1,0,0,3,4
401082646,Clemson Tigers,S. Mitchell,3136699,,True,31.0,4,9,2,4,2,5,5,6,0,2,2,0,0,0,4,1,15
401082646,Clemson Tigers,M. Reed,3133969,,True,38.0,6,14,6,12,0,2,9,11,0,0,0,3,3,0,2,4,21
401082646,Clemson Tigers,H. Tyson,4395620,,False,14.0,0,2,0,1,0,1,0,0,2,1,3,0,1,0,0,0,0
401082646,Clemson Tigers,E. Thomas,3947075,,False,26.0,5,8,5,8,0,0,7,9,3,9,12,0,0,2,1,1,17
401082646,Clemson Tigers,J. Newman III,4395622,,False,4.0,0,1,0,0,0,1,0,0,0,0,0,0,0,0,0,0,0
401082646,Clemson Tigers,T. Jemison III,4395623,,False,2.0,0,1,0,1,0,0,0,0,0,1,1,0,0,0,0,0,0
401082646,Clemson Tigers,C. Trapp,4277833,,False,21.0,2,2,2,2,0,0,0,0,1,6,7,3,1,0,1,2,4
401082646,Clemson Tigers,TEAM,TOTAL,TOTAL,False,,20,48,18,34,2,14,23,30,10,26,36,6,6,4,9,12,65
401082621,Fairfield Stags,J. Kasibabu,3947016,,True,24.0,4,6,4,6,0,0,1,2,2,8,10,2,1,0,1,4,9
401082621,Fairfield Stags,L. Taliaferro,4398078,,True,14.0,3,13,2,4,1,9,0,0,0,2,2,0,0,0,2,2,7
401082621,Fairfield Stags,F. Lemetti,4398076,,True,38.0,2,10,0,0,2,10,0,0,0,3,3,1,1,0,2,1,6
401082621,Fairfield Stags,N. Alvarez,4398075,,True,21.0,0,3,0,2,0,1,0,0,0,3,3,3,0,0,4,1,0
401082621,Fairfield Stags,J. Cruz,4279488,,True,30.0,5,12,5,10,0,2,0,0,1,4,5,5,1,1,1,1,10
401082621,Fairfield Stags,O. El-Sheikh,4279489,,False,11.0,1,2,0,1,1,1,0,0,0,2,2,1,0,0,1,1,3
401082621,Fairfield Stags,W. Methnani,4279486,,False,9.0,2,2,1,1,1,1,0,0,0,2,2,2,0,0,3,1,5
401082621,Fairfield Stags,C. Whipple,4398077,,False,34.0,7,14,0,0,7,14,0,0,0,1,1,1,0,0,1,4,21
401082621,Fairfield Stags,A. Kavaliauskas,4080375,,False,19.0,2,2,0,0,2,2,0,0,0,4,4,5,0,0,0,3,6
401082621,Fairfield Stags,TEAM,TOTAL,TOTAL,False,,26,64,12,24,14,40,1,2,4,31,35,20,3,1,15,18,67
401082621,Boston College Eagles,J. Hamilton,4395617,,True,31.0,2,4,1,3,1,1,0,1,3,5,8,1,1,0,4,2,5
401082621,Boston College Eagles,N. Popovic,4065637,,True,37.0,4,9,4,9,0,0,3,4,4,6,10,0,2,4,1,2,11
401082621,Boston College Eagles,W. Tabbs,4395619,,True,39.0,6,12,3,6,3,6,5,6,0,5,5,6,1,1,3,0,20
401082621,Boston College Eagles,C. Herren Jr.,4395618,,True,35.0,8,13,4,6,4,7,2,4,1,3,4,0,1,0,1,3,22
401082621,Boston College Eagles,K. Bowman,4065635,,True,37.0,4,17,4,11,0,6,11,12,1,11,12,2,3,0,4,1,19
401082621,Boston College Eagles,J. Reyes,3943609,,False,3.0,0,0,0,0,0,0,0,0,0,0,0,0,0,0,0,0,0
401082621,Boston College Eagles,L. Kraljevic,4277831,,False,7.0,0,0,0,0,0,0,0,0,0,0,0,0,1,0,0,0,0
401082621,Boston College Eagles,E. Meznieks,3943607,,False,2.0,0,0,0,0,0,0,0,0,0,1,1,0,1,0,0,0,0
401082621,Boston College Eagles,V. Baker Jr.,4277830,,False,6.0,0,2,0,1,0,1,0,0,0,1,1,1,0,1,0,0,0
401082621,Boston College Eagles,A. Wilson,4277829,,False,3.0,0,1,0,1,0,0,0,2,0,0,0,0,0,0,0,0,0
401082621,Boston College Eagles,TEAM,TOTAL,TOTAL,False,,24,58,16,37,8,21,21,29,9,34,43,10,10,6,13,8,77
401082580,Purdue Boilermakers,M. Haarms,4080105,,True,17.0,4,6,4,6,0,0,1,3,3,5,8,0,0,3,3,4,9
401082580,Purdue Boilermakers,G. Eifert,3906670,,True,28.0,3,4,1,1,2,3,1,1,2,8,10,1,0,0,0,2,9
401082580,Purdue Boilermakers,N. Eastern,4277984,,True,23.0,0,4,0,3,0,1,0,0,1,3,4,1,0,0,2,3,0
401082580,Purdue Boilermakers,C. Edwards,4066407,,True,28.0,10,17,3,6,7,11,3,3,0,0,0,2,1,0,2,2,30
401082580,Purdue Boilermakers,R. Cline,3906675,,True,29.0,5,10,2,4,3,6,0,0,0,2,2,8,0,0,1,0,13
401082580,Purdue Boilermakers,T. Williams,4397246,,False,4.0,1,1,1,1,0,0,0,0,1,0,1,0,0,0,0,1,2
401082580,Purdue Boilermakers,K. King,4397245,,False,2.0,0,0,0,0,0,0,0,0,0,1,1,0,0,0,0,0,0
401082580,Purdue Boilermakers,A. Wheeler,4277982,,False,12.0,0,3,0,0,0,3,2,2,0,4,4,0,2,0,2,1,2
401082580,Purdue Boilermakers,E. Boudreaux,3906964,,False,18.0,4,6,4,5,0,1,2,2,0,2,2,1,0,0,0,2,10
401082580,Purdue Boilermakers,E. Hunter Jr.,4397243,,False,17.0,4,6,3,3,1,3,1,2,1,2,3,3,0,0,0,1,10
401082580,Purdue Boilermakers,S. Stefanovic,4277985,,False,19.0,1,2,0,0,1,2,0,0,0,1,1,1,1,0,3,1,3
401082580,Purdue Boilermakers,T. Luce,4066408,,False,3.0,0,0,0,0,0,0,2,2,0,0,0,0,0,0,0,0,2
401082580,Purdue Boilermakers,TEAM,TOTAL,TOTAL,False,,32,59,18,29,14,30,12,15,10,30,40,17,4,3,13,17,90
401082580,Fairfield Stags,W. Methnani,4279486,,True,12.0,1,6,0,3,1,3,0,0,0,4,4,1,0,0,1,5,3
401082580,Fairfield Stags,J. Kasibabu,3947016,,True,27.0,4,9,2,6,2,3,4,6,1,3,4,1,1,0,3,3,14
401082580,Fairfield Stags,L. Taliaferro,4398078,,True,35.0,4,6,1,2,3,4,0,0,0,1,1,3,0,0,0,0,11
401082580,Fairfield Stags,N. Alvarez,4398075,,True,30.0,7,14,5,9,2,5,0,0,0,3,3,0,2,0,4,2,16
401082580,Fairfield Stags,T. Benning,4279483,,True,24.0,1,9,1,5,0,4,1,2,3,1,4,1,0,0,2,1,3
401082580,Fairfield Stags,K. Senghore-Peterson,4279485,,False,4.0,0,1,0,1,0,0,0,0,0,0,0,0,0,0,0,1,0
401082580,Fairfield Stags,M. Milin,3947018,,False,19.0,4,6,4,6,0,0,0,1,3,0,3,0,1,0,0,1,8
401082580,Fairfield Stags,C. Whipple,4398077,,False,3.0,0,0,0,0,0,0,0,0,0,0,0,0,0,0,0,0,0
401082580,Fairfield Stags,F. Lemetti,4398076,,False,22.0,0,1,0,1,0,0,0,0,0,0,0,2,0,0,1,2,0
401082580,Fairfield Stags,J. Cruz,4279488,,False,17.0,1,5,1,4,0,1,0,0,1,1,2,0,0,0,0,0,2
401082580,Fairfield Stags,A. Kavaliauskas,4080375,,False,5.0,0,1,0,0,0,1,0,0,0,0,0,0,0,0,0,1,0
401082580,Fairfield Stags,T. Nolan,3947015,,False,2.0,0,2,0,1,0,1,0,0,0,0,0,0,1,0,0,1,0
401082580,Fairfield Stags,TEAM,TOTAL,TOTAL,False,,22,60,14,38,8,22,5,9,10,15,25,8,5,0,12,17,57
